ibge,anomes,bpc_ben,bpc_pcd_ben,bpc_idoso_ben,bpc_pcd_val,bpc_idoso_val,bpc_val
110001,201701,499,387,112,360849.99,104109.64,464959.63
110002,201701,2628,1526,1102,1420458.63,1025406.29,2445864.92
110003,201701,86,67,19,62358.45,17682.89,80041.34
110004,201701,1882,1183,699,1099927.88,650046.95,1749974.83
110005,201701,428,347,81,322333.16,75265.32,397598.48
110006,201701,436,335,101,310928.73,93875.68,404804.41
110007,201701,79,64,15,59767.45,13974.89,73742.34
110008,201701,247,145,102,134407.23,95192.9,229600.13
110009,201701,742,494,248,459995.16,230927.26,690922.42
110010,201701,1785,1094,691,1017870.93,644331.25,1662202.18
110011,201701,1844,1410,434,1311488.64,404022.03,1715510.67
110012,201701,3959,2241,1718,2086644.25,1602714.78,3689359.03
110013,201701,719,522,197,485394.07,183165.59,668559.66
110014,201701,415,349,66,325650.47,61556.77,387207.24
110015,201701,1426,1137,289,1058010.85,268449.08,1326459.93
110018,201701,1100,647,453,601550.2,422029.59,1023579.79
110020,201701,14823,8656,6167,8009084.39,5727119.86,13736204.25
110025,201701,526,374,152,347119.83,141691.92,488811.75
110026,201701,46,31,15,28785.9,13934.56,42720.46
110028,201701,1520,1087,433,1007826.26,401448.43,1409274.69
110029,201701,132,114,18,106577.67,16846,123423.67
110030,201701,2393,1592,801,1477591.78,744338.75,2221930.53
110032,201701,373,284,89,264499.71,83128.01,347627.72
110033,201701,628,482,146,444628.89,135515.02,580143.91
110034,201701,395,292,103,269728.05,95233.78,364961.83
110037,201701,103,81,22,75796.67,20593.89,96390.56
110040,201701,316,207,109,192514.71,101331.24,293845.95
110045,201701,874,563,311,523563.21,288525.93,812089.14
110050,201701,95,74,21,68977.78,19596.78,88574.56
110060,201701,92,45,47,41944.89,43598.45,85543.34
110070,201701,128,76,52,70810.35,48121.57,118931.92
110080,201701,382,214,168,197236.26,156097.41,353333.67
110090,201701,27,22,5,20513.56,4644.78,25158.34
110092,201701,102,59,43,55022.01,39939.57,94961.58
110094,201701,185,127,58,118177.57,53824.79,172002.36
110100,201701,26,22,4,20493.78,3727.89,24221.67
110110,201701,67,40,27,37259.56,24797.56,62057.12
110120,201701,91,70,21,65229.01,19576.67,84805.68
110130,201701,296,244,52,225878.6,48423.34,274301.94
110140,201701,240,156,84,145281.85,78217.09,223498.94
110143,201701,45,39,6,36362.56,5561.67,41924.23
110145,201701,26,18,8,16785.89,7476,24261.89
110146,201701,21,13,8,12140.89,7455.89,19596.78
110147,201701,39,30,9,27769,8413,36182
110148,201701,36,25,11,23232.91,10287,33519.91
110149,201701,269,187,82,174034.05,76351.8,250385.85
110150,201701,71,43,28,40170.89,25955.34,66126.23
110155,201701,9,7,2,6519,1854,8373
110160,201701,69,57,12,53027.24,11163.67,64190.91
110170,201701,227,185,42,172304.34,39113.67,211418.01
110175,201701,25,19,6,17622.12,5601.89,23224.01
110180,201701,92,81,11,75816.78,10266.89,86083.67
120001,201701,145,93,52,86475,48695,135170
120005,201701,183,113,70,105838.12,65403,171241.12
120010,201701,930,614,316,570599.93,293645.4,864245.33
120013,201701,123,83,40,77183.77,36514.74,113698.51
120017,201701,74,49,25,45826.36,23382.12,69208.48
120020,201701,3377,2688,689,2491156.39,642026.26,3133182.65
120025,201701,614,339,275,315289,255932.37,571221.37
120030,201701,1001,827,174,767521.25,162315,929836.25
120032,201701,47,39,8,36521.12,7496,44017.12
120033,201701,217,191,26,178625.94,24362,202987.94
120034,201701,147,104,43,95552.52,40247.24,135799.76
120035,201701,25,16,9,14992,8433,23425
120038,201701,419,265,154,247779.65,144244.87,392024.52
120039,201701,17,15,2,14055,1874,15929
120040,201701,13463,9301,4162,8586880.22,3856661.27,12443541.49
120042,201701,39,33,6,30921,5622,36543
120043,201701,14,3,11,2811,10286.89,13097.89
120045,201701,515,324,191,302286.18,178746.24,481032.42
120050,201701,1213,920,293,857240.5,273258.24,1130498.74
120060,201701,1355,1083,272,998512.77,250807.1,1249319.87
120070,201701,537,376,161,346350.51,149310.11,495660.62
120080,201701,121,76,45,70145.13,41580.67,111725.80
130002,201701,151,105,46,98385,43102,141487
130006,201701,76,42,34,39354,31858,71212
130008,201701,138,73,65,67681.6,60161.08,127842.68
130010,201701,139,71,68,66527,63716,130243
130014,201701,218,159,59,148983,55283,204266
130020,201701,84,48,36,44976,33732,78708
130030,201701,851,529,322,495673,301704.63,797377.63
130040,201701,320,162,158,151794,146828,298622
130050,201701,539,307,232,287377.9,217384,504761.9
130060,201701,866,594,272,551129.53,251939.82,803069.35
130063,201701,536,285,251,267045,235165.12,502210.12
130068,201701,190,119,71,111503,66246,177749
130070,201701,1336,931,405,846170.3,369851.98,1216022.28
130080,201701,667,437,230,409094.2,215501,624595.2
130083,201701,65,34,31,31858,29047,60905
130090,201701,393,193,200,179191.88,187400,366591.88
130100,201701,1102,520,582,487240,545052.9,1032292.9
130110,201701,707,307,400,287509,374780,662289
130115,201701,174,73,101,68401,94637,163038
130120,201701,1609,1006,603,942622,565011,1507633
130130,201701,621,421,200,394477,187400,581877
130140,201701,1556,1169,387,1094722.95,361682.1,1456405.05
130150,201701,408,338,70,316706,65590,382296
130160,201701,475,260,215,243620,201455,445075
130165,201701,30,20,10,18740,9370,28110
130170,201701,944,658,286,610871.22,264927.15,875798.37
130180,201701,164,97,67,90420.5,62779,153199.5
130185,201701,1956,1054,902,985422.79,844591.89,1830014.68
130190,201701,3563,2274,1289,2127927,1206013.09,3333940.09
130195,201701,293,235,58,220195,54346,274541
130200,201701,180,80,100,74950.63,93700,168650.63
130210,201701,69,35,34,32795,31858,64653
130220,201701,185,129,56,120873,52472,173345
130230,201701,339,212,127,198644,118999,317643
130240,201701,1459,895,564,837258.98,528182.22,1365441.20
130250,201701,4616,2939,1677,2749324.6,1571215.93,4320540.53
130255,201701,402,215,187,201455,174937.9,376392.9
130260,201701,50558,23830,26728,22297742.49,25036071.26,47333813.75
130270,201701,1427,912,515,854050.82,482534.89,1336585.71
130280,201701,103,63,40,59031,37480,96511
130290,201701,2069,1513,556,1417277,520690.9,1937967.9
130300,201701,423,304,119,284566.9,111503,396069.9
130310,201701,922,497,425,465689,398225,863914
130320,201701,442,236,206,220035.71,193022,413057.71
130330,201701,715,437,278,409469,260204.9,669673.9
130340,201701,3159,1959,1200,1832584.8,1123275.7,2955860.5
130350,201701,500,305,195,285662.57,182715,468377.57
130353,201701,721,293,428,274260,401036,675296
130356,201701,703,316,387,296072,362337.9,658409.9
130360,201701,70,42,28,39354,26236,65590
130370,201701,704,504,200,472248,187400,659648
130380,201701,632,413,219,386981,205203,592184
130390,201701,506,400,106,374800,99322,474122
130395,201701,168,43,125,40291,117125,157416
130400,201701,64,46,18,43102,16866,59968
130406,201701,2006,1286,720,1201468.25,674012.16,1875480.41
130410,201701,534,222,312,208014,292344,500358
130420,201701,3215,2531,684,2368736.35,640908,3009644.35
130423,201701,166,76,90,71212,84330,155542
130426,201701,140,80,60,74960,56220,131180
130430,201701,409,269,140,252053,131180,383233
130440,201701,200,73,127,68120,118999,187119
140002,201701,35,15,20,14055,18740,32795
140005,201701,186,112,74,104709.75,69338,174047.75
140010,201701,9878,6648,3230,6204096.47,3022061.82,9226158.29
140015,201701,148,69,79,64653,74023,138676
140017,201701,98,68,30,63716,28110,91826
140020,201701,502,338,164,315769.84,153668,469437.84
140023,201701,57,40,17,37480,15929,53409
140028,201701,32,21,11,19677,10307,29984
140030,201701,354,251,103,235187,95920.69,331107.69
140040,201701,49,34,15,31858,13961.3,45819.3
140045,201701,245,114,131,106162.1,122747,228909.1
140047,201701,604,393,211,364728.66,196957.5,561686.16
140050,201701,162,102,60,94776,56220,150996
140060,201701,48,37,11,34669,10307,44976
140070,201701,30,28,2,26236,1874,28110
150010,201701,4636,2857,1779,2674338.75,1664540.66,4338879.41
150013,201701,136,89,47,83393,44039,127432
150020,201701,1066,525,541,491925,506917,998842
150030,201701,764,300,464,281100,434768,715868
150034,201701,183,109,74,102133,69338,171471
150040,201701,1317,788,529,738336,495673,1234009
150050,201701,591,340,251,317596.15,234987,552583.15
150060,201701,4615,2994,1621,2802561.55,1518352.28,4320913.83
150070,201701,299,126,173,118062,162101,280163
150080,201701,14142,7058,7084,6604029.74,6632118.16,13236147.90
150085,201701,343,206,137,193012.63,128369,321381.63
150090,201701,741,630,111,590310,104007,694317
150095,201701,348,211,137,197707,127563.18,325270.18
150100,201701,50,34,16,31858,14992,46850
150110,201701,175,85,90,79645,84330,163975
150120,201701,348,269,79,252053,74023,326076
150125,201701,48,21,27,19677,25299,44976
150130,201701,1827,965,862,904205,807689.32,1711894.32
150140,201701,54072,25164,28908,23547114.28,27073474.75,50620589.03
150145,201701,167,96,71,89952,66527,156479
150150,201701,2625,1083,1542,1014771,1440230.8,2455001.8
150157,201701,463,308,155,288596,145230.32,433826.32
150160,201701,107,83,24,77771,22488,100259
150170,201701,3606,2640,966,2470494.3,903923.9,3374418.2
150172,201701,294,201,93,188337,87141,275478
150175,201701,90,56,34,52472,31858,84330
150178,201701,723,479,244,447886,228628,676514
150180,201701,2879,1335,1544,1250098.8,1446428.86,2696527.66
150190,201701,325,201,124,188337,116188,304525
150195,201701,116,56,60,52472,56220,108692
150200,201701,208,93,115,87141,107755,194896
150210,201701,3045,2460,585,2303980.84,547906.75,2851887.59
150215,201701,467,317,150,296748,140550,437298
150220,201701,4056,2691,1365,2520005.95,1277131.36,3797137.31
150230,201701,967,782,185,732164.7,173345,905509.7
150240,201701,5476,3188,2288,2983587.47,2143843,5127430.47
150250,201701,31,13,18,12181,16866,29047
150260,201701,69,41,28,38417,26236,64653
150270,201701,2267,1482,785,1388072,734983,2123055
150275,201701,630,381,249,356997,233313,590310
150276,201701,100,40,60,37480,56220,93700
150277,201701,759,321,438,300758.63,410406,711164.63
150280,201701,337,201,136,188337,127432,315769
150285,201701,70,34,36,31858,33732,65590
150290,201701,938,567,371,530988.53,347346,878334.53
150293,201701,700,317,383,296607.63,358871,655478.63
150295,201701,456,190,266,178030,249110.82,427140.82
150300,201701,80,43,37,40291,34669,74960
150304,201701,136,83,53,77771,49661,127432
150307,201701,384,308,76,288596,71212,359808
150309,201701,502,355,147,332635,137739,470374
150310,201701,256,173,83,162101,77771,239872
150320,201701,1701,1164,537,1090391.59,503169,1593560.59
150330,201701,2036,1152,884,1078768.1,828308,1907076.1
150340,201701,189,123,66,115016.75,61842,176858.75
150345,201701,613,318,295,297966,276415,574381
150350,201701,758,570,188,531560.1,176156,707716.1
150360,201701,4313,2771,1542,2593761.74,1444844.63,4038606.37
150370,201701,712,499,213,466899,199290.9,666189.9
150375,201701,190,105,85,98385,79645,178030
150380,201701,1173,748,425,700876,397944,1098820
150390,201701,729,415,314,388855,293942,682797
150400,201701,88,69,19,64653,17803,82456
150405,201701,1236,810,426,758226.96,398599.8,1156826.76
150410,201701,146,93,53,87141,49661,136802
150420,201701,6953,3758,3195,3519567.07,2992140.49,6511707.56
150430,201701,462,308,154,288596,144298,432894
150440,201701,603,351,252,328138,235843,563981
150442,201701,1943,1061,882,992386.07,826434,1818820.07
150445,201701,498,306,192,286722,178967,465689
150450,201701,277,127,150,118999,140550,259549
150460,201701,891,660,231,616344.66,216428.26,832772.92
150470,201701,1319,782,537,732453,503169,1235622
150475,201701,24,18,6,16866,5622,22488
150480,201701,1225,847,378,793639,354186,1147825
150490,201701,614,316,298,296092,279226,575318
150495,201701,318,213,105,199581,98385,297966
150497,201701,292,196,96,183652,89942.63,273594.63
150500,201701,432,291,141,272667,132117,404784
150503,201701,732,343,389,321391,364475,685866
150506,201701,1026,634,392,594058,367285.63,961343.63
150510,201701,1237,697,540,653089,505980,1159069
150520,201701,258,170,88,159290,82456,241746
150530,201701,1447,798,649,744353.55,607832,1352185.55
150540,201701,414,295,119,276415,111503,387918
150543,201701,645,364,281,340786.9,262921.9,603708.8
150548,201701,484,319,165,298903,154605,453508
150549,201701,57,38,19,35606,17803,53409
150550,201701,2868,1472,1396,1378562,1307490,2686052
150553,201701,2890,1721,1169,1611640.2,1095052,2706692.2
150555,201701,141,72,69,67464,64653,132117
150560,201701,52,39,13,36543,12181,48724
150563,201701,58,30,28,28110,26236,54346
150565,201701,157,89,68,83393,63716,147109
150570,201701,397,261,136,244538.26,127432,371970.26
150580,201701,1454,571,883,534371.1,827371,1361742.1
150590,201701,916,540,376,505980,352312,858292
150600,201701,441,269,172,252053,161164,413217
150610,201701,137,118,19,109733,17803,127536
150611,201701,130,86,44,80582,41228,121810
150613,201701,3083,1883,1200,1764367,1124382,2888749
150616,201701,476,292,184,273604,172408,446012
150618,201701,1098,589,509,551668.49,476933,1028601.49
150619,201701,409,307,102,287659,95574,383233
150620,201701,1251,713,538,668081,504106,1172187
150630,201701,313,211,102,197707,95574,293281
150635,201701,493,195,298,182715,278944.9,461659.9
150640,201701,60,30,30,28110,28110,56220
150650,201701,2271,1290,981,1208458.27,917697.8,2126156.07
150655,201701,249,185,64,173345,59968,233313
150658,201701,99,56,43,52472,40291,92763
150660,201701,470,328,142,307336,133054,440390
150670,201701,954,328,626,307045.9,586543.63,893589.53
150680,201701,9459,5210,4249,4877152.86,3978738.26,8855891.12
150690,201701,48,29,19,27173,17803,44976
150700,201701,561,360,201,337132.6,188337,525469.6
150710,201701,243,149,94,139613,88078,227691
150715,201701,877,515,362,481590.26,339156.89,820747.15
150720,201701,451,331,120,310147,112158.9,422305.9
150730,201701,846,447,399,418830,373581.9,792411.9
150740,201701,329,236,93,221132,87141,308273
150745,201701,770,380,390,356060,365430,721490
150746,201701,53,32,21,29984,19677,49661
150747,201701,272,209,63,195833,59031,254864
150750,201701,116,67,49,62779,45913,108692
150760,201701,1352,843,509,789610,476762,1266372
150770,201701,356,180,176,168660,164740.07,333400.07
150775,201701,82,39,43,36543,40291,76834
150780,201701,177,91,86,85267,80582,165849
150790,201701,899,476,423,446012,396351,842363
150795,201701,1377,782,595,732734,557515,1290249
150796,201701,416,240,176,224880,164912,389792
150797,201701,264,154,110,144298,103070,247368
150800,201701,1381,832,549,778642.31,514413,1293055.31
150803,201701,578,479,99,448823,92763,541586
150805,201701,188,119,69,111503,64640,176143
150808,201701,924,504,420,472248,393540,865788
150810,201701,3367,2297,1070,2147034.38,1002290.26,3149324.64
150812,201701,426,224,202,209888,189274,399162
150815,201701,916,608,308,567373.8,288596,855969.8
150820,201701,1619,984,635,921071,594976.26,1516047.26
150830,201701,835,582,253,544397,237061,781458
150835,201701,169,99,70,92763,65590,158353
150840,201701,1248,793,455,742760,426335,1169095
160005,201701,49,29,20,27173,18740,45913
160010,201701,199,124,75,116188,70271,186459
160015,201701,114,67,47,62779,44039,106818
160020,201701,109,63,46,59031,43102,102133
160021,201701,39,20,19,18740,17803,36543
160023,201701,107,59,48,55283,44976,100259
160025,201701,33,14,19,13118,17803,30921
160027,201701,1413,784,629,731142.1,588636,1319778.1
160030,201701,14837,7512,7325,7030324.6,6856038.47,13886363.07
160040,201701,309,174,135,163038,126495,289533
160050,201701,596,301,295,282037,276133.9,558170.9
160053,201701,348,192,156,179623,146172,325795
160055,201701,19,13,6,12181,5622,17803
160060,201701,6197,3191,3006,2979321.78,2815400.1,5794721.88
160070,201701,157,94,63,88078,59031,147109
160080,201701,75,37,38,34669,35606,70275
170025,201701,22,14,8,13118,7496,20614
170030,201701,226,177,49,165374,45913,211287
170035,201701,236,107,129,99322,120873,220195
170040,201701,182,142,40,132772.9,37480,170252.9
170070,201701,342,192,150,179904,140550,320454
170100,201701,381,265,116,248071,108692,356763
170105,201701,64,53,11,49661,10307,59968
170110,201701,94,56,38,52472,35606,88078
170130,201701,68,30,38,28110,35325,63435
170190,201701,111,68,43,63716,40291,104007
170200,201701,400,263,137,245766.1,128266.78,374032.88
170210,201701,5879,2996,2883,2801697.36,2698167.33,5499864.69
170215,201701,65,31,34,29047,31858,60905
170220,201701,1445,1047,398,978958.86,372457.6,1351416.46
170230,201701,155,99,56,92763,52472,145235
170240,201701,598,388,210,363556,196770,560326
170255,201701,1123,889,234,832993,218976.9,1051969.9
170270,201701,37,26,11,24362,10025.9,34387.9
170290,201701,61,44,17,41228,15929,57157
170300,201701,77,47,30,43289.4,28110,71399.4
170305,201701,36,28,8,26236,7496,33732
170307,201701,56,41,15,38417,14055,52472
170310,201701,94,51,43,47787,40291,88078
170320,201701,17,13,4,12181,3748,15929
170330,201701,19,16,3,14992,2811,17803
170360,201701,21,13,8,12181,7496,19677
170370,201701,170,80,90,74960,84330,159290
170380,201701,78,54,24,50598,22488,73086
170382,201701,50,44,6,41228,5622,46850
170384,201701,118,81,37,75897,34669,110566
170386,201701,57,27,30,25299,28110,53409
170388,201701,45,16,29,14992,27173,42165
170389,201701,25,18,7,16866,6559,23425
170390,201701,48,27,21,25299,19677,44976
170410,201701,35,24,11,22488,10307,32795
170460,201701,17,12,5,11244,4685,15929
170510,201701,26,18,8,16866,7496,24362
170550,201701,1424,792,632,742084,591434.5,1333518.5
170555,201701,108,73,35,68401,32795,101196
170560,201701,101,71,30,66527,28110,94637
170600,201701,36,18,18,16866,16866,33732
170610,201701,196,107,89,100048.16,83375,183423.16
170625,201701,37,17,20,15929,18740,34669
170650,201701,78,56,22,52472,20614,73086
170700,201701,541,409,132,381312.15,122887.55,504199.70
170710,201701,153,93,60,87141,56211,143352
170720,201701,76,63,13,59031,12181,71212
170730,201701,53,31,22,29047,20614,49661
170740,201701,67,48,19,44976,17803,62779
170755,201701,115,52,63,48114.95,59031,107145.95
170765,201701,151,67,84,62170,78708,140878
170770,201701,241,131,110,121950.55,102788.9,224739.45
170820,201701,590,381,209,356997,195412,552409
170825,201701,34,20,14,18740,13118,31858
170830,201701,71,48,23,44788.6,21551,66339.6
170900,201701,207,157,50,147109,46850,193959
170930,201701,771,380,391,355660,366086,721746
170950,201701,2913,1256,1657,1174558.88,1550341.93,2724900.81
170980,201701,16,9,7,8433,6559,14992
171050,201701,123,94,29,88078,27173,115251
171070,201701,31,24,7,22488,6559,29047
171090,201701,34,23,11,21551,10307,31858
171110,201701,22,15,7,14055,6559,20614
171150,201701,37,18,19,16866,17803,34669
171180,201701,18,8,10,7496,9370,16866
171190,201701,125,69,56,64653,52472,117125
171195,201701,62,47,15,44039,14055,58094
171200,201701,45,19,26,17803,24362,42165
171215,201701,1,1,0,937,0,937
171240,201701,52,42,10,39354,9370,48724
171245,201701,46,41,5,38417,4685,43102
171250,201701,68,31,37,29047,34659.63,63706.63
171270,201701,16,12,4,11244,3748,14992
171280,201701,36,33,3,30781,2811,33592
171320,201701,971,543,428,508791,400099,908890
171330,201701,388,176,212,164912,198644,363556
171360,201701,80,58,22,54346,20614,74960
171370,201701,21,10,11,9370,10307,19677
171380,201701,125,100,25,93700,23199.19,116899.19
171395,201701,53,31,22,29047,20614,49661
171420,201701,324,212,112,198644,104662.9,303306.9
171430,201701,55,45,10,41525,9370,50895
171488,201701,207,102,105,95574,98385,193959
171500,201701,61,32,29,29984,27173,57157
171510,201701,60,39,21,36543,19677,56220
171515,201701,43,36,7,33732,6559,40291
171525,201701,31,27,4,25299,3748,29047
171550,201701,11,5,6,4685,5622,10307
171570,201701,58,29,29,27173,27173,54346
171575,201701,360,207,153,193819,143351.63,337170.63
171610,201701,1600,779,821,728057.83,767692.47,1495750.30
171620,201701,122,82,40,76290.54,37198.9,113489.44
171630,201701,51,26,25,24362,23425,47787
171650,201701,283,178,105,166786,98385,265171
171660,201701,254,135,119,126495,111503,237998
171665,201701,40,24,16,22488,14992,37480
171670,201701,430,243,187,226041.98,174656.8,400698.78
171700,201701,60,53,7,49661,6559,56220
171720,201701,24,9,15,8433,14055,22488
171750,201701,93,50,43,46850,40291,87141
171780,201701,68,55,13,51535,12181,63716
171790,201701,79,64,15,59968,14055,74023
171800,201701,32,24,8,22488,7496,29984
171820,201701,1909,1080,829,1011263.47,771030.31,1782293.78
171830,201701,35,26,9,24362,8433,32795
171840,201701,54,29,25,27173,23425,50598
171845,201701,31,19,12,17803,11244,29047
171850,201701,37,25,12,23425,11244,34669
171855,201701,65,50,15,46850,14055,60905
171865,201701,9,6,3,5622,2811,8433
171870,201701,32,23,9,21551,8433,29984
171875,201701,78,53,25,49661,23425,73086
171880,201701,26,19,7,17803,6559,24362
171884,201701,38,18,20,16866,18740,35606
171886,201701,108,39,69,36543,64371.9,100914.9
171888,201701,21,13,8,12181,7496,19677
171889,201701,22,15,7,14055,6559,20614
171890,201701,56,45,11,42165,10307,52472
171900,201701,43,30,13,28110,12181,40291
172000,201701,40,33,7,30921,6559,37480
172010,201701,38,31,7,28250.55,6559,34809.55
172015,201701,25,15,10,14055,9088.9,23143.9
172020,201701,124,76,48,71212,44976,116188
172025,201701,30,19,11,17803,10307,28110
172030,201701,29,17,12,15929,11244,27173
172049,201701,71,44,27,41228,25299,66527
172065,201701,156,102,54,95574,50598,146172
172080,201701,70,52,18,47563.02,16866,64429.02
172085,201701,22,9,13,8433,12181,20614
172090,201701,410,312,98,292344,91077,383421
172093,201701,27,18,9,16866,8433,25299
172097,201701,20,9,11,8433,10026,18459
172100,201701,4368,2390,1978,2234253.67,1850196.83,4084450.50
172110,201701,79,51,28,47787,26236,74023
172120,201701,1744,1486,258,1388046.6,240658.14,1628704.74
172125,201701,2,2,0,1874,0,1874
172130,201701,12,10,2,9370,1874,11244
172208,201701,184,115,69,107755,64653,172408
172210,201701,504,230,274,215510,256457,471967
210005,201701,2928,1808,1120,1691097.96,1046911,2738008.96
210010,201701,204,98,106,91826,99322,191148
210015,201701,23,15,8,14055,7496,21551
210020,201701,330,169,161,158353,150857,309210
210030,201701,347,210,137,196770,128360,325130
210040,201701,158,122,36,114314,33732,148046
210043,201701,249,161,88,150857,82456,233313
210047,201701,635,305,330,285410.2,309200.63,594610.83
210050,201701,307,227,80,212699,74960,287659
210055,201701,43,33,10,30921,9370,40291
210060,201701,576,431,145,403749.56,135865,539614.56
210070,201701,416,294,122,275478,114032.9,389510.9
210080,201701,99,91,8,85267,7496,92763
210083,201701,306,119,187,111503,175219,286722
210087,201701,52,33,19,30921,17803,48724
210090,201701,504,342,162,320454,151794,472248
210095,201701,509,345,164,323265,153668,476933
210100,201701,681,504,177,471920.05,164912.35,636832.40
210110,201701,158,83,75,77771,70275,148046
210120,201701,5649,4161,1488,3894192.17,1393294.32,5287486.49
210125,201701,216,110,106,103070,99322,202392
210130,201701,625,313,312,292344,292344,584688
210135,201701,35,20,15,18740,14055,32795
210140,201701,3913,3020,893,2826601.22,836570,3663171.22
210150,201701,348,216,132,202392,123511,325903
210160,201701,3300,2737,563,2561760.68,527250,3089010.68
210170,201701,1083,825,258,773025,241746,1014771
210173,201701,107,84,23,78708,21551,100259
210177,201701,513,238,275,223006,257675,480681
210180,201701,27,14,13,13118,12181,25299
210190,201701,393,242,151,226754,141487,368241
210193,201701,0,0,0,0,0,0
210197,201701,87,57,30,53409,28110,81519
210200,201701,638,492,146,461004,136802,597806
210203,201701,269,170,99,159290,92763,252053
210207,201701,379,283,96,265171,89952,355123
210210,201701,756,682,74,639034,69338,708372
210215,201701,73,62,11,58094,10307,68401
210220,201701,405,330,75,309210,70275,379485
210230,201701,309,219,90,205203,84330,289533
210232,201701,1530,920,610,861759,571570,1433329
210235,201701,153,117,36,109348,33732,143080
210237,201701,44,24,20,22488,18740,41228
210240,201701,93,75,18,70275,16866,87141
210250,201701,173,132,41,123684,38417,162101
210255,201701,290,211,79,197707,74023,271730
210260,201701,445,254,191,237998,178967,416965
210270,201701,736,447,289,418839,270793,689632
210275,201701,37,29,8,27173,7496,34669
210280,201701,1015,634,381,590756.64,355685.25,946441.89
210290,201701,491,299,192,280163,179904,460067
210300,201701,6274,3523,2751,3295712,2576498.37,5872210.37
210310,201701,100,67,33,62779,30921,93700
210312,201701,128,77,51,72149,47787,119936
210315,201701,115,80,35,74960,32795,107755
210317,201701,119,80,39,74960,36543,111503
210320,201701,2369,1911,458,1789865,428209,2218074
210325,201701,128,88,40,81519,37199,118718
210330,201701,6041,2888,3153,2702856.7,2954351.63,5657208.33
210340,201701,1473,1026,447,961362,418768.85,1380130.85
210350,201701,595,472,123,442029.75,115251,557280.75
210355,201701,122,94,28,88078,26236,114314
210360,201701,2764,1679,1085,1570132.9,1016645,2586777.9
210370,201701,1227,482,745,451634,697409.1,1149043.1
210375,201701,193,99,94,91948,88078,180026
210380,201701,656,506,150,474122,140530,614652
210390,201701,193,159,34,148983,31858,180841
210400,201701,479,392,87,367304,81519,448823
210405,201701,959,620,339,580346.87,317643,897989.87
210407,201701,56,43,13,40291,12181,52472
210408,201701,69,62,7,58094,6559,64653
210409,201701,313,257,56,240809,52472,293281
210410,201701,435,327,108,306399,101187,407586
210420,201701,196,158,38,148046,35606,183652
210430,201701,34,26,8,24362,7496,31858
210440,201701,446,252,194,236124,180841,416965
210450,201701,157,114,43,106818,40291,147109
210455,201701,194,101,93,94637,87141,181778
210460,201701,344,215,129,201455,120873,322328
210462,201701,52,43,9,40291,8433,48724
210465,201701,190,130,60,121810,56220,178030
210467,201701,497,350,147,327950,137739,465689
210470,201701,39,27,12,25299,11244,36543
210480,201701,1255,869,386,814253,361682,1175935
210490,201701,221,128,93,119936,87141,207077
210500,201701,539,281,258,263297,241746,505043
210510,201701,541,411,130,385107,121810,506917
210515,201701,458,228,230,213636,215510,429146
210520,201701,393,340,53,318298.9,49661,367959.9
210530,201701,9145,4872,4273,4550451.79,3998742.8,8549194.59
210535,201701,145,99,46,92763,43102,135865
210540,201701,1540,884,656,826903.4,613266.5,1440169.9
210542,201701,1126,580,546,542945.2,511602,1054547.2
210545,201701,12,11,1,10307,937,11244
210547,201701,135,115,20,107755,18740,126495
210550,201701,764,519,245,485231.9,229283.9,714515.8
210560,201701,173,142,31,133054,29047,162101
210565,201701,31,21,10,19677,9370,29047
210570,201701,1322,1009,313,945433,293271.63,1238704.63
210580,201701,102,87,15,81519,14055,95574
210590,201701,793,597,196,558639.4,183652,742291.4
210592,201701,35,30,5,28110,4685,32795
210594,201701,93,79,14,74023,13118,87141
210596,201701,72,61,11,57157,10307,67464
210598,201701,122,87,35,81519,32795,114314
210600,201701,354,296,58,277352,54346,331698
210610,201701,243,225,18,209888,16866,226754
210620,201701,48,27,21,25299,19677,44976
210630,201701,58,53,5,49661,4685,54346
210632,201701,1159,721,438,675577,409656.4,1085233.4
210635,201701,14,12,2,11244,1874,13118
210637,201701,102,72,30,67464,28110,95574
210640,201701,578,489,89,458193,83393,541586
210650,201701,398,318,80,297778.6,74023,371801.6
210660,201701,404,282,122,264234,114314,378548
210663,201701,14,9,5,8433,4685,13118
210667,201701,121,36,85,33732,79645,113377
210670,201701,263,234,29,218556,27173,245729
210675,201701,578,288,290,269856,271730,541586
210680,201701,220,130,90,121810,84330,206140
210690,201701,641,495,146,463815,136802,600617
210700,201701,190,136,54,127432,50598,178030
210710,201701,311,170,141,159290,132117,291407
210720,201701,116,95,21,89015,19677,108692
210725,201701,59,53,6,49661,5622,55283
210730,201701,23,17,6,15929,5622,21551
210735,201701,401,254,147,237998,137458,375456
210740,201701,541,453,88,424461,82456,506917
210745,201701,149,102,47,95574,44039,139613
210750,201701,2421,1025,1396,959362,1308052,2267414
210760,201701,289,196,93,183652,87126.95,270778.95
210770,201701,404,310,94,289533,87796.9,377329.9
210780,201701,423,299,124,280163,115251.45,395414.45
210790,201701,187,141,46,132117,43102,175219
210800,201701,122,91,31,85267,29047,114314
210805,201701,37,34,3,31858,2811,34669
210810,201701,492,361,131,337601.1,122747,460348.1
210820,201701,2333,1787,546,1666166.39,511602,2177768.39
210825,201701,180,88,92,82456,86204,168660
210830,201701,836,487,349,455382,326076,781458
210840,201701,214,138,76,129306,71212,200518
210845,201701,259,147,112,137739,104944,242683
210850,201701,911,565,346,529092.7,324202,853294.7
210860,201701,4235,2060,2175,1929283,2037954.89,3967237.89
210870,201701,466,337,129,315769,120873,436642
210880,201701,51,34,17,31858,15929,47787
210890,201701,348,284,64,266108,59968,326076
210900,201701,501,304,197,284848,184589,469437
210905,201701,80,34,46,31858,43102,74960
210910,201701,2006,1448,558,1355779.1,522846,1878625.1
210920,201701,264,73,191,68401,178967,247368
210923,201701,73,56,17,52472,15929,68401
210927,201701,448,164,284,153668,266108,419776
210930,201701,57,43,14,40291,13118,53409
210940,201701,97,70,27,65590,25299,90889
210945,201701,202,86,116,80582,108692,189274
210950,201701,511,361,150,338257,140545.32,478802.32
210955,201701,77,50,27,46850,25299,72149
210960,201701,2493,975,1518,911982.7,1421348,2333330.7
210970,201701,111,93,18,87141,16866,104007
210975,201701,79,71,8,66527,7496,74023
210980,201701,1322,534,788,500245.56,738075,1238320.56
210990,201701,4501,2687,1814,2517438,1699698,4217136
211000,201701,1407,1073,334,1005100,312676.9,1317776.9
211003,201701,922,617,305,578129,285776,863905
211010,201701,483,419,64,392603,59968,452571
211020,201701,1657,549,1108,514413,1038196,1552609
211023,201701,20,17,3,15647.9,2811,18458.9
211027,201701,57,37,20,34669,18740,53409
211030,201701,392,248,144,232376,134928,367304
211040,201701,313,228,85,213354.9,79645,292999.9
211050,201701,1189,718,471,672766,441041.32,1113807.32
211060,201701,684,576,108,539712,101196,640908
211065,201701,24,20,4,18740,3748,22488
211070,201701,909,725,184,678678.97,172408,851086.97
211080,201701,90,85,5,79645,4685,84330
211085,201701,61,32,29,29703,27173,56876
211090,201701,97,78,19,73086,17803,90889
211100,201701,527,413,114,386981,106818,493799
211102,201701,274,170,104,159290,97448,256738
211105,201701,208,137,71,128369,66527,194896
211107,201701,115,64,51,59968,47787,107755
211110,201701,814,524,290,490426,271721,762147
211120,201701,5765,2184,3581,2043092.03,3353107.92,5396199.95
211125,201701,35,28,7,26236,6559,32795
211130,201701,46596,18495,28101,17300995.48,26317877.95,43618873.43
211140,201701,456,374,82,350434,76553,426987
211150,201701,1240,748,492,700876,461000,1161876
211153,201701,185,101,84,94637,78708,173345
211157,201701,52,37,15,34669,14055,48724
211160,201701,684,552,132,516275.25,123684,639959.25
211163,201701,0,0,0,0,0,0
211167,201701,6,5,1,4685,937,5622
211170,201701,442,296,146,277352,136802,414154
211172,201701,119,75,44,70275,41228,111503
211174,201701,295,167,128,156479,119936,276415
211176,201701,528,365,163,342005,152731,494736
211178,201701,93,61,32,57157,29984,87141
211180,201701,214,163,51,152731,47627.71,200358.71
211190,201701,57,54,3,50598,2811,53409
211195,201701,18,10,8,9370,7496,16866
211200,201701,146,127,19,118661.68,17803,136464.68
211210,201701,663,313,350,292625.1,327950,620575.1
211220,201701,3849,2138,1711,1997872.71,1595815.22,3593687.93
211223,201701,93,86,7,80403.97,6559,86962.97
211227,201701,69,44,25,41228,23425,64653
211230,201701,802,642,160,601413.45,149901.26,751314.71
211240,201701,418,299,119,280163,111503,391666
211245,201701,208,83,125,77771,117125,194896
211250,201701,1666,1400,266,1310954,249242,1560196
211260,201701,811,622,189,582814,177093,759907
211270,201701,2152,1642,510,1538554,476933.1,2015487.1
211280,201701,1857,1066,791,996969.08,741167,1738136.08
211285,201701,226,123,103,115251,96229.9,211480.9
211290,201701,697,448,249,419588.6,233313,652901.6
211300,201701,819,608,211,569441.7,197707,767148.7
211400,201701,1676,898,778,841426,728986,1570412
220005,201701,19,18,1,16866,937,17803
220010,201701,91,69,22,64653,20332.9,84985.9
220020,201701,509,398,111,372926,104007,476933
220025,201701,107,103,4,96511,3748,100259
220027,201701,40,32,8,29984,7496,37480
220030,201701,86,70,16,65590,14992,80582
220040,201701,1058,789,269,738356,252053,990409
220045,201701,34,27,7,25299,6559,31858
220050,201701,637,513,124,479539.88,116169.26,595709.14
220060,201701,171,143,28,133991,26236,160227
220070,201701,131,120,11,112440,10307,122747
220080,201701,4,3,1,2811,937,3748
220090,201701,33,25,8,23144,7496,30640
220095,201701,3,2,1,1874,937,2811
220100,201701,26,22,4,20614,3748,24362
220105,201701,39,36,3,33732,2811,36543
220110,201701,201,186,15,174000.9,14055,188055.9
220115,201701,37,34,3,31858,2811,34669
220117,201701,17,17,0,15929,0,15929
220120,201701,1507,1001,506,938087.85,474122,1412209.85
220130,201701,23,22,1,20614,937,21551
220140,201701,105,85,20,78426.9,18740,97166.9
220150,201701,429,298,131,279226,122747,401973
220155,201701,4,4,0,3748,0,3748
220157,201701,20,16,4,14992,3748,18740
220160,201701,67,59,8,55283,7496,62779
220170,201701,31,29,2,27173,1874,29047
220173,201701,8,8,0,7496,0,7496
220177,201701,5,5,0,4685,0,4685
220180,201701,66,65,1,60896.32,937,61833.32
220190,201701,1024,923,101,864851,93887.4,958738.4
220191,201701,45,41,4,38417,3748,42165
220192,201701,65,62,3,58094,2811,60905
220194,201701,19,16,3,14992,2811,17803
220196,201701,105,88,17,82316,15929,98245
220198,201701,6,4,2,3748,1874,5622
220200,201701,424,339,85,318364,79645,398009
220202,201701,35,31,4,29047,3748,32795
220205,201701,36,30,6,28110,5622,33732
220207,201701,16,15,1,14055,937,14992
220208,201701,81,40,41,37480,38417,75897
220209,201701,33,30,3,28110,2811,30921
220210,201701,18,17,1,15929,937,16866
220211,201701,46,45,1,42165,937,43102
220213,201701,43,38,5,35606,4685,40291
220217,201701,38,30,8,28110,7496,35606
220220,201701,1922,1238,684,1156324.49,639671.76,1795996.25
220225,201701,13,6,7,5622,6559,12181
220230,201701,892,710,182,664829.61,169906.21,834735.82
220240,201701,139,126,13,118062,12181,130243
220245,201701,49,47,2,43661,1874,45535
220250,201701,135,119,16,111503,14992,126495
220253,201701,39,29,10,27173,9370,36543
220255,201701,28,24,4,22488,3748,26236
220260,201701,687,502,185,470374,173345,643719
220265,201701,13,10,3,9370,2811,12181
220270,201701,597,525,72,491212.88,66995.5,558208.38
220271,201701,43,32,11,29984,10307,40291
220272,201701,24,23,1,21551,937,22488
220273,201701,16,13,3,12181,2811,14992
220275,201701,45,36,9,33732,8433,42165
220277,201701,7,7,0,6559,0,6559
220280,201701,20,18,2,16866,1874,18740
220285,201701,55,50,5,46850,4685,51535
220290,201701,1369,1163,206,1087249,192976,1280225
220300,201701,58,56,2,52472,1874,54346
220310,201701,302,253,49,236919.27,45904,282823.27
220320,201701,436,403,33,376206.5,30921,407127.5
220323,201701,0,0,0,0,0,0
220325,201701,15,10,5,9370,4685,14055
220327,201701,11,10,1,9370,937,10307
220330,201701,174,115,59,107473.9,55283,162756.9
220335,201701,135,119,16,111503,14992,126495
220340,201701,45,33,12,30921,11244,42165
220342,201701,49,43,6,40291,5622,45913
220345,201701,117,103,14,96511,13118,109629
220350,201701,434,384,50,357232.01,46850,404082.01
220360,201701,36,29,7,27173,6559,33732
220370,201701,1008,798,210,746976.4,196770,943746.4
220375,201701,24,23,1,21551,937,22488
220380,201701,33,25,8,23425,7496,30921
220385,201701,28,23,5,21551,4685,26236
220390,201701,2160,1242,918,1159144.2,857871.41,2017015.61
220400,201701,26,25,1,23425,937,24362
220410,201701,16,14,2,13118,1874,14992
220415,201701,13,12,1,11244,937,12181
220420,201701,129,106,23,99322,21270,120592
220430,201701,125,113,12,104242.4,11244,115486.4
220435,201701,27,20,7,18740,6559,25299
220440,201701,298,257,41,240809,38417,279226
220450,201701,303,161,142,149712.74,133054,282766.74
220455,201701,58,56,2,52472,1874,54346
220460,201701,23,20,3,18084.1,2811,20895.1
220465,201701,96,60,36,56220,33732,89952
220470,201701,235,204,31,190211.8,29047,219258.8
220480,201701,71,59,12,55283,11244,66527
220490,201701,82,71,11,65770,10307,76077
220500,201701,96,83,13,77771,12181,89952
220510,201701,372,300,72,280351,67276.6,347627.6
220515,201701,20,16,4,14992,3748,18740
220520,201701,350,312,38,290942,35588,326530
220525,201701,27,19,8,17803,7496,25299
220527,201701,38,32,6,29188,5622,34810
220530,201701,34,14,20,13118,18740,31858
220535,201701,13,11,2,10307,1874,12181
220540,201701,49,36,13,33732,12181,45913
220545,201701,69,45,24,42165,22488,64653
220550,201701,601,453,148,424461,138676,563137
220551,201701,26,20,6,18740,5622,24362
220552,201701,8,8,0,7496,0,7496
220553,201701,65,59,6,55283,5622,60905
220554,201701,15,9,6,8151.9,5622,13773.9
220555,201701,26,22,4,20614,3748,24362
220556,201701,62,58,4,54346,3748,58094
220557,201701,52,47,5,44039,4685,48724
220558,201701,7,2,5,1874,4685,6559
220559,201701,6,5,1,4685,937,5622
220560,201701,51,34,17,31670.6,15929,47599.6
220570,201701,736,429,307,401727.14,287659,689386.14
220580,201701,599,540,59,505980,54328.26,560308.26
220585,201701,5,4,1,3748,937,4685
220590,201701,15,15,0,14055,0,14055
220595,201701,59,44,15,41228,14055,55283
220600,201701,21,11,10,10307,9370,19677
220605,201701,19,18,1,16866,937,17803
220610,201701,54,47,7,44039,6559,50598
220620,201701,540,413,127,385810.04,118999,504809.04
220630,201701,8,6,2,5622,1874,7496
220635,201701,34,29,5,27173,4685,31858
220640,201701,97,71,26,66527,24362,90889
220650,201701,112,106,6,99322,5622,104944
220660,201701,25,19,6,17803,5622,23425
220665,201701,5,4,1,3748,937,4685
220667,201701,10,10,0,9370,0,9370
220669,201701,17,16,1,14992,937,15929
220670,201701,62,49,13,45725.6,12181,57906.6
220672,201701,45,29,16,27173,14710.9,41883.9
220675,201701,34,26,8,24362,7496,31858
220680,201701,33,30,3,28110,2811,30921
220690,201701,49,44,5,41228,4685,45913
220695,201701,69,31,38,29047,35606,64653
220700,201701,1396,1060,336,991177.59,314551,1305728.59
220710,201701,3,2,1,1874,937,2811
220720,201701,120,96,24,89717.75,22347.45,112065.20
220730,201701,20,20,0,18740,0,18740
220735,201701,3,1,2,937,1874,2811
220740,201701,38,36,2,33732,1874,35606
220750,201701,95,76,19,71212,17803,89015
220755,201701,16,16,0,14992,0,14992
220760,201701,43,40,3,37480,2811,40291
220770,201701,5466,2658,2808,2484772.52,2625349.18,5110121.70
220775,201701,29,14,15,13118,14055,27173
220777,201701,11,11,0,10307,0,10307
220779,201701,15,11,4,10307,3748,14055
220780,201701,819,696,123,651496.1,114970,766466.1
220785,201701,4,3,1,2811,937,3748
220790,201701,963,762,201,711653.34,188337,899990.34
220793,201701,15,15,0,14055,0,14055
220795,201701,26,25,1,23425,937,24362
220800,201701,3671,2777,894,2600171.56,836727.74,3436899.30
220810,201701,50,46,4,43102,3748,46850
220820,201701,229,207,22,193678,20614,214292
220830,201701,1092,913,179,855476.32,167723,1023199.32
220840,201701,2300,1499,801,1395337.03,748195,2143532.03
220850,201701,51,38,13,35606,12181,47787
220855,201701,15,10,5,9370,4685,14055
220860,201701,17,15,2,14055,1874,15929
220865,201701,21,19,2,17803,1874,19677
220870,201701,59,54,5,50598,4663.12,55261.12
220880,201701,337,255,82,238279.1,76553,314832.1
220885,201701,45,40,5,37480,4685,42165
220887,201701,20,19,1,17803,937,18740
220890,201701,106,93,13,87141,12181,99322
220900,201701,42,25,17,23425,15929,39354
220910,201701,53,44,9,41228,8433,49661
220915,201701,20,19,1,17803,937,18740
220920,201701,38,35,3,32795,2811,35606
220930,201701,39,38,1,34806.73,937,35743.73
220935,201701,20,19,1,17803,937,18740
220937,201701,42,40,2,37480,1874,39354
220940,201701,49,44,5,41228,4685,45913
220945,201701,0,0,0,0,0,0
220950,201701,46,43,3,40291,2811,43102
220955,201701,38,36,2,33732,1874,35606
220960,201701,6,6,0,5622,0,5622
220965,201701,25,21,4,19677,3748,23425
220970,201701,45,37,8,34669,7496,42165
220975,201701,9,8,1,7496,937,8433
220980,201701,39,35,4,32795,3748,36543
220985,201701,56,51,5,47787,4685,52472
220987,201701,31,29,2,27173,1874,29047
220990,201701,11,9,2,8433,1874,10307
220995,201701,38,33,5,30921,4685,35606
220997,201701,29,23,6,21551,5622,27173
221000,201701,1037,929,108,867103.81,100914.9,968018.71
221005,201701,61,56,5,52472,4685,57157
221010,201701,17,13,4,12181,3748,15929
221020,201701,51,49,2,45913,1874,47787
221030,201701,34,27,7,25299,6559,31858
221035,201701,17,16,1,14992,937,15929
221037,201701,11,7,4,6559,3748,10307
221038,201701,7,6,1,5622,937,6559
221039,201701,20,20,0,18740,0,18740
221040,201701,237,205,32,192085,29984,222069
221050,201701,227,190,37,178030,34669,212699
221060,201701,1406,1229,177,1151573,165849,1317422
221062,201701,27,26,1,24362,937,25299
221063,201701,15,11,4,10307,3748,14055
221065,201701,35,31,4,29047,3748,32795
221070,201701,152,130,22,121810,20614,142424
221080,201701,363,317,46,297029,42820.9,339849.9
221090,201701,40,39,1,36291,937,37228
221093,201701,72,49,23,45913,21551,67464
221095,201701,13,12,1,11244,937,12181
221097,201701,26,23,3,21551,2811,24362
221100,201701,23431,13311,10120,12452403.52,9478675.79,21931079.31
221110,201701,988,717,271,671528,253927,925455
221120,201701,488,358,130,335165,121810,456975
221130,201701,885,719,166,672176.69,154887,827063.69
221135,201701,30,27,3,25299,2811,28110
221140,201701,37,29,8,27173,7496,34669
221150,201701,16,12,4,11244,3748,14992
221160,201701,10,10,0,9370,0,9370
221170,201701,10,10,0,9370,0,9370
230010,201701,162,148,14,138676,13118,151794
230015,201701,109,91,18,85267,16866,102133
230020,201701,1443,1244,199,1162912,185800.08,1348712.08
230030,201701,1531,1095,436,1020545.92,408532,1429077.92
230040,201701,193,173,20,161164,18740,179904
230050,201701,183,138,45,129306,42165,171471
230060,201701,124,100,24,92950.4,22488,115438.4
230070,201701,273,241,32,225817,29984,255801
230075,201701,767,668,99,623481.5,91779.9,715261.4
230080,201701,169,151,18,141487,16866,158353
230090,201701,79,56,23,52472,21551,74023
230100,201701,1802,1070,732,1000344,685603,1685947
230110,201701,2556,1595,961,1491217.6,899894.9,2391112.5
230120,201701,883,697,186,650746.91,174282,825028.91
230125,201701,128,103,25,96511,23143.9,119654.9
230130,201701,427,382,45,357934,42165,400099
230140,201701,209,182,27,170534,25299,195833
230150,201701,152,117,35,109629,32795,142424
230160,201701,912,802,110,750771.5,103070,853841.5
230170,201701,705,630,75,586564.35,70275,656839.35
230180,201701,78,74,4,69338,3748,73086
230185,201701,387,331,56,308806.16,52472,361278.16
230190,201701,2090,1678,412,1568748.69,385732,1954480.69
230195,201701,484,421,63,393821.1,59031,452852.1
230200,201701,489,422,67,394467.63,62114,456581.63
230205,201701,329,206,123,191002.96,114969.9,305972.86
230210,201701,1235,983,252,920145.18,235374.4,1155519.58
230220,201701,1297,901,396,844237,371052,1215289
230230,201701,872,770,102,718929.85,95574,814503.85
230240,201701,1574,1348,226,1261421.96,211340.45,1472762.41
230250,201701,1681,1367,314,1276614.47,293656,1570270.47
230260,201701,2781,1629,1152,1521554.79,1078487.75,2600042.54
230270,201701,1308,1055,253,986399.23,234532.3,1220931.53
230280,201701,2564,1903,661,1778428.8,619357,2397785.8
230290,201701,386,348,38,319905.92,35606,355511.92
230300,201701,507,367,140,342642.16,131180,473822.16
230310,201701,392,302,90,282974,84330,367304
230320,201701,838,715,123,666886.17,115242,782128.17
230330,201701,286,231,55,215697.4,51535,267232.4
230340,201701,452,360,92,335634.4,86204,421838.4
230350,201701,2835,1775,1060,1663137.52,990410.24,2653547.76
230360,201701,241,212,29,197750,27173,224923
230365,201701,167,133,34,123919,31858,155777
230370,201701,9096,4306,4790,4025097.39,4481998.87,8507096.26
230380,201701,446,382,64,357653,59031.8,416684.8
230390,201701,488,264,224,245597.07,209888,455485.07
230393,201701,274,229,45,213733.4,42165,255898.4
230395,201701,315,260,55,243377,51535,294912
230400,201701,672,524,148,488739.9,138188.76,626928.66
230410,201701,2442,1500,942,1401612.55,881904.6,2283517.15
230420,201701,5421,3504,1917,3265404.19,1791725.32,5057129.51
230423,201701,295,254,41,236124.8,38417,274541.8
230425,201701,311,260,51,243620,47787,291407
230426,201701,101,91,10,84554.88,9088.9,93643.78
230427,201701,78,75,3,70275,2811,73086
230428,201701,1285,657,628,615103.02,588436,1203539.02
230430,201701,700,574,126,537365.9,117298.34,654664.24
230435,201701,709,490,219,457796.09,203985.17,661781.26
230440,201701,79625,34735,44890,32470208.45,42025466.02,74495674.47
230445,201701,242,166,76,155542,71212,226754
230450,201701,385,318,67,297966,62779,360745
230460,201701,52,45,7,42165,6559,48724
230465,201701,284,228,56,213636,52472,266108
230470,201701,1757,1357,400,1271509,373712.59,1645221.59
230480,201701,137,134,3,125276.9,2811,128087.9
230490,201701,262,211,51,197707,47787,245494
230495,201701,407,306,101,285885,94637,380522
230500,201701,905,669,236,624979,221123,846102
230510,201701,39,31,8,29047,7496,36543
230520,201701,384,303,81,283911,75897,359808
230523,201701,1726,1137,589,1064619.4,551172,1615791.4
230526,201701,287,242,45,226754,42165,268919
230530,201701,461,357,104,332635.9,96511.6,429147.5
230533,201701,166,161,5,150857,4685,155542
230535,201701,331,244,87,228628,81519,310147
230540,201701,1781,1569,212,1467554.7,198363,1665917.7
230550,201701,3507,2213,1294,2066556.5,1211634.7,3278191.2
230560,201701,574,441,133,411156.4,123684,534840.4
230565,201701,170,121,49,113377,45913,159290
230570,201701,300,267,33,250179,30921,281100
230580,201701,1056,779,277,728489.39,258049.9,986539.29
230590,201701,880,682,198,635521.05,184963.8,820484.85
230600,201701,236,218,18,202598.32,16866,219464.32
230610,201701,321,256,65,239685,60905,300590
230620,201701,155,126,29,117125,27173,144298
230625,201701,702,508,194,474638.25,180645.04,655283.29
230630,201701,1211,949,262,889213,245119.2,1134332.2
230640,201701,3244,2826,418,2642197.47,391666,3033863.47
230650,201701,384,339,45,316826.49,41509.1,358335.59
230655,201701,582,509,73,476933,68392,545325
230660,201701,308,253,55,237061,51535,288596
230670,201701,412,372,40,348564,37480,386044
230680,201701,194,179,15,167723,14055,181778
230690,201701,814,710,104,665270,97448,762718
230700,201701,683,582,101,545334,93793.7,639127.7
230710,201701,700,656,44,614485,41228,655713
230720,201701,127,108,19,100999.23,17803,118802.23
230725,201701,205,162,43,151794,40282,192076
230730,201701,10963,5932,5031,5540436.89,4705085.96,10245522.85
230740,201701,629,499,130,467282,121131.63,588413.63
230750,201701,617,525,92,490754.15,86204,576958.15
230760,201701,1155,996,159,928997.49,148983,1077980.49
230763,201701,331,274,57,254817.41,53409,308226.41
230765,201701,6360,2942,3418,2749888.05,3199481.7,5949369.75
230770,201701,4758,2450,2308,2285231.89,2159373.14,4444605.03
230780,201701,659,582,77,543367,72149,615516
230790,201701,172,140,32,131180,29197.66,160377.66
230800,201701,919,664,255,622163.32,238935,861098.32
230810,201701,1208,1072,136,1003199.05,127432,1130631.05
230820,201701,303,216,87,201456,81519,282975
230830,201701,783,689,94,642925.02,88078,731003.02
230835,201701,262,229,33,213636,30219,243855
230837,201701,158,133,25,124621,23425,148046
230840,201701,848,678,170,634068.5,158072,792140.5
230850,201701,1418,1248,170,1169094.9,159009,1328103.9
230860,201701,306,222,84,208014,77771.25,285785.25
230870,201701,1710,1450,260,1357432,242294.35,1599726.35
230880,201701,76,60,16,56220,14992,71212
230890,201701,568,528,40,494080.1,37480,531560.1
230900,201701,251,195,56,182715,52279,234994
230910,201701,187,151,36,140737.4,33732,174469.4
230920,201701,358,282,76,264234,71212,335446
230930,201701,866,618,248,576255.92,232376,808631.92
230940,201701,806,649,157,608113,146922,755035
230945,201701,430,363,67,339944,62779,402723
230950,201701,375,311,64,291407,59968,351375
230960,201701,2282,1508,774,1406115.67,724957,2131072.67
230970,201701,1586,895,691,837719.45,646604.96,1484324.41
230980,201701,196,163,33,152731,30921,183652
230990,201701,139,113,26,105881,23618.95,129499.95
231000,201701,187,172,15,159290.74,14055,173345.74
231010,201701,133,104,29,97448,27173,124621
231020,201701,1152,807,345,754566.5,323245,1077811.5
231025,201701,875,652,223,608797.6,207715,816512.6
231030,201701,1135,948,187,888272,174938,1063210
231040,201701,128,89,39,82662.14,35825,118487.14
231050,201701,996,884,112,826435.5,104944,931379.5
231060,201701,131,115,16,107755,14992,122747
231070,201701,1343,958,385,895772.95,360464,1256236.95
231080,201701,247,231,16,216447,14992,231439
231085,201701,482,303,179,282975,167723,450698
231090,201701,220,186,34,174282,31858,206140
231095,201701,156,126,30,118062,28110,146172
231100,201701,113,91,22,85267,19395.9,104662.9
231110,201701,313,267,46,248684.39,43102,291786.39
231120,201701,290,250,40,233299.88,37293,270592.88
231123,201701,131,123,8,115251,7496,122747
231126,201701,261,224,37,209888,34669,244557
231130,201701,4391,3415,976,3192018.08,913912.42,4105930.50
231135,201701,179,154,25,144298,22183.2,166481.2
231140,201701,2954,2168,786,2027850.79,734689.98,2762540.77
231150,201701,331,317,14,297029,13118,310147
231160,201701,1167,918,249,856887.25,233088.12,1089975.37
231170,201701,589,378,211,353745.61,197707,551452.61
231180,201701,1441,1202,239,1125384.4,223943,1349327.4
231190,201701,207,184,23,172408,21551,193959
231195,201701,201,174,27,162326.91,25299,187625.91
231200,201701,930,761,169,713057,157115,870172
231210,201701,578,481,97,450697,90889,541586
231220,201701,970,699,271,654027,253927,907954
231230,201701,1305,1056,249,987169.3,233031.9,1220201.2
231240,201701,1216,883,333,827089.9,310803.1,1137893.0
231250,201701,102,95,7,89015,6559,95574
231260,201701,296,187,109,174937.9,101852,276789.9
231270,201701,957,797,160,742449.49,149911,892360.49
231280,201701,45,37,8,34669,7496,42165
231290,201701,6991,3836,3155,3584720.47,2953941.05,6538661.52
231300,201701,610,563,47,527531,44039,571570
231310,201701,674,629,45,588178,42160.32,630338.32
231320,201701,523,403,120,377144,112440,489584
231325,201701,83,73,10,68401,9370,77771
231330,201701,1953,1509,444,1408456.19,413406.3,1821862.49
231335,201701,250,216,34,202392,31858,234250
231340,201701,1478,1090,388,1020206.24,363556,1383762.24
231350,201701,1072,876,196,820344,182808.8,1003152.8
231355,201701,368,319,49,298776.51,45913,344689.51
231360,201701,643,496,147,461004.58,137735,598739.58
231370,201701,82,65,17,60905,15929,76834
231375,201701,264,196,68,183652,63716,247368
231380,201701,407,338,69,315139.36,64465.6,379604.96
231390,201701,188,154,34,144298,31858,176156
231395,201701,659,401,258,374903.07,241746,616649.07
231400,201701,761,613,148,573014.55,138338.9,711353.45
231410,201701,1246,989,257,921213.8,240809,1162022.8
240010,201701,386,185,201,172135.54,188142,360277.54
240020,201701,2060,1555,505,1455589.07,473185,1928774.07
240030,201701,172,140,32,131180,29984,161164
240040,201701,29,29,0,27173,0,27173
240050,201701,483,412,71,384456.06,66527,450983.06
240060,201701,67,62,5,58094,4685,62779
240070,201701,138,108,30,101196,28110,129306
240080,201701,368,230,138,215506,129306,344812
240090,201701,103,91,12,84968,11244,96212
240100,201701,1385,1308,77,1222676.18,71941.49,1294617.67
240110,201701,921,568,353,531251.66,330761,862012.66
240120,201701,136,114,22,106818,20614,127432
240130,201701,284,265,19,247605.99,17803,265408.99
240140,201701,84,64,20,59968,18740,78708
240145,201701,625,545,80,510149.65,74753.86,584903.51
240150,201701,19,16,3,14992,2796.95,17788.95
240160,201701,51,42,9,39354,8433,47787
240165,201701,34,31,3,28813,2811,31624
240170,201701,83,64,19,59968,17803,77771
240180,201701,68,54,14,50598,13118,63716
240185,201701,38,35,3,32785.63,2811,35596.63
240190,201701,19,17,2,15929,1874,17803
240200,201701,2877,1608,1269,1502627.7,1186992.7,2689620.4
240210,201701,149,117,32,109629,29984,139613
240220,201701,1108,796,312,745852,292334.63,1038186.63
240230,201701,800,739,61,689659.68,56520,746179.68
240240,201701,138,97,41,90889,38417,129306
240250,201701,90,79,11,74023,10307,84330
240260,201701,1736,1281,455,1199622.36,425183.26,1624805.62
240270,201701,179,163,16,152356.2,14992,167348.2
240280,201701,46,34,12,31858,11244,43102
240290,201701,63,60,3,56220,2811,59031
240300,201701,167,98,69,91438,64653,156091
240310,201701,1830,1000,830,929229.66,774533.06,1703762.72
240320,201701,217,207,10,193959,9370,203329
240325,201701,3982,2423,1559,2261970.17,1458648.41,3720618.58
240330,201701,67,65,2,60905,1874,62779
240340,201701,89,63,26,59031,24362,83393
240350,201701,90,80,10,74960,9370,84330
240360,201701,319,230,89,215229,83393,298622
240370,201701,41,39,2,36543,1874,38417
240375,201701,78,47,31,44039,29047,73086
240380,201701,240,196,44,182755,41135,223890
240390,201701,20,17,3,15929,2811,18740
240400,201701,82,79,3,74023,2811,76834
240410,201701,7,5,2,4685,1874,6559
240420,201701,827,637,190,595559.07,177018.04,772577.11
240430,201701,250,236,14,219426.11,13118,232544.11
240440,201701,61,33,28,30921,26236,57157
240450,201701,168,108,60,100915,56220,157135
240460,201701,55,44,11,41228,10307,51535
240470,201701,224,190,34,177482.79,31858,209340.79
240480,201701,16,16,0,14992,0,14992
240485,201701,65,54,11,50707,10307,61014
240490,201701,49,49,0,45707,0,45707
240500,201701,86,70,16,65590,14992,80582
240510,201701,42,30,12,28110,11244,39354
240520,201701,138,132,6,123684,5622,129306
240530,201701,39,35,4,32795,3748,36543
240540,201701,78,67,11,62779,10297.63,73076.63
240550,201701,17,14,3,13118,2811,15929
240560,201701,360,262,98,244878.4,91826,336704.4
240570,201701,425,257,168,239684.6,157416,397100.6
240580,201701,1225,989,236,921541.2,219994.6,1141535.8
240590,201701,26,25,1,23425,937,24362
240600,201701,116,116,0,108692,0,108692
240610,201701,494,420,74,393259,68589,461848
240615,201701,43,41,2,38417,1874,40291
240620,201701,89,86,3,79645,2811,82456
240630,201701,41,38,3,35606,2811,38417
240640,201701,28,24,4,22488,3748,26236
240650,201701,216,184,32,171566,29984,201550
240660,201701,85,75,10,70275,9370,79645
240670,201701,272,158,114,145985.15,106818,252803.15
240680,201701,54,43,11,40291,10307,50598
240690,201701,49,46,3,43102,2811,45913
240700,201701,189,159,30,148983,28110,177093
240710,201701,1771,1117,654,1045974.3,611027.07,1657001.37
240720,201701,992,725,267,678379.23,250179,928558.23
240725,201701,65,62,3,58094,2811,60905
240730,201701,127,111,16,104007,14992,118999
240740,201701,228,190,38,176690.09,35606,212296.09
240750,201701,37,22,15,20614,14055,34669
240760,201701,35,30,5,28110,4685,32795
240770,201701,134,104,30,97448,28105.32,125553.32
240780,201701,694,578,116,539890.03,108692,648582.03
240790,201701,42,40,2,37480,1874,39354
240800,201701,8136,5493,2643,5112636.46,2469842.7,7582479.16
240810,201701,19210,10453,8757,9753782.86,8196265.93,17950048.79
240820,201701,174,111,63,103721.22,59031,162752.22
240830,201701,1522,1252,270,1168590.15,252054,1420644.15
240840,201701,75,63,12,59031,11244,70275
240850,201701,86,74,12,69338,11244,80582
240860,201701,115,113,2,105881,1874,107755
240870,201701,48,41,7,38417,6559,44976
240880,201701,26,25,1,23415.63,937,24352.63
240890,201701,1055,618,437,575320.85,408528,983848.85
240895,201701,45,34,11,31858,10307,42165
240910,201701,145,132,13,123684,12181,135865
240920,201701,16,12,4,11244,3748,14992
240930,201701,356,320,36,298903,33732,332635
240933,201701,17,12,5,11244,4685,15929
240940,201701,2392,2113,279,1969486.41,258594.36,2228080.77
240950,201701,49,48,1,44976,937,45913
240960,201701,34,26,8,24362,7496,31858
240970,201701,150,107,43,100259,39554,139813
240980,201701,165,131,34,122747,31858,154605
240990,201701,108,68,40,63716,37480,101196
241000,201701,82,73,9,68214,8433,76647
241010,201701,54,42,12,39354,11244,50598
241020,201701,118,109,9,102133,8433,110566
241025,201701,10,4,6,3748,5622,9370
241030,201701,118,95,23,89015,21551,110566
241040,201701,30,25,5,23425,4685,28110
241050,201701,95,82,13,76834,12181,89015
241060,201701,33,30,3,28110,2811,30921
241070,201701,19,19,0,17803,0,17803
241080,201701,65,57,8,53127.9,7496,60623.9
241090,201701,49,39,10,36543,9327.9,45870.9
241100,201701,75,67,8,62779,7496,70275
241105,201701,8,4,4,3748,3748,7496
241110,201701,52,48,4,44976,3748,48724
241120,201701,1357,1046,311,977947.4,290544.96,1268492.36
241140,201701,219,175,44,163039,41228,204267
241142,201701,43,42,1,39354,937,40291
241150,201701,1178,1038,140,969936.5,131134,1101070.5
241160,201701,24,22,2,20614,1874,22488
241170,201701,42,39,3,36543,2811,39354
241180,201701,49,39,10,36194.15,9370,45564.15
241190,201701,46,45,1,42165,937,43102
241200,201701,3609,1989,1620,1858030.76,1516709.64,3374740.40
241210,201701,71,57,14,53409,13118,66527
241220,201701,1304,860,444,805210.7,416009.26,1221219.96
241230,201701,226,188,38,175687.5,35606,211293.5
241240,201701,51,38,13,35606,12181,47787
241250,201701,1025,960,65,899520,60624,960144
241255,201701,39,33,6,30921,5622,36543
241260,201701,626,492,134,460907.32,125558,586465.32
241270,201701,44,30,14,28110,13118,41228
241280,201701,98,84,14,78708,13118,91826
241290,201701,101,74,27,69338,25299,94637
241300,201701,79,56,23,52472,21551,74023
241310,201701,52,41,11,38277,10307,48584
241320,201701,30,16,14,14616,13118,27734
241330,201701,57,52,5,48724,4685,53409
241335,201701,56,48,8,44976,7496,52472
241340,201701,179,135,44,126495,41228,167723
241350,201701,60,56,4,52472,3748,56220
241355,201701,41,38,3,35606,2811,38417
241360,201701,49,49,0,45913,0,45913
241370,201701,45,38,7,35606,6559,42165
241380,201701,44,42,2,39354,1874,41228
241390,201701,66,52,14,48536.6,13118,61654.6
241400,201701,187,152,35,141769,32795,174564
241410,201701,166,151,15,141487,14055,155542
241415,201701,89,70,19,65590,17803,83393
241420,201701,94,71,23,66527,21383,87910
241430,201701,32,31,1,29047,937,29984
241440,201701,431,363,68,340131,63716,403847
241445,201701,28,26,2,24362,1874,26236
241450,201701,278,225,53,210701,49661,260362
241460,201701,128,115,13,107521,12181,119702
241470,201701,44,36,8,33732,7496,41228
241475,201701,68,65,3,60905,2811,63716
241480,201701,86,61,25,57157,23425,80582
241490,201701,8,6,2,5622,1593,7215
241500,201701,52,38,14,35606,13118,48724
250010,201701,98,86,12,80582,11244,91826
250020,201701,21,18,3,16866,2811,19677
250030,201701,792,573,219,535580.1,203265.51,738845.61
250040,201701,329,274,55,256738,51535,308273
250050,201701,211,177,34,165849,31858,197707
250053,201701,54,42,12,39354,11244,50598
250057,201701,0,0,0,0,0,0
250060,201701,421,328,93,307336,87141,394477
250070,201701,667,578,89,539606,83393,622999
250073,201701,8,8,0,7496,0,7496
250077,201701,205,152,53,142040.6,49661,191701.6
250080,201701,418,322,96,300122.1,89952,390074.1
250090,201701,213,142,71,132117.2,65671.26,197788.46
250100,201701,447,363,84,340131,78334,418465
250110,201701,436,330,106,307458.6,99322,406780.6
250115,201701,29,8,21,7496,19677,27173
250120,201701,96,77,19,72149,17803,89952
250130,201701,579,457,122,428209,114127,542336
250135,201701,11,8,3,7496,2811,10307
250140,201701,70,64,6,59968,5622,65590
250150,201701,528,394,134,367706,125248.79,492954.79
250153,201701,11,10,1,9370,937,10307
250157,201701,26,21,5,19677,4685,24362
250160,201701,203,159,44,148983,41228,190211
250170,201701,69,48,21,44976,19677,64653
250180,201701,3780,2544,1236,2370796.94,1153368.35,3524165.29
250190,201701,924,595,329,555875.25,307570.25,863445.50
250200,201701,47,40,7,37480,6559,44039
250205,201701,15,13,2,12181,1874,14055
250210,201701,86,74,12,69338,11244,80582
250215,201701,59,51,8,47787,7496,55283
250220,201701,23,17,6,15929,5622,21551
250230,201701,67,62,5,58094,4685,62779
250240,201701,227,187,40,174422.55,37480,211902.55
250250,201701,388,331,57,310147,53409,363556
250260,201701,29,25,4,23425,3748,27173
250270,201701,53,42,11,39354,10307,49661
250280,201701,393,325,68,304525,63716,368241
250290,201701,83,77,6,71867.9,5622,77489.9
250300,201701,574,390,184,364794.24,172394.63,537188.87
250310,201701,42,36,6,33732,5622,39354
250320,201701,1801,1243,558,1158673.84,521628,1680301.84
250330,201701,76,65,11,60905,10307,71212
250340,201701,25,21,4,19677,3748,23425
250350,201701,126,79,47,74023,43476.8,117499.8
250355,201701,21,16,5,14992,4685,19677
250360,201701,197,160,37,149826.3,34435,184261.3
250370,201701,2284,1570,714,1465283.59,666552.71,2131836.30
250375,201701,22,18,4,16866,3748,20614
250380,201701,48,33,15,30921,14055,44976
250390,201701,32,26,6,24362,5622,29984
250400,201701,14751,7386,7365,6899097.84,6893400.92,13792498.76
250403,201701,386,319,67,298893.64,62779,361672.64
250407,201701,50,44,6,41228,5622,46850
250410,201701,27,23,4,21551,3748,25299
250415,201701,37,23,14,21551,13099.26,34650.26
250420,201701,46,37,9,34669,8433,43102
250430,201701,1427,1216,211,1137238,197707,1334945
250435,201701,15,12,3,11244,2811,14055
250440,201701,688,592,96,552091.19,89952,642043.19
250450,201701,84,71,13,66527,11525.1,78052.1
250460,201701,384,264,120,247368,112307.42,359675.42
250470,201701,89,65,24,60905,22488,83393
250480,201701,403,313,90,293281,84330,377611
250485,201701,2,1,1,937,937,1874
250490,201701,203,167,36,156479,33732,190211
250500,201701,73,53,20,49661,18740,68401
250510,201701,700,535,165,499046.8,153661.26,652708.06
250520,201701,175,117,58,109610.28,54341.32,163951.60
250523,201701,108,89,19,83393,17803,101196
250527,201701,105,79,26,74018.32,24362,98380.32
250530,201701,6,5,1,4685,937,5622
250535,201701,27,21,6,19677,5622,25299
250540,201701,119,88,31,81753.25,29047,110800.25
250550,201701,67,64,3,59968,2811,62779
250560,201701,35,29,6,27173,5622,32795
250570,201701,151,119,32,111503,29984,141487
250580,201701,142,110,32,102507.8,29984,132491.8
250590,201701,17,14,3,13118,2811,15929
250600,201701,1243,843,400,786894.64,374702.32,1161596.96
250610,201701,151,129,22,120873,20614,141487
250620,201701,19,15,4,14055,3748,17803
250625,201701,56,41,15,38417,14055,52472
250630,201701,2927,1871,1056,1746717.07,988145.28,2734862.35
250640,201701,199,169,30,158353,28110,186463
250650,201701,32,22,10,20614,9370,29984
250660,201701,35,30,5,28110,4685,32795
250670,201701,46,31,15,29047,14055,43102
250680,201701,385,312,73,292344,68401,360745
250690,201701,1686,1149,537,1073395.76,502794.9,1576190.66
250700,201701,923,803,120,748216.3,112440,860656.3
250710,201701,437,340,97,318580,90889,409469
250720,201701,97,77,20,72149,18740,90889
250730,201701,356,300,56,278290,52191,330481
250740,201701,44,40,4,37480,3748,41228
250750,201701,19264,11485,7779,10707891.92,7280431.55,17988323.47
250760,201701,60,48,12,44976,11244,56220
250770,201701,334,222,112,207077.31,103796.27,310873.58
250780,201701,51,40,11,37480,10307,47787
250790,201701,502,307,195,284848.76,182012.25,466861.01
250800,201701,145,132,13,122981.25,12181,135162.25
250810,201701,47,36,11,33732,10307,44039
250820,201701,152,121,31,113377,29047,142424
250830,201701,645,425,220,397522.25,206140,603662.25
250840,201701,50,47,3,44039,2811,46850
250850,201701,48,39,9,35868.36,8433,44301.36
250855,201701,15,13,2,11338,1874,13212
250860,201701,185,136,49,127432,45631.9,173063.9
250870,201701,31,28,3,26236,2811,29047
250880,201701,73,56,17,52425.15,15929,68354.15
250890,201701,2250,1649,601,1543801.2,562289.57,2106090.77
250900,201701,41,32,9,29984,8433,38417
250905,201701,129,98,31,91826,29047,120873
250910,201701,1147,811,336,758688.91,314550.9,1073239.81
250915,201701,105,73,32,68401,29984,98385
250920,201701,131,99,32,92763,29984,122747
250930,201701,144,93,51,87141,47787,134928
250933,201701,2,2,0,1874,0,1874
250937,201701,8,7,1,6559,937,7496
250939,201701,27,19,8,17803,7496,25299
250940,201701,105,76,29,71212,27173,98385
250950,201701,71,47,24,44039,22488,66527
250960,201701,86,46,40,43081.89,37480,80561.89
250970,201701,1166,814,352,760189,329542.9,1089731.9
250980,201701,86,60,26,56220,24362,80582
250990,201701,157,120,37,112004.35,34640.9,146645.25
251000,201701,73,67,6,62591.6,5622,68213.6
251010,201701,86,66,20,61842,17975.4,79817.4
251020,201701,74,64,10,59171.55,9370,68541.55
251030,201701,39,30,9,28110,8433,36543
251040,201701,50,34,16,31858,14992,46850
251050,201701,25,23,2,21551,1874,23425
251060,201701,45,35,10,31858,9370,41228
251065,201701,4,3,1,2811,937,3748
251070,201701,25,19,6,17794,5622,23416
251080,201701,4587,2210,2377,2057661.41,2221468.21,4279129.62
251090,201701,193,167,26,156479,24362,180841
251100,201701,16,16,0,14992,0,14992
251110,201701,40,32,8,29984,7496,37480
251120,201701,1717,1000,717,932031.2,671829,1603860.2
251130,201701,340,273,67,255801,62779,318580
251140,201701,477,304,173,283725,161935.34,445660.34
251150,201701,281,244,37,227870,34669,262539
251160,201701,90,70,20,65586,18740,84326
251170,201701,98,76,22,71183.92,20604.64,91788.56
251180,201701,279,173,106,162101,99313.32,261414.32
251190,201701,191,131,60,122424.68,56220,178644.68
251200,201701,244,195,49,182715,45913,228628
251203,201701,27,25,2,23425,1874,25299
251207,201701,90,74,16,69338,14992,84330
251210,201701,1376,978,398,914859.34,372270.1,1287129.44
251220,201701,44,35,9,32795,8433,41228
251230,201701,510,434,76,406638,71212,477850
251240,201701,103,72,31,66527,29047,95574
251250,201701,1269,903,366,844003.1,342802,1186805.1
251260,201701,12,7,5,6559,4685,11244
251270,201701,333,247,86,231439,80442,311881
251272,201701,71,64,7,59968,6559,66527
251274,201701,25,20,5,18740,4685,23425
251275,201701,20,14,6,13118,5622,18740
251276,201701,17,14,3,13118,2811,15929
251278,201701,9,7,2,6559,1874,8433
251280,201701,82,79,3,74023,2811,76834
251290,201701,691,520,171,487240,160223,647463
251300,201701,17,15,2,14055,1874,15929
251310,201701,344,245,99,229561,92763,322324
251315,201701,14,13,1,12181,937,13118
251320,201701,62,49,13,45913,12181,58094
251330,201701,74,66,8,61842,7496,69338
251335,201701,9,5,4,4685,3748,8433
251340,201701,670,399,271,373863,252920.63,626783.63
251350,201701,31,29,2,27173,1874,29047
251360,201701,62,54,8,50395.61,7496,57891.61
251365,201701,14,14,0,13118,0,13118
251370,201701,5010,3363,1647,3144959.5,1541928.5,4686888.0
251380,201701,52,39,13,36543,12181,48724
251385,201701,2,2,0,1874,0,1874
251390,201701,610,491,119,458943.6,110285,569228.6
251392,201701,22,16,6,14992,5622,20614
251394,201701,9,8,1,7496,937,8433
251396,201701,21,16,5,14992,4685,19677
251398,201701,18,16,2,14992,1874,16866
251400,201701,35,29,6,27173,5622,32795
251410,201701,33,28,5,26236,4685,30921
251420,201701,105,79,26,74023,24362,98385
251430,201701,35,33,2,30921,1874,32795
251440,201701,39,25,14,23416,13118,36534
251445,201701,41,35,6,32795,5622,38417
251450,201701,399,352,47,328198.4,44039,372237.4
251455,201701,2,1,1,937,937,1874
251460,201701,15,11,4,10307,3748,14055
251465,201701,5,2,3,1874,2811,4685
251470,201701,42,34,8,31858,7496,39354
251480,201701,24,22,2,20614,1874,22488
251490,201701,129,88,41,81988,37481,119469
251500,201701,109,90,19,84330,17054,101384
251510,201701,89,66,23,61842,21551,83393
251520,201701,22,22,0,20614,0,20614
251530,201701,4590,3196,1394,2989804.06,1305887.53,4295691.59
251540,201701,74,66,8,61842,7496,69338
251550,201701,423,321,102,299840.6,95340,395180.6
251560,201701,25,20,5,18740,4685,23425
251570,201701,18,18,0,16866,0,16866
251580,201701,110,92,18,86204,16866,103070
251590,201701,126,92,34,86204,31858,118062
251593,201701,17,9,8,8433,7496,15929
251597,201701,57,46,11,43102,10307,53409
251600,201701,1081,770,311,720178.94,289710.26,1009889.20
251610,201701,207,156,51,145516.1,47132,192648.1
251615,201701,1,1,0,937,0,937
251620,201701,4153,2778,1375,2595242.17,1286221.34,3881463.51
251630,201701,405,293,112,274541,104944,379485
251640,201701,146,103,43,96511,40291,136802
251650,201701,251,182,69,168735.55,64653,233388.55
251660,201701,216,197,19,183652.55,17803,201455.55
251670,201701,335,265,70,246741.07,65590,312331.07
251675,201701,2,2,0,1874,0,1874
251680,201701,83,79,4,74023,3748,77771
251690,201701,337,279,58,261423,54002.13,315425.13
251700,201701,280,227,53,212122.75,49646.95,261769.70
251710,201701,18,13,5,12181,4685,16866
251720,201701,34,23,11,21551,10026,31577
251740,201701,10,8,2,7496,1874,9370
260005,201701,3037,1722,1315,1602412.87,1230630.43,2833043.30
260010,201701,1243,873,370,814838.76,345472.56,1160311.32
260020,201701,422,377,45,353249,42165,395414
260030,201701,560,404,156,377794.65,146172,523966.65
260040,201701,862,521,341,487099.45,319507.63,806607.08
260050,201701,1116,777,339,727815,317081,1044896
260060,201701,412,370,42,345940.4,39354,385294.4
260070,201701,1371,866,505,807854.51,470264.58,1278119.09
260080,201701,733,566,167,529124.55,156479,685603.55
260090,201701,562,348,214,325851.86,200518,526369.86
260100,201701,223,154,69,143314.6,64653,207967.6
260105,201701,241,132,109,123684,102133,225817
260110,201701,2577,1918,659,1797147.63,616687,2413834.63
260120,201701,2806,1552,1254,1444196.83,1173406.55,2617603.38
260130,201701,139,94,45,88078,42165,130243
260140,201701,1980,1288,692,1199106.25,646887.63,1845993.88
260150,201701,235,150,85,140550,79645,220195
260160,201701,278,242,36,226754,33732,260486
260170,201701,3171,1934,1237,1804591.24,1158132,2962723.24
260180,201701,118,102,16,95574,14992,110566
260190,201701,2257,1610,647,1504745.17,606239,2110984.17
260200,201701,856,707,149,661697.24,139332,801029.24
260210,201701,1365,957,408,896560.96,382287,1278847.96
260220,201701,682,627,55,586727,51535,638262
260230,201701,1167,879,288,821471.15,269856,1091327.15
260240,201701,204,151,53,140334.49,49661,189995.49
260250,201701,59,46,13,43102,12181,55283
260260,201701,952,681,271,638097,253927,892024
260270,201701,443,359,84,335165.2,78426.9,413592.1
260280,201701,908,694,214,650090.6,200518,850608.6
260290,201701,6269,3292,2977,3064645.06,2783309.06,5847954.12
260300,201701,773,679,94,633918.23,87797,721715.23
260310,201701,484,380,104,354050.13,97448,451498.13
260320,201701,898,669,229,626757,214573,841330
260330,201701,22,19,3,17803,2811,20614
260340,201701,64,46,18,43102,16866,59968
260345,201701,5401,3081,2320,2879425.32,2172565.01,5051990.33
260350,201701,455,332,123,310102.02,114315,424417.02
260360,201701,305,155,150,145235,140550,285785
260370,201701,619,397,222,370162.7,207877,578039.7
260380,201701,597,431,166,403847,154418.14,558265.14
260390,201701,284,240,44,223704.19,40291,263995.19
260392,201701,84,74,10,69338,9370,78708
260400,201701,4063,2299,1764,2144814.65,1652512.41,3797327.06
260410,201701,13763,7502,6261,7014413.91,5863874.5,12878288.41
260415,201701,119,104,15,97448,14055,111503
260420,201701,1796,1042,754,971488.55,704110,1675598.55
260430,201701,191,175,16,162992.14,14992,177984.14
260440,201701,221,159,62,147710,58094,205804
260450,201701,476,336,140,313570,131180,444750
260460,201701,852,451,401,419965.4,375732.32,795697.72
260470,201701,358,217,141,202579.4,131227.55,333806.95
260480,201701,194,117,77,109629,72149,181778
260490,201701,206,166,40,155542,37480,193022
260500,201701,1117,744,373,694459,348471,1042930
260510,201701,706,549,157,514413,146172,660585
260515,201701,251,222,29,208014,26705,234719
260520,201701,3218,1880,1338,1753799.34,1251542.11,3005341.45
260530,201701,728,590,138,550061.65,129306,679367.65
260540,201701,580,427,153,400099,142424.66,542523.66
260545,201701,15,11,4,10307,3748,14055
260550,201701,325,200,125,187400,117125,304525
260560,201701,501,382,119,357354,111221.9,468575.9
260570,201701,998,828,170,772885.9,159290,932175.9
260580,201701,287,254,33,237998,30921,268919
260590,201701,633,353,280,329093.14,262360,591453.14
260600,201701,7645,4022,3623,3748559.91,3391467.32,7140027.23
260610,201701,478,315,163,295155,152731,447886
260620,201701,3394,1786,1608,1663659.94,1501516.94,3165176.88
260630,201701,65,62,3,58094,2811,60905
260640,201701,3575,1927,1648,1802060.19,1543830.05,3345890.24
260650,201701,337,231,106,216447,99279.85,315726.85
260660,201701,491,334,157,312492.88,146218.85,458711.73
260670,201701,99,75,24,70275,22488,92763
260680,201701,3640,2006,1634,1861991.24,1529120.15,3391111.39
260690,201701,188,152,36,141768.1,33732,175500.1
260700,201701,365,216,149,201642.4,138796,340438.4
260710,201701,39,37,2,34669,1874,36543
260720,201701,2179,1291,888,1203706.97,831278.29,2034985.26
260730,201701,565,429,136,401973,125558.45,527531.45
260740,201701,71,67,4,62779,3748,66527
260750,201701,645,441,204,413217,191148,604365
260760,201701,625,339,286,317643,267670,585313
260765,201701,951,496,455,461862.9,426100.75,887963.65
260770,201701,214,157,57,147109,53409,200518
260775,201701,825,488,337,455279.3,315769,771048.3
260780,201701,261,166,95,155542,88883.82,244425.82
260790,201701,12316,6728,5588,6278922.41,5228002.54,11506924.95
260795,201701,135,93,42,85997.86,39354,125351.86
260800,201701,360,295,65,275666,60905,336571
260805,201701,202,129,73,120157.13,68401,188558.13
260810,201701,740,643,97,601263.53,90889,692152.53
260820,201701,313,207,106,192901.3,99322,292223.3
260825,201701,186,128,58,119765.66,54346,174111.66
260830,201701,254,162,92,151653.45,86204,237857.45
260840,201701,220,156,64,144912,59687,204599
260845,201701,207,146,61,136802,57157,193959
260850,201701,519,372,147,346929.64,137739,484668.64
260860,201701,247,182,65,170339.86,60905,231244.86
260870,201701,371,259,112,242543,104944,347487
260875,201701,657,446,211,416808.53,197707,614515.53
260880,201701,1357,887,470,830413.31,440202.6,1270615.91
260890,201701,2448,1699,749,1587155.1,699940.49,2287095.59
260900,201701,1051,705,346,659306.95,324202,983508.95
260910,201701,277,215,62,201455,58094,259549
260915,201701,290,188,102,176156,95454,271610
260920,201701,162,93,69,87141,64653,151794
260930,201701,390,330,60,309210,56163.85,365373.85
260940,201701,2576,1424,1152,1330541.95,1078956,2409497.95
260950,201701,1854,1093,761,1017938.45,713038.26,1730976.71
260960,201701,14226,7334,6892,6836087.02,6451845.87,13287932.89
260970,201701,423,367,56,343879,52472,396351
260980,201701,204,176,28,164622,26236,190858
260990,201701,2438,2000,438,1873504.01,410406,2283910.01
261000,201701,4299,2467,1832,2300128.85,1712977.9,4013106.75
261010,201701,185,132,53,123684,48857.8,172541.8
261020,201701,608,444,164,415888,153668,569556
261030,201701,205,149,56,139613,52443.9,192056.9
261040,201701,359,323,36,302651,33450.9,336101.9
261050,201701,455,398,57,372926,53409,426335
261060,201701,1299,847,452,791531.88,423524,1215055.88
261070,201701,8861,4544,4317,4231106.71,4036836.93,8267943.64
261080,201701,381,284,97,266108,90889,356997
261090,201701,2110,1630,480,1519065.47,449011,1968076.47
261100,201701,1040,731,309,683120.8,288221.2,971342.0
261110,201701,7584,4613,2971,4317727.93,2780380.95,7098108.88
261120,201701,283,239,44,223662,41224,264886
261130,201701,566,312,254,292016.45,237717,529733.45
261140,201701,191,124,67,116188,62779,178967
261150,201701,651,371,280,347159,262360,609519
261153,201701,69,66,3,60905.12,2811,63716.12
261160,201701,74916,38213,36703,35685933.22,34366358.82,70052292.04
261170,201701,456,336,120,314551,112440,426991
261180,201701,1725,1044,681,973346.63,638097,1611443.63
261190,201701,626,424,202,397035.89,189255.63,586291.52
261200,201701,209,186,23,173577.09,21551,195128.09
261210,201701,30,28,2,26236,1874,28110
261220,201701,2340,1649,691,1539392.97,646343,2185735.97
261230,201701,316,236,80,220663.5,74945.95,295609.45
261240,201701,423,360,63,333378.47,59031,392409.47
261245,201701,197,163,34,152731,31858,184589
261247,201701,128,95,33,89015,30921,119936
261250,201701,2700,1317,1383,1232061.4,1295871,2527932.4
261255,201701,245,223,22,208951,20614,229565
261260,201701,803,689,114,645593,106818,752411
261270,201701,168,130,38,121810,35606,157416
261280,201701,131,105,26,98385,24362,122747
261290,201701,135,90,45,84330,42165,126495
261300,201701,1196,843,353,789057.44,330761,1119818.44
261310,201701,717,479,238,448823,222396.95,671219.95
261320,201701,517,353,164,330761,153668,484429
261330,201701,771,623,148,580807.25,137845.53,718652.78
261340,201701,332,178,154,166786,144298,311084
261350,201701,716,505,211,472248.1,197667,669915.1
261360,201701,1093,691,402,647072.53,376674,1023746.53
261370,201701,4760,2938,1822,2740895.61,1705005.33,4445900.94
261380,201701,571,411,160,382540.17,149639,532179.17
261390,201701,3209,2135,1074,1995857.22,1003238.53,2999095.75
261400,201701,279,254,25,237435.8,23425,260860.8
261410,201701,996,656,340,614672,318575.32,933247.32
261420,201701,861,534,327,498457.63,306380.63,804838.26
261430,201701,329,298,31,278395,28765.9,307160.9
261440,201701,83,72,11,67464,10307,77771
261450,201701,2469,2047,422,1915651.61,395396,2311047.61
261460,201701,662,525,137,490988.81,128369,619357.81
261470,201701,232,176,56,164116,52472,216588
261480,201701,307,249,58,232190,54342,286532
261485,201701,333,203,130,190211,121810,312021
261500,201701,622,411,211,385107,197707,582814
261510,201701,39,27,12,25299,11244,36543
261520,201701,164,153,11,142425,10307,152732
261530,201701,4126,2621,1505,2447824.74,1408968,3856792.74
261540,201701,1055,638,417,597806,390729,988535
261550,201701,281,141,140,130900,131180,262080
261560,201701,734,491,243,457163.5,227119.9,684283.4
261570,201701,349,271,78,253927,73086,327013
261580,201701,366,283,83,265171,77771,342942
261590,201701,183,146,37,136802,34669,171471
261600,201701,273,222,51,207265,47319,254584
261610,201701,97,84,13,78360,12181,90541
261618,201701,61,49,12,45913,11244,57157
261620,201701,208,124,84,116188,78708,194896
261630,201701,584,445,139,414648.8,130056,544704.8
261640,201701,5940,3139,2801,2932890.75,2622579.56,5555470.31
261650,201701,470,286,184,267316.73,172408,439724.73
270010,201701,490,426,64,399162,59219,458381
270020,201701,305,239,66,223189.4,61842,285031.4
270030,201701,8906,5672,3234,5300963.35,3027733.06,8328696.41
270040,201701,1756,1061,695,994053.94,650933.9,1644987.84
270050,201701,189,139,50,130243,46850,177093
270060,201701,123,68,55,63716,51535,115251
270070,201701,927,654,273,611117.26,254555.16,865672.42
270080,201701,44,37,7,34669,6559,41228
270090,201701,20,16,4,14992,3748,18740
270100,201701,1319,850,469,792282.98,436409.12,1228692.10
270110,201701,175,129,46,120873,43102,163975
270120,201701,213,174,39,162201.72,36543,198744.72
270130,201701,256,175,81,163693.9,75615.9,239309.8
270135,201701,101,59,42,55283,39354,94637
270140,201701,1217,703,514,658052.98,479174.26,1137227.24
270150,201701,271,216,55,202392,51535,253927
270160,201701,515,375,140,350488,131180,481668
270170,201701,658,411,247,383514.1,230642.55,614156.65
270180,201701,66,49,17,45600.7,15722.86,61323.56
270190,201701,103,90,13,84330,12181,96511
270200,201701,112,102,10,95386.6,9370,104756.6
270210,201701,495,253,242,237061,226472.9,463533.9
270220,201701,209,167,42,156479,39354,195833
270230,201701,1997,1167,830,1088072.35,774923.94,1862996.29
270235,201701,734,541,193,506589.55,180482.48,687072.03
270240,201701,3025,2315,710,2159719.77,661964.9,2821684.67
270250,201701,172,123,49,114501.4,45913,160414.4
270255,201701,222,196,26,183652,23987.2,207639.2
270260,201701,319,255,64,238608,59686.9,298294.9
270270,201701,129,54,75,50589,70275,120864
270280,201701,226,145,81,135865,75897,211762
270290,201701,1134,844,290,789488.59,270006.89,1059495.48
270300,201701,251,160,91,149920,84985.9,234905.9
270310,201701,957,750,207,700838.28,193265.99,894104.27
270320,201701,904,762,142,711880.8,133054,844934.8
270330,201701,250,205,45,191148,42165,233313
270340,201701,59,45,14,42165,13118,55283
270350,201701,94,47,47,44039,44039,88078
270360,201701,85,45,40,42165,37480,79645
270370,201701,51,37,14,34669,13118,47787
270375,201701,63,38,25,35606,23421,59027
270380,201701,1071,581,490,543460,459130,1002590
270390,201701,197,106,91,99322,85267,184589
270400,201701,687,489,198,457186.83,185517,642703.83
270410,201701,720,503,217,471301.63,203319.63,674621.26
270420,201701,379,241,138,224150,129223.89,353373.89
270430,201701,31133,22083,9050,20642612.77,8471124.88,29113737.65
270440,201701,502,391,111,365383.55,104007,469390.55
270450,201701,744,367,377,343644.75,352308.05,695952.80
270460,201701,210,150,60,140550,56220,196770
270470,201701,1286,848,438,794227.95,410182,1204409.95
270480,201701,489,383,106,355282.45,98619.25,453901.70
270490,201701,23,17,6,15929,5622,21551
270500,201701,509,408,101,382296,94637,476933
270510,201701,736,447,289,418839,270793,689632
270520,201701,430,258,172,241399.45,161164,402563.45
270530,201701,66,57,9,53409,8433,61842
270540,201701,126,95,31,89015,29047,118062
270550,201701,1716,1276,440,1193792.37,412181.62,1605973.99
270560,201701,331,147,184,137739,172408,310147
270570,201701,417,256,161,239056.73,150857,389913.73
270580,201701,71,49,22,45913,20614,66527
270590,201701,87,72,15,67464,14034.89,81498.89
270600,201701,179,145,34,135865,31858,167723
270610,201701,155,119,36,111494,33732,145226
270620,201701,34,32,2,29984,1874,31858
270630,201701,3764,2847,917,2656587.86,857112.38,3513700.24
270640,201701,881,633,248,591153.3,232067.9,823221.2
270642,201701,188,159,29,148983,27173,176156
270644,201701,301,202,99,189255.63,92758.32,282013.95
270650,201701,239,140,99,131180,92763,223943
270660,201701,260,208,52,194896,48724,243620
270670,201701,3152,2354,798,2195016.84,745336.54,2940353.38
270680,201701,456,262,194,245485,181773.32,427258.32
270690,201701,1207,730,477,682308.24,446814.63,1129122.87
270700,201701,39,30,9,28110,8433,36543
270710,201701,850,623,227,582164.86,212699,794863.86
270720,201701,250,184,66,172408,61560.9,233968.9
270730,201701,1741,997,744,932925.2,695059.6,1627984.8
270740,201701,45,27,18,25299,16866,42165
270750,201701,615,446,169,417902,157698,575600
270760,201701,311,227,84,212699,78708,291407
270770,201701,2646,1621,1025,1511213.16,958691.55,2469904.71
270780,201701,91,55,36,51530.32,33714.64,85244.96
270790,201701,287,192,95,179904,89015,268919
270800,201701,1968,1537,431,1439295.12,403116.14,1842411.26
270810,201701,315,246,69,230487.95,64644.32,295132.27
270820,201701,157,98,59,91826,55190,147016
270830,201701,1034,745,289,697316,270793,968109
270840,201701,1401,1003,398,939319.2,371990,1311309.2
270850,201701,1804,1077,727,1004511.95,680510.68,1685022.63
270860,201701,2407,1533,874,1432218.3,816991.11,2249209.41
270870,201701,130,69,61,64653,57157,121810
270880,201701,907,640,267,597073.19,249293.49,846366.68
270890,201701,398,291,107,272385.9,100254.32,372640.22
270895,201701,76,61,15,57157,14055,71212
270900,201701,113,91,22,85267,20614,105881
270910,201701,336,262,74,244369.6,69129,313498.6
270915,201701,1751,1014,737,944968.73,690077.57,1635046.30
270920,201701,497,409,88,383233,82456,465689
270930,201701,6256,4437,1819,4152021.57,1702301.62,5854323.19
270940,201701,2401,1798,603,1683433.63,563588,2247021.63
280010,201701,45,40,5,37480,4685,42165
280020,201701,688,587,101,548114.31,93700,641814.31
280030,201701,18185,11603,6582,10794164.66,6139980.3,16934144.96
280040,201701,351,221,130,207077,120404.5,327481.5
280050,201701,374,282,92,264234,86204,350438
280060,201701,400,258,142,240134.91,133054,373188.91
280067,201701,969,668,301,623208.26,281100.12,904308.38
280070,201701,125,103,22,95761.4,20614,116375.4
280100,201701,589,462,127,429167.88,118812,547979.88
280110,201701,76,69,7,64653,6559,71212
280120,201701,597,473,124,442404.55,116188,558592.55
280130,201701,1258,769,489,719007.9,458052.45,1177060.35
280140,201701,462,363,99,339259.59,92763,432022.59
280150,201701,303,220,83,205472.21,76834,282306.21
280160,201701,101,86,15,80582,14055,94637
280170,201701,571,377,194,352312.68,180981.55,533294.23
280190,201701,28,25,3,23425,2811,26236
280200,201701,16,11,5,10307,4685,14992
280210,201701,2670,1859,811,1725048.14,754675.06,2479723.20
280220,201701,38,30,8,28110,7496,35606
280230,201701,291,240,51,224060.95,46850.1,270911.05
280240,201701,175,162,13,150857.55,12181,163038.55
280250,201701,23,13,10,12181,9370,21551
280260,201701,79,71,8,66527,7496,74023
280270,201701,153,117,36,109629,33732,143361
280280,201701,201,125,76,117125,71212,188337
280290,201701,2912,2113,799,1965847.58,747094.63,2712942.21
280300,201701,1049,790,259,739293,241933.4,981226.4
280310,201701,104,98,6,91639,5622,97261
280320,201701,604,402,202,376665,189274,565939
280330,201701,359,252,107,235187,100137.19,335324.19
280340,201701,384,311,73,289962.05,68401,358363.05
280350,201701,3281,2532,749,2363443.16,700058.46,3063501.62
280360,201701,466,296,170,277352,158353,435705
280370,201701,89,76,13,71212,12181,83393
280380,201701,57,41,16,38417,14992,53409
280390,201701,174,143,31,133991,29047,163038
280400,201701,303,204,99,191055,92763,283818
280410,201701,290,231,59,215305,55273.63,270578.63
280420,201701,170,141,29,132117,27173,159290
280430,201701,102,75,27,70275,25299,95574
280440,201701,639,483,156,447559.8,146153.26,593713.06
280445,201701,114,105,9,98385,8433,106818
280450,201701,909,767,142,716701.93,133054,849755.93
280460,201701,695,495,200,457569.18,187400,644969.18
280470,201701,188,170,18,159290,15930,175220
280480,201701,2141,1523,618,1414990.74,575280.43,1990271.17
280490,201701,380,348,32,324932,29984,354916
280500,201701,55,49,6,45913,5622,51535
280510,201701,139,106,33,99024.6,30640,129664.6
280520,201701,56,41,15,38417,14055,52472
280530,201701,83,61,22,57157,20614,77771
280540,201701,487,385,102,360745,95292.9,456037.9
280550,201701,680,630,50,587740.3,46850,634590.3
280560,201701,478,410,68,382296,63716,446012
280570,201701,1716,1291,425,1206382.42,398206.26,1604588.68
280580,201701,592,445,147,416826,137646,554472
280590,201701,166,101,65,94175.06,60905,155080.06
280600,201701,340,287,53,267251.54,49661,316912.54
280610,201701,140,100,40,93498,37480,130978
280620,201701,547,438,109,409469,101992.45,511461.45
280630,201701,164,134,30,125558,28110,153668
280640,201701,199,154,45,143484,42165,185649
280650,201701,85,54,31,50598,29047,79645
280660,201701,149,107,42,100259,39119.75,139378.75
280670,201701,1428,890,538,827909.63,500428.98,1328338.61
280680,201701,184,153,31,141609.62,29047,170656.62
280690,201701,39,32,7,29984,6559,36543
280700,201701,17,17,0,15929,0,15929
280710,201701,1395,1023,372,951765.6,347908.1,1299673.7
280720,201701,111,71,40,64012.7,37480,101492.7
280730,201701,23,18,5,16866,4685,21551
280740,201701,2268,1643,625,1535856.94,583883.07,2119740.01
280750,201701,284,245,39,229565,36543,266108
280760,201701,840,564,276,527343.6,258471.45,785815.05
290010,201701,175,113,62,105881,58094,163975
290020,201701,172,159,13,148983,12181,161164
290030,201701,578,371,207,346971.1,193959,540930.1
290035,201701,139,109,30,99696.8,28110,127806.8
290040,201701,262,164,98,153668,91826,245494
290050,201701,65,47,18,44039,16866,60905
290060,201701,259,114,145,106536.9,135865,242401.9
290070,201701,5336,2568,2768,2398910.07,2590108.55,4989018.62
290080,201701,537,247,290,230670.76,271712,502382.76
290090,201701,381,159,222,148983,208014,356997
290100,201701,1571,1023,548,953494.05,512913.9,1466407.95
290110,201701,694,407,287,379762.1,268544.3,648306.4
290115,201701,211,192,19,178755,17803,196558
290120,201701,773,504,269,471592.1,252053,723645.1
290130,201701,421,239,182,223652.53,169783,393435.53
290135,201701,278,216,62,202392,58094,260486
290140,201701,272,227,45,211762,42165,253927
290150,201701,128,91,37,85267,34669,119936
290160,201701,249,194,55,180560.05,51535,232095.05
290170,201701,87,57,30,53409,28110,81519
290180,201701,149,118,31,110566,29047,139613
290190,201701,451,365,86,341724,80301,422025
290195,201701,284,155,129,145235,120873,266108
290200,201701,285,245,40,229565,37480,267045
290205,201701,132,76,56,71212,52472,123684
290210,201701,1051,770,281,720366.6,263297,983663.6
290220,201701,221,121,100,112908.5,93700,206608.5
290225,201701,270,100,170,93700,159290,252990
290230,201701,62,39,23,36422,21551,57973
290240,201701,280,112,168,104662.9,157416,262078.9
290250,201701,254,228,26,212765,24362,237127
290260,201701,251,217,34,202298.9,31858,234156.9
290265,201701,179,144,35,134125,32795,166920
290270,201701,1337,1091,246,1020159,229654.75,1249813.75
290280,201701,447,329,118,308273,110566,418839
290290,201701,1104,631,473,588400.95,443201,1031601.95
290300,201701,448,377,71,352729.07,66527,419256.07
290310,201701,322,143,179,133991,167723,301714
290320,201701,3759,2374,1385,2220631.55,1294934.5,3515566.05
290323,201701,176,154,22,144017,20614,164631
290327,201701,138,109,29,101865.96,27173,129038.96
290330,201701,62,36,26,33732,24362,58094
290340,201701,915,363,552,339082.88,516601.79,855684.67
290350,201701,547,326,221,304713,207077,511790
290360,201701,359,269,90,250179.86,84330,334509.86
290370,201701,1011,371,640,347346,599680,947026
290380,201701,305,183,122,171471,114314,285785
290390,201701,2419,1496,923,1398176.57,862884,2261060.57
290395,201701,240,129,111,120639,104007,224646
290400,201701,284,206,78,192460,73086,265546
290405,201701,249,210,39,196770,36543,233313
290410,201701,531,453,78,421510.9,73086,494596.9
290420,201701,218,165,53,154605,49661,204266
290430,201701,500,311,189,291407,177093,468500
290440,201701,71,62,9,58094,7808.3,65902.3
290450,201701,226,173,53,162101,49661,211762
290460,201701,1801,1059,742,991355.52,695067.56,1686423.08
290470,201701,1450,602,848,562662.17,794263.71,1356925.88
290475,201701,580,546,34,511602,31858,543460
290480,201701,275,147,128,137739,119936,257675
290485,201701,207,192,15,179811,14055,193866
290490,201701,1068,762,306,713244.4,285780.92,999025.32
290500,201701,642,315,327,295155,306399,601554
290510,201701,197,143,54,132774,50598,183372
290515,201701,127,70,57,65590,53409,118999
290520,201701,1318,840,478,785487.61,444392.8,1229880.41
290530,201701,307,282,25,264234,23425,287659
290540,201701,90,60,30,56220,28110,84330
290550,201701,148,125,23,117125,21485.41,138610.41
290560,201701,3375,1334,2041,1248946.41,1912226.4,3161172.81
290570,201701,5356,2760,2596,2583630.69,2429571.39,5013202.08
290580,201701,1219,689,530,644135.97,496610,1140745.97
290590,201701,519,428,91,400374,85267,485641
290600,201701,1647,1151,496,1075115.08,464470.9,1539585.98
290610,201701,220,198,22,185526,20614,206140
290620,201701,305,265,40,248305,37480,285785
290630,201701,2078,872,1206,813317,1124498.47,1937815.47
290640,201701,148,118,30,110566,28110,138676
290650,201701,1635,763,872,713985.42,817064,1531049.42
290660,201701,256,210,46,196770,43102,239872
290670,201701,944,510,434,477589,406289.95,883878.95
290680,201701,1136,919,217,860166,202392,1062558
290682,201701,274,200,74,186680.15,69319.63,255999.78
290685,201701,224,144,80,133991,74960,208951
290687,201701,888,581,307,541070.7,285663.29,826733.99
290689,201701,106,65,41,60891,38402.95,99293.95
290690,201701,751,310,441,290461,412363.77,702824.77
290700,201701,256,117,139,109629,130243,239872
290710,201701,653,422,231,395414,216447,611861
290720,201701,1013,825,188,773025,175687.5,948712.5
290730,201701,1100,621,479,580049.85,447886,1027935.85
290740,201701,14,11,3,10307,2811,13118
290750,201701,1302,585,717,547772.83,670537.55,1218310.38
290755,201701,65,56,9,52472,8433,60905
290760,201701,296,262,34,245494,31858,277352
290770,201701,182,170,12,159280.63,11244,170524.63
290780,201701,900,722,178,674605.23,165005.7,839610.93
290790,201701,425,285,140,266476,131180,397656
290800,201701,2571,1009,1562,943302.07,1462497.71,2405799.78
290810,201701,428,296,132,277071,123684,400755
290820,201701,360,216,144,200729.91,134928,335657.91
290830,201701,383,254,129,237998,120873,358871
290840,201701,1550,932,618,871738.4,575805.24,1447543.64
290850,201701,725,397,328,370958.3,306399,677357.3
290860,201701,663,292,371,273604,347346,620950
290870,201701,650,471,179,441046,167723,608769
290880,201701,124,66,58,61842,54346,116188
290890,201701,354,257,97,240809,90889,331698
290900,201701,157,126,31,118062,29047,147109
290910,201701,360,273,87,255801,81519,337320
290920,201701,227,189,38,177093,35606,212699
290930,201701,777,599,178,560485.29,166786,727271.29
290940,201701,250,206,44,192272.4,41228,233500.4
290950,201701,169,94,75,88078,70275,158353
290960,201701,425,283,142,263953.72,132772.9,396726.62
290970,201701,241,213,28,199393.6,26236,225629.6
290980,201701,1428,998,430,931051.02,401880.1,1332931.12
290990,201701,361,301,60,282028,56164.89,338192.89
291000,201701,821,230,591,215510,553767,769277
291005,201701,1880,794,1086,742235.28,1017568.32,1759803.60
291010,201701,148,136,12,127432,11244,138676
291020,201701,98,80,18,74960,16866,91826
291030,201701,86,65,21,60905,19677,80582
291040,201701,570,279,291,261413.63,272667,534080.63
291050,201701,1243,702,541,656502.92,506917,1163419.92
291060,201701,1441,778,663,728330.1,621231,1349561.1
291070,201701,1838,1361,477,1269683.5,443306.18,1712989.68
291072,201701,7185,2618,4567,2450022.02,4276734.7,6726756.72
291075,201701,184,148,36,138676,33732,172408
291077,201701,41,26,15,24362,14055,38417
291080,201701,18272,7904,10368,7383427.11,9701101.92,17084529.03
291085,201701,268,215,53,201455,49656.32,251111.32
291090,201701,305,112,193,104663,180831.63,285494.63
291100,201701,735,209,526,195833,492852.63,688685.63
291110,201701,388,296,92,277352,86204,363556
291120,201701,2493,1144,1349,1071788,1263002.08,2334790.08
291125,201701,56,30,26,28110,24362,52472
291130,201701,204,176,28,164912,26236,191148
291140,201701,109,78,31,73086,29047,102133
291150,201701,367,149,218,139613,204266,343879
291160,201701,328,276,52,257675.25,48724,306399.25
291165,201701,11,8,3,7496,2811,10307
291170,201701,2709,1374,1335,1285002.45,1248459,2533461.45
291180,201701,1311,494,817,462740,765493,1228233
291185,201701,62,59,3,55283,2811,58094
291190,201701,1189,500,689,466994.5,645040.53,1112035.03
291200,201701,159,115,44,107755,41228,148983
291210,201701,2138,815,1323,760572.27,1237880.54,1998452.81
291220,201701,241,183,58,170534.43,54346,224880.43
291230,201701,1078,362,716,338351,670892,1009243
291240,201701,440,417,23,389511,21551,411062
291250,201701,409,338,71,316706,66527,383233
291260,201701,32,23,9,21551,8433,29984
291270,201701,1174,470,704,440390,659366.9,1099756.9
291280,201701,374,163,211,152543.6,197396.53,349940.13
291290,201701,1701,851,850,796262.6,795701,1591963.6
291300,201701,224,178,46,166130.1,43102,209232.1
291310,201701,245,216,29,202111,27173,229284
291320,201701,1372,979,393,914230.9,366368.75,1280599.65
291330,201701,127,105,22,96604.7,20614,117218.7
291340,201701,135,78,57,73086,53409,126495
291345,201701,121,82,39,76834,36543,113377
291350,201701,1432,434,998,406470.6,934939.15,1341409.75
291360,201701,8366,4116,4250,3846495.98,3978925.28,7825421.26
291370,201701,1032,551,481,516006,449760.31,965766.31
291380,201701,248,194,54,181778,50598,232376
291390,201701,3790,1647,2143,1539221.25,2007991,3547212.25
291400,201701,1994,1410,584,1315175.79,545274.39,1860450.18
291410,201701,159,142,17,132117,15929,148046
291420,201701,97,69,28,64653,26236,90889
291430,201701,180,101,79,93941.74,73086,167027.74
291440,201701,480,387,93,360224.25,87141,447365.25
291450,201701,828,507,321,472905.54,299840,772745.54
291460,201701,1636,1322,314,1235553.68,294069,1529622.68
291465,201701,2206,1036,1170,970362.41,1096063.89,2066426.30
291470,201701,2623,1318,1305,1231013.95,1221639,2452652.95
291480,201701,11552,5106,6446,4773470.01,6031070.2,10804540.21
291490,201701,539,218,321,204266,300777,505043
291500,201701,358,185,173,173345,162101,335446
291510,201701,1263,484,779,452368.75,729641.9,1182010.65
291520,201701,961,433,528,405721,494414.63,900135.63
291530,201701,1036,274,762,256738,713694.26,970432.26
291535,201701,109,93,16,87141,14992,102133
291540,201701,362,107,255,100259,237998.8,338257.8
291550,201701,1164,531,633,495674.19,592540.9,1088215.09
291560,201701,5581,2889,2692,2693360.13,2509711.59,5203071.72
291570,201701,186,93,93,87141,87141,174282
291580,201701,1180,703,477,657968,445998.86,1103966.86
291590,201701,70,28,42,26236,39354,65590
291600,201701,1350,606,744,566885,696829,1263714
291610,201701,1155,496,659,463491.74,617428,1080919.74
291620,201701,547,244,303,228628,283395.65,512023.65
291630,201701,497,165,332,154605,311084,465689
291640,201701,3722,1827,1895,1705655.82,1775074.71,3480730.53
291650,201701,339,218,121,203151.97,113190,316341.97
291660,201701,457,181,276,168917.3,257534.45,426451.75
291670,201701,213,131,82,122185,76834,199019
291680,201701,708,389,319,363557,298810,662367
291685,201701,561,297,264,278055,247180.6,525235.6
291690,201701,520,259,261,242683,243620,486303
291700,201701,885,698,187,654026,174282,828308
291710,201701,1684,758,926,709328.34,867268.83,1576597.17
291720,201701,397,266,131,249237.32,122747,371984.32
291730,201701,892,504,388,470608.25,363546.63,834154.88
291733,201701,255,178,77,166504.9,72149,238653.9
291735,201701,63,52,11,48724,10307,59031
291740,201701,335,251,84,234859.05,78708,313567.05
291750,201701,1844,1210,634,1127040.38,592435.81,1719476.19
291760,201701,3117,1655,1462,1544215.24,1368207.5,2912422.74
291770,201701,741,514,227,479555.03,212699,692254.03
291780,201701,48,27,21,25299,19677,44976
291790,201701,172,74,98,69338,91826,161164
291800,201701,9563,3658,5905,3419590.37,5529331.9,8948922.27
291810,201701,1146,804,342,752504.9,320454,1072958.9
291820,201701,246,180,66,168660,61842,230502
291830,201701,1048,374,674,349239,630592,979831
291835,201701,636,565,71,528937,66527,595464
291840,201701,4488,2270,2218,2122273.62,2077129.88,4199403.50
291845,201701,319,109,210,102133,196760.63,298893.63
291850,201701,302,260,42,243385.75,39354,282739.75
291855,201701,257,103,154,96511,144298,240809
291860,201701,208,127,81,118063,75897,193960
291870,201701,78,32,46,29984,43102,73086
291875,201701,175,157,18,147109,16866,163975
291880,201701,468,370,98,346690,91826,438516
291890,201701,238,77,161,72139.63,149170.5,221310.13
291900,201701,53,30,23,28110,21551,49661
291905,201701,141,91,50,84986,46850,131836
291910,201701,181,144,37,134928,34669,169597
291915,201701,379,336,43,313194,40291,353485
291920,201701,4604,2363,2241,2211770.71,2098363.34,4310134.05
291930,201701,177,101,76,93700.7,71212,164912.7
291940,201701,291,159,132,148983,123684,272667
291950,201701,1103,909,194,849860.6,181778,1031638.6
291955,201701,881,527,354,493799,331698,825497
291960,201701,163,111,52,104007,48724,152731
291970,201701,787,594,193,556578,180841,737419
291980,201701,1457,1296,161,1211096.79,149920.7,1361017.49
291990,201701,124,116,8,108692,7496,116188
291992,201701,157,77,80,71399.4,74960,146359.4
291995,201701,134,96,38,89952,35606,125558
292000,201701,376,274,102,256457,95574,352031
292010,201701,276,202,74,188618.1,68401,257019.1
292020,201701,253,183,70,171471,65590,237061
292030,201701,130,102,28,95574,26236,121810
292040,201701,590,297,293,278289,274541,552830
292045,201701,80,73,7,68401,6559,74960
292050,201701,853,569,284,532162.26,266108,798270.26
292060,201701,923,767,156,716806.59,146172,862978.59
292070,201701,54,22,32,20614,29984,50598
292080,201701,107,71,36,66527,33732,100259
292090,201701,464,156,308,146151.89,288596,434747.89
292100,201701,1278,526,752,491316.35,703650.26,1194966.61
292105,201701,186,155,31,145235,29047,174282
292110,201701,2027,745,1282,697746.42,1198690.68,1896437.10
292120,201701,631,509,122,475820.96,114314,590134.96
292130,201701,433,254,179,237998,167723,405721
292140,201701,193,152,41,142424,38287.61,180711.61
292145,201701,147,75,72,70275,67435.9,137710.9
292150,201701,1361,1089,272,1020393,253854.57,1274247.57
292160,201701,181,148,33,138394.9,30921,169315.9
292170,201701,1219,1071,148,1001419.23,138619.78,1140039.01
292180,201701,184,136,48,127432,44976,172408
292190,201701,163,99,64,92763,59968,152731
292200,201701,1231,445,786,416030.24,735845.68,1151875.92
292205,201701,110,98,12,91826,11244,103070
292210,201701,346,236,110,219567,101712.25,321279.25
292220,201701,22,16,6,14992,5622,20614
292225,201701,39,34,5,31858,4685,36543
292230,201701,860,701,159,654444.72,148983,803427.72
292240,201701,601,416,185,388855,173345,562200
292250,201701,1574,982,592,920134,554704,1474838
292260,201701,438,233,205,218321,191335.4,409656.4
292265,201701,280,194,86,181496.9,80582,262078.9
292270,201701,769,324,445,303588,416028.4,719616.4
292273,201701,196,113,83,105117.34,77771,182888.34
292275,201701,149,67,82,62779,76552.9,139331.9
292280,201701,130,91,39,85267,36543,121810
292285,201701,55,46,9,42446.1,8433,50879.1
292290,201701,483,315,168,292710.01,157135,449845.01
292300,201701,1509,567,942,530716.9,880927.99,1411644.89
292303,201701,83,56,27,52472,25299,77771
292305,201701,102,70,32,65590,29984,95574
292310,201701,828,505,323,472731,301437.99,774168.99
292320,201701,635,479,156,448312.79,146172,594484.79
292330,201701,202,100,102,93700,95574,189274
292335,201701,257,194,63,181778,59031,240809
292340,201701,543,371,172,346809,161164,507973
292350,201701,247,129,118,120076.55,110284.9,230361.45
292360,201701,679,516,163,481805.5,152731,634536.5
292370,201701,784,593,191,555641,178967,734608
292380,201701,647,495,152,462878.51,142424,605302.51
292390,201701,500,188,312,176156,290610.75,466766.75
292400,201701,3232,1977,1255,1834097.45,1172405,3006502.45
292405,201701,247,161,86,150388.5,80300.9,230689.4
292410,201701,160,93,67,87141,62779,149920
292420,201701,302,258,44,241464.9,41228,282692.9
292430,201701,475,387,88,362619,81987.5,444606.5
292440,201701,561,474,87,442264,81519,523783
292450,201701,244,187,57,175219,53409,228628
292460,201701,588,430,158,402347.9,147343.25,549691.15
292465,201701,169,144,25,134928,22700.24,157628.24
292467,201701,92,51,41,47787,38417,86204
292470,201701,246,163,83,152731,77771,230502
292480,201701,254,173,81,161164.75,75897,237061.75
292490,201701,224,144,80,134928,74960,209888
292500,201701,1183,503,680,471104,636991.35,1108095.35
292510,201701,3202,1426,1776,1335225.36,1661433.35,2996658.71
292520,201701,1015,479,536,447647.75,502214,949861.75
292525,201701,377,262,115,245489.32,107755,353244.32
292530,201701,4091,1639,2452,1533684.4,2295342.3,3829026.7
292540,201701,484,252,232,235842.9,217102.9,452945.8
292550,201701,1016,550,466,514846.49,436180.9,951027.39
292560,201701,317,296,21,277352,19677,297029
292570,201701,282,214,68,200195,63716,263911
292575,201701,443,269,174,251772,163038,414810
292580,201701,870,548,322,512070.5,301151.9,813222.4
292590,201701,500,428,72,400738.98,67464,468202.98
292593,201701,139,107,32,100259,29984,130243
292595,201701,157,114,43,106818,40291,147109
292600,201701,1200,896,304,839240,284848,1124088
292610,201701,116,89,27,82924.5,25046.01,107970.51
292620,201701,507,418,89,391657,83393,475050
292630,201701,1292,751,541,701190.75,503638.3,1204829.05
292640,201701,751,523,228,490051,213636,703687
292650,201701,191,165,26,154605,24362,178967
292660,201701,1916,1357,559,1265780.02,518812.96,1784592.98
292665,201701,122,90,32,84330,29984,114314
292670,201701,364,308,56,288592,52472,341064
292680,201701,243,187,56,175219,52472,227691
292690,201701,174,134,40,125558,37480,163038
292700,201701,899,584,315,546271.9,294873.9,841145.8
292710,201701,98,84,14,78708,12837,91545
292720,201701,790,437,353,408681.92,330574,739255.92
292730,201701,210,99,111,91826.75,104007,195833.75
292740,201701,62889,31029,31860,29000931.04,29825837.57,58826768.61
292750,201701,390,278,112,259549.07,104148.01,363697.08
292760,201701,314,245,69,228572.25,64653,293225.25
292770,201701,774,328,446,305371.03,415013.75,720384.78
292780,201701,421,157,264,146885.53,247368,394253.53
292790,201701,541,240,301,224880,281100,505980
292800,201701,1059,640,419,598743,392603,991346
292805,201701,418,126,292,117827.75,273604,391431.75
292810,201701,1424,839,585,785580.9,548145,1333725.9
292820,201701,742,595,147,555642.3,137448.9,693091.2
292830,201701,101,78,23,73086,21551,94637
292840,201701,637,526,111,492394,103992.95,596386.95
292850,201701,130,86,44,80578,41228,121806
292860,201701,1952,1122,830,1046726.07,777429,1824155.07
292870,201701,3266,2201,1065,2061331.9,997895.63,3059227.53
292880,201701,1380,909,471,848267.58,441327,1289594.58
292890,201701,441,379,62,355095,58094,413189
292895,201701,132,88,44,81121.71,41228,122349.71
292900,201701,373,276,97,258612,90889,349501
292905,201701,429,215,214,201455,200050,401505
292910,201701,378,291,87,272340,81519,353859
292920,201701,500,222,278,208014,260486,468500
292925,201701,522,483,39,451905.73,36308.75,488214.48
292930,201701,531,325,206,304525,193022,497547
292935,201701,293,119,174,111503,163038,274541
292937,201701,213,141,72,132117,67464,199581
292940,201701,190,141,49,132117,45913,178030
292950,201701,1031,531,500,495674.6,467564,963238.6
292960,201701,508,337,171,315769,160227,475996
292970,201701,283,196,87,182997,81519,264516
292975,201701,159,88,71,82456,66340,148796
292980,201701,249,168,81,155664.42,75897,231561.42
292990,201701,1257,925,332,861394.92,310900.26,1172295.18
293000,201701,99,73,26,68401,24352.63,92753.63
293010,201701,2517,1564,953,1461946.78,889496,2351442.78
293015,201701,628,492,136,460723,126805,587528
293020,201701,341,277,64,259549,59968,319517
293030,201701,630,548,82,511977.82,76834,588811.82
293040,201701,330,259,71,242683,66527,309210
293050,201701,2572,1499,1073,1395787.13,1001625.49,2397412.62
293060,201701,241,192,49,179904,44976.4,224880.4
293070,201701,3200,1593,1607,1485587.2,1504288.63,2989875.83
293075,201701,86,58,28,54346,26236,80582
293076,201701,73,44,29,41228,27173,68401
293077,201701,414,248,166,228878.66,155542,384420.66
293080,201701,459,399,60,373863,56220,430083
293090,201701,133,113,20,105600,18427.7,124027.7
293100,201701,480,348,132,326076,123684,449760
293105,201701,328,222,106,207733,99322,307055
293110,201701,170,121,49,113377,45913,159290
293120,201701,310,204,106,191148,99134.6,290282.6
293130,201701,237,154,83,144298,77489.9,221787.9
293135,201701,7553,3003,4550,2807125.21,4257103.71,7064228.92
293140,201701,175,116,59,108692,54534,163226
293150,201701,328,284,44,264703.1,41228,305931.1
293160,201701,431,236,195,221132,182433.9,403565.9
293170,201701,174,122,52,114032.9,47881,161913.9
293180,201701,443,300,143,280819,133991,414810
293190,201701,1225,856,369,796608.19,345394,1142002.19
293200,201701,507,445,62,416591,58094,474685
293210,201701,508,348,160,325927,149920,475847
293220,201701,2748,1088,1660,1018278.55,1553359.55,2571638.10
293230,201701,1787,638,1149,596401.9,1076592.89,1672994.79
293240,201701,219,201,18,188337,16866,205203
293245,201701,110,90,20,84330,18740,103070
293250,201701,723,263,460,245795.24,430739,676534.24
293260,201701,305,256,49,238935.89,45913,284848.89
293270,201701,1172,553,619,517224.65,580003,1097227.65
293280,201701,219,121,98,113377,91826,205203
293290,201701,2978,1919,1059,1797166.5,991989,2789155.5
293300,201701,656,462,194,431071.79,180044.55,611116.34
293305,201701,162,135,27,126495,25299,151794
293310,201701,137,103,34,96511,31858,128369
293315,201701,137,104,33,97448,30921,128369
293317,201701,91,66,25,61842,23425,85267
293320,201701,927,525,402,490988.25,376389,867377.25
293325,201701,173,64,109,59968,102114.26,162082.26
293330,201701,12255,5662,6593,5296697.38,6172916.38,11469613.76
293340,201701,243,171,72,160227,66527,226754
293345,201701,240,187,53,175219,49661,224880
293350,201701,624,315,309,295155,288080.65,583235.65
293360,201701,1522,1083,439,1013553,410125.35,1423678.35
310010,201701,157,80,77,74960,71587,146547
310020,201701,1029,567,462,528843.05,430739.26,959582.31
310030,201701,398,329,69,306605.94,64371.9,370977.84
310040,201701,50,33,17,30921,15929,46850
310050,201701,248,158,90,147109,84049,231158
310060,201701,239,163,76,152731,71212,223943
310070,201701,20,9,11,8433,10307,18740
310080,201701,53,28,25,26236,23425,49661
310090,201701,906,465,441,430815.31,411155.9,841971.21
310100,201701,282,211,71,197707,66527,264234
310110,201701,714,378,336,353150.09,314644.6,667794.69
310120,201701,366,206,160,192366.1,149552.61,341918.71
310130,201701,34,21,13,19677,12181,31858
310140,201701,30,16,14,14992,13118,28110
310150,201701,1273,883,390,821190.61,364867.9,1186058.51
310160,201701,2139,1095,1044,1019271.05,974855.84,1994126.89
310163,201701,82,46,36,43102,33732,76834
310170,201701,2473,971,1502,909518.6,1404844.3,2314362.9
310180,201701,114,43,71,40291,66152.2,106443.2
310190,201701,461,300,161,281100,150294.8,431394.8
310200,201701,505,320,185,299840,173064,472904
310205,201701,50,39,11,36543,10307,46850
310210,201701,278,219,59,205203,55283,260486
310220,201701,64,41,23,38417,21551,59968
310230,201701,275,184,91,171471,85267,256738
310240,201701,103,89,14,83393,13118,96511
310250,201701,101,80,21,74960,19677,94637
310260,201701,820,430,390,400287.35,364708.51,764995.86
310270,201701,263,170,93,158747,87141,245888
310280,201701,363,270,93,251398.1,87141,338539.1
310285,201701,207,150,57,140247.35,53409,193656.35
310290,201701,249,143,106,133991,99322,233313
310300,201701,139,114,25,106818,23425,130243
310310,201701,13,9,4,8433,3748,12181
310320,201701,22,15,7,14055,6559,20614
310330,201701,29,20,9,18740,8433,27173
310340,201701,1431,901,530,836070.35,495392.25,1331462.60
310350,201701,2729,1464,1265,1367041.25,1184742.9,2551784.15
310360,201701,41,34,7,31858,6559,38417
310370,201701,120,97,23,90889,21270,112159
310375,201701,99,34,65,31858,60887,92745
310380,201701,50,29,21,27173,19677,46850
310390,201701,102,71,31,66527,29047,95574
310400,201701,2206,1394,812,1301682,760544.9,2062226.9
310410,201701,124,66,58,61842,54346,116188
310420,201701,637,344,293,321485.1,273595.43,595080.53
310430,201701,327,214,113,200236.9,105881,306117.9
310440,201701,57,36,21,33732,19677,53409
310445,201701,82,66,16,61842,14992,76834
310450,201701,863,539,324,503575.1,303588,807163.1
310460,201701,257,176,81,164912,75897,240809
310470,201701,487,302,185,282974,173345,456319
310480,201701,90,62,28,58094,26236,84330
310490,201701,476,219,257,204266.1,240809,445075.1
310500,201701,117,51,66,47787,61842,109629
310510,201701,620,394,226,367956.8,211743.63,579700.43
310520,201701,128,85,43,79645,40291,119936
310530,201701,83,38,45,35606,41883.9,77489.9
310540,201701,445,275,170,255251.76,159290,414541.76
310550,201701,71,47,24,44039,22488,66527
310560,201701,2806,1938,868,1805585.65,811718.42,2617304.07
310570,201701,157,100,57,93700,53409,147109
310590,201701,329,221,108,206656,101196,307852
310600,201701,157,93,64,85407.85,59968,145375.85
310610,201701,57,20,37,18740,34669,53409
310620,201701,43667,20744,22923,19368761,21442804.88,40811565.88
310630,201701,512,324,188,301949.1,174594.61,476543.71
310640,201701,130,109,21,101945.6,19677,121622.6
310650,201701,151,133,18,123684,16866,140550
310660,201701,83,49,34,45913,31858,77771
310665,201701,47,36,11,33732,10307,44039
310670,201701,6145,2858,3287,2671287.17,3074578.25,5745865.42
310680,201701,50,33,17,30921,15929,46850
310690,201701,541,397,144,369030.23,134928,503958.23
310700,201701,65,43,22,40291,20614,60905
310710,201701,1214,815,399,763646,373863,1137509
310720,201701,84,28,56,26236,52472,78708
310730,201701,1303,901,402,843956,376674,1220630
310740,201701,1008,562,446,524533.2,417658.63,942191.83
310750,201701,243,140,103,130243.29,96511,226754.29
310760,201701,68,51,17,47787,15929,63716
310770,201701,78,43,35,40291,32795,73086
310780,201701,422,343,79,321382,74023,395405
310790,201701,96,77,19,72149,17803,89952
310800,201701,455,210,245,196301.5,229274.53,425576.03
310810,201701,161,112,49,104560,44976,149536
310820,201701,379,295,84,276415,78426.9,354841.9
310825,201701,177,143,34,133991,31858,165849
310830,201701,479,224,255,209239.61,237716.9,446956.51
310840,201701,389,221,168,207077,157134.9,364211.9
310850,201701,110,89,21,83393,19677,103070
310855,201701,378,297,81,278289,75897,354186
310860,201701,1328,992,336,925341.45,313127.95,1238469.40
310870,201701,52,41,11,38417,10307,48724
310880,201701,78,57,21,53409,19677,73086
310890,201701,303,179,124,167723,116188,283911
310900,201701,629,289,340,268592.95,318562,587154.95
310910,201701,238,166,72,154231.1,67464,221695.1
310920,201701,502,297,205,275479.1,191148.7,466627.8
310925,201701,25,20,5,18740,4404,23144
310930,201701,1091,646,445,604898.78,416862.2,1021760.98
310940,201701,678,353,325,330452,304525,634977
310945,201701,123,75,48,70275,44976,115251
310950,201701,259,202,57,189274,53409,242683
310960,201701,90,36,54,33732,50594,84326
310970,201701,172,107,65,100259,60280.3,160539.3
310980,201701,35,17,18,15929,16866,32795
310990,201701,152,88,64,82456,59968,142424
311000,201701,794,412,382,383234.9,357925,741159.9
311010,201701,39,31,8,29047,7496,36543
311020,201701,38,24,14,22488,13118,35606
311030,201701,406,235,171,218322,160227,378549
311040,201701,35,29,6,27173,5622,32795
311050,201701,456,192,264,179342,247086.9,426428.9
311060,201701,745,441,304,412093.2,284848,696941.2
311070,201701,309,137,172,128369,161164,289533
311080,201701,102,53,49,49661,45913,95574
311090,201701,384,178,206,166786,193022,359808
311100,201701,605,362,243,338913,227128.8,566041.8
311110,201701,645,432,213,404784,199572,604356
311115,201701,61,45,16,42165,14992,57157
311120,201701,989,510,479,475797.4,448213.95,924011.35
311130,201701,412,237,175,221881.6,163975,385856.6
311140,201701,154,67,87,62779,80722.55,143501.55
311150,201701,348,225,123,210708,115016.75,325724.75
311160,201701,741,529,212,493799.7,198176,691975.7
311170,201701,71,49,22,45913,20332.9,66245.9
311180,201701,336,215,121,201173.9,113096,314269.9
311190,201701,36,20,16,18740,14992,33732
311200,201701,354,243,111,226098.3,104007,330105.3
311205,201701,30,19,11,17568.75,9932.2,27500.95
311210,201701,47,39,8,36543,7496,44039
311220,201701,13,12,1,11244,937,12181
311230,201701,1443,889,554,829641.55,519098,1348739.55
311240,201701,156,94,62,88078,58094,146172
311250,201701,59,29,30,27173,28110,55283
311260,201701,560,332,228,311084,213636,524720
311265,201701,103,69,34,64653,31858,96511
311270,201701,366,249,117,233313,109441.6,342754.6
311280,201701,214,96,118,89952,110003.8,199955.8
311290,201701,110,89,21,83112,19115,102227
311300,201701,542,335,207,312958.88,193678,506636.88
311310,201701,22,18,4,16866,3748,20614
311320,201701,653,484,169,452571,158353,610924
311330,201701,985,737,248,690241.75,231439.7,921681.45
311340,201701,2509,1773,736,1652648.72,688948.83,2341597.55
311350,201701,269,208,61,194896,57157,252053
311360,201701,171,107,64,100259,59968,160227
311370,201701,1160,451,709,421850,663255.45,1085105.45
311380,201701,7,6,1,5622,937,6559
311390,201701,286,155,131,145235,122278.6,267513.6
311400,201701,163,107,56,100259,52463,152722
311410,201701,91,54,37,50598,34669,85267
311420,201701,280,160,120,148027.1,112440,260467.1
311430,201701,830,539,291,502197.1,272667,774864.1
311440,201701,493,342,151,319517.4,141487,461004.4
311450,201701,309,191,118,178967,110566,289533
311455,201701,302,204,98,190857.9,91544.9,282402.8
311460,201701,131,52,79,48724,73324.93,122048.93
311470,201701,22,13,9,12181,8433,20614
311480,201701,23,7,16,6559,14992,21551
311490,201701,17,10,7,9370,6559,15929
311500,201701,18,8,10,7496,9370,16866
311510,201701,618,423,195,395414,182715,578129
311520,201701,42,31,11,28391.1,10307,38698.1
311530,201701,1779,1319,460,1228269.81,431020,1659289.81
311535,201701,59,46,13,43102,12181,55283
311540,201701,33,29,4,27173,3748,30921
311545,201701,178,135,43,126495,40291,166786
311547,201701,32,23,9,21551,8433,29984
311550,201701,567,259,308,242288.3,288577.63,530865.93
311560,201701,40,27,13,25299,12181,37480
311570,201701,307,198,109,184963.8,102133,287096.8
311580,201701,278,157,121,146827.9,113377,260204.9
311590,201701,35,29,6,27173,5622,32795
311600,201701,91,72,19,67464,17803,85267
311610,201701,247,210,37,195833.25,34669,230502.25
311615,201701,84,68,16,63088.21,14992,78080.21
311620,201701,16,11,5,10307,4685,14992
311630,201701,71,58,13,54346,12181,66527
311640,201701,115,67,48,62779,44976,107755
311650,201701,116,86,30,79879.25,28110,107989.25
311660,201701,379,180,199,168660,186463,355123
311670,201701,160,100,60,93148,56220,149368
311680,201701,216,159,57,147324.94,52659.4,199984.34
311690,201701,17,10,7,9370,6559,15929
311700,201701,202,136,66,127150.9,61842,188992.9
311710,201701,214,138,76,129025,70998,200023
311720,201701,28,22,6,20614,5622,26236
311730,201701,512,339,173,317081,162101,479182
311740,201701,29,20,9,18740,8433,27173
311750,201701,704,480,224,447886.4,209607,657493.4
311760,201701,64,37,27,34669,25299,59968
311770,201701,388,182,206,169316.1,193022,362338.1
311780,201701,165,96,69,89952,64341,154293
311783,201701,73,64,9,59968,8433,68401
311787,201701,35,13,22,12181,20614,32795
311790,201701,264,127,137,118999,128369,247368
311800,201701,598,412,186,382719.15,174282,557001.15
311810,201701,40,33,7,30921,6559,37480
311820,201701,109,88,21,82456,19677,102133
311830,201701,1802,1152,650,1074665.75,605771.4,1680437.15
311840,201701,978,527,451,489519.11,420844.06,910363.17
311850,201701,11,5,6,4685,5622,10307
311860,201701,9059,4201,4858,3923816.87,4544061.31,8467878.18
311870,201701,159,85,74,79645,69338,148983
311880,201701,941,697,244,651861.9,228628,880489.9
311890,201701,215,112,103,104944,96511,201455
311900,201701,90,38,52,35606,48443,84049
311910,201701,1304,817,487,762880.05,454117.15,1216997.20
311920,201701,235,151,84,141253,78708,219961
311930,201701,881,503,378,471030,353670.9,824700.9
311940,201701,2226,1120,1106,1046864.25,1033277.05,2080141.30
311950,201701,203,116,87,108318,81238,189556
311960,201701,65,45,20,42165,18740,60905
311970,201701,25,15,10,12508.95,9370,21878.95
311980,201701,41,31,10,29047,9370,38417
311990,201701,63,47,16,44039,14992,59031
311995,201701,64,44,20,41228,18740,59968
312000,201701,31,21,10,19395.9,9370,28765.9
312010,201701,97,68,29,63716,27173,90889
312015,201701,86,64,22,59687,20614,80301
312020,201701,170,102,68,95574,63434.9,159008.9
312030,201701,36,31,5,28392,4685,33077
312040,201701,84,56,28,52472,26236,78708
312050,201701,245,127,118,118999,110566,229565
312060,201701,75,52,23,48724,20895.1,69619.1
312070,201701,79,46,33,43102,30921,74023
312080,201701,498,208,290,194896,271730,466626
312083,201701,43,33,10,30921,9370,40291
312087,201701,99,76,23,71212,21551,92763
312090,201701,2655,1440,1215,1337665.85,1135011.62,2472677.47
312100,201701,165,116,49,108692,45913,154605
312110,201701,126,81,45,75897,42165,118062
312120,201701,142,102,40,95574,37480,133054
312125,201701,96,52,44,48536.6,41228,89764.6
312130,201701,124,81,43,75897,40291,116188
312140,201701,134,103,31,96511,29047,125558
312150,201701,42,34,8,31858,7496,39354
312160,201701,1490,991,499,925709.85,465907.13,1391616.98
312170,201701,11,9,2,8433,1874,10307
312180,201701,134,86,48,79645.75,44695,124340.75
312190,201701,29,27,2,25299,1874,27173
312200,201701,691,595,96,555875.35,89952,645827.35
312210,201701,96,60,36,56220,33732,89952
312220,201701,116,85,31,79411,29047,108458
312230,201701,3309,1644,1665,1537459.89,1558992.99,3096452.88
312235,201701,114,73,41,68401,38417,106818
312240,201701,108,69,39,64653,36543,101196
312245,201701,147,98,49,91822,45913,137735
312247,201701,50,36,14,32983,13118,46101
312250,201701,172,82,90,76366,84330,160696
312260,201701,94,64,30,59780.6,28110,87890.6
312270,201701,140,86,54,79645.9,50598,130243.9
312280,201701,26,16,10,14992,9370,24362
312290,201701,157,113,44,105600,40291.4,145891.4
312300,201701,197,132,65,123684,60905,184589
312310,201701,56,51,5,47787,4685,52472
312320,201701,420,256,164,238935,152403.25,391338.25
312330,201701,88,76,12,70463,10962.9,81425.9
312340,201701,33,14,19,13118,17803,30921
312350,201701,17,11,6,10307,5622,15929
312352,201701,90,63,27,59031,25299,84330
312360,201701,562,259,303,241746,283255.1,525001.1
312370,201701,211,127,84,118999,78708,197707
312380,201701,144,92,52,86204,48724,134928
312385,201701,182,148,34,138676,31858,170534
312390,201701,293,183,110,171471,102415,273886
312400,201701,372,275,97,257675,90421,348096
312410,201701,840,273,567,255332.5,530713,786045.5
312420,201701,582,468,114,438516,106818,545334
312430,201701,846,629,217,586798.94,202392.1,789191.04
312440,201701,47,32,15,29984,14055,44039
312450,201701,211,132,79,123684,74023,197707
312460,201701,52,24,28,22488,26236,48724
312470,201701,53,34,19,31858,17803,49661
312480,201701,225,136,89,127432,83111.9,210543.9
312490,201701,259,180,79,168660,74023,242683
312500,201701,30,16,14,14992,13118,28110
312510,201701,399,154,245,144298,228960.36,373258.36
312520,201701,41,15,26,14055,24362,38417
312530,201701,45,34,11,31858,10307,42165
312540,201701,98,86,12,80582,11244,91826
312550,201701,34,26,8,24362,7496,31858
312560,201701,181,132,49,123403,45631.9,169034.9
312570,201701,421,252,169,235749.2,157674.23,393423.43
312580,201701,82,45,37,41884,34669,76553
312590,201701,297,233,64,217245,59968,277213
312595,201701,135,122,13,114314,12181,126495
312600,201701,76,48,28,44555,26236,70791
312610,201701,1592,819,773,762158.49,723270.3,1485428.79
312620,201701,179,124,55,116188,51535,167723
312630,201701,67,54,13,50598,12181,62779
312640,201701,48,15,33,14055,30921,44976
312650,201701,139,112,27,104663,25299,129962
312660,201701,55,41,14,38136,13118,51254
312670,201701,741,481,260,449151.95,243573.15,692725.10
312675,201701,41,31,10,29047,9370,38417
312680,201701,81,56,25,52097.2,23425,75522.2
312690,201701,232,122,110,114304.63,102788.9,217093.53
312695,201701,25,19,6,17803,5622,23425
312700,201701,189,103,86,96511,80582,177093
312705,201701,71,59,12,55283,10962.9,66245.9
312707,201701,85,59,26,55283,24362,79645
312710,201701,1828,969,859,906492.1,804675,1711167.1
312720,201701,62,31,31,29047,29047,58094
312730,201701,293,172,121,160227,113377,273604
312733,201701,48,43,5,40291,4685,44976
312735,201701,20,15,5,14055,4685,18740
312737,201701,72,39,33,36543,30921,67464
312738,201701,49,34,15,31858,14055,45913
312740,201701,68,48,20,44976,18740,63716
312750,201701,71,51,20,47787,18740,66527
312760,201701,270,194,76,181778,71212,252990
312770,201701,7437,3397,4040,3162363.46,3779350.67,6941714.13
312780,201701,433,337,96,315487.9,89952,405439.9
312790,201701,18,14,4,13118,3748,16866
312800,201701,1585,1108,477,1031598.98,445788.11,1477387.09
312810,201701,376,236,140,221132,131180,352312
312820,201701,193,144,49,134928,45913,180841
312825,201701,23,14,9,13118,8433,21551
312830,201701,296,170,126,158354,117154,275508
312840,201701,145,107,38,100259,35606,135865
312850,201701,21,19,2,17803,1874,19677
312860,201701,174,107,67,99978,62779,162757
312870,201701,979,506,473,472310.7,443201,915511.7
312880,201701,147,101,46,94496.45,43008.3,137504.75
312890,201701,158,103,55,96511,51535,148046
312900,201701,219,164,55,153012.1,51535,204547.1
312910,201701,180,87,93,80750.66,87141,167891.66
312920,201701,146,82,64,76834,59968,136802
312930,201701,334,238,96,223006,89952,312958
312940,201701,99,63,36,59031,33732,92763
312950,201701,691,436,255,407876.2,238935,646811.2
312960,201701,176,132,44,123684,41228,164912
312965,201701,42,37,5,34669,4685,39354
312970,201701,276,219,57,204032.1,53409,257441.1
312980,201701,2184,1165,1019,1088411.9,954236.8,2042648.7
312990,201701,45,26,19,24362,17803,42165
313000,201701,41,27,14,25299,13118,38417
313005,201701,154,119,35,110528.75,32514,143042.75
313010,201701,909,364,545,340131.1,510374.9,850506.0
313020,201701,196,102,94,95574,88078,183652
313030,201701,197,123,74,114315,69338,183653
313040,201701,55,19,36,17803,33732,51535
313050,201701,286,200,86,186463.1,80300.9,266764.0
313055,201701,42,30,12,28110,11244,39354
313060,201701,115,79,36,73574,33450.9,107024.9
313065,201701,55,35,20,32795,18740,51535
313070,201701,157,82,75,76834,70275,147109
313080,201701,40,17,23,15929,21551,37480
313090,201701,692,472,220,440999.15,206140,647139.15
313100,201701,175,65,110,60905,103062,163967
313110,201701,105,60,45,56220,42165,98385
313115,201701,126,69,57,64268.83,52472,116740.83
313120,201701,710,392,318,367023,296648,663671
313130,201701,4827,2563,2264,2384389.27,2112413.27,4496802.54
313140,201701,163,80,83,74960,77771,152731
313150,201701,326,258,68,241746,63434.9,305180.9
313160,201701,163,116,47,108692,44039,152731
313170,201701,1282,911,371,841756.25,346962.1,1188718.35
313180,201701,403,238,165,221431.84,154605,376036.84
313190,201701,667,388,279,359620.85,260674,620294.85
313200,201701,21,20,1,18740,937,19677
313210,201701,874,740,134,689211.48,125553.32,814764.80
313220,201701,215,146,69,135865,63950.25,199815.25
313230,201701,301,215,86,200519,80582,281101
313240,201701,1867,1014,853,947487.17,795040.52,1742527.69
313250,201701,1212,880,332,819970.8,308275.4,1128246.2
313260,201701,92,54,38,50598,35606,86204
313270,201701,937,526,411,488659.77,385107,873766.77
313280,201701,59,50,9,46475.2,8433,54908.2
313290,201701,221,174,47,162757,43102.9,205859.9
313300,201701,347,170,177,159290,165849,325139
313310,201701,204,102,102,95574,95574,191148
313320,201701,355,276,79,256691.55,74023,330714.55
313330,201701,1267,740,527,692443.6,492628.75,1185072.35
313340,201701,336,229,107,214573,100259,314832
313350,201701,541,367,174,342005.05,163038,505043.05
313360,201701,113,61,52,57157,48443,105600
313370,201701,188,76,112,71212,104944,176156
313375,201701,247,146,101,136802,94637,231439
313380,201701,1171,599,572,558189.88,535211,1093400.88
313390,201701,46,38,8,34669.4,7496,42165.4
313400,201701,399,251,148,235187,138395,373582
313410,201701,14,8,6,7496,5622,13118
313420,201701,4570,2309,2261,2155347.29,2110657.11,4266004.40
313430,201701,140,61,79,57157,74023,131180
313440,201701,1439,967,472,904732.21,441983,1346715.21
313450,201701,60,26,34,24362,31858,56220
313460,201701,358,174,184,161620,172398.63,334018.63
313470,201701,485,210,275,196770,257019.1,453789.1
313480,201701,158,106,52,98386,48724,147110
313490,201701,496,241,255,225812.32,238486,464298.32
313500,201701,15,10,5,9370,4685,14055
313505,201701,906,704,202,659366.9,189274,848640.9
313507,201701,91,51,40,47787,37480,85267
313510,201701,2632,1693,939,1582220.8,878906,2461126.8
313520,201701,3525,2736,789,2551200.24,739007.9,3290208.14
313530,201701,40,28,12,26236,11244,37480
313535,201701,94,79,15,73368,14055,87423
313540,201701,70,55,15,51535,13211.7,64746.7
313545,201701,90,72,18,67464,16866,84330
313550,201701,234,189,45,177093,41603,218696
313560,201701,338,174,164,163038,153668,316706
313570,201701,53,26,27,24362,25299,49661
313580,201701,1265,672,593,628617.15,553673.7,1182290.85
313590,201701,132,63,69,59031,64653,123684
313600,201701,694,403,291,377611,271824,649435
313610,201701,62,51,11,47505.9,10307,57812.9
313620,201701,1223,656,567,604958.06,528149.6,1133107.66
313630,201701,1623,1244,379,1163848.4,354842,1518690.4
313640,201701,123,69,54,64653,50598,115251
313650,201701,209,97,112,90889,104944,195833
313652,201701,14,13,1,12181,937,13118
313655,201701,51,29,22,27173,20614,47787
313657,201701,46,43,3,40291,2811,43102
313660,201701,124,87,37,81519,34669,116188
313665,201701,583,298,285,279226,266810.75,546036.75
313670,201701,9459,6496,2963,6065851.57,2775769,8841620.57
313680,201701,37,29,8,27173,7496,34669
313690,201701,159,122,37,114314,34669,148983
313695,201701,53,43,10,40291,9370,49661
313700,201701,276,215,61,201174,57157,258331
313710,201701,156,109,47,102133,44039,146172
313720,201701,949,435,514,407032.9,480204.83,887237.73
313730,201701,50,36,14,33732,13118,46850
313740,201701,157,124,33,116000.6,30921,146921.6
313750,201701,456,337,119,315487.9,111503,426990.9
313753,201701,235,162,73,151138.1,68401,219539.1
313760,201701,1101,404,697,378548,650401.56,1028949.56
313770,201701,341,241,100,225817,93700,319517
313780,201701,687,366,321,342942,300777,643719
313790,201701,28,26,2,24362,1686.6,26048.6
313800,201701,128,77,51,72149,47787,119936
313810,201701,51,33,18,30921,16866,47787
313820,201701,1253,625,628,584407.1,587195.1,1171602.2
313830,201701,69,51,18,47787,16866,64653
313835,201701,45,41,4,38417,3748,42165
313840,201701,1580,967,613,901490.2,573444.1,1474934.3
313850,201701,178,61,117,57157,109059.39,166216.39
313860,201701,545,428,117,396915.6,108692.55,505608.15
313862,201701,178,115,63,107755,59031,166786
313865,201701,73,55,18,51535,16866,68401
313867,201701,50,37,13,34669,12181,46850
313868,201701,21,14,7,13118,6559,19677
313870,201701,136,63,73,59031,68401,127432
313880,201701,326,207,119,193678,110940.9,304618.9
313890,201701,312,172,140,160414.9,130617.8,291032.7
313900,201701,909,502,407,468782.25,381313,850095.25
313910,201701,153,109,44,101946,40291.1,142237.1
313920,201701,570,412,158,385575.5,148046,533621.5
313925,201701,26,22,4,20614,3748,24362
313930,201701,778,589,189,551893,177070,728963
313940,201701,1702,1064,638,992564.2,597243.9,1589808.1
313950,201701,920,581,339,542616.73,317127.9,859744.63
313960,201701,1197,691,506,644187.28,473841,1118028.28
313970,201701,112,81,31,75897,29047,104944
313980,201701,202,128,74,119702,69338,189040
313990,201701,326,192,134,179904,125558,305462
314000,201701,895,607,288,566886.4,269851.32,836737.72
314010,201701,73,45,28,42165,26236,68401
314015,201701,60,19,41,17803,38417,56220
314020,201701,47,33,14,30921,13118,44039
314030,201701,90,47,43,44039,40291,84330
314040,201701,38,30,8,28110,7496,35606
314050,201701,298,175,123,163975,113939.2,277914.2
314053,201701,99,63,36,59031,33732,92763
314055,201701,279,160,119,149920,111503,261423
314060,201701,135,114,21,105881,19677,125558
314070,201701,849,446,403,413883.67,376711.53,790595.20
314080,201701,206,136,70,127198,64653.84,191851.84
314085,201701,100,67,33,62591.6,30921,93512.6
314090,201701,363,262,101,245494,94632.32,340126.32
314100,201701,453,371,82,343755,76272,420027
314110,201701,687,371,316,345311.25,295389.8,640701.05
314120,201701,107,56,51,52472,47787,100259
314130,201701,20,11,9,10307,8433,18740
314140,201701,1072,637,435,595257.46,406584.13,1001841.59
314150,201701,163,100,63,93700,59031,152731
314160,201701,358,262,96,244557.4,89765,334322.4
314170,201701,61,43,18,40291,16866,57157
314180,201701,758,656,102,613141.91,94637.25,707779.16
314190,201701,98,61,37,57157,34669,91826
314200,201701,581,393,188,367304.8,175219,542523.8
314210,201701,367,268,99,249944.75,92482,342426.75
314220,201701,375,286,89,266109,83112,349221
314225,201701,62,44,18,41228,16866,58094
314230,201701,95,44,51,41228,47787,89015
314240,201701,132,98,34,91826,31812,123638
314250,201701,54,31,23,29047,21551,50598
314260,201701,184,95,89,89015,83393,172408
314270,201701,470,358,112,334697,104663,439360
314280,201701,667,368,299,344525.9,280163,624688.9
314290,201701,539,428,111,399818.25,103725.9,503544.15
314300,201701,413,293,120,271657.5,112394,384051.5
314310,201701,1400,925,475,865507.9,444774.33,1310282.23
314315,201701,32,25,7,23425,6559,29984
314320,201701,601,373,228,349220,213004.21,562224.21
314330,201701,10398,5231,5167,4889705.22,4836167.23,9725872.45
314340,201701,561,261,300,243994.9,280538,524532.9
314345,201701,40,27,13,25299,12181,37480
314350,201701,189,111,78,104007,73086,177093
314360,201701,72,39,33,36543,30921,67464
314370,201701,60,50,10,46850,9370,56220
314380,201701,86,63,23,59031,21551,80582
314390,201701,2817,1714,1103,1603348.3,1030325.6,2633673.9
314400,201701,657,478,179,445067.1,167723,612790.1
314410,201701,409,266,143,249242,133991,383233
314420,201701,17,6,11,5622,10307,15929
314430,201701,2442,857,1585,799315.72,1482660.71,2281976.43
314435,201701,248,142,106,132772.9,98385,231157.9
314437,201701,22,17,5,15929,4685,20614
314440,201701,114,77,37,72149,34669,106818
314450,201701,155,118,37,110566,34669,145235
314460,201701,665,292,373,273604,349220,622824
314465,201701,72,52,20,48724,18740,67464
314467,201701,74,59,15,55283,13399.1,68682.1
314470,201701,335,166,169,150971.06,157416.75,308387.81
314480,201701,978,463,515,432612.9,481711.7,914324.6
314490,201701,87,62,25,58094,23425,81519
314500,201701,289,183,106,171471,99322,270793
314505,201701,112,75,37,70275,34669,104944
314510,201701,225,181,44,168660.1,41228,209888.1
314520,201701,1179,614,565,570714.43,527484.45,1098198.88
314530,201701,740,581,159,543920,148983,692903
314535,201701,184,116,68,108410.9,63188.38,171599.28
314537,201701,57,33,24,30921,22488,53409
314540,201701,32,26,6,24362,5622,29984
314545,201701,47,34,13,31858,12181,44039
314550,201701,81,43,38,40291,35606,75897
314560,201701,805,423,382,394196,356997.79,751193.79
314570,201701,21,15,6,14055,5622,19677
314580,201701,19,8,11,7496,10307,17803
314585,201701,18,12,6,11244,5622,16866
314587,201701,71,63,8,59031,7496,66527
314590,201701,508,377,131,352968,122747,475715
314600,201701,936,593,343,552429.39,318421.8,870851.19
314610,201701,894,490,404,457256.4,377424.15,834680.55
314620,201701,142,105,37,97448,34669,132117
314625,201701,91,70,21,64747,19677,84424
314630,201701,1252,623,629,582017.65,589091.9,1171109.55
314640,201701,92,61,31,57157,29047,86204
314650,201701,201,115,86,107473.9,80582,188055.9
314655,201701,62,48,14,44938.34,13099.17,58037.51
314660,201701,20,15,5,14055,4685,18740
314670,201701,172,140,32,130899,29984,160883
314675,201701,213,118,95,110566,89015,199581
314690,201701,529,290,239,271730,223662,495392
314700,201701,2422,1297,1125,1210230.6,1053234.95,2263465.55
314710,201701,1597,920,677,859043.2,632943.5,1491986.7
314720,201701,406,240,166,223193.9,155542,378735.9
314730,201701,485,258,227,240341,212221.5,452562.5
314740,201701,663,326,337,304759.25,315769,620528.25
314750,201701,20,18,2,16866,1874,18740
314760,201701,299,148,151,138676,141477.63,280153.63
314770,201701,124,83,41,77771,38417,116188
314780,201701,21,6,15,5622,14055,19677
314790,201701,2281,1424,857,1326878.85,802062.73,2128941.58
314795,201701,41,34,7,31624,6559,38183
314800,201701,2728,1570,1158,1465241.56,1084381.1,2549622.66
314810,201701,1451,800,651,747305.25,608113.4,1355418.65
314820,201701,82,46,36,43102,33732,76834
314830,201701,204,155,49,144532.75,45632,190164.75
314840,201701,80,46,34,43102,31858,74960
314850,201701,336,159,177,148983,165849,314832
314860,201701,703,520,183,485553.79,169972.35,655526.14
314870,201701,1386,689,697,644656.5,653089,1297745.5
314875,201701,36,30,6,28110,5622,33732
314880,201701,41,29,12,27173,11244,38417
314890,201701,46,27,19,25299,17803,43102
314900,201701,24,21,3,19677,2811,22488
314910,201701,258,170,88,159290,82456,241746
314915,201701,145,130,15,121576,14055,135631
314920,201701,131,77,54,72149,50317,122466
314930,201701,970,487,483,455149,452008.9,907157.9
314940,201701,28,23,5,21551,4685,26236
314950,201701,41,32,9,29281.25,8433,37714.25
314960,201701,58,41,17,38417,15929,54346
314970,201701,134,66,68,61561,63716,125277
314980,201701,301,192,109,177047.05,100915,277962.05
314990,201701,443,242,201,225817.25,187447.75,413265.00
314995,201701,155,60,95,56220,89005.63,145225.63
315000,201701,84,65,19,59968.6,17803,77771.6
315010,201701,45,29,16,27173,14992,42165
315015,201701,161,131,30,122034.88,28110,150144.88
315020,201701,56,48,8,44976,7496,52472
315030,201701,132,99,33,91826.5,30921,122747.5
315040,201701,59,43,16,40291,14992,55283
315050,201701,190,113,77,105881,72149,178030
315053,201701,31,26,5,24362,4685,29047
315057,201701,91,76,15,70837.2,14055,84892.2
315060,201701,68,62,6,56220.98,5622,61842.98
315070,201701,111,62,49,58094,45913,104007
315080,201701,350,290,60,271730,56220,327950
315090,201701,106,66,40,61842,37480,99322
315100,201701,74,38,36,35606,33732,69338
315110,201701,299,166,133,153668,124621,278289
315120,201701,1534,759,775,707951,725004,1432955
315130,201701,308,221,87,207077,81519,288596
315140,201701,535,312,223,289814.18,208951,498765.18
315150,201701,963,442,521,413218,487896,901114
315160,201701,194,98,96,91826,89952,181778
315170,201701,335,218,117,202393.1,109347.9,311741.0
315180,201701,3173,1354,1819,1265060.05,1701827.1,2966887.15
315190,201701,304,180,124,168286,116188,284474
315200,201701,1146,637,509,595089.53,475714.9,1070804.43
315210,201701,1477,822,655,765905.05,611861.8,1377766.85
315213,201701,28,19,9,17803,8433,26236
315217,201701,183,141,42,132117,39354,171471
315220,201701,1427,1096,331,1025508.59,310015.64,1335524.23
315230,201701,170,122,48,114033,44976,159009
315240,201701,420,275,145,257675,135621.63,393296.63
315250,201701,2470,1236,1234,1156820.3,1154938.37,2311758.67
315260,201701,149,89,60,82081.2,56220,138301.2
315270,201701,122,77,45,71024.6,41452.88,112477.48
315280,201701,710,463,247,433457,231429.63,664886.63
315290,201701,181,101,80,94637,74023.34,168660.34
315300,201701,76,48,28,44976,26236,71212
315310,201701,70,61,9,57157,8433,65590
315320,201701,152,81,71,75897,66527,142424
315330,201701,53,45,8,42165,7496,49661
315340,201701,407,291,116,271505.9,108687.32,380193.22
315350,201701,142,86,56,80582,52472,133054
315360,201701,92,48,44,44976,41228,86204
315370,201701,55,30,25,28110,23143.9,51253.9
315380,201701,11,6,5,5622,4685,10307
315390,201701,47,13,34,12181,31858,44039
315400,201701,792,586,206,545334.6,192366.1,737700.7
315410,201701,327,196,131,183371,122747,306118
315415,201701,62,47,15,44039,14055,58094
315420,201701,196,145,51,134788.5,47787,182575.5
315430,201701,667,398,269,372926,252053,624979
315440,201701,74,55,19,51535,17803,69338
315445,201701,252,199,53,186153.79,49661,235814.79
315450,201701,188,144,44,134928,41228,176156
315460,201701,3244,1648,1596,1539297.9,1492211.95,3031509.85
315470,201701,46,25,21,23144,19677,42821
315480,201701,56,20,36,18740,33732,52472
315490,201701,498,292,206,272432.75,193022,465454.75
315500,201701,24,13,11,12181,10307,22488
315510,201701,146,91,55,85267,51535,136802
315520,201701,64,58,6,54346,5622,59968
315530,201701,53,27,26,25299,24362,49661
315540,201701,228,144,84,134928,78708,213636
315550,201701,172,132,40,123684,37480,161164
315560,201701,922,718,204,672203.9,191148,863351.9
315570,201701,325,176,149,161820.25,139613,301433.25
315580,201701,620,407,213,381359,199581,580940
315590,201701,217,113,104,105881,96933,202814
315600,201701,269,192,77,179904,71962,251866
315610,201701,95,49,46,45913,43102,89015
315620,201701,32,23,9,21551,8433,29984
315630,201701,134,88,46,82456,43102,125558
315640,201701,50,30,20,28110,18740,46850
315645,201701,69,49,20,45913,18272,64185
315650,201701,156,118,38,110285,35606,145891
315660,201701,469,184,285,172408,267045,439453
315670,201701,2083,1068,1015,997965.75,950287.9,1948253.65
315680,201701,858,572,286,532461.81,267269.88,799731.69
315690,201701,693,469,224,438117.63,209888,648005.63
315700,201701,1862,994,868,929129.71,812379.4,1741509.11
315710,201701,305,69,236,64653,221132,285785
315720,201701,405,257,148,240809,138394.9,379203.9
315725,201701,188,151,37,141487,34669,176156
315727,201701,37,20,17,18740,15508,34248
315730,201701,41,38,3,35606,2811,38417
315733,201701,86,55,31,51254,29047,80301
315737,201701,50,37,13,34669,12181,46850
315740,201701,42,37,5,34669,4685,39354
315750,201701,159,126,33,118022,30921,148943
315760,201701,44,28,16,26236,14992,41228
315765,201701,101,66,35,61842,32795,94637
315770,201701,220,126,94,118062,88078,206140
315780,201701,3106,1643,1463,1531294.05,1368208.31,2899502.36
315790,201701,172,130,42,121810,39354,161164
315800,201701,271,201,70,188056,65590,253646
315810,201701,86,50,36,46850,33732,80582
315820,201701,785,561,224,523409.77,209888,733297.77
315830,201701,140,81,59,75897,55283,131180
315840,201701,79,51,28,47787,26236,74023
315850,201701,261,189,72,177093,67464,244557
315860,201701,11,3,8,2811,7496,10307
315870,201701,33,28,5,26236,4685,30921
315880,201701,106,67,39,62779,36543,99322
315890,201701,67,49,18,45913,16866,62779
315895,201701,315,208,107,194147,99697,293844
315900,201701,64,35,29,32795,27173,59968
315910,201701,37,23,14,21223.05,13118,34341.05
315920,201701,179,121,58,113377,53409.95,166786.95
315930,201701,32,11,21,10307,19677,29984
315935,201701,132,104,28,96652,26227,122879
315940,201701,80,62,18,58094,16866,74960
315950,201701,64,43,21,40291,19677,59968
315960,201701,598,277,321,259192.94,300777,559969.94
315970,201701,40,30,10,28110,9370,37480
315980,201701,678,302,376,282037,352302.63,634339.63
315990,201701,243,143,100,133991,93419,227410
316000,201701,42,27,15,25299,14055,39354
316010,201701,71,61,10,57157,9370,66527
316020,201701,99,82,17,76834,15929,92763
316030,201701,406,202,204,189274,190914,380188
316040,201701,464,203,261,190190.89,244276,434466.89
316045,201701,33,29,4,27173,3748,30921
316050,201701,15,14,1,11806.2,937,12743.2
316060,201701,94,63,31,58749.9,29047,87796.9
316070,201701,993,631,362,585628.25,337509,923137.25
316080,201701,103,62,41,58094,38417,96511
316090,201701,48,28,20,25299.1,18740,44039.1
316095,201701,57,47,10,43768,9370,53138
316100,201701,307,186,121,173719.9,113377,287096.9
316105,201701,35,23,12,21551,11244,32795
316110,201701,1887,1502,385,1396739.47,358777.3,1755516.77
316120,201701,74,53,21,49661,19396,69057
316130,201701,138,106,32,98667,29984,128651
316140,201701,63,51,12,47787,11244,59031
316150,201701,197,142,55,132351.25,51535,183886.25
316160,201701,90,57,33,53409,30921,84330
316165,201701,57,42,15,39167,13352.25,52519.25
316170,201701,213,143,70,133054,65590,198644
316180,201701,188,85,103,79317.05,96511,175828.05
316190,201701,123,91,32,84330,29984,114314
316200,201701,701,394,307,369178,287472,656650
316210,201701,725,477,248,446591.43,232376,678967.43
316220,201701,115,74,41,69338,38417,107755
316225,201701,12,5,7,4685,6559,11244
316230,201701,32,19,13,17803,12181,29984
316240,201701,606,487,119,455382.1,111503,566885.1
316245,201701,96,80,16,74960,14992,89952
316250,201701,1439,1021,418,947620.8,391441.12,1339061.92
316255,201701,112,90,22,83955.2,20614,104569.2
316257,201701,167,90,77,84330,72149,156479
316260,201701,235,155,80,143362.25,74867,218229.25
316265,201701,19,13,6,12181,5622,17803
316270,201701,663,459,204,427084.8,191148,618232.8
316280,201701,528,323,205,299903.3,191429.3,491332.6
316290,201701,652,426,226,396351.69,211762,608113.69
316292,201701,463,181,282,169597,263859.2,433456.2
316294,201701,120,74,46,69338,43102,112440
316295,201701,270,124,146,114766.5,136802,251568.5
316300,201701,97,65,32,60905,29984,90889
316310,201701,33,18,15,16866,14055,30921
316320,201701,47,26,21,24362,19677,44039
316330,201701,117,73,44,67183.25,40946.9,108130.15
316340,201701,136,97,39,90889,36543,127432
316350,201701,188,133,55,124294,51535,175829
316360,201701,24,19,5,17803,4685,22488
316370,201701,1007,537,470,498691.15,440380.63,939071.78
316380,201701,114,87,27,81519,25299,106818
316390,201701,121,85,36,79645,33732,113377
316400,201701,151,115,36,107755,33732,141487
316410,201701,305,224,81,208529.35,75897,284426.35
316420,201701,182,127,55,118296.25,51535,169831.25
316430,201701,150,75,75,70275,70275,140550
316440,201701,97,48,49,44976,45913,90889
316443,201701,55,49,6,45257.1,5622,50879.1
316447,201701,63,52,11,48724,10307,59031
316450,201701,203,158,45,147765,42165,189930
316460,201701,62,27,35,25299,32795,58094
316470,201701,1514,1086,428,1012788.15,398711.93,1411500.08
316480,201701,11,10,1,9370,937,10307
316490,201701,15,5,10,4685,9370,14055
316500,201701,151,100,51,93418.9,47787,141205.9
316510,201701,171,125,46,115860.15,43102,158962.15
316520,201701,193,121,72,112814.8,67464,180278.8
316530,201701,144,101,43,94637,40010,134647
316540,201701,135,72,63,66527,59031,125558
316550,201701,140,98,42,91605.67,39313.89,130919.56
316553,201701,201,103,98,96183.05,91826,188009.05
316555,201701,74,54,20,50598,18740,69338
316556,201701,12,8,4,7496,3748,11244
316557,201701,16,15,1,14055,937,14992
316560,201701,56,45,11,42165,10307,52472
316570,201701,248,224,24,209654,22488,232142
316580,201701,23,15,8,14055,7496,21551
316590,201701,132,112,20,104944,18459,123403
316600,201701,185,149,36,139332,33732,173064
316610,201701,63,42,21,39354,19677,59031
316620,201701,126,97,29,90889,27173,118062
316630,201701,49,37,12,34669,11244,45913
316640,201701,16,10,6,9370,5622,14992
316650,201701,63,47,16,44039,14992,59031
316660,201701,5,3,2,2811,1874,4685
316670,201701,433,146,287,136784,268357,405141
316680,201701,160,108,52,101196,48537,149733
316690,201701,192,116,76,108692,71212,179904
316695,201701,52,47,5,44039,4685,48724
316700,201701,12,6,6,5622,5622,11244
316710,201701,690,494,196,462362.9,183652,646014.9
316720,201701,4685,2377,2308,2212756.35,2158915.02,4371671.37
316730,201701,15,13,2,12181,1874,14055
316740,201701,136,80,56,74960,52472,127432
316750,201701,17,11,6,10307,5622,15929
316760,201701,323,257,66,240809,61842,302651
316770,201701,133,77,56,72149,52472,124621
316780,201701,73,38,35,35307,32795,68102
316790,201701,52,39,13,36543,12181,48724
316800,201701,1581,980,601,914851.56,562288,1477139.56
316805,201701,19,10,9,9370,8433,17803
316810,201701,66,41,25,38417,23425,61842
316820,201701,42,21,21,19677,19677,39354
316830,201701,87,39,48,36543,44695,81238
316840,201701,539,318,221,296935.4,205203,502138.4
316850,201701,340,219,121,203844.35,113377,317221.35
316860,201701,5885,2557,3328,2382765.89,3113596.73,5496362.62
316870,201701,1343,860,483,798841.35,448216.55,1247057.90
316880,201701,103,60,43,55564.9,40291,95855.9
316890,201701,248,167,81,156479,75897,232376
316900,201701,411,283,128,262670.84,119936,382606.84
316905,201701,40,26,14,24362,13118,37480
316910,201701,53,25,28,23425,26236,49661
316920,201701,123,98,25,91124,23425,114549
316930,201701,1916,943,973,878111.15,909265.85,1787377.00
316935,201701,860,516,344,481618.66,320828.8,802447.46
316940,201701,1061,604,457,565011.7,427628.16,992639.86
316950,201701,182,93,89,87141,83393,170534
316960,201701,1067,582,485,543741.9,454145.26,997887.16
316970,201701,591,458,133,429146,124621,553767
316980,201701,114,72,42,67464,39344.63,106808.63
316990,201701,2116,1387,729,1293295.88,682127.63,1975423.51
317000,201701,307,240,67,224599,62779,287378
317005,201701,242,173,69,162101,64653,226754
317010,201701,6081,3297,2784,3076857.13,2606724.83,5683581.96
317020,201701,15746,6866,8880,6402326.02,8306158.86,14708484.88
317030,201701,79,26,53,24362,49661,74023
317040,201701,3097,1901,1196,1779552.4,1118310.6,2897863.0
317043,201701,68,48,20,44976,18740,63716
317047,201701,34,16,18,14992,16862,31854
317050,201701,187,139,48,130243,44976,175219
317052,201701,112,87,25,81519,23425,104944
317057,201701,186,144,42,134928,38792,173720
317060,201701,54,33,21,30921,19395.9,50316.9
317065,201701,59,48,11,44976,10307,55283
317070,201701,1953,915,1038,851546.85,971107,1822653.85
317075,201701,109,56,53,52472,49661,102133
317080,201701,777,425,352,397148,329637,726785
317090,201701,589,473,116,442779.35,108692,551471.35
317100,201701,390,292,98,270850.6,91826,362676.6
317103,201701,90,76,14,71212,13118,84330
317107,201701,33,31,2,29047,1874,30921
317110,201701,104,47,57,44039,53409,97448
317115,201701,49,42,7,39354,6559,45913
317120,201701,1746,883,863,819628.35,808182,1627810.35
317130,201701,1799,1135,664,1059568.3,621513,1681081.3
317140,201701,16,14,2,13118,1874,14992
317150,201701,262,160,102,149920,94824.4,244744.4
317160,201701,305,216,89,202392,83393,285785
317170,201701,195,142,53,133054,49661,182715
317180,201701,399,295,104,275712.25,97448,373160.25
317190,201701,250,169,81,158353,75897,234250
317200,201701,769,551,218,502959,204266,707225
317210,201701,151,86,65,79645.6,60905,140550.6
317220,201701,21,12,9,11244,8433,19677
320010,201701,601,450,151,418558.8,141487,560045.8
320013,201701,127,90,37,84330,34669,118999
320016,201701,278,174,104,163038,97448,260486
320020,201701,678,402,276,373128.37,256017.97,629146.34
320030,201701,145,108,37,101196,34341.05,135537.05
320035,201701,130,95,35,89015,32795,121810
320040,201701,487,267,220,249054.8,206140,455194.8
320050,201701,97,74,23,69338,21551,90889
320060,201701,1411,613,798,574335,747061.3,1321396.3
320070,201701,95,67,28,62779,26236,89015
320080,201701,746,424,322,394992.1,301433,696425.1
320090,201701,1182,821,361,765851.4,337694.8,1103546.2
320100,201701,314,184,130,170262.01,121151.23,291413.24
320110,201701,130,84,46,77022.1,43102,120124.1
320115,201701,107,85,22,79645,20614,100259
320120,201701,3168,1758,1410,1637035.55,1319562.96,2956598.51
320130,201701,6927,3348,3579,3116137.95,3346065,6462202.95
320140,201701,421,271,150,252615.2,140310,392925.2
320150,201701,1753,1031,722,960041.05,676364.08,1636405.13
320160,201701,669,289,380,269566.22,355944.96,625511.18
320170,201701,113,85,28,78896,26236,105132
320180,201701,46,26,20,24362,18740,43102
320190,201701,234,164,70,152909.03,65309,218218.03
320200,201701,54,38,16,35606,14992,50598
320210,201701,831,467,364,435799.7,339880,775679.7
320220,201701,291,111,180,103070.86,168379,271449.86
320225,201701,73,59,14,55283,12322,67605
320230,201701,509,328,181,306024.2,168801,474825.2
320240,201701,2986,1524,1462,1426208.7,1368012.1,2794220.8
320245,201701,415,287,128,268450.6,119936,388386.6
320250,201701,204,105,99,97282.66,92763,190045.66
320255,201701,141,113,28,104597.31,26096,130693.31
320260,201701,163,118,45,110566,42118.15,152684.15
320265,201701,158,125,33,116329,30921,147250
320270,201701,150,119,31,111503,29047,140550
320280,201701,888,544,344,505025.26,320950.81,825976.07
320290,201701,64,54,10,50598,9370,59968
320300,201701,486,345,141,321832.65,130872.55,452705.20
320305,201701,612,323,289,302651,270793,573444
320310,201701,197,112,85,104663,78903,183566
320313,201701,277,144,133,134928,124340,259268
320316,201701,113,93,20,87141,18740,105881
320320,201701,3181,1397,1784,1305607.8,1669328.5,2974936.3
320330,201701,259,190,69,177380.9,62779.81,240160.71
320332,201701,847,511,336,476816,313681.15,790497.15
320334,201701,236,146,90,136521,84330,220851
320335,201701,145,105,40,97213.95,37480,134693.95
320340,201701,581,396,185,369928,172690,542618
320350,201701,932,389,543,363239,508183.44,871422.44
320360,201701,156,81,75,75616,70275,145891
320370,201701,237,178,59,165230,54268,219498
320380,201701,278,188,90,175406.4,84330,259736.4
320390,201701,1044,638,406,597806,378296.56,976102.56
320400,201701,319,225,94,208951.6,87797,296748.6
320405,201701,824,337,487,315544.34,456146.15,771690.49
320410,201701,910,470,440,437322.29,410613.1,847935.39
320420,201701,464,243,221,227223.2,207077,434300.2
320425,201701,182,103,79,96511,74023,170534
320430,201701,377,212,165,197800.95,154398.59,352199.54
320435,201701,167,107,60,99453.18,56220,155673.18
320440,201701,189,119,70,111221.9,65590,176811.9
320450,201701,123,70,53,65590,49661,115251
320455,201701,239,188,51,175220,47769,222989
320460,201701,235,150,85,140550,79645,220195
320465,201701,114,78,36,72729.94,33732,106461.94
320470,201701,584,380,204,355761.54,191140,546901.54
320480,201701,159,105,54,98385,50598,148983
320490,201701,2827,1399,1428,1307303.21,1336090.89,2643394.10
320495,201701,90,56,34,52454,31858,84312
320500,201701,9066,4612,4454,4292292.41,4163428.91,8455721.32
320501,201701,486,245,241,229565,225808,455373
320503,201701,260,186,74,173345.6,69338,242683.6
320506,201701,234,182,52,170534,48724,219258
320510,201701,869,417,452,386818.75,422567.05,809385.80
320515,201701,75,61,14,56220.45,13118,69338.45
320517,201701,187,132,55,123684,51535,175219
320520,201701,6325,2818,3507,2628285.05,3279255.68,5907540.73
320530,201701,4979,2510,2469,2343946.54,2309605.03,4653551.57
330010,201701,2738,1394,1344,1297677.8,1257155.66,2554833.46
330015,201701,155,61,94,56220.14,88078,144298.14
330020,201701,3337,1444,1893,1347507.66,1772617,3120124.66
330022,201701,203,115,88,107755,81520,189275
330023,201701,490,167,323,155308.4,302651,457959.4
330025,201701,512,119,393,111503,367959.9,479462.9
330030,201701,1768,1108,660,1031780.43,615592.04,1647372.47
330040,201701,2030,1021,1009,954517.2,944215,1898732.2
330045,201701,8181,2501,5680,2334260.29,5317253.66,7651513.95
330050,201701,753,479,274,448823,256738,705561
330060,201701,813,533,280,496611.9,262360,758971.9
330070,201701,3185,1247,1938,1164018.09,1814905.63,2978923.72
330080,201701,1398,678,720,631061.75,673703.3,1304765.05
330090,201701,349,201,148,188337,138676,327013
330093,201701,273,120,153,111503.55,143361,254864.55
330095,201701,99,49,50,45913,46850,92763
330100,201701,8783,4618,4165,4320056.84,3898763.4,8218820.24
330110,201701,468,206,262,191382.8,245494,436876.8
330115,201701,497,287,210,268919,196770,465689
330120,201701,348,180,168,167535.6,156947.5,324483.1
330130,201701,1322,430,892,402197.88,835777,1237974.88
330140,201701,595,309,286,289515,267046,556561
330150,201701,429,254,175,236124.07,163038,399162.07
330160,201701,205,127,78,118999,73086,192085
330170,201701,25066,8791,16275,8217847.02,15233348.65,23451195.67
330180,201701,231,150,81,136175.75,75194.25,211370.00
330185,201701,715,310,405,288962.1,379467,668429.1
330187,201701,242,84,158,78708,148046,226754
330190,201701,5429,2152,3277,2007734.25,3066564.98,5074299.23
330200,201701,4040,1417,2623,1324872.7,2452952.38,3777825.08
330205,201701,394,243,151,227691,141487,369178
330210,201701,922,561,361,522847.8,336570.95,859418.75
330220,201701,2304,1355,949,1266825.1,888276.1,2155101.2
330225,201701,519,291,228,272040,213636,485676
330227,201701,2307,813,1494,758679.63,1399593.32,2158272.95
330230,201701,193,112,81,104944,75897,180841
330240,201701,3320,1722,1598,1609491.04,1495230.72,3104721.76
330245,201701,139,56,83,52472,77021.4,129493.4
330250,201701,6063,3139,2924,2932863.7,2733845.26,5666708.96
330260,201701,510,154,356,144298,333572,477870
330270,201701,3118,1169,1949,1094229.5,1825840,2920069.5
330280,201701,440,292,148,270812.34,138667,409479.34
330285,201701,6673,2254,4419,2107191.4,4137355.2,6244546.6
330290,201701,570,224,346,208952,323921,532873
330300,201701,703,487,216,452571.85,202383,654954.85
330310,201701,403,240,163,223006.35,152731,375737.35
330320,201701,7205,2717,4488,2537961.7,4201368.2,6739329.9
330330,201701,9321,3565,5756,3336423.67,5389054.61,8725478.28
330340,201701,2552,1528,1024,1429838.53,959469.26,2389307.79
330350,201701,16842,6672,10170,6225859.84,9510393.48,15736253.32
330360,201701,2600,1291,1309,1208524.7,1226533,2435057.7
330370,201701,965,519,446,485553.4,416216.4,901769.8
330380,201701,807,345,462,322532.77,432425.9,754958.67
330385,201701,593,315,278,294219,260486,554705
330390,201701,4954,2709,2245,2526542.69,2101781.92,4628324.61
330395,201701,210,132,78,121998.05,70603.5,192601.55
330400,201701,616,313,303,291032.7,281619.54,572652.24
330410,201701,483,344,139,320680.63,130243,450923.63
330411,201701,222,129,93,120873,87141,208014
330412,201701,244,106,138,99041,129306,228347
330414,201701,6181,2543,3638,2379270.4,3405416.75,5784687.15
330415,201701,529,246,283,230502,264234.4,494736.4
330420,201701,2242,1184,1058,1106016.67,989192.3,2095208.97
330430,201701,1729,701,1028,656079.1,961550,1617629.1
330440,201701,237,103,134,96511,125558,222069
330450,201701,130,54,76,49661,71212,120873
330452,201701,1574,700,874,654242.28,818928.63,1473170.91
330455,201701,106180,37594,68586,35152440.19,64205623.19,99358063.38
330460,201701,262,108,154,101196,144298,245494
330470,201701,1207,656,551,609005.35,516277.63,1125282.98
330475,201701,1367,380,987,353437.7,924247.43,1277685.13
330480,201701,701,376,325,352312,303589,655901
330490,201701,12874,4615,8259,4317486.84,7731819.5,12049306.34
330500,201701,1295,600,695,562200,650841,1213041
330510,201701,10812,3401,7411,3182287.7,6937740.41,10120028.11
330513,201701,104,52,52,48724,48724,97448
330515,201701,836,347,489,323266.4,457912,781178.4
330520,201701,2258,873,1385,817786,1296714.3,2114500.3
330530,201701,229,119,110,111503,102883,214386
330540,201701,355,177,178,165849,166318,332167
330550,201701,3040,1072,1968,1003888,1842824.95,2846712.95
330555,201701,689,250,439,234250,410969,645219
330560,201701,497,188,309,176156,289524,465680
330570,201701,237,159,78,148983,73086,222069
330575,201701,714,327,387,306165,360599.75,666764.75
330580,201701,3243,1822,1421,1702338.64,1330259.1,3032597.74
330590,201701,291,154,137,144298,128369,272667
330600,201701,999,644,355,602266.62,331885.4,934152.02
330610,201701,1456,807,649,750052.61,604086.45,1354139.06
330615,201701,180,140,40,131180,37480,168660
330620,201701,845,408,437,377801.06,407031.3,784832.36
330630,201701,3372,2087,1285,1942586.13,1195483.58,3138069.71
350010,201701,607,396,211,369335,197707,567042
350020,201701,35,17,18,15929,16866,32795
350030,201701,505,328,177,306212,164680.66,470892.66
350040,201701,128,49,79,45575.68,73742,119317.68
350050,201701,286,154,132,144016.9,123431.63,267448.53
350055,201701,84,47,37,44039,34669,78708
350060,201701,76,26,50,24362,46850,71212
350070,201701,777,448,329,415351.99,306511.68,721863.67
350075,201701,64,42,22,39354,20614,59968
350080,201701,48,28,20,25611.3,17803,43414.3
350090,201701,99,57,42,53409,39349.32,92758.32
350100,201701,305,188,117,175453.25,109629,285082.25
350110,201701,65,38,27,35606,25299,60905
350115,201701,152,88,64,81800.1,59968,141768.1
350120,201701,110,74,36,69338,33732,103070
350130,201701,350,166,184,154980,172408,327388
350140,201701,34,21,13,18178.4,12181,30359.4
350150,201701,67,52,15,48724,14055,62779
350160,201701,2426,912,1514,851248.67,1417880.26,2269128.93
350170,201701,397,240,157,222725.25,146828,369553.25
350180,201701,175,91,84,84986,78708,163694
350190,201701,818,389,429,362525.84,401396.85,763922.69
350200,201701,73,26,47,24160.46,43778.8,67939.26
350210,201701,1331,740,591,684415.96,553570.23,1237986.19
350220,201701,665,568,97,528158.75,90889,619047.75
350230,201701,74,54,20,50598,18740,69338
350240,201701,62,47,15,44039,14055,58094
350250,201701,1165,583,582,540324.15,544809.93,1085134.08
350260,201701,91,66,25,61842,23425,85267
350270,201701,811,540,271,504722.03,252202.65,756924.68
350275,201701,289,114,175,106444,163975,270419
350280,201701,4557,2324,2233,2165746.18,2090197.48,4255943.66
350290,201701,394,186,208,174001,193396.9,367397.9
350300,201701,50,24,26,22488,24362,46850
350310,201701,101,71,30,66527,28110,94637
350315,201701,37,20,17,18740,15929,34669
350320,201701,3190,1560,1630,1458208.35,1527076.52,2985284.87
350330,201701,1633,859,774,802652,724237.7,1526889.7
350335,201701,21,14,7,13118,6559,19677
350340,201701,133,72,61,67464,57157,124621
350350,201701,94,45,49,42165,45913,88078
350360,201701,129,85,44,79641,40947,120588
350370,201701,92,54,38,49973.3,35596.63,85569.93
350380,201701,719,298,421,278570.1,394195.9,672766.0
350390,201701,1340,555,785,519251.25,734139.6,1253390.85
350395,201701,27,19,8,17803,7496,25299
350400,201701,1666,876,790,810160.63,737678.26,1547838.89
350410,201701,2182,965,1217,901452.88,1140019.9,2041472.78
350420,201701,240,143,97,132662.54,90889,223551.54
350430,201701,74,42,32,38792,29984,68776
350440,201701,151,108,43,100212.25,40291,140503.25
350450,201701,1608,1040,568,967387.9,532123,1499510.9
350460,201701,327,119,208,111503,194614.9,306117.9
350470,201701,13,10,3,9370,2811,12181
350480,201701,153,83,70,77771,65590,143361
350490,201701,246,115,131,107755,122747,230502
350500,201701,35,15,20,14055,18735.32,32790.32
350510,201701,159,106,53,99322,49661,148983
350520,201701,438,192,246,177406,229877.3,407283.3
350530,201701,439,211,228,197707,213636,411343
350535,201701,56,44,12,40854,11244,52098
350540,201701,376,193,183,179968.47,171190,351158.47
350550,201701,2696,1569,1127,1463365.05,1055003.19,2518368.24
350560,201701,624,429,195,401968.32,182354.97,584323.29
350570,201701,4279,1769,2510,1652412.27,2349407.1,4001819.37
350580,201701,368,175,193,163351,180546.53,343897.53
350590,201701,895,482,413,451634,386044.3,837678.3
350600,201701,6002,3022,2980,2819827.65,2789157.3,5608984.95
350610,201701,1538,759,779,706339,728696,1435035
350620,201701,40,27,13,25299,12181,37480
350630,201701,235,138,97,128369.3,89953,218322.3
350635,201701,803,307,496,287378,464116.54,751494.54
350640,201701,117,86,31,80582,29047,109629
350650,201701,1843,1221,622,1140461.45,581806.1,1722267.55
350660,201701,726,331,395,310147,369178,679325
350670,201701,314,155,159,145001,148983,293984
350680,201701,176,98,78,91826,72805,164631
350690,201701,199,101,98,94637,91826,186463
350700,201701,648,313,335,290288.09,313895,604183.09
350710,201701,302,126,176,116875.1,164912,281787.1
350715,201701,43,38,5,35606,4685,40291
350720,201701,18,14,4,13118,3748,16866
350730,201701,38,24,14,22488,13118,35606
350740,201701,190,106,84,99040.9,78708,177748.9
350745,201701,23,11,12,10283,11244,21527
350750,201701,2051,1344,707,1251693.05,661522,1913215.05
350760,201701,3570,1561,2009,1461720.3,1880540.63,3342260.93
350770,201701,59,39,20,36543,18740,55283
350775,201701,47,34,13,31858,12172,44030
350780,201701,404,204,200,191148,187400,378548
350790,201701,384,167,217,156479,203329,359808
350800,201701,416,229,187,214573,175219,389792
350810,201701,483,385,98,358872.3,91826,450698.3
350820,201701,78,50,28,46850,26236,73086
350830,201701,82,48,34,44976,31858,76834
350840,201701,724,327,397,306118,371052,677170
350850,201701,1656,960,696,893580.26,652139,1545719.26
350860,201701,522,301,221,280146.26,207077,487223.26
350870,201701,413,281,132,263297,123309.9,386606.9
350880,201701,286,159,127,146174.55,118999,265173.55
350890,201701,41,25,16,23425,14992,38417
350900,201701,1333,440,893,410330.19,835991.4,1246321.59
350910,201701,26,18,8,16866,7496,24362
350920,201701,563,316,247,295779.7,231439,527218.7
350925,201701,1160,622,538,578961.77,502700.6,1081662.37
350930,201701,93,58,35,54346,32795,87141
350940,201701,674,365,309,340505.8,287724.8,628230.6
350945,201701,100,78,22,73086,20614,93700
350950,201701,14372,6853,7519,6392292.07,7033537.74,13425829.81
350960,201701,1259,563,696,523215.9,652148,1175363.9
350970,201701,1097,621,476,579650.3,445721.63,1025371.93
350980,201701,101,68,33,63716,30921,94637
350990,201701,356,125,231,116441,216165.9,332606.9
350995,201701,27,13,14,12181,13118,25299
351000,201701,633,457,176,426024.26,164912,590936.26
351010,201701,52,27,25,25299,23425,48724
351015,201701,61,42,19,39354,17803,57157
351020,201701,1648,928,720,867860.64,672579.2,1540439.84
351030,201701,313,220,93,203610.4,87141,290751.4
351040,201701,803,434,369,405721,344816.15,750537.15
351050,201701,3106,1508,1598,1406675.04,1495192.91,2901867.95
351060,201701,4737,1937,2800,1806080.59,2620333.71,4426414.30
351070,201701,414,265,149,247996,139613,387609
351080,201701,789,559,230,523783,214573,738356
351090,201701,64,29,35,27173,32795,59968
351100,201701,440,252,188,233941.35,176142.32,410083.67
351110,201701,2124,1027,1097,955864.22,1025392.63,1981256.85
351120,201701,74,40,34,37396.6,31858,69254.6
351130,201701,170,55,115,51535,107755,159290
351140,201701,334,234,100,217478.5,93700,311178.5
351150,201701,380,192,188,179061,175875,354936
351160,201701,237,154,83,144298,77771,222069
351170,201701,173,83,90,77771,83581,161352
351190,201701,86,59,27,55283,25299,80582
351200,201701,372,241,131,225536,122747,348283
351210,201701,128,60,68,56220,63716,119936
351220,201701,510,308,202,285566.81,189274,474840.81
351230,201701,282,203,79,189305.3,73379.56,262684.86
351240,201701,227,93,134,87141,125558,212699
351250,201701,66,46,20,43102,18740,61842
351260,201701,150,109,41,102133,38417,140550
351270,201701,51,22,29,20614,27173,47787
351280,201701,1106,508,598,472250.35,559811.39,1032061.74
351290,201701,217,97,120,90889,112159,203048
351300,201701,3766,1769,1997,1650763.13,1870877,3521640.13
351310,201701,739,388,351,362338,328887,691225
351320,201701,101,60,41,56220,38417,94637
351330,201701,37,25,12,23425,11244,34669
351340,201701,1167,730,437,677144.39,408516,1085660.39
351350,201701,2212,1171,1041,1096853,974569.22,2071422.22
351360,201701,762,381,381,355123,355883.19,711006.19
351370,201701,361,188,173,176151.32,161476.3,337627.62
351380,201701,8898,4090,4808,3815770.55,4494251.57,8310022.12
351385,201701,28,19,9,17803,8433,26236
351390,201701,269,195,74,181985.26,69338,251323.26
351400,201701,61,37,24,34669,22442.63,57111.63
351410,201701,405,249,156,232844.5,146172,379016.5
351420,201701,61,50,11,46850,10307,57157
351430,201701,82,46,36,43102,33732,76834
351440,201701,784,530,254,494452.2,237994,732446.2
351450,201701,242,124,118,116188,110566,226754
351460,201701,122,53,69,49661,64653,114314
351470,201701,144,77,67,72140,62779,134919
351480,201701,529,283,246,264234.1,230384.88,494618.98
351490,201701,294,100,194,93700,181778,275478
351492,201701,31,23,8,21551,7496,29047
351495,201701,31,19,12,17803,11244,29047
351500,201701,3479,1483,1996,1383180.72,1865443.1,3248623.82
351510,201701,1743,718,1025,672484.9,958003.25,1630488.15
351512,201701,18,14,4,13118,3748,16866
351515,201701,193,109,84,102133,78708,180841
351518,201701,709,427,282,399158,264093.45,663251.45
351519,201701,77,49,28,45913,26236,72149
351520,201701,137,86,51,79957.3,47787,127744.3
351530,201701,19,15,4,14055,3748,17803
351535,201701,132,74,58,69338,54346,123684
351540,201701,417,298,119,276886,111503,388389
351550,201701,1240,760,480,706938.7,449750.63,1156689.33
351560,201701,74,38,36,35606,33732,69338
351565,201701,13,7,6,6559,5622,12181
351570,201701,2511,1311,1200,1226894.63,1123753.26,2350647.89
351580,201701,34,29,5,27173,4685,31858
351590,201701,66,47,19,44039,17803,61842
351600,201701,187,134,53,125558,49661,175219
351610,201701,60,26,34,24362,31858,56220
351620,201701,5946,3397,2549,3172986.51,2383558.73,5556545.24
351630,201701,2420,1242,1178,1158815.69,1102188.42,2261004.11
351640,201701,1639,781,858,730175.99,802166.3,1532342.29
351650,201701,32,28,4,26236,3748,29984
351660,201701,159,95,64,89015,59968,148983
351670,201701,706,439,267,408579.9,250179,658758.9
351680,201701,77,61,16,57157,14992,72149
351685,201701,39,25,14,23425,13118,36543
351690,201701,311,218,93,202153.07,87141,289294.07
351700,201701,158,109,49,102133,45913,148046
351710,201701,69,48,21,44976,19677,64653
351720,201701,137,66,71,61842,66527,128369
351730,201701,90,65,25,60905,23420.32,84325.32
351740,201701,709,471,238,441046,223001.32,664047.32
351750,201701,348,146,202,135865.7,189265,325130.7
351760,201701,787,605,182,566885,170534,737419
351770,201701,279,244,35,227692,32795,260487
351780,201701,170,91,79,85267,74023,159290
351790,201701,240,126,114,118062,106818,224880
351800,201701,50,31,19,29047,17803,46850
351810,201701,119,74,45,69057,42165,111222
351820,201701,874,625,249,581340.9,233308.32,814649.22
351830,201701,498,185,313,172595.4,293281,465876.4
351840,201701,1772,916,856,848804.75,800330.47,1649135.22
351850,201701,221,167,54,155589.8,50598,206187.8
351860,201701,740,482,258,448823.77,241741.32,690565.09
351870,201701,5545,2622,2923,2448084.62,2732906.45,5180991.07
351880,201701,18667,8243,10424,7701037.75,9752180.69,17453218.44
351885,201701,97,64,33,59968,30921,90889
351890,201701,74,63,11,59031,10307,69338
351900,201701,217,131,86,122092,80582,202674
351905,201701,73,32,41,29984,38417,68401
351907,201701,2988,1323,1665,1236208.23,1559061.22,2795269.45
351910,201701,173,71,102,66527,95574,162101
351920,201701,141,84,57,78708,53386.96,132094.96
351925,201701,80,55,25,51535,23425,74960
351930,201701,378,256,122,239778.3,114314,354092.3
351940,201701,229,105,124,98385,116188,214573
351950,201701,141,79,62,73711,58094,131805
351960,201701,786,362,424,338862.58,395507.8,734370.38
351970,201701,1861,980,881,916152.04,824926,1741078.04
351980,201701,136,69,67,62779,62779,125558
351990,201701,285,191,94,178030,87290.92,265320.92
352000,201701,343,202,141,188899.2,132117,321016.2
352010,201701,334,194,140,181778,131180,312958
352020,201701,193,71,122,66527,114314,180841
352030,201701,979,496,483,463768.25,450699.84,914468.09
352040,201701,563,245,318,229565,297966,527531
352042,201701,249,88,161,82456,150576,233032
352044,201701,374,223,151,208389,141487,349876
352050,201701,3086,1258,1828,1172582.8,1711757.53,2884340.33
352060,201701,99,63,36,59031,33577,92608
352070,201701,93,68,25,62780,23425,86205
352080,201701,64,38,26,34669,24362,59031
352090,201701,171,116,55,108692,51535,160227
352100,201701,247,123,124,115251,115056,230307
352110,201701,112,34,78,31858,73086,104944
352115,201701,75,29,46,27173,43102,70275
352120,201701,103,61,42,57157,39354,96511
352130,201701,220,185,35,173157.6,32795,205952.6
352140,201701,183,72,111,66996,104007,171003
352150,201701,125,70,55,64653.7,51535,116188.7
352160,201701,126,85,41,79645,38417,118062
352170,201701,372,253,119,236124.7,111503,347627.7
352180,201701,586,403,183,375598.55,171471,547069.55
352190,201701,268,101,167,94627.63,156432.15,251059.78
352200,201701,32,19,13,17803,12181,29984
352210,201701,3526,1449,2077,1352260.8,1940804.97,3293065.77
352215,201701,48,29,19,27112.67,17272.8,44385.47
352220,201701,6955,2743,4212,2566110.93,3944195.72,6510306.65
352230,201701,3040,1939,1101,1803617.16,1026201.96,2829819.12
352240,201701,2094,1243,851,1162677.69,795232.25,1957909.94
352250,201701,2509,1325,1184,1237419.35,1107396.7,2344816.05
352260,201701,1121,636,485,594705.32,454164,1048869.32
352265,201701,67,31,36,29047,33732,62779
352270,201701,382,218,164,203329.84,153613,356942.84
352280,201701,371,231,140,216135,130899,347034
352290,201701,168,107,61,99697,57157,156854
352300,201701,103,79,24,74023,22488,96511
352310,201701,5482,2696,2786,2514975.68,2605973.27,5120948.95
352320,201701,899,485,414,451853.99,384967.55,836821.54
352330,201701,529,229,300,213214.37,280819,494033.37
352340,201701,1366,664,702,618628.5,656931,1275559.5
352350,201701,309,198,111,185526,103726,289252
352360,201701,223,86,137,79691.85,125819,205510.85
352370,201701,102,69,33,64653,30921,95574
352380,201701,113,70,43,65590,40291,105881
352390,201701,2384,1077,1307,1004774.9,1222317.64,2227092.54
352400,201701,460,195,265,182012.25,248023.9,430036.15
352410,201701,718,514,204,478407.2,190024.19,668431.39
352420,201701,103,62,41,58094,38417,96511
352430,201701,1735,775,960,719618.55,897570.59,1617189.14
352440,201701,2986,1534,1452,1430594.1,1356745.4,2787339.5
352450,201701,189,158,31,148046,29047,177093
352460,201701,562,288,274,269589.64,255380.2,524969.84
352470,201701,537,187,350,175219,327941,503160
352480,201701,1363,761,602,712433,563511.9,1275944.9
352490,201701,79,31,48,29047,44976,74023
352500,201701,1213,543,670,506730.8,626376,1133106.8
352510,201701,729,389,340,363556.3,318580,682136.3
352520,201701,496,211,285,197707,266904.45,464611.45
352530,201701,1682,874,808,818656.9,755779.62,1574436.52
352540,201701,76,49,27,45913,25299,71212
352550,201701,181,103,78,96511,72676.53,169187.53
352560,201701,52,41,11,38417,10307,48724
352570,201701,632,331,301,309544.63,282037,591581.63
352580,201701,58,40,18,36543.33,16866,53409.33
352585,201701,13,4,9,3748,8433,12181
352590,201701,4147,2068,2079,1933374.6,1947043.48,3880418.08
352600,201701,355,246,109,229565.3,102124,331689.3
352610,201701,908,430,478,400223.51,447886,848109.51
352620,201701,967,387,580,361682.1,543460,905142.1
352630,201701,212,76,136,71212,127000.98,198212.98
352640,201701,525,359,166,335031.88,155542,490573.88
352650,201701,94,64,30,59968,28110,88078
352660,201701,82,50,32,46850,29984,76834
352670,201701,1601,870,731,811777.93,683900.48,1495678.41
352680,201701,895,571,324,531804.58,302339.2,834143.78
352690,201701,4210,1928,2282,1798632,2134624.27,3933256.27
352700,201701,112,62,50,58094,46850,104944
352710,201701,1261,660,601,616546.35,560888.6,1177434.95
352720,201701,1174,589,585,549395.1,548140.32,1097535.42
352725,201701,25,24,1,22488,937,23425
352730,201701,348,172,176,160006.81,164912,324918.81
352740,201701,406,253,153,236124.14,143361,379485.14
352750,201701,24,16,8,14710.9,7496,22206.9
352760,201701,191,138,53,129306,49661,178967
352770,201701,84,67,17,61562,15929,77491
352780,201701,89,47,42,44039,39354,83393
352790,201701,23,19,4,17803,3748,21551
352800,201701,246,167,79,156479,73741.9,230220.9
352810,201701,155,102,53,94981,49661,144642
352820,201701,58,49,9,45495.1,8433,53928.1
352830,201701,88,62,26,58094,24362,82456
352840,201701,546,285,261,265781.1,244276,510057.1
352850,201701,1279,462,817,432238.1,765127,1197365.1
352860,201701,122,80,42,74960,39354,114314
352870,201701,36,22,14,20614,13118,33732
352880,201701,190,133,57,124621,53409,178030
352885,201701,29,20,9,18740,8433,27173
352890,201701,52,36,16,33732,14992,48724
352900,201701,4915,2348,2567,2183592.86,2398582.29,4582175.15
352910,201701,39,29,10,27173,9370,36543
352920,201701,705,432,273,403847,255801,659648
352930,201701,1246,592,654,553042.22,609250.04,1162292.26
352940,201701,6245,2713,3532,2530014.07,3305410.28,5835424.35
352950,201701,91,38,53,35324.9,49661,84985.9
352960,201701,63,40,23,37480,21551,59031
352965,201701,22,9,13,8433,12181,20614
352970,201701,457,333,124,308871.14,115251.7,424122.84
352980,201701,180,89,91,83393,85267,168660
352990,201701,867,409,458,379611.14,427675.79,807286.93
353000,201701,69,32,37,29984,34669,64653
353010,201701,559,337,222,315769,207995.27,523764.27
353020,201701,296,212,84,198644,78708,277352
353030,201701,1096,514,582,480653.1,544659.73,1025312.83
353040,201701,84,53,31,49661,29047,78708
353050,201701,1266,775,491,720898.55,460067,1180965.55
353060,201701,7149,3401,3748,3174038.38,3504892.89,6678931.27
353070,201701,1580,970,610,902976,570303.04,1473279.04
353080,201701,1279,660,619,617060.72,579157.32,1196218.04
353090,201701,59,37,22,34669,20614,55283
353100,201701,63,52,11,48724,10307,59031
353110,201701,1753,590,1163,551125.63,1088032.32,1639157.95
353120,201701,64,32,32,29984,29984,59968
353130,201701,845,413,432,386025.63,404746.89,790772.52
353140,201701,577,224,353,209565,330761,540326
353150,201701,361,200,161,186463.3,150847.63,337310.93
353160,201701,104,84,20,78708,18740,97448
353170,201701,199,65,134,60895.63,125530.63,186426.26
353180,201701,932,432,500,403551.95,467985,871536.95
353190,201701,450,319,131,297864.95,122747,420611.95
353200,201701,179,85,94,79364,88078,167442
353205,201701,26,18,8,16866,7496,24362
353210,201701,83,50,33,46850,30921,77771
353215,201701,58,35,23,32795,21551,54346
353220,201701,78,43,35,40291,31858.93,72149.93
353230,201701,160,61,99,57157,92763,149920
353240,201701,264,144,120,134928,112440,247368
353250,201701,199,104,95,97448,89015,186463
353260,201701,404,304,100,283733.25,93690.63,377423.88
353270,201701,68,51,17,47787,15929,63716
353280,201701,94,48,46,44976,43102,88078
353282,201701,104,76,28,71212,26236,97448
353284,201701,21,17,4,15929,3748,19677
353286,201701,2,2,0,1874,0,1874
353290,201701,81,49,32,45913,29975,75888
353300,201701,378,214,164,199003.55,153668,352671.55
353310,201701,50,45,5,42165,4685,46850
353320,201701,53,36,17,33732,15929,49661
353325,201701,56,36,20,33732,18441,52173
353330,201701,67,50,17,46055,15929,61984
353340,201701,579,185,394,172814.03,368606.54,541420.57
353350,201701,900,420,480,392734.92,448498,841232.92
353360,201701,111,88,23,82143.7,21270,103413.7
353370,201701,119,72,47,66527.55,44039,110566.55
353380,201701,30,20,10,18736,9370,28106
353390,201701,1006,499,507,467563,475059,942622
353400,201701,45,26,19,24362,17803,42165
353410,201701,121,74,47,67876.28,43337.1,111213.38
353420,201701,53,23,30,21551,28110,49661
353430,201701,533,345,188,319797.48,175724.9,495522.38
353440,201701,10233,4451,5782,4161999.39,5410961.85,9572961.24
353450,201701,57,28,29,26236,27173,53409
353460,201701,595,311,284,287260.99,264460.25,551721.24
353470,201701,2104,1141,963,1064298.36,900887.14,1965185.50
353475,201701,229,154,75,141659.3,70275,211934.3
353480,201701,192,154,38,144298,35606,179904
353490,201701,219,131,88,122747,82456,205203
353500,201701,184,111,73,102789.3,68401,171190.3
353510,201701,102,75,27,70256.63,25289.63,95546.26
353520,201701,207,144,63,134928,59031,193959
353530,201701,431,232,199,216479,186463,402942
353540,201701,346,228,118,213319.02,110566,323885.02
353550,201701,710,480,230,446668.85,215510,662178.85
353560,201701,617,258,359,240809.6,336360.32,577169.92
353570,201701,60,31,29,29047,27173,56220
353580,201701,361,281,80,262829,74960,337789
353590,201701,81,56,25,52472,23425,75897
353600,201701,257,149,108,139020,101196,240216
353610,201701,112,60,52,56220,48724,104944
353620,201701,534,290,244,269497.25,228346.9,497844.15
353625,201701,52,24,28,22488,26236,48724
353630,201701,233,168,65,153163.07,60905,214068.07
353640,201701,121,81,40,74960.5,37480,112440.5
353650,201701,789,313,476,291688.1,446012,737700.1
353657,201701,20,14,6,13118,5622,18740
353660,201701,253,143,110,133991,102788.9,236779.9
353670,201701,674,400,274,373863,256738,630601
353680,201701,101,73,28,68401,26236,94637
353690,201701,44,35,9,32795,8433,41228
353700,201701,288,204,84,191148,78708,269856
353710,201701,401,188,213,175219.4,199581,374800.4
353715,201701,45,37,8,34387.9,7496,41883.9
353720,201701,366,159,207,148965,193930,342895
353730,201701,1091,669,422,623434.45,395414,1018848.45
353740,201701,634,359,275,336102,257675,593777
353750,201701,105,64,41,59445.62,38417,97862.62
353760,201701,2536,944,1592,881225.2,1487878.69,2369103.89
353770,201701,100,82,18,76365.5,16866,93231.5
353780,201701,1024,530,494,493931,462268.95,956199.95
353790,201701,498,288,210,268572.85,196650,465222.85
353800,201701,3231,1663,1568,1547468.97,1465800.3,3013269.27
353810,201701,233,128,105,119927,98358,218285
353820,201701,175,89,86,83393,79968.54,163361.54
353830,201701,46,39,7,36543,6559,43102
353850,201701,167,88,79,82456,74023,156479
353860,201701,463,205,258,190726.35,241218.47,431944.82
353870,201701,4840,2403,2437,2239919.4,2274368.2,4514287.6
353880,201701,626,441,185,411765.2,172408.36,584173.56
353890,201701,569,308,261,288034,244557,532591
353900,201701,138,67,71,62779,66527,129306
353910,201701,184,88,96,82456,89952,172408
353920,201701,450,244,206,226801.8,193008.64,419810.44
353930,201701,944,569,375,531190.64,350209.9,881400.54
353940,201701,185,102,83,94824.4,76928,171752.4
353950,201701,518,320,198,299810.63,185526,485336.63
353960,201701,69,55,14,51535,13118,64653
353970,201701,73,47,26,44039,24362,68401
353980,201701,1478,730,748,681403.59,700868,1382271.59
353990,201701,76,45,31,42165,29047,71212
354000,201701,373,171,202,158223.36,189082.6,347305.96
354010,201701,96,49,47,45913,44039,89952
354020,201701,534,328,206,306399,192740.9,499139.9
354025,201701,52,43,9,40291,8433,48724
354030,201701,61,31,30,29047,28110,57157
354040,201701,92,67,25,62779,23425,86204
354050,201701,176,102,74,95293,69338,164631
354060,201701,758,376,382,352312,356061.65,708373.65
354070,201701,851,484,367,451661.52,343879,795540.52
354075,201701,192,105,87,98292,80582.9,178874.9
354080,201701,277,121,156,113377,146172,259549
354085,201701,19,12,7,11244,6559,17803
354090,201701,320,174,146,162959,136802,299761
354100,201701,5347,2184,3163,2038349.57,2959206.55,4997556.12
354105,201701,82,41,41,38417,38417,76834
354110,201701,44,20,24,18740,22488,41228
354120,201701,144,101,43,94500.29,40291,134791.29
354130,201701,669,450,219,421416,204922,626338
354140,201701,3127,1453,1674,1357842.42,1567493.62,2925336.04
354150,201701,608,379,229,353905,213167.5,567072.5
354160,201701,654,399,255,372692,238654,611346
354165,201701,17,12,5,11244,4685,15929
354170,201701,167,112,55,104288.1,51535,155823.1
354180,201701,68,42,26,39034,24362,63396
354190,201701,202,93,109,85548.1,102133,187681.1
354200,201701,127,69,58,64185,54346,118531
354210,201701,76,38,38,35606,35606,71212
354220,201701,626,400,226,374229.1,210825.18,585054.28
354230,201701,154,63,91,59031,84330.8,143361.8
354240,201701,319,207,112,192741.69,104319.3,297060.99
354250,201701,87,49,38,45913,35606,81519
354260,201701,1836,852,984,786283.56,919754,1706037.56
354270,201701,91,66,25,61842,23425,85267
354280,201701,29,15,14,14055,13118,27173
354290,201701,147,100,47,92435.55,44039,136474.55
354300,201701,419,286,133,267670,124621,392291
354310,201701,99,72,27,66527.1,25299,91826.1
354320,201701,183,94,89,88078,83393,171471
354323,201701,14,12,2,11244,1874,13118
354325,201701,114,61,53,56875.9,49661,106536.9
354330,201701,2431,833,1598,775665.74,1495197.69,2270863.43
354340,201701,10580,5071,5509,4734234.57,5158661.62,9892896.19
354350,201701,126,84,42,78708,39213.45,117921.45
354360,201701,85,44,41,41228,38417,79645
354370,201701,256,136,120,127432,112440,239872
354380,201701,203,119,84,110729,78708,189437
354390,201701,2735,979,1756,916746.86,1643284.08,2560030.94
354400,201701,324,162,162,150717.9,150950.8,301668.7
354410,201701,585,285,300,266104.32,280163.1,546267.42
354420,201701,257,165,92,154605,86204,240809
354425,201701,299,167,132,156479,123019.1,279498.1
354430,201701,191,125,66,114801.95,61092.4,175894.35
354440,201701,45,32,13,29866,12181,42047
354450,201701,43,28,15,26236,14055,40291
354460,201701,92,54,38,50598,35606,86204
354470,201701,38,28,10,26236,9370,35606
354480,201701,114,63,51,59022,47777.63,106799.63
354490,201701,144,90,54,84173.81,50598,134771.81
354500,201701,399,193,206,180841,193022,373863
354510,201701,108,73,35,68297.56,32795,101092.56
354515,201701,39,16,23,14992,21551,36543
354520,201701,1547,697,850,650581.6,796112.68,1446694.28
354530,201701,594,317,277,294682.5,257769.9,552452.4
354540,201701,271,148,123,138676,115246.32,253922.32
354550,201701,43,25,18,23425,16866,40291
354560,201701,153,87,66,81519,61832.63,143351.63
354570,201701,145,96,49,89952,45913,135865
354580,201701,1991,955,1036,892023,970438.22,1862461.22
354600,201701,284,155,129,143811.36,120868.32,264679.68
354610,201701,73,63,10,59031,9370,68401
354620,201701,66,19,47,17803,44039,61842
354625,201701,19,12,7,11244,6555,17799
354630,201701,341,224,117,209879,109629,319508
354640,201701,784,505,279,469954.2,261423,731377.2
354650,201701,73,37,36,34660,33686.26,68346.26
354660,201701,783,567,216,527796.85,202392,730188.85
354670,201701,280,97,183,90889,171471,262360
354680,201701,1217,453,764,424461,715400,1139861
354690,201701,91,61,30,56221,28110,84331
354700,201701,81,55,26,51535,24362,75897
354710,201701,55,38,17,34981.3,15929,50910.3
354720,201701,22,21,1,19677,937,20614
354730,201701,1917,813,1104,759420.5,1033167.4,1792587.9
354740,201701,56,40,16,37480,14992,52472
354750,201701,427,256,171,239863,160227,400090
354760,201701,491,299,192,279226.21,179623,458849.21
354765,201701,12,6,6,5622,5622,11244
354770,201701,317,223,94,207860.71,88078,295938.71
354780,201701,7997,3248,4749,3028830.48,4444866.15,7473696.63
354790,201701,118,67,51,62779,47787,110566
354800,201701,402,226,176,211762,164631,376393
354805,201701,103,51,52,47163,48724,95887
354810,201701,138,80,58,74678.9,54346,129024.9
354820,201701,178,75,103,70069,96511,166580
354830,201701,37,21,16,19677,14992,34669
354840,201701,52,33,19,30921,17803,48724
354850,201701,4542,2012,2530,1877494.47,2365757.86,4243252.33
354860,201701,334,163,171,152731,158161.62,310892.62
354870,201701,11166,5122,6044,4774699.38,5656992.98,10431692.36
354880,201701,2919,1081,1838,1009508.55,1720361.96,2729870.51
354890,201701,2789,1535,1254,1433338.54,1173770.54,2607109.08
354900,201701,60,39,21,36543,19677,56220
354910,201701,1142,603,539,563100.22,505043,1068143.22
354920,201701,53,45,8,42165,7496,49661
354925,201701,10,5,5,4685,4685,9370
354930,201701,34,29,5,26907,4685,31592
354940,201701,807,588,219,548569.84,205203,753772.84
354950,201701,231,148,83,138074,77771,215845
354960,201701,172,65,107,60905,99978,160883
354970,201701,800,512,288,475626.09,269228.31,744854.40
354980,201701,8134,3041,5093,2843234.26,4770327.35,7613561.61
354990,201701,8944,4197,4747,3923569.7,4441669.86,8365239.56
354995,201701,521,188,333,176156,311426.6,487582.6
355000,201701,450,145,305,135860.32,284661,420521.32
355010,201701,632,405,227,378548.45,210526.36,589074.81
355020,201701,718,449,269,418830.22,252045,670875.22
355030,201701,198222,76139,122083,71143903.49,114290417.8,185434321.29
355040,201701,684,327,357,306118,334321.6,640439.6
355050,201701,154,105,49,97179.77,45913,143092.77
355060,201701,1285,688,597,639895.97,557562.25,1197458.22
355070,201701,1450,706,744,658698.44,695955.6,1354654.04
355080,201701,198,115,83,107547.74,76899.9,184447.64
355090,201701,266,181,85,167537,79645,247182
355100,201701,4640,2336,2304,2171929.2,2156195.57,4328124.77
355110,201701,294,193,101,179108.55,94637,273745.55
355120,201701,117,84,33,78239.5,29985,108224.5
355130,201701,46,24,22,22488,20614,43102
355140,201701,184,122,62,114314,58094,172408
355150,201701,681,404,277,377607.1,259549,637156.1
355160,201701,421,193,228,178498.8,213636,392134.8
355170,201701,2020,1042,978,974999.45,915717.54,1890716.99
355180,201701,612,251,361,233968.9,337156.02,571124.92
355190,201701,206,141,65,132117,60905,193022
355200,201701,108,62,46,58094,43102,101196
355210,201701,666,389,277,364493,259521.63,624014.63
355220,201701,6296,3371,2925,3149464.78,2733510.32,5882975.10
355230,201701,106,62,44,58094,41223.32,99317.32
355240,201701,3966,1765,2201,1642116.53,2057988.09,3700104.62
355250,201701,5175,2527,2648,2360727.26,2478490.51,4839217.77
355255,201701,49,28,21,26236,19677,45913
355260,201701,183,108,75,101167.89,70257,171424.89
355270,201701,162,93,69,87141,63951,151092
355280,201701,5965,2525,3440,2360883.55,3218432.07,5579315.62
355290,201701,80,58,22,54346,20614,74960
355300,201701,174,118,56,110238.05,52472,162710.05
355310,201701,106,60,46,56220,43102,99322
355320,201701,94,48,46,44694.9,42406.3,87101.2
355330,201701,263,143,120,133991,112440,246431
355340,201701,1102,508,594,475059.68,555849.2,1030908.88
355350,201701,137,70,67,65590,62779,128369
355360,201701,164,95,69,88808.86,64653,153461.86
355365,201701,25,21,4,19677,3748,23425
355370,201701,1033,582,451,540515.96,420873.23,961389.19
355380,201701,745,511,234,476949.5,219166.34,696115.84
355385,201701,50,35,15,32795,14055,46850
355390,201701,103,58,45,54346,42165,96511
355395,201701,181,110,71,102269.32,66527,168796.32
355400,201701,1477,923,554,861860.68,517598.9,1379459.58
355410,201701,4722,2198,2524,2044572.28,2355968.7,4400540.98
355420,201701,41,31,10,29047,9370,38417
355430,201701,321,198,123,184870.1,115251,300121.1
355440,201701,75,42,33,39354,30921,70275
355450,201701,412,191,221,175595.32,206140.3,381735.62
355460,201701,72,56,16,51535.51,14992,66527.51
355465,201701,51,32,19,29984,17803,47787
355470,201701,185,69,116,63716.55,108692,172408.55
355475,201701,10,7,3,6559,2811,9370
355480,201701,445,190,255,176906,237051.63,413957.63
355490,201701,106,78,28,73086,26236,99322
355495,201701,50,25,25,23425,23425,46850
355500,201701,1682,947,735,882830.14,688093.86,1570924.00
355510,201701,263,197,66,181192.5,61842,243034.5
355520,201701,33,25,8,23425,7496,30921
355530,201701,20,15,5,14055,4685,18740
355535,201701,74,33,41,30921,38417,69338
355540,201701,2248,903,1345,844546.31,1259309.63,2103855.94
355550,201701,66,40,26,37480,24362,61842
355560,201701,225,118,107,110566,99634.3,210200.3
355570,201701,29,18,11,16866,10307,27173
355580,201701,270,180,90,168660,84325.32,252985.32
355590,201701,22,14,8,13118,7496,20614
355600,201701,274,142,132,133054,123398.32,256452.32
355610,201701,198,129,69,120873,64653,185526
355620,201701,1195,545,650,508931.9,608483.8,1117415.7
355630,201701,408,286,122,267046,114314,381360
355635,201701,123,60,63,56220,59018,115238
355640,201701,573,332,241,310147,225817,535964
355645,201701,822,352,470,327225.64,438544.21,765769.85
355650,201701,1878,861,1017,805512,952629.63,1758141.63
355660,201701,270,142,128,133054,119931.32,252985.32
355670,201701,443,161,282,150857,264234,415091
355680,201701,211,114,97,106818,90889,197707
355690,201701,83,40,43,37480,39953,77433
355695,201701,15,13,2,12181,1874,14055
355700,201701,1083,583,500,540712.71,468219,1008931.71
355710,201701,2116,1161,955,1082949.68,894245,1977194.68
355715,201701,18,16,2,14992,1874,16866
355720,201701,201,125,76,115563.66,71208,186771.66
355730,201701,81,50,31,45991.53,29047,75038.53
410010,201701,125,106,19,99322,17803,117125
410020,201701,102,91,11,85267,10307,95574
410030,201701,160,102,58,95293,54346,149639
410040,201701,970,507,463,474543.65,433362.9,907906.55
410045,201701,33,29,4,27173,3748,30921
410050,201701,467,261,206,244557,192272.5,436829.5
410060,201701,256,198,58,184964,54346,239310
410070,201701,331,263,68,246431,63716,310147
410080,201701,164,108,56,101196,52472,153668
410090,201701,75,64,11,59762,10307,70069
410100,201701,290,203,87,190211,81519,271730
410105,201701,40,25,15,23425,14055,37480
410110,201701,308,184,124,172408,116188,288596
410115,201701,26,17,9,15929,8433,24362
410120,201701,437,222,215,207717.9,201455,409172.9
410130,201701,41,27,14,25299,13118,38417
410140,201701,2963,1439,1524,1343194.63,1427041.63,2770236.26
410150,201701,2651,1056,1595,988778.09,1494022.5,2482800.59
410160,201701,478,310,168,289252.9,157416,446668.9
410165,201701,63,39,24,36543,22488,59031
410170,201701,159,124,35,113992.83,32795,146787.83
410180,201701,1997,1152,845,1075508.28,790614.48,1866122.76
410185,201701,43,39,4,36543,3748,40291
410190,201701,394,241,153,225817,143361,369178
410200,201701,947,713,234,666464.18,219258,885722.18
410210,201701,536,273,263,255801,245869,501670
410220,201701,38,21,17,19677,15929,35606
410230,201701,123,72,51,67464,47787,115251
410240,201701,692,449,243,420150.9,227691,647841.9
410250,201701,383,286,97,267388.6,90868.89,358257.49
410260,201701,307,167,140,156479,131180,287659
410270,201701,32,21,11,19677,10307,29984
410275,201701,73,55,18,51535,16866,68401
410280,201701,297,166,131,155542,122747,278289
410290,201701,214,145,69,134981.81,64211.02,199192.83
410300,201701,81,65,16,60905,14992,75897
410302,201701,24,15,9,14055,8433,22488
410304,201701,48,32,16,29984,14992,44976
410305,201701,183,96,87,89160,80858.42,170018.42
410310,201701,256,167,89,156479,83393,239872
410315,201701,60,44,16,41204,14992,56196
410320,201701,132,85,47,79645,44039,123684
410322,201701,34,23,11,21551,10307,31858
410330,201701,189,133,56,124621,52472,177093
410335,201701,107,67,40,62779,37480,100259
410337,201701,30,26,4,24362,3748,28110
410340,201701,30,29,1,27173,937,28110
410345,201701,203,129,74,120132.77,69338,189470.77
410347,201701,53,41,12,38417,11244,49661
410350,201701,230,142,88,133054,82456,215510
410360,201701,433,258,175,240185.1,163694,403879.1
410370,201701,2246,912,1334,851603.81,1246722.97,2098326.78
410380,201701,227,149,78,139613,73086,212699
410390,201701,352,268,84,251112,78708,329820
410395,201701,36,24,12,22488,10870,33358
410400,201701,793,404,389,377242.1,363964,741206.1
410405,201701,84,62,22,58094,20614,78708
410410,201701,48,36,12,33732,11244,44976
410420,201701,1614,805,809,752325.6,756191.3,1508516.9
410425,201701,172,83,89,77584,83393,160977
410430,201701,2134,1253,881,1171624.9,823754.3,1995379.2
410440,201701,398,281,117,262361,109629,371990
410442,201701,357,237,120,221133,112440,333573
410445,201701,421,289,132,270793,123684,394477
410450,201701,392,199,193,186463,180841,367304
410460,201701,389,212,177,198362.9,165849,364211.9
410465,201701,192,122,70,114314,65590,179904
410470,201701,214,133,81,124621,75897,200518
410480,201701,5461,2696,2765,2511902.96,2585589.53,5097492.49
410490,201701,1333,884,449,825856.93,419776,1245632.93
410500,201701,253,145,108,135865,101196,237061
410510,201701,183,130,53,121810,49027.3,170837.3
410520,201701,289,214,75,200518,70275,270793
410530,201701,221,83,138,77771,129020.9,206791.9
410540,201701,316,231,85,215876.8,79640.32,295517.12
410550,201701,1522,659,863,616546.1,808064.12,1424610.22
410560,201701,141,107,34,100259,31858,132117
410570,201701,431,301,130,280735.6,121810,402545.6
410580,201701,3089,1387,1702,1295908.36,1593088,2888996.36
410590,201701,393,275,118,257675,110284.9,367959.9
410600,201701,166,147,19,137739,17803,155542
410610,201701,49,40,9,37480,8433,45913
410620,201701,221,158,63,148046,59031,207077
410630,201701,437,256,181,239872,168458,408330
410640,201701,912,551,361,514102.76,337615.85,851718.61
410645,201701,98,71,27,66133,25299,91432
410650,201701,357,241,116,224880,108692,333572
410655,201701,73,58,15,54346,14055,68401
410657,201701,40,17,23,15929,21551,37480
410660,201701,569,400,169,373523,158353,531876
410670,201701,74,60,14,56220,13118,69338
410680,201701,192,156,36,146172,32774.99,178946.99
410685,201701,21,16,5,14992,4685,19677
410690,201701,28461,12248,16213,11458016.26,15181283.9,26639300.16
410700,201701,319,234,85,218696,79645,298341
410710,201701,135,109,26,102133,24362,126495
410712,201701,16,10,6,9370,5622,14992
410715,201701,101,75,26,70275,24362,94637
410720,201701,574,352,222,329824,208005,537829
410725,201701,175,129,46,120873,43102,163975
410730,201701,91,60,31,56220,29047,85267
410740,201701,109,83,26,77771,24362,102133
410750,201701,207,159,48,148983,44976,193959
410752,201701,19,13,6,12181,5622,17803
410753,201701,47,21,26,19016.41,24362,43378.41
410754,201701,45,31,14,29047,13118,42165
410755,201701,81,55,26,51253.9,24362,75615.9
410760,201701,658,375,283,351375,264703,616078
410765,201701,1563,761,802,707244.94,750340.63,1457585.57
410770,201701,106,90,16,84330,14992,99322
410773,201701,46,34,12,31858,11244,43102
410775,201701,160,119,41,110847.1,38417,149264.1
410780,201701,79,41,38,38417,35606,74023
410785,201701,73,54,19,50411,17803,68214
410790,201701,69,36,33,33732,30921,64653
410800,201701,295,188,107,175220,100259,275479
410810,201701,37,29,8,27173,7215,34388
410820,201701,178,132,46,123684,43102,166786
410830,201701,8439,3852,4587,3600772.46,4296249.82,7897022.28
410832,201701,103,74,29,69056.9,27173,96229.9
410840,201701,1334,736,598,687135.89,560187.3,1247323.19
410845,201701,55,35,20,32795,18740,51535
410850,201701,201,140,61,131140,57157,188297
410855,201701,32,30,2,28110,1874,29984
410860,201701,661,383,278,358099.75,260486,618585.75
410865,201701,108,80,28,74960,26236,101196
410870,201701,144,125,19,117125,17516,134641
410880,201701,1076,527,549,493235.55,514359,1007594.55
410890,201701,73,55,18,51535,16866,68401
410895,201701,64,46,18,43102,16866,59968
410900,201701,40,31,9,29047,8433,37480
410910,201701,24,21,3,19677,2811,22488
410920,201701,50,25,25,23425,23425,46850
410930,201701,508,318,190,297758.74,177748.9,475507.64
410940,201701,4218,2534,1684,2365761.67,1576073,3941834.67
410950,201701,126,89,37,83393,34669,118062
410960,201701,734,326,408,305181,381734,686915
410965,201701,62,50,12,46850,11244,58094
410970,201701,608,429,179,401517.1,167723,569240.1
410975,201701,106,72,34,67103,31858,98961
410980,201701,1465,659,806,617483,755213.32,1372696.32
410990,201701,254,169,85,158187.25,79363.9,237551.15
411000,201701,60,41,19,38417,17803,56220
411005,201701,16,13,3,12181,2811,14992
411007,201701,234,134,100,125558,93700,219258
411010,201701,563,401,162,374884.21,151794,526678.21
411020,201701,281,192,89,179904,83393,263297
411030,201701,24,15,9,14055,8433,22488
411040,201701,49,34,15,31858,14055,45913
411050,201701,219,176,43,163463.17,40164.12,203627.29
411060,201701,500,340,160,318571,149920,468491
411065,201701,61,55,6,51413.19,5622,57035.19
411070,201701,1140,759,381,706938.79,356997,1063935.79
411080,201701,234,170,64,159373,59181.66,218554.66
411090,201701,108,78,30,73086,28069.6,101155.6
411095,201701,255,105,150,97917,140540,238457
411100,201701,110,89,21,83393,19677,103070
411110,201701,126,87,39,81519,36543,118062
411120,201701,170,132,38,123684,35606,159290
411125,201701,144,71,73,66527,68401,134928
411130,201701,113,98,15,91200,14055,105255
411140,201701,183,123,60,114928,55705,170633
411150,201701,1158,775,383,726165.63,358871,1085036.63
411155,201701,118,82,36,76834,33732,110566
411160,201701,20,9,11,8433,10307,18740
411170,201701,58,50,8,46568.9,7496,54064.9
411180,201701,902,591,311,551612.33,291402.32,843014.65
411190,201701,279,163,116,152075.1,108692,260767.1
411200,201701,655,432,223,403253.99,208482.5,611736.49
411210,201701,658,354,304,330857.97,284848,615705.97
411220,201701,152,113,39,105881,36543,142424
411230,201701,50,44,6,41228,5622,46850
411240,201701,124,86,38,80582,35606,116188
411250,201701,403,288,115,269856,107755,377611
411260,201701,21,15,6,14055,5622,19677
411270,201701,288,162,126,151794,118062,269856
411275,201701,199,174,25,162898,23425,186323
411280,201701,219,151,68,140238.36,63716,203954.36
411290,201701,58,41,17,38417,15929,54346
411295,201701,142,115,27,107755,25299,133054
411300,201701,78,43,35,40291,32795,73086
411310,201701,93,70,23,65590,21551,87141
411320,201701,719,523,196,489114.9,182078.24,671193.14
411325,201701,45,26,19,24362,17803,42165
411330,201701,881,558,323,521862.36,301807.8,823670.16
411340,201701,24,16,8,14992,7187,22179
411342,201701,81,57,24,53409,22488,75897
411345,201701,120,59,61,55283,57148,112431
411350,201701,463,380,83,355076.92,77480.63,432557.55
411360,201701,50,31,19,29047,17803,46850
411370,201701,13628,5552,8076,5185225.94,7554662.27,12739888.21
411373,201701,211,158,53,148046,49661,197707
411375,201701,84,68,16,63716,14992,78708
411380,201701,100,72,28,66527,26236,92763
411390,201701,142,91,51,85267,47787,133054
411400,201701,342,255,87,238935,81519,320454
411410,201701,440,221,219,205718.35,204922,410640.35
411420,201701,1000,452,548,421275.2,513007.6,934282.8
411430,201701,387,249,138,232657.1,129297,361954.1
411435,201701,40,28,12,26236,11244,37480
411440,201701,467,373,94,347878.17,88078,435956.17
411450,201701,438,357,81,334509,75897,410406
411460,201701,705,283,422,264178.64,394089.84,658268.48
411470,201701,126,91,35,85267,32795,118062
411480,201701,605,347,258,323640.8,241464.9,565105.7
411490,201701,289,179,110,167723,103070,270793
411500,201701,104,90,14,84330,12462.9,96792.9
411510,201701,217,177,40,164489.69,37480,201969.69
411520,201701,5782,2259,3523,2112197.76,3293713.08,5405910.84
411530,201701,111,73,38,68401,35606,104007
411535,201701,52,20,32,18740,29984,48724
411540,201701,307,210,97,195950.6,90889,286839.6
411545,201701,73,51,22,47787,20614,68401
411550,201701,72,56,16,52472,14992,67464
411560,201701,356,167,189,155851.21,177093,332944.21
411570,201701,765,289,476,270512,445825,716337
411573,201701,35,21,14,19677,13118,32795
411575,201701,248,150,98,140550,91826,232376
411580,201701,1204,465,739,434736.8,691451,1126187.8
411585,201701,71,35,36,32795,33732,66527
411590,201701,24,18,6,16866,5622,22488
411600,201701,56,28,28,26236,26236,52472
411605,201701,198,84,114,78350,106818,185168
411610,201701,232,159,73,148983,68401,217384
411620,201701,336,184,152,172220.6,142424,314644.6
411630,201701,56,37,19,34669,17803,52472
411640,201701,38,30,8,28110,7496,35606
411650,201701,14,11,3,10307,2811,13118
411660,201701,38,33,5,30921,4685,35606
411670,201701,255,194,61,180579.41,57137,237716.41
411680,201701,157,137,20,128369,18740,147109
411690,201701,591,329,262,307635.08,245112.48,552747.56
411695,201701,64,48,16,44976,14992,59968
411700,201701,171,146,25,136802,23425,160227
411705,201701,104,67,37,62779,34669,97448
411710,201701,298,194,104,180812.1,97448,278260.1
411720,201701,134,86,48,80582,44976,125558
411721,201701,70,55,15,51535,14055,65590
411722,201701,93,41,52,38417,48724,87141
411725,201701,138,109,29,101852,27173,129025
411727,201701,80,67,13,62779,11899.9,74678.9
411729,201701,32,23,9,21551,8433,29984
411730,201701,534,344,190,320485.2,178030,498515.2
411740,201701,27,21,6,19677,5622,25299
411745,201701,68,47,21,43262,19677,62939
411750,201701,812,403,409,376253.9,382273.36,758527.26
411760,201701,1174,880,294,822771.04,275448.89,1098219.93
411770,201701,397,272,125,254864,117125,371989
411780,201701,354,233,121,217384.84,113377,330761.84
411790,201701,500,274,226,256406.48,211650.67,468057.15
411800,201701,171,135,36,126495,33732,160227
411810,201701,149,110,39,103070,36543,139613
411820,201701,2069,1013,1056,947251.6,989069.86,1936321.46
411830,201701,9,9,0,8433,0,8433
411840,201701,1876,1167,709,1092502.5,663845,1756347.5
411845,201701,51,18,33,16866,30921,47787
411850,201701,1201,703,498,655319.74,464707.81,1120027.55
411860,201701,66,52,14,48423,13118,61541
411870,201701,64,49,15,45913,13774,59687
411880,201701,409,268,141,250862,132117,382979
411885,201701,103,66,37,61842,34669,96511
411890,201701,325,198,127,185526,118990,304516
411900,201701,73,53,20,49661,18740,68401
411910,201701,164,135,29,126495,26236,152731
411915,201701,1986,860,1126,803657.51,1054010.83,1857668.34
411920,201701,123,105,18,98385,16866,115251
411925,201701,19,12,7,11244,6559,17803
411930,201701,787,578,209,540369,195833,736202
411940,201701,573,413,160,386981,149920,536901
411950,201701,853,459,394,430073.63,368865.7,798939.33
411960,201701,940,672,268,627333,251116,878449
411965,201701,28,19,9,17803,8433,26236
411970,201701,74,67,7,62779,6559,69338
411980,201701,198,130,68,121810,63716,185526
411990,201701,4642,2729,1913,2540404.64,1790177.4,4330582.04
411995,201701,438,167,271,156479,253927,410406
412000,201701,264,151,113,140785.56,105881,246666.56
412010,201701,43,27,16,25299,14992,40291
412015,201701,42,31,11,29047,10307,39354
412020,201701,29,25,4,23143.9,3748,26891.9
412030,201701,67,57,10,53409,9370,62779
412033,201701,49,32,17,29960,15929,45889
412035,201701,88,55,33,51535,30921,82456
412040,201701,33,24,9,22207,8433,30640
412050,201701,197,145,52,135865,48724,184589
412060,201701,746,588,158,548145.88,148046,696191.88
412065,201701,44,32,12,29984,11244,41228
412070,201701,147,97,50,90233.1,46850,137083.1
412080,201701,266,136,130,127432,121810,249242
412085,201701,30,13,17,12181,15929,28110
412090,201701,690,423,267,394431.1,250179,644610.1
412100,201701,240,198,42,184590,39166.6,223756.6
412110,201701,72,57,15,53409,14055,67464
412120,201701,308,202,106,188711.8,99322,288033.8
412125,201701,91,50,41,46568.9,38417,84985.9
412130,201701,54,36,18,33732,16866,50598
412135,201701,27,15,12,14055,11244,25299
412140,201701,282,211,71,197707,66527,264234
412150,201701,248,169,79,157659.62,74023,231682.62
412160,201701,97,60,37,56211,34669,90880
412170,201701,610,446,164,417902,153668,571570
412175,201701,45,35,10,32795,9370,42165
412180,201701,187,147,40,137150.29,37480,174630.29
412190,201701,319,259,60,242022.41,56220,298242.41
412200,201701,188,123,65,115251,60905,176156
412210,201701,93,73,20,68401,18740,87141
412215,201701,227,155,72,145235,67464,212699
412217,201701,86,67,19,62779,17803,80582
412220,201701,761,579,182,542523,170534,713057
412230,201701,338,214,124,198323.67,115788.64,314112.31
412240,201701,1271,613,658,570408.23,613552.29,1183960.52
412250,201701,382,242,140,226754,130243.92,356997.92
412260,201701,123,89,34,83393,31858,115251
412265,201701,159,127,32,118999,29984,148983
412270,201701,82,46,36,43102,33732,76834
412280,201701,86,68,18,63716,16866,80582
412290,201701,103,65,38,60670.75,35606,96276.75
412300,201701,221,143,78,133991,73086,207077
412310,201701,46,39,7,36543,6559,43102
412320,201701,95,80,15,74960,14055,89015
412330,201701,160,144,16,134928,14992,149920
412340,201701,136,91,45,85267,41884,127151
412350,201701,573,278,295,258565.15,276228,534793.15
412360,201701,26,23,3,21551,2811,24362
412370,201701,159,134,25,124621,23425,148046
412380,201701,260,191,69,178967,64644,243611
412382,201701,52,28,24,26236,22488,48724
412385,201701,145,98,47,91826,44039,135865
412390,201701,260,195,65,182715,60905,243620
412395,201701,59,47,12,44039,11244,55283
412400,201701,67,47,20,44039,18740,62779
412402,201701,231,105,126,98380.32,117780.9,216161.22
412405,201701,791,318,473,296539.69,442718.96,739258.65
412410,201701,899,554,345,517599,323265,840864
412420,201701,17,12,5,11244,4685,15929
412430,201701,22,16,6,14992,5622,20614
412440,201701,557,298,259,276272.07,240986.28,517258.35
412450,201701,80,69,11,64653,10307,74960
412460,201701,80,63,17,59031,15929,74960
412470,201701,253,208,45,194896,42165,237061
412480,201701,179,135,44,126495,41228,167723
412490,201701,153,130,23,121810,21551,143361
412500,201701,476,386,90,360464.3,84330,444794.3
412510,201701,193,155,38,144673,35606,180279
412520,201701,127,71,56,66527,52472,118999
412530,201701,105,57,48,53409,44413.9,97822.9
412535,201701,107,79,28,74005,26227,100232
412540,201701,67,30,37,28110,34669,62779
412545,201701,92,69,23,64185,21551,85736
412550,201701,3332,1544,1788,1443358.19,1674419.55,3117777.74
412555,201701,16,12,4,11244,3748,14992
412560,201701,564,427,137,400099,128369,528468
412570,201701,736,417,319,390129.32,298622,688751.32
412575,201701,92,63,29,59031,27173,86204
412580,201701,149,102,47,95574,44039,139613
412590,201701,32,30,2,28110,1874,29984
412600,201701,171,132,39,123684,36543,160227
412610,201701,36,24,12,22488,10439,32927
412620,201701,151,133,18,124621,16866,141487
412625,201701,2137,1141,996,1067348.76,931688.72,1999037.48
412627,201701,70,57,13,53409,12181,65590
412630,201701,432,286,146,267791,136802,404593
412635,201701,64,22,42,20614,39354,59968
412640,201701,109,75,34,70275,31858,102133
412650,201701,319,203,116,190211,108687.32,298898.32
412660,201701,470,283,187,264469,175219,439688
412665,201701,48,42,6,39354,5622,44976
412667,201701,312,204,108,190543.6,100832.04,291375.64
412670,201701,61,52,9,48724,8433,57157
412680,201701,280,224,56,209888,52472,262360
412690,201701,114,74,40,69338,37199,106537
412700,201701,168,115,53,107755,49380,157135
412710,201701,1365,847,518,787082.8,484148,1271230.8
412720,201701,222,152,70,142424,65590,208014
412730,201701,196,146,50,136802,45913,182715
412740,201701,398,214,184,200377.45,172408,372785.45
412750,201701,457,260,197,242683,184589,427272
412760,201701,236,122,114,114314,106818,221132
412770,201701,1960,1112,848,1036628.05,794268,1830896.05
412780,201701,145,118,27,110566,25299,135865
412785,201701,266,128,138,119280.1,129306,248586.1
412788,201701,34,18,16,16866,14992,31858
412790,201701,130,108,22,101196,20614,121810
412795,201701,164,121,43,113377,40291,153668
412796,201701,297,202,95,188130.83,88883.82,277014.65
412800,201701,526,349,177,326472.73,165840,492312.73
412810,201701,2880,1579,1301,1475943.69,1217814.22,2693757.91
412820,201701,834,545,289,497099.65,268460.92,765560.57
412830,201701,18,14,4,13118,3748,16866
412840,201701,212,152,60,141487.1,56220,197707.1
412850,201701,767,527,240,491925,224880,716805
412853,201701,173,95,78,89015,73086,162101
412855,201701,225,119,106,111347,99322,210669
412860,201701,92,70,22,65590,20614,86204
412862,201701,63,46,17,42821,15929,58750
412863,201701,15,11,4,10307,3748,14055
412865,201701,40,30,10,28110,9370,37480
412870,201701,107,68,39,63716,36543,100259
412880,201701,122,97,25,90889,23425,114314
420005,201701,35,31,4,29047,3186,32233
420010,201701,359,240,119,224084,110557,334641
420020,201701,66,55,11,51535,10307,61842
420030,201701,28,25,3,23425,2811,26236
420040,201701,106,80,26,74960,24362,99322
420050,201701,55,33,22,30539.9,20453.34,50993.24
420055,201701,19,18,1,16866,937,17803
420060,201701,34,26,8,24362,7496,31858
420070,201701,97,83,14,77771,13108.63,90879.63
420075,201701,10,8,2,7496,1874,9370
420080,201701,47,42,5,38463.85,4685,43148.85
420090,201701,37,34,3,31094.34,2811,33905.34
420100,201701,148,125,23,115533.1,21551,137084.1
420110,201701,17,17,0,15929,0,15929
420120,201701,44,32,12,29984,11244,41228
420125,201701,80,64,16,59968,14992,74960
420127,201701,31,28,3,26236,2811,29047
420130,201701,351,220,131,205849.63,122737.63,328587.26
420140,201701,1168,676,492,632166.53,460246.62,1092413.15
420150,201701,43,36,7,33732,6559,40291
420160,201701,42,39,3,36543,2811,39354
420165,201701,15,11,4,10307,3748,14055
420170,201701,66,41,25,38417,23425,61842
420180,201701,26,25,1,23425,937,24362
420190,201701,32,29,3,27173,2811,29984
420195,201701,119,58,61,54346,57157,111503
420200,201701,1255,557,698,516217.1,653690.26,1169907.36
420205,201701,63,29,34,27173,31858,59031
420207,201701,92,54,38,50598,35596.63,86194.63
420208,201701,26,21,5,19677,3841.7,23518.7
420209,201701,17,13,4,12181,3748,15929
420210,201701,447,204,243,190866.9,227607.04,418473.94
420213,201701,50,39,11,36543,10307,46850
420215,201701,23,20,3,18740,2811,21551
420220,201701,70,46,24,43102,22488,65590
420230,201701,681,395,286,368898,267972.63,636870.63
420240,201701,2183,1483,700,1381531.91,654625.78,2036157.69
420243,201701,25,21,4,19677,3748,23425
420245,201701,79,44,35,40853.2,32795,73648.2
420250,201701,48,28,20,26236,18740,44976
420253,201701,37,30,7,28110,6559,34669
420257,201701,9,8,1,7496,937,8433
420260,201701,94,83,11,77771,10307,88078
420270,201701,31,26,5,24357.32,4685,29042.32
420280,201701,269,198,71,184516.91,66509,251025.91
420285,201701,21,13,8,12181,7496,19677
420287,201701,48,30,18,28110,16866,44976
420290,201701,912,642,270,600871.6,252914.2,853785.8
420300,201701,1298,1019,279,951432.2,260205.77,1211637.97
420310,201701,47,35,12,32795,11244,44039
420315,201701,34,31,3,29047,2811,31858
420320,201701,843,428,415,399794.48,388851,788645.48
420325,201701,0,0,0,0,0,0
420330,201701,121,85,36,79645,33732,113377
420340,201701,152,109,43,101188,40262.89,141450.89
420350,201701,237,175,62,162664.1,58094,220758.1
420360,201701,735,556,179,519315.23,166140.09,685455.32
420370,201701,102,68,34,63529,31577,95106
420380,201701,1097,786,311,732726.76,290370.02,1023096.78
420390,201701,245,152,93,141843.06,85501.25,227344.31
420395,201701,170,121,49,113377,45903.63,159280.63
420400,201701,242,177,65,164913,60905,225818
420410,201701,57,45,12,42165,11244,53409
420415,201701,32,29,3,27173,2811,29984
420417,201701,43,33,10,30921,9370,40291
420419,201701,11,10,1,9370,937,10307
420420,201701,2716,1653,1063,1538564.13,993765.88,2532330.01
420425,201701,68,59,9,55274,8414.26,63688.26
420430,201701,1240,857,383,797955.26,358842.89,1156798.15
420435,201701,16,14,2,13118,1874,14992
420440,201701,111,75,36,69354.86,33559.6,102914.46
420445,201701,19,17,2,15929,1874,17803
420450,201701,77,36,41,33703,38417,72120
420455,201701,230,180,50,168632.26,46795.63,215427.89
420460,201701,2201,1491,710,1392704.69,665057.82,2057762.51
420470,201701,121,89,32,83393,29984,113377
420475,201701,7,7,0,6559,0,6559
420480,201701,818,606,212,564336.46,197707.1,762043.56
420490,201701,111,87,24,81519,22488,104007
420500,201701,842,295,547,274761.1,512539,787300.1
420510,201701,21,17,4,15929,3748,19677
420515,201701,24,19,5,17803,4685,22488
420517,201701,6,6,0,5622,0,5622
420519,201701,0,0,0,0,0,0
420520,201701,72,55,17,51535,15929,67464
420530,201701,149,102,47,95574,44039,139613
420535,201701,20,17,3,15929,2811,18740
420540,201701,4150,2442,1708,2279902.05,1596807.29,3876709.34
420543,201701,22,22,0,20614,0,20614
420545,201701,180,129,51,120864,47515.89,168379.89
420550,201701,833,658,175,614991.52,163837.12,778828.64
420555,201701,40,32,8,29984,7496,37480
420560,201701,60,47,13,43664.2,12181,55845.2
420570,201701,117,69,48,64090.8,44966.63,109057.43
420580,201701,283,124,159,116188,148983,265171
420590,201701,481,342,139,319517.1,130243,449760.1
420600,201701,90,45,45,42165,42165,84330
420610,201701,36,33,3,30640,2811,33451
420620,201701,65,55,10,51535,9370,60905
420630,201701,143,102,41,95565.32,38409,133974.32
420640,201701,102,90,12,84330,11244,95574
420650,201701,228,122,106,113618.1,98152.06,211770.16
420660,201701,58,41,17,37667.9,15929,53596.9
420665,201701,35,26,9,24362,8433,32795
420670,201701,305,234,71,219248.63,66227.53,285476.16
420675,201701,13,13,0,12181,0,12181
420680,201701,30,23,7,21551,6559,28110
420690,201701,177,151,26,141487,24362,165849
420700,201701,572,408,164,382221.78,153446.82,535668.60
420710,201701,137,82,55,76834,51526,128360
420720,201701,95,79,16,74023,14992,89015
420730,201701,470,307,163,287585.15,151449.86,439035.01
420740,201701,42,42,0,39354,0,39354
420750,201701,472,311,161,291105.79,150857,441962.79
420757,201701,17,14,3,12321.55,2811,15132.55
420760,201701,40,31,9,29047,8433,37480
420765,201701,65,54,11,50598,10307,60905
420768,201701,73,66,7,61842,6559,68401
420770,201701,85,73,12,68401,11244,79645
420775,201701,44,42,2,38417,1874,40291
420780,201701,223,176,47,164687.12,44039,208726.12
420785,201701,13,9,4,8433,3748,12181
420790,201701,167,145,22,135548.64,19649.63,155198.27
420800,201701,72,53,19,48911.4,17803,66714.4
420810,201701,241,210,31,196770,28250.55,225020.55
420820,201701,2280,1347,933,1254032.46,872712.93,2126745.39
420830,201701,498,287,211,267474.09,196760.63,464234.72
420840,201701,131,99,32,92763,29984,122747
420845,201701,424,186,238,173622.93,221788,395410.93
420850,201701,215,175,40,163975,37480,201455
420860,201701,59,50,9,46850,8433,55283
420870,201701,123,93,30,87141,28110,115251
420880,201701,164,110,54,102404.73,50598,153002.73
420890,201701,829,413,416,383951.26,389783,773734.26
420895,201701,10,10,0,9370,0,9370
420900,201701,399,301,98,280295.22,91798.63,372093.85
420910,201701,5478,2983,2495,2789244.6,2336777.83,5126022.43
420915,201701,78,73,5,68401,4685,73086
420917,201701,18,13,5,12181,4685,16866
420920,201701,20,13,7,12181,6559,18740
420930,201701,2520,1508,1012,1405413.86,942704.96,2348118.82
420940,201701,560,410,150,384152,138935.24,523087.24
420945,201701,7,4,3,3748,2811,6559
420950,201701,51,47,4,44039,3748,47787
420960,201701,109,84,25,78680.63,23406.63,102087.26
420970,201701,304,247,57,229792.45,53381.63,283174.08
420980,201701,24,23,1,21551,937,22488
420985,201701,57,50,7,46850,6559,53409
420990,201701,73,57,16,53409,14992,68401
421000,201701,36,23,13,21551,12181,33732
421003,201701,69,43,26,39578.88,24353,63931.88
421005,201701,8,6,2,5622,1874,7496
421010,201701,709,507,202,474668.78,187240.5,661909.28
421020,201701,26,24,2,22468,1874,24342
421030,201701,122,103,19,96184,17803,113987
421040,201701,57,50,7,46850,6559,53409
421050,201701,284,200,84,185339.1,78708,264047.1
421055,201701,26,23,3,21551,2811,24362
421060,201701,85,59,26,55283,24362,79645
421070,201701,49,43,6,40291,5622,45913
421080,201701,32,29,3,27173,2811,29984
421085,201701,22,17,5,15929,4685,20614
421090,201701,43,33,10,30921,9370,40291
421100,201701,119,89,30,83393,28110,111503
421105,201701,196,161,35,150717,32771.95,183488.95
421110,201701,111,94,17,87468.95,15929,103397.95
421120,201701,129,106,23,99303.63,21532.26,120835.89
421125,201701,17,12,5,11244,4685,15929
421130,201701,764,483,281,451909.41,262275.87,714185.28
421140,201701,30,21,9,18974.25,8433,27407.25
421145,201701,38,31,7,29047,6559,35606
421150,201701,101,74,27,69333.32,25299,94632.32
421160,201701,57,38,19,35596.63,17803,53399.63
421165,201701,19,18,1,16866,937,17803
421170,201701,182,157,25,146109.26,23416,169525.26
421175,201701,146,97,49,90889,45857.52,136746.52
421180,201701,55,33,22,30565,20614,51179
421185,201701,18,14,4,13118,3748,16866
421187,201701,0,0,0,0,0,0
421189,201701,37,29,8,27173,7486.63,34659.63
421190,201701,1308,793,515,742292,481880.36,1224172.36
421200,201701,88,69,19,64653,17803,82456
421205,201701,22,14,8,13118,7486.63,20604.63
421210,201701,173,114,59,106818,55283,162101
421220,201701,254,203,51,189601.95,47767,237368.95
421223,201701,54,45,9,42165,8433,50598
421225,201701,54,39,15,36543,14055,50598
421227,201701,88,67,21,62779,19677,82456
421230,201701,44,33,11,30921,10307,41228
421240,201701,19,19,0,17803,0,17803
421250,201701,357,216,141,202299,131620.39,333919.39
421260,201701,28,23,5,21551,4685,26236
421265,201701,0,0,0,0,0,0
421270,201701,56,50,6,46850,5622,52472
421280,201701,319,182,137,170534,127432,297966
421290,201701,304,206,98,192788,90439.56,283227.56
421300,201701,28,22,6,20614,5622,26236
421310,201701,52,39,13,35887.1,12181,48068.1
421315,201701,30,21,9,19395.9,8433,27828.9
421320,201701,121,86,35,80255,32795,113050
421330,201701,111,84,27,76346.76,25290,101636.76
421335,201701,38,24,14,22488,13118,35606
421340,201701,267,178,89,165989.55,83393,249382.55
421350,201701,167,99,68,92328,63716,156044
421360,201701,667,488,179,452407.05,167499.26,619906.31
421370,201701,177,136,41,127432,37807.95,165239.95
421380,201701,133,112,21,104939.32,19677,124616.32
421390,201701,18,15,3,14055,2811,16866
421400,201701,106,92,14,86204,13118,99322
421410,201701,21,18,3,16866,2811,19677
421415,201701,19,17,2,15929,1874,17803
421420,201701,156,130,26,121247.8,24362,145609.8
421430,201701,15,12,3,11244,2811,14055
421440,201701,60,47,13,44039,12181,56220
421450,201701,100,87,13,81519,12181,93700
421460,201701,59,50,9,46060.1,8433,54493.1
421470,201701,70,45,25,42165,23425,65590
421480,201701,600,443,157,414622.5,147109,561731.5
421490,201701,25,22,3,19950,2811,22761
421500,201701,502,326,176,304034.78,164024.69,468059.47
421505,201701,26,19,7,17803,6559,24362
421507,201701,31,26,5,24362,4685,29047
421510,201701,73,48,25,44976,23425,68401
421520,201701,67,57,10,52660,9370,62030
421530,201701,55,49,6,45257.1,5622,50879.1
421535,201701,34,33,1,30659,937,31596
421540,201701,58,52,6,48724,5622,54346
421545,201701,87,70,17,65581,15929,81510
421550,201701,272,189,83,176438,77489.9,253927.9
421555,201701,21,17,4,15929,3748,19677
421560,201701,8,8,0,7496,0,7496
421565,201701,117,87,30,80956.8,28110,109066.8
421567,201701,29,23,6,21551,5622,27173
421568,201701,32,30,2,28110,1874,29984
421569,201701,8,7,1,6559,937,7496
421570,201701,126,83,43,77771,40291,118062
421575,201701,27,22,5,20356.33,4685,25041.33
421580,201701,699,420,279,393519.89,261423,654942.89
421590,201701,20,20,0,18740,0,18740
421600,201701,115,77,38,72129,34670,106799
421605,201701,99,68,31,63389,29047,92436
421610,201701,182,139,43,130243,40291,170534
421620,201701,1089,652,437,608469.76,409421.52,1017891.28
421625,201701,20,17,3,15929,2811,18740
421630,201701,263,168,95,157370,88172,245542
421635,201701,15,7,8,6559,7496,14055
421640,201701,98,85,13,79645,12181,91826
421650,201701,271,159,112,148964.26,104925.26,253889.52
421660,201701,1971,1162,809,1086701.02,756787.16,1843488.18
421670,201701,167,125,42,117125,39354,156479
421680,201701,169,153,16,143361,14983,158344
421690,201701,340,238,102,222434.8,94627.99,317062.79
421700,201701,53,34,19,31858,17803,49661
421710,201701,20,20,0,18740,0,18740
421715,201701,9,8,1,7496,937,8433
421720,201701,545,388,157,361428.3,145413.54,506841.84
421725,201701,11,5,6,4685,5622,10307
421730,201701,40,30,10,27392.48,9370,36762.48
421740,201701,79,38,41,35606,38417,74023
421750,201701,215,156,59,144580.1,55283,199863.1
421755,201701,23,21,2,19677,1874,21551
421760,201701,103,76,27,71202.63,25299,96501.63
421770,201701,516,359,157,335899.52,146772.15,482671.67
421775,201701,22,14,8,13118,7496,20614
421780,201701,183,143,40,133709.9,37480,171189.9
421790,201701,156,132,24,123684,22488,146172
421795,201701,13,11,2,10307,1874,12181
421800,201701,428,272,156,253144.61,146167.32,399311.93
421810,201701,72,56,16,51536,14992,66528
421820,201701,278,186,92,173317.1,86204,259521.1
421825,201701,131,105,26,98385,24362,122747
421830,201701,139,107,32,100259,29984,130243
421835,201701,3,3,0,2811,0,2811
421840,201701,58,49,9,45913,8433,54346
421850,201701,71,61,10,57157,9366,66523
421860,201701,41,32,9,29703,8433,38136
421870,201701,936,700,236,650515.9,221113.63,871629.53
421875,201701,48,43,5,40291,4685,44976
421880,201701,147,105,42,98385,39073,137458
421885,201701,27,22,5,20614,4404,25018
421890,201701,112,78,34,73086,31858,104944
421895,201701,38,36,2,33732,1874,35606
421900,201701,140,113,27,105807.15,25254,131061.15
421910,201701,61,40,21,37480,19677,57157
421915,201701,29,23,6,21551,5622,27173
421917,201701,36,26,10,24081,9370,33451
421920,201701,33,30,3,28110,2811,30921
421930,201701,749,570,179,533752.68,167686.63,701439.31
421935,201701,58,51,7,47787,6559,54346
421940,201701,44,39,5,36543,4685,41228
421950,201701,816,530,286,490542.96,265523.4,756066.36
421960,201701,41,35,6,32514,5622,38136
421970,201701,353,223,130,208461.12,121759.01,330220.13
421985,201701,29,20,9,18740,8433,27173
422000,201701,0,0,0,0,0,0
430003,201701,209,43,166,39588.25,155542,195130.25
430005,201701,29,23,6,21551,5622,27173
430010,201701,285,197,88,184120.5,82456,266576.5
430020,201701,157,100,57,93419,52472,145891
430030,201701,120,90,30,84330,28110,112440
430040,201701,2942,1693,1249,1579315.15,1169676.58,2748991.73
430045,201701,63,54,9,50598,8433,59031
430047,201701,7,6,1,5622,937,6559
430050,201701,78,65,13,60905,12181,73086
430055,201701,17,14,3,13118,2811,15929
430057,201701,4,2,2,1874,1874,3748
430060,201701,3648,2158,1490,2014565.82,1391602.49,3406168.31
430063,201701,52,45,7,42165,6559,48724
430064,201701,139,115,24,107052.25,22488,129540.25
430066,201701,10,7,3,6559,2811,9370
430070,201701,50,38,12,35606,11244,46850
430080,201701,68,47,21,43351.8,19677,63028.8
430085,201701,35,9,26,8433,24362,32795
430087,201701,38,28,10,26096,9370,35466
430090,201701,69,63,6,58468.8,5622,64090.8
430100,201701,115,75,40,70275,37461.26,107736.26
430105,201701,139,71,68,66527,63416.16,129943.16
430107,201701,21,17,4,15929,3748,19677
430110,201701,385,223,162,208154.55,151728.41,359882.96
430120,201701,140,123,17,114314.95,15929,130243.95
430130,201701,772,477,295,446339.95,276133.9,722473.85
430140,201701,131,122,9,114314,8433,122747
430150,201701,100,66,34,61093,31858,92951
430155,201701,31,29,2,27173,1874,29047
430160,201701,3793,2242,1551,2082133.25,1449286.11,3531419.36
430163,201701,305,129,176,119777.68,164837.04,284614.72
430165,201701,22,16,6,14992,5622,20614
430170,201701,77,72,5,67464,4685,72149
430175,201701,79,61,18,57157,16210.1,73367.1
430180,201701,91,72,19,67464,17193.95,84657.95
430185,201701,33,24,9,22488,8433,30921
430187,201701,112,44,68,41228,63416.9,104644.9
430190,201701,228,129,99,120826.15,92097.73,212923.88
430192,201701,13,13,0,12181,0,12181
430195,201701,13,9,4,8433,3748,12181
430200,201701,163,144,19,134272.1,17803,152075.1
430205,201701,18,17,1,15929,937,16866
430210,201701,576,436,140,405439.9,129915.15,535355.05
430215,201701,17,14,3,13118,2811,15929
430220,201701,61,41,20,38417,18740,57157
430222,201701,13,7,6,6559,5622,12181
430223,201701,13,7,6,6559,5622,12181
430225,201701,4,3,1,2811,937,3748
430230,201701,284,176,108,163038,101008.6,264046.6
430235,201701,44,31,13,29047,12171.63,41218.63
430237,201701,27,21,6,19677,5622,25299
430240,201701,130,77,53,72149,49651.63,121800.63
430245,201701,63,51,12,47787,11244,59031
430250,201701,194,115,79,107745.63,74013.63,181759.26
430258,201701,12,10,2,9370,1874,11244
430260,201701,36,30,6,28110,4816.18,32926.18
430265,201701,33,27,6,25280.26,5622,30902.26
430270,201701,585,431,154,400791.3,142518.81,543310.11
430280,201701,1017,636,381,593017.93,354542.8,947560.73
430290,201701,367,212,155,196770.4,145235,342005.4
430300,201701,2085,1141,944,1064087.66,880773.07,1944860.73
430310,201701,1992,1020,972,950036.48,907960.27,1857996.75
430320,201701,49,41,8,38402.95,7496,45898.95
430330,201701,100,90,10,84330,9370,93700
430340,201701,66,59,7,55283,6559,61842
430350,201701,1644,1146,498,1062369.94,465193.13,1527563.07
430355,201701,26,24,2,22488,1874,24362
430360,201701,79,34,45,31858,41228.1,73086.1
430367,201701,29,19,10,17803,8592.29,26395.29
430370,201701,56,49,7,45913,6559,52472
430380,201701,119,88,31,81893.8,29047,110940.8
430390,201701,603,376,227,352030.9,212399.63,564430.53
430400,201701,135,105,30,96698.4,28091.26,124789.66
430410,201701,57,45,12,42165,11244,53409
430420,201701,467,309,158,288034.9,145826.58,433861.48
430430,201701,52,50,2,46225.95,1874,48099.95
430435,201701,152,111,41,103725.9,37714.25,141440.15
430440,201701,505,333,172,312021,160976.6,472997.6
430450,201701,1163,957,206,888090.52,193012.63,1081103.15
430460,201701,5036,2725,2311,2538100.38,2157228.14,4695328.52
430461,201701,20,18,2,16866,1874,18740
430462,201701,11,7,4,6559,3748,10307
430463,201701,947,489,458,456244.14,428800.05,885044.19
430465,201701,29,18,11,16866,10307,27173
430466,201701,619,449,170,419495,159102.6,578597.6
430467,201701,87,50,37,46850,34659.63,81509.63
430468,201701,109,63,46,59031,42846.02,101877.02
430469,201701,22,16,6,14992,5622,20614
430470,201701,1150,643,507,594824.37,473147.52,1067971.89
430471,201701,48,35,13,32776.26,11900,44676.26
430480,201701,94,59,35,54439.7,32785.63,87225.33
430485,201701,6,6,0,5341,0,5341
430490,201701,91,72,19,67042.35,17803,84845.35
430495,201701,29,24,5,22488,4685,27173
430500,201701,188,127,61,118037.21,56787.63,174824.84
430510,201701,2843,1866,977,1743317.35,914577.96,2657895.31
430511,201701,18,18,0,16866,0,16866
430512,201701,137,93,44,87141,41228,128369
430513,201701,50,46,4,42633.5,3748,46381.5
430515,201701,31,29,2,27173,1874,29047
430517,201701,164,143,21,133054.25,19658.26,152712.51
430520,201701,366,248,118,231721,110528.52,342249.52
430530,201701,92,51,41,47787,38417,86204
430535,201701,459,295,164,276180.75,153654.32,429835.07
430537,201701,14,14,0,13118,0,13118
430540,201701,75,48,27,44976,25299,70275
430543,201701,373,116,257,108692,240575,349267
430544,201701,42,39,3,36543,2811,39354
430545,201701,324,142,182,132988.41,170046.76,303035.17
430550,201701,46,38,8,35606,7496,43102
430558,201701,5,3,2,2811,1874,4685
430560,201701,49,20,29,18740,27173,45913
430570,201701,98,45,53,42165,49604.78,91769.78
430580,201701,125,96,29,89952,27126.15,117078.15
430583,201701,16,16,0,14992,0,14992
430585,201701,8,4,4,3748,3748,7496
430587,201701,15,8,7,7496,6559,14055
430590,201701,152,127,25,117780.9,23425,141205.9
430593,201701,4,4,0,3748,0,3748
430595,201701,14,9,5,8433,4685,13118
430597,201701,55,29,26,27173,24362,51535
430600,201701,212,141,71,132107.63,66245.9,198353.53
430605,201701,152,94,58,88078,54336.63,142414.63
430607,201701,26,22,4,20614,3748,24362
430610,201701,1597,725,872,675765.25,812145.12,1487910.37
430613,201701,2,2,0,1874,0,1874
430620,201701,111,81,30,75757,28091.26,103848.26
430630,201701,47,44,3,41228,2811,44039
430632,201701,33,28,5,26236,4685,30921
430635,201701,42,37,5,34669,4685,39354
430637,201701,61,34,27,31858,25299,57157
430640,201701,204,113,91,105037.7,85267,190304.7
430642,201701,27,25,2,23425,1874,25299
430645,201701,30,26,4,24362,3748,28110
430650,201701,248,195,53,182434,49614.15,232048.15
430655,201701,7,6,1,5622,937,6559
430660,201701,964,466,498,434908.55,464414.78,899323.33
430670,201701,70,50,20,46850,18740,65590
430673,201701,78,42,36,39354,33732,73086
430675,201701,12,10,2,9370,1874,11244
430676,201701,450,265,185,247592.88,173274.84,420867.72
430680,201701,247,170,77,157135,72149,229284
430690,201701,515,307,208,286768.85,192332.01,479100.86
430692,201701,7,5,2,4685,1874,6559
430693,201701,124,80,44,74960,40609.58,115569.58
430695,201701,60,56,4,51272.64,3748,55020.64
430697,201701,62,37,25,34669,23425,58094
430700,201701,1547,1082,465,1006123.25,435705,1441828.25
430705,201701,19,18,1,16866,937,17803
430710,201701,257,166,91,155542,85267,240809
430720,201701,105,91,14,85079.6,13118,98197.6
430730,201701,121,98,23,90889,20089.8,110978.8
430740,201701,56,40,16,37480,14992,52472
430745,201701,38,30,8,28110,7496,35606
430750,201701,337,231,106,215363.23,98385,313748.23
430755,201701,81,48,33,44976,30921,75897
430760,201701,353,210,143,194194.01,133963.26,328157.27
430770,201701,1446,737,709,688536.66,659946.19,1348482.85
430780,201701,312,195,117,182424.9,109563.78,291988.68
430781,201701,27,23,4,21551,3748,25299
430783,201701,47,37,10,34356.8,9370,43726.8
430786,201701,6,3,3,2811,2811,5622
430790,201701,446,288,158,268356.8,147755.63,416112.43
430800,201701,151,125,26,117125,24362,141487
430805,201701,41,39,2,36543,1874,38417
430807,201701,31,20,11,18740,10307,29047
430810,201701,65,41,24,38417,22488,60905
430820,201701,127,74,53,69338,49005.1,118343.1
430825,201701,11,9,2,8433,1874,10307
430830,201701,229,212,17,198363,15929,214292
430840,201701,115,75,40,70275,36824.1,107099.1
430843,201701,4,3,1,2811,937,3748
430845,201701,63,37,26,34669,24362,59031
430850,201701,555,381,174,356947.41,162899.67,519847.08
430860,201701,146,92,54,84892.2,49932.73,134824.93
430865,201701,63,31,32,28391.1,29674.79,58065.89
430870,201701,74,61,13,57157,12181,69338
430880,201701,149,114,35,105881,32795,138676
430885,201701,7,6,1,5622,937,6559
430890,201701,328,198,130,183895.94,121529,305424.94
430900,201701,555,375,180,346690.7,168182.13,514872.83
430905,201701,76,31,45,29047,42165,71212
430910,201701,266,152,114,142424,106809,249233
430912,201701,7,7,0,6559,0,6559
430915,201701,28,20,8,18740,7214.9,25954.9
430920,201701,3903,2173,1730,2030286.01,1618775.42,3649061.43
430925,201701,7,6,1,5378.38,937,6315.38
430930,201701,2022,1198,824,1114910.78,769946.35,1884857.13
430940,201701,224,137,87,127422.63,81500.26,208922.89
430950,201701,159,125,34,117125,31576.9,148701.9
430955,201701,18,11,7,10307,6559,16866
430957,201701,17,16,1,14992,937,15929
430960,201701,238,153,85,142283.45,79645,221928.45
430965,201701,91,58,33,54346,30921,85267
430970,201701,75,63,12,59031,10307,69338
430975,201701,33,31,2,29047,1874,30921
430980,201701,46,29,17,27173,15929,43102
430990,201701,106,80,26,74960,24362,99322
430995,201701,115,111,4,103070,3748,106818
431000,201701,294,134,160,124332.1,149920,274252.1
431010,201701,330,194,136,180812.89,127432,308244.89
431020,201701,1888,1077,811,1003830.99,756805.53,1760636.52
431030,201701,36,28,8,26236,7496,33732
431033,201701,367,177,190,165052.6,178030,343082.6
431036,201701,14,9,5,8433,4685,13118
431040,201701,131,77,54,71212,50490.25,121702.25
431041,201701,37,26,11,24362,10307,34669
431043,201701,41,23,18,21551,16866,38417
431046,201701,11,7,4,6559,3748,10307
431050,201701,211,132,79,121280.84,72496.18,193777.02
431053,201701,69,42,27,38604.4,25299,63903.4
431055,201701,63,40,23,37480,21532.26,59012.26
431057,201701,16,16,0,14992,0,14992
431060,201701,1667,1032,635,960726.83,593212.54,1553939.37
431065,201701,16,11,5,10307,4685,14992
431070,201701,67,63,4,59031,3748,62779
431075,201701,10,10,0,9370,0,9370
431080,201701,140,91,49,83274.94,45913,129187.94
431085,201701,28,25,3,23425,2811,26236
431087,201701,13,13,0,12181,0,12181
431090,201701,51,41,10,38417,9370,47787
431100,201701,1227,729,498,673704.71,466626,1140330.71
431110,201701,246,152,94,142424,88068.63,230492.63
431112,201701,30,19,11,17803,10307,28110
431113,201701,30,20,10,18740,9370,28110
431115,201701,156,106,50,98697.2,46840.63,145537.83
431120,201701,614,362,252,337002.42,236068.52,573070.94
431123,201701,4,4,0,3748,0,3748
431125,201701,87,78,9,73086,8433,81519
431127,201701,7,2,5,1874,4685,6559
431130,201701,595,389,206,362337.9,193012.63,555350.53
431140,201701,683,455,228,423289.75,213579.78,636869.53
431142,201701,30,23,7,20361,6559,26920
431150,201701,204,150,54,140550,50579.26,191129.26
431160,201701,55,48,7,44976,6559,51535
431162,201701,20,15,5,14055,4685,18740
431164,201701,4,4,0,3748,0,3748
431170,201701,100,83,17,77771,15929,93700
431171,201701,45,24,21,22488,19667.63,42155.63
431173,201701,1,1,0,937,0,937
431175,201701,199,96,103,88734,96511,185245
431177,201701,74,56,18,52472,16847.26,69319.26
431179,201701,14,12,2,11244,1874,13118
431180,201701,424,258,166,240809,155523.63,396332.63
431190,201701,90,68,22,63716,20614,84330
431198,201701,65,44,21,41228,19677,60905
431200,201701,17,15,2,14055,1874,15929
431205,201701,28,28,0,26236,0,26236
431210,201701,79,49,30,45586,28110,73696
431213,201701,26,21,5,19677,4685,24362
431215,201701,26,22,4,20614,3748,24362
431217,201701,3,2,1,1874,937,2811
431220,201701,60,51,9,47787,8433,56220
431225,201701,142,94,48,88069,44966.63,133035.63
431230,201701,89,76,13,70556.1,12181,82737.1
431235,201701,8,8,0,7496,0,7496
431237,201701,24,16,8,14992,7496,22488
431238,201701,15,11,4,10026,3748,13774
431240,201701,956,605,351,564384.01,327838.48,892222.49
431242,201701,37,37,0,34669,0,34669
431244,201701,12,9,3,8433,2811,11244
431245,201701,62,47,15,44039,14055,58094
431247,201701,13,9,4,8433,3748,12181
431250,201701,265,134,131,125539.26,122719.26,248258.52
431260,201701,60,44,16,41228,14992,56220
431261,201701,23,15,8,14055,7496,21551
431262,201701,17,17,0,15929,0,15929
431265,201701,167,86,81,80582,75897,156479
431267,201701,13,12,1,11244,937,12181
431270,201701,300,249,51,233313,47131.1,280444.1
431275,201701,41,39,2,36543,1874,38417
431280,201701,20,15,5,13235.12,4685,17920.12
431290,201701,23,20,3,18740,2811,21551
431295,201701,5,5,0,4685,0,4685
431300,201701,21,18,3,16866,2811,19677
431301,201701,8,7,1,6559,937,7496
431303,201701,48,34,14,31736.19,12836.9,44573.09
431306,201701,207,111,96,103511.42,89952,193463.42
431308,201701,6,5,1,4685,937,5622
431310,201701,70,58,12,54346,11244,65590
431320,201701,107,65,42,60905,39344.63,100249.63
431330,201701,178,117,61,109629,57157,166786
431333,201701,32,26,6,24362,5622,29984
431335,201701,12,7,5,6559,4685,11244
431337,201701,302,147,155,136925.1,144878.94,281804.04
431339,201701,15,11,4,10307,3748,14055
431340,201701,2961,1679,1282,1569602.78,1199268.26,2768871.04
431342,201701,40,24,16,22488,14992,37480
431344,201701,16,16,0,14992,0,14992
431346,201701,4,4,0,3748,0,3748
431349,201701,38,35,3,32795,2811,35606
431350,201701,898,530,368,492105.99,343869.63,835975.62
431360,201701,43,39,4,36543,3748,40291
431365,201701,313,146,167,136783.26,156445.62,293228.88
431370,201701,1280,756,524,705458.89,490803.19,1196262.08
431380,201701,102,85,17,78989.1,15929,94918.1
431390,201701,484,266,218,248305.1,202656.01,450961.11
431395,201701,272,118,154,110566,144280,254846
431400,201701,35,27,8,25299,7496,32795
431402,201701,87,59,28,55283,26236,81519
431403,201701,16,10,6,9370,5622,14992
431405,201701,636,341,295,317480.82,276388,593868.82
431406,201701,30,26,4,24362,3748,28110
431407,201701,48,43,5,40291,4685,44976
431410,201701,2974,1720,1254,1599695.04,1174042.26,2773737.30
431413,201701,15,14,1,13118,937,14055
431415,201701,71,51,20,47787,18740,66527
431417,201701,21,11,10,10307,9370,19677
431420,201701,288,207,81,193334.3,75887.63,269221.93
431430,201701,40,15,25,14055,23425,37480
431440,201701,8773,6231,2542,5776580.28,2375273.38,8151853.66
431442,201701,29,16,13,14992,12181,27173
431445,201701,26,20,6,18740,5622,24362
431446,201701,8,7,1,6559,937,7496
431447,201701,84,58,26,54346,24362,78708
431449,201701,46,43,3,40291,2811,43102
431450,201701,396,282,114,262500.55,106115.25,368615.80
431454,201701,0,0,0,0,0,0
431455,201701,46,35,11,32795,10307,43102
431460,201701,504,341,163,315956.4,152309.9,468266.3
431470,201701,122,93,29,86461.86,27173,113634.86
431475,201701,10,10,0,9370,0,9370
431477,201701,32,22,10,20614,9370,29984
431478,201701,6,5,1,4685,937,5622
431480,201701,482,302,180,281521.65,168350.79,449872.44
431490,201701,27900,15608,12292,14555845.63,11483954.37,26039800.00
431500,201701,74,54,20,50598,18740,69338
431505,201701,44,16,28,14992,26236,41228
431507,201701,7,6,1,5622,937,6559
431510,201701,293,183,110,170768.9,101177.26,271946.16
431513,201701,22,17,5,15929,4685,20614
431514,201701,6,5,1,4685,937,5622
431515,201701,76,66,10,61842,9370,71212
431517,201701,3,1,2,937,1874,2811
431520,201701,36,32,4,29984,3748,33732
431530,201701,1621,713,908,666771.42,850341.67,1517113.09
431531,201701,22,21,1,19677,937,20614
431532,201701,21,16,5,14992,4685,19677
431535,201701,23,14,9,13118,8433,21551
431540,201701,144,127,17,117996.41,15929,133925.41
431545,201701,19,16,3,14992,2811,17803
431550,201701,335,190,145,178030,135771.3,313801.3
431555,201701,11,10,1,9370,937,10307
431560,201701,4210,2961,1249,2746298.82,1168786.89,3915085.71
431570,201701,747,397,350,368034.39,326002.04,694036.43
431575,201701,35,24,11,22488,10307,32795
431580,201701,86,58,28,53690.1,26236,79926.1
431590,201701,120,99,21,92528.75,19667.63,112196.38
431595,201701,11,10,1,9370,937,10307
431600,201701,203,113,90,105881,84330,190211
431610,201701,128,93,35,86485.1,32795,119280.1
431620,201701,40,33,7,30921,6559,37480
431630,201701,118,100,18,93700,16866,110566
431640,201701,1305,821,484,766091.2,452346.96,1218438.16
431642,201701,44,40,4,37011.5,3748,40759.5
431643,201701,47,21,26,19677,24362,44039
431645,201701,295,167,128,156479,118999,275478
431647,201701,11,11,0,10307,0,10307
431650,201701,37,25,12,23425,11244,34669
431660,201701,258,168,90,157416,84330,241746
431670,201701,212,100,112,92060.25,104915.89,196976.14
431673,201701,3,3,0,2811,0,2811
431675,201701,30,26,4,24080.9,3748,27828.9
431680,201701,1042,735,307,684478.5,287406.75,971885.25
431690,201701,4676,2854,1822,2656903.4,1702081.99,4358985.39
431695,201701,24,18,6,16866,5622,22488
431697,201701,0,0,0,0,0,0
431700,201701,166,124,42,116188,39354,155542
431710,201701,3954,1690,2264,1582021.9,2119938.71,3701960.61
431720,201701,1372,806,566,747507.18,528454.63,1275961.81
431725,201701,1,1,0,937,0,937
431730,201701,1141,761,380,707170.2,356060,1063230.2
431740,201701,1360,669,691,622319.26,646625.65,1268944.91
431750,201701,1862,1203,659,1117753.82,614644.36,1732398.18
431755,201701,5,4,1,3748,937,4685
431760,201701,1087,688,399,644281.2,373638.49,1017919.69
431770,201701,383,285,98,266754.63,91807.26,358561.89
431775,201701,25,20,5,18740,4685,23425
431780,201701,563,348,215,325082.78,201445.63,526528.41
431790,201701,140,106,34,98385,31811.15,130196.15
431795,201701,14,13,1,12181,937,13118
431800,201701,3408,1771,1637,1646680.99,1525860.78,3172541.77
431805,201701,18,15,3,14055,2811,16866
431810,201701,602,405,197,377835.88,184285.69,562121.57
431820,201701,304,169,135,158353,125378.65,283731.65
431830,201701,2313,1396,917,1304777.2,857788.51,2162565.71
431840,201701,501,332,169,307525.65,156853.9,464379.55
431842,201701,31,27,4,25299,3748,29047
431843,201701,10,6,4,5622,3748,9370
431844,201701,14,12,2,11244,1874,13118
431845,201701,29,27,2,25299,1874,27173
431846,201701,29,24,5,22488,4685,27173
431848,201701,13,11,2,10307,1874,12181
431849,201701,8,6,2,5622,1874,7496
431850,201701,773,641,132,599108.9,123449.75,722558.65
431860,201701,105,76,29,71212,26236,97448
431861,201701,4,2,2,1874,1874,3748
431862,201701,50,35,15,32795,14055,46850
431870,201701,3390,1969,1421,1838816.39,1330197.86,3169014.25
431880,201701,883,656,227,609941,211762,821703
431890,201701,1294,790,504,737109.79,470576,1207685.79
431900,201701,176,124,52,116188,48724,164912
431910,201701,49,37,12,34669,11244,45913
431912,201701,35,20,15,18740,14055,32795
431915,201701,123,99,24,92763,22488,115251
431920,201701,141,107,34,100259,31858,132117
431930,201701,83,66,17,61842,15929,77771
431935,201701,4,3,1,2811,937,3748
431936,201701,12,11,1,10307,937,11244
431937,201701,15,10,5,9370,4685,14055
431940,201701,442,286,156,266154.85,146162.63,412317.48
431950,201701,456,292,164,271403.32,152112.95,423516.27
431960,201701,708,431,277,399754.42,259390.45,659144.87
431970,201701,74,66,8,61842,7496,69338
431971,201701,3,3,0,2811,0,2811
431973,201701,13,12,1,11244,937,12181
431975,201701,6,5,1,4685,937,5622
431980,201701,197,127,70,118436.8,65590,184026.8
431990,201701,1207,647,560,604792.09,524410.9,1129202.99
432000,201701,1623,857,766,798128.07,714898.86,1513026.93
432010,201701,282,188,94,175063.3,88078,263141.3
432020,201701,167,132,35,123684,32785.63,156469.63
432023,201701,21,16,5,14992,4685,19677
432026,201701,60,54,6,50598,5622,56220
432030,201701,61,33,28,30921,26236,57157
432032,201701,23,19,4,17803,3748,21551
432035,201701,42,34,8,31858,7496,39354
432040,201701,92,62,30,58094,28110,86204
432045,201701,9,8,1,7214.9,937,8151.9
432050,201701,66,39,27,36543,25299,61842
432055,201701,98,75,23,70256.26,21551,91807.26
432057,201701,0,0,0,0,0,0
432060,201701,38,34,4,31155.25,3748,34903.25
432065,201701,29,26,3,24362,2811,27173
432067,201701,94,82,12,76834,11244,88078
432070,201701,394,295,99,274842.29,92735.26,367577.55
432080,201701,798,542,256,506917,239825.89,746742.89
432085,201701,14,11,3,10307,2811,13118
432090,201701,252,166,86,155542,80582,236124
432100,201701,168,111,57,103725.9,53409,157134.9
432110,201701,590,401,189,369337.86,176156,545493.86
432120,201701,951,551,400,515631.1,374575.86,890206.96
432130,201701,485,351,134,327950,125417.45,453367.45
432132,201701,31,28,3,26236,2811,29047
432135,201701,77,63,14,59031,13118,72149
432140,201701,283,216,67,201820.43,62779,264599.43
432143,201701,178,112,66,104944,61842,166786
432145,201701,250,173,77,160883.8,72149,233032.8
432146,201701,15,14,1,13118,937,14055
432147,201701,175,62,113,58094,105862.26,163956.26
432149,201701,14,11,3,10307,2811,13118
432150,201701,817,517,300,483257.75,279385.39,762643.14
432160,201701,1355,700,655,654229.51,612855.19,1267084.70
432162,201701,4,3,1,2811,937,3748
432163,201701,17,14,3,13118,2811,15929
432166,201701,126,91,35,85502,32795,118297
432170,201701,227,122,105,112722,98385,211107
432180,201701,517,311,206,290751.1,192741,483492.1
432183,201701,10,7,3,6559,2811,9370
432185,201701,75,63,12,58937.3,11244,70181.3
432190,201701,489,245,244,228431.63,228451.08,456882.71
432195,201701,84,72,12,66761.25,11244,78005.25
432200,201701,394,252,142,236124,132980.26,369104.26
432210,201701,113,74,39,67323.45,36543,103866.45
432215,201701,65,60,5,56220,4919.25,61139.25
432218,201701,20,19,1,17803,937,18740
432220,201701,665,330,335,308218.42,312346.53,620564.95
432225,201701,16,11,5,9838.5,4685,14523.5
432230,201701,158,84,74,78473.75,69291.15,147764.90
432232,201701,14,12,2,11244,1874,13118
432234,201701,6,5,1,4685,937,5622
432235,201701,1,1,0,937,0,937
432237,201701,30,17,13,15929,12181,28110
432240,201701,4054,2241,1813,2090552.71,1693169.71,3783722.42
432250,201701,984,597,387,556813.38,361522.71,918336.09
432252,201701,40,33,7,30190.14,6559,36749.14
432253,201701,55,46,9,43102,8433,51535
432254,201701,19,7,12,6559,11244,17803
432255,201701,13,12,1,11244,937,12181
432260,201701,833,650,183,607785.15,170534.75,778319.90
432270,201701,215,155,60,145235,56220,201455
432280,201701,112,77,35,71660.9,32795,104455.9
432285,201701,2,1,1,937,937,1874
432290,201701,66,60,6,54627.1,5622,60249.1
432300,201701,4569,2587,1982,2408002.63,1852700.25,4260702.88
432310,201701,114,89,25,83393,23425,106818
432320,201701,20,14,6,13118,5622,18740
432330,201701,12,6,6,5622,5622,11244
432335,201701,8,7,1,6559,937,7496
432340,201701,43,38,5,35606,4685,40291
432345,201701,84,60,24,56220,22488,78708
432350,201701,24,23,1,21551,937,22488
432360,201701,7,5,2,4685,1874,6559
432370,201701,25,24,1,22206.9,937,23143.9
432375,201701,42,36,6,33732,5622,39354
432377,201701,7,7,0,6559,0,6559
432380,201701,152,66,86,61842,80582,142424
500020,201701,221,114,107,106818,99669.06,206487.06
500025,201701,108,52,56,48724,52472,101196
500060,201701,1354,799,555,748663,519440.21,1268103.21
500070,201701,686,319,367,298903,343598,642501
500080,201701,133,100,33,93700,30359,124059
500085,201701,143,116,27,108401.63,24479.13,132880.76
500090,201701,341,156,185,146172,173345,319517
500100,201701,675,362,313,337320.3,292719,630039.3
500110,201701,2237,965,1272,903887.63,1190799.83,2094687.46
500124,201701,309,177,132,165849,123684,289533
500150,201701,329,124,205,116179,191731,307910
500190,201701,517,349,168,326120.48,156935,483055.48
500200,201701,194,164,30,153310.89,28110,181420.89
500210,201701,1423,499,924,467249.48,864647.78,1331897.26
500215,201701,230,129,101,119932.21,94637,214569.21
500220,201701,781,513,268,480459.26,250372.63,730831.89
500230,201701,257,176,81,164209.25,75428.5,239637.75
500240,201701,703,485,218,454445,203797.9,658242.9
500260,201701,558,195,363,182715,340131,522846
500270,201701,27897,11648,16249,10886574.7,15207099.95,26093674.65
500280,201701,194,73,121,68401,113368,181769
500290,201701,1158,646,512,604366,478518,1082884
500295,201701,377,223,154,208951,144288.63,353239.63
500310,201701,69,21,48,19677,44976,64653
500315,201701,687,395,292,370105.63,273313.53,643419.16
500320,201701,3613,1786,1827,1672035.39,1710271.47,3382306.86
500325,201701,933,501,432,468969,403826.32,872795.32
500330,201701,1471,648,823,604338.76,770266.7,1374605.46
500345,201701,322,231,91,215501.1,85267,300768.1
500348,201701,228,129,99,120873,92744.63,213617.63
500350,201701,145,70,75,65590,70275,135865
500370,201701,5328,2351,2977,2196047.91,2787101.97,4983149.88
500375,201701,345,245,100,229555.63,93700,323255.63
500380,201701,585,335,250,313740.4,234231.63,547972.03
500390,201701,68,34,34,31858,31858,63716
500400,201701,211,141,70,132098.26,65581,197679.26
500410,201701,563,217,346,203283.58,324047.05,527330.63
500430,201701,535,364,171,341068,160227,501295
500440,201701,206,101,105,93976.42,98385,192361.42
500450,201701,417,177,240,165160.8,224496.23,389657.03
500460,201701,317,157,160,147099.63,149920,297019.63
500470,201701,435,341,94,318324.05,87132,405456.05
500480,201701,103,65,38,60905,35606,96511
500490,201701,106,40,66,37475.32,61842,99317.32
500500,201701,1408,472,936,440358.36,876127.22,1316485.58
500510,201701,50,37,13,34669,12172,46841
500515,201701,106,69,37,64653,34388,99041
500520,201701,356,205,151,191055,141483,332538
500525,201701,82,49,33,45913,30639.9,76552.9
500540,201701,887,363,524,340084.52,489617.35,829701.87
500560,201701,868,483,385,450854.03,360062.83,810916.86
500568,201701,952,557,395,516662,369829.32,886491.32
500570,201701,1191,667,524,622795.83,488452.76,1111248.59
500580,201701,336,168,168,156189.03,157394,313583.03
500600,201701,323,165,158,153906.93,148046,301952.93
500620,201701,856,602,254,557744.71,237810.6,795555.31
500625,201701,78,66,12,61147.78,11244,72391.78
500627,201701,22,10,12,9370,11244,20614
500630,201701,1563,814,749,760563.9,701527.22,1462091.12
500635,201701,518,283,235,264768.09,220026.34,484794.43
500640,201701,427,222,205,206421.5,192057.63,398479.13
500660,201701,5513,2088,3425,1954675.85,3205093.73,5159769.58
500690,201701,559,197,362,184274.87,338374.34,522649.21
500710,201701,357,170,187,159009,174928.9,333937.9
500720,201701,968,574,394,536428.32,368968.26,905396.58
500730,201701,186,103,83,96511,77485.22,173996.22
500740,201701,837,374,463,349156.82,433097,782253.82
500750,201701,135,41,94,38417,87769.16,126186.16
500755,201701,130,93,37,86860,34669,121529
500769,201701,716,399,317,373542.02,297016,670558.02
500770,201701,458,227,231,212408.53,216212.75,428621.28
500780,201701,170,112,58,104944,54346,159290
500790,201701,1049,510,539,477303.32,504721.63,982024.95
500793,201701,249,132,117,123684,109620,233304
500795,201701,183,126,57,118052.63,53400,171452.63
500797,201701,39,32,7,29984,6559,36543
500800,201701,417,178,239,166777,223652.9,390429.9
500830,201701,2112,1165,947,1088391.3,886196.33,1974587.63
500840,201701,145,107,38,100259,35597,135856
510010,201701,164,89,75,83383.63,70275,153658.63
510020,201701,485,230,255,215236.67,238394.01,453630.68
510025,201701,1651,926,725,866994.03,677386.64,1544380.67
510030,201701,575,295,280,276369.26,261609.32,537978.58
510035,201701,129,55,74,51507.63,69319.63,120827.26
510040,201701,367,153,214,143361,200078.53,343439.53
510050,201701,421,230,191,214791.47,178138.89,392930.36
510060,201701,101,45,56,42155.63,52462.63,94618.26
510080,201701,218,86,132,80568.32,123600.04,204168.36
510100,201701,76,35,41,32795,38398.26,71193.26
510120,201701,28,14,14,13118,13118,26236
510125,201701,400,241,159,225147.05,148960.26,374107.31
510130,201701,600,348,252,325636.59,235696.68,561333.27
510140,201701,381,128,253,119927,237036.32,356963.32
510160,201701,86,42,44,39354,41228,80582
510170,201701,836,509,327,476660.66,305038.85,781699.51
510180,201701,2793,1371,1422,1281559.68,1330630.17,2612189.85
510185,201701,10,4,6,3748,5622,9370
510190,201701,216,74,142,69338,133049.32,202387.32
510250,201701,2600,1495,1105,1399770.59,1034328.51,2434099.10
510260,201701,203,143,60,133800.15,56183.63,189983.78
510263,201701,440,234,206,217816.04,192279.89,410095.93
510267,201701,618,338,280,316327.78,262106.15,578433.93
510268,201701,51,27,24,25299,22488,47787
510269,201701,69,25,44,23416,41218.63,64634.63
510270,201701,398,203,195,190025.82,182286.57,372312.39
510279,201701,213,150,63,140532,59012.26,199544.26
510285,201701,177,73,104,68362.63,97448,165810.63
510300,201701,558,292,266,273173.85,249168.53,522342.38
510305,201701,210,92,118,86181.63,110473.41,196655.04
510310,201701,123,57,66,53409,61823.26,115232.26
510320,201701,832,514,318,481517.52,297545.26,779062.78
510325,201701,386,160,226,149870.63,211471.53,361342.16
510330,201701,415,230,185,215477,173326.26,388803.26
510335,201701,574,293,281,274494.89,262362.69,536857.58
510336,201701,48,34,14,31858,13118,44976
510337,201701,118,45,73,42155.63,68391.63,110547.26
510340,201701,17096,8240,8856,7697398.29,8287492.31,15984890.60
510343,201701,69,45,24,42155.63,22488,64643.63
510345,201701,162,105,57,98371.63,53118.63,151490.26
510350,201701,632,356,276,332366.74,258547.89,590914.63
510360,201701,213,122,91,114295.63,85175.89,199471.52
510370,201701,129,63,66,59012.26,61712.67,120724.93
510380,201701,90,62,28,58094,26227,84321
510385,201701,51,26,25,24362,23416,47778
510390,201701,133,53,80,49661,74913.15,124574.15
510395,201701,41,27,14,25299,13118,38417
510410,201701,687,448,239,419743,223919.95,643662.95
510420,201701,613,288,325,268944.77,302916.72,571861.49
510450,201701,53,33,20,30921,18740,49661
510452,201701,40,23,17,21551,15929,37480
510454,201701,69,28,41,26236,38407.63,64643.63
510455,201701,130,79,51,74004.26,47777.63,121781.89
510460,201701,182,89,93,83084.53,87103.89,170188.42
510480,201701,686,392,294,366169.94,275119.97,641289.91
510490,201701,357,182,175,170182.01,163434.13,333616.14
510500,201701,240,182,58,170524.63,54346,224870.63
510510,201701,777,442,335,413292.43,313885.63,727178.06
510515,201701,1138,586,552,548520.11,517166.89,1065687.00
510517,201701,250,108,142,100914.9,132749.85,233664.75
510520,201701,233,151,82,141413.89,76529.52,217943.41
510523,201701,94,60,34,56220,31848.63,88068.63
510525,201701,634,354,280,330954.89,262259.89,593214.78
510530,201701,15,11,4,10307,3748,14055
510550,201701,270,116,154,108231.46,144289,252520.46
510558,201701,287,136,151,127417.95,141459.26,268877.21
510560,201701,346,214,132,200518,123385,323903
510562,201701,633,429,204,400394.25,190659.5,591053.75
510590,201701,839,436,403,408494.89,377583.96,786078.85
510600,201701,251,137,114,128336.89,106776.58,235113.47
510610,201701,160,76,84,71193.26,78408.53,149601.79
510615,201701,181,68,113,63697.26,105881,169578.26
510617,201701,15,8,7,7496,6559,14055
510618,201701,118,56,62,52472,57625.5,110097.5
510619,201701,109,72,37,67455,34660,102115
510620,201701,192,108,84,101186.63,78708,179894.63
510621,201701,189,121,68,113086.9,63707,176793.9
510622,201701,419,272,147,254752.89,137421.26,392174.15
510623,201701,348,222,126,207995.63,117468.52,325464.15
510624,201701,85,39,46,36534,43102,79636
510625,201701,508,306,202,286494.78,188677.45,475172.23
510626,201701,105,63,42,59031,39354,98385
510627,201701,48,36,12,33732,11244,44976
510628,201701,169,99,70,92633.67,65441.56,158075.23
510629,201701,247,157,90,147099.63,83383.63,230483.26
510630,201701,464,232,232,217309.78,217052.85,434362.63
510631,201701,9,3,6,2811,5622,8433
510637,201701,339,189,150,176743.79,140404.52,317148.31
510642,201701,974,522,452,488768.79,423383.82,912152.61
510645,201701,0,0,0,0,0,0
510650,201701,1524,1003,521,939644.89,488080.78,1427725.67
510665,201701,83,40,43,37426,40273,77699
510670,201701,67,37,30,34669,28110,62779
510675,201701,1166,706,460,661500,430997.32,1092497.32
510677,201701,382,177,205,164852.15,191759.27,356611.42
510680,201701,113,65,48,60887,44967,105854
510682,201701,197,87,110,81203,103070,184273
510685,201701,58,42,16,39354,14992,54346
510700,201701,613,356,257,333453.89,240648.67,574102.56
510704,201701,1014,538,476,501956.09,443501.04,945457.13
510706,201701,125,59,66,55278.32,61805.26,117083.58
510710,201701,385,256,129,239696.93,120740.56,360437.49
510715,201701,64,47,17,44029.63,15929,59958.63
510718,201701,224,113,111,105788.78,103979.26,209768.04
510719,201701,32,18,14,16866,13118,29984
510720,201701,199,127,72,118990,67182.9,186172.9
510724,201701,88,34,54,31848.63,50565.89,82414.52
510726,201701,42,23,19,21541.63,17794,39335.63
510729,201701,80,37,43,34669,40244.15,74913.15
510730,201701,463,254,209,237989,195685.63,433674.63
510735,201701,104,44,60,41228,56220,97448
510740,201701,30,15,15,14055,14055,28110
510757,201701,18,14,4,13118,3748,16866
510760,201701,6884,3596,3288,3359336.62,3076028.24,6435364.86
510770,201701,739,349,390,326837.15,365239.15,692076.30
510774,201701,14,7,7,6559,6559,13118
510775,201701,107,78,29,73076.63,27173,100249.63
510776,201701,25,6,19,5622,17803,23425
510777,201701,185,82,103,76805.89,96482.89,173288.78
510779,201701,52,24,28,22479,26172.26,48651.26
510780,201701,296,162,134,151722.26,125467.63,277189.89
510785,201701,452,242,210,226688.78,196666.93,423355.71
510787,201701,174,87,87,81505.32,81501.32,163006.64
510788,201701,0,0,0,0,0,0
510790,201701,2339,1207,1132,1128078.01,1058149.9,2186227.91
510792,201701,1011,566,445,529863.52,416549.64,946413.16
510794,201701,105,52,53,48724,49633.26,98357.26
510795,201701,2298,1306,992,1217762.69,927164.38,2144927.07
510800,201701,168,107,61,100240.26,57148,157388.26
510805,201701,161,112,49,104944,45913,150857
510810,201701,96,37,59,34577.89,55161.93,89739.82
510820,201701,276,129,147,120622.26,136756.71,257378.97
510830,201701,66,40,26,37480,24353,61833
510835,201701,1,0,1,0,937,937
510840,201701,9042,4518,4524,4220240.27,4231197.35,8451437.62
510850,201701,207,88,119,82446.63,111184.79,193631.42
510860,201701,393,170,223,159105.56,208216.05,367321.61
510880,201701,65,49,16,45894.63,14992,60886.63
510885,201701,64,39,25,36533.63,23387.89,59921.52
510890,201701,75,41,34,38417,31858,70275
510895,201701,178,102,76,95574,70908.63,166482.63
520005,201701,60,35,25,32795,23415.63,56210.63
520010,201701,297,125,172,117125,161071,278196
520013,201701,622,357,265,334472.63,248305,582777.63
520015,201701,49,35,14,32795,13118,45913
520017,201701,105,59,46,55002,43102,98104
520020,201701,30,15,15,14055,14055,28110
520025,201701,1891,1025,866,960425,810598.7,1771023.7
520030,201701,813,401,412,375728,385098,760826
520050,201701,82,54,28,50598,26236,76834
520055,201701,45,31,14,29047,13118,42165
520060,201701,177,113,64,105881,59968,165849
520080,201701,590,401,189,375737,177088.32,552825.32
520082,201701,20,14,6,13118,5622,18740
520085,201701,100,74,26,69338,24362,93700
520090,201701,79,54,25,50598,23425,74023
520110,201701,8927,3782,5145,3537822.56,4815762.24,8353584.80
520120,201701,12,8,4,7308.6,3748,11056.6
520130,201701,729,516,213,483483,199291,682774
520140,201701,11548,6471,5077,6056133.74,4754601.36,10810735.10
520145,201701,44,33,11,30921,10307,41228
520150,201701,187,146,41,136802,38417,175219
520160,201701,36,22,14,20614,13118,33732
520170,201701,226,139,87,130212,81483,211695
520180,201701,105,50,55,46850,51535,98385
520215,201701,215,128,87,119654.9,81237.9,200892.8
520235,201701,64,47,17,44039,15929,59968
520250,201701,135,80,55,74960,51253.9,126213.9
520260,201701,108,71,37,66527,33732,100259
520280,201701,47,33,14,30266,13118,43384
520310,201701,37,23,14,21551,13118,34669
520320,201701,167,102,65,95574,60905,156479
520330,201701,756,399,357,373826.63,334473,708299.63
520340,201701,361,201,160,188337,149874.63,338211.63
520350,201701,524,232,292,217384,273604,490988
520355,201701,92,51,41,47787,38417,86204
520357,201701,21,15,6,14055,5622,19677
520360,201701,0,0,0,0,0,0
520380,201701,145,74,71,69338,66527,135865
520390,201701,296,128,168,119010,157406.63,276416.63
520393,201701,11,9,2,8433,1874,10307
520396,201701,96,57,39,53409,36543,89952
520400,201701,229,135,94,124903.1,88078,212981.1
520410,201701,196,105,91,98367,85258,183625
520420,201701,24,16,8,14992,7496,22488
520425,201701,302,132,170,122748,158822.6,281570.6
520430,201701,442,228,214,213354.9,200181.9,413536.8
520440,201701,583,375,208,351375,194896,546271
520450,201701,1857,848,1009,793480.63,944778.95,1738259.58
520455,201701,59,39,20,36543,18740,55283
520460,201701,31,16,15,14992,14055,29047
520465,201701,20,17,3,15929,2811,18740
520470,201701,424,260,164,243620,153668,397288
520480,201701,79,46,33,43093,30876,73969
520485,201701,129,43,86,40291,80301,120592
520490,201701,366,273,93,255620.26,86979.84,342600.10
520495,201701,193,109,84,102133,78708,180841
520500,201701,185,142,43,133054,40291,173345
520505,201701,165,85,80,79645,74960,154605
520510,201701,1702,819,883,763100.3,825103.57,1588203.87
520520,201701,46,32,14,29984,13118,43102
520530,201701,246,176,70,162562.89,64804.79,227367.68
520540,201701,484,309,175,288249.81,163975,452224.81
520545,201701,155,83,72,77771,67464,145235
520547,201701,44,23,21,21551,19677,41228
520549,201701,965,451,514,422269,481090,903359
520551,201701,291,154,137,144298,128369,272667
520552,201701,40,23,17,21551,15929,37480
520570,201701,19,10,9,9370,8433,17803
520580,201701,283,174,109,163029,102133,265162
520590,201701,156,89,67,83393,62497.9,145890.9
520620,201701,1102,514,588,480869.14,550103.53,1030972.67
520630,201701,35,19,16,17803,14992,32795
520640,201701,415,236,179,221132,167723,388855
520650,201701,50,33,17,30921,15929,46850
520660,201701,32,18,14,16866,13118,29984
520670,201701,32,26,6,24362,5622,29984
520680,201701,69,47,22,44039,20614,64653
520690,201701,31,13,18,12181,16866,29047
520710,201701,40,37,3,34669,2811,37480
520725,201701,203,126,77,118062,72140,190202
520735,201701,55,43,12,40291,11244,51535
520740,201701,396,195,201,182013.2,188328,370341.2
520750,201701,38,28,10,26236,9370,35606
520753,201701,57,40,17,37480,15929,53409
520760,201701,109,72,37,67464,34669,102133
520780,201701,264,202,62,189274,58094,247368
520790,201701,165,74,91,69056.9,85267,154323.9
520800,201701,3540,1833,1707,1713432.68,1598794.45,3312227.13
520810,201701,166,114,52,106818,48724,155542
520815,201701,6,5,1,4685,937,5622
520830,201701,143,92,51,86204,47787,133991
520840,201701,313,201,112,187821.65,104944,292765.65
520850,201701,110,70,40,65581,37330.08,102911.08
520860,201701,1632,1008,624,943381.87,583190,1526571.87
520870,201701,29695,14664,15031,13714323.88,14069651.6,27783975.48
520880,201701,962,538,424,504106,396988.26,901094.26
520890,201701,802,457,345,426616.2,322881.63,749497.83
520910,201701,1020,525,495,488413.31,463815,952228.31
520915,201701,98,73,25,68401,23415.63,91816.63
520920,201701,431,210,221,196207.8,207077,403284.8
520929,201701,23,21,2,19677,1874,21551
520940,201701,75,44,31,41228,29047,70275
520945,201701,25,16,9,14992,8433,23425
520960,201701,51,31,20,29047,18740,47787
520970,201701,326,200,126,186782,117780.9,304562.9
520980,201701,109,80,29,74960,27173,102133
520990,201701,455,307,148,287434.12,138676,426110.12
520993,201701,120,54,66,50598,61833,112431
520995,201701,288,165,123,152967,114643,267610
521000,201701,1530,868,662,811630.4,619920,1431550.4
521010,201701,665,296,369,277112.23,345697.15,622809.38
521015,201701,17,10,7,9370,6559,15929
521020,201701,1475,1011,464,947288.63,434174.78,1381463.41
521030,201701,36,25,11,23425,10307,33732
521040,201701,893,534,359,500125,336102,836227
521056,201701,41,28,13,26236,12181,38417
521060,201701,135,82,53,76834,49661,126495
521080,201701,516,377,139,353240,130243,483483
521090,201701,519,301,218,282037,203994.27,486031.27
521100,201701,289,211,78,197707,73086,270793
521120,201701,1006,683,323,639409,302370,941779
521130,201701,362,253,109,237061,101543.9,338604.9
521140,201701,186,103,83,96511,77771,174282
521150,201701,2813,1178,1635,1101585.14,1529995.25,2631580.39
521160,201701,31,17,14,15929,13118,29047
521170,201701,149,83,66,77761.63,61842,139603.63
521180,201701,1078,668,410,625518.63,383467.25,1008985.88
521190,201701,2534,1051,1483,984787,1387942.16,2372729.16
521200,201701,41,29,12,27173,11244,38417
521205,201701,16,11,5,10307,4685,14992
521210,201701,156,86,70,80582,65590,146172
521220,201701,808,542,266,505268.78,248906,754174.78
521225,201701,20,11,9,10307,8433,18740
521230,201701,115,73,42,68401,39354,107755
521250,201701,6369,3577,2792,3345383.75,2613235.83,5958619.58
521260,201701,15,11,4,10307,3748,14055
521270,201701,154,117,37,109629,34669,144298
521280,201701,435,246,189,229846.1,177093,406939.1
521290,201701,34,14,20,13118,18740,31858
521295,201701,100,66,34,61336.02,31858,93194.02
521300,201701,224,112,112,104636,104580.89,209216.89
521305,201701,36,24,12,22488,11244,33732
521308,201701,1074,770,304,720989.78,284548.63,1005538.41
521310,201701,1322,769,553,719469.1,517281.26,1236750.36
521340,201701,23,17,6,15929,5622,21551
521350,201701,132,96,36,89952,33732,123684
521370,201701,199,123,76,114314,70930.9,185244.9
521375,201701,202,107,95,100259,88733.9,188992.9
521377,201701,50,33,17,30921,15929,46850
521380,201701,1050,684,366,637116.26,342942,980058.26
521385,201701,19,10,9,9370,8433,17803
521390,201701,106,84,22,78395.7,20614,99009.7
521400,201701,333,201,132,188055.9,123356.15,311412.05
521405,201701,154,75,79,70275,74023,144298
521410,201701,72,48,24,44976,22488,67464
521440,201701,226,159,67,148186.55,62779,210965.55
521450,201701,714,378,336,354186,314176.1,668362.1
521460,201701,1166,690,476,646249,445993.26,1092242.26
521470,201701,16,11,5,10307,4685,14992
521480,201701,57,35,22,32795,20550,53345
521483,201701,292,154,138,144017,129306,273323
521486,201701,301,180,121,168538.19,112722,281260.19
521487,201701,25,12,13,11244,12181,23425
521490,201701,28,16,12,14992,11244,26236
521500,201701,110,70,40,65590,37480,103070
521520,201701,43,32,11,29984,10307,40291
521523,201701,521,313,208,291734.95,194896,486630.95
521525,201701,48,31,17,29047,15929,44976
521530,201701,259,131,128,122747,119842.3,242589.3
521540,201701,32,18,14,16866,13118,29984
521550,201701,92,41,51,38117.63,47759.63,85877.26
521560,201701,762,521,241,487998.97,225396,713394.97
521565,201701,43,30,13,28110,12181,40291
521570,201701,478,318,160,297956.63,149827.15,447783.78
521580,201701,63,38,25,35606,23425,59031
521590,201701,36,18,18,16866,16866,33732
521600,201701,28,16,12,14992,11244,26236
521630,201701,228,114,114,106808.63,105844.88,212653.51
521640,201701,285,142,143,133054,133991,267045
521645,201701,31,16,15,14992,14055,29047
521680,201701,229,141,88,132117,82456,214573
521690,201701,1,1,0,937,0,937
521710,201701,1190,552,638,516661.9,597516,1114177.9
521720,201701,523,343,180,321391,168332.26,489723.26
521730,201701,640,315,325,295155,304244,599399
521740,201701,890,344,546,322309.63,510535.03,832844.66
521760,201701,1535,829,706,774942.42,661214,1436156.42
521770,201701,776,485,291,454163.9,272207.87,726371.77
521800,201701,2054,1235,819,1154370.2,766143.16,1920513.36
521805,201701,33,18,15,16866,14055,30921
521810,201701,95,57,38,52284.9,35606,87890.9
521830,201701,933,642,291,599962.08,272658,872620.08
521839,201701,90,63,27,59031,25299,84330
521850,201701,1093,585,508,547679.26,475648.04,1023327.30
521860,201701,348,210,138,196770,129025,325795
521870,201701,68,38,30,35606,28110,63716
521878,201701,51,21,30,19677,28110,47787
521880,201701,4216,1897,2319,1775261.33,2170483.85,3945745.18
521890,201701,552,376,176,352312,164621.9,516933.9
521900,201701,301,243,58,226785.2,54346,281131.2
521910,201701,152,106,46,99322,43102,142424
521920,201701,57,27,30,25299,28110,53409
521925,201701,33,21,12,19677,11244,30921
521930,201701,1065,605,460,566691.93,430259.46,996951.39
521935,201701,29,21,8,19677,7496,27173
521940,201701,202,104,98,97448,91544.9,188992.9
521945,201701,17,15,2,14055,1874,15929
521950,201701,7,5,2,4685,1874,6559
521960,201701,72,48,24,44976,22488,67464
521970,201701,405,253,152,236779.9,142424,379203.9
521971,201701,94,47,47,44039,44039,88078
521973,201701,32,13,19,12181,17803,29984
521975,201701,1379,698,681,652397.6,636244.36,1288641.96
521980,201701,245,165,80,154446,74960,229406
521990,201701,73,55,18,51535,16866,68401
522000,201701,294,185,109,173345,102133,275478
522005,201701,21,12,9,11244,8433,19677
522010,201701,1094,601,493,561263.1,461369.43,1022632.53
522015,201701,59,36,23,33723,21551,55274
522020,201701,830,419,411,392603,384151.26,776754.26
522026,201701,27,19,8,17803,7496,25299
522028,201701,15,11,4,10307,3748,14055
522040,201701,709,274,435,256448,407540.63,663988.63
522045,201701,1942,1222,720,1144490.53,674115.9,1818606.43
522050,201701,182,87,95,81519,89015,170534
522060,201701,543,342,201,320172.9,187336.69,507509.59
522068,201701,132,83,49,77771,45913,123684
522070,201701,12,12,0,11244,0,11244
522100,201701,43,22,21,20352,19677,40029
522108,201701,41,31,10,29047,9370,38417
522119,201701,62,30,32,28110,29984,58094
522130,201701,72,22,50,20614,46814,67428
522140,201701,3683,1897,1786,1773285.8,1671356.42,3444642.22
522145,201701,56,33,23,30921,21551,52472
522150,201701,63,50,13,46850,12181,59031
522155,201701,56,39,17,36534,15929,52463
522157,201701,6,4,2,3748,1874,5622
522160,201701,1725,993,732,929316.6,685593.9,1614910.5
522170,201701,390,257,133,240809,124621,365430
522180,201701,41,21,20,19677,18740,38417
522185,201701,1195,478,717,445265.17,671707.88,1116973.05
522190,201701,46,25,21,23425,19583.3,43008.3
522200,201701,303,182,121,170534,113377,283911
522205,201701,163,113,50,105881,46850,152731
522220,201701,178,124,54,116188,50598,166786
522230,201701,33,26,7,24362,6559,30921
530010,201701,53076,27221,25855,25377957.61,24176135.44,49554093.05
110001,201702,502,389,113,362723.99,105046.64,467770.63
110002,201702,2629,1527,1102,1421395.52,1025457.29,2446852.81
110003,201702,87,68,19,63295.45,17682.89,80978.34
110004,201702,1888,1187,701,1103754.82,651900.95,1755655.77
110005,201702,428,347,81,322333.05,75265.32,397598.37
110006,201702,435,335,100,310928.73,92938.68,403867.41
110007,201702,79,64,15,59767.45,13974.89,73742.34
110008,201702,243,142,101,131596.23,94255.9,225852.13
110009,201702,742,493,249,459038.05,231864.26,690902.31
110010,201702,1776,1088,688,1012353.48,641520.25,1653873.73
110011,201702,1854,1420,434,1320838.42,404062.03,1724900.45
110012,201702,3974,2259,1715,2102895.11,1600549.67,3703444.78
110013,201702,721,526,195,489121.96,181351.7,670473.66
110014,201702,411,347,64,323796.58,59682.77,383479.35
110015,201702,1426,1137,289,1058030.85,268449.08,1326479.93
110018,201702,1103,649,454,604140.07,422966.59,1027106.66
110020,201702,14829,8665,6164,8018170.02,5723587.99,13741758.01
110025,201702,530,377,153,349930.72,142608.81,492539.53
110026,201702,44,30,14,27848.9,12997.56,40846.46
110028,201702,1526,1091,435,1011464.26,403322.43,1414786.69
110029,201702,132,114,18,106577.67,16846,123423.67
110030,201702,2403,1603,800,1488806.67,743301.31,2232107.98
110032,201702,375,286,89,265717.81,83128.01,348845.82
110033,201702,630,483,147,445586.11,136432.02,582018.13
110034,201702,400,296,104,274413.05,96170.78,370583.83
110037,201702,101,80,21,74879.78,19656.89,94536.67
110040,201702,318,209,109,194388.71,101331.24,295719.95
110045,201702,881,568,313,528248.21,290399.93,818648.14
110050,201702,94,73,21,68040.78,19596.78,87637.56
110060,201702,89,44,45,41007.89,41724.45,82732.34
110070,201702,129,77,52,71747.35,48121.57,119868.92
110080,201702,383,213,170,196299.26,157951.19,354250.45
110090,201702,27,22,5,20513.56,4644.78,25158.34
110092,201702,102,59,43,55022.01,39939.57,94961.58
110094,201702,186,127,59,118177.57,54761.79,172939.36
110100,201702,26,22,4,20493.78,3727.89,24221.67
110110,201702,69,42,27,39133.56,24797.56,63931.12
110120,201702,90,70,20,65229.01,18639.67,83868.68
110130,201702,295,243,52,224941.6,48423.34,273364.94
110140,201702,242,158,84,147175.96,78217.09,225393.05
110143,201702,44,38,6,35425.45,5561.67,40987.12
110145,201702,26,18,8,16785.89,7476,24261.89
110146,201702,22,14,8,13077.89,7455.89,20533.78
110147,201702,39,30,9,27990,8413,36403
110148,201702,36,25,11,23232.91,10287,33519.91
110149,201702,273,190,83,176845.05,77288.8,254133.85
110150,201702,74,45,29,42044.89,26892.34,68937.23
110155,201702,9,7,2,6519,1854,8373
110160,201702,69,57,12,53027.24,11163.67,64190.91
110170,201702,226,185,41,172304.34,38176.67,210481.01
110175,201702,25,19,6,17622.12,5601.89,23224.01
110180,201702,91,80,11,74879.78,10266.89,85146.67
120001,201702,144,93,51,86326,47758,134084
120005,201702,184,114,70,106775.12,65403,172178.12
120010,201702,927,612,315,568026.74,292730.28,860757.02
120013,201702,125,84,41,78120.77,37451.74,115572.51
120017,201702,72,48,24,44889.36,22467,67356.36
120020,201702,3386,2692,694,2495819.72,646690.26,3142509.98
120025,201702,612,338,274,314070.12,254995.37,569065.49
120030,201702,1004,832,172,772206.25,160441,932647.25
120032,201702,46,38,8,35584.12,7496,43080.12
120033,201702,218,191,27,178625.94,25299,203924.94
120034,201702,148,105,43,96489.12,40247.24,136736.36
120035,201702,24,16,8,14992,7496,22488
120038,201702,420,266,154,248716.65,144244.87,392961.52
120039,201702,16,15,1,14055,937,14992
120040,201702,13532,9353,4179,8633629.67,3872654.15,12506283.82
120042,201702,39,33,6,30921,5622,36543
120043,201702,14,3,11,2811,10286.89,13097.89
120045,201702,518,326,192,304160.18,179639.48,483799.66
120050,201702,1211,916,295,853607.5,275132.24,1128739.74
120060,201702,1354,1080,274,995721.01,252702.98,1248423.99
120070,201702,540,379,161,348646.16,149310.11,497956.27
120080,201702,122,77,45,71082.13,41580.67,112662.80
130002,201702,151,105,46,98385,43102,141487
130006,201702,76,42,34,39354,31858,71212
130008,201702,137,74,63,68617.72,58330.84,126948.56
130010,201702,140,72,68,67464,63716,131180
130014,201702,221,162,59,151794,55283,207077
130020,201702,83,47,36,44039,33732,77771
130030,201702,850,528,322,494736,301704.63,796440.63
130040,201702,319,161,158,150857,146971,297828
130050,201702,541,308,233,288314.9,218321,506635.9
130060,201702,863,592,271,549489.78,251024.7,800514.48
130063,201702,534,285,249,267045,233291.12,500336.12
130068,201702,190,119,71,111503,66246,177749
130070,201702,1339,930,409,845275.29,373599.98,1218875.27
130080,201702,672,438,234,410031.2,219249,629280.2
130083,201702,67,36,31,33732,29047,62779
130090,201702,391,191,200,177317.88,187400,364717.88
130100,201702,1105,521,584,488177,546926.9,1035103.9
130110,201702,707,305,402,285635,376654,662289
130115,201702,174,72,102,67464,95574,163038
130120,201702,1613,1008,605,944496,566885,1511381
130130,201702,620,420,200,393540,187400,580940
130140,201702,1551,1165,386,1090974.95,360745.1,1451720.05
130150,201702,410,340,70,318580,65590,384170
130160,201702,473,258,215,241746,201455,443201
130165,201702,28,19,9,17803,8433,26236
130170,201702,941,657,284,609934.22,263053.15,872987.37
130180,201702,162,97,65,90420.5,60905,151325.5
130185,201702,1981,1070,911,1000422.73,853024.89,1853447.62
130190,201702,3565,2279,1286,2131676,1203202.09,3334878.09
130195,201702,294,236,58,221132,54346,275478
130200,201702,179,80,99,74950.63,92763,167713.63
130210,201702,69,35,34,32795,31858,64653
130220,201702,184,128,56,119936,52472,172408
130230,201702,335,212,123,198644,115251,313895
130240,201702,1457,896,561,838195.98,525371.22,1363567.20
130250,201702,4632,2954,1678,2763379.6,1572109.17,4335488.77
130255,201702,396,211,185,197707,173063.9,370770.9
130260,201702,50805,23957,26848,22414536.24,25148230.26,47562766.50
130270,201702,1430,914,516,855924.82,483471.89,1339396.71
130280,201702,103,63,40,59031,37480,96511
130290,201702,2068,1511,557,1415402.22,521627.9,1937030.12
130300,201702,423,304,119,284566.9,111503,396069.9
130310,201702,922,497,425,465689,398225,863914
130320,201702,441,234,207,218161.71,193959,412120.71
130330,201702,714,436,278,408532,260204.9,668736.9
130340,201702,3159,1958,1201,1831647.8,1124212.7,2955860.5
130350,201702,500,307,193,287536.57,180841,468377.57
130353,201702,719,293,426,274260,399162,673422
130356,201702,708,321,387,300757,362337.9,663094.9
130360,201702,70,42,28,39354,26236,65590
130370,201702,703,503,200,471311,187400,658711
130380,201702,629,413,216,386981,202392,589373
130390,201702,508,402,106,376674,99322,475996
130395,201702,169,43,126,40291,118062,158353
130400,201702,64,46,18,43102,16866,59968
130406,201702,2000,1282,718,1197720.25,672138.16,1869858.41
130410,201702,536,223,313,208951,293281,502232
130420,201702,3211,2530,681,2367799.35,638097,3005896.35
130423,201702,166,76,90,71212,84330,155542
130426,201702,139,80,59,74960,55283,130243
130430,201702,408,268,140,251116,131180,382296
130440,201702,201,74,127,69057,118999,188056
140002,201702,34,15,19,14055,17803,31858
140005,201702,188,113,75,105646.75,70275,175921.75
140010,201702,9882,6651,3231,6206626.47,3023115.82,9229742.29
140015,201702,150,69,81,64653,75897,140550
140017,201702,98,68,30,63716,28110,91826
140020,201702,511,346,165,323265.84,154605,477870.84
140023,201702,57,40,17,37480,15929,53409
140028,201702,32,21,11,19677,10307,29984
140030,201702,353,249,104,233313,96857.69,330170.69
140040,201702,48,33,15,30921,13961.3,44882.3
140045,201702,246,113,133,105225.1,124621,229846.1
140047,201702,611,398,213,369413.66,198831.5,568245.16
140050,201702,163,103,60,95713,56220,151933
140060,201702,48,38,10,35606,9370,44976
140070,201702,30,28,2,26236,1874,28110
150010,201702,4635,2855,1780,2672464.75,1665477.66,4337942.41
150013,201702,134,90,44,84330,41228,125558
150020,201702,1066,526,540,492862,505980,998842
150030,201702,768,304,464,284848,434768,719616
150034,201702,181,108,73,101196,68401,169597
150040,201702,1325,794,531,743958,497547,1241505
150050,201702,594,341,253,319235.9,236861,556096.9
150060,201702,4613,2994,1619,2802905.98,1516478.28,4319384.26
150070,201702,303,129,174,120873,163038,283911
150080,201702,14184,7080,7104,6624643.74,6651036.56,13275680.30
150085,201702,346,209,137,195823.63,128369,324192.63
150090,201702,741,631,110,591247,103070,694317
150095,201702,342,210,132,196013.84,122878.18,318892.02
150100,201702,51,35,16,32795,14992,47787
150110,201702,172,83,89,77771,83393,161164
150120,201702,351,271,80,253927,74960,328887
150125,201702,49,21,28,19677,26236,45913
150130,201702,1838,975,863,913575,808626.32,1722201.32
150140,201702,54131,25216,28915,23595369.03,27079787.84,50675156.87
150145,201702,167,96,71,89952,66527,156479
150150,201702,2632,1088,1544,1019456,1442853.8,2462309.8
150157,201702,463,308,155,288596,145230.32,433826.32
150160,201702,108,84,24,78708,22488,101196
150170,201702,3617,2649,968,2478927.3,905797.9,3384725.2
150172,201702,293,202,91,189274,85267,274541
150175,201702,87,54,33,50598,30921,81519
150178,201702,727,480,247,448823,231439,680262
150180,201702,2872,1339,1533,1253846.8,1436121.86,2689968.66
150190,201702,324,201,123,188337,115251,303588
150195,201702,118,58,60,54346,56220,110566
150200,201702,209,93,116,87141,108692,195833
150210,201702,3037,2463,574,2306791.84,537599.75,2844391.59
150215,201702,470,318,152,297685,142424,440109
150220,201702,4047,2687,1360,2516257.95,1271415.27,3787673.22
150230,201702,967,781,186,731227.7,174282,905509.7
150240,201702,5506,3206,2300,3000453.47,2155087,5155540.47
150250,201702,32,14,18,13118,16866,29984
150260,201702,69,41,28,38417,26236,64653
150270,201702,2273,1486,787,1391820,736857,2128677
150275,201702,632,382,250,357934,234250,592184
150276,201702,100,40,60,37480,56220,93700
150277,201702,760,322,438,301695.63,410406,712101.63
150280,201702,338,202,136,189274,127432,316706
150285,201702,71,35,36,32795,33732,66527
150290,201702,937,569,368,532862.53,344535,877397.53
150293,201702,697,313,384,292859.63,359808,652667.63
150295,201702,456,191,265,178967,248173.82,427140.82
150300,201702,80,43,37,40291,34669,74960
150304,201702,136,84,52,78708,48724,127432
150307,201702,388,312,76,292344,71212,363556
150309,201702,499,354,145,331698,135865,467563
150310,201702,253,171,82,160227,76834,237061
150320,201702,1707,1167,540,1093202.59,505980,1599182.59
150330,201702,2044,1160,884,1086264.1,828308,1914572.1
150340,201702,190,123,67,115016.75,62779,177795.75
150345,201702,608,320,288,299840,269856,569696
150350,201702,763,574,189,535308.1,177093,712401.1
150360,201702,4312,2780,1532,2602174.74,1435474.63,4037649.37
150370,201702,719,502,217,469710,203038.9,672748.9
150375,201702,193,105,88,98385,82456,180841
150380,201702,1181,755,426,707435,398881,1106316
150390,201702,726,413,313,386981,293272,680253
150400,201702,88,69,19,64653,17803,82456
150405,201702,1241,818,423,765441.86,395788.8,1161230.66
150410,201702,146,93,53,87141,49661,136802
150420,201702,6987,3776,3211,3536453.07,3007235.24,6543688.31
150430,201702,465,311,154,291407,144298,435705
150440,201702,604,352,252,329075,235843,564918
150442,201702,1953,1069,884,999882.07,828308,1828190.07
150445,201702,501,310,191,290470,178030,468500
150450,201702,275,124,151,116188,141487,257675
150460,201702,892,659,233,615407.66,218302.26,833709.92
150470,201702,1317,779,538,729642,504106,1233748
150475,201702,25,19,6,17803,5622,23425
150480,201702,1222,846,376,792702,352312,1145014
150490,201702,615,317,298,297029,279226,576255
150495,201702,318,214,104,200518,97448,297966
150497,201702,296,201,95,188337,89005.63,277342.63
150500,201702,432,293,139,274541,130243,404784
150503,201702,733,343,390,321391,365412,686803
150506,201702,1033,642,391,601554,366348.63,967902.63
150510,201702,1243,700,543,655619,508791,1164410
150520,201702,258,171,87,160227,81519,241746
150530,201702,1449,800,649,747164.55,607832,1354996.55
150540,201702,414,295,119,276415,111503,387918
150543,201702,646,366,280,342660.9,262078.9,604739.8
150548,201702,484,320,164,299840,153668,453508
150549,201702,57,38,19,35606,17803,53409
150550,201702,2871,1476,1395,1382310,1306553,2688863
150553,201702,2894,1724,1170,1614826,1095989,2710815
150555,201702,142,73,69,68401,64653,133054
150560,201702,51,38,13,35606,12181,47787
150563,201702,57,29,28,27173,26236,53409
150565,201702,157,89,68,83393,63716,147109
150570,201702,396,262,134,245475.26,125558,371033.26
150580,201702,1460,575,885,538119.1,829245,1367364.1
150590,201702,914,540,374,505980,350438,856418
150600,201702,439,268,171,251116,160227,411343
150610,201702,138,119,19,110670,17803,128473
150611,201702,129,86,43,80582,40291,120873
150613,201702,3085,1884,1201,1765304,1125319,2890623
150616,201702,477,290,187,271495.75,175219,446714.75
150618,201702,1100,591,509,553542.49,476933,1030475.49
150619,201702,408,305,103,285785,96511,382296
150620,201702,1253,715,538,669955,504106,1174061
150630,201702,308,207,101,193959,94637,288596
150635,201702,492,194,298,181778,278944.9,460722.9
150640,201702,61,30,31,28110,29047,57157
150650,201702,2268,1290,978,1208458.27,914886.8,2123345.07
150655,201702,250,187,63,175219,59031,234250
150658,201702,99,56,43,52472,40291,92763
150660,201702,472,329,143,308273,133991,442264
150670,201702,960,330,630,308919.9,590291.63,899211.53
150680,201702,9471,5223,4248,4889052.86,3977801.26,8866854.12
150690,201702,48,29,19,27173,17803,44976
150700,201702,559,360,199,337132.6,186463,523595.6
150710,201702,245,150,95,140550,89015,229565
150715,201702,876,517,359,483464.26,336345.89,819810.15
150720,201702,453,335,118,313895,110284.9,424179.9
150730,201702,845,447,398,418830,372644.9,791474.9
150740,201702,328,236,92,221132,86204,307336
150745,201702,781,388,393,363556,368241,731797
150746,201702,53,32,21,29984,19677,49661
150747,201702,271,209,62,195833,58094,253927
150750,201702,115,65,50,60905,46850,107755
150760,201702,1353,842,511,788673,478807,1267480
150770,201702,355,179,176,167723,164740.07,332463.07
150775,201702,81,39,42,36543,39354,75897
150780,201702,177,91,86,85267,80582,165849
150790,201702,899,474,425,444138,398225,842363
150795,201702,1390,795,595,744915,557515,1302430
150796,201702,416,240,176,224880,164912,389792
150797,201702,263,154,109,144298,102133,246431
150800,201702,1384,833,551,779579.31,516005.9,1295585.21
150803,201702,584,484,100,453508,93700,547208
150805,201702,187,118,69,110566,64639.63,175205.63
150808,201702,928,503,425,471311,398225,869536
150810,201702,3378,2302,1076,2151719.38,1007912.26,3159631.64
150812,201702,423,222,201,208014,188337,396351
150815,201702,913,605,308,565330.07,288596,853926.07
150820,201702,1604,979,625,916386,585606.26,1501992.26
150830,201702,837,582,255,544397,238935,783332
150835,201702,169,99,70,92763,65590,158353
150840,201702,1255,801,454,750256,425398,1175654
160005,201702,48,29,19,27173,17803,44976
160010,201702,196,122,74,114314,69334,183648
160015,201702,114,67,47,62779,44039,106818
160020,201702,114,65,49,60905,45913,106818
160021,201702,39,20,19,18740,17803,36543
160023,201702,104,56,48,52472,44976,97448
160025,201702,33,14,19,13118,17803,30921
160027,201702,1402,777,625,724583.1,584888,1309471.1
160030,201702,14903,7552,7351,7067992,6880401.15,13948393.15
160040,201702,310,175,135,163975,126495,290470
160050,201702,600,303,297,283911,278007.9,561918.9
160053,201702,349,192,157,179623,147109,326732
160055,201702,19,13,6,12181,5622,17803
160060,201702,6218,3201,3017,2987487.3,2825707.1,5813194.4
160070,201702,157,95,62,89015,58094,147109
160080,201702,76,38,38,35606,35606,71212
170025,201702,22,14,8,13118,7496,20614
170030,201702,226,179,47,167248,44039,211287
170035,201702,237,107,130,99322,121810,221132
170040,201702,184,143,41,133709.9,38417,172126.9
170070,201702,342,193,149,180841,139613,320454
170100,201702,380,265,115,248071,107755,355826
170105,201702,63,52,11,48724,10307,59031
170110,201702,97,58,39,54346,36543,90889
170130,201702,70,31,39,29047,36262,65309
170190,201702,111,68,43,63716,40291,104007
170200,201702,399,263,136,245766.1,127329.78,373095.88
170210,201702,5875,2997,2878,2802868.61,2693482.33,5496350.94
170215,201702,65,31,34,29047,31858,60905
170220,201702,1442,1044,398,976147.86,372457.6,1348605.46
170230,201702,156,100,56,93700,52472,146172
170240,201702,593,387,206,362619,193022,555641
170255,201702,1116,884,232,828308,217102.9,1045410.9
170270,201702,37,26,11,24362,10025.9,34387.9
170290,201702,62,45,17,42165,15929,58094
170300,201702,77,47,30,43289.4,28110,71399.4
170305,201702,35,28,7,26236,6559,32795
170307,201702,56,41,15,38417,14055,52472
170310,201702,95,51,44,47787,41228,89015
170320,201702,17,13,4,12181,3748,15929
170330,201702,19,16,3,14992,2811,17803
170360,201702,21,13,8,12181,7496,19677
170370,201702,170,80,90,74960,84330,159290
170380,201702,79,54,25,50598,23425,74023
170382,201702,49,43,6,40291,5622,45913
170384,201702,121,84,37,78708,34669,113377
170386,201702,57,27,30,25299,28110,53409
170388,201702,46,17,29,15929,27173,43102
170389,201702,25,18,7,16866,6559,23425
170390,201702,48,27,21,25299,19677,44976
170410,201702,34,23,11,21551,10307,31858
170460,201702,17,12,5,11244,4685,15929
170510,201702,26,18,8,16866,7496,24362
170550,201702,1434,801,633,750517,592371.5,1342888.5
170555,201702,109,74,35,69338,32795,102133
170560,201702,100,71,29,66527,27173,93700
170600,201702,36,18,18,16866,16866,33732
170610,201702,196,107,89,100104.4,83375,183479.4
170625,201702,37,17,20,15929,18740,34669
170650,201702,78,56,22,52472,20614,73086
170700,201702,547,414,133,385997.15,123824.55,509821.70
170710,201702,155,95,60,89015,56211,145226
170720,201702,77,64,13,59968,12181,72149
170730,201702,54,32,22,29984,20614,50598
170740,201702,68,49,19,45913,17803,63716
170755,201702,115,52,63,48114.95,59031,107145.95
170765,201702,150,67,83,62170,77771,139941
170770,201702,238,131,107,121950.55,100187.33,222137.88
170820,201702,588,379,209,355123,195412,550535
170825,201702,32,19,13,17803,12181,29984
170830,201702,71,48,23,44788.6,21551,66339.6
170900,201702,208,159,49,148983,45913,194896
170930,201702,771,381,390,356679,365149,721828
170950,201702,2909,1255,1654,1173621.88,1547530.93,2721152.81
170980,201702,16,9,7,8433,6559,14992
171050,201702,124,95,29,89015,27173,116188
171070,201702,33,26,7,24362,6559,30921
171090,201702,35,24,11,22488,10307,32795
171110,201702,22,15,7,14055,6559,20614
171150,201702,37,18,19,16866,17803,34669
171180,201702,20,9,11,8433,10307,18740
171190,201702,125,69,56,64653,52472,117125
171195,201702,62,47,15,44039,14055,58094
171200,201702,45,19,26,17803,24362,42165
171215,201702,1,1,0,937,0,937
171240,201702,52,42,10,39354,9370,48724
171245,201702,47,42,5,39354,4685,44039
171250,201702,67,31,36,29047,33722.63,62769.63
171270,201702,16,12,4,11244,3748,14992
171280,201702,36,33,3,30781,2811,33592
171320,201702,976,546,430,511602,401973,913575
171330,201702,390,178,212,166786,198644,365430
171360,201702,80,58,22,54346,20614,74960
171370,201702,21,10,11,9370,10307,19677
171380,201702,125,101,24,94637,22262.19,116899.19
171395,201702,52,31,21,29047,19677,48724
171420,201702,323,212,111,198644,103725.9,302369.9
171430,201702,57,46,11,42462,10307,52769
171488,201702,206,103,103,96511,96511,193022
171500,201702,61,32,29,29984,27173,57157
171510,201702,61,40,21,37480,19677,57157
171515,201702,43,36,7,33732,6559,40291
171525,201702,30,26,4,24362,3748,28110
171550,201702,11,5,6,4685,5622,10307
171570,201702,57,28,29,26236,27173,53409
171575,201702,359,208,151,194756,141477.63,336233.63
171610,201702,1604,780,824,728994.83,770521.47,1499516.30
171620,201702,124,83,41,77227.54,38135.9,115363.44
171630,201702,52,27,25,25299,23425,48724
171650,201702,280,175,105,163975,98385,262360
171660,201702,255,136,119,127432,111503,238935
171665,201702,40,24,16,22488,14992,37480
171670,201702,431,244,187,226978.98,174656.8,401635.78
171700,201702,59,53,6,49661,5622,55283
171720,201702,24,9,15,8433,14055,22488
171750,201702,95,52,43,48724,40291,89015
171780,201702,68,55,13,51535,12181,63716
171790,201702,78,63,15,59031,14055,73086
171800,201702,33,25,8,23425,7496,30921
171820,201702,1912,1082,830,1013137.47,771967.31,1785104.78
171830,201702,35,26,9,24362,8433,32795
171840,201702,54,30,24,28110,22488,50598
171845,201702,31,19,12,17803,11244,29047
171850,201702,37,25,12,23425,11244,34669
171855,201702,66,51,15,47787,14055,61842
171865,201702,9,6,3,5622,2811,8433
171870,201702,32,23,9,21551,8433,29984
171875,201702,78,53,25,49661,23425,73086
171880,201702,25,18,7,16866,6559,23425
171884,201702,38,18,20,16866,18740,35606
171886,201702,109,39,70,36543,65308.9,101851.9
171888,201702,21,13,8,12181,7496,19677
171889,201702,22,15,7,14055,6559,20614
171890,201702,57,46,11,43102,10307,53409
171900,201702,44,30,14,28110,13118,41228
172000,201702,39,32,7,29984,6559,36543
172010,201702,38,31,7,28250.55,6559,34809.55
172015,201702,26,15,11,14055,10025.9,24080.9
172020,201702,124,76,48,71212,44976,116188
172025,201702,30,19,11,17803,10307,28110
172030,201702,31,19,12,17803,11244,29047
172049,201702,71,44,27,41228,25299,66527
172065,201702,156,102,54,95574,50598,146172
172080,201702,70,52,18,47563.02,16866,64429.02
172085,201702,22,9,13,8433,12181,20614
172090,201702,408,311,97,291407,90140,381547
172093,201702,27,18,9,16866,8433,25299
172097,201702,19,9,10,8433,9089,17522
172100,201702,4399,2409,1990,2252056.67,1861721.93,4113778.60
172110,201702,77,51,26,47787,24362,72149
172120,201702,1740,1486,254,1388046.6,236910.14,1624956.74
172125,201702,2,2,0,1874,0,1874
172130,201702,12,10,2,9370,1874,11244
172208,201702,186,117,69,109629,64653,174282
172210,201702,502,228,274,213636,256457,470093
210005,201702,2922,1807,1115,1690160.96,1041945,2732105.96
210010,201702,205,99,106,92763,99322,192085
210015,201702,22,14,8,13118,7496,20614
210020,201702,331,171,160,160227,149920,310147
210030,201702,349,212,137,198644,128360,327004
210040,201702,158,122,36,114314,33732,148046
210043,201702,252,164,88,153668,82456,236124
210047,201702,632,303,329,283536.2,308263.63,591799.83
210050,201702,314,229,85,214573,79645,294218
210055,201702,43,33,10,30921,9370,40291
210060,201702,576,433,143,405623.56,133991,539614.56
210070,201702,418,296,122,277352,114032.9,391384.9
210080,201702,99,91,8,85267,7496,92763
210083,201702,310,121,189,113377,177093,290470
210087,201702,52,33,19,30921,17803,48724
210090,201702,501,341,160,319517,149920,469437
210095,201702,504,344,160,322328,149920,472248
210100,201702,677,503,174,470983.05,162101.35,633084.40
210110,201702,158,83,75,77771,70275,148046
210120,201702,5644,4161,1483,3894192.17,1388600.32,5282792.49
210125,201702,217,110,107,103070,100259,203329
210130,201702,623,313,310,292344,290470,582814
210135,201702,35,20,15,18740,14055,32795
210140,201702,3935,3034,901,2839719.22,844066,3683785.22
210150,201702,348,216,132,202392,123511,325903
210160,201702,3291,2730,561,2555201.68,525376,3080577.68
210170,201702,1084,827,257,774899,240809,1015708
210173,201702,113,90,23,84330,21551,105881
210177,201702,512,237,275,222069,257675,479744
210180,201702,27,14,13,13118,12181,25299
210190,201702,396,245,151,229565,141487,371052
210193,201702,0,0,0,0,0,0
210197,201702,86,56,30,52472,28110,80582
210200,201702,641,496,145,464752,135865,600617
210203,201702,271,172,99,161164,92763,253927
210207,201702,379,284,95,266108,89015,355123
210210,201702,759,685,74,641845,69338,711183
210215,201702,73,61,12,57157,11244,68401
210220,201702,404,329,75,308273,70275,378548
210230,201702,309,220,89,206140,83393,289533
210232,201702,1531,926,605,867381,566885,1434266
210235,201702,155,119,36,111222,33732,144954
210237,201702,44,24,20,22488,18740,41228
210240,201702,94,76,18,71212,16866,88078
210250,201702,173,133,40,124621,37480,162101
210255,201702,289,209,80,195833,74960,270793
210260,201702,439,253,186,237061,174282,411343
210270,201702,729,444,285,416028,267045,683073
210275,201702,37,29,8,27173,7496,34669
210280,201702,1017,635,382,591849.45,356622.25,948471.70
210290,201702,492,300,192,281100,179904,461004
210300,201702,6271,3540,2731,3311641,2557758.37,5869399.37
210310,201702,101,68,33,63716,30921,94637
210312,201702,128,77,51,72149,47787,119936
210315,201702,116,81,35,75897,32795,108692
210317,201702,120,81,39,75897,36543,112440
210320,201702,2380,1924,456,1802045.98,426335,2228380.98
210325,201702,127,87,40,80582,37199,117781
210330,201702,6012,2886,3126,2700982.7,2929052.63,5630035.33
210340,201702,1469,1025,444,960425,415957.85,1376382.85
210350,201702,594,473,121,442966.75,113377,556343.75
210355,201702,121,94,27,88078,25299,113377
210360,201702,2761,1681,1080,1572006.9,1011960,2583966.9
210370,201702,1223,483,740,452571,692724.1,1145295.1
210375,201702,192,98,94,91216,88078,179294
210380,201702,658,508,150,475996,140530,616526
210390,201702,193,159,34,148983,31858,180841
210400,201702,481,395,86,370115,80582,450697
210405,201702,969,627,342,586905.87,320454,907359.87
210407,201702,56,43,13,40291,12181,52472
210408,201702,68,61,7,57157,6559,63716
210409,201702,314,258,56,241746,52472,294218
210410,201702,438,330,108,309210,101187,410397
210420,201702,195,158,37,148046,34669,182715
210430,201702,34,26,8,24362,7496,31858
210440,201702,447,253,194,237061,180841,417902
210450,201702,157,114,43,106818,40291,147109
210455,201702,197,103,94,96511,88078,184589
210460,201702,343,216,127,202392,118999,321391
210462,201702,52,43,9,40291,8433,48724
210465,201702,191,131,60,122747,56220,178967
210467,201702,499,351,148,328887,138676,467563
210470,201702,39,27,12,25299,11244,36543
210480,201702,1259,873,386,818001,361682,1179683
210490,201702,222,129,93,120873,87141,208014
210500,201702,544,283,261,265171,244557,509728
210510,201702,542,411,131,385107,122747,507854
210515,201702,456,228,228,213636,213636,427272
210520,201702,396,343,53,321109.9,49661,370770.9
210530,201702,9146,4884,4262,4561695.79,3988435.8,8550131.59
210535,201702,143,97,46,90889,43102,133991
210540,201702,1548,891,657,833462.4,614203.5,1447665.9
210542,201702,1129,580,549,542945.2,514413,1057358.2
210545,201702,12,11,1,10307,937,11244
210547,201702,135,115,20,107755,18740,126495
210550,201702,764,519,245,485231.9,229283.9,714515.8
210560,201702,172,141,31,132117,29047,161164
210565,201702,31,21,10,19677,9370,29047
210570,201702,1325,1011,314,947307,294208.63,1241515.63
210580,201702,104,89,15,83393,14055,97448
210590,201702,785,594,191,555828.4,178967,734795.4
210592,201702,36,31,5,29047,4685,33732
210594,201702,93,79,14,74023,13118,87141
210596,201702,75,63,12,59031,11244,70275
210598,201702,122,87,35,81519,32795,114314
210600,201702,356,297,59,278289,55283,333572
210610,201702,243,225,18,209888,16866,226754
210620,201702,48,27,21,25299,19677,44976
210630,201702,58,54,4,50598,3748,54346
210632,201702,1161,724,437,678388,408719.4,1087107.4
210635,201702,14,12,2,11244,1874,13118
210637,201702,103,72,31,67464,29047,96511
210640,201702,582,494,88,462878,82456,545334
210650,201702,399,319,80,298715.6,74023,372738.6
210660,201702,400,281,119,263297,111503,374800
210663,201702,15,10,5,9370,4685,14055
210667,201702,121,36,85,33732,79645,113377
210670,201702,264,234,30,218556,28110,246666
210675,201702,577,288,289,269856,270793,540649
210680,201702,220,131,89,122747,83393,206140
210690,201702,639,493,146,461941,136802,598743
210700,201702,189,135,54,126495,50598,177093
210710,201702,310,171,139,160227,130243,290470
210720,201702,118,97,21,90889,19677,110566
210725,201702,60,54,6,50598,5622,56220
210730,201702,23,17,6,15929,5622,21551
210735,201702,407,261,146,244557,136521,381078
210740,201702,541,453,88,424461,82456,506917
210745,201702,149,102,47,95574,44039,139613
210750,201702,2431,1035,1396,968732,1308033.26,2276765.26
210760,201702,286,196,90,183652,84315.95,267967.95
210770,201702,401,309,92,288596,85922.9,374518.9
210780,201702,418,294,124,275478,115251.45,390729.45
210790,201702,185,140,45,131180,42165,173345
210800,201702,122,92,30,86204,28110,114314
210805,201702,38,35,3,32795,2811,35606
210810,201702,489,360,129,336664.1,120873,457537.1
210820,201702,2333,1794,539,1672725.39,505043,2177768.39
210825,201702,177,88,89,82456,83393,165849
210830,201702,827,485,342,453508,319517,773025
210840,201702,216,138,78,129306,73086,202392
210845,201702,259,149,110,139613,103070,242683
210850,201702,905,564,341,528155.7,319517,847672.7
210860,201702,4225,2066,2159,1934905,2022962.89,3957867.89
210870,201702,470,341,129,319517,120873,440390
210880,201702,52,35,17,32795,15929,48724
210890,201702,346,281,65,263297,60905,324202
210900,201702,508,310,198,290470,185526,475996
210905,201702,80,34,46,31858,43102,74960
210910,201702,2008,1454,554,1361401.1,519098,1880499.1
210920,201702,262,73,189,68401,177093,245494
210923,201702,74,56,18,52472,16866,69338
210927,201702,448,165,283,154605,265171,419776
210930,201702,58,44,14,41228,13118,54346
210940,201702,96,69,27,64653,25299,89952
210945,201702,202,86,116,80582,108692,189274
210950,201702,512,363,149,340131,139608.32,479739.32
210955,201702,78,52,26,48724,24362,73086
210960,201702,2486,974,1512,911045.7,1416463,2327508.7
210970,201702,110,93,17,87141,15929,103070
210975,201702,80,72,8,67464,7496,74960
210980,201702,1308,537,771,503056.56,722146,1225202.56
210990,201702,4499,2693,1806,2523060,1692202,4215262
211000,201702,1407,1071,336,1003226,314550.9,1317776.9
211003,201702,926,622,304,582814,284839,867653
211010,201702,482,418,64,391666,59968,451634
211020,201702,1662,555,1107,520035,1037259,1557294
211023,201702,20,17,3,15647.9,2811,18458.9
211027,201702,58,38,20,35606,18740,54346
211030,201702,390,249,141,233313,132117,365430
211040,201702,313,229,84,214292,78708,293000
211050,201702,1192,721,471,675577,441041.32,1116618.32
211060,201702,686,579,107,542523,100259,642782
211065,201702,24,20,4,18740,3748,22488
211070,201702,908,725,183,678678.97,171471,850149.97
211080,201702,90,85,5,79645,4685,84330
211085,201702,60,31,29,28766,27173,55939
211090,201702,96,78,18,73086,16866,89952
211100,201702,527,414,113,387918,105881,493799
211102,201702,274,171,103,160227,96511,256738
211105,201702,207,137,70,128369,65590,193959
211107,201702,117,65,52,60905,48724,109629
211110,201702,811,523,288,489489,269847,759336
211120,201702,5826,2243,3583,2098375.03,3354981.92,5453356.95
211125,201702,34,28,6,26236,5622,31858
211130,201702,46562,18536,28026,17340935.87,26248206.15,43589142.02
211140,201702,459,379,80,355119,74679,429798
211150,201702,1235,748,487,700876,456315,1157191
211153,201702,185,101,84,94637,78708,173345
211157,201702,52,37,15,34669,14055,48724
211160,201702,684,553,131,517212.25,122747,639959.25
211163,201702,0,0,0,0,0,0
211167,201702,6,5,1,4685,937,5622
211170,201702,442,297,145,278289,135865,414154
211172,201702,121,77,44,72149,41228,113377
211174,201702,296,168,128,157416,119936,277352
211176,201702,527,364,163,341068,152731,493799
211178,201702,91,59,32,55283,29984,85267
211180,201702,212,163,49,152731,45753.71,198484.71
211190,201702,58,54,4,50598,3748,54346
211195,201702,18,10,8,9370,7496,16866
211200,201702,146,127,19,118661.68,17803,136464.68
211210,201702,661,315,346,294499.1,324202,618701.1
211220,201702,3853,2149,1704,2008179.71,1589256.22,3597435.93
211223,201702,92,86,6,80403.97,5622,86025.97
211227,201702,68,43,25,40291,23425,63716
211230,201702,800,641,159,600476.45,148964.26,749440.71
211240,201702,419,300,119,281100,111503,392603
211245,201702,207,83,124,77771,116188,193959
211250,201702,1667,1403,264,1313765,247368,1561133
211260,201702,806,621,185,581877,173345,755222
211270,201702,2145,1638,507,1534806,474122.1,2008928.1
211280,201702,1854,1065,789,996032.08,739293,1735325.08
211285,201702,225,123,102,115251,95292.9,210543.9
211290,201702,695,451,244,422399.6,228628,651027.6
211300,201702,818,608,210,569441.7,196770,766211.7
211400,201702,1671,895,776,838615,727112,1565727
220005,201702,19,18,1,16866,937,17803
220010,201702,90,68,22,63716,20332.9,84048.9
220020,201702,515,404,111,377954.6,104007,481961.6
220025,201702,109,105,4,98385,3748,102133
220027,201702,40,32,8,29984,7496,37480
220030,201702,86,70,16,65590,14992,80582
220040,201702,1068,798,270,746789,252990,999779
220045,201702,34,27,7,25299,6559,31858
220050,201702,636,511,125,477665.88,117106.26,594772.14
220060,201702,171,143,28,133991,26236,160227
220070,201702,133,122,11,114314,10307,124621
220080,201702,5,4,1,3748,937,4685
220090,201702,33,25,8,23144,7496,30640
220095,201702,3,2,1,1874,937,2811
220100,201702,27,23,4,21551,3748,25299
220105,201702,39,36,3,33732,2811,36543
220110,201702,201,186,15,174000.9,14055,188055.9
220115,201702,37,34,3,31858,2811,34669
220117,201702,18,18,0,16866,0,16866
220120,201702,1506,1006,500,942772.85,468500,1411272.85
220130,201702,23,22,1,20614,937,21551
220140,201702,105,85,20,78638.49,18740,97378.49
220150,201702,431,299,132,280163,123684,403847
220155,201702,5,5,0,4685,0,4685
220157,201702,20,16,4,14992,3748,18740
220160,201702,68,60,8,56220,7496,63716
220170,201702,33,31,2,29047,1874,30921
220173,201702,7,7,0,6559,0,6559
220177,201702,5,5,0,4685,0,4685
220180,201702,68,67,1,62770.32,937,63707.32
220190,201702,1024,922,102,863914,94824.4,958738.4
220191,201702,46,41,5,38417,4685,43102
220192,201702,66,63,3,59031,2811,61842
220194,201702,19,16,3,14992,2811,17803
220196,201702,104,87,17,81379,15929,97308
220198,201702,6,4,2,3748,1874,5622
220200,201702,431,344,87,323049,81519,404568
220202,201702,35,31,4,29047,3748,32795
220205,201702,35,29,6,27173,5622,32795
220207,201702,17,16,1,14992,937,15929
220208,201702,81,40,41,37480,38417,75897
220209,201702,33,30,3,28110,2811,30921
220210,201702,19,18,1,16866,937,17803
220211,201702,46,45,1,42165,937,43102
220213,201702,45,39,6,36543,5622,42165
220217,201702,38,30,8,28110,7496,35606
220220,201702,1930,1238,692,1156324.49,647167.76,1803492.25
220225,201702,13,6,7,5622,6559,12181
220230,201702,901,718,183,672325.61,170843.21,843168.82
220240,201702,139,126,13,118062,12181,130243
220245,201702,53,49,4,45535,3748,49283
220250,201702,135,120,15,112440,14055,126495
220253,201702,40,30,10,28110,9370,37480
220255,201702,28,24,4,22488,3748,26236
220260,201702,688,505,183,473185,171471,644656
220265,201702,14,11,3,10307,2811,13118
220270,201702,609,537,72,502456.88,66995.5,569452.38
220271,201702,44,33,11,30921,10307,41228
220272,201702,24,23,1,21551,937,22488
220273,201702,16,13,3,12181,2811,14992
220275,201702,46,37,9,34669,8433,43102
220277,201702,7,7,0,6559,0,6559
220280,201702,21,19,2,17803,1874,19677
220285,201702,55,50,5,46850,4685,51535
220290,201702,1373,1169,204,1092871,191102,1283973
220300,201702,59,57,2,53409,1874,55283
220310,201702,300,252,48,235982.27,44967,280949.27
220320,201702,436,402,34,375269.5,31858,407127.5
220323,201702,0,0,0,0,0,0
220325,201702,15,10,5,9370,4685,14055
220327,201702,11,10,1,9370,937,10307
220330,201702,175,115,60,107473.9,56220,163693.9
220335,201702,136,120,16,112421.26,14992,127413.26
220340,201702,38,26,12,24362,11244,35606
220342,201702,50,43,7,40291,6559,46850
220345,201702,118,104,14,97448,13118,110566
220350,201702,432,382,50,355358.01,46850,402208.01
220360,201702,37,29,8,27173,7496,34669
220370,201702,1014,803,211,751661.4,197707,949368.4
220375,201702,24,23,1,21551,937,22488
220380,201702,34,26,8,24362,7496,31858
220385,201702,29,24,5,22488,4685,27173
220390,201702,2166,1242,924,1159144.2,863493.41,2022637.61
220400,201702,26,25,1,23425,937,24362
220410,201702,17,14,3,13118,2811,15929
220415,201702,13,12,1,11244,937,12181
220420,201702,130,108,22,101196,20332.9,121528.9
220430,201702,127,115,12,106116.4,11244,117360.4
220435,201702,26,19,7,17803,6559,24362
220440,201702,294,253,41,237061,38417,275478
220450,201702,304,162,142,150649.74,133054,283703.74
220455,201702,58,56,2,52472,1874,54346
220460,201702,24,21,3,19021.1,2811,21832.1
220465,201702,98,62,36,58094,33732,91826
220470,201702,234,203,31,189274.8,29047,218321.8
220480,201702,69,57,12,53409,11244,64653
220490,201702,82,71,11,65770,10307,76077
220500,201702,96,83,13,77771,12181,89952
220510,201702,376,301,75,281288,70087.6,351375.6
220515,201702,20,16,4,14992,3748,18740
220520,201702,352,314,38,292535,35588,328123
220525,201702,27,19,8,17803,7496,25299
220527,201702,38,32,6,29188,5622,34810
220530,201702,34,14,20,13118,18740,31858
220535,201702,12,11,1,10307,937,11244
220540,201702,51,38,13,35606,12181,47787
220545,201702,67,44,23,41228,21551,62779
220550,201702,604,457,147,428209,137739,565948
220551,201702,25,19,6,17803,5622,23425
220552,201702,8,8,0,7496,0,7496
220553,201702,65,59,6,55283,5622,60905
220554,201702,15,9,6,8151.9,5622,13773.9
220555,201702,25,21,4,19677,3748,23425
220556,201702,60,56,4,52472,3748,56220
220557,201702,52,47,5,44039,4685,48724
220558,201702,7,2,5,1874,4685,6559
220559,201702,6,5,1,4685,937,5622
220560,201702,51,34,17,31670.6,15929,47599.6
220570,201702,736,430,306,402664.14,286722,689386.14
220580,201702,596,538,58,504106,53391.26,557497.26
220585,201702,5,4,1,3748,937,4685
220590,201702,15,15,0,14055,0,14055
220595,201702,59,44,15,41228,14055,55283
220600,201702,21,11,10,10307,9370,19677
220605,201702,20,19,1,17803,937,18740
220610,201702,55,48,7,44976,6559,51535
220620,201702,542,414,128,386747.04,119936,506683.04
220630,201702,8,6,2,5622,1874,7496
220635,201702,34,30,4,28110,3748,31858
220640,201702,97,71,26,66527,24362,90889
220650,201702,113,107,6,100259,5622,105881
220660,201702,26,20,6,18740,5622,24362
220665,201702,5,4,1,3748,937,4685
220667,201702,11,11,0,10307,0,10307
220669,201702,17,16,1,14992,937,15929
220670,201702,61,48,13,44788.6,12181,56969.6
220672,201702,45,29,16,27173,14710.9,41883.9
220675,201702,34,26,8,24362,7496,31858
220680,201702,34,31,3,29047,2811,31858
220690,201702,50,45,5,42165,4685,46850
220695,201702,68,30,38,28110,35606,63716
220700,201702,1404,1066,338,996799.59,316425,1313224.59
220710,201702,5,3,2,2811,1874,4685
220720,201702,121,97,24,90654.75,22347.45,113002.20
220730,201702,20,20,0,18740,0,18740
220735,201702,3,1,2,937,1874,2811
220740,201702,38,36,2,33732,1874,35606
220750,201702,96,77,19,72149,17803,89952
220755,201702,17,17,0,15929,0,15929
220760,201702,43,40,3,37480,2811,40291
220770,201702,5513,2690,2823,2514788.52,2639404.18,5154192.70
220775,201702,28,13,15,12181,14055,26236
220777,201702,11,11,0,10307,0,10307
220779,201702,16,11,5,10307,4685,14992
220780,201702,826,702,124,657118.1,115907,773025.1
220785,201702,4,3,1,2811,937,3748
220790,201702,970,766,204,715401.34,191148,906549.34
220793,201702,15,15,0,14055,0,14055
220795,201702,25,24,1,22488,937,23425
220800,201702,3696,2802,894,2623103.19,836727.74,3459830.93
220810,201702,50,46,4,43102,3748,46850
220820,201702,234,212,22,198363,20614,218977
220830,201702,1095,916,179,858287.32,167723,1026010.32
220840,201702,2314,1508,806,1403770.03,752880,2156650.03
220850,201702,51,39,12,36543,11244,47787
220855,201702,15,10,5,9370,4685,14055
220860,201702,17,15,2,14055,1874,15929
220865,201702,21,19,2,17803,1874,19677
220870,201702,59,55,4,51535,3748,55283
220880,201702,337,256,81,239216.1,75616,314832.1
220885,201702,45,40,5,37480,4685,42165
220887,201702,21,20,1,18740,937,19677
220890,201702,106,93,13,87141,12181,99322
220900,201702,43,25,18,23425,16866,40291
220910,201702,55,45,10,42165,9370,51535
220915,201702,20,19,1,17803,937,18740
220920,201702,39,36,3,33732,2811,36543
220930,201702,41,40,1,36680.73,937,37617.73
220935,201702,21,20,1,18740,937,19677
220937,201702,42,40,2,37480,1874,39354
220940,201702,49,44,5,41228,4685,45913
220945,201702,0,0,0,0,0,0
220950,201702,45,42,3,39354,2811,42165
220955,201702,38,36,2,33732,1874,35606
220960,201702,6,6,0,5622,0,5622
220965,201702,25,21,4,19677,3748,23425
220970,201702,45,37,8,34669,7496,42165
220975,201702,9,8,1,7496,937,8433
220980,201702,42,38,4,35606,3748,39354
220985,201702,57,52,5,48724,4685,53409
220987,201702,31,29,2,27173,1874,29047
220990,201702,11,9,2,8433,1874,10307
220995,201702,38,33,5,30921,4685,35606
220997,201702,30,24,6,22488,5622,28110
221000,201702,1044,936,108,874458.81,100914.9,975373.71
221005,201702,61,56,5,52472,4685,57157
221010,201702,16,13,3,12181,2811,14992
221020,201702,50,49,1,45913,937,46850
221030,201702,34,27,7,25299,6559,31858
221035,201702,17,16,1,14992,937,15929
221037,201702,11,7,4,6559,3748,10307
221038,201702,6,5,1,4685,937,5622
221039,201702,20,20,0,18740,0,18740
221040,201702,239,206,33,193022,30921,223943
221050,201702,227,190,37,178030,34669,212699
221060,201702,1411,1230,181,1151713.55,169597,1321310.55
221062,201702,30,29,1,27173,937,28110
221063,201702,15,11,4,10307,3748,14055
221065,201702,35,31,4,29047,3748,32795
221070,201702,153,131,22,122747,20614,143361
221080,201702,364,318,46,297966,42820.9,340786.9
221090,201702,40,39,1,36291,937,37228
221093,201702,73,50,23,46850,21551,68401
221095,201702,11,10,1,9370,937,10307
221097,201702,26,23,3,21551,2811,24362
221100,201702,23509,13369,10140,12507117.07,9497415.79,22004532.86
221110,201702,991,720,271,674339,253927,928266
221120,201702,488,358,130,335165,121810,456975
221130,201702,887,722,165,674987.69,153950,828937.69
221135,201702,30,27,3,25299,2811,28110
221140,201702,37,29,8,27173,7496,34669
221150,201702,14,10,4,9370,3748,13118
221160,201702,10,10,0,9370,0,9370
221170,201702,10,10,0,9370,0,9370
230010,201702,158,145,13,135865,12181,148046
230015,201702,110,92,18,86204,16866,103070
230020,201702,1449,1251,198,1169471,184863.08,1354334.08
230030,201702,1541,1104,437,1028978.92,409469,1438447.92
230040,201702,195,174,21,162101,19677,181778
230050,201702,184,138,46,129306,43102,172408
230060,201702,125,101,24,93887.4,22488,116375.4
230070,201702,271,239,32,223943,29984,253927
230075,201702,770,670,100,625355.5,92716.9,718072.4
230080,201702,171,152,19,142424,17803,160227
230090,201702,80,56,24,52472,22488,74960
230100,201702,1816,1083,733,1011650.46,686540,1698190.46
230110,201702,2561,1601,960,1496839.6,898957.9,2395797.5
230120,201702,886,699,187,652620.91,175219,827839.91
230125,201702,129,104,25,97448,23143.9,120591.9
230130,201702,427,382,45,357934,42165,400099
230140,201702,210,183,27,171471,25299,196770
230150,201702,153,118,35,110566,32795,143361
230160,201702,911,800,111,748897.5,104007,852904.5
230170,201702,705,631,74,587502.1,69338,656840.1
230180,201702,77,73,4,68401,3748,72149
230185,201702,385,330,55,307869.16,51535,359404.16
230190,201702,2096,1684,412,1574534.69,385732,1960266.69
230195,201702,483,420,63,392884.1,59031,451915.1
230200,201702,491,425,66,397278.63,61177,458455.63
230205,201702,333,209,124,193949.96,115906.9,309856.86
230210,201702,1231,983,248,920145.18,231626.4,1151771.58
230220,201702,1302,902,400,845174,374800,1219974
230230,201702,871,769,102,717992.85,95574,813566.85
230240,201702,1574,1349,225,1262359.85,210403.45,1472763.30
230250,201702,1676,1365,311,1274740.47,290845,1565585.47
230260,201702,2798,1642,1156,1533735.79,1082235.75,2615971.54
230270,201702,1308,1053,255,984525.23,236406.3,1220931.53
230280,201702,2567,1904,663,1778278.24,621231,2399509.24
230290,201702,389,351,38,322716.92,35606,358322.92
230300,201702,507,368,139,343579.16,130243,473822.16
230310,201702,393,301,92,282037,86204,368241
230320,201702,839,716,123,667823.17,115007,782830.17
230330,201702,287,232,55,216634.4,51535,268169.4
230340,201702,451,360,91,335634.4,85267,420901.4
230350,201702,2846,1784,1062,1671550.52,992284.24,2663834.76
230360,201702,242,213,29,198687,27173,225860
230365,201702,168,134,34,124856,31858,156714
230370,201702,9193,4362,4831,4077803.39,4520513.05,8598316.44
230380,201702,450,385,65,360464,59968.8,420432.8
230390,201702,489,264,225,245597.07,210825,456422.07
230393,201702,272,227,45,211859.4,42165,254024.4
230395,201702,317,262,55,245251,51535,296786
230400,201702,675,527,148,491550.9,138188.76,629739.66
230410,201702,2450,1505,945,1406297.55,884715.6,2291013.15
230420,201702,5436,3510,1926,3271026.64,1799877.32,5070903.96
230423,201702,297,255,42,237061.8,39354,276415.8
230425,201702,315,263,52,246431,48724,295155
230426,201702,103,93,10,86428.88,9088.9,95517.78
230427,201702,78,75,3,70275,2811,73086
230428,201702,1287,657,630,615103.02,590310,1205413.02
230430,201702,698,572,126,535491.9,117298.34,652790.24
230435,201702,711,489,222,457153,206796.17,663949.17
230440,201702,79870,34874,44996,32600934.85,42122710.46,74723645.31
230445,201702,245,169,76,158353,71212,229565
230450,201702,389,321,68,300777,63716,364493
230460,201702,51,44,7,41228,6559,47787
230465,201702,286,229,57,214573,53409,267982
230470,201702,1765,1365,400,1279005,373712.59,1652717.59
230480,201702,138,135,3,126213.9,2811,129024.9
230490,201702,265,214,51,200518,47787,248305
230495,201702,410,306,104,285885,97448,383333
230500,201702,907,670,237,625916,222060,847976
230510,201702,42,34,8,31858,7496,39354
230520,201702,383,302,81,282974,75897,358871
230523,201702,1731,1130,601,1056467.49,562617,1619084.49
230526,201702,286,241,45,225817,42165,267982
230530,201702,460,357,103,332635.9,95574.6,428210.5
230533,201702,167,162,5,151794,4685,156479
230535,201702,331,244,87,228628,81519,310147
230540,201702,1780,1570,210,1468491.7,196489,1664980.7
230550,201702,3515,2221,1294,2073145.49,1211634.7,3284780.19
230560,201702,571,439,132,409282.4,122747,532029.4
230565,201702,174,124,50,116188,46850,163038
230570,201702,301,269,32,252053,29984,282037
230580,201702,1067,788,279,736922.39,259923.8,996846.19
230590,201702,884,688,196,641143.05,183248.63,824391.68
230600,201702,237,219,18,203535.32,16866,220401.32
230610,201702,323,258,65,241559,60905,302464
230620,201702,155,126,29,117125,27173,144298
230625,201702,704,507,197,473701.25,183456.04,657157.29
230630,201702,1207,947,260,887339,243245.2,1130584.2
230640,201702,3270,2851,419,2664919.72,392603,3057522.72
230650,201702,387,342,45,319637.49,41509.1,361146.59
230655,201702,587,512,75,478619.4,70266,548885.4
230660,201702,304,252,52,236124,48724,284848
230670,201702,415,374,41,350438,38417,388855
230680,201702,193,178,15,166786,14055,180841
230690,201702,816,711,105,666207,98385,764592
230700,201702,688,585,103,548145,95781.9,643926.9
230710,201702,702,658,44,616359,41228,657587
230720,201702,127,108,19,100999.23,17803,118802.23
230725,201702,206,163,43,152731,40282,193013
230730,201702,10998,5960,5038,5566157.54,4710816.82,10276974.36
230740,201702,633,503,130,471030,121131.63,592161.63
230750,201702,618,526,92,491691.15,86204,577895.15
230760,201702,1160,1000,160,932745.49,149920,1082665.49
230763,201702,330,273,57,253880.41,53409,307289.41
230765,201702,6378,2946,3432,2753636.05,3212599.7,5966235.75
230770,201702,4770,2455,2315,2290384.94,2165932.14,4456317.08
230780,201702,665,588,77,548989,72149,621138
230790,201702,173,140,33,131180,30134.66,161314.66
230800,201702,924,667,257,624974.32,240809,865783.32
230810,201702,1214,1076,138,1006947.05,129306,1136253.05
230820,201702,306,220,86,205204,80582,285786
230830,201702,782,689,93,642925.02,87141,730066.02
230835,201702,262,228,34,212699,31156,243855
230837,201702,160,134,26,125558,24362,149920
230840,201702,847,677,170,633131.5,158072,791203.5
230850,201702,1414,1245,169,1166283.9,158072,1324355.9
230860,201702,306,221,85,207077,78708.25,285785.25
230870,201702,1709,1448,261,1355558,243231.35,1598789.35
230880,201702,76,60,16,56220,14992,71212
230890,201702,569,527,42,493799,39354,533153
230900,201702,251,195,56,182715,52279,234994
230910,201702,188,152,36,141674.4,33732,175406.4
230920,201702,363,286,77,267982,72149,340131
230930,201702,875,627,248,584688.92,232376,817064.92
230940,201702,812,651,161,609987,150670,760657
230945,201702,430,363,67,339944,62779,402723
230950,201702,375,311,64,291407,59968,351375
230960,201702,2286,1509,777,1407052.67,727768,2134820.67
230970,201702,1590,895,695,837719.45,650352.96,1488072.41
230980,201702,197,164,33,153668,30921,184589
230990,201702,139,113,26,105881,23618.95,129499.95
231000,201702,186,171,15,158353.74,14055,172408.74
231010,201702,131,103,28,96511,26236,122747
231020,201702,1162,815,347,762062.5,325119,1087181.5
231025,201702,878,654,224,610671.6,208652,819323.6
231030,201702,1138,951,187,891083,174938,1066021
231040,201702,130,89,41,82662.14,37699,120361.14
231050,201702,1001,887,114,829246.5,106818,936064.5
231060,201702,129,114,15,106818,14055,120873
231070,201702,1351,960,391,897646.95,366086,1263732.95
231080,201702,248,231,17,216447,15929,232376
231085,201702,486,307,179,286723,167723,454446
231090,201702,223,187,36,175219,33732,208951
231095,201702,157,127,30,118999,28110,147109
231100,201702,113,91,22,85267,19395.9,104662.9
231110,201702,314,268,46,249621.39,43102,292723.39
231120,201702,290,251,39,234236.88,36356,270592.88
231123,201702,132,124,8,116188,7496,123684
231126,201702,265,227,38,212011.86,35606,247617.86
231130,201702,4404,3428,976,3204180.34,913912.42,4118092.76
231135,201702,180,155,25,145235,22183.2,167418.2
231140,201702,2969,2185,784,2043779.79,732797.24,2776577.03
231150,201702,330,316,14,296092,13118,309210
231160,201702,1168,922,246,860635.25,230277.12,1090912.37
231170,201702,592,381,211,356556.61,197707,554263.61
231180,201702,1448,1209,239,1131943.4,223943,1355886.4
231190,201702,210,187,23,175219,21551,196770
231195,201702,203,175,28,163263.91,26236,189499.91
231200,201702,939,769,170,720553,158052,878605
231210,201702,582,485,97,454445,90889,545334
231220,201702,970,699,271,654027,253927,907954
231230,201702,1312,1063,249,993728.3,233031.9,1226760.2
231240,201702,1237,896,341,839270.9,318299.1,1157570.0
231250,201702,103,96,7,89952,6559,96511
231260,201702,295,186,109,174000.9,101852,275852.9
231270,201702,959,799,160,743636.35,149911,893547.35
231280,201702,44,36,8,33732,7496,41228
231290,201702,7014,3852,3162,3599975.61,2960500.05,6560475.66
231300,201702,612,565,47,529405,44039,573444
231310,201702,674,629,45,588178,42160.32,630338.32
231320,201702,526,406,120,379955,112440,492395
231325,201702,83,73,10,68401,9370,77771
231330,201702,1959,1514,445,1413141.19,414343.3,1827484.49
231335,201702,251,217,34,203329,31858,235187
231340,201702,1483,1096,387,1025828.24,362619,1388447.24
231350,201702,1082,883,199,826903,185619.8,1012522.8
231355,201702,367,319,48,298776.51,44976,343752.51
231360,201702,644,497,147,461941.58,137735,599676.58
231370,201702,83,66,17,61842,15929,77771
231375,201702,264,194,70,181778,65590,247368
231380,201702,407,336,71,313265.36,66339.6,379604.96
231390,201702,187,153,34,143361,31858,175219
231395,201702,659,401,258,374903.07,241746,616649.07
231400,201702,759,611,148,571110.56,138338.9,709449.46
231410,201702,1243,989,254,921213.8,237998,1159211.8
240010,201702,387,186,201,173150.54,188142,361292.54
240020,201702,2057,1551,506,1451841.07,474122,1925963.07
240030,201702,173,141,32,132117,29984,162101
240040,201702,29,29,0,27173,0,27173
240050,201702,481,410,71,382582.06,66527,449109.06
240060,201702,69,64,5,59968,4685,64653
240070,201702,140,109,31,102133,29047,131180
240080,201702,370,232,138,217380,129306,346686
240090,201702,103,92,11,85905,10307,96212
240100,201702,1387,1311,76,1225487.18,71004.49,1296491.67
240110,201702,932,578,354,540631.03,331681,872312.03
240120,201702,135,113,22,105881,20614,126495
240130,201702,284,265,19,247605.99,17803,265408.99
240140,201702,85,65,20,60905,18740,79645
240145,201702,633,553,80,517645.65,74753.86,592399.51
240150,201702,19,16,3,14992,2796.95,17788.95
240160,201702,51,42,9,39354,8433,47787
240165,201702,35,32,3,29750,2811,32561
240170,201702,81,63,18,59031,16866,75897
240180,201702,69,55,14,51535,13118,64653
240185,201702,38,35,3,32785.63,2811,35596.63
240190,201702,19,17,2,15929,1874,17803
240200,201702,2884,1609,1275,1502440.3,1193458,2695898.3
240210,201702,151,118,33,110566,30921,141487
240220,201702,1106,793,313,743041,293271.63,1036312.63
240230,201702,801,740,61,690596.68,56520,747116.68
240240,201702,137,98,39,91826,36543,128369
240250,201702,90,79,11,74023,10307,84330
240260,201702,1734,1281,453,1199622.36,423495.89,1623118.25
240270,201702,178,162,16,151419.2,14992,166411.2
240280,201702,45,34,11,31858,10307,42165
240290,201702,63,60,3,56220,2811,59031
240300,201702,168,99,69,92375,64653,157028
240310,201702,1832,1001,831,930166.66,775470.06,1705636.72
240320,201702,216,205,11,192085,10307,202392
240325,201702,3997,2431,1566,2269466.17,1465207.41,3734673.58
240330,201702,68,66,2,61842,1874,63716
240340,201702,90,64,26,59968,24362,84330
240350,201702,90,80,10,74960,9370,84330
240360,201702,320,230,90,215229,84330,299559
240370,201702,39,37,2,34669,1874,36543
240375,201702,78,47,31,44039,29047,73086
240380,201702,237,193,44,179944,41135,221079
240390,201702,18,15,3,14055,2811,16866
240400,201702,81,78,3,73086,2811,75897
240410,201702,8,6,2,5622,1874,7496
240420,201702,828,634,194,592748.07,180766.04,773514.11
240430,201702,248,234,14,217552.11,13118,230670.11
240440,201702,60,32,28,29984,26236,56220
240450,201702,172,110,62,102789,58094,160883
240460,201702,57,45,12,42165,11244,53409
240470,201702,225,191,34,178419.79,31858,210277.79
240480,201702,16,16,0,14715.84,0,14715.84
240485,201702,64,53,11,49770,10307,60077
240490,201702,49,49,0,45707,0,45707
240500,201702,86,70,16,65590,14992,80582
240510,201702,42,30,12,28110,11244,39354
240520,201702,138,132,6,123684,5622,129306
240530,201702,39,35,4,32795,3748,36543
240540,201702,80,69,11,64653,10297.63,74950.63
240550,201702,17,14,3,13118,2811,15929
240560,201702,357,260,97,243004.4,90889,333893.4
240570,201702,426,258,168,240621.6,157416,398037.6
240580,201702,1234,992,242,924352.2,225616.6,1149968.8
240590,201702,26,25,1,23425,937,24362
240600,201702,116,116,0,108692,0,108692
240610,201702,497,421,76,394196,70463,464659
240615,201702,42,40,2,37480,1874,39354
240620,201702,88,85,3,78708,2811,81519
240630,201702,41,38,3,35606,2811,38417
240640,201702,28,24,4,22488,3748,26236
240650,201702,217,185,32,172503,29984,202487
240660,201702,86,76,10,71212,9370,80582
240670,201702,273,158,115,145985.15,107755,253740.15
240680,201702,54,43,11,40291,10307,50598
240690,201702,49,46,3,43102,2811,45913
240700,201702,191,160,31,149920,29047,178967
240710,201702,1781,1126,655,1054407.3,611964.07,1666371.37
240720,201702,985,718,267,671820.23,250179,921999.23
240725,201702,66,62,4,58094,3748,61842
240730,201702,128,111,17,104007,15929,119936
240740,201702,228,190,38,176690.09,35606,212296.09
240750,201702,36,22,14,20614,13118,33732
240760,201702,35,30,5,28110,4685,32795
240770,201702,137,106,31,99322,29042.32,128364.32
240780,201702,692,577,115,538953.03,107755,646708.03
240790,201702,41,39,2,36543,1874,38417
240800,201702,8177,5523,2654,5140746.46,2480149.7,7620896.16
240810,201702,19232,10467,8765,9767465.2,8203292.47,17970757.67
240820,201702,177,113,64,105595.22,59968,165563.22
240830,201702,1527,1257,270,1172057.05,252054,1424111.05
240840,201702,76,64,12,59968,11244,71212
240850,201702,86,74,12,69338,11244,80582
240860,201702,115,113,2,105881,1874,107755
240870,201702,48,41,7,38417,6559,44976
240880,201702,26,25,1,23415.63,937,24352.63
240890,201702,1062,622,440,578975.85,411339,990314.85
240895,201702,44,33,11,30921,10307,41228
240910,201702,146,133,13,124621,12181,136802
240920,201702,16,12,4,11244,3748,14992
240930,201702,356,321,35,299840,32795,332635
240933,201702,17,12,5,11244,4685,15929
240940,201702,2381,2102,279,1960116.41,258687.36,2218803.77
240950,201702,49,48,1,44976,937,45913
240960,201702,33,26,7,24362,6559,30921
240970,201702,148,106,42,99322,38617,137939
240980,201702,164,129,35,120873,32795,153668
240990,201702,113,71,42,66527,39354,105881
241000,201702,82,73,9,68214,8433,76647
241010,201702,55,43,12,40291,11244,51535
241020,201702,118,109,9,102133,8433,110566
241025,201702,10,4,6,3748,5622,9370
241030,201702,121,98,23,91826,21551,113377
241040,201702,30,25,5,23425,4685,28110
241050,201702,95,82,13,76834,12181,89015
241060,201702,34,31,3,29047,2811,31858
241070,201702,19,19,0,17803,0,17803
241080,201702,65,57,8,53127.9,7496,60623.9
241090,201702,49,39,10,36543,9327.9,45870.9
241100,201702,74,66,8,61842,7496,69338
241105,201702,7,3,4,2811,3748,6559
241110,201702,51,48,3,44976,2811,47787
241120,201702,1357,1047,310,978884.4,289607.96,1268492.36
241140,201702,220,176,44,163976,41228,205204
241142,201702,43,42,1,39354,937,40291
241150,201702,1176,1034,142,966188.5,133008,1099196.5
241160,201702,25,23,2,21551,1874,23425
241170,201702,42,39,3,36543,2811,39354
241180,201702,49,39,10,36371.53,9370,45741.53
241190,201702,46,45,1,42165,937,43102
241200,201702,3616,1995,1621,1863652.76,1517646.64,3381299.40
241210,201702,72,57,15,53409,13212,66621
241220,201702,1309,867,442,811769.7,414135.26,1225904.96
241230,201702,231,193,38,180575.59,35606,216181.59
241240,201702,52,39,13,36543,12181,48724
241250,201702,1023,957,66,896709,61561,958270
241255,201702,39,33,6,30921,5622,36543
241260,201702,622,491,131,460062.32,122747,582809.32
241270,201702,44,30,14,28110,13118,41228
241280,201702,99,85,14,79645,13118,92763
241290,201702,101,74,27,69338,25299,94637
241300,201702,79,56,23,52472,21551,74023
241310,201702,53,42,11,39214,10307,49521
241320,201702,30,16,14,14616,13118,27734
241330,201702,57,52,5,48724,4685,53409
241335,201702,56,48,8,44976,7496,52472
241340,201702,181,135,46,126495,43102,169597
241350,201702,60,55,5,51535,4685,56220
241355,201702,41,38,3,35606,2811,38417
241360,201702,49,49,0,45913,0,45913
241370,201702,46,38,8,35606,7496,43102
241380,201702,44,42,2,39354,1874,41228
241390,201702,65,51,14,47599.6,13118,60717.6
241400,201702,185,150,35,139895,32795,172690
241410,201702,168,152,16,142424,14899,157323
241415,201702,89,70,19,65590,17803,83393
241420,201702,92,70,22,65590,20446,86036
241430,201702,32,31,1,29047,937,29984
241440,201702,434,364,70,341068,65590,406658
241445,201702,28,26,2,24362,1874,26236
241450,201702,277,225,52,210701,48724,259425
241460,201702,129,116,13,108458,12181,120639
241470,201702,44,36,8,33732,7496,41228
241475,201702,68,65,3,60905,2811,63716
241480,201702,90,64,26,59968,24362,84330
241490,201702,8,6,2,5622,1593,7215
241500,201702,51,38,13,35606,12181,47787
250010,201702,98,86,12,80582,11244,91826
250020,201702,21,18,3,16866,2811,19677
250030,201702,797,576,221,538391.1,205139.51,743530.61
250040,201702,330,276,54,258612,50598,309210
250050,201702,211,177,34,165849,31858,197707
250053,201702,54,42,12,39354,11244,50598
250057,201702,0,0,0,0,0,0
250060,201702,421,328,93,307336,87141,394477
250070,201702,662,574,88,535858,82456,618314
250073,201702,8,8,0,7496,0,7496
250077,201702,205,151,54,141103.6,50598,191701.6
250080,201702,421,324,97,301996.1,90889,392885.1
250090,201702,214,144,70,133991.2,64734.26,198725.46
250100,201702,445,362,83,339194,77397,416591
250110,201702,440,334,106,311206.6,99322,410528.6
250115,201702,29,8,21,7496,19677,27173
250120,201702,96,76,20,71212,18740,89952
250130,201702,581,459,122,430083,114127,544210
250135,201702,12,8,4,7496,3748,11244
250140,201702,70,64,6,59968,5622,65590
250150,201702,529,395,134,368643,125248.79,493891.79
250153,201702,11,10,1,9370,937,10307
250157,201702,26,21,5,19677,4685,24362
250160,201702,203,159,44,148983,41228,190211
250170,201702,69,48,21,44976,19677,64653
250180,201702,3799,2562,1237,2387662.94,1154305.35,3541968.29
250190,201702,928,599,329,559623.25,307570.25,867193.50
250200,201702,47,40,7,37480,6559,44039
250205,201702,15,13,2,12181,1874,14055
250210,201702,88,76,12,71212,11244,82456
250215,201702,60,52,8,48724,7496,56220
250220,201702,25,18,7,16866,6559,23425
250230,201702,68,63,5,59031,4685,63716
250240,201702,226,185,41,172548.55,38417,210965.55
250250,201702,387,330,57,309210,53409,362619
250260,201702,29,25,4,23425,3748,27173
250270,201702,53,42,11,39354,10307,49661
250280,201702,392,324,68,303588,63716,367304
250290,201702,84,78,6,72804.9,5622,78426.9
250300,201702,575,388,187,362920.24,175205.63,538125.87
250310,201702,42,36,6,33732,5622,39354
250320,201702,1805,1244,561,1159610.84,524439,1684049.84
250330,201702,76,65,11,60905,10307,71212
250340,201702,25,21,4,19677,3748,23425
250350,201702,127,80,47,74960,43476.8,118436.8
250355,201702,21,16,5,14992,4685,19677
250360,201702,196,159,37,148889.3,34435,183324.3
250370,201702,2285,1567,718,1462472.59,670300.71,2132773.30
250375,201702,22,18,4,16866,3748,20614
250380,201702,47,33,14,30921,13118,44039
250390,201702,32,26,6,24362,5622,29984
250400,201702,14785,7398,7387,6910341.84,6914951.92,13825293.76
250403,201702,391,325,66,304515.64,61842,366357.64
250407,201702,50,44,6,41228,5622,46850
250410,201702,27,23,4,21551,3748,25299
250415,201702,38,24,14,22488,13099.26,35587.26
250420,201702,46,37,9,34669,8433,43102
250430,201702,1421,1212,209,1133490,195833,1329323
250435,201702,14,11,3,10307,2811,13118
250440,201702,689,592,97,552110.26,90889,642999.26
250450,201702,82,69,13,64653,11525.1,76178.1
250460,201702,387,265,122,248305,114181.42,362486.42
250470,201702,88,64,24,59968,22488,82456
250480,201702,405,315,90,295155,84330,379485
250485,201702,2,1,1,937,937,1874
250490,201702,202,166,36,155542,33732,189274
250500,201702,73,53,20,49661,18740,68401
250510,201702,703,538,165,501857.8,153614.41,655472.21
250520,201702,174,116,58,108673.28,54341.32,163014.60
250523,201702,109,90,19,84330,17803,102133
250527,201702,105,79,26,74018.32,24362,98380.32
250530,201702,6,5,1,4685,937,5622
250535,201702,26,21,5,19677,4685,24362
250540,201702,120,89,31,82690.25,29047,111737.25
250550,201702,67,64,3,59968,2811,62779
250560,201702,35,29,6,27173,5622,32795
250570,201702,151,119,32,111503,29984,141487
250580,201702,142,109,33,101570.8,30921,132491.8
250590,201702,17,14,3,13118,2811,15929
250600,201702,1247,845,402,788768.64,376576.32,1165344.96
250610,201702,152,130,22,121810,20614,142424
250620,201702,20,16,4,14992,3748,18740
250625,201702,55,40,15,37480,14055,51535
250630,201702,2929,1868,1061,1743919.07,992830.28,2736749.35
250640,201702,199,169,30,158353,28110,186463
250650,201702,31,21,10,19677,9370,29047
250660,201702,35,30,5,28110,4685,32795
250670,201702,48,33,15,30921,14055,44976
250680,201702,389,315,74,295155,69338,364493
250690,201702,1692,1157,535,1080891.76,500920.9,1581812.66
250700,201702,928,810,118,754775.3,110566,865341.3
250710,201702,438,339,99,317643,92763,410406
250720,201702,98,78,20,73086,18740,91826
250730,201702,354,297,57,276416,53409,329825
250740,201702,43,39,4,36543,3748,40291
250750,201702,19347,11529,7818,10750706.31,7316974.55,18067680.86
250760,201702,59,47,12,44039,11244,55283
250770,201702,335,224,111,208951.31,102859.27,311810.58
250780,201702,51,40,11,37480,10307,47787
250790,201702,499,307,192,284848.76,179201.25,464050.01
250800,201702,146,133,13,123918.25,12181,136099.25
250810,201702,46,35,11,32795,10307,43102
250820,201702,152,122,30,114314,28110,142424
250830,201702,647,429,218,400989.25,204266,605255.25
250840,201702,50,47,3,44039,2811,46850
250850,201702,48,39,9,35868.36,8433,44301.36
250855,201702,15,13,2,11338,1874,13212
250860,201702,189,138,51,129306,47505.9,176811.9
250870,201702,30,27,3,25299,2811,28110
250880,201702,73,56,17,52425.15,15929,68354.15
250890,201702,2253,1651,602,1545675.2,563226.57,2108901.77
250900,201702,41,32,9,29984,8433,38417
250905,201702,128,97,31,90889,29047,119936
250910,201702,1143,810,333,757751.91,311739.9,1069491.81
250915,201702,106,74,32,69338,29984,99322
250920,201702,130,99,31,92763,29047,121810
250930,201702,142,90,52,84330,48724,133054
250933,201702,2,2,0,1874,0,1874
250937,201702,8,7,1,6559,937,7496
250939,201702,28,21,7,19677,6559,26236
250940,201702,105,76,29,71212,27173,98385
250950,201702,71,48,23,44976,21551,66527
250960,201702,88,47,41,44018.89,38417,82435.89
250970,201702,1163,813,350,759252,327668.9,1086920.9
250980,201702,87,61,26,57157,24362,81519
250990,201702,158,121,37,112941.35,34640.9,147582.25
251000,201702,73,67,6,62591.6,5622,68213.6
251010,201702,86,66,20,61838,17975.4,79813.4
251020,201702,76,66,10,61045.55,9370,70415.55
251030,201702,38,29,9,27173,8433,35606
251040,201702,50,34,16,31858,14992,46850
251050,201702,25,23,2,21551,1874,23425
251060,201702,45,36,9,32795,8433,41228
251065,201702,4,3,1,2811,937,3748
251070,201702,25,19,6,17794,5622,23416
251080,201702,4579,2206,2373,2053913.41,2217720.21,4271633.62
251090,201702,198,170,28,159290,26236,185526
251100,201702,17,16,1,14992,937,15929
251110,201702,40,32,8,29984,7496,37480
251120,201702,1716,1002,714,934051.2,669018,1603069.2
251130,201702,339,272,67,254864,62779,317643
251140,201702,482,308,174,287473,162872.34,450345.34
251150,201702,281,243,38,226933,35606,262539
251160,201702,89,70,19,65586,17803,83389
251170,201702,98,76,22,71188.6,20604.64,91793.24
251180,201702,283,175,108,163975,101187.32,265162.32
251190,201702,191,132,59,123361.68,55283,178644.68
251200,201702,246,196,50,183652,46850,230502
251203,201702,28,26,2,24362,1874,26236
251207,201702,90,74,16,69338,14992,84330
251210,201702,1381,984,397,920481.34,371333.1,1291814.44
251220,201702,45,36,9,33732,8433,42165
251230,201702,513,437,76,409449,71212,480661
251240,201702,103,72,31,66527,29047,95574
251250,201702,1276,910,366,850562.1,342802,1193364.1
251260,201702,12,7,5,6559,4685,11244
251270,201702,334,247,87,231439,81379,312818
251272,201702,71,65,6,60905,5622,66527
251274,201702,25,20,5,18740,4685,23425
251275,201702,20,14,6,13118,5622,18740
251276,201702,17,14,3,13118,2811,15929
251278,201702,9,7,2,6559,1874,8433
251280,201702,85,80,5,74960,4685,79645
251290,201702,690,520,170,487240,159286,646526
251300,201702,17,15,2,14055,1874,15929
251310,201702,342,243,99,227687,92763,320450
251315,201702,15,14,1,13118,937,14055
251320,201702,62,49,13,45913,12181,58094
251330,201702,75,66,9,61842,8433,70275
251335,201702,9,5,4,4685,3748,8433
251340,201702,672,400,272,374800,253857.63,628657.63
251350,201702,32,30,2,28110,1874,29984
251360,201702,62,54,8,50395.61,7496,57891.61
251365,201702,15,15,0,14055,0,14055
251370,201702,5025,3378,1647,3159014.5,1541928.5,4700943.0
251380,201702,51,39,12,36543,11244,47787
251385,201702,2,2,0,1874,0,1874
251390,201702,613,493,120,460817.6,111222,572039.6
251392,201702,22,16,6,14992,5622,20614
251394,201702,10,9,1,8433,937,9370
251396,201702,20,15,5,14055,4685,18740
251398,201702,18,16,2,14992,1874,16866
251400,201702,35,29,6,27173,5622,32795
251410,201702,33,28,5,26236,4685,30921
251420,201702,106,80,26,74960,24362,99322
251430,201702,35,33,2,30921,1874,32795
251440,201702,39,25,14,23416,13118,36534
251445,201702,41,36,5,33732,4685,38417
251450,201702,400,353,47,329135.4,44039,373174.4
251455,201702,2,1,1,937,937,1874
251460,201702,15,11,4,10307,3748,14055
251465,201702,5,2,3,1874,2811,4685
251470,201702,42,34,8,31858,7496,39354
251480,201702,24,22,2,20614,1874,22488
251490,201702,130,90,40,83862,36544,120406
251500,201702,109,90,19,84330,17054,101384
251510,201702,88,65,23,60905,21551,82456
251520,201702,22,22,0,20614,0,20614
251530,201702,4589,3200,1389,2993552.06,1301202.53,4294754.59
251540,201702,75,67,8,62779,7496,70275
251550,201702,422,321,101,299840.6,94403,394243.6
251560,201702,25,20,5,18740,4685,23425
251570,201702,18,18,0,16866,0,16866
251580,201702,110,92,18,86204,16866,103070
251590,201702,126,92,34,86204,31858,118062
251593,201702,19,11,8,10307,7496,17803
251597,201702,57,46,11,43102,10307,53409
251600,201702,1086,772,314,722052.94,292521.26,1014574.20
251610,201702,206,155,51,144579.1,47132,191711.1
251615,201702,1,1,0,937,0,937
251620,201702,4165,2786,1379,2602738.17,1289969.34,3892707.51
251630,201702,408,294,114,275478,106818,382296
251640,201702,147,103,44,96511,41228,137739
251650,201702,250,182,68,168735.55,63716,232451.55
251660,201702,215,196,19,182715.55,17803,200518.55
251670,201702,334,266,68,247678.07,63716,311394.07
251675,201702,2,2,0,1874,0,1874
251680,201702,83,79,4,74023,3748,77771
251690,201702,336,279,57,261423,53065.13,314488.13
251700,201702,280,227,53,212122.75,49646.95,261769.70
251710,201702,18,13,5,12181,4685,16866
251720,201702,35,24,11,22488,10026,32514
251740,201702,10,8,2,7496,1874,9370
260005,201702,3056,1728,1328,1608421.42,1243031.43,2851452.85
260010,201702,1241,878,363,819523.76,338913.56,1158437.32
260020,201702,427,380,47,356060,44039,400099
260030,201702,561,405,156,378731.65,146172,524903.65
260040,201702,860,523,337,488973.45,315759.63,804733.08
260050,201702,1114,777,337,727815,315207,1043022
260060,201702,411,369,42,345003.4,39354,384357.4
260070,201702,1373,869,504,810770,469327.58,1280097.58
260080,201702,732,565,167,528187.55,156479,684666.55
260090,201702,559,346,213,323977.86,199581,523558.86
260100,201702,223,154,69,143314.6,64653,207967.6
260105,201702,240,131,109,122747,102133,224880
260110,201702,2583,1922,661,1800895.63,618561,2419456.63
260120,201702,2821,1557,1264,1448881.83,1182121.55,2631003.38
260130,201702,139,94,45,88078,42165,130243
260140,201702,1980,1287,693,1198168.56,647824.63,1845993.19
260150,201702,234,150,84,140550,78708,219258
260160,201702,277,242,35,226754,32795,259549
260170,201702,3170,1936,1234,1806465.24,1155321,2961786.24
260180,201702,118,102,16,95574,14992,110566
260190,201702,2261,1614,647,1508493.17,606239,2114732.17
260200,201702,856,707,149,661697.24,139332,801029.24
260210,201702,1362,951,411,890938.96,385098,1276036.96
260220,201702,684,628,56,587664,52472,640136
260230,201702,1165,881,284,823345.15,266108,1089453.15
260240,201702,204,151,53,140334.49,49661,189995.49
260250,201702,59,46,13,43102,12181,55283
260260,201702,953,680,273,637160,255801,892961
260270,201702,438,356,82,332354.2,76552.9,408907.1
260280,201702,915,701,214,656649.6,199956,856605.6
260290,201702,6255,3287,2968,3061984.96,2774876.06,5836861.02
260300,201702,779,684,95,638603.23,88734,727337.23
260310,201702,484,380,104,354050.13,97448,451498.13
260320,201702,898,671,227,628631,212699,841330
260330,201702,24,20,4,18740,3748,22488
260340,201702,65,47,18,44039,16866,60905
260345,201702,5399,3076,2323,2874740.32,2175376.01,5050116.33
260350,201702,455,332,123,308976.84,114315,423291.84
260360,201702,303,155,148,145235,138676,283911
260370,201702,618,396,222,369225.7,207877,577102.7
260380,201702,598,431,167,403847,155355.14,559202.14
260390,201702,286,242,44,225578.19,40291,265869.19
260392,201702,86,76,10,71212,9370,80582
260400,201702,4059,2303,1756,2147766.2,1645016.41,3792782.61
260410,201702,13772,7503,6269,7016287.91,5871089.5,12887377.41
260415,201702,119,104,15,97448,14055,111503
260420,201702,1794,1040,754,969614.55,704110,1673724.55
260430,201702,191,175,16,162992.14,14992,177984.14
260440,201702,221,159,62,147710,58094,205804
260450,201702,476,337,139,314507,130243,444750
260460,201702,854,451,403,419965.4,377606.32,797571.72
260470,201702,359,217,142,202579.4,132164.55,334743.95
260480,201702,197,120,77,112440,72149,184589
260490,201702,203,163,40,152731,37480,190211
260500,201702,1112,740,372,690711,347534,1038245
260510,201702,711,553,158,518161,147109,665270
260515,201702,256,226,30,211762,27642,239404
260520,201702,3223,1880,1343,1753255.88,1256227.11,3009482.99
260530,201702,728,589,139,549124.65,130243,679367.65
260540,201702,582,429,153,401973,142424.66,544397.66
260545,201702,14,10,4,9370,3748,13118
260550,201702,328,202,126,189274,118062,307336
260560,201702,501,383,118,358291,110284.9,468575.9
260570,201702,994,825,169,770074.9,158353,928427.9
260580,201702,288,255,33,238935,30921,269856
260590,201702,640,361,279,336589.14,261423,598012.14
260600,201702,7700,4020,3680,3746685.91,3444876.32,7191562.23
260610,201702,482,318,164,297966,153668,451634
260620,201702,3409,1795,1614,1673029.2,1507138.94,3180168.14
260630,201702,66,63,3,59031,2811,61842
260640,201702,3566,1921,1645,1796438.19,1540738.05,3337176.24
260650,201702,334,229,105,214573,98342.85,312915.85
260660,201702,492,334,158,312492.88,147155.85,459648.73
260670,201702,99,75,24,70275,22488,92763
260680,201702,3677,2007,1670,1863012.45,1562861.52,3425873.97
260690,201702,190,154,36,143642.1,33732,177374.1
260700,201702,365,215,150,200705.4,139733,340438.4
260710,201702,39,37,2,34669,1874,36543
260720,201702,2170,1287,883,1200080.78,826593.29,2026674.07
260730,201702,569,432,137,404784,126495.45,531279.45
260740,201702,69,65,4,60905,3748,64653
260750,201702,647,442,205,414154,192085,606239
260760,201702,626,342,284,320454,265796,586250
260765,201702,952,497,455,462799.9,426100.75,888900.65
260770,201702,215,158,57,148046,53409,201455
260775,201702,823,487,336,454342.3,314832,769174.3
260780,201702,259,164,95,153668,88883.82,242551.82
260790,201702,12302,6729,5573,6279641.12,5214194.54,11493835.66
260795,201702,135,93,42,85997.86,39354,125351.86
260800,201702,361,296,65,276603,60905,337508
260805,201702,200,128,72,119220.13,67464,186684.13
260810,201702,739,643,96,601263.53,89952,691215.53
260820,201702,313,205,108,191027.3,101196,292223.3
260825,201702,188,129,59,120702.66,55283,175985.66
260830,201702,253,161,92,150716.45,86204,236920.45
260840,201702,218,155,63,143975,58750,202725
260845,201702,207,146,61,136802,57157,193959
260850,201702,520,373,147,347866.64,137739,485605.64
260860,201702,247,182,65,170339.86,60905,231244.86
260870,201702,371,260,111,243480,104007,347487
260875,201702,662,452,210,422430.53,196770,619200.53
260880,201702,1355,884,471,827602.31,441139.6,1268741.91
260890,201702,2446,1698,748,1584813.39,699940,2284753.39
260900,201702,1049,702,347,656495.95,325139,981634.95
260910,201702,277,214,63,200518,59031,259549
260915,201702,289,187,102,175219,95454,270673
260920,201702,162,93,69,87141,64653,151794
260930,201702,391,330,61,309210,57100.85,366310.85
260940,201702,2588,1427,1161,1333352.95,1087389,2420741.95
260950,201702,1848,1087,761,1012316.45,713057,1725373.45
260960,201702,14242,7359,6883,6860308.02,6443412.87,13303720.89
260970,201702,420,364,56,341068,52472,393540
260980,201702,203,175,28,163685,26236,189921
260990,201702,2448,2011,437,1883811.01,409469,2293280.01
261000,201702,4299,2472,1827,2304813.85,1708573.9,4013387.75
261010,201702,186,133,53,124621,48857.8,173478.8
261020,201702,610,446,164,417762,153668,571430
261030,201702,204,149,55,139613,51506.9,191119.9
261040,201702,360,325,35,304525,32513.9,337038.9
261050,201702,458,402,56,376674,52472,429146
261060,201702,1301,848,453,792468.88,424461,1216929.88
261070,201702,8859,4530,4329,4218170.71,4048590.93,8266761.64
261080,201702,384,287,97,268919,90889,359808
261090,201702,2110,1628,482,1517472.47,450885,1968357.47
261100,201702,1043,733,310,684994.8,289158.2,974153.0
261110,201702,7619,4633,2986,4336467.93,2794435.95,7130903.88
261120,201702,281,238,43,222725,40287,263012
261130,201702,569,314,255,293890.45,238654,532544.45
261140,201702,188,121,67,113377,62779,176156
261150,201702,655,375,280,350907,262360,613267
261153,201702,69,66,3,60905.12,2811,63716.12
261160,201702,75006,38208,36798,35684693.19,34455619.76,70140312.95
261170,201702,456,336,120,314551,112440,426991
261180,201702,1726,1046,680,975220.63,637160,1612380.63
261190,201702,625,424,201,397035.89,188318.63,585354.52
261200,201702,210,187,23,174514.09,21551,196065.09
261210,201702,30,28,2,26236,1874,28110
261220,201702,2345,1655,690,1545014.97,645406,2190420.97
261230,201702,316,236,80,220663.5,74945.95,295609.45
261240,201702,426,364,62,337126.47,58094,395220.47
261245,201702,200,166,34,155542,31858,187400
261247,201702,128,95,33,89015,30921,119936
261250,201702,2705,1316,1389,1231124.4,1301493,2532617.4
261255,201702,242,221,21,207077,19677,226754
261260,201702,805,692,113,648404,105881,754285
261270,201702,168,130,38,121810,35606,157416
261280,201702,136,109,27,102133,25299,127432
261290,201702,133,89,44,83393,41228,124621
261300,201702,1194,843,351,789057.44,328887,1117944.44
261310,201702,719,483,236,452571,220522.95,673093.95
261320,201702,519,354,165,331698,154605,486303
261330,201702,768,620,148,577996.25,137845.53,715841.78
261340,201702,326,176,150,164912,140550,305462
261350,201702,716,507,209,474122.1,195793,669915.1
261360,201702,1101,699,402,654568.53,376674,1031242.53
261370,201702,4788,2964,1824,2764976.51,1706879.33,4471855.84
261380,201702,573,413,160,384414.17,149639,534053.17
261390,201702,3219,2143,1076,2003353.22,1005112.53,3008465.75
261400,201702,278,253,25,236498.8,23425,259923.8
261410,201702,993,653,340,611861,318575.32,930436.32
261420,201702,857,532,325,496583.63,304506.63,801090.26
261430,201702,329,298,31,278395,28765.9,307160.9
261440,201702,85,74,11,69338,10307,79645
261450,201702,2472,2051,421,1919380.87,394459,2313839.87
261460,201702,670,533,137,498484.81,128369,626853.81
261470,201702,231,175,56,163179,52472,215651
261480,201702,309,250,59,233127,55279,288406
261485,201702,337,205,132,192085,123684,315769
261500,201702,622,413,209,386981,195833,582814
261510,201702,40,27,13,25299,12181,37480
261520,201702,166,155,11,144299,10307,154606
261530,201702,4130,2619,1511,2446741.01,1414590,3861331.01
261540,201702,1054,637,417,596869,390729,987598
261550,201702,286,142,144,131569,134928,266497
261560,201702,733,487,246,453415.5,229087.8,682503.3
261570,201702,349,272,77,254864,72149,327013
261580,201702,363,280,83,262360,77771,340131
261590,201702,183,146,37,136802,34669,171471
261600,201702,272,222,50,207265,46382,253647
261610,201702,97,84,13,78360,12181,90541
261618,201702,63,50,13,46850,12181,59031
261620,201702,209,125,84,117125,78708,195833
261630,201702,585,445,140,414648.8,130993,545641.8
261640,201702,5976,3153,2823,2946008.75,2643193.56,5589202.31
261650,201702,470,284,186,265442.73,174282,439724.73
270010,201702,491,426,65,399162,60156,459318
270020,201702,304,238,66,222252.4,61842,284094.4
270030,201702,8906,5680,3226,5308459.25,3020255.43,8328714.68
270040,201702,1754,1060,694,993116.94,649996.9,1643113.84
270050,201702,189,140,49,131180,45913,177093
270060,201702,123,69,54,64653,50598,115251
270070,201702,924,653,271,610180.26,252681.16,862861.42
270080,201702,44,37,7,34669,6559,41228
270090,201702,20,16,4,14992,3748,18740
270100,201702,1320,853,467,795093.98,434535.12,1229629.10
270110,201702,175,129,46,120873,43102,163975
270120,201702,215,175,40,163138.72,37199,200337.72
270130,201702,257,174,83,162756.9,77489.9,240246.8
270135,201702,102,60,42,56220,39354,95574
270140,201702,1225,710,515,664611.98,480111.26,1144723.24
270150,201702,272,217,55,203329,51535,254864
270160,201702,515,376,139,352312,130243,482555
270170,201702,656,408,248,380703.1,231579.55,612282.65
270180,201702,67,50,17,46537.7,15722.86,62260.56
270190,201702,103,90,13,84330,12181,96511
270200,201702,111,101,10,94449.6,9370,103819.6
270210,201702,495,255,240,238935,224598.9,463533.9
270220,201702,207,165,42,154605,39354,193959
270230,201702,2004,1173,831,1093694.35,775860.94,1869555.29
270235,201702,732,540,192,505652.55,179545.48,685198.03
270240,201702,3035,2327,708,2170401.77,660090.9,2830492.67
270250,201702,172,123,49,114501.4,45913,160414.4
270255,201702,222,196,26,183652,23987.2,207639.2
270260,201702,318,255,63,238608,58749.9,297357.9
270270,201702,127,53,74,49652,69338,118990
270280,201702,224,143,81,133991,75897,209888
270290,201702,1129,837,292,782929.59,271880.89,1054810.48
270300,201702,252,159,93,148983,86859.9,235842.9
270310,201702,960,753,207,703649.28,193265.99,896915.27
270320,201702,900,758,142,708132.8,133054,841186.8
270330,201702,253,207,46,193022,43102,236124
270340,201702,59,45,14,42165,13118,55283
270350,201702,93,47,46,44039,43102,87141
270360,201702,84,44,40,41228,37480,78708
270370,201702,52,38,14,35606,13118,48724
270375,201702,62,37,25,34669,23421,58090
270380,201702,1069,580,489,542523,458193,1000716
270390,201702,198,106,92,99322,86204,185526
270400,201702,687,490,197,458123.83,184580,642703.83
270410,201702,723,508,215,475986.63,201445.63,677432.26
270420,201702,379,241,138,224150,129223.89,353373.89
270430,201702,31211,22149,9062,20700313.78,8482368.2,29182681.98
270440,201702,502,390,112,364446.55,104944,469390.55
270450,201702,750,369,381,345518.75,356056.05,701574.80
270460,201702,207,147,60,137739,56220,193959
270470,201702,1288,844,444,790479.95,415804,1206283.95
270480,201702,492,387,105,359530.19,97682.25,457212.44
270490,201702,24,18,6,16866,5622,22488
270500,201702,509,408,101,382296,94637,476933
270510,201702,736,446,290,417902,271730,689632
270520,201702,429,258,171,241399.45,160227,401626.45
270530,201702,66,57,9,53409,8433,61842
270540,201702,127,96,31,89952,29047,118999
270550,201702,1721,1282,439,1199413.69,411244.62,1610658.31
270560,201702,330,147,183,137739,171471,309210
270570,201702,415,257,158,239993.73,148046,388039.73
270580,201702,72,50,22,46850,20614,67464
270590,201702,86,72,14,67464,13097.89,80561.89
270600,201702,178,145,33,135865,30921,166786
270610,201702,155,119,36,111494,33732,145226
270620,201702,34,32,2,29984,1874,31858
270630,201702,3769,2848,921,2657524.86,860860.38,3518385.24
270640,201702,884,634,250,592090.3,233941.9,826032.2
270642,201702,191,160,31,149920,29047,178967
270644,201702,299,201,98,187997.55,91821.32,279818.87
270650,201702,236,138,98,129306,91826,221132
270660,201702,260,208,52,194896,48724,243620
270670,201702,3153,2360,793,2200919.85,740877.12,2941796.97
270680,201702,456,261,195,244548,182710.32,427258.32
270690,201702,1208,730,478,682308.24,447876.63,1130184.87
270700,201702,40,30,10,28110,9370,37480
270710,201702,851,624,227,583101.86,212699,795800.86
270720,201702,251,186,65,174282,60623.9,234905.9
270730,201702,1747,1004,743,939484.2,694122.6,1633606.8
270740,201702,45,27,18,25299,16866,42165
270750,201702,617,447,170,418839,158635,577474
270760,201702,313,229,84,214573,78708,293281
270770,201702,2657,1630,1027,1519646.16,960565.55,2480211.71
270780,201702,91,55,36,51530.32,33714.64,85244.96
270790,201702,286,192,94,179904,88078,267982
270800,201702,1973,1543,430,1444967.12,402179.14,1847146.26
270810,201702,317,248,69,232361.95,64644.32,297006.27
270820,201702,156,97,59,90889,55190,146079
270830,201702,1036,744,292,696379,273604,969983
270840,201702,1393,996,397,932760.2,371053,1303813.2
270850,201702,1788,1072,716,999826.95,670203.68,1670030.63
270860,201702,2422,1544,878,1442525.3,820739.11,2263264.41
270870,201702,128,69,59,64653,55283,119936
270880,201702,908,642,266,598965.19,248356.49,847321.68
270890,201702,394,289,105,270511.9,98380.32,368892.22
270895,201702,75,61,14,57157,13118,70275
270900,201702,112,90,22,84330,20614,104944
270910,201702,339,265,74,247180.6,69338,316518.6
270915,201702,1750,1014,736,944968.36,689140.57,1634108.93
270920,201702,494,406,88,380422,82456,462878
270930,201702,6252,4446,1806,4160454.57,1690182.62,5850637.19
270940,201702,2401,1801,600,1686351.69,560777,2247128.69
280010,201702,44,40,4,37480,3748,41228
280020,201702,692,589,103,549988.31,95574,645562.31
280030,201702,18255,11637,6618,10826057.76,6171571.2,16997628.96
280040,201702,348,219,129,205203,119467.5,324670.5
280050,201702,373,282,91,264234,85267,349501
280060,201702,398,256,142,238256.23,133054,371310.23
280067,201702,969,672,297,626956.26,277352.12,904308.38
280070,201702,127,105,22,97635.4,20614,118249.4
280100,201702,593,465,128,431697.88,119749,551446.88
280110,201702,77,70,7,65590,6559,72149
280120,201702,602,477,125,446152.55,117125,563277.55
280130,201702,1260,771,489,720881.9,458052.45,1178934.35
280140,201702,468,369,99,344902.43,92763,437665.43
280150,201702,305,221,84,206409.21,77771,284180.21
280160,201702,100,85,15,79645,14055,93700
280170,201702,569,376,193,351375.68,180044.55,531420.23
280190,201702,28,25,3,23425,2811,26236
280200,201702,17,12,5,11244,4685,15929
280210,201702,2671,1861,810,1726922.14,753738.06,2480660.20
280220,201702,38,30,8,28110,7496,35606
280230,201702,292,240,52,224060.95,47787.1,271848.05
280240,201702,176,163,13,151794.55,12181,163975.55
280250,201702,23,13,10,12181,9370,21551
280260,201702,79,71,8,66527,7496,74023
280270,201702,155,117,38,109629,35606,145235
280280,201702,199,125,74,117125,69338,186463
280290,201702,2923,2120,803,1972408.28,750842.63,2723250.91
280300,201702,1052,789,263,738356,245681.4,984037.4
280310,201702,105,99,6,92576,5622,98198
280320,201702,611,409,202,383224,189274,572498
280330,201702,359,251,108,234250,101074.19,335324.19
280340,201702,394,315,79,293710.05,74023,367733.05
280350,201702,3296,2543,753,2373750.16,703806.46,3077556.62
280360,201702,465,296,169,277352,157416,434768
280370,201702,89,76,13,71212,12181,83393
280380,201702,56,40,16,37480,14992,52472
280390,201702,177,147,30,137739,28110,165849
280400,201702,304,206,98,192929,91826,284755
280410,201702,290,231,59,215305,55273.63,270578.63
280420,201702,170,142,28,133054,26236,159290
280430,201702,103,76,27,71212,25299,96511
280440,201702,645,486,159,450370.8,148964.26,599335.06
280445,201702,115,106,9,99322,8433,107755
280450,201702,918,776,142,725134.93,133054,858188.93
280460,201702,693,495,198,457569.18,185526,643095.18
280470,201702,189,171,18,160227,15930,176157
280480,201702,2156,1535,621,1426234.74,578091.43,2004326.17
280490,201702,382,349,33,325869,30921,356790
280500,201702,55,49,6,45913,5622,51535
280510,201702,137,104,33,97150.6,30640,127790.6
280520,201702,56,41,15,38417,14055,52472
280530,201702,83,61,22,57157,20614,77771
280540,201702,486,384,102,359808,95292.9,455100.9
280550,201702,682,632,50,589614.3,46850,636464.3
280560,201702,483,415,68,386981,63716,450697
280570,201702,1715,1293,422,1207350.65,395395.26,1602745.91
280580,201702,593,446,147,417763,137646,555409
280590,201702,164,99,65,92301.06,60905,153206.06
280600,201702,340,287,53,267251.54,49661,316912.54
280610,201702,141,101,40,94435,37480,131915
280620,201702,549,440,109,411343,101992.45,513335.45
280630,201702,164,135,29,126495,27173,153668
280640,201702,200,155,45,144421,42165,186586
280650,201702,85,54,31,50598,29047,79645
280660,201702,150,107,43,100259,40056.75,140315.75
280670,201702,1441,893,548,830720.63,509798.98,1340519.61
280680,201702,182,152,30,140672.62,28110,168782.62
280690,201702,39,32,7,29984,6559,36543
280700,201702,17,17,0,15929,0,15929
280710,201702,1398,1027,371,955310.65,346971.1,1302281.75
280720,201702,111,71,40,64012.7,37480,101492.7
280730,201702,23,18,5,16866,4685,21551
280740,201702,2273,1644,629,1536612.82,587631.07,2124243.89
280750,201702,287,248,39,232376,36543,268919
280760,201702,841,566,275,529217.6,257534.45,786752.05
290010,201702,175,114,61,106818,57157,163975
290020,201702,173,160,13,149920,12181,162101
290030,201702,575,370,205,346034.1,192085,538119.1
290035,201702,138,108,30,98048.8,28110,126158.8
290040,201702,263,165,98,154605,91826,246431
290050,201702,65,47,18,44039,16866,60905
290060,201702,258,113,145,105599.9,135865,241464.9
290070,201702,5356,2584,2772,2413902.07,2593856.55,5007758.62
290080,201702,536,248,288,231607.76,269838,501445.76
290090,201702,379,157,222,147109,208014,355123
290100,201702,1571,1022,549,952557.05,513850.9,1466407.95
290110,201702,694,408,286,380699.1,267607.3,648306.4
290115,201702,211,192,19,178755,17803,196558
290120,201702,774,505,269,472529.1,252053,724582.1
290130,201702,420,239,181,223652.53,168846,392498.53
290135,201702,277,214,63,200518,59031,259549
290140,201702,275,229,46,213636,43102,256738
290150,201702,130,93,37,87141,34669,121810
290160,201702,249,194,55,180560.05,51535,232095.05
290170,201702,86,57,29,53409,27173,80582
290180,201702,149,118,31,110566,29047,139613
290190,201702,448,363,85,339850,79364,419214
290195,201702,286,154,132,144298,123684,267982
290200,201702,284,244,40,228628,37480,266108
290205,201702,132,75,57,70275,53409,123684
290210,201702,1056,774,282,724114.6,264234,988348.6
290220,201702,220,120,100,111971.5,93700,205671.5
290225,201702,269,99,170,92763,159290,252053
290230,201702,62,39,23,36422,21551,57973
290240,201702,285,114,171,106536.9,160227,266763.9
290250,201702,254,227,27,211828,25299,237127
290260,201702,253,218,35,203235.9,32795,236030.9
290265,201702,180,145,35,135062,32795,167857
290270,201702,1337,1091,246,1020159,229654.75,1249813.75
290280,201702,450,330,120,309210,112440,421650
290290,201702,1109,635,474,592148.95,444138,1036286.95
290300,201702,447,376,71,351792.07,66527,418319.07
290310,201702,323,144,179,134928,167723,302651
290320,201702,3772,2372,1400,2219004.49,1308989.5,3527993.99
290323,201702,178,156,22,145891,20614,166505
290327,201702,138,108,30,100928.96,28110,129038.96
290330,201702,61,35,26,32795,24362,57157
290340,201702,909,357,552,333513.88,516601.79,850115.67
290350,201702,546,325,221,303776,207077,510853
290360,201702,361,271,90,252053.86,84330,336383.86
290370,201702,1011,370,641,346409,600617,947026
290380,201702,305,184,121,172408,113377,285785
290390,201702,2416,1495,921,1397239.57,861010,2258249.57
290395,201702,240,130,110,121576,103070,224646
290400,201702,283,205,78,191523,73086,264609
290405,201702,250,211,39,197707,36543,234250
290410,201702,531,452,79,420573.9,74023,494596.9
290420,201702,218,165,53,154605,49661,204266
290430,201702,500,311,189,291407,177093,468500
290440,201702,71,62,9,58094,7808.3,65902.3
290450,201702,227,174,53,163038,49661,212699
290460,201702,1801,1061,740,993229.52,693193.56,1686423.08
290470,201702,1451,604,847,564536.17,793326.71,1357862.88
290475,201702,578,545,33,510665,30921,541586
290480,201702,274,148,126,138676,118062,256738
290485,201702,205,190,15,177937,14055,191992
290490,201702,1079,768,311,718866.4,290470.6,1009337.0
290500,201702,643,316,327,296092,306399,602491
290510,201702,201,147,54,136522,50598,187120
290515,201702,126,70,56,65590,52472,118062
290520,201702,1320,841,479,786424.61,445048.7,1231473.31
290530,201702,307,282,25,264234,23425,287659
290540,201702,90,60,30,56220,28110,84330
290550,201702,148,125,23,117125,21485.41,138610.41
290560,201702,3362,1333,2029,1248009.41,1900982.4,3148991.81
290570,201702,5423,2782,2641,2604525.69,2471736.39,5076262.08
290580,201702,1216,687,529,642261.97,495673,1137934.97
290590,201702,517,427,90,399437,84330,483767
290600,201702,1650,1153,497,1076989.08,465407.9,1542396.98
290610,201702,220,198,22,185292,20614,205906
290620,201702,306,266,40,249242,37480,286722
290630,201702,2084,876,1208,817065,1126372.47,1943437.47
290640,201702,147,117,30,109629,28110,137739
290650,201702,1641,762,879,713048.42,823623,1536671.42
290660,201702,258,212,46,198644,43102,241746
290670,201702,950,511,439,478526,410974.95,889500.95
290680,201702,1139,923,216,863914,201455,1065369
290682,201702,276,201,75,187617.15,70256.63,257873.78
290685,201702,224,144,80,133991,74960,208951
290687,201702,889,585,304,544818.7,282852.29,827670.99
290689,201702,105,64,41,59954,38402.95,98356.95
290690,201702,746,311,435,291398,406741.77,698139.77
290700,201702,256,117,139,109629,130243,239872
290710,201702,660,428,232,401036,217384,618420
290720,201702,1014,826,188,773962,175687.5,949649.5
290730,201702,1108,626,482,584734.85,450697,1035431.85
290740,201702,13,10,3,9370,2811,12181
290750,201702,1302,586,716,548709.83,669600.55,1218310.38
290755,201702,65,57,8,53409,7496,60905
290760,201702,298,264,34,247368,31858,279226
290770,201702,183,171,12,160217.63,11244,171461.63
290780,201702,907,726,181,678353.23,167816.7,846169.93
290790,201702,430,290,140,271161,131180,402341
290800,201702,2589,1019,1570,951725.67,1469993.71,2421719.38
290810,201702,427,295,132,276134,123684,399818
290820,201702,362,218,144,202603.91,134928,337531.91
290830,201702,382,255,127,238935,118999,357934
290840,201702,1564,942,622,881108.4,579834.34,1460942.74
290850,201702,727,399,328,372832.3,306399,679231.3
290860,201702,659,288,371,269856,347346,617202
290870,201702,649,471,178,441046,166786,607832
290880,201702,124,66,58,61842,54346,116188
290890,201702,355,259,96,242683,89952,332635
290900,201702,158,127,31,118999,29047,148046
290910,201702,359,272,87,254864,81519,336383
290920,201702,230,190,40,178030,37480,215510
290930,201702,781,599,182,560485.29,170534,731019.29
290940,201702,251,206,45,192272.4,42165,234437.4
290950,201702,168,93,75,87141,70275,157416
290960,201702,424,281,143,262079.72,133709.9,395789.62
290970,201702,243,213,30,199393.6,28110,227503.6
290980,201702,1433,1002,431,934799.02,402817.1,1337616.12
290990,201702,362,302,60,282965,56164.89,339129.89
291000,201702,824,232,592,217384,554422.9,771806.9
291005,201702,1901,800,1101,747857.28,1031342.32,1779199.60
291010,201702,149,137,12,128369,11244,139613
291020,201702,98,80,18,74960,16866,91826
291030,201702,86,65,21,60905,19677,80582
291040,201702,566,278,288,260476.63,269856,530332.63
291050,201702,1246,701,545,655565.92,510665,1166230.92
291060,201702,1438,775,663,725519.1,621231,1346750.1
291070,201702,1843,1366,477,1274368.5,443306.18,1717674.68
291072,201702,7179,2612,4567,2444418.02,4276734.7,6721152.72
291075,201702,186,150,36,140550,33732,174282
291077,201702,43,28,15,26236,14055,40291
291080,201702,18379,7955,10424,7431424.78,9753573.92,17184998.70
291085,201702,268,215,53,201455,49656.32,251111.32
291090,201702,307,113,194,105600,181768.63,287368.63
291100,201702,726,206,520,193022,487230.63,680252.63
291110,201702,389,297,92,278289,86204,364493
291120,201702,2499,1147,1352,1074599,1264594.98,2339193.98
291125,201702,56,30,26,28110,24362,52472
291130,201702,203,175,28,163975,26236,190211
291140,201702,110,78,32,73086,29984,103070
291150,201702,366,149,217,139613,203329,342942
291160,201702,328,276,52,257675.25,48724,306399.25
291165,201702,11,8,3,7496,2811,10307
291170,201702,2719,1378,1341,1288750.45,1254081,2542831.45
291180,201702,1307,492,815,460866,763619,1224485
291185,201702,64,61,3,57157,2811,59968
291190,201702,1190,501,689,467931.5,645059.9,1112991.4
291200,201702,162,118,44,110566,41228,151794
291210,201702,2139,811,1328,756824.27,1242565.54,1999389.81
291220,201702,239,181,58,168660.43,54346,223006.43
291230,201702,1081,363,718,339288,672766,1012054
291240,201702,441,418,23,390448,21551,411999
291250,201702,410,339,71,317643,66527,384170
291260,201702,32,22,10,20614,9370,29984
291270,201702,1174,467,707,437579,662177.9,1099756.9
291280,201702,373,162,211,151606.6,197396.53,349003.13
291290,201702,1710,857,853,801884.6,798512,1600396.6
291300,201702,225,179,46,167067.1,43102,210169.1
291310,201702,243,216,27,202111,25299,227410
291320,201702,1375,981,394,916104.9,367305.75,1283410.65
291330,201702,127,105,22,96604.7,20614,117218.7
291340,201702,134,77,57,72149,53409,125558
291345,201702,121,82,39,76834,36543,113377
291350,201702,1430,434,996,406470.6,933065.15,1339535.75
291360,201702,8382,4111,4271,3841810.98,3998692.28,7840503.26
291370,201702,1031,550,481,515069,449760.31,964829.31
291380,201702,249,195,54,182715,50598,233313
291390,201702,3795,1655,2140,1546717.25,2005180,3551897.25
291400,201702,2006,1420,586,1324545.79,547148.39,1871694.18
291410,201702,159,141,18,131180,16866,148046
291420,201702,98,69,29,64653,27173,91826
291430,201702,181,101,80,93941.74,74023,167964.74
291440,201702,486,393,93,365846.25,87141,452987.25
291450,201702,824,508,316,473842.54,295155,768997.54
291460,201702,1646,1330,316,1243049.68,295943,1538992.68
291465,201702,2215,1040,1175,974110.41,1100748.89,2074859.30
291470,201702,2638,1326,1312,1238743.95,1228345,2467088.95
291480,201702,11544,5094,6450,4762525.01,6034850.2,10797375.21
291490,201702,545,220,325,206140,304525,510665
291500,201702,358,185,173,173345,162101,335446
291510,201702,1264,484,780,452368.75,730578.9,1182947.65
291520,201702,961,433,528,405721,494414.63,900135.63
291530,201702,1032,272,760,254864,711820.26,966684.26
291535,201702,110,93,17,87141,15929,103070
291540,201702,360,106,254,99322,237061.8,336383.8
291550,201702,1162,533,629,497548.19,588792.9,1086341.09
291560,201702,5590,2893,2697,2697405.69,2514483.38,5211889.07
291570,201702,187,94,93,88078,87141,175219
291580,201702,1177,702,475,657031,444124.86,1101155.86
291590,201702,70,27,43,25299,40291,65590
291600,201702,1348,607,741,567822,694018,1261840
291610,201702,1169,500,669,467239.74,626798,1094037.74
291620,201702,547,246,301,230502,281521.65,512023.65
291630,201702,494,165,329,154605,308273,462878
291640,201702,3726,1828,1898,1707247.82,1777885.71,3485133.53
291650,201702,339,217,122,202214.97,114127,316341.97
291660,201702,458,181,277,168917.3,258471.45,427388.75
291670,201702,212,131,81,122185,75897,198082
291680,201702,705,388,317,362620,296936,659556
291685,201702,559,297,262,278055,245306.6,523361.6
291690,201702,520,260,260,243620,242683,486303
291700,201702,883,697,186,653089,173345,826434
291710,201702,1683,757,926,708625.34,866519.83,1575145.17
291720,201702,394,266,128,249237.32,119936,369173.32
291730,201702,888,502,386,468734.25,361672.63,830406.88
291733,201702,252,176,76,164630.9,71212,235842.9
291735,201702,62,51,11,47787,10307,58094
291740,201702,335,250,85,233922.05,79645,313567.05
291750,201702,1865,1232,633,1147654.38,591498.81,1739153.19
291760,201702,3103,1647,1456,1536719.24,1362585.5,2899304.74
291770,201702,743,513,230,478618.03,215510,694128.03
291780,201702,48,27,21,25299,19677,44976
291790,201702,170,74,96,69338,89952,159290
291800,201702,9589,3654,5935,3416281.46,5557441.9,8973723.36
291810,201702,1145,804,341,752500.22,319517,1072017.22
291820,201702,246,180,66,168660,61842,230502
291830,201702,1050,377,673,352050,629655,981705
291835,201702,625,562,63,526126,59031,585157
291840,201702,4498,2278,2220,2129769.62,2079003.88,4208773.50
291845,201702,319,109,210,102133,196760.63,298893.63
291850,201702,306,265,41,248070.75,38417,286487.75
291855,201702,256,101,155,94637,145235,239872
291860,201702,211,129,82,119937,76834,196771
291870,201702,78,32,46,29984,43102,73086
291875,201702,175,158,17,148046,15929,163975
291880,201702,468,370,98,345894,91826,437720
291890,201702,241,79,162,74013.63,150107.5,224121.13
291900,201702,54,30,24,28110,22488,50598
291905,201702,141,91,50,84986,46850,131836
291910,201702,180,143,37,133991,34669,168660
291915,201702,380,336,44,313194,41228,354422
291920,201702,4624,2379,2245,2226762.71,2102111.34,4328874.05
291930,201702,178,101,77,93700.7,72149,165849.7
291940,201702,292,160,132,149920,123056.21,272976.21
291950,201702,1105,910,195,850797.6,182715,1033512.6
291955,201702,884,530,354,496610,331698,828308
291960,201702,162,109,53,102133,49661,151794
291970,201702,783,593,190,555641,178030,733671
291980,201702,1462,1297,165,1212249.79,153668.7,1365918.49
291990,201702,123,115,8,107755,7496,115251
291992,201702,158,78,80,72336.4,74960,147296.4
291995,201702,136,97,39,90889,36543,127432
292000,201702,377,275,102,257394,95574,352968
292010,201702,276,201,75,188337,69338,257675
292020,201702,255,185,70,173345,65590,238935
292030,201702,130,102,28,95574,26236,121810
292040,201702,592,298,294,279226,275478,554704
292045,201702,81,74,7,69338,6559,75897
292050,201702,855,570,285,533099.26,267045,800144.26
292060,201702,924,768,156,717743.59,146172,863915.59
292070,201702,54,22,32,20614,29984,50598
292080,201702,109,72,37,67464,34669,102133
292090,201702,463,157,306,147088.89,286722,433810.89
292100,201702,1304,540,764,504434.35,714894.26,1219328.61
292105,201702,189,158,31,148046,29047,177093
292110,201702,2035,747,1288,699620.42,1204312.68,1903933.10
292120,201702,632,511,121,477694.96,113377,591071.96
292130,201702,436,255,181,238935,169597,408532
292140,201702,194,154,40,144298,37350.61,181648.61
292145,201702,148,76,72,71212,67435.9,138647.9
292150,201702,1368,1093,275,1024141,256665.57,1280806.57
292160,201702,182,148,34,138394.9,31858,170252.9
292170,201702,1218,1071,147,1001419.23,137682.78,1139102.01
292180,201702,185,137,48,128369,44976,173345
292190,201702,162,99,63,92763,59031,151794
292200,201702,1228,447,781,417904.24,731160.68,1149064.92
292205,201702,113,101,12,94637,11244,105881
292210,201702,347,236,111,219774,102649.25,322423.25
292220,201702,22,16,6,14992,5622,20614
292225,201702,39,34,5,31858,4685,36543
292230,201702,858,699,159,652570.72,148983,801553.72
292240,201702,599,414,185,386841,173345,560186
292250,201702,1577,982,595,920134,557515,1477649
292260,201702,437,234,203,219258,189461.4,408719.4
292265,201702,280,194,86,181496.9,80582,262078.9
292270,201702,772,326,446,305462,416965.4,722427.4
292273,201702,193,112,81,104180.34,75897,180077.34
292275,201702,148,67,81,62779,75615.9,138394.9
292280,201702,128,88,40,82456,37480,119936
292285,201702,55,46,9,42446.1,8433,50879.1
292290,201702,484,314,170,291773.01,159009,450782.01
292300,201702,1512,571,941,534464.9,879811.99,1414276.89
292303,201702,83,56,27,52472,25299,77771
292305,201702,103,71,32,66527,29984,96511
292310,201702,823,503,320,470956,298626.99,769582.99
292320,201702,635,480,155,449478.9,145235,594713.9
292330,201702,201,100,101,93700,94637,188337
292335,201702,260,196,64,183652,59968,243620
292340,201702,548,374,174,349711.93,163038,512749.93
292350,201702,245,128,117,119139.55,109347.9,228487.45
292360,201702,678,515,163,480868.5,152731,633599.5
292370,201702,781,590,191,552830,178967,731797
292380,201702,645,494,151,461941.51,141487,603428.51
292390,201702,498,186,312,174282,290610.75,464892.75
292400,201702,3242,1980,1262,1836548.35,1178964,3015512.35
292405,201702,247,162,85,151325.5,79363.9,230689.4
292410,201702,160,93,67,87141,62779,149920
292420,201702,301,257,44,240527.9,41228,281755.9
292430,201702,478,389,89,364493,82924.5,447417.5
292440,201702,561,475,86,443201,80582,523783
292450,201702,245,189,56,177093,52472,229565
292460,201702,589,432,157,404221.9,146406.25,550628.15
292465,201702,171,146,25,136802,22700.24,159502.24
292467,201702,92,51,41,47787,38417,86204
292470,201702,248,163,85,152731,79645,232376
292480,201702,259,176,83,163975.75,77771,241746.75
292490,201702,224,144,80,134928,74960,209888
292500,201702,1178,503,675,471104,632306.35,1103410.35
292510,201702,3196,1425,1771,1334288.36,1656748.35,2991036.71
292520,201702,1016,480,536,448584.75,502214,950798.75
292525,201702,376,261,115,244552.32,107755,352307.32
292530,201702,4094,1643,2451,1537432.4,2294405.3,3831837.7
292540,201702,480,249,231,233031.9,216165.9,449197.8
292550,201702,1016,547,469,512054.23,439001.27,951055.50
292560,201702,314,293,21,274541,19677,294218
292570,201702,283,216,67,202069,62779,264848
292575,201702,447,273,174,255520,163038,418558
292580,201702,873,551,322,514881.5,301151.9,816033.4
292590,201702,500,429,71,401675.98,66527,468202.98
292593,201702,140,108,32,101196,29984,131180
292595,201702,158,116,42,108692,39354,148046
292600,201702,1201,897,304,840177,284848,1125025
292610,201702,116,89,27,82924.5,25046.01,107970.51
292620,201702,505,416,89,389783,83393,473176
292630,201702,1298,751,547,701190.75,509260.3,1210451.05
292640,201702,750,523,227,490051,212699,702750
292650,201702,190,164,26,153668,24362,178030
292660,201702,1928,1374,554,1281719.02,515064.55,1796783.57
292665,201702,123,91,32,85267,29984,115251
292670,201702,363,307,56,287655,52472,340127
292680,201702,244,188,56,176156,52472,228628
292690,201702,175,133,42,124621,39354,163975
292700,201702,895,581,314,543460.9,293936.9,837397.8
292710,201702,98,84,14,78708,12837,91545
292720,201702,788,434,354,405870.92,331511,737381.92
292730,201702,210,100,110,92763.75,103070,195833.75
292740,201702,63117,31164,31953,29127634.26,29912519.47,59040153.73
292750,201702,391,279,112,260486.07,104148.01,364634.08
292760,201702,315,245,70,228572.25,65590,294162.25
292770,201702,775,327,448,304735.03,416887.75,721622.78
292780,201702,422,158,264,147822.53,247368,395190.53
292790,201702,538,236,302,221132,282037,503169
292800,201702,1066,643,423,601554,396351,997905
292805,201702,422,126,296,117827.75,277352,395179.75
292810,201702,1422,840,582,786517.9,545334,1331851.9
292820,201702,743,596,147,556579.3,137448.9,694028.2
292830,201702,103,78,25,73086,23425,96511
292840,201702,640,527,113,493331,105866.95,599197.95
292850,201702,132,87,45,81515,42165,123680
292860,201702,1967,1129,838,1053408.07,784925,1838333.07
292870,201702,3267,2196,1071,2056646.9,1003517.63,3060164.53
292880,201702,1378,909,469,848033.33,439453,1287486.33
292890,201702,444,382,62,357906,58094,416000
292895,201702,132,88,44,81121.71,41228,122349.71
292900,201702,376,281,95,263297,89015,352312
292905,201702,427,215,212,201455,198176,399631
292910,201702,378,291,87,272340,81519,353859
292920,201702,501,222,279,208014,261423,469437
292925,201702,521,482,39,450968.73,36308.75,487277.48
292930,201702,533,326,207,305462,193959,499421
292935,201702,293,121,172,113377,161164,274541
292937,201702,219,145,74,135865,69338,205203
292940,201702,189,141,48,132117,44976,177093
292950,201702,1041,536,505,500359.6,472249,972608.6
292960,201702,510,339,171,317643,160227,477870
292970,201702,282,194,88,181123,82456,263579
292975,201702,158,87,71,81519,66340,147859
292980,201702,250,170,80,157538.42,74960,232498.42
292990,201702,1258,926,332,862331.92,310900.26,1173232.18
293000,201702,100,74,26,69338,24352.63,93690.63
293010,201702,2529,1568,961,1465694.78,896992,2362686.78
293015,201702,632,495,137,463534,127742,591276
293020,201702,343,278,65,260486,60905,321391
293030,201702,626,545,81,509166.82,75897,585063.82
293040,201702,333,259,74,242683,69338,312021
293050,201702,2591,1513,1078,1408905.13,1006310.49,2415215.62
293060,201702,243,192,51,179904,46850.4,226754.4
293070,201702,3199,1594,1605,1486805.34,1502652.63,2989457.97
293075,201702,85,57,28,53409,26236,79645
293076,201702,73,44,29,41228,27173,68401
293077,201702,413,249,164,229815.66,153668,383483.66
293080,201702,458,398,60,372926,56220,429146
293090,201702,133,113,20,105600,18427.7,124027.7
293100,201702,481,347,134,325139,125558,450697
293105,201702,330,224,106,209607,99322,308929
293110,201702,170,121,49,113377,45913,159290
293120,201702,309,205,104,192085,97260.6,289345.6
293130,201702,237,153,84,143361,78426.9,221787.9
293135,201702,7560,3006,4554,2809917.47,4260870.45,7070787.92
293140,201702,175,116,59,108692,54534,163226
293150,201702,329,285,44,265640.1,41228,306868.1
293160,201702,434,239,195,223943,182433.9,406376.9
293170,201702,174,122,52,114032.9,47881,161913.9
293180,201702,441,300,141,280819,132117,412936
293190,201702,1230,858,372,798640.81,348486,1147126.81
293200,201702,506,445,61,416591,57157,473748
293210,201702,508,348,160,325927,149920,475847
293220,201702,2746,1090,1656,1020152.55,1549330.55,2569483.10
293230,201702,1780,636,1144,594527.9,1071907.89,1666435.79
293240,201702,219,200,19,187400,17803,205203
293245,201702,110,91,19,85267,17803,103070
293250,201702,722,264,458,246732.24,428865,675597.24
293260,201702,308,257,51,239872.89,47787,287659.89
293270,201702,1174,554,620,518161.65,580940,1099101.65
293280,201702,221,123,98,115251,91826,207077
293290,201702,2995,1933,1062,1810284.5,994800,2805084.5
293300,201702,658,464,194,432945.79,180981.55,613927.34
293305,201702,161,134,27,125558,25299,150857
293310,201702,137,103,34,96511,31858,128369
293315,201702,140,107,33,100259,30921,131180
293317,201702,92,67,25,62779,23425,86204
293320,201702,922,524,398,490051.25,372641,862692.25
293325,201702,176,65,111,60905,103988.26,164893.26
293330,201702,12273,5681,6592,5314219.28,6170011.68,11484230.96
293340,201702,243,171,72,160227,66527,226754
293345,201702,241,188,53,176156,49661,225817
293350,201702,624,316,308,296092,287143.65,583235.65
293360,201702,1524,1084,440,1014490,411062.35,1425552.35
310010,201702,157,80,77,74960,71587,146547
310020,201702,1027,566,461,527906.05,429802.26,957708.31
310030,201702,397,328,69,305668.94,64371.9,370040.84
310040,201702,50,33,17,30921,15929,46850
310050,201702,248,158,90,147109,84330,231439
310060,201702,237,163,74,152731,69338,222069
310070,201702,20,9,11,8433,10307,18740
310080,201702,52,28,24,26236,22488,48724
310090,201702,912,469,443,434582.14,413029.9,847612.04
310100,201702,283,211,72,197707,67464,265171
310110,201702,713,381,332,355961.09,310896.6,666857.69
310120,201702,366,207,159,193303.1,148615.61,341918.71
310130,201702,34,21,13,19677,12181,31858
310140,201702,30,16,14,14992,13118,28110
310150,201702,1279,887,392,824938.61,366741.9,1191680.51
310160,201702,2144,1098,1046,1022082.05,976729.84,1998811.89
310163,201702,81,46,35,43102,32795,75897
310170,201702,2484,980,1504,917951.6,1406718.3,2324669.9
310180,201702,114,43,71,40291,66152.2,106443.2
310190,201702,461,301,160,282037,149357.8,431394.8
310200,201702,508,321,187,300777,174938,475715
310205,201702,50,39,11,36543,10307,46850
310210,201702,279,220,59,206140,55283,261423
310220,201702,63,40,23,37480,21551,59031
310230,201702,274,184,90,171291.77,84330,255621.77
310240,201702,103,90,13,84330,12181,96511
310250,201702,101,81,20,75897,18740,94637
310260,201702,822,431,391,401224.35,365645.51,766869.86
310270,201702,264,172,92,160621,86204,246825
310280,201702,363,270,93,251398.1,87141,338539.1
310285,201702,209,150,59,140247.35,55283,195530.35
310290,201702,252,146,106,136802,99322,236124
310300,201702,144,119,25,111503,23425,134928
310310,201702,13,9,4,8433,3748,12181
310320,201702,21,14,7,13118,6559,19677
310330,201702,30,21,9,19677,8433,28110
310340,201702,1438,910,528,844503.35,493518.25,1338021.60
310350,201702,2735,1473,1262,1375474.25,1181931.9,2557406.15
310360,201702,41,34,7,31858,6559,38417
310370,201702,119,97,22,90889,20333,111222
310375,201702,99,35,64,32795,59950,92745
310380,201702,50,29,21,27173,19677,46850
310390,201702,102,71,31,66527,29047,95574
310400,201702,2214,1406,808,1312363.8,756796.9,2069160.7
310410,201702,124,66,58,61842,54346,116188
310420,201702,637,346,291,323359.1,271721.43,595080.53
310430,201702,327,215,112,201173.9,104944,306117.9
310440,201702,57,37,20,34669,18740,53409
310445,201702,81,65,16,60905,14992,75897
310450,201702,858,537,321,501701.1,300777,802478.1
310460,201702,258,177,81,165849,75897,241746
310470,201702,489,305,184,285785,172408,458193
310480,201702,90,63,27,59031,25299,84330
310490,201702,472,220,252,205203.1,236124,441327.1
310500,201702,120,53,67,49661,62779,112440
310510,201702,618,392,226,366082.8,211743.63,577826.43
310520,201702,129,85,44,79645,41228,120873
310530,201702,83,38,45,35606,41883.9,77489.9
310540,201702,442,274,168,254678.4,157416,412094.4
310550,201702,75,52,23,48724,21551,70275
310560,201702,2812,1936,876,1804096.65,819214.42,2623311.07
310570,201702,156,99,57,92763,53409,146172
310590,201702,329,221,108,206656,101196,307852
310600,201702,158,94,64,86344.85,59968,146312.85
310610,201702,58,21,37,19677,34669,54346
310620,201702,43838,20870,22968,19487725.56,21484949.65,40972675.21
310630,201702,511,325,186,302886.1,172720.61,475606.71
310640,201702,132,109,23,101945.6,21551,123496.6
310650,201702,152,133,19,123684,17803,141487
310660,201702,85,50,35,46850,32795,79645
310665,201702,46,35,11,32795,10307,43102
310670,201702,6108,2856,3252,2668840.41,3041945.92,5710786.33
310680,201702,50,33,17,30921,15929,46850
310690,201702,544,397,147,369030.23,137739,506769.23
310700,201702,66,43,23,40291,21551,61842
310710,201702,1210,809,401,758024,375737,1133761
310720,201702,85,28,57,26236,53409,79645
310730,201702,1305,902,403,844893,377611,1222504
310740,201702,1011,564,447,526407.2,418595.63,945002.83
310750,201702,243,140,103,130243.29,96511,226754.29
310760,201702,68,51,17,47787,15929,63716
310770,201702,77,41,36,38417,33732,72149
310780,201702,416,339,77,317634,72149,389783
310790,201702,96,77,19,72149,17803,89952
310800,201702,457,212,245,198175.5,229274.53,427450.03
310810,201702,160,112,48,104560,44039,148599
310820,201702,379,294,85,275478,79363.9,354841.9
310825,201702,176,143,33,133991,30921,164912
310830,201702,479,225,254,210176.61,236779.9,446956.51
310840,201702,391,222,169,208014,158071.9,366085.9
310850,201702,108,87,21,81519,19677,101196
310855,201702,374,294,80,275478,74960,350438
310860,201702,1334,995,339,928152.45,315938.95,1244091.40
310870,201702,52,41,11,38417,10307,48724
310880,201702,79,58,21,54346,19677,74023
310890,201702,310,183,127,171471,118999,290470
310900,201702,632,291,341,270466.95,319499,589965.95
310910,201702,242,167,75,155168.1,70275,225443.1
310920,201702,503,297,206,274261.2,192085.7,466346.9
310925,201702,25,20,5,18740,4404,23144
310930,201702,1088,643,445,602087.78,416861.52,1018949.30
310940,201702,683,354,329,330826.8,308273,639099.8
310945,201702,122,74,48,69338,44976,114314
310950,201702,256,200,56,187400,52472,239872
310960,201702,88,34,54,31858,50594,82452
310970,201702,171,106,65,99322,59999.2,159321.2
310980,201702,36,18,18,16866,16866,33732
310990,201702,152,87,65,81519,60905,142424
311000,201702,796,412,384,383234.9,359518,742752.9
311010,201702,39,31,8,29047,7496,36543
311020,201702,38,24,14,22488,13118,35606
311030,201702,406,234,172,217385,161164,378549
311040,201702,34,29,5,27173,4685,31858
311050,201702,462,192,270,179342,252708.9,432050.9
311060,201702,748,440,308,411156.2,288596,699752.2
311070,201702,310,137,173,128369,162101,290470
311080,201702,104,53,51,49661,47787,97448
311090,201702,388,177,211,165849,197707,363556
311100,201702,606,363,243,339850,227128.8,566978.8
311110,201702,644,432,212,404784,198635,603419
311115,201702,59,44,15,41228,14055,55283
311120,201702,984,513,471,478757.4,440717.95,919475.35
311130,201702,411,236,175,220944.6,163975,384919.6
311140,201702,153,67,86,62779,79785.55,142564.55
311150,201702,351,226,125,211645,116890.75,328535.75
311160,201702,740,529,211,493799.7,197239,691038.7
311170,201702,71,49,22,45913,20332.9,66245.9
311180,201702,337,216,121,202110.9,113096,315206.9
311190,201702,36,20,16,18740,14992,33732
311200,201702,354,243,111,226098.3,104007,330105.3
311205,201702,30,19,11,17568.75,9932.2,27500.95
311210,201702,48,40,8,37480,7496,44976
311220,201702,11,10,1,9370,937,10307
311230,201702,1440,889,551,829641.55,516287,1345928.55
311240,201702,157,95,62,89015,58094,147109
311250,201702,60,29,31,27173,29047,56220
311260,201702,560,333,227,312021,212699,524720
311265,201702,105,71,34,66527,31858,98385
311270,201702,368,251,117,235187,109441.6,344628.6
311280,201702,213,96,117,89952,109066.8,199018.8
311290,201702,110,89,21,83112,19115,102227
311300,201702,542,335,207,312958.88,193678,506636.88
311310,201702,23,19,4,17803,3748,21551
311320,201702,655,486,169,454445,158353,612798
311330,201702,991,737,254,690241.75,237061.7,927303.45
311340,201702,2515,1782,733,1661736.72,686137.83,2347874.55
311350,201702,268,207,61,193959,57157,251116
311360,201702,170,106,64,99322,59968,159290
311370,201702,1159,449,710,418758.25,664192.45,1082950.70
311380,201702,7,6,1,5622,937,6559
311390,201702,284,154,130,144298,121341.6,265639.6
311400,201702,166,108,58,101196,54337,155533
311410,201702,90,54,36,50598,33732,84330
311420,201702,283,161,122,148046.1,114314,262360.1
311430,201702,833,539,294,503077.1,275478,778555.1
311440,201702,492,342,150,319517.4,140268.9,459786.3
311450,201702,309,192,117,179904,109629,289533
311455,201702,300,202,98,188983.9,91544.9,280528.8
311460,201702,131,52,79,48724,73324.93,122048.93
311470,201702,20,11,9,10307,8433,18740
311480,201702,23,7,16,6559,14992,21551
311490,201702,17,10,7,9370,6559,15929
311500,201702,19,8,11,7496,10307,17803
311510,201702,624,426,198,398225,185526,583751
311520,201702,42,31,11,28391.1,10307,38698.1
311530,201702,1784,1322,462,1229862.91,432894,1662756.91
311535,201702,61,48,13,44976,12181,57157
311540,201702,33,29,4,27173,3748,30921
311545,201702,177,134,43,125558,40291,165849
311547,201702,32,23,9,21551,8433,29984
311550,201702,565,259,306,242683,286703.63,529386.63
311560,201702,40,27,13,25299,12181,37480
311570,201702,310,200,110,186837.8,103070,289907.8
311580,201702,279,158,121,147764.9,113377,261141.9
311590,201702,35,29,6,27173,5622,32795
311600,201702,89,71,18,66527,16866,83393
311610,201702,250,214,36,199581.25,33732,233313.25
311615,201702,84,68,16,63088.21,14992,78080.21
311620,201702,16,11,5,10307,4685,14992
311630,201702,71,58,13,54346,12181,66527
311640,201702,115,67,48,62779,44976,107755
311650,201702,118,87,31,80816.25,29047,109863.25
311660,201702,381,181,200,169597,187400,356997
311670,201702,162,101,61,94085,57157,151242
311680,201702,217,160,57,148261.94,52659.4,200921.34
311690,201702,18,10,8,9370,7496,16866
311700,201702,201,136,65,127150.9,60905,188055.9
311710,201702,213,138,75,129025,70275,199300
311720,201702,27,21,6,19677,5622,25299
311730,201702,510,337,173,315207,162101,477308
311740,201702,30,21,9,19677,8433,28110
311750,201702,701,476,225,444138.4,210544,654682.4
311760,201702,64,37,27,34669,25299,59968
311770,201702,388,182,206,169561.1,193022,362583.1
311780,201702,166,97,69,90889,64341,155230
311783,201702,73,64,9,59968,8433,68401
311787,201702,35,13,22,12181,20614,32795
311790,201702,264,127,137,118999,128369,247368
311800,201702,602,413,189,383656.15,177093,560749.15
311810,201702,40,33,7,30921,6559,37480
311820,201702,108,87,21,81519,19677,101196
311830,201702,1804,1155,649,1077476.95,605489.4,1682966.35
311840,201702,971,526,445,488646.95,415221.66,903868.61
311850,201702,11,5,6,4685,5622,10307
311860,201702,9038,4192,4846,3915664.87,4532857.35,8448522.22
311870,201702,159,85,74,79645,69338,148983
311880,201702,939,697,242,651861.9,226754,878615.9
311890,201702,220,113,107,105881,100259,206140
311900,201702,90,38,52,35606,48443,84049
311910,201702,1307,819,488,764546.05,455054.15,1219600.20
311920,201702,237,151,86,141253,80582,221835
311930,201702,882,507,375,474778,350859.9,825637.9
311940,201702,2249,1131,1118,1057171.25,1044521.05,2101692.30
311950,201702,204,117,87,109255,81238,190493
311960,201702,65,45,20,42165,18740,60905
311970,201702,27,15,12,12508.95,11244,23752.95
311980,201702,41,31,10,29047,9370,38417
311990,201702,63,47,16,44039,14992,59031
311995,201702,64,44,20,41228,18740,59968
312000,201702,31,21,10,19395.9,9370,28765.9
312010,201702,87,62,25,58094,23425,81519
312015,201702,87,65,22,60624,20614,81238
312020,201702,171,103,68,96511,63434.9,159945.9
312030,201702,36,31,5,28392,4685,33077
312040,201702,84,57,27,53409,25299,78708
312050,201702,243,125,118,117125,110566,227691
312060,201702,75,52,23,48724,20895.1,69619.1
312070,201702,79,46,33,43102,30921,74023
312080,201702,501,208,293,194896,274541,469437
312083,201702,42,32,10,29984,9370,39354
312087,201702,99,76,23,71212,21551,92763
312090,201702,2665,1451,1214,1347972.85,1133793.52,2481766.37
312100,201702,164,116,48,108692,44976,153668
312110,201702,125,81,44,75897,41228,117125
312120,201702,144,104,40,97448,37480,134928
312125,201702,94,51,43,47787,40291,88078
312130,201702,125,81,44,75897,41228,117125
312140,201702,132,103,29,96511,27173,123684
312150,201702,42,34,8,31858,7496,39354
312160,201702,1506,1002,504,936016.85,470749.1,1406765.95
312170,201702,11,9,2,8433,1874,10307
312180,201702,133,86,47,79645.75,43758,123403.75
312190,201702,30,28,2,26236,1874,28110
312200,201702,691,597,94,557749.35,88078,645827.35
312210,201702,94,59,35,55283,32795,88078
312220,201702,116,84,32,78474,29984,108458
312230,201702,3327,1649,1678,1542144.89,1571173.99,3113318.88
312235,201702,114,73,41,68401,38417,106818
312240,201702,109,70,39,65590,36543,102133
312245,201702,147,98,49,91822,45913,137735
312247,201702,51,36,15,32983,14055,47038
312250,201702,172,81,91,75429,85267,160696
312260,201702,92,63,29,58843.6,27173,86016.6
312270,201702,137,84,53,78708,49661,128369
312280,201702,27,16,11,14992,10307,25299
312290,201702,158,114,44,106537,40291.4,146828.4
312300,201702,196,132,64,123684,59968,183652
312310,201702,55,50,5,46850,4685,51535
312320,201702,419,255,164,236962.21,152403.25,389365.46
312330,201702,87,75,12,69526,10962.9,80488.9
312340,201702,33,14,19,13118,17803,30921
312350,201702,16,10,6,9370,5622,14992
312352,201702,92,65,27,60905,25299,86204
312360,201702,560,257,303,239872,283255.1,523127.1
312370,201702,215,127,88,118999,82456,201455
312380,201702,144,92,52,86204,48724,134928
312385,201702,180,147,33,137739,30921,168660
312390,201702,293,184,109,172408,101478,273886
312400,201702,368,273,95,255801,88547,344348
312410,201702,836,272,564,254395.5,527902,782297.5
312420,201702,589,473,116,443201,108692,551893
312430,201702,844,627,217,584924.94,202392.1,787317.04
312440,201702,45,32,13,29984,12181,42165
312450,201702,212,133,79,124621,74023,198644
312460,201702,52,24,28,22488,26236,48724
312470,201702,53,34,19,31858,17803,49661
312480,201702,222,136,86,127432,80300.9,207732.9
312490,201702,261,182,79,170534,74023,244557
312500,201702,29,16,13,14992,12181,27173
312510,201702,405,155,250,145235,233645.36,378880.36
312520,201702,41,15,26,14055,24362,38417
312530,201702,45,35,10,32795,9370,42165
312540,201702,99,87,12,81519,11244,92763
312550,201702,35,27,8,25299,7496,32795
312560,201702,184,134,50,125277,46568.9,171845.9
312570,201702,420,251,169,234812.2,157674.23,392486.43
312580,201702,83,45,38,41884,35606,77490
312590,201702,296,231,65,215371,60905,276276
312595,201702,137,124,13,116188,12181,128369
312600,201702,77,48,29,44555,27173,71728
312610,201702,1587,818,769,760940.39,718773.3,1479713.69
312620,201702,178,124,54,116188,50598,166786
312630,201702,68,55,13,51535,12181,63716
312640,201702,49,16,33,14992,30921,45913
312650,201702,139,112,27,104663,25299,129962
312660,201702,56,41,15,38136,14055,52191
312670,201702,745,488,257,455710.95,240762.15,696473.10
312675,201702,41,31,10,29047,9370,38417
312680,201702,82,57,25,53034.2,23425,76459.2
312690,201702,231,121,110,113367.63,102788.9,216156.53
312695,201702,25,19,6,17803,5622,23425
312700,201702,189,103,86,96511,80582,177093
312705,201702,73,61,12,57157,10962.9,68119.9
312707,201702,85,60,25,56220,23425,79645
312710,201702,1832,974,858,911177.1,803738,1714915.1
312720,201702,62,31,31,29047,29047,58094
312730,201702,293,171,122,159290,114314,273604
312733,201702,47,42,5,39354,4685,44039
312735,201702,20,15,5,14055,4685,18740
312737,201702,71,38,33,35606,30921,66527
312738,201702,49,34,15,31858,14055,45913
312740,201702,69,48,21,44976,19677,64653
312750,201702,70,50,20,46850,18740,65590
312760,201702,270,194,76,181778,71212,252990
312770,201702,7454,3410,4044,3174544.46,3783098.67,6957643.13
312780,201702,434,337,97,315487.9,90889,406376.9
312790,201702,19,15,4,14055,3748,17803
312800,201702,1579,1102,477,1025976.98,445788.11,1471765.09
312810,201702,375,234,141,219258,132117,351375
312820,201702,189,142,47,133054,44039,177093
312825,201702,24,15,9,14055,8433,22488
312830,201702,294,169,125,157417,116441,273858
312840,201702,143,106,37,99322,34669,133991
312850,201702,20,18,2,16866,1874,18740
312860,201702,173,107,66,99978,61842,161820
312870,201702,987,509,478,475121.7,447886,923007.7
312880,201702,150,104,46,97307.45,43008.3,140315.75
312890,201702,157,104,53,97448,49661,147109
312900,201702,220,165,55,153949.1,51535,205484.1
312910,201702,182,89,93,82624.66,87141,169765.66
312920,201702,147,82,65,76834,60905,137739
312930,201702,335,238,97,223006,90889,313895
312940,201702,99,64,35,59968,32795,92763
312950,201702,688,438,250,409094.3,234250,643344.3
312960,201702,177,133,44,124621,41228,165849
312965,201702,42,37,5,34669,4685,39354
312970,201702,279,221,58,205906.1,54346,260252.1
312980,201702,2182,1175,1007,1097781.9,942992.8,2040774.7
312990,201702,45,26,19,24362,17803,42165
313000,201702,40,26,14,24362,13118,37480
313005,201702,156,123,33,114276.75,30640,144916.75
313010,201702,895,359,536,335446.1,501941.9,837388.0
313020,201702,197,103,94,96511,88078,184589
313030,201702,198,124,74,115252,69338,184590
313040,201702,56,20,36,18740,33732,52472
313050,201702,285,198,87,184589.1,81237.9,265827.0
313055,201702,41,28,13,26236,12181,38417
313060,201702,117,80,37,74511,34387.9,108898.9
313065,201702,57,35,22,32795,20614,53409
313070,201702,157,82,75,76834,70275,147109
313080,201702,39,16,23,14992,21551,36543
313090,201702,692,472,220,440999.15,206140,647139.15
313100,201702,174,64,110,59968,103062,163030
313110,201702,106,61,45,57157,42165,99322
313115,201702,128,69,59,64456.23,54346,118802.23
313120,201702,710,390,320,365149,298341,663490
313130,201702,4857,2573,2284,2395492.47,2131153.27,4526645.74
313140,201702,163,80,83,74960,77771,152731
313150,201702,326,258,68,241746,63434.9,305180.9
313160,201702,162,116,46,108692,43102,151794
313170,201702,1292,916,376,848386.06,351852.42,1200238.48
313180,201702,404,239,165,222368.84,154605,376973.84
313190,201702,670,389,281,361494.6,262548,624042.6
313200,201702,21,20,1,18740,937,19677
313210,201702,878,743,135,692022.48,126490.32,818512.80
313220,201702,216,147,69,136802,63950.25,200752.25
313230,201702,303,215,88,200519,82456,282975
313240,201702,1865,1013,852,946550.17,794268.69,1740818.86
313250,201702,1209,877,332,817159.8,308275.4,1125435.2
313260,201702,92,54,38,50598,35606,86204
313270,201702,942,533,409,495438.77,383233,878671.77
313280,201702,59,50,9,46568.9,8433,55001.9
313290,201702,222,175,47,163694,43102.9,206796.9
313300,201702,349,171,178,160227,166786,327013
313310,201702,203,101,102,94637,95574,190211
313320,201702,354,275,79,256457.3,74023,330480.3
313330,201702,1269,744,525,696191.6,490754.75,1186946.35
313340,201702,334,228,106,213636,99322,312958
313350,201702,536,364,172,339194.05,161164,500358.05
313360,201702,114,62,52,58094,48443,106537
313370,201702,187,75,112,70275,104944,175219
313375,201702,250,147,103,137739,96511,234250
313380,201702,1175,596,579,555378.88,541770,1097148.88
313390,201702,47,39,8,35606.4,7496,43102.4
313400,201702,404,255,149,238935,139332,378267
313410,201702,13,8,5,7496,4685,12181
313420,201702,4569,2315,2254,2160978.29,2104098.11,4265076.40
313430,201702,140,61,79,57157,74023,131180
313440,201702,1431,962,469,900223.75,439172,1339395.75
313450,201702,59,26,33,24362,30921,55283
313460,201702,356,170,186,157872,174282,332154
313470,201702,491,213,278,199581,259830.1,459411.1
313480,201702,159,106,53,98386,49661,148047
313490,201702,497,241,256,225812.32,239423,465235.32
313500,201702,15,10,5,9370,4685,14055
313505,201702,905,703,202,657774,189274,847048
313507,201702,93,53,40,49661,37480,87141
313510,201702,2646,1702,944,1590372.9,883591,2473963.9
313520,201702,3531,2743,788,2558601.84,738070.9,3296672.74
313530,201702,39,28,11,26236,10307,36543
313535,201702,95,79,16,73368,14992,88360
313540,201702,72,56,16,52472,14148.7,66620.7
313545,201702,90,73,17,68401,15929,84330
313550,201702,234,190,44,178030,40666,218696
313560,201702,334,172,162,161164,151794,312958
313570,201702,54,28,26,26236,24362,50598
313580,201702,1268,673,595,629664,555547.7,1185211.7
313590,201702,131,62,69,58094,64653,122747
313600,201702,693,403,290,377611,270887,648498
313610,201702,63,52,11,48443,10307,58750
313620,201702,1230,661,569,609173.76,530023.6,1139197.36
313630,201702,1615,1241,374,1161037.4,350157,1511194.4
313640,201702,125,69,56,64653,52472,117125
313650,201702,208,97,111,90889,104007,194896
313652,201702,14,13,1,12181,937,13118
313655,201702,51,29,22,27173,20614,47787
313657,201702,46,43,3,40291,2811,43102
313660,201702,124,87,37,81519,34669,116188
313665,201702,588,299,289,280163,270558.75,550721.75
313670,201702,9515,6538,2977,6105831.93,2788887,8894718.93
313680,201702,37,29,8,27173,7496,34669
313690,201702,160,123,37,115251,34669,149920
313695,201702,56,43,13,40291,12181,52472
313700,201702,278,218,60,203985,56220,260205
313710,201702,157,109,48,102133,44976,147109
313720,201702,950,436,514,407969.9,480204.83,888174.73
313730,201702,50,36,14,33732,13118,46850
313740,201702,158,124,34,116000.6,31858,147858.6
313750,201702,456,337,119,315487.9,111503,426990.9
313753,201702,237,164,73,153012.1,68401,221413.1
313760,201702,1105,406,699,380422,652275.56,1032697.56
313770,201702,340,240,100,224880,93700,318580
313780,201702,688,363,325,340131,304243.9,644374.9
313790,201702,27,25,2,23425,1686.6,25111.6
313800,201702,128,79,49,74023,45913,119936
313810,201702,51,34,17,31858,15929,47787
313820,201702,1252,624,628,583470.1,587195.1,1170665.2
313830,201702,68,51,17,47787,15929,63716
313835,201702,45,41,4,38417,3748,42165
313840,201702,1575,960,615,895211.2,575318.1,1470529.3
313850,201702,178,61,117,57157,109059.39,166216.39
313860,201702,547,429,118,397852.6,109629.55,507482.15
313862,201702,175,114,61,106818,57157,163975
313865,201702,74,56,18,52472,16866,69338
313867,201702,50,37,13,34669,12181,46850
313868,201702,21,14,7,13118,6559,19677
313870,201702,135,63,72,59031,67464,126495
313880,201702,326,208,118,194333.9,110003.9,304337.8
313890,201702,312,172,140,160414.9,130617.8,291032.7
313900,201702,910,503,407,469719.25,381313,851032.25
313910,201702,151,109,42,101946,38417.1,140363.1
313920,201702,568,411,157,384638.5,147109,531747.5
313925,201702,27,23,4,21551,3748,25299
313930,201702,782,591,191,553767,178944,732711
313940,201702,1696,1062,634,990690.2,593495.9,1584186.1
313950,201702,920,581,339,542617.8,317127.9,859745.7
313960,201702,1202,695,507,647935.28,474778,1122713.28
313970,201702,113,82,31,76834,29047,105881
313980,201702,203,129,74,120639,69116.77,189755.77
313990,201702,325,193,132,180841,123684,304525
314000,201702,894,609,285,568479.4,266759.32,835238.72
314010,201702,73,45,28,42165,26236,68401
314015,201702,60,19,41,17803,38417,56220
314020,201702,48,33,15,30921,14055,44976
314030,201702,95,49,46,45913,43102,89015
314040,201702,41,32,9,29984,8433,38417
314050,201702,305,179,126,167723,116750.2,284473.2
314053,201702,100,64,36,59968,33732,93700
314055,201702,277,158,119,148046,111503,259549
314060,201702,134,113,21,104944,19677,124621
314070,201702,863,446,417,413883.67,389829.53,803713.20
314080,201702,205,135,70,126261,64653.84,190914.84
314085,201702,102,69,33,64653,30921,95574
314090,201702,362,262,100,245494,93695.32,339189.32
314100,201702,453,371,82,343755,76272,420027
314110,201702,691,372,319,346699.37,298200.8,644900.17
314120,201702,105,54,51,50598,47787,98385
314130,201702,20,11,9,10307,8433,18740
314140,201702,1072,636,436,594320.46,407595.23,1001915.69
314150,201702,163,100,63,93700,59031,152731
314160,201702,358,264,94,245485.26,87891,333376.26
314170,201702,60,43,17,40291,15929,56220
314180,201702,756,655,101,612204.91,93700.25,705905.16
314190,201702,98,60,38,56220,35606,91826
314200,201702,584,397,187,371052.8,174282,545334.8
314210,201702,365,267,98,249007.75,91545,340552.75
314220,201702,372,284,88,264235,82175,346410
314225,201702,63,45,18,42165,16866,59031
314230,201702,96,44,52,41228,48724,89952
314240,201702,134,100,34,93700,31812,125512
314250,201702,56,32,24,29984,22488,52472
314260,201702,186,96,90,89952,84330,174282
314270,201702,471,359,112,335634,104663,440297
314280,201702,671,371,300,347336.9,281100,628436.9
314290,201702,545,435,110,406377.25,102788.9,509166.15
314300,201702,413,294,119,272594.5,111457,384051.5
314310,201702,1399,925,474,865507.9,443837.33,1309345.23
314315,201702,32,25,7,23425,6559,29984
314320,201702,600,373,227,349220,212071.21,561291.21
314330,201702,10423,5254,5169,4911118.12,4838193.23,9749311.35
314340,201702,567,263,304,245868.9,284286,530154.9
314345,201702,41,28,13,26236,12181,38417
314350,201702,189,111,78,104007,73086,177093
314360,201702,71,39,32,36543,29984,66527
314370,201702,58,48,10,44976,9370,54346
314380,201702,85,62,23,58094,21551,79645
314390,201702,2832,1731,1101,1619379.3,1028451.6,2647830.9
314400,201702,657,477,180,444130.1,168660,612790.1
314410,201702,408,263,145,246431,135865,382296
314420,201702,17,6,11,5622,10307,15929
314430,201702,2445,859,1586,800719.05,1483830.91,2284549.96
314435,201702,250,143,107,133709.9,99322,233031.9
314437,201702,23,18,5,16866,4685,21551
314440,201702,114,77,37,72149,34669,106818
314450,201702,154,118,36,110566,33732,144298
314460,201702,664,294,370,275478,346409,621887
314465,201702,72,52,20,48724,18740,67464
314467,201702,74,59,15,55283,13399.1,68682.1
314470,201702,335,167,168,152152.06,156479.75,308631.81
314480,201702,989,467,522,436378.02,488270.7,924648.72
314490,201702,88,63,25,59031,23425,82456
314500,201702,290,183,107,171471,100259,271730
314505,201702,116,79,37,74023,34669,108692
314510,201702,224,179,45,166786.1,42165,208951.1
314520,201702,1182,613,569,570121.5,531232.45,1101353.95
314530,201702,744,586,158,548605,148046,696651
314535,201702,188,118,70,110284.9,65062.38,175347.28
314537,201702,58,34,24,31858,22488,54346
314540,201702,32,26,6,24362,5622,29984
314545,201702,46,33,13,30921,12181,43102
314550,201702,80,43,37,40291,34669,74960
314560,201702,799,421,378,392322,353249.79,745571.79
314570,201702,21,15,6,14055,5622,19677
314580,201702,20,8,12,7496,11244,18740
314585,201702,18,12,6,11244,5622,16866
314587,201702,71,63,8,59031,7496,66527
314590,201702,515,383,132,358792,123684,482476
314600,201702,936,592,344,551492.39,319358.8,870851.19
314610,201702,901,496,405,462878.4,378361.15,841239.55
314620,201702,142,104,38,96511,35606,132117
314625,201702,91,70,21,64747,19677,84424
314630,201702,1254,626,628,584828.65,588154.9,1172983.55
314640,201702,92,61,31,57157,29047,86204
314650,201702,203,116,87,108410.9,81050.5,189461.4
314655,201702,62,48,14,44976,13099.17,58075.17
314660,201702,19,15,4,14055,3748,17803
314670,201702,173,141,32,131836,29984,161820
314675,201702,212,117,95,109629,89015,198644
314690,201702,527,290,237,271730,221788,493518
314700,201702,2417,1293,1124,1206482.6,1052297.95,2258780.55
314710,201702,1602,923,679,861854.2,635051.75,1496905.95
314720,201702,407,241,166,224130.9,155542,379672.9
314730,201702,494,263,231,245026,215969.5,460995.5
314740,201702,669,329,340,307570.25,318580,626150.25
314750,201702,19,17,2,15929,1874,17803
314760,201702,299,147,152,137739,142414.63,280153.63
314770,201702,123,83,40,77771,37480,115251
314780,201702,21,6,15,5622,14055,19677
314790,201702,2288,1429,859,1330720.55,803936.73,2134657.28
314795,201702,42,35,7,32561,6559,39120
314800,201702,2747,1583,1164,1477141.56,1090003.1,2567144.66
314810,201702,1452,797,655,744494.25,612142.5,1356636.75
314820,201702,83,47,36,44039,33732,77771
314830,201702,204,156,48,145469.75,44695,190164.75
314840,201702,79,46,33,43102,30921,74023
314850,201702,335,158,177,148046,165849,313895
314860,201702,699,518,181,483679.79,168098.35,651778.14
314870,201702,1384,685,699,640908.5,654963,1295871.5
314875,201702,37,31,6,29047,5622,34669
314880,201702,41,29,12,27173,11244,38417
314890,201702,46,27,19,25299,17803,43102
314900,201702,23,20,3,18740,2811,21551
314910,201702,257,169,88,158353,82456,240809
314915,201702,143,128,15,119702,14055,133757
314920,201702,134,80,54,74960,50317,125277
314930,201702,965,488,477,456086,446386.9,902472.9
314940,201702,28,23,5,21551,4685,26236
314950,201702,39,30,9,27407.25,8433,35840.25
314960,201702,59,42,17,39354,15929,55283
314970,201702,134,65,69,60624,64653,125277
314980,201702,301,192,109,177047.05,100915,277962.05
314990,201702,444,242,202,225817.25,188384.75,414202.00
314995,201702,157,61,96,57157,89942.63,147099.63
315000,201702,84,65,19,59968.6,17803,77771.6
315010,201702,45,29,16,27173,14992,42165
315015,201702,161,131,30,122034.88,28110,150144.88
315020,201702,55,47,8,44039,7496,51535
315030,201702,130,97,33,89953,30921,120874
315040,201702,60,44,16,41228,14992,56220
315050,201702,192,116,76,108692,71212,179904
315053,201702,32,27,5,25299,4685,29984
315057,201702,91,76,15,70837.2,14055,84892.2
315060,201702,71,64,7,58094.98,6559,64653.98
315070,201702,110,62,48,58094,44976,103070
315080,201702,354,291,63,272667,59031,331698
315090,201702,107,67,40,62779,37480,100259
315100,201702,75,39,36,36543,33732,70275
315110,201702,298,165,133,152731,124621,277352
315120,201702,1546,768,778,715728.1,727815,1443543.1
315130,201702,308,221,87,207077,81519,288596
315140,201702,533,311,222,288877.18,208014,496891.18
315150,201702,961,440,521,411344,487896,899240
315160,201702,192,97,95,90889,89015,179904
315170,201702,337,219,118,203330.1,110284.9,313615.0
315180,201702,3178,1352,1826,1263030.05,1708386.1,2971416.15
315190,201702,304,181,123,169223,115251,284474
315200,201702,1151,640,511,597900.53,477588.9,1075489.43
315210,201702,1480,827,653,770590.05,609987.8,1380577.85
315213,201702,29,19,10,17803,9370,27173
315217,201702,184,143,41,133991,38417,172408
315220,201702,1433,1098,335,1028451.3,313801.3,1342252.6
315230,201702,169,122,47,114033,44039,158072
315240,201702,421,279,142,261423,132810.63,394233.63
315250,201702,2470,1234,1236,1154946.3,1156812.37,2311758.67
315260,201702,150,89,61,82081.2,57157,139238.2
315270,201702,125,81,44,74772.6,40515.88,115288.48
315280,201702,712,464,248,434394,232366.63,666760.63
315290,201702,180,101,79,94637,73086.34,167723.34
315300,201702,74,46,28,43102,26236,69338
315310,201702,68,59,9,55283,8433,63716
315320,201702,154,83,71,77771,66527,144298
315330,201702,53,45,8,42165,7496,49661
315340,201702,402,288,114,268694.9,106813.32,375508.22
315350,201702,142,86,56,80582,52472,133054
315360,201702,93,49,44,45913,41228,87141
315370,201702,55,30,25,28110,23143.9,51253.9
315380,201702,11,6,5,5622,4685,10307
315390,201702,47,14,33,13118,30921,44039
315400,201702,796,587,209,546271.6,195177.1,741448.7
315410,201702,331,197,134,184308,125558,309866
315415,201702,61,46,15,43102,14055,57157
315420,201702,195,145,50,134788.5,46850,181638.5
315430,201702,669,399,270,373863,252990,626853
315440,201702,73,55,18,51535,16866,68401
315445,201702,249,197,52,184279.79,48724,233003.79
315450,201702,191,146,45,136802,42165,178967
315460,201702,3235,1643,1592,1534612.9,1488463.95,3023076.85
315470,201702,46,25,21,23144,19677,42821
315480,201702,59,22,37,20614,34669,55283
315490,201702,499,291,208,271495.75,194896,466391.75
315500,201702,24,13,11,12181,10307,22488
315510,201702,147,92,55,86204,51535,137739
315520,201702,64,58,6,54346,5622,59968
315530,201702,53,27,26,25299,24362,49661
315540,201702,228,145,83,135865,77771,213636
315550,201702,168,129,39,120873,36543,157416
315560,201702,921,717,204,671266.9,191148,862414.9
315570,201702,326,176,150,161820.25,140550,302370.25
315580,201702,622,407,215,381359,201455,582814
315590,201702,217,113,104,105881,96933,202814
315600,201702,273,195,78,182715,72899,255614
315610,201702,95,48,47,44976,44039,89015
315620,201702,32,23,9,21551,8433,29984
315630,201702,134,87,47,81519,44039,125558
315640,201702,49,29,20,27173,18740,45913
315645,201702,69,49,20,45913,18272,64185
315650,201702,158,119,39,111222,36543,147765
315660,201702,470,183,287,171471,268919,440390
315670,201702,2107,1069,1038,998983.75,971838.9,1970822.65
315680,201702,856,572,284,532461.81,265395.88,797857.69
315690,201702,691,467,224,436520.63,209888,646408.63
315700,201702,1863,998,865,932596.61,809568.4,1742165.01
315710,201702,306,70,236,65590,221132,286722
315720,201702,411,261,150,244557,140268.9,384825.9
315725,201702,188,151,37,141487,34669,176156
315727,201702,37,20,17,18740,15508,34248
315730,201702,43,40,3,37480,2811,40291
315733,201702,87,55,32,51254,29984,81238
315737,201702,50,37,13,34669,12181,46850
315740,201702,42,37,5,34669,4685,39354
315750,201702,155,125,30,117085,28110,145195
315760,201702,45,29,16,27173,14992,42165
315765,201702,105,68,37,63716,34669,98385
315770,201702,222,128,94,119936,88078,208014
315780,201702,3129,1645,1484,1533251.05,1387885.31,2921136.36
315790,201702,172,131,41,122747,38417,161164
315800,201702,272,201,71,188056,66527,254583
315810,201702,85,49,36,45913,33732,79645
315820,201702,785,562,223,524346.77,208951,733297.77
315830,201702,139,80,59,74960,55283,130243
315840,201702,80,52,28,48724,26236,74960
315850,201702,260,189,71,177093,66527,243620
315860,201702,11,3,8,2811,7496,10307
315870,201702,33,28,5,26236,4685,30921
315880,201702,106,67,39,62779,36543,99322
315890,201702,67,49,18,45913,16866,62779
315895,201702,314,207,107,193210,99697,292907
315900,201702,63,34,29,31858,27173,59031
315910,201702,36,23,13,21223.05,12181,33404.05
315920,201702,176,119,57,111503,52472.95,163975.95
315930,201702,32,11,21,10307,19677,29984
315935,201702,131,103,28,95715,26227,121942
315940,201702,80,62,18,58094,16866,74960
315950,201702,63,42,21,39354,19677,59031
315960,201702,592,274,318,256381.94,297685,554066.94
315970,201702,40,30,10,28110,9370,37480
315980,201702,680,301,379,281100,355113.63,636213.63
315990,201702,245,144,101,134928,94356,229284
316000,201702,43,27,16,25299,14992,40291
316010,201702,70,60,10,56220,9370,65590
316020,201702,99,82,17,76834,15929,92763
316030,201702,408,204,204,191148,190914,382062
316040,201702,464,205,259,191708.89,242402,434110.89
316045,201702,33,29,4,27173,3748,30921
316050,201702,16,15,1,12743.2,937,13680.2
316060,201702,95,64,31,59686.9,29047,88733.9
316070,201702,996,635,361,589376.25,337508,926884.25
316080,201702,103,62,41,58094,38417,96511
316090,201702,48,28,20,25299.1,18740,44039.1
316095,201702,57,47,10,43768,9370,53138
316100,201702,304,183,121,170908.9,113377,284285.9
316105,201702,35,23,12,21551,11244,32795
316110,201702,1891,1509,382,1403298.47,355966.3,1759264.77
316120,201702,74,53,21,49661,19396,69057
316130,201702,138,106,32,98667,29984,128651
316140,201702,63,51,12,47787,11244,59031
316150,201702,198,143,55,133288.25,51535,184823.25
316160,201702,88,55,33,51535,30921,82456
316165,201702,57,42,15,39167,13352.25,52519.25
316170,201702,212,143,69,133054,64653,197707
316180,201702,185,83,102,77443.05,95574,173017.05
316190,201702,122,90,32,83393,29984,113377
316200,201702,696,394,302,369178,282787,651965
316210,201702,729,480,249,449420.43,233313,682733.43
316220,201702,117,76,41,71212,38417,109629
316225,201702,13,5,8,4685,7496,12181
316230,201702,32,19,13,17803,12181,29984
316240,201702,606,487,119,455382.1,111503,566885.1
316245,201702,97,81,16,75897,14992,90889
316250,201702,1442,1018,424,944897.8,397063.12,1341960.92
316255,201702,112,90,22,83955.2,20614,104569.2
316257,201702,169,92,77,86204,72149,158353
316260,201702,235,155,80,142743.83,74867,217610.83
316265,201702,20,14,6,13118,5622,18740
316270,201702,666,461,205,428958.8,192085,621043.8
316280,201702,520,318,202,295780.5,188618.3,484398.8
316290,201702,654,430,224,400099.69,209888,609987.69
316292,201702,463,181,282,169597,263859.2,433456.2
316294,201702,122,76,46,71212,43102,114314
316295,201702,265,119,146,110081.5,136802,246883.5
316300,201702,96,65,31,60905,29047,89952
316310,201702,33,18,15,16866,14055,30921
316320,201702,46,26,20,24362,18740,43102
316330,201702,118,74,44,68120.25,40946.9,109067.15
316340,201702,137,97,40,90889,37480,128369
316350,201702,189,134,55,125231,51535,176766
316360,201702,24,19,5,17803,4685,22488
316370,201702,1012,542,470,503376.15,440380.63,943756.78
316380,201702,115,88,27,82456,25299,107755
316390,201702,121,85,36,79645,33732,113377
316400,201702,153,116,37,108692,34669,143361
316410,201702,305,224,81,208529.35,75897,284426.35
316420,201702,184,129,55,120170.25,51535,171705.25
316430,201702,150,75,75,70275,70275,140550
316440,201702,97,48,49,44976,45913,90889
316443,201702,55,49,6,45257.1,5622,50879.1
316447,201702,63,52,11,48724,10307,59031
316450,201702,202,157,45,146828,42165,188993
316460,201702,62,27,35,25299,32795,58094
316470,201702,1523,1097,426,1023095.15,396984.79,1420079.94
316480,201702,10,9,1,8433,937,9370
316490,201702,15,5,10,4685,9370,14055
316500,201702,152,101,51,94355.9,47787,142142.9
316510,201702,173,126,47,116797.15,44039,160836.15
316520,201702,192,120,72,111877.8,67464,179341.8
316530,201702,149,105,44,98385,40947,139332
316540,201702,134,72,62,66527,58094,124621
316550,201702,141,98,43,91605.67,40250.89,131856.56
316553,201702,203,104,99,97120.05,92763,189883.05
316555,201702,75,54,21,50598,19677,70275
316556,201702,12,8,4,7496,3748,11244
316557,201702,15,14,1,13118,937,14055
316560,201702,55,44,11,41228,10307,51535
316570,201702,249,225,24,210591,22488,233079
316580,201702,23,15,8,14055,7496,21551
316590,201702,131,112,19,104944,17522,122466
316600,201702,185,149,36,139332,33732,173064
316610,201702,64,42,22,39354,20614,59968
316620,201702,127,98,29,91826,27173,118999
316630,201702,49,37,12,34669,11244,45913
316640,201702,16,10,6,9370,5622,14992
316650,201702,63,47,16,44039,14992,59031
316660,201702,5,3,2,2811,1874,4685
316670,201702,433,147,286,137721,267420,405141
316680,201702,162,110,52,103070,48537,151607
316690,201702,192,117,75,109629,70275,179904
316695,201702,53,48,5,44976,4685,49661
316700,201702,12,6,6,5622,5622,11244
316710,201702,691,496,195,464236.9,182715,646951.9
316720,201702,4728,2404,2324,2238055.35,2173907.02,4411962.37
316730,201702,15,13,2,12181,1874,14055
316740,201702,136,80,56,74960,52472,127432
316750,201702,18,12,6,11244,5622,16866
316760,201702,323,257,66,240809,61842,302651
316770,201702,136,78,58,73086,54346,127432
316780,201702,73,38,35,35307,32795,68102
316790,201702,53,40,13,37480,12181,49661
316800,201702,1575,972,603,907391,564162,1471553
316805,201702,19,10,9,9370,8433,17803
316810,201702,66,41,25,38417,23425,61842
316820,201702,41,20,21,18740,19677,38417
316830,201702,87,39,48,36543,44695,81238
316840,201702,538,317,221,295998.4,205203,501201.4
316850,201702,336,216,120,201033.35,112440,313473.35
316860,201702,5885,2563,3322,2388917.79,3108067.63,5496985.42
316870,201702,1346,861,485,798825.85,450090.55,1248916.40
316880,201702,101,59,42,54627.9,39354,93981.9
316890,201702,248,167,81,156479,75897,232376
316900,201702,413,284,129,263607.84,120873,384480.84
316905,201702,40,26,14,24362,13118,37480
316910,201702,54,26,28,24362,26236,50598
316920,201702,123,98,25,91124,23425,114549
316930,201702,1906,938,968,873426.15,904861.85,1778288.00
316935,201702,864,518,346,483492.66,322702.8,806195.46
316940,201702,1059,606,453,566885.7,423889.53,990775.23
316950,201702,181,93,88,87141,82456,169597
316960,201702,1072,589,483,550300.9,452271.26,1002572.16
316970,201702,591,458,133,429146,124621,553767
316980,201702,115,72,43,67464,40281.63,107745.63
316990,201702,2119,1388,731,1293951.33,684001.63,1977952.96
317000,201702,311,241,70,225536,65590,291126
317005,201702,242,174,68,163038,63716,226754
317010,201702,6081,3300,2781,3078918.83,2603913.83,5682832.66
317020,201702,15737,6873,8864,6407622.07,8291166.86,14698788.93
317030,201702,83,30,53,28110,49661,77771
317040,201702,3093,1898,1195,1776178.1,1117373.6,2893551.7
317043,201702,69,48,21,44976,19677,64653
317047,201702,34,16,18,14992,16862,31854
317050,201702,188,141,47,132117,44039,176156
317052,201702,115,90,25,84330,23425,107755
317057,201702,188,146,42,136802,38792,175594
317060,201702,54,33,21,30921,19395.9,50316.9
317065,201702,58,48,10,44976,9370,54346
317070,201702,1952,914,1038,850609.85,971107,1821716.85
317075,201702,110,57,53,53409,49661,103070
317080,201702,781,427,354,399022,331511,730533
317090,201702,587,474,113,443716.35,105881,549597.35
317100,201702,393,294,99,272724.6,92763,365487.6
317103,201702,93,79,14,74023,13118,87141
317107,201702,33,31,2,29047,1874,30921
317110,201702,105,47,58,44039,54346,98385
317115,201702,49,42,7,39354,6559,45913
317120,201702,1744,881,863,817754.35,808182,1625936.35
317130,201702,1805,1141,664,1065283.3,621513,1686796.3
317140,201702,16,14,2,13118,1874,14992
317150,201702,261,160,101,149920,93887.4,243807.4
317160,201702,311,222,89,207733,83393,291126
317170,201702,198,145,53,135865,49661,185526
317180,201702,398,292,106,272901.25,99322,372223.25
317190,201702,251,169,82,158353,76834,235187
317200,201702,768,551,217,503180,203329,706509
317210,201702,150,85,65,78708.6,60905,139613.6
317220,201702,21,12,9,11244,8433,19677
320010,201702,598,448,150,416684.8,140550,557234.8
320013,201702,128,91,37,85267,34669,119936
320016,201702,279,174,105,163038,98385,261423
320020,201702,676,400,276,371254.37,256017.97,627272.34
320030,201702,145,108,37,101196,34341.05,135537.05
320035,201702,129,94,35,88078,32795,120873
320040,201702,486,265,221,247180.8,207077,454257.8
320050,201702,97,74,23,69338,21551,90889
320060,201702,1422,621,801,581831,749872.3,1331703.3
320070,201702,95,67,28,62779,26236,89015
320080,201702,741,420,321,391508.1,300495.9,692004.0
320090,201702,1186,823,363,767725.4,339287.8,1107013.2
320100,201702,310,181,129,167451.01,120232.23,287683.24
320110,201702,132,86,46,78896.1,43102,121998.1
320115,201702,106,85,21,79645,19677,99322
320120,201702,3170,1761,1409,1639846.55,1318625.96,2958472.51
320130,201702,6933,3355,3578,3122696.95,3344846.9,6467543.85
320140,201702,422,271,151,252615.2,141247,393862.2
320150,201702,1758,1027,731,956500.05,684797.08,1641297.13
320160,201702,672,289,383,269566.22,358755.96,628322.18
320170,201702,114,86,28,79833,26236,106069
320180,201702,46,26,20,24362,18740,43102
320190,201702,235,165,70,153846.03,65309,219155.03
320200,201702,53,38,15,35606,14055,49661
320210,201702,834,467,367,435967.49,342691,778658.49
320220,201702,291,112,179,104007.86,167442,271449.86
320225,201702,75,60,15,56220,13259,69479
320230,201702,512,331,181,308835.2,168801,477636.2
320240,201702,2995,1527,1468,1429175.1,1373634.1,2802809.2
320245,201702,414,286,128,267513.6,119936,387449.6
320250,201702,206,107,99,99322,92763,192085
320255,201702,142,114,28,105534.31,26096,131630.31
320260,201702,163,118,45,110566,42118.15,152684.15
320265,201702,158,125,33,116329,30921,147250
320270,201702,151,120,31,112440,29047,141487
320280,201702,894,544,350,505025.26,326572.81,831598.07
320290,201702,63,53,10,49661,9370,59031
320300,201702,494,353,141,329328.65,130872.55,460201.20
320305,201702,614,326,288,305462,269856,575318
320310,201702,199,115,84,107474,77966,185440
320313,201702,274,142,132,133054,123403,256457
320316,201702,112,93,19,87141,17803,104944
320320,201702,3194,1402,1792,1310292.8,1676824.5,2987117.3
320330,201702,258,189,69,176443.9,62779.81,239223.71
320332,201702,844,508,336,474005,313681.15,787686.15
320334,201702,236,145,91,135584,85267,220851
320335,201702,146,106,40,98150.95,37480,135630.95
320340,201702,582,397,185,370865,172690,543555
320350,201702,931,391,540,365149,505444.44,870593.44
320360,201702,157,82,75,76553,70275,146828
320370,201702,236,178,58,165230,53331,218561
320380,201702,278,187,91,174469.4,85267,259736.4
320390,201702,1048,641,407,600617,379233.56,979850.56
320400,201702,319,224,95,208014.6,88734,296748.6
320405,201702,820,334,486,312733.34,455209.15,767942.49
320410,201702,909,468,441,436675.21,412760.51,849435.72
320420,201702,468,243,225,227223.2,210825,438048.2
320425,201702,184,104,80,97448,74960,172408
320430,201702,376,212,164,197800.95,153668,351468.95
320435,201702,166,108,58,100390.18,54346,154736.18
320440,201702,188,119,69,111221.9,64653,175874.9
320450,201702,123,70,53,65590,49661,115251
320455,201702,236,186,50,173346,46832,220178
320460,201702,236,152,84,142424,78708,221132
320465,201702,114,78,36,72729.94,33732,106461.94
320470,201702,589,381,208,356698.54,194888,551586.54
320480,201702,158,104,54,97448,50598,148046
320490,201702,2836,1408,1428,1315736.21,1336109.72,2651845.93
320495,201702,90,56,34,52454,31858,84312
320500,201702,9078,4627,4451,4306330.82,4160336.91,8466667.73
320501,201702,491,248,243,232376,227682,460058
320503,201702,263,187,76,174282.6,71212,245494.6
320506,201702,234,183,51,171471,47787,219258
320510,201702,870,420,450,390285.65,420693.05,810978.70
320515,201702,74,60,14,55283.45,13118,68401.45
320517,201702,186,132,54,123684,50598,174282
320520,201702,6382,2839,3543,2647980.05,3314183.93,5962163.98
320530,201702,5011,2527,2484,2359875.54,2323660.03,4683535.57
330010,201702,2760,1409,1351,1310778.32,1263714.66,2574492.98
330015,201702,155,61,94,56220.14,88078,144298.14
330020,201702,3370,1460,1910,1363342.96,1788546,3151888.96
330022,201702,203,115,88,107755,81520,189275
330023,201702,491,165,326,153434.4,305462,458896.4
330025,201702,511,119,392,111503,367022.9,478525.9
330030,201702,1773,1113,660,1035716.43,615330.36,1651046.79
330040,201702,2036,1020,1016,953680.2,950774,1904454.2
330045,201702,8187,2508,5679,2340819.29,5316316.66,7657135.95
330050,201702,757,479,278,448823,260486,709309
330060,201702,815,534,281,496330.45,263297,759627.45
330070,201702,3214,1252,1962,1168703.09,1836925.63,3005628.72
330080,201702,1409,681,728,633872.75,681199.3,1315072.05
330090,201702,348,201,147,188337,137739,326076
330093,201702,275,122,153,114314,143352,257666
330095,201702,98,48,50,44976,46850,91826
330100,201702,8836,4630,4206,4330676.17,3937180.4,8267856.57
330110,201702,469,208,261,193256.8,244557,437813.8
330115,201702,501,290,211,271730,197707,469437
330120,201702,349,181,168,168472.6,156947.5,325420.1
330130,201702,1340,429,911,401260.88,853580,1254840.88
330140,201702,592,304,288,284830,268920,553750
330150,201702,429,256,173,237998.07,161164,399162.07
330160,201702,206,128,78,119936,73086,193022
330170,201702,25265,8857,16408,8280533.12,15358157.79,23638690.91
330180,201702,230,150,80,136175.75,74257.25,210433.00
330185,201702,714,310,404,288962.1,378530,667492.1
330187,201702,243,85,158,79645,148046,227691
330190,201702,5456,2158,3298,2013356.25,3086241.98,5099598.23
330200,201702,4093,1424,2669,1331431.7,2496257.28,3827688.98
330205,201702,393,243,150,227691,140550,368241
330210,201702,923,562,361,522567.8,336570.95,859138.75
330220,201702,2308,1360,948,1271510.1,887339.1,2158849.2
330225,201702,522,290,232,271103,217384,488487
330227,201702,2307,817,1490,762427.63,1395845.32,2158272.95
330230,201702,194,113,81,105226,75897,181123
330240,201702,3347,1736,1611,1622600.04,1507411.72,3130011.76
330245,201702,140,56,84,52472,77958.4,130430.4
330250,201702,6106,3166,2940,2957101.1,2749049.26,5706150.36
330260,201702,517,154,363,144298,340131,484429
330270,201702,3125,1168,1957,1093292.5,1833336,2926628.5
330280,201702,441,291,150,269599.34,140541,410140.34
330285,201702,6728,2276,4452,2127805.4,4168478.2,6296283.6
330290,201702,566,222,344,207078,322047,529125
330300,201702,706,489,217,454445.85,203320,657765.85
330310,201702,405,241,164,223943.35,153668,377611.35
330320,201702,7293,2738,4555,2557638.7,4263379.6,6821018.3
330330,201702,9319,3570,5749,3341281.85,5382495.61,8723777.46
330340,201702,2557,1539,1018,1440145.53,953847.26,2393992.79
330350,201702,16938,6686,10252,6239312.36,9587227.48,15826539.84
330360,201702,2603,1288,1315,1205713.7,1232155,2437868.7
330370,201702,961,519,442,485553.4,412468.4,898021.8
330380,201702,810,346,464,323469.77,434299.9,757769.67
330385,201702,603,318,285,297030,267045,564075
330390,201702,4972,2730,2242,2546659.69,2099067.92,4645727.61
330395,201702,216,137,79,126683.05,71540.5,198223.55
330400,201702,620,317,303,293937.4,281619.54,575556.94
330410,201702,487,348,139,324428.63,130243,454671.63
330411,201702,225,130,95,121810,89015,210825
330412,201702,247,107,140,99978,131180,231158
330414,201702,6189,2541,3648,2377396.4,3414786.75,5792183.15
330415,201702,528,244,284,228628,265171.4,493799.4
330420,201702,2237,1180,1057,1102268.67,988255.3,2090523.97
330430,201702,1738,707,1031,661701.1,964361,1626062.1
330440,201702,235,102,133,95574,124621,220195
330450,201702,129,53,76,48724,71212,119936
330452,201702,1572,698,874,652368.28,818928.63,1471296.91
330455,201702,106618,37764,68854,35312886.88,64458577.1,99771463.98
330460,201702,262,108,154,101196,144298,245494
330470,201702,1209,662,547,614096.38,512529.63,1126626.01
330475,201702,1363,378,985,351563.7,922373.43,1273937.13
330480,201702,710,379,331,355123,309211,664334
330490,201702,12912,4617,8295,4319363.84,7765551.5,12084915.34
330500,201702,1294,599,695,561263,650841,1212104
330510,201702,10889,3428,7461,3207286.96,6984443.41,10191730.37
330513,201702,103,52,51,48724,47787,96511
330515,201702,838,346,492,322329.4,460723,783052.4
330520,201702,2263,877,1386,821534,1297651.3,2119185.3
330530,201702,229,120,109,112440,101946,214386
330540,201702,354,176,178,164912,166318,331230
330550,201702,3055,1082,1973,1013319,1847509.95,2860828.95
330555,201702,689,250,439,234250,410969,645219
330560,201702,506,194,312,181778,292335,474113
330570,201702,238,161,77,150857,72149,223006
330575,201702,718,331,387,309913,360599.75,670512.75
330580,201702,3254,1833,1421,1712645.5,1330259.1,3042904.6
330590,201702,287,154,133,144298,124621,268919
330600,201702,1001,647,354,605077.62,330948.4,936026.02
330610,201702,1462,807,655,750052.61,609708.45,1359761.06
330615,201702,178,139,39,130243,36543,166786
330620,201702,853,415,438,384360.06,407968.3,792328.36
330630,201702,3439,2138,1301,1989355.53,1210475.58,3199831.11
350010,201702,610,397,213,370584,199581,570165
350020,201702,37,18,19,16866,17803,34669
350030,201702,506,329,177,307149,164680.66,471829.66
350040,201702,130,50,80,46512.68,74679,121191.68
350050,201702,294,158,136,147764.9,127179.63,274944.53
350055,201702,84,47,37,44039,34669,78708
350060,201702,76,26,50,24362,46850,71212
350070,201702,774,444,330,411675.99,307448.68,719124.67
350075,201702,65,42,23,39354,21551,60905
350080,201702,48,27,21,24674.3,18740,43414.3
350090,201702,99,58,41,54346,38412.32,92758.32
350100,201702,300,186,114,174282,106818,281100
350110,201702,66,39,27,36543,25299,61842
350115,201702,151,88,63,81800.1,59031,140831.1
350120,201702,111,74,37,69338,34669,104007
350130,201702,351,167,184,155917,172408,328325
350140,201702,34,21,13,18178.4,12181,30359.4
350150,201702,65,51,14,47787,13118,60905
350160,201702,2422,914,1508,853122.67,1412258.26,2265380.93
350170,201702,392,238,154,220851.25,144017,364868.25
350180,201702,175,91,84,84986,78708,163694
350190,201702,843,400,443,372832.84,414514.85,787347.69
350200,201702,73,27,46,25097.46,42841.8,67939.26
350210,201702,1345,747,598,690974.96,559567.03,1250541.99
350220,201702,664,569,95,529095.75,89015,618110.75
350230,201702,73,53,20,49661,18740,68401
350240,201702,62,47,15,44039,14055,58094
350250,201702,1165,581,584,537700.55,546683.93,1084384.48
350260,201702,93,67,26,62779,24362,87141
350270,201702,811,541,270,505659.03,251265.65,756924.68
350275,201702,290,114,176,106444,164912,271356
350280,201702,4564,2330,2234,2171664.88,2091134.48,4262799.36
350290,201702,390,183,207,171190,192459.9,363649.9
350300,201702,48,23,25,21551,23425,44976
350310,201702,101,72,29,67464,27173,94637
350315,201702,37,20,17,18740,15929,34669
350320,201702,3196,1560,1636,1458208.35,1532698.52,2990906.87
350330,201702,1634,862,772,805463,722363.7,1527826.7
350335,201702,20,13,7,12181,6559,18740
350340,201702,135,74,61,69338,57157,126495
350350,201702,94,45,49,42165,45913,88078
350360,201702,128,84,44,78704,40947,119651
350370,201702,94,55,39,50910.3,36533.63,87443.93
350380,201702,718,299,419,279507.1,392321.9,671829.0
350390,201702,1351,556,795,520188.25,743509.6,1263697.85
350395,201702,26,18,8,16866,7496,24362
350400,201702,1662,878,784,812034.63,732056.26,1544090.89
350410,201702,2189,969,1220,905200.88,1142830.9,2048031.78
350420,201702,239,143,96,132662.54,89952,222614.54
350430,201702,74,42,32,38792,29984,68776
350440,201702,150,107,43,99275.25,40291,139566.25
350450,201702,1608,1041,567,968324.9,531186,1499510.9
350460,201702,320,114,206,106818,192740.9,299558.9
350470,201702,13,10,3,9370,2811,12181
350480,201702,152,82,70,76834,65590,142424
350490,201702,245,115,130,107755,121810,229565
350500,201702,34,16,18,14992,16866,31858
350510,201702,160,107,53,100259,49661,149920
350520,201702,436,192,244,177406,228003.3,405409.3
350530,201702,443,213,230,199581,215510,415091
350535,201702,56,44,12,40854,11244,52098
350540,201702,378,194,184,180905.47,172127,353032.47
350550,201702,2704,1584,1120,1477607.45,1048444.19,2526051.64
350560,201702,624,429,195,401968.32,182359.65,584327.97
350570,201702,4289,1769,2520,1653040.06,2359714.1,4012754.16
350580,201702,370,178,192,166786,179609.53,346395.53
350590,201702,896,484,412,453508,385107.3,838615.3
350600,201702,6020,3024,2996,2821677.31,2802272.5,5623949.81
350610,201702,1538,759,779,706096.7,728696,1434792.7
350620,201702,39,27,12,25299,11244,36543
350630,201702,234,138,96,128369.3,89016,217385.3
350635,201702,804,306,498,286441,465990.54,752431.54
350640,201702,117,86,31,80582,29047,109629
350650,201702,1838,1220,618,1139524.45,578058.1,1717582.55
350660,201702,736,334,402,312958,375737,688695
350670,201702,317,159,158,148749,148046,296795
350680,201702,178,99,79,92763,73742,166505
350690,201702,200,99,101,92763,94637,187400
350700,201702,648,314,334,291225.09,312958,604183.09
350710,201702,305,126,179,116875.1,167723,284598.1
350715,201702,44,39,5,36543,4685,41228
350720,201702,18,14,4,13118,3748,16866
350730,201702,38,24,14,22488,13118,35606
350740,201702,189,106,83,99040.9,77771,176811.9
350745,201702,22,11,11,10283,10307,20590
350750,201702,2064,1350,714,1257315.05,667456.3,1924771.35
350760,201702,3597,1572,2025,1472027.3,1896469.63,3368496.93
350770,201702,60,40,20,37480,18740,56220
350775,201702,47,34,13,31858,12172,44030
350780,201702,404,202,202,189274,189274,378548
350790,201702,385,169,216,158353,202392,360745
350800,201702,415,230,185,215510,173345,388855
350810,201702,480,384,96,357935.3,89952,447887.3
350820,201702,78,50,28,46850,26236,73086
350830,201702,81,48,33,44976,30921,75897
350840,201702,722,328,394,307055,368241,675296
350850,201702,1657,962,695,895454.26,650874,1546328.26
350860,201702,525,305,220,283894.16,206140,490034.16
350870,201702,414,280,134,262360,125183.9,387543.9
350880,201702,285,157,128,144300.55,119936,264236.55
350890,201702,42,26,16,24362,14992,39354
350900,201702,1346,444,902,414078.19,844424.4,1258502.59
350910,201702,26,18,8,16866,7496,24362
350920,201702,567,316,251,295779.7,235187,530966.7
350925,201702,1161,623,538,579898.77,502700.7,1082599.47
350930,201702,93,58,35,54346,32795,87141
350940,201702,675,366,309,341442.8,287724.8,629167.6
350945,201702,100,78,22,73086,20614,93700
350950,201702,14442,6887,7555,6424553.01,7067269.74,13491822.75
350960,201702,1267,570,697,529774.9,653085,1182859.9
350970,201702,1098,621,477,579650.3,446658.63,1026308.93
350980,201702,102,68,34,63716,31858,95574
350990,201702,355,124,231,115504,216165.9,331669.9
350995,201702,27,13,14,12181,13118,25299
351000,201702,625,453,172,422276.26,161164,583440.26
351010,201702,53,28,25,26236,23425,49661
351015,201702,63,44,19,41228,17803,59031
351020,201702,1648,927,721,866923.64,673516.2,1540439.84
351030,201702,313,221,92,204547.4,86204,290751.4
351040,201702,802,434,368,405721,343879.15,749600.15
351050,201702,3123,1510,1613,1408248.14,1509247.91,2917496.05
351060,201702,4737,1935,2802,1804470.95,2622338.01,4426808.96
351070,201702,414,265,149,247403,139613,387016
351080,201702,792,561,231,525657,215510,741167
351090,201702,64,29,35,27173,32795,59968
351100,201702,446,255,191,236752.35,178953.32,415705.67
351110,201702,2125,1030,1095,959081.36,1023509.63,1982590.99
351120,201702,73,39,34,36459.6,31858,68317.6
351130,201702,170,55,115,51535,107755,159290
351140,201702,335,235,100,218415.5,93700,312115.5
351150,201702,382,194,188,180935,175875,356810
351160,201702,235,152,83,142424,77771,220195
351170,201702,173,84,89,78708,82644,161352
351190,201702,85,59,26,55283,24362,79645
351200,201702,371,242,129,226473,120873,347346
351210,201702,128,59,69,55283,64653,119936
351220,201702,515,312,203,289314.81,190211,479525.81
351230,201702,281,203,78,189305.3,73067.26,262372.56
351240,201702,228,94,134,88078,125558,213636
351250,201702,65,45,20,42165,18740,60905
351260,201702,150,109,41,102133,38417,140550
351270,201702,51,22,29,20614,27173,47787
351280,201702,1101,507,594,471313.35,556063.39,1027376.74
351290,201702,217,96,121,89952,113096,203048
351300,201702,3766,1769,1997,1650763.13,1870877,3521640.13
351310,201702,738,389,349,362573,327013,689586
351320,201702,101,60,41,56220,38417,94637
351330,201702,37,25,12,23425,11244,34669
351340,201702,1178,737,441,683850.39,412264,1096114.39
351350,201702,2245,1189,1056,1113438,988905.22,2102343.22
351360,201702,762,381,381,355123,355883.19,711006.19
351370,201702,362,189,173,177088.32,161476.3,338564.62
351380,201702,8914,4105,4809,3831264.5,4497025.64,8328290.14
351385,201702,28,19,9,17803,8433,26236
351390,201702,267,193,74,180111.26,69338,249449.26
351400,201702,61,37,24,34669,22442.63,57111.63
351410,201702,407,250,157,233781.5,147109,380890.5
351420,201702,61,50,11,46850,10307,57157
351430,201702,83,46,37,43102,34669,77771
351440,201702,784,532,252,496326.2,236120,732446.2
351450,201702,244,124,120,116188,112440,228628
351460,201702,121,53,68,49661,63716,113377
351470,201702,144,77,67,72140,62779,134919
351480,201702,526,283,243,264234.1,227573.88,491807.98
351490,201702,294,101,193,94637,180841,275478
351492,201702,32,23,9,21551,8433,29984
351495,201702,31,19,12,17803,11244,29047
351500,201702,3482,1485,1997,1385788.85,1866646.1,3252434.95
351510,201702,1748,719,1029,673421.9,962008.54,1635430.44
351512,201702,19,15,4,14055,3748,17803
351515,201702,192,108,84,101196,78708,179904
351518,201702,702,425,277,397284,259408.45,656692.45
351519,201702,76,49,27,45913,25299,71212
351520,201702,136,84,52,78708,48724,127432
351530,201702,18,14,4,13118,3748,16866
351535,201702,132,74,58,69338,54346,123684
351540,201702,417,299,118,277823,110566,388389
351550,201702,1242,762,480,706970.1,449750.63,1156720.73
351560,201702,73,37,36,34669,33732,68401
351565,201702,12,7,5,6559,4685,11244
351570,201702,2515,1316,1199,1231579.63,1122816.26,2354395.89
351580,201702,34,29,5,27173,4685,31858
351590,201702,66,47,19,44039,17803,61842
351600,201702,189,137,52,128369,48724,177093
351610,201702,61,27,34,25299,31858,57157
351620,201702,5953,3403,2550,3178607.76,2384495.73,5563103.49
351630,201702,2418,1242,1176,1158815.69,1100314.42,2259130.11
351640,201702,1633,779,854,728301.99,798418.3,1526720.29
351650,201702,31,27,4,25299,3748,29047
351660,201702,161,97,64,90889,59968,150857
351670,201702,707,439,268,408579.9,251116,659695.9
351680,201702,78,62,16,58094,14992,73086
351685,201702,39,25,14,23425,13118,36543
351690,201702,315,221,94,204964.07,88078,293042.07
351700,201702,160,111,49,104007,45913,149920
351710,201702,70,49,21,45913,19677,65590
351720,201702,136,65,71,60905,66527,127432
351730,201702,91,64,27,59968,25294.32,85262.32
351740,201702,709,471,238,441046,223001.32,664047.32
351750,201702,350,145,205,134928.7,191835,326763.7
351760,201702,786,603,183,565011,171471,736482
351770,201702,280,244,36,227692,33732,261424
351780,201702,169,90,79,84330,74023,158353
351790,201702,241,126,115,118062,107755,225817
351800,201702,51,32,19,29984,17803,47787
351810,201702,119,76,43,70931,40291,111222
351820,201702,880,633,247,588836.9,231434.32,820271.22
351830,201702,499,186,313,173532.4,293281,466813.4
351840,201702,1786,922,864,854426.75,807826.47,1662253.22
351850,201702,221,168,53,156526.8,49661,206187.8
351860,201702,741,483,258,448543.77,241741.32,690285.09
351870,201702,5535,2619,2916,2445273.62,2726347.45,5171621.07
351880,201702,18712,8257,10455,7714173.75,9782155.42,17496329.17
351885,201702,97,64,33,59968,30921,90889
351890,201702,74,63,11,59031,10307,69338
351900,201702,220,133,87,123966,81519,205485
351905,201702,74,32,42,29984,39354,69338
351907,201702,3012,1328,1684,1240893.23,1576864.22,2817757.45
351910,201702,176,72,104,67464,97448,164912
351920,201702,142,84,58,78708,54323.96,133031.96
351925,201702,80,55,25,51535,23425,74960
351930,201702,378,257,121,240715.3,113377,354092.3
351940,201702,228,104,124,97448,116188,213636
351950,201702,140,78,62,72774,58094,130868
351960,201702,793,368,425,344484.58,396444.8,740929.38
351970,201702,1864,977,887,913341.04,830548,1743889.04
351980,201702,136,69,67,62779,62779,125558
351990,201702,285,191,94,178030,87290.92,265320.92
352000,201702,342,201,141,187962.2,132117,320079.2
352010,201702,334,193,141,180841,132117,312958
352020,201702,193,71,122,66527,114314,180841
352030,201702,973,494,479,461894.25,446980.2,908874.45
352040,201702,566,244,322,228628,301714,530342
352042,201702,251,89,162,83393,151513,234906
352044,201702,372,221,151,206515,141487,348002
352050,201702,3075,1256,1819,1170708.8,1703324.53,2874033.33
352060,201702,99,63,36,59031,33732,92763
352070,201702,94,68,26,62780,24362,87142
352080,201702,64,38,26,34669,24362,59031
352090,201702,169,116,53,108692,49661,158353
352100,201702,250,123,127,115251,117867,233118
352110,201702,109,33,76,30921,71212,102133
352115,201702,75,30,45,28110,42165,70275
352120,201702,103,61,42,57157,39354,96511
352130,201702,219,183,36,171283.6,33732,205015.6
352140,201702,185,74,111,68870,104007,172877
352150,201702,124,69,55,63716.7,51535,115251.7
352160,201702,129,88,41,82456,38417,120873
352170,201702,370,253,117,236124.7,109629,345753.7
352180,201702,583,401,182,373724.55,170534,544258.55
352190,201702,268,101,167,94627.63,156432.15,251059.78
352200,201702,32,19,13,17803,12181,29984
352210,201702,3538,1462,2076,1364441.8,1939867.97,3304309.77
352215,201702,48,29,19,27112.67,17272.8,44385.47
352220,201702,6947,2743,4204,2565012.23,3936699.72,6501711.95
352230,201702,3053,1952,1101,1816089.72,1026207.64,2842297.36
352240,201702,2097,1244,853,1163614.69,797106.25,1960720.94
352250,201702,2516,1331,1185,1243041.35,1108333.7,2351375.05
352260,201702,1118,637,481,595642.32,450416,1046058.32
352265,201702,67,31,36,29047,33732,62779
352270,201702,381,217,164,202392.84,153613,356005.84
352280,201702,372,232,140,217072,130894.32,347966.32
352290,201702,173,109,64,101571,59968,161539
352300,201702,102,78,24,73086,22488,95574
352310,201702,5497,2711,2786,2529733.43,2605973.27,5135706.70
352320,201702,903,486,417,452790.99,387778.55,840569.54
352330,201702,533,231,302,215088.37,282693,497781.37
352340,201702,1380,672,708,625085.4,662553,1287638.4
352350,201702,309,199,110,186463,102789,289252
352360,201702,225,86,139,79691.85,127693,207384.85
352370,201702,102,70,32,65590,29984,95574
352380,201702,113,70,43,65590,40291,105881
352390,201702,2379,1076,1303,1003837.9,1218569.64,2222407.54
352400,201702,462,195,267,182012.25,249897.9,431910.15
352410,201702,721,520,201,484029.2,188337,672366.2
352420,201702,100,61,39,57157,36543,93700
352430,201702,1732,772,960,716807.55,897743.59,1614551.14
352440,201702,2989,1537,1452,1433417.58,1356745.4,2790162.98
352450,201702,189,159,30,148983,28110,177093
352460,201702,559,284,275,265841.64,256973.1,522814.74
352470,201702,550,189,361,177093,338248,515341
352480,201702,1364,762,602,713370,563511.9,1276881.9
352490,201702,81,33,48,30921,44976,75897
352500,201702,1215,541,674,504856.8,630124,1134980.8
352510,201702,729,389,340,363556.3,318580,682136.3
352520,201702,504,215,289,201455,270652.45,472107.45
352530,201702,1683,873,810,817064,757658.3,1574722.3
352540,201702,77,50,27,46850,25299,72149
352550,201702,183,105,78,98385,72676.53,171061.53
352560,201702,52,41,11,38417,10307,48724
352570,201702,635,333,302,311418.63,282974,594392.63
352580,201702,58,40,18,36543.33,16866,53409.33
352585,201702,14,5,9,4685,8433,13118
352590,201702,4160,2080,2080,1944618.6,1948084.48,3892703.08
352600,201702,352,244,108,227691.3,101187,328878.3
352610,201702,909,430,479,400223.51,448823,849046.51
352620,201702,968,383,585,357934.1,548145,906079.1
352630,201702,212,75,137,70275,127937.98,198212.98
352640,201702,532,366,166,341590.88,155542,497132.88
352650,201702,92,63,29,59031,27173,86204
352660,201702,83,51,32,47787,29984,77771
352670,201702,1607,874,733,815525.93,685779.16,1501305.09
352680,201702,895,571,324,531804.58,302339.2,834143.78
352690,201702,4220,1947,2273,1815404.9,2126191.27,3941596.17
352700,201702,116,65,51,60905,47787,108692
352710,201702,1267,663,604,619357.35,563699.6,1183056.95
352720,201702,1177,588,589,548458.1,551888.32,1100346.42
352725,201702,26,25,1,23425,937,24362
352730,201702,349,171,178,159069.81,166224,325293.81
352740,201702,406,253,153,236124.14,143361,379485.14
352750,201702,24,16,8,14710.9,7496,22206.9
352760,201702,189,135,54,126495,50598,177093
352770,201702,84,67,17,61789,15929,77718
352780,201702,88,47,41,44039,38417,82456
352790,201702,22,18,4,16866,3748,20614
352800,201702,245,166,79,155542,73741.9,229283.9
352810,201702,155,102,53,95293,49661,144954
352820,201702,58,49,9,45495.1,8433,53928.1
352830,201702,88,62,26,58094,24362,82456
352840,201702,546,283,263,263907.1,246150,510057.1
352850,201702,1287,463,824,433175.1,771686,1204861.1
352860,201702,122,80,42,74960,39354,114314
352870,201702,36,22,14,20614,13118,33732
352880,201702,192,135,57,126495,53409,179904
352885,201702,28,19,9,17803,8433,26236
352890,201702,53,36,17,33732,15929,49661
352900,201702,4930,2361,2569,2196288.18,2401467.91,4597756.09
352910,201702,40,30,10,28110,9370,37480
352920,201702,706,434,272,405721,254864,660585
352930,201702,1245,593,652,553970.22,607394.04,1161364.26
352940,201702,6257,2709,3548,2526360.07,3320027.28,5846387.35
352950,201702,92,38,54,35324.9,50598,85922.9
352960,201702,63,40,23,37480,21551,59031
352965,201702,22,9,13,8433,12181,20614
352970,201702,456,333,123,308871.14,114314.7,423185.84
352980,201702,181,89,92,83393,86204,169597
352990,201702,873,411,462,382422.14,431142.79,813564.93
353000,201702,68,31,37,29047,34669,63716
353010,201702,557,338,219,316706,205184.27,521890.27
353020,201702,296,212,84,198644,78708,277352
353030,201702,1113,518,595,484401.1,556575.73,1040976.83
353040,201702,85,53,32,49661,29984,79645
353050,201702,1269,780,489,725583.55,458193,1183776.55
353060,201702,7224,3434,3790,3204673.6,3543948.25,6748621.85
353070,201702,1587,977,610,909615,570303.04,1479918.04
353080,201702,1286,662,624,618934.72,583842.32,1202777.04
353090,201702,59,37,22,34669,20614,55283
353100,201702,63,52,11,48724,10307,59031
353110,201702,1765,588,1177,549251.63,1101154.32,1650405.95
353120,201702,65,33,32,30921,29984,60905
353130,201702,846,415,431,387899.63,403818.89,791718.52
353140,201702,587,227,360,212376,337320,549696
353150,201702,358,198,160,184589.3,149910.63,334499.93
353160,201702,101,82,19,76834,17803,94637
353170,201702,199,65,134,60895.63,125530.63,186426.26
353180,201702,940,435,505,406362.95,472670,879032.95
353190,201702,447,317,130,295990.95,121810,417800.95
353200,201702,181,88,93,82175,87141,169316
353205,201702,26,18,8,16866,7496,24362
353210,201702,82,50,32,46850,29984,76834
353215,201702,58,35,23,32795,21551,54346
353220,201702,78,43,35,40291,31858.93,72149.93
353230,201702,158,60,98,56220,91826,148046
353240,201702,264,144,120,134928,112440,247368
353250,201702,198,104,94,97448,88078,185526
353260,201702,406,306,100,285607.25,93690.63,379297.88
353270,201702,68,51,17,47787,15929,63716
353280,201702,91,45,46,42165,43102,85267
353282,201702,104,76,28,71212,26236,97448
353284,201702,23,18,5,16866,4685,21551
353286,201702,1,1,0,937,0,937
353290,201702,81,49,32,45913,29975,75888
353300,201702,379,214,165,199003.55,154605,353608.55
353310,201702,50,45,5,42165,4685,46850
353320,201702,54,36,18,33732,16866,50598
353325,201702,56,36,20,33732,18441,52173
353330,201702,68,51,17,46992,15929,62921
353340,201702,578,186,392,174282,366732.54,541014.54
353350,201702,899,418,481,390860.92,449594,840454.92
353360,201702,110,87,23,81206.7,21270,102476.7
353370,201702,119,72,47,66527.55,44039,110566.55
353380,201702,30,20,10,18736,9370,28106
353390,201702,1018,503,515,471311,482555,953866
353400,201702,45,26,19,24362,17803,42165
353410,201702,121,74,47,67876.28,43337.1,111213.38
353420,201702,53,23,30,21551,28110,49661
353430,201702,532,343,189,317923.48,176661.9,494585.38
353440,201702,10247,4463,5784,4171950.33,5412836.53,9584786.86
353450,201702,57,28,29,26236,27173,53409
353460,201702,597,312,285,288197.99,265397.25,553595.24
353470,201702,2110,1140,970,1063080.26,907450.82,1970531.08
353475,201702,230,155,75,142596.3,70275,212871.3
353480,201702,192,154,38,144298,35606,179904
353490,201702,222,132,90,123684,84330,208014
353500,201702,182,110,72,101852.3,67464,169316.3
353510,201702,104,76,28,71193.63,26226.63,97420.26
353520,201702,207,144,63,134928,59031,193959
353530,201702,434,235,199,219290,186463,405753
353540,201702,347,229,118,214256.02,110566,324822.02
353550,201702,712,482,230,448542.85,215510,664052.85
353560,201702,621,258,363,240809.6,340108.32,580917.92
353570,201702,60,31,29,29047,27173,56220
353580,201702,360,279,81,260955,75897,336852
353590,201702,80,55,25,51535,23425,74960
353600,201702,258,150,108,140226,101196,241422
353610,201702,113,60,53,56220,49661,105881
353620,201702,536,291,245,271371.25,229283.9,500655.15
353625,201702,52,24,28,22488,26236,48724
353630,201702,234,168,66,153163.07,61842,215005.07
353640,201702,121,82,39,75897.5,36543,112440.5
353650,201702,791,314,477,292625.1,446949,739574.1
353657,201702,20,14,6,13118,5622,18740
353660,201702,255,144,111,134928,103725.9,238653.9
353670,201702,675,401,274,374800,256738,631538
353680,201702,101,73,28,68401,26236,94637
353690,201702,44,35,9,32795,8433,41228
353700,201702,289,204,85,191148,79645,270793
353710,201702,401,188,213,175219.4,199581,374800.4
353715,201702,45,37,8,34387.9,7496,41883.9
353720,201702,364,161,203,150839,190182,341021
353730,201702,1097,673,424,627212.45,397288,1024500.45
353740,201702,634,362,272,338913,254864,593777
353750,201702,104,64,40,59445.62,37480,96925.62
353760,201702,2540,950,1590,886847.2,1486009.37,2372856.57
353770,201702,101,83,18,77302.5,16866,94168.5
353780,201702,1033,530,503,493931.3,469500.02,963431.32
353790,201702,500,287,213,267635.85,199461,467096.85
353800,201702,3240,1670,1570,1554027.06,1467687.08,3021714.14
353810,201702,234,129,105,120034.75,98358,218392.75
353820,201702,179,89,90,83393,83716.54,167109.54
353830,201702,45,38,7,35606,6559,42165
353850,201702,166,88,78,82456,73086,155542
353860,201702,461,204,257,189789.35,240281.47,430070.82
353870,201702,4843,2406,2437,2242730.3,2274606.48,4517336.78
353880,201702,624,440,184,410828.2,171471.36,582299.56
353890,201702,571,308,263,288034,246431,534465
353900,201702,138,67,71,62779,66527,129306
353910,201702,184,87,97,81519,90889,172408
353920,201702,450,245,205,227738.8,192071.64,419810.44
353930,201702,950,569,381,530341.22,355831.9,886173.12
353940,201702,185,103,82,95761.4,75991,171752.4
353950,201702,523,324,199,303558.63,186463,490021.63
353960,201702,69,55,14,51535,13118,64653
353970,201702,73,46,27,43102,25299,68401
353980,201702,1478,731,747,682340.59,699931,1382271.59
353990,201702,76,45,31,42165,29047,71212
354000,201702,372,172,200,159160.36,187208.6,346368.96
354010,201702,98,49,49,45913,45913,91826
354020,201702,534,331,203,309210,189929.9,499139.9
354025,201702,53,44,9,41228,8433,49661
354030,201702,61,31,30,29047,28110,57157
354040,201702,91,66,25,61842,23425,85267
354050,201702,175,101,74,94356,69338,163694
354060,201702,767,379,388,355123,361683.65,716806.65
354070,201702,851,483,368,450443.52,344816,795259.52
354075,201702,194,105,89,98292,82456.9,180748.9
354080,201702,275,120,155,112440,145235,257675
354085,201702,19,12,7,11244,6559,17803
354090,201702,321,175,146,163896,136802,300698
354100,201702,5358,2199,3159,2051187.37,2955477.55,5006664.92
354105,201702,81,40,41,37480,38417,75897
354110,201702,44,20,24,18740,22488,41228
354120,201702,142,99,43,92626.29,40291,132917.29
354130,201702,668,448,220,419542,205859,625401
354140,201702,3140,1463,1677,1367212.42,1570304.62,2937517.04
354150,201702,609,380,229,354842,213167.5,568009.5
354160,201702,653,399,254,372691.75,237717,610408.75
354165,201702,17,12,5,11244,4685,15929
354170,201702,170,114,56,106162.1,52472,158634.1
354180,201702,68,42,26,39034,24362,63396
354190,201702,202,93,109,85548.1,102133,187681.1
354200,201702,128,70,58,65122,54346,119468
354210,201702,75,38,37,35606,34669,70275
354220,201702,627,399,228,373292.1,212699.18,585991.28
354230,201702,155,64,91,59968,84330.8,144298.8
354240,201702,318,205,113,190867.69,105256.3,296123.99
354250,201702,87,49,38,45913,35606,81519
354260,201702,1838,854,984,788157.46,919754,1707911.46
354270,201702,92,67,25,62779,23425,86204
354280,201702,29,15,14,14055,13118,27173
354290,201702,148,101,47,93372.55,44039,137411.55
354300,201702,418,285,133,266733,124621,391354
354310,201702,99,72,27,66527.1,25299,91826.1
354320,201702,185,95,90,89015,84330,173345
354323,201702,13,11,2,10307,1874,12181
354325,201702,112,60,52,56144.33,48724,104868.33
354330,201702,2448,841,1607,783630.24,1503630.69,2287260.93
354340,201702,10604,5089,5515,4751272.62,5164283.62,9915556.24
354350,201702,127,85,42,79645,39213.45,118858.45
354360,201702,87,45,42,42165,39354,81519
354370,201702,259,137,122,128369,114314,242683
354380,201702,204,119,85,110729,79645,190374
354390,201702,2732,980,1752,917840.35,1639526.72,2557367.07
354400,201702,322,163,159,151654.9,148139.8,299794.7
354410,201702,589,287,302,267978.32,282037.1,550015.42
354420,201702,257,164,93,153668,87141,240809
354425,201702,302,170,132,159290,123019.1,282309.1
354430,201702,190,124,66,114474,61092.4,175566.4
354440,201702,45,32,13,29866,12181,42047
354450,201702,43,28,15,26236,14055,40291
354460,201702,93,55,38,51535,35606,87141
354470,201702,37,28,9,26236,8433,34669
354480,201702,114,62,52,58085,48714.63,106799.63
354490,201702,144,90,54,84173.81,50598,134771.81
354500,201702,402,195,207,182715,193959,376674
354510,201702,108,74,34,69234.56,31858,101092.56
354515,201702,39,16,23,14992,21551,36543
354520,201702,1547,695,852,648707.6,797986.68,1446694.28
354530,201702,592,314,278,291871.5,258706.9,550578.4
354540,201702,272,148,124,138676,116183.32,254859.32
354550,201702,43,25,18,23425,16866,40291
354560,201702,156,89,67,83393,62769.63,146162.63
354570,201702,146,97,49,90889,45913,136802
354580,201702,1985,953,1032,889212.7,966690.22,1855902.92
354600,201702,285,155,130,143811.36,121805.32,265616.68
354610,201702,73,63,10,59031,9370,68401
354620,201702,65,19,46,17803,43102,60905
354625,201702,19,12,7,11244,6555,17799
354630,201702,341,222,119,208005,111503,319508
354640,201702,788,506,282,470266.5,264234,734500.5
354650,201702,72,36,36,33723,33686.26,67409.26
354660,201702,779,565,214,525922.85,200518,726440.85
354670,201702,282,98,184,91826,172408,264234
354680,201702,1216,457,759,428209,710715,1138924
354690,201702,91,61,30,56221,28110,84331
354700,201702,81,55,26,51535,24362,75897
354710,201702,53,36,17,33107.3,15929,49036.3
354720,201702,22,21,1,19677,937,20614
354730,201702,1918,816,1102,761679.5,1031293.4,1792972.9
354740,201702,56,40,16,37480,14992,52472
354750,201702,423,254,169,237989,158353,396342
354760,201702,494,303,191,282975,178686,461661
354765,201702,12,6,6,5622,5622,11244
354770,201702,313,220,93,205049.71,87141,292190.71
354780,201702,8029,3257,4772,3037263.48,4466885.65,7504149.13
354790,201702,119,68,51,63716,47787,111503
354800,201702,400,225,175,210825,163694,374519
354805,201702,103,51,52,47163,48724,95887
354810,201702,138,80,58,74678.9,54346,129024.9
354820,201702,177,75,102,70069,95574,165643
354830,201702,37,21,16,19677,14992,34669
354840,201702,52,33,19,30921,17803,48724
354850,201702,4547,2004,2543,1870961.47,2377938.86,4248900.33
354860,201702,335,163,172,152731,159098.62,311829.62
354870,201702,11220,5135,6085,4786880.38,5693817.98,10480698.36
354880,201702,2910,1072,1838,1001075.55,1720361.96,2721437.51
354890,201702,2786,1534,1252,1432405.94,1171896.54,2604302.48
354900,201702,60,39,21,36543,19677,56220
354910,201702,1147,607,540,566848.22,505980,1072828.22
354920,201702,53,45,8,42165,7496,49661
354925,201702,10,5,5,4685,4685,9370
354930,201702,34,29,5,26907,4685,31592
354940,201702,802,584,218,544509.84,204266,748775.84
354950,201702,230,147,83,137137,77771,214908
354960,201702,172,65,107,60905,99978,160883
354970,201702,804,513,291,476770.09,272039.31,748809.40
354980,201702,8133,3033,5100,2835946.26,4776886.35,7612832.61
354990,201702,8946,4206,4740,3931534.3,4435179.14,8366713.44
354995,201702,524,188,336,176156,314241.69,490397.69
355000,201702,449,144,305,134923.32,284661,419584.32
355010,201702,627,404,223,377611.45,206778.36,584389.81
355020,201702,716,449,267,418830.22,250171,669001.22
355030,201702,198640,76390,122250,71374273.8,114446445.7,185820719.5
355040,201702,687,328,359,307055,336195.6,643250.6
355050,201702,153,105,48,96855.77,44976,141831.77
355060,201702,1294,688,606,639614.87,565995.25,1205610.12
355070,201702,1438,701,737,654013.44,689396.6,1343410.04
355080,201702,198,115,83,107547.74,76899.9,184447.64
355090,201702,269,183,86,169411,80582,249993
355100,201702,4638,2338,2300,2173803.65,2152451.57,4326255.22
355110,201702,294,193,101,179108.55,94637,273745.55
355120,201702,114,83,31,77302.5,28673,105975.5
355130,201702,47,25,22,23425,20614,44039
355140,201702,183,122,61,114314,57157,171471
355150,201702,677,402,275,375733.1,257675,633408.1
355160,201702,419,190,229,175687.8,214573,390260.8
355170,201702,2014,1044,970,976870.87,908221.54,1885092.41
355180,201702,608,250,358,233031.9,334345.02,567376.92
355190,201702,207,141,66,132117,61842,193959
355200,201702,109,62,47,58094,44039,102133
355210,201702,672,388,284,363556,266080.63,629636.63
355220,201702,6303,3382,2921,3159771.78,2729012.72,5888784.50
355230,201702,108,63,45,59031,42160.32,101191.32
355240,201702,3983,1772,2211,1649330.95,2067704.38,3717035.33
355250,201702,5198,2525,2673,2359087.51,2501915.51,4861003.02
355255,201702,50,29,21,27173,19677,46850
355260,201702,184,109,75,102104.89,70257,172361.89
355270,201702,163,94,69,88078,63951,152029
355280,201702,5973,2536,3437,2371140.55,3215612.07,5586752.62
355290,201702,80,59,21,55283,19677,74960
355300,201702,174,118,56,110238.05,52472,162710.05
355310,201702,105,59,46,55283,43102,98385
355320,201702,94,48,46,44694.9,42406.3,87101.2
355330,201702,262,142,120,133054,112440,245494
355340,201702,1143,513,630,479744.68,589581.2,1069325.88
355350,201702,135,70,65,65590,60905,126495
355360,201702,167,98,69,91619.86,64653,156272.86
355365,201702,25,21,4,19677,3748,23425
355370,201702,1034,582,452,540515.96,421810.23,962326.19
355380,201702,747,511,236,477371.8,221132,698503.8
355385,201702,50,35,15,32795,14055,46850
355390,201702,103,58,45,54346,42165,96511
355395,201702,183,112,71,104143.32,66527,170670.32
355400,201702,1481,930,551,868419.68,514787.9,1383207.58
355410,201702,4761,2217,2544,2062375.28,2374006.7,4436381.98
355420,201702,42,32,10,29984,9370,39354
355430,201702,321,198,123,184870.1,115251,300121.1
355440,201702,76,43,33,40291,30921,71212
355450,201702,416,193,223,176344.15,208014.2,384358.35
355460,201702,72,56,16,51535.51,14992,66527.51
355465,201702,51,32,19,29984,17803,47787
355470,201702,185,69,116,63716.55,108692,172408.55
355475,201702,10,7,3,6559,2811,9370
355480,201702,443,190,253,176906,235177.63,412083.63
355490,201702,107,79,28,74023,26236,100259
355495,201702,51,25,26,23425,24362,47787
355500,201702,1687,948,739,884391.14,691841.86,1576233.00
355510,201702,266,198,68,182129.5,63716,245845.5
355520,201702,36,28,8,26236,7496,33732
355530,201702,20,14,6,13118,5622,18740
355535,201702,72,32,40,29984,37480,67464
355540,201702,2262,905,1357,846420.31,1270553.63,2116973.94
355550,201702,66,40,26,37480,24362,61842
355560,201702,226,118,108,110566,100571.3,211137.3
355570,201702,29,18,11,16866,10307,27173
355580,201702,271,181,90,169597,84325.32,253922.32
355590,201702,21,14,7,13118,6559,19677
355600,201702,274,142,132,133054,123398.32,256452.32
355610,201702,196,128,68,119936,63716,183652
355620,201702,1204,552,652,515490.9,610357.8,1125848.7
355630,201702,410,285,125,266109,117125,383234
355635,201702,122,60,62,56220,58081,114301
355640,201702,574,332,242,310147,226754,536901
355645,201702,821,353,468,328162.64,436670.21,764832.85
355650,201702,1879,865,1014,809260,949818.63,1759078.63
355660,201702,269,141,128,132117,119931.32,252048.32
355670,201702,448,163,285,152731,267045,419776
355680,201702,211,116,95,108692,89015,197707
355690,201702,83,40,43,37480,39953,77433
355695,201702,15,13,2,12181,1874,14055
355700,201702,1082,583,499,540712.71,467282,1007994.71
355710,201702,2127,1167,960,1088593.68,898930,1987523.68
355715,201702,18,16,2,14992,1874,16866
355720,201702,202,126,76,116500.66,71208,187708.66
355730,201702,80,49,31,45054.53,29047,74101.53
410010,201702,124,105,19,98385,17803,116188
410020,201702,102,91,11,85267,10307,95574
410030,201702,159,102,57,95293,53409,148702
410040,201702,974,514,460,481102.65,430551.9,911654.55
410045,201702,34,29,5,27173,4685,31858
410050,201702,466,260,206,243620,192272.5,435892.5
410060,201702,256,199,57,185901,53409,239310
410070,201702,335,266,69,249242,64653,313895
410080,201702,165,109,56,102133,52472,154605
410090,201702,73,62,11,57888,10307,68195
410100,201702,291,204,87,191148,81519,272667
410105,201702,39,24,15,22488,14055,36543
410110,201702,309,185,124,173064,116188,289252
410115,201702,26,17,9,15929,8433,24362
410120,201702,437,222,215,207717.9,201455,409172.9
410130,201702,40,26,14,24362,13118,37480
410140,201702,2955,1439,1516,1343194.63,1419545.63,2762740.26
410150,201702,2663,1066,1597,998017.55,1495896.5,2493914.05
410160,201702,480,309,171,289251.9,160227,449478.9
410165,201702,63,39,24,36543,22488,59031
410170,201702,161,126,35,115866.83,32795,148661.83
410180,201702,2011,1159,852,1082067.28,796986.08,1879053.36
410185,201702,43,39,4,36543,3748,40291
410190,201702,397,241,156,225817,146172,371989
410200,201702,951,715,236,667747.87,221132,888879.87
410210,201702,541,276,265,258612,247743,506355
410220,201702,38,21,17,19677,15929,35606
410230,201702,121,72,49,67464,45913,113377
410240,201702,696,452,244,422961.9,228628,651589.9
410250,201702,383,285,98,266451.6,91805.89,358257.49
410260,201702,307,166,141,155542,132117,287659
410270,201702,31,20,11,18740,10307,29047
410275,201702,72,55,17,51535,15929,67464
410280,201702,299,166,133,155006.04,124621,279627.04
410290,201702,213,145,68,134981.81,63274.02,198255.83
410300,201702,81,65,16,60905,14992,75897
410302,201702,24,15,9,14055,8433,22488
410304,201702,49,33,16,30921,14992,45913
410305,201702,184,98,86,91034,80577.32,171611.32
410310,201702,259,168,91,157416,85267,242683
410315,201702,61,45,16,42141,14992,57133
410320,201702,132,85,47,79645,44039,123684
410322,201702,34,23,11,21551,10307,31858
410330,201702,191,135,56,126495,52472,178967
410335,201702,106,67,39,62779,36543,99322
410337,201702,30,26,4,24362,3748,28110
410340,201702,30,29,1,27173,937,28110
410345,201702,202,128,74,119195.77,69338,188533.77
410347,201702,53,41,12,38417,11244,49661
410350,201702,230,142,88,133054,82456,215510
410360,201702,439,264,175,245807.1,163694,409501.1
410370,201702,2250,914,1336,853477.81,1249284.11,2102761.92
410380,201702,226,150,76,140550,71212,211762
410390,201702,353,270,83,252986,77771,330757
410395,201702,35,24,11,22488,9933,32421
410400,201702,795,406,389,379116.1,363964,743080.1
410405,201702,84,62,22,58094,20614,78708
410410,201702,47,36,11,33732,10307,44039
410420,201702,1620,807,813,754362.6,759939.3,1514301.9
410425,201702,172,84,88,78521,82456,160977
410430,201702,2147,1256,891,1174435.9,832652.84,2007088.74
410440,201702,396,280,116,261424,108692,370116
410442,201702,355,236,119,220196,111503,331699
410445,201702,417,286,131,267982,122747,390729
410450,201702,392,198,194,185526,181778,367304
410460,201702,390,214,176,200236.9,164912,365148.9
410465,201702,196,126,70,117780.9,65590,183370.9
410470,201702,211,132,79,123684,74023,197707
410480,201702,5478,2701,2777,2516776.8,2596890.53,5113667.33
410490,201702,1335,882,453,824983,422307,1247290
410500,201702,255,145,110,135865,103070,238935
410510,201702,179,126,53,118062,49027.3,167089.3
410520,201702,290,215,75,201455,70275,271730
410530,201702,221,83,138,77771,129020.9,206791.9
410540,201702,315,230,85,214939.8,79640.32,294580.12
410550,201702,1523,659,864,615983.9,809001.12,1424985.02
410560,201702,141,107,34,100259,31858,132117
410570,201702,431,302,129,281672.6,120873,402545.6
410580,201702,3075,1385,1690,1294034.36,1582125,2876159.36
410590,201702,393,276,117,258612,109524.09,368136.09
410600,201702,165,146,19,136802,17803,154605
410610,201702,50,41,9,38417,8433,46850
410620,201702,226,163,63,152731,59031,211762
410630,201702,438,256,182,239872,169395,409267
410640,201702,920,560,360,522535.76,336679.53,859215.29
410645,201702,97,70,27,65196,25299,90495
410650,201702,358,241,117,224880,109629,334509
410655,201702,73,58,15,54346,14055,68401
410657,201702,40,17,23,15929,21551,37480
410660,201702,568,399,169,372490,158353,530843
410670,201702,74,60,14,56220,13118,69338
410680,201702,193,157,36,147109,32774.99,179883.99
410685,201702,21,16,5,14992,4685,19677
410690,201702,28416,12231,16185,11441895.07,15155235.3,26597130.37
410700,201702,317,234,83,218696,77771,296467
410710,201702,134,109,25,102133,23425,125558
410712,201702,17,11,6,10307,5622,15929
410715,201702,100,75,25,70275,23425,93700
410720,201702,578,353,225,330761,210816,541577
410725,201702,176,128,48,119936,44976,164912
410730,201702,92,61,31,57157,29047,86204
410740,201702,112,85,27,79645,25299,104944
410750,201702,211,160,51,149920,47787,197707
410752,201702,19,13,6,12181,5622,17803
410753,201702,47,21,26,19016.41,24362,43378.41
410754,201702,48,32,16,29984,14992,44976
410755,201702,82,56,26,52190.9,24362,76552.9
410760,201702,657,374,283,350438,264703,615141
410765,201702,1571,762,809,708181.94,756899.63,1465081.57
410770,201702,106,90,16,84330,14992,99322
410773,201702,47,34,13,31858,12181,44039
410775,201702,161,120,41,111784.1,38417,150201.1
410780,201702,79,41,38,38417,35606,74023
410785,201702,74,55,19,51348,17803,69151
410790,201702,67,35,32,32795,29984,62779
410800,201702,295,187,108,174283,101196,275479
410810,201702,36,28,8,26236,7215,33451
410820,201702,176,130,46,121810,43102,164912
410830,201702,8450,3859,4591,3607185.46,4299997.82,7907183.28
410832,201702,104,75,29,69993.9,27173,97166.9
410840,201702,1334,740,594,690883.89,556448.67,1247332.56
410845,201702,56,35,21,32795,19677,52472
410850,201702,195,137,58,128329,54346,182675
410855,201702,34,32,2,29984,1874,31858
410860,201702,660,382,278,357162.75,260486,617648.75
410865,201702,108,80,28,74960,26236,101196
410870,201702,145,126,19,118062,17516,135578
410880,201702,1072,526,546,492344.12,511548,1003892.12
410890,201702,73,55,18,51535,16866,68401
410895,201702,65,47,18,44039,16866,60905
410900,201702,41,32,9,29984,8433,38417
410910,201702,25,22,3,20614,2811,23425
410920,201702,51,26,25,24362,23425,47787
410930,201702,504,316,188,295884.74,175874.9,471759.64
410940,201702,4220,2535,1685,2366372.3,1577010,3943382.3
410950,201702,128,90,38,84330,35606,119936
410960,201702,735,326,409,305181,382671,687852
410965,201702,62,49,13,45913,12181,58094
410970,201702,610,431,179,403391.1,167723,571114.1
410975,201702,107,72,35,67103,32795,99898
410980,201702,1469,658,811,616546,759898.32,1376444.32
410990,201702,256,171,85,160061.25,79363.9,239425.15
411000,201702,60,41,19,38417,17803,56220
411005,201702,15,12,3,11244,2811,14055
411007,201702,232,135,97,126495,90889,217384
411010,201702,569,405,164,379260,153668,532928
411020,201702,279,191,88,178967,82456,261423
411030,201702,24,15,9,14055,8433,22488
411040,201702,48,33,15,30921,14055,44976
411050,201702,221,177,44,164400.17,41101.12,205501.29
411060,201702,501,341,160,319508,149920,469428
411065,201702,61,55,6,51413.19,5622,57035.19
411070,201702,1142,758,384,706311,359808,1066119
411080,201702,235,170,65,159373,60118.66,219491.66
411090,201702,108,78,30,73086,28110,101196
411095,201702,253,104,149,96980,139603,236583
411100,201702,109,89,20,83393,18740,102133
411110,201702,127,87,40,81519,37480,118999
411120,201702,170,131,39,122747,36543,159290
411125,201702,149,73,76,68401,71212,139613
411130,201702,113,98,15,91200,14055,105255
411140,201702,175,120,55,112116.9,51019.65,163136.55
411150,201702,1166,778,388,728976.63,363556,1092532.63
411155,201702,119,83,36,77771,33732,111503
411160,201702,20,9,11,8433,10307,18740
411170,201702,58,50,8,46568.9,7496,54064.9
411180,201702,906,593,313,553486.33,293276.32,846762.65
411190,201702,279,163,116,152075.1,108692,260767.1
411200,201702,657,435,222,406064.99,207545.5,613610.49
411210,201702,659,356,303,332049.83,283911,615960.83
411220,201702,147,110,37,103070,34669,137739
411230,201702,50,44,6,41228,5622,46850
411240,201702,126,88,38,82456,35606,118062
411250,201702,404,289,115,270793,107755,378548
411260,201702,21,15,6,14055,5622,19677
411270,201702,287,161,126,150857,118062,268919
411275,201702,199,175,24,163835,22488,186323
411280,201702,220,152,68,141175.36,63716,204891.36
411290,201702,58,41,17,38417,15929,54346
411295,201702,143,115,28,107755,26236,133991
411300,201702,80,44,36,41228,33732,74960
411310,201702,93,70,23,65590,21551,87141
411320,201702,718,522,196,488177.9,182078.24,670256.14
411325,201702,46,26,20,24362,18740,43102
411330,201702,883,560,323,523716.25,301807.8,825524.05
411340,201702,26,16,10,14992,9061,24053
411342,201702,81,57,24,53409,22488,75897
411345,201702,119,59,60,55283,56211,111494
411350,201702,461,379,82,354139.92,76543.63,430683.55
411360,201702,50,30,20,28110,18740,46850
411370,201702,13622,5562,8060,5196516.79,7539389.27,12735906.06
411373,201702,210,157,53,147109,49661,196770
411375,201702,84,68,16,63716,14992,78708
411380,201702,102,74,28,68401.89,26236,94637.89
411390,201702,142,91,51,85267,47787,133054
411400,201702,343,256,87,239872,81519,321391
411410,201702,437,221,216,205718.35,202111,407829.35
411420,201702,1008,459,549,427834.2,513944.6,941778.8
411430,201702,396,253,143,236405.1,133982,370387.1
411435,201702,40,28,12,26236,11244,37480
411440,201702,464,370,94,345067.17,88078,433145.17
411450,201702,438,356,82,333572,76834,410406
411460,201702,709,283,426,264178.64,397861.4,662040.04
411470,201702,127,91,36,85267,33732,118999
411480,201702,609,347,262,323640.8,245212.9,568853.7
411490,201702,290,179,111,167723,104007,271730
411500,201702,105,90,15,84330,13399.9,97729.9
411510,201702,217,177,40,164489.69,37480,201969.69
411520,201702,5802,2262,3540,2115008.76,3309923.18,5424931.94
411530,201702,112,73,39,68401,36543,104944
411535,201702,53,20,33,18740,30921,49661
411540,201702,308,211,97,196887.6,90889,287776.6
411545,201702,74,52,22,48724,20614,69338
411550,201702,72,56,16,52472,14992,67464
411560,201702,356,165,191,153977.21,178967,332944.21
411570,201702,767,290,477,271449,446762,718211
411573,201702,34,21,13,19677,12181,31858
411575,201702,247,149,98,139613,91826,231439
411580,201702,1205,467,738,436610.8,690514,1127124.8
411585,201702,71,35,36,32795,33732,66527
411590,201702,24,18,6,16866,5622,22488
411600,201702,56,28,28,26236,26236,52472
411605,201702,200,85,115,79485,107755,187240
411610,201702,234,160,74,149920,69338,219258
411620,201702,339,186,153,174094.6,143361,317455.6
411630,201702,56,37,19,34669,17803,52472
411640,201702,39,31,8,29047,7496,36543
411650,201702,14,11,3,10307,2811,13118
411660,201702,39,33,6,30921,5622,36543
411670,201702,254,193,61,179642.41,57137,236779.41
411680,201702,159,139,20,130243,18740,148983
411690,201702,590,329,261,307656.08,244175.48,551831.56
411695,201702,63,48,15,44976,14055,59031
411700,201702,169,144,25,134928,23425,158353
411705,201702,104,67,37,62779,34669,97448
411710,201702,294,192,102,178938.1,95574,274512.1
411720,201702,135,86,49,80582,45913,126495
411721,201702,70,56,14,52472,13118,65590
411722,201702,94,41,53,38417,49661,88078
411725,201702,138,110,28,102789,26236,129025
411727,201702,81,67,14,62779,12836.9,75615.9
411729,201702,33,24,9,22488,8433,30921
411730,201702,536,346,190,322359.2,178030,500389.2
411740,201702,28,21,7,19677,6559,26236
411745,201702,68,47,21,43262,19677,62939
411750,201702,812,401,411,374379.9,384147.36,758527.26
411760,201702,1172,881,291,823708.04,272658,1096366.04
411770,201702,394,272,122,254864,114314,369178
411780,201702,354,232,122,216447.84,114314,330761.84
411790,201702,503,277,226,259217.48,211650.67,470868.15
411800,201702,170,134,36,125558,33732,159290
411810,201702,149,111,38,104007,35606,139613
411820,201702,2072,1016,1056,950062.5,989069.86,1939132.36
411830,201702,9,9,0,8433,0,8433
411840,201702,1880,1165,715,1090929.6,669467,1760396.6
411845,201702,50,17,33,15929,30921,46850
411850,201702,1203,703,500,655319.74,466581.81,1121901.55
411860,201702,64,49,15,45612,14055,59667
411870,201702,64,49,15,45913,13774,59687
411880,201702,414,271,143,253673,133260.14,386933.14
411885,201702,103,67,36,62779,33732,96511
411890,201702,327,200,127,187400,118990,306390
411900,201702,73,53,20,49661,18740,68401
411910,201702,165,136,29,127432,26236,153668
411915,201702,1981,854,1127,798035.51,1055189.59,1853225.10
411920,201702,123,105,18,98385,16866,115251
411925,201702,19,12,7,11244,6559,17803
411930,201702,789,580,209,541588,195833,737421
411940,201702,573,413,160,386981,149895.56,536876.56
411950,201702,853,460,393,431010.63,367928.7,798939.33
411960,201702,937,674,263,629207,246431,875638
411965,201702,28,19,9,17803,8433,26236
411970,201702,74,67,7,62779,6559,69338
411980,201702,198,130,68,121810,63716,185526
411990,201702,4643,2732,1911,2543215.64,1788584.5,4331800.14
411995,201702,443,169,274,158353,256738,415091
412000,201702,269,153,116,142659.56,108692,251351.56
412010,201702,43,27,16,25299,14992,40291
412015,201702,42,31,11,29047,10307,39354
412020,201702,30,26,4,24080.9,3748,27828.9
412030,201702,65,55,10,51535,9370,60905
412033,201702,49,32,17,29960,15929,45889
412035,201702,87,55,32,51535,29984,81519
412040,201702,33,24,9,22207,8433,30640
412050,201702,197,145,52,135865,48724,184589
412060,201702,742,586,156,546271.88,146172,692443.88
412065,201702,43,32,11,29984,10307,40291
412070,201702,147,98,49,91170.1,45913,137083.1
412080,201702,268,136,132,127432,123684,251116
412085,201702,30,13,17,12181,15929,28110
412090,201702,688,422,266,393494.1,249242,642736.1
412100,201702,240,198,42,184590,39166.6,223756.6
412110,201702,71,56,15,52472,14055,66527
412120,201702,310,203,107,189648.8,100259,289907.8
412125,201702,91,50,41,46568.9,38417,84985.9
412130,201702,52,35,17,32795,15929,48724
412135,201702,25,13,12,12181,11244,23425
412140,201702,282,210,72,196770,67464,264234
412150,201702,251,169,82,157659.62,76834,234493.62
412160,201702,97,60,37,56211,34669,90880
412170,201702,609,446,163,417902,152731,570633
412175,201702,45,35,10,32795,9370,42165
412180,201702,187,147,40,137150.29,37480,174630.29
412190,201702,321,260,61,242959.41,57157,300116.41
412200,201702,187,122,65,114314,60905,175219
412210,201702,94,74,20,69338,18740,88078
412215,201702,227,155,72,145235,67464,212699
412217,201702,87,68,19,63716,17803,81519
412220,201702,763,582,181,545334,169597,714931
412230,201702,338,214,124,198323.67,115788.64,314112.31
412240,201702,1269,612,657,569214.13,612615.29,1181829.42
412250,201702,380,241,139,225817,129306.92,355123.92
412260,201702,124,90,34,84330,31858,116188
412265,201702,159,127,32,118999,29984,148983
412270,201702,84,47,37,44039,34669,78708
412280,201702,86,68,18,63716,16866,80582
412290,201702,103,64,39,59733.75,36543,96276.75
412300,201702,223,144,79,134928,74023,208951
412310,201702,46,39,7,36543,6559,43102
412320,201702,95,80,15,74960,14055,89015
412330,201702,160,145,15,135865,14055,149920
412340,201702,135,90,45,84330,41884,126214
412350,201702,576,281,295,262313.15,276228,538541.15
412360,201702,26,23,3,21551,2811,24362
412370,201702,159,134,25,124621,23425,148046
412380,201702,260,191,69,178967,64644,243611
412382,201702,52,28,24,26236,22488,48724
412385,201702,145,99,46,92763,43102,135865
412390,201702,261,196,65,183652,60905,244557
412395,201702,59,47,12,44039,11244,55283
412400,201702,67,47,20,44039,18740,62779
412402,201702,233,106,127,99317.32,118717.9,218035.22
412405,201702,795,319,476,297472.01,445529.96,743001.97
412410,201702,905,558,347,521347,325139,846486
412420,201702,17,12,5,11244,4685,15929
412430,201702,21,16,5,14992,4685,19677
412440,201702,564,303,261,280957.07,242860.28,523817.35
412450,201702,79,68,11,63716,10307,74023
412460,201702,80,63,17,59031,15929,74960
412470,201702,256,209,47,195833,44039,239872
412480,201702,178,134,44,125558,41228,166786
412490,201702,156,132,24,123684,22488,146172
412500,201702,474,382,92,356716.3,86204,442920.3
412510,201702,190,152,38,141862,35606,177468
412520,201702,127,71,56,66527,52472,118999
412530,201702,105,57,48,53409,44413.9,97822.9
412535,201702,109,80,29,74942,27164,102106
412540,201702,66,30,36,28110,33732,61842
412545,201702,94,70,24,65122,22488,87610
412550,201702,3342,1543,1799,1442421.19,1684445.45,3126866.64
412555,201702,16,12,4,11244,3748,14992
412560,201702,566,429,137,401973,128369,530342
412570,201702,735,416,319,389192.32,298622,687814.32
412575,201702,94,65,29,60905,27173,88078
412580,201702,150,103,47,96511,44039,140550
412590,201702,32,30,2,28110,1874,29984
412600,201702,171,131,40,122747,37480,160227
412610,201702,36,24,12,22488,10439,32927
412620,201702,152,133,19,124621,17803,142424
412625,201702,2144,1143,1001,1069222.76,936373.72,2005596.48
412627,201702,70,57,13,53409,12181,65590
412630,201702,432,288,144,269665,134928,404593
412635,201702,63,22,41,20614,38417,59031
412640,201702,109,75,34,70275,31858,102133
412650,201702,319,203,116,190211,108687.32,298898.32
412660,201702,469,280,189,261658,177093,438751
412665,201702,48,42,6,39354,5622,44976
412667,201702,316,208,108,194291.6,100832.04,295123.64
412670,201702,62,53,9,49661,8433,58094
412680,201702,279,223,56,208951,52472,261423
412690,201702,113,74,39,69338,36262,105600
412700,201702,167,114,53,106818,49380,156198
412710,201702,1365,850,515,789893.8,480304.61,1270198.41
412720,201702,222,153,69,143361,64653,208014
412730,201702,196,146,50,136802,45913,182715
412740,201702,399,214,185,200377.45,173345,373722.45
412750,201702,455,259,196,241746,183652,425398
412760,201702,236,121,115,113377,107755,221132
412770,201702,1968,1117,851,1041584.05,797079,1838663.05
412780,201702,146,119,27,111503,25299,136802
412785,201702,266,132,134,123028.1,125558,248586.1
412788,201702,33,18,15,16866,14055,30921
412790,201702,132,110,22,102414.1,20614,123028.1
412795,201702,163,121,42,113377,39354,152731
412796,201702,295,202,93,188130.83,87009.82,275140.65
412800,201702,527,348,179,325535.73,167714,493249.73
412810,201702,2883,1584,1299,1480628.69,1215940.22,2696568.91
412820,201702,850,556,294,507426.43,273145.92,780572.35
412830,201702,18,14,4,13118,3748,16866
412840,201702,214,153,61,142424.1,57157,199581.1
412850,201702,763,524,239,489114,223943,713057
412853,201702,175,97,78,90889,73086,163975
412855,201702,225,119,106,111347,99322,210669
412860,201702,93,71,22,66527,20614,87141
412862,201702,64,47,17,43758,15929,59687
412863,201702,15,11,4,10307,3748,14055
412865,201702,41,31,10,29047,9370,38417
412870,201702,108,69,39,64653,36543,101196
412880,201702,122,97,25,90889,23425,114314
420005,201702,34,30,4,28110,3186,31296
420010,201702,362,242,120,225958,111494,337452
420020,201702,65,55,10,51535,9370,60905
420030,201702,28,25,3,23425,2811,26236
420040,201702,105,80,25,74960,23425,98385
420050,201702,55,33,22,30539.9,20453.34,50993.24
420055,201702,19,18,1,16866,937,17803
420060,201702,35,27,8,25299,7496,32795
420070,201702,97,83,14,77771,13108.63,90879.63
420075,201702,10,8,2,7496,1874,9370
420080,201702,47,42,5,38463.85,4685,43148.85
420090,201702,35,32,3,29220.34,2811,32031.34
420100,201702,150,127,23,117407.1,21551,138958.1
420110,201702,17,17,0,15929,0,15929
420120,201702,45,33,12,30921,11244,42165
420125,201702,81,65,16,60905,14992,75897
420127,201702,31,28,3,26236,2811,29047
420130,201702,357,225,132,210534.63,123674.63,334209.26
420140,201702,1170,678,492,634040.53,460940,1094980.53
420150,201702,44,37,7,34669,6559,41228
420160,201702,42,39,3,36543,2811,39354
420165,201702,15,11,4,10307,3748,14055
420170,201702,65,41,24,38417,22488,60905
420180,201702,27,25,2,23425,1874,25299
420190,201702,32,29,3,27173,2811,29984
420195,201702,121,59,62,55283,58094,113377
420200,201702,1263,561,702,520037.1,657401.52,1177438.62
420205,201702,65,31,34,29047,31858,60905
420207,201702,93,55,38,51535,35596.63,87131.63
420208,201702,27,22,5,20614,3841.7,24455.7
420209,201702,17,13,4,12181,3748,15929
420210,201702,449,206,243,192740.9,227607.04,420347.94
420213,201702,50,39,11,36543,10307,46850
420215,201702,23,20,3,18740,2811,21551
420220,201702,71,47,24,44039,22488,66527
420230,201702,684,398,286,371709,267972.63,639681.63
420240,201702,2182,1488,694,1386216.91,649013.15,2035230.06
420243,201702,25,21,4,19677,3748,23425
420245,201702,78,43,35,40291,32795,73086
420250,201702,48,28,20,26236,18740,44976
420253,201702,38,31,7,29047,6559,35606
420257,201702,10,9,1,8433,937,9370
420260,201702,94,83,11,77771,10307,88078
420270,201702,31,26,5,24357.32,4685,29042.32
420280,201702,268,198,70,184516.91,65572,250088.91
420285,201702,21,13,8,12181,7496,19677
420287,201702,49,30,19,28110,17803,45913
420290,201702,918,645,273,603682.6,255725.2,859407.8
420300,201702,1298,1019,279,951432.2,260205.77,1211637.97
420310,201702,47,35,12,32795,11244,44039
420315,201702,35,31,4,29047,3748,32795
420320,201702,837,425,412,397181.96,386040,783221.96
420325,201702,0,0,0,0,0,0
420330,201702,122,85,37,79645,34669,114314
420340,201702,152,109,43,101188,40262.89,141450.89
420350,201702,237,174,63,161727.1,59031,220758.1
420360,201702,733,554,179,517441.23,166140.09,683581.32
420370,201702,101,68,33,63529,30640,94169
420380,201702,1097,786,311,732726.76,290370.02,1023096.78
420390,201702,246,153,93,142780.06,85501.25,228281.31
420395,201702,169,121,48,113377,44966.63,158343.63
420400,201702,243,178,65,165850,60905,226755
420410,201702,57,45,12,42165,11244,53409
420415,201702,32,29,3,27173,2811,29984
420417,201702,43,33,10,30921,9370,40291
420419,201702,11,10,1,9370,937,10307
420420,201702,2729,1661,1068,1546062.51,998450.88,2544513.39
420425,201702,67,58,9,54337,8414.26,62751.26
420430,201702,1247,860,387,801008.36,362590.89,1163599.25
420435,201702,16,14,2,13118,1874,14992
420440,201702,112,75,37,69354.86,34496.6,103851.46
420445,201702,20,18,2,16866,1874,18740
420450,201702,77,36,41,33703,38417,72120
420455,201702,231,181,50,169569.26,46795.63,216364.89
420460,201702,2204,1491,713,1392423.59,667868.82,2060292.41
420470,201702,121,89,32,83393,29984,113377
420475,201702,7,7,0,6559,0,6559
420480,201702,820,607,213,565273.46,198644.1,763917.56
420490,201702,112,87,25,81519,23425,104944
420500,201702,837,295,542,274761.1,507854,782615.1
420510,201702,22,18,4,16866,3748,20614
420515,201702,23,18,5,16866,4685,21551
420517,201702,7,7,0,6559,0,6559
420519,201702,0,0,0,0,0,0
420520,201702,72,55,17,51535,15929,67464
420530,201702,149,101,48,94637,44976,139613
420535,201702,19,16,3,14992,2811,17803
420540,201702,4210,2482,1728,2317428.9,1614329.69,3931758.59
420543,201702,22,22,0,20614,0,20614
420545,201702,181,130,51,121801,47758.89,169559.89
420550,201702,830,658,172,614991.52,161026.12,776017.64
420555,201702,40,32,8,29984,7496,37480
420560,201702,61,48,13,44601.2,12181,56782.2
420570,201702,116,69,47,64090.8,44029.63,108120.43
420580,201702,285,127,158,118999,148046,267045
420590,201702,485,344,141,321391.1,132117,453508.1
420600,201702,90,45,45,42165,42165,84330
420610,201702,35,33,2,30640,1874,32514
420620,201702,67,56,11,52472,10307,62779
420630,201702,143,102,41,95565.32,38409,133974.32
420640,201702,103,90,13,84330,12181,96511
420650,201702,228,122,106,113618.1,98152.06,211770.16
420660,201702,58,41,17,37667.9,15929,53596.9
420665,201702,35,26,9,24362,8433,32795
420670,201702,305,234,71,219248.63,66227.53,285476.16
420675,201702,13,13,0,12181,0,12181
420680,201702,30,23,7,21551,6559,28110
420690,201702,177,151,26,141487,24362,165849
420700,201702,577,410,167,384095.78,156257.82,540353.60
420710,201702,137,82,55,76834,51526,128360
420720,201702,96,80,16,74960,14992,89952
420730,201702,473,308,165,288522.15,153323.86,441846.01
420740,201702,42,42,0,39354,0,39354
420750,201702,480,317,163,296727.79,152450,449177.79
420757,201702,17,14,3,12321.55,2811,15132.55
420760,201702,40,31,9,29047,8433,37480
420765,201702,65,54,11,50598,10307,60905
420768,201702,73,66,7,61842,6559,68401
420770,201702,86,73,13,68401,12181,80582
420775,201702,43,41,2,37480,1874,39354
420780,201702,225,177,48,165624.12,44976,210600.12
420785,201702,13,9,4,8433,3748,12181
420790,201702,169,146,23,136485.64,20586.63,157072.27
420800,201702,72,54,18,49848.4,16866,66714.4
420810,201702,240,208,32,194887,29187.55,224074.55
420820,201702,2285,1352,933,1258782.46,872712.93,2131495.39
420830,201702,498,289,209,269348.09,194886.63,464234.72
420840,201702,134,101,33,94637,30921,125558
420845,201702,423,187,236,174559.93,219914,394473.93
420850,201702,212,172,40,161164,37480,198644
420860,201702,59,50,9,46850,8433,55283
420870,201702,124,93,31,87141,29047,116188
420880,201702,164,110,54,102404.73,50598,153002.73
420890,201702,834,414,420,384887.67,393531,778418.67
420895,201702,10,10,0,9370,0,9370
420900,201702,397,301,96,280295.22,89924.63,370219.85
420910,201702,5523,3019,2504,2822937.6,2345223.83,5168161.43
420915,201702,78,73,5,68401,4685,73086
420917,201702,18,13,5,12181,4685,16866
420920,201702,19,13,6,12181,5622,17803
420930,201702,2527,1514,1013,1411044.86,943642.7,2354687.56
420940,201702,563,415,148,388837,137061.24,525898.24
420945,201702,7,4,3,3748,2811,6559
420950,201702,53,48,5,44976,4685,49661
420960,201702,110,85,25,79617.63,23406.63,103024.26
420970,201702,303,246,57,228855.45,53381.63,282237.08
420980,201702,24,23,1,21551,937,22488
420985,201702,57,50,7,46850,6559,53409
420990,201702,73,57,16,53409,14992,68401
421000,201702,36,23,13,21551,12181,33732
421003,201702,67,42,25,38641.88,23416,62057.88
421005,201702,8,6,2,5622,1874,7496
421010,201702,711,508,203,475605.78,188177.5,663783.28
421020,201702,26,24,2,22468,1874,24342
421030,201702,121,101,20,94310,18740,113050
421040,201702,57,50,7,46850,6559,53409
421050,201702,286,200,86,185339.1,80582,265921.1
421055,201702,26,23,3,21551,2811,24362
421060,201702,86,60,26,56220,24362,80582
421070,201702,49,43,6,40291,5622,45913
421080,201702,32,29,3,27173,2811,29984
421085,201702,23,18,5,16866,4685,21551
421090,201702,43,33,10,30921,9370,40291
421100,201702,119,88,31,82456,29047,111503
421105,201702,197,160,37,149780,34645.95,184425.95
421110,201702,110,93,17,86531.95,15929,102460.95
421120,201702,132,108,24,100709.13,22469.26,123178.39
421125,201702,17,12,5,11244,4685,15929
421130,201702,765,485,280,453783.41,261338.87,715122.28
421140,201702,30,21,9,18974.25,8433,27407.25
421145,201702,38,31,7,29047,6559,35606
421150,201702,103,75,28,70270.32,26236,96506.32
421160,201702,57,38,19,35596.63,17803,53399.63
421165,201702,19,18,1,16866,937,17803
421170,201702,181,156,25,145452.89,23416,168868.89
421175,201702,146,97,49,90889,45857.52,136746.52
421180,201702,55,33,22,30565,20614,51179
421185,201702,17,13,4,12181,3748,15929
421187,201702,0,0,0,0,0,0
421189,201702,38,30,8,28110,7486.63,35596.63
421190,201702,1320,801,519,749788,485628.36,1235416.36
421200,201702,88,69,19,64653,17803,82456
421205,201702,22,14,8,13118,7486.63,20604.63
421210,201702,171,113,58,105881,54346,160227
421220,201702,255,203,52,189601.95,48724,238325.95
421223,201702,54,45,9,42165,8433,50598
421225,201702,54,39,15,36543,14055,50598
421227,201702,87,66,21,61842,19677,81519
421230,201702,43,32,11,29984,10307,40291
421240,201702,19,19,0,17803,0,17803
421250,201702,355,216,139,202299,129746.39,332045.39
421260,201702,29,23,6,21551,5622,27173
421265,201702,0,0,0,0,0,0
421270,201702,56,50,6,46850,5622,52472
421280,201702,323,184,139,172408,129306,301714
421290,201702,302,205,97,191851,89502.56,281353.56
421300,201702,28,22,6,20614,5622,26236
421310,201702,52,39,13,35887.1,12181,48068.1
421315,201702,30,20,10,18660.14,9370,28030.14
421320,201702,120,85,35,79318,32795,112113
421330,201702,111,84,27,76346.76,25290,101636.76
421335,201702,39,25,14,23425,13118,36543
421340,201702,266,178,88,165989.55,82456,248445.55
421350,201702,167,98,69,91391,64653,156044
421360,201702,670,491,179,455427.47,167499.26,622926.73
421370,201702,177,136,41,127432,37807.95,165239.95
421380,201702,133,112,21,104939.32,19677,124616.32
421390,201702,18,15,3,14055,2811,16866
421400,201702,106,92,14,86204,13118,99322
421410,201702,21,18,3,16866,2811,19677
421415,201702,19,17,2,15929,1874,17803
421420,201702,155,129,26,120310.8,24362,144672.8
421430,201702,15,12,3,11244,2811,14055
421440,201702,60,47,13,44039,12181,56220
421450,201702,102,89,13,83393,12181,95574
421460,201702,59,50,9,46060.1,8433,54493.1
421470,201702,70,45,25,42165,23425,65590
421480,201702,607,447,160,418370.5,149920,568290.5
421490,201702,25,22,3,19950,2811,22761
421500,201702,506,327,179,303744.77,166835.69,470580.46
421505,201702,25,18,7,16866,6559,23425
421507,201702,31,26,5,24362,4685,29047
421510,201702,71,47,24,44039,22488,66527
421520,201702,66,56,10,51723,9370,61093
421530,201702,55,49,6,45257.1,5622,50879.1
421535,201702,35,34,1,31596,937,32533
421540,201702,58,52,6,48724,5622,54346
421545,201702,87,71,16,65769,14992,80761
421550,201702,271,190,81,177375,75897,253272
421555,201702,21,17,4,15929,3748,19677
421560,201702,8,8,0,7496,0,7496
421565,201702,116,87,29,80956.8,27173,108129.8
421567,201702,28,22,6,20614,5622,26236
421568,201702,32,30,2,28110,1874,29984
421569,201702,9,8,1,7496,937,8433
421570,201702,129,84,45,78708,42165,120873
421575,201702,27,22,5,20356.33,4685,25041.33
421580,201702,706,424,282,397267.89,263024.13,660292.02
421590,201702,20,20,0,18740,0,18740
421600,201702,113,77,36,72129,32796,104925
421605,201702,99,68,31,63389,29047,92436
421610,201702,182,139,43,130243,40291,170534
421620,201702,1086,651,435,607532.76,407547.52,1015080.28
421625,201702,20,17,3,15929,2811,18740
421630,201702,265,169,96,158307,89109,247416
421635,201702,17,7,10,6559,9370,15929
421640,201702,98,85,13,79645,12181,91826
421650,201702,270,158,112,148027.26,104925.26,252952.52
421660,201702,1993,1178,815,1101899.02,762409.16,1864308.18
421670,201702,167,125,42,117125,39354,156479
421680,201702,170,154,16,144298,14983,159281
421690,201702,340,238,102,222297.8,94627.99,316925.79
421700,201702,53,34,19,31858,17803,49661
421710,201702,20,20,0,18740,0,18740
421715,201702,8,7,1,6559,937,7496
421720,201702,546,389,157,362515.3,145413.54,507928.84
421725,201702,12,6,6,5622,5622,11244
421730,201702,39,29,10,26455.48,9370,35825.48
421740,201702,79,37,42,34669,39354,74023
421750,201702,215,156,59,144580.1,55283,199863.1
421755,201702,24,22,2,20614,1874,22488
421760,201702,104,77,27,72139.63,25299,97438.63
421770,201702,519,362,157,337774.52,146772.15,484546.67
421775,201702,22,14,8,13118,7496,20614
421780,201702,183,143,40,133709.9,37480,171189.9
421790,201702,156,132,24,123684,22488,146172
421795,201702,13,11,2,10307,1874,12181
421800,201702,433,276,157,256892.61,147104.32,403996.93
421810,201702,72,56,16,51536,14992,66528
421820,201702,279,186,93,173317.1,87141,260458.1
421825,201702,129,103,26,96511,24362,120873
421830,201702,137,106,31,99322,29047,128369
421835,201702,3,3,0,2811,0,2811
421840,201702,57,48,9,44976,8433,53409
421850,201702,71,61,10,57157,9366,66523
421860,201702,42,32,10,29703,9370,39073
421870,201702,937,704,233,654263.9,218302.63,872566.53
421875,201702,48,43,5,40291,4685,44976
421880,201702,147,105,42,98385,39073,137458
421885,201702,26,21,5,19677,4404,24081
421890,201702,112,78,34,73086,31858,104944
421895,201702,35,33,2,30921,1874,32795
421900,201702,143,113,30,105807.15,28065,133872.15
421910,201702,62,41,21,38417,19677,58094
421915,201702,31,24,7,22488,6559,29047
421917,201702,36,26,10,24081,9370,33451
421920,201702,33,30,3,28110,2811,30921
421930,201702,748,569,179,532815.68,167686.63,700502.31
421935,201702,58,51,7,47787,6559,54346
421940,201702,44,39,5,36543,4685,41228
421950,201702,818,531,287,491501.84,266460.4,757962.24
421960,201702,40,35,5,32514,4685,37199
421970,201702,355,224,131,209398.12,122696.01,332094.13
421985,201702,28,20,8,18740,7496,26236
422000,201702,0,0,0,0,0,0
430003,201702,210,44,166,40525.25,155542,196067.25
430005,201702,29,23,6,21551,5622,27173
430010,201702,286,198,88,185057.5,82456,267513.5
430020,201702,157,100,57,93419,52472,145891
430030,201702,118,89,29,83393,27173,110566
430040,201702,2958,1703,1255,1588685.15,1175298.58,2763983.73
430045,201702,63,54,9,50598,8433,59031
430047,201702,7,6,1,5622,937,6559
430050,201702,78,65,13,60905,12181,73086
430055,201702,17,14,3,13118,2811,15929
430057,201702,4,2,2,1874,1874,3748
430060,201702,3663,2162,1501,2018313.82,1401909.49,3420223.31
430063,201702,52,45,7,42165,6559,48724
430064,201702,136,113,23,105178.25,21551,126729.25
430066,201702,10,7,3,6559,2811,9370
430070,201702,49,37,12,34669,11244,45913
430080,201702,67,46,21,42414.8,19677,62091.8
430085,201702,35,9,26,8433,24362,32795
430087,201702,38,28,10,26096,9370,35466
430090,201702,68,62,6,57531.8,5622,63153.8
430100,201702,116,76,40,71212,37461.26,108673.26
430105,201702,140,71,69,66527,64353.16,130880.16
430107,201702,21,16,5,14992,4685,19677
430110,201702,386,224,162,209091.55,151728.41,360819.96
430120,201702,139,123,16,114314.95,14992,129306.95
430130,201702,769,474,295,443528.95,276133.9,719662.85
430140,201702,133,124,9,116188,8433,124621
430150,201702,101,67,34,62030,31858,93888
430155,201702,29,27,2,25299,1874,27173
430160,201702,3782,2236,1546,2077003.35,1444601.11,3521604.46
430163,201702,307,132,175,122588.68,163900.04,286488.72
430165,201702,22,16,6,14992,5622,20614
430170,201702,76,71,5,66527,4685,71212
430175,201702,80,61,19,57157,17147.1,74304.1
430180,201702,91,72,19,67464,17193.95,84657.95
430185,201702,35,26,9,24362,8433,32795
430187,201702,110,44,66,41228,61542.9,102770.9
430190,201702,228,129,99,120826.15,92097.73,212923.88
430192,201702,13,13,0,12181,0,12181
430195,201702,13,9,4,8433,3748,12181
430200,201702,162,143,19,133335.1,17803,151138.1
430205,201702,19,18,1,16866,937,17803
430210,201702,575,433,142,402628.9,131789.15,534418.05
430215,201702,17,14,3,13118,2811,15929
430220,201702,61,41,20,38417,18740,57157
430222,201702,13,7,6,6559,5622,12181
430223,201702,13,7,6,6559,5622,12181
430225,201702,4,3,1,2811,937,3748
430230,201702,289,179,110,165849,102882.6,268731.6
430235,201702,44,31,13,29047,12171.63,41218.63
430237,201702,27,21,6,19677,5622,25299
430240,201702,130,77,53,72149,49651.63,121800.63
430245,201702,63,51,12,47787,11244,59031
430250,201702,195,115,80,107745.63,74950.63,182696.26
430258,201702,12,10,2,9370,1874,11244
430260,201702,36,31,5,29047,3879.18,32926.18
430265,201702,34,27,7,25280.26,6559,31839.26
430270,201702,587,434,153,403602.3,141581.81,545184.11
430280,201702,1014,636,378,593017.93,351731.8,944749.73
430290,201702,364,209,155,193959.4,145235,339194.4
430300,201702,2086,1140,946,1061932.76,882647.07,1944579.83
430310,201702,1993,1022,971,951817,907042.01,1858859.01
430320,201702,48,40,8,37465.95,7496,44961.95
430330,201702,101,91,10,85267,9370,94637
430340,201702,65,58,7,54346,6559,60905
430350,201702,1649,1149,500,1065061.49,467057.76,1532119.25
430355,201702,26,24,2,22488,1874,24362
430360,201702,79,34,45,31858,41228.1,73086.1
430367,201702,29,19,10,17803,8592.29,26395.29
430370,201702,56,49,7,45913,6559,52472
430380,201702,119,88,31,81893.8,29047,110940.8
430390,201702,605,377,228,352967.9,213336.63,566304.53
430400,201702,133,104,29,95761.4,27154.26,122915.66
430410,201702,57,45,12,42165,11244,53409
430420,201702,464,308,156,287097.9,143952.58,431050.48
430430,201702,51,49,2,45288.95,1874,47162.95
430435,201702,150,110,40,102788.9,36777.25,139566.15
430440,201702,507,335,172,313895,160976.6,474871.6
430450,201702,1160,955,205,887434.37,192075.63,1079510.00
430460,201702,5060,2729,2331,2542117.89,2176296.4,4718414.29
430461,201702,20,18,2,16866,1874,18740
430462,201702,11,7,4,6559,3748,10307
430463,201702,953,493,460,459271.39,430674.05,889945.44
430465,201702,28,17,11,15929,10307,26236
430466,201702,621,451,170,421369,159102.6,580471.6
430467,201702,86,49,37,45913,34659.63,80572.63
430468,201702,111,65,46,60905,42846.02,103751.02
430469,201702,22,16,6,14992,5622,20614
430470,201702,1143,642,501,593887.37,467525.52,1061412.89
430471,201702,48,36,12,33713.26,10972,44685.26
430480,201702,95,60,35,55376.7,32785.63,88162.33
430485,201702,5,5,0,4404,0,4404
430490,201702,92,73,19,67979.35,17803,85782.35
430495,201702,29,24,5,22488,4685,27173
430500,201702,188,127,61,118296.25,56787.63,175083.88
430510,201702,2851,1878,973,1754327.35,910829.96,2665157.31
430511,201702,18,18,0,16866,0,16866
430512,201702,136,92,44,86204,41228,127432
430513,201702,52,47,5,43570.5,4685,48255.5
430515,201702,30,28,2,26236,1874,28110
430517,201702,165,144,21,133991.25,19658.26,153649.51
430520,201702,364,246,118,229837.63,110528.52,340366.15
430530,201702,91,50,41,46850,38417,85267
430535,201702,461,296,165,277117.75,154591.32,431709.07
430537,201702,14,14,0,13118,0,13118
430540,201702,76,49,27,45913,25299,71212
430543,201702,370,115,255,107755,238701,346456
430544,201702,42,39,3,36543,2811,39354
430545,201702,325,144,181,134862.41,169109.76,303972.17
430550,201702,46,38,8,35606,7496,43102
430558,201702,5,3,2,2811,1874,4685
430560,201702,47,20,27,18740,25299,44039
430570,201702,98,45,53,42165,49604.78,91769.78
430580,201702,125,96,29,89952,27126.15,117078.15
430583,201702,16,16,0,14992,0,14992
430585,201702,8,4,4,3748,3748,7496
430587,201702,15,8,7,7496,6559,14055
430590,201702,153,128,25,118717.9,23425,142142.9
430593,201702,4,4,0,3748,0,3748
430595,201702,16,10,6,9370,5622,14992
430597,201702,55,29,26,27173,24362,51535
430600,201702,212,142,70,133044.63,65308.9,198353.53
430605,201702,152,93,59,87141,55273.63,142414.63
430607,201702,26,22,4,20614,3748,24362
430610,201702,1604,732,872,681762.05,812145.12,1493907.17
430613,201702,2,2,0,1874,0,1874
430620,201702,112,82,30,76694,28091.26,104785.26
430630,201702,47,44,3,41228,2811,44039
430632,201702,32,28,4,26236,3748,29984
430635,201702,41,37,4,34669,3748,38417
430637,201702,62,35,27,32795,25299,58094
430640,201702,205,112,93,104100.7,87141,191241.7
430642,201702,27,25,2,23425,1874,25299
430645,201702,30,26,4,24362,3748,28110
430650,201702,246,193,53,180560,49614.15,230174.15
430655,201702,7,6,1,5622,937,6559
430660,201702,965,464,501,433034.55,467225.78,900260.33
430670,201702,69,49,20,45913,18740,64653
430673,201702,77,42,35,39354,32795,72149
430675,201702,13,10,3,9370,2811,12181
430676,201702,453,267,186,249466.88,174211.84,423678.72
430680,201702,247,169,78,156198,73086,229284
430690,201702,512,305,207,284894.85,191395.01,476289.86
430692,201702,7,5,2,4685,1874,6559
430693,201702,124,80,44,74960,40609.58,115569.58
430695,201702,64,58,6,53310.72,5622,58932.72
430697,201702,62,37,25,34669,23425,58094
430700,201702,1555,1087,468,1010795.71,438516,1449311.71
430705,201702,19,18,1,16866,937,17803
430710,201702,255,164,91,153668,85267,238935
430720,201702,107,93,14,86953.6,13118,100071.6
430730,201702,121,98,23,90889,20370.38,111259.38
430740,201702,56,40,16,37480,14992,52472
430745,201702,37,29,8,27173,7496,34669
430750,201702,333,229,104,213700.72,96511,310211.72
430755,201702,81,48,33,44976,30921,75897
430760,201702,352,210,142,194194.01,133026.26,327220.27
430770,201702,1445,741,704,692284.66,655261.19,1347545.85
430780,201702,308,195,113,182424.9,105815.78,288240.68
430781,201702,27,23,4,21551,3748,25299
430783,201702,45,36,9,33419.8,8433,41852.8
430786,201702,6,3,3,2811,2811,5622
430790,201702,450,292,158,272104.8,147755.63,419860.43
430800,201702,152,126,26,118062,24362,142424
430805,201702,40,38,2,35606,1874,37480
430807,201702,31,19,12,17803,11244,29047
430810,201702,68,43,25,40291,23425,63716
430820,201702,126,74,52,69338,48068.1,117406.1
430825,201702,11,9,2,8433,1874,10307
430830,201702,228,211,17,197426,15929,213355
430840,201702,115,75,40,70275,36824.1,107099.1
430843,201702,4,3,1,2811,937,3748
430845,201702,68,40,28,37480,26236,63716
430850,201702,560,386,174,361632.41,162899.67,524532.08
430860,201702,146,92,54,84892.2,49932.73,134824.93
430865,201702,63,30,33,27454.1,30611.79,58065.89
430870,201702,73,60,13,56220,12181,68401
430880,201702,148,113,35,105881,32795,138676
430885,201702,7,6,1,5622,937,6559
430890,201702,328,198,130,183895.94,121529,305424.94
430900,201702,553,375,178,347147.92,166308.13,513456.05
430905,201702,78,32,46,29984,43102,73086
430910,201702,262,149,113,139613,105872,245485
430912,201702,7,7,0,6559,0,6559
430915,201702,28,20,8,18740,7214.9,25954.9
430920,201702,3921,2180,1741,2037125.85,1629082.42,3666208.27
430925,201702,7,6,1,5378.38,937,6315.38
430930,201702,2022,1202,820,1118658.78,766198.35,1884857.13
430940,201702,225,138,87,128359.63,81500.26,209859.89
430950,201702,158,125,33,117125,30639.9,147764.9
430955,201702,18,11,7,10307,6559,16866
430957,201702,17,16,1,14992,937,15929
430960,201702,237,152,85,141346.45,79645,220991.45
430965,201702,91,58,33,54346,30921,85267
430970,201702,77,64,13,59968,11244,71212
430975,201702,33,31,2,29047,1874,30921
430980,201702,47,30,17,28110,15929,44039
430990,201702,105,79,26,74023,24362,98385
430995,201702,114,110,4,102133,3748,105881
431000,201702,296,134,162,124332.1,151794,276126.1
431010,201702,335,198,137,184560.89,128369,312929.89
431020,201702,1883,1070,813,996990.99,758679.53,1755670.52
431030,201702,39,31,8,29047,7496,36543
431033,201702,365,179,186,166926.6,174282,341208.6
431036,201702,14,9,5,8433,4685,13118
431040,201702,132,78,54,72149,50490.25,122639.25
431041,201702,36,25,11,23425,10307,33732
431043,201702,41,23,18,21551,16866,38417
431046,201702,11,7,4,6559,3748,10307
431050,201702,211,134,77,123154.84,70642.29,193797.13
431053,201702,68,41,27,37667.4,25299,62966.4
431055,201702,63,40,23,37480,21532.26,59012.26
431057,201702,16,16,0,14992,0,14992
431060,201702,1670,1036,634,964586.83,592284.91,1556871.74
431065,201702,17,11,6,10307,5622,15929
431070,201702,68,64,4,59968,3748,63716
431075,201702,10,10,0,9370,0,9370
431080,201702,141,92,49,84211.94,45913,130124.94
431085,201702,27,24,3,22488,2811,25299
431087,201702,13,13,0,12181,0,12181
431090,201702,52,42,10,39354,9370,48724
431100,201702,1227,729,498,673704.71,466626,1140330.71
431110,201702,246,153,93,143361,87131.63,230492.63
431112,201702,30,19,11,17803,10307,28110
431113,201702,30,20,10,18740,9370,28110
431115,201702,156,105,51,97760.2,47777.63,145537.83
431120,201702,614,363,251,337939.42,235131.52,573070.94
431123,201702,4,4,0,3748,0,3748
431125,201702,88,79,9,74023,8433,82456
431127,201702,7,2,5,1874,4685,6559
431130,201702,596,390,206,363274.9,193012.63,556287.53
431140,201702,684,456,228,424226.75,213579.78,637806.53
431142,201702,30,23,7,20361,6559,26920
431150,201702,204,150,54,140550,50579.26,191129.26
431160,201702,55,48,7,44976,6559,51535
431162,201702,20,15,5,14055,4685,18740
431164,201702,4,4,0,3748,0,3748
431170,201702,99,82,17,76834,15929,92763
431171,201702,45,24,21,22488,19667.63,42155.63
431173,201702,1,1,0,937,0,937
431175,201702,198,95,103,87797,96511,184308
431177,201702,74,56,18,52472,16847.26,69319.26
431179,201702,14,12,2,11244,1874,13118
431180,201702,425,259,166,241746,155523.63,397269.63
431190,201702,91,68,23,63716,21551,85267
431198,201702,65,44,21,41228,19677,60905
431200,201702,18,16,2,14992,1874,16866
431205,201702,28,28,0,26236,0,26236
431210,201702,79,49,30,45586,28110,73696
431213,201702,26,21,5,19677,4685,24362
431215,201702,26,23,3,21551,2811,24362
431217,201702,3,2,1,1874,937,2811
431220,201702,60,51,9,47787,8433,56220
431225,201702,142,94,48,88069,44966.63,133035.63
431230,201702,89,76,13,70556.1,12181,82737.1
431235,201702,8,8,0,7496,0,7496
431237,201702,24,16,8,14992,7496,22488
431238,201702,15,11,4,10026,3748,13774
431240,201702,964,605,359,564337.16,335334.48,899671.64
431242,201702,37,37,0,34669,0,34669
431244,201702,12,9,3,8433,2811,11244
431245,201702,63,48,15,44976,14055,59031
431247,201702,13,9,4,8433,3748,12181
431250,201702,269,137,132,128350.26,123656.26,252006.52
431260,201702,60,44,16,41228,14992,56220
431261,201702,23,15,8,14055,7496,21551
431262,201702,18,18,0,16866,0,16866
431265,201702,166,86,80,80582,74960,155542
431267,201702,14,13,1,12181,937,13118
431270,201702,301,249,52,233313,48068.1,281381.1
431275,201702,40,38,2,35606,1874,37480
431280,201702,20,15,5,13235.12,4685,17920.12
431290,201702,23,20,3,18740,2811,21551
431295,201702,5,5,0,4685,0,4685
431300,201702,21,18,3,16866,2811,19677
431301,201702,8,7,1,6559,937,7496
431303,201702,47,33,14,30799.19,12836.9,43636.09
431306,201702,209,112,97,104496.11,90889,195385.11
431308,201702,6,5,1,4685,937,5622
431310,201702,69,58,11,54346,10307,64653
431320,201702,110,66,44,61842,41218.63,103060.63
431330,201702,178,117,61,109629,57157,166786
431333,201702,32,26,6,24362,5622,29984
431335,201702,12,7,5,6559,4685,11244
431337,201702,303,146,157,135988.1,146752.94,282741.04
431339,201702,14,11,3,10307,2811,13118
431340,201702,2960,1675,1285,1565854.78,1202088.63,2767943.41
431342,201702,40,24,16,22488,14992,37480
431344,201702,16,16,0,14992,0,14992
431346,201702,4,4,0,3748,0,3748
431349,201702,36,33,3,30921,2811,33732
431350,201702,896,529,367,491168.99,342932.63,834101.62
431360,201702,42,39,3,36543,2811,39354
431365,201702,314,147,167,137720.26,156469.63,294189.89
431370,201702,1284,761,523,710378.14,489866.19,1200244.33
431380,201702,103,86,17,79926.1,15929,95855.1
431390,201702,485,267,218,249242.1,202656.01,451898.11
431395,201702,275,120,155,112440,145217,257657
431400,201702,35,27,8,25299,7496,32795
431402,201702,87,59,28,55283,26236,81519
431403,201702,15,9,6,8433,5622,14055
431405,201702,641,344,297,321231.81,278262,599493.81
431406,201702,30,26,4,24362,3748,28110
431407,201702,48,43,5,40291,4685,44976
431410,201702,2998,1741,1257,1620583.64,1176853.26,2797436.90
431413,201702,15,14,1,13118,937,14055
431415,201702,72,51,21,47787,19677,67464
431417,201702,21,11,10,10307,9370,19677
431420,201702,287,206,81,192397.3,75887.63,268284.93
431430,201702,40,15,25,14055,23425,37480
431440,201702,8782,6247,2535,5793820.98,2368713.83,8162534.81
431442,201702,28,15,13,14055,12181,26236
431445,201702,26,20,6,18740,5622,24362
431446,201702,8,7,1,6559,937,7496
431447,201702,84,58,26,54346,24362,78708
431449,201702,47,44,3,41228,2811,44039
431450,201702,398,284,114,264374.55,106115.25,370489.80
431454,201702,0,0,0,0,0,0
431455,201702,46,35,11,32795,10307,43102
431460,201702,502,340,162,315019.4,151372.9,466392.3
431470,201702,122,93,29,86461.86,27173,113634.86
431475,201702,10,10,0,9370,0,9370
431477,201702,31,21,10,19677,9370,29047
431478,201702,6,5,1,4685,937,5622
431480,201702,485,303,182,282458.65,170224.79,452683.44
431490,201702,27946,15648,12298,14595381.3,11490315.59,26085696.89
431500,201702,73,53,20,49661,18740,68401
431505,201702,45,17,28,15929,26236,42165
431507,201702,7,6,1,5622,937,6559
431510,201702,291,183,108,170768.9,99303.26,270072.16
431513,201702,22,17,5,15929,4685,20614
431514,201702,6,5,1,4685,937,5622
431515,201702,76,66,10,61842,9370,71212
431517,201702,3,1,2,937,1874,2811
431520,201702,35,31,4,29047,3748,32795
431530,201702,1621,712,909,665834.42,851278.67,1517113.09
431531,201702,22,21,1,19677,937,20614
431532,201702,22,16,6,14992,5622,20614
431535,201702,22,14,8,13118,7496,20614
431540,201702,144,127,17,117996.41,15929,133925.41
431545,201702,19,16,3,14992,2811,17803
431550,201702,337,191,146,178967,136708.3,315675.3
431555,201702,11,10,1,9370,937,10307
431560,201702,4200,2951,1249,2737043.63,1168895.82,3905939.45
431570,201702,749,395,354,366554.6,329750.04,696304.64
431575,201702,35,24,11,22488,10307,32795
431580,201702,89,60,29,55283,27173,82456
431590,201702,122,101,21,94402.75,19667.63,114070.38
431595,201702,12,11,1,10307,937,11244
431600,201702,205,115,90,107755,84330,192085
431610,201702,128,93,35,86485.1,32795,119280.1
431620,201702,41,34,7,31858,6559,38417
431630,201702,119,101,18,94637,16866,111503
431640,201702,1310,821,489,766091.2,457031.96,1223123.16
431642,201702,44,40,4,37011.5,3748,40759.5
431643,201702,47,21,26,19677,24362,44039
431645,201702,297,168,129,157416,119936,277352
431647,201702,12,12,0,11244,0,11244
431650,201702,34,24,10,22488,9370,31858
431660,201702,258,169,89,158353,83393,241746
431670,201702,212,99,113,91123.25,105852.89,196976.14
431673,201702,3,3,0,2811,0,2811
431675,201702,30,26,4,24080.9,3748,27828.9
431680,201702,1049,743,306,691974.5,286469.75,978444.25
431690,201702,4689,2864,1825,2668524.41,1704892.99,4373417.40
431695,201702,24,18,6,16866,5622,22488
431697,201702,0,0,0,0,0,0
431700,201702,163,122,41,114314,38417,152731
431710,201702,3958,1692,2266,1583895.9,2121812.71,3705708.61
431720,201702,1372,806,566,747507.18,528454.63,1275961.81
431725,201702,1,1,0,937,0,937
431730,201702,1143,759,384,705562.2,359808,1065370.2
431740,201702,1358,674,684,627004.26,640347.7,1267351.96
431750,201702,1861,1202,659,1116816.82,614644.36,1731461.18
431755,201702,5,4,1,3748,937,4685
431760,201702,1085,686,399,642407.2,373638.49,1016045.69
431770,201702,385,285,100,266754.63,93681.26,360435.89
431775,201702,26,20,6,18740,5622,24362
431780,201702,564,347,217,324145.78,203319.63,527465.41
431790,201702,139,106,33,98385,30874.15,129259.15
431795,201702,14,13,1,12181,937,13118
431800,201702,3415,1779,1636,1653905.26,1524941.78,3178847.04
431805,201702,18,15,3,14055,2811,16866
431810,201702,603,404,199,376898.88,186159.69,563058.57
431820,201702,307,172,135,161164,125511.15,286675.15
431830,201702,2307,1391,916,1300092.2,856851.51,2156943.71
431840,201702,502,331,171,306588.65,158972.31,465560.96
431842,201702,32,27,5,25299,4685,29984
431843,201702,11,7,4,6559,3748,10307
431844,201702,14,12,2,11244,1874,13118
431845,201702,29,27,2,25299,1874,27173
431846,201702,28,24,4,22488,3748,26236
431848,201702,13,11,2,10307,1874,12181
431849,201702,8,6,2,5622,1874,7496
431850,201702,774,642,132,600045.9,123449.75,723495.65
431860,201702,105,75,30,70275,27173,97448
431861,201702,5,3,2,2811,1874,4685
431862,201702,50,35,15,32795,14055,46850
431870,201702,3395,1976,1419,1845375.39,1328332.86,3173708.25
431880,201702,884,657,227,610878,211762,822640
431890,201702,1299,796,503,742731.79,469639,1212370.79
431900,201702,175,125,50,117125,46850,163975
431910,201702,50,37,13,34669,12181,46850
431912,201702,35,20,15,18740,14055,32795
431915,201702,126,102,24,95574,22488,118062
431920,201702,141,107,34,100259,31858,132117
431930,201702,83,66,17,61842,15929,77771
431935,201702,4,3,1,2811,937,3748
431936,201702,12,11,1,10307,937,11244
431937,201702,15,10,5,9370,4685,14055
431940,201702,442,289,153,268965.85,143351.63,412317.48
431950,201702,459,293,166,273276.42,153986.95,427263.37
431960,201702,705,429,276,397880.42,258453.45,656333.87
431970,201702,74,66,8,61842,7496,69338
431971,201702,3,3,0,2811,0,2811
431973,201702,13,12,1,11244,937,12181
431975,201702,6,5,1,4685,937,5622
431980,201702,198,128,70,119373.8,65590,184963.8
431990,201702,1202,645,557,602918.09,521599.9,1124517.99
432000,201702,1630,866,764,806583.07,713024.86,1519607.93
432010,201702,282,187,95,174126.3,89015,263141.3
432020,201702,166,131,35,122747,32785.63,155532.63
432023,201702,21,16,5,14992,4685,19677
432026,201702,61,55,6,51535,5622,57157
432030,201702,62,33,29,30921,27173,58094
432032,201702,23,19,4,17803,3748,21551
432035,201702,42,34,8,31858,7496,39354
432040,201702,93,64,29,59968,27173,87141
432045,201702,9,8,1,7214.9,937,8151.9
432050,201702,63,37,26,34669,24362,59031
432055,201702,98,75,23,70256.26,21551,91807.26
432057,201702,0,0,0,0,0,0
432060,201702,38,34,4,31155.25,3748,34903.25
432065,201702,30,27,3,25299,2811,28110
432067,201702,95,83,12,77771,11244,89015
432070,201702,397,295,102,274123.92,95546.26,369670.18
432080,201702,798,542,256,506917,239825.89,746742.89
432085,201702,14,11,3,10307,2811,13118
432090,201702,253,167,86,156479,80582,237061
432100,201702,171,112,59,104662.9,55283,159945.9
432110,201702,590,401,189,369488.62,176156,545644.62
432120,201702,958,556,402,520316.1,376624.77,896940.87
432130,201702,483,348,135,325139,126354.45,451493.45
432132,201702,31,28,3,26236,2811,29047
432135,201702,77,63,14,59031,13118,72149
432140,201702,282,215,67,200883.43,62779,263662.43
432143,201702,178,113,65,105881,60905,166786
432145,201702,254,174,80,161820.8,74960,236780.8
432146,201702,15,14,1,13118,937,14055
432147,201702,173,62,111,58094,103988.26,162082.26
432149,201702,14,11,3,10307,2811,13118
432150,201702,818,514,304,480446.75,283133.39,763580.14
432160,201702,1362,703,659,657040.51,616603.19,1273643.70
432162,201702,4,3,1,2811,937,3748
432163,201702,18,14,4,13118,3748,16866
432166,201702,125,91,34,85502,31858,117360
432170,201702,229,123,106,113659,99322,212981
432180,201702,520,314,206,293562.1,192741,486303.1
432183,201702,10,7,3,6559,2811,9370
432185,201702,77,65,12,60811.3,11244,72055.3
432190,201702,487,243,244,226557.63,228451.08,455008.71
432195,201702,83,71,12,65824.25,11244,77068.25
432200,201702,392,250,142,234250,132980.26,367230.26
432210,201702,112,73,39,66386.45,36543,102929.45
432215,201702,65,60,5,56220,4919.25,61139.25
432218,201702,20,19,1,17803,937,18740
432220,201702,667,331,336,309146.05,313108.62,622254.67
432225,201702,16,11,5,9838.5,4685,14523.5
432230,201702,159,86,73,80347.75,68354.15,148701.90
432232,201702,14,12,2,11244,1874,13118
432234,201702,6,5,1,4685,937,5622
432235,201702,1,1,0,937,0,937
432237,201702,28,15,13,14055,12181,26236
432240,201702,4071,2246,1825,2095455.07,1704413.24,3799868.31
432250,201702,995,605,390,564309.38,364333.71,928643.09
432252,201702,40,33,7,30190.14,6559,36749.14
432253,201702,55,46,9,43102,8433,51535
432254,201702,19,7,12,6559,11244,17803
432255,201702,14,13,1,12181,937,13118
432260,201702,836,649,187,606848.15,174282.75,781130.90
432270,201702,216,155,61,145235,57157,202392
432280,201702,112,78,34,72597.9,31858,104455.9
432285,201702,2,1,1,937,937,1874
432290,201702,66,61,5,55564.1,4685,60249.1
432300,201702,4589,2603,1986,2423337.11,1856447.51,4279784.62
432310,201702,116,91,25,85267,23425,108692
432320,201702,20,14,6,13118,5622,18740
432330,201702,12,6,6,5622,5622,11244
432335,201702,8,7,1,6559,937,7496
432340,201702,43,38,5,35606,4685,40291
432345,201702,85,61,24,57157,22488,79645
432350,201702,24,23,1,21551,937,22488
432360,201702,7,5,2,4685,1874,6559
432370,201702,25,24,1,22206.9,937,23143.9
432375,201702,42,36,6,33732,5622,39354
432377,201702,7,7,0,6559,0,6559
432380,201702,153,67,86,62077.1,80582,142659.1
500020,201702,225,116,109,108692,101543.06,210235.06
500025,201702,108,52,56,48724,52472,101196
500060,201702,1350,793,557,742759.9,521314.21,1264074.11
500070,201702,690,320,370,299840,346409,646249
500080,201702,134,101,33,94637,30359,124996
500085,201702,142,115,27,107464.63,24479.13,131943.76
500090,201702,337,156,181,146172,169597,315769
500100,201702,677,363,314,338500.3,293656,632156.3
500110,201702,2234,962,1272,901076.63,1190799.83,2091876.46
500124,201702,310,177,133,165849,124339.9,290188.9
500150,201702,328,122,206,114305,192668,306973
500190,201702,523,354,169,331042.1,157872,488914.1
500200,201702,194,165,29,154247.89,27173,181420.89
500210,201702,1422,497,925,465375.48,865654.47,1331029.95
500215,201702,229,129,100,119932.21,93700,213632.21
500220,201702,780,511,269,478585.26,251309.63,729894.89
500230,201702,256,175,81,163272.25,75428.5,238700.75
500240,201702,704,486,218,455382,203797.9,659179.9
500260,201702,556,196,360,183652,337320,520972
500270,201702,27950,11702,16248,10938054,15206300.46,26144354.46
500280,201702,193,73,120,68401,112431,180832
500290,201702,1170,656,514,613736,480392,1094128
500295,201702,379,224,155,209888,145225.63,355113.63
500310,201702,69,21,48,19677,44976,64653
500315,201702,693,399,294,373853.63,275187.53,649041.16
500320,201702,3613,1785,1828,1671098.39,1711299.47,3382397.86
500325,201702,934,502,432,469906,403826.32,873732.32
500330,201702,1470,649,821,605275.76,768392.7,1373668.46
500345,201702,324,233,91,217375.1,85267,302642.1
500348,201702,231,132,99,123684,92744.63,216428.63
500350,201702,145,70,75,65590,70275,135865
500370,201702,5354,2369,2985,2212913.91,2794597.97,5007511.88
500375,201702,345,246,99,230492.63,92763,323255.63
500380,201702,586,334,252,312803.4,236105.63,548909.03
500390,201702,68,34,34,31858,31858,63716
500400,201702,212,142,70,133035.26,65581,198616.26
500410,201702,562,217,345,203283.58,323110.05,526393.63
500430,201702,533,365,168,342005,157416,499421
500440,201702,205,100,105,93039.42,98385,191424.42
500450,201702,419,179,240,167034.8,224496.23,391531.03
500460,201702,319,158,161,148036.63,150857,298893.63
500470,201702,434,340,94,317387.05,87132,404519.05
500480,201702,102,63,39,59031,36543,95574
500490,201702,106,40,66,37475.32,61842,99317.32
500500,201702,1405,472,933,440349.36,873316.22,1313665.58
500510,201702,50,37,13,34669,12172,46841
500515,201702,105,69,36,64653,33451,98104
500520,201702,358,205,153,191055,143357,334412
500525,201702,82,49,33,45913,30639.9,76552.9
500540,201702,883,363,520,340065.78,485869.35,825935.13
500560,201702,865,482,383,449917.03,358188.83,808105.86
500568,201702,959,562,397,521347,371703.32,893050.32
500570,201702,1198,675,523,630291.83,487515.39,1117807.22
500580,201702,335,168,167,156189.03,156457,312646.03
500600,201702,322,163,159,152032.93,148983,301015.93
500620,201702,863,607,256,562429.71,239684.6,802114.31
500625,201702,79,67,12,62084.78,11244,73328.78
500627,201702,21,10,11,9370,10307,19677
500630,201702,1562,813,749,759626.9,701527.22,1461154.12
500635,201702,518,281,237,262894.09,221900.34,484794.43
500640,201702,426,220,206,204547.5,192994.63,397542.13
500660,201702,5524,2091,3433,1957486.85,3212589.73,5170076.58
500690,201702,559,199,360,186148.87,336575.34,522724.21
500710,201702,355,170,185,159009,173054.9,332063.9
500720,201702,967,573,394,535491.32,368968.26,904459.58
500730,201702,187,102,85,95574,79359.22,174933.22
500740,201702,836,374,462,349156.14,432159.32,781315.46
500750,201702,135,41,94,38417,87769.16,126186.16
500755,201702,128,92,36,85923,33732,119655
500769,201702,719,397,322,371668.02,301701,673369.02
500770,201702,453,226,227,211471.53,212464.75,423936.28
500780,201702,171,114,57,106818,53409,160227
500790,201702,1045,509,536,476366.32,501910.63,978276.95
500793,201702,252,133,119,124621,111494,236115
500795,201702,182,126,56,118052.63,52463,170515.63
500797,201702,39,32,7,29984,6559,36543
500800,201702,414,177,237,165840,221787.9,387627.9
500830,201702,2112,1167,945,1090245.3,884322.33,1974567.63
500840,201702,144,107,37,100259,34660,134919
510010,201702,163,88,75,82446.63,70275,152721.63
510020,201702,488,230,258,215236.67,241195.64,456432.31
510025,201702,1644,918,726,859498.03,677105.54,1536603.57
510030,201702,584,302,282,282928.26,263483.32,546411.58
510035,201702,129,55,74,51507.63,69319.63,120827.26
510040,201702,368,154,214,144298,200078.53,344376.53
510050,201702,421,230,191,214791.47,178138.89,392930.36
510060,201702,103,47,56,44029.63,52462.63,96492.26
510080,201702,216,85,131,79621.95,122663.04,202284.99
510100,201702,76,35,41,32795,38398.26,71193.26
510120,201702,28,14,14,13118,13118,26236
510125,201702,396,240,156,224210.05,146149.26,370359.31
510130,201702,596,346,250,323762.96,233813.31,557576.27
510140,201702,380,128,252,119927,236099.32,356026.32
510160,201702,86,41,45,38417,42165,80582
510170,201702,849,522,327,488850.66,305113.85,793964.51
510180,201702,2788,1368,1420,1278757.68,1328756.17,2607513.85
510185,201702,10,4,6,3748,5622,9370
510190,201702,214,73,141,68401,132112.32,200513.32
510250,201702,2601,1496,1105,1400707.59,1034328.51,2435036.10
510260,201702,202,142,60,132863.15,56183.63,189046.78
510263,201702,442,238,204,221564.04,190405.89,411969.93
510267,201702,619,335,284,313516.78,265849.47,579366.25
510268,201702,51,27,24,25299,22488,47787
510269,201702,69,25,44,23416,41218.63,64634.63
510270,201702,400,203,197,190025.82,184160.57,374186.39
510279,201702,213,149,64,139595,59949.26,199544.26
510285,201702,177,73,104,68362.63,97448,165810.63
510300,201702,560,294,266,275047.85,249168.53,524216.38
510305,201702,210,93,117,87118.63,109536.41,196655.04
510310,201702,124,57,67,53409,62760.26,116169.26
510320,201702,834,517,317,484328.52,296608.26,780936.78
510325,201702,385,160,225,149870.63,210534.53,360405.16
510330,201702,414,228,186,213603,174263.26,387866.26
510335,201702,577,295,282,276368.89,263290.32,539659.21
510336,201702,49,34,15,31858,14055,45913
510337,201702,118,45,73,42155.63,68391.63,110547.26
510340,201702,17127,8252,8875,7708876.29,8304980.83,16013857.12
510343,201702,70,46,24,43092.63,22488,65580.63
510345,201702,162,105,57,98375.63,53118.63,151494.26
510350,201702,630,353,277,329555.74,259484.89,589040.63
510360,201702,213,122,91,114295.63,85175.89,199471.52
510370,201702,131,64,67,59949.26,62649.67,122598.93
510380,201702,91,63,28,59031,26227,85258
510385,201702,51,26,25,24362,23416,47778
510390,201702,133,53,80,49661,74913.15,124574.15
510395,201702,41,27,14,25299,13118,38417
510410,201702,683,445,238,416932,222982.95,639914.95
510420,201702,611,287,324,267989.4,301980.09,569969.49
510450,201702,54,34,20,31858,18740,50598
510452,201702,40,23,17,21551,15929,37480
510454,201702,69,28,41,26236,38407.63,64643.63
510455,201702,130,79,51,74004.26,47777.63,121781.89
510460,201702,181,89,92,83084.53,86166.89,169251.42
510480,201702,686,391,295,365242.31,276056.97,641299.28
510490,201702,357,182,175,170182.01,163434.13,333616.14
510500,201702,241,183,58,171461.63,54346,225807.63
510510,201702,779,442,337,413283.43,315759.63,729043.06
510515,201702,1144,586,558,548520.11,522788.89,1071309.00
510517,201702,249,108,141,100914.9,131812.85,232727.75
510520,201702,235,153,82,143287.89,76529.52,219817.41
510523,201702,94,60,34,56220,31848.63,88068.63
510525,201702,641,357,284,333765.89,266007.89,599773.78
510530,201702,15,11,4,10307,3748,14055
510550,201702,272,116,156,108231.46,146163,254394.46
510558,201702,285,134,151,125543.95,141459.26,267003.21
510560,201702,350,215,135,201455,126196,327651
510562,201702,640,434,206,405079.25,192533.5,597612.75
510590,201702,839,435,404,407557.89,378520.96,786078.85
510600,201702,250,136,114,127399.89,106776.58,234176.47
510610,201702,162,77,85,72130.26,79345.53,151475.79
510615,201702,183,69,114,64634.26,106818,171452.26
510617,201702,15,8,7,7496,6559,14055
510618,201702,117,56,61,52472,56688.5,109160.5
510619,201702,108,72,36,67455,33723,101178
510620,201702,194,108,86,101186.63,80582,181768.63
510621,201702,189,122,67,114023.9,62770,176793.9
510622,201702,418,270,148,252878.89,138358.26,391237.15
510623,201702,350,224,126,209869.63,117468.52,327338.15
510624,201702,84,39,45,36534,42165,78699
510625,201702,508,308,200,288368.78,186803.45,475172.23
510626,201702,105,63,42,59031,39354,98385
510627,201702,48,36,12,33732,11244,44976
510628,201702,168,99,69,92680.15,64569.04,157249.19
510629,201702,250,159,91,148973.63,84320.63,233294.26
510630,201702,464,232,232,217309.78,217052.85,434362.63
510631,201702,9,3,6,2811,5622,8433
510637,201702,342,190,152,177680.79,142278.52,319959.31
510642,201702,972,520,452,486894.79,423383.82,910278.61
510645,201702,0,0,0,0,0,0
510650,201702,1523,1004,519,940581.89,486206.78,1426788.67
510665,201702,82,39,43,36489,40273,76762
510670,201702,67,37,30,34669,28110,62779
510675,201702,1173,712,461,667102,431934.32,1099036.32
510677,201702,377,176,201,163915.15,188190.04,352105.19
510680,201702,113,65,48,60887,44967,105854
510682,201702,198,87,111,81203,104007,185210
510685,201702,58,42,16,39354,14992,54346
510700,201702,616,358,258,335327.89,241585.67,576913.56
510704,201702,1014,537,477,501009.72,444447.04,945456.76
510706,201702,124,59,65,55278.32,60868.26,116146.58
510710,201702,384,256,128,239696.93,119803.56,359500.49
510715,201702,64,47,17,44029.63,15929,59958.63
510718,201702,225,113,112,105788.78,104925.63,210714.41
510719,201702,32,18,14,16866,13118,29984
510720,201702,197,126,71,118053,66245.9,184298.9
510724,201702,88,35,53,32785.63,49628.89,82414.52
510726,201702,43,24,19,22478.63,17785,40263.63
510729,201702,79,37,42,34669,39307.15,73976.15
510730,201702,464,256,208,239863,194748.63,434611.63
510735,201702,103,43,60,40291,56220,96511
510740,201702,30,15,15,14055,14055,28110
510757,201702,18,14,4,13118,3748,16866
510760,201702,6892,3604,3288,3366823.25,3076037.24,6442860.49
510770,201702,740,349,391,326837.15,366176.15,693013.30
510774,201702,14,7,7,6559,6559,13118
510775,201702,107,78,29,73076.63,27173,100249.63
510776,201702,25,6,19,5622,17803,23425
510777,201702,188,82,106,76805.89,99293.89,176099.78
510779,201702,52,24,28,22479,26172.26,48651.26
510780,201702,294,160,134,149848.26,125467.63,275315.89
510785,201702,450,242,208,226688.78,194792.93,421481.71
510787,201702,174,87,87,81505.32,81501.32,163006.64
510788,201702,0,0,0,0,0,0
510790,201702,2345,1212,1133,1132947.01,1059095.9,2192042.91
510792,201702,1011,568,443,531737.52,414675.64,946413.16
510794,201702,106,53,53,49661,49633.26,99294.26
510795,201702,2327,1333,994,1243021.69,929029.38,2172051.07
510800,201702,168,107,61,100249.63,57148,157397.63
510805,201702,161,112,49,104944,45913,150857
510810,201702,96,37,59,34577.89,55161.93,89739.82
510820,201702,275,129,146,120622.26,135819.71,256441.97
510830,201702,67,41,26,38417,24353,62770
510835,201702,1,0,1,0,937,937
510840,201702,9031,4514,4517,4216495.9,4224632.92,8441128.82
510850,201702,207,88,119,82446.63,111184.79,193631.42
510860,201702,392,170,222,159105.56,207279.05,366384.61
510880,201702,65,49,16,45894.63,14992,60886.63
510885,201702,65,40,25,37470.63,23387.89,60858.52
510890,201702,75,41,34,38417,31858,70275
510895,201702,178,101,77,94637,71845.63,166482.63
520005,201702,60,35,25,32795,23415.63,56210.63
520010,201702,293,125,168,117125,157323,274448
520013,201702,621,359,262,336346.63,245494,581840.63
520015,201702,49,35,14,32795,13118,45913
520017,201702,105,59,46,55002,43102,98104
520020,201702,30,15,15,14055,14055,28110
520025,201702,1918,1034,884,968858,827464.7,1796322.7
520030,201702,810,399,411,373854,384161,758015
520050,201702,79,52,27,48724,25299,74023
520055,201702,44,30,14,28110,13118,41228
520060,201702,176,113,63,105881,59031,164912
520080,201702,588,401,187,375737,175214.32,550951.32
520082,201702,20,14,6,13118,5622,18740
520085,201702,100,74,26,69338,24362,93700
520090,201702,80,55,25,51535,23425,74960
520110,201702,8931,3794,5137,3549300.91,4808349.24,8357650.15
520120,201702,13,8,5,7308.6,4685,11993.6
520130,201702,727,515,212,482546,198354,680900
520140,201702,11572,6502,5070,6085167.64,4747761.36,10832929.00
520145,201702,44,33,11,30921,10307,41228
520150,201702,184,144,40,134928,37480,172408
520160,201702,34,22,12,20614,11244,31858
520170,201702,227,138,89,129275,83357,212632
520180,201702,104,50,54,46850,50598,97448
520215,201702,215,128,87,119654.9,81237.9,200892.8
520235,201702,68,51,17,47787,15929,63716
520250,201702,135,81,54,75897,50316.9,126213.9
520260,201702,107,70,37,65590,33732,99322
520280,201702,48,33,15,30266,14055,44321
520310,201702,37,23,14,21551,13118,34669
520320,201702,166,102,64,95574,59968,155542
520330,201702,756,398,358,372889.63,335410,708299.63
520340,201702,362,201,161,188337,150811.63,339148.63
520350,201702,522,231,291,216447,272667,489114
520355,201702,91,50,41,46850,38417,85267
520357,201702,22,15,7,14055,6559,20614
520360,201702,0,0,0,0,0,0
520380,201702,145,76,69,71212,64653,135865
520390,201702,297,127,170,118250,159280.63,277530.63
520393,201702,12,9,3,8433,2811,11244
520396,201702,95,56,39,52472,36543,89015
520400,201702,228,134,94,123966.1,88078,212044.1
520410,201702,195,103,92,96493,86195,182688
520420,201702,24,16,8,14992,7496,22488
520425,201702,304,134,170,124622,158822.6,283444.6
520430,201702,442,228,214,213354.9,200181.9,413536.8
520440,201702,585,381,204,356997,191148,548145
520450,201702,1858,850,1008,795354.63,943841.95,1739196.58
520455,201702,59,39,20,36543,18740,55283
520460,201702,31,16,15,14992,14055,29047
520465,201702,20,17,3,15929,2811,18740
520470,201702,427,261,166,244357,155542,399899
520480,201702,78,46,32,43093,29939,73032
520485,201702,129,43,86,40291,80301,120592
520490,201702,365,272,93,254683.26,86979.84,341663.10
520495,201702,190,109,81,102133,75897,178030
520500,201702,186,141,45,132117,42165,174282
520505,201702,165,86,79,80582,74023,154605
520510,201702,1713,825,888,768722.3,829847.2,1598569.5
520520,201702,46,32,14,29984,13118,43102
520530,201702,245,175,70,161625.89,64804.79,226430.68
520540,201702,489,315,174,293871.81,163038,456909.81
520545,201702,155,83,72,77771,67464,145235
520547,201702,45,24,21,22488,19677,42165
520549,201702,968,453,515,424143,482027,906170
520551,201702,292,155,137,145235,128369,273604
520552,201702,43,24,19,22488,17803,40291
520570,201702,18,10,8,9370,7496,16866
520580,201702,284,174,110,163029,103070,266099
520590,201702,155,88,67,82456,62497.9,144953.9
520620,201702,1108,516,592,482743.14,553851.53,1036594.67
520630,201702,36,20,16,18740,14992,33732
520640,201702,412,234,178,219258,166786,386044
520650,201702,53,37,16,34669,14992,49661
520660,201702,33,18,15,16866,14055,30921
520670,201702,32,26,6,24362,5622,29984
520680,201702,68,46,22,43102,20614,63716
520690,201702,31,13,18,12181,16866,29047
520710,201702,39,36,3,33732,2811,36543
520725,201702,204,126,78,118062,73077,191139
520735,201702,55,44,11,41228,10307,51535
520740,201702,395,195,200,182013.2,187391,369404.2
520750,201702,36,27,9,25299,8433,33732
520753,201702,58,41,17,38417,15929,54346
520760,201702,110,73,37,68401,34669,103070
520780,201702,267,206,61,193022,57157,250179
520790,201702,168,77,91,71867.9,85267,157134.9
520800,201702,3540,1838,1702,1718117.68,1594109.45,3312227.13
520810,201702,164,112,52,104944,48724,153668
520815,201702,6,5,1,4685,937,5622
520830,201702,141,91,50,85267,46850,132117
520840,201702,314,203,111,189695.65,104007,293702.65
520850,201702,111,70,41,65581,38267.08,103848.08
520860,201702,1632,1010,622,945255.87,581316,1526571.87
520870,201702,29740,14677,15063,13726410.88,14100253.23,27826664.11
520880,201702,962,536,426,502232,399061.26,901293.26
520890,201702,799,457,342,426616.2,320070.63,746686.83
520910,201702,1020,525,495,488413.31,463815,952228.31
520915,201702,96,71,25,66527,23415.63,89942.63
520920,201702,433,210,223,196207.8,208951,405158.8
520929,201702,24,22,2,20614,1874,22488
520940,201702,75,44,31,41228,29047,70275
520945,201702,24,15,9,14055,8433,22488
520960,201702,51,31,20,29047,18740,47787
520970,201702,325,199,126,185845,117780.9,303625.9
520980,201702,108,79,29,74023,27173,101196
520990,201702,455,307,148,287434.12,138676,426110.12
520993,201702,121,55,66,51535,61833,113368
520995,201702,290,165,125,152967,116517,269484
521000,201702,1538,873,665,816315.4,622731,1439046.4
521010,201702,666,296,370,277112.23,346634.15,623746.38
521015,201702,16,9,7,8433,6559,14992
521020,201702,1467,1008,459,944487,429727.78,1374214.78
521030,201702,37,26,11,24362,10307,34669
521040,201702,903,541,362,506684,338006.89,844690.89
521056,201702,41,28,13,26236,12181,38417
521060,201702,133,82,51,76834,47787,124621
521080,201702,512,374,138,350429,129306,479735
521090,201702,517,297,220,278289,205868.27,484157.27
521100,201702,288,210,78,196770,73086,269856
521120,201702,1006,683,323,639409,302370,941779
521130,201702,360,253,107,237061,99669.9,336730.9
521140,201702,187,105,82,98385,76834,175219
521150,201702,2808,1175,1633,1098774.14,1528121.25,2626895.39
521160,201702,31,17,14,15929,13118,29047
521170,201702,150,84,66,78698.63,61842,140540.63
521180,201702,1082,671,411,627500.43,384404.25,1011904.68
521190,201702,2545,1060,1485,993220,1390097.16,2383317.16
521200,201702,43,31,12,29047,11244,40291
521205,201702,16,11,5,10307,4685,14992
521210,201702,155,86,69,80582,64653,145235
521220,201702,803,538,265,501520.78,248227,749747.78
521225,201702,20,11,9,10307,8433,18740
521230,201702,115,73,42,68401,39354,107755
521250,201702,6412,3605,2807,3372556.75,2626855.83,5999412.58
521260,201702,16,12,4,11244,3748,14992
521270,201702,153,116,37,108692,34669,143361
521280,201702,432,246,186,229846.1,174282,404128.1
521290,201702,33,14,19,13118,17803,30921
521295,201702,100,66,34,61336.02,31858,93194.02
521300,201702,224,112,112,104636,104580.89,209216.89
521305,201702,37,25,12,23425,11244,34669
521308,201702,1072,767,305,718178.78,285485.63,1003664.41
521310,201702,1331,776,555,726028.1,519155.26,1245183.36
521340,201702,23,17,6,15929,5622,21551
521350,201702,132,96,36,89952,33732,123684
521370,201702,199,123,76,114314,70930.9,185244.9
521375,201702,199,106,93,99322,86859.9,186181.9
521377,201702,50,33,17,30921,15929,46850
521380,201702,1054,686,368,638990.26,344816,983806.26
521385,201702,20,11,9,10307,8433,18740
521390,201702,107,85,22,79332.7,20614,99946.7
521400,201702,332,201,131,188055.9,122419.15,310475.05
521405,201702,152,74,78,68557.16,73086,141643.16
521410,201702,71,48,23,44976,21551,66527
521440,201702,224,157,67,146312.55,62779,209091.55
521450,201702,717,380,337,356060,315113.1,671173.1
521460,201702,1165,692,473,648123,443182.26,1091305.26
521470,201702,16,11,5,10307,4685,14992
521480,201702,57,35,22,32795,20550,53345
521483,201702,291,153,138,143080,129306,272386
521486,201702,300,180,120,168538.19,111785,280323.19
521487,201702,25,12,13,11244,12181,23425
521490,201702,28,16,12,14992,11244,26236
521500,201702,109,70,39,65590,36543,102133
521520,201702,43,32,11,29984,10307,40291
521523,201702,523,317,206,295482.95,193022,488504.95
521525,201702,48,31,17,29047,15929,44976
521530,201702,257,132,125,123684,117031.3,240715.3
521540,201702,32,18,14,16866,13118,29984
521550,201702,92,41,51,38117.63,47759.63,85877.26
521560,201702,760,517,243,484250.97,227410,711660.97
521565,201702,43,30,13,28110,12181,40291
521570,201702,482,319,163,298893.63,152638.15,451531.78
521580,201702,62,38,24,35606,22488,58094
521590,201702,36,18,18,16866,16866,33732
521600,201702,29,16,13,14992,12181,27173
521630,201702,228,115,113,107745.63,104907.88,212653.51
521640,201702,293,150,143,140550,133991,274541
521645,201702,31,16,15,14992,14055,29047
521680,201702,227,139,88,130243,82456,212699
521690,201702,1,1,0,937,0,937
521710,201702,1187,552,635,516661.9,594705,1111366.9
521720,201702,521,343,178,321391,166557.26,487948.26
521730,201702,638,315,323,295155,302370,597525
521740,201702,893,345,548,323246.63,512409.03,835655.66
521760,201702,1539,830,709,775935.08,664025,1439960.08
521770,201702,778,488,290,457145,271270.87,728415.87
521800,201702,2057,1236,821,1155511.2,768017.06,1923528.26
521805,201702,33,18,15,16866,14055,30921
521810,201702,94,56,38,51347.9,35606,86953.9
521830,201702,939,646,293,603710.08,274532,878242.08
521839,201702,89,62,27,58094,25299,83393
521850,201702,1094,588,506,550490.26,473774.04,1024264.30
521860,201702,347,212,135,198644,126214,324858
521870,201702,66,36,30,33732,28110,61842
521878,201702,52,22,30,20614,28110,48724
521880,201702,4225,1899,2326,1777135.33,2177053.2,3954188.53
521890,201702,552,376,176,352312,164621.9,516933.9
521900,201702,302,243,59,226785.2,55283,282068.2
521910,201702,151,106,45,99322,42165,141487
521920,201702,57,27,30,25299,28110,53409
521925,201702,34,20,14,18740,13118,31858
521930,201702,1073,608,465,569502.56,434944.46,1004447.02
521935,201702,29,21,8,19677,7496,27173
521940,201702,203,105,98,98385,91544.9,189929.9
521945,201702,16,14,2,13118,1874,14992
521950,201702,7,5,2,4685,1874,6559
521960,201702,72,48,24,44976,22488,67464
521970,201702,408,255,153,238653.9,143361,382014.9
521971,201702,95,47,48,44039,44976,89015
521973,201702,32,13,19,12181,17803,29984
521975,201702,1377,698,679,652397.6,634370.36,1286767.96
521980,201702,242,163,79,152572,74023,226595
521990,201702,72,54,18,50598,16866,67464
522000,201702,293,184,109,172408,102133,274541
522005,201702,22,13,9,12181,8433,20614
522010,201702,1096,603,493,563128.1,461369.43,1024497.53
522015,201702,59,36,23,33723,21551,55274
522020,201702,831,420,411,393540,384151.26,777691.26
522026,201702,27,19,8,17803,7496,25299
522028,201702,15,11,4,10307,3748,14055
522040,201702,707,274,433,256448,405666.63,662114.63
522045,201702,1946,1225,721,1147301.53,675052.9,1822354.43
522050,201702,181,87,94,81519,88078,169597
522060,201702,541,342,199,320172.9,186369.3,506542.2
522068,201702,133,84,49,78708,45913,124621
522070,201702,12,12,0,11244,0,11244
522100,201702,43,22,21,20352,19677,40029
522108,201702,40,30,10,28110,9370,37480
522119,201702,62,30,32,28110,29984,58094
522130,201702,73,23,50,21551,46814,68365
522140,201702,3677,1893,1784,1769687.8,1669640.42,3439328.22
522145,201702,56,33,23,30921,21551,52472
522150,201702,63,50,13,46850,12181,59031
522155,201702,57,40,17,37471,15929,53400
522157,201702,6,4,2,3748,1874,5622
522160,201702,1724,994,730,930253.6,683719.9,1613973.5
522170,201702,396,264,132,247368,123684,371052
522180,201702,40,21,19,19677,17803,37480
522185,201702,1196,479,717,446202.17,671707.88,1117910.05
522190,201702,47,26,21,24362,19583.3,43945.3
522200,201702,303,183,120,171471,112440,283911
522205,201702,165,113,52,105881,48724,154605
522220,201702,178,125,53,117125,49661,166786
522230,201702,32,25,7,23425,6559,29984
530010,201702,53232,27290,25942,25440731.48,24258614.99,49699346.47
110001,201703,500,391,109,364577.88,101298.64,465876.52
110002,201703,2630,1530,1100,1424217.41,1023623.51,2447840.92
110003,201703,88,69,19,64232.45,17682.89,81915.34
110004,201703,1915,1210,705,1125185.05,655669.17,1780854.22
110005,201703,429,347,82,322353.16,76182.32,398535.48
110006,201703,437,337,100,312802.73,92938.68,405741.41
110007,201703,78,63,15,58830.45,13974.89,72805.34
110008,201703,237,138,99,127868.23,92381.9,220250.13
110009,201703,745,495,250,460912.05,232801.26,693713.31
110010,201703,1775,1087,688,1011395.6,641446.33,1652841.93
110011,201703,1860,1424,436,1324637.42,405935.92,1730573.34
110012,201703,3977,2267,1710,2110848.18,1595864.3,3706712.48
110013,201703,715,523,192,486331.18,178600.7,664931.88
110014,201703,361,305,56,284744.23,52247.21,336991.44
110015,201703,1432,1145,287,1064874.26,266575.08,1331449.34
110018,201703,1105,649,456,604139.85,424860.59,1029000.44
110020,201703,14811,8678,6133,8029319.49,5693696.37,13723015.86
110025,201703,587,424,163,393687.96,151978.81,545666.77
110026,201703,44,30,14,27848.9,12997.56,40846.46
110028,201703,1575,1129,446,1046808.61,413569.1,1460377.71
110029,201703,132,114,18,106577.67,16846,123423.67
110030,201703,2419,1619,800,1503830.12,743341.31,2247171.43
110032,201703,375,287,88,267290.71,82191.01,349481.72
110033,201703,632,484,148,446523,137368.91,583891.91
110034,201703,361,263,98,243733.26,90568.89,334302.15
110037,201703,99,79,20,73942.78,18719.89,92662.67
110040,201703,317,210,107,195325.71,99477.35,294803.06
110045,201703,885,571,314,531079.32,291336.93,822416.25
110050,201703,95,74,21,68997.78,19596.78,88594.56
110060,201703,88,43,45,40090.89,41724.45,81815.34
110070,201703,128,76,52,70810.35,48121.57,118931.92
110080,201703,385,217,168,200067.37,156117.3,356184.67
110090,201703,27,22,5,20513.56,4644.78,25158.34
110092,201703,103,60,43,55959.01,39939.57,95898.58
110094,201703,191,130,61,120988.57,56635.79,177624.36
110100,201703,26,22,4,20493.78,3727.89,24221.67
110110,201703,68,41,27,38196.56,24797.56,62994.12
110120,201703,69,52,17,48463.56,15828.67,64292.23
110130,201703,295,243,52,224941.6,48423.34,273364.94
110140,201703,246,161,85,149986.96,79154.09,229141.05
110143,201703,43,37,6,34488.45,5561.67,40050.12
110145,201703,27,19,8,17722.89,7476,25198.89
110146,201703,21,13,8,12140.89,7455.89,19596.78
110147,201703,39,30,9,27990,8413,36403
110148,201703,36,25,11,23232.91,10287,33519.91
110149,201703,277,194,83,180592.94,77288.8,257881.74
110150,201703,75,46,29,42981.89,26892.34,69874.23
110155,201703,9,7,2,6519,1854,8373
110160,201703,70,58,12,53964.24,11163.67,65127.91
110170,201703,210,173,37,161120.78,34428.67,195549.45
110175,201703,25,19,6,17622.12,5601.89,23224.01
110180,201703,90,79,11,73942.78,10266.89,84209.67
120001,201703,125,83,42,76956,39325,116281
120005,201703,182,113,69,105838.12,64466,170304.12
120010,201703,967,637,330,590236.15,306762.52,896998.67
120013,201703,125,84,41,78120.77,37451.74,115572.51
120017,201703,73,49,24,45826.36,22467,68293.36
120020,201703,3398,2702,696,2504061.03,647345.28,3151406.31
120025,201703,613,338,275,314176.12,255932.37,570108.49
120030,201703,1017,842,175,781576.25,163252,944828.25
120032,201703,46,38,8,35584.12,7496,43080.12
120033,201703,210,185,25,173003.94,23425,196428.94
120034,201703,148,105,43,96489.12,40247.24,136736.36
120035,201703,24,16,8,14992,7496,22488
120038,201703,371,237,134,221258.2,125514.24,346772.44
120039,201703,17,16,1,14992,937,15929
120040,201703,13618,9403,4215,8682040.64,3906147.24,12588187.88
120042,201703,40,34,6,31858,5622,37480
120043,201703,14,3,11,2811,10286.89,13097.89
120045,201703,523,329,194,306971.18,181513.48,488484.66
120050,201703,1211,919,292,856418.5,272316.56,1128735.06
120060,201703,1354,1083,271,998508.25,249886.7,1248394.95
120070,201703,501,357,144,328209.68,133467.75,461677.43
120080,201703,125,80,45,73871.25,41602.55,115473.80
130002,201703,151,105,46,98385,43102,141487
130006,201703,76,42,34,39354,31858,71212
130008,201703,138,74,64,68617.72,59245.96,127863.68
130010,201703,141,74,67,69338,62779,132117
130014,201703,223,163,60,152731,56220,208951
130020,201703,82,47,35,44039,32795,76834
130030,201703,853,531,322,497547,301704.63,799251.63
130040,201703,321,164,157,153668,146172,299840
130050,201703,541,308,233,288314.9,218321,506635.9
130060,201703,860,589,271,546700.66,251046.58,797747.24
130063,201703,537,286,251,267982,235165.12,503147.12
130068,201703,189,120,69,112440,64372,176812
130070,201703,1331,922,409,837983.3,373639,1211622.3
130080,201703,671,438,233,410031.2,218312,628343.2
130083,201703,68,36,32,33732,29984,63716
130090,201703,391,193,198,179191.88,185526,364717.88
130100,201703,1107,522,585,489114,547863.9,1036977.9
130110,201703,706,305,401,285635,375717,661352
130115,201703,174,72,102,67464,95574,163038
130120,201703,1609,1004,605,940748,566885,1507633
130130,201703,622,422,200,395414,187400,582814
130140,201703,1549,1161,388,1087226.95,362619.1,1449846.05
130150,201703,412,342,70,320454,65590,386044
130160,201703,470,255,215,238935,201455,440390
130165,201703,28,19,9,17803,8433,26236
130170,201703,944,660,284,612745.11,263052.93,875798.04
130180,201703,162,97,65,90420.5,60905,151325.5
130185,201703,1996,1082,914,1011939.89,855835.89,1867775.78
130190,201703,3555,2271,1284,2124180,1201328.09,3325508.09
130195,201703,293,235,58,220195,54346,274541
130200,201703,181,80,101,74950.63,94637,169587.63
130210,201703,69,35,34,32795,31858,64653
130220,201703,186,129,57,120873,53409,174282
130230,201703,335,212,123,198644,115251,313895
130240,201703,1474,916,558,856935.98,522560.22,1379496.20
130250,201703,4622,2953,1669,2762442.6,1563698.05,4326140.65
130255,201703,394,211,183,197707,171189.9,368896.9
130260,201703,51024,24112,26912,22560139.2,25208178.26,47768317.46
130270,201703,1437,919,518,860609.82,485325.89,1345935.71
130280,201703,103,63,40,59031,37480,96511
130290,201703,2073,1516,557,1420087.22,521627.9,1941715.12
130300,201703,423,304,119,284566.9,111503,396069.9
130310,201703,918,496,422,464752,395414,860166
130320,201703,442,235,207,219098.71,193959,413057.71
130330,201703,711,435,276,407595,258330.9,665925.9
130340,201703,3168,1959,1209,1832584.8,1131708.7,2964293.5
130350,201703,498,306,192,286599.57,179904,466503.57
130353,201703,729,298,431,278945,403847,682792
130356,201703,711,322,389,301694,364211.9,665905.9
130360,201703,70,42,28,39354,26236,65590
130370,201703,702,503,199,471311,186463,657774
130380,201703,642,427,215,400099,201455,601554
130390,201703,505,399,106,373863,99322,473185
130395,201703,169,42,127,39354,118999,158353
130400,201703,65,46,19,43102,17803,60905
130406,201703,2004,1287,717,1202405.25,671201.16,1873606.41
130410,201703,530,222,308,208014,288596,496610
130420,201703,3202,2528,674,2365925.35,631538,2997463.35
130423,201703,166,76,90,71212,84330,155542
130426,201703,140,81,59,75897,55283,131180
130430,201703,407,268,139,251116,130243,381359
130440,201703,200,73,127,68120,118999,187119
140002,201703,35,15,20,14055,18740,32795
140005,201703,190,115,75,107520.75,70275,177795.75
140010,201703,10126,6804,3322,6347929.13,3108382.82,9456311.95
140015,201703,150,68,82,63716,76834,140550
140017,201703,101,69,32,64653,29984,94637
140020,201703,482,326,156,304525.84,146172,450697.84
140023,201703,20,16,4,14992,3748,18740
140028,201703,12,7,5,6559,4685,11244
140030,201703,355,250,105,234250,97794.69,332044.69
140040,201703,50,35,15,32795,13961.3,46756.3
140045,201703,245,113,132,105225.1,123684,228909.1
140047,201703,517,342,175,317782.52,163225.5,481008.02
140050,201703,156,100,56,92902,52472,145374
140060,201703,29,22,7,20614,6559,27173
140070,201703,29,27,2,25299,1874,27173
150010,201703,4649,2861,1788,2678086.75,1672973.66,4351060.41
150013,201703,134,90,44,84330,41228,125558
150020,201703,1100,556,544,520972,509728,1030700
150030,201703,757,302,455,282974,426335,709309
150034,201703,182,109,73,102133,68401,170534
150040,201703,1332,797,535,746769,501295,1248064
150050,201703,672,396,276,370770.9,258412,629182.9
150060,201703,4620,2991,1629,2799501.54,1524942.51,4324444.05
150070,201703,304,130,174,121810,163038,284848
150080,201703,14274,7117,7157,6658590.42,6700697.86,13359288.28
150085,201703,346,209,137,195823.63,128369,324192.63
150090,201703,742,630,112,590310,104944,695254
150095,201703,342,209,133,195076.84,123815.18,318892.02
150100,201703,52,36,16,33732,14992,48724
150110,201703,173,83,90,77771,84330,162101
150120,201703,426,315,111,295155,104007,399162
150125,201703,49,21,28,19677,26236,45913
150130,201703,1842,971,871,909827,816122.32,1725949.32
150140,201703,54189,25232,28957,23610361.03,27118802.45,50729163.48
150145,201703,168,97,71,90889,66527,157416
150150,201703,2665,1105,1560,1034890.27,1457845.7,2492735.97
150157,201703,454,300,154,281100,144293.32,425393.32
150160,201703,109,85,24,79645,22488,102133
150170,201703,3615,2659,956,2488297.3,894553.9,3382851.2
150172,201703,290,200,90,187400,84330,271730
150175,201703,88,55,33,51535,30921,82456
150178,201703,733,486,247,454445,231439,685884
150180,201703,2882,1344,1538,1258531.8,1440806.86,2699338.66
150190,201703,329,206,123,193022,115251,308273
150195,201703,118,58,60,54346,56220,110566
150200,201703,208,92,116,86204,108692,194896
150210,201703,3075,2489,586,2331153.84,548843.75,2879997.59
150215,201703,475,319,156,298622,146172,444794
150220,201703,4032,2681,1351,2510635.95,1263076.36,3773712.31
150230,201703,1144,910,234,852100.7,219258,1071358.7
150240,201703,5541,3225,2316,3018256.47,2170079,5188335.47
150250,201703,32,14,18,13118,16866,29984
150260,201703,69,41,28,38417,26236,64653
150270,201703,2275,1485,790,1390039.45,739668,2129707.45
150275,201703,595,355,240,332635,224880,557515
150276,201703,100,39,61,36543,57157,93700
150277,201703,758,320,438,299821.63,410406,710227.63
150280,201703,339,203,136,190211,127432,317643
150285,201703,72,36,36,33732,33732,67464
150290,201703,943,568,375,531925.53,351094,883019.53
150293,201703,697,314,383,293796.63,358871,652667.63
150295,201703,455,192,263,179904,246299.82,426203.82
150300,201703,79,43,36,40291,33732,74023
150304,201703,136,87,49,81519,45913,127432
150307,201703,390,316,74,296092,69338,365430
150309,201703,507,359,148,336383,138676,475059
150310,201703,254,171,83,160227,77771,237998
150320,201703,1794,1234,560,1155981.59,524720,1680701.59
150330,201703,2046,1159,887,1085327.1,831119,1916446.1
150340,201703,192,125,67,116890.75,62779,179669.75
150345,201703,610,322,288,301535.97,269856,571391.97
150350,201703,425,334,91,310606.13,85267,395873.13
150360,201703,4319,2785,1534,2606859.74,1437348.63,4044208.37
150370,201703,714,501,213,468773,199290.9,668063.9
150375,201703,191,104,87,97448,81519,178967
150380,201703,1178,753,425,705561,397195,1102756
150390,201703,724,412,312,386044,292335,678379
150400,201703,90,71,19,66527,17803,84330
150405,201703,1247,824,423,771063.86,395788.8,1166852.66
150410,201703,146,93,53,87141,49661,136802
150420,201703,7004,3800,3204,3558950.44,3000947.12,6559897.56
150430,201703,465,312,153,292344,143361,435705
150440,201703,594,351,243,328138,227410,555548
150442,201703,1989,1080,909,1010189.07,851733,1861922.07
150445,201703,501,310,191,290470,178030,468500
150450,201703,275,125,150,117125,140550,257675
150460,201703,780,589,191,549817.66,178948.26,728765.92
150470,201703,1323,784,539,734327,505043,1239370
150475,201703,25,20,5,18740,4685,23425
150480,201703,1224,847,377,793639,353249,1146888
150490,201703,612,317,295,297029,276415,573444
150495,201703,317,213,104,199581,97448,297029
150497,201703,296,202,94,189274,88068.63,277342.63
150500,201703,433,294,139,275478,130243,405721
150503,201703,742,351,391,328887,366349,695236
150506,201703,1037,648,389,607176,364474.63,971650.63
150510,201703,1200,685,515,641564,482555,1124119
150520,201703,256,170,86,159290,80582,239872
150530,201703,1494,819,675,764967.55,632194,1397161.55
150540,201703,241,167,74,156479,69338,225817
150543,201703,645,364,281,340142.76,263015.9,603158.66
150548,201703,485,321,164,300777,153668,454445
150549,201703,57,38,19,35606,17803,53409
150550,201703,2871,1479,1392,1385121,1303742,2688863
150553,201703,2911,1735,1176,1625133,1101611,2726744
150555,201703,142,73,69,68401,64653,133054
150560,201703,52,39,13,36543,12181,48724
150563,201703,58,30,28,28110,26236,54346
150565,201703,159,91,68,85267,63716,148983
150570,201703,396,262,134,245475.26,125558,371033.26
150580,201703,1470,580,890,542804.1,833930,1376734.1
150590,201703,820,480,340,449760,318580,768340
150600,201703,442,272,170,254864,159290,414154
150610,201703,137,118,19,109733,17803,127536
150611,201703,130,88,42,82456,39354,121810
150613,201703,3084,1879,1205,1760619,1129067,2889686
150616,201703,474,290,184,271495.75,172408,443903.75
150618,201703,1109,601,508,562912.49,475996,1038908.49
150619,201703,407,305,102,285785,95574,381359
150620,201703,1262,717,545,671829,510665,1182494
150630,201703,312,208,104,194896,97448,292344
150635,201703,495,197,298,184589,278944.9,463533.9
150640,201703,63,31,32,29047,29984,59031
150650,201703,2276,1298,978,1215954.27,915037.87,2130992.14
150655,201703,250,186,64,174282,59968,234250
150658,201703,97,55,42,51535,39354,90889
150660,201703,473,328,145,307336,135865,443201
150670,201703,962,331,631,309856.9,591228.63,901085.53
150680,201703,9460,5213,4247,4879776.22,3976583.26,8856359.48
150690,201703,49,30,19,28110,17803,45913
150700,201703,557,359,198,336195.6,185526,521721.6
150710,201703,247,152,95,142424,89015,231439
150715,201703,872,516,356,482527.26,333534.89,816062.15
150720,201703,452,335,117,313895,109347.9,423242.9
150730,201703,844,448,396,419767,370770.9,790537.9
150740,201703,246,174,72,163038,67464,230502
150745,201703,778,388,390,363556,365430,728986
150746,201703,54,33,21,30921,19677,50598
150747,201703,272,210,62,196770,58094,254864
150750,201703,118,68,50,63716,46850,110566
150760,201703,1696,1084,612,1015427,573444,1588871
150770,201703,353,180,173,168660,161929.07,330589.07
150775,201703,81,39,42,36543,39354,75897
150780,201703,177,91,86,85267,80582,165849
150790,201703,901,476,425,446012,398225,844237
150795,201703,1390,794,596,743134.65,558452,1301586.65
150796,201703,414,237,177,222069,165849,387918
150797,201703,266,155,111,145235,104007,249242
150800,201703,1393,837,556,783327.31,520690.9,1304018.21
150803,201703,582,482,100,451634,93700,545334
150805,201703,186,117,69,109629,64639.63,174268.63
150808,201703,931,506,425,474122,398225,872347
150810,201703,3349,2289,1060,2139538.38,992920.26,3132458.64
150812,201703,420,221,199,207077,186463,393540
150815,201703,911,600,311,560846.04,291407,852253.04
150820,201703,1600,976,624,913575,584669.26,1498244.26
150830,201703,843,589,254,550956,237998,788954
150835,201703,169,97,72,90889,67464,158353
150840,201703,1254,801,453,750272,424461,1174733
160005,201703,48,29,19,27173,17803,44976
160010,201703,197,123,74,115251,69334,184585
160015,201703,114,66,48,61842,44976,106818
160020,201703,116,67,49,62779,45913,108692
160021,201703,40,21,19,19677,17803,37480
160023,201703,105,57,48,53409,44976,98385
160025,201703,33,14,19,13118,17803,30921
160027,201703,1402,782,620,729268.1,580203,1309471.1
160030,201703,14954,7590,7364,7103598,6892586.15,13996184.15
160040,201703,311,177,134,165849,125558,291407
160050,201703,612,313,299,293281,279881.9,573162.9
160053,201703,349,192,157,179623,147109,326732
160055,201703,18,13,5,12181,4685,16866
160060,201703,6229,3218,3011,3003729.72,2820366.1,5824095.82
160070,201703,157,94,63,88078,59031,147109
160080,201703,75,38,37,35606,34669,70275
170025,201703,23,15,8,14055,7496,21551
170030,201703,225,177,48,165478,44976,210454
170035,201703,237,108,129,100259,120873,221132
170040,201703,183,142,41,132772.9,38417,171189.9
170070,201703,340,193,147,180841,137739,318580
170100,201703,381,266,115,249008,107755,356763
170105,201703,63,52,11,48724,10307,59031
170110,201703,97,58,39,54346,36543,90889
170130,201703,73,33,40,30921,37199,68120
170190,201703,111,69,42,64653,39354,104007
170200,201703,399,265,134,247359.1,125455.78,372814.88
170210,201703,5882,3005,2877,2810364.61,2692545.33,5502909.94
170215,201703,67,31,36,28766,33732,62498
170220,201703,1441,1045,396,977084.86,370583.6,1347668.46
170230,201703,157,101,56,94637,52472,147109
170240,201703,588,385,203,360745,190211,550956
170255,201703,1119,886,233,830182,218039.9,1048221.9
170270,201703,37,26,11,24362,10025.9,34387.9
170290,201703,64,46,18,43102,16866,59968
170300,201703,78,49,29,45163.4,27173,72336.4
170305,201703,36,28,8,26236,7496,33732
170307,201703,58,41,17,38417,15929,54346
170310,201703,96,51,45,47787,42165,89952
170320,201703,17,13,4,12181,3748,15929
170330,201703,18,15,3,14055,2811,16866
170360,201703,22,14,8,13118,7496,20614
170370,201703,170,80,90,74960,84330,159290
170380,201703,80,55,25,51535,23425,74960
170382,201703,48,42,6,39354,5622,44976
170384,201703,122,85,37,79645,34669,114314
170386,201703,57,27,30,25299,28110,53409
170388,201703,46,17,29,15929,27173,43102
170389,201703,24,18,6,16866,5622,22488
170390,201703,49,29,20,27173,18740,45913
170410,201703,34,23,11,21551,10307,31858
170460,201703,17,12,5,11244,4685,15929
170510,201703,26,18,8,16866,7496,24362
170550,201703,1440,803,637,752391,596119.5,1348510.5
170555,201703,110,74,36,69338,33732,103070
170560,201703,100,71,29,66527,27173,93700
170600,201703,36,18,18,16866,16866,33732
170610,201703,195,105,90,98230.4,84312,182542.4
170625,201703,37,17,20,15929,18740,34669
170650,201703,80,58,22,54346,20614,74960
170700,201703,545,413,132,385060.15,122887.55,507947.70
170710,201703,155,95,60,89015,56211,145226
170720,201703,78,65,13,60905,12181,73086
170730,201703,55,33,22,30921,20614,51535
170740,201703,66,48,18,44976,16866,61842
170755,201703,115,52,63,48114.95,59031,107145.95
170765,201703,150,67,83,62170,77771,139941
170770,201703,236,130,106,121013.55,99322,220335.55
170820,201703,588,379,209,355123,195412,550535
170825,201703,32,19,13,17803,12181,29984
170830,201703,70,47,23,43851.6,21551,65402.6
170900,201703,209,159,50,148983,46850,195833
170930,201703,771,384,387,359490,362338,721828
170950,201703,2924,1260,1664,1178306.88,1556900.93,2735207.81
170980,201703,16,9,7,8433,6559,14992
171050,201703,122,93,29,87141,27173,114314
171070,201703,33,26,7,24362,6559,30921
171090,201703,34,24,10,22488,9370,31858
171110,201703,22,15,7,14055,6559,20614
171150,201703,37,18,19,16866,17803,34669
171180,201703,21,10,11,9370,10307,19677
171190,201703,124,69,55,64653,51535,116188
171195,201703,62,47,15,44039,14055,58094
171200,201703,45,19,26,17803,24362,42165
171215,201703,1,1,0,937,0,937
171240,201703,52,42,10,39354,9370,48724
171245,201703,48,43,5,40291,4685,44976
171250,201703,66,31,35,29047,32785.63,61832.63
171270,201703,16,12,4,11244,3748,14992
171280,201703,35,32,3,29844,2811,32655
171320,201703,974,545,429,510665,401036,911701
171330,201703,403,190,213,178030,199581,377611
171360,201703,79,58,21,54346,19677,74023
171370,201703,22,11,11,10307,10307,20614
171380,201703,123,101,22,94637,20388.19,115025.19
171395,201703,52,31,21,29047,19677,48724
171420,201703,321,211,110,197707,102788.9,300495.9
171430,201703,58,47,11,43399,10307,53706
171488,201703,206,106,100,99322,93700,193022
171500,201703,59,32,27,29984,25299,55283
171510,201703,61,40,21,37480,19677,57157
171515,201703,44,37,7,34669,6559,41228
171525,201703,30,26,4,24362,3748,28110
171550,201703,11,5,6,4685,5622,10307
171570,201703,57,28,29,26236,27173,53409
171575,201703,357,209,148,195693,138666.63,334359.63
171610,201703,1607,784,823,732742.83,769575.47,1502318.30
171620,201703,124,84,40,78164.54,37198.9,115363.44
171630,201703,54,28,26,26236,24362,50598
171650,201703,281,176,105,164912,98385,263297
171660,201703,257,137,120,128369,112440,240809
171665,201703,41,25,16,23425,14992,38417
171670,201703,430,245,185,227915.98,172782.8,400698.78
171700,201703,59,53,6,49661,5622,55283
171720,201703,24,9,15,8433,14055,22488
171750,201703,96,53,43,49661,40291,89952
171780,201703,70,57,13,53409,12181,65590
171790,201703,79,64,15,59968,14055,74023
171800,201703,33,25,8,23425,7496,30921
171820,201703,1910,1084,826,1015011.47,768219.31,1783230.78
171830,201703,35,26,9,24362,8433,32795
171840,201703,54,30,24,28110,22488,50598
171845,201703,31,19,12,17803,11244,29047
171850,201703,37,25,12,23425,11244,34669
171855,201703,68,53,15,49661,14055,63716
171865,201703,9,6,3,5622,2811,8433
171870,201703,31,22,9,20614,8433,29047
171875,201703,78,53,25,49661,23425,73086
171880,201703,25,18,7,16866,6559,23425
171884,201703,39,19,20,17803,18740,36543
171886,201703,108,39,69,36543,64371.9,100914.9
171888,201703,21,14,7,13118,6559,19677
171889,201703,22,15,7,14055,6559,20614
171890,201703,56,45,11,42165,10307,52472
171900,201703,43,29,14,27173,13118,40291
172000,201703,39,32,7,29984,6559,36543
172010,201703,38,31,7,28250.55,6559,34809.55
172015,201703,27,16,11,14992,10025.9,25017.9
172020,201703,122,76,46,71212,43102,114314
172025,201703,32,19,13,17803,12181,29984
172030,201703,31,19,12,17803,11244,29047
172049,201703,71,44,27,41228,25299,66527
172065,201703,154,100,54,93700,50598,144298
172080,201703,70,52,18,47563.02,16866,64429.02
172085,201703,23,10,13,9370,12181,21551
172090,201703,408,309,99,289533,92014,381547
172093,201703,28,18,10,16866,9370,26236
172097,201703,18,9,9,8433,8152,16585
172100,201703,4423,2429,1994,2270796.67,1865469.93,4136266.60
172110,201703,78,51,27,47787,25299,73086
172120,201703,1733,1483,250,1385235.6,233162.14,1618397.74
172125,201703,2,2,0,1874,0,1874
172130,201703,12,10,2,9370,1874,11244
172208,201703,184,117,67,109629,62779,172408
172210,201703,489,227,262,212699,245213,457912
210005,201703,2915,1803,1112,1686131.86,1039415,2725546.86
210010,201703,205,99,106,92763,99322,192085
210015,201703,22,14,8,13118,7496,20614
210020,201703,334,171,163,160227,152731,312958
210030,201703,348,213,135,199581,126486,326067
210040,201703,158,122,36,114314,33732,148046
210043,201703,252,164,88,153668,82456,236124
210047,201703,633,304,329,284473.2,308263.63,592736.83
210050,201703,302,219,83,205203,77771,282974
210055,201703,41,31,10,29047,9370,38417
210060,201703,578,434,144,406560.56,134928,541488.56
210070,201703,417,297,120,278289,112158.9,390447.9
210080,201703,97,89,8,83393,7496,90889
210083,201703,310,122,188,114314,176156,290470
210087,201703,52,33,19,30921,17803,48724
210090,201703,498,339,159,317643,148983,466626
210095,201703,506,346,160,324202,149920,474122
210100,201703,676,503,173,470983.05,161164.35,632147.40
210110,201703,157,82,75,76834,70275,147109
210120,201703,5380,3961,1419,3706074.93,1328633.14,5034708.07
210125,201703,218,111,107,104007,100259,204266
210130,201703,569,280,289,261423,270793,532216
210135,201703,34,20,14,18740,13118,31858
210140,201703,3942,3042,900,2847215.22,843129,3690344.22
210150,201703,354,220,134,206140,125385,331525
210160,201703,3289,2731,558,2556138.68,522565,3078703.68
210170,201703,1093,838,255,785206,238935,1024141
210173,201703,110,90,20,84330,18740,103070
210177,201703,510,236,274,221132,256738,477870
210180,201703,27,14,13,13118,12181,25299
210190,201703,401,250,151,234250,141487,375737
210193,201703,0,0,0,0,0,0
210197,201703,86,56,30,52472,28110,80582
210200,201703,638,495,143,463815,133991,597806
210203,201703,272,173,99,162101,92763,254864
210207,201703,379,285,94,267045,88078,355123
210210,201703,762,689,73,645593,68401,713994
210215,201703,75,62,13,58094,12181,70275
210220,201703,405,330,75,309210,70275,379485
210230,201703,308,219,89,205203,83393,288596
210232,201703,1526,925,601,866444,563137,1429581
210235,201703,153,117,36,109442,33732,143174
210237,201703,44,24,20,22488,18740,41228
210240,201703,93,75,18,70275,16866,87141
210250,201703,175,134,41,125558,38417,163975
210255,201703,291,209,82,195833,76834,272667
210260,201703,439,253,186,237061,174282,411343
210270,201703,726,444,282,416028,264234,680262
210275,201703,39,31,8,29047,7496,36543
210280,201703,1014,635,379,591849.45,353811.25,945660.70
210290,201703,491,300,191,281100,178967,460067
210300,201703,6266,3541,2725,3312578,2552136.37,5864714.37
210310,201703,101,68,33,63716,30921,94637
210312,201703,128,77,51,72149,47787,119936
210315,201703,116,81,35,75897,32795,108692
210317,201703,120,81,39,75897,36543,112440
210320,201703,2380,1926,454,1803919.98,424461,2228380.98
210325,201703,128,87,41,80582,38136,118718
210330,201703,5694,2704,2990,2530448.7,2801620.63,5332069.33
210340,201703,1465,1024,441,959488,413146.85,1372634.85
210350,201703,599,478,121,447651.75,113377,561028.75
210355,201703,121,94,27,88078,25299,113377
210360,201703,2749,1676,1073,1567321.9,1005401,2572722.9
210370,201703,1275,520,755,487240,706779.1,1194019.1
210375,201703,197,102,95,95040,89015,184055
210380,201703,727,543,184,508791,172388,681179
210390,201703,194,160,34,149920,31858,181778
210400,201703,419,346,73,324202,68401,392603
210405,201703,972,631,341,590653.87,319517,910170.87
210407,201703,56,43,13,40291,12181,52472
210408,201703,68,61,7,57157,6559,63716
210409,201703,315,258,57,241746,52707,294453
210410,201703,435,329,106,308273,99313,407586
210420,201703,195,159,36,148983,33732,182715
210430,201703,34,26,8,24362,7496,31858
210440,201703,388,226,162,211762,150857,362619
210450,201703,147,108,39,101196,36543,137739
210455,201703,198,104,94,97448,88078,185526
210460,201703,343,216,127,202392,118999,321391
210462,201703,52,44,8,41228,7496,48724
210465,201703,190,131,59,122747,55283,178030
210467,201703,503,354,149,331698,139613,471311
210470,201703,38,27,11,25299,10307,35606
210480,201703,1269,880,389,824560,364493,1189053
210490,201703,221,129,92,120873,86204,207077
210500,201703,542,281,261,263297,244557,507854
210510,201703,546,413,133,386981,124621,511602
210515,201703,456,230,226,215510,211762,427272
210520,201703,400,346,54,323920.9,50598,374518.9
210530,201703,9162,4894,4268,4571065.79,3993589.8,8564655.59
210535,201703,140,96,44,89952,41228,131180
210540,201703,1553,897,656,839308.4,613266.5,1452574.9
210542,201703,1141,584,557,546693.2,521909,1068602.2
210545,201703,12,11,1,10307,937,11244
210547,201703,134,114,20,106818,18740,125558
210550,201703,762,518,244,484294.9,228346.9,712641.8
210560,201703,171,140,31,131180,29047,160227
210565,201703,29,20,9,18740,8433,27173
210570,201703,1389,1061,328,994157,307326.63,1301483.63
210580,201703,105,90,15,84330,14055,98385
210590,201703,786,595,191,556765.4,178967,735732.4
210592,201703,36,31,5,29047,4685,33732
210594,201703,94,80,14,74960,13118,88078
210596,201703,75,63,12,59031,11244,70275
210598,201703,122,87,35,81519,32795,114314
210600,201703,356,297,59,278289,55283,333572
210610,201703,243,225,18,209888,16866,226754
210620,201703,49,28,21,26236,19677,45913
210630,201703,58,54,4,50598,3748,54346
210632,201703,1158,724,434,678388,405908.4,1084296.4
210635,201703,14,12,2,11244,1874,13118
210637,201703,102,72,30,67464,28110,95574
210640,201703,584,498,86,466626,80582,547208
210650,201703,400,320,80,299652.6,74023,373675.6
210660,201703,399,281,118,263297,110566,373863
210663,201703,17,12,5,11244,4685,15929
210667,201703,121,36,85,33732,79645,113377
210670,201703,264,234,30,218556,28110,246666
210675,201703,575,287,288,268919,269856,538775
210680,201703,223,134,89,125558,83393,208951
210690,201703,641,495,146,463815,136802,600617
210700,201703,189,135,54,126495,50598,177093
210710,201703,308,169,139,158353,130243,288596
210720,201703,119,98,21,91826,19677,111503
210725,201703,60,54,6,50598,5622,56220
210730,201703,23,17,6,15929,5622,21551
210735,201703,405,260,145,243620,135584,379204
210740,201703,540,454,86,425398,80582,505980
210745,201703,148,101,47,94637,44039,138676
210750,201703,2437,1045,1392,978102,1304285.26,2282387.26
210760,201703,286,197,89,184589,83378.95,267967.95
210770,201703,405,312,93,291407,86859.9,378266.9
210780,201703,417,293,124,274541,115251.45,389792.45
210790,201703,184,140,44,131180,41228,172408
210800,201703,125,94,31,88078,29047,117125
210805,201703,38,35,3,32795,2811,35606
210810,201703,490,363,127,339475.1,118999,458474.1
210820,201703,2334,1800,534,1678347.39,500358,2178705.39
210825,201703,178,89,89,83393,83393,166786
210830,201703,827,483,344,451634,321391,773025
210840,201703,216,138,78,129306,73086,202392
210845,201703,258,149,109,139613,102133,241746
210850,201703,901,562,339,526281.7,317643,843924.7
210860,201703,4223,2072,2151,1940527,2015466.89,3955993.89
210870,201703,470,341,129,319517,120873,440390
210880,201703,53,36,17,33732,15929,49661
210890,201703,344,280,64,262360,59968,322328
210900,201703,511,313,198,293281,185526,478807
210905,201703,80,34,46,31858,43102,74960
210910,201703,2011,1456,555,1363275.1,520035,1883310.1
210920,201703,262,72,190,67464,178030,245494
210923,201703,74,56,18,52472,16866,69338
210927,201703,449,168,281,157416,263297,420713
210930,201703,58,44,14,41228,13118,54346
210940,201703,97,69,28,64653,26236,90889
210945,201703,201,86,115,80582,107755,188337
210950,201703,510,363,147,340131,137734.32,477865.32
210955,201703,79,53,26,49661,24362,74023
210960,201703,2483,972,1511,909171.7,1415526,2324697.7
210970,201703,109,92,17,86204,15929,102133
210975,201703,81,73,8,68401,7496,75897
210980,201703,1305,537,768,503056.56,719335,1222391.56
210990,201703,5056,3056,2000,2863191,1873980,4737171
211000,201703,1407,1072,335,1004163,313613.9,1317776.9
211003,201703,927,620,307,580940,287650,868590
211010,201703,479,416,63,389792,59031,448823
211020,201703,1678,554,1124,519098,1053188,1572286
211023,201703,20,17,3,15647.9,2811,18458.9
211027,201703,58,38,20,35606,18740,54346
211030,201703,390,250,140,234250,131180,365430
211040,201703,315,230,85,215229,79645,294874
211050,201703,1189,720,469,674640,439167.32,1113807.32
211060,201703,686,580,106,543460,99322,642782
211065,201703,24,20,4,18740,3748,22488
211070,201703,908,725,183,678678.97,171471,850149.97
211080,201703,90,85,5,79645,4685,84330
211085,201703,60,31,29,28766,27173,55939
211090,201703,97,79,18,74023,16866,90889
211100,201703,510,402,108,376674,101196,477870
211102,201703,274,173,101,162101,94637,256738
211105,201703,207,138,69,129306,64653,193959
211107,201703,119,66,53,61842,49661,111503
211110,201703,814,524,290,490426,271721,762147
211120,201703,5825,2258,3567,2112430.03,3340181.92,5452611.95
211125,201703,34,28,6,26236,5622,31858
211130,201703,46513,18538,27975,17340624.04,26200578.05,43541202.09
211140,201703,456,377,79,353245,73742,426987
211150,201703,1234,751,483,703687,452567,1156254
211153,201703,184,100,84,93700,78708,172408
211157,201703,52,37,15,34669,14055,48724
211160,201703,682,552,130,516275.25,121810,638085.25
211163,201703,0,0,0,0,0,0
211167,201703,5,4,1,3748,937,4685
211170,201703,457,308,149,288596,139613,428209
211172,201703,121,78,43,73086,40291,113377
211174,201703,296,169,127,158353,118999,277352
211176,201703,531,367,164,343879,153668,497547
211178,201703,90,58,32,54346,29984,84330
211180,201703,212,162,50,151794,46690.71,198484.71
211190,201703,59,54,5,50598,4685,55283
211195,201703,18,10,8,9370,7496,16866
211200,201703,158,137,21,128031.68,19677,147708.68
211210,201703,660,316,344,295436.1,322328,617764.1
211220,201703,3860,2154,1706,2012864.71,1591130.22,3603994.93
211223,201703,90,84,6,78529.97,5622,84151.97
211227,201703,67,43,24,40291,22488,62779
211230,201703,799,639,160,598602.45,149901.26,748503.71
211240,201703,418,300,118,281100,110566,391666
211245,201703,210,83,127,77771,118999,196770
211250,201703,1663,1399,264,1310017,247368,1557385
211260,201703,813,627,186,587499,174282,761781
211270,201703,2138,1636,502,1532932,469437.1,2002369.1
211280,201703,1851,1065,786,996032.08,736482,1732514.08
211285,201703,222,122,100,114314,93418.9,207732.9
211290,201703,696,453,243,424273.6,227691,651964.6
211300,201703,814,607,207,568504.7,193959,762463.7
211400,201703,1671,901,770,844237,721490,1565727
220005,201703,19,18,1,16866,937,17803
220010,201703,90,68,22,63716,20332.9,84048.9
220020,201703,519,407,112,380765.6,104944,485709.6
220025,201703,107,103,4,96511,3748,100259
220027,201703,41,33,8,30921,7496,38417
220030,201703,84,69,15,64653,14055,78708
220040,201703,1074,799,275,747726,257675,1005401
220045,201703,36,28,8,26236,7496,33732
220050,201703,636,510,126,476728.88,118043.26,594772.14
220060,201703,171,143,28,133991,26236,160227
220070,201703,135,123,12,115251,11244,126495
220080,201703,6,5,1,4685,937,5622
220090,201703,33,25,8,23144,7496,30640
220095,201703,3,2,1,1874,937,2811
220100,201703,28,24,4,22488,3748,26236
220105,201703,39,36,3,33732,2811,36543
220110,201703,201,186,15,174000.9,14055,188055.9
220115,201703,38,35,3,32795,2811,35606
220117,201703,19,19,0,17803,0,17803
220120,201703,1519,1021,498,956827.85,466626,1423453.85
220130,201703,23,22,1,20614,937,21551
220140,201703,102,83,19,76834,17803,94637
220150,201703,433,302,131,282974,122747,405721
220155,201703,5,5,0,4685,0,4685
220157,201703,20,16,4,14992,3748,18740
220160,201703,70,62,8,58094,7496,65590
220170,201703,33,31,2,29047,1874,30921
220173,201703,7,7,0,6559,0,6559
220177,201703,5,5,0,4685,0,4685
220180,201703,68,67,1,62770.32,937,63707.32
220190,201703,1026,925,101,866725,93887.4,960612.4
220191,201703,47,42,5,39354,4685,44039
220192,201703,67,64,3,59968,2811,62779
220194,201703,19,16,3,14992,2811,17803
220196,201703,104,87,17,81379,15929,97308
220198,201703,6,4,2,3748,1874,5622
220200,201703,432,345,87,323986,81519,405505
220202,201703,35,31,4,29047,3748,32795
220205,201703,37,31,6,29047,5622,34669
220207,201703,17,16,1,14992,937,15929
220208,201703,80,40,40,37480,37480,74960
220209,201703,32,29,3,27173,2811,29984
220210,201703,17,16,1,14992,937,15929
220211,201703,46,45,1,42165,937,43102
220213,201703,45,39,6,36543,5622,42165
220217,201703,38,30,8,28110,7496,35606
220220,201703,1921,1235,686,1153513.49,641545.76,1795059.25
220225,201703,13,6,7,5622,6559,12181
220230,201703,898,718,180,672325.61,168032.21,840357.82
220240,201703,138,125,13,117125,12181,129306
220245,201703,53,49,4,45535,3748,49283
220250,201703,136,120,16,112440,14992,127432
220253,201703,41,31,10,29047,9370,38417
220255,201703,27,23,4,21551,3748,25299
220260,201703,689,505,184,473185,172408,645593
220265,201703,13,10,3,9370,2811,12181
220270,201703,622,550,72,514637.88,66995.5,581633.38
220271,201703,45,35,10,32795,9370,42165
220272,201703,26,25,1,23425,937,24362
220273,201703,16,13,3,12181,2811,14992
220275,201703,46,37,9,34669,8433,43102
220277,201703,8,8,0,7496,0,7496
220280,201703,21,19,2,17803,1874,19677
220285,201703,54,50,4,46850,3748,50598
220290,201703,1373,1170,203,1093808,190165,1283973
220300,201703,59,57,2,53409,1874,55283
220310,201703,302,254,48,237856.27,44967,282823.27
220320,201703,438,403,35,376206.5,32795,409001.5
220323,201703,0,0,0,0,0,0
220325,201703,14,9,5,8433,4685,13118
220327,201703,11,10,1,9370,937,10307
220330,201703,178,117,61,109347.9,57157,166504.9
220335,201703,136,120,16,112421.26,14992,127413.26
220340,201703,23,13,10,12181,9370,21551
220342,201703,51,44,7,41228,6559,47787
220345,201703,118,104,14,97448,13118,110566
220350,201703,439,388,51,360980.01,47787,408767.01
220360,201703,39,30,9,28110,8433,36543
220370,201703,1021,810,211,758220.4,197707,955927.4
220375,201703,25,24,1,22488,937,23425
220380,201703,34,26,8,24362,7496,31858
220385,201703,29,24,5,22488,4685,27173
220390,201703,2171,1243,928,1160081.2,867241.41,2027322.61
220400,201703,27,26,1,24362,937,25299
220410,201703,17,14,3,13118,2811,15929
220415,201703,13,12,1,11244,937,12181
220420,201703,130,108,22,101196,20276.7,121472.7
220430,201703,129,117,12,107990.4,11244,119234.4
220435,201703,27,20,7,18740,6559,25299
220440,201703,292,250,42,234250,38447.95,272697.95
220450,201703,303,162,141,150649.74,132117,282766.74
220455,201703,58,56,2,52472,1874,54346
220460,201703,23,21,2,19021.1,1874,20895.1
220465,201703,99,64,35,59968,32795,92763
220470,201703,234,202,32,188337.8,29984,218321.8
220480,201703,69,57,12,53409,11244,64653
220490,201703,82,71,11,65770,10307,76077
220500,201703,97,83,14,77771,13118,90889
220510,201703,377,302,75,282225,70087.6,352312.6
220515,201703,20,16,4,14992,3748,18740
220520,201703,353,315,38,293472,35588,329060
220525,201703,27,19,8,17803,7496,25299
220527,201703,38,32,6,29188,5622,34810
220530,201703,36,14,22,13118,20614,33732
220535,201703,12,11,1,10307,937,11244
220540,201703,57,44,13,41228,12181,53409
220545,201703,67,44,23,41228,21551,62779
220550,201703,616,467,149,437579,139613,577192
220551,201703,25,19,6,17803,5622,23425
220552,201703,8,8,0,7496,0,7496
220553,201703,64,58,6,54346,5622,59968
220554,201703,15,9,6,8151.9,5622,13773.9
220555,201703,25,21,4,19677,3748,23425
220556,201703,60,56,4,52472,3748,56220
220557,201703,53,47,6,44039,5622,49661
220558,201703,7,2,5,1874,4685,6559
220559,201703,6,5,1,4685,937,5622
220560,201703,51,34,17,31670.6,15929,47599.6
220570,201703,735,429,306,401727.14,286722,688449.14
220580,201703,597,539,58,505043,53391.26,558434.26
220585,201703,5,4,1,3748,937,4685
220590,201703,14,14,0,13118,0,13118
220595,201703,60,45,15,42165,14055,56220
220600,201703,21,11,10,10307,9370,19677
220605,201703,20,19,1,17803,937,18740
220610,201703,55,48,7,44976,6559,51535
220620,201703,545,418,127,390495.04,118999,509494.04
220630,201703,8,6,2,5622,1874,7496
220635,201703,35,31,4,29047,3748,32795
220640,201703,99,71,28,66527,26236,92763
220650,201703,110,104,6,97448,5622,103070
220660,201703,25,19,6,17803,5622,23425
220665,201703,5,4,1,3748,937,4685
220667,201703,12,12,0,11244,0,11244
220669,201703,19,18,1,16866,937,17803
220670,201703,63,49,14,45725.6,13118,58843.6
220672,201703,45,29,16,27173,14710.9,41883.9
220675,201703,34,26,8,24362,7496,31858
220680,201703,33,29,4,27173,3748,30921
220690,201703,49,45,4,42165,3748,45913
220695,201703,68,30,38,28110,35606,63716
220700,201703,1406,1067,339,997736.59,317362,1315098.59
220710,201703,4,2,2,1874,1874,3748
220720,201703,122,98,24,91591.75,22347.45,113939.20
220730,201703,20,20,0,18740,0,18740
220735,201703,3,1,2,937,1874,2811
220740,201703,39,37,2,34669,1874,36543
220750,201703,96,77,19,72149,17803,89952
220755,201703,17,17,0,15929,0,15929
220760,201703,43,40,3,37480,2811,40291
220770,201703,5540,2706,2834,2530029.52,2649711.18,5179740.70
220775,201703,26,12,14,11244,13118,24362
220777,201703,11,11,0,10307,0,10307
220779,201703,14,11,3,10307,2811,13118
220780,201703,834,710,124,664614.1,115907,780521.1
220785,201703,4,3,1,2811,937,3748
220790,201703,976,770,206,719149.34,193022,912171.34
220793,201703,15,15,0,14055,0,14055
220795,201703,25,24,1,22488,937,23425
220800,201703,3727,2826,901,2646646.56,843286.74,3489933.30
220810,201703,51,47,4,44039,3748,47787
220820,201703,234,212,22,198524,20614,219138
220830,201703,1098,921,177,862972.32,165849,1028821.32
220840,201703,2331,1521,810,1415951.03,756628,2172579.03
220850,201703,51,39,12,36543,11244,47787
220855,201703,15,10,5,9370,4685,14055
220860,201703,12,11,1,10307,937,11244
220865,201703,20,18,2,16866,1874,18740
220870,201703,59,55,4,51535,3748,55283
220880,201703,336,255,81,238279.1,75616,313895.1
220885,201703,45,40,5,37480,4685,42165
220887,201703,21,20,1,18740,937,19677
220890,201703,106,93,13,87141,12181,99322
220900,201703,46,27,19,25299,17803,43102
220910,201703,54,45,9,42165,8433,50598
220915,201703,20,19,1,17803,937,18740
220920,201703,37,34,3,31858,2811,34669
220930,201703,40,39,1,35743.73,937,36680.73
220935,201703,20,19,1,17803,937,18740
220937,201703,43,41,2,38417,1874,40291
220940,201703,49,44,5,41228,4685,45913
220945,201703,0,0,0,0,0,0
220950,201703,46,42,4,39354,3748,43102
220955,201703,39,37,2,34669,1874,36543
220960,201703,5,5,0,4685,0,4685
220965,201703,25,21,4,19677,3748,23425
220970,201703,45,37,8,34669,7496,42165
220975,201703,9,8,1,7496,937,8433
220980,201703,42,38,4,35606,3748,39354
220985,201703,58,53,5,49661,4685,54346
220987,201703,31,29,2,27173,1874,29047
220990,201703,12,10,2,9370,1874,11244
220995,201703,38,33,5,30921,4685,35606
220997,201703,30,24,6,22488,5622,28110
221000,201703,1052,942,110,880080.81,102788.9,982869.71
221005,201703,61,56,5,52472,4685,57157
221010,201703,16,13,3,12181,2811,14992
221020,201703,50,49,1,45913,937,46850
221030,201703,34,27,7,25299,6559,31858
221035,201703,17,16,1,14992,937,15929
221037,201703,10,6,4,5622,3748,9370
221038,201703,7,6,1,5622,937,6559
221039,201703,20,20,0,18740,0,18740
221040,201703,238,205,33,192085,30921,223006
221050,201703,231,194,37,181778,34669,216447
221060,201703,1419,1236,183,1157335.55,171471,1328806.55
221062,201703,31,30,1,28110,937,29047
221063,201703,15,11,4,10307,3748,14055
221065,201703,36,31,5,29047,4685,33732
221070,201703,152,130,22,121810,20614,142424
221080,201703,365,320,45,299840,41883.9,341723.9
221090,201703,40,39,1,36291,937,37228
221093,201703,74,51,23,47787,21551,69338
221095,201703,11,10,1,9370,937,10307
221097,201703,26,23,3,21551,2811,24362
221100,201703,23586,13428,10158,12561653.02,9514281.79,22075934.81
221110,201703,995,725,270,679024,252990,932014
221120,201703,489,359,130,336102,121810,457912
221130,201703,886,722,164,674987.69,153013,828000.69
221135,201703,31,28,3,26236,2811,29047
221140,201703,38,29,9,27173,8433,35606
221150,201703,14,10,4,9370,3748,13118
221160,201703,10,10,0,9370,0,9370
221170,201703,11,11,0,10307,0,10307
230010,201703,157,144,13,134928,12181,147109
230015,201703,112,93,19,87141,17803,104944
230020,201703,1448,1252,196,1170408,182989.08,1353397.08
230030,201703,1544,1105,439,1029915.62,411343,1441258.62
230040,201703,195,174,21,162101,19677,181778
230050,201703,187,140,47,131180,44039,175219
230060,201703,125,101,24,93887.4,22488,116375.4
230070,201703,272,240,32,224880,29984,254864
230075,201703,772,672,100,627229.5,92487.57,719717.07
230080,201703,172,153,19,143361,17803,161164
230090,201703,83,57,26,53409,24362,77771
230100,201703,1825,1090,735,1019084,688414,1707498
230110,201703,2569,1610,959,1505272.6,898020.9,2403293.5
230120,201703,887,699,188,652620.91,176156,828776.91
230125,201703,127,103,24,96511,22206.9,118717.9
230130,201703,428,383,45,358871,42165,401036
230140,201703,210,184,26,172408,24362,196770
230150,201703,153,119,34,111503,31858,143361
230160,201703,912,801,111,749834.5,104007,853841.5
230170,201703,549,505,44,469440.1,41228,510668.1
230180,201703,76,72,4,67464,3748,71212
230185,201703,388,333,55,310680.16,51535,362215.16
230190,201703,2101,1686,415,1576687.69,388543,1965230.69
230195,201703,482,420,62,392884.1,58094,450978.1
230200,201703,357,313,44,292334.63,40563,332897.63
230205,201703,334,210,124,195031.96,116076.19,311108.15
230210,201703,1229,983,246,920145.18,229752.4,1149897.58
230220,201703,1309,907,402,849859,376674,1226533
230230,201703,873,771,102,719866.85,95574,815440.85
230240,201703,1576,1352,224,1265170.85,209466.45,1474637.30
230250,201703,1678,1369,309,1278488.47,288971,1567459.47
230260,201703,2792,1642,1150,1533735.79,1076613.75,2610349.54
230270,201703,1297,1046,251,977966.23,232658.3,1210624.53
230280,201703,2586,1920,666,1793512.02,624042,2417554.02
230290,201703,388,349,39,320842.92,36543,357385.92
230300,201703,502,367,135,342642.16,126495,469137.16
230310,201703,397,305,92,285785,86204,371989
230320,201703,842,719,123,670634.17,115242,785876.17
230330,201703,289,234,55,218508.4,51535,270043.4
230340,201703,453,362,91,337508.4,85267,422775.4
230350,201703,2855,1798,1057,1684668.52,987599.24,2672267.76
230360,201703,242,213,29,198687,27173,225860
230365,201703,169,135,34,125793,31858,157651
230370,201703,9215,4390,4825,4104039.39,4515118.05,8619157.44
230380,201703,446,382,64,357653,59031.8,416684.8
230390,201703,490,266,224,247471.07,209888,457359.07
230393,201703,272,227,45,211859.4,42165,254024.4
230395,201703,315,260,55,243377,51535,294912
230400,201703,601,479,122,446574.9,113826.76,560401.66
230410,201703,2466,1518,948,1418478.55,887952,2306430.55
230420,201703,5463,3530,1933,3290140.34,1805516.45,5095656.79
230423,201703,295,254,41,236124.8,38417,274541.8
230425,201703,319,267,52,250179,48724,298903
230426,201703,103,93,10,86428.88,9088.9,95517.78
230427,201703,79,76,3,71212,2811,74023
230428,201703,1291,658,633,616040.02,593121,1209161.02
230430,201703,431,337,94,315578,87314.34,402892.34
230435,201703,719,497,222,464649,207077.27,671726.27
230440,201703,79844,34909,44935,32633033.59,42064690.77,74697724.36
230445,201703,248,170,78,159290,73086,232376
230450,201703,526,419,107,392603,100259,492862
230460,201703,51,44,7,41228,6559,47787
230465,201703,286,229,57,214573,53409,267982
230470,201703,1770,1369,401,1282753,374649.59,1657402.59
230480,201703,138,134,4,125276.9,3748,129024.9
230490,201703,265,214,51,200518,47787,248305
230495,201703,409,306,103,285885,96511,382396
230500,201703,910,672,238,627790,222997,850787
230510,201703,41,33,8,30921,7496,38417
230520,201703,386,305,81,285785,75897,361682
230523,201703,1741,1135,606,1062245.66,567382,1629627.66
230526,201703,287,240,47,224880,44039,268919
230530,201703,657,492,165,458045.38,153668.6,611713.98
230533,201703,169,164,5,153668,4685,158353
230535,201703,331,245,86,229565,80582,310147
230540,201703,1805,1578,227,1475987.7,212418,1688405.7
230550,201703,3513,2225,1288,2077697.43,1206012.7,3283710.13
230560,201703,572,439,133,409282.4,123684,532966.4
230565,201703,179,128,51,119936,47787,167723
230570,201703,302,270,32,252990,29984,282974
230580,201703,1070,792,278,740670.39,258986.8,999657.19
230590,201703,886,689,197,641425.05,184120.9,825545.95
230600,201703,236,218,18,202598.32,16866,219464.32
230610,201703,323,258,65,241559,60905,302464
230620,201703,157,128,29,118999,27173,146172
230625,201703,704,506,198,472764.25,184393.04,657157.29
230630,201703,1203,944,259,884528,242308.2,1126836.2
230640,201703,3279,2857,422,2670541.72,395414,3065955.72
230650,201703,385,340,45,317763.49,41509.1,359272.59
230655,201703,593,516,77,482555.4,72125.95,554681.35
230660,201703,306,254,52,237998,48724,286722
230670,201703,416,375,41,351375,38417,389792
230680,201703,195,179,16,167723,14992,182715
230690,201703,817,714,103,669018,96511,765529
230700,201703,691,589,102,551893,95011.8,646904.8
230710,201703,703,660,43,618233,40291,658524
230720,201703,128,109,19,101936.23,17803,119739.23
230725,201703,206,163,43,152731,40282,193013
230730,201703,11015,5969,5046,5574696.17,4718880.96,10293577.13
230740,201703,632,501,131,469156,122068.63,591224.63
230750,201703,774,651,123,608816.15,115251,724067.15
230760,201703,1172,1012,160,944102.68,149920,1094022.68
230763,201703,330,272,58,252943.41,54346,307289.41
230765,201703,6410,2962,3448,2768628.05,3227591.7,5996219.75
230770,201703,4761,2451,2310,2286636.94,2161247.14,4447884.08
230780,201703,665,588,77,548989,72149,621138
230790,201703,175,141,34,132117,31071.66,163188.66
230800,201703,1069,781,288,731792.32,269856,1001648.32
230810,201703,1213,1076,137,1006947.05,128369,1135316.05
230820,201703,308,222,86,207078,80582,287660
230830,201703,923,803,120,749743.02,112440,862183.02
230835,201703,263,228,35,212699,32093,244792
230837,201703,161,135,26,126495,24362,150857
230840,201703,850,680,170,635942.5,158072,794014.5
230850,201703,1412,1242,170,1163472.9,159009,1322481.9
230860,201703,306,221,85,207077,78708.25,285785.25
230870,201703,1714,1452,262,1359306,244182.4,1603488.4
230880,201703,10,7,3,6559,2811,9370
230890,201703,561,519,42,486303,39354,525657
230900,201703,252,196,56,183652,52279,235931
230910,201703,189,152,37,141674.4,34669,176343.4
230920,201703,367,289,78,270793,73086,343879
230930,201703,879,629,250,586562.92,234250,820812.92
230940,201703,812,652,160,610642.9,149733,760375.9
230945,201703,432,365,67,341818,62779,404597
230950,201703,348,300,48,281100,44976,326076
230960,201703,2300,1523,777,1420170.67,727768,2147938.67
230970,201703,1601,900,701,842404.45,655974.96,1498379.41
230980,201703,198,164,34,153668,31858,185526
230990,201703,139,113,26,105881,23618.95,129499.95
231000,201703,186,171,15,158353.74,14055,172408.74
231010,201703,131,104,27,97448,25299,122747
231020,201703,1161,819,342,765810.5,320434,1086244.5
231025,201703,885,659,226,615356.6,210244.9,825601.5
231030,201703,1139,952,187,892020,174938,1066958
231040,201703,130,89,41,82662.14,37699,120361.14
231050,201703,998,884,114,826435.5,106818,933253.5
231060,201703,129,114,15,106818,14055,120873
231070,201703,1352,962,390,899233.31,365359,1264592.31
231080,201703,246,229,17,214573,15929,230502
231085,201703,490,310,180,289534,168660,458194
231090,201703,222,186,36,174282,33732,208014
231095,201703,158,127,31,118999,29047,148046
231100,201703,114,92,22,86204,19395.9,105599.9
231110,201703,312,268,44,249621.39,41228,290849.39
231120,201703,291,252,39,235173.88,36356,271529.88
231123,201703,132,124,8,116188,7496,123684
231126,201703,265,227,38,212699,35606,248305
231130,201703,4398,3425,973,3200714.34,911101.42,4111815.76
231135,201703,181,156,25,146172,22183.2,168355.2
231140,201703,2979,2189,790,2047527.79,738419.24,2785947.03
231150,201703,330,316,14,296092,13118,309210
231160,201703,1174,928,246,866257.25,230277.12,1096534.37
231170,201703,532,341,191,319517,178967,498484
231180,201703,1452,1215,237,1137565.4,222069,1359634.4
231190,201703,207,185,22,173345,20614,193959
231195,201703,204,175,29,163263.91,27173,190436.91
231200,201703,797,654,143,612798,132753,745551
231210,201703,587,490,97,459130,90889,550019
231220,201703,977,703,274,657775,256738,914513
231230,201703,1314,1065,249,995602.3,233031.9,1228634.2
231240,201703,1240,899,341,842081.9,318299.1,1160381.0
231250,201703,103,96,7,89952,6559,96511
231260,201703,296,187,109,174937.9,101852,276789.9
231270,201703,962,800,162,745260.49,151785,897045.49
231280,201703,45,37,8,34669,7496,42165
231290,201703,7007,3850,3157,3598584.7,2955815.05,6554399.75
231300,201703,609,562,47,526594,44039,570633
231310,201703,675,630,45,589115,42160.32,631275.32
231320,201703,526,406,120,379955,112440,492395
231325,201703,84,73,11,68401,10307,78708
231330,201703,1959,1514,445,1413141.19,414343.3,1827484.49
231335,201703,250,216,34,202392,31858,234250
231340,201703,1489,1099,390,1028639.24,365430,1394069.24
231350,201703,1083,886,197,829714,183745.8,1013459.8
231355,201703,369,321,48,300650.51,44976,345626.51
231360,201703,444,361,83,335595.1,77771,413366.1
231370,201703,84,67,17,62779,15929,78708
231375,201703,266,196,70,183652,65590,249242
231380,201703,406,334,72,311391.36,67276.6,378667.96
231390,201703,189,155,34,145235,31858,177093
231395,201703,715,437,278,408194.68,260486,668680.68
231400,201703,1022,843,179,787378.6,167385.9,954764.5
231410,201703,1247,992,255,924024.8,237716.9,1161741.7
240010,201703,386,184,202,171276.54,189079,360355.54
240020,201703,2073,1569,504,1468707.07,472248,1940955.07
240030,201703,172,140,32,131180,29984,161164
240040,201703,31,31,0,29047,0,29047
240050,201703,480,409,71,381645.06,66527,448172.06
240060,201703,69,64,5,59968,4685,64653
240070,201703,144,110,34,103070,31858,134928
240080,201703,375,236,139,221128,130243,351371
240090,201703,105,94,11,87779,10307,98086
240100,201703,1390,1314,76,1228298.18,71004.49,1299302.67
240110,201703,935,578,357,540631.03,334509,875140.03
240120,201703,135,113,22,105881,20614,126495
240130,201703,284,265,19,247601.31,17803,265404.31
240140,201703,84,64,20,59968,18740,78708
240145,201703,637,557,80,521393.65,74753.86,596147.51
240150,201703,19,16,3,14992,2796.95,17788.95
240160,201703,51,42,9,39354,8433,47787
240165,201703,35,32,3,29750,2811,32561
240170,201703,83,65,18,60905,16866,77771
240180,201703,69,55,14,51535,13118,64653
240185,201703,39,36,3,33722.63,2811,36533.63
240190,201703,19,17,2,15929,1874,17803
240200,201703,2881,1606,1275,1499348.2,1193458,2692806.2
240210,201703,151,118,33,110566,30921,141487
240220,201703,1106,792,314,742104,294208.63,1036312.63
240230,201703,799,741,58,691533.68,53709,745242.68
240240,201703,138,99,39,92763,36543,129306
240250,201703,90,79,11,74023,10307,84330
240260,201703,1731,1279,452,1197748.36,422558.89,1620307.25
240270,201703,180,164,16,153293.2,14992,168285.2
240280,201703,44,34,10,31858,9370,41228
240290,201703,63,60,3,56220,2811,59031
240300,201703,169,99,70,92375,65590,157965
240310,201703,1841,1007,834,935788.66,778281.06,1714069.72
240320,201703,216,205,11,192085,10307,202392
240325,201703,4011,2438,1573,2276025.17,1471766.41,3747791.58
240330,201703,68,66,2,61842,1874,63716
240340,201703,92,65,27,60905,25299,86204
240350,201703,91,80,11,74960,10307,85267
240360,201703,323,232,91,217103,85267,302370
240370,201703,39,37,2,34669,1874,36543
240375,201703,79,47,32,44039,29984,74023
240380,201703,237,194,43,180881,40198,221079
240390,201703,19,16,3,14992,2811,17803
240400,201703,81,78,3,73086,2811,75897
240410,201703,8,6,2,5622,1874,7496
240420,201703,832,637,195,595559.07,181703.04,777262.11
240430,201703,247,233,14,216615.11,13118,229733.11
240440,201703,62,34,28,31858,26236,58094
240450,201703,174,112,62,104381.9,58094,162475.9
240460,201703,57,45,12,42165,11244,53409
240470,201703,225,191,34,178419.79,31858,210277.79
240480,201703,16,16,0,14898.3,0,14898.3
240485,201703,65,54,11,50707,10307,61014
240490,201703,49,49,0,45707,0,45707
240500,201703,83,68,15,63716,14055,77771
240510,201703,43,30,13,28110,12181,40291
240520,201703,136,130,6,121810,5622,127432
240530,201703,38,34,4,31858,3748,35606
240540,201703,80,69,11,64653,10297.63,74950.63
240550,201703,17,14,3,13118,2811,15929
240560,201703,355,258,97,241130.4,90889,332019.4
240570,201703,430,260,170,242495.6,159290,401785.6
240580,201703,1241,1000,241,931613.95,224679.6,1156293.55
240590,201703,26,25,1,23425,937,24362
240600,201703,116,116,0,108692,0,108692
240610,201703,499,422,77,395133,71400,466533
240615,201703,40,38,2,35606,1874,37480
240620,201703,90,87,3,80582,2811,83393
240630,201703,39,37,2,34669,1874,36543
240640,201703,28,24,4,22488,3748,26236
240650,201703,217,185,32,172503,29984,202487
240660,201703,86,76,10,71212,9370,80582
240670,201703,270,157,113,145048.15,105881,250929.15
240680,201703,54,43,11,40291,10307,50598
240690,201703,48,45,3,42165,2811,44976
240700,201703,191,160,31,149920,29047,178967
240710,201703,1786,1131,655,1059092.3,611964.07,1671056.37
240720,201703,988,720,268,673694.23,251116,924810.23
240725,201703,66,62,4,58094,3748,61842
240730,201703,128,111,17,104007,15929,119936
240740,201703,227,189,38,175753.09,35606,211359.09
240750,201703,37,23,14,21551,13118,34669
240760,201703,35,30,5,28110,4685,32795
240770,201703,139,108,31,101196,29042.32,130238.32
240780,201703,693,580,113,541764.03,105881,647645.03
240790,201703,42,40,2,37480,1874,39354
240800,201703,8183,5534,2649,5150772.36,2475977.6,7626749.96
240810,201703,19259,10483,8776,9781089.06,8214017.52,17995106.58
240820,201703,180,115,65,107469.22,60905,168374.22
240830,201703,1535,1262,273,1175632.55,254865,1430497.55
240840,201703,76,64,12,59968,11244,71212
240850,201703,88,76,12,71212,11244,82456
240860,201703,115,113,2,105881,1874,107755
240870,201703,48,41,7,38417,6559,44976
240880,201703,25,24,1,22478.63,937,23415.63
240890,201703,1068,626,442,582723.85,413213,995936.85
240895,201703,44,33,11,30921,10307,41228
240910,201703,146,133,13,124621,12181,136802
240920,201703,16,12,4,11244,3748,14992
240930,201703,358,323,35,301714,32795,334509
240933,201703,17,12,5,11244,4685,15929
240940,201703,2383,2105,278,1962927.41,257750.36,2220677.77
240950,201703,48,47,1,44039,937,44976
240960,201703,33,26,7,24362,6559,30921
240970,201703,151,109,42,102133,38617,140750
240980,201703,167,132,35,123684,32795,156479
240990,201703,113,72,41,67464,38417,105881
241000,201703,82,73,9,68214,8433,76647
241010,201703,55,43,12,40291,11244,51535
241020,201703,117,109,8,102133,7496,109629
241025,201703,9,3,6,2811,5622,8433
241030,201703,123,100,23,93700,21551,115251
241040,201703,29,24,5,22488,4685,27173
241050,201703,96,83,13,77771,12181,89952
241060,201703,34,31,3,29047,2811,31858
241070,201703,19,19,0,17803,0,17803
241080,201703,65,57,8,53127.9,7496,60623.9
241090,201703,51,41,10,38417,9327.9,47744.9
241100,201703,75,67,8,62779,7496,70275
241105,201703,7,3,4,2811,3748,6559
241110,201703,50,47,3,44039,2811,46850
241120,201703,1357,1046,311,977947.4,290544.96,1268492.36
241140,201703,221,178,43,165850,40291,206141
241142,201703,44,42,2,39354,1874,41228
241150,201703,1185,1040,145,971810.5,135819,1107629.5
241160,201703,25,23,2,21551,1874,23425
241170,201703,42,39,3,36543,2811,39354
241180,201703,50,39,11,36371.53,10307,46678.53
241190,201703,46,45,1,42165,937,43102
241200,201703,3610,1995,1615,1863887.01,1512024.64,3375911.65
241210,201703,73,58,15,54346,13212,67558
241220,201703,1311,868,443,812706.7,415072.26,1227778.96
241230,201703,234,195,39,182527.6,36543,219070.6
241240,201703,51,39,12,36543,11244,47787
241250,201703,1032,965,67,904205,62498,966703
241255,201703,39,33,6,30921,5622,36543
241260,201703,621,492,129,460999.32,120873,581872.32
241270,201703,45,30,15,28110,14055,42165
241280,201703,100,86,14,80582,13118,93700
241290,201703,101,74,27,69338,25299,94637
241300,201703,78,55,23,51535,21551,73086
241310,201703,53,42,11,39214,10307,49521
241320,201703,29,16,13,14616,12181,26797
241330,201703,57,52,5,48724,4685,53409
241335,201703,56,48,8,44976,7496,52472
241340,201703,182,135,47,126495,44039,170534
241350,201703,57,54,3,50598,2811,53409
241355,201703,41,38,3,35606,2811,38417
241360,201703,48,48,0,44976,0,44976
241370,201703,46,38,8,35606,7496,43102
241380,201703,44,42,2,39354,1874,41228
241390,201703,66,52,14,48536.6,13118,61654.6
241400,201703,185,150,35,139895,32795,172690
241410,201703,168,152,16,142424,14899,157323
241415,201703,90,71,19,66527,17803,84330
241420,201703,92,70,22,65590,20446,86036
241430,201703,32,31,1,29047,937,29984
241440,201703,432,361,71,338257,66527,404784
241445,201703,30,28,2,26236,1874,28110
241450,201703,278,226,52,211638,48724,260362
241460,201703,128,115,13,107521,12181,119702
241470,201703,45,37,8,34669,7496,42165
241475,201703,68,65,3,60905,2811,63716
241480,201703,88,63,25,59031,23425,82456
241490,201703,8,6,2,5622,1593,7215
241500,201703,49,36,13,33732,12181,45913
250010,201703,98,86,12,80582,11244,91826
250020,201703,21,18,3,16866,2811,19677
250030,201703,799,581,218,543076.1,202328.51,745404.61
250040,201703,309,263,46,246431,43102,289533
250050,201703,211,177,34,165849,31858,197707
250053,201703,55,43,12,40291,11244,51535
250057,201703,0,0,0,0,0,0
250060,201703,424,331,93,310147,87141,397288
250070,201703,661,574,87,535858,81519,617377
250073,201703,8,8,0,7496,0,7496
250077,201703,203,149,54,139229.6,50598,189827.6
250080,201703,420,323,97,301059.1,90889,391948.1
250090,201703,212,142,70,132117.2,64734.26,196851.46
250100,201703,443,361,82,338257,76460,414717
250110,201703,447,339,108,315891.6,101196,417087.6
250115,201703,29,8,21,7496,19677,27173
250120,201703,96,76,20,71212,18740,89952
250130,201703,581,458,123,429146,115064,544210
250135,201703,12,8,4,7496,3748,11244
250140,201703,69,63,6,59031,5622,64653
250150,201703,535,399,136,372391,127122.79,499513.79
250153,201703,11,10,1,9370,937,10307
250157,201703,27,22,5,20614,4685,25299
250160,201703,204,160,44,149920,41228,191148
250170,201703,69,48,21,44976,19677,64653
250180,201703,3809,2572,1237,2397032.94,1154305.35,3551338.29
250190,201703,931,601,330,561497.25,308507.25,870004.50
250200,201703,47,40,7,37480,6559,44039
250205,201703,15,13,2,12181,1874,14055
250210,201703,88,76,12,71212,11244,82456
250215,201703,60,52,8,48724,7496,56220
250220,201703,24,18,6,16866,5622,22488
250230,201703,67,62,5,58094,4685,62779
250240,201703,226,185,41,172548.55,38417,210965.55
250250,201703,388,331,57,310147,53409,363556
250260,201703,29,25,4,23425,3748,27173
250270,201703,53,42,11,39354,10307,49661
250280,201703,392,325,67,304525,62779,367304
250290,201703,84,78,6,72804.9,5622,78426.9
250300,201703,571,386,185,361046.24,173331.63,534377.87
250310,201703,42,36,6,33732,5622,39354
250320,201703,1805,1245,560,1160547.84,523502,1684049.84
250330,201703,75,64,11,59968,10307,70275
250340,201703,24,20,4,18740,3748,22488
250350,201703,127,80,47,74960,43476.8,118436.8
250355,201703,22,17,5,15929,4685,20614
250360,201703,197,160,37,149920,34435,184355
250370,201703,2296,1572,724,1467157.59,675922.71,2143080.30
250375,201703,22,18,4,16866,3748,20614
250380,201703,48,33,15,30921,14055,44976
250390,201703,31,26,5,24362,4685,29047
250400,201703,15144,7640,7504,7137282.84,7022739.92,14160022.76
250403,201703,406,338,68,316696.64,63716,380412.64
250407,201703,50,44,6,41228,5622,46850
250410,201703,27,23,4,21551,3748,25299
250415,201703,38,24,14,22488,13099.26,35587.26
250420,201703,46,37,9,34669,8433,43102
250430,201703,1676,1404,272,1313394,254864,1568258
250435,201703,13,11,2,10307,1874,12181
250440,201703,689,593,96,553309.29,89952,643261.29
250450,201703,82,69,13,64653,11525.1,76178.1
250460,201703,387,264,123,247368,115118.42,362486.42
250470,201703,89,65,24,60905,22488,83393
250480,201703,324,254,70,237998,65590,303588
250485,201703,2,1,1,937,937,1874
250490,201703,201,166,35,155542,32795,188337
250500,201703,72,52,20,48724,18740,67464
250510,201703,702,538,164,502794.8,152724.26,655519.06
250520,201703,172,115,57,107736.28,53404.32,161140.60
250523,201703,107,88,19,82456,17803,100259
250527,201703,104,79,25,74018.32,23425,97443.32
250530,201703,6,5,1,4685,937,5622
250535,201703,25,20,5,18740,4685,23425
250540,201703,121,90,31,83627.25,29047,112674.25
250550,201703,68,65,3,60905,2811,63716
250560,201703,35,29,6,27173,5622,32795
250570,201703,151,119,32,111503,29984,141487
250580,201703,141,109,32,101677.16,29984,131661.16
250590,201703,17,14,3,13118,2811,15929
250600,201703,1241,841,400,785020.64,374702.32,1159722.96
250610,201703,153,131,22,122747,20614,143361
250620,201703,20,16,4,14992,3748,18740
250625,201703,56,41,15,38417,14055,52472
250630,201703,2934,1871,1063,1746730.07,994699.6,2741429.67
250640,201703,196,166,30,155542,28110,183652
250650,201703,31,21,10,19677,9370,29047
250660,201703,34,29,5,27173,4685,31858
250670,201703,51,35,16,32795,14992,47787
250680,201703,389,316,73,296092,68401,364493
250690,201703,1706,1168,538,1091198.76,503731.9,1594930.66
250700,201703,930,811,119,755712.3,111503,867215.3
250710,201703,436,336,100,314832,93700,408532
250720,201703,98,78,20,73086,18740,91826
250730,201703,357,299,58,277165.16,54346,331511.16
250740,201703,44,40,4,37480,3748,41228
250750,201703,19376,11531,7845,10751517.58,7342287.55,18093805.13
250760,201703,61,48,13,44976,12181,57157
250770,201703,337,226,111,210825.31,102859.27,313684.58
250780,201703,51,40,11,37480,10307,47787
250790,201703,499,308,191,285785.76,178264.25,464050.01
250800,201703,147,134,13,124855.25,12181,137036.25
250810,201703,80,59,21,55283,19677,74960
250820,201703,153,122,31,114314,29047,143361
250830,201703,428,284,144,265124.25,134928,400052.25
250840,201703,51,48,3,44976,2811,47787
250850,201703,48,39,9,35868.36,8433,44301.36
250855,201703,14,12,2,11244,1874,13118
250860,201703,189,138,51,129306,47505.9,176811.9
250870,201703,32,29,3,27173,2811,29984
250880,201703,73,56,17,52425.15,15929,68354.15
250890,201703,2249,1648,601,1542864.2,562289.57,2105153.77
250900,201703,42,33,9,30921,8433,39354
250905,201703,129,98,31,91826,29047,120873
250910,201703,1145,811,334,758211.04,312676.9,1070887.94
250915,201703,106,74,32,69338,29984,99322
250920,201703,132,100,32,93700,29984,123684
250930,201703,145,91,54,85267,50598,135865
250933,201703,1,1,0,937,0,937
250937,201703,8,7,1,6559,937,7496
250939,201703,29,22,7,20614,6559,27173
250940,201703,102,74,28,69338,26236,95574
250950,201703,73,50,23,46850,21551,68401
250960,201703,88,47,41,44018.89,38417,82435.89
250970,201703,1173,825,348,770496,325794.9,1096290.9
250980,201703,88,62,26,58094,24362,82456
250990,201703,156,119,37,111081.4,34640.9,145722.3
251000,201703,72,66,6,61654.6,5622,67276.6
251010,201703,87,67,20,62775,17975.4,80750.4
251020,201703,76,66,10,61045.55,9370,70415.55
251030,201703,38,29,9,27173,8433,35606
251040,201703,50,35,15,32795,14055,46850
251050,201703,25,23,2,21551,1874,23425
251060,201703,45,36,9,32795,8433,41228
251065,201703,4,3,1,2811,937,3748
251070,201703,25,19,6,17794,5622,23416
251080,201703,4595,2218,2377,2065166.78,2221492.21,4286658.99
251090,201703,198,170,28,159290,26236,185526
251100,201703,17,16,1,14992,937,15929
251110,201703,42,33,9,30921,8433,39354
251120,201703,1732,1017,715,947813.2,669955,1617768.2
251130,201703,340,273,67,255801,62779,318580
251140,201703,481,309,172,288410,160998.34,449408.34
251150,201703,282,244,38,227870,35606,263476
251160,201703,89,71,18,66523,16866,83389
251170,201703,98,76,22,71188.6,20604.64,91793.24
251180,201703,284,176,108,164912,101187.32,266099.32
251190,201703,190,131,59,122424.68,55283,177707.68
251200,201703,244,194,50,181778,46850,228628
251203,201703,28,26,2,24362,1874,26236
251207,201703,89,73,16,68401,14992,83393
251210,201703,1167,828,339,774309.34,316987.1,1091296.44
251220,201703,44,35,9,32795,8433,41228
251230,201703,508,434,74,406638,69338,475976
251240,201703,104,73,31,67464,29047,96511
251250,201703,1280,911,369,851499.1,345613,1197112.1
251260,201703,13,8,5,7496,4685,12181
251270,201703,333,246,87,230502,81379,311881
251272,201703,71,65,6,60905,5622,66527
251274,201703,25,20,5,18740,4685,23425
251275,201703,20,14,6,13118,5622,18740
251276,201703,16,13,3,12181,2811,14992
251278,201703,9,7,2,6559,1874,8433
251280,201703,83,79,4,74023,3748,77771
251290,201703,699,527,172,493799,161164,654963
251300,201703,17,15,2,14055,1874,15929
251310,201703,342,243,99,227687,92763,320450
251315,201703,15,14,1,13118,937,14055
251320,201703,60,47,13,44039,12181,56220
251330,201703,76,67,9,62779,8433,71212
251335,201703,9,5,4,4685,3748,8433
251340,201703,672,401,271,375737,252920.63,628657.63
251350,201703,32,30,2,28110,1874,29984
251360,201703,62,54,8,50395.61,7496,57891.61
251365,201703,15,15,0,14055,0,14055
251370,201703,5047,3395,1652,3174690.77,1546613.5,4721304.27
251380,201703,51,39,12,36543,11244,47787
251385,201703,2,2,0,1874,0,1874
251390,201703,609,491,118,458943.6,109348,568291.6
251392,201703,27,16,11,14992,10307,25299
251394,201703,10,9,1,8433,937,9370
251396,201703,20,15,5,14055,4685,18740
251398,201703,19,17,2,15929,1874,17803
251400,201703,36,30,6,28110,5622,33732
251410,201703,33,29,4,27173,3748,30921
251420,201703,106,80,26,74960,24362,99322
251430,201703,35,33,2,30921,1874,32795
251440,201703,39,25,14,23416,13118,36534
251445,201703,42,37,5,34669,4685,39354
251450,201703,398,352,46,328198.4,43102,371300.4
251455,201703,2,1,1,937,937,1874
251460,201703,15,11,4,10307,3748,14055
251465,201703,5,2,3,1874,2811,4685
251470,201703,43,34,9,31858,8433,40291
251480,201703,24,22,2,20614,1874,22488
251490,201703,129,90,39,83862,35607,119469
251500,201703,109,90,19,84330,17054,101384
251510,201703,27,22,5,20614,4685,25299
251520,201703,22,22,0,20614,0,20614
251530,201703,4582,3199,1383,2991856.09,1295561.79,4287417.88
251540,201703,75,67,8,62779,7496,70275
251550,201703,420,320,100,298903.6,93466,392369.6
251560,201703,26,21,5,19677,4685,24362
251570,201703,18,18,0,16866,0,16866
251580,201703,114,94,20,88078,18740,106818
251590,201703,127,93,34,87141,31858,118999
251593,201703,19,11,8,10307,7496,17803
251597,201703,57,46,11,43102,10307,53409
251600,201703,1085,771,314,721115.94,292521.26,1013637.20
251610,201703,208,156,52,145516.1,48069,193585.1
251615,201703,1,1,0,937,0,937
251620,201703,4172,2788,1384,2604612.17,1294373.34,3898985.51
251630,201703,410,295,115,276415,107755,384170
251640,201703,148,103,45,96511,42165,138676
251650,201703,251,183,68,169672.55,63716,233388.55
251660,201703,217,197,20,183652.55,18740,202392.55
251670,201703,335,267,68,248615.07,63716,312331.07
251675,201703,2,2,0,1874,0,1874
251680,201703,82,78,4,73086,3748,76834
251690,201703,333,276,57,258612,53065.13,311677.13
251700,201703,280,227,53,212122.75,49646.95,261769.70
251710,201703,18,13,5,12181,4685,16866
251720,201703,34,23,11,21551,10026,31577
251740,201703,10,8,2,7496,1874,9370
260005,201703,3049,1726,1323,1605683.42,1237284.87,2842968.29
260010,201703,1245,884,361,825145.76,337039.56,1162185.32
260020,201703,429,380,49,356060,45913,401973
260030,201703,560,405,155,378731.65,145235,523966.65
260040,201703,853,521,332,487099.45,311074.63,798174.08
260050,201703,1112,777,335,727815,313333,1041148
260060,201703,412,370,42,345940.4,39354,385294.4
260070,201703,1379,874,505,815094,470264.58,1285358.58
260080,201703,733,570,163,532872.55,152731,685603.55
260090,201703,559,346,213,323977.86,199581,523558.86
260100,201703,221,153,68,142377.6,63716,206093.6
260105,201703,238,131,107,122747,100259,223006
260110,201703,2583,1923,660,1801832.63,617624,2419456.63
260120,201703,2864,1585,1279,1474646.73,1195769.55,2670416.28
260130,201703,141,95,46,89015,43102,132117
260140,201703,1990,1299,691,1209412.56,645950.63,1855363.19
260150,201703,233,149,84,139613,78708,218321
260160,201703,281,244,37,228628,34669,263297
260170,201703,3141,1925,1216,1796158.24,1138455,2934613.24
260180,201703,117,101,16,94637,14992,109629
260190,201703,2258,1613,645,1507556.17,604365,2111921.17
260200,201703,856,709,147,663571.24,137458,801029.24
260210,201703,1384,960,424,899371.96,397279,1296650.96
260220,201703,683,627,56,586727,52472,639199
260230,201703,1168,882,286,824282.15,267982,1092264.15
260240,201703,204,151,53,140334.49,49661,189995.49
260250,201703,63,51,12,47787,11244,59031
260260,201703,954,682,272,639034,254864,893898
260270,201703,437,355,82,331417.2,76552.9,407970.1
260280,201703,918,703,215,658523.6,200893,859416.6
260290,201703,6255,3285,2970,3059314.51,2776750.06,5836064.57
260300,201703,783,686,97,640477.23,90608,731085.23
260310,201703,483,379,104,353113.13,97448,450561.13
260320,201703,897,673,224,630505,209888,840393
260330,201703,24,20,4,18740,3748,22488
260340,201703,64,47,17,44039,15929,59968
260345,201703,5414,3078,2336,2877510.92,2187561.01,5065071.93
260350,201703,454,332,122,309165.02,113378,422543.02
260360,201703,301,154,147,144298,137739,282037
260370,201703,616,394,222,367351.7,207877,575228.7
260380,201703,594,427,167,400099,155356,555455
260390,201703,286,243,43,226515.19,39354,265869.19
260392,201703,86,76,10,71212,9370,80582
260400,201703,4055,2308,1747,2152451.2,1636583.41,3789034.61
260410,201703,13840,7539,6301,7049597.81,5901238.5,12950836.31
260415,201703,120,105,15,98385,14055,112440
260420,201703,1790,1036,754,965866.55,704110,1669976.55
260430,201703,191,175,16,162978.14,14992,177970.14
260440,201703,223,161,62,149584,58094,207678
260450,201703,478,339,139,316381,130243,446624
260460,201703,850,449,401,418091.4,375732.32,793823.72
260470,201703,362,218,144,203516.4,134038.55,337554.95
260480,201703,199,122,77,114314,72149,186463
260490,201703,203,163,40,152731,37480,190211
260500,201703,1114,738,376,688837,350486,1039323
260510,201703,710,554,156,519098,145235,664333
260515,201703,257,227,30,212699,27642,240341
260520,201703,3235,1890,1345,1762905.8,1258101.11,3021006.91
260530,201703,728,588,140,548187.65,131180,679367.65
260540,201703,579,428,151,401036,140550.66,541586.66
260545,201703,14,10,4,9370,3748,13118
260550,201703,327,201,126,188337,118062,306399
260560,201703,504,383,121,358291,113095.9,471386.9
260570,201703,993,823,170,768200.9,159290,927490.9
260580,201703,289,256,33,239872,30921,270793
260590,201703,636,360,276,335933.24,258612,594545.24
260600,201703,7772,4011,3761,3738252.91,3520773.32,7259026.23
260610,201703,488,322,166,301714,155542,457256
260620,201703,3415,1805,1610,1682118.2,1503390.94,3185509.14
260630,201703,69,66,3,61842,2811,64653
260640,201703,3566,1923,1643,1798576.45,1539145.05,3337721.50
260650,201703,335,230,105,215510,98342.85,313852.85
260660,201703,491,334,157,312493.68,146218.85,458712.53
260670,201703,101,76,25,71212,23425,94637
260680,201703,3654,2008,1646,1864133.45,1540373.52,3404506.97
260690,201703,191,155,36,144579.1,33732,178311.1
260700,201703,362,216,146,201643,135985,337628
260710,201703,40,38,2,35606,1874,37480
260720,201703,2177,1293,884,1205430.35,827530.29,2032960.64
260730,201703,570,433,137,405721,126495.45,532216.45
260740,201703,68,64,4,59968,3748,63716
260750,201703,646,442,204,414154,191148,605302
260760,201703,629,343,286,321391,267670,589061
260765,201703,953,499,454,464673.9,425163.75,889837.65
260770,201703,215,158,57,148046,53409,201455
260775,201703,818,483,335,450594.3,313895,764489.3
260780,201703,259,164,95,153668,88883.82,242551.82
260790,201703,12293,6730,5563,6280234.41,5204824.54,11485058.95
260795,201703,136,93,43,85997.86,40291,126288.86
260800,201703,360,297,63,277540,59031,336571
260805,201703,200,128,72,119220.13,67464,186684.13
260810,201703,737,641,96,599389.53,89952,689341.53
260820,201703,311,203,108,188822.05,101196,290018.05
260825,201703,190,131,59,122576.66,55283,177859.66
260830,201703,253,162,91,151653.45,85267,236920.45
260840,201703,218,156,62,144912,57813,202725
260845,201703,207,145,62,135865,58094,193959
260850,201703,521,375,146,349740.64,136802,486542.64
260860,201703,246,182,64,170339.86,59968,230307.86
260870,201703,369,259,110,242683,103070,345753
260875,201703,667,456,211,426178.53,197707,623885.53
260880,201703,1363,890,473,833224.31,443013.6,1276237.91
260890,201703,2440,1701,739,1587624.39,691507,2279131.39
260900,201703,1049,701,348,655558.95,326076,981634.95
260910,201703,275,216,59,202392,55283,257675
260915,201703,290,188,102,176156,95454,271610
260920,201703,163,93,70,87141,65590,152731
260930,201703,394,332,62,311084,58037.85,369121.85
260940,201703,2596,1426,1170,1332415.95,1095822,2428237.95
260950,201703,1864,1098,766,1022623.45,717742,1740365.45
260960,201703,14240,7380,6860,6879984.92,6419893.47,13299878.39
260970,201703,420,364,56,341068,52472,393540
260980,201703,204,175,29,163685,27173,190858
260990,201703,2456,2017,439,1889433.01,411343,2300776.01
261000,201703,4303,2476,1827,2308561.85,1709369.9,4017931.75
261010,201703,184,134,50,125558,46046.8,171604.8
261020,201703,612,450,162,421510,151794,573304
261030,201703,205,149,56,139613,52443.9,192056.9
261040,201703,358,323,35,302651,32513.9,335164.9
261050,201703,454,399,55,373863,51535,425398
261060,201703,1298,848,450,792468.88,421650,1214118.88
261070,201703,8851,4525,4326,4213049.61,4045381.93,8258431.54
261080,201703,387,290,97,271730,90889,362619
261090,201703,2103,1625,478,1514661.92,447137,1961798.92
261100,201703,1046,738,308,689679.8,287284.2,976964.0
261110,201703,7648,4651,2997,4353146.93,2804738.95,7157885.88
261120,201703,280,237,43,221788,40287,262075
261130,201703,572,316,256,295764.45,239591,535355.45
261140,201703,189,122,67,114314,62779,177093
261150,201703,656,378,278,352978,260486,613464
261153,201703,70,67,3,61842.12,2811,64653.12
261160,201703,75108,38200,36908,35674904.19,34559489.73,70234393.92
261170,201703,457,337,120,315488,112440,427928
261180,201703,1721,1048,673,976813.53,630601,1607414.53
261190,201703,623,422,201,395161.89,188318.63,583480.52
261200,201703,211,188,23,175451.09,21551,197002.09
261210,201703,30,28,2,26236,1874,28110
261220,201703,2362,1669,693,1558132.97,648217,2206349.97
261230,201703,319,238,81,222537.5,75882.95,298420.45
261240,201703,427,366,61,339000.47,57157,396157.47
261245,201703,201,167,34,156479,31858,188337
261247,201703,129,95,34,89015,31858,120873
261250,201703,2709,1319,1390,1233935.4,1301621,2535556.4
261255,201703,243,222,21,208014,19677,227691
261260,201703,808,698,110,654026,103070,757096
261270,201703,168,130,38,121810,35606,157416
261280,201703,135,109,26,102133,24362,126495
261290,201703,134,90,44,83868.77,41228,125096.77
261300,201703,1202,849,353,794679.44,330761,1125440.44
261310,201703,722,485,237,454445,221459.95,675904.95
261320,201703,522,355,167,332635,156479,489114
261330,201703,771,624,147,581744.25,136908.53,718652.78
261340,201703,327,176,151,164912,141487,306399
261350,201703,718,510,208,476933.1,194856,671789.1
261360,201703,1113,710,403,664875.53,377611,1042486.53
261370,201703,4778,2949,1829,2750438.95,1711402.21,4461841.16
261380,201703,571,410,161,382305.92,150576,532881.92
261390,201703,3210,2140,1070,2000542.22,999490.53,3000032.75
261400,201703,279,254,25,237435.8,23425,260860.8
261410,201703,995,655,340,613735,318576,932311
261420,201703,852,529,323,492898.09,302632.63,795530.72
261430,201703,328,297,31,277458,28765.9,306223.9
261440,201703,85,74,11,69338,10307,79645
261450,201703,2475,2053,422,1921254.87,394890.02,2316144.89
261460,201703,673,536,137,501296,128369,629665
261470,201703,229,175,54,163179,50598,213777
261480,201703,310,252,58,235001,54342,289343
261485,201703,339,206,133,192366.1,124621,316987.1
261500,201703,622,413,209,386981,195833,582814
261510,201703,40,27,13,25299,12181,37480
261520,201703,165,154,11,143362,10307,153669
261530,201703,4127,2621,1506,2447589.71,1409905,3857494.71
261540,201703,1052,635,417,594517.13,390729,985246.13
261550,201703,284,141,143,130759,133991,264750
261560,201703,738,492,246,458100.5,229087.8,687188.3
261570,201703,350,274,76,256738,71212,327950
261580,201703,367,285,82,266298,76834,343132
261590,201703,183,146,37,136802,34669,171471
261600,201703,273,223,50,208202,46382,254584
261610,201703,99,86,13,80234,12181,92415
261618,201703,64,50,14,46850,13118,59968
261620,201703,208,124,84,116188,78708,194896
261630,201703,588,448,140,417459.8,130993,548452.8
261640,201703,6007,3172,2835,2963811.75,2653594.26,5617406.01
261650,201703,471,285,186,266379.73,174282,440661.73
270010,201703,498,433,65,405721,60156,465877
270020,201703,305,239,66,223189.4,61842,285031.4
270030,201703,8926,5690,3236,5317838.15,3029625.43,8347463.58
270040,201703,1754,1062,692,994990.94,648122.9,1643113.84
270050,201703,185,136,49,127432,45913,173345
270060,201703,121,67,54,62779,50598,113377
270070,201703,919,650,269,607369.26,250807.16,858176.42
270080,201703,44,37,7,34669,6559,41228
270090,201703,20,16,4,14992,3748,18740
270100,201703,1316,852,464,794156.98,431724.12,1225881.10
270110,201703,175,128,47,119936,44039,163975
270120,201703,217,177,40,165012.72,37198.9,202211.62
270130,201703,256,173,83,161819.9,77489.9,239309.8
270135,201703,103,61,42,57157,39354,96511
270140,201703,1225,712,513,666485.98,478237.26,1144723.24
270150,201703,273,218,55,204266,51535,255801
270160,201703,513,374,139,350438,130243,480681
270170,201703,658,408,250,380703.1,233453.55,614156.65
270180,201703,69,52,17,48411.7,15722.86,64134.56
270190,201703,103,90,13,84330,12181,96511
270200,201703,111,101,10,94449.6,9370,103819.6
270210,201703,496,255,241,238935,225535.9,464470.9
270220,201703,206,164,42,153668,39354,193022
270230,201703,2013,1186,827,1105969.45,772112.94,1878082.39
270235,201703,730,541,189,506589.55,176734.48,683324.03
270240,201703,3025,2322,703,2165716.77,655405.9,2821122.67
270250,201703,171,122,49,113564.4,45913,159477.4
270255,201703,219,194,25,181778,23050.2,204828.2
270260,201703,318,255,63,238608,58749.9,297357.9
270270,201703,123,50,73,46841,68401,115242
270280,201703,222,142,80,133054,74960,208014
270290,201703,1126,839,287,784803.59,268038.89,1052842.48
270300,201703,254,161,93,150857,86859.9,237716.9
270310,201703,956,750,206,700838.28,192319.99,893158.27
270320,201703,904,761,143,710943.8,133991,844934.8
270330,201703,252,205,47,191148,44039,235187
270340,201703,61,47,14,44039,13118,57157
270350,201703,94,47,47,44039,44039,88078
270360,201703,83,43,40,40291,37480,77771
270370,201703,52,38,14,35606,13118,48724
270375,201703,62,37,25,34669,23421,58090
270380,201703,1068,581,487,543460,456319,999779
270390,201703,200,105,95,98385,89015,187400
270400,201703,687,490,197,457655.33,184580,642235.33
270410,201703,723,508,215,475986.63,201445.63,677432.26
270420,201703,380,242,138,225087,129223.89,354310.89
270430,201703,31267,22176,9091,20727539.81,8509681.2,29237221.01
270440,201703,503,392,111,366320.55,104007,470327.55
270450,201703,756,374,382,350203.75,356997.73,707201.48
270460,201703,207,147,60,137739,56220,193959
270470,201703,1295,846,449,792353.95,420480,1212833.95
270480,201703,493,387,106,359530.19,98619.25,458149.44
270490,201703,25,19,6,17803,5622,23425
270500,201703,510,410,100,384170,93700,477870
270510,201703,731,446,285,417902,267045,684947
270520,201703,423,254,169,237651.45,158353,396004.45
270530,201703,66,57,9,53409,8433,61842
270540,201703,128,97,31,90889,29047,119936
270550,201703,1721,1286,435,1203161.69,407496.62,1610658.31
270560,201703,331,148,183,138676,171471,310147
270570,201703,417,260,157,242804.73,147109,389913.73
270580,201703,72,50,22,46850,20614,67464
270590,201703,86,72,14,67464,13097.89,80561.89
270600,201703,177,144,33,134928,30921,165849
270610,201703,158,121,37,113368,34669,148037
270620,201703,34,32,2,29984,1874,31858
270630,201703,3779,2855,924,2663896.86,863671.38,3527568.24
270640,201703,883,634,249,592090.3,233004.9,825095.2
270642,201703,193,162,31,151794,29047,180841
270644,201703,299,200,99,187212.97,92758.32,279971.29
270650,201703,237,138,99,129306,92763,222069
270660,201703,259,207,52,193959,48724,242683
270670,201703,3150,2362,788,2202887.64,736192.12,2939079.76
270680,201703,456,260,196,243611,183647.32,427258.32
270690,201703,1204,727,477,679497.24,446939.63,1126436.87
270700,201703,38,29,9,27173,8433,35606
270710,201703,851,624,227,583101.86,212699,795800.86
270720,201703,249,186,63,174282,58749.9,233031.9
270730,201703,1752,1004,748,939484.2,698807.6,1638291.8
270740,201703,46,28,18,26236,16866,43102
270750,201703,618,447,171,418839,159572,578411
270760,201703,313,230,83,215510,77771,293281
270770,201703,2646,1624,1022,1514024.16,956677,2470701.16
270780,201703,91,55,36,51530.32,33714.64,85244.96
270790,201703,287,193,94,180841,88078,268919
270800,201703,1968,1543,425,1444967.12,397494.14,1842461.26
270810,201703,319,250,69,234235.95,64644.32,298880.27
270820,201703,157,98,59,91826,55190,147016
270830,201703,1027,737,290,689820,271730,961550
270840,201703,1401,1004,397,940256.2,371053,1311309.2
270850,201703,1780,1070,710,997952.95,664581.68,1662534.63
270860,201703,2426,1550,876,1448147.3,818865.11,2267012.41
270870,201703,127,69,58,64653,54346,118999
270880,201703,907,645,262,601776.19,244608.49,846384.68
270890,201703,387,283,104,264889.9,97443.32,362333.22
270895,201703,75,61,14,57157,13118,70275
270900,201703,112,90,22,84330,20614,104944
270910,201703,338,264,74,246243.6,69338,315581.6
270915,201703,1753,1015,738,945914.73,691014.57,1636929.30
270920,201703,500,412,88,386044,82456,468500
270930,201703,6256,4455,1801,4168887.57,1685711.94,5854599.51
270940,201703,2396,1798,598,1683540.69,558622,2242162.69
280010,201703,43,39,4,36543,3748,40291
280020,201703,699,595,104,555610.31,96511,652121.31
280030,201703,18382,11706,6676,10892607.11,6224707.19,17117314.30
280040,201703,345,218,127,204266,117593.5,321859.5
280050,201703,374,283,91,264885.9,85267,350152.9
280060,201703,313,207,106,191783.48,99322,291105.48
280067,201703,972,676,296,630704.26,276415.12,907119.38
280070,201703,127,105,22,97636,20614,118250
280100,201703,595,466,129,432634.88,120686,553320.88
280110,201703,78,71,7,66527,6559,73086
280120,201703,605,480,125,448963.55,117125,566088.55
280130,201703,1262,771,491,720881.9,459926.45,1180808.35
280140,201703,467,368,99,343972.7,92763,436735.7
280150,201703,307,222,85,207346.21,78708,286054.21
280160,201703,99,84,15,78020.86,14055,92075.86
280170,201703,569,374,195,349501.68,181918.55,531420.23
280190,201703,28,25,3,23425,2811,26236
280200,201703,17,12,5,11244,4685,15929
280210,201703,2696,1887,809,1751336.82,752801.06,2504137.88
280220,201703,38,30,8,28110,7496,35606
280230,201703,292,240,52,224060.95,47787.1,271848.05
280240,201703,106,100,6,93560,5622,99182
280250,201703,23,13,10,12181,9370,21551
280260,201703,77,69,8,64653,7496,72149
280270,201703,155,117,38,109629,35606,145235
280280,201703,198,125,73,117125,68401,185526
280290,201703,2923,2113,810,1965849.28,757401.63,2723250.91
280300,201703,1054,791,263,740230,245681.4,985911.4
280310,201703,105,99,6,92576,5622,98198
280320,201703,618,416,202,389783,189274,579057
280330,201703,360,253,107,235700.29,100137.19,335837.48
280340,201703,394,316,78,294647.05,73086,367733.05
280350,201703,3278,2527,751,2358275.26,701932.46,3060207.72
280360,201703,462,294,168,275478,156479,431957
280370,201703,89,76,13,71212,12181,83393
280380,201703,54,40,14,37480,13118,50598
280390,201703,175,145,30,135865,28110,163975
280400,201703,307,207,100,193116.4,93700,286816.4
280410,201703,288,229,59,213431,55273.63,268704.63
280420,201703,169,141,28,132117,26236,158353
280430,201703,103,76,27,71212,25299,96511
280440,201703,646,488,158,452244.8,148027.26,600272.06
280445,201703,114,105,9,98385,8433,106818
280450,201703,1014,865,149,807731.48,139613,947344.48
280460,201703,690,492,198,453704.06,185526,639230.06
280470,201703,190,172,18,161164,15930,177094
280480,201703,2174,1552,622,1442163.74,579028.43,2021192.17
280490,201703,380,347,33,323995,30921,354916
280500,201703,55,49,6,45913,5622,51535
280510,201703,138,105,33,98087.6,30640,128727.6
280520,201703,57,42,15,39354,14055,53409
280530,201703,74,54,20,50598,18740,69338
280540,201703,484,383,101,358871,94355.9,453226.9
280550,201703,681,631,50,588677.3,46850,635527.3
280560,201703,468,399,69,371989,64653,436642
280570,201703,1719,1291,428,1206382.42,401017.26,1607399.68
280580,201703,592,446,146,417763,136709,554472
280590,201703,167,102,65,95299.46,60905,156204.46
280600,201703,340,286,54,266314.54,50598,316912.54
280610,201703,143,102,41,95372,38417,133789
280620,201703,549,440,109,411343,101992.45,513335.45
280630,201703,165,136,29,127432,27173,154605
280640,201703,199,154,45,143484,42165,185649
280650,201703,85,54,31,50598,29047,79645
280660,201703,126,93,33,87141,30686.75,117827.75
280670,201703,1458,909,549,845712.63,510735.98,1356448.61
280680,201703,181,152,29,140672.62,27173,167845.62
280690,201703,39,32,7,29984,6559,36543
280700,201703,16,16,0,14992,0,14992
280710,201703,1392,1025,367,952820.29,343223.1,1296043.39
280720,201703,110,71,39,64012.7,36543,100555.7
280730,201703,23,18,5,16866,4685,21551
280740,201703,2281,1653,628,1545045.82,586694.07,2131739.89
280750,201703,287,248,39,232376,36543,268919
280760,201703,845,570,275,532965.6,257534.45,790500.05
290010,201703,178,115,63,107755,59031,166786
290020,201703,172,159,13,148983,12181,161164
290030,201703,576,370,206,346034.1,193022,539056.1
290035,201703,140,110,30,99922.8,28110,128032.8
290040,201703,262,164,98,153668,91826,245494
290050,201703,66,48,18,44976,16866,61842
290060,201703,260,112,148,104662.9,138676,243338.9
290070,201703,5368,2590,2778,2419524.07,2599319.11,5018843.18
290080,201703,524,239,285,223456.16,267027,490483.16
290090,201703,381,160,221,149920,207077,356997
290100,201703,1566,1019,547,949746.05,511976.9,1461722.95
290110,201703,699,412,287,384447.1,268544.3,652991.4
290115,201703,210,191,19,178030,17803,195833
290120,201703,776,508,268,475340.1,251116,726456.1
290130,201703,422,241,181,225526.53,168846,394372.53
290135,201703,282,217,65,203329,60905,264234
290140,201703,279,231,48,215510,44976,260486
290150,201703,130,93,37,87141,34669,121810
290160,201703,250,194,56,180560.05,52472,233032.05
290170,201703,85,56,29,52472,27173,79645
290180,201703,150,118,32,110566,29984,140550
290190,201703,449,365,84,341724,78427,420151
290195,201703,286,154,132,144298,123684,267982
290200,201703,284,243,41,227691,38417,266108
290205,201703,133,75,58,70275,54346,124621
290210,201703,1062,780,282,729736.6,264234,993970.6
290220,201703,220,119,101,111034.5,94637,205671.5
290225,201703,269,99,170,92763,159290,252053
290230,201703,62,39,23,36422,21551,57973
290240,201703,287,116,171,108410.9,160227,268637.9
290250,201703,249,224,25,209017,23425,232442
290260,201703,253,218,35,203235.9,32795,236030.9
290265,201703,181,146,35,135999,32795,168794
290270,201703,1346,1101,245,1029529,228718,1258247
290280,201703,452,332,120,311084,112440,423524
290290,201703,1119,642,477,598909.95,446949,1045858.95
290300,201703,449,378,71,353666.07,66527,420193.07
290310,201703,322,142,180,133054,168660,301714
290320,201703,3795,2382,1413,2229280.46,1321170.5,3550450.96
290323,201703,177,154,23,144017,21551,165568
290327,201703,137,107,30,99991.96,28110,128101.96
290330,201703,61,35,26,32795,24362,57157
290340,201703,912,356,556,332576.88,520349.79,852926.67
290350,201703,543,323,220,302043,206140,508183
290360,201703,361,270,91,251116.86,85267,336383.86
290370,201703,1010,369,641,345472,600617,946089
290380,201703,291,175,116,163975,108692,272667
290390,201703,2407,1492,915,1394428.57,855388,2249816.57
290395,201703,237,129,108,120639,101196,221835
290400,201703,283,206,77,192460,72149,264609
290405,201703,250,211,39,197707,36543,234250
290410,201703,530,453,77,421510.9,72149,493659.9
290420,201703,221,169,52,158353,48724,207077
290430,201703,502,313,189,293281,177093,470374
290440,201703,71,62,9,58094,7808.3,65902.3
290450,201703,226,174,52,163038,48724,211762
290460,201703,1812,1068,744,999797.52,696941.56,1696739.08
290470,201703,1446,602,844,562662.17,790515.71,1353177.88
290475,201703,578,544,34,509728,31858,541586
290480,201703,277,149,128,139613,119936,259549
290485,201703,203,188,15,176063,14055,190118
290490,201703,1075,768,307,718866.4,286722.6,1005589.0
290500,201703,644,317,327,297029,306399,603428
290510,201703,201,147,54,136522,50598,187120
290515,201703,127,71,56,66527,52472,118999
290520,201703,1319,840,479,785487.61,445048.7,1230536.31
290530,201703,306,281,25,263297,23425,286722
290540,201703,90,60,30,56220,28110,84330
290550,201703,149,125,24,117125,22141.31,139266.31
290560,201703,3357,1334,2023,1248937.04,1895360.4,3144297.44
290570,201703,5447,2792,2655,2613132.69,2484854.39,5097987.08
290580,201703,1222,691,531,646009.97,497547,1143556.97
290590,201703,523,432,91,404122,85267,489389
290600,201703,1647,1152,495,1076052.08,463533.9,1539585.98
290610,201703,219,197,22,184355,20614,204969
290620,201703,309,269,40,252053,37480,289533
290630,201703,2089,881,1208,821750,1126372.47,1948122.47
290640,201703,147,117,30,109629,28110,137739
290650,201703,1642,762,880,713048.42,824560,1537608.42
290660,201703,259,211,48,197707,44976,242683
290670,201703,956,511,445,478526,416596.95,895122.95
290680,201703,1136,921,215,862040,200518,1062558
290682,201703,277,201,76,187330.15,71193.63,258523.78
290685,201703,223,144,79,133991,74023,208014
290687,201703,890,587,303,546692.7,281915.29,828607.99
290689,201703,104,63,41,59017,38402.95,97419.95
290690,201703,690,284,406,266099,379568.77,645667.77
290700,201703,256,117,139,109629,130243,239872
290710,201703,661,430,231,402910,216447,619357
290720,201703,1007,822,185,770214,172876.5,943090.5
290730,201703,1115,630,485,588482.85,453508,1041990.85
290740,201703,14,11,3,10307,2811,13118
290750,201703,1308,589,719,551520.83,671629.06,1223149.89
290755,201703,64,56,8,52472,7496,59968
290760,201703,299,265,34,248305,31858,280163
290770,201703,183,172,11,161154.63,10307,171461.63
290780,201703,912,732,180,683975.23,166879.7,850854.93
290790,201703,431,293,138,273972,129306,403278
290800,201703,2587,1019,1568,951735.07,1468119.71,2419854.78
290810,201703,428,296,132,277071,123684,400755
290820,201703,359,219,140,203540.91,131180,334720.91
290830,201703,381,256,125,239872,117125,356997
290840,201703,1568,948,620,886730.4,577960.44,1464690.84
290850,201703,731,401,330,374706.3,308273,682979.3
290860,201703,662,291,371,272667,347346,620013
290870,201703,650,470,180,440109,168660,608769
290880,201703,124,66,58,61842,54346,116188
290890,201703,358,258,100,241746,93700,335446
290900,201703,159,127,32,118999,29984,148983
290910,201703,359,273,86,255801,80582,336383
290920,201703,230,190,40,178030,37480,215510
290930,201703,778,597,181,558611.29,169597,728208.29
290940,201703,251,205,46,191335.4,43102,234437.4
290950,201703,167,93,74,87141,69338,156479
290960,201703,426,284,142,264890.72,132772.9,397663.62
290970,201703,245,215,30,201267.6,28110,229377.6
290980,201703,1437,1010,427,942295.02,399069.1,1341364.12
290990,201703,362,302,60,282965,56164.89,339129.89
291000,201703,830,236,594,221132,556296.9,777428.9
291005,201703,1913,803,1110,750668.28,1039775.32,1790443.60
291010,201703,150,138,12,129306,11244,140550
291020,201703,99,81,18,75897,16866,92763
291030,201703,86,65,21,60905,19677,80582
291040,201703,566,281,285,263287.63,267045,530332.63
291050,201703,1248,704,544,658376.92,509728,1168104.92
291060,201703,1445,775,670,725519.1,627790,1353309.1
291070,201703,1845,1367,478,1275305.5,444243.18,1719548.68
291072,201703,7169,2607,4562,2439751.02,4272049.7,6711800.72
291075,201703,188,151,37,141487,34669,176156
291077,201703,44,29,15,27173,14055,41228
291080,201703,18485,8008,10477,7481429.78,9804171.92,17285601.70
291085,201703,268,216,52,202392,48719.32,251111.32
291090,201703,305,112,193,104663,180831.63,285494.63
291100,201703,728,210,518,196770,485356.63,682126.63
291110,201703,389,298,91,279226,85267,364493
291120,201703,2504,1155,1349,1082095,1261981.06,2344076.06
291125,201703,57,30,27,28110,25299,53409
291130,201703,204,176,28,164912,26236,191148
291140,201703,111,79,32,74023,29984,104007
291150,201703,365,150,215,140550,201455,342005
291160,201703,327,275,52,256738.25,48724,305462.25
291165,201703,12,9,3,8433,2811,11244
291170,201703,2736,1389,1347,1299057.45,1259703,2558760.45
291180,201703,1307,490,817,458992,765493,1224485
291185,201703,65,62,3,58094,2811,60905
291190,201703,1190,505,685,471679.5,641311.9,1112991.4
291200,201703,162,118,44,110566,41228,151794
291210,201703,2142,814,1328,759635.27,1242565.54,2002200.81
291220,201703,239,181,58,168660.43,54346,223006.43
291230,201703,1024,342,682,319611,639034,958645
291240,201703,440,417,23,389511,21551,411062
291250,201703,409,339,70,317643,65590,383233
291260,201703,33,22,11,20614,10307,30921
291270,201703,1185,472,713,442264,667799.9,1110063.9
291280,201703,370,162,208,151606.6,194585.53,346192.13
291290,201703,1703,856,847,800947.6,792890,1593837.6
291300,201703,227,180,47,168004.1,44039,212043.1
291310,201703,244,217,27,203048,25299,228347
291320,201703,1370,979,391,914230.9,365240.8,1279471.7
291330,201703,128,107,21,98478.7,19677,118155.7
291340,201703,134,77,57,72149,53409,125558
291345,201703,121,82,39,76834,36543,113377
291350,201703,1497,461,1036,431769.6,970545.15,1402314.75
291360,201703,8390,4125,4265,3854928.98,3993351.28,7848280.26
291370,201703,1035,556,479,520691,448823,969514
291380,201703,252,199,53,186463,49661,236124
291390,201703,3797,1652,2145,1543906.25,2009865,3553771.25
291400,201703,2010,1423,587,1327356.79,548085.39,1875442.18
291410,201703,158,140,18,130243,16866,147109
291420,201703,98,69,29,64653,27173,91826
291430,201703,182,101,81,93941.74,74960,168901.74
291440,201703,485,392,93,364909.25,87141,452050.25
291450,201703,836,515,321,480401.54,299840,780241.54
291460,201703,1654,1337,317,1250332.8,296880,1547212.8
291465,201703,2214,1038,1176,972236.01,1101685.89,2073921.90
291470,201703,2629,1324,1305,1236869.95,1221786,2458655.95
291480,201703,11549,5107,6442,4774706.01,6028539.28,10803245.29
291490,201703,547,220,327,206140,306399,512539
291500,201703,359,186,173,174282,162101,336383
291510,201703,1267,483,784,451431.75,734326.9,1185758.65
291520,201703,962,435,527,407595,493477.63,901072.63
291530,201703,1031,270,761,252990,712757.26,965747.26
291535,201703,110,92,18,86204,16866,103070
291540,201703,357,106,251,99322,234250.8,333572.8
291550,201703,1166,534,632,498485.19,591603.9,1090089.09
291560,201703,5587,2893,2694,2698633.8,2511886.15,5210519.95
291570,201703,186,94,92,88078,86204,174282
291580,201703,1175,704,471,658905,440376.86,1099281.86
291590,201703,71,28,43,26236,40291,66527
291600,201703,1349,605,744,565948,696829,1262777
291610,201703,1184,511,673,477546.74,630546,1108092.74
291620,201703,550,249,301,233313,281521.65,514834.65
291630,201703,494,166,328,155542,307336,462878
291640,201703,3732,1835,1897,1713319.58,1776386.71,3489706.29
291650,201703,340,216,124,201277.97,116001,317278.97
291660,201703,456,179,277,167043.3,258471.45,425514.75
291670,201703,211,130,81,121248,75897,197145
291680,201703,704,388,316,362620,295999,658619
291685,201703,555,295,260,276181,243432.6,519613.6
291690,201703,528,267,261,250179,243620,493799
291700,201703,890,704,186,659648,173345,832993
291710,201703,1682,753,929,704877.34,869330.83,1574208.17
291720,201703,388,261,127,244552.32,118999,363551.32
291730,201703,891,505,386,471545.25,361672.63,833217.88
291733,201703,252,176,76,164630.9,71212,235842.9
291735,201703,62,51,11,47787,10307,58094
291740,201703,332,249,83,232985.05,77771,310756.05
291750,201703,1872,1237,635,1152452.75,593372.81,1745825.56
291760,201703,3092,1640,1452,1530160.24,1358837.5,2888997.74
291770,201703,750,515,235,480492.03,220195,700687.03
291780,201703,48,27,21,25299,19677,44976
291790,201703,171,75,96,70275,89952,160227
291800,201703,9604,3659,5945,3420995.46,5566811.9,8987807.36
291810,201703,1148,806,342,754374.22,320454,1074828.22
291820,201703,247,181,66,169597,61842,231439
291830,201703,1047,377,670,352050,626844,978894
291835,201703,624,562,62,526126,58094,584220
291840,201703,4494,2276,2218,2127895.62,2077129.88,4205025.50
291845,201703,320,109,211,102133,197697.63,299830.63
291850,201703,307,266,41,249007.75,38417,287424.75
291855,201703,258,103,155,96511,145235,241746
291860,201703,209,127,82,118063,76834,194897
291870,201703,77,31,46,29047,43102,72149
291875,201703,175,158,17,148046,15929,163975
291880,201703,469,370,99,345894,92763,438657
291890,201703,240,79,161,74013.63,149170.5,223184.13
291900,201703,54,30,24,28110,22488,50598
291905,201703,139,90,49,84049,45913,129962
291910,201703,179,142,37,133054,34669,167723
291915,201703,378,335,43,312257,40291,352548
291920,201703,4634,2389,2245,2236132.71,2101924.34,4338057.05
291930,201703,180,101,79,93700.7,74023,167723.7
291940,201703,296,162,134,151794,124930.21,276724.21
291950,201703,1107,912,195,852671.6,182715,1035386.6
291955,201703,889,529,360,495673,337320,832993
291960,201703,165,110,55,103070,51535,154605
291970,201703,782,592,190,554704,178030,732734
291980,201703,1468,1304,164,1218808.79,152731.7,1371540.49
291990,201703,121,113,8,105881,7496,113377
291992,201703,157,77,80,71399.4,74960,146359.4
291995,201703,138,98,40,91826,37480,129306
292000,201703,377,275,102,257394,95574,352968
292010,201703,278,203,75,189555.1,69338,258893.1
292020,201703,257,188,69,176156,64653,240809
292030,201703,130,102,28,95574,26236,121810
292040,201703,594,298,296,279226,277352,556578
292045,201703,82,75,7,70275,6559,76834
292050,201703,857,569,288,532162.26,269856,802018.26
292060,201703,924,768,156,717743.59,146172,863915.59
292070,201703,54,23,31,21551,29047,50598
292080,201703,108,73,35,68401,32795,101196
292090,201703,463,156,307,145683.39,287659,433342.39
292100,201703,1306,542,764,506308.35,714894.26,1221202.61
292105,201703,192,161,31,150857,29047,179904
292110,201703,2041,749,1292,701494.42,1208060.68,1909555.10
292120,201703,605,493,112,460828.96,104944,565772.96
292130,201703,436,255,181,238935,169597,408532
292140,201703,195,154,41,144298,38287.61,182585.61
292145,201703,149,76,73,71212,68372.9,139584.9
292150,201703,1374,1099,275,1029763,256665.57,1286428.57
292160,201703,182,148,34,138394.9,31858,170252.9
292170,201703,1218,1072,146,1002356.23,136745.78,1139102.01
292180,201703,185,136,49,127432,45913,173345
292190,201703,163,99,64,92763,59968,152731
292200,201703,1227,444,783,415093.24,733034.68,1148127.92
292205,201703,114,102,12,95574,11244,106818
292210,201703,345,235,110,218837,101712.25,320549.25
292220,201703,22,16,6,14992,5622,20614
292225,201703,40,35,5,32795,4685,37480
292230,201703,869,709,160,661940.72,149920,811860.72
292240,201703,598,415,183,387778,171471,559249
292250,201703,1573,985,588,922945,550956,1473901
292260,201703,436,234,202,219258,188524.4,407782.4
292265,201703,276,191,85,178685.9,79645,258330.9
292270,201703,775,329,446,307336.1,416965.4,724301.5
292273,201703,194,112,82,104180.34,76834,181014.34
292275,201703,149,68,81,63716,75615.9,139331.9
292280,201703,130,90,40,84330,37480,121810
292285,201703,55,46,9,42446.1,8433,50879.1
292290,201703,484,314,170,291773.01,159009,450782.01
292300,201703,1569,600,969,561637.9,906047.99,1467685.89
292303,201703,83,56,27,52472,25299,77771
292305,201703,103,71,32,66527,29984,96511
292310,201703,826,505,321,472830,299563.99,772393.99
292320,201703,635,479,156,448541.9,146172,594713.9
292330,201703,198,98,100,91826,93700,185526
292335,201703,263,199,64,186463,59968,246431
292340,201703,550,375,175,350648.93,163975,514623.93
292350,201703,244,127,117,118202.55,109347.9,227550.45
292360,201703,685,519,166,484616.5,155542,640158.5
292370,201703,782,591,191,553767,178967,732734
292380,201703,642,494,148,461941.51,138676,600617.51
292390,201703,500,188,312,176156,290610.75,466766.75
292400,201703,3254,1989,1265,1844981.35,1181775,3026756.35
292405,201703,249,164,85,153199.5,79363.9,232563.4
292410,201703,159,93,66,87141,61842,148983
292420,201703,301,257,44,240527.9,41228,281755.9
292430,201703,481,390,91,365430,84798.5,450228.5
292440,201703,566,479,87,446949,81519,528468
292450,201703,246,189,57,177093,53409,230502
292460,201703,585,429,156,401410.9,145469.25,546880.15
292465,201703,174,149,25,139613,22700.24,162313.24
292467,201703,91,50,41,46850,38417,85267
292470,201703,247,163,84,152731,78708,231439
292480,201703,284,190,94,177093.75,88078,265171.75
292490,201703,225,145,80,135865,74960,210825
292500,201703,1181,505,676,472978,633243.35,1106221.35
292510,201703,3200,1426,1774,1335225.36,1659559.35,2994784.71
292520,201703,1018,481,537,449521.75,503151,952672.75
292525,201703,373,259,114,242678.32,106818,349496.32
292530,201703,4087,1640,2447,1534621.4,2290657.3,3825278.7
292540,201703,482,252,230,235842.9,215228.9,451071.8
292550,201703,1031,556,475,520487.23,444605.27,965092.50
292560,201703,314,293,21,274541,19677,294218
292570,201703,288,220,68,205817,63716,269533
292575,201703,448,273,175,255520,163975,419495
292580,201703,875,551,324,514881.5,303025.9,817907.4
292590,201703,503,431,72,403549.98,67464,471013.98
292593,201703,138,107,31,100259,29047,129306
292595,201703,161,119,42,111503,39354,150857
292600,201703,1206,901,305,843925,285785,1129710
292610,201703,116,89,27,82924.5,25046.01,107970.51
292620,201703,507,416,91,389783,85267,475050
292630,201703,1301,752,549,702127.75,511134.3,1213262.05
292640,201703,749,522,227,489114,212699,701813
292650,201703,188,163,25,152019,23425,175444
292660,201703,1930,1376,554,1283593.02,514127.96,1797720.98
292665,201703,126,93,33,87141,30921,118062
292670,201703,366,310,56,290466,52472,342938
292680,201703,244,189,55,177093,51535,228628
292690,201703,175,133,42,124621,39354,163975
292700,201703,902,585,317,547208.9,296747.9,843956.8
292710,201703,96,83,13,77771,11900,89671
292720,201703,794,439,355,410555.92,332448,743003.92
292730,201703,212,101,111,93700.75,104007,197707.75
292740,201703,63265,31253,32012,29212310.78,29967811.84,59180122.62
292750,201703,375,265,110,247368.07,102274.01,349642.08
292760,201703,314,244,70,227635.25,65590,293225.25
292770,201703,778,328,450,305672.03,418761.64,724433.67
292780,201703,425,159,266,148759.53,249242,398001.53
292790,201703,716,343,373,321391,348564,669955
292800,201703,1068,646,422,604365,395414,999779
292805,201703,424,127,297,118764.75,278289,397053.75
292810,201703,1426,838,588,784643.9,550956,1335599.9
292820,201703,740,596,144,555829.7,134637.9,690467.6
292830,201703,102,77,25,72149,23425,95574
292840,201703,641,528,113,494268,105866.95,600134.95
292850,201703,132,87,45,81515,42165,123680
292860,201703,1978,1137,841,1060904.07,787736,1848640.07
292870,201703,3298,2220,1078,2079134.9,1010076.63,3089211.53
292880,201703,1388,915,473,853655.33,443201,1296856.33
292890,201703,444,383,61,358843,57157,416000
292895,201703,132,89,43,82058.71,40291,122349.71
292900,201703,376,282,94,264234,88078,352312
292905,201703,429,215,214,201455,200290,401745
292910,201703,379,293,86,274214,80582,354796
292920,201703,505,225,280,210825,262360,473185
292925,201703,520,481,39,450031.73,36308.75,486340.48
292930,201703,540,331,209,310147,195833,505980
292935,201703,295,123,172,115251,161164,276415
292937,201703,223,147,76,137739,71212,208951
292940,201703,189,142,47,133054,44039,177093
292950,201703,1047,538,509,501811.95,475997,977808.95
292960,201703,507,336,171,314832,160227,475059
292970,201703,280,193,87,180186,81519,261705
292975,201703,160,88,72,82456,67277,149733
292980,201703,248,169,79,156601.42,74023,230624.42
292990,201703,1262,927,335,863268.92,313711.26,1176980.18
293000,201703,100,74,26,69338,24352.63,93690.63
293010,201703,2536,1576,960,1472394.33,896055,2368449.33
293015,201703,636,499,137,467282,127742,595024
293020,201703,338,274,64,256738,59968,316706
293030,201703,627,544,83,507479.77,77771,585250.77
293040,201703,332,258,74,241746,69338,311084
293050,201703,2597,1515,1082,1410779.13,1010058.49,2420837.62
293060,201703,245,194,51,181778,46850.4,228628.4
293070,201703,3213,1602,1611,1494301.34,1508317.63,3002618.97
293075,201703,85,57,28,53409,26236,79645
293076,201703,73,44,29,41228,27173,68401
293077,201703,411,248,163,228878.66,152731,381609.66
293080,201703,459,399,60,373863,56220,430083
293090,201703,133,113,20,104942.8,18427.7,123370.5
293100,201703,477,345,132,323265,123684,446949
293105,201703,330,224,106,209607,99322,308929
293110,201703,168,119,49,111503,45913,157416
293120,201703,310,206,104,193022,97260.6,290282.6
293130,201703,246,160,86,149920,80300.9,230220.9
293135,201703,7561,3007,4554,2810854.47,4260907.19,7071761.66
293140,201703,176,117,59,109629,54534,164163
293150,201703,328,285,43,265640.1,40291,305931.1
293160,201703,431,237,194,222069,181496.9,403565.9
293170,201703,176,124,52,115906.9,47881,163787.9
293180,201703,441,300,141,280819,132117,412936
293190,201703,1234,860,374,801255.98,350360,1151615.98
293200,201703,507,447,60,417716,56220,473936
293210,201703,330,242,88,226605,82456,309061
293220,201703,2743,1086,1657,1016404.45,1550267.55,2566672.00
293230,201703,1768,633,1135,591716.9,1063495,1655211.9
293240,201703,218,200,18,187400,16866,204266
293245,201703,110,91,19,85267,17803,103070
293250,201703,720,262,458,244858.24,428865,673723.24
293260,201703,309,257,52,239872.89,48724,288596.89
293270,201703,1181,556,625,518818.48,585625,1104443.48
293280,201703,220,123,97,115251,90889,206140
293290,201703,3002,1944,1058,1820591.5,991052,2811643.5
293300,201703,657,466,191,434819.79,178170.55,612990.34
293305,201703,161,134,27,125558,25299,150857
293310,201703,137,103,34,96511,31858,128369
293315,201703,140,107,33,100259,30921,131180
293317,201703,90,65,25,60905,23425,84330
293320,201703,924,523,401,489114.25,375452,864566.25
293325,201703,180,66,114,61842,106799.26,168641.26
293330,201703,12303,5704,6599,5334299.79,6176817.74,11511117.53
293340,201703,243,172,71,161164,65590,226754
293345,201703,243,191,52,178967,48724,227691
293350,201703,622,315,307,295155,286206.65,581361.65
293360,201703,1530,1087,443,1017301,413873.35,1431174.35
310010,201703,157,79,78,74023,72524,146547
310020,201703,1022,565,457,526969.05,426054.26,953023.31
310030,201703,330,267,63,248511.94,58749.9,307261.84
310040,201703,50,33,17,30921,15929,46850
310050,201703,247,159,88,148046,82456,230502
310060,201703,239,164,75,153668,70275,223943
310070,201703,20,9,11,8433,10307,18740
310080,201703,52,28,24,26236,22488,48724
310090,201703,913,469,444,434582.14,413966.9,848549.04
310100,201703,283,212,71,198644,66527,265171
310110,201703,718,383,335,357835.09,313707.6,671542.69
310120,201703,365,206,159,192366.1,148615.61,340981.71
310130,201703,34,21,13,19677,12181,31858
310140,201703,30,16,14,14992,13118,28110
310150,201703,1279,886,393,824001.61,367678.9,1191680.51
310160,201703,2144,1094,1050,1018334.05,980477.84,1998811.89
310163,201703,82,47,35,44039,32795,76834
310170,201703,2476,985,1491,922636.6,1394537.3,2317173.9
310180,201703,117,43,74,40291,68963.2,109254.2
310190,201703,462,302,160,282974,149076.7,432050.7
310200,201703,507,321,186,300777,174001,474778
310205,201703,50,39,11,36543,10307,46850
310210,201703,282,223,59,208951,55283,264234
310220,201703,47,29,18,27173,16866,44039
310230,201703,263,183,80,171104.37,74960,246064.37
310240,201703,101,88,13,82456,12181,94637
310250,201703,101,82,19,76834,17803,94637
310260,201703,818,428,390,398413.35,364708.51,763121.86
310270,201703,267,175,92,163432,86204,249636
310280,201703,360,267,93,248587.1,87141,335728.1
310285,201703,211,151,60,141184.35,56220,197404.35
310290,201703,251,146,105,136802,98385,235187
310300,201703,146,123,23,115251,21551,136802
310310,201703,5,4,1,3748,937,4685
310320,201703,21,14,7,13118,6559,19677
310330,201703,29,20,9,18740,8433,27173
310340,201703,1441,914,527,848251.35,492581.25,1340832.60
310350,201703,2735,1473,1262,1375474.25,1181931.9,2557406.15
310360,201703,41,34,7,31858,6559,38417
310370,201703,118,96,22,89952,20333,110285
310375,201703,101,37,64,34669,59950,94619
310380,201703,51,30,21,28110,19677,47787
310390,201703,100,69,31,64653,29047,93700
310400,201703,2219,1410,809,1316111.8,757733.9,2073845.7
310410,201703,124,66,58,61842,54346,116188
310420,201703,644,348,296,325233.1,276406.43,601639.53
310430,201703,326,215,111,201173.9,104007,305180.9
310440,201703,57,37,20,34669,18740,53409
310445,201703,79,64,15,59968,14055,74023
310450,201703,854,534,320,498890.1,299840,798730.1
310460,201703,260,180,80,168660,74960,243620
310470,201703,493,309,184,289533,172408,461941
310480,201703,89,62,27,58094,25299,83393
310490,201703,472,220,252,205203.1,236124,441327.1
310500,201703,122,54,68,50598,63716,114314
310510,201703,617,392,225,366082.8,210806.63,576889.43
310520,201703,130,85,45,79645,42165,121810
310530,201703,82,38,44,35606,40946.9,76552.9
310540,201703,443,276,167,255990.2,156479,412469.2
310550,201703,75,51,24,47787,22488,70275
310560,201703,2822,1945,877,1811832.65,820151.42,2631984.07
310570,201703,156,99,57,92763,53409,146172
310590,201703,329,221,108,206656,101196,307852
310600,201703,159,94,65,86344.85,60905,147249.85
310610,201703,59,22,37,20614,34669,55283
310620,201703,43984,21001,22983,19608279.12,21499432.78,41107711.90
310630,201703,515,326,189,303214.05,175531.61,478745.66
310640,201703,133,110,23,102882.6,21551,124433.6
310650,201703,154,135,19,125558,17803,143361
310660,201703,86,51,35,47787,32795,80582
310665,201703,46,34,12,31858,11244,43102
310670,201703,6108,2861,3247,2673525.41,3036979.92,5710505.33
310680,201703,50,33,17,30921,15929,46850
310690,201703,545,397,148,369030.23,138676,507706.23
310700,201703,66,43,23,40291,21551,61842
310710,201703,1239,821,418,768659,391666,1160325
310720,201703,85,28,57,26236,53409,79645
310730,201703,1314,909,405,851452,379485,1230937
310740,201703,1014,568,446,530155.2,417658.63,947813.83
310750,201703,242,140,102,130243.29,95574,225817.29
310760,201703,67,51,16,47787,14992,62779
310770,201703,79,42,37,39354,34669,74023
310780,201703,413,335,78,313886,73086,386972
310790,201703,96,77,19,72149,17803,89952
310800,201703,457,214,243,200049.5,227400.53,427450.03
310810,201703,162,113,49,105497,44976,150473
310820,201703,379,295,84,276415,78426.9,354841.9
310825,201703,179,146,33,136802,30921,167723
310830,201703,466,219,247,204554.61,230220.9,434775.51
310840,201703,390,221,169,207077,158071.9,365148.9
310850,201703,109,88,21,82456,19677,102133
310855,201703,374,294,80,275478,74960,350438
310860,201703,1334,999,335,931900.45,312190.95,1244091.40
310870,201703,53,42,11,39354,10307,49661
310880,201703,79,58,21,54346,19677,74023
310890,201703,311,184,127,172408,118999,291407
310900,201703,630,290,340,269354.95,318562,587916.95
310910,201703,245,169,76,157042.1,71212,228254.1
310920,201703,501,296,205,273462.2,191148.7,464610.9
310925,201703,24,19,5,17803,4404,22207
310930,201703,1093,647,446,605835.78,417803.2,1023638.98
310940,201703,677,351,326,328153.99,305462,633615.99
310945,201703,122,74,48,69338,44976,114314
310950,201703,257,200,57,187400,53409,240809
310960,201703,88,33,55,30921,51531,82452
310970,201703,167,102,65,95574,59999.2,155573.2
310980,201703,36,18,18,16866,16866,33732
310990,201703,155,89,66,83393,61842,145235
311000,201703,804,415,389,386045.9,364203,750248.9
311010,201703,37,30,7,28110,6559,34669
311020,201703,38,24,14,22488,13118,35606
311030,201703,398,229,169,212700,158353,371053
311040,201703,34,29,5,27173,4685,31858
311050,201703,462,192,270,179342,252708.9,432050.9
311060,201703,750,441,309,412093.2,289533,701626.2
311070,201703,312,139,173,130243,162101,292344
311080,201703,104,54,50,50598,46850,97448
311090,201703,388,178,210,166786,196770,363556
311100,201703,609,366,243,342661,227409.9,570070.9
311110,201703,643,433,210,405721,196761,602482
311115,201703,59,44,15,41228,14055,55283
311120,201703,982,516,466,481568.4,436032.95,917601.35
311130,201703,413,237,176,221881.6,164912,386793.6
311140,201703,155,69,86,64653,79785.55,144438.55
311150,201703,350,226,124,211645,115953.75,327598.75
311160,201703,740,529,211,493799.7,197239,691038.7
311170,201703,72,50,22,46850,20332.9,67182.9
311180,201703,335,218,117,203703.8,109348,313051.8
311190,201703,37,21,16,19677,14992,34669
311200,201703,352,241,111,224224.3,104007,328231.3
311205,201703,30,19,11,17568.75,9932.2,27500.95
311210,201703,47,39,8,36543,7496,44039
311220,201703,11,10,1,9370,937,10307
311230,201703,1603,1022,581,954315.96,544397,1498712.96
311240,201703,161,97,64,90889,59968,150857
311250,201703,60,29,31,27173,29047,56220
311260,201703,559,333,226,312021,211762,523783
311265,201703,105,71,34,66527,31858,98385
311270,201703,274,188,86,176156,80582,256738
311280,201703,213,96,117,89952,109066.8,199018.8
311290,201703,109,88,21,82175,19115,101290
311300,201703,541,334,207,312021.88,193678,505699.88
311310,201703,23,19,4,17803,3748,21551
311320,201703,652,483,169,451634,158353,609987
311330,201703,996,740,256,693052.75,238935.7,931988.45
311340,201703,2523,1791,732,1670169.72,685200.83,2355370.55
311350,201703,266,206,60,193022,56220,249242
311360,201703,169,106,63,99322,59031,158353
311370,201703,1162,450,712,419695.25,666066.45,1085761.70
311380,201703,7,6,1,5622,937,6559
311390,201703,284,154,130,144298,121341.6,265639.6
311400,201703,149,96,53,89952,49652,139604
311410,201703,92,54,38,50598,35606,86204
311420,201703,287,163,124,149920.1,116188,266108.1
311430,201703,831,539,292,503077.1,273604,776681.1
311440,201703,489,340,149,317643.4,139331.9,456975.3
311450,201703,309,192,117,179904,109629,289533
311455,201703,302,204,98,190857.9,91544.9,282402.8
311460,201703,130,51,79,47787,73324.93,121111.93
311470,201703,19,10,9,9370,8433,17803
311480,201703,24,7,17,6559,15929,22488
311490,201703,17,10,7,9370,6559,15929
311500,201703,19,8,11,7496,10307,17803
311510,201703,620,423,197,395414,184589,580003
311520,201703,42,31,11,28391.1,10307,38698.1
311530,201703,1816,1349,467,1255161.91,437579,1692740.91
311535,201703,61,48,13,44976,12181,57157
311540,201703,33,29,4,27173,3748,30921
311545,201703,178,135,43,126495,40291,166786
311547,201703,32,23,9,21551,8433,29984
311550,201703,561,257,304,240809,284829.63,525638.63
311560,201703,41,28,13,26236,12181,38417
311570,201703,308,200,108,186837.8,101196,288033.8
311580,201703,282,158,124,147764.9,116188,263952.9
311590,201703,35,29,6,27173,5622,32795
311600,201703,87,70,17,65590,15929,81519
311610,201703,264,227,37,211449.95,34669,246118.95
311615,201703,83,68,15,63088.21,14055,77143.21
311620,201703,16,11,5,10307,4685,14992
311630,201703,71,59,12,55283,11244,66527
311640,201703,115,66,49,61842,45913,107755
311650,201703,117,86,31,79879.25,29047,108926.25
311660,201703,379,180,199,168660,186463,355123
311670,201703,162,101,61,94085,57157,151242
311680,201703,220,162,58,150135.94,53596.4,203732.34
311690,201703,16,9,7,8433,6559,14992
311700,201703,201,136,65,127150.9,60905,188055.9
311710,201703,215,140,75,130899,70275,201174
311720,201703,30,23,7,21551,6559,28110
311730,201703,510,335,175,313333,163975,477308
311740,201703,29,20,9,18740,8433,27173
311750,201703,698,475,223,443201.4,208670,651871.4
311760,201703,64,37,27,34669,25299,59968
311770,201703,388,182,206,169101.1,193022,362123.1
311780,201703,168,99,69,92763,64341,157104
311783,201703,73,64,9,59968,8433,68401
311787,201703,31,13,18,12181,16866,29047
311790,201703,266,127,139,118999,130243,249242
311800,201703,601,411,190,381782.15,178030,559812.15
311810,201703,40,33,7,30921,6559,37480
311820,201703,108,87,21,81519,19677,101196
311830,201703,1814,1165,649,1086846.95,605489.4,1692336.35
311840,201703,966,525,441,487710.5,411473.66,899184.16
311850,201703,11,5,6,4685,5622,10307
311860,201703,9042,4195,4847,3917830.16,4534226.67,8452056.83
311870,201703,160,86,74,80582,69338,149920
311880,201703,944,702,242,656546.9,226754,883300.9
311890,201703,221,113,108,105881,101196,207077
311900,201703,89,37,52,34669,48443,83112
311910,201703,1343,843,500,787034.05,466298.15,1253332.20
311920,201703,235,152,83,142190,77771,219961
311930,201703,884,510,374,477589,349922.9,827511.9
311940,201703,2263,1144,1119,1069352.25,1045458.05,2114810.30
311950,201703,204,116,88,108318,82175,190493
311960,201703,66,46,20,43102,18740,61842
311970,201703,27,15,12,12508.95,11244,23752.95
311980,201703,41,31,10,29047,9370,38417
311990,201703,63,47,16,44039,14992,59031
311995,201703,63,43,20,40291,18740,59031
312000,201703,31,21,10,19395.9,9370,28765.9
312010,201703,86,61,25,57157,23425,80582
312015,201703,87,66,21,61561,19677,81238
312020,201703,146,92,54,86204,50316.9,136520.9
312030,201703,37,32,5,29329,4685,34014
312040,201703,82,55,27,51535,25299,76834
312050,201703,224,116,108,108692,101196,209888
312060,201703,74,51,23,47787,20895.1,68682.1
312070,201703,79,45,34,42165,31858,74023
312080,201703,502,207,295,193959,276415,470374
312083,201703,43,32,11,29984,10307,40291
312087,201703,99,76,23,71212,21551,92763
312090,201703,2668,1456,1212,1352095.85,1131012.95,2483108.80
312100,201703,162,114,48,106818,44976,151794
312110,201703,122,79,43,74023,40291,114314
312120,201703,145,105,40,98385,37480,135865
312125,201703,92,49,43,45537.76,40291,85828.76
312130,201703,127,83,44,77771,41228,118999
312140,201703,131,102,29,95574,27173,122747
312150,201703,41,33,8,30921,7496,38417
312160,201703,1507,1000,507,934142.85,473560.1,1407702.95
312170,201703,11,9,2,8433,1874,10307
312180,201703,133,86,47,79645.75,43758,123403.75
312190,201703,30,28,2,26236,1874,28110
312200,201703,695,600,95,560560.35,89015,649575.35
312210,201703,93,59,34,55283,31858,87141
312220,201703,117,85,32,79411,29984,109395
312230,201703,3331,1649,1682,1542050.79,1574921.99,3116972.78
312235,201703,117,76,41,71212,38417,109629
312240,201703,110,71,39,66527,36543,103070
312245,201703,148,99,49,92759,45913,138672
312247,201703,51,36,15,32983,14055,47038
312250,201703,172,82,90,76366,84330,160696
312260,201703,93,64,29,59125.6,27173,86298.6
312270,201703,137,84,53,78708,49661,128369
312280,201703,26,16,10,14992,9370,24362
312290,201703,157,113,44,105600,40292,145892
312300,201703,197,132,65,123684,60905,184589
312310,201703,55,50,5,46850,4685,51535
312320,201703,417,254,163,236124,151466.25,387590.25
312330,201703,87,76,11,70463,10025.9,80488.9
312340,201703,33,14,19,13118,17803,30921
312350,201703,16,10,6,9370,5622,14992
312352,201703,93,66,27,61842,25299,87141
312360,201703,556,256,300,238935,280444.1,519379.1
312370,201703,281,167,114,156197.9,106818,263015.9
312380,201703,139,89,50,83393,46850,130243
312385,201703,181,147,34,137739,31858,169597
312390,201703,295,187,108,175219,100541,275760
312400,201703,369,274,95,256738,88547,345285
312410,201703,833,272,561,254395.5,525091,779486.5
312420,201703,591,475,116,445075,108692,553767
312430,201703,842,625,217,583050.94,202392.1,785443.04
312440,201703,45,32,13,29984,12181,42165
312450,201703,211,132,79,123684,74023,197707
312460,201703,53,24,29,22488,27173,49661
312470,201703,52,34,18,31858,16866,48724
312480,201703,222,136,86,127432,80300.9,207732.9
312490,201703,243,169,74,158353,69338,227691
312500,201703,29,16,13,14992,12181,27173
312510,201703,407,156,251,146172,234582.36,380754.36
312520,201703,42,16,26,14992,24362,39354
312530,201703,45,35,10,32795,9370,42165
312540,201703,98,86,12,80582,11244,91826
312550,201703,35,27,8,25299,7496,32795
312560,201703,185,135,50,126214,46568.9,172782.9
312570,201703,421,252,169,235749.2,157674.23,393423.43
312580,201703,83,45,38,41884,35606,77490
312590,201703,273,216,57,201316,53409,254725
312595,201703,141,128,13,119936,12181,132117
312600,201703,77,48,29,44555,27173,71728
312610,201703,1589,819,770,762014.29,719710.3,1481724.59
312620,201703,180,125,55,117125,51535,168660
312630,201703,67,54,13,50598,12181,62779
312640,201703,49,15,34,14055,31858,45913
312650,201703,137,110,27,102789,25299,128088
312660,201703,55,40,15,37199,14055,51254
312670,201703,842,556,286,519426.95,267747.75,787174.70
312675,201703,41,31,10,29047,9370,38417
312680,201703,82,56,26,52097.2,24362,76459.2
312690,201703,234,124,110,116178.63,102788.9,218967.53
312695,201703,26,20,6,18740,5622,24362
312700,201703,187,102,85,95574,79645,175219
312705,201703,73,61,12,57157,10962.9,68119.9
312707,201703,85,61,24,57157,22488,79645
312710,201703,1823,968,855,905555,800927,1706482
312720,201703,62,31,31,29047,29047,58094
312730,201703,293,174,119,162101,111503,273604
312733,201703,47,42,5,39354,4685,44039
312735,201703,20,15,5,14055,4685,18740
312737,201703,77,40,37,37480,34669,72149
312738,201703,49,34,15,31858,14055,45913
312740,201703,69,48,21,44976,19677,64653
312750,201703,70,50,20,46850,18740,65590
312760,201703,269,193,76,180841,71212,252053
312770,201703,7456,3416,4040,3179324.46,3778085.57,6957410.03
312780,201703,432,336,96,314550.9,89952,404502.9
312790,201703,19,15,4,14055,3748,17803
312800,201703,1599,1115,484,1038157.98,452347.11,1490505.09
312810,201703,372,234,138,219258,129306,348564
312820,201703,189,141,48,132117,44976,177093
312825,201703,24,15,9,14055,8433,22488
312830,201703,295,171,124,159291,115561,274852
312840,201703,145,106,39,99322,36543,135865
312850,201703,20,18,2,16866,1874,18740
312860,201703,172,106,66,99041,61842,160883
312870,201703,981,506,475,472310.7,445075,917385.7
312880,201703,150,104,46,97307.45,43008.3,140315.75
312890,201703,158,105,53,98385,49661,148046
312900,201703,219,163,56,152075.1,52472,204547.1
312910,201703,183,90,93,83561.66,87141,170702.66
312920,201703,149,84,65,78708,60905,139613
312930,201703,337,243,94,227691,88078,315769
312940,201703,100,65,35,60905,32795,93700
312950,201703,683,436,247,407220.3,231439,638659.3
312960,201703,175,131,44,122747,41228,163975
312965,201703,43,38,5,35606,4685,40291
312970,201703,279,221,58,205906.1,54346,260252.1
312980,201703,2189,1180,1009,1102466.9,944866.8,2047333.7
312990,201703,46,26,20,24362,18740,43102
313000,201703,40,26,14,24362,13118,37480
313005,201703,157,124,33,115213.75,30640,145853.75
313010,201703,904,367,537,342942.1,502878.9,845821.0
313020,201703,197,102,95,95574,89015,184589
313030,201703,200,125,75,116189,70275,186464
313040,201703,55,20,35,18740,32795,51535
313050,201703,287,199,88,185526.1,82331.02,267857.12
313055,201703,42,29,13,27173,12181,39354
313060,201703,119,81,38,75448,35324.9,110772.9
313065,201703,57,35,22,32795,20614,53409
313070,201703,157,82,75,76834,70275,147109
313080,201703,40,17,23,15929,21551,37480
313090,201703,698,474,224,442170.4,209606.9,651777.3
313100,201703,172,63,109,59031,102125,161156
313110,201703,107,62,45,58094,42165,100259
313115,201703,130,70,60,65393.23,55283,120676.23
313120,201703,710,388,322,363275,300215,663490
313130,201703,4892,2599,2293,2417012.57,2139705.97,4556718.54
313140,201703,162,80,82,74960,76834,151794
313150,201703,322,256,66,239872,61560.9,301432.9
313160,201703,167,119,48,111503,44976,156479
313170,201703,1292,915,377,847565.55,352865.2,1200430.75
313180,201703,327,188,139,175518.84,130243,305761.84
313190,201703,668,388,280,360557.6,261611,622168.6
313200,201703,21,20,1,18740,937,19677
313210,201703,879,743,136,692029.48,127427.32,819456.80
313220,201703,215,146,69,135865,63950.25,199815.25
313230,201703,292,205,87,191149,81519,272668
313240,201703,1866,1013,853,946550.17,795321.62,1741871.79
313250,201703,1217,884,333,823718.8,309212.4,1132931.2
313260,201703,92,54,38,50598,35606,86204
313270,201703,947,537,410,499186.77,384170,883356.77
313280,201703,59,50,9,46568.9,8433,55001.9
313290,201703,221,174,47,162757,43102.9,205859.9
313300,201703,352,174,178,160603.2,166786,327389.2
313310,201703,208,105,103,98385,96511,194896
313320,201703,355,276,79,256691.55,74023,330714.55
313330,201703,1269,746,523,698065.6,488880.75,1186946.35
313340,201703,333,226,107,211762,100259,312021
313350,201703,535,362,173,337320.05,162101,499421.05
313360,201703,113,61,52,57157,48443,105600
313370,201703,186,74,112,69338,104944,174282
313375,201703,251,148,103,138676,96511,235187
313380,201703,1182,603,579,561937.88,541770,1103707.88
313390,201703,47,39,8,35606.4,7496,43102.4
313400,201703,406,257,149,240809,139332,380141
313410,201703,13,8,5,7496,4685,12181
313420,201703,4583,2330,2253,2175141.29,2103161.11,4278302.40
313430,201703,137,61,76,57157,71212,128369
313440,201703,1441,971,470,908375.65,440109,1348484.65
313450,201703,59,26,33,24362,30921,55283
313460,201703,358,171,187,158809,174943,333752
313470,201703,491,213,278,199581,259830.1,459411.1
313480,201703,158,106,52,98386,48724,147110
313490,201703,498,241,257,225812.32,240360,466172.32
313500,201703,15,10,5,9370,4685,14055
313505,201703,904,702,202,656837,189274,846111
313507,201703,93,53,40,49661,37480,87141
313510,201703,2659,1708,951,1595994.9,890150,2486144.9
313520,201703,3521,2738,783,2553916.29,733667,3287583.29
313530,201703,39,28,11,26236,10307,36543
313535,201703,97,81,16,75242,14992,90234
313540,201703,71,55,16,51535,14148.7,65683.7
313545,201703,91,74,17,69338,15929,85267
313550,201703,234,189,45,177093,41603,218696
313560,201703,334,172,162,161164,151794,312958
313570,201703,54,28,26,26236,24362,50598
313580,201703,1271,677,594,633412,554610.7,1188022.7
313590,201703,101,51,50,47787,46850,94637
313600,201703,692,404,288,378548,269013,647561
313610,201703,58,48,10,44086,9370,53456
313620,201703,1279,685,594,630491.16,553448.6,1183939.76
313630,201703,1613,1238,375,1158226.4,351094,1509320.4
313640,201703,125,69,56,64653,52472,117125
313650,201703,209,97,112,90889,104944,195833
313652,201703,11,10,1,9370,937,10307
313655,201703,50,29,21,27173,19677,46850
313657,201703,46,43,3,40291,2811,43102
313660,201703,123,88,35,82456,32795,115251
313665,201703,587,298,289,279226,270558.75,549784.75
313670,201703,9582,6603,2979,6166822.53,2790761,8957583.53
313680,201703,37,29,8,27173,7496,34669
313690,201703,159,122,37,114314,34669,148983
313695,201703,58,44,14,41228,13118,54346
313700,201703,279,219,60,204922,56220,261142
313710,201703,155,107,48,100259,44976,145235
313720,201703,955,437,518,407688.8,484045.83,891734.63
313730,201703,51,37,14,34669,13118,47787
313740,201703,159,126,33,117874.6,30921,148795.6
313750,201703,457,337,120,315487.9,112440,427927.9
313753,201703,238,165,73,153949.1,68401,222350.1
313760,201703,1105,406,699,380422,652275.56,1032697.56
313770,201703,339,240,99,224880,92763,317643
313780,201703,718,377,341,353249,319235.9,672484.9
313790,201703,26,25,1,23425,937,24362
313800,201703,128,80,48,74960,44976,119936
313810,201703,51,34,17,31858,15929,47787
313820,201703,1262,629,633,588155.1,591880.1,1180035.2
313830,201703,68,51,17,47787,15929,63716
313835,201703,49,45,4,42165,3748,45913
313840,201703,1577,965,612,899897.2,572226.1,1472123.3
313850,201703,177,61,116,57157,108122.39,165279.39
313860,201703,486,376,110,348472.7,102133.55,450606.25
313862,201703,176,114,62,106818,58094,164912
313865,201703,76,58,18,54346,16866,71212
313867,201703,51,38,13,35606,12181,47787
313868,201703,20,13,7,12181,6559,18740
313870,201703,131,62,69,58094,64653,122747
313880,201703,328,210,118,196207.9,110003.9,306211.8
313890,201703,314,174,140,162288.9,130617.8,292906.7
313900,201703,911,500,411,466908.25,385061,851969.25
313910,201703,143,103,40,96324,36543.1,132867.1
313920,201703,570,412,158,385575.5,148046,533621.5
313925,201703,27,23,4,21551,3748,25299
313930,201703,789,598,191,560326,178944,739270
313940,201703,1700,1063,637,991627.2,596306.9,1587934.1
313950,201703,920,583,337,544491.8,315253.9,859745.7
313960,201703,1306,762,544,709786.65,508791.1,1218577.75
313970,201703,113,82,31,76834,29047,105881
313980,201703,204,129,75,120639,70275,190914
313990,201703,346,203,143,190211,133991,324202
314000,201703,897,612,285,570839.48,266759.32,837598.80
314010,201703,72,44,28,41228,26236,67464
314015,201703,60,19,41,17803,38417,56220
314020,201703,48,33,15,30921,13961.3,44882.3
314030,201703,97,49,48,45913,44976,90889
314040,201703,39,30,9,28110,8433,36543
314050,201703,304,177,127,165849,117687.2,283536.2
314053,201703,97,63,34,59031,31858,90889
314055,201703,276,159,117,148983,109629,258612
314060,201703,136,115,21,106818,19677,126495
314070,201703,872,453,419,420442.67,391984.63,812427.30
314080,201703,207,136,71,127198,65590.84,192788.84
314085,201703,103,70,33,65590,30921,96511
314090,201703,341,245,96,229565,89947.32,319512.32
314100,201703,452,371,81,343755,75335,419090
314110,201703,690,371,319,345762.37,298200.8,643963.17
314120,201703,107,56,51,52472,47787,100259
314130,201703,20,11,9,10307,8433,18740
314140,201703,1070,638,432,596194.46,403847.23,1000041.69
314150,201703,164,100,64,93700,59968,153668
314160,201703,358,264,94,245495.3,87891,333386.3
314170,201703,62,45,17,42165,15929,58094
314180,201703,713,618,95,577848.21,88078.25,665926.46
314190,201703,99,60,39,56220,36543,92763
314200,201703,583,396,187,370115.8,174282,544397.8
314210,201703,269,200,69,187118.9,64372,251490.9
314220,201703,317,238,79,221133,73742,294875
314225,201703,63,45,18,42165,16866,59031
314230,201703,96,44,52,41228,48724,89952
314240,201703,136,102,34,95574,31812,127386
314250,201703,57,33,24,30921,22488,53409
314260,201703,187,96,91,89952,85267,175219
314270,201703,470,362,108,338445,100915,439360
314280,201703,669,370,299,346399.9,280163,626562.9
314290,201703,546,436,110,407314.25,102788.9,510103.15
314300,201703,413,294,119,272594.5,111457,384051.5
314310,201703,1393,922,471,862696.9,441026.33,1303723.23
314315,201703,32,25,7,23425,6559,29984
314320,201703,600,375,225,351094,210197.21,561291.21
314330,201703,10439,5277,5162,4932526.12,4831669.23,9764195.35
314340,201703,565,263,302,245868.9,282412,528280.9
314345,201703,22,17,5,15929,4685,20614
314350,201703,189,111,78,104007,73086,177093
314360,201703,68,37,31,34669,29047,63716
314370,201703,59,49,10,45913,9370,55283
314380,201703,87,62,25,58094,23425,81519
314390,201703,3061,1915,1146,1789858.25,1070616.6,2860474.85
314400,201703,656,475,181,442256.1,169597,611853.1
314410,201703,408,265,143,248305,133991,382296
314420,201703,18,7,11,6559,10307,16866
314430,201703,2449,861,1588,803016.95,1485752.81,2288769.76
314435,201703,249,143,106,133709.9,98385,232094.9
314437,201703,23,18,5,16866,4685,21551
314440,201703,110,74,36,69338,33732,103070
314450,201703,154,118,36,110566,33732,144298
314460,201703,643,285,358,267045,335327,602372
314465,201703,72,52,20,48724,18740,67464
314467,201703,60,50,10,46841,9370,56211
314470,201703,337,167,170,152152.06,158353.75,310505.81
314480,201703,995,475,520,444138,487052.6,931190.6
314490,201703,89,64,25,59968,23425,83393
314500,201703,293,186,107,174282,100259,274541
314505,201703,119,82,37,76834,34669,111503
314510,201703,223,178,45,165849.1,42165,208014.1
314520,201703,1184,614,570,570777.5,532169.45,1102946.95
314530,201703,647,513,134,480204,125558,605762
314535,201703,190,120,70,112158.9,65062.38,177221.28
314537,201703,58,34,24,31858,22488,54346
314540,201703,6,4,2,3748,1874,5622
314545,201703,46,33,13,30921,12181,43102
314550,201703,79,43,36,40291,33732,74023
314560,201703,814,432,382,402629,356997.79,759626.79
314570,201703,22,16,6,14992,5622,20614
314580,201703,19,8,11,7496,10307,17803
314585,201703,18,12,6,11244,5622,16866
314587,201703,72,63,9,59031,8433,67464
314590,201703,518,386,132,361682,123684,485366
314600,201703,977,620,357,577728.39,331539.8,909268.19
314610,201703,902,494,408,460395.4,381172.15,841567.55
314620,201703,142,104,38,96511,35606,132117
314625,201703,91,70,21,64747,19677,84424
314630,201703,1249,625,624,583891.65,584406.9,1168298.55
314640,201703,92,61,31,57157,29047,86204
314650,201703,203,116,87,108410.9,81050.5,189461.4
314655,201703,61,47,14,44039,13118,57157
314660,201703,19,15,4,14055,3748,17803
314670,201703,171,140,31,130899,29047,159946
314675,201703,210,115,95,107755,89015,196770
314690,201703,531,293,238,274541,222996,497537
314700,201703,2419,1297,1122,1210230.6,1050423.95,2260654.55
314710,201703,1591,922,669,859699.15,625681.75,1485380.90
314720,201703,407,241,166,224130.9,155542,379672.9
314730,201703,495,264,231,245963,215688.4,461651.4
314740,201703,670,330,340,308507.25,318580,627087.25
314750,201703,19,17,2,15929,1874,17803
314760,201703,301,148,153,138676,143351.63,282027.63
314770,201703,123,83,40,77771,37480,115251
314780,201703,21,6,15,5622,14055,19677
314790,201703,2294,1435,859,1336623.55,803936.73,2140560.28
314795,201703,43,36,7,33498,6559,40057
314800,201703,2758,1593,1165,1486584.56,1090940.1,2577524.66
314810,201703,1458,802,656,749179.25,613079.5,1362258.75
314820,201703,84,47,37,44039,34669,78708
314830,201703,203,155,48,144532.75,44695,189227.75
314840,201703,80,47,33,44039,30921,74960
314850,201703,338,160,178,149920,166786,316706
314860,201703,698,517,181,482742.79,168098.35,650841.14
314870,201703,1392,695,697,650278.5,653089,1303367.5
314875,201703,55,47,8,44039,7496,51535
314880,201703,42,30,12,28110,11244,39354
314890,201703,48,29,19,27173,17803,44976
314900,201703,24,21,3,19677,2811,22488
314910,201703,260,172,88,161164,82456,243620
314915,201703,144,128,16,119702,14992,134694
314920,201703,135,80,55,74960,51254,126214
314930,201703,970,492,478,459178.1,447323.9,906502.0
314940,201703,53,42,11,39354,10307,49661
314950,201703,39,30,9,27407.25,8433,35840.25
314960,201703,61,44,17,41228,15929,57157
314970,201703,134,66,68,61561,63716,125277
314980,201703,304,194,110,178921.05,101852,280773.05
314990,201703,464,248,216,231439.25,201502.75,432942.00
314995,201703,157,60,97,56220,90879.63,147099.63
315000,201703,84,66,18,60905.6,16866,77771.6
315010,201703,45,29,16,27173,14992,42165
315015,201703,160,130,30,121097.88,28110,149207.88
315020,201703,55,47,8,44039,7496,51535
315030,201703,125,94,31,87142,29047,116189
315040,201703,60,44,16,41228,14992,56220
315050,201703,192,116,76,108692,71212,179904
315053,201703,32,27,5,25299,4685,29984
315057,201703,93,78,15,72711.2,14055,86766.2
315060,201703,71,64,7,58094.98,6559,64653.98
315070,201703,110,62,48,58094,44976,103070
315080,201703,355,292,63,273604,59031,332635
315090,201703,106,67,39,62779,36543,99322
315100,201703,75,40,35,37480,32795,70275
315110,201703,296,165,131,152731,122747,275478
315120,201703,1552,773,779,720413.1,728752,1449165.1
315130,201703,307,221,86,207077,80582,287659
315140,201703,534,311,223,288877.18,208951,497828.18
315150,201703,961,441,520,412281,486959,899240
315160,201703,191,96,95,89952,89015,178967
315170,201703,339,219,120,203330.1,112158.9,315489.0
315180,201703,3173,1347,1826,1258897.31,1708386.1,2967283.41
315190,201703,305,181,124,169223,116188,285411
315200,201703,1158,645,513,602585.53,479462.9,1082048.43
315210,201703,1472,825,647,768716.05,604365.8,1373081.85
315213,201703,31,21,10,19677,9370,29047
315217,201703,181,141,40,132117,37480,169597
315220,201703,1438,1102,336,1032199.3,314738.3,1346937.6
315230,201703,166,121,45,113096,42165,155261
315240,201703,423,279,144,261423,134684.63,396107.63
315250,201703,2475,1231,1244,1152135.3,1164589.31,2316724.61
315260,201703,150,89,61,82081.2,57157,139238.2
315270,201703,125,82,43,75709.6,39578.88,115288.48
315280,201703,705,460,245,430646,229555.63,660201.63
315290,201703,181,102,79,95574,73086.34,168660.34
315300,201703,74,46,28,43102,26236,69338
315310,201703,67,59,8,55283,7496,62779
315320,201703,154,83,71,77771,66527,144298
315330,201703,54,46,8,43102,7496,50598
315340,201703,407,290,117,270568.9,109624.32,380193.22
315350,201703,141,85,56,79645,52472,132117
315360,201703,93,49,44,45913,41228,87141
315370,201703,55,30,25,28110,23143.9,51253.9
315380,201703,11,6,5,5622,4685,10307
315390,201703,48,14,34,13118,31858,44976
315400,201703,791,588,203,547208.6,189555.1,736763.7
315410,201703,332,198,134,185245,125558,310803
315415,201703,61,46,15,43102,14055,57157
315420,201703,194,145,49,134788.5,45913,180701.5
315430,201703,667,397,270,371989,252990,624979
315440,201703,75,57,18,53409,16866,70275
315445,201703,251,199,52,186153.79,48724,234877.79
315450,201703,191,146,45,136802,42165,178967
315460,201703,3238,1643,1595,1534612.9,1491274.95,3025887.85
315470,201703,46,25,21,23144,19677,42821
315480,201703,60,22,38,20614,35606,56220
315490,201703,597,370,227,345518.75,212699,558217.75
315500,201703,24,13,11,12181,10307,22488
315510,201703,147,92,55,86204,51535,137739
315520,201703,64,58,6,54346,5622,59968
315530,201703,51,27,24,25299,22488,47787
315540,201703,232,147,85,137739,79645,217384
315550,201703,169,130,39,121810,36543,158353
315560,201703,725,576,149,539149.9,139613,678762.9
315570,201703,301,163,138,149639.25,129306,278945.25
315580,201703,617,405,212,379485,198644,578129
315590,201703,216,113,103,105881,95797.82,201678.82
315600,201703,273,196,77,183652,71962,255614
315610,201703,94,47,47,44039,44039,88078
315620,201703,31,23,8,21551,7496,29047
315630,201703,135,89,46,83393,43102,126495
315640,201703,50,31,19,29047,17803,46850
315645,201703,69,49,20,45913,18272,64185
315650,201703,159,118,41,110285,38417,148702
315660,201703,470,184,286,172408,267982,440390
315670,201703,2142,1080,1062,1009290.75,994317.9,2003608.65
315680,201703,856,573,283,533398.81,264458.88,797857.69
315690,201703,699,476,223,444957.63,208951,653908.63
315700,201703,1861,996,865,930441.51,809568.97,1740010.48
315710,201703,304,71,233,66527,218321,284848
315720,201703,411,263,148,246431,138394.9,384825.9
315725,201703,189,152,37,142424,34669,177093
315727,201703,37,20,17,18740,15705,34445
315730,201703,42,39,3,36543,2811,39354
315733,201703,88,56,32,52191,29984,82175
315737,201703,50,37,13,34669,12181,46850
315740,201703,42,37,5,34669,4685,39354
315750,201703,155,125,30,117085,28110,145195
315760,201703,44,29,15,27173,14055,41228
315765,201703,106,69,37,64653,34669,99322
315770,201703,224,130,94,121810,88078,209888
315780,201703,3151,1656,1495,1543756.05,1398192.31,2941948.36
315790,201703,194,148,46,138676,43102,181778
315800,201703,271,200,71,187119,66527,253646
315810,201703,85,49,36,45913,33732,79645
315820,201703,793,570,223,531842.77,208951,740793.77
315830,201703,141,82,59,76834,55283,132117
315840,201703,81,53,28,49661,26236,75897
315850,201703,260,191,69,178967,64653,243620
315860,201703,11,3,8,2811,7496,10307
315870,201703,33,28,5,26236,4685,30921
315880,201703,106,67,39,62779,36543,99322
315890,201703,67,49,18,45913,16866,62779
315895,201703,321,212,109,197895,101571,299466
315900,201703,64,35,29,32795,27173,59968
315910,201703,36,23,13,21223.05,12181,33404.05
315920,201703,186,124,62,116188,57157.95,173345.95
315930,201703,32,11,21,10307,19677,29984
315935,201703,131,102,29,94778,27164,121942
315940,201703,80,62,18,58094,16866,74960
315950,201703,62,41,21,38417,19677,58094
315960,201703,591,274,317,256381.94,296748,553129.94
315970,201703,40,30,10,28110,9370,37480
315980,201703,681,305,376,284848,352302.63,637150.63
315990,201703,243,144,99,134928,92482,227410
316000,201703,45,28,17,26236,15929,42165
316010,201703,69,59,10,55283,9370,64653
316020,201703,98,81,17,75897,15929,91826
316030,201703,403,202,201,189274,188103,377377
316040,201703,469,209,260,195531.89,243339,438870.89
316045,201703,63,57,6,53409,5622,59031
316050,201703,16,15,1,12743.2,937,13680.2
316060,201703,95,64,31,59686.9,29047,88733.9
316070,201703,997,638,359,592187.25,335634,927821.25
316080,201703,105,64,41,59968,38417,98385
316090,201703,48,28,20,25299.1,18740,44039.1
316095,201703,57,47,10,43768,9370,53138
316100,201703,297,175,122,163412.9,114314,277726.9
316105,201703,30,21,9,19677,8433,28110
316110,201703,1899,1514,385,1407983.47,358777.3,1766760.77
316120,201703,76,54,22,50598,20333,70931
316130,201703,138,106,32,98667,29984,128651
316140,201703,21,16,5,14992,4685,19677
316150,201703,196,141,55,131414.25,51535,182949.25
316160,201703,88,55,33,51535,30921,82456
316165,201703,56,42,14,39167,12415.25,51582.25
316170,201703,212,143,69,133054,64653,197707
316180,201703,186,84,102,78380.05,95574,173954.05
316190,201703,128,93,35,86204,32795,118999
316200,201703,698,395,303,370115,283724,653839
316210,201703,725,478,247,447546.43,231439,678985.43
316220,201703,117,76,41,71212,38417,109629
316225,201703,15,7,8,6559,7496,14055
316230,201703,32,19,13,17803,12181,29984
316240,201703,606,488,118,456319.1,110566,566885.1
316245,201703,98,82,16,76834,14992,91826
316250,201703,1451,1020,431,946964.8,403622.12,1350586.92
316255,201703,112,90,22,83955.2,20614,104569.2
316257,201703,168,91,77,85267,72149,157416
316260,201703,236,153,83,141805.83,77678,219483.83
316265,201703,21,13,8,12181,7496,19677
316270,201703,662,461,201,428958.8,188337,617295.8
316280,201703,525,322,203,299528.5,189555.3,489083.8
316290,201703,653,431,222,401036.69,208014,609050.69
316292,201703,472,186,286,174282,267607.2,441889.2
316294,201703,121,75,46,70275,43102,113377
316295,201703,268,122,146,112892.5,136802,249694.5
316300,201703,97,67,30,62779,28110,90889
316310,201703,33,18,15,16866,14055,30921
316320,201703,47,27,20,25299,18740,44039
316330,201703,119,75,44,69317.25,40946.9,110264.15
316340,201703,139,99,40,92763,37480,130243
316350,201703,187,132,55,123357,51535,174892
316360,201703,24,19,5,17803,4685,22488
316370,201703,1023,549,474,510684.75,444128.63,954813.38
316380,201703,115,88,27,82456,25299,107755
316390,201703,121,85,36,79645,33732,113377
316400,201703,127,97,30,90889,28110,118999
316410,201703,307,225,82,209466.35,76834,286300.35
316420,201703,182,128,54,119233.25,50598,169831.25
316430,201703,150,76,74,71212,69338,140550
316440,201703,100,48,52,44976,48724,93700
316443,201703,35,33,2,30921,1874,32795
316447,201703,63,52,11,48724,10307,59031
316450,201703,201,156,45,146172,42165,188337
316460,201703,62,27,35,25299,32795,58094
316470,201703,1535,1105,430,1030546.15,400732.79,1431278.94
316480,201703,10,9,1,8433,937,9370
316490,201703,15,5,10,4685,9370,14055
316500,201703,151,101,50,94355.9,46850,141205.9
316510,201703,171,125,46,115860.15,43102,158962.15
316520,201703,192,119,73,110940.8,68401,179341.8
316530,201703,148,105,43,98385,40010,138395
316540,201703,135,73,62,67464,58094,125558
316550,201703,141,97,44,90668.67,41187.89,131856.56
316553,201703,205,105,100,98166.5,93700,191866.5
316555,201703,21,12,9,11244,8433,19677
316556,201703,12,8,4,7496,3748,11244
316557,201703,14,13,1,12181,937,13118
316560,201703,55,44,11,41228,10307,51535
316570,201703,248,224,24,209654,22488,232142
316580,201703,23,15,8,14055,7496,21551
316590,201703,129,111,18,104007,16866,120873
316600,201703,183,147,36,137511,33732,171243
316610,201703,64,42,22,38791.8,20614,59405.8
316620,201703,127,98,29,91826,27173,118999
316630,201703,39,29,10,27173,9370,36543
316640,201703,16,10,6,9370,5622,14992
316650,201703,60,46,14,43102,13118,56220
316660,201703,5,3,2,2811,1874,4685
316670,201703,435,148,287,138658,268357,407015
316680,201703,160,110,50,103070,46663,149733
316690,201703,189,117,72,109629,67464,177093
316695,201703,53,48,5,44976,4685,49661
316700,201703,12,6,6,5622,5622,11244
316710,201703,693,498,195,466110.9,182715,648825.9
316720,201703,4725,2404,2321,2238079.71,2170810.34,4408890.05
316730,201703,15,13,2,12181,1874,14055
316740,201703,136,80,56,74960,52472,127432
316750,201703,18,12,6,11244,5622,16866
316760,201703,325,258,67,241746,62779,304525
316770,201703,134,79,55,74023,51535,125558
316780,201703,71,38,33,35307,30921,66228
316790,201703,53,40,13,37480,12181,49661
316800,201703,1762,1102,660,1029201,617571,1646772
316805,201703,19,10,9,9370,8433,17803
316810,201703,65,41,24,38417,22488,60905
316820,201703,40,20,20,18740,18740,37480
316830,201703,89,39,50,36543,46569,83112
316840,201703,493,290,203,270980.5,188337,459317.5
316850,201703,335,216,119,201033.35,111503,312536.35
316860,201703,5892,2574,3318,2400161.79,3104319.63,5504481.42
316870,201703,1358,872,486,809148.85,451027.55,1260176.40
316880,201703,100,59,41,54627.9,38417,93044.9
316890,201703,249,168,81,157416,75897,233313
316900,201703,411,282,129,261733.84,120873,382606.84
316905,201703,13,9,4,8433,3748,12181
316910,201703,54,27,27,25299,25299,50598
316920,201703,125,99,26,92061,24362,116423
316930,201703,1901,942,959,876987.15,896428.85,1773416.00
316935,201703,836,500,336,466626.66,313332.8,779959.46
316940,201703,1060,607,453,567541.6,423889.53,991431.13
316950,201703,181,93,88,87141,82456,169597
316960,201703,1086,597,489,557796.9,457893.26,1015690.16
316970,201703,631,493,138,461941,129306,591247
316980,201703,115,72,43,67464,40281.63,107745.63
316990,201703,2119,1387,732,1293014.33,684938.63,1977952.96
317000,201703,312,242,70,226473,65590,292063
317005,201703,243,174,69,163038,64653,227691
317010,201703,6087,3305,2782,3080847.08,2604850.83,5685697.91
317020,201703,15736,6886,8850,6421284.17,8278039.86,14699324.03
317030,201703,85,31,54,29047,50598,79645
317040,201703,3091,1900,1191,1776932.58,1113732.6,2890665.18
317043,201703,69,48,21,44976,19396,64372
317047,201703,34,16,18,14992,16862,31854
317050,201703,188,141,47,132117,44039,176156
317052,201703,116,91,25,85267,23425,108692
317057,201703,189,146,43,136802,39729,176531
317060,201703,54,34,20,31858,18458.9,50316.9
317065,201703,58,48,10,44976,9370,54346
317070,201703,1944,910,1034,847048.85,967078,1814126.85
317075,201703,108,56,52,52472,48724,101196
317080,201703,781,427,354,399022,331511,730533
317090,201703,596,482,114,451212.35,106818,558030.35
317100,201703,399,299,100,278232.6,93700,371932.6
317103,201703,94,80,14,74960,13118,88078
317107,201703,33,31,2,29047,1874,30921
317110,201703,97,43,54,40291,50598,90889
317115,201703,42,36,6,33732,5622,39354
317120,201703,1746,881,865,817754.35,810056,1627810.35
317130,201703,1814,1150,664,1073716.3,621513,1695229.3
317140,201703,4,3,1,2811,937,3748
317150,201703,261,159,102,148983,94824.4,243807.4
317160,201703,307,221,86,206796,80582,287378
317170,201703,199,145,54,135865,50598,186463
317180,201703,400,293,107,273838.25,100259,374097.25
317190,201703,250,168,82,157416,76834,234250
317200,201703,772,554,218,505894,204266,710160
317210,201703,150,85,65,78708.6,60905,139613.6
317220,201703,22,13,9,12181,8433,20614
320010,201703,591,440,151,409188.8,141487,550675.8
320013,201703,126,89,37,83393,34669,118062
320016,201703,276,171,105,160227,98385,258612
320020,201703,683,405,278,375939.37,257891.97,633831.34
320030,201703,146,108,38,101196,35278.05,136474.05
320035,201703,130,95,35,89015,32795,121810
320040,201703,488,264,224,246243.8,209888,456131.8
320050,201703,98,76,22,71212,20614,91826
320060,201703,1435,633,802,593075,750809.3,1343884.3
320070,201703,95,67,28,62779,26236,89015
320080,201703,744,425,319,396193.1,298621.9,694815.0
320090,201703,1187,826,361,770536.4,337413.8,1107950.2
320100,201703,309,180,129,166514.01,120252.34,286766.35
320110,201703,131,85,46,77959.1,43102,121061.1
320115,201703,106,85,21,79645,19677,99322
320120,201703,3173,1764,1409,1642657.55,1318625.96,2961283.51
320130,201703,6946,3357,3589,3124570.95,3355153.9,6479724.85
320140,201703,417,268,149,249804.6,139373,389177.6
320150,201703,1768,1037,731,965944.05,684937.63,1650881.68
320160,201703,671,288,383,268629.22,358755.96,627385.18
320170,201703,114,87,27,80770,25299,106069
320180,201703,46,26,20,24362,18740,43102
320190,201703,236,166,70,154783.4,65309,220092.4
320200,201703,53,39,14,36543,13118,49661
320210,201703,832,467,365,436080.8,340817,776897.8
320220,201703,295,113,182,104944.86,170253,275197.86
320225,201703,76,62,14,58094,13118,71212
320230,201703,510,329,181,306961.2,168801,475762.2
320240,201703,2998,1528,1470,1430237.8,1375508.1,2805745.9
320245,201703,411,286,125,267513.6,117125,384638.6
320250,201703,209,110,99,102133,92763,194896
320255,201703,140,112,28,103660.31,26096,129756.31
320260,201703,163,118,45,110566,42118.15,152684.15
320265,201703,163,128,35,119140,32795,151935
320270,201703,152,121,31,113377,29047,142424
320280,201703,891,543,348,503011.1,324698.81,827709.91
320290,201703,66,56,10,52472,9370,61842
320300,201703,492,355,137,331202.65,127124.55,458327.20
320305,201703,607,326,281,305462,263297,568759
320310,201703,202,116,86,108411,79840,188251
320313,201703,274,142,132,133054,123403,256457
320316,201703,107,90,17,84330,15929,100259
320320,201703,3197,1410,1787,1317788.8,1672139.5,2989928.3
320330,201703,257,189,68,176443.9,61842.81,238286.71
320332,201703,844,507,337,472506,314618.15,787124.15
320334,201703,236,145,91,135584,85267,220851
320335,201703,144,105,39,97213.95,36543,133756.95
320340,201703,582,397,185,370865,172690,543555
320350,201703,933,396,537,369347,502633.44,871980.44
320360,201703,157,82,75,76553,70275,146828
320370,201703,234,178,56,165230,51457,216687
320380,201703,280,189,91,176343.4,85267,261610.4
320390,201703,1063,649,414,608113,385772.45,993885.45
320400,201703,317,222,95,206140.6,88734,294874.6
320405,201703,816,333,483,311796.34,452398.15,764194.49
320410,201703,913,470,443,438731.7,414726.34,853458.04
320420,201703,466,243,223,227223.2,208951,436174.2
320425,201703,183,104,79,97448,74023,171471
320430,201703,377,212,165,197800.95,154605,352405.95
320435,201703,166,109,57,101327.18,53409,154736.18
320440,201703,191,121,70,113095.9,65590,178685.9
320450,201703,123,70,53,65590,49661,115251
320455,201703,238,188,50,175220,46832,222052
320460,201703,234,151,83,141487,77771,219258
320465,201703,115,79,36,73666.94,33732,107398.94
320470,201703,590,382,208,357635.54,194888,552523.54
320480,201703,160,105,55,98385,51535,149920
320490,201703,2839,1407,1432,1314799.21,1339875.72,2654674.93
320495,201703,90,56,34,52454,31858,84312
320500,201703,9070,4624,4446,4303465.82,4155631.91,8459097.73
320501,201703,497,252,245,236124,229556,465680
320503,201703,260,186,74,173345.6,69338,242683.6
320506,201703,243,189,54,177093,50598,227691
320510,201703,869,419,450,389348.65,420693.05,810041.70
320515,201703,75,61,14,56220.45,13118,69338.45
320517,201703,187,133,54,124621,50598,175219
320520,201703,6406,2855,3551,2662972.05,3321490.93,5984462.98
320530,201703,4993,2523,2470,2355378.54,2310260.93,4665639.47
330010,201703,2768,1417,1351,1318292.9,1263714.66,2582007.56
330015,201703,156,62,94,57157.14,88078,145235.14
330020,201703,3384,1472,1912,1374273.88,1790420,3164693.88
330022,201703,203,115,88,107755,81520,189275
330023,201703,499,168,331,156245.4,310147,466392.4
330025,201703,510,119,391,111503,366085.9,477588.9
330030,201703,1794,1134,660,1055393.43,615330.36,1670723.79
330040,201703,2040,1020,1020,953679.3,954522,1908201.3
330045,201703,8180,2518,5662,2350119.29,5300387.66,7650506.95
330050,201703,758,483,275,452571,257675,710246
330060,201703,821,534,287,496431.45,268919,765350.45
330070,201703,3231,1253,1978,1169921.19,1851917.63,3021838.82
330080,201703,1411,684,727,636683.75,680262.3,1316946.05
330090,201703,349,202,147,189274,137739,327013
330093,201703,274,120,154,112440,144289,256729
330095,201703,99,48,51,44976,47787,92763
330100,201703,8875,4653,4222,4351447.44,3952172.4,8303619.84
330110,201703,468,208,260,193256.8,243620,436876.8
330115,201703,499,290,209,271730,195833,467563
330120,201703,352,183,169,170346.6,157884.5,328231.1
330130,201703,1363,428,935,400323.88,876068,1276391.88
330140,201703,590,305,285,285767,266109,551876
330150,201703,426,257,169,238935.07,157416,396351.07
330160,201703,207,128,79,119936,74023,193959
330170,201703,25439,8953,16486,8370261.02,15431243.79,23801504.81
330180,201703,225,144,81,131490.75,75194.25,206685.00
330185,201703,713,308,405,287088.1,379467,666555.1
330187,201703,247,87,160,81519,149920,231439
330190,201703,5447,2156,3291,2011485.25,3079682.98,5091168.23
330200,201703,4076,1433,2643,1339864.7,2471895.28,3811759.98
330205,201703,392,242,150,226754,140269,367023
330210,201703,929,566,363,526315.8,338444.95,864760.75
330220,201703,2316,1367,949,1277756.76,888276.1,2166032.86
330225,201703,529,297,232,277662,217384,495046
330227,201703,2296,809,1487,754931.63,1393034.32,2147965.95
330230,201703,192,113,79,105226,74023,179249
330240,201703,3362,1742,1620,1628398.48,1515835.72,3144234.20
330245,201703,144,56,88,52472,81706.4,134178.4
330250,201703,6145,3180,2965,2970578.1,2772474.26,5743052.36
330260,201703,518,156,362,146172,339194,485366
330270,201703,3130,1169,1961,1094229.5,1837084,2931313.5
330280,201703,435,287,148,266034.34,138667,404701.34
330285,201703,6729,2289,4440,2140084.4,4157313.2,6297397.6
330290,201703,567,222,345,207078,322984,530062
330300,201703,701,484,217,449760.85,203320,653080.85
330310,201703,405,240,165,223006.35,154605,377611.35
330320,201703,7331,2762,4569,2580126.7,4276497.6,6856624.3
330330,201703,9326,3586,5740,3354444.16,5374062.61,8728506.77
330340,201703,2558,1540,1018,1441097.53,953847.26,2394944.79
330350,201703,16946,6722,10224,6273568.04,9560991.48,15834559.52
330360,201703,2582,1273,1309,1191658.7,1226533,2418191.7
330370,201703,965,523,442,489301.4,412468.4,901769.8
330380,201703,803,344,459,321595.77,429614.9,751210.67
330385,201703,600,316,284,295156,266108,561264
330390,201703,4962,2732,2230,2548473.44,2087823.92,4636297.36
330395,201703,218,142,76,131368.05,68729.5,200097.55
330400,201703,623,317,306,293937.4,284430.54,578367.94
330410,201703,492,350,142,326302.63,133054,459356.63
330411,201703,221,128,93,119936,87141,207077
330412,201703,245,106,139,99041,130243,229284
330414,201703,6178,2535,3643,2371755.66,3410101.75,5781857.41
330415,201703,531,246,285,230502,266108.4,496610.4
330420,201703,2248,1188,1060,1109764.67,991066.3,2100830.97
330430,201703,1746,715,1031,669197.1,964361,1633558.1
330440,201703,238,104,134,97448,125558,223006
330450,201703,128,52,76,47788,71212,119000
330452,201703,1570,699,871,653024.18,816117.63,1469141.81
330455,201703,106689,37863,68826,35405654.38,64432804.68,99838459.06
330460,201703,261,108,153,101196,143361,244557
330470,201703,1209,662,547,615290.8,512529.63,1127820.43
330475,201703,1361,377,984,350626.7,921436.43,1272063.13
330480,201703,708,378,330,354186,308274,662460
330490,201703,12912,4628,8284,4329948.84,7755244.5,12085193.34
330500,201703,1299,604,695,565948,650841,1216789
330510,201703,10856,3431,7425,3210097.96,6950858.41,10160956.37
330513,201703,104,52,52,48724,48724,97448
330515,201703,839,346,493,322329.4,461660,783989.4
330520,201703,2261,877,1384,821534,1295777.3,2117311.3
330530,201703,230,121,109,113377,101946,215323
330540,201703,356,179,177,167723,165381,333104
330550,201703,3071,1090,1981,1020815,1855005.95,2875820.95
330555,201703,696,254,442,237998,413780,651778
330560,201703,506,193,313,180841,293272,474113
330570,201703,243,166,77,155542,72149,227691
330575,201703,715,328,387,307102,360100.01,667202.01
330580,201703,3260,1841,1419,1720141.5,1328104,3048245.5
330590,201703,288,154,134,144298,125558,269856
330600,201703,1008,652,356,609762.62,332822.4,942585.02
330610,201703,1463,808,655,751146.61,609708.45,1360855.06
330615,201703,177,139,38,130243,35606,165849
330620,201703,854,420,434,389071.06,404220.3,793291.36
330630,201703,3488,2175,1313,2025042.45,1222656.58,3247699.03
350010,201703,606,394,212,367773,198644,566417
350020,201703,36,18,18,16866,16866,33732
350030,201703,509,331,178,309023,165617.66,474640.66
350040,201703,130,49,81,45575.68,75616,121191.68
350050,201703,293,159,134,148701.9,125305.63,274007.53
350055,201703,83,46,37,43102,34669,77771
350060,201703,74,26,48,24362,44976,69338
350070,201703,776,445,331,412588.11,308433.68,721021.79
350075,201703,66,43,23,40291,21551,61842
350080,201703,49,28,21,25611.3,18740,44351.3
350090,201703,98,57,41,53409,38412.32,91821.32
350100,201703,300,185,115,172642.25,107755,280397.25
350110,201703,64,38,26,35606,24362,59968
350115,201703,149,89,60,82737.1,56220,138957.1
350120,201703,110,74,36,69338,33732,103070
350130,201703,350,166,184,154980,172408,327388
350140,201703,35,21,14,18178.4,13118,31296.4
350150,201703,66,52,14,48724,13118,61842
350160,201703,2421,921,1500,859681.77,1404757.58,2264439.35
350170,201703,394,240,154,222725.25,144017,366742.25
350180,201703,177,92,85,85923,79645,165568
350190,201703,853,407,446,378173.74,417325.85,795499.59
350200,201703,73,27,46,25097.46,42841.8,67939.26
350210,201703,1341,747,594,691021.96,555819.03,1246840.99
350220,201703,667,573,94,532843.75,88078,620921.75
350230,201703,73,53,20,49661,18740,68401
350240,201703,62,47,15,44039,14055,58094
350250,201703,1170,587,583,543322.55,545746.93,1089069.48
350260,201703,93,67,26,62779,24362,87141
350270,201703,810,539,271,503785.03,252202.65,755987.68
350275,201703,289,113,176,105507,164912,270419
350280,201703,4566,2330,2236,2171664.58,2093004.48,4264669.06
350290,201703,388,183,205,171190,190585.9,361775.9
350300,201703,48,24,24,22488,22488,44976
350310,201703,101,72,29,67464,27173,94637
350315,201703,36,20,16,18740,14992,33732
350320,201703,3214,1569,1645,1466621.35,1541131.52,3007752.87
350330,201703,1639,863,776,805182.3,726111.7,1531294.0
350335,201703,20,13,7,12181,6559,18740
350340,201703,134,73,61,68401,57157,125558
350350,201703,94,45,49,42165,45913,88078
350360,201703,126,84,42,78704,39073,117777
350370,201703,94,55,39,50910.3,36533.63,87443.93
350380,201703,715,298,417,278570.1,390447.9,669018.0
350390,201703,1356,558,798,522062.25,746320.6,1268382.85
350395,201703,26,18,8,16866,7496,24362
350400,201703,1666,878,788,812970.87,735804.13,1548775.00
350410,201703,2187,965,1222,901452.88,1144704.9,2046157.78
350420,201703,237,141,96,130788.54,89952,220740.54
350430,201703,75,43,32,39729,29984,69713
350440,201703,148,105,43,97401.25,40291,137692.25
350450,201703,1614,1041,573,968324.9,536808,1505132.9
350460,201703,325,115,210,107755,196488.9,304243.9
350470,201703,13,10,3,9370,2811,12181
350480,201703,152,83,69,77771,64653,142424
350490,201703,244,114,130,106818,121810,228628
350500,201703,33,15,18,14055,16866,30921
350510,201703,160,107,53,100259,49661,149920
350520,201703,437,195,242,180217,226129.3,406346.3
350530,201703,443,216,227,202392,212699,415091
350535,201703,56,44,12,40854,11244,52098
350540,201703,375,193,182,179968.47,170253,350221.47
350550,201703,2706,1587,1119,1480418.45,1047507.19,2527925.64
350560,201703,620,430,190,402905.32,177674.65,580579.97
350570,201703,4277,1766,2511,1650884.06,2351281.1,4002165.16
350580,201703,371,178,193,166786,180703.88,347489.88
350590,201703,900,485,415,454445,387918.3,842363.3
350600,201703,6014,3030,2984,2826370.14,2791314.28,5617684.42
350610,201703,1526,755,771,702373.17,721200,1423573.17
350620,201703,39,27,12,25299,11244,36543
350630,201703,237,138,99,128369.3,91827,220196.3
350635,201703,808,309,499,289252,466927.54,756179.54
350640,201703,119,88,31,82456,29047,111503
350650,201703,1837,1223,614,1142335.45,574301.1,1716636.55
350660,201703,739,334,405,312958,378548,691506
350670,201703,315,157,158,146875,148046,294921
350680,201703,180,100,80,93700,74679,168379
350690,201703,201,100,101,93700,94637,188337
350700,201703,653,317,336,293908.09,314832,608740.09
350710,201703,311,128,183,118749.1,171471,290220.1
350715,201703,47,41,6,38417,5622,44039
350720,201703,18,14,4,13118,3748,16866
350730,201703,40,26,14,24362,13118,37480
350740,201703,191,108,83,100914.9,77771,178685.9
350745,201703,22,11,11,10283,10307,20590
350750,201703,2075,1352,723,1259189.05,675889.3,1935078.35
350760,201703,3630,1581,2049,1480460.3,1917739.53,3398199.83
350770,201703,59,39,20,36543,18740,55283
350775,201703,47,34,13,31858,12172,44030
350780,201703,405,201,204,188337,191148,379485
350790,201703,384,170,214,159290,200518,359808
350800,201703,416,232,184,217384,172408,389792
350810,201703,482,386,96,359809.3,89952,449761.3
350820,201703,78,50,28,46850,26236,73086
350830,201703,82,48,34,44976,31858,76834
350840,201703,722,328,394,307055,368241,675296
350850,201703,1650,955,695,888895.26,650968,1539863.26
350860,201703,528,305,223,283894.16,208951,492845.16
350870,201703,420,286,134,267982,125183.9,393165.9
350880,201703,289,157,132,143785.2,123684,267469.2
350890,201703,41,25,16,23425,14992,38417
350900,201703,1352,447,905,416889.19,847235.4,1264124.59
350910,201703,26,18,8,16866,7496,24362
350920,201703,573,320,253,299527.7,237061,536588.7
350925,201703,1160,623,537,579898.77,501763.7,1081662.47
350930,201703,94,58,36,54346,33732,88078
350940,201703,677,366,311,341442.8,289598.8,631041.6
350945,201703,99,77,22,72149,20614,92763
350950,201703,14456,6901,7555,6437646.51,7066751.68,13504398.19
350960,201703,1267,574,693,533522.9,649337,1182859.9
350970,201703,1096,622,474,580587.3,443847.63,1024434.93
350980,201703,103,69,34,64653,31858,96511
350990,201703,357,124,233,115504,218039.9,333543.9
350995,201703,28,14,14,13118,13118,26236
351000,201703,627,456,171,425087.26,160227,585314.26
351010,201703,53,28,25,26236,23425,49661
351015,201703,61,43,18,40291,16866,57157
351020,201703,1631,920,711,860364.64,664146.2,1524510.84
351030,201703,311,219,92,202673.4,86204,288877.4
351040,201703,808,436,372,407595,347627.15,755222.15
351050,201703,3140,1517,1623,1414798.03,1518637.33,2933435.36
351060,201703,4753,1950,2803,1818525.95,2623435.93,4441961.88
351070,201703,412,264,148,246466,138676,385142
351080,201703,801,570,231,534090,215510,749600
351090,201703,65,29,36,27173,33732,60905
351100,201703,448,256,192,237689.35,179890.32,417579.67
351110,201703,2122,1028,1094,957419.99,1022572.26,1979992.25
351120,201703,74,40,34,37396.6,31858,69254.6
351130,201703,168,53,115,49661,107755,157416
351140,201703,337,237,100,220289.5,93700,313989.5
351150,201703,383,196,187,182809,175160,357969
351160,201703,238,154,84,144298,78708,223006
351170,201703,175,86,89,80582,82644,163226
351190,201703,85,59,26,55283,24362,79645
351200,201703,374,244,130,228347,121810,350157
351210,201703,128,59,69,55283,64653,119936
351220,201703,518,314,204,291188.81,191148,482336.81
351230,201703,281,203,78,189305.3,73067.26,262372.56
351240,201703,228,94,134,87890.6,125558,213448.6
351250,201703,65,46,19,43102,17803,60905
351260,201703,149,108,41,101196,38417,139613
351270,201703,51,22,29,20614,27173,47787
351280,201703,1106,510,596,474124.35,557937.39,1032061.74
351290,201703,219,97,122,90889,114033,204922
351300,201703,3747,1762,1985,1643970.13,1859633,3503603.13
351310,201703,735,387,348,361636,326076,687712
351320,201703,101,60,41,56220,38417,94637
351330,201703,38,26,12,24362,11244,35606
351340,201703,1184,744,440,690409.39,411327,1101736.39
351350,201703,2263,1201,1062,1124682,994527.22,2119209.22
351360,201703,762,381,381,355123,355883.19,711006.19
351370,201703,361,188,173,176151.32,161476.3,337627.62
351380,201703,8906,4107,4799,3833377.18,4487375.11,8320752.29
351385,201703,28,19,9,17803,8433,26236
351390,201703,268,193,75,180111.26,70275,250386.26
351400,201703,59,37,22,34669,20568.63,55237.63
351410,201703,405,252,153,235655.5,143361,379016.5
351420,201703,61,50,11,46850,10307,57157
351430,201703,82,47,35,44039,32795,76834
351440,201703,782,531,251,495389.2,235183,730572.2
351450,201703,245,125,120,117125,112440,229565
351460,201703,120,53,67,49661,62779,112440
351470,201703,143,77,66,72140,61842,133982
351480,201703,517,278,239,259549.1,223825.88,483374.98
351490,201703,293,101,192,94637,179904,274541
351492,201703,33,24,9,22488,8433,30921
351495,201703,30,19,11,17803,10307,28110
351500,201703,3489,1493,1996,1393253.37,1865709.1,3258962.47
351510,201703,1753,719,1034,673421.9,966693.54,1640115.44
351512,201703,19,15,4,14055,3748,17803
351515,201703,189,106,83,99322,77771,177093
351518,201703,700,427,273,399158,255660.45,654818.45
351519,201703,75,48,27,44976,25299,70275
351520,201703,139,86,53,79958,49661,129619
351530,201703,18,14,4,13118,3748,16866
351535,201703,131,74,57,69338,53409,122747
351540,201703,418,300,118,278760,110566,389326
351550,201703,1257,769,488,713529.1,457246.63,1170775.73
351560,201703,73,37,36,34669,33732,68401
351565,201703,11,6,5,5622,4685,10307
351570,201703,2520,1317,1203,1232538.29,1126564.26,2359102.55
351580,201703,34,29,5,27173,4685,31858
351590,201703,66,46,20,43102,18740,61842
351600,201703,188,137,51,128369,47787,176156
351610,201703,61,27,34,25299,31858,57157
351620,201703,5968,3410,2558,3185166.76,2391898.73,5577065.49
351630,201703,2424,1244,1180,1160689.69,1104062.42,2264752.11
351640,201703,1631,781,850,730175.99,794670.3,1524846.29
351650,201703,30,26,4,24362,3748,28110
351660,201703,155,95,60,89015,56220,145235
351670,201703,715,443,272,412843.25,254864,667707.25
351680,201703,79,64,15,59968,14055,74023
351685,201703,39,25,14,23425,13118,36543
351690,201703,309,217,92,201216.17,86204,287420.17
351700,201703,159,110,49,103070,45913,148983
351710,201703,70,49,21,45913,19677,65590
351720,201703,138,65,73,60905,68401,129306
351730,201703,92,65,27,60905,25294.32,86199.32
351740,201703,713,473,240,442920,224875.32,667795.32
351750,201703,355,146,209,135865.7,195824,331689.7
351760,201703,791,609,182,570633,170534,741167
351770,201703,283,246,37,229566,34669,264235
351780,201703,168,92,76,86204,71212,157416
351790,201703,239,126,113,118062,105881,223943
351800,201703,51,32,19,29984,17803,47787
351810,201703,120,78,42,72805,39354,112159
351820,201703,879,633,246,588837.8,230497.32,819335.12
351830,201703,500,186,314,173532.4,294218,467750.4
351840,201703,1818,935,883,866607.75,825629.47,1692237.22
351850,201703,220,167,53,155680.8,49661,205341.8
351860,201703,740,483,257,448543.77,240804.32,689348.09
351870,201703,5547,2623,2924,2449021.62,2733421.47,5182443.09
351880,201703,18737,8297,10440,7751603.67,9767890.44,17519494.11
351885,201703,96,63,33,59031,30921,89952
351890,201703,74,63,11,59031,10307,69338
351900,201703,220,133,87,123966,81519,205485
351905,201703,75,33,42,30921,39354,70275
351907,201703,3026,1330,1696,1242767.23,1588108.22,2830875.45
351910,201703,174,70,104,65590,97448,163038
351920,201703,140,82,58,76834,54323.96,131157.96
351925,201703,80,55,25,51535,23425,74960
351930,201703,379,258,121,241652.3,113377,355029.3
351940,201703,227,104,123,97448,115251,212699
351950,201703,139,78,61,72774,57157,129931
351960,201703,796,371,425,347295.58,396388.58,743684.16
351970,201703,1865,979,886,915215.04,829611,1744826.04
351980,201703,138,70,68,63716,63716,127432
351990,201703,284,191,93,178030,86353.92,264383.92
352000,201703,346,204,142,190773.2,133054,323827.2
352010,201703,336,195,141,182715,132117,314832
352020,201703,192,70,122,65590,114314,179904
352030,201703,977,498,479,465642.25,446980.2,912622.45
352040,201703,565,242,323,226754,302651,529405
352042,201703,251,87,164,81519,153387,234906
352044,201703,383,229,154,213544.1,144298,357842.1
352050,201703,3080,1259,1821,1172302.2,1705198.53,2877500.73
352060,201703,99,63,36,59031,33732,92763
352070,201703,98,69,29,63717,27173,90890
352080,201703,65,39,26,35606,24362,59968
352090,201703,170,116,54,108692,50598,159290
352100,201703,250,125,125,117125,115993,233118
352110,201703,110,33,77,30921,72149,103070
352115,201703,73,29,44,27173,41228,68401
352120,201703,103,61,42,57157,39354,96511
352130,201703,222,186,36,174094.6,33732,207826.6
352140,201703,185,74,111,68870,104007,172877
352150,201703,124,69,55,63716.7,51535,115251.7
352160,201703,129,87,42,81519,39354,120873
352170,201703,372,254,118,237061.7,110566,347627.7
352180,201703,590,402,188,374661.55,176156,550817.55
352190,201703,268,100,168,93690.63,157369.15,251059.78
352200,201703,32,19,13,17803,12181,29984
352210,201703,3554,1468,2086,1369314.2,1949237.97,3318552.17
352215,201703,48,29,19,27112.67,17272.8,44385.47
352220,201703,6950,2754,4196,2575580.23,3929203.72,6504783.95
352230,201703,3057,1951,1106,1816089.52,1030892.64,2846982.16
352240,201703,2106,1253,853,1171023.08,797106.25,1968129.33
352250,201703,2527,1336,1191,1247726.35,1113955.7,2361682.05
352260,201703,1109,634,475,592831.32,444794,1037625.32
352265,201703,67,31,36,29047,33732,62779
352270,201703,383,217,166,202392.84,155487,357879.84
352280,201703,373,232,141,217072,131831.32,348903.32
352290,201703,175,110,65,102508,60905,163413
352300,201703,102,79,23,74023,21551,95574
352310,201703,5500,2719,2781,2537229.43,2601284.27,5138513.70
352320,201703,898,486,412,452790.99,383093.55,835884.54
352330,201703,532,229,303,213214.37,283630,496844.37
352340,201703,1376,673,703,626124.4,657868,1283992.4
352350,201703,309,198,111,185526,103726,289252
352360,201703,225,88,137,81565.85,125819,207384.85
352370,201703,104,71,33,66527,30921,97448
352380,201703,114,71,43,66527,40291,106818
352390,201703,2386,1085,1301,1012270.9,1216695.64,2228966.54
352400,201703,460,193,267,180138.25,249897.9,430036.15
352410,201703,728,522,206,484685.9,193022,677707.9
352420,201703,101,62,39,58094,36543,94637
352430,201703,1732,770,962,714933.55,899725.59,1614659.14
352440,201703,2986,1538,1448,1433605.88,1352997.4,2786603.28
352450,201703,188,159,29,148983,27173,176156
352460,201703,561,286,275,267715.64,256973.1,524688.74
352470,201703,556,191,365,178967,341996,520963
352480,201703,1363,763,600,714307,561637.9,1275944.9
352490,201703,81,34,47,31858,44039,75897
352500,201703,1212,542,670,505957.8,626376,1132333.8
352510,201703,730,390,340,364493.3,318580,683073.3
352520,201703,506,215,291,201455,272526.45,473981.45
352530,201703,1689,877,812,820812,759251.3,1580063.3
352540,201703,77,51,26,47787,24362,72149
352550,201703,184,105,79,98385,73613.53,171998.53
352560,201703,52,41,11,38417,10307,48724
352570,201703,640,338,302,316103.63,282974,599077.63
352580,201703,56,38,18,34669.33,16866,51535.33
352585,201703,14,5,9,4685,8433,13118
352590,201703,4185,2091,2094,1954413.06,1961202.48,3915615.54
352600,201703,352,245,107,228628.3,100250,328878.3
352610,201703,908,429,479,399286.51,448823,848109.51
352620,201703,966,384,582,358871.1,545334,904205.1
352630,201703,211,74,137,69338,127937.98,197275.98
352640,201703,535,371,164,346275.88,153668,499943.88
352650,201703,92,63,29,59031,27173,86204
352660,201703,83,50,33,46850,30921,77771
352670,201703,1613,876,737,817399.93,689513.12,1506913.05
352680,201703,898,574,324,534639.58,302339.2,836978.78
352690,201703,4214,1943,2271,1811560.69,2124129.87,3935690.56
352700,201703,115,65,50,60905,46850,107755
352710,201703,1269,664,605,620294.35,564636.6,1184930.95
352720,201703,1184,592,592,552206.1,554699.32,1106905.42
352725,201703,26,25,1,23425,937,24362
352730,201703,357,177,180,164691.81,168098,332789.81
352740,201703,406,255,151,237717.04,141487,379204.04
352750,201703,24,16,8,14710.9,7496,22206.9
352760,201703,190,136,54,127432,50598,178030
352770,201703,85,68,17,62780,15929,78709
352780,201703,86,46,40,43102,37480,80582
352790,201703,23,20,3,18740,2811,21551
352800,201703,244,165,79,154605,73741.9,228346.9
352810,201703,158,104,54,96574,50598,147172
352820,201703,61,51,10,47369.1,9370,56739.1
352830,201703,87,61,26,57157,24362,81519
352840,201703,543,280,263,261096.1,246150,507246.1
352850,201703,1292,466,826,435986.1,773560,1209546.1
352860,201703,123,80,43,74960,40291,115251
352870,201703,37,23,14,21551,13118,34669
352880,201703,188,131,57,122747,53409,176156
352885,201703,27,19,8,17803,7496,25299
352890,201703,53,36,17,33732,15648,49380
352900,201703,4909,2360,2549,2195113.73,2382727.51,4577841.24
352910,201703,40,30,10,28110,9370,37480
352920,201703,711,439,272,410406,254864,665270
352930,201703,1242,593,649,553978.85,604583.41,1158562.26
352940,201703,6243,2705,3538,2522893.07,3310376.18,5833269.25
352950,201703,92,38,54,35324.9,50598,85922.9
352960,201703,67,44,23,41228,21551,62779
352965,201703,20,8,12,7496,11244,18740
352970,201703,453,333,120,308871.14,111503.7,420374.84
352980,201703,178,89,89,83393,83393,166786
352990,201703,878,412,466,383359.14,434890.79,818249.93
353000,201703,68,32,36,29984,33732,63716
353010,201703,559,340,219,318580,205184.27,523764.27
353020,201703,297,212,85,198644,79645,278289
353030,201703,1123,521,602,487202.73,563399.73,1050602.46
353040,201703,87,53,34,49661,31858,81519
353050,201703,1265,783,482,728394.55,451634,1180028.55
353060,201703,7256,3440,3816,3210296.28,3568868.57,6779164.85
353070,201703,1590,977,613,909614.3,573114.04,1482728.34
353080,201703,1300,670,630,626149.72,589464.32,1215614.04
353090,201703,59,37,22,34669,20614,55283
353100,201703,63,52,11,48724,10307,59031
353110,201703,1766,589,1177,550188.63,1101154.32,1651342.95
353120,201703,67,33,34,30921,31858,62779
353130,201703,850,415,435,387899.63,407566.89,795466.52
353140,201703,592,229,363,214250,340131,554381
353150,201703,361,199,162,185526.3,151784.63,337310.93
353160,201703,103,83,20,77771,18740,96511
353170,201703,200,66,134,61832.63,125530.63,187363.26
353180,201703,944,437,507,408236.95,474544,882780.95
353190,201703,447,318,129,296927.95,120873,417800.95
353200,201703,182,89,93,83112,87141,170253
353205,201703,26,18,8,16866,7496,24362
353210,201703,82,50,32,46850,29984,76834
353215,201703,58,35,23,32795,21551,54346
353220,201703,79,44,35,41228,31858.93,73086.93
353230,201703,157,59,98,55283,91826,147109
353240,201703,265,145,120,135865,112440,248305
353250,201703,200,105,95,98385,89015,187400
353260,201703,411,309,102,288418.25,95564.63,383982.88
353270,201703,68,51,17,47787,15929,63716
353280,201703,92,46,46,43102,43102,86204
353282,201703,107,79,28,74023,26236,100259
353284,201703,23,18,5,16866,4685,21551
353286,201703,1,1,0,937,0,937
353290,201703,80,48,32,44976,29975,74951
353300,201703,380,214,166,199003.55,155542,354545.55
353310,201703,49,45,4,42165,3748,45913
353320,201703,53,35,18,32795,16866,49661
353325,201703,57,37,20,34669,18441,53110
353330,201703,67,51,16,46992,14992,61984
353340,201703,580,187,393,175219,367669.54,542888.54
353350,201703,892,414,478,387112.92,446914,834026.92
353360,201703,110,87,23,81206.7,21270,102476.7
353370,201703,118,71,47,65590.55,44039,109629.55
353380,201703,29,20,9,18736,8433,27169
353390,201703,1015,493,522,461941,489114,951055
353400,201703,45,26,19,24362,17803,42165
353410,201703,121,74,47,67876.28,43337.1,111213.38
353420,201703,52,23,29,21551,27173,48724
353430,201703,537,348,189,322608.48,176661.9,499270.38
353440,201703,10232,4453,5779,4162580.33,5408150.85,9570731.18
353450,201703,59,30,29,28110,27173,55283
353460,201703,596,314,282,290071.99,262586.25,552658.24
353470,201703,2107,1137,970,1060269.26,907450.82,1967720.08
353475,201703,229,154,75,141659.3,70275,211934.3
353480,201703,190,151,39,141487,36543,178030
353490,201703,226,135,91,126495,85267,211762
353500,201703,179,107,72,99041.3,67464,166505.3
353510,201703,104,75,29,70256.63,27163.63,97420.26
353520,201703,205,143,62,133991,58094,192085
353530,201703,436,235,201,219290,188337,407627
353540,201703,347,229,118,214256.02,110566,324822.02
353550,201703,712,482,230,448542.85,215510,664052.85
353560,201703,624,260,364,242683.6,340483.12,583166.72
353570,201703,60,31,29,29047,27173,56220
353580,201703,356,277,79,259081,74023,333104
353590,201703,79,54,25,50598,23425,74023
353600,201703,256,147,109,137427,102133,239560
353610,201703,113,60,53,56220,49661,105881
353620,201703,532,289,243,269146.25,227409.9,496556.15
353625,201703,52,24,28,22488,26236,48724
353630,201703,235,169,66,154100.07,61842,215942.07
353640,201703,121,82,39,75897.5,36543,112440.5
353650,201703,794,319,475,297310.1,445075,742385.1
353657,201703,20,14,6,13118,5622,18740
353660,201703,256,144,112,134928,104662.9,239590.9
353670,201703,674,401,273,374800,255801,630601
353680,201703,100,72,28,67464,26236,93700
353690,201703,45,36,9,33732,8433,42165
353700,201703,292,205,87,192085,81519,273604
353710,201703,398,188,210,175219.4,196770,371989.4
353715,201703,44,37,7,34387.9,6559,40946.9
353720,201703,357,159,198,148965,185497,334462
353730,201703,1101,677,424,631211.45,397006.9,1028218.35
353740,201703,636,364,272,340505.9,254864,595369.9
353750,201703,100,62,38,57571.62,35606,93177.62
353760,201703,2554,958,1596,894343.2,1491631.37,2385974.57
353770,201703,100,82,18,76365.5,16866,93231.5
353780,201703,1038,533,505,496742.3,471638.95,968381.25
353790,201703,499,286,213,266698.85,199461,466159.85
353800,201703,3234,1665,1569,1551403.46,1466750.08,3018153.54
353810,201703,233,128,105,119097.75,98358,217455.75
353820,201703,178,88,90,82456,83716.54,166172.54
353830,201703,45,38,7,35606,6559,42165
353850,201703,163,87,76,81519,71212,152731
353860,201703,461,202,259,187915.35,242155.47,430070.82
353870,201703,4853,2414,2439,2250226.3,2276480.48,4526706.78
353880,201703,631,444,187,414576.2,174282.36,588858.56
353890,201703,569,307,262,287097,245494,532591
353900,201703,140,67,73,62779,68401,131180
353910,201703,184,87,97,81519,90889,172408
353920,201703,450,245,205,228394.7,192071.64,420466.34
353930,201703,955,573,382,533996.3,356768.9,890765.2
353940,201703,187,103,84,95761.4,77865,173626.4
353950,201703,518,322,196,301704.63,183652,485356.63
353960,201703,69,55,14,51535,13118,64653
353970,201703,71,45,26,42165,24362,66527
353980,201703,1482,729,753,680466.59,705553,1386019.59
353990,201703,76,43,33,40291,30921,71212
354000,201703,369,170,199,157286.36,186271.6,343557.96
354010,201703,100,51,49,47787,45913,93700
354020,201703,531,333,198,311084,185244.9,496328.9
354025,201703,53,44,9,41228,8433,49661
354030,201703,61,31,30,29047,28110,57157
354040,201703,92,66,26,61842,24362,86204
354050,201703,175,102,73,95293,68401,163694
354060,201703,766,377,389,353249,362620.65,715869.65
354070,201703,848,482,366,449506.52,342942,792448.52
354075,201703,194,106,88,99229,81519.9,180748.9
354080,201703,277,121,156,113377,146172,259549
354085,201703,18,11,7,10307,6559,16866
354090,201703,321,176,145,164833,135865,300698
354100,201703,5363,2202,3161,2053155.07,2957351.55,5010506.62
354105,201703,79,40,39,37480,36543,74023
354110,201703,45,21,24,19677,22488,42165
354120,201703,144,101,43,94500.29,40291,134791.29
354130,201703,666,448,218,419542,203985,623527
354140,201703,3134,1462,1672,1366275.42,1565619.62,2931895.04
354150,201703,610,381,229,355779,213167.5,568946.5
354160,201703,653,398,255,371754.75,238654,610408.75
354165,201703,18,12,6,11244,5622,16866
354170,201703,171,116,55,108036.1,51535,159571.1
354180,201703,67,41,26,38097,24362,62459
354190,201703,201,92,109,84611.1,102133,186744.1
354200,201703,128,70,58,65122,54346,119468
354210,201703,75,38,37,35606,34669,70275
354220,201703,633,403,230,376674.1,214573.18,591247.28
354230,201703,154,64,90,59968,83393.8,143361.8
354240,201703,318,206,112,191804.69,104319.3,296123.99
354250,201703,87,49,38,45913,35606,81519
354260,201703,1851,861,990,794716.46,925376,1720092.46
354270,201703,98,73,25,68401,23425,91826
354280,201703,30,16,14,14992,13118,28110
354290,201703,149,102,47,94309.55,44039,138348.55
354300,201703,420,288,132,269544,123684,393228
354310,201703,98,71,27,65590.1,25299,90889.1
354320,201703,185,95,90,89015,84330,173345
354323,201703,13,11,2,10307,1874,12181
354325,201703,113,61,52,57157,48724,105881
354330,201703,2448,843,1605,785504.24,1501756.69,2287260.93
354340,201703,10603,5101,5502,4762751.62,5151259.42,9914011.04
354350,201703,126,85,41,79645,38276.45,117921.45
354360,201703,87,45,42,42165,39354,81519
354370,201703,261,137,124,128369,116188,244557
354380,201703,204,119,85,110729,79645,190374
354390,201703,2728,981,1747,918897.96,1634841.72,2553739.68
354400,201703,321,164,157,152591.9,145984.7,298576.6
354410,201703,589,286,303,267041.32,282974.1,550015.42
354420,201703,259,167,92,156479,86204,242683
354425,201703,307,175,132,163975,123019.1,286994.1
354430,201703,191,126,65,115738.95,60155.4,175894.35
354440,201703,45,32,13,29866,12181,42047
354450,201703,43,28,15,26236,14055,40291
354460,201703,91,54,37,50598,34669,85267
354470,201703,37,27,10,25299,9370,34669
354480,201703,114,61,53,57148,49651.63,106799.63
354490,201703,144,90,54,84173.81,50598,134771.81
354500,201703,399,196,203,183652,190211,373863
354510,201703,108,74,34,69234.56,31858,101092.56
354515,201703,39,16,23,14992,21551,36543
354520,201703,1542,689,853,643085.6,798923.68,1442009.28
354530,201703,593,315,278,292808.5,259643.1,552451.6
354540,201703,273,149,124,139613,116183.32,255796.32
354550,201703,44,26,18,24362,16866,41228
354560,201703,156,88,68,82456,63706.63,146162.63
354570,201703,145,97,48,90889,44976,135865
354580,201703,1974,948,1026,884527.7,961072.22,1845599.92
354600,201703,284,155,129,143811.36,120868.32,264679.68
354610,201703,73,64,9,59968,8433,68401
354620,201703,64,18,46,16866,43102,59968
354625,201703,19,12,7,11244,6555,17799
354630,201703,340,221,119,207068,111503,318571
354640,201703,786,506,280,470266.5,262360,732626.5
354650,201703,72,36,36,33723,33695.26,67418.26
354660,201703,785,570,215,530607.85,201455,732062.85
354670,201703,285,99,186,92763,173239,266002
354680,201703,1211,457,754,428209,706030,1134239
354690,201703,89,60,29,55284,27173,82457
354700,201703,80,55,25,51535,23425,74960
354710,201703,52,36,16,33107.3,14992,48099.3
354720,201703,22,21,1,19677,937,20614
354730,201703,1914,812,1102,757946.5,1031387.1,1789333.6
354740,201703,55,39,16,36543,14992,51535
354750,201703,424,254,170,237989,159290,397279
354760,201703,495,303,192,282975,179623,462598
354765,201703,11,5,6,4685,5622,10307
354770,201703,311,220,91,205049.71,85267,290316.71
354780,201703,8037,3266,4771,3045696.48,4465673.45,7511369.93
354790,201703,119,68,51,63716,47787,111503
354800,201703,397,222,175,208014,163694,371708
354805,201703,103,51,52,47163,48724,95887
354810,201703,140,81,59,75615.9,55283,130898.9
354820,201703,177,76,101,71006,94637,165643
354830,201703,36,21,15,19677,14055,33732
354840,201703,52,33,19,30921,17803,48724
354850,201703,4544,2000,2544,1867485.47,2378875.86,4246361.33
354860,201703,332,162,170,151794,157229.3,309023.3
354870,201703,11271,5152,6119,4801638.18,5725675.98,10527314.16
354880,201703,2917,1074,1843,1002949.55,1725046.96,2727996.51
354890,201703,2787,1537,1250,1435217.12,1169835.24,2605052.36
354900,201703,59,39,20,36543,18740,55283
354910,201703,1144,605,539,564974.22,505043,1070017.22
354920,201703,54,46,8,43102,7496,50598
354925,201703,11,6,5,5622,4685,10307
354930,201703,32,28,4,25970,3748,29718
354940,201703,796,579,217,540183.84,203329,743512.84
354950,201703,232,149,83,139011,77771,216782
354960,201703,172,66,106,61842,99041,160883
354970,201703,804,513,291,476844.09,272039.31,748883.40
354980,201703,8161,3047,5114,2847732.67,4790004.35,7637737.02
354990,201703,8941,4210,4731,3934626.4,4426080.87,8360707.27
354995,201703,524,187,337,175219,315178.69,490397.69
355000,201703,451,147,304,137734.32,283724,421458.32
355010,201703,626,404,222,377611.45,205841.36,583452.81
355020,201703,713,447,266,416956.22,249234,666190.22
355030,201703,199025,76667,122358,71629798.86,114544494.9,186174293.76
355040,201703,691,327,364,306118,340880.6,646998.6
355050,201703,151,103,48,94981.77,44976,139957.77
355060,201703,1295,686,609,637740.87,568806.25,1206547.12
355070,201703,1441,702,739,654950.44,691362.55,1346312.99
355080,201703,200,117,83,109421.74,76899.9,186321.64
355090,201703,270,182,88,168474,82456,250930
355100,201703,4644,2344,2300,2177983.2,2152451.57,4330434.77
355110,201703,292,191,101,177234.55,94637,271871.55
355120,201703,116,85,31,79176.5,28673,107849.5
355130,201703,47,25,22,23425,20614,44039
355140,201703,184,120,64,112440,59968,172408
355150,201703,682,405,277,378263.1,259549,637812.1
355160,201703,419,189,230,174750.8,215510,390260.8
355170,201703,2003,1036,967,969374.87,905405.86,1874780.73
355180,201703,608,249,359,232094.9,335282.02,567376.92
355190,201703,210,143,67,133991,62779,196770
355200,201703,111,63,48,59031,44976,104007
355210,201703,669,386,283,361682,265143.63,626825.63
355220,201703,6303,3390,2913,3167401.78,2721516.72,5888918.50
355230,201703,106,64,42,59968,38787.12,98755.12
355240,201703,3996,1776,2220,1653152.95,2076137.38,3729290.33
355250,201703,5195,2518,2677,2352528.51,2505663.51,4858192.02
355255,201703,50,29,21,27173,19677,46850
355260,201703,182,109,73,102104.89,68383,170487.89
355270,201703,164,95,69,89015,63951,152966
355280,201703,5971,2545,3426,2380357.5,3205024.07,5585381.57
355290,201703,78,58,20,54346,18740,73086
355300,201703,173,118,55,110238.05,51535,161773.05
355310,201703,105,59,46,55283,43102,98385
355320,201703,94,48,46,44694.9,42406.3,87101.2
355330,201703,264,144,120,134928,112440,247368
355340,201703,1181,521,660,486022.58,617691.2,1103713.78
355350,201703,135,70,65,65590,60905,126495
355360,201703,167,99,68,92556.86,63716,156272.86
355365,201703,26,21,5,19677,4685,24362
355370,201703,1028,576,452,534902.96,421810.23,956713.19
355380,201703,747,510,237,476470.8,221788,698258.8
355385,201703,50,35,15,32795,14055,46850
355390,201703,104,58,46,54346,43102,97448
355395,201703,186,113,73,105080.32,68401,173481.32
355400,201703,1485,928,557,866545.68,520409.9,1386955.58
355410,201703,4752,2212,2540,2057690.28,2370254.02,4427944.30
355420,201703,43,33,10,30921,9370,40291
355430,201703,325,202,123,188618.1,115251,303869.1
355440,201703,76,43,33,40291,30921,71212
355450,201703,414,192,222,175595.32,206421.3,382016.62
355460,201703,70,54,16,49661.51,14992,64653.51
355465,201703,50,32,18,29984,16866,46850
355470,201703,184,69,115,63716.55,107755,171471.55
355475,201703,10,7,3,6559,2811,9370
355480,201703,443,190,253,176906,235177.63,412083.63
355490,201703,108,80,28,74960,26236,101196
355495,201703,52,25,27,23425,25299,48724
355500,201703,1688,951,737,886578.14,689967.86,1576546.00
355510,201703,264,196,68,180255.5,63716,243971.5
355520,201703,36,28,8,26236,7496,33732
355530,201703,21,14,7,13118,6559,19677
355535,201703,75,33,42,30921,39354,70275
355540,201703,2276,908,1368,849231.31,1280860.63,2130091.94
355550,201703,66,40,26,37480,24362,61842
355560,201703,229,119,110,111503,102445.3,213948.3
355570,201703,29,18,11,16866,10307,27173
355580,201703,271,182,89,170534,83388.32,253922.32
355590,201703,22,14,8,13118,7496,20614
355600,201703,278,145,133,135865,124335.32,260200.32
355610,201703,198,131,67,122747,62779,185526
355620,201703,1201,547,654,510805.9,612231.8,1123037.7
355630,201703,404,283,121,264235,113377,377612
355635,201703,126,60,66,56220,61829,118049
355640,201703,572,331,241,309210,225817,535027
355645,201703,819,353,466,329099.64,434796.21,763895.85
355650,201703,1891,871,1020,814601,955721.63,1770322.63
355660,201703,269,141,128,132117,119931.32,252048.32
355670,201703,450,163,287,152731,268638,421369
355680,201703,211,116,95,108692,89015,197707
355690,201703,82,39,43,36543,39953,76496
355695,201703,14,12,2,11244,1874,13118
355700,201703,1082,583,499,540712.71,467282,1007994.71
355710,201703,2126,1171,955,1092341.68,894245,1986586.68
355715,201703,19,17,2,15929,1874,17803
355720,201703,204,125,79,115563.66,74019,189582.66
355730,201703,82,51,31,46928.53,29047,75975.53
410010,201703,124,104,20,97448,18740,116188
410020,201703,101,90,11,84330,10307,94637
410030,201703,158,102,56,95293,52472,147765
410040,201703,977,516,461,482976.65,431488.9,914465.55
410045,201703,34,29,5,27173,4685,31858
410050,201703,465,261,204,244557,190398.5,434955.5
410060,201703,255,200,55,186838,51535,238373
410070,201703,332,265,67,248305,62779,311084
410080,201703,164,109,55,102133,51535,153668
410090,201703,71,63,8,58825,7496,66321
410100,201703,290,204,86,191148,80582,271730
410105,201703,37,24,13,22488,12181,34669
410110,201703,305,183,122,171204,114314,285518
410115,201703,27,18,9,16866,8433,25299
410120,201703,440,223,217,208654.9,203329,411983.9
410130,201703,39,25,14,23425,13118,36543
410140,201703,2955,1439,1516,1343194.63,1419545.63,2762740.26
410150,201703,2653,1061,1592,993473,1491211.5,2484684.5
410160,201703,487,313,174,292999.9,163038,456037.9
410165,201703,65,41,24,38417,22488,60905
410170,201703,163,127,36,116803.83,33732,150535.83
410180,201703,2018,1155,863,1078319.28,807293.08,1885612.36
410185,201703,43,39,4,36543,3748,40291
410190,201703,396,240,156,224880,146172,371052
410200,201703,951,715,236,668150.78,221132,889282.78
410210,201703,540,275,265,257675,247743,505418
410220,201703,37,21,16,19677,14992,34669
410230,201703,121,72,49,67464,45913,113377
410240,201703,701,456,245,426709.9,229565,656274.9
410250,201703,381,284,97,265514.6,90868.89,356383.49
410260,201703,309,167,142,156479,133054,289533
410270,201703,30,20,10,18740,9370,28110
410275,201703,72,54,18,50598,16866,67464
410280,201703,301,167,134,156040.57,125558,281598.57
410290,201703,212,145,67,135001.81,62337.02,197338.83
410300,201703,81,65,16,60905,14992,75897
410302,201703,24,15,9,14055,8433,22488
410304,201703,49,33,16,30921,14992,45913
410305,201703,183,98,85,91034,79640.32,170674.32
410310,201703,259,168,91,157416,85267,242683
410315,201703,60,44,16,41204,14992,56196
410320,201703,133,86,47,80582,44039,124621
410322,201703,34,23,11,21551,10307,31858
410330,201703,192,136,56,127432,52472,179904
410335,201703,105,66,39,61842,36543,98385
410337,201703,30,26,4,24362,3748,28110
410340,201703,31,30,1,28110,937,29047
410345,201703,200,127,73,118258.77,68401,186659.77
410347,201703,53,41,12,38417,11244,49661
410350,201703,231,143,88,133991,82456,216447
410360,201703,445,269,176,250492.1,164631,415123.1
410370,201703,2262,922,1340,859773.73,1252751.11,2112524.84
410380,201703,227,150,77,140550,72149,212699
410390,201703,358,273,85,255797,79645,335442
410395,201703,35,24,11,22488,9933,32421
410400,201703,797,406,391,379116.1,365838,744954.1
410405,201703,84,62,22,58094,20614,78708
410410,201703,46,35,11,32795,10307,43102
410420,201703,1621,809,812,756260.6,759126.3,1515386.9
410425,201703,173,85,88,79458,82456,161914
410430,201703,2147,1257,890,1175372.9,831981.16,2007354.06
410440,201703,400,282,118,263298,110566,373864
410442,201703,358,238,120,222070,112440,334510
410445,201703,414,284,130,266108,121810,387918
410450,201703,396,198,198,185526,185526,371052
410460,201703,391,215,176,201173.9,164912,366085.9
410465,201703,192,122,70,114032.9,65590,179622.9
410470,201703,212,131,81,122747,75897,198644
410480,201703,5500,2719,2781,2533642.8,2600643.21,5134286.01
410490,201703,1334,883,451,825920,420433,1246353
410500,201703,252,144,108,134928,101196,236124
410510,201703,181,127,54,118999,49964.3,168963.3
410520,201703,290,214,76,200518,71212,271730
410530,201703,221,82,139,76834,130074.41,206908.41
410540,201703,316,228,88,213065.8,82451.32,295517.12
410550,201703,1545,677,868,632988.09,812749.12,1445737.21
410560,201703,144,110,34,103070,31858,134928
410570,201703,435,304,131,283124.95,122747,405871.95
410580,201703,3075,1386,1689,1295692.36,1581188,2876880.36
410590,201703,394,276,118,258612,110566,369178
410600,201703,167,148,19,138676,17803,156479
410610,201703,50,41,9,38417,8433,46850
410620,201703,228,164,64,153668,59968,213636
410630,201703,440,258,182,241746,169395,411141
410640,201703,920,562,358,524414.44,334805.53,859219.97
410645,201703,99,72,27,67070,25299,92369
410650,201703,353,238,115,222069,107755,329824
410655,201703,75,60,15,56220,14055,70275
410657,201703,41,17,24,15929,22488,38417
410660,201703,567,401,166,374083,155542,529625
410670,201703,74,60,14,56220,13118,69338
410680,201703,193,157,36,147109,32774.99,179883.99
410685,201703,21,16,5,14992,4685,19677
410690,201703,28405,12227,16178,11438822.07,15148582.2,26587404.27
410700,201703,306,227,79,212137,74023,286160
410710,201703,132,107,25,100259,23425,123684
410712,201703,17,10,7,9370,6559,15929
410715,201703,88,65,23,60905,21551,82456
410720,201703,580,356,224,333572,209879,543451
410725,201703,174,127,47,118999,44039,163038
410730,201703,90,58,32,54346,29984,84330
410740,201703,111,84,27,78708,25299,104007
410750,201703,209,158,51,148046,47787,195833
410752,201703,20,14,6,13118,5622,18740
410753,201703,50,22,28,19953.41,26236,46189.41
410754,201703,48,32,16,29984,14992,44976
410755,201703,82,56,26,52190.9,24362,76552.9
410760,201703,657,373,284,349501,265640,615141
410765,201703,1584,767,817,712866.94,764652.63,1477519.57
410770,201703,105,89,16,83393,14992,98385
410773,201703,48,35,13,32795,12181,44976
410775,201703,174,128,46,119280.1,43102,162382.1
410780,201703,81,42,39,39354,36543,75897
410785,201703,72,54,18,50411,16866,67277
410790,201703,68,35,33,32795,30921,63716
410800,201703,296,187,109,174283,102133,276416
410810,201703,36,28,8,26236,7215,33451
410820,201703,176,131,45,122747,42165,164912
410830,201703,8461,3860,4601,3607841.46,4309371.82,7917213.28
410832,201703,104,74,30,69056.9,28110,97166.9
410840,201703,1339,745,594,695568.99,556448.67,1252017.66
410845,201703,57,35,22,32795,20614,53409
410850,201703,188,130,58,121489,54346,175835
410855,201703,37,34,3,31858,2811,34669
410860,201703,661,383,278,358099.75,260486,618585.75
410865,201703,106,79,27,74023,25299,99322
410870,201703,144,125,19,117125,17516,134641
410880,201703,1070,525,545,491571.93,510611,1002182.93
410890,201703,75,57,18,53409,16866,70275
410895,201703,64,46,18,43102,16866,59968
410900,201703,41,32,9,29984,8433,38417
410910,201703,24,21,3,19677,2811,22488
410920,201703,51,26,25,24362,23425,47787
410930,201703,501,315,186,294947.74,174000.9,468948.64
410940,201703,4233,2543,1690,2373913.57,1581695,3955608.57
410950,201703,124,86,38,80582,35606,116188
410960,201703,737,327,410,306118,384170,690288
410965,201703,62,49,13,45913,12181,58094
410970,201703,611,432,179,404328.1,167723,572051.1
410975,201703,107,71,36,66166,33732,99898
410980,201703,1469,658,811,615328.8,759898.32,1375227.12
410990,201703,256,171,85,160061.25,79363.9,239425.15
411000,201703,60,41,19,38417,17803,56220
411005,201703,17,13,4,12181,3748,15929
411007,201703,233,136,97,127432,90889,218321
411010,201703,570,404,166,378323,155542,533865
411020,201703,276,189,87,177093,81519,258612
411030,201703,24,15,9,14055,8433,22488
411040,201703,48,33,15,30921,14055,44976
411050,201703,223,179,44,166274.17,41101.12,207375.29
411060,201703,501,341,160,319508,149920,469428
411065,201703,61,55,6,51413.19,5622,57035.19
411070,201703,1146,763,383,710996,358590,1069586
411080,201703,239,172,67,161247,61992.66,223239.66
411090,201703,109,79,30,74023,28110,102133
411095,201703,254,104,150,96980,140540,237520
411100,201703,108,88,20,82456,18740,101196
411110,201703,127,87,40,81519,37480,118999
411120,201703,170,131,39,122747,36543,159290
411125,201703,155,73,82,68401,76834,145235
411130,201703,113,97,16,90263,14992,105255
411140,201703,173,119,54,111179.9,50082.65,161262.55
411150,201703,1166,776,390,727102.63,365430,1092532.63
411155,201703,119,82,37,76834,34669,111503
411160,201703,20,9,11,8433,10307,18740
411170,201703,59,51,8,47505.9,7496,55001.9
411180,201703,903,594,309,554423.33,289528.32,843951.65
411190,201703,285,166,119,154886.1,111503,266389.1
411200,201703,656,436,220,407001.99,205530.95,612532.94
411210,201703,657,354,303,330175.83,283911,614086.83
411220,201703,148,112,36,104944,33732,138676
411230,201703,51,45,6,42165,5622,47787
411240,201703,126,88,38,82456,35606,118062
411250,201703,403,290,113,271730,105881,377611
411260,201703,21,15,6,14055,5622,19677
411270,201703,287,160,127,149920,118999,268919
411275,201703,199,175,24,163835,22488,186323
411280,201703,218,151,67,140238.36,62779,203017.36
411290,201703,59,42,17,39354,15929,55283
411295,201703,144,116,28,108692,26236,134928
411300,201703,80,44,36,41228,33732,74960
411310,201703,91,68,23,63716,21551,85267
411320,201703,717,523,194,488974.9,180204.24,669179.14
411325,201703,46,26,20,24362,18740,43102
411330,201703,886,564,322,527464.25,300870.8,828335.05
411340,201703,26,17,9,15929,8124,24053
411342,201703,84,59,25,55283,23425,78708
411345,201703,119,59,60,55283,56211,111494
411350,201703,467,384,83,358824.92,77480.63,436305.55
411360,201703,50,30,20,28110,18740,46850
411370,201703,13628,5576,8052,5209352.69,7531402.02,12740754.71
411373,201703,206,152,54,142424,50598,193022
411375,201703,84,68,16,63716,14992,78708
411380,201703,102,74,28,68401.89,26236,94637.89
411390,201703,140,90,50,84330,46850,131180
411400,201703,345,257,88,240809,82456,323265
411410,201703,440,223,217,207592.35,203048,410640.35
411420,201703,1008,461,547,429708.2,512070.6,941778.8
411430,201703,396,254,142,237342.1,133045,370387.1
411435,201703,40,29,11,27173,10307,37480
411440,201703,465,370,95,345067.17,89015,434082.17
411450,201703,435,353,82,330761,76834,407595
411460,201703,708,282,426,263241.64,397861.4,661103.04
411470,201703,126,91,35,85267,32795,118062
411480,201703,612,349,263,325514.8,246149.9,571664.7
411490,201703,289,177,112,165849,104944,270793
411500,201703,104,90,14,84330,12462.9,96792.9
411510,201703,216,176,40,163552.69,37480,201032.69
411520,201703,5804,2272,3532,2124383.44,3302369.52,5426752.96
411530,201703,111,72,39,67464,36543,104007
411535,201703,53,20,33,18740,30921,49661
411540,201703,312,213,99,198761.6,92763,291524.6
411545,201703,74,52,22,48724,20614,69338
411550,201703,71,55,16,51535,14992,66527
411560,201703,360,166,194,154914.21,181778,336692.21
411570,201703,765,291,474,272386,443951,716337
411573,201703,35,22,13,20614,12181,32795
411575,201703,251,152,99,142424,92763,235187
411580,201703,1200,469,731,438484.8,683955,1122439.8
411585,201703,70,35,35,32795,32795,65590
411590,201703,24,18,6,16866,5622,22488
411600,201703,46,25,21,23425,19677,43102
411605,201703,227,105,122,98225,114314,212539
411610,201703,233,159,74,148983,69338,218321
411620,201703,340,187,153,175031.6,143361,318392.6
411630,201703,55,36,19,33732,17803,51535
411640,201703,37,29,8,27173,7496,34669
411650,201703,14,11,3,10307,2811,13118
411660,201703,40,34,6,31858,5622,37480
411670,201703,253,193,60,179829.81,56200,236029.81
411680,201703,159,138,21,129306,19677,148983
411690,201703,593,330,263,308593.08,246048.6,554641.68
411695,201703,64,49,15,45913,14055,59968
411700,201703,170,145,25,135865,23425,159290
411705,201703,105,67,38,62779,35606,98385
411710,201703,294,192,102,178938.1,95574,274512.1
411720,201703,133,84,49,78708,45913,124621
411721,201703,71,57,14,53409,13118,66527
411722,201703,94,41,53,38417,49661,88078
411725,201703,141,112,29,104663,27173,131836
411727,201703,82,68,14,63716,12836.9,76552.9
411729,201703,34,25,9,23425,8433,31858
411730,201703,535,345,190,321586.39,178030,499616.39
411740,201703,28,21,7,19677,6559,26236
411745,201703,71,49,22,45136,20614,65750
411750,201703,818,404,414,377190.9,386958.36,764149.26
411760,201703,1177,885,292,827737.04,273595,1101332.04
411770,201703,398,276,122,258612,114314,372926
411780,201703,354,230,124,214573.84,116188,330761.84
411790,201703,508,279,229,260501.17,214461.67,474962.84
411800,201703,171,134,37,125558,34669,160227
411810,201703,149,112,37,104944,34669,139613
411820,201703,2077,1019,1058,952873.5,990943.86,1943817.36
411830,201703,9,9,0,8433,0,8433
411840,201703,1882,1165,717,1090929.6,671341,1762270.6
411845,201703,49,16,33,14992,30921,45913
411850,201703,1205,706,499,658130.74,465644.81,1123775.55
411860,201703,45,30,15,27829,14055,41884
411870,201703,50,41,9,38417,8433,46850
411880,201703,414,272,142,254610,132323.14,386933.14
411885,201703,105,68,37,63716,34669,98385
411890,201703,325,198,127,185526,118990,304516
411900,201703,73,53,20,49661,18740,68401
411910,201703,166,137,29,128359.63,26236,154595.63
411915,201703,1986,857,1129,801877.11,1057102.93,1858980.04
411920,201703,122,104,18,97448,16866,114314
411925,201703,18,12,6,11244,5622,16866
411930,201703,789,579,210,540651,196770,737421
411940,201703,575,414,161,387918,150832.56,538750.56
411950,201703,855,460,395,431010.63,369802.7,800813.33
411960,201703,936,674,262,629207,245494,874701
411965,201703,28,19,9,17803,8433,26236
411970,201703,75,67,8,62779,7496,70275
411980,201703,195,127,68,118999,63716,182715
411990,201703,4658,2748,1910,2557926.64,1787366.5,4345293.14
411995,201703,445,170,275,159290,257675,416965
412000,201703,269,152,117,141722.56,109629,251351.56
412010,201703,43,27,16,25299,14992,40291
412015,201703,42,31,11,29047,10307,39354
412020,201703,30,26,4,24080.9,3748,27828.9
412030,201703,63,53,10,49661,9370,59031
412033,201703,49,32,17,29960,15929,45889
412035,201703,87,55,32,51535,29984,81519
412040,201703,33,24,9,22207,8433,30640
412050,201703,198,145,53,135865,49661,185526
412060,201703,742,588,154,548145.88,144298,692443.88
412065,201703,43,32,11,29984,10307,40291
412070,201703,149,100,49,93044.1,45913,138957.1
412080,201703,267,134,133,125558,124621,250179
412085,201703,29,13,16,12181,14992,27173
412090,201703,698,429,269,400053.1,252053,652106.1
412100,201703,239,198,41,184590,38229.6,222819.6
412110,201703,74,58,16,54346,14992,69338
412120,201703,309,202,107,188711.8,100259,288970.8
412125,201703,91,50,41,46568.9,38417,84985.9
412130,201703,52,35,17,32795,15929,48724
412135,201703,26,13,13,12181,12181,24362
412140,201703,282,211,71,197707,66527,264234
412150,201703,253,170,83,158596.62,77771,236367.62
412160,201703,97,60,37,56211,34669,90880
412170,201703,610,445,165,416965,154605,571570
412175,201703,45,35,10,32795,9370,42165
412180,201703,188,149,39,139024.29,36543,175567.29
412190,201703,322,261,61,243896.41,57157,301053.41
412200,201703,186,121,65,113377,60905,174282
412210,201703,95,75,20,70275,18740,89015
412215,201703,228,156,72,146172,67464,213636
412217,201703,88,69,19,64653,17803,82456
412220,201703,768,585,183,548145,171471,719616
412230,201703,331,208,123,192701.67,114871.75,307573.42
412240,201703,1274,618,656,575116.79,611560.15,1186676.94
412250,201703,380,241,139,225817,129306.92,355123.92
412260,201703,122,90,32,84330,29984,114314
412265,201703,162,129,33,120873,30921,151794
412270,201703,83,46,37,43102,34669,77771
412280,201703,87,68,19,63716,17803,81519
412290,201703,103,64,39,59733.75,36543,96276.75
412300,201703,221,143,78,133991,73086,207077
412310,201703,45,38,7,35606,6559,42165
412320,201703,94,79,15,74023,14055,88078
412330,201703,159,143,16,133991,14992,148983
412340,201703,137,92,45,86204,41884,128088
412350,201703,563,271,292,252943.15,273417,526360.15
412360,201703,26,23,3,21551,2811,24362
412370,201703,159,132,27,122747,25299,148046
412380,201703,257,188,69,176156,64644,240800
412382,201703,52,28,24,26236,22488,48724
412385,201703,144,98,46,91826,43102,134928
412390,201703,262,197,65,184589,60905,245494
412395,201703,62,50,12,46850,11244,58094
412400,201703,67,47,20,44039,18740,62779
412402,201703,233,106,127,99317.32,118717.9,218035.22
412405,201703,793,318,475,296535.01,444592.96,741127.97
412410,201703,909,561,348,524158,326076,850234
412420,201703,17,12,5,11244,4685,15929
412430,201703,21,16,5,14992,4685,19677
412440,201703,569,311,258,288452.19,240073.28,528525.47
412450,201703,80,68,12,63716,11244,74960
412460,201703,80,63,17,59031,15929,74960
412470,201703,261,212,49,198644,45913,244557
412480,201703,176,132,44,123684,41228,164912
412490,201703,157,133,24,124621,22488,147109
412500,201703,475,383,92,357653.3,86204,443857.3
412510,201703,191,153,38,142283,35606,177889
412520,201703,127,71,56,66527,52472,118999
412530,201703,106,58,48,54346,44413.9,98759.9
412535,201703,111,82,29,76816,27164,103980
412540,201703,66,32,34,29984,31858,61842
412545,201703,97,71,26,66059,24362,90421
412550,201703,3353,1542,1811,1441474.82,1695689.45,3137164.27
412555,201703,16,12,4,11244,3748,14992
412560,201703,566,429,137,401318,128369,529687
412570,201703,734,414,320,387318.32,299559,686877.32
412575,201703,94,66,28,61842,26236,88078
412580,201703,150,103,47,96511,44039,140550
412590,201703,32,30,2,28110,1874,29984
412600,201703,170,131,39,122747,36543,159290
412610,201703,35,22,13,20614,11376,31990
412620,201703,153,134,19,125558,17803,143361
412625,201703,2148,1144,1004,1070159.76,939184.72,2009344.48
412627,201703,70,57,13,53409,12181,65590
412630,201703,436,290,146,271539,136802,408341
412635,201703,63,21,42,19677,39354,59031
412640,201703,113,77,36,72149,33732,105881
412650,201703,320,204,116,191148,108687.32,299835.32
412660,201703,472,281,191,262595,178967,441562
412665,201703,48,42,6,39354,5622,44976
412667,201703,315,208,107,194291.6,99895.04,294186.64
412670,201703,64,55,9,51535,8433,59968
412680,201703,277,222,55,208014,51535,259549
412690,201703,111,73,38,68401,35325,103726
412700,201703,165,113,52,105881,48443,154324
412710,201703,1375,857,518,796171.8,481992.9,1278164.7
412720,201703,224,154,70,144298,65590,209888
412730,201703,199,149,50,139613,45913,185526
412740,201703,401,215,186,201314.45,174282,375596.45
412750,201703,452,258,194,240809,181778,422587
412760,201703,237,122,115,114314,107755,222069
412770,201703,1971,1123,848,1047369.12,794268,1841637.12
412780,201703,146,118,28,110433.88,26236,136669.88
412785,201703,266,135,131,126026.5,122747,248773.5
412788,201703,33,18,15,16866,14055,30921
412790,201703,132,110,22,102414.1,20614,123028.1
412795,201703,162,120,42,112440,39354,151794
412796,201703,299,204,95,190004.83,88883.82,278888.65
412800,201703,528,348,180,325535.73,168651,494186.73
412810,201703,2887,1596,1291,1491872.69,1208444.22,2700316.91
412820,201703,897,593,304,542836.78,282234.82,825071.60
412830,201703,18,14,4,13118,3748,16866
412840,201703,213,151,62,140550.1,58094,198644.1
412850,201703,766,526,240,490988,224880,715868
412853,201703,176,98,78,91826,73086,164912
412855,201703,228,121,107,112003.21,100259,212262.21
412860,201703,92,70,22,65590,20614,86204
412862,201703,62,46,16,42821,14992,57813
412863,201703,15,11,4,10307,3748,14055
412865,201703,41,31,10,29047,9370,38417
412870,201703,109,69,40,64653,37480,102133
412880,201703,123,97,26,90889,24362,115251
420005,201703,34,30,4,28110,3186,31296
420010,201703,361,241,120,225021,111494,336515
420020,201703,69,58,11,54346,10307,64653
420030,201703,29,26,3,24362,2811,27173
420040,201703,106,81,25,75897,23425,99322
420050,201703,55,33,22,30539.9,20453.34,50993.24
420055,201703,20,19,1,17782,937,18719
420060,201703,34,26,8,24362,7496,31858
420070,201703,97,83,14,77771,13108.63,90879.63
420075,201703,10,8,2,7496,1874,9370
420080,201703,46,41,5,37526.85,4685,42211.85
420090,201703,36,33,3,30157.34,2811,32968.34
420100,201703,148,125,23,115533.1,21551,137084.1
420110,201703,17,17,0,15929,0,15929
420120,201703,43,33,10,30921,9370,40291
420125,201703,81,65,16,60905,14992,75897
420127,201703,32,29,3,27173,2811,29984
420130,201703,356,225,131,210534.63,122737.63,333272.26
420140,201703,1170,682,488,637788.53,457192,1094980.53
420150,201703,45,38,7,35606,6559,42165
420160,201703,42,39,3,36543,2811,39354
420165,201703,16,12,4,11244,3748,14992
420170,201703,65,41,24,38417,22488,60905
420180,201703,26,25,1,23425,937,24362
420190,201703,32,29,3,27173,2811,29984
420195,201703,122,59,63,55283,59031,114314
420200,201703,1262,560,702,519102.1,657120.52,1176222.62
420205,201703,64,30,34,28110,31858,59968
420207,201703,96,57,39,53409,36533.63,89942.63
420208,201703,26,21,5,19677,3841.7,23518.7
420209,201703,17,13,4,12181,3748,15929
420210,201703,448,205,243,191803.9,227607.04,419410.94
420213,201703,50,39,11,36543,10307,46850
420215,201703,23,20,3,18740,2811,21551
420220,201703,72,48,24,44976,22488,67464
420230,201703,690,402,288,375457,269846.63,645303.63
420240,201703,2191,1490,701,1388090.91,656333.86,2044424.77
420243,201703,27,23,4,21551,3748,25299
420245,201703,77,43,34,40291,31858,72149
420250,201703,49,29,20,27173,18740,45913
420253,201703,39,32,7,29984,6559,36543
420257,201703,10,9,1,8433,937,9370
420260,201703,94,83,11,77771,10307,88078
420270,201703,33,28,5,26231.32,4685,30916.32
420280,201703,270,198,72,184453.84,66389.26,250843.10
420285,201703,20,13,7,12181,6559,18740
420287,201703,48,29,19,27173,17803,44976
420290,201703,926,651,275,609304.6,257599.2,866903.8
420300,201703,1300,1021,279,953025.2,260205.77,1213230.97
420310,201703,51,38,13,35606,12181,47787
420315,201703,35,31,4,29047,3748,32795
420320,201703,839,425,414,397264.58,387914,785178.58
420325,201703,0,0,0,0,0,0
420330,201703,121,85,36,79645,33732,113377
420340,201703,151,109,42,101188,39325.89,140513.89
420350,201703,237,175,62,162664.1,58094,220758.1
420360,201703,732,553,179,516504.23,166140.09,682644.32
420370,201703,102,68,34,63529,31577,95106
420380,201703,1099,791,308,737411.76,287474.12,1024885.88
420390,201703,248,154,94,143717.06,86438.25,230155.31
420395,201703,171,124,47,116188,44029.63,160217.63
420400,201703,244,180,64,167724,59968,227692
420410,201703,58,46,12,43102,11244,54346
420415,201703,33,30,3,28110,2811,30921
420417,201703,43,33,10,30921,9370,40291
420419,201703,11,10,1,9370,937,10307
420420,201703,2733,1665,1068,1548871.13,998450.88,2547322.01
420425,201703,67,58,9,54337,8414.26,62751.26
420430,201703,1248,859,389,800072.11,364464.89,1164537.00
420435,201703,16,14,2,13118,1874,14992
420440,201703,109,73,36,67480.86,33559.6,101040.46
420445,201703,20,18,2,16866,1874,18740
420450,201703,77,36,41,33703,38417,72120
420455,201703,230,181,49,169569.26,45858.63,215427.89
420460,201703,2211,1499,712,1399919.59,666931.82,2066851.41
420470,201703,119,88,31,82456,29047,111503
420475,201703,7,7,0,6559,0,6559
420480,201703,821,606,215,564336.46,200518.1,764854.56
420490,201703,112,87,25,81519,23425,104944
420500,201703,834,293,541,272887.1,506917,779804.1
420510,201703,21,18,3,16866,2811,19677
420515,201703,22,18,4,16866,3748,20614
420517,201703,7,7,0,6559,0,6559
420519,201703,0,0,0,0,0,0
420520,201703,69,53,16,49661,14992,64653
420530,201703,148,100,48,93700,44976,138676
420535,201703,19,16,3,14992,2811,17803
420540,201703,4231,2510,1721,2342409.15,1607770.69,3950179.84
420543,201703,22,22,0,20614,0,20614
420545,201703,182,130,52,121801,48695.89,170496.89
420550,201703,827,659,168,615937.89,157268.75,773206.64
420555,201703,39,31,8,29047,7496,36543
420560,201703,60,47,13,43664.2,12181,55845.2
420570,201703,116,68,48,63153.8,44966.63,108120.43
420580,201703,287,129,158,120873,148046,268919
420590,201703,489,349,140,326357.1,131180,457537.1
420600,201703,91,45,46,42165,43102,85267
420610,201703,34,32,2,29703,1874,31577
420620,201703,67,56,11,52472,10307,62779
420630,201703,143,103,40,96502.32,37472,133974.32
420640,201703,100,89,11,83393,10307,93700
420650,201703,229,123,106,114555.1,98152.06,212707.16
420660,201703,58,41,17,37667.9,15929,53596.9
420665,201703,36,27,9,25299,8433,33732
420670,201703,308,236,72,221122.63,67164.53,288287.16
420675,201703,13,13,0,12181,0,12181
420680,201703,30,23,7,21551,6559,28110
420690,201703,178,152,26,142424,24362,166786
420700,201703,579,411,168,385023.41,157186.19,542209.60
420710,201703,138,83,55,77771,51535,129306
420720,201703,97,81,16,75897,14992,90889
420730,201703,468,304,164,284774.15,152386.49,437160.64
420740,201703,43,42,1,39354,937,40291
420750,201703,478,315,163,294853.79,152538,447391.79
420757,201703,17,14,3,12321.55,2811,15132.55
420760,201703,40,31,9,29047,8433,37480
420765,201703,67,56,11,52472,10307,62779
420768,201703,71,64,7,59968,6559,66527
420770,201703,86,73,13,68401,12181,80582
420775,201703,44,42,2,38417,1874,40291
420780,201703,227,177,50,165624.12,46850,212474.12
420785,201703,13,9,4,8433,3748,12181
420790,201703,167,142,25,132737.64,22460.63,155198.27
420800,201703,72,54,18,49848.4,16866,66714.4
420810,201703,242,210,32,196761,29187.55,225948.55
420820,201703,2298,1362,936,1268368.46,875523.93,2143892.39
420830,201703,501,292,209,272159.09,194886.63,467045.72
420840,201703,136,102,34,95574,31858,127432
420845,201703,427,190,237,177370.93,220851,398221.93
420850,201703,210,170,40,159290,37480,196770
420860,201703,59,50,9,46850,8433,55283
420870,201703,111,83,28,77771,26236,104007
420880,201703,161,109,52,101467.73,48724,150191.73
420890,201703,831,413,418,383951.26,391657,775608.26
420895,201703,10,10,0,9370,0,9370
420900,201703,393,300,93,279358.22,87113.63,366471.85
420910,201703,5553,3034,2519,2837265.6,2359287.83,5196553.43
420915,201703,81,75,6,70275,5622,75897
420917,201703,18,13,5,12181,4685,16866
420920,201703,20,13,7,12181,6559,18740
420930,201703,2532,1515,1017,1411981.49,947381.7,2359363.19
420940,201703,562,415,147,388837,136124.24,524961.24
420945,201703,7,4,3,3748,2811,6559
420950,201703,55,50,5,46850,4685,51535
420960,201703,111,85,26,79617.63,24343.63,103961.26
420970,201703,301,244,57,226981.45,53381.63,280363.08
420980,201703,24,23,1,21551,937,22488
420985,201703,57,50,7,46850,6559,53409
420990,201703,72,55,17,51535,15929,67464
421000,201703,36,23,13,21551,12181,33732
421003,201703,66,42,24,38641.88,22479,61120.88
421005,201703,8,6,2,5622,1874,7496
421010,201703,714,511,203,478416.78,188157.39,666574.17
421020,201703,27,24,3,22468,2811,25279
421030,201703,122,101,21,94310,19677,113987
421040,201703,56,49,7,45913,6559,52472
421050,201703,288,202,86,187213.1,80582,267795.1
421055,201703,26,23,3,21551,2811,24362
421060,201703,87,61,26,57157,24362,81519
421070,201703,49,44,5,41228,4685,45913
421080,201703,32,29,3,27173,2811,29984
421085,201703,23,18,5,16866,4685,21551
421090,201703,44,34,10,31858,9370,41228
421100,201703,114,84,30,78708,28110,106818
421105,201703,200,161,39,150717,36519.95,187236.95
421110,201703,111,94,17,87468.95,15929,103397.95
421120,201703,138,109,29,101646.13,27154.26,128800.39
421125,201703,17,12,5,11244,4685,15929
421130,201703,773,492,281,460322.41,262275.87,722598.28
421140,201703,30,21,9,18974.25,8433,27407.25
421145,201703,38,31,7,29047,6559,35606
421150,201703,103,75,28,70275,26236,96511
421160,201703,58,38,20,35596.63,18740,54336.63
421165,201703,19,18,1,16866,937,17803
421170,201703,181,156,25,145443.52,23416,168859.52
421175,201703,146,97,49,90889,45857.52,136746.52
421180,201703,55,33,22,30565,20614,51179
421185,201703,16,13,3,12181,2811,14992
421187,201703,0,0,0,0,0,0
421189,201703,38,30,8,28110,7486.63,35596.63
421190,201703,1326,808,518,756347,484691.36,1241038.36
421200,201703,89,70,19,65590,17803,83393
421205,201703,22,14,8,13118,7486.63,20604.63
421210,201703,175,117,58,109629,54346,163975
421220,201703,260,207,53,193349.95,49661,243010.95
421223,201703,54,45,9,42165,8433,50598
421225,201703,51,37,14,34669,13118,47787
421227,201703,89,66,23,61842,21551,83393
421230,201703,44,32,12,29984,11244,41228
421240,201703,19,19,0,17803,0,17803
421250,201703,359,217,142,203236,132557.39,335793.39
421260,201703,29,23,6,21551,5622,27173
421265,201703,0,0,0,0,0,0
421270,201703,56,50,6,46850,5622,52472
421280,201703,324,186,138,174282,128369,302651
421290,201703,303,205,98,191851,90439.56,282290.56
421300,201703,28,22,6,20614,5622,26236
421310,201703,54,40,14,36824.1,13118,49942.1
421315,201703,30,20,10,18740,9370,28110
421320,201703,121,88,33,82129,30921,113050
421330,201703,111,84,27,76346.76,25290,101636.76
421335,201703,39,25,14,23425,13118,36543
421340,201703,269,179,90,166094.55,84330,250424.55
421350,201703,167,100,67,93265,62779,156044
421360,201703,675,495,180,459422.69,168436.26,627858.95
421370,201703,178,136,42,127432,38744.95,166176.95
421380,201703,123,103,20,96506.32,18740,115246.32
421390,201703,18,15,3,14055,2811,16866
421400,201703,109,94,15,88078,14055,102133
421410,201703,21,18,3,16866,2811,19677
421415,201703,19,17,2,15929,1874,17803
421420,201703,152,127,25,118436.8,23425,141861.8
421430,201703,15,12,3,11244,2811,14055
421440,201703,59,46,13,43102,12181,55283
421450,201703,101,89,12,83393,11244,94637
421460,201703,58,49,9,45123.1,8433,53556.1
421470,201703,72,47,25,44039,23425,67464
421480,201703,610,450,160,421181.5,149920,571101.5
421490,201703,25,22,3,19950,2811,22761
421500,201703,506,328,178,304952.51,165918.69,470871.20
421505,201703,25,18,7,16866,6559,23425
421507,201703,31,26,5,24362,4685,29047
421510,201703,72,48,24,44976,22488,67464
421520,201703,67,57,10,52660,9370,62030
421530,201703,53,47,6,43383.1,5622,49005.1
421535,201703,34,33,1,30659,937,31596
421540,201703,58,52,6,48724,5622,54346
421545,201703,89,71,18,65860,16866,82726
421550,201703,269,190,79,177375,74023,251398
421555,201703,22,18,4,16866,3748,20614
421560,201703,8,8,0,7496,0,7496
421565,201703,122,91,31,84704.8,29047,113751.8
421567,201703,28,22,6,20614,5622,26236
421568,201703,32,30,2,28110,1874,29984
421569,201703,9,8,1,7496,937,8433
421570,201703,131,86,45,80582,42165,122747
421575,201703,27,22,5,20356.33,4685,25041.33
421580,201703,709,427,282,400078.89,263297.27,663376.16
421590,201703,20,20,0,18740,0,18740
421600,201703,111,75,36,70255,32796,103051
421605,201703,99,68,31,63389,29047,92436
421610,201703,182,140,42,131180,39354,170534
421620,201703,1090,654,436,610343.76,408484.52,1018828.28
421625,201703,20,17,3,15929,2811,18740
421630,201703,267,169,98,158307,90983,249290
421635,201703,17,7,10,6559,9370,15929
421640,201703,96,84,12,78708,11244,89952
421650,201703,268,158,110,148027.26,103051.26,251078.52
421660,201703,2008,1190,818,1113316.36,765220.16,1878536.52
421670,201703,167,125,42,117125,39354,156479
421680,201703,169,153,16,143361,14983,158344
421690,201703,342,240,102,224299.8,94627.99,318927.79
421700,201703,54,34,20,31858,17843,49701
421710,201703,20,20,0,18740,0,18740
421715,201703,9,8,1,7496,937,8433
421720,201703,543,386,157,359704.3,145413.54,505117.84
421725,201703,11,5,6,4685,5622,10307
421730,201703,38,29,9,26455.48,8433,34888.48
421740,201703,80,38,42,35606,39354,74960
421750,201703,215,156,59,144580.1,55283,199863.1
421755,201703,24,22,2,20614,1874,22488
421760,201703,107,77,30,72139.63,28110,100249.63
421770,201703,527,367,160,342459.52,149574.15,492033.67
421775,201703,22,14,8,13118,7496,20614
421780,201703,183,143,40,133709.9,37480,171189.9
421790,201703,157,132,25,123684,23425,147109
421795,201703,13,11,2,10307,1874,12181
421800,201703,434,278,156,258766.61,146167.32,404933.93
421810,201703,72,56,16,51536,14992,66528
421820,201703,281,188,93,175191.1,87141,262332.1
421825,201703,129,103,26,96511,24362,120873
421830,201703,134,103,31,96511,29047,125558
421835,201703,3,3,0,2811,0,2811
421840,201703,58,49,9,45904,8433,54337
421850,201703,71,61,10,57157,9366,66523
421860,201703,42,32,10,29703,9370,39073
421870,201703,954,716,238,664804.86,222721.43,887526.29
421875,201703,49,43,6,40291,5622,45913
421880,201703,162,116,46,108692,42821,151513
421885,201703,26,21,5,19677,4404,24081
421890,201703,114,79,35,74023,32795,106818
421895,201703,35,33,2,30921,1874,32795
421900,201703,139,112,27,104870.15,25254,130124.15
421910,201703,64,43,21,40291,19677,59968
421915,201703,31,24,7,22488,6559,29047
421917,201703,36,26,10,24081,9370,33451
421920,201703,34,31,3,29047,2811,31858
421930,201703,748,572,176,535626.68,164875.63,700502.31
421935,201703,58,51,7,47787,6559,54346
421940,201703,44,39,5,36543,4685,41228
421950,201703,824,536,288,496208.72,267397.4,763606.12
421960,201703,40,35,5,32514,4685,37199
421970,201703,356,224,132,209398.12,123633.01,333031.13
421985,201703,28,20,8,18740,7496,26236
422000,201703,0,0,0,0,0,0
430003,201703,212,46,166,42399.25,155542,197941.25
430005,201703,29,23,6,21551,5622,27173
430010,201703,286,199,87,185994.5,81519,267513.5
430020,201703,154,99,55,92482,50598,143080
430030,201703,117,89,28,83393,26236,109629
430040,201703,2969,1712,1257,1597118.15,1177172.58,2774290.73
430045,201703,64,55,9,51535,8433,59968
430047,201703,7,6,1,5622,937,6559
430050,201703,77,64,13,59968,12181,72149
430055,201703,17,14,3,13118,2811,15929
430057,201703,4,2,2,1874,1874,3748
430060,201703,3674,2166,1508,2022061.72,1408468.49,3430530.21
430063,201703,53,46,7,43102,6559,49661
430064,201703,136,113,23,105178.25,21551,126729.25
430066,201703,10,7,3,6559,2811,9370
430070,201703,49,37,12,34669,11244,45913
430080,201703,71,50,21,46162.8,19677,65839.8
430085,201703,36,9,27,8433,25299,33732
430087,201703,37,27,10,25159,9370,34529
430090,201703,68,62,6,57531.8,5622,63153.8
430100,201703,110,72,38,67464,35606,103070
430105,201703,141,71,70,66527,65290.16,131817.16
430107,201703,21,15,6,14055,5622,19677
430110,201703,386,223,163,208154.55,152665.41,360819.96
430120,201703,143,127,16,118062.95,14992,133054.95
430130,201703,774,479,295,448213.95,276133.9,724347.85
430140,201703,125,116,9,108692,8433,117125
430150,201703,105,69,36,63904,33732,97636
430155,201703,28,27,1,25299,937,26236
430160,201703,3781,2233,1548,2074192.35,1446475.11,3520667.46
430163,201703,307,133,174,123525.68,162963.04,286488.72
430165,201703,22,16,6,14992,5622,20614
430170,201703,77,72,5,67464,4685,72149
430175,201703,80,61,19,57157,17147.1,74304.1
430180,201703,91,72,19,67464,17193.95,84657.95
430185,201703,32,24,8,22488,7496,29984
430187,201703,111,45,66,42165,61542.9,103707.9
430190,201703,229,131,98,122700.15,91160.73,213860.88
430192,201703,13,13,0,12181,0,12181
430195,201703,13,9,4,8433,3748,12181
430200,201703,159,140,19,130524.1,17803,148327.1
430205,201703,19,18,1,16866,937,17803
430210,201703,579,438,141,407313.9,130852.15,538166.05
430215,201703,17,14,3,13118,2811,15929
430220,201703,61,41,20,38417,18740,57157
430222,201703,13,7,6,6559,5622,12181
430223,201703,13,7,6,6559,5622,12181
430225,201703,4,3,1,2811,937,3748
430230,201703,293,182,111,168660,103819.6,272479.6
430235,201703,45,32,13,29984,12171.63,42155.63
430237,201703,27,21,6,19677,5622,25299
430240,201703,127,76,51,71212,47777.63,118989.63
430245,201703,65,53,12,49661,11244,60905
430250,201703,195,115,80,107745.63,74950.63,182696.26
430258,201703,12,10,2,9370,1874,11244
430260,201703,36,31,5,29047,3879.18,32926.18
430265,201703,34,27,7,25280.26,6559,31839.26
430270,201703,580,429,151,397700.3,139707.81,537408.11
430280,201703,1014,638,376,594891.93,349857.8,944749.73
430290,201703,367,211,156,195833.4,146172,342005.4
430300,201703,2088,1141,947,1062883.76,883584.07,1946467.83
430310,201703,1987,1020,967,949943,903294.01,1853237.01
430320,201703,47,39,8,36528.95,7496,44024.95
430330,201703,97,87,10,80769.4,9370,90139.4
430340,201703,66,59,7,55283,6559,61842
430350,201703,1649,1148,501,1064124.49,467994.76,1532119.25
430355,201703,26,24,2,22488,1874,24362
430360,201703,81,34,47,31858,43102.1,74960.1
430367,201703,28,18,10,16866,8592.29,25458.29
430370,201703,56,49,7,45913,6559,52472
430380,201703,120,90,30,83767.8,28110,111877.8
430390,201703,606,379,227,354841.9,212399.63,567241.53
430400,201703,134,104,30,95761.4,28091.26,123852.66
430410,201703,57,45,12,42165,11244,53409
430420,201703,461,307,154,286160.9,142078.58,428239.48
430430,201703,50,49,1,45288.95,937,46225.95
430435,201703,151,112,39,104662.9,35840.25,140503.15
430440,201703,510,338,172,316706,160976.6,477682.6
430450,201703,1164,957,207,890245.27,193949.63,1084194.90
430460,201703,5064,2738,2326,2550562.48,2172075.45,4722637.93
430461,201703,21,19,2,17803,1874,19677
430462,201703,11,7,4,6559,3748,10307
430463,201703,953,492,461,458334.39,431611.05,889945.44
430465,201703,28,17,11,15929,10307,26236
430466,201703,624,452,172,422306,160976.6,583282.6
430467,201703,86,49,37,45913,34659.63,80572.63
430468,201703,110,64,46,59968,42855.39,102823.39
430469,201703,22,16,6,14992,5622,20614
430470,201703,1144,639,505,591076.37,471273.52,1062349.89
430471,201703,48,36,12,33713.26,11244,44957.26
430480,201703,95,60,35,55376.7,32785.63,88162.33
430485,201703,5,5,0,4404,0,4404
430490,201703,91,72,19,67042.35,17803,84845.35
430495,201703,32,27,5,25299,4685,29984
430500,201703,189,128,61,119233.25,56787.63,176020.88
430510,201703,2867,1896,971,1771286.8,909004.6,2680291.4
430511,201703,18,18,0,16866,0,16866
430512,201703,135,91,44,85267,41228,126495
430513,201703,52,47,5,43570.5,4685,48255.5
430515,201703,29,27,2,25299,1874,27173
430517,201703,166,145,21,134928.25,19658.26,154586.51
430520,201703,363,245,118,228900.63,110528.52,339429.15
430530,201703,92,51,41,47787,38417,86204
430535,201703,461,298,163,278991.75,152717.32,431709.07
430537,201703,14,14,0,13118,0,13118
430540,201703,75,48,27,44976,25299,70275
430543,201703,369,115,254,107755,237764,345519
430544,201703,42,39,3,36543,2811,39354
430545,201703,324,145,179,135799.41,167235.76,303035.17
430550,201703,46,38,8,35606,7496,43102
430558,201703,5,3,2,2811,1874,4685
430560,201703,46,19,27,17803,25299,43102
430570,201703,100,46,54,43102,50541.78,93643.78
430580,201703,127,98,29,91826,27126.15,118952.15
430583,201703,16,16,0,14992,0,14992
430585,201703,8,4,4,3748,3748,7496
430587,201703,15,8,7,7496,6559,14055
430590,201703,151,126,25,116843.9,23425,140268.9
430593,201703,4,4,0,3748,0,3748
430595,201703,15,9,6,8433,5622,14055
430597,201703,55,29,26,27173,24362,51535
430600,201703,213,142,71,133044.63,66245.9,199290.53
430605,201703,151,92,59,86204,55273.63,141477.63
430607,201703,25,21,4,19677,3748,23425
430610,201703,1598,730,868,679888.05,808397.12,1488285.17
430613,201703,2,2,0,1874,0,1874
430620,201703,109,79,30,73883,28091.26,101974.26
430630,201703,46,43,3,40291,2811,43102
430632,201703,32,28,4,26236,3748,29984
430635,201703,40,36,4,33732,3748,37480
430637,201703,61,35,26,32795,24362,57157
430640,201703,203,112,91,104100.7,85267,189367.7
430642,201703,27,25,2,23425,1874,25299
430645,201703,30,26,4,24362,3748,28110
430650,201703,245,192,53,179623,49614.15,229237.15
430655,201703,7,6,1,5622,937,6559
430660,201703,964,464,500,433034.55,466288.78,899323.33
430670,201703,68,49,19,45913,17803,63716
430673,201703,76,42,34,39354,31858,71212
430675,201703,13,10,3,9370,2811,12181
430676,201703,449,264,185,246674.62,173274.84,419949.46
430680,201703,244,166,78,153387,73086,226473
430690,201703,518,310,208,289598.59,192332.01,481930.60
430692,201703,7,5,2,4685,1874,6559
430693,201703,125,81,44,75897,40609.58,116506.58
430695,201703,64,58,6,53427.74,5622,59049.74
430697,201703,62,37,25,34669,23425,58094
430700,201703,1546,1080,466,1004099.2,436642,1440741.2
430705,201703,19,18,1,16866,937,17803
430710,201703,257,165,92,154605,86204,240809
430720,201703,106,92,14,86016.6,13118,99134.6
430730,201703,121,98,23,90889,20370.38,111259.38
430740,201703,56,40,16,37480,14992,52472
430745,201703,38,30,8,27829,7496,35325
430750,201703,334,230,104,214637.72,96511,311148.72
430755,201703,80,46,34,43102,31858,74960
430760,201703,360,218,142,201034.11,133026.26,334060.37
430770,201703,1453,741,712,692256.66,662757.19,1355013.85
430780,201703,310,196,114,183361.9,106752.78,290114.68
430781,201703,26,22,4,20614,3748,24362
430783,201703,44,35,9,32482.8,8433,40915.8
430786,201703,5,2,3,1874,2811,4685
430790,201703,451,292,159,272104.8,148692.63,420797.43
430800,201703,151,126,25,118062,23425,141487
430805,201703,40,38,2,35606,1874,37480
430807,201703,31,19,12,17803,11244,29047
430810,201703,66,42,24,39354,22488,61842
430820,201703,127,75,52,70275,48068.1,118343.1
430825,201703,11,9,2,8433,1874,10307
430830,201703,225,209,16,195552,14992,210544
430840,201703,115,75,40,70275,36824.1,107099.1
430843,201703,4,3,1,2811,937,3748
430845,201703,69,40,29,37480,27173,64653
430850,201703,558,384,174,359758.41,162899.67,522658.08
430860,201703,148,95,53,87703.2,48995.73,136698.93
430865,201703,64,31,33,28391.1,30611.79,59002.89
430870,201703,74,61,13,57157,12181,69338
430880,201703,149,114,35,106818,32795,139613
430885,201703,7,6,1,5622,937,6559
430890,201703,329,200,129,185769.94,120592,306361.94
430900,201703,553,374,179,346315.8,167245.13,513560.93
430905,201703,78,32,46,29984,43102,73086
430910,201703,260,147,113,137739,104728.37,242467.37
430912,201703,7,7,0,6559,0,6559
430915,201703,28,20,8,18740,7214.9,25954.9
430920,201703,3923,2178,1745,2035251.11,1632830.42,3668081.53
430925,201703,7,6,1,5378.38,937,6315.38
430930,201703,2032,1210,822,1126182.89,768072.35,1894255.24
430940,201703,234,147,87,136792.63,81500.26,218292.89
430950,201703,159,126,33,118062,30639.9,148701.9
430955,201703,18,11,7,10307,6559,16866
430957,201703,17,16,1,14992,937,15929
430960,201703,238,153,85,142283.45,79645,221928.45
430965,201703,91,58,33,54346,30921,85267
430970,201703,78,65,13,60905,11244,72149
430975,201703,33,31,2,29047,1874,30921
430980,201703,44,27,17,25299,15929,41228
430990,201703,108,81,27,75897,25299,101196
430995,201703,114,110,4,102133,3748,105881
431000,201703,296,135,161,125269.1,150857,276126.1
431010,201703,336,198,138,184560.89,129306,313866.89
431020,201703,1878,1070,808,995819.24,753994.53,1749813.77
431030,201703,40,32,8,29984,7496,37480
431033,201703,370,181,189,168800.6,177093,345893.6
431036,201703,14,9,5,8433,4685,13118
431040,201703,134,79,55,73086,51427.25,124513.25
431041,201703,36,25,11,23425,10307,33732
431043,201703,42,23,19,21551,17803,39354
431046,201703,12,7,5,6559,4685,11244
431050,201703,210,134,76,123154.84,69725.4,192880.24
431053,201703,67,40,27,36730.4,25299,62029.4
431055,201703,63,40,23,37480,21532.26,59012.26
431057,201703,17,17,0,15929,0,15929
431060,201703,1669,1038,631,966460.83,589473.91,1555934.74
431065,201703,16,10,6,9370,5622,14992
431070,201703,68,64,4,59968,3748,63716
431075,201703,9,9,0,8433,0,8433
431080,201703,135,87,48,80223.17,44976,125199.17
431085,201703,27,24,3,22488,2811,25299
431087,201703,14,13,1,12181,937,13118
431090,201703,52,42,10,39354,9370,48724
431100,201703,1226,729,497,673521.71,465689,1139210.71
431110,201703,246,152,94,142424,88068.63,230492.63
431112,201703,29,18,11,16866,10307,27173
431113,201703,30,20,10,18740,9370,28110
431115,201703,155,105,50,97760.2,46840.63,144600.83
431120,201703,614,364,250,338876.42,234194.52,573070.94
431123,201703,3,3,0,2811,0,2811
431125,201703,88,79,9,74023,8433,82456
431127,201703,8,3,5,2811,4685,7496
431130,201703,599,393,206,366085.9,193012.63,559098.53
431140,201703,692,462,230,429830.01,215153.94,644983.95
431142,201703,31,24,7,21298,6559,27857
431150,201703,204,150,54,140550,50579.26,191129.26
431160,201703,54,48,6,44976,5622,50598
431162,201703,20,15,5,14055,4685,18740
431164,201703,5,5,0,4685,0,4685
431170,201703,98,81,17,75897,15929,91826
431171,201703,47,25,22,23425,20604.63,44029.63
431173,201703,1,1,0,937,0,937
431175,201703,200,96,104,88734,97448,186182
431177,201703,74,56,18,52472,16847.26,69319.26
431179,201703,14,12,2,11244,1874,13118
431180,201703,427,261,166,243620,155523.63,399143.63
431190,201703,91,68,23,63716,21551,85267
431198,201703,65,44,21,41228,19677,60905
431200,201703,18,16,2,14992,1874,16866
431205,201703,28,28,0,26236,0,26236
431210,201703,81,50,31,46523,29047,75570
431213,201703,26,21,5,19677,4685,24362
431215,201703,27,24,3,22488,2811,25299
431217,201703,5,4,1,3748,937,4685
431220,201703,60,51,9,47787,8433,56220
431225,201703,142,94,48,88069,44966.63,133035.63
431230,201703,99,84,15,78052.1,14055,92107.1
431235,201703,7,7,0,6559,0,6559
431237,201703,24,16,8,14992,7496,22488
431238,201703,16,12,4,10963,3748,14711
431240,201703,964,606,358,565274.16,334388.11,899662.27
431242,201703,37,37,0,34669,0,34669
431244,201703,11,8,3,7496,2811,10307
431245,201703,62,47,15,44039,14055,58094
431247,201703,13,9,4,8433,3748,12181
431250,201703,264,134,130,125539.26,121782.26,247321.52
431260,201703,61,45,16,42165,14992,57157
431261,201703,23,15,8,14055,7496,21551
431262,201703,18,18,0,16866,0,16866
431265,201703,165,87,78,81519,73086,154605
431267,201703,15,14,1,13118,937,14055
431270,201703,301,249,52,233313,48724,282037
431275,201703,40,38,2,35606,1874,37480
431280,201703,20,15,5,13235.12,4685,17920.12
431290,201703,23,20,3,18740,2811,21551
431295,201703,5,5,0,4685,0,4685
431300,201703,22,19,3,17803,2811,20614
431301,201703,8,7,1,6559,937,7496
431303,201703,47,33,14,30799.19,12836.9,43636.09
431306,201703,209,112,97,104496.11,90889,195385.11
431308,201703,6,5,1,4685,937,5622
431310,201703,69,58,11,54346,10307,64653
431320,201703,112,68,44,63716,41218.63,104934.63
431330,201703,176,116,60,108692,56220,164912
431333,201703,32,26,6,24362,5622,29984
431335,201703,10,5,5,4685,4685,9370
431337,201703,302,146,156,135988.1,145815.94,281804.04
431339,201703,14,11,3,10307,2811,13118
431340,201703,2961,1678,1283,1568665.78,1200224.18,2768889.96
431342,201703,40,24,16,22488,14992,37480
431344,201703,16,16,0,14992,0,14992
431346,201703,5,5,0,4685,0,4685
431349,201703,35,32,3,29984,2811,32795
431350,201703,897,528,369,490231.99,344788.63,835020.62
431360,201703,41,38,3,35606,2811,38417
431365,201703,312,146,166,136783.26,155532.63,292315.89
431370,201703,1280,763,517,712252.14,484244.19,1196496.33
431380,201703,103,85,18,78989.1,16866,95855.1
431390,201703,485,270,215,252053.1,199845.01,451898.11
431395,201703,274,119,155,111503,145217,256720
431400,201703,35,27,8,25299,7496,32795
431402,201703,89,61,28,57157,26236,83393
431403,201703,14,8,6,7496,5622,13118
431405,201703,642,347,295,324042.81,276388,600430.81
431406,201703,28,24,4,22488,3748,26236
431407,201703,48,43,5,40291,4685,44976
431410,201703,3002,1749,1253,1628079.64,1173105.26,2801184.90
431413,201703,15,14,1,13118,937,14055
431415,201703,72,51,21,47787,19677,67464
431417,201703,21,11,10,10307,9370,19677
431420,201703,285,205,80,191460.3,74950.63,266410.93
431430,201703,40,15,25,14055,23425,37480
431440,201703,8774,6244,2530,5789109.87,2364028.83,8153138.70
431442,201703,27,15,12,14055,11244,25299
431445,201703,26,20,6,18740,5622,24362
431446,201703,8,7,1,6559,937,7496
431447,201703,85,59,26,55283,24362,79645
431449,201703,48,45,3,42165,2811,44976
431450,201703,397,282,115,262500.55,107052.25,369552.80
431454,201703,0,0,0,0,0,0
431455,201703,46,35,11,32795,10307,43102
431460,201703,506,342,164,316893.4,153246.9,470140.3
431470,201703,121,93,28,86461.86,26236,112697.86
431475,201703,11,10,1,9370,937,10307
431477,201703,32,22,10,20614,9370,29984
431478,201703,6,5,1,4685,937,5622
431480,201703,484,305,179,284332.65,167404.42,451737.07
431490,201703,27980,15682,12298,14626934.01,11491062.71,26117996.72
431500,201703,75,54,21,50598,19677,70275
431505,201703,45,17,28,15929,26236,42165
431507,201703,6,6,0,5622,0,5622
431510,201703,288,180,108,167957.9,99303.26,267261.16
431513,201703,22,17,5,15929,4685,20614
431514,201703,6,5,1,4685,937,5622
431515,201703,76,66,10,61842,9370,71212
431517,201703,3,1,2,937,1874,2811
431520,201703,35,31,4,29047,3748,32795
431530,201703,1629,720,909,673330.42,851278.67,1524609.09
431531,201703,22,21,1,19677,937,20614
431532,201703,22,16,6,14992,5622,20614
431535,201703,22,14,8,13118,7496,20614
431540,201703,142,125,17,116122.41,15929,132051.41
431545,201703,17,15,2,14055,1874,15929
431550,201703,339,193,146,180841,136708.3,317549.3
431555,201703,11,10,1,9370,937,10307
431560,201703,4213,2962,1251,2747350.59,1170941.79,3918292.38
431570,201703,748,394,354,365617.6,329750.04,695367.64
431575,201703,35,25,10,23425,9370,32795
431580,201703,91,62,29,57157,27173,84330
431590,201703,122,101,21,94402.75,19667.63,114070.38
431595,201703,13,12,1,11244,937,12181
431600,201703,202,113,89,105881,83393,189274
431610,201703,127,92,35,85548.1,32795,118343.1
431620,201703,42,34,8,31858,7496,39354
431630,201703,118,102,16,95574,14992,110566
431640,201703,1310,824,486,768902.2,454475.96,1223378.16
431642,201703,44,40,4,37011.5,3748,40759.5
431643,201703,47,21,26,19677,24362,44039
431645,201703,300,171,129,160227,119936,280163
431647,201703,11,11,0,10307,0,10307
431650,201703,34,24,10,22488,9370,31858
431660,201703,261,171,90,160227,84330,244557
431670,201703,211,99,112,91123.25,104915.89,196039.14
431673,201703,4,4,0,3748,0,3748
431675,201703,30,26,4,24080.9,3748,27828.9
431680,201703,1052,747,305,695722.5,285523.38,981245.88
431690,201703,4680,2857,1823,2660747.31,1703018.99,4363766.30
431695,201703,24,18,6,16866,5622,22488
431697,201703,0,0,0,0,0,0
431700,201703,163,122,41,114314,38417,152731
431710,201703,3964,1703,2261,1594202.9,2117127.71,3711330.61
431720,201703,1374,806,568,747483.18,530328.63,1277811.81
431725,201703,1,1,0,937,0,937
431730,201703,1148,761,387,707155.35,362619,1069774.35
431740,201703,1353,673,680,626067.26,636609.12,1262676.38
431750,201703,1857,1202,655,1116816.82,611177.36,1727994.18
431755,201703,5,4,1,3748,937,4685
431760,201703,1086,686,400,642407.2,374575.49,1016982.69
431770,201703,384,284,100,265924.63,93681.26,359605.89
431775,201703,26,20,6,18740,5622,24362
431780,201703,558,346,212,323208.78,198634.63,521843.41
431790,201703,142,109,33,101196,30874.15,132070.15
431795,201703,12,11,1,10307,937,11244
431800,201703,3409,1777,1632,1652050,1521212.52,3173262.52
431805,201703,18,15,3,14055,2811,16866
431810,201703,600,405,195,377835.88,182430.06,560265.94
431820,201703,307,171,136,160227,126448.15,286675.15
431830,201703,2311,1391,920,1300092.2,860599.51,2160691.71
431840,201703,503,330,173,305651.65,160883,466534.65
431842,201703,33,27,6,25299,5622,30921
431843,201703,10,6,4,5622,3748,9370
431844,201703,14,12,2,11244,1874,13118
431845,201703,29,27,2,25299,1874,27173
431846,201703,28,24,4,22488,3748,26236
431848,201703,13,11,2,10307,1874,12181
431849,201703,8,6,2,5622,1874,7496
431850,201703,771,639,132,597246.93,123449.75,720696.68
431860,201703,105,75,30,70275,27173,97448
431861,201703,5,3,2,2811,1874,4685
431862,201703,49,35,14,32795,13118,45913
431870,201703,3391,1969,1422,1838816.79,1331143.49,3169960.28
431880,201703,887,659,228,612752,212699,825451
431890,201703,1300,798,502,744605.79,468702,1213307.79
431900,201703,173,123,50,115251,46850,162101
431910,201703,50,37,13,34669,12181,46850
431912,201703,35,20,15,18740,14055,32795
431915,201703,122,100,22,93700,20614,114314
431920,201703,139,105,34,98385,31858,130243
431930,201703,83,66,17,61842,15929,77771
431935,201703,4,3,1,2811,937,3748
431936,201703,12,11,1,10307,937,11244
431937,201703,15,10,5,9370,4685,14055
431940,201703,435,286,149,265498.95,139603.63,405102.58
431950,201703,458,294,164,274213.42,152103.95,426317.37
431960,201703,705,428,277,396943.42,259390.45,656333.87
431970,201703,74,66,8,61842,7496,69338
431971,201703,3,3,0,2811,0,2811
431973,201703,13,12,1,11244,937,12181
431975,201703,6,5,1,4685,937,5622
431980,201703,198,128,70,118248.96,65590,183838.96
431990,201703,1209,646,563,603855.09,527221.9,1131076.99
432000,201703,1630,871,759,810706.07,708339.86,1519045.93
432010,201703,281,186,95,173189.3,89015,262204.3
432020,201703,166,131,35,122747,32785.63,155532.63
432023,201703,20,16,4,14992,3748,18740
432026,201703,61,55,6,51535,5622,57157
432030,201703,61,32,29,29984,27173,57157
432032,201703,23,19,4,17803,3748,21551
432035,201703,42,34,8,31858,7496,39354
432040,201703,97,67,30,62779,28110,90889
432045,201703,8,7,1,6277.9,937,7214.9
432050,201703,65,39,26,36543,24362,60905
432055,201703,99,77,22,72130.26,20614,92744.26
432057,201703,0,0,0,0,0,0
432060,201703,38,34,4,31155.25,3748,34903.25
432065,201703,30,27,3,25299,2811,28110
432067,201703,97,84,13,78708,12181,90889
432070,201703,401,296,105,275761.29,98357.26,374118.55
432080,201703,799,543,256,507854,239825.89,747679.89
432085,201703,14,11,3,10307,2811,13118
432090,201703,255,168,87,157416,81519,238935
432100,201703,171,112,59,104662.9,55283,159945.9
432110,201703,593,402,191,370930.76,178030,548960.76
432120,201703,960,564,396,527812.1,371014.89,898826.99
432130,201703,486,351,135,327950,126354.45,454304.45
432132,201703,28,25,3,23425,2811,26236
432135,201703,77,63,14,59031,13118,72149
432140,201703,267,204,63,190576.43,59031,249607.43
432143,201703,179,112,67,104944,62779,167723
432145,201703,254,175,79,162757.8,73460.8,236218.6
432146,201703,15,14,1,13118,937,14055
432147,201703,173,61,112,57157,104925.26,162082.26
432149,201703,16,11,5,10307,4685,14992
432150,201703,826,518,308,484194.75,286872.39,771067.14
432160,201703,1360,705,655,658914.51,612855.19,1271769.70
432162,201703,4,3,1,2811,937,3748
432163,201703,18,14,4,13118,3748,16866
432166,201703,126,92,34,86439,31858,118297
432170,201703,229,123,106,113659,99322,212981
432180,201703,523,316,207,295436.1,193678,489114.1
432183,201703,8,6,2,5622,1874,7496
432185,201703,76,64,12,59874.3,11244,71118.3
432190,201703,493,248,245,231233.63,229388.08,460621.71
432195,201703,84,72,12,66761.25,11244,78005.25
432200,201703,390,248,142,232376,132980.26,365356.26
432210,201703,111,72,39,65449.45,36543,101992.45
432215,201703,64,60,4,56220,3982.25,60202.25
432218,201703,20,19,1,17803,937,18740
432220,201703,665,331,334,309146.05,312159.13,621305.18
432225,201703,16,11,5,9838.5,4685,14523.5
432230,201703,159,87,72,81284.75,67417.15,148701.90
432232,201703,14,12,2,11244,1874,13118
432234,201703,5,4,1,3748,937,4685
432235,201703,1,1,0,937,0,937
432237,201703,29,16,13,14992,12181,27173
432240,201703,4079,2251,1828,2099640.71,1707224.24,3806864.95
432250,201703,996,606,390,565246.38,364333.71,929580.09
432252,201703,40,33,7,30190.14,6559,36749.14
432253,201703,55,46,9,43102,8433,51535
432254,201703,19,7,12,6559,11244,17803
432255,201703,14,13,1,12181,937,13118
432260,201703,832,648,184,605911.15,171471.75,777382.90
432270,201703,216,156,60,146172,56220,202392
432280,201703,115,81,34,75408.9,31858,107266.9
432285,201703,2,1,1,937,937,1874
432290,201703,67,62,5,56501.1,4685,61186.1
432300,201703,4583,2596,1987,2417732.36,1856806.69,4274539.05
432310,201703,116,92,24,86204,22488,108692
432320,201703,20,14,6,13118,5622,18740
432330,201703,12,6,6,5622,5622,11244
432335,201703,8,7,1,6559,937,7496
432340,201703,43,38,5,35606,4685,40291
432345,201703,87,62,25,58094,23425,81519
432350,201703,21,20,1,18740,937,19677
432360,201703,7,5,2,4685,1874,6559
432370,201703,25,24,1,22206.9,937,23143.9
432375,201703,41,35,6,32795,5622,38417
432377,201703,7,7,0,6559,0,6559
432380,201703,149,64,85,59312.1,79645,138957.1
500020,201703,225,116,109,108692,101543.06,210235.06
500025,201703,110,53,57,49661,53409,103070
500060,201703,1356,799,557,748381.9,521314.21,1269696.11
500070,201703,698,325,373,304525,349220,653745
500080,201703,134,101,33,94637,30359,124996
500085,201703,139,112,27,104663,24479.13,129142.13
500090,201703,338,156,182,146172,170534,316706
500100,201703,671,361,310,336664.3,289908,626572.3
500110,201703,2230,962,1268,901076.63,1187052.2,2088128.83
500124,201703,309,177,132,165849,123402.9,289251.9
500150,201703,323,119,204,111494,190794,302288
500190,201703,525,357,168,333853.1,156935,490788.1
500200,201703,194,165,29,154247.89,27173,181420.89
500210,201703,1420,497,923,465375.48,863780.47,1329155.95
500215,201703,230,129,101,119932.21,94637,214569.21
500220,201703,780,513,267,480459.26,249435.63,729894.89
500230,201703,256,175,81,163272.25,75428.5,238700.75
500240,201703,707,487,220,455570,205671.9,661241.9
500260,201703,551,195,356,182715,333572,516287
500270,201703,27974,11717,16257,10951798.03,15215479.25,26167277.28
500280,201703,192,72,120,67464,112431,179895
500290,201703,1170,658,512,615610,479454,1095064
500295,201703,383,226,157,211762,147099.63,358861.63
500310,201703,69,21,48,19677,44976,64653
500315,201703,697,406,291,380412.63,272376.53,652789.16
500320,201703,3613,1794,1819,1679531.39,1703056.47,3382587.86
500325,201703,936,505,431,472717,402889.32,875606.32
500330,201703,1483,661,822,616519.76,769329.7,1385849.46
500345,201703,327,236,91,220186.1,85267,305453.1
500348,201703,231,131,100,122747,93681.63,216428.63
500350,201703,145,70,75,65590,70275,135865
500370,201703,5366,2374,2992,2217130.41,2801156.97,5018287.38
500375,201703,350,251,99,235177.63,92763,327940.63
500380,201703,582,331,251,309992.4,235168.63,545161.03
500390,201703,69,35,34,32795,31858,64653
500400,201703,210,141,69,132098.26,64644,196742.26
500410,201703,565,219,346,205157.58,324056.42,529214.00
500430,201703,532,366,166,342942,155542,498484
500440,201703,207,102,105,94813.42,98385,193198.42
500450,201703,420,180,240,167971.8,224496.23,392468.03
500460,201703,314,157,157,147099.63,147109,294208.63
500470,201703,431,339,92,316450.05,85258,401708.05
500480,201703,105,65,40,60905,37480,98385
500490,201703,105,39,66,36538.32,61842,98380.32
500500,201703,1405,477,928,445034.36,868631.22,1313665.58
500510,201703,51,38,13,35606,12172,47778
500515,201703,105,69,36,64653,33451,98104
500520,201703,355,202,153,188244,143357,331601
500525,201703,83,50,33,46850,30639.9,77489.9
500540,201703,885,360,525,337254.78,490928.35,828183.13
500560,201703,857,480,377,448043.03,352566.83,800609.86
500568,201703,960,559,401,518536,375451.32,893987.32
500570,201703,1198,677,521,632156.46,485641.39,1117797.85
500580,201703,337,168,169,156189.03,158340,314529.03
500600,201703,323,163,160,152032.93,149920,301952.93
500620,201703,865,607,258,562429.71,241558.6,803988.31
500625,201703,80,68,12,63021.78,11244,74265.78
500627,201703,22,10,12,9370,11244,20614
500630,201703,1557,811,746,757752.9,698716.22,1456469.12
500635,201703,516,281,235,262894.09,220026.34,482920.43
500640,201703,428,221,207,205484.5,193931.63,399416.13
500660,201703,5512,2088,3424,1954675.85,3204412.73,5159088.58
500690,201703,568,203,365,189868.76,341241.6,531110.36
500710,201703,352,169,183,158072,171180.9,329252.9
500720,201703,965,573,392,535491.32,367094.26,902585.58
500730,201703,188,103,85,96511,79359.22,175870.22
500740,201703,839,374,465,349156.14,434971,784127.14
500750,201703,135,40,95,37480,88706.16,126186.16
500755,201703,129,93,36,86860,33732,120592
500769,201703,722,400,322,374479.02,301701,676180.02
500770,201703,449,227,222,212583.85,207779.75,420363.60
500780,201703,172,116,56,108692,52472,161164
500790,201703,1038,506,532,473555.32,498162.63,971717.95
500793,201703,249,130,119,121810,111494,233304
500795,201703,183,127,56,118989.63,52463,171452.63
500797,201703,40,33,7,30921,6559,37480
500800,201703,410,176,234,164903,218976.9,383879.9
500830,201703,2108,1169,939,1091858.2,878700.33,1970558.53
500840,201703,145,108,37,101196,34660,135856
510010,201703,164,89,75,83383.63,70275,153658.63
510020,201703,486,230,256,215236.67,239321.64,454558.31
510025,201703,1639,916,723,857156.03,674327.47,1531483.50
510030,201703,586,299,287,280117.26,268168.32,548285.58
510035,201703,130,55,75,51507.63,70256.63,121764.26
510040,201703,366,154,212,144298,198204.53,342502.53
510050,201703,422,230,192,214782.47,179084.89,393867.36
510060,201703,105,48,57,44966.63,53399.63,98366.26
510080,201703,216,85,131,79612.95,122644.3,202257.25
510100,201703,75,35,40,32795,37461.26,70256.26
510120,201703,29,15,14,14055,13118,27173
510125,201703,391,239,152,223273.05,142401.26,365674.31
510130,201703,594,344,250,321898.33,233813.31,555711.64
510140,201703,376,125,251,117116,235162.32,352278.32
510160,201703,88,42,46,39354,43098,82452
510170,201703,851,524,327,490434.66,305122.85,795557.51
510180,201703,2798,1374,1424,1284407.42,1332522.54,2616929.96
510185,201703,10,4,6,3748,5622,9370
510190,201703,214,73,141,68401,132112.32,200513.32
510250,201703,2614,1500,1114,1404464.59,1042761.51,2447226.10
510260,201703,202,142,60,132863.15,56183.63,189046.78
510263,201703,444,240,204,223157.04,190405.89,413562.93
510267,201703,626,340,286,318388.78,267723.47,586112.25
510268,201703,52,28,24,26236,22488,48724
510269,201703,69,25,44,23416,41218.63,64634.63
510270,201703,399,202,197,189098.19,184160.57,373258.76
510279,201703,216,151,65,141459.63,60886.26,202345.89
510285,201703,176,71,105,66488.63,98385,164873.63
510300,201703,561,294,267,275043.85,250105.53,525149.38
510305,201703,211,94,117,88055.63,109536.41,197592.04
510310,201703,121,56,65,52472,60895.63,113367.63
510320,201703,834,515,319,482454.52,298482.26,780936.78
510325,201703,385,159,226,148933.63,211190.43,360124.06
510330,201703,409,227,182,212666,170515.26,383181.26
510335,201703,575,294,281,275431.89,262353.32,537785.21
510336,201703,50,35,15,32795,14055,46850
510337,201703,117,45,72,42155.63,67454.63,109610.26
510340,201703,17173,8278,8895,7733219.55,8323736.1,16056955.65
510343,201703,71,47,24,44029.63,22488,66517.63
510345,201703,160,104,56,97438.63,52181.63,149620.26
510350,201703,632,356,276,332366.74,258547.89,590914.63
510360,201703,209,120,89,112421.63,83301.89,195723.52
510370,201703,131,64,67,59949.26,62649.67,122598.93
510380,201703,91,63,28,59031,26227,85258
510385,201703,51,25,26,23425,24353,47778
510390,201703,131,52,79,48724,73976.15,122700.15
510395,201703,41,27,14,25299,13118,38417
510410,201703,683,445,238,416932,222982.95,639914.95
510420,201703,604,284,320,265196.77,298268.46,563465.23
510450,201703,50,32,18,29984,16866,46850
510452,201703,40,23,17,21551,15929,37480
510454,201703,70,28,42,26236,39344.63,65580.63
510455,201703,128,77,51,72130.26,47777.63,119907.89
510460,201703,180,89,91,83084.53,85229.89,168314.42
510480,201703,686,389,297,363368.31,277921.97,641290.28
510490,201703,356,180,176,168307.64,164371.13,332678.77
510500,201703,252,185,67,173335.63,62779,236114.63
510510,201703,778,442,336,413283.43,314822.63,728106.06
510515,201703,1144,586,558,548520.11,522788.89,1071309.00
510517,201703,248,108,140,100914.9,131089.69,232004.59
510520,201703,235,153,82,143287.89,76529.52,219817.41
510523,201703,93,60,33,56220,30911.63,87131.63
510525,201703,643,358,285,334702.89,266944.89,601647.78
510530,201703,15,11,4,10307,3748,14055
510550,201703,269,116,153,108231.46,143352,251583.46
510558,201703,285,134,151,125543.95,141459.26,267003.21
510560,201703,347,213,134,199581,125259,324840
510562,201703,636,434,202,405079.25,188785.5,593864.75
510590,201703,836,435,401,407557.89,375709.96,783267.85
510600,201703,251,135,116,126472.26,108650.58,235122.84
510610,201703,163,78,85,73067.26,79345.63,152412.89
510615,201703,184,69,115,64634.26,107755,172389.26
510617,201703,15,8,7,7496,6559,14055
510618,201703,119,57,62,53409,57625.5,111034.5
510619,201703,109,73,36,68392,33723,102115
510620,201703,192,107,85,100249.63,79645,179894.63
510621,201703,190,122,68,114023.9,63707,177730.9
510622,201703,425,276,149,258500.89,139295.26,397796.15
510623,201703,351,225,126,210806.63,117530.52,328337.15
510624,201703,81,38,43,35597,40291,75888
510625,201703,513,309,204,289305.78,190533.08,479838.86
510626,201703,103,61,42,57157,39354,96511
510627,201703,50,36,14,33732,13118,46850
510628,201703,169,99,70,92680.15,65496.67,158176.82
510629,201703,248,156,92,146172,85257.63,231429.63
510630,201703,460,227,233,212624.78,217989.85,430614.63
510631,201703,9,3,6,2811,5622,8433
510637,201703,339,187,152,174869.79,142278.52,317148.31
510642,201703,975,523,452,489705.79,423383.82,913089.61
510645,201703,0,0,0,0,0,0
510650,201703,1516,1000,516,936833.89,483395.78,1420229.67
510665,201703,82,40,42,37426,39336,76762
510670,201703,67,37,30,34669,28110,62779
510675,201703,1176,715,461,669913,431934.32,1101847.32
510677,201703,377,176,201,163915.15,188190.04,352105.19
510680,201703,112,65,47,60887,44030,104917
510682,201703,197,87,110,81203,103070,184273
510685,201703,58,42,16,39354,14992,54346
510700,201703,618,358,260,335327.89,243459.67,578787.56
510704,201703,1012,537,475,501000.72,442582.04,943582.76
510706,201703,122,58,64,54341.32,59931.26,114272.58
510710,201703,388,259,129,242507.93,120722.56,363230.49
510715,201703,64,47,17,44029.63,15929,59958.63
510718,201703,220,111,109,103914.78,102114.63,206029.41
510719,201703,32,18,14,16866,13118,29984
510720,201703,195,124,71,116179,66245.9,182424.9
510724,201703,88,35,53,32785.63,49628.89,82414.52
510726,201703,44,25,19,23415.63,17785,41200.63
510729,201703,78,37,41,34669,38370.15,73039.15
510730,201703,465,257,208,240800,194748.63,435548.63
510735,201703,103,43,60,40291,56220,96511
510740,201703,30,15,15,14055,14055,28110
510757,201703,18,14,4,13118,3748,16866
510760,201703,6894,3600,3294,3363093.62,3080940.61,6444034.23
510770,201703,739,350,389,327774.15,364302.15,692076.30
510774,201703,14,7,7,6559,6559,13118
510775,201703,107,78,29,73076.63,27173,100249.63
510776,201703,25,6,19,5622,17803,23425
510777,201703,188,82,106,76805.89,99293.89,176099.78
510779,201703,53,24,29,22479,27109.26,49588.26
510780,201703,295,161,134,150785.26,125467.63,276252.89
510785,201703,447,241,206,225751.78,192928.3,418680.08
510787,201703,173,87,86,81505.32,80564.32,162069.64
510788,201703,0,0,0,0,0,0
510790,201703,2344,1217,1127,1137623.38,1053492.27,2191115.65
510792,201703,1012,568,444,531737.52,415612.64,947350.16
510794,201703,106,52,54,48724,50570.26,99294.26
510795,201703,2326,1336,990,1245822.79,924773.9,2170596.69
510800,201703,167,106,61,99312.63,57148,156460.63
510805,201703,162,113,49,105881,45913,151794
510810,201703,93,36,57,33649.89,53296.93,86946.82
510820,201703,275,129,146,120622.26,135819.71,256441.97
510830,201703,67,41,26,38417,24353,62770
510835,201703,1,0,1,0,937,937
510840,201703,9022,4518,4504,4220253.63,4212456.97,8432710.60
510850,201703,207,88,119,82446.63,111184.79,193631.42
510860,201703,394,172,222,160979.56,207279.05,368258.61
510880,201703,63,48,15,44957.63,14055,59012.63
510885,201703,66,41,25,38398.63,23387.89,61786.52
510890,201703,75,41,34,38417,31858,70275
510895,201703,178,101,77,94637,71845.63,166482.63
520005,201703,21,15,6,14055,5612.63,19667.63
520010,201703,290,125,165,117125,154512,271637
520013,201703,619,360,259,337283.63,242401.9,579685.53
520015,201703,49,35,14,32795,13118,45913
520017,201703,105,59,46,55002,43102,98104
520020,201703,30,15,15,14055,14055,28110
520025,201703,1929,1034,895,968858,837771.7,1806629.7
520030,201703,809,398,411,372917,384161,757078
520050,201703,79,52,27,48724,25299,74023
520055,201703,44,30,14,28110,13118,41228
520060,201703,174,112,62,104944,58094,163038
520080,201703,585,400,185,374800,173340.32,548140.32
520082,201703,20,14,6,13118,5622,18740
520085,201703,100,73,27,68401,25299,93700
520090,201703,79,54,25,50598,23425,74023
520110,201703,8943,3800,5143,3553704.71,4814160.24,8367864.95
520120,201703,13,8,5,7308.6,4685,11993.6
520130,201703,729,518,211,485357,197417,682774
520140,201703,11612,6523,5089,6104857.64,4765321.63,10870179.27
520145,201703,43,33,10,30921,9370,40291
520150,201703,185,145,40,135865,37480,173345
520160,201703,34,22,12,20614,11244,31858
520170,201703,233,141,92,132086,86168,218254
520180,201703,103,50,53,46850,49661,96511
520215,201703,215,128,87,119654.9,81237.9,200892.8
520235,201703,69,52,17,48724,15929,64653
520250,201703,137,83,54,77771,50316.9,128087.9
520260,201703,108,71,37,66527,33732,100259
520280,201703,49,34,15,31203,14055,45258
520310,201703,37,22,15,20614,14055,34669
520320,201703,168,103,65,96511,60905,157416
520330,201703,766,402,364,376637.63,341032,717669.63
520340,201703,361,201,160,188337,149883.63,338220.63
520350,201703,520,229,291,214573,272667,487240
520355,201703,90,49,41,45913,38417,84330
520357,201703,22,15,7,14055,6559,20614
520360,201703,0,0,0,0,0,0
520380,201703,146,76,70,71212,65570,136782
520390,201703,296,126,170,117313,159280.63,276593.63
520393,201703,12,9,3,8433,2811,11244
520396,201703,96,58,38,54346,35606,89952
520400,201703,228,133,95,123029.1,89015,212044.1
520410,201703,195,102,93,95565,87132,182697
520420,201703,24,16,8,14992,7496,22488
520425,201703,302,134,168,124622,156948.6,281570.6
520430,201703,441,228,213,213354.9,199244.9,412599.8
520440,201703,584,383,201,358871,188337,547208
520450,201703,1856,850,1006,795354.63,941967.95,1737322.58
520455,201703,59,39,20,36543,18740,55283
520460,201703,31,16,15,14992,14055,29047
520465,201703,21,18,3,16866,2811,19677
520470,201703,428,262,166,245294,155542,400836
520480,201703,83,46,37,43093,34624,77717
520485,201703,127,41,86,38417,80301,118718
520490,201703,367,275,92,257494.26,86042.84,343537.10
520495,201703,188,108,80,101196,74960,176156
520500,201703,185,140,45,131180,42165,173345
520505,201703,166,86,80,80582,74960,155542
520510,201703,1716,827,889,770596.3,831014.83,1601611.13
520520,201703,45,32,13,29984,12181,42165
520530,201703,239,172,67,158814.89,61993.79,220808.68
520540,201703,485,311,174,290123.81,163038,453161.81
520545,201703,156,85,71,79645,66527,146172
520547,201703,46,25,21,23425,19677,43102
520549,201703,973,456,517,426954,483901,910855
520551,201703,294,157,137,147109,128369,275478
520552,201703,44,24,20,22488,18740,41228
520570,201703,18,10,8,9370,7496,16866
520580,201703,284,174,110,163029,103070,266099
520590,201703,157,90,67,84330,62497.9,146827.9
520620,201703,1114,519,595,485554.14,556662.53,1042216.67
520630,201703,36,20,16,18740,14992,33732
520640,201703,411,235,176,220195,164912,385107
520650,201703,51,36,15,33732,14055,47787
520660,201703,34,18,16,16866,14992,31858
520670,201703,32,26,6,24362,5622,29984
520680,201703,65,42,23,39354,21551,60905
520690,201703,31,13,18,12181,16866,29047
520710,201703,38,35,3,32795,2811,35606
520725,201703,203,126,77,118062,72140,190202
520735,201703,57,46,11,43102,10307,53409
520740,201703,395,194,201,181076.2,188328,369404.2
520750,201703,37,28,9,26236,8433,34669
520753,201703,58,41,17,38417,15929,54346
520760,201703,110,73,37,68401,34669,103070
520780,201703,267,205,62,192085,58094,250179
520790,201703,168,77,91,71867.9,85267,157134.9
520800,201703,3549,1844,1705,1723739.68,1596915.77,3320655.45
520810,201703,164,112,52,104944,48724,153668
520815,201703,6,5,1,4685,937,5622
520830,201703,140,91,49,85267,45913,131180
520840,201703,319,208,111,194380.65,104007,298387.65
520850,201703,108,68,40,63707,37330.08,101037.08
520860,201703,1638,1015,623,949940.87,582065.6,1532006.47
520870,201703,29905,14755,15150,13798278.98,14181398.49,27979677.47
520880,201703,964,541,423,506636,396332.26,902968.26
520890,201703,794,455,339,424742.2,317259.63,742001.83
520910,201703,1025,528,497,491224.31,465689,956913.31
520915,201703,98,74,24,69338,22478.63,91816.63
520920,201703,407,199,208,185900.8,194896,380796.8
520929,201703,24,22,2,20614,1874,22488
520940,201703,76,45,31,42165,29047,71212
520945,201703,23,14,9,13118,8433,21551
520960,201703,50,30,20,28110,18740,46850
520970,201703,327,200,127,186782,118717.9,305499.9
520980,201703,101,74,27,69338,25299,94637
520990,201703,456,307,149,287434.12,139613,427047.12
520993,201703,125,59,66,55283,61833,117116
520995,201703,244,136,108,125794,100634,226428
521000,201703,1545,877,668,820063.3,625542,1445605.3
521010,201703,667,297,370,278049.23,346634.15,624683.38
521015,201703,16,9,7,8433,6559,14992
521020,201703,1471,1009,462,945424,432538.78,1377962.78
521030,201703,38,27,11,25299,10307,35606
521040,201703,894,536,358,501999,335165,837164
521056,201703,41,28,13,26236,12181,38417
521060,201703,133,82,51,76834,47787,124621
521080,201703,498,365,133,341996,124621,466617
521090,201703,523,302,221,282974,206805.27,489779.27
521100,201703,288,210,78,196770,73086,269856
521120,201703,1008,682,326,638472,305181,943653
521130,201703,362,256,106,239872,98732.8,338604.8
521140,201703,189,106,83,99322,77771,177093
521150,201703,2793,1172,1621,1095963.14,1517626.85,2613589.99
521160,201703,31,17,14,15929,13118,29047
521170,201703,194,113,81,105871.63,75897,181768.63
521180,201703,1082,671,411,627500.43,384404.25,1011904.68
521190,201703,2538,1060,1478,993220,1383538.16,2376758.16
521200,201703,44,32,12,29984,11244,41228
521205,201703,16,11,5,10307,4685,14992
521210,201703,156,86,70,80582,65590,146172
521220,201703,803,537,266,500583.78,249187,749770.78
521225,201703,25,15,10,14055,9370,23425
521230,201703,114,72,42,67464,39354,106818
521250,201703,6429,3612,2817,3377382.4,2636379.83,6013762.23
521260,201703,16,12,4,11244,3748,14992
521270,201703,152,116,36,108692,33732,142424
521280,201703,431,245,186,228909.1,174282,403191.1
521290,201703,33,14,19,13118,17803,30921
521295,201703,101,67,34,62273.02,31858,94131.02
521300,201703,224,112,112,104636,104580.89,209216.89
521305,201703,36,24,12,22488,11244,33732
521308,201703,1071,767,304,718178.78,284548.63,1002727.41
521310,201703,1326,774,552,724154.1,516344.26,1240498.36
521340,201703,22,17,5,15929,4685,20614
521350,201703,132,96,36,89952,33732,123684
521370,201703,199,123,76,114314,70930.9,185244.9
521375,201703,195,105,90,98385,84048.9,182433.9
521377,201703,50,33,17,30921,15929,46850
521380,201703,1054,687,367,639927.26,343879,983806.26
521385,201703,20,11,9,10307,8433,18740
521390,201703,108,85,23,79332.7,21551,100883.7
521400,201703,333,203,130,189929.9,121482.15,311412.05
521405,201703,150,73,77,68401,72149,140550
521410,201703,71,48,23,44976,21551,66527
521440,201703,221,155,66,144438.55,61842,206280.55
521450,201703,715,378,337,354186,315113.1,669299.1
521460,201703,1168,695,473,650934,442463.11,1093397.11
521470,201703,16,11,5,10307,4685,14992
521480,201703,57,35,22,32795,20550,53345
521483,201703,290,152,138,142143,129306,271449
521486,201703,299,182,117,170412.19,108974,279386.19
521487,201703,25,12,13,11244,12181,23425
521490,201703,29,17,12,15929,11244,27173
521500,201703,111,72,39,67464,36543,104007
521520,201703,42,31,11,29047,10307,39354
521523,201703,533,325,208,302978.95,194896,497874.95
521525,201703,48,31,17,29047,15929,44976
521530,201703,248,127,121,118999,113377,232376
521540,201703,31,17,14,15929,13118,29047
521550,201703,93,41,52,38117.63,48696.63,86814.26
521560,201703,762,520,242,486780.97,226473,713253.97
521565,201703,44,30,14,28110,13118,41228
521570,201703,480,319,161,298893.63,150764.15,449657.78
521580,201703,62,38,24,35606,22488,58094
521590,201703,36,18,18,16866,16866,33732
521600,201703,28,16,12,14992,11244,26236
521630,201703,229,114,115,106808.63,106781.88,213590.51
521640,201703,295,151,144,141487,134928,276415
521645,201703,30,16,14,14992,13118,28110
521680,201703,228,140,88,131180,82456,213636
521690,201703,1,1,0,937,0,937
521710,201703,1185,553,632,517598.9,591894,1109492.9
521720,201703,522,341,181,319517,169550.26,489067.26
521730,201703,635,315,320,295155,299559,594714
521740,201703,902,347,555,325120.63,518874.33,843994.96
521760,201703,1538,830,708,776160.52,663088,1439248.52
521770,201703,786,495,291,463815,272207.87,736022.87
521800,201703,2056,1234,822,1152808.43,768954.06,1921762.49
521805,201703,33,18,15,16866,14055,30921
521810,201703,95,57,38,52284.9,35606,87890.9
521830,201703,938,648,290,605584.08,271721,877305.08
521839,201703,90,63,27,59031,25299,84330
521850,201703,1091,588,503,549273.26,470972.04,1020245.30
521860,201703,349,214,135,200518,126214,326732
521870,201703,66,36,30,33732,28110,61842
521878,201703,52,22,30,20614,28110,48724
521880,201703,4236,1906,2330,1783694.33,2180275.5,3963969.83
521890,201703,552,377,175,353249,163684.9,516933.9
521900,201703,300,242,58,225848.2,54346,280194.2
521910,201703,150,106,44,99322,41228,140550
521920,201703,56,27,29,25299,27173,52472
521925,201703,36,21,15,19677,14055,33732
521930,201703,1080,613,467,574187.56,436818.46,1011006.02
521935,201703,32,24,8,22488,7496,29984
521940,201703,199,102,97,95574,90607.9,186181.9
521945,201703,16,14,2,13118,1874,14992
521950,201703,7,5,2,4685,1874,6559
521960,201703,73,49,24,45913,22488,68401
521970,201703,408,255,153,238653.9,143361,382014.9
521971,201703,93,47,46,44039,43102,87141
521973,201703,32,14,18,13118,16866,29984
521975,201703,1368,691,677,645838.6,632505.73,1278344.33
521980,201703,239,162,77,151635,72149,223784
521990,201703,72,54,18,50598,16866,67464
522000,201703,291,182,109,170534,102133,272667
522005,201703,22,13,9,12181,8433,20614
522010,201703,1101,608,493,567813.1,461369.43,1029182.53
522015,201703,59,36,23,33723,21551,55274
522020,201703,832,420,412,393540,385088.26,778628.26
522026,201703,28,20,8,18740,7496,26236
522028,201703,15,11,4,10307,3748,14055
522040,201703,711,277,434,259259,406603.63,665862.63
522045,201703,1960,1234,726,1155734.53,679456.9,1835191.43
522050,201703,181,88,93,82456,87141,169597
522060,201703,543,343,200,321109.9,187306.3,508416.2
522068,201703,131,83,48,77771,44976,122747
522070,201703,12,12,0,11244,0,11244
522100,201703,43,22,21,20352,19677,40029
522108,201703,40,30,10,28110,9370,37480
522119,201703,62,30,32,28110,29984,58094
522130,201703,73,23,50,21551,46814,68365
522140,201703,3683,1895,1788,1771922.8,1673511.42,3445434.22
522145,201703,57,34,23,31858,21551,53409
522150,201703,63,50,13,46850,12181,59031
522155,201703,57,40,17,37471,15929,53400
522157,201703,6,4,2,3748,1874,5622
522160,201703,1724,996,728,932127.6,681845.9,1613973.5
522170,201703,396,263,133,246431,124621,371052
522180,201703,38,20,18,18740,16866,35606
522185,201703,1197,480,717,447139.17,671707.88,1118847.05
522190,201703,47,26,21,24362,19583.3,43945.3
522200,201703,301,183,118,171471,110566,282037
522205,201703,164,112,52,104944,48724,153668
522220,201703,177,123,54,115251,50598,165849
522230,201703,32,25,7,23425,6559,29984
530010,201703,53274,27347,25927,25493897.47,24242357.02,49736254.49
110001,201704,502,394,108,367388.88,100361.64,467750.52
110002,201704,2642,1540,1102,1433733.32,1025778.72,2459512.04
110003,201704,87,69,18,64232.45,16745.89,80978.34
110004,201704,1914,1211,703,1126141.83,653795.17,1779937.00
110005,201704,427,347,80,322353.16,74328.43,396681.59
110006,201704,437,337,100,312802.73,92958.79,405761.52
110007,201704,80,65,15,60704.45,13974.89,74679.34
110008,201704,235,136,99,126014.34,92381.9,218396.24
110009,201704,751,500,251,465597.05,233718.15,699315.20
110010,201704,1783,1094,689,1017954.71,642403.33,1660358.04
110011,201704,1865,1427,438,1327468.53,407850.03,1735318.56
110012,201704,3980,2277,1703,2120686.61,1589325.41,3710012.02
110013,201704,714,524,190,487308.29,176726.7,664034.99
110014,201704,362,306,56,285681.23,52247.21,337928.44
110015,201704,1435,1146,289,1065540.41,268449.08,1333989.49
110018,201704,1108,652,456,607031.18,424880.7,1031911.88
110020,201704,14822,8693,6129,8043455.81,5690188.35,13733644.16
110025,201704,592,427,165,396539.07,153852.81,550391.88
110026,201704,43,30,13,27848.9,12060.56,39909.46
110028,201704,1588,1138,450,1055241.61,417036.21,1472277.82
110029,201704,133,115,18,107514.67,16846,124360.67
110030,201704,2428,1626,802,1508437.46,745235.31,2253672.77
110032,201704,376,288,88,268227.71,82191.01,350418.72
110033,201704,630,483,147,445606.22,136431.91,582038.13
110034,201704,363,265,98,244389.16,90568.89,334958.05
110037,201704,100,80,20,74879.78,18719.89,93599.67
110040,201704,320,211,109,196282.82,101351.35,297634.17
110045,201704,887,574,313,533348.33,290419.93,823768.26
110050,201704,95,75,20,69934.78,18679.89,88614.67
110060,201704,87,43,44,40090.89,40787.45,80878.34
110070,201704,129,77,52,71747.35,48121.57,119868.92
110080,201704,386,217,169,200308.25,157054.3,357362.55
110090,201704,28,23,5,21450.56,4644.78,26095.34
110092,201704,102,59,43,55022.01,39939.57,94961.58
110094,201704,192,130,62,120988.57,57572.79,178561.36
110100,201704,26,22,4,20493.78,3727.89,24221.67
110110,201704,68,41,27,38196.56,24797.56,62994.12
110120,201704,71,54,17,50337.56,15828.67,66166.23
110130,201704,294,242,52,224004.6,48423.34,272427.94
110140,201704,245,160,85,149049.96,79154.09,228204.05
110143,201704,43,37,6,34488.45,5561.67,40050.12
110145,201704,27,19,8,17722.89,7476,25198.89
110146,201704,22,12,10,11203.89,9329.89,20533.78
110147,201704,40,31,9,28926.89,8413,37339.89
110148,201704,36,25,11,23232.91,10287,33519.91
110149,201704,282,198,84,184320.94,78225.91,262546.85
110150,201704,80,51,29,47666.89,26892.34,74559.23
110155,201704,9,7,2,6519,1854,8373
110160,201704,71,59,12,54901.24,11163.67,66064.91
110170,201704,210,172,38,160183.67,35365.67,195549.34
110175,201704,25,19,6,17622.12,5601.89,23224.01
110180,201704,90,79,11,73942.78,10266.89,84209.67
120001,201704,126,83,43,76958,40262,117220
120005,201704,183,114,69,106775.12,64466,171241.12
120010,201704,971,639,332,592301.15,308615.52,900916.67
120013,201704,125,84,41,78120.77,37451.74,115572.51
120017,201704,73,49,24,45826.36,22467,68293.36
120020,201704,3404,2707,697,2509494.41,648499.9,3157994.31
120025,201704,616,341,275,317121.12,255932.37,573053.49
120030,201704,1022,848,174,787198.25,162293.12,949491.37
120032,201704,46,38,8,35584.12,7496,43080.12
120033,201704,212,187,25,174877.94,23425,198302.94
120034,201704,147,104,43,95552.12,40247.24,135799.36
120035,201704,25,16,9,14992,8433,23425
120038,201704,378,239,139,223132.2,130199.24,353331.44
120039,201704,19,18,1,16866,937,17803
120040,201704,13628,9426,4202,8706469.3,3894409.18,12600878.48
120042,201704,38,32,6,29984,5622,35606
120043,201704,14,3,11,2811,10286.89,13097.89
120045,201704,526,332,194,309782.18,181513.48,491295.66
120050,201704,1215,925,290,862040.5,270442.56,1132483.06
120060,201704,1350,1083,267,998529.25,246182.46,1244711.71
120070,201704,503,359,144,330294.9,133488.75,463783.65
120080,201704,125,80,45,73871.25,41602.55,115473.80
130002,201704,150,104,46,97448,43102,140550
130006,201704,74,41,33,38417,30921,69338
130008,201704,139,74,65,68617.72,60182.96,128800.68
130010,201704,141,74,67,69338,62779,132117
130014,201704,221,162,59,151794,55283,207077
130020,201704,82,47,35,44039,32795,76834
130030,201704,857,534,323,500358,302641.63,802999.63
130040,201704,322,164,158,153668,147109,300777
130050,201704,544,308,236,288314.9,221132,509446.9
130060,201704,862,589,273,546700.66,252920.58,799621.24
130063,201704,538,286,252,267982,236102.12,504084.12
130068,201704,190,121,69,113377,64371.9,177748.9
130070,201704,1328,923,405,838962.29,369952.22,1208914.51
130080,201704,669,437,232,409094.2,217375,626469.2
130083,201704,68,36,32,33732,29984,63716
130090,201704,391,193,198,179191.88,185526,364717.88
130100,201704,1111,520,591,487240,553485.9,1040725.9
130110,201704,711,305,406,285635,380402,666037
130115,201704,174,72,102,67464,95574,163038
130120,201704,1612,1013,599,949181,561263,1510444
130130,201704,623,422,201,395414,188337,583751
130140,201704,1543,1157,386,1083478.95,360745.1,1444224.05
130150,201704,411,342,69,320454,64653,385107
130160,201704,471,255,216,238935,202392,441327
130165,201704,28,19,9,17803,8433,26236
130170,201704,951,666,285,618387.22,263989.93,882377.15
130180,201704,161,97,64,90420.5,59968,150388.5
130185,201704,2021,1097,924,1025994.89,865205.89,1891200.78
130190,201704,3554,2264,1290,2117620.4,1206950.09,3324570.49
130195,201704,293,235,58,220195,54346,274541
130200,201704,181,80,101,74950.63,94637,169587.63
130210,201704,73,36,37,33732,34669,68401
130220,201704,186,130,56,121810,52472,174282
130230,201704,335,212,123,198644,115251,313895
130240,201704,1473,918,555,858809.98,519749.22,1378559.20
130250,201704,4618,2951,1667,2760568.6,1561824.05,4322392.65
130255,201704,399,212,187,198644,174937.9,373581.9
130260,201704,51248,24252,26996,22691642.45,25286904.26,47978546.71
130270,201704,1436,920,516,861546.82,483451.89,1344998.71
130280,201704,103,63,40,59031,37480,96511
130290,201704,2073,1512,561,1416339.22,525375.9,1941715.12
130300,201704,424,303,121,283629.9,113377,397006.9
130310,201704,915,494,421,462878,394477,857355
130320,201704,442,236,206,220035.71,193022,413057.71
130330,201704,711,435,276,407595,258330.9,665925.9
130340,201704,3175,1956,1219,1829492.7,1141078.7,2970571.4
130350,201704,498,306,192,286599.57,179904,466503.57
130353,201704,733,298,435,278945,407595,686540
130356,201704,714,325,389,304505,364211.9,668716.9
130360,201704,70,42,28,39354,26236,65590
130370,201704,700,502,198,470374,185526,655900
130380,201704,644,429,215,401973,201455,603428
130390,201704,504,398,106,372926,99322,472248
130395,201704,173,42,131,39354,122747,162101
130400,201704,66,46,20,43102,18740,61842
130406,201704,2003,1288,715,1203061.15,669327.16,1872388.31
130410,201704,530,222,308,208014,288596,496610
130420,201704,3206,2536,670,2373421.35,627790,3001211.35
130423,201704,166,76,90,71212,84330,155542
130426,201704,140,81,59,75897,55283,131180
130430,201704,406,268,138,251116,129306,380422
130440,201704,200,73,127,68120,118999,187119
140002,201704,35,15,20,14055,18740,32795
140005,201704,191,117,74,109394.75,69338,178732.75
140010,201704,10198,6835,3363,6375785.45,3146799.82,9522585.27
140015,201704,149,67,82,62779,76834,139613
140017,201704,101,69,32,64653,29984,94637
140020,201704,482,327,155,305462.84,145235,450697.84
140023,201704,20,16,4,14496,3748,18244
140028,201704,13,8,5,7496,4685,12181
140030,201704,354,248,106,232376,98731.69,331107.69
140040,201704,50,35,15,32795,13961.3,46756.3
140045,201704,248,114,134,106162.1,125558,231720.1
140047,201704,518,340,178,315908.52,166036.5,481945.02
140050,201704,156,100,56,92902,52472,145374
140060,201704,31,23,8,20829.51,7496,28325.51
140070,201704,29,27,2,25299,1874,27173
150010,201704,4654,2862,1792,2679023.75,1676721.66,4355745.41
150013,201704,134,90,44,84330,41228,125558
150020,201704,1101,559,542,523783,507854,1031637
150030,201704,756,302,454,282974,425398,708372
150034,201704,183,109,74,102133,69338,171471
150040,201704,1336,799,537,748643,503169,1251812
150050,201704,671,398,273,372644.9,255601,628245.9
150060,201704,4641,3004,1637,2810785.29,1533344.28,4344129.57
150070,201704,304,131,173,122747,162101,284848
150080,201704,14351,7154,7197,6693259.42,6737522.86,13430782.28
150085,201704,346,210,136,196760.63,127432,324192.63
150090,201704,744,630,114,590310,106818,697128
150095,201704,344,210,134,196013.84,124752.18,320766.02
150100,201704,53,37,16,34669,14992,49661
150110,201704,172,83,89,77771,83393,161164
150120,201704,429,316,113,296092,105881,401973
150125,201704,48,20,28,18677.53,26236,44913.53
150130,201704,1855,973,882,911701,826429.32,1738130.32
150140,201704,54382,25307,29075,23680636.03,27228726.45,50909362.48
150145,201704,168,96,72,89952,67464,157416
150150,201704,2701,1129,1572,1057429.85,1469089.7,2526519.55
150157,201704,455,301,154,282037,144293.32,426330.32
150160,201704,108,84,24,78708,22488,101196
150170,201704,3626,2663,963,2492208.65,901112.9,3393321.55
150172,201704,290,199,91,185557.23,85267,270824.23
150175,201704,88,55,33,51535,30921,82456
150178,201704,736,487,249,455382,233313,688695
150180,201704,2900,1356,1544,1269775.8,1446428.86,2716204.66
150190,201704,332,208,124,194896,116188,311084
150195,201704,120,59,61,55283,57157,112440
150200,201704,208,92,116,86204,108692,194896
150210,201704,3090,2502,588,2343334.84,550717.75,2894052.59
150215,201704,482,325,157,304244,147109,451353
150220,201704,4034,2683,1351,2512509.95,1263076.36,3775586.31
150230,201704,1146,910,236,852100.7,221132,1073232.7
150240,201704,5557,3227,2330,3020130.47,2183197,5203327.47
150250,201704,32,14,18,13118,16866,29984
150260,201704,70,41,29,38417,27173,65590
150270,201704,2278,1485,793,1389882.85,742479,2132361.85
150275,201704,596,356,240,333572,224880,558452
150276,201704,101,40,61,37480,57157,94637
150277,201704,755,319,436,298884.63,408532,707416.63
150280,201704,341,203,138,190211,129306,319517
150285,201704,72,35,37,32795,34669,67464
150290,201704,947,569,378,532862.53,353905,886767.53
150293,201704,698,315,383,294733.63,358871,653604.63
150295,201704,454,192,262,179904,245362.82,425266.82
150300,201704,79,43,36,40291,33732,74023
150304,201704,139,89,50,83393,46850,130243
150307,201704,389,316,73,296092,68401,364493
150309,201704,504,356,148,333572,138676,472248
150310,201704,255,172,83,161164,77771,238935
150320,201704,1800,1240,560,1161603.59,524720,1686323.59
150330,201704,2053,1164,889,1090012.1,832993,1923005.1
150340,201704,192,124,68,115953.75,63716,179669.75
150345,201704,613,323,290,302472.97,271730,574202.97
150350,201704,423,331,92,307795.13,86204,393999.13
150360,201704,4340,2793,1547,2614355.74,1449529.63,4063885.37
150370,201704,719,505,214,472521,200227.9,672748.9
150375,201704,193,105,88,98385,82456,180841
150380,201704,1182,756,426,708372,398132,1106504
150390,201704,723,413,310,386981,290461,677442
150400,201704,93,74,19,69338,17803,87141
150405,201704,1252,826,426,772937.86,398599.8,1171537.66
150410,201704,146,93,53,87141,49661,136802
150420,201704,7020,3812,3208,3570194.44,3004695.12,6574889.56
150430,201704,467,314,153,294218,143361,437579
150440,201704,596,350,246,327201,230221,557422
150442,201704,2020,1097,923,1026118.07,864851,1890969.07
150445,201704,510,317,193,297029,179904,476933
150450,201704,276,127,149,118999,139613,258612
150460,201704,783,592,191,552628.66,178948.26,731576.92
150470,201704,1330,787,543,737138,508791,1245929
150475,201704,25,20,5,18740,4685,23425
150480,201704,1229,851,378,797387,354186,1151573
150490,201704,614,318,296,297966,277352,575318
150495,201704,321,216,105,202392,98385,300777
150497,201704,298,204,94,191148,88068.63,279216.63
150500,201704,432,293,139,274541,130243,404784
150503,201704,749,356,393,333291,368223,701514
150506,201704,1035,651,384,609987,359798.63,969785.63
150510,201704,1206,687,519,643438,486303,1129741
150520,201704,258,171,87,160227,81519,241746
150530,201704,1495,821,674,765623.45,631257,1396880.45
150540,201704,241,167,74,156479,69338,225817
150543,201704,647,362,285,338894.16,266763.9,605658.06
150548,201704,491,324,167,303588,156479,460067
150549,201704,57,38,19,35606,17803,53409
150550,201704,2874,1482,1392,1387932,1303742,2691674
150553,201704,2925,1745,1180,1634503,1105379,2739882
150555,201704,143,73,70,68401,65590,133991
150560,201704,52,39,13,36543,12181,48724
150563,201704,62,32,30,29984,28110,58094
150565,201704,161,92,69,86204,64653,150857
150570,201704,397,263,134,246412.26,125558,371970.26
150580,201704,1477,582,895,544678.1,838615,1383293.1
150590,201704,818,479,339,448823,317643,766466
150600,201704,444,271,173,253927,162101,416028
150610,201704,137,118,19,109733,17803,127536
150611,201704,132,89,43,83393,40291,123684
150613,201704,3092,1884,1208,1765304,1131878,2897182
150616,201704,476,292,184,273369.75,172408,445777.75
150618,201704,1113,604,509,565723.49,476933,1042656.49
150619,201704,406,305,101,285785,94637,380422
150620,201704,1265,721,544,675577,509728,1185305
150630,201704,313,209,104,195833,97448,293281
150635,201704,496,198,298,185526,279130.98,464656.98
150640,201704,63,31,32,29047,29984,59031
150650,201704,2270,1292,978,1210332.27,915167.9,2125500.17
150655,201704,254,188,66,176156,61842,237998
150658,201704,98,55,43,51535,40291,91826
150660,201704,473,327,146,306399,136802,443201
150670,201704,969,332,637,310793.9,596850.63,907644.53
150680,201704,9508,5233,4275,4899359.86,4002819.16,8902179.02
150690,201704,50,31,19,29047,17803,46850
150700,201704,559,360,199,337132.6,186463,523595.6
150710,201704,249,154,95,144298,89015,233313
150715,201704,875,520,355,486275.26,332606.89,818882.15
150720,201704,451,337,114,315769,106536.9,422305.9
150730,201704,851,451,400,422578,374518.9,797096.9
150740,201704,248,174,74,163038,69338,232376
150745,201704,776,389,387,364493,362619,727112
150746,201704,54,33,21,30921,19677,50598
150747,201704,274,211,63,197707,59031,256738
150750,201704,119,69,50,64653,46850,111503
150760,201704,1702,1088,614,1019175,575318,1594493
150770,201704,353,180,173,168660,161929.07,330589.07
150775,201704,82,39,43,36543,40291,76834
150780,201704,178,91,87,85267,81519,166786
150790,201704,902,476,426,446012,399162,845174
150795,201704,1395,798,597,747726,559389,1307115
150796,201704,414,237,177,222069,165849,387918
150797,201704,267,156,111,146172,104007,250179
150800,201704,1394,838,556,784264.31,520690.9,1304955.21
150803,201704,587,485,102,454445,95574,550019
150805,201704,187,117,70,109629,65576.63,175205.63
150808,201704,932,506,426,474122,399162,873284
150810,201704,3361,2296,1065,2146331.63,997605.26,3143936.89
150812,201704,420,222,198,208014,185526,393540
150815,201704,911,601,310,561783.04,290470,852253.04
150820,201704,1602,975,627,912638,587480.26,1500118.26
150830,201704,841,589,252,550956,236124,787080
150835,201704,169,97,72,90889,67464,158353
150840,201704,1264,810,454,758970,425398,1184368
160005,201704,48,29,19,27173,17803,44976
160010,201704,198,124,74,116188,69334,185522
160015,201704,115,67,48,62779,44976,107755
160020,201704,115,66,49,61842,45913,107755
160021,201704,40,21,19,19677,17803,37480
160023,201704,106,58,48,54346,44976,99322
160025,201704,33,14,19,13118,17803,30921
160027,201704,1413,791,622,737701.1,582077,1319778.1
160030,201704,15018,7634,7384,7144826,6911326.15,14056152.15
160040,201704,312,176,136,164912,127432,292344
160050,201704,616,315,301,295155,281755.9,576910.9
160053,201704,344,188,156,175875,146172,322047
160055,201704,18,13,5,12181,4685,16866
160060,201704,6252,3244,3008,3026884.1,2817555.1,5844439.2
160070,201704,157,94,63,88078,59031,147109
160080,201704,76,38,38,35606,35606,71212
170025,201704,24,16,8,14992,7496,22488
170030,201704,225,177,48,165655,44976,210631
170035,201704,234,107,127,99322,118999,218321
170040,201704,184,144,40,134646.9,37480,172126.9
170070,201704,341,193,148,180841,138676,319517
170100,201704,381,267,114,249945,106818,356763
170105,201704,62,51,11,47787,10307,58094
170110,201704,98,59,39,55283,36543,91826
170130,201704,70,31,39,29047,36262,65309
170190,201704,110,68,42,63716,39354,103070
170200,201704,400,266,134,248296.1,125455.78,373751.88
170210,201704,5896,3011,2885,2816455.21,2700041.33,5516496.54
170215,201704,66,30,36,28110,33732,61842
170220,201704,1445,1047,398,978958.86,372457.6,1351416.46
170230,201704,156,100,56,93700,52472,146172
170240,201704,587,384,203,359808,190211,550019
170255,201704,1119,887,232,831119,217102.9,1048221.9
170270,201704,38,27,11,25299,10025.9,35324.9
170290,201704,65,47,18,44039,16866,60905
170300,201704,78,49,29,45163.4,27173,72336.4
170305,201704,36,28,8,26236,7496,33732
170307,201704,58,41,17,38417,15929,54346
170310,201704,96,51,45,47787,42165,89952
170320,201704,17,13,4,12181,3748,15929
170330,201704,18,15,3,14055,2811,16866
170360,201704,22,14,8,13118,7496,20614
170370,201704,170,80,90,74960,84330,159290
170380,201704,80,55,25,51535,23425,74960
170382,201704,49,43,6,40291,5622,45913
170384,201704,123,86,37,80582,34669,115251
170386,201704,57,27,30,25299,28110,53409
170388,201704,46,17,29,15929,27173,43102
170389,201704,23,17,6,15929,5622,21551
170390,201704,50,30,20,28110,18740,46850
170410,201704,35,24,11,22488,10307,32795
170460,201704,17,12,5,11244,4685,15929
170510,201704,26,18,8,16866,7496,24362
170550,201704,1442,805,637,754265,596119.5,1350384.5
170555,201704,111,74,37,69338,34388,103726
170560,201704,100,71,29,66527,27173,93700
170600,201704,36,18,18,16866,16866,33732
170610,201704,193,103,90,96356.4,84312,180668.4
170625,201704,37,17,20,15929,18740,34669
170650,201704,81,59,22,55283,20614,75897
170700,201704,550,417,133,388808.15,123824.55,512632.70
170710,201704,155,95,60,89015,56211,145226
170720,201704,78,65,13,60905,12181,73086
170730,201704,56,33,23,30921,21551,52472
170740,201704,65,48,17,44976,15929,60905
170755,201704,116,52,64,48114.95,59968,108082.95
170765,201704,150,67,83,62170,77771,139941
170770,201704,235,130,105,121013.55,98385,219398.55
170820,201704,590,380,210,356060,196349,552409
170825,201704,32,19,13,17803,12181,29984
170830,201704,72,49,23,45725.6,21551,67276.6
170900,201704,209,158,51,148046,47787,195833
170930,201704,769,382,387,357616,362338,719954
170950,201704,2931,1262,1669,1180180.88,1561585.93,2741766.81
170980,201704,16,9,7,8433,6559,14992
171050,201704,124,95,29,89015,27173,116188
171070,201704,32,25,7,23425,6559,29984
171090,201704,35,24,11,22488,10307,32795
171110,201704,21,14,7,13118,6559,19677
171150,201704,37,18,19,16866,17803,34669
171180,201704,21,10,11,9370,10307,19677
171190,201704,124,69,55,64653,51535,116188
171195,201704,62,47,15,44039,14055,58094
171200,201704,45,19,26,17803,24362,42165
171215,201704,1,1,0,937,0,937
171240,201704,52,42,10,39354,9370,48724
171245,201704,51,46,5,43102,4685,47787
171250,201704,67,32,35,29984,32785.63,62769.63
171270,201704,16,12,4,11244,3748,14992
171280,201704,35,32,3,29844,2811,32655
171320,201704,976,546,430,511602,401973,913575
171330,201704,404,191,213,178967,199581,378548
171360,201704,81,60,21,56220,19677,75897
171370,201704,22,11,11,10307,10307,20614
171380,201704,125,102,23,95574,21325.19,116899.19
171395,201704,52,31,21,29047,19677,48724
171420,201704,322,211,111,197707,103725.9,301432.9
171430,201704,59,48,11,44336,10307,54643
171488,201704,208,107,101,100259,94637,194896
171500,201704,59,32,27,29984,25299,55283
171510,201704,61,40,21,37480,19677,57157
171515,201704,44,37,7,34669,6559,41228
171525,201704,30,26,4,24362,3748,28110
171550,201704,11,5,6,4685,5622,10307
171570,201704,57,28,29,26236,27173,53409
171575,201704,357,210,147,196630,137729.63,334359.63
171610,201704,1613,789,824,737427.83,770512.47,1507940.30
171620,201704,124,84,40,78164.54,37198.9,115363.44
171630,201704,54,28,26,26236,24362,50598
171650,201704,281,176,105,164912,98385,263297
171660,201704,256,137,119,128369,111503,239872
171665,201704,41,25,16,23425,14992,38417
171670,201704,428,245,183,227915.98,170908.8,398824.78
171700,201704,59,53,6,49661,5622,55283
171720,201704,24,9,15,8433,14055,22488
171750,201704,95,52,43,48724,40291,89015
171780,201704,70,57,13,53409,12181,65590
171790,201704,79,64,15,59968,14055,74023
171800,201704,33,25,8,23425,7496,30921
171820,201704,1917,1084,833,1015011.47,774892.31,1789903.78
171830,201704,36,27,9,25299,8433,33732
171840,201704,55,30,25,28110,23425,51535
171845,201704,31,19,12,17803,11244,29047
171850,201704,36,24,12,22488,11244,33732
171855,201704,70,55,15,51535,14055,65590
171865,201704,9,6,3,5622,2811,8433
171870,201704,31,22,9,20614,8433,29047
171875,201704,77,52,25,48724,23425,72149
171880,201704,25,18,7,16866,6559,23425
171884,201704,40,19,21,17803,19677,37480
171886,201704,110,40,70,37480,65308.9,102788.9
171888,201704,21,14,7,13118,6559,19677
171889,201704,22,15,7,14055,6559,20614
171890,201704,57,46,11,43102,10307,53409
171900,201704,42,29,13,27173,12181,39354
172000,201704,39,32,7,29984,6559,36543
172010,201704,38,31,7,28250.55,6559,34809.55
172015,201704,27,16,11,14992,10025.9,25017.9
172020,201704,122,76,46,71212,43102,114314
172025,201704,33,20,13,18740,12181,30921
172030,201704,31,19,12,17803,11244,29047
172049,201704,72,44,28,41228,26236,67464
172065,201704,153,99,54,92763,50598,143361
172080,201704,70,52,18,47563.02,16866,64429.02
172085,201704,23,10,13,9370,12181,21551
172090,201704,409,308,101,288596,93888,382484
172093,201704,28,18,10,16866,9370,26236
172097,201704,18,9,9,8433,8152,16585
172100,201704,4444,2444,2000,2284617.67,1871278.93,4155896.60
172110,201704,78,51,27,47787,25299,73086
172120,201704,1731,1484,247,1386360,230351.14,1616711.14
172125,201704,2,2,0,1874,0,1874
172130,201704,12,10,2,9370,1874,11244
172208,201704,185,118,67,110566,62779,173345
172210,201704,489,227,262,212699,245213,457912
210005,201704,2926,1806,1120,1688942.86,1046911,2735853.86
210010,201704,206,100,106,93700,99322,193022
210015,201704,21,13,8,12181,7496,19677
210020,201704,337,172,165,161164,154605,315769
210030,201704,348,213,135,199581,126486,326067
210040,201704,158,122,36,114314,33732,148046
210043,201704,254,165,89,154605,83393,237998
210047,201704,632,302,330,282599.2,309200.63,591799.83
210050,201704,300,217,83,203329,77771,281100
210055,201704,42,32,10,29984,9370,39354
210060,201704,576,431,145,403749.56,135865,539614.56
210070,201704,417,297,120,278289,112158.9,390447.9
210080,201704,100,92,8,86204,7496,93700
210083,201704,313,124,189,116188,177093,293281
210087,201704,51,33,18,30921,16866,47787
210090,201704,497,339,158,317643,148046,465689
210095,201704,506,347,159,325139,148983,474122
210100,201704,679,506,173,473794.05,161164.35,634958.40
210110,201704,157,82,75,76834,70275,147109
210120,201704,5614,4141,1473,3875453.3,1379231.14,5254684.44
210125,201704,220,113,107,105881,100259,206140
210130,201704,569,280,289,261423,270793,532216
210135,201704,34,20,14,18740,13118,31858
210140,201704,3958,3049,909,2853774.22,851562,3705336.22
210150,201704,354,221,133,207077,124448,331525
210160,201704,3298,2739,559,2563634.68,523502,3087136.68
210170,201704,1099,840,259,787080,242683,1029763
210173,201704,110,90,20,84330,18740,103070
210177,201704,510,237,273,222069,255801,477870
210180,201704,27,14,13,13118,12181,25299
210190,201704,403,252,151,236124,141487,377611
210193,201704,0,0,0,0,0,0
210197,201704,88,57,31,53409,29030,82439
210200,201704,640,498,142,466626,133054,599680
210203,201704,272,174,98,163038,91826,254864
210207,201704,377,284,93,266108,87141,353249
210210,201704,766,693,73,649341,68401,717742
210215,201704,75,62,13,58094,12181,70275
210220,201704,405,330,75,309210,70275,379485
210230,201704,308,219,89,205203,83393,288596
210232,201704,1524,924,600,865507,562200,1427707
210235,201704,154,117,37,109442,34669,144111
210237,201704,44,24,20,22488,18740,41228
210240,201704,93,75,18,70275,16866,87141
210250,201704,174,133,41,124621,38417,163038
210255,201704,298,213,85,199581,79645,279226
210260,201704,438,253,185,237061,173345,410406
210270,201704,729,446,283,417902,265171,683073
210275,201704,40,32,8,29984,7496,37480
210280,201704,1019,641,378,597599.45,352874.25,950473.70
210290,201704,492,301,191,282037,178967,461004
210300,201704,6280,3557,2723,3327138.33,2550262.37,5877400.70
210310,201704,101,68,33,63716,30921,94637
210312,201704,128,77,51,72149,47787,119936
210315,201704,118,83,35,77771,32795,110566
210317,201704,119,81,38,75897,35606,111503
210320,201704,2391,1933,458,1810478.98,428209,2238687.98
210325,201704,128,87,41,80582,38136,118718
210330,201704,6001,2881,3120,2696297.7,2923430.63,5619728.33
210340,201704,1460,1020,440,954954,412209.85,1367163.85
210350,201704,603,482,121,451399.75,113377,564776.75
210355,201704,121,94,27,88078,25299,113377
210360,201704,2746,1678,1068,1569195.9,1000716,2569911.9
210370,201704,1277,523,754,490051,705842.1,1195893.1
210375,201704,196,100,96,93166,89952,183118
210380,201704,730,545,185,510665,173325,683990
210390,201704,194,160,34,149920,31858,181778
210400,201704,417,344,73,322328,68401,390729
210405,201704,973,632,341,591590.87,319517,911107.87
210407,201704,55,43,12,40291,11244,51535
210408,201704,67,60,7,56220,6559,62779
210409,201704,316,259,57,242683,52707,295390
210410,201704,440,334,106,312958,99313,412271
210420,201704,194,158,36,148046,33732,181778
210430,201704,34,26,8,24362,7496,31858
210440,201704,388,226,162,211762,150857,362619
210450,201704,147,108,39,101196,36543,137739
210455,201704,200,107,93,100259,87141,187400
210460,201704,343,215,128,201455,119936,321391
210462,201704,53,45,8,42165,7496,49661
210465,201704,190,131,59,122747,55283,178030
210467,201704,505,356,149,333572,139613,473185
210470,201704,39,28,11,26236,10307,36543
210480,201704,1276,884,392,828308,367304,1195612
210490,201704,220,128,92,119936,86204,206140
210500,201704,547,283,264,265171,247368,512539
210510,201704,547,414,133,387918,124621,512539
210515,201704,457,232,225,217384,210825,428209
210520,201704,399,345,54,322983.9,50598,373581.9
210530,201704,9204,4913,4291,4588868.79,4015140.8,8604009.59
210535,201704,140,96,44,89952,41228,131180
210540,201704,1561,899,662,841239.4,618888.5,1460127.9
210542,201704,1144,587,557,549504.2,521909,1071413.2
210545,201704,12,11,1,10307,937,11244
210547,201704,134,114,20,106818,18740,125558
210550,201704,759,514,245,480546.9,229283.9,709830.8
210560,201704,173,142,31,133054,29047,162101
210565,201704,29,20,9,18740,8433,27173
210570,201704,1398,1071,327,1003527,306389.63,1309916.63
210580,201704,106,91,15,85267,14055,99322
210590,201704,785,595,190,556765.4,178030,734795.4
210592,201704,36,31,5,29047,4685,33732
210594,201704,94,80,14,74960,13118,88078
210596,201704,75,63,12,59031,11244,70275
210598,201704,123,88,35,82456,32795,115251
210600,201704,356,297,59,278289,55283,333572
210610,201704,242,225,17,209888,15929,225817
210620,201704,49,28,21,26236,19677,45913
210630,201704,58,54,4,50598,3748,54346
210632,201704,1154,723,431,677451,403097.4,1080548.4
210635,201704,14,12,2,11244,1874,13118
210637,201704,102,73,29,68401,27173,95574
210640,201704,586,500,86,468500,80582,549082
210650,201704,400,319,81,298715.6,74960,373675.6
210660,201704,397,279,118,261423,110566,371989
210663,201704,18,13,5,12181,4685,16866
210667,201704,119,35,84,32795,78708,111503
210670,201704,266,235,31,219493,29047,248540
210675,201704,580,288,292,269856,273604,543460
210680,201704,225,135,90,126495,84330,210825
210690,201704,640,493,147,461941,137739,599680
210700,201704,190,136,54,127432,50598,178030
210710,201704,308,169,139,158353,130243,288596
210720,201704,123,102,21,95574,19677,115251
210725,201704,62,56,6,52472,5622,58094
210730,201704,23,17,6,15929,5622,21551
210735,201704,404,260,144,243620,134647,378267
210740,201704,540,456,84,427272,78708,505980
210745,201704,150,102,48,95574,44976,140550
210750,201704,2449,1051,1398,983724,1309907.26,2293631.26
210760,201704,287,198,89,185526,83378.95,268904.95
210770,201704,404,311,93,290470,86859.9,377329.9
210780,201704,418,294,124,275478,115251.45,390729.45
210790,201704,185,141,44,132117,41228,173345
210800,201704,127,94,33,88078,30921,118999
210805,201704,38,35,3,32795,2811,35606
210810,201704,492,365,127,341349.1,118999,460348.1
210820,201704,2335,1805,530,1683032.39,496610,2179642.39
210825,201704,178,89,89,83393,83393,166786
210830,201704,827,482,345,450697,322328,773025
210840,201704,216,138,78,129306,73086,202392
210845,201704,254,146,108,136802,101196,237998
210850,201704,899,562,337,526281.7,315769,842050.7
210860,201704,4217,2071,2146,1939590,2010781.89,3950371.89
210870,201704,468,342,126,320454,118062,438516
210880,201704,55,37,18,34669,16866,51535
210890,201704,343,279,64,261423,59968,321391
210900,201704,512,313,199,293281,186463,479744
210905,201704,80,34,46,31858,43102,74960
210910,201704,2016,1457,559,1364155.18,523783,1887938.18
210920,201704,258,69,189,64653,177093,241746
210923,201704,73,55,18,51535,16866,68401
210927,201704,449,168,281,157416,263297,420713
210930,201704,59,45,14,42165,13118,55283
210940,201704,97,69,28,64653,26236,90889
210945,201704,200,87,113,81519,105881,187400
210950,201704,511,365,146,342005,136797.32,478802.32
210955,201704,80,54,26,50598,24362,74960
210960,201704,2493,976,1517,912919.7,1421148,2334067.7
210970,201704,109,92,17,86204,15929,102133
210975,201704,81,73,8,68401,7496,75897
210980,201704,1300,538,762,503993.56,713713,1217706.56
210990,201704,4507,2700,1807,2529619,1693139,4222758
211000,201704,1410,1074,336,1006037,314550.9,1320587.9
211003,201704,927,621,306,581877,286713,868590
211010,201704,480,417,63,390729,59031,449760
211020,201704,1683,562,1121,526594,1049958.85,1576552.85
211023,201704,21,18,3,16584.9,2811,19395.9
211027,201704,59,39,20,36543,18740,55283
211030,201704,389,248,141,232376,132117,364493
211040,201704,314,229,85,214292,79645,293937
211050,201704,1189,723,466,677451,436356.32,1113807.32
211060,201704,687,581,106,544397,99322,643719
211065,201704,24,20,4,18740,3748,22488
211070,201704,912,728,184,680272.26,172408,852680.26
211080,201704,90,85,5,79645,4685,84330
211085,201704,61,31,30,28766,28110,56876
211090,201704,97,79,18,74023,16866,90889
211100,201704,509,403,106,377611,99322,476933
211102,201704,276,175,101,163975,94637,258612
211105,201704,208,139,69,130243,64653,194896
211107,201704,122,68,54,63716,50598,114314
211110,201704,815,524,291,490426,272658,763084
211120,201704,5845,2283,3562,2134786.38,3335585.92,5470372.30
211125,201704,35,29,6,27173,5622,32795
211130,201704,46566,18595,27971,17392852.55,26196109.05,43588961.60
211140,201704,452,375,77,351371,71868,423239
211150,201704,1235,750,485,702750,454160,1156910
211153,201704,184,100,84,93700,78708,172408
211157,201704,52,37,15,34669,14055,48724
211160,201704,686,556,130,520023.25,121810,641833.25
211163,201704,0,0,0,0,0,0
211167,201704,5,4,1,3748,937,4685
211170,201704,455,307,148,287659,138676,426335
211172,201704,120,77,43,72149,40291,112440
211174,201704,295,168,127,157416,118999,276415
211176,201704,532,369,163,345753,152731,498484
211178,201704,91,58,33,54346,30921,85267
211180,201704,214,164,50,153668,46690.71,200358.71
211190,201704,61,56,5,52472,4685,57157
211195,201704,19,11,8,10307,7496,17803
211200,201704,158,137,21,128031.68,19677,147708.68
211210,201704,660,314,346,293562.1,324202,617764.1
211220,201704,3876,2162,1714,2020360.71,1598626.22,3618986.93
211223,201704,94,88,6,82277.97,5622,87899.97
211227,201704,67,43,24,40291,22488,62779
211230,201704,798,639,159,598602.45,148964.26,747566.71
211240,201704,421,304,117,284848,109629,394477
211245,201704,209,84,125,78708,117125,195833
211250,201704,1662,1400,262,1310954,245494,1556448
211260,201704,813,629,184,589373,172408,761781
211270,201704,2137,1637,500,1533869,467563.1,2001432.1
211280,201704,1857,1071,786,1001654.08,736482,1738136.08
211285,201704,221,121,100,113377,93418.9,206795.9
211290,201704,700,457,243,428021.6,227691,655712.6
211300,201704,819,610,209,571315.7,195833,767148.7
211400,201704,1669,900,769,843300,720553,1563853
220005,201704,20,18,2,16866,1874,18740
220010,201704,90,68,22,63716,20332.9,84048.9
220020,201704,524,411,113,384513.6,105881,490394.6
220025,201704,107,103,4,96511,3748,100259
220027,201704,41,33,8,30921,7496,38417
220030,201704,85,70,15,65590,14055,79645
220040,201704,1081,802,279,750537,261423,1011960
220045,201704,36,28,8,26236,7496,33732
220050,201704,635,510,125,476728.88,117106.26,593835.14
220060,201704,172,144,28,134928,26236,161164
220070,201704,135,123,12,115251,11244,126495
220080,201704,6,5,1,4685,937,5622
220090,201704,32,25,7,23144,6559,29703
220095,201704,3,2,1,1874,937,2811
220100,201704,28,24,4,22488,3748,26236
220105,201704,40,37,3,34669,2811,37480
220110,201704,200,185,15,173063.9,14055,187118.9
220115,201704,40,37,3,34669,2811,37480
220117,201704,19,19,0,17803,0,17803
220120,201704,1526,1028,498,963386.85,466626,1430012.85
220130,201704,24,23,1,21551,937,22488
220140,201704,102,83,19,76834,17803,94637
220150,201704,436,304,132,284848,123684,408532
220155,201704,4,4,0,3748,0,3748
220157,201704,20,16,4,14992,3748,18740
220160,201704,70,62,8,58094,7496,65590
220170,201704,33,31,2,29047,1874,30921
220173,201704,7,7,0,6559,0,6559
220177,201704,5,5,0,4685,0,4685
220180,201704,68,67,1,62770.32,937,63707.32
220190,201704,1033,930,103,871410,95761.4,967171.4
220191,201704,47,42,5,39354,4685,44039
220192,201704,67,64,3,59968,2811,62779
220194,201704,20,17,3,15929,2811,18740
220196,201704,105,88,17,82316,15929,98245
220198,201704,6,4,2,3748,1874,5622
220200,201704,429,341,88,320238,82456,402694
220202,201704,35,31,4,29047,3748,32795
220205,201704,38,32,6,29984,5622,35606
220207,201704,18,17,1,15929,937,16866
220208,201704,81,41,40,38417,37480,75897
220209,201704,32,29,3,27173,2811,29984
220210,201704,17,16,1,14992,937,15929
220211,201704,46,45,1,42165,937,43102
220213,201704,45,39,6,36543,5622,42165
220217,201704,38,30,8,28110,7496,35606
220220,201704,1930,1240,690,1158198.49,645293.76,1803492.25
220225,201704,13,6,7,5622,6559,12181
220230,201704,903,721,182,675136.61,169906.21,845042.82
220240,201704,138,125,13,117125,12181,129306
220245,201704,52,48,4,44598,3748,48346
220250,201704,137,121,16,113377,14992,128369
220253,201704,43,34,9,31858,8433,40291
220255,201704,27,23,4,21551,3748,25299
220260,201704,689,504,185,472248,173345,645593
220265,201704,15,11,4,10307,3748,14055
220270,201704,623,551,72,515574.88,66995.5,582570.38
220271,201704,45,35,10,32795,9370,42165
220272,201704,27,26,1,24362,937,25299
220273,201704,16,13,3,12181,2811,14992
220275,201704,48,37,11,34669,10307,44976
220277,201704,8,8,0,7496,0,7496
220280,201704,21,19,2,17803,1874,19677
220285,201704,54,50,4,46850,3748,50598
220290,201704,1378,1174,204,1097556,191102,1288658
220300,201704,59,57,2,53409,1874,55283
220310,201704,300,252,48,235982.27,44967,280949.27
220320,201704,439,404,35,377143.5,32795,409938.5
220323,201704,0,0,0,0,0,0
220325,201704,13,8,5,7496,4685,12181
220327,201704,12,11,1,10307,937,11244
220330,201704,180,118,62,110284.9,58094,168378.9
220335,201704,137,121,16,113358.26,14992,128350.26
220340,201704,24,12,12,11244,11244,22488
220342,201704,51,44,7,41228,6559,47787
220345,201704,120,106,14,99322,13118,112440
220350,201704,439,388,51,360980.01,47787,408767.01
220360,201704,40,31,9,29047,8433,37480
220370,201704,1022,810,212,758220.4,198644,956864.4
220375,201704,26,25,1,23425,937,24362
220380,201704,34,26,8,24362,7496,31858
220385,201704,29,24,5,22488,4685,27173
220390,201704,2177,1245,932,1161955.2,870989.41,2032944.61
220400,201704,28,27,1,25299,937,26236
220410,201704,17,14,3,13118,2811,15929
220415,201704,13,12,1,11244,937,12181
220420,201704,130,108,22,101196,20332.9,121528.9
220430,201704,129,117,12,107990.4,11244,119234.4
220435,201704,26,19,7,17799,6559,24358
220440,201704,291,250,41,234250,38417,272667
220450,201704,303,162,141,150649.74,132117,282766.74
220455,201704,61,59,2,55283,1874,57157
220460,201704,22,21,1,19021.1,937,19958.1
220465,201704,100,65,35,60905,32795,93700
220470,201704,234,202,32,188337.8,29984,218321.8
220480,201704,69,57,12,53409,11244,64653
220490,201704,83,72,11,66707,10307,77014
220500,201704,97,83,14,77771,13118,90889
220510,201704,377,302,75,282225,70087.6,352312.6
220515,201704,20,16,4,14992,3748,18740
220520,201704,356,316,40,294409,37462,331871
220525,201704,27,19,8,17803,7496,25299
220527,201704,38,32,6,29188,5622,34810
220530,201704,34,13,21,12181,19677,31858
220535,201704,12,11,1,10307,937,11244
220540,201704,59,46,13,43102,12181,55283
220545,201704,67,44,23,41228,21551,62779
220550,201704,616,465,151,435705,141487,577192
220551,201704,25,19,6,17803,5622,23425
220552,201704,8,8,0,7496,0,7496
220553,201704,64,58,6,54346,5622,59968
220554,201704,15,9,6,8151.9,5622,13773.9
220555,201704,26,22,4,20614,3748,24362
220556,201704,61,57,4,53409,3748,57157
220557,201704,53,47,6,44039,5622,49661
220558,201704,7,2,5,1874,4685,6559
220559,201704,6,5,1,4685,937,5622
220560,201704,53,36,17,33544.6,15929,49473.6
220570,201704,744,436,308,408286.14,288596,696882.14
220580,201704,594,536,58,502232,53391.26,555623.26
220585,201704,5,4,1,3748,937,4685
220590,201704,14,14,0,13118,0,13118
220595,201704,60,45,15,42165,14055,56220
220600,201704,20,10,10,9370,9370,18740
220605,201704,21,20,1,18740,937,19677
220610,201704,55,48,7,44976,6559,51535
220620,201704,546,418,128,390495.04,119936,510431.04
220630,201704,9,7,2,6559,1874,8433
220635,201704,35,31,4,29047,3748,32795
220640,201704,97,71,26,66527,24362,90889
220650,201704,112,106,6,99322,5622,104944
220660,201704,25,19,6,17803,5622,23425
220665,201704,5,4,1,3748,937,4685
220667,201704,11,11,0,10307,0,10307
220669,201704,19,18,1,16866,937,17803
220670,201704,62,48,14,44788.6,13118,57906.6
220672,201704,46,30,16,28110,14710.9,42820.9
220675,201704,34,26,8,24362,7496,31858
220680,201704,33,29,4,27173,3748,30921
220690,201704,48,44,4,41228,3748,44976
220695,201704,68,30,38,28110,35606,63716
220700,201704,1420,1078,342,1008043.59,320173,1328216.59
220710,201704,4,2,2,1874,1874,3748
220720,201704,122,98,24,91591.75,22347.45,113939.20
220730,201704,20,20,0,18740,0,18740
220735,201704,4,2,2,1874,1874,3748
220740,201704,39,37,2,34669,1874,36543
220750,201704,96,77,19,72149,17803,89952
220755,201704,17,17,0,15929,0,15929
220760,201704,43,40,3,37480,2811,40291
220770,201704,5568,2727,2841,2549706.52,2656270.18,5205976.70
220775,201704,26,12,14,11244,13118,24362
220777,201704,11,11,0,10307,0,10307
220779,201704,14,11,3,10307,2811,13118
220780,201704,838,713,125,667425.1,116844,784269.1
220785,201704,4,3,1,2811,937,3748
220790,201704,981,774,207,722897.34,193959,916856.34
220793,201704,15,15,0,14055,0,14055
220795,201704,26,25,1,23425,937,24362
220800,201704,3746,2842,904,2661638.56,846097.74,3507736.30
220810,201704,51,47,4,44039,3748,47787
220820,201704,234,212,22,198644,20614,219258
220830,201704,1106,927,179,868594.32,167723,1036317.32
220840,201704,2347,1538,809,1430111.68,755691,2185802.68
220850,201704,51,39,12,36543,11244,47787
220855,201704,15,10,5,9370,4685,14055
220860,201704,12,11,1,10307,937,11244
220865,201704,20,18,2,16866,1874,18740
220870,201704,58,54,4,50598,3748,54346
220880,201704,336,253,83,236405.1,77490,313895.1
220885,201704,45,40,5,37480,4685,42165
220887,201704,21,20,1,18740,937,19677
220890,201704,106,93,13,87141,12181,99322
220900,201704,46,27,19,25299,17803,43102
220910,201704,54,45,9,42165,8433,50598
220915,201704,18,17,1,15929,937,16866
220920,201704,36,33,3,30921,2811,33732
220930,201704,41,40,1,36680.73,937,37617.73
220935,201704,20,19,1,17803,937,18740
220937,201704,44,42,2,39354,1874,41228
220940,201704,49,44,5,41228,4685,45913
220945,201704,0,0,0,0,0,0
220950,201704,46,42,4,39354,3748,43102
220955,201704,40,38,2,35606,1874,37480
220960,201704,5,5,0,4685,0,4685
220965,201704,25,21,4,19677,3748,23425
220970,201704,45,37,8,34669,7496,42165
220975,201704,9,8,1,7496,937,8433
220980,201704,40,36,4,33732,3748,37480
220985,201704,58,53,5,49661,4685,54346
220987,201704,32,30,2,28110,1874,29984
220990,201704,12,10,2,9370,1874,11244
220995,201704,38,33,5,30921,4685,35606
220997,201704,30,24,6,22488,5622,28110
221000,201704,1057,946,111,883828.81,103725.9,987554.71
221005,201704,62,57,5,53409,4685,58094
221010,201704,16,13,3,12181,2811,14992
221020,201704,49,48,1,44976,937,45913
221030,201704,34,27,7,25299,6559,31858
221035,201704,17,16,1,14992,937,15929
221037,201704,10,6,4,5622,3748,9370
221038,201704,9,8,1,7496,937,8433
221039,201704,21,21,0,19677,0,19677
221040,201704,239,205,34,192085,31858,223943
221050,201704,230,192,38,179904,35606,215510
221060,201704,1426,1243,183,1163894.55,171471,1335365.55
221062,201704,31,30,1,28110,937,29047
221063,201704,15,11,4,10307,3748,14055
221065,201704,38,33,5,30921,4685,35606
221070,201704,153,131,22,122747,20614,143361
221080,201704,367,322,45,301714,41883.9,343597.9
221090,201704,40,39,1,36291,937,37228
221093,201704,73,51,22,47787,20614,68401
221095,201704,11,10,1,9370,937,10307
221097,201704,27,24,3,22488,2811,25299
221100,201704,23678,13486,10192,12615502.02,9546139.79,22161641.81
221110,201704,994,725,269,679024,252053,931077
221120,201704,489,359,130,336102,121810,457912
221130,201704,888,725,163,677798.69,152076,829874.69
221135,201704,31,28,3,26236,2811,29047
221140,201704,39,30,9,28110,8433,36543
221150,201704,14,10,4,9370,3748,13118
221160,201704,10,10,0,9370,0,9370
221170,201704,11,11,0,10307,0,10307
230010,201704,156,142,14,133054,13118,146172
230015,201704,112,94,18,88078,16866,104944
230020,201704,1455,1259,196,1176967,182989.08,1359956.08
230030,201704,1549,1107,442,1031789.62,414154,1445943.62
230040,201704,195,174,21,162101,19677,181778
230050,201704,189,140,49,131180,45913,177093
230060,201704,131,104,27,96698.4,25299,121997.4
230070,201704,274,240,34,224880,31858,256738
230075,201704,777,675,102,630040.5,95292.9,725333.4
230080,201704,172,153,19,143361,17803,161164
230090,201704,86,59,27,54534,25299,79833
230100,201704,1835,1092,743,1020958,695910,1716868
230110,201704,2574,1615,959,1509957.6,898020.9,2407978.5
230120,201704,892,703,189,656368.91,177075,833443.91
230125,201704,129,105,24,98385,22488,120873
230130,201704,434,388,46,363556,43102,406658
230140,201704,210,184,26,172408,24362,196770
230150,201704,155,121,34,113377,31858,145235
230160,201704,911,799,112,747960.5,104944,852904.5
230170,201704,553,509,44,473188.1,41228,514416.1
230180,201704,76,72,4,67464,3748,71212
230185,201704,385,331,54,308806.16,50598,359404.16
230190,201704,2116,1698,418,1587931.69,391354,1979285.69
230195,201704,482,420,62,392884.1,58094,450978.1
230200,201704,357,313,44,292334.63,40563,332897.63
230205,201704,337,212,125,196905.96,117125,314030.96
230210,201704,1229,982,247,919208.18,230689.4,1149897.58
230220,201704,1313,910,403,852670,377611,1230281
230230,201704,880,778,102,726425.85,95574,821999.85
230240,201704,1575,1351,224,1264233.85,209607,1473840.85
230250,201704,1686,1377,309,1285984.47,288971,1574955.47
230260,201704,2803,1652,1151,1543105.79,1077550.75,2620656.54
230270,201704,1308,1055,253,986673.98,234532.3,1221206.28
230280,201704,2609,1933,676,1805882.97,632475.1,2438358.07
230290,201704,387,348,39,319905.92,36543,356448.92
230300,201704,499,364,135,339831.16,126495,466326.16
230310,201704,397,301,96,282037,89952,371989
230320,201704,850,726,124,677193.17,116179,793372.17
230330,201704,289,234,55,218508.4,51535,270043.4
230340,201704,450,359,91,334697.4,85267,419964.4
230350,201704,2860,1799,1061,1685605.52,991347.24,2676952.76
230360,201704,242,214,28,199624,26236,225860
230365,201704,170,136,34,126730,31858,158588
230370,201704,9265,4430,4835,4141519.39,4525291.05,8666810.44
230380,201704,446,381,65,356716,59968.8,416684.8
230390,201704,493,266,227,247471.07,212699,460170.07
230393,201704,273,228,45,212796.4,42165,254961.4
230395,201704,315,259,56,242440,52472,294912
230400,201704,601,478,123,445637.9,114763.76,560401.66
230410,201704,2480,1529,951,1428785.55,890806,2319591.55
230420,201704,5507,3552,1955,3310754.34,1827050.22,5137804.56
230423,201704,295,253,42,235187.8,39354,274541.8
230425,201704,324,271,53,253927,49661,303588
230426,201704,104,93,11,86428.88,10025.9,96454.78
230427,201704,78,75,3,70275,2811,73086
230428,201704,1303,666,637,623575.76,596869,1220444.76
230430,201704,429,336,93,314641,86377.34,401018.34
230435,201704,727,501,226,468397,210825.27,679222.27
230440,201704,80212,35093,45119,32805072.39,42237174.17,75042246.56
230445,201704,251,173,78,162101,73086,235187
230450,201704,530,424,106,397288,99322,496610
230460,201704,50,43,7,40291,6559,46850
230465,201704,286,229,57,214573,53409,267982
230470,201704,1778,1373,405,1286501,378397.59,1664898.59
230480,201704,138,134,4,125276.9,3748,129024.9
230490,201704,267,216,51,202392,47787,250179
230495,201704,409,306,103,285885,96511,382396
230500,201704,912,679,233,634349,218312,852661
230510,201704,41,33,8,30921,7496,38417
230520,201704,387,306,81,286722,75897,362619
230523,201704,1765,1146,619,1073052.4,579563,1652615.4
230526,201704,285,238,47,223006,44039,267045
230530,201704,660,495,165,460856.38,153668.6,614524.98
230533,201704,168,163,5,152731,4685,157416
230535,201704,334,247,87,231439,81519,312958
230540,201704,1812,1584,228,1481609.7,213355,1694964.7
230550,201704,3537,2238,1299,2089677.93,1216319.7,3305997.63
230560,201704,572,439,133,409282.4,123684,532966.4
230565,201704,179,127,52,118999,48724,167723
230570,201704,301,269,32,252053,29984,282037
230580,201704,1071,791,280,739733.39,260955.77,1000689.16
230590,201704,898,697,201,648921.05,187868.9,836789.95
230600,201704,235,218,17,202598.32,15929,218527.32
230610,201704,326,259,67,242496,62779,305275
230620,201704,159,130,29,120873,27173,148046
230625,201704,712,514,198,480260.25,184393.04,664653.29
230630,201704,1200,942,258,882654,241371.2,1124025.2
230640,201704,3278,2853,425,2666793.72,398225,3065018.72
230650,201704,386,341,45,318700.49,41509.1,360209.59
230655,201704,596,519,77,485366.4,72111.95,557478.35
230660,201704,310,257,53,240809,49361.11,290170.11
230670,201704,418,376,42,352312,39354,391666
230680,201704,196,180,16,168660,14992,183652
230690,201704,818,716,102,670892,95574,766466
230700,201704,694,591,103,553767,95948.8,649715.8
230710,201704,706,662,44,620107,41228,661335
230720,201704,131,111,20,103810.23,18740,122550.23
230725,201704,209,164,45,153668,42156,195824
230730,201704,11055,5984,5071,5589863.98,4743361.39,10333225.37
230740,201704,631,499,132,467282,123005.63,590287.63
230750,201704,774,652,122,609753.15,114314,724067.15
230760,201704,1177,1018,159,949892.59,148983,1098875.59
230763,201704,332,274,58,254817.41,54346,309163.41
230765,201704,6425,2971,3454,2777061.05,3233213.7,6010274.75
230770,201704,4779,2463,2316,2297880.94,2166869.14,4464750.08
230780,201704,664,587,77,547234.57,72149,619383.57
230790,201704,179,144,35,134928,32008.66,166936.66
230800,201704,1072,782,290,732729.32,271730,1004459.32
230810,201704,1221,1082,139,1012569.05,130243,1142812.05
230820,201704,306,220,86,205204,80582,285786
230830,201704,925,806,119,752554.02,111503,864057.02
230835,201704,265,230,35,214573,32093,246666
230837,201704,163,135,28,126495,26236,152731
230840,201704,848,679,169,635005.5,157135,792140.5
230850,201704,1417,1245,172,1166283.9,160883,1327166.9
230860,201704,305,222,83,208014,76834.25,284848.25
230870,201704,1723,1460,263,1366802,245119.4,1611921.4
230880,201704,11,6,5,5622,4685,10307
230890,201704,563,521,42,487868.35,39354,527222.35
230900,201704,251,195,56,182715,52279,234994
230910,201704,190,153,37,142611.4,34669,177280.4
230920,201704,376,298,78,279226,73086,352312
230930,201704,881,631,250,588436.92,234250,822686.92
230940,201704,816,655,161,613453.9,150670,764123.9
230945,201704,436,367,69,343692,64653,408345
230950,201704,349,301,48,282037,44976,327013
230960,201704,2310,1531,779,1427731.25,729642,2157373.25
230970,201704,1607,901,706,843341.45,660659.96,1504001.41
230980,201704,197,163,34,152731,31858,184589
230990,201704,138,112,26,104944,23618.95,128562.95
231000,201704,189,174,15,161164.74,14055,175219.74
231010,201704,132,105,27,98385,25299,123684
231020,201704,1171,824,347,770495.5,325119,1095614.5
231025,201704,885,659,226,615356.6,210244.9,825601.5
231030,201704,1137,951,186,890802,174001,1064803
231040,201704,132,90,42,83599.14,38636,122235.14
231050,201704,997,881,116,823624.5,108692,932316.5
231060,201704,131,115,16,107755,14992,122747
231070,201704,1355,965,390,902144.55,365430,1267574.55
231080,201704,247,230,17,215510,15929,231439
231085,201704,495,312,183,291408,171471,462879
231090,201704,223,187,36,175219,33732,208951
231095,201704,158,127,31,118999,29047,148046
231100,201704,116,94,22,88078,19395.9,107473.9
231110,201704,315,271,44,252432.39,41228,293660.39
231120,201704,290,251,39,234236.88,36356,270592.88
231123,201704,132,124,8,116188,7496,123684
231126,201704,267,228,39,213636,36543,250179
231130,201704,4405,3429,976,3204462.34,913912.42,4118374.76
231135,201704,182,158,24,148046,21246.2,169292.2
231140,201704,2981,2190,791,2048464.79,739356.24,2787821.03
231150,201704,331,317,14,297029,13118,310147
231160,201704,1176,928,248,866257.25,232151.12,1098408.37
231170,201704,533,343,190,321391,178030,499421
231180,201704,1458,1221,237,1143187.4,222069,1365256.4
231190,201704,210,188,22,176156,20596,196752
231195,201704,204,175,29,163263.91,27173,190436.91
231200,201704,806,660,146,618420,135564,753984
231210,201704,586,489,97,458193,90889,549082
231220,201704,981,706,275,660586,257675,918261
231230,201704,1319,1070,249,1001223.3,233031.9,1234255.2
231240,201704,1248,905,343,847703.9,320173.1,1167877.0
231250,201704,104,97,7,90889,6559,97448
231260,201704,295,187,108,174937.9,100915,275852.9
231270,201704,968,805,163,749945.49,152722,902667.49
231280,201704,44,36,8,33732,7496,41228
231290,201704,7015,3862,3153,3609887.71,2952067.05,6561954.76
231300,201704,605,559,46,523783,43102,566885
231310,201704,676,631,45,590052,42160.32,632212.32
231320,201704,535,413,122,386514,114314,500828
231325,201704,85,74,11,69338,10307,79645
231330,201704,1967,1524,443,1422511.19,412469.3,1834980.49
231335,201704,249,215,34,201455,31858,233313
231340,201704,1495,1105,390,1034261.24,365430,1399691.24
231350,201704,1085,888,197,831588,183745.8,1015333.8
231355,201704,371,323,48,302524.51,44976,347500.51
231360,201704,443,359,84,333440.1,78708,412148.1
231370,201704,84,67,17,62779,15929,78708
231375,201704,265,195,70,182715,65590,248305
231380,201704,407,335,72,312328.36,67276.6,379604.96
231390,201704,189,154,35,144298,32795,177093
231395,201704,716,435,281,406320.68,263297,669617.68
231400,201704,1021,841,180,785490.55,168322.9,953813.45
231410,201704,1248,996,252,927772.8,234906.2,1162679.0
240010,201704,386,184,202,171276.54,189079,360355.54
240020,201704,2083,1578,505,1477140.07,473185,1950325.07
240030,201704,172,140,32,131180,29984,161164
240040,201704,32,32,0,29984,0,29984
240050,201704,482,411,71,383519.06,66527,450046.06
240060,201704,68,63,5,59031,4685,63716
240070,201704,148,112,36,104944,33732,138676
240080,201704,381,242,139,226750,130243,356993
240090,201704,105,94,11,87779,10307,98086
240100,201704,1394,1317,77,1231109.18,71941.49,1303050.67
240110,201704,937,579,358,541568.03,335446,877014.03
240120,201704,136,114,22,106818,20614,127432
240130,201704,284,265,19,247601.31,17803,265404.31
240140,201704,85,65,20,60905,18740,79645
240145,201704,641,561,80,525141.65,74753.86,599895.51
240150,201704,19,16,3,14992,2796.95,17788.95
240160,201704,51,42,9,39354,8433,47787
240165,201704,35,32,3,29750,2811,32561
240170,201704,85,68,17,63716,15929,79645
240180,201704,69,55,14,51535,13118,64653
240185,201704,39,36,3,33722.63,2811,36533.63
240190,201704,19,17,2,15929,1874,17803
240200,201704,2885,1613,1272,1505907.3,1190647,2696554.3
240210,201704,154,120,34,112440,31858,144298
240220,201704,1105,790,315,740230,295145.63,1035375.63
240230,201704,797,740,57,690596.68,52772,743368.68
240240,201704,141,102,39,95480.3,36543,132023.3
240250,201704,91,80,11,74960,10307,85267
240260,201704,1738,1283,455,1201496.36,425369.89,1626866.25
240270,201704,183,165,18,154230.2,16866,171096.2
240280,201704,43,33,10,30921,9370,40291
240290,201704,63,60,3,56220,2811,59031
240300,201704,169,99,70,92375,65590,157965
240310,201704,1849,1012,837,939311.24,781092.06,1720403.30
240320,201704,215,204,11,191148,10307,201455
240325,201704,4035,2450,1585,2287269.17,1483010.41,3770279.58
240330,201704,71,68,3,63716,2811,66527
240340,201704,94,67,27,62779,25299,88078
240350,201704,91,80,11,74960,10307,85267
240360,201704,324,233,91,218040,85267,303307
240370,201704,39,37,2,34669,1874,36543
240375,201704,79,47,32,44039,29984,74023
240380,201704,239,196,43,182755,40198,222953
240390,201704,19,16,3,14992,2811,17803
240400,201704,82,79,3,74023,2811,76834
240410,201704,8,6,2,5622,1874,7496
240420,201704,836,639,197,597433.07,183577.04,781010.11
240430,201704,250,236,14,219426.11,13118,232544.11
240440,201704,61,33,28,30921,26236,57157
240450,201704,177,113,64,105318.9,59968,165286.9
240460,201704,58,45,13,42165,12181,54346
240470,201704,227,193,34,180293.79,31858,212151.79
240480,201704,16,16,0,14898.3,0,14898.3
240485,201704,66,55,11,51644,10307,61951
240490,201704,50,50,0,46644,0,46644
240500,201704,83,68,15,63716,14055,77771
240510,201704,44,31,13,29047,12181,41228
240520,201704,135,129,6,120873,5622,126495
240530,201704,41,36,5,33732,4685,38417
240540,201704,80,68,12,63716,11234.63,74950.63
240550,201704,17,14,3,13118,2811,15929
240560,201704,359,262,97,244878.4,90889,335767.4
240570,201704,430,261,169,243432.6,158353,401785.6
240580,201704,1244,1005,239,936298.95,222805.6,1159104.55
240590,201704,26,25,1,23425,937,24362
240600,201704,117,117,0,109629,0,109629
240610,201704,501,422,79,394851.9,73274,468125.9
240615,201704,40,38,2,35606,1874,37480
240620,201704,91,88,3,81519,2811,84330
240630,201704,38,36,2,33732,1874,35606
240640,201704,28,24,4,22488,3748,26236
240650,201704,221,189,32,176251,29984,206235
240660,201704,88,78,10,73086,9370,82456
240670,201704,270,157,113,145048.15,105881,250929.15
240680,201704,54,43,11,40291,10307,50598
240690,201704,49,46,3,43102,2811,45913
240700,201704,191,160,31,149920,29047,178967
240710,201704,1798,1140,658,1067525.3,614775.07,1682300.37
240720,201704,1002,728,274,681190.23,256738,937928.23
240725,201704,66,62,4,58094,3748,61842
240730,201704,128,111,17,104007,15929,119936
240740,201704,228,190,38,176690.09,35606,212296.09
240750,201704,38,24,14,22488,13118,35606
240760,201704,35,30,5,28110,4685,32795
240770,201704,143,110,33,103070,30916.32,133986.32
240780,201704,696,582,114,543638.03,106818,650456.03
240790,201704,41,39,2,36543,1874,38417
240800,201704,8206,5553,2653,5168294.36,2479725.6,7648019.96
240810,201704,19333,10536,8797,9830903.95,8234129.17,18065033.12
240820,201704,180,115,65,107469.22,60905,168374.22
240830,201704,1544,1270,274,1183301.05,255802,1439103.05
240840,201704,76,64,12,59968,11244,71212
240850,201704,88,76,12,71212,11244,82456
240860,201704,115,113,2,105881,1874,107755
240870,201704,51,44,7,41228,6559,47787
240880,201704,26,25,1,23415.63,937,24352.63
240890,201704,1070,626,444,582816.85,415087,997903.85
240895,201704,44,33,11,30921,10307,41228
240910,201704,146,133,13,124621,12181,136802
240920,201704,16,12,4,11244,3748,14992
240930,201704,359,324,35,302651,32795,335446
240933,201704,17,12,5,11244,4685,15929
240940,201704,2381,2106,275,1963864.41,254939.36,2218803.77
240950,201704,48,47,1,44039,937,44976
240960,201704,33,26,7,24362,6559,30921
240970,201704,151,109,42,102133,38617,140750
240980,201704,168,133,35,124621,32795,157416
240990,201704,114,74,40,69338,37480,106818
241000,201704,84,75,9,70088,8433,78521
241010,201704,56,44,12,41228,11244,52472
241020,201704,115,108,7,101196,6559,107755
241025,201704,9,3,6,2811,5622,8433
241030,201704,122,99,23,92763,21551,114314
241040,201704,29,24,5,22488,4685,27173
241050,201704,96,83,13,77771,12181,89952
241060,201704,34,31,3,29047,2811,31858
241070,201704,19,19,0,17803,0,17803
241080,201704,65,57,8,53127.9,7496,60623.9
241090,201704,51,41,10,38417,9327.9,47744.9
241100,201704,73,66,7,61842,6559,68401
241105,201704,8,3,5,2811,4685,7496
241110,201704,50,47,3,44039,2811,46850
241120,201704,1356,1046,310,977170.4,289607.96,1266778.36
241140,201704,223,180,43,167724,40291,208015
241142,201704,44,42,2,39354,1874,41228
241150,201704,1189,1045,144,976495.5,134928,1111423.5
241160,201704,26,24,2,22488,1874,24362
241170,201704,42,39,3,36543,2811,39354
241180,201704,49,39,10,36371.53,9370,45741.53
241190,201704,46,45,1,42165,937,43102
241200,201704,3608,1993,1615,1862013.01,1512024.64,3374037.65
241210,201704,73,58,15,54346,13212,67558
241220,201704,1320,869,451,813643.7,422568.26,1236211.96
241230,201704,233,195,38,182527.6,35606,218133.6
241240,201704,51,39,12,36543,11244,47787
241250,201704,1035,967,68,906079,63435,969514
241255,201704,39,33,6,30921,5622,36543
241260,201704,622,493,129,461936.32,120873,582809.32
241270,201704,47,32,15,29984,14055,44039
241280,201704,100,86,14,80582,13118,93700
241290,201704,102,75,27,70275,25299,95574
241300,201704,78,55,23,51535,21551,73086
241310,201704,53,42,11,39214,10307,49521
241320,201704,29,16,13,14616,12181,26797
241330,201704,58,52,6,48724,5622,54346
241335,201704,57,49,8,45913,7496,53409
241340,201704,182,135,47,126495,44039,170534
241350,201704,55,52,3,48724,2811,51535
241355,201704,41,38,3,35606,2811,38417
241360,201704,48,48,0,44976,0,44976
241370,201704,46,38,8,35606,7496,43102
241380,201704,44,42,2,39354,1874,41228
241390,201704,69,55,14,51347.6,13118,64465.6
241400,201704,186,151,35,140832,32795,173627
241410,201704,171,155,16,145235,14899,160134
241415,201704,91,72,19,67464,17803,85267
241420,201704,92,70,22,65590,20446,86036
241430,201704,32,31,1,29047,937,29984
241440,201704,438,367,71,343879,66587,410466
241445,201704,30,28,2,26236,1874,28110
241450,201704,278,226,52,211638,48724,260362
241460,201704,129,116,13,108458,12181,120639
241470,201704,45,37,8,34669,7496,42165
241475,201704,71,68,3,63716,2811,66527
241480,201704,89,64,25,59968,23425,83393
241490,201704,8,6,2,5622,1593,7215
241500,201704,50,37,13,34669,12181,46850
250010,201704,99,87,12,81519,11244,92763
250020,201704,22,18,4,16866,3748,20614
250030,201704,808,590,218,551509.1,202422.51,753931.61
250040,201704,310,264,46,247368,43102,290470
250050,201704,211,178,33,166786,30921,197707
250053,201704,55,43,12,40291,11244,51535
250057,201704,0,0,0,0,0,0
250060,201704,428,334,94,312958,88078,401036
250070,201704,661,574,87,535858,81519,617377
250073,201704,8,8,0,7496,0,7496
250077,201704,207,152,55,142040.6,51535,193575.6
250080,201704,420,324,96,301996.1,89952,391948.1
250090,201704,212,142,70,132117.2,64734.26,196851.46
250100,201704,446,364,82,341068,76460,417528
250110,201704,454,344,110,320576.6,103070,423646.6
250115,201704,29,8,21,7496,19677,27173
250120,201704,98,76,22,71212,20614,91826
250130,201704,584,459,125,430083,116938,547021
250135,201704,12,8,4,7496,3748,11244
250140,201704,71,64,7,59968,6559,66527
250150,201704,538,402,136,375202,127122.79,502324.79
250153,201704,11,10,1,9370,937,10307
250157,201704,27,22,5,20614,4685,25299
250160,201704,204,160,44,149920,41228,191148
250170,201704,70,49,21,45913,19677,65590
250180,201704,3828,2583,1245,2407339.94,1161801.35,3569141.29
250190,201704,928,599,329,559623.25,307570.25,867193.50
250200,201704,47,40,7,37480,6559,44039
250205,201704,15,13,2,12181,1874,14055
250210,201704,88,76,12,71212,11244,82456
250215,201704,61,53,8,49661,7496,57157
250220,201704,24,18,6,16866,5622,22488
250230,201704,67,62,5,58094,4685,62779
250240,201704,227,185,42,172548.55,39354,211902.55
250250,201704,388,331,57,310147,53409,363556
250260,201704,29,25,4,23425,3748,27173
250270,201704,53,42,11,39354,10307,49661
250280,201704,391,325,66,304525,61842,366367
250290,201704,85,79,6,73741.9,5622,79363.9
250300,201704,575,390,185,364794.24,173332,538126.24
250310,201704,42,36,6,33732,5622,39354
250320,201704,1818,1252,566,1167106.84,529124,1696230.84
250330,201704,77,65,12,60905,11244,72149
250340,201704,24,20,4,18740,3748,22488
250350,201704,126,79,47,73732.52,43476.8,117209.32
250355,201704,23,18,5,16866,4685,21551
250360,201704,198,161,37,150857,34435,185292
250370,201704,2300,1573,727,1468094.59,679669.71,2147764.30
250375,201704,22,18,4,16866,3748,20614
250380,201704,48,33,15,30921,14055,44976
250390,201704,33,28,5,26236,4685,30921
250400,201704,15185,7668,7517,7163509.84,7034752.19,14198262.03
250403,201704,404,336,68,314822.64,63716,378538.64
250407,201704,52,46,6,43102,5622,48724
250410,201704,27,23,4,21551,3748,25299
250415,201704,39,24,15,22488,14036.26,36524.26
250420,201704,46,37,9,34669,8433,43102
250430,201704,1673,1401,272,1310583,254864,1565447
250435,201704,13,11,2,10307,1874,12181
250440,201704,689,593,96,553309.29,89952,643261.29
250450,201704,82,69,13,64653,11525.1,76178.1
250460,201704,390,265,125,248305,116992.42,365297.42
250470,201704,89,65,24,60905,22488,83393
250480,201704,322,252,70,236124,65590,301714
250485,201704,2,1,1,937,937,1874
250490,201704,201,166,35,155542,32795,188337
250500,201704,72,52,20,48724,18740,67464
250510,201704,710,542,168,506542.8,156472.26,663015.06
250520,201704,172,115,57,107736.28,53404.32,161140.60
250523,201704,107,88,19,82456,17803,100259
250527,201704,105,80,25,74955.32,23425,98380.32
250530,201704,6,5,1,4685,937,5622
250535,201704,25,20,5,18740,4685,23425
250540,201704,121,90,31,83627.25,29047,112674.25
250550,201704,69,65,4,60905,3748,64653
250560,201704,35,29,6,27173,5622,32795
250570,201704,151,120,31,112440,29047,141487
250580,201704,141,109,32,101851.9,29984,131835.9
250590,201704,17,14,3,13118,2811,15929
250600,201704,1253,851,402,794390.64,376576.32,1170966.96
250610,201704,153,131,22,122747,20614,143361
250620,201704,20,16,4,14992,3748,18740
250625,201704,57,42,15,39354,14055,53409
250630,201704,2936,1875,1061,1750477.97,992825.6,2743303.57
250640,201704,197,166,31,155542,29047,184589
250650,201704,31,21,10,19677,9370,29047
250660,201704,35,30,5,28110,4685,32795
250670,201704,51,35,16,32795,14992,47787
250680,201704,391,318,73,297966,68401,366367
250690,201704,1715,1176,539,1098694.76,504668.9,1603363.66
250700,201704,932,812,120,756649.3,112440,869089.3
250710,201704,439,338,101,316706,94637,411343
250720,201704,99,78,21,73086,19677,92763
250730,201704,359,300,59,278290,55283,333573
250740,201704,44,40,4,37480,3748,41228
250750,201704,19467,11590,7877,10806133.4,7371990.55,18178123.95
250760,201704,61,48,13,44976,12181,57157
250770,201704,337,226,111,210825.31,102859.27,313684.58
250780,201704,51,40,11,37480,10307,47787
250790,201704,495,309,186,286722.76,173579.25,460302.01
250800,201704,150,137,13,127666.25,12181,139847.25
250810,201704,81,60,21,56220,19677,75897
250820,201704,154,123,31,115251,29047,144298
250830,201704,428,282,146,263250.25,136802,400052.25
250840,201704,51,48,3,44976,2811,47787
250850,201704,48,39,9,35868.36,8433,44301.36
250855,201704,14,12,2,11244,1874,13118
250860,201704,192,140,52,131180,48442.9,179622.9
250870,201704,32,29,3,27173,2811,29984
250880,201704,73,56,17,52425.15,15929,68354.15
250890,201704,2258,1655,603,1549423.2,564163.57,2113586.77
250900,201704,41,33,8,30921,7496,38417
250905,201704,129,98,31,91826,29047,120873
250910,201704,1144,809,335,756405.29,313613.9,1070019.19
250915,201704,107,74,33,69338,30921,100259
250920,201704,135,102,33,95574,30921,126495
250930,201704,147,91,56,85267,52472,137739
250933,201704,0,0,0,0,0,0
250937,201704,8,7,1,6559,937,7496
250939,201704,30,22,8,20614,7496,28110
250940,201704,99,71,28,66527,26236,92763
250950,201704,74,50,24,46850,22488,69338
250960,201704,89,48,41,44955.89,38417,83372.89
250970,201704,1174,827,347,773307,324857.9,1098164.9
250980,201704,88,62,26,58094,24362,82456
250990,201704,158,121,37,112955.4,34640.9,147596.3
251000,201704,72,66,6,61654.6,5622,67276.6
251010,201704,86,67,19,62775,17038.4,79813.4
251020,201704,76,66,10,61045.55,9370,70415.55
251030,201704,38,29,9,27173,8433,35606
251040,201704,51,35,16,32795,14992,47787
251050,201704,25,23,2,21551,1874,23425
251060,201704,46,37,9,33732,8433,42165
251065,201704,4,3,1,2811,937,3748
251070,201704,25,19,6,17794,5622,23416
251080,201704,4612,2237,2375,2082969.78,2219875.21,4302844.99
251090,201704,198,169,29,158353,27173,185526
251100,201704,16,15,1,14055,937,14992
251110,201704,42,33,9,30921,8433,39354
251120,201704,1733,1023,710,953582.2,665270,1618852.2
251130,201704,336,272,64,254864,59968,314832
251140,201704,481,309,172,288410,160998.34,449408.34
251150,201704,286,247,39,230681,36543,267224
251160,201704,89,71,18,66523,16866,83389
251170,201704,100,78,22,73057.92,20604.64,93662.56
251180,201704,284,177,107,165849,100250.32,266099.32
251190,201704,190,131,59,122424.68,55283,177707.68
251200,201704,244,195,49,182715,45913,228628
251203,201704,28,26,2,24362,1874,26236
251207,201704,89,73,16,68401,14992,83393
251210,201704,1171,827,344,773372.89,321672.1,1095044.99
251220,201704,45,35,10,32795,9370,42165
251230,201704,509,435,74,407575,69338,476913
251240,201704,104,73,31,67464,29047,96511
251250,201704,1282,910,372,850562.1,348424,1198986.1
251260,201704,13,8,5,7496,4685,12181
251270,201704,332,247,85,231439,79505,310944
251272,201704,71,65,6,60905,5622,66527
251274,201704,25,20,5,18740,4685,23425
251275,201704,20,14,6,13118,5622,18740
251276,201704,16,13,3,12181,2811,14992
251278,201704,9,7,2,6559,1874,8433
251280,201704,83,79,4,74023,3748,77771
251290,201704,704,528,176,494736,164912,659648
251300,201704,17,15,2,14055,1874,15929
251310,201704,340,242,98,226750,91826,318576
251315,201704,15,14,1,13118,937,14055
251320,201704,60,47,13,44039,12181,56220
251330,201704,76,67,9,62779,8433,71212
251335,201704,9,5,4,4685,3748,8433
251340,201704,680,405,275,379485,256668.63,636153.63
251350,201704,33,31,2,29047,1874,30921
251360,201704,62,54,8,50395.61,7496,57891.61
251365,201704,14,14,0,13118,0,13118
251370,201704,5090,3429,1661,3206755.39,1555046.5,4761801.89
251380,201704,51,39,12,36543,11244,47787
251385,201704,2,2,0,1874,0,1874
251390,201704,612,494,118,461754.6,109348,571102.6
251392,201704,27,16,11,14992,10307,25299
251394,201704,10,9,1,8433,937,9370
251396,201704,19,14,5,13118,4685,17803
251398,201704,19,17,2,15929,1874,17803
251400,201704,34,28,6,26236,5622,31858
251410,201704,33,29,4,27173,3748,30921
251420,201704,107,81,26,75897,24362,100259
251430,201704,35,33,2,30921,1874,32795
251440,201704,40,26,14,24353,13118,37471
251445,201704,42,37,5,34669,4685,39354
251450,201704,399,352,47,328198.4,44039,372237.4
251455,201704,2,1,1,937,937,1874
251460,201704,15,11,4,10307,3748,14055
251465,201704,5,2,3,1874,2811,4685
251470,201704,45,36,9,33732,8433,42165
251480,201704,24,22,2,20614,1874,22488
251490,201704,130,91,39,84799,35607,120406
251500,201704,109,90,19,84330,17054,101384
251510,201704,29,22,7,20614,6559,27173
251520,201704,22,22,0,20614,0,20614
251530,201704,4592,3205,1387,2997478.09,1299309.79,4296787.88
251540,201704,75,67,8,62779,7496,70275
251550,201704,421,321,100,299840.6,93466,393306.6
251560,201704,25,20,5,18740,4685,23425
251570,201704,17,17,0,15929,0,15929
251580,201704,114,94,20,88078,18740,106818
251590,201704,128,94,34,88078,31858,119936
251593,201704,19,11,8,10307,7496,17803
251597,201704,57,46,11,43102,10307,53409
251600,201704,1086,773,313,722989.94,291584.26,1014574.20
251610,201704,207,156,51,145516.1,47132,192648.1
251615,201704,1,1,0,937,0,937
251620,201704,4178,2798,1380,2613982.17,1290625.34,3904607.51
251630,201704,414,299,115,280163,107755,387918
251640,201704,150,104,46,97448,43102,140550
251650,201704,255,187,68,173420.55,63716,237136.55
251660,201704,217,198,19,184589.55,17803,202392.55
251670,201704,339,268,71,249552.07,66527,316079.07
251675,201704,2,2,0,1874,0,1874
251680,201704,83,78,5,73086,4685,77771
251690,201704,332,276,56,258612,52128.13,310740.13
251700,201704,281,228,53,213059.75,49646.95,262706.70
251710,201704,18,12,6,11244,5622,16866
251720,201704,32,21,11,19677,10026,29703
251740,201704,10,8,2,7496,1874,9370
260005,201704,3054,1725,1329,1604527.1,1243028.87,2847555.97
260010,201704,1249,887,362,827956.76,337976.56,1165933.32
260020,201704,430,379,51,355123,47787,402910
260030,201704,560,406,154,379668.65,144298,523966.65
260040,201704,855,521,334,487099.45,312948.63,800048.08
260050,201704,1117,782,335,732500,313333,1045833
260060,201704,413,370,43,345940.4,40291,386231.4
260070,201704,1380,877,503,817718,468390.58,1286108.58
260080,201704,732,569,163,531935.55,152731,684666.55
260090,201704,559,346,213,323977.86,199581,523558.86
260100,201704,224,156,68,145188.6,63716,208904.6
260105,201704,238,131,107,122747,100259,223006
260110,201704,2597,1932,665,1810265.63,622309,2432574.63
260120,201704,2850,1578,1272,1468087.73,1189617.55,2657705.28
260130,201704,142,96,46,89952,43102,133054
260140,201704,1999,1301,698,1211633.25,652509.63,1864142.88
260150,201704,235,151,84,141487,78708,220195
260160,201704,283,244,39,228628,36543,265171
260170,201704,3200,1966,1234,1834575.24,1155321,2989896.24
260180,201704,122,106,16,99322,14992,114314
260190,201704,2259,1612,647,1507350.03,606239,2113589.03
260200,201704,861,712,149,666382.24,139332,805714.24
260210,201704,1398,961,437,900308.96,409460,1309768.96
260220,201704,686,630,56,589538,52472,642010
260230,201704,1168,880,288,822408.15,269856,1092264.15
260240,201704,205,150,55,139397.49,51535,190932.49
260250,201704,65,53,12,49661,11244,60905
260260,201704,956,684,272,640908,254864,895772
260270,201704,437,355,82,331417.2,76552.9,407970.1
260280,201704,919,705,214,660397.6,199956,860353.6
260290,201704,6259,3285,2974,3058471.61,2780498.06,5838969.67
260300,201704,786,689,97,643288.23,90608,733896.23
260310,201704,485,381,104,354987.13,97448,452435.13
260320,201704,900,675,225,632379,210825,843204
260330,201704,24,20,4,18740,3748,22488
260340,201704,64,47,17,44039,15929,59968
260345,201704,5412,3078,2334,2877644.92,2185705.01,5063349.93
260350,201704,458,335,123,312182.16,114315,426497.16
260360,201704,298,155,143,145235,133991,279226
260370,201704,618,396,222,369225.7,207877,577102.7
260380,201704,595,428,167,401036,155355.14,556391.14
260390,201704,287,244,43,227452.19,39354,266806.19
260392,201704,87,76,11,71212,10307,81519
260400,201704,4067,2318,1749,2161821.2,1638457.41,3800278.61
260410,201704,13801,7506,6295,7018254.39,5895732.5,12913986.89
260415,201704,121,106,15,99322,14055,113377
260420,201704,1782,1034,748,963992.55,698488,1662480.55
260430,201704,192,175,17,162978.14,15929,178907.14
260440,201704,224,162,62,150521,58094,208615
260450,201704,478,340,138,317318,129306,446624
260460,201704,849,449,400,418091.4,374795.32,792886.72
260470,201704,363,219,144,204453.4,134038.55,338491.95
260480,201704,198,121,77,113377,72149,185526
260490,201704,202,162,40,151794,37480,189274
260500,201704,1113,737,376,687900,350486,1038386
260510,201704,713,558,155,522846,144298,667144
260515,201704,255,225,30,210825,27642,238467
260520,201704,3239,1891,1348,1764030.98,1261193.21,3025224.19
260530,201704,729,590,139,550061.31,130243,680304.31
260540,201704,577,427,150,400099,139613.66,539712.66
260545,201704,14,10,4,9370,3748,13118
260550,201704,326,200,126,187400,118062,305462
260560,201704,506,385,121,360165,113095.9,473260.9
260570,201704,1001,830,171,774759.9,160227,934986.9
260580,201704,290,257,33,240809,30921,271730
260590,201704,634,361,273,336870.24,255801,592671.24
260600,201704,7825,4019,3806,3745748.91,3562657.32,7308406.23
260610,201704,491,324,167,303588,156479,460067
260620,201704,3430,1813,1617,1689614.1,1510141.94,3199756.04
260630,201704,70,67,3,62779,2811,65590
260640,201704,3563,1922,1641,1797656.24,1537271.05,3334927.29
260650,201704,335,230,105,215510,98342.85,313852.85
260660,201704,493,336,157,314366.88,146218.85,460585.73
260670,201704,101,76,25,71212,23425,94637
260680,201704,3680,2017,1663,1873138.35,1556302.52,3429440.87
260690,201704,194,157,37,146453.1,34669,181122.1
260700,201704,357,211,146,196957.4,135985,332942.4
260710,201704,40,38,2,35606,1874,37480
260720,201704,2179,1297,882,1209506.23,825656.29,2035162.52
260730,201704,576,438,138,410406,127432.45,537838.45
260740,201704,67,63,4,59031,3748,62779
260750,201704,650,446,204,417902,191148,609050
260760,201704,631,344,287,322328,268589,590917
260765,201704,952,498,454,463736.9,425163.75,888900.65
260770,201704,219,162,57,151794,53409,205203
260775,201704,813,481,332,448720.3,311084,759804.3
260780,201704,259,165,94,154605,87946.82,242551.82
260790,201704,12324,6754,5570,6302337.96,5211810.45,11514148.41
260795,201704,137,94,43,86934.86,40291,127225.86
260800,201704,364,301,63,281288,59031,340319
260805,201704,200,128,72,119220.13,67464,186684.13
260810,201704,736,641,95,599389.53,89015,688404.53
260820,201704,310,202,108,187968,101196,289164
260825,201704,192,132,60,123513.66,56220,179733.66
260830,201704,255,164,91,153527.45,85267,238794.45
260840,201704,218,157,61,145849,56876,202725
260845,201704,209,145,64,135865,59968,195833
260850,201704,520,374,146,348803.64,136802,485605.64
260860,201704,249,184,65,172213.86,60905,233118.86
260870,201704,369,259,110,242683,103070,345753
260875,201704,667,456,211,426178.53,197707,623885.53
260880,201704,1368,893,475,836035.31,444887.6,1280922.91
260890,201704,2437,1699,738,1584568.65,690570,2275138.65
260900,201704,1047,702,345,656495.95,323265,979760.95
260910,201704,275,216,59,202392,55283,257675
260915,201704,300,197,103,184589,96391,280980
260920,201704,164,94,70,88078,65590,153668
260930,201704,395,335,60,313895,56163.85,370058.85
260940,201704,2610,1429,1181,1335226.95,1106129,2441355.95
260950,201704,1868,1097,771,1021686.45,722427,1744113.45
260960,201704,14243,7387,6856,6887507.47,6416347.16,13303854.63
260970,201704,422,364,58,341068,54346,395414
260980,201704,202,174,28,162748,26236,188984
260990,201704,2469,2030,439,1901614.01,411343,2312957.01
261000,201704,4303,2480,1823,2311621.15,1705621.9,4017243.05
261010,201704,186,134,52,125558,47920.8,173478.8
261020,201704,609,447,162,418699,151794,570493
261030,201704,205,149,56,139613,52443.9,192056.9
261040,201704,357,322,35,301714,32513.9,334227.9
261050,201704,456,401,55,375737,51535,427272
261060,201704,1294,844,450,788720.88,421650,1210370.88
261070,201704,8878,4534,4344,4220954.47,4061912.93,8282867.40
261080,201704,387,291,96,272667,89952,362619
261090,201704,2111,1626,485,1515999.92,453696,1969695.92
261100,201704,1048,740,308,691553.8,287284.2,978838.0
261110,201704,7672,4668,3004,4368674.93,2811297.95,7179972.88
261120,201704,279,236,43,220851,40287,261138
261130,201704,571,318,253,297638.45,236780,534418.45
261140,201704,186,121,65,113377,60905,174282
261150,201704,656,379,277,353914.77,259549,613463.77
261153,201704,70,67,3,61842.12,2811,64653.12
261160,201704,75377,38282,37095,35752372.92,34733588.94,70485961.86
261170,201704,458,338,120,316425,112440,428865
261180,201704,1740,1055,685,983372.53,641845,1625217.53
261190,201704,624,423,201,396098.89,188318.63,584417.52
261200,201704,212,187,25,174514.09,23425,197939.09
261210,201704,30,27,3,25299,2811,28110
261220,201704,2368,1672,696,1560943.97,651028,2211971.97
261230,201704,318,237,81,221600.5,75882.95,297483.45
261240,201704,431,370,61,342748.47,57157,399905.47
261245,201704,201,167,34,156479,31858,188337
261247,201704,131,96,35,89952,32795,122747
261250,201704,2718,1324,1394,1238620.4,1305368.71,2543989.11
261255,201704,243,222,21,208014,19677,227691
261260,201704,817,705,112,660585,104944,765529
261270,201704,168,130,38,121810,35606,157416
261280,201704,136,110,26,103070,24362,127432
261290,201704,133,90,43,84095.75,40291,124386.75
261300,201704,1206,848,358,793742.44,335446,1129188.44
261310,201704,727,489,238,458193,222396.95,680589.95
261320,201704,526,355,171,332635,160227,492862
261330,201704,769,621,148,578933.25,137845.53,716778.78
261340,201704,326,176,150,164912,140550,305462
261350,201704,722,509,213,475996.1,199541,675537.1
261360,201704,1117,711,406,665812.53,380422,1046234.53
261370,201704,4802,2954,1848,2754711.62,1729244.04,4483955.66
261380,201704,571,410,161,382305.92,150576,532881.92
261390,201704,3283,2189,1094,2046455.22,1021978.53,3068433.75
261400,201704,282,257,25,240246.8,23425,263671.8
261410,201704,994,655,339,613735,317638.32,931373.32
261420,201704,852,530,322,494709.63,301695.63,796405.26
261430,201704,330,298,32,278395,29702.9,308097.9
261440,201704,87,76,11,71212,10307,81519
261450,201704,2477,2057,420,1924984.13,393016.02,2318000.15
261460,201704,681,543,138,507854.81,129306,637160.81
261470,201704,232,178,54,165990,50598,216588
261480,201704,318,257,61,239686,57153,296839
261485,201704,336,205,131,191429.1,122747,314176.1
261500,201704,622,415,207,388855,193959,582814
261510,201704,40,27,13,25299,12181,37480
261520,201704,166,154,12,143362,11244,154606
261530,201704,4134,2615,1519,2442296.99,1422071.95,3864368.94
261540,201704,1054,638,416,597328.13,389792,987120.13
261550,201704,285,141,144,130759,134928,265687
261560,201704,741,492,249,457819.5,231898.8,689718.3
261570,201704,349,273,76,255801,71212,327013
261580,201704,371,289,82,270046,76834,346880
261590,201704,182,147,35,137739,32795,170534
261600,201704,274,224,50,209139,46382,255521
261610,201704,100,86,14,80234,13118,93352
261618,201704,64,50,14,46850,13118,59968
261620,201704,208,124,84,116188,78708,194896
261630,201704,590,449,141,418396.8,131930,550326.8
261640,201704,6033,3188,2845,2978803.75,2662964.26,5641768.01
261650,201704,474,287,187,268253.73,175219,443472.73
270010,201704,498,433,65,405721,60156,465877
270020,201704,309,242,67,226000.4,62779,288779.4
270030,201704,8926,5683,3243,5310848.15,3036193.8,8347041.95
270040,201704,1757,1064,693,996864.94,649059.9,1645924.84
270050,201704,185,135,50,126495,46850,173345
270060,201704,119,66,53,61842,49661,111503
270070,201704,922,650,272,607369.26,253618.16,860987.42
270080,201704,44,37,7,34669,6559,41228
270090,201704,20,16,4,14992,3748,18740
270100,201704,1319,851,468,793219.98,435472.12,1228692.10
270110,201704,173,126,47,118062,44039,162101
270120,201704,220,179,41,166886.72,38135.9,205022.62
270130,201704,256,173,83,161819.9,77489.9,239309.8
270135,201704,102,60,42,56220,39354,95574
270140,201704,1225,715,510,669309.99,475426.26,1144736.25
270150,201704,274,218,56,204266,52472,256738
270160,201704,514,374,140,350438,131180,481618
270170,201704,661,409,252,381640.1,235327.55,616967.65
270180,201704,67,50,17,46537.7,15722.86,62260.56
270190,201704,103,90,13,84330,12181,96511
270200,201704,110,100,10,93512.6,9370,102882.6
270210,201704,497,256,241,239872,225535.9,465407.9
270220,201704,205,163,42,152731,39354,192085
270230,201704,2013,1188,825,1107843.45,770238.94,1878082.39
270235,201704,731,541,190,506589.55,177671.48,684261.03
270240,201704,3030,2322,708,2165736.07,660090.9,2825826.97
270250,201704,171,122,49,113564.4,45913,159477.4
270255,201704,218,193,25,180841,23050.2,203891.2
270260,201704,317,254,63,237671,58749.9,296420.9
270270,201704,122,50,72,46841,67464,114305
270280,201704,221,142,79,133054,74023,207077
270290,201704,1129,840,289,785740.59,269912.89,1055653.48
270300,201704,256,162,94,151794,87796.9,239590.9
270310,201704,952,748,204,698964.28,190445.99,889410.27
270320,201704,906,763,143,712817.8,133991,846808.8
270330,201704,254,207,47,193022,44039,237061
270340,201704,60,47,13,44039,12181,56220
270350,201704,93,48,45,44976,42165,87141
270360,201704,81,42,39,39354,36543,75897
270370,201704,52,38,14,35606,13118,48724
270375,201704,62,36,26,33732,24358,58090
270380,201704,1069,581,488,543460,457256,1000716
270390,201704,200,105,95,98385,89015,187400
270400,201704,684,489,195,456978.75,182706,639684.75
270410,201704,724,509,215,476923.63,201445.63,678369.26
270420,201704,381,242,139,225087,130160.89,355247.89
270430,201704,31376,22237,9139,20783868.64,8554366.83,29338235.47
270440,201704,504,393,111,367257.55,104007,471264.55
270450,201704,765,381,384,356762.75,358871.73,715634.48
270460,201704,207,147,60,137739,56220,193959
270470,201704,1299,850,449,796101.95,420489,1216590.95
270480,201704,491,387,104,359530.19,96745.25,456275.44
270490,201704,26,20,6,18740,5622,24362
270500,201704,508,408,100,382296,93700,475996
270510,201704,733,446,287,417902,268919,686821
270520,201704,421,254,167,237651.45,156479,394130.45
270530,201704,66,57,9,53409,8433,61842
270540,201704,129,98,31,91826,29047,120873
270550,201704,1723,1288,435,1205035.69,407496.62,1612532.31
270560,201704,328,148,180,138676,168660,307336
270570,201704,420,263,157,245615.73,147109,392724.73
270580,201704,71,49,22,45913,20614,66527
270590,201704,83,69,14,64653,13097.89,77750.89
270600,201704,176,143,33,133991,30921,164912
270610,201704,160,122,38,114305,35606,149911
270620,201704,34,32,2,29984,1874,31858
270630,201704,3787,2862,925,2670455.86,864608.38,3535064.24
270640,201704,888,638,250,595838.3,233941.9,829780.2
270642,201704,194,163,31,152731,29047,181778
270644,201704,299,200,99,187212.97,92758.32,279971.29
270650,201704,234,139,95,130243,89015,219258
270660,201704,258,206,52,193022,48724,241746
270670,201704,3158,2370,788,2210853.04,736192.12,2947045.16
270680,201704,452,258,194,241737,181773.32,423510.32
270690,201704,1207,731,476,683245.24,446002.63,1129247.87
270700,201704,38,29,9,27173,8433,35606
270710,201704,851,624,227,583101.86,212699,795800.86
270720,201704,250,186,64,174282,59686.9,233968.9
270730,201704,1759,1007,752,942295.2,702555.6,1644850.8
270740,201704,47,29,18,27173,16866,44039
270750,201704,621,451,170,422587,158635,581222
270760,201704,312,228,84,213636,78708,292344
270770,201704,2648,1627,1021,1516554.16,955740,2472294.16
270780,201704,91,55,36,51530.32,33714.64,85244.96
270790,201704,288,194,94,181778,88078,269856
270800,201704,1970,1543,427,1444967.12,399368.14,1844335.26
270810,201704,319,249,70,233298.95,65581.32,298880.27
270820,201704,157,98,59,91826,55190,147016
270830,201704,1026,737,289,689820,270793,960613
270840,201704,1400,1005,395,941193.2,369179,1310372.2
270850,201704,1772,1067,705,995141.95,659896.68,1655038.63
270860,201704,2427,1555,872,1452832.3,815117.11,2267949.41
270870,201704,126,69,57,64653,53409,118062
270880,201704,909,646,263,602713.19,245545.49,848258.68
270890,201704,385,281,104,263015.9,97443.32,360459.22
270895,201704,76,62,14,58094,13118,71212
270900,201704,112,90,22,84330,20614,104944
270910,201704,339,265,74,247180.6,69338,316518.6
270915,201704,1753,1016,737,947142.57,690077.57,1637220.14
270920,201704,502,414,88,387918,82456,470374
270930,201704,6239,4442,1797,4156706.57,1681963.94,5838670.51
270940,201704,2397,1800,597,1685414.69,557685,2243099.69
280010,201704,44,40,4,37480,3748,41228
280020,201704,699,596,103,556547.31,95574,652121.31
280030,201704,18438,11738,6700,10922391.51,6249069.39,17171460.90
280040,201704,346,219,127,205203,117593.5,322796.5
280050,201704,375,284,91,265822.9,85267,351089.9
280060,201704,314,207,107,191783.48,100259,292042.48
280067,201704,979,682,297,636326.26,277352.12,913678.38
280070,201704,127,105,22,97636,20614,118250
280100,201704,595,466,129,432634.88,120686,553320.88
280110,201704,78,71,7,66527,6559,73086
280120,201704,610,484,126,452711.55,118062,570773.55
280130,201704,1266,772,494,721818.9,462737.45,1184556.35
280140,201704,467,367,100,343035.7,93700,436735.7
280150,201704,306,221,85,206409.21,78708,285117.21
280160,201704,98,83,15,77771,14055,91826
280170,201704,567,375,192,350438.68,179107.55,529546.23
280190,201704,29,26,3,24362,2811,27173
280200,201704,17,12,5,11244,4685,15929
280210,201704,2684,1878,806,1743132.24,749990.06,2493122.30
280220,201704,37,29,8,27173,7496,34669
280230,201704,293,240,53,224060.95,48724.1,272785.05
280240,201704,105,99,6,92623,5622,98245
280250,201704,23,13,10,12181,9370,21551
280260,201704,78,70,8,65590,7496,73086
280270,201704,155,117,38,109629,35606,145235
280280,201704,199,126,73,118062,68401,186463
280290,201704,2940,2125,815,1977093.28,762086.63,2739179.91
280300,201704,1056,796,260,744915,242870.4,987785.4
280310,201704,105,99,6,92576,5622,98198
280320,201704,625,420,205,393531,192085,585616
280330,201704,363,256,107,238511.29,100137.19,338648.48
280340,201704,398,317,81,295584.05,75148,370732.05
280350,201704,3317,2555,762,2384717.53,712239.46,3096956.99
280360,201704,463,294,169,275478,157416,432894
280370,201704,88,76,12,71212,11244,82456
280380,201704,54,40,14,37480,13118,50598
280390,201704,175,145,30,135865,28110,163975
280400,201704,313,213,100,198738.4,93700,292438.4
280410,201704,286,228,58,212494,54336.63,266830.63
280420,201704,171,143,28,133991,26236,160227
280430,201704,106,79,27,74023,25299,99322
280440,201704,651,492,159,455992.8,148495.76,604488.56
280445,201704,115,106,9,99322,8433,107755
280450,201704,1022,871,151,813353.48,141487,954840.48
280460,201704,698,499,199,460449.27,186463,646912.27
280470,201704,192,174,18,163038,15930,178968
280480,201704,2165,1543,622,1433730.74,579028.43,2012759.17
280490,201704,381,348,33,324932,30921,355853
280500,201704,55,49,6,45913,5622,51535
280510,201704,138,105,33,98087.6,30640,128727.6
280520,201704,56,41,15,38417,14055,52472
280530,201704,73,54,19,50598,17803,68401
280540,201704,489,386,103,361682,96229.9,457911.9
280550,201704,683,631,52,588677.3,48724,637401.3
280560,201704,464,396,68,369178,63716,432894
280570,201704,1716,1288,428,1203571.42,401017.26,1604588.68
280580,201704,594,448,146,419637,136709,556346
280590,201704,168,102,66,95299.46,61842,157141.46
280600,201704,343,289,54,269125.54,50598,319723.54
280610,201704,143,102,41,95372,38417,133789
280620,201704,551,442,109,413217,101992.45,515209.45
280630,201704,167,138,29,129306,27173,156479
280640,201704,201,155,46,144421,43102,187523
280650,201704,85,54,31,50598,29047,79645
280660,201704,126,93,33,87141,30686.75,117827.75
280670,201704,1471,916,555,852271.63,516357.98,1368629.61
280680,201704,178,150,28,138798.62,26236,165034.62
280690,201704,40,33,7,30921,6559,37480
280700,201704,16,16,0,14992,0,14992
280710,201704,1394,1027,367,954694.29,343223.1,1297917.39
280720,201704,109,71,38,64012.7,35606,99618.7
280730,201704,23,18,5,16866,4685,21551
280740,201704,2278,1651,627,1543171.82,585757.07,2128928.89
280750,201704,288,248,40,232376,37480,269856
280760,201704,845,571,274,533902.6,256597.45,790500.05
290010,201704,178,115,63,107755,59031,166786
290020,201704,173,160,13,149920,12181,162101
290030,201704,572,367,205,343223.1,192085,535308.1
290035,201704,139,110,29,99922.8,27173,127095.8
290040,201704,265,166,99,155542,92763,248305
290050,201704,68,50,18,46850,16866,63716
290060,201704,260,112,148,104662.9,138676,243338.9
290070,201704,5380,2595,2785,2424209.07,2605943.85,5030152.92
290080,201704,528,240,288,224393.16,269838,494231.16
290090,201704,380,160,220,149920,206140,356060
290100,201704,1559,1016,543,946935.05,508228.9,1455163.95
290110,201704,711,423,288,394754.1,269481.3,664235.4
290115,201704,208,189,19,176156,17803,193959
290120,201704,776,508,268,475340.1,251116,726456.1
290130,201704,424,242,182,226463.53,169783,396246.53
290135,201704,284,218,66,204266,61842,266108
290140,201704,277,229,48,213636,44976,258612
290150,201704,133,96,37,89952,34669,124621
290160,201704,250,194,56,180560.05,52472,233032.05
290170,201704,83,55,28,51535,26236,77771
290180,201704,150,118,32,110566,29984,140550
290190,201704,451,366,85,342661,79364,422025
290195,201704,284,154,130,144298,121810,266108
290200,201704,285,244,41,228628,38417,267045
290205,201704,133,75,58,70275,54346,124621
290210,201704,1068,784,284,733484.6,266108,999592.6
290220,201704,219,118,101,110097.5,94637,204734.5
290225,201704,270,100,170,93700,159290,252990
290230,201704,63,40,23,37359,21551,58910
290240,201704,291,117,174,109347.9,163038,272385.9
290250,201704,251,226,25,210891,23425,234316
290260,201704,256,220,36,205350.13,33732,239082.13
290265,201704,181,146,35,135999,32795,168794
290270,201704,1358,1109,249,1037025,232466,1269491
290280,201704,457,336,121,314832,113377,428209
290290,201704,1139,655,484,609952.61,453508,1063460.61
290300,201704,450,379,71,354603.07,66527,421130.07
290310,201704,320,140,180,131180,168660,299840
290320,201704,3809,2393,1416,2239587.46,1323981.5,3563568.96
290323,201704,177,154,23,144017,21551,165568
290327,201704,138,108,30,100928.96,28110,129038.96
290330,201704,60,34,26,31858,24362,56220
290340,201704,914,358,556,334450.88,520349.79,854800.67
290350,201704,550,327,223,305931,208951,514882
290360,201704,361,270,91,251116.86,85267,336383.86
290370,201704,1011,372,639,348283,598743,947026
290380,201704,294,176,118,164912,110566,275478
290390,201704,2407,1490,917,1392554.57,857262,2249816.57
290395,201704,238,130,108,121576,101196,222772
290400,201704,283,206,77,192460,72149,264609
290405,201704,250,212,38,198644,35606,234250
290410,201704,530,453,77,421510.9,72149,493659.9
290420,201704,222,170,52,159290,48724,208014
290430,201704,502,313,189,293281,177093,470374
290440,201704,70,61,9,57157,7808.3,64965.3
290450,201704,228,175,53,163975,49661,213636
290460,201704,1817,1071,746,1002608.52,698815.56,1701424.08
290470,201704,1447,603,844,563599.17,790515.71,1354114.88
290475,201704,581,545,36,509963,33732,543695
290480,201704,280,149,131,139613,122747,262360
290485,201704,205,190,15,177937,14055,191992
290490,201704,1082,775,307,725425.4,286722.6,1012148.0
290500,201704,646,318,328,297966,307336,605302
290510,201704,205,150,55,139362,51535,190897
290515,201704,129,71,58,66527,54346,120873
290520,201704,1323,839,484,784550.61,449733.7,1234284.31
290530,201704,306,281,25,263297,23425,286722
290540,201704,89,59,30,55283,28110,83393
290550,201704,149,126,23,118062,21204.31,139266.31
290560,201704,3356,1337,2019,1251748.04,1891612.4,3143360.44
290570,201704,5533,2817,2716,2636880.69,2542011.39,5178892.08
290580,201704,1224,691,533,646009.97,499421,1145430.97
290590,201704,524,433,91,404691,85267,489958
290600,201704,1663,1160,503,1083548.08,471029.9,1554577.98
290610,201704,218,196,22,183203,20614,203817
290620,201704,309,269,40,252053,37480,289533
290630,201704,2093,884,1209,824561,1127309.47,1951870.47
290640,201704,146,117,29,109629,27173,136802
290650,201704,1644,765,879,715859.42,823623,1539482.42
290660,201704,263,212,51,198644,47787,246431
290670,201704,970,514,456,481337,426917.9,908254.9
290680,201704,1136,924,212,864851,197707,1062558
290682,201704,278,202,76,188367.15,71193.63,259560.78
290685,201704,224,145,79,134928,74023,208951
290687,201704,893,585,308,544818.7,286600.29,831418.99
290689,201704,107,65,42,60891,39339.95,100230.95
290690,201704,688,284,404,266099,377694.77,643793.77
290700,201704,258,119,139,111503,130243,241746
290710,201704,661,429,232,401973,217384,619357
290720,201704,1012,827,185,774899,172876.5,947775.5
290730,201704,1117,629,488,587545.85,456319,1043864.85
290740,201704,14,11,3,10307,2811,13118
290750,201704,1313,590,723,552457.83,675377.06,1227834.89
290755,201704,65,57,8,53409,7496,60905
290760,201704,300,265,35,248305,32795,281100
290770,201704,183,172,11,161154.63,10307,171461.63
290780,201704,916,735,181,686786.23,167816.7,854602.93
290790,201704,430,291,139,272098,130243,402341
290800,201704,2596,1021,1575,953609.07,1474678.71,2428287.78
290810,201704,430,297,133,278008,124621,402629
290820,201704,362,222,140,206351.91,131180,337531.91
290830,201704,380,255,125,238935,117125,356060
290840,201704,1583,958,625,896100.4,582645.44,1478745.84
290850,201704,733,403,330,376580.3,308273,684853.3
290860,201704,660,292,368,273604,344535,618139
290870,201704,655,473,182,442920,170534,613454
290880,201704,124,66,58,61842,54346,116188
290890,201704,360,260,100,243620,93700,337320
290900,201704,160,127,33,118999,30921,149920
290910,201704,359,274,85,256738,79645,336383
290920,201704,230,190,40,178030,37480,215510
290930,201704,786,599,187,560485.29,175219,735704.29
290940,201704,253,206,47,192272.4,44039,236311.4
290950,201704,166,93,73,87141,68401,155542
290960,201704,429,286,143,266764.72,133709.9,400474.62
290970,201704,244,215,29,201267.6,27173,228440.6
290980,201704,1442,1017,425,948854.02,397195.1,1346049.12
290990,201704,363,302,61,282965,57101.89,340066.89
291000,201704,828,235,593,220195,555359.9,775554.9
291005,201704,1930,816,1114,762849.28,1043523.32,1806372.60
291010,201704,154,141,13,132117,12181,144298
291020,201704,98,80,18,74960,16866,91826
291030,201704,87,66,21,61842,19677,81519
291040,201704,572,284,288,266098.63,269856,535954.63
291050,201704,1253,708,545,662124.92,510665,1172789.92
291060,201704,1449,776,673,726456.1,630601,1357057.1
291070,201704,1854,1372,482,1279990.5,447991.18,1727981.68
291072,201704,7169,2600,4569,2433173.28,4278608.7,6711781.98
291075,201704,189,152,37,142424,34669,177093
291077,201704,45,30,15,28110,14055,42165
291080,201704,18581,8064,10517,7534364.18,9841732.92,17376097.10
291085,201704,269,216,53,202392,49656.32,252048.32
291090,201704,310,113,197,105600,184579.63,290179.63
291100,201704,726,209,517,195833,484419.63,680252.63
291110,201704,390,299,91,280163,85267,365430
291120,201704,2508,1158,1350,1084906,1263002.08,2347908.08
291125,201704,57,30,27,28110,25299,53409
291130,201704,205,177,28,165849,26236,192085
291140,201704,114,81,33,75897,30921,106818
291150,201704,366,149,217,139613,203329,342942
291160,201704,330,278,52,259549.25,48724,308273.25
291165,201704,12,9,3,8433,2811,11244
291170,201704,2751,1400,1351,1309364.45,1263451,2572815.45
291180,201704,1310,489,821,458055,769223,1227278
291185,201704,65,62,3,58094,2811,60905
291190,201704,1194,506,688,472616.5,644122.9,1116739.4
291200,201704,162,118,44,110566,41228,151794
291210,201704,2149,815,1334,760572.27,1248187.54,2008759.81
291220,201704,242,184,58,171471.43,54346,225817.43
291230,201704,1028,342,686,319611,642782,962393
291240,201704,440,417,23,389511,21551,411062
291250,201704,414,340,74,318580,69338,387918
291260,201704,33,22,11,20614,10307,30921
291270,201704,1185,473,712,443201,666862.9,1110063.9
291280,201704,369,162,207,151606.6,193648.53,345255.13
291290,201704,1702,857,845,801884.6,791016,1592900.6
291300,201704,228,180,48,168004.1,44976,212980.1
291310,201704,246,219,27,204922,25299,230221
291320,201704,1373,979,394,914230.9,368148.8,1282379.7
291330,201704,129,106,23,97541.7,21551,119092.7
291340,201704,135,77,58,72149,54346,126495
291345,201704,121,82,39,76834,36543,113377
291350,201704,1506,463,1043,433643.6,977104.15,1410747.75
291360,201704,8421,4134,4287,3863361.98,4013965.28,7877327.26
291370,201704,1030,552,478,516943,447886,964829
291380,201704,255,202,53,189274,49661,238935
291390,201704,3797,1653,2144,1544843.25,2008928,3553771.25
291400,201704,2018,1429,589,1332978.79,549959.39,1882938.18
291410,201704,159,141,18,131180,16866,148046
291420,201704,99,70,29,65590,27173,92763
291430,201704,181,100,81,93004.74,74960,167964.74
291440,201704,487,393,94,365846.25,88078,453924.25
291450,201704,839,516,323,481338.54,301714,783052.54
291460,201704,1658,1341,317,1254080.8,296880,1550960.8
291465,201704,2231,1038,1193,972217.27,1117614.89,2089832.16
291470,201704,2675,1360,1315,1270601.95,1231156,2501757.95
291480,201704,11595,5138,6457,4803753.01,6041376.18,10845129.19
291490,201704,545,219,326,205203,305462,510665
291500,201704,360,187,173,175219,162101,337320
291510,201704,1262,479,783,447683.75,733389.9,1181073.65
291520,201704,960,433,527,405721,493477.63,899198.63
291530,201704,1032,270,762,252990,713694.26,966684.26
291535,201704,112,94,18,88078,16866,104944
291540,201704,359,108,251,101196,234250.8,335446.8
291550,201704,1167,536,631,500359.19,590666.9,1091026.09
291560,201704,5597,2901,2696,2705754.63,2513750.41,5219505.04
291570,201704,188,96,92,89952,86204,176156
291580,201704,1171,702,469,657031,438502.86,1095533.86
291590,201704,71,28,43,26236,40291,66527
291600,201704,1349,603,746,564074,698703,1262777
291610,201704,1200,522,678,487853.74,635231,1123084.74
291620,201704,553,249,304,233313,284332.65,517645.65
291630,201704,496,164,332,153668,311084,464752
291640,201704,3751,1848,1903,1725500.58,1782008.71,3507509.29
291650,201704,341,217,124,202214.97,116001,318215.97
291660,201704,454,180,274,167980.3,255660.45,423640.75
291670,201704,212,130,82,121248,76834,198082
291680,201704,703,387,316,361683,295999,657682
291685,201704,557,297,260,278055,243432.6,521487.6
291690,201704,532,268,264,251116,246431,497547
291700,201704,891,704,187,659648,174282,833930
291710,201704,1689,757,932,708625.34,872141.83,1580767.17
291720,201704,388,261,127,244552.32,118999,363551.32
291730,201704,891,506,385,472482.25,360735.63,833217.88
291733,201704,254,176,78,164630.9,73086,237716.9
291735,201704,62,51,11,47787,10307,58094
291740,201704,333,249,84,232985.05,78708,311693.05
291750,201704,1886,1240,646,1155431.48,603679.81,1759111.29
291760,201704,3097,1642,1455,1532034.24,1361648.5,2893682.74
291770,201704,758,518,240,483303.03,224880,708183.03
291780,201704,48,27,21,25299,19677,44976
291790,201704,172,76,96,71212,89952,161164
291800,201704,9607,3669,5938,3430365.46,5559737.55,8990103.01
291810,201704,1152,809,343,757185.22,321391,1078576.22
291820,201704,254,185,69,173345,64653,237998
291830,201704,1042,374,668,349239,624970,974209
291835,201704,624,563,61,527063,57157,584220
291840,201704,4496,2271,2225,2123210.62,2083688.88,4206899.50
291845,201704,320,109,211,102133,197697.63,299830.63
291850,201704,307,266,41,249007.75,38417,287424.75
291855,201704,258,103,155,96511,145235,241746
291860,201704,211,127,84,118063,78708,196771
291870,201704,77,31,46,29047,43102,72149
291875,201704,174,157,17,147109,15929,163038
291880,201704,472,372,100,347768,93700,441468
291890,201704,239,78,161,73076.63,149170.5,222247.13
291900,201704,53,30,23,28110,21551,49661
291905,201704,139,91,48,84986,44976,129962
291910,201704,181,142,39,133054,36543,169597
291915,201704,378,335,43,312257,40291,352548
291920,201704,4645,2393,2252,2239880.71,2108483.34,4348364.05
291930,201704,178,102,76,94637.7,71212,165849.7
291940,201704,296,161,135,150857,125867.21,276724.21
291950,201704,1107,913,194,853608.6,181778,1035386.6
291955,201704,905,536,369,502232,345753,847985
291960,201704,165,109,56,102133,52472,154605
291970,201704,783,593,190,555641,178030,733671
291980,201704,1470,1304,166,1218215.79,154605.7,1372821.49
291990,201704,120,112,8,104944,7496,112440
291992,201704,155,76,79,70462.4,74023,144485.4
291995,201704,138,98,40,91826,37480,129306
292000,201704,375,275,100,257394,93700,351094
292010,201704,278,204,74,190492.1,68401,258893.1
292020,201704,257,187,70,175219,65590,240809
292030,201704,132,103,29,96511,27173,123684
292040,201704,596,299,297,280163,278289,558452
292045,201704,82,75,7,70275,6559,76834
292050,201704,858,570,288,533099.26,269856,802955.26
292060,201704,919,765,154,714932.59,144298,859230.59
292070,201704,56,25,31,23425,29047,52472
292080,201704,108,74,34,69338,31858,101196
292090,201704,465,158,307,147589.18,287659,435248.18
292100,201704,1317,545,772,509119.35,722390.26,1231509.61
292105,201704,193,162,31,151794,29047,180841
292110,201704,2048,750,1298,702431.42,1213682.68,1916114.10
292120,201704,608,493,115,460828.96,107755,568583.96
292130,201704,436,255,181,238935,169597,408532
292140,201704,195,154,41,144298,38287.61,182585.61
292145,201704,151,77,74,72149,69309.9,141458.9
292150,201704,1375,1102,273,1032574,254791.57,1287365.57
292160,201704,182,148,34,138394.9,31858,170252.9
292170,201704,1215,1069,146,999545.23,136745.78,1136291.01
292180,201704,186,136,50,127432,46850,174282
292190,201704,164,100,64,93700,59968,153668
292200,201704,1232,443,789,414156.24,738656.68,1152812.92
292205,201704,114,102,12,95574,11244,106818
292210,201704,347,236,111,219774,102649.25,322423.25
292220,201704,23,17,6,15929,5622,21551
292225,201704,38,33,5,30921,4685,35606
292230,201704,867,705,162,658192.72,151794,809986.72
292240,201704,600,416,184,388715,172408,561123
292250,201704,1584,996,588,933252,550956,1484208
292260,201704,436,234,202,219258,188524.4,407782.4
292265,201704,277,191,86,178685.9,80582,259267.9
292270,201704,777,331,446,309210.1,416965.4,726175.5
292273,201704,194,113,81,105117.34,75897,181014.34
292275,201704,151,69,82,64653,76552.9,141205.9
292280,201704,131,91,40,85267,37480,122747
292285,201704,56,47,9,43383.1,8433,51816.1
292290,201704,485,315,170,292710.01,159009,451719.01
292300,201704,1582,604,978,565385.9,914480.99,1479866.89
292303,201704,84,57,27,53409,25299,78708
292305,201704,104,72,32,67464,29984,97448
292310,201704,825,505,320,472830,298626.99,771456.99
292320,201704,634,478,156,447604.9,146172,593776.9
292330,201704,198,98,100,91826,93700,185526
292335,201704,264,199,65,186463,60905,247368
292340,201704,551,376,175,351585.93,163975,515560.93
292350,201704,247,128,119,119139.55,111221.9,230361.45
292360,201704,685,518,167,483679.5,156479,640158.5
292370,201704,782,591,191,553767,178967,732734
292380,201704,635,488,147,456319.51,137739,594058.51
292390,201704,502,190,312,178030,290610.75,468640.75
292400,201704,3264,1996,1268,1851540.35,1184305,3035845.35
292405,201704,253,166,87,155073.5,81237.9,236311.4
292410,201704,157,91,66,85267,61842,147109
292420,201704,302,257,45,240527.9,42165,282692.9
292430,201704,482,391,91,366367,84798.5,451165.5
292440,201704,570,482,88,449760,82456,532216
292450,201704,245,188,57,176156,53409,229565
292460,201704,586,430,156,402347.9,145469.25,547817.15
292465,201704,176,151,25,141487,22700.24,164187.24
292467,201704,93,52,41,48724,38417,87141
292470,201704,247,164,83,153668,77771,231439
292480,201704,288,194,94,180841.75,88078,268919.75
292490,201704,228,147,81,137739,75897,213636
292500,201704,1183,504,679,472041,636054.35,1108095.35
292510,201704,3221,1434,1787,1342721.36,1671740.35,3014461.71
292520,201704,1015,481,534,449521.75,500340,949861.75
292525,201704,372,258,114,241741.32,106818,348559.32
292530,201704,4096,1650,2446,1543991.4,2289720.3,3833711.7
292540,201704,481,252,229,236124,214291.9,450415.9
292550,201704,1032,553,479,517685.23,448353.27,966038.50
292560,201704,311,291,20,272667,18740,291407
292570,201704,288,221,67,206754,62779,269533
292575,201704,450,274,176,256457,164912,421369
292580,201704,880,552,328,515818.5,306773.9,822592.4
292590,201704,506,434,72,406360.98,67464,473824.98
292593,201704,137,107,30,100259,28110,128369
292595,201704,163,121,42,113377,39354,152731
292600,201704,1211,903,308,845799,288596,1134395
292610,201704,116,89,27,82924.5,25046.01,107970.51
292620,201704,511,420,91,393250,85267,478517
292630,201704,1302,752,550,703064.5,512071.3,1215135.8
292640,201704,747,520,227,487240,212699,699939
292650,201704,189,164,25,153086,23425,176511
292660,201704,1947,1391,556,1297648.02,515724.96,1813372.98
292665,201704,128,94,34,88078,31858,119936
292670,201704,367,310,57,290466,53409,343875
292680,201704,243,188,55,176156,51535,227691
292690,201704,174,132,42,123684,39354,163038
292700,201704,905,585,320,547208.9,299558.9,846767.8
292710,201704,95,82,13,76834,11900,88734
292720,201704,803,445,358,416177.92,335259,751436.92
292730,201704,212,101,111,93700.75,104007,197707.75
292740,201704,63482,31360,32122,29312308.42,30070694.84,59383003.26
292750,201704,374,265,109,247368.07,101337.01,348705.08
292760,201704,315,245,70,228572.25,65590,294162.25
292770,201704,781,329,452,306609.03,420635.64,727244.67
292780,201704,425,158,267,147822.53,250179,398001.53
292790,201704,717,342,375,320454,350438,670892
292800,201704,1075,650,425,608113,398225,1006338
292805,201704,424,127,297,118764.75,278289,397053.75
292810,201704,1429,838,591,784643.9,553767,1338410.9
292820,201704,738,595,143,555642.3,133700.9,689343.2
292830,201704,104,79,25,74023,23425,97448
292840,201704,637,525,112,491457,104929.95,596386.95
292850,201704,133,88,45,82452,42165,124617
292860,201704,2005,1163,842,1085266.07,788692,1873958.07
292870,201704,3272,2201,1071,2061331.9,1003517.63,3064849.53
292880,201704,1397,921,476,859277.33,446012,1305289.33
292890,201704,446,385,61,360717,57157,417874
292895,201704,133,90,43,82995.71,40291,123286.71
292900,201704,381,285,96,267045,89952,356997
292905,201704,429,214,215,200518,201268,401786
292910,201704,380,294,86,275151,80582,355733
292920,201704,511,225,286,210825,267982,478807
292925,201704,520,480,40,449094.73,37245.75,486340.48
292930,201704,544,336,208,314832,194896,509728
292935,201704,297,124,173,116188,162101,278289
292937,201704,225,149,76,139613,71212,210825
292940,201704,188,142,46,133054,43102,176156
292950,201704,1057,545,512,508554.05,478808,987362.05
292960,201704,511,340,171,318580,160227,478807
292970,201704,285,197,88,183934,82456,266390
292975,201704,160,88,72,82456,67277,149733
292980,201704,252,172,80,159412.42,74960,234372.42
292990,201704,1262,925,337,861394.92,315585.26,1176980.18
293000,201704,100,74,26,69338,24352.63,93690.63
293010,201704,2551,1578,973,1474268.33,907392.7,2381661.03
293015,201704,633,498,135,466345,125868,592213
293020,201704,339,275,64,257675,59968,317643
293030,201704,627,544,83,508229.82,77771,586000.82
293040,201704,335,261,74,244557,69301,313858
293050,201704,2608,1521,1087,1416401.13,1014462.39,2430863.52
293060,201704,245,194,51,181778,46850.4,228628.4
293070,201704,3202,1600,1602,1492427.34,1499884.63,2992311.97
293075,201704,85,56,29,52472,27173,79645
293076,201704,73,44,29,41228,27173,68401
293077,201704,412,247,165,227941.66,154605,382546.66
293080,201704,459,399,60,373863,56220,430083
293090,201704,132,112,20,104944,18427.7,123371.7
293100,201704,481,346,135,324202,126495,450697
293105,201704,330,224,106,209607,99322,308929
293110,201704,168,119,49,111503,45913,157416
293120,201704,312,207,105,193959,98197.6,292156.6
293130,201704,245,160,85,149920,79363.9,229283.9
293135,201704,7593,3030,4563,2832405.47,4269067.35,7101472.82
293140,201704,176,117,59,109629,54534,164163
293150,201704,328,284,44,264703.1,41228,305931.1
293160,201704,431,238,193,223006,180559.9,403565.9
293170,201704,177,125,52,116843.9,47881,164724.9
293180,201704,439,297,142,278008,133054,411062
293190,201704,1246,865,381,805940.98,356919,1162859.98
293200,201704,509,450,59,420527,55283,475810
293210,201704,329,242,87,226605,81519,308124
293220,201704,2742,1088,1654,1018278.45,1547456.55,2565735.00
293230,201704,1776,634,1142,592653.9,1070054,1662707.9
293240,201704,217,199,18,186463,16866,203329
293245,201704,111,92,19,86204,17803,104007
293250,201704,722,263,459,245795.24,429802,675597.24
293260,201704,309,257,52,239279.49,48724,288003.49
293270,201704,1185,558,627,520692.48,587499,1108191.48
293280,201704,220,123,97,115251,90889,206140
293290,201704,3016,1955,1061,1830898.5,993863,2824761.5
293300,201704,656,467,189,435756.79,176296.55,612053.34
293305,201704,162,135,27,126495,25299,151794
293310,201704,137,103,34,96511,31858,128369
293315,201704,145,112,33,104944,30921,135865
293317,201704,92,66,26,61842,24362,86204
293320,201704,931,527,404,492862.25,378263,871125.25
293325,201704,181,67,114,62779,106799.26,169578.26
293330,201704,12362,5730,6632,5358661.79,6208053.88,11566715.67
293340,201704,243,172,71,161164,65590,226754
293345,201704,244,192,52,179904,48724,228628
293350,201704,623,315,308,295155,287143.65,582298.65
293360,201704,1536,1092,444,1021986,414810.35,1436796.35
310010,201704,158,80,78,74960,72524,147484
310020,201704,1024,568,456,529780.05,425117.26,954897.31
310030,201704,331,268,63,249448.94,58749.9,308198.84
310040,201704,50,33,17,30921,15929,46850
310050,201704,248,159,89,148047,83393,231440
310060,201704,238,163,75,152731,70275,223006
310070,201704,20,9,11,8433,10307,18740
310080,201704,52,28,24,26236,22488,48724
310090,201704,918,475,443,440204.14,413029.9,853234.04
310100,201704,286,214,72,200518,67464,267982
310110,201704,722,385,337,359709.09,315581.6,675290.69
310120,201704,368,207,161,193303.1,150489.61,343792.71
310130,201704,34,21,13,19677,12181,31858
310140,201704,30,16,14,14992,13118,28110
310150,201704,1275,882,393,821190.06,367678.9,1188868.96
310160,201704,2143,1092,1051,1016460.05,981414.84,1997874.89
310163,201704,83,48,35,44976,32795,77771
310170,201704,2493,995,1498,932194,1401096.3,2333290.3
310180,201704,117,43,74,40291,68963.2,109254.2
310190,201704,468,307,161,287659,150013.7,437672.7
310200,201704,508,322,186,301714,174001,475715
310205,201704,51,40,11,37480,10307,47787
310210,201704,283,224,59,209888,55283,265171
310220,201704,47,29,18,27173,16866,44039
310230,201704,263,183,80,171104.37,74960,246064.37
310240,201704,104,91,13,85267,12181,97448
310250,201704,100,81,19,75897,17803,93700
310260,201704,815,427,388,397476.35,362834.51,760310.86
310270,201704,267,176,91,164369,85267,249636
310280,201704,361,268,93,249524.1,87141,336665.1
310285,201704,211,151,60,141184.35,56220,197404.35
310290,201704,251,146,105,136802,98385,235187
310300,201704,147,122,25,114314,23425,137739
310310,201704,5,4,1,3748,937,4685
310320,201704,21,14,7,13118,6559,19677
310330,201704,31,22,9,20614,8433,29047
310340,201704,1459,931,528,864180.35,493518.25,1357698.60
310350,201704,2750,1483,1267,1384844.25,1186616.9,2571461.15
310360,201704,42,34,8,31858,7496,39354
310370,201704,120,98,22,91826,20333,112159
310375,201704,105,39,66,36543,61824,98367
310380,201704,51,30,21,28110,19677,47787
310390,201704,100,69,31,64653,29047,93700
310400,201704,2224,1415,809,1321038.81,757733.9,2078772.71
310410,201704,124,66,58,61842,54346,116188
310420,201704,649,353,296,329918.1,276406.43,606324.53
310430,201704,327,215,112,201173.9,104944,306117.9
310440,201704,57,37,20,34669,18740,53409
310445,201704,79,64,15,59968,14055,74023
310450,201704,846,530,316,495142.1,296092,791234.1
310460,201704,266,186,80,174282,74960,249242
310470,201704,495,311,184,291407,172408,463815
310480,201704,89,62,27,58094,25299,83393
310490,201704,473,220,253,205203.1,237061,442264.1
310500,201704,122,55,67,51535,62779,114314
310510,201704,621,395,226,368893.8,211743.63,580637.43
310520,201704,130,85,45,79645,42165,121810
310530,201704,82,38,44,35606,40946.9,76552.9
310540,201704,446,278,168,258144.63,157416,415560.63
310550,201704,77,53,24,49661,22488,72149
310560,201704,2825,1947,878,1813706.65,821088.42,2634795.07
310570,201704,156,99,57,92763,53409,146172
310590,201704,330,222,108,207593,101196,308789
310600,201704,159,94,65,86344.85,60905,147249.85
310610,201704,59,22,37,20614,34669,55283
310620,201704,44127,21105,23022,19704988.28,21536933.61,41241921.89
310630,201704,516,329,187,306025.05,173657.61,479682.66
310640,201704,132,110,22,102882.6,20614,123496.6
310650,201704,153,134,19,124621,17803,142424
310660,201704,88,53,35,49661,32795,82456
310665,201704,47,34,13,31858,12181,44039
310670,201704,6118,2864,3254,2676336.41,3043538.92,5719875.33
310680,201704,51,34,17,31858,15929,47787
310690,201704,548,400,148,370623.88,138676,509299.88
310700,201704,68,44,24,41228,22488,63716
310710,201704,1239,824,415,771470,388574,1160044
310720,201704,85,28,57,26236,53409,79645
310730,201704,1321,913,408,855200,382296,1237496
310740,201704,1004,565,439,527344.2,411099.63,938443.83
310750,201704,242,140,102,130243.29,95574,225817.29
310760,201704,67,51,16,47787,14992,62779
310770,201704,84,44,40,41228,37480,78708
310780,201704,411,332,79,311075,74023,385098
310790,201704,96,77,19,72149,17803,89952
310800,201704,453,214,239,200049.5,223652.53,423702.03
310810,201704,162,113,49,105497,44976,150473
310820,201704,377,295,82,276415,76552.9,352967.9
310825,201704,180,146,34,136802,31858,168660
310830,201704,465,219,246,204554.61,229283.9,433838.51
310840,201704,391,222,169,208014,158071.9,366085.9
310850,201704,109,88,21,82456,19677,102133
310855,201704,374,294,80,275478,74960,350438
310860,201704,1342,1006,336,938459.45,313127.95,1251587.40
310870,201704,53,42,11,39354,10307,49661
310880,201704,78,58,20,54346,18740,73086
310890,201704,310,184,126,172408,118062,290470
310900,201704,635,292,343,271228.95,321373,592601.95
310910,201704,242,168,74,156105.1,69338,225443.1
310920,201704,498,295,203,272668.2,189274.7,461942.9
310925,201704,25,19,6,17803,5341,23144
310930,201704,1096,650,446,608646.78,417803.2,1026449.98
310940,201704,677,350,327,327359.9,306399,633758.9
310945,201704,122,74,48,69338,44976,114314
310950,201704,256,200,56,187400,52472,239872
310960,201704,88,33,55,30921,51531,82452
310970,201704,168,103,65,96511,59999.2,156510.2
310980,201704,37,19,18,17803,16866,34669
310990,201704,154,88,66,82456,61842,144298
311000,201704,802,417,385,387919.9,360465,748384.9
311010,201704,40,33,7,30921,6559,37480
311020,201704,38,24,14,22488,13118,35606
311030,201704,397,229,168,212700,157416,370116
311040,201704,35,30,5,28110,4685,32795
311050,201704,462,193,269,180279,251771.9,432050.9
311060,201704,750,439,311,410219.2,291407,701626.2
311070,201704,313,140,173,131180,162101,293281
311080,201704,105,55,50,51535,46850,98385
311090,201704,393,180,213,168660,199581,368241
311100,201704,609,366,243,342661,227409.9,570070.9
311110,201704,650,439,211,411343,197698,609041
311115,201704,60,44,16,41228,14992,56220
311120,201704,986,517,469,482505.4,438843.95,921349.35
311130,201704,414,237,177,221881.6,165849,387730.6
311140,201704,155,69,86,64653,79785.55,144438.55
311150,201704,353,229,124,214456,115953.75,330409.75
311160,201704,741,530,211,494736.7,197239,691975.7
311170,201704,73,51,22,47787,20332.9,68119.9
311180,201704,335,217,118,202766.8,110285,313051.8
311190,201704,37,21,16,19677,14992,34669
311200,201704,353,242,111,225161.3,104007,329168.3
311205,201704,30,19,11,17568.75,9932.2,27500.95
311210,201704,49,41,8,38417,7496,45913
311220,201704,11,10,1,9370,937,10307
311230,201704,1613,1031,582,962976.65,545148.16,1508124.81
311240,201704,163,99,64,92763,59968,152731
311250,201704,61,30,31,28110,29047,57157
311260,201704,559,334,225,312958,210825,523783
311265,201704,106,72,34,67464,31858,99322
311270,201704,275,190,85,178030,79645,257675
311280,201704,214,96,118,89952,110003.8,199955.8
311290,201704,109,88,21,82175,19115,101290
311300,201704,543,338,205,315769.88,191804,507573.88
311310,201704,23,19,4,17803,3748,21551
311320,201704,654,485,169,453508,158353,611861
311330,201704,995,738,257,691178.75,239872.7,931051.45
311340,201704,2532,1800,732,1678602.72,685200.83,2363803.55
311350,201704,269,209,60,195833,56220,252053
311360,201704,169,106,63,99322,59031,158353
311370,201704,1167,452,715,421569.25,668877.45,1090446.70
311380,201704,7,6,1,5622,937,6559
311390,201704,282,152,130,142424,121341.6,263765.6
311400,201704,149,97,52,90889,48715,139604
311410,201704,94,55,39,51535,36543,88078
311420,201704,288,164,124,151097.1,116188,267285.1
311430,201704,839,546,293,509636.1,274541,784177.1
311440,201704,490,341,149,318580.4,139331.9,457912.3
311450,201704,308,190,118,178030,110566,288596
311455,201704,302,204,98,190857.9,91544.9,282402.8
311460,201704,130,51,79,47787,73324.93,121111.93
311470,201704,19,10,9,9370,8433,17803
311480,201704,24,7,17,6559,15929,22488
311490,201704,17,10,7,9370,6559,15929
311500,201704,19,8,11,7496,10307,17803
311510,201704,625,424,201,396351,188337,584688
311520,201704,42,32,10,29328.1,9370,38698.1
311530,201704,1815,1349,466,1255161.91,436642,1691803.91
311535,201704,62,48,14,44976,13118,58094
311540,201704,33,29,4,27173,3748,30921
311545,201704,180,136,44,127432,41228,168660
311547,201704,32,23,9,21551,8433,29984
311550,201704,566,260,306,243620,286703.63,530323.63
311560,201704,42,28,14,26236,13118,39354
311570,201704,305,197,108,184026.8,101196,285222.8
311580,201704,284,160,124,149638.9,116188,265826.9
311590,201704,35,29,6,27173,5622,32795
311600,201704,87,70,17,65590,15929,81519
311610,201704,263,227,36,211449.95,33732,245181.95
311615,201704,83,68,15,63088.21,14055,77143.21
311620,201704,16,11,5,10307,4685,14992
311630,201704,72,60,12,56220,11244,67464
311640,201704,115,66,49,61842,45913,107755
311650,201704,118,87,31,80816.25,29047,109863.25
311660,201704,383,180,203,168660,190211,358871
311670,201704,161,101,60,94085,56220,150305
311680,201704,220,162,58,150135.94,53596.4,203732.34
311690,201704,15,8,7,7496,6559,14055
311700,201704,201,136,65,127150.9,60905,188055.9
311710,201704,215,140,75,130899,70275,201174
311720,201704,32,25,7,23425,6559,29984
311730,201704,513,338,175,316144,163975,480119
311740,201704,30,20,10,18740,9370,28110
311750,201704,698,476,222,444138.4,208014,652152.4
311760,201704,64,37,27,34669,25299,59968
311770,201704,388,183,205,169561.61,192085,361646.61
311780,201704,168,99,69,92763,64341,157104
311783,201704,73,64,9,59968,8433,68401
311787,201704,31,13,18,12181,16866,29047
311790,201704,265,127,138,118999,129306,248305
311800,201704,603,411,192,381782.15,179904,561686.15
311810,201704,40,33,7,30921,6559,37480
311820,201704,105,86,19,80582,17803,98385
311830,201704,1824,1174,650,1095530.95,606426.4,1701957.35
311840,201704,980,536,444,498017.5,414284.66,912302.16
311850,201704,11,5,6,4685,5622,10307
311860,201704,9050,4201,4849,3923652.8,4536190.41,8459843.21
311870,201704,161,86,75,80582,70275,150857
311880,201704,946,703,243,657483.9,227691,885174.9
311890,201704,223,114,109,106818,102133,208951
311900,201704,88,37,51,34669,47787,82456
311910,201704,1353,846,507,789845.05,472857.15,1262702.20
311920,201704,233,151,82,141253,76834,218087
311930,201704,893,514,379,481337,354607.9,835944.9
311940,201704,2281,1151,1130,1075911.25,1055878.05,2131789.30
311950,201704,205,115,90,107381,84049,191430
311960,201704,66,46,20,43102,18740,61842
311970,201704,27,15,12,12508.95,11244,23752.95
311980,201704,41,31,10,29047,9370,38417
311990,201704,62,47,15,44039,14055,58094
311995,201704,64,44,20,41228,18740,59968
312000,201704,31,21,10,19395.9,9370,28765.9
312010,201704,86,61,25,57157,23425,80582
312015,201704,89,67,22,62498,20614,83112
312020,201704,147,92,55,86204,51253.9,137457.9
312030,201704,37,32,5,29329,4685,34014
312040,201704,74,48,26,44976,24362,69338
312050,201704,224,116,108,108692,101196,209888
312060,201704,72,49,23,45913,20895.1,66808.1
312070,201704,79,45,34,42165,31858,74023
312080,201704,502,207,295,193959,276415,470374
312083,201704,43,32,11,29984,10307,40291
312087,201704,100,77,23,72149,21551,93700
312090,201704,2683,1473,1210,1366712.85,1130326.62,2497039.47
312100,201704,163,115,48,107755,44976,152731
312110,201704,123,80,43,74960,40291,115251
312120,201704,145,105,40,98385,37480,135865
312125,201704,92,49,43,45725.6,40291,86016.6
312130,201704,127,83,44,77771,41228,118999
312140,201704,132,103,29,96511,27173,123684
312150,201704,41,33,8,30921,7496,38417
312160,201704,1509,1002,507,936016.85,473560.1,1409576.95
312170,201704,11,9,2,8433,1874,10307
312180,201704,134,86,48,79645.75,44695,124340.75
312190,201704,31,28,3,26236,2811,29047
312200,201704,695,599,96,559623.35,89952,649575.35
312210,201704,93,59,34,55283,31858,87141
312220,201704,120,87,33,81285,30921,112206
312230,201704,3353,1661,1692,1553294.79,1584282.62,3137577.41
312235,201704,124,81,43,75897,40291,116188
312240,201704,109,70,39,65590,36543,102133
312245,201704,151,102,49,95570,45913,141483
312247,201704,52,37,15,33920,14055,47975
312250,201704,170,81,89,75429,83393,158822
312260,201704,95,65,30,60062.6,28110,88172.6
312270,201704,137,84,53,78708,49661,128369
312280,201704,26,16,10,14992,9370,24362
312290,201704,156,110,46,102789,42166,144955
312300,201704,198,132,66,123684,61842,185526
312310,201704,54,50,4,46850,3748,50598
312320,201704,416,254,162,236124,150529.25,386653.25
312330,201704,88,77,11,71400,10025.9,81425.9
312340,201704,33,14,19,13118,17803,30921
312350,201704,16,10,6,9370,5622,14992
312352,201704,95,67,28,62779,26236,89015
312360,201704,556,256,300,238935,280444.1,519379.1
312370,201704,277,163,114,152449.9,106818,259267.9
312380,201704,138,88,50,82456,46850,129306
312385,201704,182,147,35,137739,32795,170534
312390,201704,293,186,107,174282,99604,273886
312400,201704,370,275,95,257675,88547,346222
312410,201704,834,273,561,255332.5,525091,780423.5
312420,201704,592,478,114,447886,106818,554704
312430,201704,843,625,218,583050.94,203329.1,786380.04
312440,201704,45,32,13,29984,12181,42165
312450,201704,208,129,79,120873,74023,194896
312460,201704,54,25,29,23425,27173,50598
312470,201704,52,34,18,31858,16866,48724
312480,201704,219,135,84,126495,78426.9,204921.9
312490,201704,243,168,75,157416,70275,227691
312500,201704,31,18,13,16866,12181,29047
312510,201704,410,159,251,148983,234582.36,383565.36
312520,201704,42,16,26,14992,24362,39354
312530,201704,44,34,10,31858,9370,41228
312540,201704,98,86,12,80582,11244,91826
312550,201704,35,27,8,25299,7496,32795
312560,201704,188,138,50,129025,46568.9,175593.9
312570,201704,427,254,173,237623.2,161422.23,399045.43
312580,201704,85,46,39,42821,36543,79364
312590,201704,273,217,56,202253,52472,254725
312595,201704,143,130,13,121810,12181,133991
312600,201704,78,48,30,44555,28110,72665
312610,201704,1593,827,766,769654.29,715962.3,1485616.59
312620,201704,181,126,55,118062,51535,169597
312630,201704,67,54,13,50598,12181,62779
312640,201704,49,15,34,14055,31858,45913
312650,201704,139,112,27,104663,25299,129962
312660,201704,59,43,16,40010,14992,55002
312670,201704,843,555,288,518489.95,269621.75,788111.70
312675,201704,41,31,10,29047,9370,38417
312680,201704,83,57,26,53034.2,24362,77396.2
312690,201704,237,125,112,117115.63,104662.9,221778.53
312695,201704,26,20,6,18740,5622,24362
312700,201704,187,103,84,96511,78708,175219
312705,201704,72,60,12,56220,10962.9,67182.9
312707,201704,87,63,24,59031,22488,81519
312710,201704,1831,971,860,908366,805612,1713978
312720,201704,63,33,30,30921,28110,59031
312730,201704,291,172,119,160227,111221.9,271448.9
312733,201704,47,42,5,39354,4685,44039
312735,201704,20,15,5,14055,4685,18740
312737,201704,76,39,37,36543,34669,71212
312738,201704,48,34,14,31858,13118,44976
312740,201704,71,50,21,46850,19677,66527
312750,201704,69,50,19,46850,17803,64653
312760,201704,270,194,76,181778,71212,252990
312770,201704,7504,3441,4063,3202923.83,3799654.94,7002578.77
312780,201704,433,338,95,316424.9,89015,405439.9
312790,201704,19,15,4,14055,3748,17803
312800,201704,1605,1118,487,1040968.98,455158.11,1496127.09
312810,201704,369,232,137,217384,128369,345753
312820,201704,190,142,48,133054,44976,178030
312825,201704,25,15,10,14055,9370,23425
312830,201704,290,168,122,156480,113687,270167
312840,201704,149,110,39,103070,36543,139613
312850,201704,21,19,2,17803,1874,19677
312860,201704,173,107,66,99978,61842,161820
312870,201704,987,509,478,475121.7,447886,923007.7
312880,201704,149,103,46,96370.45,43008.3,139378.75
312890,201704,159,106,53,99322,49661,148983
312900,201704,218,162,56,151138.1,52472,203610.1
312910,201704,184,91,93,84498.66,87141,171639.66
312920,201704,152,85,67,79645,62779,142424
312930,201704,340,243,97,227691,90889,318580
312940,201704,100,65,35,60905,32795,93700
312950,201704,683,439,244,410031.3,228628,638659.3
312960,201704,174,130,44,121810,41228,163038
312965,201704,43,38,5,35606,4685,40291
312970,201704,281,224,57,208717.1,53409,262126.1
312980,201704,2195,1185,1010,1107151.9,945803.8,2052955.7
312990,201704,48,27,21,25299,19677,44976
313000,201704,40,26,14,24362,13118,37480
313005,201704,161,125,36,116150.75,33451,149601.75
313010,201704,906,366,540,342005.1,505689.9,847695.0
313020,201704,196,102,94,95574,88078,183652
313030,201704,201,126,75,117126,70275,187401
313040,201704,56,20,36,18740,33732,52472
313050,201704,291,202,89,188337.1,83393,271730.1
313055,201704,42,29,13,27173,12181,39354
313060,201704,119,81,38,75448,35324.9,110772.9
313065,201704,57,35,22,32795,20614,53409
313070,201704,156,82,74,76834,69338,146172
313080,201704,40,17,23,15929,21551,37480
313090,201704,696,477,219,444981.4,204921.9,649903.3
313100,201704,171,63,108,59031,101188,160219
313110,201704,109,63,46,59031,43102,102133
313115,201704,132,69,63,64456.23,58094,122550.23
313120,201704,713,388,325,363275,303026,666301
313130,201704,4926,2612,2314,2430844.97,2160481.37,4591326.34
313140,201704,160,79,81,74023,75897,149920
313150,201704,320,255,65,238935,60623.9,299558.9
313160,201704,170,121,49,113377,45913,159290
313170,201704,1295,917,378,849252.06,353802.2,1203054.26
313180,201704,331,191,140,178329.84,131180,309509.84
313190,201704,675,390,285,362431.6,266296,628727.6
313200,201704,21,20,1,18740,937,19677
313210,201704,885,747,138,696052.48,129301.32,825353.80
313220,201704,217,149,68,138676,63013.25,201689.25
313230,201704,290,206,84,192086,78708,270794
313240,201704,1868,1016,852,949603.59,794384.62,1743988.21
313250,201704,1229,894,335,833088.8,311086.4,1144175.2
313260,201704,90,53,37,49661,34669,84330
313270,201704,946,537,409,499186.77,383233,882419.77
313280,201704,59,50,9,46030.14,8433,54463.14
313290,201704,223,176,47,164631,43102.9,207733.9
313300,201704,353,175,178,161540.2,166786,328326.2
313310,201704,208,106,102,99322,95574,194896
313320,201704,358,277,81,257628.55,75897,333525.55
313330,201704,1285,760,525,711183.6,490754.75,1201938.35
313340,201704,332,225,107,210825,100259,311084
313350,201704,533,360,173,335446.05,162101,497547.05
313360,201704,115,62,53,58094,49380,107474
313370,201704,188,74,114,69338,106818,176156
313375,201704,250,148,102,138676,95574,234250
313380,201704,1197,613,584,571307.74,546455,1117762.74
313390,201704,47,39,8,35606.4,7496,43102.4
313400,201704,409,259,150,242683,140269,382952
313410,201704,13,8,5,7496,4685,12181
313420,201704,4602,2338,2264,2183091.29,2114238.81,4297330.10
313430,201704,135,60,75,56220,70275,126495
313440,201704,1445,970,475,907157.65,444513,1351670.65
313450,201704,59,26,33,24362,30921,55283
313460,201704,361,172,189,159746,177093,336839
313470,201704,500,219,281,205203,262641.1,467844.1
313480,201704,157,106,51,98386,47787,146173
313490,201704,498,240,258,224875.32,241297,466172.32
313500,201704,15,10,5,9370,4685,14055
313505,201704,906,707,199,661522,186463,847985
313507,201704,90,52,38,48724,35606,84330
313510,201704,2686,1727,959,1613797.9,897646,2511443.9
313520,201704,3532,2749,783,2563904.61,733667,3297571.61
313530,201704,38,27,11,25299,10307,35606
313535,201704,95,80,15,74305,14055,88360
313540,201704,72,55,17,51535,15085.7,66620.7
313545,201704,93,76,17,71212,15929,87141
313550,201704,237,192,45,179904,41603,221507
313560,201704,335,170,165,159290,154605,313895
313570,201704,54,28,26,26236,24362,50598
313580,201704,1273,677,596,633412,556484.7,1189896.7
313590,201704,86,47,39,44039,36543,80582
313600,201704,693,403,290,377611,270887,648498
313610,201704,56,46,10,42212,9370,51582
313620,201704,1283,687,596,633442.16,555322.6,1188764.76
313630,201704,1614,1239,375,1159178.4,351094,1510272.4
313640,201704,125,68,57,63716,53409,117125
313650,201704,214,98,116,91826,108692,200518
313652,201704,11,10,1,9370,937,10307
313655,201704,52,31,21,29047,19677,48724
313657,201704,46,43,3,40291,2811,43102
313660,201704,123,88,35,82456,32795,115251
313665,201704,594,299,295,280163,276180.75,556343.75
313670,201704,9636,6649,2987,6209923.83,2798257,9008180.83
313680,201704,38,29,9,27173,8433,35606
313690,201704,158,121,37,113377,34669,148046
313695,201704,58,44,14,41228,13118,54346
313700,201704,278,219,59,204922,55283,260205
313710,201704,153,107,46,100259,43102,143361
313720,201704,968,439,529,409562.8,494071.83,903634.63
313730,201704,51,37,14,34669,13118,47787
313740,201704,158,126,32,117874.6,29984,147858.6
313750,201704,457,336,121,314550.9,113377,427927.9
313753,201704,239,166,73,154886.1,68401,223287.1
313760,201704,1123,412,711,386044,663519.56,1049563.56
313770,201704,338,240,98,224880,91826,316706
313780,201704,740,385,355,360745,332353.9,693098.9
313790,201704,26,25,1,23425,937,24362
313800,201704,130,81,49,75897,45913,121810
313810,201704,50,33,17,30921,15929,46850
313820,201704,1265,629,636,588155.1,594691.1,1182846.2
313830,201704,69,52,17,48724,15929,64653
313835,201704,50,46,4,43102,3748,46850
313840,201704,1583,967,616,901771.2,575974,1477745.2
313850,201704,175,60,115,56220,107185.39,163405.39
313860,201704,489,378,111,350346.7,103070.55,453417.25
313862,201704,178,116,62,108692,58094,166786
313865,201704,78,61,17,57157,15929,73086
313867,201704,52,39,13,36543,12181,48724
313868,201704,20,13,7,12181,6559,18740
313870,201704,128,62,66,58094,61842,119936
313880,201704,328,211,117,197354.9,109066.9,306421.8
313890,201704,316,175,141,163225.9,131554.8,294780.7
313900,201704,917,503,414,469719.25,387872,857591.25
313910,201704,135,97,38,90702,34669.1,125371.1
313920,201704,570,412,158,385575.5,148046,533621.5
313925,201704,27,23,4,21551,3748,25299
313930,201704,787,598,189,560326,177070,737396
313940,201704,1700,1065,635,993501.2,594432.9,1587934.1
313950,201704,924,585,339,546365.8,317127.9,863493.7
313960,201704,1314,765,549,712597.65,513476.1,1226073.75
313970,201704,112,82,30,76834,28110,104944
313980,201704,204,129,75,120639,70275,190914
313990,201704,348,205,143,192085,133991,326076
314000,201704,897,611,286,570025.35,267696.32,837721.67
314010,201704,70,43,27,40291,25299,65590
314015,201704,59,18,41,16866,38417,55283
314020,201704,49,34,15,31858,13961.3,45819.3
314030,201704,101,52,49,48724,45913,94637
314040,201704,41,30,11,28110,10307,38417
314050,201704,304,178,126,166786,116750.2,283536.2
314053,201704,97,63,34,59031,31858,90889
314055,201704,276,159,117,148983,109629,258612
314060,201704,138,117,21,108692,19677,128369
314070,201704,888,462,426,428875.67,398543.63,827419.30
314080,201704,208,136,72,127198,66527.84,193725.84
314085,201704,106,73,33,68401,30921,99322
314090,201704,342,244,98,228628,91821.32,320449.32
314100,201704,454,372,82,344692,76272,420964
314110,201704,692,372,320,346699.37,299137.8,645837.17
314120,201704,105,55,50,51535,46850,98385
314130,201704,20,11,9,10307,8433,18740
314140,201704,1074,640,434,598068.46,405721.23,1003789.69
314150,201704,167,102,65,95574,60905,156479
314160,201704,359,264,95,245495.3,88828,334323.3
314170,201704,63,45,18,42165,16866,59031
314180,201704,723,629,94,588155.21,87141.25,675296.46
314190,201704,98,59,39,55283,36543,91826
314200,201704,586,397,189,371052.8,176156,547208.8
314210,201704,268,200,68,187118.9,63435,250553.9
314220,201704,317,237,80,220196,74679,294875
314225,201704,63,45,18,42165,16866,59031
314230,201704,97,44,53,41228,49661,90889
314240,201704,135,101,34,94637,31812,126449
314250,201704,57,33,24,30921,22488,53409
314260,201704,188,96,92,89952,86204,176156
314270,201704,470,362,108,338445,100915,439360
314280,201704,669,369,300,345462.9,281100,626562.9
314290,201704,550,439,111,410125.25,103725.9,513851.15
314300,201704,414,296,118,274468.5,110520,384988.5
314310,201704,1399,929,470,869255.9,440089.33,1309345.23
314315,201704,32,25,7,23425,6559,29984
314320,201704,599,375,224,351094,209260.21,560354.21
314330,201704,10486,5291,5195,4945644.12,4862590.13,9808234.25
314340,201704,568,265,303,247742.9,283349,531091.9
314345,201704,22,17,5,15929,4685,20614
314350,201704,189,111,78,104007,73086,177093
314360,201704,70,39,31,36543,29047,65590
314370,201704,60,50,10,46850,9370,56220
314380,201704,89,62,27,58094,25299,83393
314390,201704,3073,1925,1148,1799509.25,1072490.6,2871999.85
314400,201704,661,479,182,446004.1,170534,616538.1
314410,201704,410,268,142,251116,133054,384170
314420,201704,18,7,11,6559,10307,16866
314430,201704,2455,867,1588,808695.15,1485752.81,2294447.96
314435,201704,251,143,108,133709.9,100259,233968.9
314437,201704,23,18,5,16866,4685,21551
314440,201704,106,72,34,67464,31858,99322
314450,201704,153,117,36,109629,33732,143361
314460,201704,648,291,357,272667,334509,607176
314465,201704,72,52,20,48724,18740,67464
314467,201704,60,50,10,46841,9370,56211
314470,201704,340,169,171,154026.06,159290.75,313316.81
314480,201704,1002,479,523,447886,489863.6,937749.6
314490,201704,88,64,24,59968,22488,82456
314500,201704,298,189,109,177093,102133,279226
314505,201704,120,82,38,76834,35606,112440
314510,201704,223,178,45,165849.1,42165,208014.1
314520,201704,1187,614,573,570777.5,534980.45,1105757.95
314530,201704,657,522,135,488637,126495,615132
314535,201704,190,119,71,111221.9,66237.88,177459.78
314537,201704,58,34,24,31858,22488,54346
314540,201704,6,4,2,3748,1874,5622
314545,201704,47,34,13,31858,12181,44039
314550,201704,79,43,36,40291,33732,74023
314560,201704,811,431,380,401692,355123.79,756815.79
314570,201704,22,16,6,14992,5622,20614
314580,201704,18,8,10,7496,9370,16866
314585,201704,18,12,6,11244,5622,16866
314587,201704,73,64,9,59968,8433,68401
314590,201704,523,389,134,364493,125558,490051
314600,201704,982,625,357,582132.39,331539.8,913672.19
314610,201704,908,495,413,461554.4,385857.15,847411.55
314620,201704,140,103,37,95574,34669,130243
314625,201704,91,70,21,64747,19677,84424
314630,201704,1249,628,621,586702.65,581595.9,1168298.55
314640,201704,94,63,31,59031,29047,88078
314650,201704,204,115,89,107473.9,82924.5,190398.4
314655,201704,63,49,14,45913,13118,59031
314660,201704,19,15,4,14055,3748,17803
314670,201704,172,141,31,131836,29047,160883
314675,201704,212,116,96,108692,89952,198644
314690,201704,531,293,238,274541,223006,497547
314700,201704,2419,1301,1118,1213978.6,1046675.95,2260654.55
314710,201704,1599,929,670,866258.15,626896.62,1493154.77
314720,201704,407,241,166,224265.85,155542,379807.85
314730,201704,495,264,231,245963,215688.4,461651.4
314740,201704,669,330,339,308507.25,317643,626150.25
314750,201704,19,17,2,15929,1874,17803
314760,201704,302,147,155,137739,145225.63,282964.63
314770,201704,122,83,39,77771,36543,114314
314780,201704,21,6,15,5622,14055,19677
314790,201704,2301,1437,864,1338276.55,808621.73,2146898.28
314795,201704,44,37,7,34435,6559,40994
314800,201704,2775,1605,1170,1498036.56,1095625.1,2593661.66
314810,201704,1461,804,657,751053.25,614016.5,1365069.75
314820,201704,85,48,37,44976,34669,79645
314830,201704,202,155,47,144532.75,43758,188290.75
314840,201704,81,48,33,44976,30921,75897
314850,201704,335,161,174,150857,163038,313895
314860,201704,703,520,183,485272.79,169972.35,655245.14
314870,201704,1402,706,696,659948.34,652152,1312100.34
314875,201704,53,45,8,42165,7496,49661
314880,201704,42,30,12,28110,11244,39354
314890,201704,48,29,19,27173,17803,44976
314900,201704,25,21,4,19677,3748,23425
314910,201704,260,172,88,161164,82456,243620
314915,201704,143,127,16,118765,14992,133757
314920,201704,134,81,53,75897,49380,125277
314930,201704,979,494,485,461052.1,453882.9,914935.0
314940,201704,56,44,12,41228,11244,52472
314950,201704,39,30,9,27407.25,8433,35840.25
314960,201704,57,41,16,38417,14992,53409
314970,201704,133,66,67,61561,62779,124340
314980,201704,303,193,110,177984.05,101852,279836.05
314990,201704,465,248,217,231439.25,202439.75,433879.00
314995,201704,161,59,102,55283,95564.63,150847.63
315000,201704,83,66,17,60905.6,15929,76834.6
315010,201704,46,30,16,28110,14992,43102
315015,201704,162,132,30,122971.88,28110,151081.88
315020,201704,49,41,8,38417,7496,45913
315030,201704,125,94,31,87142,29047,116189
315040,201704,61,44,17,41228,15929,57157
315050,201704,194,118,76,110566,71212,181778
315053,201704,32,27,5,25299,4685,29984
315057,201704,95,80,15,74585.2,14055,88640.2
315060,201704,72,65,7,59031.98,6559,65590.98
315070,201704,108,61,47,57157,44039,101196
315080,201704,359,295,64,276415,59968,336383
315090,201704,109,67,42,62779,39354,102133
315100,201704,75,40,35,37480,32795,70275
315110,201704,295,164,131,152075.1,122747,274822.1
315120,201704,1563,782,781,728846.1,730626,1459472.1
315130,201704,306,220,86,206140,80582,286722
315140,201704,532,311,221,288877.18,207077,495954.18
315150,201704,962,441,521,412281,487896,900177
315160,201704,193,97,96,90889,89952,180841
315170,201704,339,220,119,204267.1,111221.9,315489.0
315180,201704,3179,1347,1832,1259000.95,1714008.1,2973009.05
315190,201704,304,180,124,168286,116188,284474
315200,201704,1164,647,517,603241.43,483210.9,1086452.33
315210,201704,1474,826,648,769653.05,605302.8,1374955.85
315213,201704,31,21,10,19677,9370,29047
315217,201704,184,143,41,133991,38417,172408
315220,201704,1450,1110,340,1039695.3,318486.3,1358181.6
315230,201704,166,121,45,113096,42165,155261
315240,201704,426,280,146,262360,136558.63,398918.63
315250,201704,2477,1235,1242,1155883.3,1162715.47,2318598.77
315260,201704,149,89,60,82081.2,56220,138301.2
315270,201704,124,82,42,75709.6,38641.88,114351.48
315280,201704,709,462,247,432520,231429.63,663949.63
315290,201704,185,106,79,99322,73086.34,172408.34
315300,201704,76,48,28,44976,26236,71212
315310,201704,67,59,8,55283,7496,62779
315320,201704,157,84,73,78708,68401,147109
315330,201704,55,47,8,44039,7496,51535
315340,201704,411,292,119,272442.9,111498.32,383941.22
315350,201704,141,85,56,79645,52472,132117
315360,201704,94,49,45,45913,42165,88078
315370,201704,55,30,25,28110,23143.9,51253.9
315380,201704,11,6,5,5622,4685,10307
315390,201704,48,14,34,13118,31858,44976
315400,201704,789,586,203,545334.6,189555.1,734889.7
315410,201704,337,201,136,188056,127432,315488
315415,201704,61,46,15,43102,14055,57157
315420,201704,195,146,49,135725.5,45913,181638.5
315430,201704,670,398,272,372926,254864,627790
315440,201704,75,57,18,53409,16866,70275
315445,201704,250,199,51,186153.79,47787,233940.79
315450,201704,193,147,46,137739,43102,180841
315460,201704,3247,1652,1595,1543045.9,1490619.95,3033665.85
315470,201704,46,24,22,22207,20614,42821
315480,201704,61,23,38,21551,35606,57157
315490,201704,600,372,228,347392.75,213636,561028.75
315500,201704,24,13,11,12181,10307,22488
315510,201704,149,94,55,88078,51535,139613
315520,201704,64,58,6,54346,5622,59968
315530,201704,51,27,24,25299,22488,47787
315540,201704,235,149,86,139613,80582,220195
315550,201704,171,132,39,123684,36543,160227
315560,201704,733,581,152,543834.9,142424,686258.9
315570,201704,302,164,138,150576.25,129306,279882.25
315580,201704,619,405,214,379485,200518,580003
315590,201704,212,112,100,104944,93700,198644
315600,201704,278,200,78,187400,72899,260299
315610,201704,95,48,47,44976,44039,89015
315620,201704,31,23,8,21551,7496,29047
315630,201704,135,89,46,83393,43102,126495
315640,201704,47,29,18,27173,16866,44039
315645,201704,67,47,20,44039,18272,62311
315650,201704,160,119,41,111222,38417,149639
315660,201704,473,186,287,174282,268919,443201
315670,201704,2153,1087,1066,1015849.75,998065.9,2013915.65
315680,201704,856,573,283,533398.81,264458.88,797857.69
315690,201704,701,476,225,444957.63,210825,655782.63
315700,201704,1867,994,873,928567.51,818001,1746568.51
315710,201704,299,70,229,65590,214573,280163
315720,201704,415,266,149,249242,139331.9,388573.9
315725,201704,193,156,37,146172,34669,180841
315727,201704,37,20,17,18740,15929,34669
315730,201704,42,39,3,36543,2811,39354
315733,201704,87,56,31,52191,29047,81238
315737,201704,51,37,14,34669,13118,47787
315740,201704,42,37,5,34669,4685,39354
315750,201704,159,126,33,118022,30921,148943
315760,201704,44,29,15,27173,14055,41228
315765,201704,107,70,37,65590,34669,100259
315770,201704,227,131,96,122747,89952,212699
315780,201704,3175,1662,1513,1549378.05,1415058.31,2964436.36
315790,201704,197,151,46,141487,43102,184589
315800,201704,271,200,71,187119,66527,253646
315810,201704,86,49,37,45913,34669,80582
315820,201704,793,569,224,530905.77,209888,740793.77
315830,201704,141,82,59,76834,55283,132117
315840,201704,81,53,28,49661,26236,75897
315850,201704,260,192,68,179904,63716,243620
315860,201704,11,3,8,2811,7496,10307
315870,201704,34,28,6,26236,5622,31858
315880,201704,106,67,39,62779,36543,99322
315890,201704,68,50,18,46850,16866,63716
315895,201704,336,221,115,206328,107193,313521
315900,201704,64,35,29,32795,27173,59968
315910,201704,36,23,13,21223.05,12181,33404.05
315920,201704,185,124,61,116188,56220.95,172408.95
315930,201704,32,11,21,10307,19677,29984
315935,201704,136,107,29,99463,27164,126627
315940,201704,82,63,19,59031,17803,76834
315950,201704,61,41,20,38417,18740,57157
315960,201704,586,270,316,252633.94,295811,548444.94
315970,201704,39,30,9,28110,8433,36543
315980,201704,674,301,373,281100,349491.63,630591.63
315990,201704,244,145,99,135865,92482,228347
316000,201704,45,28,17,26236,15929,42165
316010,201704,69,60,9,56220,8433,64653
316020,201704,101,83,18,77771,16866,94637
316030,201704,402,202,200,189274,187166,376440
316040,201704,468,210,258,196468.89,241465,437933.89
316045,201704,63,57,6,53409,5622,59031
316050,201704,16,15,1,12883.74,937,13820.74
316060,201704,95,64,31,59686.9,29047,88733.9
316070,201704,1002,642,360,595935.25,336571,932506.25
316080,201704,105,64,41,59968,38417,98385
316090,201704,48,28,20,25299.1,18740,44039.1
316095,201704,59,49,10,45642,9370,55012
316100,201704,295,173,122,161538.9,114314,275852.9
316105,201704,29,20,9,18740,8433,27173
316110,201704,1912,1521,391,1415479.37,364399.3,1779878.67
316120,201704,76,54,22,50598,20333,70931
316130,201704,139,107,32,99604,29984,129588
316140,201704,22,16,6,14992,5622,20614
316150,201704,195,139,56,129540.25,52472,182012.25
316160,201704,86,53,33,49661,30921,80582
316165,201704,57,43,14,40104,12415.25,52519.25
316170,201704,211,142,69,132117,64653,196770
316180,201704,188,86,102,80254.05,95574,175828.05
316190,201704,129,93,36,86204,33732,119936
316200,201704,699,396,303,371052,283724,654776
316210,201704,725,477,248,446609.43,232376,678985.43
316220,201704,117,76,41,71212,38417,109629
316225,201704,15,7,8,6559,7496,14055
316230,201704,33,19,14,17803,13118,30921
316240,201704,603,485,118,453508.1,110566,564074.1
316245,201704,98,82,16,76834,14992,91826
316250,201704,1460,1025,435,951649.8,407370.12,1359019.92
316255,201704,112,90,22,83955.2,20614,104569.2
316257,201704,170,94,76,88078,71212,159290
316260,201704,236,153,83,142044.39,77678,219722.39
316265,201704,21,13,8,12181,7496,19677
316270,201704,666,465,201,432706.8,188337,621043.8
316280,201704,539,333,206,309835.5,192366.3,502201.8
316290,201704,652,431,221,401036.69,207077,608113.69
316292,201704,471,186,285,174282,266670.2,440952.2
316294,201704,115,71,44,66527,41228,107755
316295,201704,267,123,144,113829.5,134928,248757.5
316300,201704,98,67,31,62779,29047,91826
316310,201704,31,17,14,15929,13118,29047
316320,201704,48,28,20,26236,18740,44976
316330,201704,122,76,46,70275.25,42820.9,113096.15
316340,201704,138,98,40,91826,37480,129306
316350,201704,189,133,56,124294,52472,176766
316360,201704,24,19,5,17803,4685,22488
316370,201704,1019,550,469,511621.75,439443.63,951065.38
316380,201704,115,88,27,82456,25299,107755
316390,201704,121,85,36,79645,33732,113377
316400,201704,126,97,29,90889,27173,118062
316410,201704,306,224,82,208529.35,76834,285363.35
316420,201704,183,130,53,121107.25,49661,170768.25
316430,201704,152,77,75,72149,70275,142424
316440,201704,100,48,52,44976,48724,93700
316443,201704,35,33,2,30921,1874,32795
316447,201704,59,48,11,44976,10307,55283
316450,201704,204,159,45,148983,42165,191148
316460,201704,63,27,36,25299,33732,59031
316470,201704,1547,1110,437,1035322.65,407291.79,1442614.44
316480,201704,10,9,1,8433,937,9370
316490,201704,15,5,10,4685,9370,14055
316500,201704,153,103,50,96229.9,46850,143079.9
316510,201704,172,126,46,116797.15,43102,159899.15
316520,201704,192,118,74,110003.8,69338,179341.8
316530,201704,150,106,44,99322,40947,140269
316540,201704,136,73,63,67464,59031,126495
316550,201704,143,98,45,91625.67,42124.89,133750.56
316553,201704,205,105,100,98166.5,93700,191866.5
316555,201704,21,12,9,11244,8433,19677
316556,201704,12,8,4,7496,3748,11244
316557,201704,14,13,1,12181,937,13118
316560,201704,54,43,11,40291,10307,50598
316570,201704,248,224,24,209654,22488,232142
316580,201704,23,15,8,14055,7496,21551
316590,201704,124,107,17,100259,15929,116188
316600,201704,182,147,35,137739,32795,170534
316610,201704,65,43,22,39728.8,20614,60342.8
316620,201704,125,97,28,90889,26236,117125
316630,201704,39,29,10,27173,9370,36543
316640,201704,16,10,6,9370,5622,14992
316650,201704,59,46,13,43102,12181,55283
316660,201704,5,3,2,2811,1874,4685
316670,201704,436,148,288,138658,269294,407952
316680,201704,158,109,49,102133,45726,147859
316690,201704,189,117,72,109629,67464,177093
316695,201704,55,50,5,46850,4685,51535
316700,201704,12,6,6,5622,5622,11244
316710,201704,690,497,193,465173.9,180841,646014.9
316720,201704,4729,2406,2323,2240950.17,2172684.34,4413634.51
316730,201704,15,13,2,12181,1874,14055
316740,201704,138,80,58,74960,54346,129306
316750,201704,18,12,6,11244,5622,16866
316760,201704,328,261,67,244557,62779,307336
316770,201704,138,81,57,75897,53409,129306
316780,201704,66,35,31,32495.16,29047,61542.16
316790,201704,54,40,14,37480,13118,50598
316800,201704,1781,1114,667,1040445,624130,1664575
316805,201704,19,10,9,9370,8433,17803
316810,201704,65,41,24,38417,22207,60624
316820,201704,40,20,20,18740,18740,37480
316830,201704,91,39,52,36543,48443,84986
316840,201704,495,292,203,272854.5,188337,461191.5
316850,201704,336,217,119,201970.35,111503,313473.35
316860,201704,5902,2592,3310,2417027.79,3097104.63,5514132.42
316870,201704,1366,878,488,813553.85,452901.55,1266455.40
316880,201704,100,59,41,54627.9,38417,93044.9
316890,201704,249,167,82,156479,76834,233313
316900,201704,414,282,132,261733.84,123684,385417.84
316905,201704,14,10,4,9370,3748,13118
316910,201704,53,27,26,25299,24362,49661
316920,201704,127,101,26,93935,24362,118297
316930,201704,1903,945,958,879798.15,895491.85,1775290.00
316935,201704,835,500,335,466626.66,312395.8,779022.46
316940,201704,1065,610,455,570352.6,425763.53,996116.13
316950,201704,180,93,87,87141,81519,168660
316960,201704,1086,597,489,557796.9,457893.26,1015690.16
316970,201704,638,498,140,466626,131180,597806
316980,201704,117,72,45,67464,42155.63,109619.63
316990,201704,2123,1386,737,1292077.33,688920.88,1980998.21
317000,201704,314,244,70,228347,65590,293937
317005,201704,243,173,70,162101,65590,227691
317010,201704,6122,3332,2790,3106541.45,2612346.83,5718888.28
317020,201704,15797,6922,8875,6454805.07,8300247.41,14755052.48
317030,201704,83,31,52,29047,48724,77771
317040,201704,3086,1897,1189,1774586.2,1112032.6,2886618.8
317043,201704,70,49,21,45913,19396,65309
317047,201704,33,15,18,14055,16862,30917
317050,201704,187,140,47,131180,44039,175219
317052,201704,115,91,24,85267,22488,107755
317057,201704,194,148,46,138676,42540,181216
317060,201704,54,34,20,31858,18458.9,50316.9
317065,201704,58,48,10,44976,9370,54346
317070,201704,1947,916,1031,852670.85,964267,1816937.85
317075,201704,111,57,54,53409,50598,104007
317080,201704,790,428,362,399958.45,339007,738965.45
317090,201704,595,479,116,448635.6,108692,557327.6
317100,201704,399,299,100,278289.6,93700,371989.6
317103,201704,93,79,14,74023,13118,87141
317107,201704,34,32,2,29984,1874,31858
317110,201704,95,41,54,38417,50598,89015
317115,201704,42,36,6,33732,5622,39354
317120,201704,1746,879,867,815880.35,811649,1627529.35
317130,201704,1819,1152,667,1075590.3,624042.9,1699633.2
317140,201704,4,3,1,2811,937,3748
317150,201704,262,160,102,149920,94824.4,244744.4
317160,201704,311,224,87,209607,81519,291126
317170,201704,200,146,54,136802,50598,187400
317180,201704,400,293,107,273838.25,100259,374097.25
317190,201704,248,166,82,155542,76271.8,231813.8
317200,201704,776,559,217,510631,202814,713445
317210,201704,149,84,65,77771.6,60905,138676.6
317220,201704,21,12,9,11244,8433,19677
320010,201704,600,444,156,412936.8,146172,559108.8
320013,201704,127,89,38,83393,35606,118999
320016,201704,277,172,105,161164,98385,259549
320020,201704,687,407,280,377813.37,259765.97,637579.34
320030,201704,145,107,38,100259,35278.05,135537.05
320035,201704,133,98,35,91826,32795,124621
320040,201704,488,263,225,245306.8,210825,456131.8
320050,201704,98,76,22,71212,20614,91826
320060,201704,1447,643,804,602445,752683.3,1355128.3
320070,201704,98,69,29,64653,27173,91826
320080,201704,750,429,321,399941.1,300708.25,700649.35
320090,201704,1184,825,359,768980.98,335539.8,1104520.78
320100,201704,310,180,130,166595.23,121309.67,287904.90
320110,201704,132,86,46,78896.1,43102,121998.1
320115,201704,108,87,21,81519,19677,101196
320120,201704,3189,1777,1412,1654838.55,1321453.96,2976292.51
320130,201704,6996,3380,3616,3146121.95,3380171.9,6526293.85
320140,201704,417,267,150,248867.6,140310,389177.6
320150,201704,1779,1045,734,973721.15,687748.63,1661469.78
320160,201704,669,288,381,268629.22,356881.96,625511.18
320170,201704,114,87,27,80770,25299,106069
320180,201704,46,26,20,24362,18740,43102
320190,201704,235,165,70,153846.4,65309,219155.4
320200,201704,54,40,14,37480,13118,50598
320210,201704,832,469,363,437954.8,338662,776616.8
320220,201704,297,114,183,105881.86,171190,277071.86
320225,201704,75,61,14,57157,13118,70275
320230,201704,511,331,180,308835.2,167864,476699.2
320240,201704,3008,1533,1475,1434266.9,1380193.1,2814460.0
320245,201704,411,288,123,269387.6,115251,384638.6
320250,201704,213,113,100,103727,93700,197427
320255,201704,140,112,28,103660.31,26096,129756.31
320260,201704,165,119,46,111503,43055.15,154558.15
320265,201704,162,127,35,118203,32795,150998
320270,201704,154,122,32,114314,29984,144298
320280,201704,890,542,348,502233.1,324698.81,826931.91
320290,201704,66,56,10,52472,9370,61842
320300,201704,493,355,138,331202.65,128061.55,459264.20
320305,201704,606,322,284,301714,265921,567635
320310,201704,204,117,87,109348,80777,190125
320313,201704,281,144,137,134928,128088,263016
320316,201704,108,90,18,84330,16866,101196
320320,201704,3205,1413,1792,1320599.8,1675607.5,2996207.3
320330,201704,259,190,69,177380.9,62779.81,240160.71
320332,201704,842,504,338,470228,315555.15,785783.15
320334,201704,236,145,91,135584,85267,220851
320335,201704,147,108,39,100024.95,36543,136567.95
320340,201704,579,396,183,369928,170816,540744
320350,201704,937,397,540,369553.14,505444.44,874997.58
320360,201704,158,83,75,77490,69682,147172
320370,201704,235,179,56,166167,51457,217624
320380,201704,283,192,91,179154.4,85267,264421.4
320390,201704,1066,649,417,607514,388583.45,996097.45
320400,201704,319,224,95,208014.6,88734,296748.6
320405,201704,818,333,485,311796.34,453850.15,765646.49
320410,201704,919,472,447,440605.7,418474.34,859080.04
320420,201704,465,243,222,227223.2,208014,435237.2
320425,201704,183,104,79,97448,74023,171471
320430,201704,379,213,166,198737.95,155542,354279.95
320435,201704,167,111,56,103201.18,52472,155673.18
320440,201704,191,120,71,112158.9,66527,178685.9
320450,201704,124,71,53,66527,49661,116188
320455,201704,239,189,50,176157,46832,222989
320460,201704,236,153,83,143361,77771,221132
320465,201704,115,79,36,73666.94,33732,107398.94
320470,201704,604,387,217,362320.54,203321,565641.54
320480,201704,160,105,55,98385,51535,149920
320490,201704,2858,1410,1448,1317610.21,1354848.98,2672459.19
320495,201704,89,55,34,51517,31858,83375
320500,201704,9114,4651,4463,4328813.11,4170858.16,8499671.27
320501,201704,497,252,245,236124,229556,465680
320503,201704,260,185,75,172408.6,70275,242683.6
320506,201704,242,188,54,176156,50598,226754
320510,201704,872,420,452,390285.65,422567.05,812852.70
320515,201704,76,62,14,57157.45,13118,70275.45
320517,201704,189,134,55,125558,51535,177093
320520,201704,6425,2860,3565,2666439.45,3333866.93,6000306.38
320530,201704,5004,2531,2473,2362874.54,2313071.93,4675946.47
330010,201704,2787,1432,1355,1332536.9,1267462.66,2599999.56
330015,201704,157,63,94,58094.14,88078,146172.14
330020,201704,3389,1467,1922,1369901.56,1800352,3170253.56
330022,201704,204,115,89,107755,82457,190212
330023,201704,501,171,330,159056.4,309210,468266.4
330025,201704,510,119,391,111503,366085.9,477588.9
330030,201704,1815,1151,664,1071322.43,619078.36,1690400.79
330040,201704,2063,1028,1035,961175.3,968577,1929752.3
330045,201704,8160,2524,5636,2355741.29,5276025.66,7631766.95
330050,201704,761,484,277,453508,259549,713057
330060,201704,828,535,293,497549.45,274541,772090.45
330070,201704,3262,1259,2003,1175543.19,1875399.26,3050942.45
330080,201704,1412,684,728,636683.75,681199.3,1317883.05
330090,201704,350,205,145,192085,135865,327950
330093,201704,276,122,154,114314,144289,258603
330095,201704,100,49,51,45913,47787,93700
330100,201704,8927,4672,4255,4369454.44,3983093.4,8352547.84
330110,201704,470,211,259,196067.8,242683,438750.8
330115,201704,505,295,210,276415,196770,473185
330120,201704,351,181,170,168472.6,158821.5,327294.1
330130,201704,1367,427,940,399386.88,880753,1280139.88
330140,201704,590,306,284,286704,265172,551876
330150,201704,427,257,170,238935,158353,397288
330160,201704,208,129,79,120873,74023,194896
330170,201704,25638,9003,16635,8416361.42,15570856.79,23987218.21
330180,201704,229,145,84,132427.75,78005.25,210433.00
330185,201704,718,311,407,289899.1,381341,671240.1
330187,201704,243,86,157,80582,147109,227691
330190,201704,5474,2164,3310,2019259.25,3097485.98,5116745.23
330200,201704,4099,1449,2650,1353639.1,2478173.18,3831812.28
330205,201704,392,242,150,226051.25,140269,366320.25
330210,201704,935,569,366,529384.8,341255.95,870640.75
330220,201704,2346,1384,962,1293482.75,900457.1,2193939.85
330225,201704,534,300,234,280473,219258,499731
330227,201704,2301,808,1493,753994.63,1398656.32,2152650.95
330230,201704,191,113,78,105226,73086,178312
330240,201704,3372,1751,1621,1636917.77,1516969.66,3153887.43
330245,201704,144,56,88,52472,81706.4,134178.4
330250,201704,6182,3200,2982,2989318.1,2788122.86,5777440.96
330260,201704,523,161,362,150857,339194,490051
330270,201704,3135,1170,1965,1095166.5,1840832,2935998.5
330280,201704,437,287,150,266034.34,140541,406575.34
330285,201704,6787,2293,4494,2144085.4,4207911.2,6351996.6
330290,201704,570,224,346,208952,323921,532873
330300,201704,700,479,221,445075.85,207068,652143.85
330310,201704,405,240,165,223006.35,154605,377611.35
330320,201704,7461,2786,4675,2602614.7,4375819.6,6978434.3
330330,201704,9330,3599,5731,3366785.16,5365629.61,8732414.77
330340,201704,2566,1544,1022,1444845.53,957595.26,2402440.79
330350,201704,16998,6755,10243,6304470.3,9578794.88,15883265.18
330360,201704,2581,1277,1304,1195406.7,1221839,2417245.7
330370,201704,969,524,445,490238.4,415279.4,905517.8
330380,201704,808,347,461,324406.77,431488.9,755895.67
330385,201704,596,312,284,291408,266108,557516
330390,201704,4982,2747,2235,2562654.44,2092508.92,4655163.36
330395,201704,217,141,76,130431.05,68729.5,199160.55
330400,201704,624,318,306,294874.4,284430.54,579304.94
330410,201704,494,351,143,327239.63,133991,461230.63
330411,201704,218,126,92,118062,86204,204266
330412,201704,245,106,139,99041,130243,229284
330414,201704,6192,2536,3656,2372692.66,3422001.75,5794694.41
330415,201704,533,248,285,232376,266108.4,498484.4
330420,201704,2255,1198,1057,1119134.67,988255.3,2107389.97
330430,201704,1750,727,1023,680441.1,956865,1637306.1
330440,201704,238,103,135,96511,126495,223006
330450,201704,128,53,75,48725,70275,119000
330452,201704,1573,705,868,658646.18,813306.63,1471952.81
330455,201704,107150,38061,69089,35591059.88,64679652.75,100270712.63
330460,201704,261,108,153,101196,143361,244557
330470,201704,1215,663,552,615985.29,517214.63,1133199.92
330475,201704,1372,379,993,352500.7,929878.8,1282379.5
330480,201704,715,380,335,356060,312959,669019
330490,201704,12961,4638,8323,4339318.84,7791787.5,12131106.34
330500,201704,1299,603,696,565011,651778,1216789
330510,201704,10873,3457,7416,3234459.96,6942425.41,10176885.37
330513,201704,104,52,52,48724,48724,97448
330515,201704,845,346,499,322329.4,467282,789611.4
330520,201704,2284,878,1406,822471,1316391.3,2138862.3
330530,201704,230,119,111,111503,103820,215323
330540,201704,353,178,175,166786,163507,330293
330550,201704,3081,1102,1979,1032059,1853131.95,2885190.95
330555,201704,706,258,448,241746,419402,661148
330560,201704,512,196,316,183652,296083,479735
330570,201704,237,161,76,150857,71212,222069
330575,201704,728,330,398,308976,370906.75,679882.75
330580,201704,3281,1854,1427,1732379.5,1335600,3067979.5
330590,201704,294,155,139,145235,130243,275478
330600,201704,1023,661,362,618195.62,338444.4,956640.02
330610,201704,1464,807,657,750333.61,611582.45,1361916.06
330615,201704,177,139,38,130243,35606,165849
330620,201704,853,421,432,390263.06,402346.3,792609.36
330630,201704,3501,2189,1312,2037223.53,1221719.58,3258943.11
350010,201704,604,394,210,367529.5,196770,564299.5
350020,201704,36,18,18,16866,16866,33732
350030,201704,512,332,180,309960,167491.66,477451.66
350040,201704,131,49,82,45575.68,76553,122128.68
350050,201704,293,160,133,149638.9,124368.63,274007.53
350055,201704,83,47,36,44039,33732,77771
350060,201704,74,26,48,24362,44976,69338
350070,201704,780,445,335,412612.11,312181.68,724793.79
350075,201704,66,43,23,40291,21551,61842
350080,201704,50,29,21,26548.3,18740,45288.3
350090,201704,98,57,41,53409,38412.32,91821.32
350100,201704,300,185,115,172642.25,107755,280397.25
350110,201704,64,38,26,35606,24362,59968
350115,201704,148,88,60,81800.1,56220,138020.1
350120,201704,110,73,37,68401,34669,103070
350130,201704,349,167,182,155917,170534,326451
350140,201704,34,20,14,17241.4,13118,30359.4
350150,201704,66,52,14,48724,13118,61842
350160,201704,2429,932,1497,869988.77,1401946.58,2271935.35
350170,201704,396,242,154,224599.25,144017,368616.25
350180,201704,177,92,85,85923,79645,165568
350190,201704,870,420,450,390415.37,421073.85,811489.22
350200,201704,73,27,46,25097.46,42841.8,67939.26
350210,201704,1342,747,595,691255.96,556756.03,1248011.99
350220,201704,669,573,96,532843.75,89952,622795.75
350230,201704,73,53,20,49661,18740,68401
350240,201704,61,46,15,43102,14055,57157
350250,201704,1173,587,586,543322.55,548557.93,1091880.48
350260,201704,93,67,26,62779,24362,87141
350270,201704,805,533,272,498444.03,253139.65,751583.68
350275,201704,294,115,179,107381,167723,275104
350280,201704,4582,2327,2255,2169415.88,2110798.12,4280214.00
350290,201704,390,185,205,173064,190585.9,363649.9
350300,201704,48,24,24,22488,22488,44976
350310,201704,101,72,29,67464,27173,94637
350315,201704,36,20,16,18740,14992,33732
350320,201704,3235,1579,1656,1475804.35,1551438.52,3027242.87
350330,201704,1644,866,778,807211.32,727985.7,1535197.02
350335,201704,20,13,7,12181,6559,18740
350340,201704,138,74,64,69338,59968,129306
350350,201704,95,46,49,43102,45913,89015
350360,201704,127,85,42,79641,39073,118714
350370,201704,94,55,39,50910.3,36533.63,87443.93
350380,201704,714,298,416,278570.1,389510.9,668081.0
350390,201704,1372,562,810,525810.25,757629.08,1283439.33
350395,201704,26,18,8,16866,7496,24362
350400,201704,1671,883,788,817655.87,735749.46,1553405.33
350410,201704,2190,972,1218,907480.91,1140956.9,2048437.81
350420,201704,236,140,96,129851.54,89952,219803.54
350430,201704,75,43,32,39729,29984,69713
350440,201704,148,105,43,97401.25,40291,137692.25
350450,201704,1609,1037,572,964576.9,535871,1500447.9
350460,201704,328,117,211,109629,197425.9,307054.9
350470,201704,13,10,3,9370,2811,12181
350480,201704,153,84,69,78053,64653,142706
350490,201704,245,115,130,106621.51,121810,228431.51
350500,201704,34,16,18,14992,16866,31858
350510,201704,160,107,53,100259,49661,149920
350520,201704,440,195,245,180217,228940.3,409157.3
350530,201704,440,215,225,201455,210825,412280
350535,201704,55,43,12,39917,11244,51161
350540,201704,375,191,184,178094.47,172127,350221.47
350550,201704,2735,1609,1126,1500563.95,1054066.19,2554630.14
350560,201704,620,430,190,402905.32,177674.65,580579.97
350570,201704,4265,1761,2504,1646199.06,2344713.1,3990912.16
350580,201704,372,179,193,167723,180827.63,348550.63
350590,201704,903,487,416,456319,388855.3,845174.3
350600,201704,6018,3028,2990,2824465.21,2797871.5,5622336.71
350610,201704,1536,762,774,708937.7,724011,1432948.7
350620,201704,39,27,12,25299,11244,36543
350630,201704,239,139,100,129306.3,92764,222070.3
350635,201704,808,308,500,288315,467864.54,756179.54
350640,201704,118,87,31,81519,29047,110566
350650,201704,1843,1224,619,1143253.71,578986.1,1722239.81
350660,201704,742,337,405,315769,378548,694317
350670,201704,315,158,157,147812,147109,294921
350680,201704,181,100,81,93700,75616,169316
350690,201704,201,99,102,92763,95574,188337
350700,201704,653,317,336,293755.09,314832,608587.09
350710,201704,311,130,181,120623.1,169597,290220.1
350715,201704,48,41,7,38417,6559,44976
350720,201704,17,13,4,12181,3748,15929
350730,201704,40,26,14,24362,13118,37480
350740,201704,194,108,86,100905.53,80582,181487.53
350745,201704,22,11,11,10283,10307,20590
350750,201704,2081,1354,727,1261063.05,679637.3,1940700.35
350760,201704,3647,1583,2064,1482334.3,1931961.39,3414295.69
350770,201704,59,39,20,36543,18740,55283
350775,201704,47,34,13,31858,12172,44030
350780,201704,408,201,207,188337,193959,382296
350790,201704,386,172,214,161164,200518,361682
350800,201704,417,232,185,217384,173345,390729
350810,201704,490,392,98,365431.3,91826,457257.3
350820,201704,78,50,28,46850,26236,73086
350830,201704,82,49,33,45913,30921,76834
350840,201704,718,325,393,304244,367304,671548
350850,201704,1666,963,703,896703.26,658455,1555158.26
350860,201704,531,308,223,286705.16,208951,495656.16
350870,201704,421,287,134,268919,125183.9,394102.9
350880,201704,287,157,130,143785.2,121810,265595.2
350890,201704,41,25,16,23425,14992,38417
350900,201704,1368,449,919,418763.19,860353.4,1279116.59
350910,201704,26,18,8,16866,7496,24362
350920,201704,579,323,256,302338.7,239872,542210.7
350925,201704,1161,622,539,578961.77,503637.7,1082599.47
350930,201704,95,58,37,54346,34669,89015
350940,201704,676,366,310,341442.8,288661.8,630104.6
350945,201704,98,76,22,71212,20614,91826
350950,201704,14504,6921,7583,6457070.71,7093443.24,13550513.95
350960,201704,1273,576,697,535396.9,653085,1188481.9
350970,201704,1101,622,479,580587.3,448532.63,1029119.93
350980,201704,107,73,34,68401,31858,100259
350990,201704,360,125,235,116441,219913.9,336354.9
350995,201704,29,15,14,14055,13118,27173
351000,201704,630,457,173,426024.26,162101,588125.26
351010,201704,53,28,25,26236,23425,49661
351015,201704,60,42,18,39354,16866,56220
351020,201704,1644,931,713,870671.64,666020.2,1536691.84
351030,201704,315,220,95,203610.1,89015,292625.1
351040,201704,812,437,375,408532,350438.15,758970.15
351050,201704,3168,1525,1643,1422294.03,1537377.33,2959671.36
351060,201704,4776,1962,2814,1829769.95,2633742.93,4463512.88
351070,201704,413,265,148,247403,138676,386079
351080,201704,796,567,229,531279,213636,744915
351090,201704,65,29,36,27173,33732,60905
351100,201704,448,256,192,237689.35,179890.32,417579.67
351110,201704,2113,1022,1091,951865.99,1019752.26,1971618.25
351120,201704,74,40,34,37396.6,31858,69254.6
351130,201704,170,54,116,50598,108692,159290
351140,201704,336,236,100,219352.5,93700,313052.5
351150,201704,382,195,187,181872,175219,357091
351160,201704,241,157,84,147109,78708,225817
351170,201704,175,88,87,82456,80770,163226
351190,201704,84,59,25,55283,23425,78708
351200,201704,375,245,130,229284,121810,351094
351210,201704,129,59,70,55283,65590,120873
351220,201704,515,313,202,289970.81,189274,479244.81
351230,201704,278,200,78,186494.3,73067.26,259561.56
351240,201704,228,96,132,89764.6,123684,213448.6
351250,201704,64,45,19,42165,17803,59968
351260,201704,148,109,39,102133,36543,138676
351270,201704,51,22,29,20614,27173,47787
351280,201704,1101,510,591,474124.35,553252.39,1027376.74
351290,201704,221,97,124,90889,115907,206796
351300,201704,3753,1768,1985,1649311.13,1859633,3508944.13
351310,201704,736,390,346,364447,324202,688649
351320,201704,105,62,43,58094,40291,98385
351330,201704,39,27,12,25299,11244,36543
351340,201704,1183,745,438,691346.39,409448.32,1100794.71
351350,201704,2285,1209,1076,1132178,1007645.22,2139823.22
351360,201704,764,382,382,356060,356820.19,712880.19
351370,201704,359,188,171,176151.32,159602.3,335753.62
351380,201704,8937,4119,4818,3845047,4504390.4,8349437.4
351385,201704,28,19,9,17803,8433,26236
351390,201704,270,195,75,181985.26,70275,252260.26
351400,201704,60,38,22,35606,20568.63,56174.63
351410,201704,410,255,155,238466.5,144954,383420.5
351420,201704,61,50,11,46850,10307,57157
351430,201704,82,47,35,44039,32795,76834
351440,201704,785,534,251,498200.2,235183,733383.2
351450,201704,243,123,120,115251,112440,227691
351460,201704,122,55,67,51535,62779,114314
351470,201704,143,76,67,71203,62779,133982
351480,201704,516,278,238,259549.1,222888.88,482437.98
351490,201704,293,100,193,93700,180841,274541
351492,201704,33,24,9,22488,8433,30921
351495,201704,30,19,11,17803,10307,28110
351500,201704,3503,1502,2001,1401686.37,1870113.1,3271799.47
351510,201704,1759,721,1038,675295.9,970441.54,1645737.44
351512,201704,19,15,4,14055,3748,17803
351515,201704,188,105,83,98385,77771,176156
351518,201704,703,428,275,400095,257534.45,657629.45
351519,201704,73,47,26,44039,24362,68401
351520,201704,140,87,53,80895,49661,130556
351530,201704,18,14,4,13118,3748,16866
351535,201704,132,74,58,69338,54346,123684
351540,201704,421,302,119,280634,111128.2,391762.2
351550,201704,1258,768,490,712834.1,459120.63,1171954.73
351560,201704,73,37,36,34669,33732,68401
351565,201704,10,5,5,4685,4685,9370
351570,201704,2528,1320,1208,1234984.03,1131249.26,2366233.29
351580,201704,35,30,5,28110,4685,32795
351590,201704,66,46,20,43102,18740,61842
351600,201704,189,138,51,129306,47787,177093
351610,201704,60,27,33,25299,30921,56220
351620,201704,5965,3409,2556,3184229.76,2390029.41,5574259.17
351630,201704,2435,1254,1181,1170059.69,1104999.42,2275059.11
351640,201704,1638,787,851,735797.99,795607.3,1531405.29
351650,201704,30,26,4,24362,3748,28110
351660,201704,153,94,59,88078,55283,143361
351670,201704,721,446,275,415654.25,257675,673329.25
351680,201704,78,63,15,59031,14055,73086
351685,201704,39,25,14,23425,13118,36543
351690,201704,309,217,92,201216.17,86204,287420.17
351700,201704,160,111,49,104007,45913,149920
351710,201704,71,50,21,46850,19677,66527
351720,201704,136,64,72,59968,67464,127432
351730,201704,92,65,27,60905,25294.32,86199.32
351740,201704,709,470,239,440109,223938.32,664047.32
351750,201704,356,147,209,136802.7,195824,332626.7
351760,201704,793,610,183,571570,171471,743041
351770,201704,283,246,37,229566,34669,264235
351780,201704,166,90,76,84330,71212,155542
351790,201704,240,126,114,118062,106818,224880
351800,201704,50,32,18,29984,16866,46850
351810,201704,118,77,41,71868,38417,110285
351820,201704,879,632,247,587900.8,231434.32,819335.12
351830,201704,500,186,314,173532.4,294218,467750.4
351840,201704,1828,936,892,867544.75,834058.47,1701603.22
351850,201704,220,167,53,155870.9,49661,205531.9
351860,201704,738,480,258,445940.77,241741.32,687682.09
351870,201704,5572,2631,2941,2455861.72,2748835.45,5204697.17
351880,201704,18772,8318,10454,7771290.14,9781068.47,17552358.61
351885,201704,95,62,33,58094,30921,89015
351890,201704,74,63,11,59031,10307,69338
351900,201704,220,131,89,122092,83393,205485
351905,201704,74,33,41,30921,38417,69338
351907,201704,3031,1331,1700,1243704.23,1591856.22,2835560.45
351910,201704,178,73,105,68401,98385,166786
351920,201704,138,82,56,76834,52449.96,129283.96
351925,201704,82,57,25,53409,23425,76834
351930,201704,378,260,118,243526.3,110566,354092.3
351940,201704,225,103,122,96511,114314,210825
351950,201704,143,80,63,74648,59031,133679
351960,201704,805,375,430,351043.58,401073.58,752117.16
351970,201704,1860,979,881,915215.04,824926,1740141.04
351980,201704,137,69,68,62779,63716,126495
351990,201704,285,191,94,178030,87290.92,265320.92
352000,201704,352,210,142,196395.2,133054,329449.2
352010,201704,336,197,139,184589,130243,314832
352020,201704,191,70,121,65590,113377,178967
352030,201704,980,497,483,464705.25,450728.2,915433.45
352040,201704,565,242,323,226754,302651,529405
352042,201704,255,88,167,82456,156198,238654
352044,201704,384,230,154,214573.1,144298,358871.1
352050,201704,3090,1264,1826,1176987.2,1709883.53,2886870.73
352060,201704,100,64,36,59968,33732,93700
352070,201704,97,69,28,63717,26236,89953
352080,201704,65,39,26,35606,24362,59968
352090,201704,172,116,56,108692,52472,161164
352100,201704,251,125,126,117125,116930,234055
352110,201704,111,33,78,30921,73086,104007
352115,201704,73,28,45,26236,42165,68401
352120,201704,103,62,41,58094,38417,96511
352130,201704,222,186,36,174094.6,33732,207826.6
352140,201704,184,74,110,68870,103070,171940
352150,201704,122,68,54,62779.7,50598,113377.7
352160,201704,128,87,41,81519,38417,119936
352170,201704,372,253,119,236124.7,111503,347627.7
352180,201704,593,404,189,376535.55,177089,553624.55
352190,201704,268,100,168,93690.63,157369.15,251059.78
352200,201704,31,19,12,17803,11244,29047
352210,201704,3567,1476,2091,1376810.2,1953922.97,3330733.17
352215,201704,49,29,20,27112.67,18209.8,45322.47
352220,201704,6955,2754,4201,2575138.23,3934147.72,6509285.95
352230,201704,3066,1957,1109,1821430.42,1033703.64,2855134.06
352240,201704,2112,1256,856,1173922.69,799917.25,1973839.94
352250,201704,2538,1343,1195,1254285.35,1117703.7,2371989.05
352260,201704,1110,634,476,592831.32,445731,1038562.32
352265,201704,66,31,35,29047,32795,61842
352270,201704,381,218,163,203329.84,152676,356005.84
352280,201704,372,232,140,217072,130894.32,347966.32
352290,201704,175,110,65,102508,60905,163413
352300,201704,104,80,24,74960,22488,97448
352310,201704,5557,2746,2811,2562528.43,2629082.25,5191610.68
352320,201704,898,486,412,452790.99,383093.55,835884.54
352330,201704,530,229,301,213308.07,281756,495064.07
352340,201704,1393,686,707,638305.4,661616,1299921.4
352350,201704,312,199,113,186463,105600,292063
352360,201704,224,87,137,80628.85,125819,206447.85
352370,201704,104,71,33,66527,30921,97448
352380,201704,116,73,43,68401,40291,108692
352390,201704,2394,1091,1303,1017892.9,1218569.64,2236462.54
352400,201704,458,191,267,178264.25,249897.9,428162.15
352410,201704,728,522,206,484879.9,193022,677901.9
352420,201704,101,62,39,58094,36543,94637
352430,201704,1744,775,969,719618.55,906284.59,1625903.14
352440,201704,2994,1546,1448,1440145.68,1353925.4,2794071.08
352450,201704,186,157,29,147109,27173,174282
352460,201704,563,287,276,268652.64,257910.1,526562.74
352470,201704,557,192,365,179904,341996,521900
352480,201704,1367,763,604,714307,565385.9,1279692.9
352490,201704,81,34,47,31858,44039,75897
352500,201704,1215,545,670,508885.8,626563,1135448.8
352510,201704,735,391,344,365430.3,322328,687758.3
352520,201704,509,219,290,205203,271589.45,476792.45
352530,201704,1691,879,812,822686,759251.3,1581937.3
352540,201704,77,51,26,47787,24362,72149
352550,201704,186,107,79,100259,73613.53,173872.53
352560,201704,52,41,11,38417,10307,48724
352570,201704,642,339,303,317040.63,283911,600951.63
352580,201704,56,38,18,34669.33,16866,51535.33
352585,201704,14,5,9,4685,8433,13118
352590,201704,4200,2105,2095,1967387.8,1962139.48,3929527.28
352600,201704,352,245,107,228628.3,100250,328878.3
352610,201704,905,428,477,398349.51,446949,845298.51
352620,201704,964,382,582,356997.1,545334,902331.1
352630,201704,214,77,137,72149,127937.98,200086.98
352640,201704,541,373,168,348149.88,157416,505565.88
352650,201704,93,63,30,59031,28110,87141
352660,201704,83,50,33,46850,30921,77771
352670,201704,1618,879,739,820210.93,691106.02,1511316.95
352680,201704,896,575,321,535576.58,299528.2,835104.78
352690,201704,4222,1952,2270,1819657.5,2123192.87,3942850.37
352700,201704,115,65,50,60905,46850,107755
352710,201704,1271,663,608,619357.35,567166.6,1186523.95
352720,201704,1184,591,593,551269.1,555636.32,1106905.42
352725,201704,27,25,2,23425,1874,25299
352730,201704,355,175,180,162817.81,168098,330915.81
352740,201704,406,254,152,236780.04,142424,379204.04
352750,201704,24,16,8,14710.9,7496,22206.9
352760,201704,192,137,55,128369,51535,179904
352770,201704,84,67,17,61843,15929,77772
352780,201704,86,45,41,42165,38417,80582
352790,201704,24,21,3,19677,2811,22488
352800,201704,243,164,79,153668,73741.9,227409.9
352810,201704,161,106,55,98697,51535,150232
352820,201704,63,53,10,49243.1,9370,58613.1
352830,201704,87,61,26,57157,24362,81519
352840,201704,543,280,263,261096.1,246150,507246.1
352850,201704,1298,471,827,440671.1,774497,1215168.1
352860,201704,122,80,42,74960,39354,114314
352870,201704,37,23,14,21551,13118,34669
352880,201704,186,130,56,121810,52472,174282
352885,201704,29,20,9,18740,8433,27173
352890,201704,53,36,17,33732,15648,49380
352900,201704,4935,2372,2563,2205639.36,2395845.51,4601484.87
352910,201704,40,30,10,28110,9370,37480
352920,201704,710,437,273,408532,255801,664333
352930,201704,1241,595,646,555852.85,602071.88,1157924.73
352940,201704,6251,2707,3544,2525048.07,3315717.08,5840765.15
352950,201704,92,38,54,35324.9,50598,85922.9
352960,201704,68,44,24,41228,22488,63716
352965,201704,20,8,12,7496,11244,18740
352970,201704,452,333,119,308246.44,110566.7,418813.14
352980,201704,178,89,89,83393,83393,166786
352990,201704,884,416,468,387107.14,436764.79,823871.93
353000,201704,67,32,35,29984,32795,62779
353010,201704,559,341,218,319517,204247.27,523764.27
353020,201704,290,209,81,195833,75897,271730
353030,201704,1143,527,616,493480.63,576517.73,1069998.36
353040,201704,87,53,34,49661,31858,81519
353050,201704,1270,788,482,733079.55,451634,1184713.55
353060,201704,7350,3461,3889,3228754.9,3637256.21,6866011.11
353070,201704,1611,999,612,929634.9,572177.04,1501811.94
353080,201704,1309,677,632,632989.72,591338.32,1224328.04
353090,201704,59,37,22,34669,20614,55283
353100,201704,63,52,11,48724,10307,59031
353110,201704,1782,589,1193,550188.63,1116146.32,1666334.95
353120,201704,67,33,34,30921,31858,62779
353130,201704,855,417,438,389773.63,410377.89,800151.52
353140,201704,596,233,363,217998,340131,558129
353150,201704,362,199,163,185526.3,152721.63,338247.93
353160,201704,103,84,19,78708,17803,96511
353170,201704,202,65,137,60895.63,128341.63,189237.26
353180,201704,946,438,508,409173.95,475481,884654.95
353190,201704,448,318,130,296927.95,121810,418737.95
353200,201704,183,89,94,83112,88078,171190
353205,201704,26,18,8,16866,7496,24362
353210,201704,82,50,32,46850,29984,76834
353215,201704,59,35,24,32795,22488,55283
353220,201704,78,43,35,40291,31858.93,72149.93
353230,201704,158,61,97,57157,90889,148046
353240,201704,268,145,123,135865,115251,251116
353250,201704,200,106,94,99322,88078,187400
353260,201704,414,310,104,289355.25,97438.63,386793.88
353270,201704,68,51,17,47787,15929,63716
353280,201704,91,45,46,42165,43102,85267
353282,201704,106,79,27,74023,25299,99322
353284,201704,24,19,5,17803,4685,22488
353286,201704,1,1,0,937,0,937
353290,201704,79,48,31,44976,29038,74014
353300,201704,391,218,173,202751.55,162101,364852.55
353310,201704,49,45,4,42165,3748,45913
353320,201704,54,35,19,32795,17803,50598
353325,201704,56,37,19,34669,17504,52173
353330,201704,68,52,16,48584,14992,63576
353340,201704,589,191,398,178967,372354.54,551321.54
353350,201704,894,415,479,388049.92,447860,835909.92
353360,201704,110,87,23,81206.7,21270,102476.7
353370,201704,119,71,48,65590.55,44976,110566.55
353380,201704,29,20,9,18736,8433,27169
353390,201704,1017,496,521,464752,488177,952929
353400,201704,45,26,19,24362,17803,42165
353410,201704,119,72,47,67464,43337.1,110801.1
353420,201704,54,24,30,22488,28110,50598
353430,201704,538,351,187,325419.48,174787.9,500207.38
353440,201704,10233,4456,5777,4165391.33,5406272.17,9571663.50
353450,201704,58,29,29,27173,27173,54346
353460,201704,592,314,278,290169.99,258838.25,549008.24
353470,201704,2116,1142,974,1064954.26,911198.82,1976153.08
353475,201704,228,153,75,140722.3,70275,210997.3
353480,201704,190,151,39,141487,36543,178030
353490,201704,227,135,92,126495,86204,212699
353500,201704,178,107,71,99041.3,66527,165568.3
353510,201704,104,75,29,70256.63,27163.63,97420.26
353520,201704,205,143,62,133991,58094,192085
353530,201704,437,235,202,219290,189274,408564
353540,201704,346,229,117,214256.02,109629,323885.02
353550,201704,714,482,232,448542.85,217384,665926.85
353560,201704,625,260,365,242683.6,341578.07,584261.67
353570,201704,60,31,29,29047,27173,56220
353580,201704,360,279,81,260955,75897,336852
353590,201704,79,54,25,50598,23425,74023
353600,201704,257,148,109,138364,102133,240497
353610,201704,115,60,55,56220,51535,107755
353620,201704,544,294,250,273058.52,233968.9,507027.42
353625,201704,52,24,28,22488,26236,48724
353630,201704,234,168,66,153163.07,61842,215005.07
353640,201704,120,81,39,74960.5,36543,111503.5
353650,201704,802,320,482,298247.1,451634,749881.1
353657,201704,21,15,6,14055,5622,19677
353660,201704,256,143,113,133991,105599.9,239590.9
353670,201704,685,407,278,380422,260486,640908
353680,201704,100,72,28,67464,26236,93700
353690,201704,45,36,9,33732,8433,42165
353700,201704,293,205,88,192085,82456,274541
353710,201704,400,188,212,175219.4,198644,373863.4
353715,201704,44,37,7,34387.9,6559,40946.9
353720,201704,358,159,199,148965,186434,335399
353730,201704,1103,679,424,633085.45,397006.9,1030092.35
353740,201704,637,363,274,339849.9,256738,596587.9
353750,201704,100,62,38,57571.62,35606,93177.62
353760,201704,2561,960,1601,896217.2,1496316.37,2392533.57
353770,201704,99,81,18,75428.5,16866,92294.5
353780,201704,1047,540,507,503301.3,473512.95,976814.25
353790,201704,501,286,215,266698.85,201335,468033.85
353800,201704,3235,1664,1571,1550466.46,1468624.08,3019090.54
353810,201704,234,129,105,120034.75,98358,218392.75
353820,201704,175,88,87,82456,80905.54,163361.54
353830,201704,46,39,7,36543,6559,43102
353850,201704,164,87,77,81519,72149,153668
353860,201704,461,201,260,186978.35,243092.47,430070.82
353870,201704,4868,2425,2443,2259361.45,2280404.48,4539765.93
353880,201704,628,441,187,411765.2,174282.36,586047.56
353890,201704,581,315,266,294593,249242,543835
353900,201704,140,67,73,62779,68401,131180
353910,201704,183,87,96,81519,89952,171471
353920,201704,458,248,210,231205.7,196756.64,427962.34
353930,201704,955,573,382,535246.44,356768.9,892015.34
353940,201704,187,103,84,95761.4,77865,173626.4
353950,201704,518,324,194,303578.63,181778,485356.63
353960,201704,69,55,14,51535,13118,64653
353970,201704,72,46,26,43102,24362,67464
353980,201704,1491,735,756,686088.59,708360,1394448.59
353990,201704,77,43,34,40291,31858,72149
354000,201704,368,170,198,158635,185334.6,343969.6
354010,201704,98,51,47,47787,43290,91077
354020,201704,532,335,197,312958,184307.9,497265.9
354025,201704,53,44,9,41228,8433,49661
354030,201704,62,32,30,29984,28110,58094
354040,201704,91,65,26,60905,24362,85267
354050,201704,175,103,72,96230,67464,163694
354060,201704,764,374,390,350438,363557.65,713995.65
354070,201704,854,484,370,451380.52,346690,798070.52
354075,201704,194,107,87,100166,80582.9,180748.9
354080,201704,277,121,156,113377,146172,259549
354085,201704,19,12,7,11244,6559,17803
354090,201704,320,176,144,164833,134928,299761
354100,201704,5379,2211,3168,2061588.07,2963910.55,5025498.62
354105,201704,79,40,39,37480,36543,74023
354110,201704,45,21,24,19677,22488,42165
354120,201704,145,101,44,94500.29,41228,135728.29
354130,201704,665,448,217,419542,203048,622590
354140,201704,3158,1477,1681,1380330.42,1574052.62,2954383.04
354150,201704,614,385,229,359527,213167.5,572694.5
354160,201704,654,398,256,371754.75,239591,611345.75
354165,201704,18,12,6,11244,5622,16866
354170,201704,170,116,54,108036.1,50598,158634.1
354180,201704,67,41,26,38097,24362,62459
354190,201704,199,91,108,83674.1,101196,184870.1
354200,201704,128,71,57,66059,53409,119468
354210,201704,74,37,37,34669,34669,69338
354220,201704,636,403,233,376674.1,217384.18,594058.28
354230,201704,155,65,90,60905,83393.8,144298.8
354240,201704,318,205,113,190867.69,105256.3,296123.99
354250,201704,86,49,37,45913,34669,80582
354260,201704,1858,868,990,801275.46,925376,1726651.46
354270,201704,98,73,25,68401,23425,91826
354280,201704,30,16,14,14992,13118,28110
354290,201704,148,101,47,93372.55,44039,137411.55
354300,201704,423,291,132,272355,123684,396039
354310,201704,99,72,27,66527.1,25299,91826.1
354320,201704,187,96,91,89952,85267,175219
354323,201704,13,11,2,10307,1874,12181
354325,201704,112,61,51,57157,47787,104944
354330,201704,2461,848,1613,790189.24,1509252.69,2299441.93
354340,201704,10624,5119,5505,4778680.62,5154070.42,9932751.04
354350,201704,128,87,41,81519,38276.45,119795.45
354360,201704,88,45,43,42165,40291,82456
354370,201704,259,134,125,125558,117125,242683
354380,201704,203,119,84,110729,78708,189437
354390,201704,2732,990,1742,927321.6,1630152.72,2557474.32
354400,201704,322,166,156,154465.9,145047.7,299513.6
354410,201704,592,287,305,267978.32,284848.1,552826.42
354420,201704,259,166,93,155542,87141,242683
354425,201704,311,178,133,166786,123956.1,290742.1
354430,201704,192,125,67,114801.95,62029.4,176831.35
354440,201704,44,31,13,28929,12181,41110
354450,201704,44,29,15,27173,14055,41228
354460,201704,91,54,37,50598,34669,85267
354470,201704,38,27,11,25299,10307,35606
354480,201704,114,61,53,57148,49651.63,106799.63
354490,201704,143,89,54,83236.81,50598,133834.81
354500,201704,398,195,203,182715,190211,372926
354510,201704,109,74,35,69234.56,32795,102029.56
354515,201704,38,15,23,14055,21551,35606
354520,201704,1551,698,853,651518.6,798923.68,1450442.28
354530,201704,593,313,280,290934.5,261517.1,552451.6
354540,201704,270,149,121,139613,113372.32,252985.32
354550,201704,45,26,19,24362,17803,42165
354560,201704,158,90,68,84330,63706.63,148036.63
354570,201704,147,98,49,91826,45913,137739
354580,201704,1986,949,1037,885464.7,971379.22,1856843.92
354600,201704,284,155,129,143811.36,120868.32,264679.68
354610,201704,70,62,8,58094,7496,65590
354620,201704,64,18,46,16866,43102,59968
354625,201704,20,12,8,11244,7492,18736
354630,201704,338,219,119,204881.7,111503,316384.7
354640,201704,786,508,278,472140.5,260486,732626.5
354650,201704,71,36,35,33723,32758.26,66481.26
354660,201704,781,566,215,526859.85,201455,728314.85
354670,201704,287,100,187,93700,174283,267983
354680,201704,1218,463,755,433831,706967,1140798
354690,201704,89,60,29,55284,27173,82457
354700,201704,81,56,25,52472,23425,75897
354710,201704,54,37,17,34044.3,15929,49973.3
354720,201704,22,21,1,19677,937,20614
354730,201704,1914,807,1107,753527.5,1036446.9,1789974.4
354740,201704,55,39,16,36543,14992,51535
354750,201704,421,252,169,236115,158353,394468
354760,201704,499,306,193,285786,180560,466346
354765,201704,11,5,6,4685,5622,10307
354770,201704,314,221,93,205986.71,87141,293127.71
354780,201704,8054,3273,4781,3051701.79,4475247.34,7526949.13
354790,201704,119,68,51,63716,47787,111503
354800,201704,399,222,177,208014,165568,373582
354805,201704,103,51,52,47163,48724,95887
354810,201704,140,81,59,75615.9,55283,130898.9
354820,201704,178,77,101,71943,94637,166580
354830,201704,37,21,16,19677,14992,34669
354840,201704,51,33,18,30921,16866,47787
354850,201704,4566,2021,2545,1886693.97,2379808.86,4266502.83
354860,201704,334,163,171,152731,158166.3,310897.3
354870,201704,11368,5191,6177,4837524.88,5779193.68,10616718.56
354880,201704,2968,1098,1870,1025633.55,1750341.96,2775975.51
354890,201704,2791,1537,1254,1435217.04,1173677.24,2608894.28
354900,201704,58,38,20,35606,18740,54346
354910,201704,1153,603,550,563100.22,515350,1078450.22
354920,201704,54,46,8,43102,7496,50598
354925,201704,11,6,5,5622,4685,10307
354930,201704,32,28,4,25970,3748,29718
354940,201704,796,579,217,540183.84,203329,743512.84
354950,201704,232,150,82,139948,76834,216782
354960,201704,173,66,107,61842,99978,161820
354970,201704,803,513,290,476844.09,271102.31,747946.40
354980,201704,8173,3053,5120,2854353.97,4795626.35,7649980.32
354990,201704,8997,4219,4778,3943821.3,4470785.88,8414607.18
354995,201704,525,188,337,176156,315178.69,491334.69
355000,201704,450,147,303,137734.32,282787,420521.32
355010,201704,625,402,223,375737.45,206778.36,582515.81
355020,201704,709,444,265,414145.22,248297,662442.22
355030,201704,199697,76991,122706,71930079.51,114874086.1,186804165.61
355040,201704,697,331,366,309866,342754.6,652620.6
355050,201704,154,103,51,95008.77,47787,142795.77
355060,201704,1300,686,614,637740.87,573491.25,1211232.12
355070,201704,1449,709,740,661509.44,692395,1353904.44
355080,201704,199,116,83,108484.74,76899.9,185384.64
355090,201704,274,185,89,171285,83393,254678
355100,201704,4653,2344,2309,2177983.2,2160884.57,4338867.77
355110,201704,292,192,100,178171.55,93700,271871.55
355120,201704,115,85,30,79176.5,28110,107286.5
355130,201704,48,25,23,23425,21551,44976
355140,201704,185,121,64,113377,59968,173345
355150,201704,680,407,273,380137.1,255801,635938.1
355160,201704,418,187,231,172876.8,216447,389323.8
355170,201704,2001,1037,964,970311.87,902594.18,1872906.05
355180,201704,609,251,358,233968.9,334345.02,568313.92
355190,201704,212,144,68,134928,63716,198644
355200,201704,111,63,48,59031,44976,104007
355210,201704,671,387,284,362619,266080.63,628699.63
355220,201704,6319,3392,2927,3169559.78,2734634.72,5904194.50
355230,201704,104,64,40,59968,37475.32,97443.32
355240,201704,4012,1779,2233,1655981.95,2088318.38,3744300.33
355250,201704,5212,2536,2676,2369394.51,2504101.81,4873496.32
355255,201704,50,29,21,27173,19677,46850
355260,201704,181,108,73,101177.26,68383,169560.26
355270,201704,164,96,68,89952,63014,152966
355280,201704,6036,2581,3455,2414089.5,3231916.07,5646005.57
355290,201704,79,59,20,55283,18740,74023
355300,201704,174,118,56,110238.05,52472,162710.05
355310,201704,105,59,46,55283,43102,98385
355320,201704,94,48,46,44694.9,42406.3,87101.2
355330,201704,269,147,122,137739,114314,252053
355340,201704,1224,526,698,490865.52,653297.2,1144162.72
355350,201704,135,70,65,65590,60905,126495
355360,201704,164,98,66,91619.86,61842,153461.86
355365,201704,26,21,5,19677,4685,24362
355370,201704,1028,576,452,534902.96,421871.86,956774.82
355380,201704,758,515,243,481155.8,227645,708800.8
355385,201704,50,35,15,32795,14055,46850
355390,201704,105,59,46,55283,43102,98385
355395,201704,185,113,72,105080.32,67464,172544.32
355400,201704,1486,925,561,863734.68,524157.9,1387892.58
355410,201704,4773,2227,2546,2071745.28,2376816.7,4448561.98
355420,201704,42,32,10,29984,9370,39354
355430,201704,328,203,125,189555.1,117125,306680.1
355440,201704,76,43,33,40291,30921,71212
355450,201704,411,190,221,173861.87,205484.3,379346.17
355460,201704,71,55,16,50598.51,14992,65590.51
355465,201704,50,32,18,29984,16866,46850
355470,201704,184,69,115,63716.55,107755,171471.55
355475,201704,10,7,3,6559,2811,9370
355480,201704,443,190,253,176906,235177.63,412083.63
355490,201704,109,81,28,75897,26236,102133
355495,201704,52,25,27,23425,25299,48724
355500,201704,1694,959,735,894074.14,688093.86,1582168.00
355510,201704,265,196,69,180255.5,64653,244908.5
355520,201704,36,28,8,26236,7496,33732
355530,201704,21,14,7,13118,6559,19677
355535,201704,76,34,42,31858,39354,71212
355540,201704,2278,907,1371,848294.31,1283671.63,2131965.94
355550,201704,66,40,26,37480,24362,61842
355560,201704,229,120,109,112440,101508.3,213948.3
355570,201704,29,18,11,16866,10307,27173
355580,201704,271,182,89,170534,83388.32,253922.32
355590,201704,22,14,8,13118,7496,20614
355600,201704,276,144,132,134928,123398.32,258326.32
355610,201704,198,131,67,122747,62779,185526
355620,201704,1211,552,659,515490.9,616916.8,1132407.7
355630,201704,406,285,121,266109,113377,379486
355635,201704,128,59,69,55283,64640,119923
355640,201704,572,331,241,309210,225817,535027
355645,201704,820,353,467,329099.64,435733.21,764832.85
355650,201704,1913,879,1034,822097,968839.63,1790936.63
355660,201704,268,142,126,133054,118057.32,251111.32
355670,201704,449,163,286,152731,267701,420432
355680,201704,212,117,95,109629,89015,198644
355690,201704,83,39,44,36543,40890,77433
355695,201704,14,12,2,11244,1874,13118
355700,201704,1090,586,504,543382.71,471967,1015349.71
355710,201704,2146,1179,967,1099556.68,905488.9,2005045.58
355715,201704,20,18,2,16866,1874,18740
355720,201704,204,125,79,115563.66,74019,189582.66
355730,201704,84,51,33,46928.53,30921,77849.53
410010,201704,123,103,20,96511,18740,115251
410020,201704,101,90,11,84330,10307,94637
410030,201704,158,102,56,95293,52472,147765
410040,201704,974,517,457,484180.13,427740.9,911921.03
410045,201704,34,29,5,27173,4685,31858
410050,201704,464,262,202,245494,188524.5,434018.5
410060,201704,258,200,58,186838,54346,241184
410070,201704,333,266,67,249242,62779,312021
410080,201704,165,109,56,102133,52472,154605
410090,201704,71,63,8,58825,7496,66321
410100,201704,290,205,85,192085,78942.25,271027.25
410105,201704,38,24,14,22488,13118,35606
410110,201704,305,184,121,172408,113377,285785
410115,201704,27,18,9,16866,8433,25299
410120,201704,442,224,218,209591.9,204266,413857.9
410130,201704,39,25,14,23425,13118,36543
410140,201704,2960,1444,1516,1347879.63,1418983.63,2766863.26
410150,201704,2660,1064,1596,996424.65,1494959.5,2491384.15
410160,201704,490,316,174,295810.9,163038,458848.9
410165,201704,65,41,24,38417,22488,60905
410170,201704,163,127,36,116803.83,33732,150535.83
410180,201704,2041,1171,870,1093310.69,813852.08,1907162.77
410185,201704,43,39,4,36543,3748,40291
410190,201704,398,243,155,227691,145235,372926
410200,201704,951,715,236,668160.15,221132,889292.15
410210,201704,536,274,262,256738,244932,501670
410220,201704,37,21,16,19677,14992,34669
410230,201704,121,72,49,67464,45913,113377
410240,201704,702,457,245,427646.9,229565,657211.9
410250,201704,383,285,98,266451.6,91805.89,358257.49
410260,201704,307,166,141,155542,132117,287659
410270,201704,30,20,10,18740,9370,28110
410275,201704,73,55,18,51535,16866,68401
410280,201704,302,169,133,158098.14,124621,282719.14
410290,201704,215,147,68,136875.81,63274.02,200149.83
410300,201704,81,65,16,60905,14992,75897
410302,201704,23,15,8,14055,7496,21551
410304,201704,50,33,17,30921,15929,46850
410305,201704,183,96,87,89160,81514.32,170674.32
410310,201704,257,166,91,155542,85267,240809
410315,201704,59,43,16,40267,14992,55259
410320,201704,136,89,47,83393,44039,127432
410322,201704,34,23,11,21551,10307,31858
410330,201704,194,138,56,129306,52472,181778
410335,201704,105,66,39,61842,36543,98385
410337,201704,32,28,4,26236,3748,29984
410340,201704,31,30,1,28110,937,29047
410345,201704,199,126,73,117321.77,68401,185722.77
410347,201704,52,40,12,37480,11244,48724
410350,201704,234,146,88,136802,82456,219258
410360,201704,443,268,175,249555.1,163694,413249.1
410370,201704,2259,925,1334,862876.25,1246661.11,2109537.36
410380,201704,225,150,75,140550,70275,210825
410390,201704,358,273,85,255797,79645,335442
410395,201704,35,24,11,22488,9933,32421
410400,201704,810,410,400,382864.1,374178,757042.1
410405,201704,87,64,23,59968,21551,81519
410410,201704,46,35,11,32795,10307,43102
410420,201704,1615,805,810,752512.6,757409.3,1509921.9
410425,201704,172,84,88,78521,82456,160977
410430,201704,2160,1266,894,1183805.9,835729.16,2019535.06
410440,201704,399,281,118,262361,110566,372927
410442,201704,358,238,120,222070,112440,334510
410445,201704,413,287,126,268919,118062,386981
410450,201704,404,200,204,187400,191148,378548
410460,201704,390,215,175,201173.9,163975,365148.9
410465,201704,192,123,69,113751.8,64653,178404.8
410470,201704,213,131,82,122747,76834,199581
410480,201704,5530,2737,2793,2550508.8,2611887.21,5162396.01
410490,201704,1339,885,454,827782.46,423271,1251053.46
410500,201704,253,144,109,134928,102133,237061
410510,201704,182,128,54,119936,49964.3,169900.3
410520,201704,291,215,76,201455,71212,272667
410530,201704,222,83,139,77771,130239,208010
410540,201704,317,229,88,214002.8,82451.32,296454.12
410550,201704,1553,679,874,635005,818371.12,1453376.12
410560,201704,144,111,33,104007,30921,134928
410570,201704,439,307,132,285139.5,123684,408823.5
410580,201704,3097,1393,1704,1302251.36,1595243,2897494.36
410590,201704,394,275,119,257675,111503,369178
410600,201704,167,148,19,138676,17803,156479
410610,201704,50,41,9,38417,8433,46850
410620,201704,226,162,64,151794,59968,211762
410630,201704,434,253,181,237061,168458,405519
410640,201704,919,560,359,522540.44,335742.53,858282.97
410645,201704,99,72,27,67070,25299,92369
410650,201704,355,238,117,222069,109629,331698
410655,201704,75,60,15,56220,14055,70275
410657,201704,41,17,24,15929,22488,38417
410660,201704,567,403,164,376012,153668,529680
410670,201704,74,60,14,56220,13118,69338
410680,201704,193,157,36,147109,32774.99,179883.99
410685,201704,21,16,5,14992,4685,19677
410690,201704,28443,12248,16195,11458630.09,15164923.94,26623554.03
410700,201704,306,225,81,210263,75897,286160
410710,201704,134,108,26,101196,24362,125558
410712,201704,16,10,6,9370,5622,14992
410715,201704,87,65,22,60905,20614,81519
410720,201704,583,357,226,334509,211753,546262
410725,201704,173,126,47,118062,44039,162101
410730,201704,90,58,32,54346,29984,84330
410740,201704,111,84,27,78708,25299,104007
410750,201704,209,158,51,148046,47787,195833
410752,201704,20,14,6,13118,5622,18740
410753,201704,50,22,28,19953.41,26236,46189.41
410754,201704,48,32,16,29984,14992,44976
410755,201704,82,56,26,52190.9,24362,76552.9
410760,201704,657,374,283,350438,264703,615141
410765,201704,1588,769,819,714740.94,766550.63,1481291.57
410770,201704,106,90,16,84330,14992,99322
410773,201704,48,35,13,32795,12181,44976
410775,201704,174,128,46,119280.1,43102,162382.1
410780,201704,81,43,38,40291,35606,75897
410785,201704,72,54,18,50411,16866,67277
410790,201704,65,32,33,29984,30921,60905
410800,201704,293,185,108,172409,101196,273605
410810,201704,35,28,7,26236,6278,32514
410820,201704,175,130,45,121670,42165,163835
410830,201704,8483,3874,4609,3620959.46,4316867.82,7937827.28
410832,201704,105,74,31,69056.9,29047,98103.9
410840,201704,1353,747,606,697433.99,567692.67,1265126.66
410845,201704,56,34,22,31858,20614,52472
410850,201704,190,131,59,122426,55283,177709
410855,201704,41,37,4,34669,3748,38417
410860,201704,666,385,281,359973.75,263297,623270.75
410865,201704,108,81,27,75897,25299,101196
410870,201704,146,127,19,118999,17516,136515
410880,201704,1074,525,549,491610.05,514359,1005969.05
410890,201704,74,57,17,53409,15929,69338
410895,201704,64,46,18,43102,16866,59968
410900,201704,40,32,8,29984,7496,37480
410910,201704,24,21,3,19677,2811,22488
410920,201704,50,26,24,24362,22488,46850
410930,201704,500,315,185,294947.74,173063.9,468011.64
410940,201704,4248,2553,1695,2383283.57,1586380,3969663.57
410950,201704,122,85,37,79645,34669,114314
410960,201704,744,331,413,309866,386981,696847
410965,201704,63,50,13,46850,12181,59031
410970,201704,608,431,177,403391.1,165849,569240.1
410975,201704,107,70,37,65229,34669,99898
410980,201704,1470,660,810,617406.91,758680.22,1376087.13
410990,201704,255,170,85,159124.25,79363.9,238488.15
411000,201704,60,41,19,38417,17803,56220
411005,201704,17,13,4,12181,3748,15929
411007,201704,234,137,97,128369,90889,219258
411010,201704,566,401,165,375512,154605,530117
411020,201704,280,192,88,179904,82456,262360
411030,201704,24,15,9,14055,8433,22488
411040,201704,48,33,15,30921,14055,44976
411050,201704,224,180,44,167190.17,41101.12,208291.29
411060,201704,507,346,161,324193,150857,475050
411065,201704,61,55,6,51413.19,5622,57035.19
411070,201704,1153,769,384,716618,359527,1076145
411080,201704,242,173,69,162184,63866.66,226050.66
411090,201704,109,79,30,74023,28110,102133
411095,201704,255,104,151,96980,141477,238457
411100,201704,109,89,20,83393,18740,102133
411110,201704,128,87,41,81519,38417,119936
411120,201704,171,132,39,123684,36543,160227
411125,201704,160,72,88,67464,82456,149920
411130,201704,114,98,16,91200,14992,106192
411140,201704,173,118,55,110263.9,51019.65,161283.55
411150,201704,1165,775,390,726165.63,365430,1091595.63
411155,201704,118,81,37,75897,34669,110566
411160,201704,21,10,11,9370,10307,19677
411170,201704,60,52,8,48442.9,7496,55938.9
411180,201704,903,595,308,555360.33,288591.32,843951.65
411190,201704,292,169,123,157697.1,115251,272948.1
411200,201704,658,436,222,407119.84,207404.95,614524.79
411210,201704,660,354,306,330175.83,286722,616897.83
411220,201704,148,112,36,104944,33732,138676
411230,201704,51,45,6,42165,5622,47787
411240,201704,124,86,38,80582,35606,116188
411250,201704,406,294,112,275478,104944,380422
411260,201704,21,15,6,14055,5622,19677
411270,201704,286,159,127,148983,118999,267982
411275,201704,198,174,24,162898,22488,185386
411280,201704,217,150,67,139301.36,62779,202080.36
411290,201704,59,42,17,39354,15929,55283
411295,201704,142,114,28,106818,26236,133054
411300,201704,80,43,37,40291,34669,74960
411310,201704,91,68,23,63716,21551,85267
411320,201704,722,527,195,492441.9,181141.24,673583.14
411325,201704,46,27,19,25299,17803,43102
411330,201704,885,564,321,526246.75,299933.8,826180.55
411340,201704,25,17,8,15929,7187,23116
411342,201704,85,60,25,56220,23425,79645
411345,201704,119,60,59,56220,55274,111494
411350,201704,467,383,84,357887.92,78417.63,436305.55
411360,201704,50,30,20,28110,18740,46850
411370,201704,13667,5607,8060,5238835.26,7539096.02,12777931.28
411373,201704,205,151,54,141487,50598,192085
411375,201704,85,69,16,64653,14992,79645
411380,201704,101,73,28,67464.89,26236,93700.89
411390,201704,142,92,50,86204,46850,133054
411400,201704,346,258,88,241737,82456,324193
411410,201704,442,222,220,206655.35,205859,412514.35
411420,201704,1010,463,547,431582.2,512070.6,943652.8
411430,201704,396,255,141,238279.1,132108,370387.1
411435,201704,38,27,11,25299,10307,35606
411440,201704,464,369,95,344130.17,89015,433145.17
411450,201704,433,352,81,329824,75897,405721
411460,201704,707,282,425,263266.08,396924.4,660190.48
411470,201704,125,91,34,85267,31858,117125
411480,201704,612,349,263,325514.8,246149.9,571664.7
411490,201704,291,179,112,167723,104944,272667
411500,201704,107,92,15,86204,13399.9,99603.9
411510,201704,214,174,40,161678.69,37480,199158.69
411520,201704,5804,2275,3529,2127194.44,3299615.99,5426810.43
411530,201704,110,72,38,67464,35606,103070
411535,201704,52,20,32,18740,29984,48724
411540,201704,315,216,99,201572.6,92763,294335.6
411545,201704,74,52,22,48724,20614,69338
411550,201704,70,54,16,50598,14992,65590
411560,201704,362,166,196,154914.21,183652,338566.21
411570,201704,765,290,475,271449,444888,716337
411573,201704,37,23,14,21551,13118,34669
411575,201704,252,153,99,143361,92763,236124
411580,201704,1195,469,726,438484.8,679270,1117754.8
411585,201704,70,35,35,32795,32795,65590
411590,201704,25,18,7,16866,6559,23425
411600,201704,42,22,20,20614,18740,39354
411605,201704,228,108,120,101036,112440,213476
411610,201704,234,160,74,149920,69338,219258
411620,201704,342,188,154,175968.6,144298,320266.6
411630,201704,55,36,19,33732,17803,51535
411640,201704,38,30,8,28110,7496,35606
411650,201704,14,11,3,10307,2811,13118
411660,201704,40,34,6,31858,5622,37480
411670,201704,251,192,59,178892.81,55263,234155.81
411680,201704,160,138,22,129306,20614,149920
411690,201704,593,329,264,307656.08,246985.6,554641.68
411695,201704,64,49,15,45913,14055,59968
411700,201704,169,144,25,134928,23425,158353
411705,201704,107,69,38,64653,35606,100259
411710,201704,294,192,102,178938.1,95574,274512.1
411720,201704,132,83,49,77771,45913,123684
411721,201704,71,57,14,53409,13118,66527
411722,201704,95,42,53,39354,49661,89015
411725,201704,140,111,29,103726,27173,130899
411727,201704,81,67,14,62779,12836.9,75615.9
411729,201704,34,25,9,23425,8433,31858
411730,201704,537,347,190,323577.3,178030,501607.3
411740,201704,28,21,7,19677,6559,26236
411745,201704,70,48,22,44199,20614,64813
411750,201704,818,400,418,373442.9,390706.36,764149.26
411760,201704,1183,889,294,831485.04,275469,1106954.04
411770,201704,398,275,123,257675,115251,372926
411780,201704,355,231,124,215510.84,116188,331698.84
411790,201704,513,281,232,262375.17,217272.67,479647.84
411800,201704,169,133,36,124621,33732,158353
411810,201704,150,113,37,105881,34669,140550
411820,201704,2085,1021,1064,954166.56,996565.86,1950732.42
411830,201704,10,10,0,9370,0,9370
411840,201704,1900,1174,726,1099362.6,679774,1779136.6
411845,201704,49,16,33,14992,30921,45913
411850,201704,1209,708,501,660005.29,467518.81,1127524.10
411860,201704,44,29,15,26892,14055,40947
411870,201704,37,30,7,28110,6559,34669
411880,201704,414,272,142,254610,132323.14,386933.14
411885,201704,107,69,38,64653,35606,100259
411890,201704,324,199,125,186463,117116,303579
411900,201704,72,53,19,49661,17803,67464
411910,201704,167,138,29,129296.63,26236,155532.63
411915,201704,1991,859,1132,803751.11,1059913.93,1863665.04
411920,201704,120,102,18,95574,16866,112440
411925,201704,18,12,6,11244,5622,16866
411930,201704,784,578,206,539714,193022,732736
411940,201704,578,415,163,388855,152706.56,541561.56
411950,201704,865,464,401,434758.63,375424.7,810183.33
411960,201704,938,675,263,630144,246431,876575
411965,201704,28,19,9,17803,8433,26236
411970,201704,75,68,7,63716,6559,70275
411980,201704,195,127,68,118999,63716,182715
411990,201704,4683,2760,1923,2569170.39,1799547.5,4368717.89
411995,201704,445,170,275,159290,257675,416965
412000,201704,268,151,117,140785.56,109629,250414.56
412010,201704,43,27,16,25299,14992,40291
412015,201704,43,32,11,29984,10307,40291
412020,201704,30,26,4,24080.9,3748,27828.9
412030,201704,64,54,10,50598,9370,59968
412033,201704,49,32,17,29960,15929,45889
412035,201704,86,55,31,51535,29047,80582
412040,201704,33,24,9,22207,8433,30640
412050,201704,199,146,53,136802,49661,186463
412060,201704,746,589,157,549082.88,146827.9,695910.78
412065,201704,44,31,13,29047,12181,41228
412070,201704,149,100,49,93044.1,45913,138957.1
412080,201704,268,135,133,126495,124621,251116
412085,201704,29,13,16,12181,14992,27173
412090,201704,699,429,270,400053.1,252990,653043.1
412100,201704,242,201,41,187401,38229.6,225630.6
412110,201704,75,59,16,55283,14992,70275
412120,201704,308,201,107,187774.8,100259,288033.8
412125,201704,90,50,40,46568.9,37480,84048.9
412130,201704,52,35,17,32795,15929,48724
412135,201704,26,13,13,12181,12181,24362
412140,201704,284,212,72,198644,67464,266108
412150,201704,252,169,83,157659.62,77771,235430.62
412160,201704,98,61,37,57157,34669,91826
412170,201704,610,444,166,416028,155542,571570
412175,201704,45,35,10,32795,9370,42165
412180,201704,188,149,39,139024.29,36543,175567.29
412190,201704,323,262,61,244833.41,57157,301990.41
412200,201704,190,123,67,115251,62779,178030
412210,201704,95,75,20,70275,18740,89015
412215,201704,232,159,73,148983,68401,217384
412217,201704,87,69,18,64653,16866,81519
412220,201704,767,584,183,547208,171471,718679
412230,201704,330,207,123,191764.67,114871.75,306636.42
412240,201704,1279,622,657,578631.87,612497.15,1191129.02
412250,201704,381,243,138,227691,128369.92,356060.92
412260,201704,124,92,32,86204,29984,116188
412265,201704,162,129,33,120873,30921,151794
412270,201704,83,46,37,43102,34669,77771
412280,201704,87,68,19,63716,17803,81519
412290,201704,103,65,38,60670.75,35606,96276.75
412300,201704,221,144,77,134928,72149,207077
412310,201704,45,38,7,35606,6559,42165
412320,201704,94,79,15,74023,14055,88078
412330,201704,160,143,17,133991,15929,149920
412340,201704,138,93,45,87141,41884,129025
412350,201704,561,269,292,251069.15,273417,524486.15
412360,201704,26,23,3,21551,2811,24362
412370,201704,158,130,28,120873,26236,147109
412380,201704,257,187,70,175219,65065.65,240284.65
412382,201704,52,28,24,26236,22488,48724
412385,201704,142,97,45,90889,42165,133054
412390,201704,263,197,66,184589,61842,246431
412395,201704,62,50,12,46850,11244,58094
412400,201704,68,48,20,44976,18740,63716
412402,201704,233,106,127,99317.32,118717.9,218035.22
412405,201704,795,318,477,296535.01,446466.96,743001.97
412410,201704,910,562,348,525095,326076,851171
412420,201704,17,12,5,11244,4685,15929
412430,201704,20,15,5,14055,4685,18740
412440,201704,572,313,259,290326.19,241010.28,531336.47
412450,201704,81,68,13,63716,12181,75897
412460,201704,77,61,16,57157,14992,72149
412470,201704,261,212,49,198644,45913,244557
412480,201704,176,133,43,123403.5,40291,163694.5
412490,201704,157,133,24,124621,22488,147109
412500,201704,476,382,94,356716.3,88078,444794.3
412510,201704,192,154,38,143455,35606,179061
412520,201704,127,72,55,67464,51535,118999
412530,201704,107,59,48,55283,44413.9,99696.9
412535,201704,111,83,28,77753,26227,103980
412540,201704,66,32,34,29984,31858,61842
412545,201704,96,70,26,65590,24362,89952
412550,201704,3367,1545,1822,1444295.19,1705996.45,3150291.64
412555,201704,15,12,3,11244,2811,14055
412560,201704,563,427,136,399444,127432,526876
412570,201704,735,414,321,387318.32,300496,687814.32
412575,201704,94,66,28,61842,26236,88078
412580,201704,152,105,47,98385,44039,142424
412590,201704,33,31,2,29047,1874,30921
412600,201704,171,132,39,123684,36543,160227
412610,201704,35,22,13,20614,11376,31990
412620,201704,152,133,19,124621,17803,142424
412625,201704,2141,1141,1000,1067348.76,935436.72,2002785.48
412627,201704,70,57,13,53409,12181,65590
412630,201704,439,291,148,272476,138676,411152
412635,201704,63,21,42,19677,39354,59031
412640,201704,115,78,37,73086,34669,107755
412650,201704,324,207,117,193959,109624.32,303583.32
412660,201704,474,282,192,263532,179904,443436
412665,201704,48,42,6,39354,5622,44976
412667,201704,315,208,107,194291.6,99895.04,294186.64
412670,201704,65,55,10,51535,9370,60905
412680,201704,277,222,55,208014,51535,259549
412690,201704,112,74,38,69338,35325,104663
412700,201704,169,114,55,106818,51254,158072
412710,201704,1382,859,523,798045.8,487877.83,1285923.63
412720,201704,225,154,71,144298,66527,210825
412730,201704,197,150,47,140550,43102,183652
412740,201704,402,216,186,202251.45,174282,376533.45
412750,201704,452,259,193,241746,180841,422587
412760,201704,238,121,117,113377,109629,223006
412770,201704,1984,1132,852,1056388.15,798016,1854404.15
412780,201704,147,119,28,111370.88,26236,137606.88
412785,201704,263,134,129,125089.5,120873,245962.5
412788,201704,33,18,15,16866,14055,30921
412790,201704,133,110,23,102414.1,21551,123965.1
412795,201704,162,120,42,112440,39354,151794
412796,201704,301,206,95,191878.83,88883.82,280762.65
412800,201704,530,348,182,325526.36,170525,496051.36
412810,201704,2893,1599,1294,1494683.69,1211255.22,2705938.91
412820,201704,911,604,307,553142.77,285065.82,838208.59
412830,201704,18,14,4,13118,3748,16866
412840,201704,213,151,62,140550.1,58094,198644.1
412850,201704,774,533,241,497547,225817,723364
412853,201704,178,99,79,92763,74023,166786
412855,201704,229,122,107,112940.21,100259,213199.21
412860,201704,92,70,22,65590,20614,86204
412862,201704,62,46,16,42821,14992,57813
412863,201704,15,11,4,10307,3748,14055
412865,201704,42,32,10,29984,9370,39354
412870,201704,110,70,40,65590,37480,103070
412880,201704,125,98,27,91826,25299,117125
420005,201704,35,31,4,29047,3186,32233
420010,201704,366,243,123,226895,114305,341200
420020,201704,69,58,11,54346,10307,64653
420030,201704,29,26,3,24362,2811,27173
420040,201704,105,81,24,75897,22488,98385
420050,201704,56,34,22,31476.9,20453.34,51930.24
420055,201704,20,19,1,17782,937,18719
420060,201704,33,26,7,24362,6559,30921
420070,201704,98,84,14,78708,13108.63,91816.63
420075,201704,11,9,2,8433,1874,10307
420080,201704,46,41,5,37526.85,4685,42211.85
420090,201704,36,34,2,31094.34,1874,32968.34
420100,201704,148,125,23,115533.1,21551,137084.1
420110,201704,17,17,0,15929,0,15929
420120,201704,43,32,11,29984,10307,40291
420125,201704,82,66,16,61093,14992,76085
420127,201704,31,28,3,26236,2811,29047
420130,201704,359,228,131,213345.63,122737.63,336083.26
420140,201704,1176,687,489,642525.62,458129,1100654.62
420150,201704,45,38,7,35606,6559,42165
420160,201704,42,39,3,36543,2811,39354
420165,201704,16,12,4,11244,3748,14992
420170,201704,65,41,24,38417,22488,60905
420180,201704,25,24,1,22488,937,23425
420190,201704,32,29,3,27173,2811,29984
420195,201704,124,60,64,56220,59687,115907
420200,201704,1266,560,706,520412.1,660868.52,1181280.62
420205,201704,64,30,34,28110,31858,59968
420207,201704,96,56,40,52472,37470.63,89942.63
420208,201704,25,20,5,18740,3841.7,22581.7
420209,201704,17,13,4,12181,3748,15929
420210,201704,449,206,243,192740.9,227607.04,420347.94
420213,201704,50,39,11,36543,10307,46850
420215,201704,23,20,3,18740,2811,21551
420220,201704,69,46,23,43102,21551,64653
420230,201704,698,405,293,378268,274293.63,652561.63
420240,201704,2202,1502,700,1399511.91,655468.98,2054980.89
420243,201704,29,24,5,22488,4685,27173
420245,201704,77,43,34,40291,31858,72149
420250,201704,49,29,20,27173,18740,45913
420253,201704,39,32,7,29984,6559,36543
420257,201704,10,9,1,8433,937,9370
420260,201704,94,83,11,77771,10307,88078
420270,201704,34,29,5,27168.32,4685,31853.32
420280,201704,273,199,74,185397.39,68383,253780.39
420285,201704,20,13,7,12181,6559,18740
420287,201704,48,29,19,27173,17803,44976
420290,201704,929,655,274,613052.6,256671.2,869723.8
420300,201704,1311,1029,282,960521.2,263191.77,1223712.97
420310,201704,56,41,15,38417,14055,52472
420315,201704,35,31,4,29047,3748,32795
420320,201704,838,423,415,395390.58,388851,784241.58
420325,201704,0,0,0,0,0,0
420330,201704,121,85,36,79645,33732,113377
420340,201704,150,107,43,99314,40262.89,139576.89
420350,201704,237,174,63,161727.1,59031,220758.1
420360,201704,735,555,180,518378.23,167077.09,685455.32
420370,201704,102,68,34,63529,31577,95106
420380,201704,1104,796,308,742096.76,287483.29,1029580.05
420390,201704,250,154,96,143717.06,88312.25,232029.31
420395,201704,171,124,47,116188,44029.63,160217.63
420400,201704,243,179,64,166787,59968,226755
420410,201704,59,47,12,44039,11244,55283
420415,201704,33,30,3,28110,2811,30921
420417,201704,43,33,10,30921,9370,40291
420419,201704,11,10,1,9370,937,10307
420420,201704,2741,1670,1071,1553556.13,1000980.88,2554537.01
420425,201704,67,58,9,54337,8414.26,62751.26
420430,201704,1255,864,391,804757.01,366338.89,1171095.90
420435,201704,16,14,2,13118,1874,14992
420440,201704,108,72,36,66724.3,33559.6,100283.9
420445,201704,20,18,2,16866,1874,18740
420450,201704,75,35,40,32766,37480,70246
420455,201704,229,180,49,168632.26,45858.63,214490.89
420460,201704,2217,1507,710,1407359.37,665057.82,2072417.19
420470,201704,119,88,31,82456,29047,111503
420475,201704,7,7,0,6559,0,6559
420480,201704,827,613,214,570895.46,199581.1,770476.56
420490,201704,112,87,25,81519,23425,104944
420500,201704,835,293,542,272887.1,507854,780741.1
420510,201704,21,18,3,16866,2811,19677
420515,201704,22,19,3,17803,2811,20614
420517,201704,7,7,0,6559,0,6559
420519,201704,0,0,0,0,0,0
420520,201704,68,52,16,48724,14992,63716
420530,201704,148,100,48,93700,44976,138676
420535,201704,20,17,3,15929,2811,18740
420540,201704,4247,2524,1723,2355799.15,1609779.69,3965578.84
420543,201704,21,21,0,19677,0,19677
420545,201704,182,130,52,121801,48695.89,170496.89
420550,201704,824,657,167,614063.89,156331.75,770395.64
420555,201704,39,31,8,29047,7496,36543
420560,201704,61,47,14,43664.2,13118,56782.2
420570,201704,121,71,50,65964.8,46840.63,112805.43
420580,201704,289,130,159,121810,148983,270793
420590,201704,494,351,143,328231.1,133991,462222.1
420600,201704,91,45,46,42165,43102,85267
420610,201704,34,32,2,29703,1874,31577
420620,201704,67,56,11,52472,10307,62779
420630,201704,145,104,41,97439.32,38409,135848.32
420640,201704,100,89,11,83393,10307,93700
420650,201704,234,126,108,117366.1,100400.86,217766.96
420660,201704,58,42,16,38604.9,14992,53596.9
420665,201704,37,28,9,26236,8433,34669
420670,201704,308,237,71,222059.63,66227.53,288287.16
420675,201704,13,13,0,12181,0,12181
420680,201704,31,24,7,22488,6559,29047
420690,201704,177,150,27,140550,25299,165849
420700,201704,583,412,171,385969.78,159988.19,545957.97
420710,201704,142,84,58,78708,54346,133054
420720,201704,99,82,17,76834,15929,92763
420730,201704,470,305,165,285711.15,153323.49,439034.64
420740,201704,43,42,1,39354,937,40291
420750,201704,480,317,163,296727.79,152731,449458.79
420757,201704,17,14,3,12321.55,2811,15132.55
420760,201704,40,31,9,29047,8433,37480
420765,201704,68,57,11,53409,10307,63716
420768,201704,68,61,7,57157,6559,63716
420770,201704,86,73,13,68401,12181,80582
420775,201704,43,41,2,37480,1874,39354
420780,201704,225,175,50,163750.12,46850,210600.12
420785,201704,13,9,4,8433,3748,12181
420790,201704,167,141,26,131800.64,23397.63,155198.27
420800,201704,73,55,18,50785.4,16866,67651.4
420810,201704,246,213,33,199572,30124.55,229696.55
420820,201704,2309,1370,939,1276128.83,878334.93,2154463.76
420830,201704,505,294,211,274033.09,196760.63,470793.72
420840,201704,136,102,34,95574,31858,127432
420845,201704,428,191,237,178307.93,220851,399158.93
420850,201704,216,176,40,164912,37480,202392
420860,201704,59,50,9,46850,8433,55283
420870,201704,109,83,26,77771,24362,102133
420880,201704,161,108,53,100530.73,49661,150191.73
420890,201704,826,409,417,381139.26,390720,771859.26
420895,201704,10,10,0,9370,0,9370
420900,201704,392,300,92,279358.22,86176.63,365534.85
420910,201704,5558,3043,2515,2845698.6,2355506.02,5201204.62
420915,201704,81,75,6,70275,5622,75897
420917,201704,18,13,5,12181,4685,16866
420920,201704,20,13,7,12181,6559,18740
420930,201704,2531,1517,1014,1413855.12,944233.31,2358088.43
420940,201704,565,416,149,389774,137998.24,527772.24
420945,201704,7,5,2,4685,1874,6559
420950,201704,54,50,4,46850,3748,50598
420960,201704,113,87,26,81491.63,24343.63,105835.26
420970,201704,300,243,57,226044.45,53381.63,279426.08
420980,201704,24,23,1,21551,937,22488
420985,201704,58,51,7,47787,6559,54346
420990,201704,73,56,17,52472,15929,68401
421000,201704,35,22,13,20614,12181,32795
421003,201704,66,42,24,38641.88,22479,61120.88
421005,201704,8,6,2,5622,1874,7496
421010,201704,725,515,210,482164.78,194716.39,676881.17
421020,201704,27,24,3,22468,2811,25279
421030,201704,122,101,21,94310,19677,113987
421040,201704,56,49,7,45913,6559,52472
421050,201704,290,203,87,188150.1,81519,269669.1
421055,201704,26,23,3,21551,2811,24362
421060,201704,87,61,26,57157,24362,81519
421070,201704,48,43,5,40291,4685,44976
421080,201704,32,29,3,27173,2811,29984
421085,201704,23,18,5,16866,4685,21551
421090,201704,45,34,11,31858,10307,42165
421100,201704,108,82,26,76834,24362,101196
421105,201704,198,159,39,148843,36519.95,185362.95
421110,201704,110,93,17,86531.95,15929,102460.95
421120,201704,144,114,30,106331.13,28091.26,134422.39
421125,201704,17,12,5,11244,4685,15929
421130,201704,778,496,282,464070.3,263212.87,727283.17
421140,201704,30,21,9,18974.25,8433,27407.25
421145,201704,39,32,7,29984,6559,36543
421150,201704,104,76,28,71212,26236,97448
421160,201704,58,38,20,35596.63,18740,54336.63
421165,201704,19,18,1,16866,937,17803
421170,201704,180,156,24,145443.52,22479,167922.52
421175,201704,145,97,48,90889,44920.52,135809.52
421180,201704,56,34,22,31502,20614,52116
421185,201704,16,13,3,12181,2811,14992
421187,201704,0,0,0,0,0,0
421189,201704,38,30,8,28110,7486.63,35596.63
421190,201704,1349,824,525,771339,491240.99,1262579.99
421200,201704,88,69,19,64653,17803,82456
421205,201704,22,14,8,13118,7486.63,20604.63
421210,201704,175,117,58,109629,54346,163975
421220,201704,261,208,53,194286.95,49661,243947.95
421223,201704,54,45,9,42165,8433,50598
421225,201704,51,36,15,33732,14055,47787
421227,201704,89,66,23,61842,21551,83393
421230,201704,44,32,12,29984,11244,41228
421240,201704,19,19,0,17803,0,17803
421250,201704,360,217,143,203236,133494.39,336730.39
421260,201704,29,23,6,21551,5622,27173
421265,201704,0,0,0,0,0,0
421270,201704,56,50,6,46850,5622,52472
421280,201704,326,187,139,175219,129306,304525
421290,201704,300,205,95,191851,87628.56,279479.56
421300,201704,29,23,6,21551,5622,27173
421310,201704,55,40,15,36824.1,14055,50879.1
421315,201704,30,20,10,18740,9370,28110
421320,201704,124,91,33,84940,30921,115861
421330,201704,111,84,27,76346.76,25290,101636.76
421335,201704,40,26,14,24362,13118,37480
421340,201704,273,181,92,167582.5,86204,253786.5
421350,201704,168,101,67,94202,62779,156981
421360,201704,676,497,179,461296.69,167517.63,628814.32
421370,201704,178,137,41,128369,37901.64,166270.64
421380,201704,121,101,20,94632.32,18740,113372.32
421390,201704,18,15,3,14055,2811,16866
421400,201704,108,93,15,87141,14055,101196
421410,201704,21,18,3,16866,2811,19677
421415,201704,18,16,2,14992,1874,16866
421420,201704,152,127,25,118436.8,23425,141861.8
421430,201704,15,12,3,11244,2811,14055
421440,201704,58,45,13,42165,12181,54346
421450,201704,101,89,12,83393,11244,94637
421460,201704,58,49,9,45123.1,8433,53556.1
421470,201704,70,46,24,43102,22488,65590
421480,201704,614,453,161,423992.5,150857,574849.5
421490,201704,25,22,3,19950,2811,22761
421500,201704,507,328,179,304962.51,166864.69,471827.20
421505,201704,25,18,7,16866,6559,23425
421507,201704,31,26,5,24362,4685,29047
421510,201704,73,48,25,44976,23425,68401
421520,201704,67,57,10,52660,9370,62030
421530,201704,53,47,6,43383.1,5622,49005.1
421535,201704,33,32,1,29722,937,30659
421540,201704,58,52,6,48724,5622,54346
421545,201704,90,72,18,66987,16866,83853
421550,201704,268,191,77,178312,72149,250461
421555,201704,22,18,4,16866,3748,20614
421560,201704,8,8,0,7496,0,7496
421565,201704,121,91,30,84704.8,28110,112814.8
421567,201704,28,22,6,20614,5622,26236
421568,201704,33,31,2,29047,1874,30921
421569,201704,9,8,1,7496,937,8433
421570,201704,132,87,45,81519,42165,123684
421575,201704,27,22,5,20356.33,4685,25041.33
421580,201704,709,428,281,401015.89,262360.27,663376.16
421590,201704,20,20,0,18740,0,18740
421600,201704,111,75,36,70255,32796,103051
421605,201704,100,68,32,63389,29984,93373
421610,201704,186,144,42,134928,39354,174282
421620,201704,1103,663,440,618776.76,412232.52,1031009.28
421625,201704,20,17,3,15929,2811,18740
421630,201704,265,169,96,158307,89109,247416
421635,201704,17,7,10,6559,9370,15929
421640,201704,96,84,12,78708,11244,89952
421650,201704,268,157,111,147090.26,103988.26,251078.52
421660,201704,2013,1194,819,1117064.36,766157.16,1883221.52
421670,201704,168,126,42,118062,39354,157416
421680,201704,171,155,16,145235,14983,160218
421690,201704,339,238,101,222425.8,93690.99,316116.79
421700,201704,54,34,20,31858,17897,49755
421710,201704,21,21,0,19677,0,19677
421715,201704,9,8,1,7496,937,8433
421720,201704,545,387,158,360641.3,146350.54,506991.84
421725,201704,11,5,6,4685,5622,10307
421730,201704,40,30,10,27392.48,9370,36762.48
421740,201704,81,39,42,36543,39354,75897
421750,201704,213,154,59,142706.1,55283,197989.1
421755,201704,24,22,2,20614,1874,22488
421760,201704,106,76,30,71202.63,28110,99312.63
421770,201704,530,368,162,343387.52,151448.15,494835.67
421775,201704,22,14,8,13118,7496,20614
421780,201704,185,145,40,135583.9,37480,173063.9
421790,201704,157,132,25,123684,23425,147109
421795,201704,14,12,2,11244,1874,13118
421800,201704,432,277,155,257829.61,145230.32,403059.93
421810,201704,70,54,16,50598,14992,65590
421820,201704,291,197,94,183624.1,88078,271702.1
421825,201704,126,102,24,95574,22488,118062
421830,201704,132,101,31,94637,29047,123684
421835,201704,3,3,0,2811,0,2811
421840,201704,59,50,9,46841,8433,55274
421850,201704,71,61,10,57157,9366,66523
421860,201704,42,32,10,29703,9370,39073
421870,201704,952,717,235,664319.26,219474.91,883794.17
421875,201704,49,43,6,40291,5622,45913
421880,201704,162,115,47,107755,43758,151513
421885,201704,26,21,5,19677,4404,24081
421890,201704,114,79,35,74023,32795,106818
421895,201704,35,33,2,30921,1874,32795
421900,201704,144,117,27,109555.15,25254,134809.15
421910,201704,64,43,21,40291,19677,59968
421915,201704,31,24,7,22488,6559,29047
421917,201704,36,26,10,24081,9370,33451
421920,201704,35,32,3,29984,2811,32795
421930,201704,752,577,175,540311.68,163938.63,704250.31
421935,201704,58,51,7,47787,6559,54346
421940,201704,42,37,5,34669,4685,39354
421950,201704,821,535,286,495314.6,265522.52,760837.12
421960,201704,40,35,5,32514,4685,37199
421970,201704,359,227,132,212209.12,123633.01,335842.13
421985,201704,28,20,8,18740,7496,26236
422000,201704,0,0,0,0,0,0
430003,201704,211,46,165,42399.25,154605,197004.25
430005,201704,30,24,6,22488,5622,28110
430010,201704,284,199,85,185994.5,79645,265639.5
430020,201704,154,99,55,92482,50598,143080
430030,201704,118,90,28,84330,26236,110566
430040,201704,2982,1725,1257,1609018.15,1177172.58,2786190.73
430045,201704,65,55,10,51535,9370,60905
430047,201704,7,6,1,5622,937,6559
430050,201704,77,64,13,59968,12181,72149
430055,201704,17,14,3,13118,2811,15929
430057,201704,4,2,2,1874,1874,3748
430060,201704,3688,2168,1520,2023954.46,1419806.64,3443761.10
430063,201704,54,47,7,44039,6559,50598
430064,201704,139,116,23,107989.25,21551,129540.25
430066,201704,10,7,3,6559,2811,9370
430070,201704,49,37,12,34669,11244,45913
430080,201704,70,49,21,45225.8,19677,64902.8
430085,201704,37,10,27,9370,25299,34669
430087,201704,37,27,10,25159,9370,34529
430090,201704,69,63,6,58468.8,5622,64090.8
430100,201704,111,73,38,68401,35606,104007
430105,201704,142,71,71,66527,66227.16,132754.16
430107,201704,20,14,6,13118,5622,18740
430110,201704,391,230,161,214713.55,150791.41,365504.96
430120,201704,143,127,16,118062.95,14992,133054.95
430130,201704,773,477,296,446339.95,277070.9,723410.85
430140,201704,125,116,9,108692,8433,117125
430150,201704,105,70,35,64841,32795,97636
430155,201704,28,27,1,25299,937,26236
430160,201704,3788,2239,1549,2079814.35,1447412.11,3527226.46
430163,201704,307,132,175,122588.68,163853.19,286441.87
430165,201704,22,16,6,14992,5622,20614
430170,201704,78,73,5,68401,4685,73086
430175,201704,80,61,19,57157,17147.1,74304.1
430180,201704,92,73,19,68401,17193.95,85594.95
430185,201704,32,24,8,22488,7496,29984
430187,201704,109,44,65,41228,60605.9,101833.9
430190,201704,229,131,98,122700.15,91160.73,213860.88
430192,201704,14,14,0,13118,0,13118
430195,201704,13,9,4,8433,3748,12181
430200,201704,160,140,20,130524.1,18740,149264.1
430205,201704,19,18,1,16866,937,17803
430210,201704,581,440,141,409187.9,130852.15,540040.05
430215,201704,17,14,3,13118,2811,15929
430220,201704,61,41,20,38417,18740,57157
430222,201704,13,7,6,6559,5622,12181
430223,201704,13,7,6,6559,5622,12181
430225,201704,4,3,1,2811,937,3748
430230,201704,294,184,110,170534,102882.6,273416.6
430235,201704,46,33,13,30921,12171.63,43092.63
430237,201704,28,22,6,20614,5622,26236
430240,201704,126,75,51,70275,47777.63,118052.63
430245,201704,64,52,12,48724,11244,59968
430250,201704,193,114,79,106808.63,74013.63,180822.26
430258,201704,13,11,2,10307,1874,12181
430260,201704,36,31,5,29047,3879.18,32926.18
430265,201704,35,28,7,26217.26,6559,32776.26
430270,201704,580,429,151,397700.3,139707.81,537408.11
430280,201704,1018,639,379,595828.93,352668.8,948497.73
430290,201704,370,213,157,197707.4,147109,344816.4
430300,201704,2091,1144,947,1065961.76,883584.07,1949545.83
430310,201704,1989,1026,963,955565,899555.38,1855120.38
430320,201704,47,39,8,36528.95,7496,44024.95
430330,201704,96,87,9,80861.38,8433,89294.38
430340,201704,65,59,6,55283,5622,60905
430350,201704,1653,1153,500,1068809.49,467057.76,1535867.25
430355,201704,26,24,2,22488,1874,24362
430360,201704,82,35,47,32795,43102.1,75897.1
430367,201704,29,19,10,17803,8592.29,26395.29
430370,201704,55,48,7,44976,6559,51535
430380,201704,120,90,30,83767.8,28110,111877.8
430390,201704,608,381,227,356715.9,212399.63,569115.53
430400,201704,135,104,31,95761.4,29028.26,124789.66
430410,201704,56,44,12,41228,11244,52472
430420,201704,464,307,157,286160.9,144889.58,431050.48
430430,201704,51,49,2,45288.95,1874,47162.95
430435,201704,150,111,39,103725.9,35840.25,139566.15
430440,201704,515,343,172,321391,160976.6,482367.6
430450,201704,1163,957,206,890245.27,193012.63,1083257.90
430460,201704,5077,2747,2330,2558995.58,2175832.08,4734827.66
430461,201704,21,19,2,17803,1874,19677
430462,201704,11,7,4,6559,3748,10307
430463,201704,956,492,464,458334.39,434422.05,892756.44
430465,201704,28,17,11,15929,10307,26236
430466,201704,629,454,175,423525,163787.6,587312.6
430467,201704,86,49,37,45913,34659.63,80572.63
430468,201704,110,65,45,60905,41918.39,102823.39
430469,201704,22,16,6,14992,5622,20614
430470,201704,1147,640,507,592013.37,473138.15,1065151.52
430471,201704,50,38,12,35587.26,11244,46831.26
430480,201704,96,61,35,56313.7,32785.63,89099.33
430485,201704,5,5,0,4404,0,4404
430490,201704,92,73,19,67979.35,17803,85782.35
430495,201704,32,27,5,25299,4685,29984
430500,201704,188,126,62,117359.25,57724.63,175083.88
430510,201704,2900,1916,984,1790214.2,921418.06,2711632.26
430511,201704,18,18,0,16866,0,16866
430512,201704,134,91,43,85267,40291,125558
430513,201704,52,47,5,43570.5,4685,48255.5
430515,201704,30,28,2,26236,1874,28110
430517,201704,166,145,21,134928.25,19658.26,154586.51
430520,201704,368,248,120,231711.63,112402.52,344114.15
430530,201704,93,52,41,48724,38417,87141
430535,201704,461,298,163,279010.49,152717.32,431727.81
430537,201704,13,13,0,12181,0,12181
430540,201704,75,48,27,44976,25299,70275
430543,201704,374,117,257,109629,240575,350204
430544,201704,42,39,3,36543,2811,39354
430545,201704,329,146,183,136736.41,170983.76,307720.17
430550,201704,46,38,8,35606,7496,43102
430558,201704,5,3,2,2811,1874,4685
430560,201704,46,19,27,17803,25299,43102
430570,201704,100,46,54,43102,50541.78,93643.78
430580,201704,126,98,28,91826,26189.15,118015.15
430583,201704,16,16,0,14992,0,14992
430585,201704,8,4,4,3748,3748,7496
430587,201704,16,9,7,8433,6559,14992
430590,201704,151,126,25,116843.9,23425,140268.9
430593,201704,4,4,0,3748,0,3748
430595,201704,15,9,6,8433,5622,14055
430597,201704,55,29,26,27173,24362,51535
430600,201704,212,141,71,132107.63,66245.9,198353.53
430605,201704,151,93,58,87141,54336.63,141477.63
430607,201704,25,21,4,19677,3748,23425
430610,201704,1589,725,864,675203.05,804649.12,1479852.17
430613,201704,2,2,0,1874,0,1874
430620,201704,109,78,31,72946,29028.26,101974.26
430630,201704,46,43,3,40291,2811,43102
430632,201704,32,28,4,26236,3748,29984
430635,201704,40,36,4,33732,3748,37480
430637,201704,60,34,26,31858,24362,56220
430640,201704,206,114,92,105974.7,86204,192178.7
430642,201704,27,25,2,23425,1874,25299
430645,201704,30,26,4,24362,3748,28110
430650,201704,244,191,53,178686,49614.15,228300.15
430655,201704,7,7,0,6559,0,6559
430660,201704,962,464,498,433034.55,464414.78,897449.33
430670,201704,70,49,21,45913,19677,65590
430673,201704,75,42,33,39354,30921,70275
430675,201704,13,10,3,9370,2811,12181
430676,201704,451,265,186,247630.36,174211.84,421842.20
430680,201704,244,167,77,154324,72149,226473
430690,201704,517,310,207,289598.59,191395.01,480993.60
430692,201704,7,5,2,4685,1874,6559
430693,201704,126,82,44,76834,40609.58,117443.58
430695,201704,64,58,6,53427.74,5622,59049.74
430697,201704,62,37,25,34669,23425,58094
430700,201704,1548,1087,461,1009777.55,431957,1441734.55
430705,201704,19,18,1,16866,937,17803
430710,201704,258,166,92,155542,86204,241746
430720,201704,105,91,14,85079.6,13118,98197.6
430730,201704,121,99,22,91826,19433.38,111259.38
430740,201704,56,40,16,37480,14992,52472
430745,201704,38,30,8,27829,7496,35325
430750,201704,334,232,102,216511.72,94637,311148.72
430755,201704,81,45,36,42165,33732,75897
430760,201704,359,219,140,201971.11,131152.26,333123.37
430770,201704,1449,738,711,689445.66,661820.19,1351265.85
430780,201704,309,195,114,182424.9,106752.78,289177.68
430781,201704,27,23,4,21551,3748,25299
430783,201704,43,35,8,32482.8,7496,39978.8
430786,201704,5,2,3,1874,2811,4685
430790,201704,456,295,161,274915.8,150566.63,425482.43
430800,201704,150,125,25,117125,23425,140550
430805,201704,41,39,2,36543,1874,38417
430807,201704,31,19,12,17803,11244,29047
430810,201704,67,42,25,39354,23425,62779
430820,201704,129,76,53,71212,49005.1,120217.1
430825,201704,11,9,2,8433,1874,10307
430830,201704,225,209,16,195552,14992,210544
430840,201704,116,76,40,71212,36824.1,108036.1
430843,201704,4,3,1,2811,937,3748
430845,201704,70,40,30,37480,28110,65590
430850,201704,575,396,179,369784.81,167584.67,537369.48
430860,201704,150,95,55,87703.2,50869.73,138572.93
430865,201704,64,30,34,27454.1,31548.79,59002.89
430870,201704,76,63,13,59031,12181,71212
430880,201704,150,114,36,106818,33732,140550
430885,201704,7,6,1,5622,937,6559
430890,201704,336,203,133,188580.94,124621,313201.94
430900,201704,552,373,179,345378.8,167245.13,512623.93
430905,201704,79,33,46,30921,43102,74023
430910,201704,262,146,116,136802,107746,244548
430912,201704,7,7,0,6559,0,6559
430915,201704,28,20,8,18740,7214.9,25954.9
430920,201704,3951,2190,1761,2046764.11,1647822.42,3694586.53
430925,201704,6,5,1,4441.38,937,5378.38
430930,201704,2045,1219,826,1134615.89,771820.35,1906436.24
430940,201704,233,146,87,135855.63,81500.26,217355.89
430950,201704,159,126,33,118062,30639.9,148701.9
430955,201704,18,11,7,10307,6559,16866
430957,201704,16,15,1,14055,937,14992
430960,201704,239,156,83,145094.45,77771,222865.45
430965,201704,91,58,33,54346,30921,85267
430970,201704,77,64,13,59968,11244,71212
430975,201704,33,31,2,29047,1874,30921
430980,201704,44,27,17,25299,15929,41228
430990,201704,109,82,27,76834,25299,102133
430995,201704,114,110,4,102133,3748,105881
431000,201704,298,137,161,127143.1,150857,278000.1
431010,201704,338,202,136,188308.89,127432,315740.89
431020,201704,1886,1076,810,1001676.24,755868.53,1757544.77
431030,201704,40,33,7,30921,6559,37480
431033,201704,371,181,190,168800.6,178030,346830.6
431036,201704,14,9,5,8433,4685,13118
431040,201704,136,81,55,74960,51427.25,126387.25
431041,201704,36,25,11,23425,10307,33732
431043,201704,41,23,18,21551,16866,38417
431046,201704,12,7,5,6559,4685,11244
431050,201704,210,133,77,122237.84,70662.4,192900.24
431053,201704,67,40,27,36730.4,25299,62029.4
431055,201704,64,41,23,38417,21532.26,59949.26
431057,201704,17,17,0,15929,0,15929
431060,201704,1679,1048,631,975830.83,589473.91,1565304.74
431065,201704,17,10,7,9370,6559,15929
431070,201704,68,64,4,59968,3748,63716
431075,201704,9,9,0,8433,0,8433
431080,201704,137,88,49,81237.9,45913,127150.9
431085,201704,27,24,3,22488,2811,25299
431087,201704,14,13,1,12181,937,13118
431090,201704,53,43,10,40291,9370,49661
431100,201704,1236,733,503,676515.71,471311,1147826.71
431110,201704,245,151,94,141487,87787.53,229274.53
431112,201704,29,18,11,16866,10307,27173
431113,201704,30,20,10,18740,9370,28110
431115,201704,158,106,52,98697.2,48714.63,147411.83
431120,201704,615,363,252,338220.42,236068.52,574288.94
431123,201704,3,3,0,2811,0,2811
431125,201704,89,79,10,74023,9370,83393
431127,201704,8,3,5,2811,4685,7496
431130,201704,602,394,208,367022.9,194596.16,561619.06
431140,201704,693,464,229,431704.01,214216.94,645920.95
431142,201704,31,24,7,21298,6559,27857
431150,201704,204,150,54,140550,50579.26,191129.26
431160,201704,54,48,6,44976,5622,50598
431162,201704,19,14,5,13118,4685,17803
431164,201704,5,5,0,4685,0,4685
431170,201704,98,81,17,75897,15929,91826
431171,201704,47,25,22,23425,20604.63,44029.63
431173,201704,1,1,0,937,0,937
431175,201704,201,97,104,89671,97448,187119
431177,201704,73,55,18,51535,16847.26,68382.26
431179,201704,14,12,2,11244,1874,13118
431180,201704,428,262,166,244557,155523.63,400080.63
431190,201704,88,67,21,62779,19677,82456
431198,201704,65,44,21,41228,19677,60905
431200,201704,18,16,2,14992,1874,16866
431205,201704,27,27,0,25299,0,25299
431210,201704,81,50,31,46523,29047,75570
431213,201704,26,21,5,19677,4685,24362
431215,201704,27,24,3,22488,2811,25299
431217,201704,5,4,1,3748,937,4685
431220,201704,60,51,9,47787,8433,56220
431225,201704,143,94,49,88069,45903.63,133972.63
431230,201704,100,85,15,78989.1,14055,93044.1
431235,201704,7,7,0,6559,0,6559
431237,201704,24,16,8,14992,7496,22488
431238,201704,16,12,4,10963,3748,14711
431240,201704,965,610,355,569022.16,331577.11,900599.27
431242,201704,37,37,0,34669,0,34669
431244,201704,11,8,3,7496,2811,10307
431245,201704,63,48,15,44976,14055,59031
431247,201704,13,9,4,8433,3748,12181
431250,201704,264,134,130,125539.26,121782.26,247321.52
431260,201704,60,44,16,41228,14992,56220
431261,201704,23,15,8,14055,7496,21551
431262,201704,17,17,0,15929,0,15929
431265,201704,166,87,79,81519,74023,155542
431267,201704,15,14,1,13118,937,14055
431270,201704,300,248,52,232376,48724,281100
431275,201704,40,38,2,35606,1874,37480
431280,201704,21,16,5,14172.12,4685,18857.12
431290,201704,23,20,3,18740,2811,21551
431295,201704,5,5,0,4685,0,4685
431300,201704,22,19,3,17803,2811,20614
431301,201704,8,7,1,6559,937,7496
431303,201704,47,33,14,30799.19,12836.9,43636.09
431306,201704,210,111,99,103559.11,92763,196322.11
431308,201704,6,5,1,4685,937,5622
431310,201704,68,58,10,54346,9370,63716
431320,201704,112,68,44,63716,41218.63,104934.63
431330,201704,176,116,60,108692,56220,164912
431333,201704,32,26,6,24362,5622,29984
431335,201704,10,5,5,4685,4685,9370
431337,201704,303,146,157,135988.1,146752.94,282741.04
431339,201704,14,11,3,10307,2811,13118
431340,201704,2985,1690,1295,1579909.78,1211468.18,2791377.96
431342,201704,40,24,16,22488,14992,37480
431344,201704,16,16,0,14992,0,14992
431346,201704,5,5,0,4685,0,4685
431349,201704,34,31,3,29047,2811,31858
431350,201704,896,524,372,486483.99,347599.63,834083.62
431360,201704,40,37,3,34669,2811,37480
431365,201704,310,144,166,134909.26,155532.63,290441.89
431370,201704,1294,770,524,718811.14,490793.82,1209604.96
431380,201704,102,84,18,78052.1,16866,94918.1
431390,201704,489,272,217,253927.1,201719.01,455646.11
431395,201704,275,119,156,111503,146154,257657
431400,201704,35,27,8,25299,7496,32795
431402,201704,90,62,28,58094,26236,84330
431403,201704,14,8,6,7496,5622,13118
431405,201704,644,347,297,324042.81,278262,602304.81
431406,201704,29,25,4,23425,3748,27173
431407,201704,49,44,5,41228,4685,45913
431410,201704,3028,1776,1252,1652385.25,1172168.26,2824553.51
431413,201704,16,14,2,13118,1874,14992
431415,201704,71,50,21,46850,19677,66527
431417,201704,22,12,10,11244,9370,20614
431420,201704,284,204,80,190523.3,74950.63,265473.93
431430,201704,39,14,25,13118,23425,36543
431440,201704,8779,6256,2523,5800383.96,2357469.83,8157853.79
431442,201704,27,15,12,14055,11244,25299
431445,201704,27,21,6,19677,5622,25299
431446,201704,9,8,1,7496,937,8433
431447,201704,85,58,27,54346,25299,79645
431449,201704,48,45,3,42165,2811,44976
431450,201704,395,280,115,260626.55,107052.25,367678.80
431454,201704,0,0,0,0,0,0
431455,201704,46,35,11,32795,10307,43102
431460,201704,506,342,164,316893.4,153246.9,470140.3
431470,201704,120,93,27,86461.86,25299,111760.86
431475,201704,11,10,1,9370,937,10307
431477,201704,32,22,10,20614,9370,29984
431478,201704,6,5,1,4685,937,5622
431480,201704,486,306,180,285269.65,168341.42,453611.07
431490,201704,28073,15745,12328,14687163.68,11517474.77,26204638.45
431500,201704,75,54,21,50598,19677,70275
431505,201704,45,17,28,15929,26236,42165
431507,201704,6,6,0,5622,0,5622
431510,201704,288,181,107,168894.9,98366.26,267261.16
431513,201704,22,17,5,15929,4685,20614
431514,201704,6,5,1,4685,937,5622
431515,201704,76,66,10,61842,9370,71212
431517,201704,3,1,2,937,1874,2811
431520,201704,35,31,4,29047,3748,32795
431530,201704,1625,719,906,672393.42,848467.67,1520861.09
431531,201704,21,20,1,18740,937,19677
431532,201704,23,16,7,14992,6559,21551
431535,201704,22,14,8,13118,7496,20614
431540,201704,141,125,16,115841.31,14992,130833.31
431545,201704,18,16,2,14992,1874,16866
431550,201704,338,193,145,180841,135771.3,316612.3
431555,201704,11,10,1,9370,937,10307
431560,201704,4249,2989,1260,2773586.59,1178156.69,3951743.28
431570,201704,746,391,355,363275.1,329580.85,692855.95
431575,201704,35,25,10,23425,9370,32795
431580,201704,91,62,29,57157,27173,84330
431590,201704,124,103,21,96276.75,19667.63,115944.38
431595,201704,12,11,1,10307,937,11244
431600,201704,202,114,88,106818,82456,189274
431610,201704,127,92,35,85548.1,32795,118343.1
431620,201704,42,34,8,31858,7496,39354
431630,201704,122,106,16,99322,14992,114314
431640,201704,1315,830,485,774524.2,453755.57,1228279.77
431642,201704,44,40,4,37011.5,3748,40759.5
431643,201704,47,21,26,19677,24362,44039
431645,201704,302,173,129,162101,119936,282037
431647,201704,11,11,0,10307,0,10307
431650,201704,34,24,10,22488,9370,31858
431660,201704,264,173,91,162101,85267,247368
431670,201704,211,99,112,91123.25,104915.89,196039.14
431673,201704,4,4,0,3748,0,3748
431675,201704,30,26,4,24080.9,3748,27828.9
431680,201704,1050,745,305,694317,285523.38,979840.38
431690,201704,4692,2860,1832,2663650.29,1711451.99,4375102.28
431695,201704,24,18,6,16866,5622,22488
431697,201704,0,0,0,0,0,0
431700,201704,162,121,41,113377,38417,151794
431710,201704,3939,1686,2253,1578273.9,2109650.45,3687924.35
431720,201704,1375,806,569,747482.39,531265.63,1278748.02
431725,201704,1,1,0,937,0,937
431730,201704,1157,767,390,712777.35,365430,1078207.35
431740,201704,1354,673,681,626067.26,637546.12,1263613.38
431750,201704,1854,1198,656,1113068.82,612114.36,1725183.18
431755,201704,5,4,1,3748,937,4685
431760,201704,1084,687,397,643344.2,371764.49,1015108.69
431770,201704,386,285,101,267035.63,94618.26,361653.89
431775,201704,27,21,6,19677,5622,25299
431780,201704,558,345,213,322271.78,199571.63,521843.41
431790,201704,142,109,33,101196,30874.15,132070.15
431795,201704,12,11,1,10307,937,11244
431800,201704,3413,1776,1637,1651387.89,1525897.42,3177285.31
431805,201704,17,15,2,14055,1874,15929
431810,201704,602,407,195,379709.88,182430.06,562139.94
431820,201704,308,172,136,161164,126448.15,287612.15
431830,201704,2318,1399,919,1307588.2,859896.76,2167484.96
431840,201704,504,332,172,307525.65,159946,467471.65
431842,201704,33,27,6,25299,5622,30921
431843,201704,10,6,4,5622,3748,9370
431844,201704,14,12,2,11244,1874,13118
431845,201704,29,27,2,25299,1874,27173
431846,201704,28,24,4,22488,3748,26236
431848,201704,13,11,2,10307,1874,12181
431849,201704,8,6,2,5622,1874,7496
431850,201704,774,641,133,599390,124386.75,723776.75
431860,201704,104,74,30,69338,27173,96511
431861,201704,5,3,2,2811,1874,4685
431862,201704,48,35,13,32795,12181,44976
431870,201704,3403,1980,1423,1849123.79,1332071.12,3181194.91
431880,201704,887,657,230,610878,214573,825451
431890,201704,1297,796,501,742263.29,467765,1210028.29
431900,201704,174,124,50,116188,46850,163038
431910,201704,51,38,13,35606,12181,47787
431912,201704,35,20,15,18740,14055,32795
431915,201704,122,100,22,93700,20614,114314
431920,201704,140,106,34,99312.63,31858,131170.63
431930,201704,82,65,17,60905,15929,76834
431935,201704,4,3,1,2811,937,3748
431936,201704,12,11,1,10307,937,11244
431937,201704,15,10,5,9370,4685,14055
431940,201704,435,285,150,264561.95,140540.63,405102.58
431950,201704,459,294,165,274213.42,153040.95,427254.37
431960,201704,706,429,277,397880.42,259390.45,657270.87
431970,201704,74,66,8,61842,7496,69338
431971,201704,3,3,0,2811,0,2811
431973,201704,13,12,1,11244,937,12181
431975,201704,6,5,1,4685,937,5622
431980,201704,198,128,70,118436.8,65590,184026.8
431990,201704,1223,654,569,611351.09,532843.9,1144194.99
432000,201704,1644,874,770,812862.07,718646.86,1531508.93
432010,201704,281,186,95,173189.3,89015,262204.3
432020,201704,164,130,34,121810,31848.63,153658.63
432023,201704,22,17,5,15929,4685,20614
432026,201704,62,56,6,52472,5622,58094
432030,201704,60,31,29,29047,27173,56220
432032,201704,22,18,4,16866,3748,20614
432035,201704,43,35,8,32795,7496,40291
432040,201704,99,68,31,63716,29047,92763
432045,201704,8,7,1,6277.9,937,7214.9
432050,201704,65,39,26,36543,24362,60905
432055,201704,99,77,22,72130.26,20614,92744.26
432057,201704,0,0,0,0,0,0
432060,201704,38,34,4,31155.25,3748,34903.25
432065,201704,31,28,3,26236,2811,29047
432067,201704,96,83,13,77771,12181,89952
432070,201704,399,296,103,275761.29,96483.26,372244.55
432080,201704,803,544,259,508791,242636.89,751427.89
432085,201704,14,11,3,10307,2811,13118
432090,201704,256,168,88,157416,82456,239872
432100,201704,171,113,58,105599.9,54346,159945.9
432110,201704,593,403,190,371867.76,177093,548960.76
432120,201704,966,570,396,533434.1,371014.89,904448.99
432130,201704,484,349,135,326076,126354.45,452430.45
432132,201704,27,24,3,22488,2811,25299
432135,201704,77,63,14,59031,13118,72149
432140,201704,266,203,63,189920.53,59031,248951.53
432143,201704,180,113,67,105881,62779,168660
432145,201704,254,175,79,162757.8,74023,236780.8
432146,201704,15,14,1,13118,937,14055
432147,201704,173,61,112,57157,104925.26,162082.26
432149,201704,17,12,5,11244,4685,15929
432150,201704,826,521,305,487005.75,284061.39,771067.14
432160,201704,1372,713,659,666410.51,616603.19,1283013.70
432162,201704,4,3,1,2811,937,3748
432163,201704,18,14,4,13118,3748,16866
432166,201704,125,92,33,86439,30921,117360
432170,201704,230,124,106,114596,99322,213918
432180,201704,524,316,208,295436.1,194615,490051.1
432183,201704,8,6,2,5622,1874,7496
432185,201704,77,65,12,60811.3,11244,72055.3
432190,201704,493,249,244,232170.63,228460.45,460631.08
432195,201704,82,72,10,66761.25,9370,76131.25
432200,201704,392,250,142,234250,132980.26,367230.26
432210,201704,111,72,39,65449.45,36543,101992.45
432215,201704,64,60,4,56220,3982.25,60202.25
432218,201704,19,18,1,16866,937,17803
432220,201704,664,331,333,309145.15,311222.13,620367.28
432225,201704,15,10,5,8901.5,4685,13586.5
432230,201704,161,88,73,82221.75,68354.15,150575.90
432232,201704,14,12,2,11244,1874,13118
432234,201704,5,4,1,3748,937,4685
432235,201704,1,1,0,937,0,937
432237,201704,29,16,13,14992,12181,27173
432240,201704,4091,2262,1829,2109947.71,1708170.24,3818117.95
432250,201704,998,607,391,565902.28,365270.71,931172.99
432252,201704,39,32,7,29253.14,6559,35812.14
432253,201704,55,46,9,43102,8433,51535
432254,201704,19,7,12,6559,11244,17803
432255,201704,14,13,1,12181,937,13118
432260,201704,841,656,185,613544.83,172408.75,785953.58
432270,201704,216,156,60,146172,56220,202392
432280,201704,118,84,34,78219.9,31858,110077.9
432285,201704,2,1,1,937,937,1874
432290,201704,67,62,5,56501.1,4685,61186.1
432300,201704,4597,2608,1989,2429605.51,1859202.29,4288807.80
432310,201704,116,91,25,85267,23425,108692
432320,201704,20,14,6,13118,5622,18740
432330,201704,13,7,6,6559,5622,12181
432335,201704,8,7,1,6559,937,7496
432340,201704,43,38,5,35606,4685,40291
432345,201704,89,64,25,59968,23425,83393
432350,201704,22,21,1,19677,937,20614
432360,201704,7,5,2,4685,1874,6559
432370,201704,25,24,1,22206.9,937,23143.9
432375,201704,41,35,6,32795,5622,38417
432377,201704,7,7,0,6559,0,6559
432380,201704,150,65,85,60249.1,79645,139894.1
500020,201704,227,118,109,110566,101542.69,212108.69
500025,201704,113,55,58,51535,54346,105881
500060,201704,1355,804,551,753066.9,515692.21,1268759.11
500070,201704,714,339,375,317643,351094,668737
500080,201704,134,101,33,94637,30359,124996
500085,201704,140,113,27,105600,24479.13,130079.13
500090,201704,334,156,178,146172,166786,312958
500100,201704,678,361,317,336664.3,296467,633131.3
500110,201704,2226,965,1261,903896.63,1180615.32,2084511.95
500124,201704,312,178,134,166786,125276.9,292062.9
500150,201704,320,118,202,110557,188920,299477
500190,201704,525,357,168,333853.1,156935,490788.1
500200,201704,193,164,29,153310.89,27173,180483.89
500210,201704,1420,499,921,466194.99,861906.47,1328101.46
500215,201704,231,130,101,120849.21,94637,215486.21
500220,201704,777,511,266,478585.26,248498.63,727083.89
500230,201704,255,175,80,163272.25,74491.5,237763.75
500240,201704,705,487,218,455569.4,203797.9,659367.3
500260,201704,555,198,357,185526,334509,520035
500270,201704,28072,11763,16309,10994540.54,15263902.77,26258443.31
500280,201704,192,72,120,67464,112431,179895
500290,201704,1178,665,513,622169,480391,1102560
500295,201704,385,228,157,213636,147099.63,360735.63
500310,201704,68,21,47,19677,44039,63716
500315,201704,697,406,291,380412.63,272376.53,652789.16
500320,201704,3612,1792,1820,1677657.39,1703712.37,3381369.76
500325,201704,937,505,432,472717,403826.32,876543.32
500330,201704,1489,673,816,627979.39,763988.8,1391968.19
500345,201704,328,236,92,220186.1,86204,306390.1
500348,201704,233,134,99,125558,92744.63,218302.63
500350,201704,146,71,75,66527,70275,136802
500370,201704,5360,2367,2993,2209353.41,2801509.97,5010863.38
500375,201704,346,248,98,232366.63,91826,324192.63
500380,201704,578,330,248,309055.4,232357.63,541413.03
500390,201704,69,35,34,32795,31858,64653
500400,201704,212,143,69,133972.26,64644,198616.26
500410,201704,568,218,350,204220.58,327804.42,532025.00
500430,201704,535,368,167,344816,156479,501295
500440,201704,206,102,104,94813.42,97448,192261.42
500450,201704,420,180,240,167971.8,223875.94,391847.74
500460,201704,313,157,156,147099.63,146172,293271.63
500470,201704,433,341,92,318324.05,85258,403582.05
500480,201704,107,66,41,61842,38417,100259
500490,201704,107,40,67,37476,62779,100255
500500,201704,1410,478,932,445970.68,872392.9,1318363.58
500510,201704,50,37,13,34669,12172,46841
500515,201704,106,71,35,66527,32514,99041
500520,201704,353,201,152,187307,142420,329727
500525,201704,84,50,34,46850,31576.9,78426.9
500540,201704,887,362,525,339128.78,490928.35,830057.13
500560,201704,863,485,378,452718.66,353503.83,806222.49
500568,201704,960,556,404,515725,378262.32,893987.32
500570,201704,1206,683,523,637778.09,487506.39,1125284.48
500580,201704,339,171,168,159936.53,157403,317339.53
500600,201704,321,163,158,152032.93,148046,300078.93
500620,201704,865,609,256,564303.52,239684.6,803988.12
500625,201704,80,68,12,63021.78,11244,74265.78
500627,201704,22,10,12,9370,11244,20614
500630,201704,1560,815,745,761500.9,697779.22,1459280.12
500635,201704,515,282,233,263831.09,218152.34,481983.43
500640,201704,422,218,204,202673.5,191120.63,393794.13
500660,201704,5512,2087,3425,1953738.85,3205561.73,5159300.58
500690,201704,570,204,366,190805.76,342187.6,532993.36
500710,201704,354,170,184,159009,172117.9,331126.9
500720,201704,967,572,395,534554.32,369905.26,904459.58
500730,201704,189,104,85,97448,79359.22,176807.22
500740,201704,839,371,468,346345.14,437969,784314.14
500750,201704,135,40,95,37480,88706.16,126186.16
500755,201704,129,93,36,86860,33732,120592
500769,201704,730,404,326,378227.02,305449,683676.02
500770,201704,452,228,224,213626.63,209653.75,423280.38
500780,201704,176,118,58,110566,54346,164912
500790,201704,1036,506,530,473555.32,496288.63,969843.95
500793,201704,252,133,119,124621,111494,236115
500795,201704,181,126,55,118052.63,51526,169578.63
500797,201704,40,33,7,30921,6559,37480
500800,201704,410,176,234,164903,218976.9,383879.9
500830,201704,2119,1174,945,1096558.3,884312.96,1980871.26
500840,201704,145,108,37,101196,34660,135856
510010,201704,165,90,75,84320.63,70275,154595.63
510020,201704,485,229,256,214299.67,239322.01,453621.68
510025,201704,1640,921,719,861920.03,670855.75,1532775.78
510030,201704,598,305,293,285739.26,273790.32,559529.58
510035,201704,130,55,75,51507.63,70256.63,121764.26
510040,201704,370,156,214,146172,200078.53,346250.53
510050,201704,422,230,192,214782.47,179084.89,393867.36
510060,201704,105,50,55,46840.63,51525.63,98366.26
510080,201704,217,85,132,79612.95,123581.3,203194.25
510100,201704,75,35,40,32795,37461.26,70256.26
510120,201704,29,15,14,14055,13118,27173
510125,201704,396,244,152,227958.05,142401.26,370359.31
510130,201704,593,344,249,321898.33,232876.31,554774.64
510140,201704,377,125,252,117116,236099.32,353215.32
510160,201704,89,42,47,39354,44035,83389
510170,201704,852,524,328,490443.66,306068.85,796512.51
510180,201704,2817,1378,1439,1288155.42,1346305.54,2634460.96
510185,201704,10,4,6,3748,5622,9370
510190,201704,214,73,141,68401,132112.32,200513.32
510250,201704,2621,1507,1114,1411023.59,1042761.51,2453785.10
510260,201704,201,143,58,133800.15,54309.63,188109.78
510263,201704,449,244,205,226905.04,191342.89,418247.93
510267,201704,632,344,288,322136.78,269597.47,591734.25
510268,201704,52,28,24,26236,22488,48724
510269,201704,68,24,44,22479,41218.63,63697.63
510270,201704,404,206,198,192846.19,185097.57,377943.76
510279,201704,218,152,66,142396.63,61823.26,204219.89
510285,201704,175,72,103,67425.63,96511,163936.63
510300,201704,559,294,265,275043.85,248231.53,523275.38
510305,201704,212,95,117,88992.63,109527.04,198519.67
510310,201704,121,56,65,52472,60895.63,113367.63
510320,201704,833,513,320,480580.52,299419.26,779999.78
510325,201704,387,157,230,147059.63,214938.43,361998.06
510330,201704,408,225,183,210792,171452.26,382244.26
510335,201704,580,297,283,278242.89,264227.32,542470.21
510336,201704,50,35,15,32774.89,14055,46829.89
510337,201704,117,45,72,42155.63,67454.63,109610.26
510340,201704,17209,8295,8914,7749112.44,8341759.94,16090872.38
510343,201704,71,47,24,44029.63,22488,66517.63
510345,201704,160,103,57,96501.63,53118.63,149620.26
510350,201704,634,357,277,333303.74,259484.89,592788.63
510360,201704,207,120,87,112421.63,81427.89,193849.52
510370,201704,133,66,67,61823.26,62649.67,124472.93
510380,201704,91,63,28,59031,26227,85258
510385,201704,52,25,27,23425,25290,48715
510390,201704,130,51,79,47787,73976.15,121763.15
510395,201704,42,28,14,26236,13118,39354
510410,201704,688,449,239,420680,223919.95,644599.95
510420,201704,604,283,321,264259.77,299205.46,563465.23
510450,201704,50,32,18,29984,16866,46850
510452,201704,40,23,17,21551,15929,37480
510454,201704,73,31,42,29047,39344.63,68391.63
510455,201704,129,78,51,73067.26,47777.63,120844.89
510460,201704,178,87,91,81210.53,85229.89,166440.42
510480,201704,694,390,304,364305.31,284480.97,648786.28
510490,201704,356,179,177,167370.64,165308.13,332678.77
510500,201704,252,185,67,173335.63,62779,236114.63
510510,201704,770,441,329,412346.43,308263.63,720610.06
510515,201704,1147,585,562,547583.11,526536.89,1074120.00
510517,201704,249,108,141,100914.9,132093.95,233008.85
510520,201704,235,153,82,143278.89,76529.52,219808.41
510523,201704,94,60,34,56220,31848.63,88068.63
510525,201704,647,359,288,335639.89,269755.89,605395.78
510530,201704,15,11,4,10307,3748,14055
510550,201704,270,116,154,108231.46,144289,252520.46
510558,201704,284,135,149,126480.95,139585.26,266066.21
510560,201704,350,214,136,200518,127133,327651
510562,201704,638,437,201,407890.25,187848.5,595738.75
510590,201704,837,436,401,408494.89,375709.96,784204.85
510600,201704,252,136,116,127409.26,108650.58,236059.84
510610,201704,163,77,86,72130.26,80373.63,152503.89
510615,201704,187,71,116,66508.26,108692,175200.26
510617,201704,15,8,7,7496,6559,14055
510618,201704,119,57,62,53409,57625.5,111034.5
510619,201704,108,73,35,68392,32786,101178
510620,201704,194,107,87,100249.63,81519,181768.63
510621,201704,189,121,68,113077.53,63707,176784.53
510622,201704,432,282,150,264122.89,140232.26,404355.15
510623,201704,354,227,127,212662.26,118686.52,331348.78
510624,201704,84,39,45,36534,42165,78699
510625,201704,514,308,206,288368.78,192416.45,480785.23
510626,201704,103,61,42,57157,39354,96511
510627,201704,53,39,14,36543,13118,49661
510628,201704,168,99,69,92680.15,64559.67,157239.82
510629,201704,248,156,92,146172,85257.63,231429.63
510630,201704,461,227,234,212624.78,218926.85,431551.63
510631,201704,9,3,6,2811,5622,8433
510637,201704,338,186,152,173932.79,142278.52,316211.31
510642,201704,975,524,451,490642.79,422446.82,913089.61
510645,201704,0,0,0,0,0,0
510650,201704,1516,999,517,935900.89,484328.78,1420229.67
510665,201704,81,39,42,36489,39336,75825
510670,201704,67,37,30,34669,28110,62779
510675,201704,1177,722,455,676472,426312.32,1102784.32
510677,201704,378,176,202,163915.15,189127.04,353042.19
510680,201704,111,64,47,59950,44030,103980
510682,201704,197,87,110,81203,103070,184273
510685,201704,58,42,16,39354,14992,54346
510700,201704,615,355,260,332516.89,243459.67,575976.56
510704,201704,1012,536,476,500063.72,443500.67,943564.39
510706,201704,124,60,64,56215.32,59931.26,116146.58
510710,201704,386,258,128,241570.93,119785.56,361356.49
510715,201704,64,47,17,44029.63,15929,59958.63
510718,201704,218,111,107,103914.78,100240.63,204155.41
510719,201704,32,18,14,16866,13118,29984
510720,201704,198,127,71,118990,66245.9,185235.9
510724,201704,87,34,53,31848.63,49628.89,81477.52
510726,201704,43,25,18,23415.63,16848,40263.63
510729,201704,80,38,42,35606,39307.15,74913.15
510730,201704,463,257,206,240800,192874.63,433674.63
510735,201704,104,43,61,40291,57157,97448
510740,201704,29,15,14,14055,13118,27173
510757,201704,18,14,4,13118,3748,16866
510760,201704,6925,3621,3304,3382743.52,3090283.61,6473027.13
510770,201704,741,353,388,330585.15,363365.15,693950.30
510774,201704,14,7,7,6559,6559,13118
510775,201704,109,80,29,74950.63,27173,102123.63
510776,201704,25,6,19,5622,17803,23425
510777,201704,189,83,106,77742.89,99293.89,177036.78
510779,201704,53,24,29,22479,27127.26,49606.26
510780,201704,297,161,136,150785.26,127341.63,278126.89
510785,201704,448,242,206,226688.78,192928.3,419617.08
510787,201704,176,90,86,84316.32,80564.32,164880.64
510788,201704,0,0,0,0,0,0
510790,201704,2351,1221,1130,1141904.59,1056303.27,2198207.86
510792,201704,1020,576,444,539233.52,415622.01,954855.53
510794,201704,106,52,54,48724,50570.26,99294.26
510795,201704,2326,1337,989,1246759.79,923836.9,2170596.69
510800,201704,166,105,61,98385,57148,155533
510805,201704,161,113,48,105881,44976,150857
510810,201704,94,36,58,33649.89,54233.93,87883.82
510820,201704,274,129,145,120622.26,134882.71,255504.97
510830,201704,69,41,28,38417,26227,64644
510835,201704,1,0,1,0,937,937
510840,201704,9039,4533,4506,4234326.63,4214318.34,8448644.97
510850,201704,204,85,119,79635.63,111184.79,190820.42
510860,201704,394,173,221,161916.56,206342.05,368258.61
510880,201704,62,47,15,44020.63,14055,58075.63
510885,201704,67,41,26,38398.63,24324.89,62723.52
510890,201704,74,41,33,38417,30921,69338
510895,201704,179,102,77,95574,71845.63,167419.63
520005,201704,21,15,6,14055,5613,19668
520010,201704,291,127,164,118979,153575,272554
520013,201704,622,363,259,340094.63,242401.9,582496.53
520015,201704,49,35,14,32795,13118,45913
520017,201704,104,59,45,55002,42165,97167
520020,201704,30,15,15,14055,14055,28110
520025,201704,1939,1039,900,973543,842456.7,1815999.7
520030,201704,805,399,406,373854,379476,753330
520050,201704,78,51,27,47787,25299,73086
520055,201704,44,30,14,28110,13118,41228
520060,201704,174,112,62,104944,58094,163038
520080,201704,584,399,185,373863,173340.32,547203.32
520082,201704,20,14,6,13118,5622,18740
520085,201704,100,73,27,68401,25299,93700
520090,201704,78,53,25,49661,23425,73086
520110,201704,8968,3816,5152,3568696.71,4822312.24,8391008.95
520120,201704,13,8,5,7308.6,4685,11993.6
520130,201704,731,521,210,488168,196480,684648
520140,201704,11628,6546,5082,6126621.8,4758779.53,10885401.33
520145,201704,44,33,11,30921,10307,41228
520150,201704,183,143,40,133991,37480,171471
520160,201704,34,22,12,20614,11244,31858
520170,201704,231,140,91,131149,85231,216380
520180,201704,103,50,53,46850,49661,96511
520215,201704,215,128,87,119654.9,81237.9,200892.8
520235,201704,69,52,17,48724,15929,64653
520250,201704,137,83,54,77771,50316.9,128087.9
520260,201704,111,73,38,68401,34669,103070
520280,201704,49,34,15,31203,14055,45258
520310,201704,37,22,15,20614,14055,34669
520320,201704,169,104,65,97448,60905,158353
520330,201704,768,403,365,377574.63,341969,719543.63
520340,201704,362,201,161,188337,150820.63,339157.63
520350,201704,521,229,292,214573,273558,488131
520355,201704,92,51,41,47787,38417,86204
520357,201704,23,15,8,14055,7496,21551
520360,201704,0,0,0,0,0,0
520380,201704,145,75,70,70275,65570,135845
520390,201704,294,125,169,116376,158343.63,274719.63
520393,201704,12,9,3,8433,2811,11244
520396,201704,99,61,38,57157,35606,92763
520400,201704,229,134,95,123966.1,89015,212981.1
520410,201704,193,100,93,93691,87132,180823
520420,201704,24,16,8,14992,7496,22488
520425,201704,303,135,168,125559,156948.6,282507.6
520430,201704,443,230,213,215228.9,199244.9,414473.8
520440,201704,587,386,201,361682,188337,550019
520450,201704,1867,858,1009,802850.63,944778.95,1747629.58
520455,201704,59,39,20,36543,18740,55283
520460,201704,30,16,14,14992,13118,28110
520465,201704,22,19,3,17803,2811,20614
520470,201704,425,261,164,244357,153668,398025
520480,201704,83,45,38,42156,35561,77717
520485,201704,128,42,86,39354,80301,119655
520490,201704,375,282,93,264053.26,86979.84,351033.10
520495,201704,188,108,80,101196,74960,176156
520500,201704,186,141,45,132117,42165,174282
520505,201704,165,85,80,79645,74960,154605
520510,201704,1728,837,891,779957.3,832003.01,1611960.31
520520,201704,45,32,13,29984,12181,42165
520530,201704,238,172,66,158814.89,61056.79,219871.68
520540,201704,490,315,175,293871.81,163975,457846.81
520545,201704,157,85,72,79645,67464,147109
520547,201704,47,26,21,24362,19677,44039
520549,201704,977,456,521,426954,487649,914603
520551,201704,294,157,137,147109,128369,275478
520552,201704,43,23,20,21551,18740,40291
520570,201704,19,11,8,10307,7496,17803
520580,201704,283,173,110,162092,103070,265162
520590,201704,158,90,68,84330,63434.9,147764.9
520620,201704,1115,520,595,486491.14,556662.53,1043153.67
520630,201704,36,20,16,18740,14992,33732
520640,201704,412,236,176,221132,164912,386044
520650,201704,51,37,14,34669,13118,47787
520660,201704,34,18,16,16866,14992,31858
520670,201704,32,26,6,24362,5622,29984
520680,201704,65,42,23,39354,21551,60905
520690,201704,31,13,18,12181,16866,29047
520710,201704,38,35,3,32795,2811,35606
520725,201704,202,126,76,118062,71203,189265
520735,201704,55,44,11,41228,10307,51535
520740,201704,398,196,202,182950.2,189265,372215.2
520750,201704,38,28,10,26236,9370,35606
520753,201704,57,41,16,38417,14992,53409
520760,201704,110,73,37,68401,34669,103070
520780,201704,269,208,61,194896,57157,252053
520790,201704,170,78,92,72804.9,86204,159008.9
520800,201704,3560,1854,1706,1733109.68,1597852.77,3330962.45
520810,201704,165,112,53,104944,49661,154605
520815,201704,6,5,1,4685,937,5622
520830,201704,140,91,49,85267,45913,131180
520840,201704,320,209,111,195317.65,104007,299324.65
520850,201704,108,68,40,63707,37330.08,101037.08
520860,201704,1644,1021,623,955562.87,582065.6,1537628.47
520870,201704,30006,14815,15191,13855107.1,14219961.49,28075068.59
520880,201704,968,544,424,509447,397269.26,906716.26
520890,201704,790,451,339,420994.2,317259.63,738253.83
520910,201704,1024,527,497,490287.31,465689,955976.31
520915,201704,97,73,24,68401,22478.63,90879.63
520920,201704,409,199,210,185900.8,196770,382670.8
520929,201704,23,21,2,19677,1874,21551
520940,201704,78,47,31,44039,29047,73086
520945,201704,23,14,9,13118,8433,21551
520960,201704,50,30,20,28110,18740,46850
520970,201704,324,198,126,184908,117780.9,302688.9
520980,201704,99,73,26,68401,24362,92763
520990,201704,462,309,153,289308.12,143361,432669.12
520993,201704,124,59,65,55283,60896,116179
520995,201704,245,136,109,126496,101571,228067
521000,201704,1541,874,667,817252.3,624605,1441857.3
521010,201704,666,297,369,278049.23,345697.15,623746.38
521015,201704,16,9,7,8433,6559,14992
521020,201704,1483,1017,466,952310.95,436286.78,1388597.73
521030,201704,38,27,11,25299,10307,35606
521040,201704,904,545,359,510432,336102,846534
521056,201704,41,28,13,26236,12181,38417
521060,201704,133,82,51,76834,47787,124621
521080,201704,497,366,131,342933,122747,465680
521090,201704,525,303,222,283911,207742.27,491653.27
521100,201704,287,209,78,195833,73086,268919
521120,201704,1020,691,329,646905,307992,954897
521130,201704,361,255,106,238935,98732.8,337667.8
521140,201704,191,107,84,100259,78708,178967
521150,201704,2793,1172,1621,1095963.14,1517626.85,2613589.99
521160,201704,31,17,14,15929,13118,29047
521170,201704,193,112,81,104934.63,75897,180831.63
521180,201704,1082,669,413,625626.43,386278.25,1011904.68
521190,201704,2536,1059,1477,992283,1382601.16,2374884.16
521200,201704,45,33,12,30921,11244,42165
521205,201704,16,11,5,10307,4685,14992
521210,201704,156,85,71,79645,66527,146172
521220,201704,802,536,266,499646.78,249187,748833.78
521225,201704,25,15,10,14055,9370,23425
521230,201704,114,72,42,67464,39354,106818
521250,201704,6461,3622,2839,3386752.4,2656993.83,6043746.23
521260,201704,16,12,4,11244,3748,14992
521270,201704,151,115,36,107755,33732,141487
521280,201704,432,247,185,230783.1,173345,404128.1
521290,201704,34,14,20,13118,18740,31858
521295,201704,102,68,34,63409.81,31858,95267.81
521300,201704,222,112,110,104876,102706.89,207582.89
521305,201704,36,24,12,22488,11244,33732
521308,201704,1076,769,307,720052.78,287359.63,1007412.41
521310,201704,1327,775,552,725091.1,516344.26,1241435.36
521340,201704,22,17,5,15929,4685,20614
521350,201704,132,96,36,89952,33732,123684
521370,201704,199,123,76,114314,70930.9,185244.9
521375,201704,194,104,90,97448,84048.9,181496.9
521377,201704,51,34,17,31858,15929,47787
521380,201704,1056,689,367,641801.26,343879,985680.26
521385,201704,20,11,9,10307,8433,18740
521390,201704,108,86,22,80269.7,20614,100883.7
521400,201704,333,203,130,189929.9,121763.15,311693.05
521405,201704,151,75,76,70275,71212,141487
521410,201704,71,48,23,44976,21551,66527
521440,201704,220,154,66,143501.55,61842,205343.55
521450,201704,716,381,335,356997,313239.1,670236.1
521460,201704,1168,695,473,650934,443182.26,1094116.26
521470,201704,17,12,5,11244,4685,15929
521480,201704,57,35,22,32795,20550,53345
521483,201704,292,153,139,143080,130243,273323
521486,201704,299,183,116,171349.19,108037,279386.19
521487,201704,25,12,13,11244,12181,23425
521490,201704,29,17,12,15929,11244,27173
521500,201704,111,72,39,67464,36543,104007
521520,201704,43,32,11,29984,10307,40291
521523,201704,541,330,211,307663.95,197707,505370.95
521525,201704,48,31,17,29047,15929,44976
521530,201704,248,127,121,118999,113377,232376
521540,201704,30,16,14,14992,13118,28110
521550,201704,92,39,53,36243.63,49624.63,85868.26
521560,201704,767,523,244,489591.97,228347,717938.97
521565,201704,46,32,14,29984,13118,43102
521570,201704,480,318,162,297956.63,151701.15,449657.78
521580,201704,63,39,24,36543,22488,59031
521590,201704,36,18,18,16866,16866,33732
521600,201704,30,18,12,16866,11244,28110
521630,201704,230,115,115,107745.63,106781.88,214527.51
521640,201704,296,150,146,140550,136802,277352
521645,201704,30,16,14,14992,13118,28110
521680,201704,227,140,87,131180,81519,212699
521690,201704,1,1,0,937,0,937
521710,201704,1189,555,634,519472.9,593768,1113240.9
521720,201704,520,340,180,318580,168613.26,487193.26
521730,201704,634,314,320,294218,299559,593777
521740,201704,909,349,560,326994.63,523549.96,850544.59
521760,201704,1542,827,715,773349.52,669647,1442996.52
521770,201704,786,494,292,462878,273144.87,736022.87
521800,201704,2061,1239,822,1158399.2,768954.06,1927353.26
521805,201704,34,19,15,17799,14055,31854
521810,201704,96,57,39,52284.9,36543,88827.9
521830,201704,944,654,290,611206.08,271721,882927.08
521839,201704,90,63,27,59031,25299,84330
521850,201704,1089,587,502,547867.76,470035.04,1017902.80
521860,201704,350,214,136,200518,127151,327669
521870,201704,66,36,30,33732,28110,61842
521878,201704,52,22,30,20614,28110,48724
521880,201704,4250,1908,2342,1785546.48,2191637.5,3977183.98
521890,201704,553,378,175,354186,163684.9,517870.9
521900,201704,298,241,57,224911.2,53409,278320.2
521910,201704,150,106,44,99322,41228,140550
521920,201704,56,27,29,25299,27173,52472
521925,201704,36,21,15,19677,14055,33732
521930,201704,1081,610,471,571376.56,440566.46,1011943.02
521935,201704,31,23,8,21551,7496,29047
521940,201704,199,102,97,95574,90607.9,186181.9
521945,201704,16,14,2,13118,1874,14992
521950,201704,7,5,2,4685,1874,6559
521960,201704,73,49,24,45913,22488,68401
521970,201704,408,255,153,238653.9,143361,382014.9
521971,201704,94,47,47,44039,44039,88078
521973,201704,32,14,18,13118,16866,29984
521975,201704,1013,544,469,508546.6,438460.73,947007.33
521980,201704,240,163,77,152572,72149,224721
521990,201704,74,56,18,52472,16866,69338
522000,201704,291,182,109,170534,102133,272667
522005,201704,23,14,9,13118,8433,21551
522010,201704,1105,613,492,572498.1,460432.43,1032930.53
522015,201704,59,36,23,33723,21551,55274
522020,201704,835,419,416,392603,388836.26,781439.26
522026,201704,28,20,8,18740,7496,26236
522028,201704,15,11,4,10307,3748,14055
522040,201704,715,277,438,259259,410351.63,669610.63
522045,201704,1964,1234,730,1155734.53,683204.8,1838939.33
522050,201704,180,88,92,82456,86204,168660
522060,201704,543,343,200,321109.9,187306.3,508416.2
522068,201704,137,88,49,82456,45913,128369
522070,201704,12,12,0,11244,0,11244
522100,201704,42,21,21,19415,19677,39092
522108,201704,40,30,10,28110,9370,37480
522119,201704,61,29,32,27173,29984,57157
522130,201704,74,24,50,22488,46814,69302
522140,201704,3667,1883,1784,1760729.8,1669763.42,3430493.22
522145,201704,56,33,23,30921,21551,52472
522150,201704,62,49,13,45913,12181,58094
522155,201704,57,40,17,37471,15929,53400
522157,201704,6,4,2,3748,1874,5622
522160,201704,1737,1001,736,936812.6,689341.9,1626154.5
522170,201704,396,263,133,246431,124621,371052
522180,201704,38,20,18,18740,16866,35606
522185,201704,1205,483,722,449950.17,676392.88,1126343.05
522190,201704,47,26,21,24362,19583.3,43945.3
522200,201704,297,179,118,167723,110566,278289
522205,201704,163,111,52,104007,48724,152731
522220,201704,177,123,54,115251,50598,165849
522230,201704,32,25,7,23425,6559,29984
530010,201704,53816,27576,26240,25705663.16,24532682.66,50238345.82
110001,201705,502,393,109,366471.99,101298.64,467770.63
110002,201705,2644,1544,1100,1437541.87,1023904.61,2461446.48
110003,201705,89,71,18,66106.45,16745.89,82852.34
110004,201705,1927,1218,709,1132699.73,660018.93,1792718.66
110005,201705,428,348,80,323290.16,74328.43,397618.59
110006,201705,435,336,99,311845.62,92021.79,403867.41
110007,201705,79,64,15,59767.45,13974.89,73742.34
110008,201705,232,134,98,124140.34,91444.9,215585.24
110009,201705,753,501,252,466553.94,234655.15,701209.09
110010,201705,1780,1090,690,1014485.61,643319.45,1657805.06
110011,201705,1862,1423,439,1323740.09,408806.81,1732546.90
110012,201705,4000,2289,1711,2132615.92,1596861.52,3729477.44
110013,201705,723,530,193,492930.29,179537.7,672467.99
110014,201705,362,306,56,285681.23,52247.21,337928.44
110015,201705,1439,1152,287,1071413.04,266896.29,1338309.33
110018,201705,1108,654,454,609146.2,423400.7,1032546.9
110020,201705,14841,8705,6136,8054274.42,5696938.48,13751212.90
110025,201705,599,433,166,402161.07,154789.81,556950.88
110026,201705,43,30,13,27848.9,12060.56,39909.46
110028,201705,1592,1142,450,1059008.52,417055.66,1476064.18
110029,201705,133,115,18,107514.67,16846,124360.67
110030,201705,2436,1633,803,1515618.27,746190.77,2261809.04
110032,201705,378,289,89,269164.71,83148.12,352312.83
110033,201705,636,485,151,447440,140179.91,587619.91
110034,201705,358,262,96,241598.27,89350.79,330949.06
110037,201705,99,79,20,73942.78,18719.89,92662.67
110040,201705,319,211,108,196282.82,100434.46,296717.28
110045,201705,889,574,315,533367.89,292272.5,825640.39
110050,201705,95,75,20,69934.67,18679.89,88614.56
110060,201705,87,43,44,40090.89,40787.45,80878.34
110070,201705,128,75,53,69873.35,49058.57,118931.92
110080,201705,392,222,170,204223.54,157971.19,362194.73
110090,201705,29,24,5,22387.56,4644.78,27032.34
110092,201705,102,59,43,55022.01,39939.57,94961.58
110094,201705,197,135,62,125673.57,57572.79,183246.36
110100,201705,26,22,4,20493.78,3727.89,24221.67
110110,201705,68,41,27,38196.56,24797.56,62994.12
110120,201705,72,55,17,51274.56,15828.67,67103.23
110130,201705,296,244,52,225878.6,48423.34,274301.94
110140,201705,245,161,84,149986.96,78257.09,228244.05
110143,201705,43,37,6,34488.45,5561.67,40050.12
110145,201705,28,20,8,18659.89,7476,26135.89
110146,201705,22,12,10,11203.89,9329.89,20533.78
110147,201705,39,30,9,27487.89,8413,35900.89
110148,201705,36,25,11,23232.91,10287,33519.91
110149,201705,283,197,86,183423.94,80099.91,263523.85
110150,201705,81,51,30,47666.89,27829.34,75496.23
110155,201705,9,7,2,6519,1854,8373
110160,201705,71,59,12,54901.24,11163.67,66064.91
110170,201705,213,175,38,162994.67,35365.67,198360.34
110175,201705,27,21,6,19496.12,5601.89,25098.01
110180,201705,92,81,11,75816.78,10266.89,86083.67
120001,201705,128,86,42,79838,39346,119184
120005,201705,186,117,69,109586.12,64466,174052.12
120010,201705,968,637,331,590427.15,307721.4,898148.55
120013,201705,127,86,41,79951.01,37451.74,117402.75
120017,201705,72,48,24,44889.36,22467,67356.36
120020,201705,3418,2713,705,2515112.04,656059.38,3171171.42
120025,201705,617,343,274,319142.12,254821.46,573963.58
120030,201705,1019,847,172,786261.25,160419.12,946680.37
120032,201705,46,38,8,35584.12,7496,43080.12
120033,201705,213,187,26,174877.94,24362,199239.94
120034,201705,148,106,42,97426.12,39310.24,136736.36
120035,201705,25,17,8,15929,7496,23425
120038,201705,380,240,140,224069.2,131136.24,355205.44
120039,201705,19,18,1,16866,937,17803
120040,201705,13673,9461,4212,8738206.42,3905082.56,12643288.98
120042,201705,40,34,6,31858,5622,37480
120043,201705,14,3,11,2811,10286.89,13097.89
120045,201705,523,332,191,309782.18,178702.48,488484.66
120050,201705,1218,928,290,864850.62,270421.46,1135272.08
120060,201705,1353,1086,267,1001304.29,246204.34,1247508.63
120070,201705,502,360,142,331217.82,131626.07,462843.89
120080,201705,130,83,47,76616.61,43476.55,120093.16
130002,201705,150,104,46,97448,43102,140550
130006,201705,75,42,33,39354,30921,70275
130008,201705,140,74,66,68617.72,61119.96,129737.68
130010,201705,141,74,67,69338,62779,132117
130014,201705,226,166,60,155542,56220,211762
130020,201705,84,48,36,44976,33732,78708
130030,201705,859,533,326,499421,305452.63,804873.63
130040,201705,322,164,158,153668,147109,300777
130050,201705,548,309,239,289251.9,223943,513194.9
130060,201705,864,590,274,547637.66,253857.58,801495.24
130063,201705,543,287,256,268919,239850.12,508769.12
130068,201705,190,121,69,113377,64371.9,177748.9
130070,201705,1332,925,407,840820.23,371821.38,1212641.61
130080,201705,668,437,231,409094.2,216438,625532.2
130083,201705,68,36,32,33732,29984,63716
130090,201705,382,190,192,176380.88,179904,356284.88
130100,201705,1113,521,592,488177,554422.9,1042599.9
130110,201705,714,310,404,290320,378528,668848
130115,201705,173,72,101,67464,94637,162101
130120,201705,1610,1011,599,947307,561263,1508570
130130,201705,624,421,203,394477,190211,584688
130140,201705,1562,1175,387,1100344.95,361682.1,1462027.05
130150,201705,420,352,68,329824,63716,393540
130160,201705,470,255,215,238935,201455,440390
130165,201705,27,19,8,17803,7496,25299
130170,201705,956,671,285,623011.7,264009.6,887021.3
130180,201705,162,97,65,90420.5,60905,151325.5
130185,201705,2050,1104,946,1032553.89,885819.89,1918373.78
130190,201705,3567,2272,1295,2125116.4,1211635.09,3336751.49
130195,201705,293,235,58,220195,54346,274541
130200,201705,181,81,100,75887.63,93700,169587.63
130210,201705,74,36,38,33732,35606,69338
130220,201705,188,132,56,123684,52472,176156
130230,201705,335,211,124,197707,116188,313895
130240,201705,1471,919,552,859746.98,516938.22,1376685.20
130250,201705,4644,2974,1670,2782119.6,1564635.05,4346754.65
130255,201705,416,211,205,197707,191803.9,389510.9
130260,201705,51503,24463,27040,22889326.97,25328132.26,48217459.23
130270,201705,1450,933,517,873732.5,484388.89,1358121.39
130280,201705,103,63,40,59031,37480,96511
130290,201705,2071,1514,557,1418213.22,521627.9,1939841.12
130300,201705,424,304,120,284566.9,112440,397006.9
130310,201705,912,493,419,461941,392603,854544
130320,201705,442,235,207,219258,193959,413217
130330,201705,713,438,275,410406,257393.9,667799.9
130340,201705,3180,1957,1223,1830429.6,1144826.7,2975256.3
130350,201705,493,306,187,286599.57,175219,461818.57
130353,201705,743,301,442,281756,414154,695910
130356,201705,719,327,392,306379,367022.9,673401.9
130360,201705,71,42,29,39354,27173,66527
130370,201705,701,504,197,472248,184589,656837
130380,201705,657,441,216,413217,202392,615609
130390,201705,501,395,106,370115,99322,469437
130395,201705,172,42,130,39354,121810,161164
130400,201705,65,45,20,42165,18740,60905
130406,201705,2026,1307,719,1221114.15,673075.16,1894189.31
130410,201705,524,222,302,208014,282955.26,490969.26
130420,201705,3216,2550,666,2386539.35,624042,3010581.35
130423,201705,166,76,90,71212,84330,155542
130426,201705,140,81,59,75897,55283,131180
130430,201705,404,268,136,251116,127432,378548
130440,201705,200,73,127,68368,118999,187367
140002,201705,36,15,21,14055,19677,33732
140005,201705,192,117,75,109394.75,70275,179669.75
140010,201705,10252,6877,3375,6412672.83,3158247.82,9570920.65
140015,201705,151,68,83,63716,77771,141487
140017,201705,101,69,32,64653,29984,94637
140020,201705,486,329,157,307336,147109,454445
140023,201705,20,16,4,14496,3748,18244
140028,201705,14,9,5,8433,4685,13118
140030,201705,353,246,107,230502,99668.69,330170.69
140040,201705,51,36,15,33732,13961.3,47693.3
140045,201705,248,116,132,108036.1,123684,231720.1
140047,201705,523,347,176,322467.52,164162.5,486630.02
140050,201705,155,98,57,91028,53409,144437
140060,201705,32,24,8,21766.51,7496,29262.51
140070,201705,30,28,2,26236,1874,28110
150010,201705,4653,2864,1789,2680897.75,1673910.66,4354808.41
150013,201705,136,92,44,86204,41228,127432
150020,201705,1096,559,537,523783,503169,1026952
150030,201705,755,303,452,283911,423524,707435
150034,201705,184,109,75,102133,70275,172408
150040,201705,1341,803,538,752391,504106,1256497
150050,201705,685,405,280,378501.9,262160,640661.9
150060,201705,4639,2998,1641,2805435.88,1537092.28,4342528.16
150070,201705,304,131,173,122747,162101,284848
150080,201705,14338,7160,7178,6698881.42,6718502.66,13417384.08
150085,201705,344,210,134,196760.63,125558,322318.63
150090,201705,747,635,112,594995,104944,699939
150095,201705,342,208,134,194139.84,124752.18,318892.02
150100,201705,53,37,16,34669,14992,49661
150110,201705,171,83,88,77771,82456,160227
150120,201705,430,317,113,297029,105881,402910
150125,201705,49,20,29,18740,27173,45913
150130,201705,1855,972,883,910764,827366.32,1738130.32
150140,201705,54431,25350,29081,23721114.33,27234896.87,50956011.20
150145,201705,171,98,73,91826,68401,160227
150150,201705,2709,1139,1570,1067029.37,1467215.7,2534245.07
150157,201705,452,302,150,282974,140545.32,423519.32
150160,201705,108,84,24,78708,22488,101196
150170,201705,3664,2700,964,2526995.4,902049.9,3429045.3
150172,201705,290,198,92,185526,86204,271730
150175,201705,88,55,33,51535,30921,82456
150178,201705,745,497,248,464752,232376,697128
150180,201705,2906,1367,1539,1280082.8,1441743.86,2721826.66
150190,201705,333,209,124,195833,116188,312021
150195,201705,121,61,60,57157,56220,113377
150200,201705,210,93,117,87141,109629,196770
150210,201705,3108,2517,591,2357389.84,553528.75,2910918.59
150215,201705,483,326,157,305181,147109,452290
150220,201705,4027,2683,1344,2512509.35,1257454.36,3769963.71
150230,201705,1147,910,237,852100.7,222069,1074169.7
150240,201705,5577,3240,2337,3032311.47,2189756,5222067.47
150250,201705,31,14,17,13118,15929,29047
150260,201705,70,41,29,38417,27173,65590
150270,201705,2284,1490,794,1395568,743415.9,2138983.9
150275,201705,593,355,238,332635,223006,555641
150276,201705,101,40,61,37480,57157,94637
150277,201705,759,322,437,301695.63,409469,711164.63
150280,201705,337,202,135,189274,126495,315769
150285,201705,72,35,37,32795,34669,67464
150290,201705,955,576,379,539421.53,354842,894263.53
150293,201705,692,314,378,293796.63,354186,647982.63
150295,201705,452,192,260,179904,243488.82,423392.82
150300,201705,79,43,36,40291,33732,74023
150304,201705,137,88,49,82456,45913,128369
150307,201705,389,317,72,297029,67464,364493
150309,201705,514,366,148,342942,138676,481618
150310,201705,254,171,83,160227,77771,237998
150320,201705,1798,1236,562,1157855.59,526594,1684449.59
150330,201705,2060,1168,892,1093760.1,835804,1929564.1
150340,201705,192,125,67,116890.75,62779,179669.75
150345,201705,611,323,288,302472.97,269856,572328.97
150350,201705,429,335,94,311543.13,88078,399621.13
150360,201705,4358,2798,1560,2619040.74,1461710.63,4080751.37
150370,201705,717,507,210,474277,196479.9,670756.9
150375,201705,192,105,87,98385,81519,179904
150380,201705,1186,764,422,715868,394384,1110252
150390,201705,720,410,310,384170,290461,674631
150400,201705,94,76,18,71212,16866,88078
150405,201705,1251,825,426,772000.86,398599.8,1170600.66
150410,201705,145,92,53,86204,49661,135865
150420,201705,7058,3860,3198,3615170.44,2995325.12,6610495.56
150430,201705,470,316,154,296092,144298,440390
150440,201705,595,348,247,325327,231158,556485
150442,201705,2060,1132,928,1058913.07,869536,1928449.07
150445,201705,507,315,192,295155,178967,474122
150450,201705,275,127,148,118999,138676,257675
150460,201705,783,593,190,553565.66,178011.26,731576.92
150470,201705,1329,788,541,738075,506917,1244992
150475,201705,26,20,6,18740,5622,24362
150480,201705,1225,851,374,797387,350438,1147825
150490,201705,613,318,295,297966,276415,574381
150495,201705,319,215,104,201455,97448,298903
150497,201705,301,207,94,193959,88068.63,282027.63
150500,201705,433,292,141,273604,132117,405721
150503,201705,763,368,395,344535,370097,714632
150506,201705,1040,658,382,616546,357924.63,974470.63
150510,201705,1211,689,522,645312,489114,1134426
150520,201705,262,173,89,162101,83393,245494
150530,201705,1503,826,677,770417.26,634068,1404485.26
150540,201705,241,167,74,156479,69338,225817
150543,201705,654,364,290,340768.16,271448.9,612217.06
150548,201705,490,326,164,305462,153668,459130
150549,201705,57,38,19,35606,17803,53409
150550,201705,2876,1486,1390,1391680,1301868,2693548
150553,201705,2961,1761,1200,1649494.9,1124119,2773613.9
150555,201705,142,72,70,67464,65590,133054
150560,201705,52,39,13,36543,12181,48724
150563,201705,63,32,31,29984,29047,59031
150565,201705,161,92,69,86204,64653,150857
150570,201705,397,263,134,246412.26,125558,371970.26
150580,201705,1478,584,894,546552.1,837678,1384230.1
150590,201705,810,474,336,444138,314832,758970
150600,201705,440,269,171,252053,160227,412280
150610,201705,138,119,19,110670,17803,128473
150611,201705,131,89,42,83393,39354,122747
150613,201705,3111,1899,1212,1779359,1135626,2914985
150616,201705,473,293,180,274306.75,168660,442966.75
150618,201705,1115,605,510,566660.49,477870,1044530.49
150619,201705,405,306,99,286722,92763,379485
150620,201705,1268,722,546,676514,511321,1187835
150630,201705,313,209,104,195833,97448,293281
150635,201705,498,201,297,188337,278194.21,466531.21
150640,201705,62,30,32,28110,29984,58094
150650,201705,2281,1299,982,1216891.27,918915.9,2135807.17
150655,201705,255,189,66,177093,61842,238935
150658,201705,97,54,43,50598,40291,90889
150660,201705,477,329,148,308273,138676,446949
150670,201705,982,339,643,317352.9,602472.63,919825.53
150680,201705,9552,5250,4302,4915288.86,4028093.57,8943382.43
150690,201705,51,32,19,29984,17803,47787
150700,201705,562,362,200,339006.6,187400,526406.6
150710,201705,250,154,96,144298,89952,234250
150715,201705,869,517,352,483464.26,329795.89,813260.15
150720,201705,451,337,114,315769,106536.9,422305.9
150730,201705,855,452,403,423515,377329.9,800844.9
150740,201705,244,171,73,160227,68401,228628
150745,201705,777,390,387,365430,362619,728049
150746,201705,55,33,22,30921,20614,51535
150747,201705,274,213,61,199581,57157,256738
150750,201705,125,73,52,68401,48724,117125
150760,201705,1706,1093,613,1023859.9,574381,1598240.9
150770,201705,354,180,174,168660,162866.07,331526.07
150775,201705,82,39,43,36543,40291,76834
150780,201705,178,92,86,86204,80582,166786
150790,201705,904,478,426,447886,399162,847048
150795,201705,1402,802,600,751474,562200,1313674
150796,201705,409,233,176,218321,164912,383233
150797,201705,267,156,111,146172,104007,250179
150800,201705,1402,841,561,787075.31,525375.9,1312451.21
150803,201705,589,485,104,454445,97448,551893
150805,201705,186,117,69,109629,64639.63,174268.63
150808,201705,939,509,430,476933,402910,879843
150810,201705,3365,2296,1069,2146331.63,1001353.26,3147684.89
150812,201705,422,222,200,208014,187400,395414
150815,201705,913,601,312,561783.04,292344,854127.04
150820,201705,1594,972,622,909827,582795.26,1492622.26
150830,201705,842,591,251,552830,235187,788017
150835,201705,170,98,72,91826,67464,159290
150840,201705,1261,807,454,756159,425398,1181557
160005,201705,48,29,19,27173,17803,44976
160010,201705,196,124,72,116188,67460,183648
160015,201705,114,65,49,60905,45913,106818
160020,201705,115,66,49,61842,45913,107755
160021,201705,40,21,19,19677,17803,37480
160023,201705,105,58,47,54346,44039,98385
160025,201705,33,14,19,13118,17803,30921
160027,201705,1413,791,622,737701.1,582077,1319778.1
160030,201705,15075,7676,7399,7183993,6926973.68,14110966.68
160040,201705,315,176,139,164912,130243,295155
160050,201705,617,317,300,297029,280818.9,577847.9
160053,201705,341,187,154,174938,144298,319236
160055,201705,18,13,5,12181,4685,16866
160060,201705,6270,3250,3020,3032506.59,2828799.1,5861305.69
160070,201705,158,94,64,88078,59968,148046
160080,201705,77,39,38,36543,35606,72149
170025,201705,25,17,8,15929,7496,23425
170030,201705,225,178,47,166592,44039,210631
170035,201705,234,108,126,100259,118062,218321
170040,201705,184,144,40,134646.9,37480,172126.9
170070,201705,338,191,147,178967,137739,316706
170100,201705,379,266,113,249008,105881,354889
170105,201705,63,51,12,47787,11244,59031
170110,201705,101,61,40,57157,37480,94637
170130,201705,70,31,39,29047,36262,65309
170190,201705,110,68,42,63716,39354,103070
170200,201705,401,267,134,249233.1,125455.78,374688.88
170210,201705,5910,3024,2886,2828753.21,2700978.33,5529731.54
170215,201705,67,32,35,29984,32795,62779
170220,201705,1443,1049,394,980832.86,368709.6,1349542.46
170230,201705,155,99,56,92763,52472,145235
170240,201705,581,379,202,355123,189274,544397
170255,201705,1113,884,229,828308,214291.9,1042599.9
170270,201705,38,27,11,25299,10025.9,35324.9
170290,201705,66,47,19,44039,17803,61842
170300,201705,78,49,29,45163.4,27173,72336.4
170305,201705,36,29,7,27173,6559,33732
170307,201705,58,41,17,38417,15929,54346
170310,201705,95,50,45,46850,42165,89015
170320,201705,17,13,4,12181,3748,15929
170330,201705,18,15,3,14055,2811,16866
170360,201705,22,14,8,13118,7496,20614
170370,201705,170,80,90,74960,84330,159290
170380,201705,81,55,26,51535,24362,75897
170382,201705,49,43,6,40291,5622,45913
170384,201705,123,86,37,80582,34669,115251
170386,201705,58,27,31,25299,29047,54346
170388,201705,46,16,30,14992,28110,43102
170389,201705,23,17,6,15929,5622,21551
170390,201705,50,30,20,28110,18740,46850
170410,201705,34,23,11,21551,10307,31858
170460,201705,17,12,5,11244,4685,15929
170510,201705,28,20,8,18740,7496,26236
170550,201705,1449,809,640,758012.89,598930.5,1356943.39
170555,201705,111,74,37,69338,34590,103928
170560,201705,100,71,29,66527,27173,93700
170600,201705,36,18,18,16866,16866,33732
170610,201705,194,103,91,96356.4,85249,181605.4
170625,201705,37,17,20,15929,18740,34669
170650,201705,81,59,22,55283,20614,75897
170700,201705,553,419,134,390682.15,124761.55,515443.70
170710,201705,155,96,59,89952,55274,145226
170720,201705,78,65,13,60905,12181,73086
170730,201705,56,32,24,29984,22488,52472
170740,201705,67,50,17,46850,15929,62779
170755,201705,115,52,63,48114.95,59031,107145.95
170765,201705,151,68,83,63107,77771,140878
170770,201705,232,130,102,120732.45,95574,216306.45
170820,201705,592,380,212,356060,198223,554283
170825,201705,31,19,12,17803,11244,29047
170830,201705,72,49,23,45725.6,21551,67276.6
170900,201705,208,157,51,147109,47787,194896
170930,201705,774,388,386,363238,361120,724358
170950,201705,2929,1267,1662,1184865.88,1555026.93,2739892.81
170980,201705,16,9,7,8433,6559,14992
171050,201705,124,95,29,89015,27173,116188
171070,201705,33,26,7,24362,6559,30921
171090,201705,35,24,11,22488,10307,32795
171110,201705,21,14,7,13118,6559,19677
171150,201705,36,18,18,16866,16866,33732
171180,201705,22,10,12,9370,11244,20614
171190,201705,121,69,52,64653,48724,113377
171195,201705,63,48,15,44976,14055,59031
171200,201705,45,19,26,17803,24362,42165
171215,201705,1,1,0,937,0,937
171240,201705,52,42,10,39354,9370,48724
171245,201705,51,46,5,43102,4685,47787
171250,201705,66,31,35,29047,32785.63,61832.63
171270,201705,16,12,4,11244,3748,14992
171280,201705,35,32,3,29844,2811,32655
171320,201705,975,546,429,511602,401036,912638
171330,201705,408,192,216,179904,202392,382296
171360,201705,82,61,21,57157,19677,76834
171370,201705,22,11,11,10307,10307,20614
171380,201705,126,102,24,95574,22262.19,117836.19
171395,201705,51,31,20,29047,18740,47787
171420,201705,321,211,110,197707,102788.9,300495.9
171430,201705,60,48,12,44336,11244,55580
171488,201705,207,107,100,100259,93700,193959
171500,201705,58,31,27,29047,25299,54346
171510,201705,62,41,21,38417,19677,58094
171515,201705,44,37,7,34669,6559,41228
171525,201705,30,26,4,24362,3748,28110
171550,201705,12,6,6,5622,5622,11244
171570,201705,57,28,29,26236,27173,53409
171575,201705,353,211,142,197567,133044.63,330611.63
171610,201705,1610,791,819,739301.83,765825.62,1505127.45
171620,201705,128,87,41,80975.54,38135.9,119111.44
171630,201705,55,28,27,26236,25299,51535
171650,201705,277,175,102,163975,95574,259549
171660,201705,256,137,119,128369,111503,239872
171665,201705,41,25,16,23425,14992,38417
171670,201705,433,249,184,231710.98,171845.8,403556.78
171700,201705,59,53,6,49661,5622,55283
171720,201705,24,9,15,8433,14055,22488
171750,201705,96,53,43,49661,40291,89952
171780,201705,70,57,13,53409,12181,65590
171790,201705,80,65,15,60905,14055,74960
171800,201705,33,25,8,23425,7496,30921
171820,201705,1908,1079,829,1010326.47,771311.21,1781637.68
171830,201705,38,29,9,27173,8433,35606
171840,201705,57,32,25,29984,23425,53409
171845,201705,31,19,12,17803,11244,29047
171850,201705,36,24,12,22488,11244,33732
171855,201705,70,55,15,51535,14055,65590
171865,201705,9,6,3,5622,2811,8433
171870,201705,32,23,9,21551,8433,29984
171875,201705,77,53,24,49661,22488,72149
171880,201705,25,18,7,16866,6559,23425
171884,201705,43,22,21,20614,19677,40291
171886,201705,110,40,70,37480,65308.9,102788.9
171888,201705,22,15,7,14055,6559,20614
171889,201705,22,15,7,14055,6559,20614
171890,201705,58,47,11,44039,10307,54346
171900,201705,42,29,13,27173,12181,39354
172000,201705,41,34,7,31858,6559,38417
172010,201705,39,32,7,29187.55,6559,35746.55
172015,201705,27,16,11,14992,10025.9,25017.9
172020,201705,124,76,48,71212,44976,116188
172025,201705,32,19,13,17803,12181,29984
172030,201705,32,19,13,17803,12181,29984
172049,201705,73,45,28,42165,26236,68401
172065,201705,151,99,52,92763,48724,141487
172080,201705,72,53,19,48500.02,17803,66303.02
172085,201705,23,10,13,9370,12181,21551
172090,201705,411,309,102,288488,94825,383313
172093,201705,27,18,9,16866,8433,25299
172097,201705,18,9,9,8433,8152,16585
172100,201705,4466,2462,2004,2301483.67,1875026.93,4176510.60
172110,201705,78,51,27,47787,25299,73086
172120,201705,1732,1484,248,1385141.01,231288.14,1616429.15
172125,201705,2,2,0,1874,0,1874
172130,201705,12,10,2,9370,1874,11244
172208,201705,185,117,68,109629,63716,173345
172210,201705,487,228,259,213636,242402,456038
210005,201705,2923,1811,1112,1693627.86,1039415,2733042.86
210010,201705,206,101,105,94637,98385,193022
210015,201705,21,13,8,12181,7496,19677
210020,201705,340,172,168,161164,157416,318580
210030,201705,351,217,134,203329,125549,328878
210040,201705,157,121,36,113377,33732,147109
210043,201705,254,167,87,156479,81519,237998
210047,201705,631,301,330,281662.2,309200.63,590862.83
210050,201705,301,218,83,204266,77771,282037
210055,201705,41,31,10,29047,9370,38417
210060,201705,575,435,140,407497.56,131180,538677.56
210070,201705,416,296,120,277352,112158.9,389510.9
210080,201705,99,91,8,85267,7496,92763
210083,201705,315,125,190,117125,178030,295155
210087,201705,51,33,18,30921,16866,47787
210090,201705,497,340,157,318580,147109,465689
210095,201705,506,350,156,327940.63,146172,474112.63
210100,201705,684,512,172,479416.05,160227.35,639643.40
210110,201705,157,82,75,76834,70275,147109
210120,201705,5607,4144,1463,3877983.2,1369861.14,5247844.34
210125,201705,218,112,106,104944,99322,204266
210130,201705,569,282,287,263297,268919,532216
210135,201705,34,20,14,18740,13118,31858
210140,201705,3974,3066,908,2869703.22,850625,3720328.22
210150,201705,352,222,130,208014,121637,329651
210160,201705,3306,2751,555,2574878.68,519754,3094632.68
210170,201705,1113,850,263,796450,246431,1042881
210173,201705,110,90,20,84330,18740,103070
210177,201705,508,237,271,222069,253927,475996
210180,201705,27,14,13,13118,12181,25299
210190,201705,402,254,148,237998,138676,376674
210193,201705,0,0,0,0,0,0
210197,201705,87,56,31,52472,29030,81502
210200,201705,641,499,142,467563,133054,600617
210203,201705,273,175,98,163975,91826,255801
210207,201705,377,284,93,266108,87141,353249
210210,201705,767,694,73,650278,68401,718679
210215,201705,78,65,13,60905,12181,73086
210220,201705,405,329,76,308273,71212,379485
210230,201705,305,219,86,205203,80582,285785
210232,201705,1527,930,597,871129,559389,1430518
210235,201705,156,119,37,111316,34669,145985
210237,201705,44,24,20,22488,18740,41228
210240,201705,95,77,18,72149,16866,89015
210250,201705,176,136,40,127432,37480,164912
210255,201705,305,218,87,204266,81519,285785
210260,201705,436,253,183,237061,171471,408532
210270,201705,725,447,278,418839,260486,679325
210275,201705,40,31,9,29047,8433,37480
210280,201705,1022,644,378,600162.97,352874.25,953037.22
210290,201705,489,301,188,282037,176156,458193
210300,201705,6267,3553,2714,3324325.43,2541829.37,5866154.80
210310,201705,102,69,33,64653,30921,95574
210312,201705,130,78,52,73086,48724,121810
210315,201705,118,83,35,77771,32795,110566
210317,201705,119,81,38,75897,35606,111503
210320,201705,2397,1943,454,1818630.88,424461,2243091.88
210325,201705,126,85,41,78708,38136,116844
210330,201705,5981,2877,3104,2692549.7,2908438.63,5600988.33
210340,201705,1455,1019,436,954017,408461.85,1362478.85
210350,201705,606,485,121,454210.75,113377,567587.75
210355,201705,124,97,27,90889,25299,116188
210360,201705,2746,1682,1064,1572943.36,996968,2569911.36
210370,201705,1279,524,755,490988,706779.1,1197767.1
210375,201705,193,97,96,90355,89952,180307
210380,201705,730,544,186,509728,174262,683990
210390,201705,194,160,34,149920,31858,181778
210400,201705,417,344,73,322328,68401,390729
210405,201705,971,632,339,591590.87,317643,909233.87
210407,201705,55,43,12,40291,11244,51535
210408,201705,69,62,7,58094,6559,64653
210409,201705,316,259,57,242683,52707,295390
210410,201705,436,332,104,311084,97439,408523
210420,201705,194,158,36,148046,33732,181778
210430,201705,33,25,8,23425,7496,30921
210440,201705,387,226,161,211762,149920,361682
210450,201705,147,109,38,102133,35606,137739
210455,201705,205,111,94,104007,88078,192085
210460,201705,341,214,127,200518,118999,319517
210462,201705,55,47,8,44039,7496,51535
210465,201705,191,132,59,123684,55283,178967
210467,201705,508,359,149,336383,139613,475996
210470,201705,40,29,11,27173,10307,37480
210480,201705,1275,885,390,829245,365430,1194675
210490,201705,220,129,91,120873,85267,206140
210500,201705,548,283,265,265171,248305,513476
210510,201705,547,413,134,386981,125558,512539
210515,201705,458,234,224,219258,209888,429146
210520,201705,398,344,54,322046.9,50598,372644.9
210530,201705,9240,4936,4304,4610419.65,4027402.6,8637822.25
210535,201705,139,96,43,89952,40291,130243
210540,201705,1563,905,658,846861.4,615140.5,1462001.9
210542,201705,1142,587,555,549504.2,520035,1069539.2
210545,201705,12,11,1,10307,937,11244
210547,201705,134,114,20,106818,18740,125558
210550,201705,753,511,242,477735.9,226754,704489.9
210560,201705,175,144,31,134928,29047,163975
210565,201705,29,20,9,18740,8433,27173
210570,201705,1398,1071,327,1003527,306389.63,1309916.63
210580,201705,107,92,15,86204,14055,100259
210590,201705,773,590,183,552080.4,171471,723551.4
210592,201705,35,31,4,29047,3748,32795
210594,201705,96,82,14,76834,13118,89952
210596,201705,76,64,12,59968,11244,71212
210598,201705,123,88,35,82456,32795,115251
210600,201705,355,296,59,277352,55283,332635
210610,201705,241,224,17,208951,15929,224880
210620,201705,50,29,21,27173,19677,46850
210630,201705,59,55,4,51535,3748,55283
210632,201705,1154,726,428,680262,400286.4,1080548.4
210635,201705,14,12,2,11244,1874,13118
210637,201705,105,75,30,70275,28110,98385
210640,201705,589,507,82,475059,76834,551893
210650,201705,401,320,81,299652.6,74960,374612.6
210660,201705,398,281,117,263297,109629,372926
210663,201705,16,11,5,10307,4685,14992
210667,201705,119,36,83,33732,77771,111503
210670,201705,266,235,31,219493,29047,248540
210675,201705,577,287,290,268919,271730,540649
210680,201705,226,135,91,126495,85267,211762
210690,201705,645,497,148,465689,138676,604365
210700,201705,192,139,53,130243,49661,179904
210710,201705,309,169,140,158353,131180,289533
210720,201705,122,101,21,94637,19677,114314
210725,201705,63,56,7,52472,6559,59031
210730,201705,24,18,6,16866,5622,22488
210735,201705,403,261,142,244557,132773,377330
210740,201705,540,455,85,426335,79645,505980
210745,201705,149,102,47,95574,44039,139613
210750,201705,2449,1057,1392,989346,1304285.26,2293631.26
210760,201705,286,199,87,186463,81504.95,267967.95
210770,201705,405,312,93,291407,86859.9,378266.9
210780,201705,423,299,124,280163,115251.45,395414.45
210790,201705,185,142,43,133054,40291,173345
210800,201705,128,95,33,89015,30921,119936
210805,201705,38,35,3,32795,2811,35606
210810,201705,496,369,127,345097.1,118999,464096.1
210820,201705,2337,1809,528,1686780.39,494736,2181516.39
210825,201705,178,89,89,83393,83393,166786
210830,201705,826,482,344,450697,321391,772088
210840,201705,216,139,77,130243,72149,202392
210845,201705,258,149,109,139613,102133,241746
210850,201705,895,559,336,523470.7,314832,838302.7
210860,201705,4218,2075,2143,1943338,2007970.89,3951308.89
210870,201705,473,347,126,325139,118062,443201
210880,201705,56,37,19,34669,17803,52472
210890,201705,341,277,64,259549,59968,319517
210900,201705,520,320,200,299110.07,187400,486510.07
210905,201705,79,34,45,31858,42165,74023
210910,201705,2012,1459,553,1366035.89,518161,1884196.89
210920,201705,254,70,184,65590,172408,237998
210923,201705,77,56,21,52472,19677,72149
210927,201705,448,168,280,157416,262360,419776
210930,201705,59,45,14,42165,13118,55283
210940,201705,97,69,28,64653,26236,90889
210945,201705,204,87,117,81519,109629,191148
210950,201705,506,361,145,338257,135860.32,474117.32
210955,201705,78,54,24,50598,22488,73086
210960,201705,2488,979,1509,915730.7,1413652,2329382.7
210970,201705,109,92,17,86204,15929,102133
210975,201705,81,73,8,68401,7496,75897
210980,201705,1289,537,752,503056.56,704343,1207399.56
210990,201705,4494,2696,1798,2525871,1684706,4210577
211000,201705,1404,1074,330,1006037,308928.9,1314965.9
211003,201705,929,622,307,582814,287650,870464
211010,201705,479,417,62,390729,58094,448823
211020,201705,1647,561,1086,525657,1017366.49,1543023.49
211023,201705,21,18,3,16584.9,2811,19395.9
211027,201705,59,39,20,36543,18740,55283
211030,201705,388,249,139,233313,130243,363556
211040,201705,316,231,85,216166,79645,295811
211050,201705,1195,730,465,684010,435419.32,1119429.32
211060,201705,686,580,106,543460,99322,642782
211065,201705,24,20,4,18740,3748,22488
211070,201705,912,732,180,684020.97,168660,852680.97
211080,201705,89,84,5,78708,4685,83393
211085,201705,59,30,29,27829,27173,55002
211090,201705,98,80,18,74960,16866,91826
211100,201705,508,403,105,377611,98385,475996
211102,201705,274,173,101,162101,94637,256738
211105,201705,210,141,69,132117,64653,196770
211107,201705,121,69,52,64653,48724,113377
211110,201705,809,520,289,486678,270784,757462
211120,201705,5835,2293,3542,2144306.77,3316845.92,5461152.69
211125,201705,35,29,6,27173,5622,32795
211130,201705,46573,18633,27940,17428558.77,26166781.05,43595339.82
211140,201705,455,378,77,354182,71868,426050
211150,201705,1246,760,486,712120,455097,1167217
211153,201705,184,100,84,93700,78708,172408
211157,201705,55,40,15,37480,14055,51535
211160,201705,686,557,129,520960.25,120873,641833.25
211163,201705,0,0,0,0,0,0
211167,201705,5,4,1,3748,937,4685
211170,201705,455,308,147,288596,137739,426335
211172,201705,121,78,43,73086,40291,113377
211174,201705,294,168,126,157416,118062,275478
211176,201705,530,368,162,344816,151794,496610
211178,201705,91,58,33,54346,30921,85267
211180,201705,211,164,47,153668,43879.71,197547.71
211190,201705,63,58,5,54346,4685,59031
211195,201705,18,10,8,9370,7496,16866
211200,201705,157,136,21,127094.68,19677,146771.68
211210,201705,658,314,344,293562.1,322328,615890.1
211220,201705,3896,2174,1722,2031743.71,1606122.22,3637865.93
211223,201705,95,89,6,83214.97,5622,88836.97
211227,201705,67,44,23,41228,21551,62779
211230,201705,791,634,157,593917.45,147090.26,741007.71
211240,201705,425,308,117,288596,109629,398225
211245,201705,208,84,124,78708,116188,194896
211250,201705,1661,1400,261,1310954,244557,1555511
211260,201705,808,628,180,588436,168660,757096
211270,201705,2137,1639,498,1535743,465689.1,2001432.1
211280,201705,1849,1072,777,1002591.08,728049,1730640.08
211285,201705,221,121,100,113377,93418.9,206795.9
211290,201705,697,457,240,428021.6,224880,652901.6
211300,201705,823,616,207,576937.7,193959,770896.7
211400,201705,1666,902,764,845174,715868,1561042
220005,201705,20,18,2,16866,1874,18740
220010,201705,90,68,22,63716,20332.9,84048.9
220020,201705,532,418,114,391072.6,106818,497890.6
220025,201705,108,104,4,97448,3748,101196
220027,201705,42,34,8,31858,7496,39354
220030,201705,86,71,15,66527,14055,80582
220040,201705,1087,809,278,757096,260486,1017582
220045,201705,36,28,8,26236,7496,33732
220050,201705,633,510,123,476728.88,115232.26,591961.14
220060,201705,175,145,30,135865,28110,163975
220070,201705,136,124,12,116188,11244,127432
220080,201705,8,7,1,6559,937,7496
220090,201705,33,26,7,24081,6559,30640
220095,201705,3,2,1,1874,937,2811
220100,201705,28,24,4,22488,3748,26236
220105,201705,40,37,3,34669,2811,37480
220110,201705,200,185,15,173063.9,14055,187118.9
220115,201705,42,39,3,36543,2811,39354
220117,201705,19,19,0,17803,0,17803
220120,201705,1519,1027,492,962449.85,460985.26,1423435.11
220130,201705,24,23,1,21551,937,22488
220140,201705,104,85,19,78708,17803,96511
220150,201705,441,308,133,288596,124621,413217
220155,201705,4,4,0,3748,0,3748
220157,201705,19,15,4,14055,3748,17803
220160,201705,69,61,8,57157,7496,64653
220170,201705,35,33,2,30921,1874,32795
220173,201705,8,8,0,7496,0,7496
220177,201705,6,6,0,5622,0,5622
220180,201705,68,67,1,62770.32,937,63707.32
220190,201705,1035,931,104,872347,96698.4,969045.4
220191,201705,47,42,5,39354,4685,44039
220192,201705,67,64,3,59968,2811,62779
220194,201705,21,18,3,16866,2811,19677
220196,201705,103,86,17,80442,15929,96371
220198,201705,6,4,2,3748,1874,5622
220200,201705,427,340,87,319301,81519,400820
220202,201705,35,31,4,29047,3748,32795
220205,201705,38,32,6,29984,5622,35606
220207,201705,18,17,1,15929,937,16866
220208,201705,81,41,40,38417,37480,75897
220209,201705,32,29,3,27173,2811,29984
220210,201705,17,16,1,14992,937,15929
220211,201705,45,44,1,41228,937,42165
220213,201705,42,37,5,34669,4685,39354
220217,201705,38,30,8,28110,7496,35606
220220,201705,1944,1250,694,1167709.04,649041.76,1816750.80
220225,201705,13,6,7,5622,6559,12181
220230,201705,905,723,182,677010.61,169906.21,846916.82
220240,201705,139,126,13,118062,12181,130243
220245,201705,54,50,4,46472,3748,50220
220250,201705,137,121,16,113377,14992,128369
220253,201705,43,34,9,31858,8433,40291
220255,201705,27,23,4,21551,3748,25299
220260,201705,690,505,185,473185,173345,646530
220265,201705,13,9,4,8433,3748,12181
220270,201705,627,555,72,519322.88,66995.5,586318.38
220271,201705,44,35,9,32795,8433,41228
220272,201705,27,26,1,24362,937,25299
220273,201705,16,13,3,12181,2811,14992
220275,201705,48,37,11,34669,10307,44976
220277,201705,9,8,1,7496,937,8433
220280,201705,21,19,2,17803,1874,19677
220285,201705,55,51,4,47787,3748,51535
220290,201705,1381,1178,203,1101304,190165,1291469
220300,201705,60,58,2,54346,1874,56220
220310,201705,301,252,49,235982.27,45904,281886.27
220320,201705,440,405,35,378080.5,32795,410875.5
220323,201705,0,0,0,0,0,0
220325,201705,13,8,5,7496,4685,12181
220327,201705,12,11,1,10307,937,11244
220330,201705,186,122,64,114032.9,59968,174000.9
220335,201705,139,123,16,115232.26,14992,130224.26
220340,201705,23,12,11,11244,10307,21551
220342,201705,51,44,7,41228,6559,47787
220345,201705,121,108,13,101196,12181,113377
220350,201705,436,385,51,358169.01,47787,405956.01
220360,201705,40,31,9,29047,8433,37480
220370,201705,1034,820,214,767590.4,200518,968108.4
220375,201705,25,24,1,22488,937,23425
220380,201705,35,27,8,25299,7496,32795
220385,201705,28,24,4,22488,3748,26236
220390,201705,2180,1243,937,1160081.2,875674.41,2035755.61
220400,201705,28,27,1,25299,937,26236
220410,201705,17,14,3,13118,2811,15929
220415,201705,13,12,1,11244,937,12181
220420,201705,129,107,22,100259,20332.9,120591.9
220430,201705,130,117,13,107990.4,12181,120171.4
220435,201705,26,19,7,17799,6559,24358
220440,201705,289,247,42,231439,39354,270793
220450,201705,304,161,143,149712.74,133991,283703.74
220455,201705,61,59,2,55283,1874,57157
220460,201705,22,21,1,19021.1,937,19958.1
220465,201705,102,66,36,61842,33732,95574
220470,201705,236,204,32,190211.8,29984,220195.8
220480,201705,71,59,12,55283,11244,66527
220490,201705,83,72,11,66707,10307,77014
220500,201705,96,83,13,77771,12181,89952
220510,201705,376,301,75,281288,70087.6,351375.6
220515,201705,19,15,4,14055,3748,17803
220520,201705,358,318,40,296283,37462,333745
220525,201705,27,19,8,17803,7496,25299
220527,201705,37,31,6,29047,5622,34669
220530,201705,35,13,22,12181,20614,32795
220535,201705,13,12,1,11244,937,12181
220540,201705,59,46,13,43102,12181,55283
220545,201705,67,44,23,41228,21551,62779
220550,201705,613,466,147,436642,137739,574381
220551,201705,24,18,6,16866,5622,22488
220552,201705,8,8,0,7496,0,7496
220553,201705,62,56,6,52472,5622,58094
220554,201705,15,9,6,8151.9,5622,13773.9
220555,201705,26,22,4,20614,3748,24362
220556,201705,61,57,4,53409,3748,57157
220557,201705,55,49,6,45913,5622,51535
220558,201705,7,2,5,1874,4685,6559
220559,201705,6,5,1,4685,937,5622
220560,201705,55,36,19,33544.6,17803,51347.6
220570,201705,745,438,307,410160.14,287659,697819.14
220580,201705,595,537,58,503169,53391.26,556560.26
220585,201705,5,4,1,3748,937,4685
220590,201705,14,14,0,13118,0,13118
220595,201705,61,46,15,42821,14055,56876
220600,201705,20,10,10,9370,9370,18740
220605,201705,20,19,1,17803,937,18740
220610,201705,57,49,8,45913,7496,53409
220620,201705,549,421,128,394242.75,119936,514178.75
220630,201705,9,7,2,6559,1874,8433
220635,201705,35,32,3,29984,2811,32795
220640,201705,98,72,26,67464,24362,91826
220650,201705,116,109,7,102133,6559,108692
220660,201705,24,18,6,16866,5622,22488
220665,201705,5,4,1,3748,937,4685
220667,201705,13,13,0,12181,0,12181
220669,201705,20,18,2,16866,1874,18740
220670,201705,63,49,14,45725.6,13118,58843.6
220672,201705,47,31,16,29047,14710.9,43757.9
220675,201705,33,25,8,23425,7496,30921
220680,201705,34,29,5,27173,4685,31858
220690,201705,51,47,4,44039,3748,47787
220695,201705,68,30,38,28110,35606,63716
220700,201705,1431,1089,342,1018350.59,320173,1338523.59
220710,201705,4,2,2,1874,1874,3748
220720,201705,122,98,24,91591.75,22347.45,113939.20
220730,201705,21,21,0,19677,0,19677
220735,201705,3,1,2,937,1874,2811
220740,201705,39,37,2,34669,1874,36543
220750,201705,98,79,19,74023,17803,91826
220755,201705,16,16,0,14992,0,14992
220760,201705,46,43,3,40291,2811,43102
220770,201705,5580,2742,2838,2563761.52,2653459.18,5217220.70
220775,201705,26,12,14,11244,13118,24362
220777,201705,12,12,0,11244,0,11244
220779,201705,15,12,3,11244,2811,14055
220780,201705,845,719,126,673047.1,117781,790828.1
220785,201705,5,3,2,2811,1874,4685
220790,201705,981,775,206,723834.34,193022,916856.34
220793,201705,14,14,0,13118,0,13118
220795,201705,25,24,1,22488,937,23425
220800,201705,3760,2852,908,2671008.56,849845.74,3520854.30
220810,201705,51,47,4,44039,3748,47787
220820,201705,236,214,22,200518,20614,221132
220830,201705,1107,930,177,871405.32,165849,1037254.32
220840,201705,2364,1550,814,1441562.1,760376,2201938.1
220850,201705,50,38,12,35606,11244,46850
220855,201705,15,10,5,9370,4685,14055
220860,201705,13,12,1,11244,937,12181
220865,201705,19,17,2,15929,1874,17803
220870,201705,58,54,4,50598,3748,54346
220880,201705,336,253,83,236405.1,77490,313895.1
220885,201705,45,40,5,37480,4685,42165
220887,201705,21,20,1,18740,937,19677
220890,201705,106,93,13,87141,12181,99322
220900,201705,46,27,19,25299,17803,43102
220910,201705,54,45,9,42165,8433,50598
220915,201705,18,17,1,15929,937,16866
220920,201705,35,32,3,29984,2811,32795
220930,201705,41,40,1,36680.73,937,37617.73
220935,201705,20,19,1,17803,937,18740
220937,201705,43,41,2,38417,1874,40291
220940,201705,48,43,5,40291,4685,44976
220945,201705,0,0,0,0,0,0
220950,201705,46,42,4,39354,3748,43102
220955,201705,41,38,3,35606,2811,38417
220960,201705,4,4,0,3748,0,3748
220965,201705,25,21,4,19677,3748,23425
220970,201705,45,37,8,34669,7496,42165
220975,201705,9,8,1,7496,937,8433
220980,201705,40,36,4,33732,3748,37480
220985,201705,59,54,5,50598,4685,55283
220987,201705,32,30,2,28110,1874,29984
220990,201705,12,10,2,9370,1874,11244
220995,201705,38,33,5,30921,4685,35606
220997,201705,30,24,6,22488,5622,28110
221000,201705,1061,950,111,887576.81,103725.9,991302.71
221005,201705,62,57,5,53409,4685,58094
221010,201705,16,13,3,12181,2811,14992
221020,201705,49,48,1,44976,937,45913
221030,201705,34,27,7,25299,6559,31858
221035,201705,17,16,1,14992,937,15929
221037,201705,9,5,4,4685,3748,8433
221038,201705,10,9,1,8433,937,9370
221039,201705,23,23,0,21551,0,21551
221040,201705,241,208,33,194896,30921,225817
221050,201705,229,190,39,178030,36543,214573
221060,201705,1435,1248,187,1168579.55,175219,1343798.55
221062,201705,32,31,1,29047,937,29984
221063,201705,15,12,3,11244,2811,14055
221065,201705,39,34,5,31858,4685,36543
221070,201705,153,131,22,122747,20614,143361
221080,201705,370,324,46,303588,42820.9,346408.9
221090,201705,39,38,1,35354,937,36291
221093,201705,73,51,22,47787,20614,68401
221095,201705,11,10,1,9370,937,10307
221097,201705,27,24,3,22488,2811,25299
221100,201705,23814,13574,10240,12696956.02,9591115.79,22288071.81
221110,201705,990,724,266,678087,249242,927329
221120,201705,493,362,131,338913,122747,461660
221130,201705,897,732,165,684357.69,153950,838307.69
221135,201705,33,30,3,28110,2811,30921
221140,201705,40,30,10,28110,9370,37480
221150,201705,15,11,4,10307,3748,14055
221160,201705,11,11,0,10307,0,10307
221170,201705,11,11,0,10307,0,10307
230010,201705,156,143,13,133991,12181,146172
230015,201705,111,94,17,88078,15929,104007
230020,201705,1454,1258,196,1176030,182989.08,1359019.08
230030,201705,1552,1109,443,1033663.62,415091,1448754.62
230040,201705,199,176,23,163975,21551,185526
230050,201705,189,139,50,130243,46850,177093
230060,201705,133,107,26,99509.4,24362,123871.4
230070,201705,272,239,33,223943,30233.86,254176.86
230075,201705,781,680,101,634725.5,94355.9,729081.4
230080,201705,174,155,19,145235,17803,163038
230090,201705,87,60,27,54722,25299,80021
230100,201705,1830,1092,738,1020958,691225,1712183
230110,201705,2575,1621,954,1515579.6,893335.9,2408915.5
230120,201705,900,711,189,663864.91,177075,840939.91
230125,201705,130,106,24,99322,22488,121810
230130,201705,436,390,46,365430,43102,408532
230140,201705,209,183,26,171471,24362,195833
230150,201705,154,120,34,112440,31858,144298
230160,201705,906,794,112,743275.5,104944,848219.5
230170,201705,558,513,45,476936.1,42165,519101.1
230180,201705,75,71,4,66527,3748,70275
230185,201705,385,331,54,308806.16,50598,359404.16
230190,201705,2133,1714,419,1602923.69,392291,1995214.69
230195,201705,478,415,63,388199.1,59031,447230.1
230200,201705,357,313,44,292334.63,40563,332897.63
230205,201705,340,212,128,196905.86,119936,316841.86
230210,201705,1228,980,248,917334.18,231626.4,1148960.58
230220,201705,1320,918,402,860166,376674,1236840
230230,201705,883,781,102,729892.75,95574,825466.75
230240,201705,1575,1355,220,1267981.85,206140,1474121.85
230250,201705,1689,1379,310,1288794.47,289908,1578702.47
230260,201705,2818,1663,1155,1553412.79,1081298.75,2634711.54
230270,201705,1309,1058,251,989491.33,232658.3,1222149.63
230280,201705,2615,1941,674,1813378.97,630601.1,2443980.07
230290,201705,389,350,39,321779.92,36543,358322.92
230300,201705,501,368,133,343579.16,124621,468200.16
230310,201705,398,302,96,282974,89952,372926
230320,201705,856,732,124,682815.17,116003.86,798819.03
230330,201705,290,234,56,218508.4,52472,270980.4
230340,201705,448,358,90,333760.4,84330,418090.4
230350,201705,2868,1803,1065,1689353.52,995095.24,2684448.76
230360,201705,241,212,29,197750,27173,224923
230365,201705,170,136,34,126730,31858,158588
230370,201705,9289,4461,4828,4170302.61,4519569.05,8689871.66
230380,201705,449,383,66,358590,60905.8,419495.8
230390,201705,493,267,226,248408.07,211762,460170.07
230393,201705,269,224,45,209048.4,42165,251213.4
230395,201705,320,262,58,245251,54346,299597
230400,201705,596,474,122,441889.9,113826.76,555716.66
230410,201705,2488,1539,949,1438155.55,888932,2327087.55
230420,201705,5568,3592,1976,3347259.84,1846827.22,5194087.06
230423,201705,298,255,43,237061.8,40291,277352.8
230425,201705,321,268,53,251116,49661,300777
230426,201705,104,93,11,86428.88,10025.9,96454.78
230427,201705,78,75,3,70275,2811,73086
230428,201705,1309,671,638,628502.12,597806,1226308.12
230430,201705,429,336,93,314641,86377.34,401018.34
230435,201705,731,504,227,471208,211481.17,682689.17
230440,201705,80415,35219,45196,32926045.36,42307961.53,75234006.89
230445,201705,253,176,77,164912,72149,237061
230450,201705,534,430,104,402910,97448,500358
230460,201705,53,43,10,40291,9370,49661
230465,201705,284,229,55,214573,51535,266108
230470,201705,1793,1384,409,1296808,382145.59,1678953.59
230480,201705,138,134,4,125276.9,3748,129024.9
230490,201705,269,218,51,204266,47787,252053
230495,201705,410,306,104,285885,97448,383333
230500,201705,915,682,233,637160,218312,855472
230510,201705,41,33,8,30921,7496,38417
230520,201705,382,300,82,281100,76834,357934
230523,201705,1779,1157,622,1083359.4,582374,1665733.4
230526,201705,284,237,47,222069,44039,266108
230530,201705,658,496,162,461793.38,150857.6,612650.98
230533,201705,169,164,5,153668,4685,158353
230535,201705,335,247,88,231439,82456,313895
230540,201705,1817,1587,230,1484420.7,215229,1699649.7
230550,201705,3553,2249,1304,2100185.43,1221004.7,3321190.13
230560,201705,575,441,134,411156.4,124621,535777.4
230565,201705,182,130,52,121810,48724,170534
230570,201705,300,269,31,252053,29047,281100
230580,201705,1074,796,278,744418.39,259267.9,1003686.29
230590,201705,904,703,201,654542.15,187868.9,842411.05
230600,201705,238,220,18,204472.32,16866,221338.32
230610,201705,324,259,65,242496,60905,303401
230620,201705,159,130,29,120873,27173,148046
230625,201705,711,514,197,480260.25,183456.04,663716.29
230630,201705,1201,943,258,883591,241371.2,1124962.2
230640,201705,3311,2881,430,2692392.56,402910,3095302.56
230650,201705,388,342,46,319637.49,42446.1,362083.59
230655,201705,597,520,77,486303.4,72111.95,558415.35
230660,201705,314,262,52,245494,48442.9,293936.9
230670,201705,416,375,41,351375,38417,389792
230680,201705,197,182,15,170534,14055,184589
230690,201705,818,716,102,670892,95574,766466
230700,201705,698,594,104,556578,96885.8,653463.8
230710,201705,707,664,43,621981,40291,662272
230720,201705,133,111,22,103810.23,20614,124424.23
230725,201705,212,167,45,156479,42156,198635
230730,201705,11158,6045,5113,5647582.74,4782715.39,10430298.13
230740,201705,636,502,134,470093,124879.63,594972.63
230750,201705,777,656,121,613501.15,113377,726878.15
230760,201705,1181,1020,161,951766.59,150857,1102623.59
230763,201705,332,273,59,253880.41,55283,309163.41
230765,201705,6461,2990,3471,2795132.05,3250079.1,6045211.15
230770,201705,4801,2471,2330,2305376.94,2180108.14,4485485.08
230780,201705,664,585,79,545360.57,74023,619383.57
230790,201705,181,146,35,136802,32008.66,168810.66
230800,201705,1072,783,289,733666.32,270793,1004459.32
230810,201705,1226,1086,140,1016317.05,130711.5,1147028.55
230820,201705,308,222,86,207078,80582,287660
230830,201705,925,806,119,752678.02,111503,864181.02
230835,201705,265,229,36,213636,33030,246666
230837,201705,163,135,28,126495,26236,152731
230840,201705,851,683,168,638753.5,156198,794951.5
230850,201705,1418,1245,173,1166283.9,161820,1328103.9
230860,201705,308,224,84,209888,77771.25,287659.25
230870,201705,1728,1464,264,1370550,246056.4,1616606.4
230880,201705,12,6,6,5622,5622,11244
230890,201705,560,517,43,484308.98,40291,524599.98
230900,201705,256,197,59,184589,55090,239679
230910,201705,189,152,37,141674.4,34669,176343.4
230920,201705,381,303,78,283911,73086,356997
230930,201705,888,636,252,593121.92,236124,829245.92
230940,201705,821,658,163,616264.9,152544,768808.9
230945,201705,437,366,71,342755,66527,409282
230950,201705,352,304,48,284848,44976,329824
230960,201705,2314,1539,775,1435443.51,725894,2161337.51
230970,201705,1620,911,709,852711.45,663470.96,1516182.41
230980,201705,198,164,34,153668,31858,185526
230990,201705,138,112,26,104944,23618.95,128562.95
231000,201705,191,176,15,163038.74,14055,177093.74
231010,201705,132,105,27,98385,25299,123684
231020,201705,1182,834,348,779865.5,326056,1105921.5
231025,201705,895,669,226,624445.6,210244.9,834690.5
231030,201705,1137,951,186,890802,174001,1064803
231040,201705,134,92,42,85473.14,38636,124109.14
231050,201705,999,884,115,826435.5,107755,934190.5
231060,201705,132,116,16,108692,14992,123684
231070,201705,1361,963,398,899802.05,372926,1272728.05
231080,201705,252,235,17,219398.55,15929,235327.55
231085,201705,494,312,182,291408,170534,461942
231090,201705,225,189,36,177093,33732,210825
231095,201705,160,127,33,118999,30921,149920
231100,201705,117,95,22,89015,19395.9,108410.9
231110,201705,321,277,44,258054.39,41228,299282.39
231120,201705,294,254,40,237047.88,37293,274340.88
231123,201705,133,125,8,117125,7496,124621
231126,201705,267,228,39,213636,36543,250179
231130,201705,4416,3441,975,3215706.34,912975.42,4128681.76
231135,201705,186,162,24,151794,21246.2,173040.2
231140,201705,2994,2199,795,2056897.79,743104.24,2800002.03
231150,201705,330,317,13,297029,12181,309210
231160,201705,1182,933,249,870942.25,233088.12,1104030.37
231170,201705,534,344,190,322328,178030,500358
231180,201705,1474,1237,237,1158179.4,222069,1380248.4
231190,201705,212,189,23,177093,21533,198626
231195,201705,207,178,29,166074.91,27173,193247.91
231200,201705,804,660,144,618420,133690,752110
231210,201705,588,490,98,459130,91826,550956
231220,201705,988,713,275,667145,257675,924820
231230,201705,1320,1069,251,1000286.3,234156.3,1234442.6
231240,201705,1263,916,347,858010.9,323921.1,1181932.0
231250,201705,106,99,7,92763,6559,99322
231260,201705,295,188,107,176156,99978,276134
231270,201705,972,811,161,755567.49,150848,906415.49
231280,201705,46,36,10,33732,9370,43102
231290,201705,7047,3877,3170,3623942.71,2968923.35,6592866.06
231300,201705,607,561,46,525657,43102,568759
231310,201705,679,634,45,592582,42160.32,634742.32
231320,201705,530,411,119,384640,111503,496143
231325,201705,86,74,12,69338,11244,80582
231330,201705,1976,1534,442,1431881.19,411251.3,1843132.49
231335,201705,249,216,33,202392,30921,233313
231340,201705,1513,1114,399,1042694.24,373863,1416557.24
231350,201705,1087,891,196,834867,182808.9,1017675.9
231355,201705,376,326,50,305462,46850,352312
231360,201705,445,359,86,333440,80582,414022
231370,201705,86,69,17,64653,15929,80582
231375,201705,265,195,70,182715,65590,248305
231380,201705,409,337,72,314202.36,67276.6,381478.96
231390,201705,190,155,35,145235,32795,178030
231395,201705,717,437,280,408194.68,262360,670554.68
231400,201705,1022,845,177,789238.55,165511.9,954750.45
231410,201705,1256,1004,252,935268.8,235131.26,1170400.06
240010,201705,385,182,203,169402.54,190016,359418.54
240020,201705,2084,1587,497,1485573.07,465689,1951262.07
240030,201705,172,140,32,131180,29984,161164
240040,201705,33,33,0,30921,0,30921
240050,201705,487,414,73,386330.06,68401,454731.06
240060,201705,68,63,5,59031,4685,63716
240070,201705,152,115,37,107755,34669,142424
240080,201705,384,244,140,228624,131180,359804
240090,201705,106,94,12,87779,11244,99023
240100,201705,1395,1316,79,1230172.18,73815.49,1303987.67
240110,201705,937,583,354,544613.28,331698,876311.28
240120,201705,137,115,22,107755,20614,128369
240130,201705,282,264,18,246664.31,16866,263530.31
240140,201705,84,64,20,59968,18740,78708
240145,201705,642,563,79,527015.65,73816.86,600832.51
240150,201705,19,16,3,14992,2796.95,17788.95
240160,201705,49,40,9,37480,8433,45913
240165,201705,34,31,3,28813,2811,31624
240170,201705,85,67,18,62779,16866,79645
240180,201705,69,55,14,51535,13118,64653
240185,201705,40,37,3,34659.63,2811,37470.63
240190,201705,19,17,2,15929,1874,17803
240200,201705,2899,1621,1278,1513403.3,1196269,2709672.3
240210,201705,155,120,35,112440,32795,145235
240220,201705,1108,790,318,740230,297956.63,1038186.63
240230,201705,792,737,55,687785.68,50898,738683.68
240240,201705,142,103,39,96417.3,36543,132960.3
240250,201705,91,80,11,74960,10307,85267
240260,201705,1747,1291,456,1208992.36,426306.89,1635299.25
240270,201705,183,164,19,153293.2,17803,171096.2
240280,201705,43,33,10,30921,9370,40291
240290,201705,61,59,2,55283,1874,57157
240300,201705,171,100,71,93312,66527,159839
240310,201705,1854,1010,844,937662.66,787651.06,1725313.72
240320,201705,215,205,10,192085,9370,201455
240325,201705,4079,2483,1596,2318190.17,1493317.41,3811507.58
240330,201705,73,69,4,64653,3748,68401
240340,201705,96,69,27,64653,25299,89952
240350,201705,93,81,12,75897,11244,87141
240360,201705,331,238,93,222725,87141,309866
240370,201705,39,37,2,34669,1874,36543
240375,201705,79,47,32,44039,29984,74023
240380,201705,242,199,43,185566,40198,225764
240390,201705,19,16,3,14992,2811,17803
240400,201705,82,79,3,74023,2811,76834
240410,201705,8,6,2,5622,1874,7496
240420,201705,840,647,193,604929.07,179829.04,784758.11
240430,201705,250,236,14,219426.11,13118,232544.11
240440,201705,64,34,30,31858,28110,59968
240450,201705,180,116,64,108129.9,59968,168097.9
240460,201705,59,45,14,42165,13118,55283
240470,201705,226,192,34,179356.79,31858,211214.79
240480,201705,16,16,0,14898.3,0,14898.3
240485,201705,67,56,11,52581,10307,62888
240490,201705,50,50,0,46644,0,46644
240500,201705,84,69,15,64653,14055,78708
240510,201705,46,32,14,29984,13118,43102
240520,201705,134,128,6,119936,5622,125558
240530,201705,44,38,6,35606,5622,41228
240540,201705,81,69,12,64653,11234.63,75887.63
240550,201705,17,14,3,13118,2811,15929
240560,201705,357,260,97,243004.4,90889,333893.4
240570,201705,426,258,168,240621.6,157416,398037.6
240580,201705,1248,1007,241,937423.35,224679.6,1162102.95
240590,201705,28,26,2,24362,1874,26236
240600,201705,117,117,0,109629,0,109629
240610,201705,504,422,82,395061.01,76085,471146.01
240615,201705,41,39,2,36543,1874,38417
240620,201705,91,88,3,81519,2811,84330
240630,201705,39,37,2,34669,1874,36543
240640,201705,27,23,4,21551,3748,25299
240650,201705,223,190,33,177188,30921,208109
240660,201705,88,78,10,73086,9370,82456
240670,201705,270,157,113,145048.15,105881,250929.15
240680,201705,55,43,12,40291,11244,51535
240690,201705,50,47,3,44039,2811,46850
240700,201705,190,159,31,148983,29047,178030
240710,201705,1808,1151,657,1077832.3,613838.07,1691670.37
240720,201705,1000,729,271,682127.23,253927,936054.23
240725,201705,67,63,4,59031,3748,62779
240730,201705,129,112,17,104944,15929,120873
240740,201705,228,190,38,176690.09,35606,212296.09
240750,201705,39,24,15,22488,14055,36543
240760,201705,35,30,5,28110,4685,32795
240770,201705,142,109,33,102133,30916.32,133049.32
240780,201705,698,583,115,544575.03,107755,652330.03
240790,201705,41,39,2,36543,1874,38417
240800,201705,8236,5584,2652,5198044.11,2478788.6,7676832.71
240810,201705,19446,10623,8823,9914048.12,8257570.39,18171618.51
240820,201705,182,117,65,109343.22,60905,170248.22
240830,201705,1548,1273,275,1186112.05,256739,1442851.05
240840,201705,76,64,12,59968,11244,71212
240850,201705,88,76,12,71212,11244,82456
240860,201705,114,112,2,104944,1874,106818
240870,201705,52,45,7,42165,6559,48724
240880,201705,26,25,1,23415.63,937,24352.63
240890,201705,1077,630,447,586564.85,417898,1004462.85
240895,201705,44,33,11,30921,10307,41228
240910,201705,148,135,13,126495,12181,138676
240920,201705,17,13,4,12181,3748,15929
240930,201705,360,325,35,303588,32795,336383
240933,201705,18,14,4,13118,3748,16866
240940,201705,2386,2109,277,1966254.41,256813.36,2223067.77
240950,201705,48,47,1,44039,937,44976
240960,201705,33,26,7,24362,6559,30921
240970,201705,151,109,42,102133,38617,140750
240980,201705,171,135,36,126495,33732,160227
240990,201705,116,76,40,71212,37480,108692
241000,201705,84,75,9,70088,8433,78521
241010,201705,57,45,12,42165,11244,53409
241020,201705,117,110,7,103070,6559,109629
241025,201705,9,3,6,2811,5622,8433
241030,201705,121,98,23,91826,21551,113377
241040,201705,30,25,5,23425,4685,28110
241050,201705,96,83,13,77771,12181,89952
241060,201705,34,31,3,29047,2811,31858
241070,201705,19,19,0,17803,0,17803
241080,201705,65,57,8,53127.9,7496,60623.9
241090,201705,51,41,10,38417,9327.9,47744.9
241100,201705,73,66,7,61842,6559,68401
241105,201705,8,3,5,2811,4685,7496
241110,201705,50,47,3,44039,2811,46850
241120,201705,1363,1051,312,981855.4,291481.96,1273337.36
241140,201705,226,183,43,170535,40291,210826
241142,201705,43,42,1,39354,937,40291
241150,201705,1188,1045,143,976495.5,133991,1110486.5
241160,201705,26,24,2,22488,1874,24362
241170,201705,42,39,3,36543,2811,39354
241180,201705,49,39,10,36371.53,9370,45741.53
241190,201705,46,45,1,42165,937,43102
241200,201705,3629,2007,1622,1875131.01,1518583.64,3393714.65
241210,201705,74,59,15,55283,13212,68495
241220,201705,1326,871,455,815517.7,426316.26,1241833.96
241230,201705,237,199,38,186275.6,35606,221881.6
241240,201705,51,39,12,36543,11244,47787
241250,201705,1037,968,69,907016,64372,971388
241255,201705,39,33,6,30921,5622,36543
241260,201705,628,497,131,465684.32,122747,588431.32
241270,201705,47,32,15,29984,14055,44039
241280,201705,100,86,14,80582,13118,93700
241290,201705,103,76,27,71212,25299,96511
241300,201705,78,55,23,51535,21551,73086
241310,201705,51,40,11,37340,10307,47647
241320,201705,29,16,13,14616,12181,26797
241330,201705,58,52,6,48724,5622,54346
241335,201705,57,49,8,45913,7496,53409
241340,201705,182,137,45,128369,42165,170534
241350,201705,55,52,3,48724,2811,51535
241355,201705,42,39,3,36543,2811,39354
241360,201705,48,48,0,44976,0,44976
241370,201705,46,38,8,35606,7496,43102
241380,201705,44,42,2,39354,1874,41228
241390,201705,70,55,15,51347.6,14055,65402.6
241400,201705,188,153,35,142706,32795,175501
241410,201705,172,156,16,146172,14899,161071
241415,201705,91,72,19,67464,17803,85267
241420,201705,92,70,22,65590,20446,86036
241430,201705,31,30,1,28110,937,29047
241440,201705,437,368,69,344816,64713,409529
241445,201705,30,28,2,26236,1874,28110
241450,201705,280,228,52,213512,48724,262236
241460,201705,129,116,13,108458,12181,120639
241470,201705,47,39,8,36543,7496,44039
241475,201705,71,68,3,63716,2811,66527
241480,201705,90,66,24,61842,22488,84330
241490,201705,10,8,2,7496,1593,9089
241500,201705,50,37,13,34669,12181,46850
250010,201705,99,87,12,81519,11244,92763
250020,201705,22,18,4,16866,3748,20614
250030,201705,804,588,216,549635.1,200548.51,750183.61
250040,201705,310,261,49,244557,45913,290470
250050,201705,212,177,35,165849,32795,198644
250053,201705,55,43,12,40291,11244,51535
250057,201705,0,0,0,0,0,0
250060,201705,437,342,95,320454,89015,409469
250070,201705,666,576,90,537732,84330,622062
250073,201705,8,8,0,7496,0,7496
250077,201705,212,156,56,145788.6,52472,198260.6
250080,201705,422,326,96,303870.1,89952,393822.1
250090,201705,215,145,70,134928.2,64734.26,199662.46
250100,201705,448,366,82,342942,76460,419402
250110,201705,462,349,113,325261.6,105881,431142.6
250115,201705,29,8,21,7496,19677,27173
250120,201705,98,76,22,71212,20614,91826
250130,201705,586,461,125,431957,116938,548895
250135,201705,13,8,5,7496,4685,12181
250140,201705,72,65,7,60905,6559,67464
250150,201705,544,405,139,377358,129933.79,507291.79
250153,201705,11,10,1,9370,937,10307
250157,201705,27,22,5,20614,4685,25299
250160,201705,204,160,44,149920,41228,191148
250170,201705,68,48,20,44976,18740,63716
250180,201705,3850,2595,1255,2418583.94,1171171.35,3589755.29
250190,201705,925,598,327,558686.25,305696.25,864382.50
250200,201705,47,40,7,37480,6559,44039
250205,201705,16,14,2,13118,1874,14992
250210,201705,88,76,12,71212,11244,82456
250215,201705,61,53,8,49661,7496,57157
250220,201705,25,19,6,17803,5622,23425
250230,201705,67,62,5,58094,4685,62779
250240,201705,231,189,42,176296.55,39354,215650.55
250250,201705,389,332,57,311084,53409,364493
250260,201705,29,25,4,23425,3748,27173
250270,201705,54,43,11,40291,10307,50598
250280,201705,386,322,64,301714,59968,361682
250290,201705,89,82,7,76552.9,6559,83111.9
250300,201705,565,384,181,359172.24,169584,528756.24
250310,201705,42,36,6,33732,5622,39354
250320,201705,1835,1263,572,1178350.29,534737,1713087.29
250330,201705,77,66,11,61842,10307,72149
250340,201705,24,20,4,18740,3748,22488
250350,201705,128,81,47,75615.9,43476.8,119092.7
250355,201705,24,19,5,17803,4685,22488
250360,201705,199,162,37,151794,34435,186229
250370,201705,2295,1571,724,1466220.59,676858.71,2143079.30
250375,201705,22,18,4,16866,3748,20614
250380,201705,48,33,15,30921,14055,44976
250390,201705,33,28,5,26236,4685,30921
250400,201705,15211,7678,7533,7173815.84,7050040.66,14223856.50
250403,201705,414,340,74,318570.64,69338,387908.64
250407,201705,52,46,6,43102,5622,48724
250410,201705,27,23,4,21551,3748,25299
250415,201705,43,28,15,26236,14036.26,40272.26
250420,201705,47,38,9,35606,8433,44039
250430,201705,1662,1392,270,1302150,252990,1555140
250435,201705,13,11,2,10307,1874,12181
250440,201705,692,596,96,556120.29,89952,646072.29
250450,201705,84,70,14,65590,12462.1,78052.1
250460,201705,393,266,127,249242,118866.42,368108.42
250470,201705,91,66,25,61842,23425,85267
250480,201705,316,247,69,231439,64653,296092
250485,201705,1,1,0,937,0,937
250490,201705,204,167,37,156479,34669,191148
250500,201705,72,52,20,48724,18740,67464
250510,201705,714,546,168,510290.8,156472.26,666763.06
250520,201705,172,116,56,108673.28,52467.32,161140.60
250523,201705,108,89,19,83393,17803,101196
250527,201705,104,79,25,74018.32,23425,97443.32
250530,201705,6,5,1,4685,937,5622
250535,201705,27,22,5,20614,4685,25299
250540,201705,122,91,31,84564.25,29047,113611.25
250550,201705,69,65,4,60905,3748,64653
250560,201705,35,29,6,27173,5622,32795
250570,201705,152,120,32,112440,29984,142424
250580,201705,141,109,32,101851.9,29984,131835.9
250590,201705,17,14,3,13118,2811,15929
250600,201705,1264,857,407,800012.64,381261.32,1181273.96
250610,201705,151,130,21,121810,19677,141487
250620,201705,20,16,4,14992,3748,18740
250625,201705,57,42,15,39354,14055,53409
250630,201705,2940,1879,1061,1754225.97,993106.7,2747332.67
250640,201705,199,167,32,156479,29984,186463
250650,201705,31,21,10,19677,9370,29047
250660,201705,36,30,6,28110,5622,33732
250670,201705,51,34,17,31858,15929,47787
250680,201705,391,317,74,297029,69338,366367
250690,201705,1738,1186,552,1108064.76,516849.9,1624914.66
250700,201705,929,811,118,755525.3,110566,866091.3
250710,201705,439,338,101,316706,94637,411343
250720,201705,99,78,21,73086,19677,92763
250730,201705,363,305,58,282975,54346,337321
250740,201705,43,39,4,36543,3748,40291
250750,201705,19577,11671,7906,10879167.5,7399144.03,18278311.53
250760,201705,62,48,14,44976,13118,58094
250770,201705,339,227,112,211762.31,103796.27,315558.58
250780,201705,53,41,12,38417,11244,49661
250790,201705,493,308,185,285785.76,172642.25,458428.01
250800,201705,150,137,13,127666.25,12181,139847.25
250810,201705,81,61,20,57157,18740,75897
250820,201705,154,123,31,115251,29047,144298
250830,201705,428,286,142,266998.25,133054,400052.25
250840,201705,52,49,3,45913,2811,48724
250850,201705,48,39,9,35868.36,8433,44301.36
250855,201705,13,11,2,10307,1874,12181
250860,201705,197,143,54,133991,50316.9,184307.9
250870,201705,32,29,3,27173,2811,29984
250880,201705,72,55,17,51488.15,15929,67417.15
250890,201705,2282,1678,604,1570974.2,565100.57,2136074.77
250900,201705,49,41,8,38417,7496,45913
250905,201705,128,97,31,90889,29047,119936
250910,201705,1142,812,330,759429.14,308928.9,1068358.04
250915,201705,108,74,34,69338,31858,101196
250920,201705,136,103,33,96511,30921,127432
250930,201705,149,93,56,87141,52472,139613
250933,201705,0,0,0,0,0,0
250937,201705,8,7,1,6559,937,7496
250939,201705,31,24,7,22488,6559,29047
250940,201705,99,71,28,66527,26236,92763
250950,201705,74,50,24,46850,22488,69338
250960,201705,90,49,41,45892.89,38417,84309.89
250970,201705,1177,829,348,775181,325794.9,1100975.9
250980,201705,87,61,26,57157,24362,81519
250990,201705,159,122,37,113878.35,34640.9,148519.25
251000,201705,72,66,6,61654.6,5622,67276.6
251010,201705,89,70,19,65586,17038.4,82624.4
251020,201705,77,67,10,61982.55,9370,71352.55
251030,201705,40,30,10,28110,9370,37480
251040,201705,52,36,16,33732,14992,48724
251050,201705,25,23,2,21551,1874,23425
251060,201705,45,36,9,32795,8433,41228
251065,201705,4,3,1,2811,937,3748
251070,201705,26,20,6,18731,5622,24353
251080,201705,4615,2242,2373,2087654.78,2216994.2,4304648.98
251090,201705,202,173,29,162101,27173,189274
251100,201705,17,16,1,14992,937,15929
251110,201705,42,33,9,30921,8433,39354
251120,201705,1742,1030,712,960141.2,667144,1627285.2
251130,201705,337,273,64,255801,59968,315769
251140,201705,481,308,173,287473,161935.34,449408.34
251150,201705,286,248,38,231618,35606,267224
251160,201705,88,71,17,66523,15929,82452
251170,201705,100,78,22,73057.92,20604.64,93662.56
251180,201705,285,177,108,165849,101187.32,267036.32
251190,201705,190,132,58,123361.68,54346,177707.68
251200,201705,247,196,51,183652,47787,231439
251203,201705,28,26,2,24362,1874,26236
251207,201705,90,74,16,69338,14992,84330
251210,201705,1192,841,351,786490.89,328231.1,1114721.99
251220,201705,46,36,10,33732,9370,43102
251230,201705,510,434,76,406638,71212,477850
251240,201705,104,72,32,66527,29984,96511
251250,201705,1281,913,368,853373.1,344676,1198049.1
251260,201705,13,8,5,7496,4685,12181
251270,201705,333,246,87,230502,81379,311881
251272,201705,71,65,6,60905,5622,66527
251274,201705,25,20,5,18740,4685,23425
251275,201705,20,14,6,13118,5622,18740
251276,201705,17,14,3,13118,2811,15929
251278,201705,9,7,2,6559,1874,8433
251280,201705,83,79,4,74023,3748,77771
251290,201705,704,530,174,496610,163038,659648
251300,201705,17,15,2,14055,1874,15929
251310,201705,345,247,98,231435,91826,323261
251315,201705,15,14,1,13118,937,14055
251320,201705,59,46,13,43102,12181,55283
251330,201705,77,68,9,63716,8433,72149
251335,201705,9,5,4,4685,3748,8433
251340,201705,679,408,271,382296,252920.63,635216.63
251350,201705,33,31,2,29047,1874,30921
251360,201705,64,55,9,51332.61,8433,59765.61
251365,201705,15,15,0,14055,0,14055
251370,201705,5133,3467,1666,3242361.39,1559450.5,4801811.89
251380,201705,49,39,10,36543,9370,45913
251385,201705,2,2,0,1874,0,1874
251390,201705,614,495,119,462691.6,110285,572976.6
251392,201705,28,17,11,15929,10307,26236
251394,201705,10,9,1,8433,937,9370
251396,201705,20,15,5,14055,4685,18740
251398,201705,17,15,2,14055,1874,15929
251400,201705,34,28,6,26236,5622,31858
251410,201705,32,28,4,26236,3748,29984
251420,201705,106,81,25,75897,23425,99322
251430,201705,35,33,2,30921,1874,32795
251440,201705,39,25,14,23416,13118,36534
251445,201705,43,38,5,35606,4685,40291
251450,201705,401,354,47,330072.4,44039,374111.4
251455,201705,2,1,1,937,937,1874
251460,201705,16,12,4,11244,3748,14992
251465,201705,6,3,3,2811,2811,5622
251470,201705,45,36,9,33732,8433,42165
251480,201705,24,22,2,20614,1874,22488
251490,201705,131,92,39,85736,35607,121343
251500,201705,111,91,20,85267,17991,103258
251510,201705,29,22,7,20614,6559,27173
251520,201705,22,22,0,20614,0,20614
251530,201705,4577,3197,1380,2990919.09,1292769.53,4283688.62
251540,201705,75,67,8,62779,7496,70275
251550,201705,422,322,100,300777.6,93466,394243.6
251560,201705,24,19,5,17803,4685,22488
251570,201705,17,17,0,15929,0,15929
251580,201705,115,93,22,87141,20614,107755
251590,201705,129,94,35,88078,32795,120873
251593,201705,19,11,8,10307,7496,17803
251597,201705,58,47,11,44039,10307,54346
251600,201705,1085,768,317,718304.94,295332.26,1013637.20
251610,201705,208,157,51,146453.1,47132,193585.1
251615,201705,1,1,0,937,0,937
251620,201705,4183,2798,1385,2613420.07,1295310.34,3908730.41
251630,201705,419,302,117,282974,109629,392603
251640,201705,149,103,46,96511,43102,139613
251650,201705,254,186,68,172483.55,63716,236199.55
251660,201705,217,199,18,185526.55,16866,202392.55
251670,201705,340,268,72,249552.07,67464,317016.07
251675,201705,3,3,0,2811,0,2811
251680,201705,85,79,6,74023,5622,79645
251690,201705,331,275,56,257675,52128.13,309803.13
251700,201705,281,229,52,213996.75,48709.95,262706.70
251710,201705,18,12,6,11244,5622,16866
251720,201705,33,22,11,20614,10026,30640
251740,201705,10,8,2,7496,1874,9370
260005,201705,3043,1727,1316,1607837.62,1231011.55,2838849.17
260010,201705,1259,894,365,834515.76,340787.56,1175303.32
260020,201705,429,378,51,354186,47787,401973
260030,201705,559,405,154,378731.65,144298,523029.65
260040,201705,853,522,331,488036.45,310137.63,798174.08
260050,201705,1116,781,335,731563,313333,1044896
260060,201705,414,371,43,346877.4,40291,387168.4
260070,201705,1384,881,503,821466,468390.58,1289856.58
260080,201705,731,570,161,532872.55,150857,683729.55
260090,201705,561,346,215,323977.86,201455,525432.86
260100,201705,221,154,67,143314.6,62779,206093.6
260105,201705,241,133,108,124621,101196,225817
260110,201705,2615,1948,667,1825257.63,624183,2449440.63
260120,201705,2851,1574,1277,1464249.41,1194302.55,2658551.96
260130,201705,144,98,46,91826,43102,134928
260140,201705,2000,1299,701,1209759.25,655320.63,1865079.88
260150,201705,236,151,85,141487,79645,221132
260160,201705,282,245,37,229565,34669,264234
260170,201705,3213,1977,1236,1844882.24,1157054.45,3001936.69
260180,201705,126,109,17,102133,15929,118062
260190,201705,2265,1616,649,1511098.03,608113,2119211.03
260200,201705,867,717,150,671067.24,140269,811336.24
260210,201705,1406,965,441,904056.96,412927,1316983.96
260220,201705,685,629,56,588601,52472,641073
260230,201705,1176,890,286,831778.15,267982,1099760.15
260240,201705,206,151,55,140334.49,51535,191869.49
260250,201705,66,53,13,49661,12181,61842
260260,201705,955,683,272,639971,254864,894835
260270,201705,437,355,82,331417.1,76552.9,407970.0
260280,201705,919,703,216,658523.6,201830,860353.6
260290,201705,6269,3290,2979,3063156.61,2785183.06,5848339.67
260300,201705,786,688,98,642351.23,91545,733896.23
260310,201705,484,381,103,354987.13,96511,451498.13
260320,201705,891,668,223,625820,208951,834771
260330,201705,28,22,6,20614,5622,26236
260340,201705,63,46,17,43102,15929,59031
260345,201705,5417,3084,2333,2883266.92,2184768.01,5068034.93
260350,201705,459,336,123,313119.16,114315,427434.16
260360,201705,294,152,142,142424,133054,275478
260370,201705,614,396,218,369225.7,204129,573354.7
260380,201705,594,427,167,400099,155355.14,555454.14
260390,201705,287,244,43,227452.19,39354,266806.19
260392,201705,88,77,11,72149,10307,82456
260400,201705,4075,2319,1756,2162758.2,1645016.41,3807774.61
260410,201705,13839,7514,6325,7026032.06,5923842.5,12949874.56
260415,201705,122,107,15,100259,14055,114314
260420,201705,1784,1039,745,968209.55,695677,1663886.55
260430,201705,193,176,17,163721.14,15929,179650.14
260440,201705,225,163,62,151458,58094,209552
260450,201705,477,338,139,315444,130243,445687
260460,201705,850,450,400,419028.4,374795.32,793823.72
260470,201705,366,220,146,205390.4,135912.55,341302.95
260480,201705,201,122,79,114314,74023,188337
260490,201705,203,163,40,152731,37480,190211
260500,201705,1112,737,375,687900,349642,1037542
260510,201705,712,557,155,521909,144298,666207
260515,201705,255,225,30,210825,27642,238467
260520,201705,3250,1899,1351,1771761.23,1264004.21,3035765.44
260530,201705,729,592,137,551935.31,128369,680304.31
260540,201705,583,431,152,403847,141487.66,545334.66
260545,201705,14,10,4,9370,3748,13118
260550,201705,327,201,126,188337,118062,306399
260560,201705,507,387,120,362039,112158.9,474197.9
260570,201705,1008,835,173,779444.9,162101,941545.9
260580,201705,289,255,34,238935,31858,270793
260590,201705,633,359,274,334996.24,256738,591734.24
260600,201705,7911,4031,3880,3756255.86,3632021.32,7388277.18
260610,201705,492,325,167,304525,156479,461004
260620,201705,3457,1820,1637,1696173.1,1528970.94,3225144.04
260630,201705,71,68,3,63716,2811,66527
260640,201705,3546,1923,1623,1798593.24,1520405.05,3318998.29
260650,201705,337,231,106,216447,99279.85,315726.85
260660,201705,491,336,155,314457.2,144344.85,458802.05
260670,201705,101,76,25,71212,23425,94637
260680,201705,3672,2024,1648,1879690.95,1542247.52,3421938.47
260690,201705,191,153,38,142705.1,35606,178311.1
260700,201705,351,206,145,192272.4,135048,327320.4
260710,201705,40,38,2,35606,1874,37480
260720,201705,2184,1305,879,1217002.23,822845.29,2039847.52
260730,201705,579,441,138,413217,127432.45,540649.45
260740,201705,66,62,4,58094,3748,61842
260750,201705,646,444,202,416028,189274,605302
260760,201705,628,343,285,321391,266715,588106
260765,201705,954,497,457,462799.9,427974.75,890774.65
260770,201705,216,160,56,149920,52472,202392
260775,201705,817,484,333,451531.3,312021,763552.3
260780,201705,262,166,96,155542,89820.82,245362.82
260790,201705,12314,6747,5567,6292717.96,5209134.64,11501852.60
260795,201705,143,98,45,90682.86,42165,132847.86
260800,201705,363,300,63,280351,59031,339382
260805,201705,200,128,72,119220.13,67464,186684.13
260810,201705,735,642,93,600326.53,87141,687467.53
260820,201705,311,204,107,189842,100259,290101
260825,201705,192,132,60,123313.71,56220,179533.71
260830,201705,256,163,93,152590.45,87141,239731.45
260840,201705,218,157,61,145849,56876,202725
260845,201705,208,144,64,134928,59968,194896
260850,201705,513,370,143,345055.64,133991,479046.64
260860,201705,249,185,64,173150.86,59968,233118.86
260870,201705,369,259,110,242683,103070,345753
260875,201705,665,458,207,428052.53,193959,622011.53
260880,201705,1370,893,477,836035.31,446761.6,1282796.91
260890,201705,2437,1702,735,1587896.63,687759,2275655.63
260900,201705,1045,701,344,655558.95,322328,977886.95
260910,201705,273,215,58,201455,54346,255801
260915,201705,307,201,106,188337,99202,287539
260920,201705,164,94,70,88078,65590,153668
260930,201705,394,335,59,313895,55226.85,369121.85
260940,201705,2626,1442,1184,1347220.55,1108659,2455879.55
260950,201705,1861,1090,771,1015127.45,722427,1737554.45
260960,201705,14245,7397,6848,6896951.73,6408930.57,13305882.30
260970,201705,422,364,58,341068,54346,395414
260980,201705,202,174,28,162748,26236,188984
260990,201705,2477,2040,437,1910984.01,409469,2320453.01
261000,201705,4311,2491,1820,2322116.25,1702810.9,4024927.15
261010,201705,186,134,52,125558,47920.8,173478.8
261020,201705,615,452,163,423384,152731,576115
261030,201705,206,148,58,138676,54317.9,192993.9
261040,201705,357,322,35,301714,32513.9,334227.9
261050,201705,456,400,56,374800,52472,427272
261060,201705,1295,845,450,789657.88,421650,1211307.88
261070,201705,8870,4548,4322,4234915.91,4041394.09,8276310.00
261080,201705,390,294,96,275478,89952,365430
261090,201705,2116,1631,485,1520684.92,453696,1974380.92
261100,201705,1053,747,306,698112.8,285410.2,983523.0
261110,201705,7718,4689,3029,4388351.93,2834973.95,7223325.88
261120,201705,280,236,44,220851,41224,262075
261130,201705,571,319,252,298575.45,236124,534699.45
261140,201705,187,121,66,113377,61842,175219
261150,201705,656,381,275,355788.77,257675,613463.77
261153,201705,70,67,3,61842.12,2811,64653.12
261160,201705,75538,38375,37163,35838794.13,34799889.49,70638683.62
261170,201705,460,339,121,317362,113377,430739
261180,201705,1747,1061,686,988994.53,642782,1631776.53
261190,201705,622,424,198,397035.89,185507.63,582543.52
261200,201705,212,187,25,174514.09,23425,197939.09
261210,201705,29,26,3,24362,2811,27173
261220,201705,2382,1681,701,1569571.11,655713,2225284.11
261230,201705,318,236,82,220663.5,76819.95,297483.45
261240,201705,433,370,63,342748.47,59031,401779.47
261245,201705,204,169,35,158353,32795,191148
261247,201705,131,96,35,89952,32795,122747
261250,201705,2728,1333,1395,1247521.9,1306305.71,2553827.61
261255,201705,247,226,21,211762,19677,231439
261260,201705,816,705,111,660585,104007,764592
261270,201705,169,131,38,122747,35606,158353
261280,201705,138,111,27,104007,25299,129306
261290,201705,135,92,43,85969.75,40291,126260.75
261300,201705,1213,852,361,797490.44,338257,1135747.44
261310,201705,729,490,239,459130,223333.95,682463.95
261320,201705,519,350,169,327950,158353,486303
261330,201705,775,625,150,582681.25,139719.53,722400.78
261340,201705,325,176,149,164912,139613,304525
261350,201705,731,518,213,484429.1,199541,683970.1
261360,201705,1127,717,410,671434.53,384170,1055604.53
261370,201705,4824,2968,1856,2767829.62,1737689.2,4505518.82
261380,201705,574,412,162,384179.92,151513,535692.92
261390,201705,3304,2207,1097,2063321.22,1024789.53,3088110.75
261400,201705,283,258,25,240902.8,23425,264327.8
261410,201705,1007,665,342,623105,320449.32,943554.32
261420,201705,857,532,325,496583.63,304506.63,801090.26
261430,201705,331,299,32,279332,29702.9,309034.9
261440,201705,88,77,11,72149,10307,82456
261450,201705,2477,2055,422,1923297.53,395154.51,2318452.04
261460,201705,683,546,137,510665.81,128369,639034.81
261470,201705,233,180,53,167864,49661,217525
261480,201705,321,261,60,243434,56216,299650
261485,201705,333,204,129,190492.1,120873,311365.1
261500,201705,618,414,204,387918,191148,579066
261510,201705,40,26,14,24362,13118,37480
261520,201705,168,155,13,144299,12181,156480
261530,201705,4132,2616,1516,2443233.99,1419260.95,3862494.94
261540,201705,1057,641,416,600139.13,389792,989931.13
261550,201705,282,138,144,127948,134928,262876
261560,201705,749,499,250,465128.1,232835.8,697963.9
261570,201705,353,277,76,259549,71212,330761
261580,201705,373,289,84,270046,78708,348754
261590,201705,183,149,34,139613,31858,171471
261600,201705,277,227,50,211950,46382,258332
261610,201705,101,87,14,81171,13118,94289
261618,201705,64,50,14,46850,13118,59968
261620,201705,211,125,86,117125,80582,197707
261630,201705,586,448,138,417459.8,129119,546578.8
261640,201705,6074,3209,2865,2998480.75,2681704.26,5680185.01
261650,201705,476,290,186,271064.73,174282,445346.73
270010,201705,500,435,65,407595,60156,467751
270020,201705,310,243,67,226937.4,62779,289716.4
270030,201705,8952,5704,3248,5330665.78,3040887.8,8371553.58
270040,201705,1767,1073,694,1005297.94,649996.9,1655294.84
270050,201705,187,136,51,127432,47787,175219
270060,201705,119,66,53,61842,49661,111503
270070,201705,918,651,267,608306.26,248933.16,857239.42
270080,201705,44,37,7,34669,6559,41228
270090,201705,20,16,4,14992,3748,18740
270100,201705,1309,847,462,789784.28,429850.12,1219634.40
270110,201705,170,123,47,115251,44039,159290
270120,201705,217,177,40,165012.72,37198.9,202211.62
270130,201705,263,178,85,166504.9,79363.9,245868.8
270135,201705,101,59,42,55283,39354,94637
270140,201705,1225,715,510,669578.08,475426.26,1145004.34
270150,201705,274,218,56,204266,52472,256738
270160,201705,515,375,140,351375,131180,482555
270170,201705,660,410,250,382577.1,233453.55,616030.65
270180,201705,67,50,17,46537.7,15722.86,62260.56
270190,201705,104,90,14,84330,13118,97448
270200,201705,109,99,10,92575.6,9370,101945.6
270210,201705,498,255,243,238935,227409.9,466344.9
270220,201705,204,162,42,151794,39354,191148
270230,201705,2021,1193,828,1111310.96,773049.94,1884360.90
270235,201705,738,546,192,511274.55,179545.48,690820.03
270240,201705,3043,2335,708,2178178.07,660090.9,2838268.97
270250,201705,172,122,50,113564.4,46850,160414.4
270255,201705,218,192,26,179904,23987.2,203891.2
270260,201705,316,253,63,236564,58749.9,295313.9
270270,201705,121,49,72,45904,67464,113368
270280,201705,221,141,80,132117,74960,207077
270290,201705,1129,841,288,786677.59,268975.89,1055653.48
270300,201705,260,165,95,154605,88733.9,243338.9
270310,201705,949,746,203,697090.28,189508.99,886599.27
270320,201705,903,760,143,710006.8,133991,843997.8
270330,201705,255,208,47,193959,44039,237998
270340,201705,60,47,13,44039,12181,56220
270350,201705,92,47,45,44039,42165,86204
270360,201705,81,42,39,39354,36543,75897
270370,201705,53,38,15,35606,14055,49661
270375,201705,63,36,27,33732,25295,59027
270380,201705,1063,578,485,540649,454445,995094
270390,201705,201,105,96,98385,89952,188337
270400,201705,686,492,194,459789.8,181769,641558.8
270410,201705,718,505,213,473175.63,199571.63,672747.26
270420,201705,381,242,139,225087,130160.89,355247.89
270430,201705,31503,22332,9171,20874249.03,8582852.83,29457101.86
270440,201705,500,389,111,363509.55,104007,467516.55
270450,201705,768,382,386,357699.75,360745.73,718445.48
270460,201705,204,145,59,135865,55283,191148
270470,201705,1314,861,453,806408.95,424237,1230645.95
270480,201705,497,393,104,365776.89,96745.25,462522.14
270490,201705,25,19,6,17803,5622,23425
270500,201705,514,413,101,386981,94637,481618
270510,201705,735,448,287,419776,268919,688695
270520,201705,418,252,166,235777.45,155542,391319.45
270530,201705,66,57,9,53409,8433,61842
270540,201705,128,97,31,90889,29047,119936
270550,201705,1725,1295,430,1211846.37,402811.62,1614657.99
270560,201705,327,148,179,138676,167723,306399
270570,201705,423,264,159,246552.73,148983,395535.73
270580,201705,71,49,22,45913,20614,66527
270590,201705,83,69,14,64653,13097.89,77750.89
270600,201705,177,144,33,134928,30921,165849
270610,201705,164,128,36,119927,33732,153659
270620,201705,33,32,1,29984,937,30921
270630,201705,3800,2876,924,2683573.86,863671.38,3547245.24
270640,201705,890,640,250,597075.3,233941.9,831017.2
270642,201705,194,163,31,152731,29047,181778
270644,201705,298,200,98,187212.97,91821.32,279034.29
270650,201705,233,138,95,129306,89015,218321
270660,201705,259,207,52,193959,48724,242683
270670,201705,3165,2384,781,2223549.94,729633.12,2953183.06
270680,201705,453,259,194,242674,181773.32,424447.32
270690,201705,1212,740,472,691678.24,442254.63,1133932.87
270700,201705,37,29,8,27173,7496,34669
270710,201705,848,622,226,581227.86,211762,792989.86
270720,201705,252,187,65,175219,60623.9,235842.9
270730,201705,1777,1017,760,951665.2,710051.6,1661716.8
270740,201705,47,29,18,27173,16866,44039
270750,201705,623,450,173,421650,161446,583096
270760,201705,312,228,84,213636,78708,292344
270770,201705,2675,1649,1026,1537168.16,960425,2497593.16
270780,201705,92,56,36,52467.32,33714.64,86181.96
270790,201705,285,191,94,178967,88078,267045
270800,201705,1980,1554,426,1455274.12,398431.14,1853705.26
270810,201705,319,250,69,234235.95,64644.32,298880.27
270820,201705,156,98,58,91826,54253,146079
270830,201705,1030,740,290,692631,271730,964361
270840,201705,1404,1011,393,946815.2,367305,1314120.2
270850,201705,1760,1065,695,993267.95,651182.58,1644450.53
270860,201705,2431,1559,872,1456580.3,815117.11,2271697.41
270870,201705,124,68,56,63716,52472,116188
270880,201705,909,645,264,601794.93,246482.49,848277.42
270890,201705,380,277,103,259267.9,96506.32,355774.22
270895,201705,74,61,13,57157,12181,69338
270900,201705,112,90,22,84330,20614,104944
270910,201705,337,263,74,245306.6,69338,314644.6
270915,201705,1751,1017,734,948088.94,687266.57,1635355.51
270920,201705,501,413,88,386981,82456,469437
270930,201705,6228,4437,1791,4152030.57,1676342.62,5828373.19
270940,201705,2411,1811,600,1695721.69,561245,2256966.69
280010,201705,43,39,4,36543,3748,40291
280020,201705,699,598,101,558421.31,93700,652121.31
280030,201705,18450,11751,6699,10935350.16,6246898.85,17182249.01
280040,201705,345,218,127,204266,117593.5,321859.5
280050,201705,374,284,90,265826.9,84330,350156.9
280060,201705,314,209,105,193657.48,98385,292042.48
280067,201705,984,685,299,639137.26,279226.12,918363.38
280070,201705,126,104,22,97448,20614,118062
280100,201705,597,467,130,433571.88,121623,555194.88
280110,201705,77,70,7,65590,6559,72149
280120,201705,612,485,127,453648.55,118999,572647.55
280130,201705,1275,777,498,726503.9,466485.45,1192989.35
280140,201705,468,370,98,345846.7,91826,437672.7
280150,201705,307,222,85,207346.21,78708,286054.21
280160,201705,97,82,15,76834,14055,90889
280170,201705,566,374,192,349501.68,179107.55,528609.23
280190,201705,29,26,3,24362,2811,27173
280200,201705,16,11,5,10307,4685,14992
280210,201705,2687,1885,802,1749692.04,746277.19,2495969.23
280220,201705,38,30,8,28110,7496,35606
280230,201705,296,243,53,226871.95,48724.1,275596.05
280240,201705,109,103,6,96371,5622,101993
280250,201705,23,13,10,12181,9370,21551
280260,201705,78,70,8,65590,7496,73086
280270,201705,155,118,37,110566,34669,145235
280280,201705,201,127,74,118999,69338,188337
280290,201705,2949,2132,817,1983608.28,763960.63,2747568.91
280300,201705,1060,802,258,750537,240996.4,991533.4
280310,201705,103,97,6,90702,5622,96324
280320,201705,636,428,208,401027,194896,595923
280330,201705,362,255,107,237574.29,100137.19,337711.48
280340,201705,398,317,81,295584.05,75148,370732.05
280350,201705,3309,2553,756,2383026.36,706617.46,3089643.82
280360,201705,465,295,170,276415,158353,434768
280370,201705,90,78,12,73086,11244,84330
280380,201705,55,41,14,38417,13118,51535
280390,201705,178,147,31,137739,29047,166786
280400,201705,314,216,98,201549.4,91826,293375.4
280410,201705,286,227,59,211557,55273.63,266830.63
280420,201705,171,143,28,133991,26236,160227
280430,201705,106,78,28,73086,26236,99322
280440,201705,654,494,160,457866.8,149432.76,607299.56
280445,201705,115,106,9,99322,8433,107755
280450,201705,1024,875,149,817101.48,139613,956714.48
280460,201705,703,504,199,465460.88,186463,651923.88
280470,201705,191,173,18,162101,15930,178031
280480,201705,2176,1553,623,1442352.19,579993.54,2022345.73
280490,201705,379,346,33,323058,30921,353979
280500,201705,54,48,6,44976,5622,50598
280510,201705,139,106,33,99024.6,30640,129664.6
280520,201705,56,41,15,38417,14055,52472
280530,201705,72,53,19,49661,17803,67464
280540,201705,492,387,105,362619,98103.9,460722.9
280550,201705,688,636,52,593362.3,48724,642086.3
280560,201705,464,397,67,369833.9,62779,432612.9
280570,201705,1721,1298,423,1212941.42,396351,1609292.42
280580,201705,591,447,144,418700,134835,553535
280590,201705,168,102,66,95299.46,61842,157141.46
280600,201705,343,289,54,269125.54,50598,319723.54
280610,201705,141,102,39,95372,36543,131915
280620,201705,554,446,108,416965,101055.45,518020.45
280630,201705,167,138,29,129306,27173,156479
280640,201705,200,155,45,144421,42165,186586
280650,201705,85,54,31,50598,29047,79645
280660,201705,125,92,33,86204,30686.75,116890.75
280670,201705,1485,927,558,862578.63,519168.98,1381747.61
280680,201705,178,150,28,138798.62,26236,165034.62
280690,201705,40,33,7,30921,6559,37480
280700,201705,16,16,0,14992,0,14992
280710,201705,1398,1031,367,958442.29,343223.1,1301665.39
280720,201705,108,72,36,64949.7,33732,98681.7
280730,201705,23,18,5,16866,4685,21551
280740,201705,2289,1665,624,1556289.82,582946.07,2139235.89
280750,201705,288,247,41,231439,38417,269856
280760,201705,847,573,274,535776.6,256597.45,792374.05
290010,201705,180,116,64,108692,59968,168660
290020,201705,174,161,13,150857,12181,163038
290030,201705,575,370,205,346034.1,192085,538119.1
290035,201705,137,109,28,98985.8,26236,125221.8
290040,201705,266,166,100,155542,93700,249242
290050,201705,68,50,18,46850,16866,63716
290060,201705,261,113,148,105599.9,138676,244275.9
290070,201705,5393,2608,2785,2436390.07,2606130.85,5042520.92
290080,201705,522,235,287,219707.76,268901,488608.76
290090,201705,380,161,219,150857,205203,356060
290100,201705,1555,1022,533,952557.05,498858.9,1451415.95
290110,201705,716,424,292,395695.1,273229.3,668924.4
290115,201705,210,191,19,178030,17803,195833
290120,201705,776,508,268,475340.1,251116,726456.1
290130,201705,423,243,180,227400.53,167909,395309.53
290135,201705,288,221,67,206411.73,62779,269190.73
290140,201705,280,231,49,215510,45913,261423
290150,201705,132,95,37,89015,34669,123684
290160,201705,249,193,56,179623.05,52472,232095.05
290170,201705,86,57,29,53409,27173,80582
290180,201705,148,116,32,108692,29984,138676
290190,201705,449,366,83,342661,77490,420151
290195,201705,283,153,130,143361,121810,265171
290200,201705,289,247,42,231439,39354,270793
290205,201705,134,77,57,72149,53409,125558
290210,201705,1068,784,284,733484.6,266108,999592.6
290220,201705,220,120,100,111971.5,93700,205671.5
290225,201705,273,103,170,96511,159290,255801
290230,201705,63,40,23,37480,21551,59031
290240,201705,296,121,175,113095.9,163975,277070.9
290250,201705,256,229,27,213702,25299,239001
290260,201705,256,220,36,205391,33732,239123
290265,201705,182,146,36,135999,33732,169731
290270,201705,1361,1111,250,1038899,233403,1272302
290280,201705,464,342,122,320454,114314,434768
290290,201705,1144,656,488,611061.61,457256,1068317.61
290300,201705,451,381,70,356477.07,65590,422067.07
290310,201705,320,141,179,132117,167723,299840
290320,201705,3838,2406,1432,2251768.46,1338973.5,3590741.96
290323,201705,177,154,23,144017,21551,165568
290327,201705,139,109,30,101865.96,28110,129975.96
290330,201705,61,34,27,31858,25299,57157
290340,201705,911,358,553,334450.88,517538.79,851989.67
290350,201705,548,329,219,307805,205203,513008
290360,201705,360,270,90,251116.86,84330,335446.86
290370,201705,1005,370,635,346409,594995,941404
290380,201705,294,179,115,167723,107755,275478
290390,201705,2414,1495,919,1397239.57,859136,2256375.57
290395,201705,239,132,107,123450,100259,223709
290400,201705,281,205,76,191523,71212,262735
290405,201705,252,214,38,200518,35606,236124
290410,201705,529,452,77,420573.9,72149,492722.9
290420,201705,224,171,53,160227,49661,209888
290430,201705,503,314,189,294218,177093,471311
290440,201705,70,61,9,57157,7808.3,64965.3
290450,201705,228,175,53,163975,49661,213636
290460,201705,1821,1075,746,1006356.52,698815.56,1705172.08
290470,201705,1444,601,843,561725.17,789569.71,1351294.88
290475,201705,583,546,37,510900,34669,545569
290480,201705,281,152,129,142424,120873,263297
290485,201705,205,191,14,178874,13118,191992
290490,201705,1089,783,306,732921.4,285785.6,1018707.0
290500,201705,649,321,328,300777,307336,608113
290510,201705,207,153,54,142425,50598,193023
290515,201705,128,72,56,67464,52472,119936
290520,201705,1320,839,481,784550.61,446922.7,1231473.31
290530,201705,306,280,26,262360,24362,286722
290540,201705,92,58,34,54346,31858,86204
290550,201705,151,129,22,120873,20267.31,141140.31
290560,201705,3352,1337,2015,1251748.04,1887864.4,3139612.44
290570,201705,5587,2836,2751,2654683.69,2575039.39,5229723.08
290580,201705,1230,698,532,652568.97,498484,1151052.97
290590,201705,527,435,92,406565,86204,492769
290600,201705,1667,1160,507,1083267.08,474777.9,1558044.98
290610,201705,218,196,22,182922,20614,203536
290620,201705,309,269,40,252053,37480,289533
290630,201705,2098,886,1212,826435,1130120.47,1956555.47
290640,201705,145,117,28,109629,26236,135865
290650,201705,1650,771,879,721481.42,823623,1545104.42
290660,201705,262,212,50,198644,46850,245494
290670,201705,970,513,457,480400,427854.9,908254.9
290680,201705,1131,920,211,861103,196770,1057873
290682,201705,279,204,75,190241.15,70256.63,260497.78
290685,201705,227,146,81,135865,75897,211762
290687,201705,895,588,307,547629.7,285663.29,833292.99
290689,201705,108,65,43,60891,40276.95,101167.95
290690,201705,687,283,404,265162,377694.77,642856.77
290700,201705,259,120,139,112440,130243,242683
290710,201705,663,429,234,401973,219258,621231
290720,201705,1012,825,187,773025,174750.5,947775.5
290730,201705,1122,639,483,596915.85,451634,1048549.85
290740,201705,14,11,3,10307,2811,13118
290750,201705,1317,594,723,556205.83,675377.06,1231582.89
290755,201705,68,60,8,56220,7496,63716
290760,201705,300,264,36,247368,33732,281100
290770,201705,182,171,11,160217.63,10307,170524.63
290780,201705,918,739,179,690534.23,165942.7,856476.93
290790,201705,431,292,139,273035,130243,403278
290800,201705,2611,1029,1582,961105.07,1481237.71,2442342.78
290810,201705,428,296,132,277071,123684,400755
290820,201705,367,226,141,210099.91,132117,342216.91
290830,201705,382,256,126,239872,118062,357934
290840,201705,1599,973,626,910155.4,583582.44,1493737.84
290850,201705,735,406,329,379391.3,307336,686727.3
290860,201705,660,291,369,272667,345472,618139
290870,201705,654,474,180,443220,168660,611880
290880,201705,126,68,58,63716,54346,118062
290890,201705,362,262,100,245494,93700,339194
290900,201705,161,127,34,118999,31858,150857
290910,201705,360,275,85,257675,79645,337320
290920,201705,230,191,39,178967,36543,215510
290930,201705,787,600,187,561422.29,175219,736641.29
290940,201705,253,207,46,193209.4,43102,236311.4
290950,201705,166,93,73,87141,68401,155542
290960,201705,428,285,143,266108.82,133709.9,399818.72
290970,201705,246,217,29,203141.6,27173,230314.6
290980,201705,1442,1021,421,952602.02,393447.1,1346049.12
290990,201705,363,303,60,283902,56164.89,340066.89
291000,201705,837,236,601,221132,562855.9,783987.9
291005,201705,1941,826,1115,772219.28,1044460.32,1816679.60
291010,201705,158,145,13,135865,12181,148046
291020,201705,99,81,18,75897,16866,92763
291030,201705,86,66,20,61842,18740,80582
291040,201705,574,285,289,267035.63,270793,537828.63
291050,201705,1255,711,544,664935.92,509728,1174663.92
291060,201705,1442,772,670,723364,627790,1351154
291070,201705,1860,1375,485,1282801.5,450802.18,1733603.68
291072,201705,7168,2607,4561,2439732.28,4271112.7,6710844.98
291075,201705,190,152,38,142424,35606,178030
291077,201705,46,31,15,29047,14055,43102
291080,201705,18638,8115,10523,7582202.97,9847554.92,17429757.89
291085,201705,280,226,54,211762,50593.32,262355.32
291090,201705,308,112,196,104663,183642.63,288305.63
291100,201705,729,212,517,198644,484419.63,683063.63
291110,201705,391,299,92,280163,86204,366367
291120,201705,2510,1162,1348,1088654,1261128.08,2349782.08
291125,201705,58,31,27,29047,25299,54346
291130,201705,206,178,28,166786,26236,193022
291140,201705,116,83,33,77771,30921,108692
291150,201705,367,150,217,140550,203329,343879
291160,201705,332,280,52,261423.25,48724,310147.25
291165,201705,13,10,3,9370,2811,12181
291170,201705,2756,1401,1355,1310301.45,1267199,2577500.45
291180,201705,1300,487,813,456181,761727,1217908
291185,201705,67,64,3,59968,2811,62779
291190,201705,1197,507,690,473553.5,645996.9,1119550.4
291200,201705,159,115,44,107755,41228,148983
291210,201705,2150,815,1335,760572.27,1249124.54,2009696.81
291220,201705,244,185,59,172408.43,55283,227691.43
291230,201705,1020,341,679,318674,636223,954897
291240,201705,440,416,24,388574,22488,411062
291250,201705,417,341,76,319517,71212,390729
291260,201705,36,25,11,23425,10307,33732
291270,201705,1180,473,707,443201,662177.9,1105378.9
291280,201705,369,162,207,151606.6,193648.53,345255.13
291290,201705,1714,866,848,810317.6,793827,1604144.6
291300,201705,227,179,48,167067.1,44976,212043.1
291310,201705,246,219,27,204922,25299,230221
291320,201705,1373,985,388,919852.9,362526.8,1282379.7
291330,201705,127,105,22,96604.7,20614,117218.7
291340,201705,137,78,59,73086,55283,128369
291345,201705,120,82,38,76834,35606,112440
291350,201705,1520,469,1051,438984.6,984600.15,1423584.75
291360,201705,8402,4137,4265,3867391.03,3993351.28,7860742.31
291370,201705,1036,558,478,522565,447886,970451
291380,201705,256,204,52,191148,48724,239872
291390,201705,3816,1661,2155,1552339.25,2019235,3571574.25
291400,201705,2022,1436,586,1339537.79,547148.39,1886686.18
291410,201705,157,140,17,130243,15929,146172
291420,201705,99,70,29,65590,27173,92763
291430,201705,181,100,81,93004.74,74960,167964.74
291440,201705,488,393,95,365846.25,89015,454861.25
291450,201705,845,522,323,486960.54,301714,788674.54
291460,201705,1668,1348,320,1260639.8,299691,1560330.8
291465,201705,2232,1040,1192,974091.27,1116677.89,2090769.16
291470,201705,2692,1368,1324,1278097.95,1239589,2517686.95
291480,201705,11607,5152,6455,4816871.01,6038545.22,10855416.23
291490,201705,545,219,326,205203,305462,510665
291500,201705,363,189,174,177093,163038,340131
291510,201705,1262,479,783,447683.75,733389.9,1181073.65
291520,201705,961,433,528,405721,494414.63,900135.63
291530,201705,1026,269,757,252053,709009.26,961062.26
291535,201705,112,93,19,87141,17803,104944
291540,201705,357,106,251,99322,234250.8,333572.8
291550,201705,1162,534,628,498485.19,587855.9,1086341.09
291560,201705,5567,2891,2676,2696439.74,2495101.15,5191540.89
291570,201705,195,102,93,95574,87141,182715
291580,201705,1170,703,467,657968,437565.32,1095533.32
291590,201705,72,28,44,26236,41228,67464
291600,201705,1355,608,747,568759,699640,1268399
291610,201705,1236,542,694,506593.74,650223,1156816.74
291620,201705,548,248,300,232376,280584.65,512960.65
291630,201705,500,164,336,153668,314832,468500
291640,201705,3774,1860,1914,1736744.58,1792324.71,3529069.29
291650,201705,344,219,125,204088.97,116938,321026.97
291660,201705,452,181,271,168917.3,252849.45,421766.75
291670,201705,213,131,82,122185,76834,199019
291680,201705,698,389,309,364493,289440,653933
291685,201705,557,297,260,278055,243432.6,521487.6
291690,201705,541,276,265,258612,247368,505980
291700,201705,892,705,187,660585,174282,834867
291710,201705,1697,765,932,716121.34,872141.83,1588263.17
291720,201705,387,261,126,244552.32,118062,362614.32
291730,201705,903,513,390,479790.85,365420.63,845211.48
291733,201705,252,175,77,163693.9,72149,235842.9
291735,201705,65,52,13,48724,12181,60905
291740,201705,333,250,83,233922.05,77771,311693.05
291750,201705,1904,1256,648,1170423.48,605553.81,1775977.29
291760,201705,3095,1644,1451,1533908.24,1357900.5,2891808.74
291770,201705,767,525,242,489862.03,226754,716616.03
291780,201705,48,27,21,25299,19677,44976
291790,201705,171,77,94,72149,88078,160227
291800,201705,9650,3701,5949,3459132.11,5570747.3,9029879.41
291810,201705,1153,811,342,759059.22,320454,1079513.22
291820,201705,256,186,70,174282,65590,239872
291830,201705,1040,375,665,350176,622159,972335
291835,201705,630,568,62,531748,58094,589842
291840,201705,4499,2277,2222,2128832.62,2080877.88,4209710.50
291845,201705,321,109,212,102133,198634.63,300767.63
291850,201705,310,269,41,251818.75,38417,290235.75
291855,201705,259,104,155,97448,145235,242683
291860,201705,213,128,85,119000,79645,198645
291870,201705,77,31,46,29047,43102,72149
291875,201705,175,158,17,148046,15929,163975
291880,201705,476,375,101,350579,94637,445216
291890,201705,243,80,163,74950.63,151044.5,225995.13
291900,201705,57,31,26,29047,24362,53409
291905,201705,140,91,49,84986,45913,130899
291910,201705,181,144,37,134928,34669,169597
291915,201705,378,335,43,312257,40291,352548
291920,201705,4669,2405,2264,2251124.71,2119727.34,4370852.05
291930,201705,179,101,78,93700.7,73086,166786.7
291940,201705,297,162,135,151794,125867.21,277661.21
291950,201705,1102,908,194,848923.6,181778,1030701.6
291955,201705,919,547,372,512539,348564,861103
291960,201705,166,110,56,103070,52472,155542
291970,201705,786,594,192,556578,179904,736482
291980,201705,1474,1304,170,1218233.79,158353.7,1376587.49
291990,201705,121,113,8,105881,7496,113377
291992,201705,154,76,78,70462.4,73086,143548.4
291995,201705,139,99,40,92763,37480,130243
292000,201705,374,275,99,256175.9,92763,348938.9
292010,201705,277,203,74,189555.1,68401,257956.1
292020,201705,260,189,71,177093,66527,243620
292030,201705,133,103,30,96511,28110,124621
292040,201705,599,300,299,281100,280163,561263
292045,201705,82,75,7,70275,6559,76834
292050,201705,866,578,288,540595.26,269856,810451.26
292060,201705,918,764,154,713995.59,144298,858293.59
292070,201705,54,24,30,22488,28110,50598
292080,201705,112,76,36,71212,33732,104944
292090,201705,469,158,311,147838.49,291407,439245.49
292100,201705,1319,552,767,515678.35,717705.26,1233383.61
292105,201705,195,164,31,153668,29047,182715
292110,201705,2058,754,1304,706179.42,1219585.68,1925765.10
292120,201705,615,497,118,464576.96,110566,575142.96
292130,201705,435,255,180,238935,168660,407595
292140,201705,195,154,41,144298,38287.61,182585.61
292145,201705,149,77,72,72149,67435.9,139584.9
292150,201705,1380,1107,273,1037259,254791.57,1292050.57
292160,201705,181,148,33,138394.9,30921,169315.9
292170,201705,1213,1067,146,998397.23,136745.78,1135143.01
292180,201705,189,138,51,129306,47787,177093
292190,201705,162,98,64,91826,59968,151794
292200,201705,1240,446,794,416967.24,743341.68,1160308.92
292205,201705,114,102,12,95574,11244,106818
292210,201705,348,238,110,221648,102367.25,324015.25
292220,201705,23,17,6,15929,5622,21551
292225,201705,38,33,5,30921,4685,35606
292230,201705,866,706,160,659129.72,149920,809049.72
292240,201705,604,419,185,391526,173345,564871
292250,201705,1591,1000,591,937000,553767,1490767
292260,201705,438,237,201,222069,187587.4,409656.4
292265,201705,277,191,86,178685.9,80582,259267.9
292270,201705,779,334,445,312021.1,416028.4,728049.5
292273,201705,196,114,82,106054.34,76834,182888.34
292275,201705,156,74,82,69338,76552.9,145890.9
292280,201705,134,93,41,87141,38417,125558
292285,201705,56,47,9,43383.1,8433,51816.1
292290,201705,489,319,170,296458.01,159009,455467.01
292300,201705,1587,604,983,565385.9,919165.99,1484551.89
292303,201705,84,56,28,52472,26236,78708
292305,201705,102,71,31,66527,29047,95574
292310,201705,819,503,316,470956,294878.99,765834.99
292320,201705,640,480,160,449478.9,149920,599398.9
292330,201705,198,98,100,91826,93700,185526
292335,201705,264,198,66,185526,61842,247368
292340,201705,550,376,174,351585.93,163038,514623.93
292350,201705,246,129,117,120076.55,109347.9,229424.45
292360,201705,689,519,170,484616.5,159290,643906.5
292370,201705,780,592,188,554704,176156,730860
292380,201705,636,490,146,458193.51,136802,594995.51
292390,201705,500,188,312,176156,290610.75,466766.75
292400,201705,3280,2012,1268,1866410.64,1184305,3050715.64
292405,201705,255,168,87,156947.5,81237.9,238185.4
292410,201705,156,91,65,85267,60905,146172
292420,201705,303,259,44,242401.9,41228,283629.9
292430,201705,484,391,93,366367,86672.5,453039.5
292440,201705,570,483,87,450697,81519,532216
292450,201705,245,188,57,176156,53409,229565
292460,201705,588,432,156,404221.9,145469.25,549691.15
292465,201705,180,155,25,145235,22700.24,167935.24
292467,201705,93,52,41,48724,38417,87141
292470,201705,243,163,80,152731,74960,227691
292480,201705,290,193,97,179904.75,90889,270793.75
292490,201705,225,146,79,136802,74023,210825
292500,201705,1178,505,673,472978,630432.35,1103410.35
292510,201705,3226,1431,1795,1339910.36,1678955.35,3018865.71
292520,201705,1013,478,535,446710.75,501277,947987.75
292525,201705,371,259,112,242678.32,104944,347622.32
292530,201705,4114,1670,2444,1562749.4,2287846.3,3850595.7
292540,201705,484,252,232,236124,217120.76,453244.76
292550,201705,1040,553,487,517403.49,455868.01,973271.50
292560,201705,313,293,20,274541,18740,293281
292570,201705,288,220,68,205817,63716,269533
292575,201705,451,274,177,256457,165849,422306
292580,201705,876,546,330,510196.5,308647.9,818844.4
292590,201705,508,436,72,408234.98,67464,475698.98
292593,201705,137,107,30,100259,28110,128369
292595,201705,165,123,42,115251,39354,154605
292600,201705,1222,912,310,854232,290470,1144702
292610,201705,118,89,29,82924.5,26920.01,109844.51
292620,201705,508,418,90,391376,84330,475706
292630,201705,1308,756,552,706812.5,513945.3,1220757.8
292640,201705,749,522,227,489114,212699,701813
292650,201705,188,163,25,152300,23425,175725
292660,201705,1960,1392,568,1298585.02,527245.96,1825830.98
292665,201705,128,95,33,89015,30921,119936
292670,201705,368,311,57,291403,53409,344812
292680,201705,241,186,55,174282,51535,225817
292690,201705,175,132,43,123684,40291,163975
292700,201705,908,589,319,550956.9,298621.9,849578.8
292710,201705,96,84,12,78708,10963,89671
292720,201705,809,452,357,422736.92,334322,757058.92
292730,201705,211,101,110,93700.75,103070,196770.75
292740,201705,63792,31485,32307,29430436.42,30243580.74,59674017.16
292750,201705,373,264,109,246431.07,101337.01,347768.08
292760,201705,311,244,67,227635.25,62779,290414.25
292770,201705,785,333,452,310357.03,420635.64,730992.67
292780,201705,422,158,264,147822.53,247368,395190.53
292790,201705,718,345,373,323265,349266.75,672531.75
292800,201705,1088,660,428,617483,401036,1018519
292805,201705,424,127,297,118764.75,278289,397053.75
292810,201705,1430,836,594,782769.9,556578,1339347.9
292820,201705,738,595,143,555642.3,133700.9,689343.2
292830,201705,106,80,26,74960,24362,99322
292840,201705,634,523,111,489583,103992.95,593575.95
292850,201705,132,87,45,81515,42165,123680
292860,201705,2018,1174,844,1095573.07,790828,1886401.07
292870,201705,3276,2203,1073,2063205.9,1005391.63,3068597.53
292880,201705,1402,923,479,861151.33,448823,1309974.33
292890,201705,452,389,63,364465,59031,423496
292895,201705,133,90,43,82995.71,40291,123286.71
292900,201705,376,282,94,264234,88078,352312
292905,201705,436,217,219,203329,205016,408345
292910,201705,382,296,86,277025,80582,357607
292920,201705,514,227,287,212699,268919,481618
292925,201705,517,478,39,447220.73,36308.75,483529.48
292930,201705,552,340,212,318580,198644,517224
292935,201705,295,124,171,116188,160227,276415
292937,201705,227,151,76,141487,71212,212699
292940,201705,189,143,46,133991,43102,177093
292950,201705,1064,550,514,513337.05,480682,994019.05
292960,201705,511,341,170,319517,159290,478807
292970,201705,284,197,87,183934,81519,265453
292975,201705,160,89,71,83393,66340,149733
292980,201705,253,173,80,160349.42,74960,235309.42
292990,201705,1264,930,334,866079.92,312774.26,1178854.18
293000,201705,100,74,26,69338,24352.63,93690.63
293010,201705,2564,1589,975,1484026.98,909266.7,2393293.68
293015,201705,642,504,138,471967,128679,600646
293020,201705,338,275,63,257675,59031,316706
293030,201705,630,547,83,511040.82,77771,588811.82
293040,201705,335,262,73,245494,68364,313858
293050,201705,2617,1526,1091,1421086.13,1018210.39,2439296.52
293060,201705,244,194,50,181778,45913.4,227691.4
293070,201705,3212,1604,1608,1496175.34,1505506.63,3001681.97
293075,201705,88,56,32,52472,29984,82456
293076,201705,73,44,29,41228,27173,68401
293077,201705,410,246,164,227004.66,153668,380672.66
293080,201705,461,400,61,374800,57157,431957
293090,201705,132,112,20,104944,18427.7,123371.7
293100,201705,489,350,139,327950,130243,458193
293105,201705,328,222,106,207733,99322,307055
293110,201705,168,119,49,111503,45913,157416
293120,201705,314,211,103,197707,96323.6,294030.6
293130,201705,244,161,83,150857,77771,228628
293135,201705,7629,3046,4583,2847406.47,4287807.35,7135213.82
293140,201705,177,116,61,108692,56408,165100
293150,201705,328,284,44,264703.1,41228,305931.1
293160,201705,434,240,194,224880,181496.9,406376.9
293170,201705,176,125,51,116843.9,46944,163787.9
293180,201705,445,300,145,280819,135865,416684
293190,201705,1252,868,384,808751.98,359730,1168481.98
293200,201705,511,451,60,421464,56220,477684
293210,201705,330,242,88,226604.08,81753.25,308357.33
293220,201705,2732,1085,1647,1015467.45,1540897.55,2556365.00
293230,201705,1771,632,1139,590779.9,1067243,1658022.9
293240,201705,218,200,18,187400,16866,204266
293245,201705,111,92,19,86204,17803,104007
293250,201705,727,265,462,247669.24,432613,680282.24
293260,201705,307,256,51,238342.49,47787,286129.49
293270,201705,1176,555,621,518145.48,581877,1100022.48
293280,201705,220,123,97,115251,90889,206140
293290,201705,3034,1972,1062,1846827.5,994800,2841627.5
293300,201705,661,472,189,440441.79,176296.55,616738.34
293305,201705,162,135,27,126495,25299,151794
293310,201705,137,103,34,96511,31858,128369
293315,201705,149,115,34,107755,31858,139613
293317,201705,92,66,26,61842,24362,86204
293320,201705,925,522,403,488177.25,377326,865503.25
293325,201705,186,68,118,63716,110547.26,174263.26
293330,201705,12417,5753,6664,5378995.79,6238037.88,11617033.67
293340,201705,244,173,71,162101,65590,227691
293345,201705,245,193,52,180841,48724,229565
293350,201705,624,317,307,297029,286206.65,583235.65
293360,201705,1533,1090,443,1020112,413873.35,1433985.35
310010,201705,156,79,77,74023,71587,145610
310020,201705,1031,571,460,532591.05,428865.26,961456.31
310030,201705,331,268,63,249448.94,58749.9,308198.84
310040,201705,51,33,18,30921,16866,47787
310050,201705,211,137,74,127432.2,69338,196770.2
310060,201705,238,164,74,153668,69338,223006
310070,201705,18,9,9,8433,8433,16866
310080,201705,50,26,24,24362,22488,46850
310090,201705,923,476,447,441141.14,417433.8,858574.94
310100,201705,286,215,71,201455,66527,267982
310110,201705,728,389,339,363457.09,316706.6,680163.69
310120,201705,371,207,164,193303.1,153300.61,346603.71
310130,201705,34,21,13,19677,12181,31858
310140,201705,31,17,14,15929,13118,29047
310150,201705,1271,880,391,819316.06,365804.9,1185120.96
310160,201705,2135,1086,1049,1010838.05,978353.97,1989192.02
310163,201705,83,48,35,44976,32795,77771
310170,201705,2508,1008,1500,944375,1402970.3,2347345.3
310180,201705,117,43,74,40291,68963.2,109254.2
310190,201705,476,311,165,291407,153761.7,445168.7
310200,201705,506,319,187,298903,174938,473841
310205,201705,53,42,11,39354,10307,49661
310210,201705,285,227,58,212699,54346,267045
310220,201705,49,29,20,27173,18740,45913
310230,201705,263,183,80,171283.6,74960,246243.6
310240,201705,102,90,12,84330,11244,95574
310250,201705,100,81,19,75897,17803,93700
310260,201705,814,427,387,397476.35,361897.51,759373.86
310270,201705,267,176,91,164369,85267,249636
310280,201705,362,270,92,251398.1,86204,337602.1
310285,201705,212,151,61,141184.35,57157,198341.35
310290,201705,252,147,105,137739,98385,236124
310300,201705,151,126,25,118062,23425,141487
310310,201705,5,4,1,3748,937,4685
310320,201705,23,15,8,14055,7496,21551
310330,201705,32,23,9,21551,8433,29984
310340,201705,1461,933,528,866054.35,493518.25,1359572.60
310350,201705,2753,1490,1263,1391402.85,1182868.9,2574271.75
310360,201705,42,34,8,31858,7496,39354
310370,201705,120,98,22,91826,20333,112159
310375,201705,108,38,70,35606,65572,101178
310380,201705,50,29,21,27173,19677,46850
310390,201705,99,69,30,64653,28110,92763
310400,201705,2234,1421,813,1326699.9,761481.9,2088181.8
310410,201705,125,67,58,62779,54346,117125
310420,201705,653,353,300,329918.1,280154.43,610072.53
310430,201705,327,215,112,201173.9,104944,306117.9
310440,201705,57,37,20,34669,18740,53409
310445,201705,78,63,15,59031,14055,73086
310450,201705,850,531,319,496079.1,298903,794982.1
310460,201705,267,187,80,175219,74960,250179
310470,201705,491,309,182,289533,170534,460067
310480,201705,88,61,27,57157,25299,82456
310490,201705,474,220,254,205203.1,237998,443201.1
310500,201705,122,55,67,51535,62779,114314
310510,201705,619,396,223,369830.8,208932.63,578763.43
310520,201705,131,86,45,80582,42165,122747
310530,201705,83,39,44,36543,40946.9,77489.9
310540,201705,447,280,167,260019.3,156479,416498.3
310550,201705,75,51,24,47787,22488,70275
310560,201705,2823,1953,870,1819580.08,813592.42,2633172.50
310570,201705,158,101,57,94637,53409,148046
310590,201705,331,221,110,206656,103070,309726
310600,201705,159,94,65,86344.85,60905,147249.85
310610,201705,59,22,37,20614,34669,55283
310620,201705,44321,21209,23112,19800983.91,21619184.09,41420168.00
310630,201705,544,348,196,323828.05,182090.61,505918.66
310640,201705,132,110,22,102882.6,20614,123496.6
310650,201705,153,134,19,124621,17803,142424
310660,201705,91,56,35,52472,32795,85267
310665,201705,46,33,13,30921,12181,43102
310670,201705,6125,2872,3253,2684682.31,3042601.92,5727284.23
310680,201705,52,35,17,32795,15929,48724
310690,201705,554,405,149,374954,139613,514567
310700,201705,67,43,24,40291,22488,62779
310710,201705,1232,820,412,767721.95,385763,1153484.95
310720,201705,85,28,57,26236,53409,79645
310730,201705,1327,917,410,858948,384170,1243118
310740,201705,1000,561,439,523596.2,411099.63,934695.83
310750,201705,244,143,101,133054.29,94637,227691.29
310760,201705,67,51,16,47787,14992,62779
310770,201705,85,44,41,41228,38417,79645
310780,201705,414,335,79,313886,74023,387909
310790,201705,97,78,19,73086,17803,90889
310800,201705,455,215,240,200986.5,224589.53,425576.03
310810,201705,162,113,49,105497,44976,150473
310820,201705,377,295,82,276415,76552.9,352967.9
310825,201705,182,148,34,138676,31858,170534
310830,201705,462,219,243,204554.61,226472.9,431027.51
310840,201705,393,224,169,209888,158071.9,367959.9
310850,201705,108,88,20,82456,18740,101196
310855,201705,377,297,80,278289,74960,353249
310860,201705,1346,1010,336,942207.45,313127.95,1255335.40
310870,201705,53,42,11,39354,10307,49661
310880,201705,78,59,19,55002,17803,72805
310890,201705,308,184,124,172408,116188,288596
310900,201705,642,290,352,269354.95,329806,599160.95
310910,201705,243,168,75,156105.1,70275,226380.1
310920,201705,497,294,203,271731.2,189274.7,461005.9
310925,201705,25,19,6,17803,5341,23144
310930,201705,1101,657,444,615205.78,415929.2,1031134.98
310940,201705,676,350,326,327359.9,305462,632821.9
310945,201705,123,75,48,70275,44976,115251
310950,201705,257,201,56,188337,52472,240809
310960,201705,85,30,55,28110,51531,79641
310970,201705,169,103,66,96511,60936.2,157447.2
310980,201705,39,20,19,18740,17803,36543
310990,201705,154,86,68,80582,63716,144298
311000,201705,807,418,389,388856.9,364484,753340.9
311010,201705,40,33,7,30921,6559,37480
311020,201705,38,24,14,22488,13118,35606
311030,201705,398,231,167,214574,156479,371053
311040,201705,35,30,5,28110,4685,32795
311050,201705,464,194,270,181216,252427.8,433643.8
311060,201705,751,438,313,409001.2,293281,702282.2
311070,201705,316,140,176,131180,164912,296092
311080,201705,108,56,52,52472,48724,101196
311090,201705,392,179,213,167723,199581,367304
311100,201705,609,365,244,341786,228346.9,570132.9
311110,201705,647,438,209,410406,195824,606230
311115,201705,61,45,16,42165,14992,57157
311120,201705,992,521,471,486253.4,440516.28,926769.68
311130,201705,412,238,174,222818.6,163038,385856.6
311140,201705,154,70,84,65590,77911.55,143501.55
311150,201705,349,225,124,210708,115953.75,326661.75
311160,201705,741,530,211,494736.7,197239,691975.7
311170,201705,73,51,22,47787,20332.9,68119.9
311180,201705,338,220,118,205843.97,110285,316128.97
311190,201705,37,21,16,19677,14992,34669
311200,201705,351,242,109,225161.3,102133,327294.3
311205,201705,29,19,10,17568.75,8995.2,26563.95
311210,201705,49,41,8,38417,7496,45913
311220,201705,11,10,1,9370,937,10307
311230,201705,1610,1029,581,961102.65,544397,1505499.65
311240,201705,165,101,64,94637,59968,154605
311250,201705,61,30,31,28110,29047,57157
311260,201705,560,338,222,316706,208014,524720
311265,201705,106,72,34,67464,31858,99322
311270,201705,275,189,86,177093,80582,257675
311280,201705,215,98,117,91826,109066.8,200892.8
311290,201705,108,87,21,81238,19115,100353
311300,201705,549,342,207,319517.88,193678,513195.88
311310,201705,23,19,4,17803,3748,21551
311320,201705,657,486,171,454445,160227,614672
311330,201705,1003,742,261,694926.75,243620.7,938547.45
311340,201705,2550,1816,734,1693753.89,687074.83,2380828.72
311350,201705,271,211,60,197707,56220,253927
311360,201705,171,106,65,99322,60905,160227
311370,201705,1171,454,717,423162.25,670751.45,1093913.70
311380,201705,8,7,1,6559,937,7496
311390,201705,283,152,131,142424,122278.6,264702.6
311400,201705,151,99,52,92763,48715,141478
311410,201705,94,55,39,51535,36543,88078
311420,201705,291,164,127,151138.1,118999,270137.1
311430,201705,838,547,291,510573.1,272667,783240.1
311440,201705,485,340,145,317643.4,135583.9,453227.3
311450,201705,312,193,119,180841,111503,292344
311455,201705,302,204,98,190857.9,91544.9,282402.8
311460,201705,129,52,77,48724,71450.93,120174.93
311470,201705,20,11,9,10307,8433,18740
311480,201705,24,7,17,6559,15929,22488
311490,201705,17,10,7,9370,6559,15929
311500,201705,19,8,11,7496,10307,17803
311510,201705,624,426,198,398225,185526,583751
311520,201705,42,32,10,29328.1,9370,38698.1
311530,201705,1813,1350,463,1256806.81,433831,1690637.81
311535,201705,63,49,14,45913,13118,59031
311540,201705,33,29,4,27173,3748,30921
311545,201705,183,138,45,129306,42165,171471
311547,201705,31,22,9,20614,8433,29047
311550,201705,569,259,310,242683,290451.63,533134.63
311560,201705,43,29,14,27173,13118,40291
311570,201705,306,198,108,184963.8,101196,286159.8
311580,201705,287,163,124,152449.9,116188,268637.9
311590,201705,35,29,6,27173,5622,32795
311600,201705,88,71,17,66527,15929,82456
311610,201705,263,227,36,211449.95,33732,245181.95
311615,201705,87,71,16,65899.21,14992,80891.21
311620,201705,16,11,5,10307,4685,14992
311630,201705,76,63,13,59031,12181,71212
311640,201705,115,66,49,61842,45913,107755
311650,201705,121,90,31,83627.25,29047,112674.25
311660,201705,390,183,207,171471,193959,365430
311670,201705,162,102,60,95022,56220,151242
311680,201705,220,161,59,149198.94,54533.4,203732.34
311690,201705,15,8,7,7496,6559,14055
311700,201705,200,135,65,126213.9,60905,187118.9
311710,201705,216,140,76,130899,71212,202111
311720,201705,33,26,7,24362,6559,30921
311730,201705,516,343,173,320829,162101,482930
311740,201705,30,20,10,18740,9370,28110
311750,201705,702,478,224,446012.4,209888,655900.4
311760,201705,64,37,27,34669,25299,59968
311770,201705,389,183,206,169597.61,193022,362619.61
311780,201705,168,99,69,92763,64341,157104
311783,201705,73,64,9,59968,8433,68401
311787,201705,31,13,18,12181,16866,29047
311790,201705,264,128,136,119936,127432,247368
311800,201705,612,420,192,390215.15,179904,570119.15
311810,201705,40,34,6,31858,5622,37480
311820,201705,108,89,19,83393,17803,101196
311830,201705,1825,1175,650,1096497.95,605771.4,1702269.35
311840,201705,981,537,444,498953.95,414284.66,913238.61
311850,201705,9,4,5,3748,4685,8433
311860,201705,9104,4231,4873,3951200.6,4558669.41,8509870.01
311870,201705,160,87,73,81519,68401,149920
311880,201705,951,707,244,661231.9,228628,889859.9
311890,201705,224,114,110,106818,103070,209888
311900,201705,87,36,51,33732,47787,81519
311910,201705,1354,848,506,791719.05,471920.15,1263639.20
311920,201705,234,152,82,142190,76834,219024
311930,201705,893,514,379,480461.75,354607.9,835069.65
311940,201705,2307,1166,1141,1089966.25,1066353.05,2156319.30
311950,201705,203,114,89,106444,83112,189556
311960,201705,66,46,20,43102,18740,61842
311970,201705,27,15,12,12508.95,11244,23752.95
311980,201705,42,31,11,29047,10307,39354
311990,201705,62,47,15,44039,14055,58094
311995,201705,64,44,20,41228,18740,59968
312000,201705,32,22,10,20332.9,9370,29702.9
312010,201705,86,61,25,57157,23425,80582
312015,201705,89,67,22,62498,20614,83112
312020,201705,144,91,53,85267,49661,134928
312030,201705,37,32,5,29329,4685,34014
312040,201705,74,48,26,44976,24362,69338
312050,201705,226,118,108,110566,101196,211762
312060,201705,71,48,23,44976,20895.1,65871.1
312070,201705,78,44,34,41228,31858,73086
312080,201705,508,208,300,194896,281100,475996
312083,201705,46,34,12,31858,11244,43102
312087,201705,100,77,23,72149,21551,93700
312090,201705,2700,1487,1213,1379823.7,1133137.62,2512961.32
312100,201705,164,115,49,107755,45145,152900
312110,201705,119,80,39,74960,36543,111503
312120,201705,145,105,40,98385,37480,135865
312125,201705,93,50,43,46662.6,40291,86953.6
312130,201705,126,83,43,77771,40291,118062
312140,201705,134,105,29,98385,27173,125558
312150,201705,43,34,9,31858,8433,40291
312160,201705,1512,1006,506,939799.24,472173.34,1411972.58
312170,201705,11,9,2,8433,1874,10307
312180,201705,134,86,48,79645.75,44695,124340.75
312190,201705,32,29,3,27173,2811,29984
312200,201705,699,603,96,563371.35,89952,653323.35
312210,201705,94,60,34,56220,31858,88078
312220,201705,120,87,33,81285,30921,112206
312230,201705,3362,1671,1691,1561446.89,1583345.62,3144792.51
312235,201705,129,85,44,79645,41228,120873
312240,201705,109,71,38,66527,35606,102133
312245,201705,153,104,49,97444,45913,143357
312247,201705,53,37,16,33920,14992,48912
312250,201705,173,83,90,77303,84330,161633
312260,201705,94,65,29,60062.6,27173,87235.6
312270,201705,137,84,53,78708,49661,128369
312280,201705,26,16,10,14992,9370,24362
312290,201705,155,109,46,101851.9,42166,144017.9
312300,201705,197,132,65,123684,60905,184589
312310,201705,57,52,5,48724,4685,53409
312320,201705,420,257,163,238935,151466.25,390401.25
312330,201705,88,77,11,71400,10025.9,81425.9
312340,201705,33,14,19,13118,17803,30921
312350,201705,17,11,6,10307,5622,15929
312352,201705,96,68,28,63716,26236,89952
312360,201705,556,256,300,238935,280444.1,519379.1
312370,201705,276,163,113,152449.9,105881,258330.9
312380,201705,138,88,50,82456,46850,129306
312385,201705,182,147,35,137739,32795,170534
312390,201705,292,186,106,174282,98667,272949
312400,201705,368,275,93,257675,86673,344348
312410,201705,833,272,561,254395.5,525091,779486.5
312420,201705,588,476,112,446012,104944,550956
312430,201705,846,626,220,583987.94,205203.1,789191.04
312440,201705,44,32,12,29984,11244,41228
312450,201705,211,132,79,123684,74023,197707
312460,201705,54,25,29,23425,27173,50598
312470,201705,52,34,18,31858,16866,48724
312480,201705,219,136,83,127432,77489.9,204921.9
312490,201705,243,167,76,156479,71212,227691
312500,201705,31,18,13,16866,12181,29047
312510,201705,416,161,255,150857,238330.36,389187.36
312520,201705,41,15,26,14055,24362,38417
312530,201705,45,35,10,32795,9370,42165
312540,201705,98,86,12,80582,11244,91826
312550,201705,35,27,8,25299,7496,32795
312560,201705,190,138,52,129025,48442.9,177467.9
312570,201705,434,259,175,242308.2,163296.23,405604.43
312580,201705,84,45,39,42165,36543,78708
312590,201705,273,216,57,201316,53409,254725
312595,201705,143,130,13,121810,12181,133991
312600,201705,77,47,30,43618,28110,71728
312610,201705,1604,834,770,776213.29,719710.3,1495923.59
312620,201705,182,127,55,118999,51535,170534
312630,201705,67,54,13,50598,12181,62779
312640,201705,49,15,34,14055,31858,45913
312650,201705,141,114,27,106537,25299,131836
312660,201705,60,44,16,40947,14992,55939
312670,201705,845,556,289,519426.95,270272.82,789699.77
312675,201705,41,31,10,29047,9370,38417
312680,201705,80,54,26,50223.2,24362,74585.2
312690,201705,240,127,113,118989.63,105599.9,224589.53
312695,201705,27,21,6,19677,5622,25299
312700,201705,189,105,84,98385,78708,177093
312705,201705,71,60,11,56220,10025.9,66245.9
312707,201705,87,63,24,59031,22488,81519
312710,201705,1843,979,864,915862,809360,1725222
312720,201705,63,33,30,30921,28110,59031
312730,201705,290,171,119,159290,111221.9,270511.9
312733,201705,47,42,5,39354,4685,44039
312735,201705,20,15,5,14055,4685,18740
312737,201705,75,38,37,35606,34669,70275
312738,201705,49,34,15,31858,14055,45913
312740,201705,70,50,20,46850,18740,65590
312750,201705,73,53,20,49661,18740,68401
312760,201705,272,196,76,183652,71212,254864
312770,201705,7549,3465,4084,3225114.84,3819331.57,7044446.41
312780,201705,436,341,95,319235.9,89015,408250.9
312790,201705,19,15,4,14055,3748,17803
312800,201705,1604,1121,483,1043779.98,451410.11,1495190.09
312810,201705,368,231,137,216447,128369,344816
312820,201705,190,143,47,133991,44039,178030
312825,201705,24,14,10,13118,9370,22488
312830,201705,288,167,121,155543,112750,268293
312840,201705,148,109,39,102133,36543,138676
312850,201705,22,19,3,17803,2811,20614
312860,201705,173,107,66,99978,61842,161820
312870,201705,986,508,478,474184.7,447886,922070.7
312880,201705,148,102,46,95433.45,43008.3,138441.75
312890,201705,159,106,53,99322,49661,148983
312900,201705,214,158,56,147390.1,52472,199862.1
312910,201705,185,92,93,84965.66,87141,172106.66
312920,201705,155,87,68,81519,63716,145235
312930,201705,339,243,96,227691,89952,317643
312940,201705,102,67,35,62779,32795,95574
312950,201705,691,446,245,416590.3,229565,646155.3
312960,201705,177,133,44,124621,41228,165849
312965,201705,43,38,5,35606,4685,40291
312970,201705,284,227,57,211528.1,53409,264937.1
312980,201705,2211,1191,1020,1112773.9,955173.8,2067947.7
312990,201705,48,27,21,25299,19677,44976
313000,201705,39,26,13,24362,12181,36543
313005,201705,161,125,36,116150.75,33451,149601.75
313010,201705,911,370,541,345753.1,506626.9,852380.0
313020,201705,197,102,95,95574,89015,184589
313030,201705,203,128,75,119000,70275,189275
313040,201705,53,20,33,18740,30921,49661
313050,201705,291,202,89,188337.1,83393,271730.1
313055,201705,42,29,13,27173,12181,39354
313060,201705,119,81,38,75448,35324.9,110772.9
313065,201705,58,36,22,33732,20614,54346
313070,201705,155,82,73,76834,68401,145235
313080,201705,41,17,24,15929,22488,38417
313090,201705,696,472,224,440296.4,209838.84,650135.24
313100,201705,170,63,107,59031,100251,159282
313110,201705,111,64,47,59968,44039,104007
313115,201705,135,72,63,67267.23,58094,125361.23
313120,201705,721,393,328,367960,305837,673797
313130,201705,4950,2637,2313,2453438.97,2159544.37,4612983.34
313140,201705,163,81,82,75897,76834,152731
313150,201705,320,255,65,238935,60623.9,299558.9
313160,201705,171,121,50,113377,46850,160227
313170,201705,1301,918,383,848361.77,358487.2,1206848.97
313180,201705,332,193,139,180203.84,130243,310446.84
313190,201705,687,398,289,369927.6,270044,639971.6
313200,201705,21,20,1,18740,937,19677
313210,201705,891,752,139,700737.48,130238.32,830975.80
313220,201705,218,150,68,139613,63013.25,202626.25
313230,201705,285,204,81,190212,75897,266109
313240,201705,1870,1017,853,950579.27,795145.27,1745724.54
313250,201705,1227,895,332,834025.8,308275.4,1142301.2
313260,201705,90,53,37,49661,34669,84330
313270,201705,955,546,409,507619.77,383233,890852.77
313280,201705,60,51,9,47318.51,8433,55751.51
313290,201705,226,177,49,165568,44976.9,210544.9
313300,201705,354,175,179,161792.3,167723,329515.3
313310,201705,209,107,102,100259,95574,195833
313320,201705,363,279,84,259502.55,78708,338210.55
313330,201705,1304,775,529,725238.6,494502.75,1219741.35
313340,201705,331,222,109,208014,102133,310147
313350,201705,530,359,171,334509.05,160227,494736.05
313360,201705,117,64,53,59968,49380,109348
313370,201705,191,76,115,71212,107755,178967
313375,201705,255,152,103,142424,96511,238935
313380,201705,1205,618,587,575992.74,549266,1125258.74
313390,201705,47,39,8,35606.4,7496,43102.4
313400,201705,412,262,150,245494,140269,385763
313410,201705,16,9,7,8433,6559,14992
313420,201705,4618,2357,2261,2200613.19,2111427.81,4312041.00
313430,201705,137,60,77,56220,72149,128369
313440,201705,1452,977,475,913910.1,444513,1358423.1
313450,201705,61,27,34,25299,31858,57157
313460,201705,363,174,189,161620,177093,338713
313470,201705,504,223,281,208951,262641.1,471592.1
313480,201705,156,106,50,98386,46850,145236
313490,201705,499,240,259,224875.32,242234,467109.32
313500,201705,15,10,5,9370,4685,14055
313505,201705,909,710,199,664333,186463,850796
313507,201705,88,51,37,47787,34669,82456
313510,201705,2706,1737,969,1623167.9,907016,2530183.9
313520,201705,3548,2769,779,2582682.19,729919,3312601.19
313530,201705,38,27,11,25299,10307,35606
313535,201705,97,81,16,75242,14992,90234
313540,201705,71,54,17,50598,15085.7,65683.7
313545,201705,96,78,18,73086,16866,89952
313550,201705,237,192,45,179904,41603,221507
313560,201705,336,170,166,159290,155542,314832
313570,201705,54,28,26,26236,24362,50598
313580,201705,1279,680,599,635567.1,559295.7,1194862.8
313590,201705,85,47,38,44039,35606,79645
313600,201705,695,406,289,380422,269950,650372
313610,201705,57,46,11,42211.9,10307,52518.9
313620,201705,1286,690,596,636253.16,555322.6,1191575.76
313630,201705,1621,1246,375,1166003.4,351094,1517097.4
313640,201705,124,68,56,63716,52472,116188
313650,201705,216,98,118,91826,110566,202392
313652,201705,11,10,1,9370,937,10307
313655,201705,52,31,21,29047,19677,48724
313657,201705,46,43,3,40291,2811,43102
313660,201705,124,89,35,83393,32795,116188
313665,201705,604,302,302,282974,282739.75,565713.75
313670,201705,9713,6721,2992,6275570.59,2802942,9078512.59
313680,201705,39,29,10,27173,9370,36543
313690,201705,158,121,37,113377,34669,148046
313695,201705,59,45,14,42165,13118,55283
313700,201705,285,226,59,211481,55283,266764
313710,201705,154,107,47,100259,44039,144298
313720,201705,974,449,525,418932.8,490323.83,909256.63
313730,201705,53,39,14,36543,13118,49661
313740,201705,159,126,33,117874.6,30921,148795.6
313750,201705,452,328,124,307054.9,116188,423242.9
313753,201705,239,166,73,154886.1,68401,223287.1
313760,201705,1137,413,724,386981,675700.56,1062681.56
313770,201705,339,240,99,224880,92763,317643
313780,201705,747,388,359,363556,336101.9,699657.9
313790,201705,26,25,1,23425,937,24362
313800,201705,130,82,48,76834,44976,121810
313810,201705,54,35,19,32795,17803,50598
313820,201705,1266,626,640,585344.1,598242.1,1183586.2
313830,201705,68,51,17,47787,15929,63716
313835,201705,50,46,4,43102,3748,46850
313840,201705,1592,977,615,911141.2,575037,1486178.2
313850,201705,176,60,116,56220,108122.39,164342.39
313860,201705,493,381,112,353157.7,104007.55,457165.25
313862,201705,175,115,60,107755,56220,163975
313865,201705,79,61,18,57157,16866,74023
313867,201705,52,39,13,36543,12181,48724
313868,201705,20,13,7,12181,6559,18740
313870,201705,123,62,61,58094,57157,115251
313880,201705,329,212,117,198362.9,109066.9,307429.8
313890,201705,320,177,143,165099.9,133428.8,298528.7
313900,201705,916,502,414,468782.25,387591,856373.25
313910,201705,135,97,38,90702,34669.1,125371.1
313920,201705,579,415,164,388476.59,153668,542144.59
313925,201705,28,24,4,22488,3748,26236
313930,201705,779,595,184,557515,172385,729900
313940,201705,1713,1074,639,1001934.2,598180.9,1600115.1
313950,201705,931,588,343,549176.8,320875.9,870052.7
313960,201705,1326,768,558,715408.65,521909.1,1237317.75
313970,201705,112,82,30,76834,28110,104944
313980,201705,201,127,74,118765,69338,188103
313990,201705,347,206,141,192741,132117,324858
314000,201705,893,607,286,566277.35,267696.32,833973.67
314010,201705,74,46,28,43102,26236,69338
314015,201705,59,18,41,16866,38417,55283
314020,201705,51,35,16,32795,14898.3,47693.3
314030,201705,102,52,50,48724,46850,95574
314040,201705,41,30,11,28110,10307,38417
314050,201705,308,180,128,168660,118624.2,287284.2
314053,201705,96,62,34,58094,31858,89952
314055,201705,276,159,117,148983,109629,258612
314060,201705,141,120,21,111503,19677,131180
314070,201705,894,466,428,432623.77,400417.63,833041.40
314080,201705,209,137,72,128135,66527.84,194662.84
314085,201705,107,73,34,68401,31858,100259
314090,201705,343,245,98,229565,91821.32,321386.32
314100,201705,456,374,82,346566,76272,422838
314110,201705,686,370,316,344825.37,295389.8,640215.17
314120,201705,105,57,48,53409,44976,98385
314130,201705,20,11,9,10307,8433,18740
314140,201705,1076,639,437,597131.46,408532.23,1005663.69
314150,201705,166,102,64,95574,59968,155542
314160,201705,353,259,94,240216.86,87891,328107.86
314170,201705,63,45,18,42165,16866,59031
314180,201705,729,635,94,593777.21,87141.25,680918.46
314190,201705,101,60,41,56220,38417,94637
314200,201705,585,398,187,371708.7,174282,545990.7
314210,201705,268,200,68,187118.9,63435,250553.9
314220,201705,317,237,80,220196,74679,294875
314225,201705,62,44,18,41228,16866,58094
314230,201705,98,44,54,41228,50598,91826
314240,201705,135,101,34,94637,31812,126449
314250,201705,57,33,24,30921,22488,53409
314260,201705,188,96,92,89952,86204,176156
314270,201705,470,363,107,339382,99978,439360
314280,201705,668,369,299,345462.9,280163,625625.9
314290,201705,546,438,108,409188.25,100914.9,510103.15
314300,201705,416,295,121,273531.5,113331,386862.5
314310,201705,1407,932,475,872066.9,444774.33,1316841.23
314315,201705,32,25,7,23425,6559,29984
314320,201705,595,375,220,351094,205512.21,556606.21
314330,201705,10539,5307,5232,4960636.12,4896486.1,9857122.22
314340,201705,570,267,303,249616.9,283349,532965.9
314345,201705,24,18,6,16866,5622,22488
314350,201705,190,111,79,104007,74023,178030
314360,201705,70,39,31,36543,29047,65590
314370,201705,60,50,10,46850,9370,56220
314380,201705,88,62,26,58094,24362,82456
314390,201705,3081,1933,1148,1807005.25,1072771.7,2879776.95
314400,201705,664,482,182,448815.1,170534,619349.1
314410,201705,414,271,143,253927,133991,387918
314420,201705,20,7,13,6559,12181,18740
314430,201705,2457,870,1587,811506.15,1484815.81,2296321.96
314435,201705,258,146,112,136520.9,104007,240527.9
314437,201705,23,18,5,16866,4685,21551
314440,201705,97,68,29,63716,27173,90889
314450,201705,152,116,36,108692,33732,142424
314460,201705,650,294,356,275478,333572,609050
314465,201705,73,52,21,48724,19677,68401
314467,201705,64,54,10,50589,9370,59959
314470,201705,337,169,168,154026.06,156479.75,310505.81
314480,201705,1009,486,523,454445,489503.6,943948.6
314490,201705,88,65,23,60905,21551,82456
314500,201705,297,190,107,178030,100259,278289
314505,201705,119,81,38,75897,35606,111503
314510,201705,222,177,45,165849,42165,208014
314520,201705,1188,611,577,567966.5,538728.45,1106694.95
314530,201705,660,526,134,492058,125558,617616
314535,201705,190,118,72,110284.9,67217.48,177502.38
314537,201705,59,34,25,31858,23425,55283
314540,201705,8,4,4,3748,3748,7496
314545,201705,47,34,13,31858,12181,44039
314550,201705,79,43,36,40291,33732,74023
314560,201705,809,430,379,400755,354186.79,754941.79
314570,201705,21,16,5,14992,4685,19677
314580,201705,18,8,10,7496,9370,16866
314585,201705,18,12,6,11244,5622,16866
314587,201705,75,65,10,60905,9370,70275
314590,201705,531,394,137,369178,128369,497547
314600,201705,984,626,358,583069.39,332476.8,915546.19
314610,201705,913,499,414,465361.4,386794.15,852155.55
314620,201705,143,105,38,97448,35606,133054
314625,201705,92,70,22,64747,20614,85361
314630,201705,1249,631,618,589513.65,578784.9,1168298.55
314640,201705,92,62,30,58094,28110,86204
314650,201705,204,115,89,107473.9,82924.5,190398.4
314655,201705,63,50,13,46850,12181,59031
314660,201705,18,14,4,13118,3748,16866
314670,201705,173,141,32,131836,29984,161820
314675,201705,214,117,97,109629,90889,200518
314690,201705,530,293,237,274259.9,222069,496328.9
314700,201705,2421,1299,1122,1212104.6,1050423.95,2262528.55
314710,201705,1601,933,668,870006.15,625025.85,1495032.00
314720,201705,408,240,168,223475,157416,380891
314730,201705,496,264,232,245963,216625.4,462588.4
314740,201705,674,332,342,309725.35,320454,630179.35
314750,201705,21,18,3,16866,2811,19677
314760,201705,303,148,155,138676,145225.63,283901.63
314770,201705,123,84,39,78708,36543,115251
314780,201705,21,6,15,5622,14055,19677
314790,201705,2310,1446,864,1346710.45,808621.73,2155332.18
314795,201705,46,39,7,36309,6559,42868
314800,201705,2793,1618,1175,1510217.56,1100310.1,2610527.66
314810,201705,1462,807,655,753864.25,612142.5,1366006.75
314820,201705,85,48,37,44976,34669,79645
314830,201705,203,155,48,144532.75,44695,189227.75
314840,201705,84,49,35,45913,32795,78708
314850,201705,338,164,174,153668,163038,316706
314860,201705,705,523,182,488083.79,169035.35,657119.14
314870,201705,1401,708,693,662459.5,649341,1311800.5
314875,201705,53,45,8,42165,7496,49661
314880,201705,43,30,13,28110,12181,40291
314890,201705,49,30,19,28110,17803,45913
314900,201705,27,23,4,21551,3748,25299
314910,201705,257,170,87,159008.9,81519,240527.9
314915,201705,145,129,16,120639,14992,135631
314920,201705,131,80,51,74960,47506,122466
314930,201705,984,500,484,466675,452945.9,919620.9
314940,201705,56,44,12,41228,11244,52472
314950,201705,38,30,8,27407.25,7496,34903.25
314960,201705,56,41,15,38417,14055,52472
314970,201705,132,66,66,61561,61842,123403
314980,201705,306,196,110,180795.05,102133,282928.05
314990,201705,466,250,216,233313.25,201502.75,434816.00
314995,201705,166,61,105,57157,98375.63,155532.63
315000,201705,83,66,17,60905.6,15929,76834.6
315010,201705,46,30,16,28110,14992,43102
315015,201705,165,134,31,124845.88,29047,153892.88
315020,201705,50,42,8,39354,7496,46850
315030,201705,123,93,30,86205,28110,114315
315040,201705,60,44,16,41228,14992,56220
315050,201705,197,119,78,111503,73086,184589
315053,201705,33,28,5,26236,4685,30921
315057,201705,97,81,16,75522.2,14992,90514.2
315060,201705,72,65,7,59031.98,6559,65590.98
315070,201705,107,61,46,57157,43102,100259
315080,201705,358,294,64,275478,59968,335446
315090,201705,110,67,43,62779,40291,103070
315100,201705,75,40,35,37480,32795,70275
315110,201705,294,163,131,151138.1,122747,273885.1
315120,201705,1577,786,791,732594.1,739996,1472590.1
315130,201705,311,224,87,209888,81519,291407
315140,201705,530,309,221,287003.18,207077,494080.18
315150,201705,966,443,523,414155,489770,903925
315160,201705,194,98,96,91826,89952,181778
315170,201705,341,220,121,204267.1,113095.9,317363.0
315180,201705,3177,1350,1827,1261530.95,1709323.1,2970854.05
315190,201705,309,180,129,168286,120873,289159
315200,201705,1171,653,518,609143.64,484147.9,1093291.54
315210,201705,1482,833,649,776212.05,606239.8,1382451.85
315213,201705,32,21,11,19677,10307,29984
315217,201705,185,144,41,134928,38417,173345
315220,201705,1453,1113,340,1042506.3,318486.3,1360992.6
315230,201705,164,120,44,112159,41228,153387
315240,201705,424,278,146,260486,136558.63,397044.63
315250,201705,2498,1245,1253,1165253.3,1173022.47,2338275.77
315260,201705,150,90,60,83018.2,56220,139238.2
315270,201705,123,81,42,74772.6,38641.88,113414.48
315280,201705,707,459,248,429709,232366.63,662075.63
315290,201705,192,111,81,104007,74960.34,178967.34
315300,201705,76,48,28,44976,26236,71212
315310,201705,67,59,8,55283,7496,62779
315320,201705,157,83,74,77771,69338,147109
315330,201705,55,47,8,44039,7496,51535
315340,201705,417,294,123,274316.9,115246.32,389563.22
315350,201705,140,85,55,79645,51535,131180
315360,201705,97,51,46,47787,43102,90889
315370,201705,56,30,26,28110,24080.9,52190.9
315380,201705,11,6,5,5622,4685,10307
315390,201705,48,13,35,12181,32795,44976
315400,201705,798,593,205,550675.7,191429.1,742104.8
315410,201705,337,202,135,188993,126495,315488
315415,201705,62,47,15,44039,14055,58094
315420,201705,195,146,49,135725.5,45913,181638.5
315430,201705,670,397,273,371989,255519.9,627508.9
315440,201705,77,57,20,53409,18740,72149
315445,201705,249,198,51,185216.79,47787,233003.79
315450,201705,193,147,46,137739,43102,180841
315460,201705,3255,1661,1594,1551478.9,1489682.05,3041160.95
315470,201705,45,23,22,21270,20614,41884
315480,201705,61,23,38,21551,35606,57157
315490,201705,604,372,232,347392.75,217384,564776.75
315500,201705,24,13,11,12181,10307,22488
315510,201705,153,97,56,90889,52472,143361
315520,201705,63,57,6,53409,5622,59031
315530,201705,51,28,23,26236,21551,47787
315540,201705,236,148,88,138676,82456,221132
315550,201705,174,134,40,125558,37480,163038
315560,201705,738,586,152,548519.9,142424,690943.9
315570,201705,299,164,135,150811.25,126495,277306.25
315580,201705,623,408,215,382296,201455,583751
315590,201705,214,114,100,106818,93700,200518
315600,201705,279,202,77,189274,71962,261236
315610,201705,95,48,47,44976,44039,89015
315620,201705,32,24,8,22488,7496,29984
315630,201705,135,89,46,83393,43102,126495
315640,201705,49,30,19,28110,17803,45913
315645,201705,67,47,20,44039,18272,62311
315650,201705,161,119,42,111222,39354,150576
315660,201705,476,188,288,176156,269856,446012
315670,201705,2171,1099,1072,1027093.75,1003313.1,2030406.85
315680,201705,862,579,283,539020.81,264458.88,803479.69
315690,201705,707,482,225,450579.63,210825,661404.63
315700,201705,1873,998,875,932315.51,819875,1752190.51
315710,201705,303,74,229,69338,214573,283911
315720,201705,414,265,149,248305,139331.9,387636.9
315725,201705,196,159,37,148983,34669,183652
315727,201705,38,21,17,19677,15929,35606
315730,201705,41,38,3,35606,2811,38417
315733,201705,87,56,31,52191,29047,81238
315737,201705,51,37,14,34669,13118,47787
315740,201705,43,38,5,35606,4685,40291
315750,201705,158,126,32,118022,29984,148006
315760,201705,44,29,15,27173,14055,41228
315765,201705,107,70,37,65590,34669,100259
315770,201705,231,134,97,125558,90608,216166
315780,201705,3200,1670,1530,1557155.15,1430987.31,2988142.46
315790,201705,199,154,45,144298,42165,186463
315800,201705,274,201,73,188056,68401,256457
315810,201705,88,50,38,46850,35606,82456
315820,201705,801,575,226,536527.77,211762,748289.77
315830,201705,141,82,59,76834,55283,132117
315840,201705,83,55,28,51535,26236,77771
315850,201705,259,191,68,178967,63716,242683
315860,201705,11,3,8,2811,7496,10307
315870,201705,34,28,6,26236,5622,31858
315880,201705,106,67,39,62779,36543,99322
315890,201705,70,51,19,47787,17803,65590
315895,201705,346,230,116,214761,108130,322891
315900,201705,65,35,30,32795,28110,60905
315910,201705,36,23,13,21223.05,12181,33404.05
315920,201705,184,124,60,116188,55283.95,171471.95
315930,201705,33,11,22,10307,20614,30921
315935,201705,143,112,31,104148,29038,133186
315940,201705,83,63,20,59031,18740,77771
315950,201705,62,42,20,39354,18740,58094
315960,201705,586,271,315,253570.94,294593,548163.94
315970,201705,40,31,9,29047,8433,37480
315980,201705,681,306,375,285229.1,351365.63,636594.73
315990,201705,244,146,98,136802,91545,228347
316000,201705,47,30,17,28110,15929,44039
316010,201705,70,61,9,57157,8433,65590
316020,201705,103,85,18,79645,16866,96511
316030,201705,402,203,199,190211,186229,376440
316040,201705,467,209,258,195531.89,241465,436996.89
316045,201705,63,57,6,53409,5622,59031
316050,201705,14,13,1,12181,937,13118
316060,201705,94,63,31,58749.9,29047,87796.9
316070,201705,1009,648,361,601557.25,337508,939065.25
316080,201705,105,64,41,59968,38417,98385
316090,201705,48,28,20,25299.1,18740,44039.1
316095,201705,60,50,10,46579,9370,55949
316100,201705,296,176,120,164349.9,112440,276789.9
316105,201705,30,21,9,19677,8433,28110
316110,201705,1922,1531,391,1424849.37,364399.3,1789248.67
316120,201705,77,55,22,51535,20332.9,71867.9
316130,201705,138,106,32,98667,29984,128651
316140,201705,24,18,6,16866,5622,22488
316150,201705,195,139,56,129540.25,52472,182012.25
316160,201705,87,53,34,49661,31858,81519
316165,201705,59,45,14,41978,12415.25,54393.25
316170,201705,209,141,68,131180,63716,194896
316180,201705,192,88,104,82128.05,97448,179576.05
316190,201705,132,93,39,86204,36543,122747
316200,201705,696,395,301,370115,281850,651965
316210,201705,731,484,247,453168.43,231439,684607.43
316220,201705,116,75,41,70275,38417,108692
316225,201705,17,9,8,8433,7496,15929
316230,201705,33,19,14,17803,13118,30921
316240,201705,604,487,117,455382.1,109629,565011.1
316245,201705,97,81,16,75897,14992,90889
316250,201705,1456,1022,434,948838.8,406433.12,1355271.92
316255,201705,110,90,20,83955.2,18740,102695.2
316257,201705,168,92,76,86204,71212,157416
316260,201705,237,153,84,142086.93,78615,220701.93
316265,201705,22,14,8,13118,7496,20614
316270,201705,671,466,205,433643.8,192085,625728.8
316280,201705,542,336,206,312646.5,192366.3,505012.8
316290,201705,651,430,221,400099.69,207077,607176.69
316292,201705,476,187,289,175219,270418.2,445637.2
316294,201705,104,64,40,59343.33,37480,96823.33
316295,201705,269,124,145,114766.5,135865,250631.5
316300,201705,98,67,31,62779,29047,91826
316310,201705,32,17,15,15929,14055,29984
316320,201705,48,28,20,26236,18740,44976
316330,201705,124,78,46,72149.25,42820.9,114970.15
316340,201705,137,98,39,91826,36543,128369
316350,201705,190,134,56,125231,52472,177703
316360,201705,23,18,5,16866,4685,21551
316370,201705,1026,553,473,514432.75,443191.63,957624.38
316380,201705,115,88,27,82456,25299,107755
316390,201705,124,87,37,81519,34669,116188
316400,201705,132,102,30,95574,28110,123684
316410,201705,307,225,82,209466.35,76834,286300.35
316420,201705,183,130,53,121107.25,49661,170768.25
316430,201705,151,75,76,70275,71212,141487
316440,201705,98,47,51,44039,47787,91826
316443,201705,36,34,2,31858,1874,33732
316447,201705,60,49,11,45913,10307,56220
316450,201705,209,162,47,151794,44039,195833
316460,201705,64,28,36,26236,33732,59968
316470,201705,1554,1118,436,1043942.15,407104.39,1451046.54
316480,201705,10,9,1,8433,937,9370
316490,201705,15,5,10,4685,9370,14055
316500,201705,153,103,50,96229.9,46850,143079.9
316510,201705,172,126,46,116797.15,43102,159899.15
316520,201705,193,119,74,110940.8,69338,180278.8
316530,201705,149,106,43,99322,40010,139332
316540,201705,136,74,62,68401,58094,126495
316550,201705,142,98,44,91705.89,41208,132913.89
316553,201705,203,102,101,95355.5,94637,189992.5
316555,201705,23,13,10,12181,9370,21551
316556,201705,11,7,4,6559,3748,10307
316557,201705,15,14,1,13118,937,14055
316560,201705,53,42,11,39354,10307,49661
316570,201705,249,225,24,210591,22488,233079
316580,201705,23,15,8,14055,7496,21551
316590,201705,119,103,16,96511,14992,111503
316600,201705,187,150,37,140550,34669,175219
316610,201705,66,44,22,40665.8,20614,61279.8
316620,201705,124,96,28,89952,26236,116188
316630,201705,37,27,10,25299,9370,34669
316640,201705,16,10,6,9370,5622,14992
316650,201705,60,47,13,44039,12181,56220
316660,201705,5,3,2,2811,1874,4685
316670,201705,436,152,284,142406,265546,407952
316680,201705,158,109,49,102133,45726,147859
316690,201705,190,118,72,110566,67464,178030
316695,201705,54,49,5,45913,4685,50598
316700,201705,12,6,6,5622,5622,11244
316710,201705,698,504,194,471732.9,181778,653510.9
316720,201705,4741,2418,2323,2252193.8,2173621.34,4425815.14
316730,201705,15,13,2,12181,1874,14055
316740,201705,135,79,56,74023,52472,126495
316750,201705,19,13,6,12181,5622,17803
316760,201705,330,263,67,246431,62779,309210
316770,201705,141,81,60,75897,56220,132117
316780,201705,62,34,28,31558.16,26236,57794.16
316790,201705,56,42,14,39354,13118,52472
316800,201705,1785,1108,677,1034823,633600,1668423
316805,201705,19,10,9,9370,8433,17803
316810,201705,64,41,23,38417,21270,59687
316820,201705,38,20,18,18740,16866,35606
316830,201705,90,39,51,36543,47506,84049
316840,201705,500,295,205,275665.5,190211,465876.5
316850,201705,340,221,119,205718.35,111503,317221.35
316860,201705,5918,2600,3318,2423306.59,3104755.63,5528062.22
316870,201705,1373,887,486,821986.85,449912.38,1271899.23
316880,201705,98,57,41,52753.9,38417,91170.9
316890,201705,248,166,82,155542,76834,232376
316900,201705,415,282,133,261733.84,124621,386354.84
316905,201705,14,10,4,9370,3748,13118
316910,201705,53,27,26,25299,24362,49661
316920,201705,130,103,27,95809,25299,121108
316930,201705,1904,946,958,880735.15,895491.85,1776227.00
316935,201705,838,502,336,468500.66,313332.8,781833.46
316940,201705,1068,612,456,572226.6,426700.53,998927.13
316950,201705,181,93,88,87141,82456,169597
316960,201705,1088,600,488,560607.9,456956.26,1017564.16
316970,201705,638,498,140,466626,131180,597806
316980,201705,115,70,45,65590,42155.63,107745.63
316990,201705,2125,1390,735,1295825.33,687046.88,1982872.21
317000,201705,315,245,70,229284,65590,294874
317005,201705,244,172,72,161164,67464,228628
317010,201705,6122,3345,2777,3118535.23,2600165.83,5718701.06
317020,201705,15820,6944,8876,6476763.63,8302372.54,14779136.17
317030,201705,85,31,54,29047,50598,79645
317040,201705,3089,1905,1184,1782194.64,1107347.6,2889542.24
317043,201705,71,49,22,45913,20551,66464
317047,201705,33,15,18,14055,16862,30917
317050,201705,188,141,47,132117,44039,176156
317052,201705,117,93,24,87141,22488,109629
317057,201705,194,148,46,138676,42540,181216
317060,201705,54,33,21,30921,19395.9,50316.9
317065,201705,58,48,10,44976,9370,54346
317070,201705,1951,921,1030,857355.85,963330,1820685.85
317075,201705,110,57,53,53409,49661,103070
317080,201705,794,430,364,401832.45,340881,742713.45
317090,201705,601,482,119,450977.92,111503,562480.92
317100,201705,401,300,101,279226.6,94637,373863.6
317103,201705,93,79,14,74023,13118,87141
317107,201705,35,32,3,29984,2811,32795
317110,201705,93,41,52,38417,48724,87141
317115,201705,40,34,6,31858,5622,37480
317120,201705,1742,875,867,812132.35,811649,1623781.35
317130,201705,1823,1154,669,1078401.2,625916.9,1704318.1
317140,201705,5,3,2,2811,1874,4685
317150,201705,260,157,103,147109,95761.4,242870.4
317160,201705,313,226,87,211481,81519,293000
317170,201705,202,148,54,138676,50598,189274
317180,201705,404,295,109,275712.25,102133,377845.25
317190,201705,252,170,82,159290,76271.8,235561.8
317200,201705,772,554,218,505991,203914,709905
317210,201705,152,86,66,79645.6,61842,141487.6
317220,201705,21,12,9,11244,8433,19677
320010,201705,602,447,155,415747.8,145235,560982.8
320013,201705,130,92,38,86204,35606,121810
320016,201705,277,170,107,159290,100259,259549
320020,201705,690,410,280,380624.37,259765.97,640390.34
320030,201705,146,107,39,100259,36215.05,136474.05
320035,201705,135,98,37,91826,34669,126495
320040,201705,489,263,226,245306.8,211762,457068.8
320050,201705,98,76,22,71212,20614,91826
320060,201705,1458,651,807,609941,755494.3,1365435.3
320070,201705,100,70,30,65590,28110,93700
320080,201705,749,429,320,399191.5,299840,699031.5
320090,201705,1183,825,358,768980.98,334602.8,1103583.78
320100,201705,311,181,130,168072.89,121730,289802.89
320110,201705,132,86,46,78896.1,43102,121998.1
320115,201705,107,87,20,81519,18740,100259
320120,201705,3206,1792,1414,1668331.35,1323591.96,2991923.31
320130,201705,7036,3397,3639,3161651.95,3401695.53,6563347.48
320140,201705,414,264,150,246056.6,140310,386366.6
320150,201705,1802,1061,741,987121.45,694307.63,1681429.08
320160,201705,674,289,385,269566.22,360629.96,630196.18
320170,201705,115,88,27,81707,25299,107006
320180,201705,45,26,19,24362,17803,42165
320190,201705,237,165,72,153828.03,67183,221011.03
320200,201705,53,40,13,37480,12181,49661
320210,201705,834,473,361,441702.8,336788,778490.8
320220,201705,300,115,185,106818.86,173064,279882.86
320225,201705,76,63,13,59031,12181,71212
320230,201705,512,333,179,310709.2,166927,477636.2
320240,201705,3027,1533,1494,1434266.9,1397996.1,2832263.0
320245,201705,413,290,123,271261.6,115251,386512.6
320250,201705,210,112,98,102790,91826,194616
320255,201705,141,112,29,103660.31,27033,130693.31
320260,201705,165,121,44,113377,41181.15,154558.15
320265,201705,164,130,34,121014,31858,152872
320270,201705,153,122,31,114314,29047,143361
320280,201705,897,546,351,505981.1,327509.81,833490.91
320290,201705,65,56,9,52472,8433,60905
320300,201705,504,362,142,337761.65,131809.55,469571.20
320305,201705,613,326,287,305462,268732,574194
320310,201705,203,115,88,107474,81714,189188
320313,201705,282,145,137,135865,128088,263953
320316,201705,107,89,18,83393,16866,100259
320320,201705,3212,1427,1785,1333717.8,1669048.5,3002766.3
320330,201705,260,189,71,176443.9,64653.81,241097.71
320332,201705,846,508,338,473704.9,315555.15,789260.05
320334,201705,234,144,90,134647,84330,218977
320335,201705,147,108,39,100024.95,36543,136567.95
320340,201705,581,397,184,370865,171753,542618
320350,201705,931,397,534,369553.14,499822.44,869375.58
320360,201705,159,84,75,78427,69682,148109
320370,201705,236,179,57,166167,52394,218561
320380,201705,288,197,91,183184.4,85267,268451.4
320390,201705,1072,654,418,612199,389540.45,1001739.45
320400,201705,323,228,95,211762.6,88734,300496.6
320405,201705,817,337,480,315544.34,449353.15,764897.49
320410,201705,930,480,450,448083.7,421285.34,869369.04
320420,201705,468,243,225,227223.2,210825,438048.2
320425,201705,181,102,79,95574,74023,169597
320430,201705,382,216,166,201548.95,155542,357090.95
320435,201705,167,110,57,102264.18,53409,155673.18
320440,201705,190,119,71,111221.9,66527,177748.9
320450,201705,124,72,52,67464,48724,116188
320455,201705,242,191,51,178031,47769,225800
320460,201705,239,153,86,143361,80582,223943
320465,201705,117,81,36,75540.94,33732,109272.94
320470,201705,612,391,221,366068.54,207069,573137.54
320480,201705,161,106,55,99322,51535,150857
320490,201705,2874,1418,1456,1325106.21,1361127.98,2686234.19
320495,201705,90,56,34,52454,31858,84312
320500,201705,9153,4678,4475,4355680.93,4182106.16,8537787.09
320501,201705,500,255,245,238935,229565,468500
320503,201705,262,187,75,175219,70275,245494
320506,201705,243,188,55,176156,51535,227691
320510,201705,872,423,449,393096.65,419756.05,812852.70
320515,201705,79,66,13,60905.45,12181,73086.45
320517,201705,191,134,57,125558,53409,178967
320520,201705,6449,2865,3584,2670773.45,3350725.93,6021499.38
320530,201705,5020,2540,2480,2370893.77,2318881.93,4689775.70
330010,201705,2822,1456,1366,1356053.9,1277769.66,2633823.56
330015,201705,156,62,94,57157.14,88078,145235.14
330020,201705,3406,1477,1929,1379999.29,1806911,3186910.29
330022,201705,207,118,89,110566,82457,193023
330023,201705,504,174,330,161867.4,309210,471077.4
330025,201705,512,120,392,112440,367022.9,479462.9
330030,201705,1836,1169,667,1088188.43,621889.36,1710077.79
330040,201705,2090,1050,1040,982023.55,973262,1955285.55
330045,201705,8149,2532,5617,2363218.55,5258222.66,7621441.21
330050,201705,767,488,279,457256,261423,718679
330060,201705,825,532,293,494551.05,274541,769092.05
330070,201705,3271,1261,2010,1177417.19,1882322.63,3059739.82
330080,201705,1420,689,731,641368.75,684010.3,1325379.05
330090,201705,351,205,146,192085,136802,328887
330093,201705,275,121,154,113377,144289,257666
330095,201705,101,50,51,46850,47787,94637
330100,201705,8992,4707,4285,4401857.84,4011203.4,8413061.24
330110,201705,468,212,256,197004.8,239872,436876.8
330115,201705,513,301,212,282037,198644,480681
330120,201705,353,182,171,169409.6,159758.5,329168.1
330130,201705,1383,428,955,400323.88,894817,1295140.88
330140,201705,589,307,282,287650,263298,550948
330150,201705,428,257,171,238935,159290,398225
330160,201705,206,129,77,120873,72149,193022
330170,201705,25887,9120,16767,8525966.32,15693978.79,24219945.11
330180,201705,231,146,85,133364.75,78942.25,212307.00
330185,201705,722,311,411,289899.1,385089,674988.1
330187,201705,245,85,160,79645,149920,229565
330190,201705,5499,2176,3323,2030503.25,3109198.63,5139701.88
330200,201705,4155,1465,2690,1368995.1,2515668.67,3884663.77
330205,201705,388,238,150,222456.46,140269,362725.46
330210,201705,939,573,366,533132.8,341255.95,874388.75
330220,201705,2358,1390,968,1299104.75,906079.1,2205183.85
330225,201705,531,298,233,278599,218321,496920
330227,201705,2325,807,1518,753057.63,1422063.32,2175120.95
330230,201705,193,114,79,106163,74023,180186
330240,201705,3408,1772,1636,1657242.24,1530999.29,3188241.53
330245,201705,145,58,87,54346,80769.4,135115.4
330250,201705,6254,3241,3013,3027735.1,2817169.86,5844904.96
330260,201705,524,161,363,150857,340131,490988
330270,201705,3148,1170,1978,1095166.5,1853013,2948179.5
330280,201705,436,286,150,265097.34,140541,405638.34
330285,201705,6827,2304,4523,2154392.4,4235084.2,6389476.6
330290,201705,571,224,347,208952,324858,533810
330300,201705,703,484,219,449760.85,205194,654954.85
330310,201705,404,240,164,223006.35,153668,376674.35
330320,201705,7609,2825,4784,2639157.7,4477952.6,7117110.3
330330,201705,9324,3599,5725,3367066.16,5360007.61,8727073.77
330340,201705,2574,1552,1022,1452341.53,957595.26,2409936.79
330350,201705,17033,6768,10265,6317447.3,9598326.54,15915773.84
330360,201705,2582,1275,1307,1193532.7,1224650,2418182.7
330370,201705,965,522,443,488364.4,413405.4,901769.8
330380,201705,812,350,462,327217.77,432425.9,759643.67
330385,201705,598,315,283,294219,265171,559390
330390,201705,5005,2765,2240,2579239.44,2097006.52,4676245.96
330395,201705,222,143,79,132305.05,71540.5,203845.55
330400,201705,624,317,307,293937.4,285367.54,579304.94
330410,201705,495,351,144,327239.63,134928,462167.63
330411,201705,222,127,95,118999,89015,208014
330412,201705,244,105,139,98104,130243,228347
330414,201705,6210,2529,3681,2366133.66,3445426.75,5811560.41
330415,201705,536,249,287,233313,267982.4,501295.4
330420,201705,2246,1197,1049,1118197.67,980759.3,2098956.97
330430,201705,1763,746,1017,698244.1,951430,1649674.1
330440,201705,237,105,132,98385,123684,222069
330450,201705,127,52,75,47788,70275,118063
330452,201705,1583,712,871,665205.18,816117.63,1481322.81
330455,201705,107550,38258,69292,35774948.86,64868783.22,100643732.08
330460,201705,262,109,153,102133,143361,245494
330470,201705,1222,670,552,621889.29,517214.63,1139103.92
330475,201705,1375,377,998,351376.3,934563.8,1285940.1
330480,201705,722,386,336,361682,313896,675578
330490,201705,13007,4652,8355,4352671.09,7821771.95,12174443.04
330500,201705,1302,606,696,567822,651778,1219600
330510,201705,10923,3478,7445,3254136.96,6969129.91,10223266.87
330513,201705,104,52,52,48724,48724,97448
330515,201705,850,349,501,325140.4,469063,794203.4
330520,201705,2310,879,1431,823408,1339816.3,2163224.3
330530,201705,231,120,111,112440,103820,216260
330540,201705,352,178,174,166786,162570,329356
330550,201705,3078,1104,1974,1033933,1848446.95,2882379.95
330555,201705,715,263,452,246431,423150,669581
330560,201705,509,195,314,182715,294209,476924
330570,201705,240,164,76,153668,71212,224880
330575,201705,741,333,408,311787,380276.75,692063.75
330580,201705,3281,1856,1425,1734492.5,1333726,3068218.5
330590,201705,294,155,139,145235,130243,275478
330600,201705,1029,665,364,621943.62,340318.4,962262.02
330610,201705,1475,816,659,758766.61,613456.45,1372223.06
330615,201705,179,140,39,131180,36543,167723
330620,201705,860,425,435,394011.06,405157.3,799168.36
330630,201705,3517,2201,1316,2048467.53,1225467.58,3273935.11
350010,201705,601,391,210,364447,196770,561217
350020,201705,37,19,18,17803,16866,34669
350030,201705,507,328,179,306212,166554.66,472766.66
350040,201705,131,48,83,44638.68,77771,122409.68
350050,201705,290,158,132,147764.9,123431.63,271196.53
350055,201705,83,47,36,44039,33732,77771
350060,201705,74,26,48,24362,44976,69338
350070,201705,782,451,331,418258.11,308458.12,726716.23
350075,201705,66,43,23,40291,21551,61842
350080,201705,52,31,21,28422.3,18740,47162.3
350090,201705,99,56,43,52472,40286.32,92758.32
350100,201705,301,185,116,172642.25,108692,281334.25
350110,201705,62,38,24,35606,22488,58094
350115,201705,148,88,60,81800.1,56220,138020.1
350120,201705,109,73,36,68401,33732,102133
350130,201705,355,168,187,156854,175219,332073
350140,201705,34,20,14,17241.4,13118,30359.4
350150,201705,66,52,14,48724,13118,61842
350160,201705,2438,940,1498,877484.77,1402602.58,2280087.35
350170,201705,396,243,153,225536.25,143080,368616.25
350180,201705,177,92,85,85923,79645,165568
350190,201705,882,427,455,397194.84,426012.85,823207.69
350200,201705,73,27,46,25097.46,42841.8,67939.26
350210,201705,1344,750,594,694066.96,555819.03,1249885.99
350220,201705,670,575,95,534717.75,89015,623732.75
350230,201705,75,54,21,50598,19677,70275
350240,201705,61,46,15,43102,14055,57157
350250,201705,1173,588,585,545196.45,547620.93,1092817.38
350260,201705,91,65,26,60905,24362,85267
350270,201705,812,535,277,500318.03,257824.65,758142.68
350275,201705,296,116,180,108318,168660,276978
350280,201705,4589,2333,2256,2175041.2,2111735.12,4286776.32
350290,201705,393,186,207,174001,192459.9,366460.9
350300,201705,48,24,24,22488,22488,44976
350310,201705,100,71,29,66527,27173,93700
350315,201705,36,20,16,18740,14992,33732
350320,201705,3252,1584,1668,1479271.62,1562682.52,3041954.14
350330,201705,1645,865,780,806400.3,729859.7,1536260.0
350335,201705,20,13,7,12181,6559,18740
350340,201705,136,72,64,67464,59968,127432
350350,201705,93,44,49,41228,45913,87141
350360,201705,126,85,41,79641,38136,117777
350370,201705,94,55,39,50910.3,36533.63,87443.93
350380,201705,713,300,413,280444.1,386699.9,667144.0
350390,201705,1381,560,821,523561.45,768152.7,1291714.15
350395,201705,26,18,8,16866,7496,24362
350400,201705,1670,887,783,821403.87,731119.28,1552523.15
350410,201705,2191,969,1222,905200.88,1144704.9,2049905.78
350420,201705,237,141,96,130788.54,89952,220740.54
350430,201705,75,43,32,39729,29984,69713
350440,201705,148,105,43,97401.25,40291,137692.25
350450,201705,1605,1034,571,961765.9,534934,1496699.9
350460,201705,330,119,211,111503,197425.9,308928.9
350470,201705,13,10,3,9370,2811,12181
350480,201705,152,84,68,78053,63716,141769
350490,201705,242,115,127,106818.9,118999,225817.9
350500,201705,34,16,18,14992,16866,31858
350510,201705,162,109,53,102133,49661,151794
350520,201705,443,199,244,183965,228003.3,411968.3
350530,201705,442,218,224,204266,209888,414154
350535,201705,55,43,12,39917,11244,51161
350540,201705,374,191,183,178094.47,171190,349284.47
350550,201705,2743,1616,1127,1507122.95,1054998.51,2562121.46
350560,201705,622,430,192,402905.32,179548.65,582453.97
350570,201705,4260,1758,2502,1643388.06,2341621,3985009.06
350580,201705,371,179,192,167723,179890.63,347613.63
350590,201705,896,487,409,456319,382296.3,838615.3
350600,201705,6032,3039,2993,2834491.21,2801618.72,5636109.93
350610,201705,1546,767,779,712998,728696,1441694
350620,201705,39,27,12,25299,11244,36543
350630,201705,236,137,99,127432.3,91827,219259.3
350635,201705,809,309,500,288539.82,467864.54,756404.36
350640,201705,119,87,32,81519,29984,111503
350650,201705,1845,1223,622,1141604.59,581797.1,1723401.69
350660,201705,737,334,403,312958,376670,689628
350670,201705,313,157,156,146875,146172,293047
350680,201705,179,98,81,91826,75616,167442
350690,201705,203,101,102,94637,95574,190211
350700,201705,658,322,336,298439.99,314832,613271.99
350710,201705,311,130,181,120623.1,169597,290220.1
350715,201705,47,41,6,38417,5622,44039
350720,201705,17,13,4,12181,3748,15929
350730,201705,41,26,15,24362,14055,38417
350740,201705,195,109,86,101842.53,80582,182424.53
350745,201705,22,11,11,10283,10307,20590
350750,201705,2103,1366,737,1272307.05,689007.3,1961314.35
350760,201705,3650,1582,2068,1481397.3,1935823.63,3417220.93
350770,201705,60,40,20,37480,18740,56220
350775,201705,47,34,13,31858,12172,44030
350780,201705,404,199,205,186463,192085,378548
350790,201705,385,171,214,160227,200518,360745
350800,201705,421,235,186,220195,174282,394477
350810,201705,496,397,99,370116.3,92763,462879.3
350820,201705,78,50,28,46850,26236,73086
350830,201705,84,50,34,46850,31858,78708
350840,201705,716,325,391,304244,365430,669674
350850,201705,1686,977,709,909821.26,664077,1573898.26
350860,201705,533,309,224,287642.16,209888,497530.16
350870,201705,430,292,138,273604,128931.9,402535.9
350880,201705,290,158,132,144722.2,123684,268406.2
350890,201705,40,25,15,23425,14055,37480
350900,201705,1381,452,929,420848.19,869723.4,1290571.59
350910,201705,27,19,8,17803,7496,25299
350920,201705,586,328,258,307023.7,241746,548769.7
350925,201705,1164,624,540,580835.77,504574.7,1085410.47
350930,201705,93,56,37,52472,34669,87141
350940,201705,678,369,309,344253.8,287724.8,631978.6
350945,201705,100,77,23,72149,21551,93700
350950,201705,14582,6972,7610,6503751.61,7120642.79,13624394.40
350960,201705,1267,578,689,536989.9,645589,1182578.9
350970,201705,1111,625,486,583398.3,455091.63,1038489.93
350980,201705,105,71,34,66527,31858,98385
350990,201705,362,126,236,117378,220850.9,338228.9
350995,201705,29,15,14,14055,13118,27173
351000,201705,632,459,173,427898.26,162101,589999.26
351010,201705,53,28,25,26236,23425,49661
351015,201705,61,43,18,40291,16866,57157
351020,201705,1639,932,707,871608.64,660398.2,1532006.84
351030,201705,313,220,93,203610.1,87141,290751.1
351040,201705,817,441,376,412280,351188.15,763468.15
351050,201705,3166,1526,1640,1423231.03,1534566.33,2957797.36
351060,201705,4809,1974,2835,1839796.16,2653419.25,4493215.41
351070,201705,412,264,148,246466,138676,385142
351080,201705,802,571,231,535027,215510,750537
351090,201705,66,29,37,27173,34669,61842
351100,201705,449,258,191,239563.35,178953.32,418516.67
351110,201705,2109,1022,1087,951865.99,1015994.89,1967860.88
351120,201705,74,40,34,37396.6,31858,69254.6
351130,201705,172,54,118,50598,110566,161164
351140,201705,335,235,100,218415.5,93700,312115.5
351150,201705,384,196,188,182809,176156,358965
351160,201705,244,161,83,150857,77771,228628
351170,201705,175,88,87,82456,80770,163226
351190,201705,84,58,26,54346,24362,78708
351200,201705,379,247,132,230564.6,123684,354248.6
351210,201705,132,60,72,56220,67464,123684
351220,201705,520,314,206,290907.81,193022,483929.81
351230,201705,277,200,77,186494.3,72130.26,258624.56
351240,201705,227,96,131,89764.6,122747,212511.6
351250,201705,64,45,19,42165,17803,59968
351260,201705,147,108,39,101196,36543,137739
351270,201705,52,22,30,20614,28110,48724
351280,201705,1100,504,596,468502.35,557937.39,1026439.74
351290,201705,222,97,125,90889,116844,207733
351300,201705,3745,1766,1979,1647621,1854011,3501632
351310,201705,736,388,348,362338,326076,688414
351320,201705,104,62,42,58094,39354,97448
351330,201705,40,28,12,26236,11244,37480
351340,201705,1185,747,438,693220.39,409448.32,1102668.71
351350,201705,2325,1246,1079,1165769.85,1010456.22,2176226.07
351360,201705,766,384,382,357934,356820.19,714754.19
351370,201705,361,190,171,178025.32,159602.3,337627.62
351380,201705,8923,4126,4797,3851090.65,4486099.66,8337190.31
351385,201705,28,19,9,17803,8433,26236
351390,201705,274,199,75,185733.26,70275,256008.26
351400,201705,60,38,22,35606,20568.63,56174.63
351410,201705,413,256,157,239403.5,146828,386231.5
351420,201705,60,49,11,45913,10307,56220
351430,201705,81,46,35,43102,32795,75897
351440,201705,783,534,249,498200.2,233309,731509.2
351450,201705,245,124,121,116188,113377,229565
351460,201705,122,55,67,51535,62779,114314
351470,201705,142,76,66,71203,61842,133045
351480,201705,514,275,239,256738.1,223825.88,480563.98
351490,201705,295,101,194,94637,181778,276415
351492,201705,33,24,9,22488,8433,30921
351495,201705,29,19,10,17803,9370,27173
351500,201705,3521,1514,2007,1412930.37,1875735.1,3288665.47
351510,201705,1753,721,1032,675295.9,964819.54,1640115.44
351512,201705,19,15,4,14055,3748,17803
351515,201705,187,104,83,97448,77771,175219
351518,201705,702,428,274,400095,256597.45,656692.45
351519,201705,73,47,26,44039,24362,68401
351520,201705,138,86,52,79958,48724,128682
351530,201705,18,14,4,13118,3748,16866
351535,201705,133,74,59,69338,55283,124621
351540,201705,420,299,121,277823,113002.2,390825.2
351550,201705,1263,768,495,712873.1,463805.63,1176678.73
351560,201705,73,37,36,34669,33732,68401
351565,201705,10,5,5,4685,4685,9370
351570,201705,2529,1324,1205,1238732.03,1128438.26,2367170.29
351580,201705,35,30,5,28110,4685,32795
351590,201705,67,46,21,43102,19677,62779
351600,201705,187,136,51,127432,47787,175219
351610,201705,60,27,33,25299,30921,56220
351620,201705,5979,3423,2556,3197183.48,2390966.31,5588149.79
351630,201705,2459,1266,1193,1181303.69,1115962.32,2297266.01
351640,201705,1636,784,852,732986.99,796825.4,1529812.39
351650,201705,30,26,4,24362,3748,28110
351660,201705,154,95,59,89015,55283,144298
351670,201705,722,446,276,415654.25,258612,674266.25
351680,201705,77,63,14,59031,13118,72149
351685,201705,40,25,15,23425,14055,37480
351690,201705,308,216,92,200279.17,86204,286483.17
351700,201705,162,113,49,105881,45913,151794
351710,201705,72,51,21,47787,19677,67464
351720,201705,137,64,73,59968,68401,128369
351730,201705,92,65,27,60905,25294.32,86199.32
351740,201705,704,469,235,439172,220190.32,659362.32
351750,201705,358,148,210,137739.7,196761,334500.7
351760,201705,792,612,180,573444,168524,741968
351770,201705,285,247,38,230503,35606,266109
351780,201705,167,90,77,84330,72149,156479
351790,201705,238,126,112,118062,104944,223006
351800,201705,50,32,18,29984,16866,46850
351810,201705,121,80,41,74679,38417,113096
351820,201705,881,633,248,588837.8,232371.32,821209.12
351830,201705,502,186,316,173532.4,296092,469624.4
351840,201705,1835,941,894,872229.75,835932.47,1708162.22
351850,201705,222,169,53,157744.9,49661,207405.9
351860,201705,739,480,259,446013.77,242678.32,688692.09
351870,201705,5563,2633,2930,2457285.91,2738481.6,5195767.51
351880,201705,18801,8339,10462,7790997.68,9788551.44,17579549.12
351885,201705,95,62,33,58094,30921,89015
351890,201705,74,63,11,59031,10307,69338
351900,201705,220,131,89,122092,83393,205485
351905,201705,76,34,42,31858,39354,71212
351907,201705,3040,1328,1712,1240893.23,1603104.9,2843998.13
351910,201705,178,73,105,68401,98385,166786
351920,201705,136,81,55,75897,51512.96,127409.96
351925,201705,83,57,26,53409,24362,77771
351930,201705,376,259,117,242589.3,109629,352218.3
351940,201705,224,103,121,96511,113377,209888
351950,201705,144,81,63,75585,59031,134616
351960,201705,815,381,434,356665.58,404821.58,761487.16
351970,201705,1868,988,880,923648.04,823989,1747637.04
351980,201705,140,72,68,65590,63716,129306
351990,201705,288,194,94,180841,87290.92,268131.92
352000,201705,352,210,142,196395.2,133054,329449.2
352010,201705,336,197,139,184589,130243,314832
352020,201705,195,70,125,65590,117125,182715
352030,201705,987,499,488,466579.25,455413.2,921992.45
352040,201705,572,245,327,229565,306399,535964
352042,201705,259,91,168,85267,157135,242402
352044,201705,384,230,154,214573.1,144298,358871.1
352050,201705,3095,1267,1828,1179882.2,1711757.53,2891639.73
352060,201705,100,64,36,59968,33732,93700
352070,201705,96,68,28,62780,26236,89016
352080,201705,65,39,26,35606,24362,59968
352090,201705,171,116,55,108692,51535,160227
352100,201705,249,123,126,115251,116930,232181
352110,201705,110,33,77,30921,72149,103070
352115,201705,73,28,45,26236,42165,68401
352120,201705,102,61,41,57157,38417,95574
352130,201705,220,184,36,172220.6,33732,205952.6
352140,201705,184,74,110,68870,103070,171940
352150,201705,121,68,53,62779.7,49661,112440.7
352160,201705,128,87,41,81519,38417,119936
352170,201705,372,253,119,236124.7,111503,347627.7
352180,201705,591,403,188,375598.55,176152,551750.55
352190,201705,268,102,166,95564.63,155495.15,251059.78
352200,201705,31,19,12,17803,11244,29047
352210,201705,3587,1488,2099,1386911.22,1961418.97,3348330.19
352215,201705,48,28,20,26175.67,18209.8,44385.47
352220,201705,6945,2747,4198,2568823.95,3931358.72,6500182.67
352230,201705,3076,1967,1109,1830795.74,1033703.64,2864499.38
352240,201705,2125,1265,860,1182355.29,803665.25,1986020.54
352250,201705,2538,1346,1192,1258267.6,1114892.7,2373160.3
352260,201705,1120,638,482,596579.32,451353,1047932.32
352265,201705,65,30,35,28110,32795,60905
352270,201705,381,217,164,202392.84,153613,356005.84
352280,201705,377,237,140,221757,130894.32,352651.32
352290,201705,174,110,64,102508,59968,162476
352300,201705,105,81,24,75897,22488,98385
352310,201705,5588,2768,2820,2581650.96,2637515.25,5219166.21
352320,201705,902,488,414,454664.99,384967.55,839632.54
352330,201705,527,226,301,211434.05,281756,493190.05
352340,201705,1393,689,704,641116.4,658570.75,1299687.15
352350,201705,314,200,114,187400,106537,293937
352360,201705,220,85,135,78754.85,123945,202699.85
352370,201705,104,71,33,66527,30921,97448
352380,201705,116,73,43,68401,40291,108692
352390,201705,2405,1102,1303,1028199.9,1218569.64,2246769.54
352400,201705,457,191,266,178264.25,248960.9,427225.15
352410,201705,730,522,208,484966.9,194615,679581.9
352420,201705,99,62,37,58094,34669,92763
352430,201705,1739,769,970,713996.55,907221.59,1621218.14
352440,201705,3001,1552,1449,1445615.89,1354862.4,2800478.29
352450,201705,185,157,28,147109,26236,173345
352460,201705,568,289,279,270526.64,260721.1,531247.74
352470,201705,560,193,367,180841,343870,524711
352480,201705,1370,763,607,714307,568196.9,1282503.9
352490,201705,79,32,47,29984,44039,74023
352500,201705,1213,541,672,505137.8,628250,1133387.8
352510,201705,731,388,343,362619.3,321391,684010.3
352520,201705,518,222,296,208014,277211.45,485225.45
352530,201705,1699,882,817,825497,763936.3,1589433.3
352540,201705,77,51,26,47787,24362,72149
352550,201705,186,107,79,100259,73282.77,173541.77
352560,201705,52,41,11,38417,10307,48724
352570,201705,650,344,306,321725.63,286722,608447.63
352580,201705,58,40,18,36543.33,16866,53409.33
352585,201705,14,5,9,4685,8433,13118
352590,201705,4216,2115,2101,1976476.7,1967752.11,3944228.81
352600,201705,350,244,106,227691.3,99313,327004.3
352610,201705,906,429,477,399286.51,446949,846235.51
352620,201705,964,382,582,356997.1,545334,902331.1
352630,201705,215,78,137,73086,127937.98,201023.98
352640,201705,541,374,167,349086.88,156479,505565.88
352650,201705,93,63,30,59031,28110,87141
352660,201705,83,50,33,46850,30921,77771
352670,201705,1617,880,737,821147.93,689232.02,1510379.95
352680,201705,896,571,325,531828.58,303276.2,835104.78
352690,201705,4227,1952,2275,1819840.5,2127877.87,3947718.37
352700,201705,113,64,49,59968,45913,105881
352710,201705,1279,666,613,622168.35,571851.6,1194019.95
352720,201705,1182,591,591,551269.1,553762.32,1105031.42
352725,201705,27,25,2,23425,1874,25299
352730,201705,358,177,181,164691.81,169035,333726.81
352740,201705,407,255,152,236996.04,142424,379420.04
352750,201705,24,16,8,14710.9,7496,22206.9
352760,201705,191,138,53,129306,49661,178967
352770,201705,85,68,17,62780,15929,78709
352780,201705,84,44,40,41228,37480,78708
352790,201705,24,21,3,19677,2811,22488
352800,201705,240,163,77,152731,71867.9,224598.9
352810,201705,163,108,55,98447.92,51535,149982.92
352820,201705,63,53,10,49243.1,9370,58613.1
352830,201705,87,61,26,57157,24362,81519
352840,201705,544,281,263,262033.1,246150,508183.1
352850,201705,1311,477,834,446293.1,781056,1227349.1
352860,201705,123,80,43,74960,40291,115251
352870,201705,36,22,14,20614,13118,33732
352880,201705,186,130,56,121810,52472,174282
352885,201705,29,20,9,18740,8433,27173
352890,201705,53,36,17,33732,15648,49380
352900,201705,4922,2368,2554,2202609.18,2387412.51,4590021.69
352910,201705,40,30,10,28110,9370,37480
352920,201705,712,435,277,406658,259549,666207
352930,201705,1240,598,642,558663.85,598333.25,1156997.10
352940,201705,6241,2702,3539,2520363.07,3311032.08,5831395.15
352950,201705,91,38,53,35606,49661,85267
352960,201705,68,44,24,41228,22488,63716
352965,201705,20,8,12,7496,11244,18740
352970,201705,450,333,117,307028.34,108692.7,415721.04
352980,201705,180,91,89,85267,83393,168660
352990,201705,875,413,462,384296.14,431142.79,815438.93
353000,201705,67,32,35,29984,32795,62779
353010,201705,560,345,215,323265,201436.27,524701.27
353020,201705,287,207,80,193959,74960,268919
353030,201705,1149,528,621,494417.63,581202.73,1075620.36
353040,201705,87,53,34,49661,31858,81519
353050,201705,1273,792,481,736827.55,450697,1187524.55
353060,201705,7420,3477,3943,3243995.9,3687841.53,6931837.43
353070,201705,1623,1005,618,935538,577799.04,1513337.04
353080,201705,1309,680,629,634583.52,589364.32,1223947.84
353090,201705,59,36,23,33732,21551,55283
353100,201705,63,52,11,48724,10307,59031
353110,201705,1801,590,1211,551129.63,1133012.32,1684141.95
353120,201705,69,35,34,32795,31858,64653
353130,201705,848,415,433,387899.63,405692.89,793592.52
353140,201705,596,233,363,217998,340131,558129
353150,201705,361,200,161,186463.3,150847.63,337310.93
353160,201705,104,85,19,79645,17803,97448
353170,201705,201,66,135,61832.63,126467.63,188300.26
353180,201705,946,438,508,409173.95,475481,884654.95
353190,201705,450,321,129,299738.95,120873,420611.95
353200,201705,182,88,94,82175,88078,170253
353205,201705,25,18,7,16866,6559,23425
353210,201705,83,51,32,47787,29984,77771
353215,201705,58,34,24,31858,22488,54346
353220,201705,79,43,36,40291,32795.93,73086.93
353230,201705,157,61,96,57157,89952,147109
353240,201705,269,146,123,136802,115251,252053
353250,201705,199,107,92,100259,86204,186463
353260,201705,417,309,108,288418.25,101186.63,389604.88
353270,201705,69,51,18,47787,16210.1,63997.1
353280,201705,92,46,46,43102,43102,86204
353282,201705,108,81,27,75897,25299,101196
353284,201705,24,19,5,17803,4685,22488
353286,201705,1,1,0,937,0,937
353290,201705,79,48,31,44976,29038,74014
353300,201705,389,217,172,201814.55,161164,362978.55
353310,201705,50,46,4,43102,3748,46850
353320,201705,56,36,20,33732,18740,52472
353325,201705,55,36,19,33732,17504,51236
353330,201705,70,54,16,50458,14992,65450
353340,201705,594,190,404,178030,377976.54,556006.54
353350,201705,894,416,478,388986.92,446923,835909.92
353360,201705,110,87,23,81206.7,21270,102476.7
353370,201705,118,70,48,64653.55,44976,109629.55
353380,201705,30,21,9,19673,8433,28106
353390,201705,1023,497,526,465689,492862,958551
353400,201705,45,26,19,24362,17803,42165
353410,201705,117,71,46,66527,42400.1,108927.1
353420,201705,54,24,30,22488,28110,50598
353430,201705,542,354,188,328043.08,175724.9,503767.98
353440,201705,10200,4453,5747,4162299.33,5378338.17,9540637.50
353450,201705,59,29,30,27173,28110,55283
353460,201705,598,317,281,292980.99,261649.25,554630.24
353470,201705,2115,1148,967,1070576.26,904639.82,1975216.08
353475,201705,230,153,77,140722.3,72149,212871.3
353480,201705,191,151,40,141487,37480,178967
353490,201705,226,133,93,124621,87141,211762
353500,201705,176,107,69,99041.3,64653,163694.3
353510,201705,103,74,29,69319.63,27163.63,96483.26
353520,201705,207,144,63,134928,59031,193959
353530,201705,440,236,204,220504,191148,411652
353540,201705,347,231,116,216130.02,108692,324822.02
353550,201705,717,487,230,453227.85,215510,668737.85
353560,201705,621,262,359,244557.6,336079.22,580636.82
353570,201705,60,31,29,29047,27173,56220
353580,201705,359,279,80,260955,74960,335915
353590,201705,79,54,25,50598,23425,74023
353600,201705,255,146,109,136490,102133,238623
353610,201705,114,60,54,56220,50598,106818
353620,201705,551,296,255,275119.52,238653.9,513773.42
353625,201705,52,24,28,22488,26236,48724
353630,201705,232,167,65,152226.07,60905,213131.07
353640,201705,122,83,39,76834.5,36543,113377.5
353650,201705,804,323,481,301058.1,450697,751755.1
353657,201705,21,15,6,14055,5622,19677
353660,201705,256,142,114,133054,106536.9,239590.9
353670,201705,695,416,279,388855.1,261423,650278.1
353680,201705,100,71,29,66527,27173,93700
353690,201705,46,36,10,33732,9370,43102
353700,201705,293,205,88,192085,82456,274541
353710,201705,400,184,216,171471.4,202392,373863.4
353715,201705,45,37,8,34387.9,7496,41883.9
353720,201705,362,163,199,152713,186434,339147
353730,201705,1110,683,427,636833.45,399817.9,1036651.35
353740,201705,639,365,274,341723.9,256738,598461.9
353750,201705,98,61,37,56634.62,34669,91303.62
353760,201705,2567,960,1607,895936.2,1501938.37,2397874.57
353770,201705,99,80,19,74491.5,17803,92294.5
353780,201705,1055,542,513,505175.3,479462.9,984638.2
353790,201705,503,287,216,267635.85,202272,469907.85
353800,201705,3221,1656,1565,1543907.46,1463002.08,3006909.54
353810,201705,235,131,104,121908.75,97421,219329.75
353820,201705,175,87,88,81519,81842.54,163361.54
353830,201705,47,40,7,37480,6559,44039
353850,201705,164,87,77,81519,72149,153668
353860,201705,459,202,257,187915.35,240527.9,428443.25
353870,201705,4900,2448,2452,2280866.2,2288820.15,4569686.35
353880,201705,633,444,189,414576.2,176156.36,590732.56
353890,201705,585,318,267,297404,250179,547583
353900,201705,140,66,74,61842,69338,131180
353910,201705,181,86,95,80582,89015,169597
353920,201705,457,246,211,229331.7,197693.64,427025.34
353930,201705,962,576,386,538306.5,360516.9,898823.4
353940,201705,188,104,84,96698.4,77865,174563.4
353950,201705,516,325,191,304515.63,178967,483482.63
353960,201705,69,55,14,51535,13118,64653
353970,201705,72,46,26,43102,24362,67464
353980,201705,1500,742,758,692647.59,710234,1402881.59
353990,201705,77,43,34,40291,31858,72149
354000,201705,366,169,197,157698,184397.6,342095.6
354010,201705,97,51,46,47787,42444,90231
354020,201705,535,337,198,314832,185244.9,500076.9
354025,201705,52,44,8,41228,7496,48724
354030,201705,63,32,31,29984,29047,59031
354040,201705,91,65,26,60905,24362,85267
354050,201705,175,104,71,97167,66527,163694
354060,201705,763,375,388,351375,361683.65,713058.65
354070,201705,860,485,375,452317.52,351375,803692.52
354075,201705,196,107,89,100166,82456.9,182622.9
354080,201705,275,120,155,112158.9,145235,257393.9
354085,201705,19,12,7,11244,6559,17803
354090,201705,320,177,143,165770,133991,299761
354100,201705,5387,2212,3175,2062682.1,2970469.55,5033151.65
354105,201705,79,40,39,37480,36543,74023
354110,201705,45,21,24,19677,22488,42165
354120,201705,143,100,43,93563.29,40291,133854.29
354130,201705,666,448,218,419542,203985,623527
354140,201705,3159,1483,1676,1385952.42,1569367.62,2955320.04
354150,201705,618,387,231,361401,215041.5,576442.5
354160,201705,664,409,255,382061.75,238654,620715.75
354165,201705,18,12,6,11244,5622,16866
354170,201705,169,115,54,107099.1,50598,157697.1
354180,201705,66,41,25,38097,23425,61522
354190,201705,198,90,108,82737.1,101196,183933.1
354200,201705,131,72,59,66996,55283,122279
354210,201705,72,36,36,33732,33732,67464
354220,201705,640,405,235,378548.1,219258.18,597806.28
354230,201705,156,65,91,60905,84330.8,145235.8
354240,201705,316,205,111,190867.69,103382.3,294249.99
354250,201705,88,51,37,47787,34669,82456
354260,201705,1865,868,997,801275.46,931935,1733210.46
354270,201705,97,72,25,67464,23425,90889
354280,201705,31,17,14,15929,13118,29047
354290,201705,149,101,48,93372.55,44976,138348.55
354300,201705,419,289,130,270481,121810,392291
354310,201705,101,73,28,67464.1,26236,93700.1
354320,201705,187,96,91,89952,85267,175219
354323,201705,14,12,2,11244,1874,13118
354325,201705,113,62,51,58094,47787,105881
354330,201705,2465,849,1616,791126.24,1512063.69,2303189.93
354340,201705,10618,5140,5478,4798545.62,5127674.65,9926220.27
354350,201705,130,88,42,82456,39213.45,121669.45
354360,201705,90,47,43,44039,40291,84330
354370,201705,262,135,127,126495,118999,245494
354380,201705,202,118,84,109792,78708,188500
354390,201705,2735,991,1744,928258.6,1632022.04,2560280.64
354400,201705,324,166,158,154465.9,147202.8,301668.7
354410,201705,597,288,309,268915.32,288315.1,557230.42
354420,201705,261,166,95,155542,89015,244557
354425,201705,307,174,133,163038,124612,287650
354430,201705,191,124,67,113864.95,62029.4,175894.35
354440,201705,44,31,13,28929,12181,41110
354450,201705,44,29,15,27173,14055,41228
354460,201705,95,54,41,50598,38417,89015
354470,201705,38,27,11,25299,10307,35606
354480,201705,116,62,54,58085,50588.63,108673.63
354490,201705,143,89,54,83236.81,50598,133834.81
354500,201705,394,194,200,181778,187400,369178
354510,201705,109,74,35,69234.56,32795,102029.56
354515,201705,39,15,24,14055,22488,36543
354520,201705,1556,700,856,653392.6,801734.68,1455127.28
354530,201705,594,313,281,290934.5,262454.1,553388.6
354540,201705,271,150,121,140550,113372.32,253922.32
354550,201705,44,25,19,23425,17803,41228
354560,201705,158,90,68,84330,63706.63,148036.63
354570,201705,148,97,51,90889,47787,138676
354580,201705,1991,951,1040,887338.7,974190.22,1861528.92
354600,201705,280,152,128,141000.36,119931.32,260931.68
354610,201705,69,61,8,57157,7496,64653
354620,201705,64,18,46,16866,43102,59968
354625,201705,19,12,7,11244,6555,17799
354630,201705,331,216,115,201789.6,107755,309544.6
354640,201705,786,510,276,474014.5,258612,732626.5
354650,201705,73,38,35,35597,32758.26,68355.26
354660,201705,783,566,217,526859.85,203329,730188.85
354670,201705,289,102,187,95574,174283,269857
354680,201705,1221,462,759,432894,710715,1143609
354690,201705,86,59,27,54347,25299,79646
354700,201705,81,56,25,52472,23425,75897
354710,201705,54,37,17,34044.3,15929,49973.3
354720,201705,22,21,1,19677,937,20614
354730,201705,1909,807,1102,753527.5,1031761.9,1785289.4
354740,201705,55,39,16,36543,14992,51535
354750,201705,422,251,171,235178,160227,395405
354760,201705,502,306,196,285162,183371,468533
354765,201705,11,5,6,4685,5622,10307
354770,201705,316,224,92,208797.71,86204,295001.71
354780,201705,8085,3281,4804,3059738.38,4496882.97,7556621.35
354790,201705,119,68,51,63716,47787,111503
354800,201705,398,222,176,208014,164631,372645
354805,201705,105,53,52,49037,48724,97761
354810,201705,139,81,58,75615.9,54346,129961.9
354820,201705,177,78,99,72880,92763,165643
354830,201705,37,22,15,20614,14055,34669
354840,201705,53,35,18,32795,16866,49661
354850,201705,4586,2027,2559,1892306.6,2392645.66,4284952.26
354860,201705,336,164,172,153668,159103.3,312771.3
354870,201705,11384,5205,6179,4850923.88,5781076.68,10632000.56
354880,201705,2962,1099,1863,1026655.55,1743782.96,2770438.51
354890,201705,2802,1546,1256,1443650.28,1175551.24,2619201.52
354900,201705,59,38,21,35606,19677,55283
354910,201705,1164,613,551,572470.22,516287,1088757.22
354920,201705,52,44,8,41228,7496,48724
354925,201705,11,6,5,5622,4685,10307
354930,201705,32,28,4,25970,3748,29718
354940,201705,799,583,216,544119.24,202392,746511.24
354950,201705,231,150,81,139948,75897,215845
354960,201705,173,67,106,62779,99041,161820
354970,201705,809,518,291,481529.09,272039.31,753568.40
354980,201705,8209,3072,5137,2871959.58,4811555.35,7683514.93
354990,201705,9033,4243,4790,3966484.3,4482030.25,8448514.55
354995,201705,524,187,337,175219,315178.69,490397.69
355000,201705,451,148,303,138671.32,282787,421458.32
355010,201705,624,400,224,373863.45,207715.36,581578.81
355020,201705,707,442,265,413212.9,248297,661509.9
355030,201705,200074,77293,122781,72213003.1,114944741.4,187157744.5
355040,201705,700,336,364,314551,340880.6,655431.6
355050,201705,156,104,52,95946.77,48724,144670.77
355060,201705,1305,681,624,633055.87,582861.25,1215917.12
355070,201705,1454,716,738,668068.44,690521,1358589.44
355080,201705,199,115,84,107547.74,77836.9,185384.64
355090,201705,280,188,92,174096,86204,260300
355100,201705,4680,2353,2327,2186416.2,2177750.57,4364166.77
355110,201705,294,195,99,180982.55,92763,273745.55
355120,201705,115,84,31,78239.5,29047,107286.5
355130,201705,50,26,24,24362,22488,46850
355140,201705,183,119,64,111503,59968,171471
355150,201705,681,407,274,380137.1,256738,636875.1
355160,201705,422,193,229,178498.8,214573,393071.8
355170,201705,1995,1037,958,970311.87,897159.09,1867470.96
355180,201705,617,256,361,238653.9,337156.02,575809.92
355190,201705,213,145,68,135865,63716,199581
355200,201705,111,62,49,58094,45913,104007
355210,201705,670,390,280,365430,262332.63,627762.63
355220,201705,6354,3416,2938,3192047.78,2745779.44,5937827.22
355230,201705,105,65,40,60905,37475.32,98380.32
355240,201705,4037,1787,2250,1663477.95,2104247.38,3767725.33
355250,201705,5197,2538,2659,2371268.51,2488339.6,4859608.11
355255,201705,50,29,21,27173,19677,46850
355260,201705,181,109,72,101121.36,67446,168567.36
355270,201705,168,99,69,92763,63951,156714
355280,201705,6082,2611,3471,2441496.75,3246908.07,5688404.82
355290,201705,78,59,19,55283,17803,73086
355300,201705,175,118,57,110238.05,53409,163647.05
355310,201705,105,59,46,55283,43102,98385
355320,201705,94,47,47,43757.9,43343.3,87101.2
355330,201705,269,147,122,137739,114314,252053
355340,201705,1243,524,719,489114.68,672974.2,1162088.88
355350,201705,133,69,64,64653,59968,124621
355360,201705,166,99,67,92556.86,62779,155335.86
355365,201705,26,21,5,19677,4685,24362
355370,201705,1023,575,448,533956.59,417762.49,951719.08
355380,201705,763,514,249,480218.8,233313,713531.8
355385,201705,50,35,15,32795,14055,46850
355390,201705,105,59,46,55283,43102,98385
355395,201705,185,113,72,105080.32,67464,172544.32
355400,201705,1495,936,559,872823.98,523220.9,1396044.88
355410,201705,4785,2232,2553,2076430.28,2383094.6,4459524.88
355420,201705,44,33,11,30921,10307,41228
355430,201705,329,204,125,190492.1,117125,307617.1
355440,201705,76,43,33,40291,30921,71212
355450,201705,414,192,222,175735.87,206421.3,382157.17
355460,201705,69,54,15,49661.51,14055,63716.51
355465,201705,50,32,18,29984,16866,46850
355470,201705,186,71,115,65590.55,107755,173345.55
355475,201705,10,7,3,6559,2811,9370
355480,201705,443,191,252,177843,234240.63,412083.63
355490,201705,112,82,30,76834,28110,104944
355495,201705,52,25,27,23425,25299,48724
355500,201705,1696,961,735,895948.14,688093.86,1584042.00
355510,201705,269,199,70,183066.5,65590,248656.5
355520,201705,37,29,8,27173,7496,34669
355530,201705,21,14,7,13118,6559,19677
355535,201705,75,33,42,30921,39354,70275
355540,201705,2289,917,1372,857664.31,1284608.63,2142272.94
355550,201705,66,40,26,37480,24362,61842
355560,201705,229,119,110,111503,102445.3,213948.3
355570,201705,28,17,11,15929,10307,26236
355580,201705,272,184,88,172408,82451.32,254859.32
355590,201705,22,14,8,13118,7496,20614
355600,201705,273,143,130,133991,121524.32,255515.32
355610,201705,199,130,69,121810,64653,186463
355620,201705,1217,552,665,515490.9,622538.8,1138029.7
355630,201705,404,282,122,263298,114314,377612
355635,201705,128,59,69,55283,64640,119923
355640,201705,573,333,240,311084,224880,535964
355645,201705,820,353,467,329099.64,435733.21,764832.85
355650,201705,1928,892,1036,834278,970713.63,1804991.63
355660,201705,268,143,125,133991,117120.32,251111.32
355670,201705,451,165,286,154605,267982,422587
355680,201705,211,117,94,109629,88078,197707
355690,201705,83,39,44,36543,40890,77433
355695,201705,14,12,2,11244,1874,13118
355700,201705,1102,586,516,543101.61,483211,1026312.61
355710,201705,2150,1178,972,1098619.68,910173.9,2008793.58
355715,201705,20,18,2,16866,1874,18740
355720,201705,204,124,80,114626.66,74956,189582.66
355730,201705,85,51,34,46928.53,31858,78786.53
410010,201705,128,107,21,100259,19677,119936
410020,201705,102,91,11,85267,10307,95574
410030,201705,159,102,57,94918.2,53409,148327.2
410040,201705,979,524,455,490191.55,425951.24,916142.79
410045,201705,34,29,5,27173,4685,31858
410050,201705,465,261,204,244537,190398.5,434935.5
410060,201705,257,201,56,187842,52472,240314
410070,201705,329,264,65,247368,60905,308273
410080,201705,166,109,57,102133,53409,155542
410090,201705,73,65,8,60699,7496,68195
410100,201705,294,208,86,194896,79879.25,274775.25
410105,201705,39,24,15,22488,14055,36543
410110,201705,309,187,122,175219,114314,289533
410115,201705,27,18,9,16866,8433,25299
410120,201705,446,225,221,210528.9,207077,417605.9
410130,201705,40,26,14,24362,13118,37480
410140,201705,2983,1452,1531,1355375.63,1433038.63,2788414.26
410150,201705,2659,1072,1587,1004068.18,1486245.5,2490313.68
410160,201705,495,319,176,298621.9,164912,463533.9
410165,201705,66,43,23,40291,21551,61842
410170,201705,169,129,40,118677.83,37480,156157.83
410180,201705,2059,1188,871,1109239.69,814789.08,1924028.77
410185,201705,43,39,4,36543,3748,40291
410190,201705,401,244,157,228628,147109,375737
410200,201705,962,727,235,679404.15,219913.9,899318.05
410210,201705,543,278,265,260486,247743,508229
410220,201705,38,22,16,20614,14992,35606
410230,201705,121,71,50,66527,46850,113377
410240,201705,703,460,243,430457.9,227691,658148.9
410250,201705,383,284,99,265514.6,92742.89,358257.49
410260,201705,305,165,140,154605,131180,285785
410270,201705,30,20,10,18740,9370,28110
410275,201705,74,56,18,52472,16866,69338
410280,201705,302,169,133,158098.14,124621,282719.14
410290,201705,217,147,70,136875.92,65148.02,202023.94
410300,201705,82,65,17,60905,15929,76834
410302,201705,24,16,8,14992,7496,22488
410304,201705,50,33,17,30921,15929,46850
410305,201705,185,97,88,90097,82456,172553
410310,201705,258,166,92,155542,86204,241746
410315,201705,58,42,16,39330,14992,54322
410320,201705,135,92,43,86204,40291,126495
410322,201705,34,23,11,21551,10307,31858
410330,201705,194,138,56,129306,52472,181778
410335,201705,105,66,39,61842,36543,98385
410337,201705,35,31,4,29047,3748,32795
410340,201705,31,30,1,28110,937,29047
410345,201705,204,129,75,120132.77,70275,190407.77
410347,201705,52,40,12,37480,11244,48724
410350,201705,236,146,90,136802,84330,221132
410360,201705,444,267,177,248618.1,165568,414186.1
410370,201705,2276,938,1338,875093.36,1250409.11,2125502.47
410380,201705,224,149,75,139613,70275,209888
410390,201705,357,271,86,253923,80582,334505
410395,201705,36,24,12,22488,10870,33358
410400,201705,814,414,400,386799.1,374271,761070.1
410405,201705,87,64,23,59968,21551,81519
410410,201705,45,34,11,31858,10307,42165
410420,201705,1613,801,812,748764.6,759283.3,1508047.9
410425,201705,174,86,88,80395,82456,162851
410430,201705,2162,1267,895,1184742.9,836385.16,2021128.06
410440,201705,397,282,115,263298,107755,371053
410442,201705,362,239,123,223007,115251,338258
410445,201705,415,288,127,269856,118999,388855
410450,201705,402,199,203,186463,190211,376674
410460,201705,392,214,178,200236.9,166786,367022.9
410465,201705,192,123,69,113751.8,64653,178404.8
410470,201705,214,131,83,122747,77771,200518
410480,201705,5546,2751,2795,2563626.8,2614046.99,5177673.79
410490,201705,1349,892,457,834634,426336,1260970
410500,201705,255,145,110,135865,103070,238935
410510,201705,184,131,53,122747,49027.3,171774.3
410520,201705,291,214,77,200518,72149,272667
410530,201705,223,83,140,77771,131176,208947
410540,201705,319,231,88,215876.8,82451.32,298328.12
410550,201705,1554,681,873,637815.9,817434.12,1455250.02
410560,201705,144,110,34,103070,31858,134928
410570,201705,442,309,133,287169.95,124621,411790.95
410580,201705,3107,1398,1709,1307404.36,1599928,2907332.36
410590,201705,391,274,117,256738,109629,366367
410600,201705,170,150,20,140550,18740,159290
410610,201705,50,41,9,38417,8433,46850
410620,201705,225,163,62,152731,58094,210825
410630,201705,435,256,179,239872,166584,406456
410640,201705,919,556,363,518792.44,338271.75,857064.19
410645,201705,100,72,28,67070,26236,93306
410650,201705,356,240,116,223943,108692,332635
410655,201705,77,61,16,57157,14992,72149
410657,201705,42,17,25,15929,23425,39354
410660,201705,574,411,163,383508,152731,536239
410670,201705,74,60,14,56220,13118,69338
410680,201705,192,156,36,146172,32774.99,178946.99
410685,201705,21,16,5,14992,4685,19677
410690,201705,28493,12292,16201,11500510.03,15170388.63,26670898.66
410700,201705,307,226,81,211200,75897,287097
410710,201705,134,108,26,101196,24362,125558
410712,201705,16,10,6,9370,5622,14992
410715,201705,87,66,21,61842,19677,81519
410720,201705,579,353,226,330761,211753,542514
410725,201705,176,129,47,120873,44039,164912
410730,201705,93,59,34,55283,31858,87141
410740,201705,112,85,27,79645,25299,104944
410750,201705,211,159,52,148983,48724,197707
410752,201705,20,14,6,13118,5622,18740
410753,201705,50,22,28,19953.41,26236,46189.41
410754,201705,47,31,16,29047,14992,44039
410755,201705,82,56,26,52190.9,24362,76552.9
410760,201705,657,374,283,350438,264703,615141
410765,201705,1594,771,823,716333.94,770298.63,1486632.57
410770,201705,107,91,16,85267,14992,100259
410773,201705,47,34,13,31858,12181,44039
410775,201705,173,128,45,119280.1,42165,161445.1
410780,201705,81,44,37,41228,34669,75897
410785,201705,74,56,18,52285,16866,69151
410790,201705,65,32,33,29984,30921,60905
410800,201705,293,185,108,172409,101196,273605
410810,201705,34,27,7,25299,6278,31577
410820,201705,179,134,45,125418,42165,167583
410830,201705,8495,3882,4613,3628178.3,4320438.19,7948616.49
410832,201705,106,75,31,69993.9,29047,99040.9
410840,201705,1362,749,613,699307.99,574260.67,1273568.66
410845,201705,58,35,23,32795,21551,54346
410850,201705,188,129,59,120552,55283,175835
410855,201705,43,38,5,35606,4685,40291
410860,201705,670,390,280,364658.75,262360,627018.75
410865,201705,109,82,27,76834,25299,102133
410870,201705,149,130,19,121810,17516,139326
410880,201705,1077,530,547,496295.05,512485,1008780.05
410890,201705,75,58,17,54346,15929,70275
410895,201705,66,47,19,44039,17803,61842
410900,201705,40,32,8,29984,7496,37480
410910,201705,24,21,3,19677,2811,22488
410920,201705,51,27,24,25299,22488,47787
410930,201705,499,316,183,295884.74,171189.9,467074.64
410940,201705,4253,2552,1701,2382442.09,1590253.7,3972695.79
410950,201705,122,86,36,80582,33732,114314
410960,201705,745,331,414,309866,387918,697784
410965,201705,63,50,13,46850,12181,59031
410970,201705,614,435,179,407139.1,167723,574862.1
410975,201705,107,71,36,66166,33732,99898
410980,201705,1481,669,812,625916.9,760554.22,1386471.12
410990,201705,257,171,86,160061.25,80300.9,240362.15
411000,201705,61,42,19,39354,17803,57157
411005,201705,17,13,4,12181,3748,15929
411007,201705,235,137,98,128369,91826,220195
411010,201705,570,402,168,376449,157416,533865
411020,201705,281,190,91,178030,85267,263297
411030,201705,25,15,10,14055,9370,23425
411040,201705,49,34,15,31858,14055,45913
411050,201705,223,179,44,166274.17,41101.12,207375.29
411060,201705,508,346,162,324193,151794,475987
411065,201705,59,53,6,49539.19,5622,55161.19
411070,201705,1156,771,385,718492,360464,1078956
411080,201705,242,172,70,161247,64803.66,226050.66
411090,201705,110,80,30,74960,28110,103070
411095,201705,259,107,152,99791,142414,242205
411100,201705,108,89,19,83393,17803,101196
411110,201705,125,85,40,79645,37480,117125
411120,201705,171,131,40,122747,37480,160227
411125,201705,165,74,91,68682.1,85267,153949.1
411130,201705,113,97,16,90263,14992,105255
411140,201705,169,118,51,110263.9,47271.65,157535.55
411150,201705,1165,776,389,727102.63,364493,1091595.63
411155,201705,117,81,36,75897,33732,109629
411160,201705,21,10,11,9370,10307,19677
411170,201705,61,53,8,49379.9,7496,56875.9
411180,201705,903,592,311,552549.33,291402.32,843951.65
411190,201705,292,171,121,159571.1,113377,272948.1
411200,201705,662,439,223,410094.09,208341.95,618436.04
411210,201705,660,352,308,328301.83,288596,616897.83
411220,201705,146,110,36,103070,33732,136802
411230,201705,51,45,6,42165,5622,47787
411240,201705,125,87,38,81519,35606,117125
411250,201705,407,294,113,275478,105881,381359
411260,201705,21,15,6,14055,5622,19677
411270,201705,286,158,128,148046,119936,267982
411275,201705,200,176,24,164772,22488,187260
411280,201705,215,148,67,137427.36,62779,200206.36
411290,201705,61,44,17,40384.7,15929,56313.7
411295,201705,142,114,28,106818,26236,133054
411300,201705,81,44,37,41228,34669,75897
411310,201705,90,67,23,62779,21551,84330
411320,201705,728,533,195,498063.9,181141.24,679205.14
411325,201705,46,29,17,27173,15929,43102
411330,201705,879,559,320,521653.75,298996.8,820650.55
411340,201705,26,17,9,15929,8124,24053
411342,201705,85,60,25,56220,23425,79645
411345,201705,118,59,59,55283,55283,110566
411350,201705,465,380,85,355076.92,79354.63,434431.55
411360,201705,51,31,20,29047,18740,47787
411370,201705,13725,5633,8092,5263323.89,7569788.92,12833112.81
411373,201705,207,151,56,141487,52472,193959
411375,201705,86,70,16,65590,14992,80582
411380,201705,101,73,28,67464.89,26236,93700.89
411390,201705,141,91,50,85267,46850,132117
411400,201705,345,257,88,240800,82456,323256
411410,201705,439,221,218,206421.1,203985,410406.1
411420,201705,1010,464,546,432519.2,511133.6,943652.8
411430,201705,398,256,142,239216.1,133045,372261.1
411435,201705,38,27,11,25299,10307,35606
411440,201705,465,370,95,345066.37,89015,434081.37
411450,201705,431,353,78,330761,73086,403847
411460,201705,709,281,428,262353.08,399735.4,662088.48
411470,201705,121,90,31,84330,29047,113377
411480,201705,610,348,262,324577.8,245212.9,569790.7
411490,201705,290,178,112,166786,104944,271730
411500,201705,106,91,15,85267,13399.9,98666.9
411510,201705,214,174,40,161678.69,37480,199158.69
411520,201705,5816,2279,3537,2131879.34,3306830.99,5438710.33
411530,201705,110,72,38,67464,35606,103070
411535,201705,52,20,32,18740,29984,48724
411540,201705,312,214,98,199698.6,91826,291524.6
411545,201705,73,52,21,48724,19677,68401
411550,201705,71,55,16,51535,14992,66527
411560,201705,360,165,195,153977.21,182715,336692.21
411570,201705,766,291,475,272386,444888,717274
411573,201705,37,22,15,20614,14055,34669
411575,201705,253,153,100,143361,93700,237061
411580,201705,1203,473,730,442232.8,683018,1125250.8
411585,201705,73,35,38,32795,35606,68401
411590,201705,25,18,7,16866,6559,23425
411600,201705,41,21,20,19677,18740,38417
411605,201705,230,109,121,101973,113377,215350
411610,201705,238,162,76,151794,71212,223006
411620,201705,346,192,154,179716.6,144298,324014.6
411630,201705,55,36,19,33732,17803,51535
411640,201705,40,32,8,29984,7496,37480
411650,201705,14,11,3,10307,2811,13118
411660,201705,41,35,6,32795,5622,38417
411670,201705,251,191,60,177955.81,56200,234155.81
411680,201705,157,135,22,126495,20614,147109
411690,201705,594,326,268,304845.08,250733.6,555578.68
411695,201705,65,50,15,46850,14055,60905
411700,201705,171,146,25,136802,23425,160227
411705,201705,107,69,38,64653,35606,100259
411710,201705,295,194,101,180812.1,94637,275449.1
411720,201705,132,84,48,78708,44976,123684
411721,201705,73,59,14,55283,13118,68401
411722,201705,94,41,53,38417,49661,88078
411725,201705,142,111,31,103726,29047,132773
411727,201705,82,68,14,63716,12836.9,76552.9
411729,201705,34,25,9,23425,8433,31858
411730,201705,542,349,193,325451.3,180841,506292.3
411740,201705,30,23,7,21551,6559,28110
411745,201705,71,49,22,45136,20614,65750
411750,201705,817,398,419,371568.9,391643.36,763212.26
411760,201705,1191,897,294,838981.04,275469,1114450.04
411770,201705,402,278,124,260486,116188,376674
411780,201705,358,232,126,216447.84,118062,334509.84
411790,201705,512,280,232,261438.17,217272.67,478710.84
411800,201705,170,134,36,125558,33732,159290
411810,201705,151,115,36,107755,33732,141487
411820,201705,2084,1022,1062,955346.56,994691.86,1950038.42
411830,201705,10,10,0,9370,0,9370
411840,201705,1905,1179,726,1104047.6,679774,1783821.6
411845,201705,50,17,33,15929,30921,46850
411850,201705,1221,712,509,664689.74,475014.81,1139704.55
411860,201705,44,29,15,26892,14055,40947
411870,201705,33,27,6,25299,5622,30921
411880,201705,415,273,142,255547,132323.14,387870.14
411885,201705,108,70,38,65590,35606,101196
411890,201705,327,202,125,189274,117116,306390
411900,201705,73,54,19,50598,17803,68401
411910,201705,166,137,29,128359.63,26236,154595.63
411915,201705,2002,864,1138,808436.11,1065535.93,1873972.04
411920,201705,120,102,18,95574,16866,112440
411925,201705,18,12,6,11244,5622,16866
411930,201705,784,578,206,539714,193022,732736
411940,201705,580,416,164,389792,153643.56,543435.56
411950,201705,871,468,403,438506.63,377298.7,815805.33
411960,201705,937,673,264,628270,247368,875638
411965,201705,28,19,9,17803,8433,26236
411970,201705,75,68,7,63716,6559,70275
411980,201705,195,126,69,118062,64653,182715
411990,201705,4709,2774,1935,2582289.18,1810964.5,4393253.68
411995,201705,447,170,277,159290,259549,418839
412000,201705,266,151,115,140785.56,107755,248540.56
412010,201705,43,27,16,25299,14992,40291
412015,201705,43,32,11,29984,10307,40291
412020,201705,30,26,4,24080.9,3748,27828.9
412030,201705,64,54,10,50598,9370,59968
412033,201705,50,32,18,29960,16866,46826
412035,201705,87,55,32,51535,29984,81519
412040,201705,35,24,11,22207,10307,32514
412050,201705,199,147,52,137739,48724,186463
412060,201705,750,591,159,550956.88,148014.9,698971.78
412065,201705,46,33,13,30921,12181,43102
412070,201705,151,102,49,94918.1,45913,140831.1
412080,201705,268,136,132,127432,123684,251116
412085,201705,29,13,16,12181,14992,27173
412090,201705,702,433,269,403801.1,252053,655854.1
412100,201705,237,198,39,184590,36355.6,220945.6
412110,201705,75,59,16,55283,14992,70275
412120,201705,308,201,107,187774.8,100259,288033.8
412125,201705,90,50,40,46568.9,37480,84048.9
412130,201705,53,36,17,33732,15929,49661
412135,201705,27,14,13,13118,12181,25299
412140,201705,283,211,72,197707,67464,265171
412150,201705,257,172,85,160227.62,79645,239872.62
412160,201705,99,61,38,57157,35606,92763
412170,201705,617,447,170,418839,159290,578129
412175,201705,48,37,11,34669,10307,44976
412180,201705,191,151,40,140898.29,37480,178378.29
412190,201705,327,266,61,248581.41,57157,305738.41
412200,201705,191,124,67,116188,62779,178967
412210,201705,95,75,20,70275,18740,89015
412215,201705,234,160,74,149920,69338,219258
412217,201705,87,69,18,64653,16866,81519
412220,201705,769,585,184,548145,172408,720553
412230,201705,330,207,123,191764.67,114871.75,306636.42
412240,201705,1281,621,660,577952.23,615308.15,1193260.38
412250,201705,382,244,138,228628,128369.92,356997.92
412260,201705,123,91,32,85267,29984,115251
412265,201705,162,129,33,120873,30921,151794
412270,201705,84,47,37,44039,34669,78708
412280,201705,87,68,19,63716,17803,81519
412290,201705,103,65,38,60905,35606,96511
412300,201705,223,144,79,134928,74023,208951
412310,201705,44,37,7,34669,6559,41228
412320,201705,94,79,15,74023,14055,88078
412330,201705,162,144,18,134928,16866,151794
412340,201705,139,94,45,88078,41884,129962
412350,201705,568,274,294,255754.15,275291,531045.15
412360,201705,26,23,3,21551,2811,24362
412370,201705,159,132,27,122747,25299,148046
412380,201705,258,189,69,176811.9,64128.65,240940.55
412382,201705,53,28,25,26236,23425,49661
412385,201705,143,98,45,91826,42165,133991
412390,201705,265,196,69,183652,64653,248305
412395,201705,63,51,12,47787,11244,59031
412400,201705,68,48,20,44976,18740,63716
412402,201705,233,105,128,98380.32,119654.9,218035.22
412405,201705,796,318,478,296535.01,447403.96,743938.97
412410,201705,911,562,349,525095,327013,852108
412420,201705,17,12,5,11244,4685,15929
412430,201705,20,15,5,14055,4685,18740
412440,201705,580,318,262,295010.31,243820.4,538830.71
412450,201705,82,69,13,64653,12181,76834
412460,201705,74,59,15,55283,14055,69338
412470,201705,259,209,50,195833,46850,242683
412480,201705,180,135,45,125277.5,42165,167442.5
412490,201705,158,134,24,125558,22488,148046
412500,201705,475,383,92,357653.3,86204,443857.3
412510,201705,192,155,37,144392,34669,179061
412520,201705,128,72,56,67464,52472,119936
412530,201705,106,58,48,54346,44413.9,98759.9
412535,201705,109,82,27,76816,25290,102106
412540,201705,66,32,34,29984,31858,61842
412545,201705,94,69,25,64653,23425,88078
412550,201705,3388,1552,1836,1450854.19,1719114.45,3169968.64
412555,201705,15,12,3,11244,2811,14055
412560,201705,567,430,137,401599.1,128369,529968.1
412570,201705,736,416,320,389192.32,299559,688751.32
412575,201705,91,64,27,59968,25299,85267
412580,201705,152,105,47,98385,44039,142424
412590,201705,33,31,2,29047,1874,30921
412600,201705,172,133,39,124621,36543,161164
412610,201705,35,22,13,20614,11376,31990
412620,201705,150,132,18,123684,16866,140550
412625,201705,2149,1146,1003,1072033.76,938247.72,2010281.48
412627,201705,70,57,13,53409,12181,65590
412630,201705,436,288,148,269665,138676,408341
412635,201705,63,21,42,19677,39354,59031
412640,201705,117,79,38,74023,35606,109629
412650,201705,327,208,119,194896,111498.32,306394.32
412660,201705,473,281,192,262595,179904,442499
412665,201705,48,42,6,39354,5622,44976
412667,201705,316,208,108,194291.6,100832.04,295123.64
412670,201705,65,55,10,51535,9370,60905
412680,201705,279,224,55,209888,51535,261423
412690,201705,111,73,38,68401,35325,103726
412700,201705,169,116,53,108692,49380,158072
412710,201705,1389,864,525,802730.8,489770,1292500.8
412720,201705,225,154,71,144298,66527,210825
412730,201705,198,151,47,141487,43102,184589
412740,201705,405,217,188,203188.45,176156,379344.45
412750,201705,455,261,194,243620,181778,425398
412760,201705,240,122,118,114314,110566,224880
412770,201705,1982,1130,852,1054514.15,798016,1852530.15
412780,201705,148,119,29,111370.88,27173,138543.88
412785,201705,263,133,130,124152.5,121810,245962.5
412788,201705,35,20,15,18740,14055,32795
412790,201705,133,109,24,101477.1,22488,123965.1
412795,201705,162,120,42,112440,39354,151794
412796,201705,299,205,94,190941.83,87946.82,278888.65
412800,201705,536,350,186,327400.36,174273,501673.36
412810,201705,2912,1617,1295,1511549.69,1211911.12,2723460.81
412820,201705,921,609,312,557827.55,288533.11,846360.66
412830,201705,18,14,4,13118,3748,16866
412840,201705,213,151,62,140550.1,58094,198644.1
412850,201705,774,534,240,498484,224880,723364
412853,201705,176,97,79,90889,74023,164912
412855,201705,230,122,108,112940.21,101196,214136.21
412860,201705,91,70,21,65590,19677,85267
412862,201705,63,47,16,43758,14992,58750
412863,201705,15,11,4,10307,3748,14055
412865,201705,42,32,10,29984,9370,39354
412870,201705,111,71,40,66527,37480,104007
412880,201705,127,100,27,93700,25299,118999
420005,201705,35,31,4,29047,3186,32233
420010,201705,368,246,122,229683.67,113368,343051.67
420020,201705,71,60,11,56220,10307,66527
420030,201705,29,26,3,24362,2811,27173
420040,201705,108,82,26,76834,24362,101196
420050,201705,56,34,22,31476.9,20453.34,51930.24
420055,201705,20,19,1,17782,937,18719
420060,201705,33,26,7,24362,6559,30921
420070,201705,96,84,12,78708,11234.63,89942.63
420075,201705,11,9,2,8433,1874,10307
420080,201705,45,40,5,36589.85,4685,41274.85
420090,201705,36,34,2,31094.34,1874,32968.34
420100,201705,148,125,23,115533.1,21551,137084.1
420110,201705,17,17,0,15929,0,15929
420120,201705,43,32,11,29984,10307,40291
420125,201705,83,66,17,61093,15929,77022
420127,201705,32,29,3,27173,2811,29984
420130,201705,360,227,133,212408.63,124611.63,337020.26
420140,201705,1188,694,494,649322.63,462814,1112136.63
420150,201705,45,38,7,35606,6559,42165
420160,201705,42,39,3,36543,2811,39354
420165,201705,16,12,4,11244,3748,14992
420170,201705,64,40,24,37480,22488,59968
420180,201705,25,24,1,22488,937,23425
420190,201705,32,29,3,27173,2811,29984
420195,201705,125,60,65,56220,60624,116844
420200,201705,1262,559,703,518165.1,658066.52,1176231.62
420205,201705,64,30,34,28110,31858,59968
420207,201705,96,56,40,52472,37470.63,89942.63
420208,201705,25,20,5,18740,3841.7,22581.7
420209,201705,18,14,4,13118,3748,16866
420210,201705,444,204,240,190866.9,224796.04,415662.94
420213,201705,50,39,11,36543,10307,46850
420215,201705,24,20,4,18740,3748,22488
420220,201705,70,47,23,44039,21551,65590
420230,201705,697,404,293,377799,274531.63,652330.63
420240,201705,2203,1504,699,1401489.91,654531.98,2056021.89
420243,201705,31,26,5,24362,4685,29047
420245,201705,82,47,35,44039,32795,76834
420250,201705,49,29,20,27173,18740,45913
420253,201705,39,32,7,29984,6559,36543
420257,201705,10,9,1,8433,937,9370
420260,201705,95,84,11,78708,10307,89015
420270,201705,34,29,5,27168.32,4685,31853.32
420280,201705,274,199,75,185454.08,69039,254493.08
420285,201705,21,13,8,12181,7496,19677
420287,201705,48,29,19,27173,17803,44976
420290,201705,940,663,277,620267.6,259482.2,879749.8
420300,201705,1318,1036,282,967080.2,263297.77,1230377.97
420310,201705,57,43,14,40291,13118,53409
420315,201705,35,31,4,29047,3748,32795
420320,201705,841,425,416,397264.58,389788,787052.58
420325,201705,0,0,0,0,0,0
420330,201705,121,85,36,79645,33732,113377
420340,201705,153,108,45,100251,42136.89,142387.89
420350,201705,239,175,64,162664.1,59968,222632.1
420360,201705,734,553,181,516504.23,168014.09,684518.32
420370,201705,102,68,34,63529,31577,95106
420380,201705,1106,796,310,742096.76,289357.29,1031454.05
420390,201705,251,154,97,143717.06,89249.25,232966.31
420395,201705,170,123,47,115251,44029.63,159280.63
420400,201705,243,179,64,166787,59968,226755
420410,201705,59,46,13,43102,12181,55283
420415,201705,33,30,3,28110,2811,30921
420417,201705,43,33,10,30921,9370,40291
420419,201705,11,10,1,9370,937,10307
420420,201705,2744,1670,1074,1553766.92,1003801.25,2557568.17
420425,201705,66,57,9,53400,8414.26,61814.26
420430,201705,1266,875,391,815064.01,366338.89,1181402.90
420435,201705,16,14,2,13118,1874,14992
420440,201705,105,70,35,64850.54,32622.6,97473.14
420445,201705,20,18,2,16866,1874,18740
420450,201705,76,35,41,32766,38417,71183
420455,201705,232,181,51,169569.26,47723.63,217292.89
420460,201705,2215,1507,708,1407359.37,663183.82,2070543.19
420470,201705,119,87,32,81519,29984,111503
420475,201705,7,7,0,6559,0,6559
420480,201705,831,617,214,574643.46,199581.1,774224.56
420490,201705,113,88,25,82456,23425,105881
420500,201705,829,293,536,272887.1,502232,775119.1
420510,201705,21,18,3,16866,2811,19677
420515,201705,21,18,3,16866,2811,19677
420517,201705,7,7,0,6559,0,6559
420519,201705,0,0,0,0,0,0
420520,201705,69,52,17,48724,15929,64653
420530,201705,146,99,47,92763,44039,136802
420535,201705,20,17,3,15929,2811,18740
420540,201705,4271,2543,1728,2373602.15,1614456.69,3988058.84
420543,201705,21,21,0,19677,0,19677
420545,201705,184,132,52,123675,48695.89,172370.89
420550,201705,826,657,169,614063.89,158196.75,772260.64
420555,201705,41,31,10,29047,9370,38417
420560,201705,62,47,15,43664.2,14055,57719.2
420570,201705,123,70,53,65027.8,49651.63,114679.43
420580,201705,288,128,160,119936,149639,269575
420590,201705,496,351,145,328231.1,135865,464096.1
420600,201705,91,45,46,42165,43102,85267
420610,201705,34,32,2,29703,1874,31577
420620,201705,67,56,11,52472,10307,62779
420630,201705,147,106,41,99313.32,38409,137722.32
420640,201705,99,89,10,83393,9370,92763
420650,201705,237,127,110,118302.99,102274.86,220577.85
420660,201705,59,42,17,38604.9,15929,54533.9
420665,201705,37,28,9,26236,8433,34669
420670,201705,308,238,70,222996.63,65290.53,288287.16
420675,201705,14,14,0,13118,0,13118
420680,201705,32,25,7,23425,6559,29984
420690,201705,177,150,27,140550,25299,165849
420700,201705,588,415,173,388780.78,161861.82,550642.60
420710,201705,143,84,59,78708,55283,133991
420720,201705,99,83,16,77771,14992,92763
420730,201705,477,309,168,289459.15,156134.49,445593.64
420740,201705,43,42,1,39354,937,40291
420750,201705,478,316,162,295790.79,151794,447584.79
420757,201705,17,14,3,12321.55,2811,15132.55
420760,201705,40,31,9,29047,8433,37480
420765,201705,66,55,11,51535,10307,61842
420768,201705,67,60,7,56220,6559,62779
420770,201705,86,73,13,68401,12181,80582
420775,201705,46,42,4,38417,3748,42165
420780,201705,221,173,48,162101,44976,207077
420785,201705,13,9,4,8433,3748,12181
420790,201705,167,141,26,131800.64,23397.63,155198.27
420800,201705,73,55,18,50785.4,16866,67651.4
420810,201705,243,209,34,195824,31061.55,226885.55
420820,201705,2319,1381,938,1286472.56,877397.93,2163870.49
420830,201705,509,293,216,273096.09,201445.63,474541.72
420840,201705,135,102,33,95574,30921,126495
420845,201705,433,192,241,179244.93,224599,403843.93
420850,201705,221,179,42,167723,39354,207077
420860,201705,59,50,9,46850,8433,55283
420870,201705,108,83,25,77771,23425,101196
420880,201705,161,109,52,101467.73,48724,150191.73
420890,201705,835,413,422,383991.67,395405,779396.67
420895,201705,10,10,0,9370,0,9370
420900,201705,389,299,90,278421.22,84302.63,362723.85
420910,201705,5610,3076,2534,2876614.92,2373300.02,5249914.94
420915,201705,80,74,6,69338,5622,74960
420917,201705,18,13,5,12181,4685,16866
420920,201705,20,13,7,12181,6559,18740
420930,201705,2529,1522,1007,1418512.38,937683.68,2356196.06
420940,201705,569,418,151,391367,139872.24,531239.24
420945,201705,7,5,2,4685,1874,6559
420950,201705,55,51,4,47787,3748,51535
420960,201705,113,88,25,82419.26,23406.63,105825.89
420970,201705,300,244,56,226981.45,52444.63,279426.08
420980,201705,26,25,1,23425,937,24362
420985,201705,60,53,7,49661,6559,56220
420990,201705,71,55,16,51535,14992,66527
421000,201705,35,22,13,20614,12181,32795
421003,201705,66,41,25,38417,23416,61833
421005,201705,8,6,2,5622,1874,7496
421010,201705,733,519,214,485912.78,198464.39,684377.17
421020,201705,27,24,3,22468,2811,25279
421030,201705,127,106,21,98995,19677,118672
421040,201705,56,49,7,45913,6559,52472
421050,201705,289,202,87,187213.1,81519,268732.1
421055,201705,27,23,4,21551,3748,25299
421060,201705,85,59,26,55283,24362,79645
421070,201705,49,45,4,42165,3748,45913
421080,201705,32,29,3,27173,2811,29984
421085,201705,23,18,5,16866,4685,21551
421090,201705,45,34,11,31858,10307,42165
421100,201705,109,82,27,76834,25299,102133
421105,201705,200,160,40,149780,37456.95,187236.95
421110,201705,109,92,17,85594.95,15929,101523.95
421120,201705,152,119,33,111016.13,30902.26,141918.39
421125,201705,17,12,5,11244,4685,15929
421130,201705,778,496,282,464070.3,263212.87,727283.17
421140,201705,30,21,9,18974.25,8433,27407.25
421145,201705,39,32,7,29984,6559,36543
421150,201705,103,74,29,69338,27173,96511
421160,201705,59,39,20,36533.63,18740,55273.63
421165,201705,19,18,1,16866,937,17803
421170,201705,183,158,25,147317.52,23416,170733.52
421175,201705,148,98,50,91826,46794.52,138620.52
421180,201705,58,36,22,33376,20614,53990
421185,201705,16,13,3,12181,2811,14992
421187,201705,0,0,0,0,0,0
421189,201705,38,30,8,28110,7486.63,35596.63
421190,201705,1353,828,525,775087,491240.99,1266327.99
421200,201705,88,69,19,64653,17803,82456
421205,201705,23,15,8,14055,7486.63,21541.63
421210,201705,174,117,57,109629,53409,163038
421220,201705,261,208,53,194286.95,49661,243947.95
421223,201705,54,45,9,42165,8433,50598
421225,201705,53,38,15,35606,14055,49661
421227,201705,90,66,24,61842,22488,84330
421230,201705,45,33,12,30921,11244,42165
421240,201705,19,19,0,17803,0,17803
421250,201705,360,217,143,203236,133213.29,336449.29
421260,201705,28,22,6,20614,5622,26236
421265,201705,0,0,0,0,0,0
421270,201705,54,49,5,45913,4685,50598
421280,201705,331,191,140,178967,130243,309210
421290,201705,298,204,94,190914,86691.56,277605.56
421300,201705,30,24,6,22488,5622,28110
421310,201705,54,41,13,37761.1,12181,49942.1
421315,201705,30,20,10,18740,9370,28110
421320,201705,123,90,33,84003,30921,114924
421330,201705,112,84,28,76346.76,26227,102573.76
421335,201705,40,26,14,24362,13118,37480
421340,201705,275,182,93,168519.5,87141,255660.5
421350,201705,164,98,66,91391,61842,153233
421360,201705,678,499,179,463170.69,167517.63,630688.32
421370,201705,179,137,42,128369,39026.05,167395.05
421380,201705,121,101,20,94632.32,18740,113372.32
421390,201705,17,14,3,13118,2811,15929
421400,201705,108,93,15,87141,14055,101196
421410,201705,21,18,3,16866,2811,19677
421415,201705,18,16,2,14992,1874,16866
421420,201705,154,129,25,120310.8,23425,143735.8
421430,201705,15,12,3,11244,2811,14055
421440,201705,59,46,13,43102,12181,55283
421450,201705,101,89,12,83393,11244,94637
421460,201705,60,51,9,46997.1,8433,55430.1
421470,201705,71,47,24,44039,22488,66527
421480,201705,621,460,161,430551.5,150857,581408.5
421490,201705,25,22,3,19950,2811,22761
421500,201705,509,329,180,305879.51,167801.69,473681.20
421505,201705,24,17,7,15929,6559,22488
421507,201705,31,26,5,24362,4685,29047
421510,201705,73,48,25,44976,23425,68401
421520,201705,67,57,10,51754.23,9370,61124.23
421530,201705,53,47,6,43383.1,5622,49005.1
421535,201705,32,31,1,28785,937,29722
421540,201705,59,53,6,49661,5622,55283
421545,201705,90,72,18,66987,16866,83853
421550,201705,274,195,79,182060,74023,256083
421555,201705,22,18,4,16866,3748,20614
421560,201705,8,8,0,7496,0,7496
421565,201705,121,91,30,85267,28110,113377
421567,201705,28,22,6,20614,5622,26236
421568,201705,33,31,2,29047,1874,30921
421569,201705,9,8,1,7496,937,8433
421570,201705,130,85,45,79645,42165,121810
421575,201705,27,22,5,20356.33,4685,25041.33
421580,201705,707,424,283,397288,264234.27,661522.27
421590,201705,20,20,0,18740,0,18740
421600,201705,112,76,36,71192,32796,103988
421605,201705,100,68,32,63389,29984,93373
421610,201705,190,149,41,139613,38417,178030
421620,201705,1098,662,436,617745.99,408484.52,1026230.51
421625,201705,20,17,3,15929,2811,18740
421630,201705,267,171,96,160181,89109,249290
421635,201705,17,7,10,6559,9370,15929
421640,201705,97,85,12,79645,11244,90889
421650,201705,269,156,113,146153.26,105862.26,252015.52
421660,201705,2030,1204,826,1125965.86,772716.16,1898682.02
421670,201705,169,127,42,118999,39354,158353
421680,201705,170,154,16,144298,14983,159281
421690,201705,342,239,103,223362.8,95564.99,318927.79
421700,201705,54,34,20,31858,18178,50036
421710,201705,21,21,0,19677,0,19677
421715,201705,9,8,1,7496,937,8433
421720,201705,548,389,159,362515.3,147287.54,509802.84
421725,201705,12,6,6,5622,5622,11244
421730,201705,41,30,11,27392.48,10307,37699.48
421740,201705,79,38,41,35606,38417,74023
421750,201705,213,154,59,142706.1,55283,197989.1
421755,201705,25,23,2,21551,1874,23425
421760,201705,106,76,30,71202.63,28110,99312.63
421770,201705,534,371,163,346563.52,152546.15,499109.67
421775,201705,22,14,8,13118,7496,20614
421780,201705,183,144,39,134646.9,36543,171189.9
421790,201705,156,131,25,122747,23425,146172
421795,201705,14,12,2,11244,1874,13118
421800,201705,430,276,154,256892.61,144293.32,401185.93
421810,201705,69,54,15,50598,14055,64653
421820,201705,295,199,96,185498.1,89952,275450.1
421825,201705,126,102,24,95574,22488,118062
421830,201705,132,102,30,95574,28110,123684
421835,201705,3,3,0,2811,0,2811
421840,201705,59,50,9,46841,8433,55274
421850,201705,72,62,10,58094,9366,67460
421860,201705,43,32,11,29702.9,10307,40009.9
421870,201705,959,717,242,663573.5,225840.59,889414.09
421875,201705,49,43,6,40291,5622,45913
421880,201705,164,116,48,108692,44695,153387
421885,201705,26,21,5,19677,4404,24081
421890,201705,114,78,36,73086,33732,106818
421895,201705,35,33,2,30921,1874,32795
421900,201705,144,117,27,109555.15,25254,134809.15
421910,201705,64,43,21,40291,19677,59968
421915,201705,32,24,8,22488,7496,29984
421917,201705,38,27,11,25018,10307,35325
421920,201705,35,32,3,29984,2811,32795
421930,201705,753,579,174,542185.68,163001.63,705187.31
421935,201705,59,51,8,47787,7496,55283
421940,201705,43,38,5,35606,4685,40291
421950,201705,826,538,288,498102.84,267396.52,765499.36
421960,201705,40,35,5,32514,4685,37199
421970,201705,360,229,131,214083.12,122696.01,336779.13
421985,201705,28,20,8,18740,7496,26236
422000,201705,0,0,0,0,0,0
430003,201705,211,46,165,42399.25,154605,197004.25
430005,201705,31,24,7,22488,6559,29047
430010,201705,285,201,84,187868.5,78708,266576.5
430020,201705,154,99,55,92482,50598,143080
430030,201705,121,93,28,87141,26236,113377
430040,201705,2972,1713,1259,1597493.05,1177828.68,2775321.73
430045,201705,65,55,10,51535,9370,60905
430047,201705,7,6,1,5622,937,6559
430050,201705,78,65,13,60905,12181,73086
430055,201705,17,14,3,13118,2811,15929
430057,201705,4,2,2,1874,1874,3748
430060,201705,3696,2176,1520,2031451.31,1419632.24,3451083.55
430063,201705,54,47,7,44039,6559,50598
430064,201705,138,116,22,107989.25,20614,128603.25
430066,201705,10,7,3,6559,2811,9370
430070,201705,49,37,12,34669,11244,45913
430080,201705,69,47,22,43351.8,20614,63965.8
430085,201705,36,9,27,8433,25299,33732
430087,201705,38,28,10,26096,9370,35466
430090,201705,69,63,6,58468.8,5622,64090.8
430100,201705,109,72,37,67464,34669,102133
430105,201705,145,74,71,69338,66227.16,135565.16
430107,201705,20,14,6,13118,5622,18740
430110,201705,391,232,159,216587.55,148917.41,365504.96
430120,201705,142,127,15,118062.95,14055,132117.95
430130,201705,775,480,295,449150.95,276133.9,725284.85
430140,201705,125,116,9,108692,8433,117125
430150,201705,103,69,34,63904,31858,95762
430155,201705,29,28,1,26236,937,27173
430160,201705,3790,2238,1552,2078877.35,1450223.11,3529100.46
430163,201705,311,134,177,124462.68,165774.04,290236.72
430165,201705,22,16,6,14992,5622,20614
430170,201705,79,73,6,68401,5622,74023
430175,201705,80,61,19,57157,17147.1,74304.1
430180,201705,92,73,19,68401,17193.95,85594.95
430185,201705,32,24,8,22488,7496,29984
430187,201705,109,44,65,41228,60605.9,101833.9
430190,201705,228,131,97,122700.15,90223.73,212923.88
430192,201705,14,14,0,13118,0,13118
430195,201705,12,8,4,7496,3748,11244
430200,201705,160,140,20,130524.1,18740,149264.1
430205,201705,19,18,1,16866,937,17803
430210,201705,587,444,143,412935.9,132726.15,545662.05
430215,201705,17,14,3,13118,2811,15929
430220,201705,59,41,18,38417,16866,55283
430222,201705,13,7,6,6559,5622,12181
430223,201705,13,7,6,6559,5622,12181
430225,201705,4,3,1,2811,937,3748
430230,201705,296,186,110,173345,102922.91,276267.91
430235,201705,46,33,13,30921,12171.63,43092.63
430237,201705,28,22,6,20614,5622,26236
430240,201705,126,75,51,70275,47777.63,118052.63
430245,201705,66,54,12,50598,11244,61842
430250,201705,194,115,79,107745.63,74013.63,181759.26
430258,201705,12,10,2,9370,1874,11244
430260,201705,37,32,5,29984,3879.18,33863.18
430265,201705,35,28,7,26217.26,6559,32776.26
430270,201705,580,431,149,399583.67,137833.81,537417.48
430280,201705,1017,638,379,594142.33,352668.8,946811.13
430290,201705,372,215,157,199581.4,147109,346690.4
430300,201705,2097,1149,948,1070646.76,885279.67,1955926.43
430310,201705,1991,1031,960,960250,897164.11,1857414.11
430320,201705,47,39,8,36528.95,7496,44024.95
430330,201705,97,88,9,81987.5,8433,90420.5
430340,201705,64,58,6,54346,5622,59968
430350,201705,1646,1149,497,1065300.38,463965.66,1529266.04
430355,201705,26,24,2,22488,1874,24362
430360,201705,82,36,46,33732,42165.1,75897.1
430367,201705,30,20,10,18740,8592.29,27332.29
430370,201705,56,48,8,44976,7496,52472
430380,201705,120,90,30,83767.8,28110,111877.8
430390,201705,609,382,227,357652.9,212399.63,570052.53
430400,201705,134,103,31,94824.4,29028.26,123852.66
430410,201705,56,44,12,41228,11244,52472
430420,201705,470,310,160,288971.9,147700.58,436672.48
430430,201705,51,49,2,45288.95,1874,47162.95
430435,201705,148,109,39,101851.9,35840.25,137692.15
430440,201705,512,341,171,319517,160039.6,479556.6
430450,201705,1171,964,207,896804.27,193949.63,1090753.90
430460,201705,5077,2751,2326,2562696.73,2171812.08,4734508.81
430461,201705,21,19,2,17803,1874,19677
430462,201705,11,7,4,6559,3748,10307
430463,201705,962,497,465,463019.39,435359.05,898378.44
430465,201705,28,17,11,15929,10307,26236
430466,201705,632,457,175,426336,163787.6,590123.6
430467,201705,88,51,37,47787,34659.63,82446.63
430468,201705,109,65,44,60905,40981.39,101886.39
430469,201705,22,16,6,14992,5622,20614
430470,201705,1154,645,509,596698.37,475012.15,1071710.52
430471,201705,47,35,12,32776.26,11244,44020.26
430480,201705,98,62,36,57250.7,33722.63,90973.33
430485,201705,5,5,0,4404,0,4404
430490,201705,92,73,19,67979.35,17803,85782.35
430495,201705,31,26,5,24362,4685,29047
430500,201705,188,126,62,117359.25,57724.63,175083.88
430510,201705,2915,1924,991,1798412.95,927977.06,2726390.01
430511,201705,18,18,0,16866,0,16866
430512,201705,135,92,43,86204,40291,126495
430513,201705,52,47,5,43570.5,4685,48255.5
430515,201705,31,28,3,26236,2811,29047
430517,201705,168,147,21,136802.25,19658.26,156460.51
430520,201705,367,248,119,231721,111474.89,343195.89
430530,201705,93,52,41,48724,38417,87141
430535,201705,462,300,162,280884.49,151780.32,432664.81
430537,201705,13,13,0,12181,0,12181
430540,201705,76,49,27,45913,25299,71212
430543,201705,376,117,259,109629,242449,352078
430544,201705,43,40,3,37480,2811,40291
430545,201705,333,148,185,138610.41,172857.76,311468.17
430550,201705,45,37,8,34669,7496,42165
430558,201705,5,3,2,2811,1874,4685
430560,201705,48,20,28,18740,26236,44976
430570,201705,99,45,54,42165,50541.78,92706.78
430580,201705,126,98,28,91826,26189.15,118015.15
430583,201705,16,16,0,14992,0,14992
430585,201705,8,4,4,3748,3748,7496
430587,201705,14,8,6,7496,5622,13118
430590,201705,154,128,26,118717.9,24362,143079.9
430593,201705,4,4,0,3748,0,3748
430595,201705,15,9,6,8433,5622,14055
430597,201705,55,29,26,27173,24362,51535
430600,201705,213,142,71,133044.63,66245.9,199290.53
430605,201705,152,94,58,88078,54336.63,142414.63
430607,201705,26,22,4,20614,3748,24362
430610,201705,1596,732,864,681762.05,804658.49,1486420.54
430613,201705,2,2,0,1874,0,1874
430620,201705,108,77,31,72009,29028.26,101037.26
430630,201705,47,43,4,40291,3748,44039
430632,201705,32,28,4,26236,3748,29984
430635,201705,38,35,3,32795,2811,35606
430637,201705,58,32,26,29984,24362,54346
430640,201705,206,112,94,104100.7,88078,192178.7
430642,201705,28,26,2,24362,1874,26236
430645,201705,30,26,4,24362,3748,28110
430650,201705,247,194,53,181497,49614.15,231111.15
430655,201705,7,7,0,6559,0,6559
430660,201705,960,462,498,431160.55,464414.78,895575.33
430670,201705,69,49,20,45913,18740,64653
430673,201705,75,42,33,39354,30921,70275
430675,201705,13,10,3,9370,2811,12181
430676,201705,460,272,188,254189.36,176085.84,430275.20
430680,201705,243,168,75,155261,70275,225536
430690,201705,517,310,207,289598.59,192332.01,481930.60
430692,201705,7,5,2,4685,1874,6559
430693,201705,127,83,44,77771,40609.58,118380.58
430695,201705,68,61,7,56238.74,6559,62797.74
430697,201705,62,37,25,34669,23425,58094
430700,201705,1552,1089,463,1011651.55,433831,1445482.55
430705,201705,18,17,1,15929,937,16866
430710,201705,257,165,92,154605,86204,240809
430720,201705,106,91,15,85079.6,14055,99134.6
430730,201705,120,99,21,91826,18496.38,110322.38
430740,201705,55,39,16,36543,14992,51535
430745,201705,38,30,8,27829,7496,35325
430750,201705,335,232,103,216511.72,95574,312085.72
430755,201705,79,44,35,41228,32795,74023
430760,201705,357,219,138,201971.11,129278.26,331249.37
430770,201705,1451,745,706,696003.92,657135.19,1353139.11
430780,201705,312,198,114,185235.9,106752.78,291988.68
430781,201705,28,24,4,22488,3748,26236
430783,201705,43,35,8,32482.8,7496,39978.8
430786,201705,5,2,3,1874,2811,4685
430790,201705,460,299,161,278839.06,150566.63,429405.69
430800,201705,150,126,24,118062,22488,140550
430805,201705,41,39,2,36543,1874,38417
430807,201705,32,20,12,18740,11244,29984
430810,201705,67,42,25,39354,23425,62779
430820,201705,127,76,51,71212,47131.1,118343.1
430825,201705,11,9,2,8433,1874,10307
430830,201705,223,208,15,194615,14055,208670
430840,201705,117,77,40,72149,36824.1,108973.1
430843,201705,5,3,2,2811,1874,4685
430845,201705,70,40,30,37480,28110,65590
430850,201705,572,395,177,369575,165710.67,535285.67
430860,201705,154,97,57,89577.2,52743.73,142320.93
430865,201705,63,30,33,27454.1,30611.79,58065.89
430870,201705,74,61,13,57157,12181,69338
430880,201705,151,115,36,107755,33732,141487
430885,201705,7,6,1,5622,937,6559
430890,201705,334,204,130,189517.94,121810,311327.94
430900,201705,552,372,180,344441.8,168182.13,512623.93
430905,201705,79,33,46,30921,43102,74023
430910,201705,264,146,118,136802,108965,245767
430912,201705,7,7,0,6559,0,6559
430915,201705,28,20,8,18740,7214.9,25954.9
430920,201705,3971,2204,1767,2058958.85,1653631.42,3712590.27
430925,201705,6,5,1,4441.38,937,5378.38
430930,201705,2048,1225,823,1140237.89,769009.35,1909247.24
430940,201705,231,146,85,135855.63,79626.26,215481.89
430950,201705,160,127,33,118999,30639.9,149638.9
430955,201705,18,11,7,10307,6559,16866
430957,201705,16,15,1,14055,937,14992
430960,201705,238,155,83,144157.45,77771,221928.45
430965,201705,96,60,36,56220,33732,89952
430970,201705,78,65,13,60905,11244,72149
430975,201705,33,31,2,29047,1874,30921
430980,201705,45,28,17,26236,15929,42165
430990,201705,109,82,27,76834,25299,102133
430995,201705,113,109,4,101196,3748,104944
431000,201705,296,137,159,127143.1,148983,276126.1
431010,201705,338,202,136,188308.89,127432,315740.89
431020,201705,1894,1079,815,1005142.89,760553.53,1765696.42
431030,201705,41,33,8,30921,7496,38417
431033,201705,372,184,188,171611.6,176156,347767.6
431036,201705,14,9,5,8433,4685,13118
431040,201705,134,80,54,74023,50490.25,124513.25
431041,201705,36,25,11,23425,10307,33732
431043,201705,42,24,18,22488,16866,39354
431046,201705,12,7,5,6559,4685,11244
431050,201705,209,132,77,121321.06,70662.4,191983.46
431053,201705,67,40,27,36730.4,25299,62029.4
431055,201705,64,41,23,38417,21532.26,59949.26
431057,201705,17,17,0,15929,0,15929
431060,201705,1686,1050,636,977704.83,594158.91,1571863.74
431065,201705,17,10,7,9370,6559,15929
431070,201705,69,65,4,60905,3748,64653
431075,201705,9,9,0,8433,0,8433
431080,201705,138,89,49,82174.9,45913,128087.9
431085,201705,28,25,3,23425,2811,26236
431087,201705,15,13,2,12181,1874,14055
431090,201705,53,43,10,40291,9370,49661
431100,201705,1234,736,498,679326.71,466626,1145952.71
431110,201705,245,151,94,141487,88068.63,229555.63
431112,201705,29,18,11,16866,10307,27173
431113,201705,30,20,10,18740,9370,28110
431115,201705,157,106,51,98697.2,47777.63,146474.83
431120,201705,612,360,252,335409.42,236068.52,571477.94
431123,201705,4,3,1,2811,937,3748
431125,201705,89,79,10,74023,9370,83393
431127,201705,8,3,5,2811,4685,7496
431130,201705,605,396,209,369833.9,195533.16,565367.06
431140,201705,696,464,232,430485.96,217027.94,647513.90
431142,201705,32,25,7,22235,6559,28794
431150,201705,204,151,53,141487,49642.26,191129.26
431160,201705,55,49,6,45913,5622,51535
431162,201705,19,14,5,13118,4685,17803
431164,201705,5,5,0,4685,0,4685
431170,201705,99,82,17,76834,15929,92763
431171,201705,47,25,22,23425,20604.63,44029.63
431173,201705,1,1,0,937,0,937
431175,201705,200,97,103,89671,96511,186182
431177,201705,75,56,19,52472,17784.26,70256.26
431179,201705,14,12,2,11244,1874,13118
431180,201705,431,264,167,246431,156460.63,402891.63
431190,201705,89,68,21,63716,19677,83393
431198,201705,68,45,23,42165,21551,63716
431200,201705,18,16,2,14992,1874,16866
431205,201705,26,26,0,24362,0,24362
431210,201705,82,51,31,47460,29047,76507
431213,201705,25,20,5,18740,4685,23425
431215,201705,27,24,3,22488,2811,25299
431217,201705,5,4,1,3748,937,4685
431220,201705,62,53,9,49661,8433,58094
431225,201705,143,95,48,89006,44966.63,133972.63
431230,201705,99,85,14,78989.1,13118,92107.1
431235,201705,7,7,0,6559,0,6559
431237,201705,25,17,8,15929,7496,23425
431238,201705,15,11,4,10026,3748,13774
431240,201705,970,614,356,572770.16,332514.11,905284.27
431242,201705,37,37,0,34669,0,34669
431244,201705,11,8,3,7496,2811,10307
431245,201705,62,47,15,44039,14055,58094
431247,201705,13,9,4,8433,3748,12181
431250,201705,262,133,129,124602.26,120845.26,245447.52
431260,201705,60,44,16,41228,14992,56220
431261,201705,22,15,7,14055,6559,20614
431262,201705,16,16,0,14992,0,14992
431265,201705,162,84,78,78708,73086,151794
431267,201705,15,14,1,13118,937,14055
431270,201705,304,249,55,233313,51535,284848
431275,201705,40,38,2,35606,1874,37480
431280,201705,21,16,5,14172.12,4685,18857.12
431290,201705,22,19,3,17803,2811,20614
431295,201705,5,5,0,4685,0,4685
431300,201705,22,19,3,17803,2811,20614
431301,201705,8,7,1,6559,937,7496
431303,201705,48,34,14,31736.19,12836.9,44573.09
431306,201705,210,112,98,104496.11,91826,196322.11
431308,201705,6,5,1,4685,937,5622
431310,201705,67,58,9,54346,8433,62779
431320,201705,116,72,44,67464,41218.63,108682.63
431330,201705,176,115,61,107755,57157,164912
431333,201705,32,26,6,24362,5622,29984
431335,201705,10,5,5,4685,4685,9370
431337,201705,308,148,160,137862.1,149845.04,287707.14
431339,201705,15,12,3,11244,2811,14055
431340,201705,2993,1695,1298,1584057.78,1214277.89,2798335.67
431342,201705,40,24,16,22488,14992,37480
431344,201705,17,17,0,15929,0,15929
431346,201705,5,5,0,4685,0,4685
431349,201705,36,33,3,30921,2811,33732
431350,201705,895,520,375,482753.99,350400.52,833154.51
431360,201705,40,37,3,34669,2811,37480
431365,201705,307,144,163,134909.26,152721.63,287630.89
431370,201705,1295,774,521,722090.64,487992.19,1210082.83
431380,201705,101,84,17,78052.1,15929,93981.1
431390,201705,491,273,218,254864.1,202656.01,457520.11
431395,201705,275,120,155,112440,145217,257657
431400,201705,36,28,8,26236,7496,33732
431402,201705,90,61,29,57157,27173,84330
431403,201705,14,8,6,7496,5622,13118
431405,201705,651,351,300,327790.81,281073,608863.81
431406,201705,30,26,4,24362,3748,28110
431407,201705,50,44,6,41228,5622,46850
431410,201705,3047,1794,1253,1669026.54,1173105.26,2842131.80
431413,201705,16,14,2,13118,1874,14992
431415,201705,72,51,21,47787,19677,67464
431417,201705,23,13,10,12181,9370,21551
431420,201705,290,207,83,193334.3,77761.63,271095.93
431430,201705,39,15,24,14055,22488,36543
431440,201705,8829,6286,2543,5827549.62,2376209.83,8203759.45
431442,201705,27,15,12,14055,11244,25299
431445,201705,27,21,6,19677,5622,25299
431446,201705,9,8,1,7496,937,8433
431447,201705,85,58,27,54346,25299,79645
431449,201705,47,44,3,41228,2811,44039
431450,201705,396,280,116,260626.55,107989.25,368615.80
431454,201705,0,0,0,0,0,0
431455,201705,47,36,11,33732,10307,44039
431460,201705,507,345,162,319704.4,151372.9,471077.3
431470,201705,121,93,28,86461.86,26236,112697.86
431475,201705,11,10,1,9370,937,10307
431477,201705,34,24,10,22488,9370,31858
431478,201705,6,5,1,4685,937,5622
431480,201705,487,307,180,286206.65,168332.05,454538.70
431490,201705,28130,15810,12320,14747916.11,11510423.15,26258339.26
431500,201705,77,55,22,51535,20614,72149
431505,201705,43,16,27,14992,25299,40291
431507,201705,6,6,0,5622,0,5622
431510,201705,285,179,106,167020.9,97429.26,264450.16
431513,201705,22,17,5,15929,4685,20614
431514,201705,7,6,1,5622,937,6559
431515,201705,76,66,10,61842,9370,71212
431517,201705,3,1,2,937,1874,2811
431520,201705,36,32,4,29984,3748,33732
431530,201705,1628,718,910,671456.42,852215.67,1523672.09
431531,201705,21,20,1,18740,937,19677
431532,201705,23,16,7,14992,6559,21551
431535,201705,23,14,9,13118,8433,21551
431540,201705,143,127,16,117715.31,14992,132707.31
431545,201705,18,16,2,14992,1874,16866
431550,201705,339,194,145,181778,135771.3,317549.3
431555,201705,11,10,1,9370,937,10307
431560,201705,4260,2991,1269,2775460.59,1186589.69,3962050.28
431570,201705,753,393,360,365149.1,334543.73,699692.83
431575,201705,36,26,10,24362,9370,33732
431580,201705,93,64,29,59031,27173,86204
431590,201705,127,106,21,99087.75,19677,118764.75
431595,201705,12,11,1,10307,937,11244
431600,201705,205,115,90,107755,84330,192085
431610,201705,127,92,35,85548.1,32795,118343.1
431620,201705,42,34,8,31858,7496,39354
431630,201705,125,108,17,101196,15929,117125
431640,201705,1316,832,484,776398.2,452909.06,1229307.26
431642,201705,44,40,4,37011.5,3748,40759.5
431643,201705,47,21,26,19677,24362,44039
431645,201705,302,173,129,162101,119936,282037
431647,201705,11,11,0,10307,0,10307
431650,201705,33,23,10,21551,9370,30921
431660,201705,266,174,92,161819.9,86204,248023.9
431670,201705,215,102,113,93934.25,105852.89,199787.14
431673,201705,3,3,0,2811,0,2811
431675,201705,30,26,4,24080.9,3748,27828.9
431680,201705,1056,751,305,699939,285523.38,985462.38
431690,201705,4694,2860,1834,2664026.41,1713325.99,4377352.40
431695,201705,24,18,6,16866,5622,22488
431697,201705,0,0,0,0,0,0
431700,201705,162,121,41,113377,38417,151794
431710,201705,3939,1690,2249,1582021.9,2105902.45,3687924.35
431720,201705,1387,814,573,754978.39,535013.63,1289992.02
431725,201705,1,1,0,937,0,937
431730,201705,1163,773,390,719336.1,365430,1084766.1
431740,201705,1356,674,682,627004.26,638483.12,1265487.38
431750,201705,1869,1208,661,1122438.82,616799.36,1739238.18
431755,201705,5,4,1,3748,937,4685
431760,201705,1090,693,397,648966.2,371764.49,1020730.69
431770,201705,389,287,102,268909.63,95555.26,364464.89
431775,201705,27,21,6,19677,5622,25299
431780,201705,561,346,215,323208.78,201445.63,524654.41
431790,201705,142,108,34,100259,31811.15,132070.15
431795,201705,13,12,1,11244,937,12181
431800,201705,3413,1777,1636,1652330.73,1524979.16,3177309.89
431805,201705,17,15,2,14055,1874,15929
431810,201705,605,411,194,383457.88,181493.06,564950.94
431820,201705,313,175,138,163975,128322.15,292297.15
431830,201705,2311,1397,914,1305714.2,855211.76,2160925.96
431840,201705,502,330,172,305651.65,159946,465597.65
431842,201705,33,27,6,25299,5622,30921
431843,201705,11,6,5,5622,4685,10307
431844,201705,15,13,2,12181,1874,14055
431845,201705,29,27,2,25299,1874,27173
431846,201705,29,25,4,23425,3748,27173
431848,201705,13,11,2,10307,1874,12181
431849,201705,8,6,2,5622,1874,7496
431850,201705,778,644,134,602201,125323.75,727524.75
431860,201705,102,73,29,68401,26236,94637
431861,201705,4,2,2,1874,1874,3748
431862,201705,48,35,13,32795,12181,44976
431870,201705,3415,1989,1426,1855845.09,1334881.75,3190726.84
431880,201705,889,658,231,611833,215510,827343
431890,201705,1302,801,501,746246.29,467859,1214105.29
431900,201705,172,122,50,114314,46850,161164
431910,201705,52,38,14,35606,13118,48724
431912,201705,35,20,15,18740,14055,32795
431915,201705,122,99,23,92763,21551,114314
431920,201705,137,103,34,96501.63,31858,128359.63
431930,201705,85,67,18,62779,16866,79645
431935,201705,4,3,1,2811,937,3748
431936,201705,12,11,1,10307,937,11244
431937,201705,16,11,5,10307,4685,14992
431940,201705,443,291,152,269996.55,142414.63,412411.18
431950,201705,458,293,165,273276.42,153040.95,426317.37
431960,201705,712,432,280,400691.42,262201.45,662892.87
431970,201705,72,64,8,59968,7496,67464
431971,201705,3,3,0,2811,0,2811
431973,201705,15,13,2,12181,1874,14055
431975,201705,6,5,1,4685,937,5622
431980,201705,199,128,71,118436.8,66527,184963.8
431990,201705,1230,659,571,616036.09,534708.9,1150744.99
432000,201705,1649,878,771,816702.07,719583.12,1536285.19
432010,201705,280,185,95,172252.3,89015,261267.3
432020,201705,161,128,33,119936,30911.63,150847.63
432023,201705,21,17,4,15929,3748,19677
432026,201705,62,56,6,52472,5622,58094
432030,201705,59,31,28,29047,26236,55283
432032,201705,22,18,4,16866,3748,20614
432035,201705,43,35,8,32795,7496,40291
432040,201705,100,70,30,65590,28110,93700
432045,201705,8,7,1,6277.9,937,7214.9
432050,201705,66,39,27,36543,25299,61842
432055,201705,100,77,23,72130.26,21551,93681.26
432057,201705,0,0,0,0,0,0
432060,201705,38,34,4,31155.25,3748,34903.25
432065,201705,31,28,3,26236,2811,29047
432067,201705,96,83,13,77771,12181,89952
432070,201705,401,298,103,277635.29,96483.26,374118.55
432080,201705,807,547,260,511602,243573.89,755175.89
432085,201705,14,11,3,10307,2811,13118
432090,201705,257,168,89,157416,83393,240809
432100,201705,172,112,60,104662.9,56220,160882.9
432110,201705,593,402,191,370930.76,178030,548960.76
432120,201705,960,569,391,532497.1,366329.89,898826.99
432130,201705,486,349,137,326076,128228.45,454304.45
432132,201705,27,24,3,22488,2811,25299
432135,201705,76,63,13,59031,12181,71212
432140,201705,266,203,63,189920.53,59031,248951.53
432143,201705,180,111,69,104007,64653,168660
432145,201705,254,174,80,161820.8,74678.9,236499.7
432146,201705,15,14,1,13118,937,14055
432147,201705,173,61,112,57157,104925.26,162082.26
432149,201705,16,11,5,10307,4685,14992
432150,201705,821,520,301,486068.75,280313.39,766382.14
432160,201705,1393,724,669,676718.25,625982.56,1302700.81
432162,201705,4,3,1,2811,937,3748
432163,201705,18,14,4,13118,3748,16866
432166,201705,126,93,33,87376,30921,118297
432170,201705,231,125,106,115533,99322,214855
432180,201705,525,316,209,295436.1,195552,490988.1
432183,201705,8,6,2,5622,1874,7496
432185,201705,78,66,12,61748.3,11244,72992.3
432190,201705,490,252,238,234981.63,222847.45,457829.08
432195,201705,80,71,9,65824.25,8433,74257.25
432200,201705,397,251,146,235187,136709.52,371896.52
432210,201705,113,74,39,67323.45,36543,103866.45
432215,201705,63,59,4,55283,3982.25,59265.25
432218,201705,19,18,1,16866,937,17803
432220,201705,668,335,333,312894.05,311222.13,624116.18
432225,201705,15,10,5,8901.5,4685,13586.5
432230,201705,162,90,72,84095.75,67464,151559.75
432232,201705,14,12,2,11244,1874,13118
432234,201705,5,4,1,3748,937,4685
432235,201705,1,1,0,937,0,937
432237,201705,29,16,13,14992,12181,27173
432240,201705,4121,2282,1839,2128687.71,1716087.71,3844775.42
432250,201705,1007,612,395,570587.28,369018.71,939605.99
432252,201705,39,32,7,29253.14,6559,35812.14
432253,201705,55,46,9,43102,8433,51535
432254,201705,19,7,12,6559,11244,17803
432255,201705,14,13,1,12181,937,13118
432260,201705,844,656,188,613688.25,175219.75,788908.00
432270,201705,215,156,59,146172,55283,201455
432280,201705,119,85,34,79156.9,31858,111014.9
432285,201705,2,1,1,937,937,1874
432290,201705,67,62,5,56501.1,4685,61186.1
432300,201705,4610,2607,2003,2429046.76,1872825.33,4301872.09
432310,201705,117,92,25,86204,23425,109629
432320,201705,21,15,6,14055,5622,19677
432330,201705,13,7,6,6559,5622,12181
432335,201705,8,7,1,6559,937,7496
432340,201705,41,37,4,34669,3748,38417
432345,201705,88,63,25,59031,23425,82456
432350,201705,23,22,1,20614,937,21551
432360,201705,7,5,2,4685,1874,6559
432370,201705,25,24,1,22206.9,937,23143.9
432375,201705,42,36,6,33732,5622,39354
432377,201705,7,7,0,6559,0,6559
432380,201705,157,66,91,61186.1,85267,146453.1
500020,201705,232,120,112,112440,104353.69,216793.69
500025,201705,112,56,56,52472,52472,104944
500060,201705,1361,811,550,759344.8,514755.21,1274100.01
500070,201705,720,338,382,316706,357653,674359
500080,201705,133,100,33,93700,30359,124059
500085,201705,140,113,27,105600,24479.13,130079.13
500090,201705,332,155,177,145235,165849,311084
500100,201705,689,366,323,341349.3,302089,643438.3
500110,201705,2228,973,1255,911392.63,1175151.93,2086544.56
500124,201705,314,178,136,166786,127150.9,293936.9
500150,201705,323,120,203,112431,189857,302288
500190,201705,523,356,167,332916.1,155998,488914.1
500200,201705,194,165,29,154247.89,27173,181420.89
500210,201705,1415,499,916,466312.48,857230.47,1323542.95
500215,201705,236,134,102,124597.21,95574,220171.21
500220,201705,779,510,269,477648.26,251309.63,728957.89
500230,201705,253,173,80,161398.25,74491.5,235889.75
500240,201705,708,489,219,457443.4,204734.9,662178.3
500260,201705,561,203,358,190211,335446,525657
500270,201705,28188,11870,16318,11095005.16,15272634.6,26367639.76
500280,201705,193,72,121,67464,113368,180832
500290,201705,1180,668,512,624980,479453.9,1104433.9
500295,201705,384,225,159,210825,148973.63,359798.63
500310,201705,67,21,46,19677,43102,62779
500315,201705,700,410,290,384160.63,271439.53,655600.16
500320,201705,3606,1785,1821,1669880.29,1704649.37,3374529.66
500325,201705,946,513,433,480213,404763.32,884976.32
500330,201705,1490,675,815,629918.86,763051.8,1392970.66
500345,201705,326,236,90,220186.1,84330,304516.1
500348,201705,235,136,99,127432,92744.63,220176.63
500350,201705,143,68,75,63716,70275,133991
500370,201705,5379,2382,2997,2223834.21,2805235.06,5029069.27
500375,201705,344,249,95,233303.63,89015,322318.63
500380,201705,578,331,247,309992.4,231420.63,541413.03
500390,201705,69,35,34,32795,31858,64653
500400,201705,214,145,69,135846.26,64644,200490.26
500410,201705,569,216,353,202346.58,330615.42,532962.00
500430,201705,533,368,165,344816,154605,499421
500440,201705,204,102,102,94813.42,95574,190387.42
500450,201705,418,177,241,165160.8,224812.94,389973.74
500460,201705,313,157,156,147099.63,146172,293271.63
500470,201705,433,342,91,319261.05,84321,403582.05
500480,201705,106,65,41,60905,38417,99322
500490,201705,106,40,66,37475.32,61842,99317.32
500500,201705,1413,477,936,445033.31,876149.9,1321183.21
500510,201705,50,37,13,34669,12172,46841
500515,201705,108,72,36,67464,33451,100915
500520,201705,351,199,152,185433,142420,327853
500525,201705,86,50,36,46850,33450.9,80300.9
500540,201705,887,361,526,338191.78,491865.35,830057.13
500560,201705,869,491,378,458349.66,353503.83,811853.49
500568,201705,962,557,405,517012.13,379199.32,896211.45
500570,201705,1208,686,522,640589.09,486569.39,1127158.48
500580,201705,337,170,167,158999.53,156466,315465.53
500600,201705,321,163,158,152032.93,148046,300078.93
500620,201705,866,611,255,566833.42,238738.23,805571.65
500625,201705,80,68,12,63021.78,11244,74265.78
500627,201705,21,9,12,8433,11244,19677
500630,201705,1560,815,745,761500.9,697779.22,1459280.12
500635,201705,514,281,233,262894.09,218161.71,481055.80
500640,201705,423,218,205,202673.5,192057.63,394731.13
500660,201705,5500,2089,3411,1954413.8,3192443.73,5146857.53
500690,201705,571,202,369,188931.76,344989.23,533920.99
500710,201705,355,170,185,159009,173054.9,332063.9
500720,201705,966,572,394,534554.32,368972.26,903526.58
500730,201705,191,107,84,100259,78422.22,178681.22
500740,201705,838,370,468,345408.14,438067,783475.14
500750,201705,135,42,93,39354,86832.16,126186.16
500755,201705,125,91,34,84986,31858,116844
500769,201705,736,409,327,382912.02,306386,689298.02
500770,201705,452,228,224,213626.63,209644.38,423271.01
500780,201705,176,118,58,110566,54346,164912
500790,201705,1034,507,527,474492.32,493477.63,967969.95
500793,201705,250,133,117,124621,109620,234241
500795,201705,180,125,55,117115.63,51526,168641.63
500797,201705,41,34,7,31858,6559,38417
500800,201705,410,178,232,166777,217102.9,383879.9
500830,201705,2130,1177,953,1099635.3,891897.96,1991533.26
500840,201705,146,109,37,102133,34379,136512
510010,201705,168,92,76,86194.63,71212,157406.63
510020,201705,482,225,257,210551.67,240259.01,450810.68
510025,201705,1638,919,719,860248.03,670856.65,1531104.68
510030,201705,609,308,301,288550.26,281286.32,569836.58
510035,201705,129,55,74,51507.63,69319.63,120827.26
510040,201705,371,157,214,147109,200078.53,347187.53
510050,201705,419,228,191,212908.47,178147.89,391056.36
510060,201705,107,50,57,46840.63,53399.63,100240.26
510080,201705,216,84,132,78675.95,123581.3,202257.25
510100,201705,75,34,41,31858,38398.26,70256.26
510120,201705,32,18,14,16866,13118,29984
510125,201705,396,243,153,227021.05,143338.26,370359.31
510130,201705,590,343,247,320961.33,231002.31,551963.64
510140,201705,380,124,256,116179,239847.32,356026.32
510160,201705,88,42,46,39354,43098,82452
510170,201705,848,520,328,486705.03,306068.85,792773.88
510180,201705,2827,1382,1445,1291931.16,1351936.91,2643868.07
510185,201705,9,4,5,3748,4685,8433
510190,201705,216,74,142,69338,133049.32,202387.32
510250,201705,2622,1513,1109,1416645.22,1038066.4,2454711.62
510260,201705,202,144,58,134737.15,54309.63,189046.78
510263,201705,447,244,203,226904.94,189468.89,416373.83
510267,201705,637,347,290,324947.78,271471.47,596419.25
510268,201705,53,28,25,26236,23425,49661
510269,201705,70,26,44,24353,41218.63,65571.63
510270,201705,403,207,196,193783.19,183223.57,377006.76
510279,201705,217,152,65,142396.63,60886.26,203282.89
510285,201705,174,73,101,68362.63,94637,162999.63
510300,201705,554,294,260,275043.85,243546.53,518590.38
510305,201705,211,94,117,88055.63,109527.04,197582.67
510310,201705,122,57,65,53409,60895.63,114304.63
510320,201705,839,518,321,485265.52,300356.26,785621.78
510325,201705,392,159,233,148933.63,218003.33,366936.96
510330,201705,412,228,184,213603,172389.26,385992.26
510335,201705,590,304,286,284801.89,267223.32,552025.21
510336,201705,50,35,15,32774.89,14055,46829.89
510337,201705,118,44,74,41218.63,69328.63,110547.26
510340,201705,17247,8315,8932,7768827.93,8358557.2,16127385.13
510343,201705,71,47,24,44029.63,22488,66517.63
510345,201705,160,104,56,97438.63,52181.63,149620.26
510350,201705,634,355,279,331429.74,261358.89,592788.63
510360,201705,207,120,87,112421.63,81427.89,193849.52
510370,201705,134,66,68,61823.26,63586.67,125409.93
510380,201705,92,64,28,59968,26227,86195
510385,201705,57,26,31,24362,29038,53400
510390,201705,128,51,77,47787,72102.15,119889.15
510395,201705,42,28,14,26236,13118,39354
510410,201705,687,448,239,419743,223919.95,643662.95
510420,201705,595,279,316,260520.77,294538.46,555059.23
510450,201705,51,33,18,30921,16866,47787
510452,201705,39,23,16,21551,14992,36543
510454,201705,72,30,42,28110,39344.63,67454.63
510455,201705,130,79,51,74004.26,47777.63,121781.89
510460,201705,184,91,93,84958.53,87103.89,172062.42
510480,201705,701,392,309,366179.31,289156.97,655336.28
510490,201705,360,183,177,171118.64,165308.13,336426.77
510500,201705,255,188,67,176146.63,62779,238925.63
510510,201705,770,441,329,412346.43,308263.63,720610.06
510515,201705,1146,586,560,548520.11,524662.89,1073183.00
510517,201705,248,106,142,99040.9,133030.95,232071.85
510520,201705,235,153,82,143278.89,76529.52,219808.41
510523,201705,95,60,35,56220,32785.63,89005.63
510525,201705,654,368,286,344043.78,267872.15,611915.93
510530,201705,15,11,4,10307,3748,14055
510550,201705,274,118,156,110085.46,146163,256248.46
510558,201705,285,136,149,127417.95,139585.26,267003.21
510560,201705,354,214,140,200518,130881,331399
510562,201705,640,442,198,412575.25,185037.5,597612.75
510590,201705,837,435,402,407557.89,376646.96,784204.85
510600,201705,254,136,118,127409.26,110524.58,237933.84
510610,201705,160,76,84,71193.26,78499.63,149692.89
510615,201705,187,71,116,66508.26,108692,175200.26
510617,201705,15,8,7,7496,6559,14055
510618,201705,119,56,63,52472,58562.5,111034.5
510619,201705,111,76,35,71203,32786,103989
510620,201705,194,107,87,100249.63,81519,181768.63
510621,201705,195,126,69,117762.53,64634.63,182397.16
510622,201705,435,283,152,265059.89,142097.26,407157.15
510623,201705,357,229,128,214536.26,119623.52,334159.78
510624,201705,85,39,46,36534,43102,79636
510625,201705,515,311,204,291188.78,190542.45,481731.23
510626,201705,105,62,43,58094,40291,98385
510627,201705,54,39,15,36543,14055,50598
510628,201705,166,98,68,91780.26,63659.78,155440.04
510629,201705,248,156,92,146172,85257.63,231429.63
510630,201705,463,228,235,213552.41,219863.85,433416.26
510631,201705,10,3,7,2811,6559,9370
510637,201705,339,187,152,174869.79,142278.52,317148.31
510642,201705,985,533,452,499066.42,423383.82,922450.24
510645,201705,0,0,0,0,0,0
510650,201705,1515,999,516,935900.89,483391.78,1419292.67
510665,201705,83,40,43,37426,40273,77699
510670,201705,68,37,31,34669,29047,63716
510675,201705,1177,723,454,677389,425355.32,1102744.32
510677,201705,380,176,204,163895.15,191001.04,354896.19
510680,201705,111,65,46,60887,43093,103980
510682,201705,203,90,113,84014,105881,189895
510685,201705,59,43,16,40291,14992,55283
510700,201705,616,355,261,332516.89,244406.04,576922.93
510704,201705,1013,536,477,500045.72,444447.41,944493.13
510706,201705,124,60,64,56215.32,59931.26,116146.58
510710,201705,392,259,133,242489.93,124470.56,366960.49
510715,201705,64,47,17,44029.63,15929,59958.63
510718,201705,218,111,107,103914.78,100240.63,204155.41
510719,201705,32,18,14,16866,13118,29984
510720,201705,194,125,69,117116,64371.9,181487.9
510724,201705,86,33,53,30911.63,49628.89,80540.52
510726,201705,44,25,19,23415.63,17785,41200.63
510729,201705,80,38,42,35606,39307.15,74913.15
510730,201705,465,256,209,239863,195685.63,435548.63
510735,201705,106,42,64,39354,59968,99322
510740,201705,29,15,14,14055,13118,27173
510757,201705,18,14,4,13118,3748,16866
510760,201705,6936,3632,3304,3393028.67,3090289.65,6483318.32
510770,201705,742,354,388,331522.15,363365.15,694887.30
510774,201705,14,7,7,6559,6559,13118
510775,201705,111,82,29,76824.63,27163.63,103988.26
510776,201705,26,6,20,5622,18740,24362
510777,201705,189,82,107,76805.89,100230.89,177036.78
510779,201705,52,24,28,22479,26199.26,48678.26
510780,201705,299,162,137,151722.26,128269.26,279991.52
510785,201705,449,245,204,229499.78,191054.3,420554.08
510787,201705,176,91,85,85253.32,79627.32,164880.64
510788,201705,0,0,0,0,0,0
510790,201705,2351,1225,1126,1145699.85,1052554.16,2198254.01
510792,201705,1033,579,454,542044.52,424992.01,967036.53
510794,201705,103,49,54,45913,50570.26,96483.26
510795,201705,2342,1345,997,1253037.79,931332.8,2184370.59
510800,201705,168,106,62,99312.63,58085,157397.63
510805,201705,162,114,48,106818,44976,151794
510810,201705,93,37,56,34586.89,52359.93,86946.82
510820,201705,272,129,143,120622.26,133008.71,253630.97
510830,201705,67,40,27,37480,25290,62770
510835,201705,1,0,1,0,937,937
510840,201705,9054,4540,4514,4240885.63,4221833.08,8462718.71
510850,201705,204,85,119,79635.63,111184.79,190820.42
510860,201705,397,174,223,162853.56,208216.05,371069.61
510880,201705,62,47,15,44020.63,14055,58075.63
510885,201705,67,41,26,38398.63,24324.89,62723.52
510890,201705,74,41,33,38417,30921,69338
510895,201705,179,102,77,95574,71845.63,167419.63
520005,201705,20,15,5,14055,4676,18731
520010,201705,289,125,164,117105,153575,270680
520013,201705,623,364,259,341031.63,242401.9,583433.53
520015,201705,50,35,15,32795,14055,46850
520017,201705,103,59,44,55002,41228,96230
520020,201705,30,15,15,14055,14055,28110
520025,201705,1941,1048,893,981976,835616.7,1817592.7
520030,201705,805,400,405,374791,378539,753330
520050,201705,77,51,26,47787,24362,72149
520055,201705,44,30,14,28110,13118,41228
520060,201705,176,112,64,104944,59968,164912
520080,201705,582,400,182,374800,170529.32,545329.32
520082,201705,20,14,6,13118,5622,18740
520085,201705,99,73,26,68401,24362,92763
520090,201705,79,54,25,50598,23425,74023
520110,201705,8986,3840,5146,3591251.01,4817635.97,8408886.98
520120,201705,13,8,5,7299.23,4685,11984.23
520130,201705,732,526,206,492853,192732,685585
520140,201705,11625,6545,5080,6125772.85,4757248.28,10883021.13
520145,201705,44,33,11,30921,10307,41228
520150,201705,183,143,40,133991,37480,171471
520160,201705,33,22,11,20614,10307,30921
520170,201705,231,140,91,131149,85231,216380
520180,201705,103,50,53,46850,49661,96511
520215,201705,215,128,87,119654.9,81237.9,200892.8
520235,201705,70,53,17,49661,15929,65590
520250,201705,138,85,53,79645,49379.9,129024.9
520260,201705,112,73,39,68401,35606,104007
520280,201705,49,34,15,31203,14055,45258
520310,201705,38,22,16,20614,14992,35606
520320,201705,169,104,65,97448,60905,158353
520330,201705,772,404,368,378511.63,344780,723291.63
520340,201705,361,200,161,187400,150838.63,338238.63
520350,201705,519,228,291,213636,272621,486257
520355,201705,93,52,41,48724,38417,87141
520357,201705,23,15,8,14055,7496,21551
520360,201705,0,0,0,0,0,0
520380,201705,145,75,70,70275,65570,135845
520390,201705,292,124,168,116188,157406.63,273594.63
520393,201705,12,9,3,8433,2811,11244
520396,201705,96,59,37,55283,34669,89952
520400,201705,230,135,95,124903.1,89015,213918.1
520410,201705,192,99,93,92754,87132,179886
520420,201705,25,17,8,15929,7496,23425
520425,201705,302,135,167,125559,156011.6,281570.6
520430,201705,441,230,211,215228.9,197370.9,412599.8
520440,201705,590,391,199,366367,186463,552830
520450,201705,1866,856,1010,800976.63,945715.95,1746692.58
520455,201705,59,39,20,36543,18740,55283
520460,201705,29,16,13,14992,12181,27173
520465,201705,22,19,3,17803,2811,20614
520470,201705,424,261,163,244357,152731,397088
520480,201705,83,45,38,42165,35552,77717
520485,201705,129,44,85,41228,79364,120592
520490,201705,382,287,95,268738.26,88853.84,357592.10
520495,201705,187,106,81,99322,75897,175219
520500,201705,186,141,45,132117,42165,174282
520505,201705,168,86,82,80582,76834,157416
520510,201705,1736,843,893,785533.56,834534.13,1620067.69
520520,201705,45,32,13,29984,12181,42165
520530,201705,237,172,65,158814.89,60119.79,218934.68
520540,201705,497,320,177,298556.81,165849,464405.81
520545,201705,156,84,72,78708,67464,146172
520547,201705,47,26,21,24362,19677,44039
520549,201705,988,464,524,434450,490460,924910
520551,201705,293,154,139,144298,130243,274541
520552,201705,44,24,20,22488,18740,41228
520570,201705,18,10,8,9370,7496,16866
520580,201705,286,172,114,161155,106818,267973
520590,201705,158,90,68,84330,63434.9,147764.9
520620,201705,1117,522,595,488365.14,556662.53,1045027.67
520630,201705,37,21,16,19677,14992,34669
520640,201705,412,235,177,220195,165849,386044
520650,201705,51,38,13,35606,12181,47787
520660,201705,34,18,16,16866,14992,31858
520670,201705,33,27,6,25299,5622,30921
520680,201705,64,42,22,39354,20614,59968
520690,201705,31,13,18,12181,16857,29038
520710,201705,38,35,3,32795,2811,35606
520725,201705,200,125,75,117125,70266,187391
520735,201705,56,43,13,40291,12181,52472
520740,201705,400,195,205,182013.2,192076,374089.2
520750,201705,40,30,10,28110,9370,37480
520753,201705,56,40,16,37480,14992,52472
520760,201705,110,73,37,68401,34669,103070
520780,201705,269,208,61,194896,57157,252053
520790,201705,170,78,92,72804.9,86204,159008.9
520800,201705,3551,1856,1695,1734983.68,1587545.77,3322529.45
520810,201705,167,114,53,106818,48786.02,155604.02
520815,201705,6,5,1,4685,937,5622
520830,201705,138,90,48,84330,44976,129306
520840,201705,320,208,112,194423.42,104944,299367.42
520850,201705,109,69,40,64644,37330.08,101974.08
520860,201705,1642,1022,620,956499.87,579535.6,1536035.47
520870,201705,30077,14858,15219,13895698.2,14246769.17,28142467.37
520880,201705,981,555,426,519754,399143.26,918897.26
520890,201705,786,449,337,419120.2,315385.63,734505.83
520910,201705,1024,527,497,490287.31,465689,955976.31
520915,201705,97,73,24,68401,22478.63,90879.63
520920,201705,409,200,209,186837.8,195833,382670.8
520929,201705,23,21,2,19677,1874,21551
520940,201705,77,46,31,43102,29047,72149
520945,201705,23,15,8,14055,7496,21551
520960,201705,49,30,19,28110,17803,45913
520970,201705,323,198,125,184908,116843.9,301751.9
520980,201705,96,71,25,66527,23425,89952
520990,201705,464,310,154,290245.12,144298,434543.12
520993,201705,121,58,63,54346,59022,113368
520995,201705,243,136,107,126496,99697,226193
521000,201705,1546,880,666,822874.3,623668,1446542.3
521010,201705,665,299,366,279836.53,342886.15,622722.68
521015,201705,16,9,7,8433,6559,14992
521020,201705,1484,1017,467,952310.95,437223.78,1389534.73
521030,201705,37,26,11,24362,10307,34669
521040,201705,917,557,360,521676,337039,858715
521056,201705,42,29,13,27173,12181,39354
521060,201705,132,81,51,75897,47787,123684
521080,201705,497,367,130,343870,121810,465680
521090,201705,528,308,220,288596,205868.27,494464.27
521100,201705,290,213,77,199581,72149,271730
521120,201705,1025,696,329,651590,307983,959573
521130,201705,362,256,106,239872,98732.8,338604.8
521140,201705,191,107,84,100259,78708,178967
521150,201705,2783,1176,1607,1099711.14,1504508.85,2604219.99
521160,201705,32,17,15,15929,14055,29984
521170,201705,193,112,81,104934.63,75897,180831.63
521180,201705,1088,673,415,629374.43,388152.25,1017526.68
521190,201705,2542,1060,1482,993201.26,1387286.16,2380487.42
521200,201705,44,32,12,29984,11244,41228
521205,201705,16,11,5,10307,4685,14992
521210,201705,153,85,68,79645,63716,143361
521220,201705,804,538,266,501520.78,249187,750707.78
521225,201705,25,15,10,14055,9370,23425
521230,201705,113,71,42,65964.8,39354,105318.8
521250,201705,6405,3603,2802,3369463.4,2622364.83,5991828.23
521260,201705,17,12,5,11244,4685,15929
521270,201705,153,118,35,110566,32795,143361
521280,201705,440,256,184,238309.89,172408,410717.89
521290,201705,34,14,20,13118,18740,31858
521295,201705,103,69,34,64428.12,31858,96286.12
521300,201705,224,114,110,106791,102706.89,209497.89
521305,201705,36,24,12,22488,11244,33732
521308,201705,1073,769,304,720052.78,284548.63,1004601.41
521310,201705,1336,788,548,737272.1,512596.26,1249868.36
521340,201705,22,17,5,15929,4685,20614
521350,201705,131,95,36,89015,33732,122747
521370,201705,198,122,76,113377,70930.9,184307.9
521375,201705,198,110,88,103070,82174.9,185244.9
521377,201705,51,34,17,31858,15929,47787
521380,201705,1060,695,365,647423.26,342005,989428.26
521385,201705,19,11,8,10307,7496,17803
521390,201705,108,86,22,80269.7,20614,100883.7
521400,201705,335,204,131,190866.9,122700.15,313567.05
521405,201705,150,74,76,69338,71212,140550
521410,201705,72,49,23,45913,21551,67464
521440,201705,219,153,66,142564.55,61842,204406.55
521450,201705,715,381,334,356997,312302.1,669299.1
521460,201705,1179,704,475,659367,445056.26,1104423.26
521470,201705,15,10,5,9370,4685,14055
521480,201705,56,34,22,31858,20550,52408
521483,201705,292,153,139,143080,130243,273323
521486,201705,291,183,108,171349.19,100541,271890.19
521487,201705,25,12,13,11244,12181,23425
521490,201705,29,17,12,15929,11244,27173
521500,201705,111,72,39,67464,36543,104007
521520,201705,43,32,11,29984,10307,40291
521523,201705,544,335,209,312348.95,195833,508181.95
521525,201705,48,31,17,29047,15929,44976
521530,201705,249,128,121,119936,113377,233313
521540,201705,30,16,14,14992,13118,28110
521550,201705,92,40,52,37180.63,48687.63,85868.26
521560,201705,764,524,240,490528.97,224599,715127.97
521565,201705,46,32,14,29984,13118,43102
521570,201705,479,319,160,298893.63,149827.15,448720.78
521580,201705,63,39,24,36543,22488,59031
521590,201705,36,18,18,16866,16866,33732
521600,201705,30,18,12,16866,11244,28110
521630,201705,230,115,115,107745.63,106781.88,214527.51
521640,201705,298,151,147,141487,137739,279226
521645,201705,30,16,14,14992,13118,28110
521680,201705,226,140,86,131180,80582,211762
521690,201705,1,1,0,937,0,937
521710,201705,1184,553,631,517598.9,590957,1108555.9
521720,201705,518,337,181,315769,169550.26,485319.26
521730,201705,626,311,315,291407,294874,586281
521740,201705,909,351,558,328868.63,521675.96,850544.59
521760,201705,1546,832,714,778034.52,668710,1446744.52
521770,201705,785,497,288,465689,269396.87,735085.87
521800,201705,2077,1259,818,1177139.2,765206.06,1942345.26
521805,201705,35,20,15,18736,14055,32791
521810,201705,97,58,39,53221.9,36543,89764.9
521830,201705,943,655,288,612143.08,269847,881990.08
521839,201705,89,62,27,58094,25299,83393
521850,201705,1087,586,501,547399.26,469107.04,1016506.30
521860,201705,349,211,138,197707,129025,326732
521870,201705,66,36,30,33732,28110,61842
521878,201705,49,21,28,19677,26236,45913
521880,201705,4273,1920,2353,1796790.48,2202107.5,3998897.98
521890,201705,557,382,175,357934,163684.9,521618.9
521900,201705,298,241,57,224911.2,53409,278320.2
521910,201705,150,106,44,99322,41228,140550
521920,201705,56,27,29,25299,27173,52472
521925,201705,34,21,13,19677,12181,31858
521930,201705,1080,607,473,568565.56,442431.46,1010997.02
521935,201705,31,23,8,21551,7496,29047
521940,201705,200,103,97,96511,90607.9,187118.9
521945,201705,16,14,2,13118,1874,14992
521950,201705,7,5,2,4685,1874,6559
521960,201705,75,52,23,48724,21551,70275
521970,201705,409,254,155,237716.9,145235,382951.9
521971,201705,92,47,45,44039,42165,86204
521973,201705,32,14,18,13118,16866,29984
521975,201705,1032,552,480,516100.6,448767.73,964868.33
521980,201705,243,164,79,153509,74023,227532
521990,201705,73,56,17,52472,15929,68401
522000,201705,292,183,109,171471,102133,273604
522005,201705,23,14,9,13118,8433,21551
522010,201705,1113,622,491,580931.1,459495.43,1040426.53
522015,201705,59,36,23,33723,21551,55274
522020,201705,833,419,414,392603,386962.26,779565.26
522026,201705,28,20,8,18740,7496,26236
522028,201705,16,12,4,11244,3748,14992
522040,201705,721,276,445,258322,416910.63,675232.63
522045,201705,1968,1240,728,1161335.53,681330.8,1842666.33
522050,201705,179,87,92,81519,86204,167723
522060,201705,543,344,199,322046.9,186369.3,508416.2
522068,201705,137,88,49,82456,45913,128369
522070,201705,12,12,0,11244,0,11244
522100,201705,45,23,22,21289,20614,41903
522108,201705,40,30,10,28110,9370,37480
522119,201705,61,29,32,27173,29984,57157
522130,201705,73,23,50,21551,46814,68365
522140,201705,3655,1872,1783,1750422.8,1668826.42,3419249.22
522145,201705,56,33,23,30921,21551,52472
522150,201705,64,51,13,47787,12181,59968
522155,201705,57,40,17,37471,15929,53400
522157,201705,6,4,2,3748,1874,5622
522160,201705,1740,1004,736,939623.6,689295.9,1628919.5
522170,201705,401,267,134,250179,125558,375737
522180,201705,39,21,18,19677,16866,36543
522185,201705,1306,538,768,501195.17,719454.88,1220650.05
522190,201705,47,26,21,24362,19583.3,43945.3
522200,201705,297,180,117,168660,109629,278289
522205,201705,163,110,53,103070,49661,152731
522220,201705,177,123,54,115251,50598,165849
522230,201705,32,25,7,23425,6559,29984
530010,201705,53891,27644,26247,25767636.74,24539431.53,50307068.27
110001,201706,501,393,108,366471.99,100361.64,466833.63
110002,201706,2650,1550,1100,1443238.51,1023924.72,2467163.23
110003,201706,89,71,18,66106.45,16745.89,82852.34
110004,201706,1934,1226,708,1140275.95,659081.93,1799357.88
110005,201706,432,349,83,324227.05,77139.43,401366.48
110006,201706,435,334,101,309991.62,93895.68,403887.30
110007,201706,79,64,15,59767.45,13974.89,73742.34
110008,201706,233,134,99,124140.34,92402.01,216542.35
110009,201706,753,500,253,465616.94,235592.04,701208.98
110010,201706,1773,1089,684,1013608.72,637998.45,1651607.17
110011,201706,1867,1427,440,1327487.87,409763.7,1737251.57
110012,201706,4027,2311,1716,2153209.7,1601535.1,3754744.8
110013,201706,734,540,194,502320.29,180474.7,682794.99
110014,201706,359,303,56,282870.23,52247.21,335117.44
110015,201706,1436,1149,287,1068582.04,266896.29,1335478.33
110018,201706,1113,657,456,611977.31,425294.81,1037272.12
110020,201706,14863,8734,6129,8082903.12,5690931.55,13773834.67
110025,201706,599,434,165,403118.07,153852.81,556970.88
110026,201706,43,30,13,27848.79,12060.56,39909.35
110028,201706,1593,1144,449,1060922.41,416138.66,1477061.07
110029,201706,133,115,18,107514.67,16846,124360.67
110030,201706,2440,1632,808,1514980.25,750961.62,2265941.87
110032,201706,383,292,91,271788.2,84981.9,356770.1
110033,201706,636,484,152,446503,141116.91,587619.91
110034,201706,359,261,98,240731.42,90568.89,331300.31
110037,201706,101,81,20,75836.78,18719.89,94556.67
110040,201706,320,213,107,198156.82,99497.46,297654.28
110045,201706,896,580,316,538990.77,293231.26,832222.03
110050,201706,95,75,20,69934.67,18679.89,88614.56
110060,201706,88,44,44,41027.89,40787.34,81815.23
110070,201706,128,75,53,69893.46,49058.57,118952.03
110080,201706,394,222,172,204223.54,159824.97,364048.51
110090,201706,29,24,5,22387.56,4644.78,27032.34
110092,201706,104,60,44,55959.01,40876.57,96835.58
110094,201706,198,137,61,127527.46,56635.79,184163.25
110100,201706,26,22,4,20493.78,3727.89,24221.67
110110,201706,70,42,28,39133.56,25734.56,64868.12
110120,201706,72,56,16,52211.56,14891.67,67103.23
110130,201706,298,245,53,226835.71,49360.34,276196.05
110140,201706,245,158,87,147176.36,81068.09,228244.45
110143,201706,43,37,6,34488.45,5561.67,40050.12
110145,201706,28,20,8,18659.89,7476,26135.89
110146,201706,23,12,11,11203.89,10266.89,21470.78
110147,201706,39,30,9,27487.89,8413,35900.89
110148,201706,37,25,12,23232.91,11224,34456.91
110149,201706,283,197,86,183423.94,80119.91,263543.85
110150,201706,81,51,30,47666.89,27829.34,75496.23
110155,201706,9,7,2,6519,1854,8373
110160,201706,71,59,12,54901.24,11163.67,66064.91
110170,201706,215,174,41,162077.45,38176.67,200254.12
110175,201706,27,21,6,19496.12,5601.89,25098.01
110180,201706,92,81,11,75816.78,10266.89,86083.67
120001,201706,130,88,42,81712,39346,121058
120005,201706,190,120,70,112397.12,65403,177800.12
120010,201706,979,640,339,593238.15,315217.4,908455.55
120013,201706,126,86,40,79951.01,36514.74,116465.75
120017,201706,75,50,25,46763.36,23404,70167.36
120020,201706,3429,2724,705,2524304.7,656599.7,3180904.4
120025,201706,610,340,270,316437.12,251073.46,567510.58
120030,201706,1021,849,172,788135.25,160419.12,948554.37
120032,201706,46,38,8,35584.12,7496,43080.12
120033,201706,212,186,26,173940.94,24362,198302.94
120034,201706,148,107,41,98363.12,38373.24,136736.36
120035,201706,25,17,8,15929,7496,23425
120038,201706,381,241,140,225006.2,131136.24,356142.44
120039,201706,19,18,1,16866,937,17803
120040,201706,13711,9490,4221,8765755.99,3913842.02,12679598.01
120042,201706,41,35,6,32795,5622,38417
120043,201706,14,3,11,2811,10286.89,13097.89
120045,201706,521,332,189,309526.05,176828.48,486354.53
120050,201706,1226,936,290,872346.62,270421.46,1142768.08
120060,201706,1352,1085,267,1000388.29,246248.1,1246636.39
120070,201706,505,362,143,333070.82,132563.07,465633.89
120080,201706,134,85,49,78490.61,45350.55,123841.16
130002,201706,149,103,46,96511,43102,139613
130006,201706,75,42,33,39354,30921,70275
130008,201706,140,74,66,68617.72,61119.96,129737.68
130010,201706,140,73,67,68401,62779,131180
130014,201706,235,171,64,160227,59968,220195
130020,201706,84,48,36,44976,33732,78708
130030,201706,858,535,323,501295,302641.63,803936.63
130040,201706,321,164,157,153668,146005.84,299673.84
130050,201706,548,311,237,291125.9,222069,513194.9
130060,201706,860,587,273,544870.42,252920.58,797791.00
130063,201706,537,286,251,267982,235165.12,503147.12
130068,201706,189,121,68,113377,63434.9,176811.9
130070,201706,1330,923,407,838947.22,371800.38,1210747.60
130080,201706,661,433,228,405346.2,213627,618973.2
130083,201706,68,36,32,33732,29984,63716
130090,201706,378,189,189,175443.88,177093,352536.88
130100,201706,1107,519,588,486303,550674.9,1036977.9
130110,201706,712,312,400,292194,374780,666974
130115,201706,174,72,102,67464,95574,163038
130120,201706,1604,1007,597,943559,559389,1502948
130130,201706,622,420,202,393540,189274,582814
130140,201706,1558,1171,387,1096596.95,361682.1,1458279.05
130150,201706,424,356,68,333572,63716,397288
130160,201706,472,258,214,241746,200518,442264
130165,201706,27,19,8,17803,7496,25299
130170,201706,958,669,289,621338.58,267878.26,889216.84
130180,201706,162,97,65,90420.5,60905,151325.5
130185,201706,2064,1111,953,1039112.89,892378.89,1931491.78
130190,201706,3577,2273,1304,2126053.4,1220068.09,3346121.49
130195,201706,293,235,58,220195,54346,274541
130200,201706,181,81,100,75887.63,93700,169587.63
130210,201706,75,36,39,33732,36543,70275
130220,201706,185,129,56,120873,52472,173345
130230,201706,334,211,123,197707,115251,312958
130240,201706,1469,918,551,858809.98,516001.22,1374811.20
130250,201706,4640,2975,1665,2783056.6,1559971.93,4343028.53
130255,201706,414,210,204,196770,190866.9,387636.9
130260,201706,51574,24555,27019,22975152.62,25307940.26,48283092.88
130270,201706,1444,930,514,870921.5,481577.78,1352499.28
130280,201706,105,65,40,60905,37480,98385
130290,201706,2071,1514,557,1418213.22,521627.9,1939841.12
130300,201706,424,304,120,284566.9,112440,397006.9
130310,201706,908,490,418,459130,391666,850796
130320,201706,442,235,207,219258,193959,413217
130330,201706,707,433,274,405721,256456.9,662177.9
130340,201706,3180,1959,1221,1832022.6,1142671.6,2974694.2
130350,201706,492,306,186,286599.57,174282,460881.57
130353,201706,744,300,444,280819,416028,696847
130356,201706,721,328,393,307316,367959.9,675275.9
130360,201706,71,41,30,38417,28110,66527
130370,201706,696,499,197,467563,184589,652152
130380,201706,651,438,213,410406,199581,609987
130390,201706,500,394,106,369178,99322,468500
130395,201706,172,42,130,39354,121810,161164
130400,201706,65,45,20,42165,18740,60905
130406,201706,2038,1309,729,1222988.15,682445.16,1905433.31
130410,201706,521,222,299,208014,280144.26,488158.26
130420,201706,3204,2548,656,2384665.35,614672,2999337.35
130423,201706,166,76,90,71212,84330,155542
130426,201706,140,82,58,76834,54346,131180
130430,201706,405,268,137,251116,128369,379485
130440,201706,201,73,128,68401,119936,188337
140002,201706,35,14,21,13118,19677,32795
140005,201706,191,116,75,108457.75,70275,178732.75
140010,201706,10252,6898,3354,6433377.06,3138647.82,9572024.88
140015,201706,152,69,83,64653,77771,142424
140017,201706,103,70,33,65590,30921,96511
140020,201706,485,328,157,306399,147109,453508
140023,201706,23,17,6,15433,5622,21055
140028,201706,15,10,5,9370,4685,14055
140030,201706,358,250,108,234250,100605.69,334855.69
140040,201706,51,36,15,33732,13961.3,47693.3
140045,201706,248,117,131,108973.1,122747,231720.1
140047,201706,532,350,182,325278.52,169784.5,495063.02
140050,201706,152,98,54,91028,50598,141626
140060,201706,33,24,9,21766.51,8433,30199.51
140070,201706,31,29,2,27173,1874,29047
150010,201706,4682,2884,1798,2699637.75,1682343.66,4381981.41
150013,201706,138,94,44,88078,41228,129306
150020,201706,1099,568,531,532216,497547,1029763
150030,201706,752,303,449,283911,420713,704624
150034,201706,186,111,75,104007,70275,174282
150040,201706,1346,804,542,753328,507854,1261182
150050,201706,707,421,286,393493.9,267782,661275.9
150060,201706,4624,2996,1628,2803561.88,1524911.28,4328473.16
150070,201706,309,136,173,127432,162101,289533
150080,201706,14266,7134,7132,6674519.42,6675400.66,13349920.08
150085,201706,345,213,132,199571.63,123684,323255.63
150090,201706,749,635,114,594995,106818,701813
150095,201706,342,209,133,195076.84,123815.18,318892.02
150100,201706,53,37,16,34669,14992,49661
150110,201706,171,83,88,77771,82456,160227
150120,201706,432,319,113,298903,105881,404784
150125,201706,49,20,29,18740,27173,45913
150130,201706,1869,984,885,922008,829240.32,1751248.32
150140,201706,54100,25213,28887,23592837.42,27053343.87,50646181.29
150145,201706,168,97,71,90889,66527,157416
150150,201706,2719,1147,1572,1074525.37,1469089.7,2543615.07
150157,201706,449,302,147,282974,137734.32,420708.32
150160,201706,110,85,25,79645,23425,103070
150170,201706,3672,2707,965,2533554.4,902986.9,3436541.3
150172,201706,293,202,91,189274,85267,274541
150175,201706,89,56,33,52472,30921,83393
150178,201706,742,493,249,461004,233313,694317
150180,201706,2913,1377,1536,1289452.8,1438932.86,2728385.66
150190,201706,336,212,124,198644,116188,314832
150195,201706,122,62,60,58094,56220,114314
150200,201706,209,94,115,88078,107755,195833
150210,201706,3103,2511,592,2351767.84,554465.75,2906233.59
150215,201706,491,330,161,308929,150857,459786
150220,201706,3999,2673,1326,2503139.35,1240588.36,3743727.71
150230,201706,1141,908,233,850226.7,218321,1068547.7
150240,201706,5602,3264,2338,3054799.47,2190693,5245492.47
150250,201706,31,14,17,13118,15929,29047
150260,201706,71,42,29,39354,27173,66527
150270,201706,2278,1498,780,1403064,730297.9,2133361.9
150275,201706,587,353,234,330761,219258,550019
150276,201706,100,40,60,37480,56220,93700
150277,201706,755,325,430,304506.63,402910,707416.63
150280,201706,340,204,136,191148,127432,318580
150285,201706,71,34,37,31858,34669,66527
150290,201706,958,575,383,538484.53,358590,897074.53
150293,201706,688,313,375,292390.94,351375,643765.94
150295,201706,454,197,257,184589,240677.82,425266.82
150300,201706,79,43,36,40291,33732,74023
150304,201706,137,89,48,83236.83,44976,128212.83
150307,201706,389,318,71,297966,66527,364493
150309,201706,510,363,147,340131,137739,477870
150310,201706,252,171,81,160227,75897,236124
150320,201706,1792,1235,557,1156918.59,521909,1678827.59
150330,201706,2057,1171,886,1096571.1,830182,1926753.1
150340,201706,194,126,68,117827.75,63716,181543.75
150345,201706,605,320,285,299661.97,267045,566706.97
150350,201706,426,332,94,308732.13,88078,396810.13
150360,201706,4357,2804,1553,2624662.74,1455151.63,4079814.37
150370,201706,719,512,207,478962,193668.9,672630.9
150375,201706,192,105,87,98385,81519,179904
150380,201706,1194,770,424,721490,396258,1117748
150390,201706,719,411,308,385107,288587,673694
150400,201706,95,77,18,72149,16866,89015
150405,201706,1243,821,422,768252.86,394851.8,1163104.66
150410,201706,145,92,53,86204,49661,135865
150420,201706,7062,3875,3187,3629225.44,2985027.49,6614252.93
150430,201706,464,314,150,294218,140550,434768
150440,201706,593,347,246,324390,230221,554611
150442,201706,2066,1133,933,1059850.07,874221,1934071.07
150445,201706,507,317,190,297029,177093,474122
150450,201706,271,126,145,118062,135865,253927
150460,201706,777,587,190,547943.66,178011.26,725954.92
150470,201706,1328,792,536,741823,502232,1244055
150475,201706,27,21,6,19677,5622,25299
150480,201706,1223,851,372,797387,348564,1145951
150490,201706,612,321,291,300777,272667,573444
150495,201706,317,214,103,200518,96511,297029
150497,201706,299,206,93,193022,87131.63,280153.63
150500,201706,431,290,141,271730,132117,403847
150503,201706,762,367,395,343598,370097,713695
150506,201706,1046,661,385,619357,360736,980093
150510,201706,1212,690,522,646249,489114,1135363
150520,201706,262,173,89,162101,83393,245494
150530,201706,1509,832,677,776211.55,634229,1410440.55
150540,201706,237,164,73,153668,68401,222069
150543,201706,666,372,294,348264.16,275196.9,623461.06
150548,201706,495,333,162,312021,151794,463815
150549,201706,57,38,19,35606,17803,53409
150550,201706,2866,1482,1384,1387932,1296246,2684178
150553,201706,2972,1772,1200,1659792.53,1124119,2783911.53
150555,201706,141,72,69,67464,64653,132117
150560,201706,52,39,13,36543,12181,48724
150563,201706,64,33,31,30921,29047,59968
150565,201706,160,92,68,86204,63716,149920
150570,201706,396,263,133,246412.26,124621,371033.26
150580,201706,1465,588,877,550300.1,821749,1372049.1
150590,201706,778,458,320,429146,299840,728986
150600,201706,437,268,169,251116,158353,409469
150610,201706,139,119,20,110670,18740,129410
150611,201706,131,89,42,83393,39354,122747
150613,201706,3097,1890,1207,1770926,1130941,2901867
150616,201706,474,295,179,276181,167723,443904
150618,201706,1113,605,508,566660.49,475996,1042656.49
150619,201706,399,303,96,283911,89952,373863
150620,201706,1276,729,547,683073,512257.9,1195330.9
150630,201706,311,207,104,193959,97448,291407
150635,201706,496,202,294,189274,275478,464752
150640,201706,63,30,33,28110,30921,59031
150650,201706,2281,1301,980,1218765.27,917041.9,2135807.17
150655,201706,255,188,67,176156,62779,238935
150658,201706,97,54,43,50598,40291,90889
150660,201706,480,331,149,310147,139613,449760
150670,201706,981,339,642,317352.9,601535.63,918888.53
150680,201706,9547,5255,4292,4919692.86,4018757.06,8938449.92
150690,201706,51,32,19,29984,17803,47787
150700,201706,557,360,197,337132.6,184589,521721.6
150710,201706,253,156,97,146172,90889,237061
150715,201706,866,521,345,487212.26,323236.89,810449.15
150720,201706,448,334,114,312958,106536.9,419494.9
150730,201706,861,454,407,425389,381077.9,806466.9
150740,201706,240,171,69,160227,64653,224880
150745,201706,777,395,382,370115,357934,728049
150746,201706,55,33,22,30921,20614,51535
150747,201706,271,211,60,197707,56220,253927
150750,201706,125,73,52,68401,48724,117125
150760,201706,1703,1101,602,1031355.9,564074,1595429.9
150770,201706,356,183,173,171471,161929.07,333400.07
150775,201706,81,38,43,35606,40291,75897
150780,201706,177,93,84,87141,78708,165849
150790,201706,900,476,424,446012,397288,843300
150795,201706,1396,803,593,752411,555641,1308052
150796,201706,407,232,175,217384,163975,381359
150797,201706,267,156,111,146172,104007,250179
150800,201706,1408,846,562,791760.31,526312.9,1318073.21
150803,201706,585,482,103,451634,96511,548145
150805,201706,186,117,69,109629,64639.63,174268.63
150808,201706,939,510,429,477870,401973,879843
150810,201706,3355,2304,1051,2153172.63,984487.26,3137659.89
150812,201706,425,221,204,207077,191148,398225
150815,201706,913,604,309,564594.04,289533,854127.04
150820,201706,1588,970,618,907953,579047.26,1487000.26
150830,201706,838,589,249,550956,233313,784269
150835,201706,173,101,72,94637,67464,162101
150840,201706,1262,808,454,756721.2,425398,1182119.2
160005,201706,48,29,19,27173,17803,44976
160010,201706,195,122,73,114314,68397,182711
160015,201706,113,65,48,60905,44976,105881
160020,201706,114,66,48,61842,44976,106818
160021,201706,40,21,19,19677,17803,37480
160023,201706,106,59,47,55283,44039,99322
160025,201706,34,15,19,14055,17803,31858
160027,201706,1419,795,624,741449.1,583951,1325400.1
160030,201706,15096,7682,7414,7188942.54,6941028.68,14129971.22
160040,201706,313,175,138,163975,129306,293281
160050,201706,619,318,301,297966,281755.9,579721.9
160053,201706,338,186,152,174001,142424,316425
160055,201706,18,13,5,12181,4685,16866
160060,201706,6259,3252,3007,3035119.09,2816618.1,5851737.19
160070,201706,157,95,62,89015,58094,147109
160080,201706,75,38,37,35606,34669,70275
170025,201706,24,16,8,14992,7496,22488
170030,201706,221,174,47,162844,44039,206883
170035,201706,230,107,123,99322,115251,214573
170040,201706,185,146,39,136520.9,36543,173063.9
170070,201706,335,188,147,176156,137739,313895
170100,201706,379,267,112,249945,104944,354889
170105,201706,63,51,12,47787,11244,59031
170110,201706,101,62,39,58094,36543,94637
170130,201706,70,31,39,29047,36262,65309
170190,201706,111,69,42,64653,39354,104007
170200,201706,401,268,133,250170.1,124518.78,374688.88
170210,201706,5918,3034,2884,2837228.99,2699104.33,5536333.32
170215,201706,67,31,36,29047,33732,62779
170220,201706,1446,1051,395,982425.76,369834,1352259.76
170230,201706,153,98,55,91826,51535,143361
170240,201706,577,377,200,353249,187400,540649
170255,201706,1114,885,229,829245,214291.9,1043536.9
170270,201706,38,27,11,25299,10025.9,35324.9
170290,201706,68,48,20,44976,18740,63716
170300,201706,79,50,29,46100.4,27173,73273.4
170305,201706,37,30,7,28110,6559,34669
170307,201706,59,42,17,39354,15929,55283
170310,201706,96,51,45,47787,42165,89952
170320,201706,17,13,4,12181,3748,15929
170330,201706,18,15,3,14055,2811,16866
170360,201706,23,15,8,14055,7496,21551
170370,201706,170,81,89,75897,83393,159290
170380,201706,81,55,26,51535,24362,75897
170382,201706,49,43,6,40291,5622,45913
170384,201706,122,86,36,80582,33732,114314
170386,201706,58,27,31,25299,29047,54346
170388,201706,47,17,30,15929,28110,44039
170389,201706,23,17,6,15929,5622,21551
170390,201706,49,29,20,27173,18740,45913
170410,201706,33,22,11,20614,10307,30921
170460,201706,17,12,5,11244,4685,15929
170510,201706,27,20,7,18740,6559,25299
170550,201706,1452,816,636,764571.89,595182.5,1359754.39
170555,201706,110,74,36,69338,33732,103070
170560,201706,100,70,30,65590,28110,93700
170600,201706,37,18,19,16866,17803,34669
170610,201706,194,104,90,97293.4,84312,181605.4
170625,201706,37,17,20,15929,18740,34669
170650,201706,84,62,22,58094,20614,78708
170700,201706,551,417,134,388808.15,124761.55,513569.70
170710,201706,155,96,59,89952,55274,145226
170720,201706,80,66,14,61842,13118,74960
170730,201706,55,32,23,29984,21551,51535
170740,201706,68,49,19,45913,17803,63716
170755,201706,115,54,61,49988.95,57157,107145.95
170765,201706,149,67,82,62170,76834,139004
170770,201706,228,128,100,118858.45,93700,212558.45
170820,201706,592,381,211,356997,197286,554283
170825,201706,31,19,12,17803,11244,29047
170830,201706,73,50,23,46662.6,21551,68213.6
170900,201706,205,155,50,145235,46850,192085
170930,201706,776,390,386,365112,361120,726232
170950,201706,2921,1260,1661,1178306.88,1554089.93,2732396.81
170980,201706,16,9,7,8433,6559,14992
171050,201706,125,96,29,89952,27173,117125
171070,201706,34,27,7,25299,6559,31858
171090,201706,36,25,11,23425,10307,33732
171110,201706,21,14,7,13118,6559,19677
171150,201706,36,18,18,16866,16866,33732
171180,201706,22,10,12,9370,11244,20614
171190,201706,122,69,53,64653,49661,114314
171195,201706,63,48,15,44976,14055,59031
171200,201706,46,20,26,18740,24362,43102
171215,201706,1,1,0,937,0,937
171240,201706,52,42,10,39354,9370,48724
171245,201706,50,45,5,42165,4685,46850
171250,201706,64,32,32,29984,29974.63,59958.63
171270,201706,16,12,4,11244,3748,14992
171280,201706,36,33,3,30781,2811,33592
171320,201706,977,550,427,515350,399162,914512
171330,201706,404,189,215,177093,201455,378548
171360,201706,82,61,21,57157,19677,76834
171370,201706,22,11,11,10307,10307,20614
171380,201706,126,102,24,95574,22262.19,117836.19
171395,201706,50,31,19,29047,17803,46850
171420,201706,319,210,109,196770,101851.9,298621.9
171430,201706,60,48,12,44336,11244,55580
171488,201706,207,108,99,101196,92763,193959
171500,201706,58,31,27,29047,25299,54346
171510,201706,63,42,21,39354,19677,59031
171515,201706,44,37,7,34669,6559,41228
171525,201706,30,26,4,24362,3748,28110
171550,201706,12,6,6,5622,5622,11244
171570,201706,57,28,29,26236,27173,53409
171575,201706,351,211,140,197567,131170.63,328737.63
171610,201706,1621,804,817,751482.83,763951.62,1515434.45
171620,201706,130,88,42,81912.54,39072.9,120985.44
171630,201706,55,28,27,26236,25299,51535
171650,201706,276,176,100,164912,93700,258612
171660,201706,257,137,120,128369,112440,240809
171665,201706,41,26,15,24362,14055,38417
171670,201706,434,251,183,233584.98,170908.8,404493.78
171700,201706,60,53,7,49661,6559,56220
171720,201706,24,9,15,8433,14055,22488
171750,201706,98,53,45,49661,42165,91826
171780,201706,68,56,12,52472,11244,63716
171790,201706,79,64,15,59968,14055,74023
171800,201706,33,25,8,23425,7496,30921
171820,201706,1911,1089,822,1019696.47,764752.21,1784448.68
171830,201706,37,29,8,27173,7496,34669
171840,201706,55,30,25,28110,23425,51535
171845,201706,32,20,12,18740,11244,29984
171850,201706,36,24,12,22488,11244,33732
171855,201706,70,55,15,51535,14055,65590
171865,201706,9,6,3,5622,2811,8433
171870,201706,31,22,9,20614,8433,29047
171875,201706,77,53,24,49661,22488,72149
171880,201706,27,20,7,18740,6559,25299
171884,201706,43,22,21,20614,19677,40291
171886,201706,111,40,71,37480,66245.9,103725.9
171888,201706,22,15,7,14055,6559,20614
171889,201706,22,15,7,14055,6559,20614
171890,201706,58,47,11,44039,10307,54346
171900,201706,42,29,13,27173,12181,39354
172000,201706,42,35,7,32795,6559,39354
172010,201706,38,31,7,28250.55,6559,34809.55
172015,201706,27,16,11,14992,10025.9,25017.9
172020,201706,123,75,48,70275,44976,115251
172025,201706,33,20,13,18740,12181,30921
172030,201706,33,20,13,18740,12181,30921
172049,201706,74,45,29,42165,27173,69338
172065,201706,151,99,52,92763,48724,141487
172080,201706,73,54,19,49437.02,17803,67240.02
172085,201706,23,10,13,9370,12181,21551
172090,201706,414,312,102,291408,94825,386233
172093,201706,27,18,9,16866,8433,25299
172097,201706,18,9,9,8433,8152,16585
172100,201706,4469,2470,1999,2308979.67,1870341.93,4179321.60
172110,201706,78,51,27,47787,25299,73086
172120,201706,1735,1485,250,1386078.01,233162.14,1619240.15
172125,201706,2,2,0,1874,0,1874
172130,201706,13,11,2,10307,1874,12181
172208,201706,187,119,68,111503,63716,175219
172210,201706,485,228,257,213636,240528,454164
210005,201706,2918,1808,1110,1690816.76,1037260,2728076.76
210010,201706,203,100,103,93700,96511,190211
210015,201706,23,15,8,14055,7496,21551
210020,201706,344,176,168,164912,157416,322328
210030,201706,348,215,133,201455,124612,326067
210040,201706,155,119,36,111503,33732,145235
210043,201706,259,170,89,159290,83393,242683
210047,201706,624,301,323,281662.2,302641.63,584303.83
210050,201706,302,218,84,204266,78708,282974
210055,201706,42,32,10,29984,9370,39354
210060,201706,579,440,139,412182.56,130243,542425.56
210070,201706,415,295,120,276415,112158.9,388573.9
210080,201706,99,91,8,85267,7496,92763
210083,201706,312,125,187,117125,175219,292344
210087,201706,50,32,18,29984,16866,46850
210090,201706,496,339,157,317643,147109,464752
210095,201706,506,354,152,331688.63,142424,474112.63
210100,201706,681,510,171,477542.05,159290.35,636832.40
210110,201706,155,82,73,76834,68401,145235
210120,201706,5564,4122,1442,3857369.2,1350184.14,5207553.34
210125,201706,222,115,107,107755,100259,208014
210130,201706,569,286,283,267045,265171,532216
210135,201706,34,20,14,18740,13118,31858
210140,201706,3983,3078,905,2880947.22,847814,3728761.22
210150,201706,350,220,130,206140,121637,327777
210160,201706,3302,2751,551,2574878.68,516006,3090884.68
210170,201706,1114,848,266,794576,249242,1043818
210173,201706,112,92,20,86204,18740,104944
210177,201706,505,235,270,220195,252990,473185
210180,201706,27,14,13,13118,12181,25299
210190,201706,401,254,147,237998,137739,375737
210193,201706,0,0,0,0,0,0
210197,201706,86,55,31,51535,29030,80565
210200,201706,638,499,139,467563,130243,597806
210203,201706,273,175,98,163975,91826,255801
210207,201706,375,285,90,267045,84330,351375
210210,201706,768,696,72,652152,67464,719616
210215,201706,78,65,13,60905,12181,73086
210220,201706,403,328,75,307336,70275,377611
210230,201706,305,219,86,205203,80582,285785
210232,201706,1524,933,591,873940,553767,1427707
210235,201706,154,119,35,111316,32795,144111
210237,201706,45,24,21,22488,19677,42165
210240,201706,95,77,18,72149,16866,89015
210250,201706,177,138,39,129306,36543,165849
210255,201706,303,218,85,204266,79645,283911
210260,201706,434,253,181,237061,169597,406658
210270,201706,710,440,270,412280,252990,665270
210275,201706,42,33,9,30921,8433,39354
210280,201706,1024,647,377,603167.38,351937.25,955104.63
210290,201706,489,301,188,282037,176156,458193
210300,201706,6228,3538,2690,3310279.91,2519341.37,5829621.28
210310,201706,102,69,33,64653,30921,95574
210312,201706,130,79,51,74023,47787,121810
210315,201706,118,84,34,78708,31858,110566
210317,201706,120,82,38,76834,35606,112440
210320,201706,2395,1947,448,1822378.88,418839,2241217.88
210325,201706,128,85,43,78708,40010,118718
210330,201706,5926,2859,3067,2675683.7,2873769.63,5549453.33
210340,201706,1444,1010,434,945584,406587.85,1352171.85
210350,201706,603,482,121,451399.75,113377,564776.75
210355,201706,127,100,27,93700,25299,118999
210360,201706,2731,1674,1057,1565447.36,990409,2555856.36
210370,201706,1272,521,751,488177,703031.1,1191208.1
210375,201706,192,96,96,89418,89952,179370
210380,201706,729,543,186,508791,174262,683053
210390,201706,194,160,34,149920,31858,181778
210400,201706,414,344,70,322328,65590,387918
210405,201706,973,636,337,595338.87,315769,911107.87
210407,201706,54,42,12,39354,11244,50598
210408,201706,67,60,7,56220,6559,62779
210409,201706,315,259,56,242683,52472,295155
210410,201706,435,332,103,311084,96502,407586
210420,201706,190,155,35,145235,32795,178030
210430,201706,33,25,8,23425,7496,30921
210440,201706,389,225,164,210825,152731,363556
210450,201706,147,109,38,102133,35606,137739
210455,201706,207,111,96,104007,89952,193959
210460,201706,341,214,127,200518,118999,319517
210462,201706,55,46,9,43102,8433,51535
210465,201706,187,130,57,121810,53409,175219
210467,201706,513,366,147,342942,137739,480681
210470,201706,40,29,11,27173,10307,37480
210480,201706,1276,886,390,830182,365430,1195612
210490,201706,219,128,91,119936,85267,205203
210500,201706,547,286,261,267982,244557,512539
210510,201706,548,416,132,389792,123684,513476
210515,201706,452,234,218,219258,204266,423524
210520,201706,402,348,54,325794.9,50598,376392.9
210530,201706,9248,4946,4302,4620585.65,4026041.1,8646626.75
210535,201706,138,97,41,90889,38417,129306
210540,201706,1550,906,644,847798.4,602022.5,1449820.9
210542,201706,1139,589,550,551518.2,515350,1066868.2
210545,201706,12,11,1,10307,937,11244
210547,201706,133,114,19,106818,17803,124621
210550,201706,749,509,240,475861.9,224880,700741.9
210560,201706,176,144,32,134928,29984,164912
210565,201706,28,20,8,18740,7496,26236
210570,201706,1389,1073,316,1005401,296082.63,1301483.63
210580,201706,107,92,15,86204,14055,100259
210590,201706,776,595,181,556765.4,169597,726362.4
210592,201706,34,30,4,28110,3748,31858
210594,201706,98,82,16,76834,14992,91826
210596,201706,77,66,11,61842,10307,72149
210598,201706,122,87,35,81519,32795,114314
210600,201706,357,298,59,279226,55283,334509
210610,201706,241,224,17,208951,15929,224880
210620,201706,49,29,20,27173,18740,45913
210630,201706,59,55,4,51535,3748,55283
210632,201706,1145,725,420,679325,392790.4,1072115.4
210635,201706,14,12,2,11244,1874,13118
210637,201706,106,75,31,70275,29047,99322
210640,201706,592,510,82,477870,76834,554704
210650,201706,399,320,79,299652.6,73086,372738.6
210660,201706,401,284,117,266108,109629,375737
210663,201706,17,11,6,10307,5622,15929
210667,201706,118,36,82,33732,76834,110566
210670,201706,266,235,31,219493,29047,248540
210675,201706,575,288,287,269856,268919,538775
210680,201706,227,136,91,127432,85267,212699
210690,201706,645,499,146,467563,136802,604365
210700,201706,190,138,52,129306,48724,178030
210710,201706,311,171,140,160227,131180,291407
210720,201706,121,100,21,93700,19677,113377
210725,201706,64,57,7,53409,6559,59968
210730,201706,23,17,6,15929,5622,21551
210735,201706,407,266,141,249242,131836,381078
210740,201706,540,455,85,426335,79645,505980
210745,201706,149,102,47,95574,44039,139613
210750,201706,2434,1055,1379,986328.12,1292104.26,2278432.38
210760,201706,286,200,86,187400,80567.95,267967.95
210770,201706,402,310,92,289533,85922.9,375455.9
210780,201706,422,301,121,282037,113377,395414
210790,201706,184,141,43,132117,40291,172408
210800,201706,130,97,33,90889,30921,121810
210805,201706,37,34,3,31858,2811,34669
210810,201706,490,364,126,340412.1,118062,458474.1
210820,201706,2323,1798,525,1676473.39,491925,2168398.39
210825,201706,176,88,88,82456,82456,164912
210830,201706,819,480,339,448823,316706,765529
210840,201706,218,141,77,132117,72149,204266
210845,201706,256,151,105,141487,98385,239872
210850,201706,887,557,330,521596.7,309210,830806.7
210860,201706,4204,2075,2129,1943338,1994852.89,3938190.89
210870,201706,475,348,127,326076,118999,445075
210880,201706,56,37,19,34669,17803,52472
210890,201706,341,277,64,259549,59968,319517
210900,201706,529,329,200,307543.07,187400,494943.07
210905,201706,77,34,43,31858,40291,72149
210910,201706,2001,1457,544,1364334.88,509728,1874062.88
210920,201706,253,69,184,64653,172408,237061
210923,201706,78,57,21,53409,19677,73086
210927,201706,446,169,277,158353,259549,417902
210930,201706,58,45,13,42165,12181,54346
210940,201706,97,69,28,64653,26236,90889
210945,201706,203,88,115,82456,107755,190211
210950,201706,503,359,144,336383,134923.32,471306.32
210955,201706,75,51,24,47787,22488,70275
210960,201706,2477,987,1490,923226.7,1395849,2319075.7
210970,201706,109,92,17,86204,15929,102133
210975,201706,83,74,9,69338,8433,77771
210980,201706,1286,537,749,503056.56,701532,1204588.56
210990,201706,4466,2699,1767,2528682,1655659,4184341
211000,201706,1392,1069,323,1001352,302369.9,1303721.9
211003,201706,924,620,304,580940,284839,865779
211010,201706,475,414,61,387918,57157,445075
211020,201706,1628,558,1070,522846,1002374.49,1525220.49
211023,201706,22,19,3,17521.9,2811,20332.9
211027,201706,59,39,20,36543,18740,55283
211030,201706,387,249,138,233313,129306,362619
211040,201706,313,231,82,216166,76834,293000
211050,201706,1192,726,466,680262,436356.32,1116618.32
211060,201706,685,580,105,543460,98385,641845
211065,201706,24,20,4,18740,3748,22488
211070,201706,915,735,180,686869.97,168660,855529.97
211080,201706,88,84,4,78708,3748,82456
211085,201706,60,31,29,28766,27173,55939
211090,201706,98,80,18,74960,16866,91826
211100,201706,500,399,101,373863,94637,468500
211102,201706,275,175,100,163975,93700,257675
211105,201706,206,139,67,130243,62779,193022
211107,201706,123,70,53,65590,49661,115251
211110,201706,806,519,287,485741,268910,754651
211120,201706,5814,2285,3529,2136810.77,3305601.32,5442412.09
211125,201706,35,29,6,27173,5622,32795
211130,201706,46546,18649,27897,17442232.55,26126204.27,43568436.82
211140,201706,449,374,75,350434,70275,420709
211150,201706,1247,761,486,713057,455097,1168154
211153,201706,179,99,80,92763,74960,167723
211157,201706,56,41,15,38417,14055,52472
211160,201706,685,558,127,521897.25,118999,640896.25
211163,201706,0,0,0,0,0,0
211167,201706,5,3,2,2811,1874,4685
211170,201706,452,308,144,288596,134928,423524
211172,201706,119,78,41,73086,38417,111503
211174,201706,292,168,124,157416,116188,273604
211176,201706,525,365,160,342005,149920,491925
211178,201706,92,59,33,55283,30921,86204
211180,201706,210,163,47,152731,43879.71,196610.71
211190,201706,62,57,5,53409,4685,58094
211195,201706,18,10,8,9370,7496,16866
211200,201706,156,136,20,127094.68,18740,145834.68
211210,201706,642,310,332,289814.1,311084,600898.1
211220,201706,3912,2178,1734,2035633.71,1617366.22,3652999.93
211223,201706,96,90,6,84151.97,5622,89773.97
211227,201706,66,45,21,42165,19677,61842
211230,201706,788,633,155,592980.45,145216.26,738196.71
211240,201706,422,307,115,287659,107755,395414
211245,201706,208,84,124,78708,116188,194896
211250,201706,1649,1390,259,1301584,242683,1544267
211260,201706,799,623,176,583751,164912,748663
211270,201706,2125,1637,488,1533869,456319.1,1990188.1
211280,201706,1835,1073,762,1003528.08,713994,1717522.08
211285,201706,219,121,98,113377,91544.9,204921.9
211290,201706,696,459,237,429895.6,222069,651964.6
211300,201706,822,618,204,578811.7,191148,769959.7
211400,201706,1652,897,755,840489,707435,1547924
220005,201706,19,18,1,16866,937,17803
220010,201706,89,67,22,62779,20332.9,83111.9
220020,201706,536,419,117,392009.6,109629,501638.6
220025,201706,107,103,4,96511,3748,100259
220027,201706,42,34,8,31858,7496,39354
220030,201706,86,71,15,66527,14055,80582
220040,201706,1087,808,279,756159,261423,1017582
220045,201706,37,28,9,26236,8433,34669
220050,201706,631,509,122,475791.88,114295.26,590087.14
220060,201706,174,145,29,135865,27173,163038
220070,201706,135,123,12,115251,11244,126495
220080,201706,9,8,1,7496,937,8433
220090,201706,33,26,7,24081,6559,30640
220095,201706,3,2,1,1874,937,2811
220100,201706,28,24,4,22488,3748,26236
220105,201706,40,37,3,34669,2811,37480
220110,201706,201,185,16,173063.9,14992,188055.9
220115,201706,41,38,3,35606,2811,38417
220117,201706,19,19,0,17803,0,17803
220120,201706,1512,1023,489,958683.11,458174.26,1416857.37
220130,201706,24,23,1,21551,937,22488
220140,201706,104,85,19,78708,17803,96511
220150,201706,443,310,133,290470,124621,415091
220155,201706,4,4,0,3748,0,3748
220157,201706,19,15,4,14055,3748,17803
220160,201706,70,62,8,58094,7496,65590
220170,201706,36,33,3,30921,2811,33732
220173,201706,8,8,0,7496,0,7496
220177,201706,5,5,0,4685,0,4685
220180,201706,68,67,1,62770.32,937,63707.32
220190,201706,1034,931,103,872347,95761.4,968108.4
220191,201706,44,39,5,36543,4685,41228
220192,201706,68,65,3,60905,2811,63716
220194,201706,23,19,4,17803,3748,21551
220196,201706,103,86,17,80442,15929,96371
220198,201706,6,4,2,3748,1874,5622
220200,201706,427,341,86,320238,80582,400820
220202,201706,36,32,4,29984,3748,33732
220205,201706,38,32,6,29984,5622,35606
220207,201706,19,18,1,16866,937,17803
220208,201706,81,41,40,38417,37480,75897
220209,201706,32,29,3,27173,2811,29984
220210,201706,17,16,1,14992,937,15929
220211,201706,45,44,1,41228,937,42165
220213,201706,42,37,5,34669,4685,39354
220217,201706,38,30,8,28110,7496,35606
220220,201706,1958,1249,709,1166772.04,663096.76,1829868.80
220225,201706,13,6,7,5622,6559,12181
220230,201706,910,726,184,679821.61,171780.21,851601.82
220240,201706,140,127,13,118999,12181,131180
220245,201706,54,50,4,46472,3748,50220
220250,201706,136,120,16,112440,14992,127432
220253,201706,41,33,8,30921,7496,38417
220255,201706,28,24,4,22488,3748,26236
220260,201706,690,506,184,474122,172408,646530
220265,201706,13,9,4,8433,3748,12181
220270,201706,630,558,72,522133.88,66995.5,589129.38
220271,201706,44,35,9,32795,8433,41228
220272,201706,30,28,2,26236,1874,28110
220273,201706,17,14,3,13118,2811,15929
220275,201706,48,37,11,34669,10307,44976
220277,201706,10,8,2,7496,1874,9370
220280,201706,21,19,2,17803,1874,19677
220285,201706,54,50,4,46850,3748,50598
220290,201706,1382,1176,206,1099430,192976,1292406
220300,201706,60,58,2,54346,1874,56220
220310,201706,302,253,49,236919.27,45904,282823.27
220320,201706,439,404,35,377143.5,32795,409938.5
220323,201706,0,0,0,0,0,0
220325,201706,13,8,5,7496,4685,12181
220327,201706,12,11,1,10307,937,11244
220330,201706,188,125,63,116843.9,59031,175874.9
220335,201706,139,123,16,115232.26,14992,130224.26
220340,201706,21,11,10,10307,9370,19677
220342,201706,51,44,7,41228,6559,47787
220345,201706,121,107,14,100259,13118,113377
220350,201706,434,383,51,356295.01,47787,404082.01
220360,201706,41,32,9,29984,8433,38417
220370,201706,1044,831,213,777710,199581,977291
220375,201706,26,25,1,23425,937,24362
220380,201706,35,27,8,25299,7496,32795
220385,201706,28,24,4,22488,3748,26236
220390,201706,2182,1245,937,1161955.2,875674.41,2037629.61
220400,201706,28,27,1,25299,937,26236
220410,201706,17,14,3,13118,2811,15929
220415,201706,13,12,1,11244,937,12181
220420,201706,129,107,22,100259,20332.9,120591.9
220430,201706,129,116,13,107053.4,12181,119234.4
220435,201706,26,19,7,17799,6559,24358
220440,201706,290,247,43,231439,40291,271730
220450,201706,304,160,144,148775.74,134928,283703.74
220455,201706,61,59,2,55283,1874,57157
220460,201706,22,21,1,19021.1,937,19958.1
220465,201706,103,67,36,62779,33732,96511
220470,201706,236,205,31,191148.8,29047,220195.8
220480,201706,72,60,12,56220,11244,67464
220490,201706,82,71,11,65770,10307,76077
220500,201706,96,83,13,77771,12181,89952
220510,201706,373,297,76,277540,71024.6,348564.6
220515,201706,19,15,4,14055,3748,17803
220520,201706,361,322,39,300031,36525,336556
220525,201706,26,18,8,16866,7496,24362
220527,201706,37,31,6,29047,5622,34669
220530,201706,35,13,22,12181,20614,32795
220535,201706,15,14,1,13118,937,14055
220540,201706,58,46,12,43102,11244,54346
220545,201706,64,41,23,38417,21551,59968
220550,201706,615,467,148,437579,138676,576255
220551,201706,26,19,7,17803,6559,24362
220552,201706,8,8,0,7496,0,7496
220553,201706,62,56,6,52472,5622,58094
220554,201706,15,9,6,8151.9,5622,13773.9
220555,201706,22,18,4,16866,3748,20614
220556,201706,61,57,4,53409,3748,57157
220557,201706,58,50,8,46850,7496,54346
220558,201706,7,2,5,1874,4685,6559
220559,201706,6,5,1,4685,937,5622
220560,201706,55,36,19,33544.6,17803,51347.6
220570,201706,754,445,309,416719.14,289533,706252.14
220580,201706,596,538,58,504106,53391.26,557497.26
220585,201706,6,5,1,4685,937,5622
220590,201706,13,13,0,12181,0,12181
220595,201706,62,47,15,43758,14055,57813
220600,201706,20,10,10,9370,9370,18740
220605,201706,21,20,1,18740,937,19677
220610,201706,57,49,8,45913,7496,53409
220620,201706,548,421,127,394242.75,118999,513241.75
220630,201706,9,7,2,6559,1874,8433
220635,201706,35,32,3,29984,2811,32795
220640,201706,97,72,25,67464,23425,90889
220650,201706,116,109,7,102133,6559,108692
220660,201706,24,18,6,16866,5622,22488
220665,201706,5,4,1,3748,937,4685
220667,201706,11,11,0,10307,0,10307
220669,201706,20,17,3,15929,2811,18740
220670,201706,63,49,14,45725.6,13118,58843.6
220672,201706,46,31,15,29047,13773.9,42820.9
220675,201706,33,25,8,23425,7496,30921
220680,201706,34,29,5,27173,4685,31858
220690,201706,51,47,4,44039,3748,47787
220695,201706,66,31,35,29047,32795,61842
220700,201706,1446,1102,344,1030531.59,322047,1352578.59
220710,201706,4,2,2,1874,1874,3748
220720,201706,123,99,24,92528.75,22347.45,114876.20
220730,201706,20,20,0,18740,0,18740
220735,201706,3,1,2,937,1874,2811
220740,201706,39,37,2,34669,1874,36543
220750,201706,99,80,19,74960,17803,92763
220755,201706,14,14,0,13118,0,13118
220760,201706,46,43,3,40291,2811,43102
220770,201706,5587,2758,2829,2578753.52,2645026.18,5223779.70
220775,201706,26,12,14,11244,13118,24362
220777,201706,13,13,0,12181,0,12181
220779,201706,15,12,3,11244,2811,14055
220780,201706,847,720,127,673984.1,118718,792702.1
220785,201706,6,4,2,3748,1874,5622
220790,201706,989,780,209,728519.34,195833,924352.34
220793,201706,14,14,0,13118,0,13118
220795,201706,25,24,1,22488,937,23425
220800,201706,3768,2859,909,2677562.88,850782.74,3528345.62
220810,201706,50,46,4,43102,3748,46850
220820,201706,237,216,21,202392,19677,222069
220830,201706,1105,929,176,870468.32,164912,1035380.32
220840,201706,2371,1560,811,1449819.61,757565,2207384.61
220850,201706,51,39,12,36543,11244,47787
220855,201706,15,10,5,9370,4685,14055
220860,201706,13,12,1,11244,937,12181
220865,201706,19,17,2,15929,1874,17803
220870,201706,58,54,4,50598,3748,54346
220880,201706,335,252,83,235468.1,77490,312958.1
220885,201706,45,40,5,37480,4685,42165
220887,201706,21,20,1,18740,937,19677
220890,201706,104,91,13,85267,12181,97448
220900,201706,46,27,19,25299,17803,43102
220910,201706,54,45,9,42165,8433,50598
220915,201706,18,17,1,15929,937,16866
220920,201706,34,31,3,29047,2811,31858
220930,201706,42,41,1,37617.73,937,38554.73
220935,201706,20,19,1,17803,937,18740
220937,201706,43,41,2,38417,1874,40291
220940,201706,48,43,5,40291,4685,44976
220945,201706,0,0,0,0,0,0
220950,201706,47,43,4,40291,3748,44039
220955,201706,41,38,3,35606,2811,38417
220960,201706,4,4,0,3748,0,3748
220965,201706,25,21,4,19677,3748,23425
220970,201706,45,37,8,34669,7496,42165
220975,201706,9,8,1,7496,937,8433
220980,201706,40,36,4,33732,3748,37480
220985,201706,60,55,5,51535,4685,56220
220987,201706,32,30,2,28110,1874,29984
220990,201706,12,11,1,10307,937,11244
220995,201706,38,33,5,30921,4685,35606
220997,201706,30,24,6,22488,5622,28110
221000,201706,1061,950,111,887576.81,103725.9,991302.71
221005,201706,63,58,5,54346,4685,59031
221010,201706,16,13,3,12181,2811,14992
221020,201706,49,48,1,44976,937,45913
221030,201706,36,29,7,27173,6559,33732
221035,201706,18,17,1,15929,937,16866
221037,201706,9,5,4,4685,3748,8433
221038,201706,10,9,1,8433,937,9370
221039,201706,23,23,0,21551,0,21551
221040,201706,247,213,34,199581,31858,231439
221050,201706,227,189,38,177093,35606,212699
221060,201706,1436,1249,187,1169516.55,175219,1344735.55
221062,201706,32,31,1,29047,937,29984
221063,201706,15,12,3,11244,2811,14055
221065,201706,39,34,5,31858,4685,36543
221070,201706,152,131,21,122747,19677,142424
221080,201706,372,326,46,305462,42820.9,348282.9
221090,201706,40,39,1,36291,937,37228
221093,201706,73,51,22,47787,20614,68401
221095,201706,11,10,1,9370,937,10307
221097,201706,27,24,3,22488,2811,25299
221100,201706,23871,13608,10263,12727429.66,9612764.79,22340194.45
221110,201706,990,725,265,679024,248305,927329
221120,201706,498,367,131,343598,122747,466345
221130,201706,903,736,167,688105.69,155824,843929.69
221135,201706,32,29,3,27173,2811,29984
221140,201706,41,31,10,29047,9370,38417
221150,201706,15,11,4,10307,3748,14055
221160,201706,11,11,0,10307,0,10307
221170,201706,11,11,0,10307,0,10307
230010,201706,156,143,13,133991,12181,146172
230015,201706,110,93,17,87141,15929,103070
230020,201706,1463,1261,202,1178841,188597.08,1367438.08
230030,201706,1558,1110,448,1034600.62,419776,1454376.62
230040,201706,197,174,23,162101,21551,183652
230050,201706,192,141,51,132117,47787,179904
230060,201706,136,109,27,101383.4,25299,126682.4
230070,201706,275,242,33,226754,30921,257675
230075,201706,788,687,101,641284.5,94355.9,735640.4
230080,201706,173,153,20,143361,18740,162101
230090,201706,88,61,27,55658.4,25299,80957.4
230100,201706,1838,1098,740,1026562,693099,1719661
230110,201706,2582,1628,954,1522138.6,893335.9,2415474.5
230120,201706,897,710,187,662927.91,175201,838128.91
230125,201706,131,106,25,99322,23425,122747
230130,201706,438,392,46,367304,43102,410406
230140,201706,209,182,27,170534,25299,195833
230150,201706,151,117,34,109629,31858,141487
230160,201706,909,797,112,746086.5,104944,851030.5
230170,201706,561,516,45,479747.1,42165,521912.1
230180,201706,78,73,5,68401,4685,73086
230185,201706,385,331,54,308806.16,50598,359404.16
230190,201706,2147,1727,420,1614573.72,393228,2007801.72
230195,201706,477,416,61,389792,57157,446949
230200,201706,361,315,46,294208.63,42437,336645.63
230205,201706,336,210,126,195031.86,118062,313093.86
230210,201706,1225,976,249,913586.18,232563.4,1146149.58
230220,201706,1324,924,400,865788,374800,1240588
230230,201706,892,788,104,736170.65,97448,833618.65
230240,201706,1589,1367,222,1279225.85,208014,1487239.85
230250,201706,1698,1388,310,1297227.47,289908,1587135.47
230260,201706,2831,1674,1157,1563719.79,1083172.75,2646892.54
230270,201706,1310,1057,253,988554.33,234016.95,1222571.28
230280,201706,2632,1957,675,1828370.97,631538,2459908.97
230290,201706,388,351,37,322716.92,34669,357385.92
230300,201706,498,366,132,341705.16,123684,465389.16
230310,201706,401,303,98,283911,91826,375737
230320,201706,865,739,126,689374.17,118053,807427.17
230330,201706,289,233,56,217571.4,52472,270043.4
230340,201706,450,359,91,334697.4,85267,419964.4
230350,201706,2871,1800,1071,1686561.26,1000717.24,2687278.50
230360,201706,241,212,29,197750,27173,224923
230365,201706,169,135,34,125793,31858,157651
230370,201706,9289,4464,4825,4174019.69,4516290.05,8690309.74
230380,201706,447,383,64,358590,59031.8,417621.8
230390,201706,493,269,224,250282.07,209888,460170.07
230393,201706,269,225,44,209985.4,41228,251213.4
230395,201706,322,263,59,246188,55283,301471
230400,201706,596,476,120,443763.9,111952.76,555716.66
230410,201706,2491,1544,947,1442840.55,886152.23,2328992.78
230420,201706,5620,3629,1991,3380809.74,1861063.22,5241872.96
230423,201706,298,256,42,237998.8,39354,277352.8
230425,201706,324,270,54,252990,50598,303588
230426,201706,104,93,11,86428.88,10025.9,96454.78
230427,201706,77,74,3,69338,2811,72149
230428,201706,1307,671,636,628502.12,595932,1224434.12
230430,201706,435,343,92,321200,85440.34,406640.34
230435,201706,739,511,228,477767,212418.17,690185.17
230440,201706,80615,35321,45294,33022285.85,42401080.67,75423366.52
230445,201706,257,180,77,168334.69,71867.9,240202.59
230450,201706,541,437,104,409469,97448,506917
230460,201706,51,42,9,39354,8433,47787
230465,201706,286,231,55,216447,51535,267982
230470,201706,1797,1389,408,1301493,381208.59,1682701.59
230480,201706,141,137,4,128087.9,3748,131835.9
230490,201706,274,221,53,207077,49661,256738
230495,201706,408,304,104,284011,97448,381459
230500,201706,921,689,232,643719,217375,861094
230510,201706,40,33,7,30921,6559,37480
230520,201706,385,304,81,284848,75897,360745
230523,201706,1794,1159,635,1083672.63,594555,1678227.63
230526,201706,287,240,47,224880,44039,268919
230530,201706,658,497,161,462730.38,149920.6,612650.98
230533,201706,170,165,5,154605,4685,159290
230535,201706,334,247,87,231439,81519,312958
230540,201706,1821,1588,233,1485357.7,218040,1703397.7
230550,201706,3553,2252,1301,2102996.43,1218193.7,3321190.13
230560,201706,578,441,137,411156.4,127151,538307.4
230565,201706,181,131,50,122747,46850,169597
230570,201706,304,270,34,252990,31858,284848
230580,201706,1076,797,279,745355.39,260204.9,1005560.29
230590,201706,902,702,200,653605.15,186931.9,840537.05
230600,201706,238,220,18,204472.32,16866,221338.32
230610,201706,324,259,65,242496,60905,303401
230620,201706,159,130,29,120873,27173,148046
230625,201706,704,509,195,475575.25,181582.04,657157.29
230630,201706,1203,944,259,884528,242308.2,1126836.2
230640,201706,3334,2902,432,2712069.56,404784,3116853.56
230650,201706,384,339,45,316826.49,41509.1,358335.59
230655,201706,601,523,78,489114.4,73048.95,562163.35
230660,201706,317,264,53,247368,49379.9,296747.9
230670,201706,417,376,41,352312,38417,390729
230680,201706,201,186,15,174282,14055,188337
230690,201706,822,720,102,674640,95574,770214
230700,201706,696,594,102,556578,95011.8,651589.8
230710,201706,710,668,42,625729,39354,665083
230720,201706,136,113,23,104778.46,21551,126329.46
230725,201706,214,169,45,158353,42156,200509
230730,201706,11201,6067,5134,5667951.49,4801486.62,10469438.11
230740,201706,640,505,135,472904,125816.63,598720.63
230750,201706,778,659,119,616312.15,111503,727815.15
230760,201706,1195,1035,160,965821.59,149920,1115741.59
230763,201706,331,273,58,253880.41,54346,308226.41
230765,201706,6485,3001,3484,2805452.05,3262260.1,6067712.15
230770,201706,4812,2467,2345,2301628.94,2194323.14,4495952.08
230780,201706,667,587,80,547234.57,74960,622194.57
230790,201706,182,147,35,137739,32008.66,169747.66
230800,201706,1075,784,291,734603.32,272667,1007270.32
230810,201706,1237,1096,141,1025687.05,131910.57,1157597.62
230820,201706,308,221,87,206141,81519,287660
230830,201706,925,804,121,750834.02,113377,864211.02
230835,201706,269,233,36,217384,33030,250414
230837,201706,162,134,28,125558,26236,151794
230840,201706,850,681,169,636879.5,157135,794014.5
230850,201706,1427,1254,173,1174716.9,161820,1336536.9
230860,201706,310,225,85,210825,78708.25,289533.25
230870,201706,1732,1468,264,1374298,246056.4,1620354.4
230880,201706,14,8,6,7496,5622,13118
230890,201706,562,519,43,486182.98,40291,526473.98
230900,201706,258,197,61,184589,56964,241553
230910,201706,188,152,36,141674.4,33732,175406.4
230920,201706,388,309,79,289533,74023,363556
230930,201706,893,639,254,595932.92,237998,833930.92
230940,201706,821,658,163,616264.9,152544,768808.9
230945,201706,440,371,69,347440,64653,412093
230950,201706,360,310,50,290470,46850,337320
230960,201706,2326,1552,774,1447624.51,724957,2172581.51
230970,201706,1618,913,705,854585.45,659722.96,1514308.41
230980,201706,199,166,33,155542,30921,186463
230990,201706,139,113,26,105881,23618.95,129499.95
231000,201706,193,177,16,163975.74,14992,178967.74
231010,201706,131,104,27,97448,25299,122747
231020,201706,1196,840,356,785487.5,333552,1119039.5
231025,201706,892,667,225,622571.6,209307.9,831879.5
231030,201706,1137,951,186,891063,174001,1065064
231040,201706,133,92,41,85473.14,37699,123172.14
231050,201706,1001,888,113,830183.5,105881,936064.5
231060,201706,132,116,16,108692,14992,123684
231070,201706,1354,960,394,896991.05,369178,1266169.05
231080,201706,254,236,18,220335.55,16866,237201.55
231085,201706,497,314,183,293282,171471,464753
231090,201706,224,189,35,177093,32795,209888
231095,201706,159,125,34,117125,31858,148983
231100,201706,116,94,22,88078,19395.9,107473.9
231110,201706,324,280,44,260865.39,41228,302093.39
231120,201706,299,257,42,239858.88,39167,279025.88
231123,201706,134,126,8,118062,7496,125558
231126,201706,270,231,39,216447,36543,252990
231130,201706,4432,3457,975,3230698.34,912975.42,4143673.76
231135,201706,189,164,25,153668,22183.2,175851.2
231140,201706,2998,2206,792,2063456.79,740293.24,2803750.03
231150,201706,338,322,16,301714,14992,316706
231160,201706,1182,934,248,872160.35,232151.12,1104311.47
231170,201706,532,344,188,322328,176156,498484
231180,201706,1486,1249,237,1169423.4,222069,1391492.4
231190,201706,213,190,23,178030,21551,199581
231195,201706,206,178,28,166074.91,26236,192310.91
231200,201706,811,663,148,621231,137438,758669
231210,201706,588,490,98,459130,91826,550956
231220,201706,985,714,271,668063.26,253927,921990.26
231230,201706,1325,1070,255,1001223.3,237904.3,1239127.6
231240,201706,1265,917,348,858042.13,324858.1,1182900.23
231250,201706,106,99,7,92763,6559,99322
231260,201706,297,189,108,177093,100915,278008
231270,201706,973,813,160,757441.49,149911,907352.49
231280,201706,48,38,10,35606,9370,44976
231290,201706,7022,3861,3161,3608950.71,2959273.05,6568223.76
231300,201706,607,560,47,524720,44039,568759
231310,201706,680,635,45,593519,42160.32,635679.32
231320,201706,534,415,119,388388,111503,499891
231325,201706,84,73,11,68401,10307,78708
231330,201706,1976,1536,440,1433755.19,409377.3,1843132.49
231335,201706,246,214,32,200518,29984,230502
231340,201706,1526,1124,402,1052064.24,376674,1428738.24
231350,201706,1094,898,196,841426,182808.9,1024234.9
231355,201706,376,327,49,306399,45913,352312
231360,201706,446,359,87,333440,81519,414959
231370,201706,86,69,17,64653,15929,80582
231375,201706,266,196,70,183652,65590,249242
231380,201706,412,338,74,315139.36,69150.6,384289.96
231390,201706,189,154,35,144298,32795,177093
231395,201706,715,437,278,408194.68,260486,668680.68
231400,201706,1020,844,176,788301.55,164574.9,952876.45
231410,201706,1264,1011,253,941827.8,236124.3,1177952.1
240010,201706,387,184,203,170995.54,190016,361011.54
240020,201706,2098,1602,496,1499628.07,464752,1964380.07
240030,201706,171,140,31,131180,29047,160227
240040,201706,33,33,0,30921,0,30921
240050,201706,487,415,72,387267.06,67464,454731.06
240060,201706,68,63,5,59031,4685,63716
240070,201706,157,117,40,109629,37480,147109
240080,201706,386,246,140,230498,131180,361678
240090,201706,106,94,12,87779,11244,99023
240100,201706,1397,1317,80,1231109.18,74752.49,1305861.67
240110,201706,942,587,355,548361.28,332635,880996.28
240120,201706,138,116,22,108692,20614,129306
240130,201706,283,265,18,247601.31,16866,264467.31
240140,201706,84,64,20,59968,18740,78708
240145,201706,646,566,80,529826.65,74753.86,604580.51
240150,201706,19,16,3,14992,2796.95,17788.95
240160,201706,49,40,9,37480,8433,45913
240165,201706,33,30,3,27876,2811,30687
240170,201706,87,69,18,64653,16866,81519
240180,201706,71,57,14,53409,13118,66527
240185,201706,40,37,3,34659.63,2811,37470.63
240190,201706,19,17,2,15929,1874,17803
240200,201706,2914,1627,1287,1519025.3,1204702,2723727.3
240210,201706,158,122,36,114314,33732,148046
240220,201706,1110,791,319,741167,298893.63,1040060.63
240230,201706,794,738,56,688722.68,51835,740557.68
240240,201706,141,102,39,95574,36543,132117
240250,201706,96,85,11,79645,10307,89952
240260,201706,1751,1294,457,1211803.36,427243.89,1639047.25
240270,201706,183,164,19,153293.2,17803,171096.2
240280,201706,43,33,10,30921,9370,40291
240290,201706,61,59,2,55283,1874,57157
240300,201706,172,100,72,93312,67464,160776
240310,201706,1863,1015,848,942347.66,791399.06,1733746.72
240320,201706,214,204,10,191148,9370,200518
240325,201706,4096,2494,1602,2328493.17,1498939.41,3827432.58
240330,201706,73,70,3,65590,2811,68401
240340,201706,97,70,27,65590,25299,90889
240350,201706,92,80,12,74960,11244,86204
240360,201706,337,242,95,226473,89015,315488
240370,201706,39,37,2,34669,1874,36543
240375,201706,80,48,32,44976,29984,74960
240380,201706,241,198,43,184629,40198,224827
240390,201706,19,16,3,14992,2811,17803
240400,201706,83,80,3,74960,2811,77771
240410,201706,10,7,3,6559,2811,9370
240420,201706,838,647,191,604929.07,177955.04,782884.11
240430,201706,253,239,14,222237.11,13118,235355.11
240440,201706,65,35,30,32795,28110,60905
240450,201706,181,117,64,109066.9,59968,169034.9
240460,201706,60,46,14,43102,13118,56220
240470,201706,229,195,34,182167.79,31858,214025.79
240480,201706,16,16,0,14898.3,0,14898.3
240485,201706,68,58,10,54455,9370,63825
240490,201706,47,47,0,43833,0,43833
240500,201706,85,69,16,64653,14992,79645
240510,201706,46,31,15,29047,14055,43102
240520,201706,133,127,6,118999,5622,124621
240530,201706,44,38,6,35606,5622,41228
240540,201706,81,69,12,64653,11234.63,75887.63
240550,201706,17,14,3,13118,2811,15929
240560,201706,360,263,97,245815.4,90889,336704.4
240570,201706,427,260,167,242495.6,156479,398974.6
240580,201706,1249,1006,243,936486.35,226553.6,1163039.95
240590,201706,29,27,2,25299,1874,27173
240600,201706,117,117,0,109629,0,109629
240610,201706,504,423,81,396070,75148,471218
240615,201706,41,39,2,36543,1874,38417
240620,201706,92,88,4,81519,3748,85267
240630,201706,39,37,2,34669,1874,36543
240640,201706,27,23,4,21551,3748,25299
240650,201706,224,190,34,177188,31858,209046
240660,201706,90,80,10,74960,9370,84330
240670,201706,273,159,114,146922.15,106818,253740.15
240680,201706,54,42,12,39354,11244,50598
240690,201706,51,48,3,44976,2811,47787
240700,201706,196,165,31,154605,29047,183652
240710,201706,1810,1150,660,1076895.3,616649.07,1693544.37
240720,201706,1005,734,271,686812.23,253927,940739.23
240725,201706,68,64,4,59968,3748,63716
240730,201706,129,112,17,104944,15929,120873
240740,201706,230,193,37,179501.09,34669,214170.09
240750,201706,38,24,14,22488,13118,35606
240760,201706,36,31,5,29047,4685,33732
240770,201706,144,110,34,103070,31853.32,134923.32
240780,201706,694,582,112,543638.03,104944,648582.03
240790,201706,41,39,2,36543,1874,38417
240800,201706,8281,5615,2666,5227090.21,2491906.6,7718996.81
240810,201706,19480,10650,8830,9939730.59,8263905.72,18203636.31
240820,201706,184,118,66,110280.22,61842,172122.22
240830,201706,1555,1280,275,1192671.05,256739,1449410.05
240840,201706,77,65,12,60905,11244,72149
240850,201706,89,77,12,72149,11244,83393
240860,201706,114,112,2,104944,1874,106818
240870,201706,54,47,7,43764,6559,50323
240880,201706,26,25,1,23415.63,937,24352.63
240890,201706,1091,639,452,594903.59,422583,1017486.59
240895,201706,43,32,11,29984,10307,40291
240910,201706,150,135,15,126495,14055,140550
240920,201706,17,13,4,12181,3748,15929
240930,201706,364,328,36,306399,33732,340131
240933,201706,19,15,4,14055,3748,17803
240940,201706,2390,2111,279,1968366.41,258687.36,2227053.77
240950,201706,47,46,1,43102,937,44039
240960,201706,34,26,8,24362,7496,31858
240970,201706,151,109,42,102133,38617,140750
240980,201706,175,138,37,129306,34669,163975
240990,201706,114,73,41,68401,38417,106818
241000,201706,83,74,9,69151,8433,77584
241010,201706,58,46,12,43102,11244,54346
241020,201706,115,108,7,101196,6559,107755
241025,201706,9,3,6,2811,5622,8433
241030,201706,122,99,23,92763,21551,114314
241040,201706,30,25,5,23425,4685,28110
241050,201706,97,84,13,78708,12181,90889
241060,201706,34,31,3,29047,2811,31858
241070,201706,18,18,0,16866,0,16866
241080,201706,65,57,8,53127.9,7496,60623.9
241090,201706,52,42,10,39354,9327.9,48681.9
241100,201706,72,65,7,60905,6559,67464
241105,201706,8,3,5,2811,4685,7496
241110,201706,50,47,3,44039,2811,46850
241120,201706,1361,1051,310,981855.4,289607.96,1271463.36
241140,201706,228,185,43,172409,40291,212700
241142,201706,43,42,1,39354,937,40291
241150,201706,1184,1041,143,972747.5,133991,1106738.5
241160,201706,27,25,2,23425,1874,25299
241170,201706,41,39,2,36543,1874,38417
241180,201706,49,39,10,36371.53,9370,45741.53
241190,201706,46,45,1,42165,937,43102
241200,201706,3648,2022,1626,1889186.01,1521675.74,3410861.75
241210,201706,74,59,15,55283,13212,68495
241220,201706,1328,877,451,821139.7,422568.26,1243707.96
241230,201706,234,197,37,184401.6,34669,219070.6
241240,201706,51,39,12,36543,11244,47787
241250,201706,1040,969,71,907953,66246,974199
241255,201706,40,33,7,30921,6559,37480
241260,201706,622,491,131,460062.32,122747,582809.32
241270,201706,47,32,15,29984,14055,44039
241280,201706,101,87,14,81519,13118,94637
241290,201706,105,78,27,73086,25299,98385
241300,201706,78,55,23,51535,21551,73086
241310,201706,52,40,12,37340,11244,48584
241320,201706,29,16,13,14616,12181,26797
241330,201706,58,52,6,48724,5622,54346
241335,201706,54,46,8,43102,7496,50598
241340,201706,182,137,45,128369,42165,170534
241350,201706,55,52,3,48724,2811,51535
241355,201706,42,39,3,36543,2811,39354
241360,201706,48,48,0,44976,0,44976
241370,201706,45,38,7,35606,6559,42165
241380,201706,44,42,2,39354,1874,41228
241390,201706,72,57,15,53221.6,14055,67276.6
241400,201706,187,153,34,142706,31858,174564
241410,201706,175,158,17,148046,15836,163882
241415,201706,90,72,18,67464,16866,84330
241420,201706,92,69,23,64653,21383,86036
241430,201706,29,28,1,26236,937,27173
241440,201706,440,372,68,348564,63536,412100
241445,201706,30,28,2,26236,1874,28110
241450,201706,281,230,51,215386,47787,263173
241460,201706,131,118,13,110332,12181,122513
241470,201706,46,38,8,35606,7496,43102
241475,201706,72,68,4,63716,3748,67464
241480,201706,89,65,24,60905,22488,83393
241490,201706,10,8,2,7496,1593,9089
241500,201706,50,37,13,34669,12181,46850
250010,201706,99,87,12,81519,11244,92763
250020,201706,22,18,4,16866,3748,20614
250030,201706,803,587,216,548698.1,200548.51,749246.61
250040,201706,307,257,50,240809,46850,287659
250050,201706,215,179,36,167723,33732,201455
250053,201706,55,43,12,40291,11244,51535
250057,201706,0,0,0,0,0,0
250060,201706,438,341,97,319517,90889,410406
250070,201706,669,576,93,537732,87141,624873
250073,201706,8,8,0,7496,0,7496
250077,201706,211,156,55,145788.6,51535,197323.6
250080,201706,419,322,97,300122.1,90889,391011.1
250090,201706,216,145,71,134928.2,65671.26,200599.46
250100,201706,450,368,82,344816,76460,421276
250110,201706,474,354,120,329946.6,112440,442386.6
250115,201706,29,8,21,7496,19677,27173
250120,201706,98,75,23,70275,21551,91826
250130,201706,586,460,126,431020,117875,548895
250135,201706,13,8,5,7496,4685,12181
250140,201706,71,63,8,59031,7496,66527
250150,201706,545,405,140,377358,130870.79,508228.79
250153,201706,11,10,1,9370,937,10307
250157,201706,27,22,5,20614,4685,25299
250160,201706,204,160,44,149920,41228,191148
250170,201706,68,48,20,44976,18740,63716
250180,201706,3865,2612,1253,2434660.86,1169297.35,3603958.21
250190,201706,924,601,323,561497.25,301948.25,863445.50
250200,201706,48,41,7,38417,6559,44976
250205,201706,17,14,3,13118,2811,15929
250210,201706,87,75,12,70275,11244,81519
250215,201706,62,53,9,49661,8433,58094
250220,201706,27,20,7,18740,6559,25299
250230,201706,67,62,5,58094,4685,62779
250240,201706,232,190,42,177233.55,39354,216587.55
250250,201706,389,332,57,311084,53409,364493
250260,201706,29,25,4,23425,3748,27173
250270,201706,56,44,12,41228,11244,52472
250280,201706,386,323,63,302651,59031,361682
250290,201706,88,81,7,75615.9,6559,82174.9
250300,201706,558,381,177,356361.24,165836,522197.24
250310,201706,43,37,6,34669,5622,40291
250320,201706,1841,1266,575,1181161.29,537548,1718709.29
250330,201706,77,66,11,61842,10307,72149
250340,201706,24,20,4,18740,3748,22488
250350,201706,129,81,48,75615.9,44413.8,120029.7
250355,201706,24,19,5,17803,4685,22488
250360,201706,200,163,37,152731,34435,187166
250370,201706,2307,1570,737,1465283.59,689039.71,2154323.30
250375,201706,23,19,4,17803,3748,21551
250380,201706,49,33,16,30921,14992,45913
250390,201706,34,28,6,26236,5622,31858
250400,201706,15217,7690,7527,7183879.84,7045579.29,14229459.13
250403,201706,416,340,76,318570.64,71212,389782.64
250407,201706,52,46,6,43102,5622,48724
250410,201706,29,24,5,22488,4685,27173
250415,201706,43,28,15,26236,14036.26,40272.26
250420,201706,47,38,9,35606,8433,44039
250430,201706,1654,1385,269,1295591,252053,1547644
250435,201706,14,12,2,11244,1874,13118
250440,201706,690,595,95,555183.29,89015,644198.29
250450,201706,83,69,14,64653,12462.1,77115.1
250460,201706,394,264,130,247368,121677.42,369045.42
250470,201706,89,64,25,59968,23425,83393
250480,201706,321,252,69,236124,64653,300777
250485,201706,1,1,0,937,0,937
250490,201706,202,166,36,155542,33732,189274
250500,201706,73,53,20,49661,18740,68401
250510,201706,715,551,164,514975.8,152677.41,667653.21
250520,201706,172,116,56,108673.28,52467.32,161140.60
250523,201706,109,90,19,84330,17803,102133
250527,201706,103,79,24,74018.32,22488,96506.32
250530,201706,5,4,1,3748,937,4685
250535,201706,27,22,5,20614,4685,25299
250540,201706,123,92,31,85501.25,29047,114548.25
250550,201706,68,65,3,60905,2811,63716
250560,201706,36,31,5,29047,4685,33732
250570,201706,151,119,32,111503,29984,141487
250580,201706,140,109,31,101851.9,29047,130898.9
250590,201706,18,14,4,13118,3748,16866
250600,201706,1273,866,407,808445.64,381261.32,1189706.96
250610,201706,151,130,21,121810,19677,141487
250620,201706,20,16,4,14992,3748,18740
250625,201706,57,42,15,39354,14055,53409
250630,201706,2944,1884,1060,1758910.97,991883.92,2750794.89
250640,201706,199,166,33,155542,30921,186463
250650,201706,31,21,10,19677,9370,29047
250660,201706,36,30,6,28110,5622,33732
250670,201706,51,34,17,31858,15929,47787
250680,201706,388,314,74,294218,69338,363556
250690,201706,1725,1179,546,1101505.76,511227.9,1612733.66
250700,201706,935,817,118,761147.3,110359.86,871507.16
250710,201706,445,344,101,322328,94637,416965
250720,201706,100,79,21,74023,19677,93700
250730,201706,362,303,59,283911,55283,339194
250740,201706,44,40,4,37480,3748,41228
250750,201706,19603,11700,7903,10906244.91,7396333.03,18302577.94
250760,201706,62,48,14,44976,13118,58094
250770,201706,338,226,112,210825.31,103796.27,314621.58
250780,201706,54,42,12,39354,11244,50598
250790,201706,487,306,181,283911.76,168894.25,452806.01
250800,201706,149,137,12,127666.25,11244,138910.25
250810,201706,83,61,22,57157,20614,77771
250820,201706,153,122,31,114314,29047,143361
250830,201706,429,286,143,266998.25,133991,400989.25
250840,201706,52,49,3,45913,2811,48724
250850,201706,48,39,9,35868.36,8433,44301.36
250855,201706,13,11,2,10307,1874,12181
250860,201706,197,143,54,133991,50316.9,184307.9
250870,201706,32,29,3,27173,2811,29984
250880,201706,72,55,17,51488.15,15929,67417.15
250890,201706,2285,1682,603,1574722.2,564163.57,2138885.77
250900,201706,53,45,8,42165,7496,49661
250905,201706,129,98,31,91826,29047,120873
250910,201706,1144,815,329,762240.14,307991.9,1070232.04
250915,201706,109,74,35,69338,32795,102133
250920,201706,137,104,33,97448,30921,128369
250930,201706,150,95,55,89015,51535,140550
250933,201706,0,0,0,0,0,0
250937,201706,8,7,1,6559,937,7496
250939,201706,31,24,7,22488,6559,29047
250940,201706,99,71,28,66527,26236,92763
250950,201706,77,52,25,48724,23425,72149
250960,201706,90,48,42,44955.89,39354,84309.89
250970,201706,1179,830,349,776118,326731.9,1102849.9
250980,201706,88,62,26,58094,24362,82456
250990,201706,159,122,37,113878.35,34640.9,148519.25
251000,201706,71,65,6,60717.6,5622,66339.6
251010,201706,90,71,19,66523,17038.4,83561.4
251020,201706,78,68,10,62919.55,9370,72289.55
251030,201706,41,31,10,29047,9370,38417
251040,201706,51,35,16,32795,14992,47787
251050,201706,25,23,2,21551,1874,23425
251060,201706,46,37,9,33732,8433,42165
251065,201706,4,3,1,2811,937,3748
251070,201706,26,20,6,18731,5622,24353
251080,201706,4603,2234,2369,2081104.78,2213316.41,4294421.19
251090,201706,200,171,29,160227,27173,187400
251100,201706,18,17,1,15929,937,16866
251110,201706,45,36,9,33732,8433,42165
251120,201706,1744,1032,712,962015.2,667144,1629159.2
251130,201706,338,274,64,256738,59968,316706
251140,201706,484,309,175,288410,163809.34,452219.34
251150,201706,285,247,38,230681,35606,266287
251160,201706,89,73,16,68397,14992,83389
251170,201706,101,79,22,73994.92,20604.64,94599.56
251180,201706,287,179,108,167723,101187.32,268910.32
251190,201706,188,129,59,120550.68,55283,175833.68
251200,201706,249,198,51,185526,47787,233313
251203,201706,30,28,2,26236,1874,28110
251207,201706,91,75,16,70275,14992,85267
251210,201706,1207,851,356,795860.34,332916.1,1128776.44
251220,201706,46,36,10,33732,9370,43102
251230,201706,514,437,77,409449,72149,481598
251240,201706,102,72,30,66527,28110,94637
251250,201706,1287,920,367,859932.1,343739,1203671.1
251260,201706,13,8,5,7496,4685,12181
251270,201706,335,247,88,231439,82316,313755
251272,201706,71,65,6,60905,5622,66527
251274,201706,24,19,5,17803,4685,22488
251275,201706,20,14,6,13118,5622,18740
251276,201706,17,14,3,13118,2811,15929
251278,201706,9,7,2,6559,1874,8433
251280,201706,84,80,4,74960,3748,78708
251290,201706,697,524,173,490988,162101,653089
251300,201706,17,15,2,14055,1874,15929
251310,201706,344,246,98,230498,91826,322324
251315,201706,15,14,1,13118,937,14055
251320,201706,59,46,13,43102,12181,55283
251330,201706,78,69,9,64653,8433,73086
251335,201706,9,5,4,4685,3748,8433
251340,201706,679,411,268,385107,250109.63,635216.63
251350,201706,33,31,2,29047,1874,30921
251360,201706,64,55,9,51332.61,8433,59765.61
251365,201706,14,14,0,13118,0,13118
251370,201706,5152,3479,1673,3254391.39,1566009.4,4820400.79
251380,201706,50,40,10,37480,9370,46850
251385,201706,2,2,0,1874,0,1874
251390,201706,620,498,122,465502.6,113096,578598.6
251392,201706,30,19,11,17803,10307,28110
251394,201706,10,9,1,8433,937,9370
251396,201706,19,15,4,14055,3748,17803
251398,201706,17,15,2,14055,1874,15929
251400,201706,35,29,6,27173,5622,32795
251410,201706,33,29,4,27173,3748,30921
251420,201706,106,82,24,76834,22488,99322
251430,201706,36,34,2,31858,1874,33732
251440,201706,39,25,14,23416,13118,36534
251445,201706,43,38,5,35606,4685,40291
251450,201706,405,358,47,333820.4,44039,377859.4
251455,201706,2,1,1,937,937,1874
251460,201706,16,12,4,11244,3748,14992
251465,201706,5,2,3,1874,2811,4685
251470,201706,45,36,9,33732,8433,42165
251480,201706,24,22,2,20614,1874,22488
251490,201706,131,92,39,85736,35607,121343
251500,201706,115,92,23,86204,20802,107006
251510,201706,31,23,8,21551,7496,29047
251520,201706,22,22,0,20614,0,20614
251530,201706,4567,3192,1375,2986234.09,1288084.53,4274318.62
251540,201706,75,67,8,62779,7496,70275
251550,201706,422,322,100,300777.6,93466,394243.6
251560,201706,23,18,5,16866,4685,21551
251570,201706,17,17,0,15929,0,15929
251580,201706,115,93,22,87141,20614,107755
251590,201706,129,94,35,88078,32795,120873
251593,201706,19,11,8,10307,7496,17803
251597,201706,59,48,11,44976,10307,55283
251600,201706,1092,773,319,722989.94,297206.26,1020196.20
251610,201706,209,157,52,146453.1,47788,194241.1
251615,201706,1,1,0,937,0,937
251620,201706,4197,2813,1384,2627475.07,1294373.34,3921848.41
251630,201706,420,304,116,284848,108692,393540
251640,201706,148,103,45,96511,42165,138676
251650,201706,254,185,69,171546.55,64653,236199.55
251660,201706,218,199,19,185526.55,17803,203329.55
251670,201706,342,269,73,250489.07,68401,318890.07
251675,201706,4,3,1,2811,937,3748
251680,201706,85,79,6,74023,5622,79645
251690,201706,333,277,56,259549,52128.13,311677.13
251700,201706,279,227,52,212122.75,48709.95,260832.70
251710,201706,18,12,6,11244,5622,16866
251720,201706,33,22,11,20614,10026,30640
251740,201706,9,7,2,6559,1874,8433
260005,201706,3034,1718,1316,1599532.88,1231947.55,2831480.43
260010,201706,1272,903,369,842948.76,344535.56,1187484.32
260020,201706,432,380,52,356060,48724,404784
260030,201706,561,408,153,381542.65,143361,524903.65
260040,201706,851,521,330,487099.45,308862.61,795962.06
260050,201706,1119,787,332,737185,310522,1047707
260060,201706,410,370,40,345940.4,37480,383420.4
260070,201706,1394,887,507,827088,472138.58,1299226.58
260080,201706,729,567,162,530061.55,151794,681855.55
260090,201706,563,345,218,323040.86,204266,527306.86
260100,201706,224,155,69,144251.6,64653,208904.6
260105,201706,240,131,109,122747,102133,224880
260110,201706,2627,1957,670,1833690.63,626994,2460684.63
260120,201706,2868,1569,1299,1459012.74,1214916.55,2673929.29
260130,201706,144,99,45,92763,42165,134928
260140,201706,2002,1303,699,1213507.25,653446.63,1866953.88
260150,201706,233,151,82,141487,76834,218321
260160,201706,282,245,37,229565,34669,264234
260170,201706,3224,1994,1230,1861467.04,1151432.45,3012899.49
260180,201706,128,111,17,104007,15929,119936
260190,201706,2256,1612,644,1507350.03,603428,2110778.03
260200,201706,872,721,151,674815.24,141206,816021.24
260210,201706,1384,962,422,901245.96,395124,1296369.96
260220,201706,691,634,57,593286,53409,646695
260230,201706,1183,895,288,836463.15,269856,1106319.15
260240,201706,209,153,56,142208.49,52472,194680.49
260250,201706,70,56,14,52472,13118,65590
260260,201706,958,686,272,642782,254864,897646
260270,201706,440,356,84,332354.1,78426.9,410781.0
260280,201706,942,709,233,664145.6,217759,881904.6
260290,201706,6273,3300,2973,3072245.51,2779561.06,5851806.57
260300,201706,798,700,98,653595.23,91545,745140.23
260310,201706,485,382,103,355924.13,96511,452435.13
260320,201706,882,662,220,620198,206140,826338
260330,201706,28,22,6,20614,5622,26236
260340,201706,63,46,17,43102,15929,59031
260345,201706,5433,3096,2337,2894510.92,2188516.01,5083026.93
260350,201706,461,338,123,314993.16,114315,429308.16
260360,201706,291,150,141,140550,132117,272667
260370,201706,620,396,224,369225.7,209751,578976.7
260380,201706,595,425,170,398225,158166.14,556391.14
260390,201706,287,244,43,227452.19,39354,266806.19
260392,201706,88,77,11,72149,10307,82456
260400,201706,4065,2315,1750,2159000.83,1639394.41,3798395.24
260410,201706,13859,7535,6324,7045709.06,5922905.5,12968614.56
260415,201706,122,107,15,100259,14055,114314
260420,201706,1783,1045,738,973831.55,690054.8,1663886.35
260430,201706,195,177,18,164658.14,16866,181524.14
260440,201706,226,162,64,150521,59968,210489
260450,201706,480,338,142,315444,132773,448217
260460,201706,852,450,402,419028.4,376669.32,795697.72
260470,201706,368,221,147,206327.4,136849.55,343176.95
260480,201706,198,121,77,113377,72149,185526
260490,201706,202,163,39,152731,36543,189274
260500,201706,1118,746,372,695864.5,346831,1042695.5
260510,201706,720,560,160,524720,148983,673703
260515,201706,254,224,30,209888,27642,237530
260520,201706,3254,1903,1351,1775509.23,1264004.21,3039513.44
260530,201706,729,592,137,551935.31,128369,680304.31
260540,201706,585,433,152,405721,141487.66,547208.66
260545,201706,14,10,4,9370,3748,13118
260550,201706,327,201,126,188337,118062,306399
260560,201706,507,386,121,361102,113095.9,474197.9
260570,201706,999,830,169,774759.9,158353,933112.9
260580,201706,285,251,34,235187,31858,267045
260590,201706,631,360,271,335933.24,253927,589860.24
260600,201706,7934,4041,3893,3765643.71,3644457.32,7410101.03
260610,201706,494,328,166,307336,155542,462878
260620,201706,3470,1834,1636,1708541.95,1528033.94,3236575.89
260630,201706,71,68,3,63716,2811,66527
260640,201706,3545,1926,1619,1800279.17,1516657.05,3316936.22
260650,201706,336,231,105,216447,98342.85,314789.85
260660,201706,494,338,156,316331.2,145281.85,461613.05
260670,201706,101,76,25,71212,23425,94637
260680,201706,3649,2013,1636,1868165.85,1531003.52,3399169.37
260690,201706,192,154,38,143642.1,35606,179248.1
260700,201706,344,205,139,191335.4,129426,320761.4
260710,201706,40,38,2,35606,1874,37480
260720,201706,2180,1307,873,1218876.23,817223.29,2036099.52
260730,201706,584,444,140,416028,129306.45,545334.45
260740,201706,66,62,4,58094,3748,61842
260750,201706,649,449,200,420713,187400,608113
260760,201706,631,346,285,324202,266715,590917
260765,201706,957,501,456,466547.9,427037.75,893585.65
260770,201706,216,160,56,149920,52472,202392
260775,201706,812,485,327,453275.3,306399,759674.3
260780,201706,261,167,94,156479,87946.82,244425.82
260790,201706,12319,6751,5568,6296946.44,5210071.64,11507018.08
260795,201706,149,101,48,93493.86,44976,138469.86
260800,201706,363,300,63,280351,59031,339382
260805,201706,200,128,72,119220.13,67464,186684.13
260810,201706,733,641,92,599389.53,86204,685593.53
260820,201706,313,207,106,192653,99322,291975
260825,201706,195,134,61,125187.71,57157,182344.71
260830,201706,254,163,91,152590.45,85267,237857.45
260840,201706,218,157,61,145849,56876,202725
260845,201706,209,144,65,134928,60905,195833
260850,201706,513,370,143,345055.64,133991,479046.64
260860,201706,251,186,65,174087.86,60905,234992.86
260870,201706,373,262,111,245494,104007,349501
260875,201706,666,458,208,428052.53,194896,622948.53
260880,201706,1394,894,500,836972.31,468312.6,1305284.91
260890,201706,2454,1715,739,1600086.49,691507,2291593.49
260900,201706,1038,699,339,653684.95,317643,971327.95
260910,201706,272,214,58,200518,54346,254864
260915,201706,307,202,105,189274,98265,287539
260920,201706,165,94,71,88078,66527,154605
260930,201706,395,336,59,314832,55212.8,370044.8
260940,201706,2639,1457,1182,1361275.55,1106785,2468060.55
260950,201706,1864,1094,770,1018735.45,721490,1740225.45
260960,201706,14228,7382,6846,6882222.09,6406494.37,13288716.46
260970,201706,424,365,59,342005,55283,397288
260980,201706,203,175,28,163685,26236,189921
260990,201706,2480,2046,434,1916606.01,406658,2323264.01
261000,201706,4308,2499,1809,2329612.25,1692503.9,4022116.15
261010,201706,186,134,52,125558,47920.8,173478.8
261020,201706,616,454,162,425258,150997.55,576255.55
261030,201706,210,151,59,141487,55254.9,196741.9
261040,201706,355,320,35,299840,32513.9,332353.9
261050,201706,462,406,56,380422,52472,432894
261060,201706,1296,846,450,790594.88,421650,1212244.88
261070,201706,8880,4557,4323,4243484.11,4042235.09,8285719.20
261080,201706,391,294,97,275478,90889,366367
261090,201706,2129,1638,491,1527243.92,459318,1986561.92
261100,201706,1052,745,307,696238.8,286347.2,982586.0
261110,201706,7792,4739,3053,4435201.93,2858428.5,7293630.43
261120,201706,281,237,44,221788,41224,263012
261130,201706,569,318,251,297638.45,235187,532825.45
261140,201706,187,120,67,112440,62779,175219
261150,201706,652,378,274,352977.77,256738,609715.77
261153,201706,71,68,3,62779.12,2811,65590.12
261160,201706,75631,38463,37168,35920649.07,34802856.26,70723505.33
261170,201706,459,338,121,316425,113377,429802
261180,201706,1740,1059,681,987120.43,638097,1625217.43
261190,201706,621,424,197,397035.89,184580,581615.89
261200,201706,212,187,25,174514.09,23425,197939.09
261210,201706,30,27,3,25299,2811,28110
261220,201706,2393,1683,710,1571445.11,664146,2235591.11
261230,201706,319,237,82,221600.5,76819.95,298420.45
261240,201706,439,374,65,346496.47,60905,407401.47
261245,201706,204,169,35,158353,32795,191148
261247,201706,133,97,36,90889,33732,124621
261250,201706,2734,1339,1395,1253143.9,1306305.71,2559449.61
261255,201706,247,226,21,211762,19677,231439
261260,201706,820,709,111,664333,104007,768340
261270,201706,168,130,38,121810,35606,157416
261280,201706,139,112,27,104944,25299,130243
261290,201706,133,91,42,85032.75,39354,124386.75
261300,201706,1214,852,362,797490.44,339194,1136684.44
261310,201706,735,492,243,461004,227081.95,688085.95
261320,201706,526,354,172,331698,161114,492812
261330,201706,776,624,152,581744.25,141593.53,723337.78
261340,201706,320,175,145,163975,135865,299840
261350,201706,739,521,218,487240.1,204226,691466.1
261360,201706,1132,721,411,675182.53,385107,1060289.53
261370,201706,4839,2982,1857,2780198.02,1738345.2,4518543.22
261380,201706,574,415,159,386990.92,148702,535692.92
261390,201706,3333,2229,1104,2083897.74,1031348.53,3115246.27
261400,201706,285,260,25,242776.7,23425,266201.7
261410,201706,1013,666,347,624042,325134.32,949176.32
261420,201706,852,528,324,492835.63,303569.63,796405.26
261430,201706,331,300,31,280269,28765.9,309034.9
261440,201706,90,79,11,74023,10307,84330
261450,201706,2478,2060,418,1927607.06,390674.12,2318281.18
261460,201706,683,548,135,512539.81,126495,639034.81
261470,201706,234,180,54,167864,50598,218462
261480,201706,324,265,59,247182,55279,302461
261485,201706,333,203,130,189555.1,121810,311365.1
261500,201706,616,412,204,386044,191148,577192
261510,201706,39,28,11,26236,10307,36543
261520,201706,169,156,13,145236,12181,157417
261530,201706,4113,2600,1513,2428381.99,1416449.95,3844831.94
261540,201706,1059,645,414,604044.34,387918,991962.34
261550,201706,284,138,146,127948,136802,264750
261560,201706,756,505,251,470750.1,233772.8,704522.9
261570,201706,355,277,78,259549,73086,332635
261580,201706,371,290,81,270983,75897,346880
261590,201706,183,150,33,140550,30921,171471
261600,201706,279,227,52,211950,48256,260206
261610,201706,99,86,13,80234,12181,92415
261618,201706,64,50,14,46850,13118,59968
261620,201706,211,126,85,118062,79645,197707
261630,201706,587,448,139,417459.8,130056,547515.8
261640,201706,6093,3232,2861,3020031.75,2677956.26,5697988.01
261650,201706,476,293,183,273875.73,171471,445346.73
270010,201706,503,439,64,411343,59219,470562
270020,201706,308,241,67,225063.4,62779,287842.4
270030,201706,8969,5729,3240,5354109.15,3033428.54,8387537.69
270040,201706,1830,1117,713,1046525.94,667799.9,1714325.84
270050,201706,187,136,51,127432,47787,175219
270060,201706,121,66,55,61842,51535,113377
270070,201706,916,652,264,608943.26,246122.16,855065.42
270080,201706,44,37,7,34669,6559,41228
270090,201706,20,16,4,14992,3748,18740
270100,201706,1299,842,457,785099.28,425165.12,1210264.40
270110,201706,169,123,46,115251,43102,158353
270120,201706,219,179,40,166886.72,37198.9,204085.62
270130,201706,267,184,83,172126.9,77489.9,249616.8
270135,201706,100,58,42,54346,39354,93700
270140,201706,1231,725,506,678929.34,471678.26,1150607.60
270150,201706,273,217,56,203329,52472,255801
270160,201706,515,376,139,351425,130243,481668
270170,201706,665,418,247,390073.1,230642.55,620715.65
270180,201706,67,50,17,46537.7,15722.86,62260.56
270190,201706,102,89,13,83393,12181,95574
270200,201706,109,99,10,92575.6,9370,101945.6
270210,201706,494,254,240,237998,224598.9,462596.9
270220,201706,201,160,41,149920,38417,188337
270230,201706,2031,1200,831,1118144.96,775860.94,1894005.90
270235,201706,738,546,192,511293.29,179545.48,690838.77
270240,201706,3047,2341,706,2183800.07,657654.7,2841454.77
270250,201706,174,122,52,113564.4,48724,162288.4
270255,201706,221,194,27,181778,24924.2,206702.2
270260,201706,314,252,62,235937,57812.9,293749.9
270270,201706,120,47,73,44030,68401,112431
270280,201706,216,138,78,129306,73086,202392
270290,201706,1129,840,289,785740.59,269912.89,1055653.48
270300,201706,252,162,90,151794,84048.9,235842.9
270310,201706,954,752,202,702431.18,188571.99,891003.17
270320,201706,898,758,140,708132.8,131180,839312.8
270330,201706,256,208,48,193959,44976,238935
270340,201706,61,48,13,44976,12181,57157
270350,201706,92,47,45,44039,42165,86204
270360,201706,78,43,35,40291,32795,73086
270370,201706,51,37,14,34669,13118,47787
270375,201706,61,34,27,31858,25295,57153
270380,201706,1069,587,482,549082,451634,1000716
270390,201706,199,105,94,98385,88078,186463
270400,201706,691,498,193,465432.43,180832,646264.43
270410,201706,716,503,213,471301.63,199571.63,670873.26
270420,201706,385,245,140,227898,131097.89,358995.89
270430,201706,31512,22338,9174,20880529.88,8585944.83,29466474.71
270440,201706,498,388,110,362572.55,102788.9,465361.45
270450,201706,765,383,382,358636.75,356997.73,715634.48
270460,201706,202,144,58,134928,54346,189274
270470,201706,1324,868,456,812967.95,427048,1240015.95
270480,201706,504,402,102,374209.89,94871.25,469081.14
270490,201706,26,20,6,18740,5622,24362
270500,201706,513,412,101,386044,94637,480681
270510,201706,738,452,286,423524,267982,691506
270520,201706,412,248,164,232029.45,153668,385697.45
270530,201706,66,57,9,53409,8433,61842
270540,201706,127,96,31,89952,29047,118999
270550,201706,1713,1288,425,1205321.37,398126.62,1603447.99
270560,201706,327,148,179,138676,167723,306399
270570,201706,428,269,159,251237.73,148983,400220.73
270580,201706,72,50,22,46850,20614,67464
270590,201706,83,69,14,64653,13097.89,77750.89
270600,201706,177,144,33,134928,30921,165849
270610,201706,166,131,35,122738,32795,155533
270620,201706,32,31,1,29047,937,29984
270630,201706,3805,2878,927,2685728.96,866482.38,3552211.34
270640,201706,895,645,250,601760.3,233941.9,835702.2
270642,201706,194,163,31,152731,29047,181778
270644,201706,297,200,97,187212.97,90884.32,278097.29
270650,201706,229,136,93,127432,87141,214573
270660,201706,259,208,51,194896,47787,242683
270670,201706,3157,2378,779,2217553.24,727759.12,2945312.36
270680,201706,457,264,193,246453.23,180836.32,427289.55
270690,201706,1166,711,455,664505.24,426325.63,1090830.87
270700,201706,37,29,8,27173,7496,34669
270710,201706,852,627,225,585912.86,210825,796737.86
270720,201706,252,187,65,175219,60623.9,235842.9
270730,201706,1783,1021,762,955413.2,711925.6,1667338.8
270740,201706,47,29,18,27173,16866,44039
270750,201706,619,451,168,422587,156761,579348
270760,201706,309,226,83,211762,77771,289533
270770,201706,2665,1643,1022,1531550.84,956677,2488227.84
270780,201706,92,56,36,52467.32,33714.64,86181.96
270790,201706,286,191,95,178967,89015,267982
270800,201706,1957,1541,416,1443093.12,389061.14,1832154.26
270810,201706,322,252,70,236109.95,65581.32,301691.27
270820,201706,157,99,58,92763,54253,147016
270830,201706,1024,735,289,687946,270793,958739
270840,201706,1403,1010,393,945878.2,367305,1313183.2
270850,201706,1749,1057,692,985871.95,648371.58,1634243.53
270860,201706,2429,1561,868,1457798.4,811369.11,2269167.51
270870,201706,124,68,56,63716,52472,116188
270880,201706,914,652,262,608353.93,244608.49,852962.42
270890,201706,379,277,102,259267.9,95569.32,354837.22
270895,201706,72,61,11,57157,10307,67464
270900,201706,113,90,23,84330,21551,105881
270910,201706,337,263,74,245306.6,69338,314644.6
270915,201706,1749,1016,733,947048.82,686329.57,1633378.39
270920,201706,502,414,88,387918,82456,470374
270930,201706,6210,4427,1783,4142660.57,1668851.3,5811511.87
270940,201706,2406,1808,598,1692910.69,558808.8,2251719.49
280010,201706,43,39,4,36543,3748,40291
280020,201706,698,598,100,558421.31,92763,651184.31
280030,201706,18488,11798,6690,10977890.37,6239657.39,17217547.76
280040,201706,345,220,125,206140,115719.5,321859.5
280050,201706,376,286,90,267700.9,84330,352030.9
280060,201706,314,208,106,192720.48,99322,292042.48
280067,201706,977,680,297,634452.26,277352.12,911804.38
280070,201706,126,104,22,97448,20614,118062
280100,201706,601,469,132,435445.88,123497,558942.88
280110,201706,77,70,7,65590,6559,72149
280120,201706,614,488,126,456459.55,118062,574521.55
280130,201706,1278,779,499,728377.9,467422.45,1195800.35
280140,201706,467,370,97,345846.7,90889,436735.7
280150,201706,312,226,86,211094.21,79645,290739.21
280160,201706,96,81,15,75897,14055,89952
280170,201706,567,375,192,349918.68,179107.55,529026.23
280190,201706,29,26,3,24362,2811,27173
280200,201706,16,11,5,10307,4685,14992
280210,201706,2689,1894,795,1758123.64,739718.19,2497841.83
280220,201706,38,30,8,28110,7496,35606
280230,201706,300,246,54,229682.95,49661.1,279344.05
280240,201706,109,103,6,96371,5622,101993
280250,201706,21,12,9,11244,8433,19677
280260,201706,76,68,8,63716,7496,71212
280270,201706,155,117,38,109629,35606,145235
280280,201706,199,125,74,117125,69338,186463
280290,201706,2957,2137,820,1988292.6,767052.63,2755345.23
280300,201706,1065,804,261,752411,243807.4,996218.4
280310,201706,104,98,6,91639,5622,97261
280320,201706,635,428,207,401027,193959,594986
280330,201706,361,255,106,237667.99,99200.19,336868.18
280340,201706,396,316,80,294647.05,74211,368858.05
280350,201706,3301,2549,752,2379278.36,702869.46,3082147.82
280360,201706,464,295,169,276415,157416,433831
280370,201706,91,79,12,74023,11244,85267
280380,201706,56,41,15,38417,14055,52472
280390,201706,179,148,31,138676,29047,167723
280400,201706,323,222,101,207171.4,94637,301808.4
280410,201706,288,229,59,213431,55273.63,268704.63
280420,201706,171,144,27,134928,25299,160227
280430,201706,107,79,28,74023,26236,100259
280440,201706,655,497,158,460677.8,147742.37,608420.17
280445,201706,115,105,10,98385,9370,107755
280450,201706,1032,884,148,824738.03,138676,963414.03
280460,201706,709,509,200,470195.26,187400,657595.26
280470,201706,190,172,18,161164,15930,177094
280480,201706,2175,1553,622,1442352.19,578797.65,2021149.84
280490,201706,375,342,33,319310,30921,350231
280500,201706,54,49,5,45913,4685,50598
280510,201706,140,107,33,99961.6,30640,130601.6
280520,201706,54,41,13,38417,12181,50598
280530,201706,72,53,19,49661,17803,67464
280540,201706,492,389,103,364493,96229.9,460722.9
280550,201706,694,642,52,598984.3,48724,647708.3
280560,201706,463,396,67,368896.9,62779,431675.9
280570,201706,1724,1303,421,1217626.42,394477,1612103.42
280580,201706,586,445,141,416826,132024,548850
280590,201706,169,103,66,96236.46,61842,158078.46
280600,201706,343,289,54,269125.54,50598,319723.54
280610,201706,142,104,38,97246,35606,132852
280620,201706,558,449,109,419776,101993,521769
280630,201706,167,138,29,129306,27173,156479
280640,201706,202,157,45,146295,42165,188460
280650,201706,84,54,30,50598,28110,78708
280660,201706,127,93,34,87141,31623.75,118764.75
280670,201706,1496,933,563,868200.63,523853.98,1392054.61
280680,201706,176,149,27,137861.62,25299,163160.62
280690,201706,43,36,7,33732,6559,40291
280700,201706,16,16,0,14992,0,14992
280710,201706,1395,1029,366,956568.29,342286.1,1298854.39
280720,201706,107,72,35,64949.7,32795,97744.7
280730,201706,24,20,4,18740,3748,22488
280740,201706,2294,1670,624,1560974.82,582946.07,2143920.89
280750,201706,289,248,41,232376,38417,270793
280760,201706,850,575,275,537650.6,257534.45,795185.05
290010,201706,181,117,64,109629,59968,169597
290020,201706,173,160,13,149920,12181,162101
290030,201706,577,370,207,346034.1,193959,539993.1
290035,201706,138,110,28,99922.8,26236,126158.8
290040,201706,267,167,100,156479,93700,250179
290050,201706,68,50,18,46850,16866,63716
290060,201706,260,112,148,104662.9,138676,243338.9
290070,201706,5410,2626,2784,2453256.07,2605193.85,5058449.92
290080,201706,523,238,285,222518.76,267027,489545.76
290090,201706,381,164,217,153668,203329,356997
290100,201706,1566,1024,542,954431.05,507291.9,1461722.95
290110,201706,724,429,295,400376.1,276080.3,676456.4
290115,201706,216,197,19,183652,17803,201455
290120,201706,772,507,265,474403.1,248305,722708.1
290130,201706,422,243,179,227400.53,166972,394372.53
290135,201706,290,221,69,206411.73,64653,271064.73
290140,201706,279,231,48,215510,44976,260486
290150,201706,131,95,36,89015,33732,122747
290160,201706,244,192,52,178686.05,48724,227410.05
290170,201706,85,56,29,52472,27173,79645
290180,201706,148,117,31,109629,29047,138676
290190,201706,449,365,84,341724,78427,420151
290195,201706,282,153,129,143361,120873,264234
290200,201706,292,248,44,232376,41228,273604
290205,201706,137,79,58,74023,54346,128369
290210,201706,1077,789,288,738169.6,269856,1008025.6
290220,201706,219,120,99,111971.5,92763,204734.5
290225,201706,271,102,169,95574,158353,253927
290230,201706,63,40,23,37480,21551,59031
290240,201706,304,124,180,115906.9,168660,284566.9
290250,201706,256,229,27,213702,25299,239001
290260,201706,257,219,38,204454,35606,240060
290265,201706,181,146,35,135999,32795,168794
290270,201706,1361,1111,250,1038899,233403,1272302
290280,201706,462,342,120,320454,112440,432894
290290,201706,1151,661,490,615855.61,459130,1074985.61
290300,201706,453,384,69,359288.07,64653,423941.07
290310,201706,317,139,178,130243,166786,297029
290320,201706,3850,2408,1442,2253642.46,1348343.5,3601985.96
290323,201706,180,156,24,145891,22488,168379
290327,201706,140,110,30,102802.96,28110,130912.96
290330,201706,63,34,29,31858,27173,59031
290340,201706,908,357,551,333513.88,515664.79,849178.67
290350,201706,547,327,220,306399,206140,512539
290360,201706,358,269,89,250179.86,83393,333572.86
290370,201706,1003,371,632,347346,592184,939530
290380,201706,295,179,116,167723,108692,276415
290390,201706,2435,1508,927,1409139.57,866725,2275864.57
290395,201706,237,131,106,122513,99322,221835
290400,201706,280,205,75,191523,70275,261798
290405,201706,252,215,37,201455,34669,236124
290410,201706,536,457,79,425258.9,74023,499281.9
290420,201706,225,173,52,162101,48724,210825
290430,201706,507,315,192,295155,179904,475059
290440,201706,72,63,9,59031,7808.3,66839.3
290450,201706,230,177,53,165849,49661,215510
290460,201706,1819,1074,745,1005419.52,697878.56,1703298.08
290470,201706,1441,600,841,560788.17,787705.08,1348493.25
290475,201706,580,544,36,509026,33732,542758
290480,201706,283,154,129,144298,120873,265171
290485,201706,205,191,14,178874,13118,191992
290490,201706,1088,780,308,730110.4,287659.6,1017770.0
290500,201706,650,322,328,301714,307336,609050
290510,201706,210,156,54,145236,50594,195830
290515,201706,126,71,55,66527,51535,118062
290520,201706,1321,838,483,783613.61,448796.7,1232410.31
290530,201706,309,283,26,265171,24362,289533
290540,201706,91,56,35,52472,32795,85267
290550,201706,152,130,22,121810,20267.31,142077.31
290560,201706,3356,1338,2018,1252685.04,1890675.4,3143360.44
290570,201706,5606,2855,2751,2671296.69,2575105.39,5246402.08
290580,201706,1220,692,528,646946.97,494736,1141682.97
290590,201706,524,432,92,403754,86204,489958
290600,201706,1673,1164,509,1087015.08,476651.9,1563666.98
290610,201706,219,197,22,184040,20614,204654
290620,201706,310,271,39,253927,36543,290470
290630,201706,2091,886,1205,826435,1123561.47,1949996.47
290640,201706,146,118,28,110566,26236,136802
290650,201706,1647,766,881,716796.42,825497,1542293.42
290660,201706,262,212,50,198644,46850,245494
290670,201706,969,514,455,481337,425980.9,907317.9
290680,201706,1136,924,212,864851,197707,1062558
290682,201706,279,204,75,190034.15,70256.63,260290.78
290685,201706,227,145,82,134928,76834,211762
290687,201706,902,596,306,555125.7,284726.29,839851.99
290689,201706,112,67,45,62765,42150.95,104915.95
290690,201706,683,282,401,264225,374865.03,639090.03
290700,201706,257,120,137,112440,128369,240809
290710,201706,670,435,235,407595,220195,627790
290720,201706,1015,829,186,776773,173813.5,950586.5
290730,201706,1122,638,484,595978.85,452571,1048549.85
290740,201706,15,11,4,10307,3748,14055
290750,201706,1317,592,725,553113.73,677251.06,1230364.79
290755,201706,69,61,8,57157,7496,64653
290760,201706,303,266,37,249242,34669,283911
290770,201706,184,173,11,162091.63,10307,172398.63
290780,201706,928,745,183,696156.23,169690.7,865846.93
290790,201706,430,290,140,271161,131180,402341
290800,201706,2620,1037,1583,968601.07,1482174.71,2450775.78
290810,201706,432,299,133,279882,124621,404503
290820,201706,365,224,141,208937,132117,341054
290830,201706,386,257,129,240809,120873,361682
290840,201706,1605,980,625,916714.4,582645.44,1499359.84
290850,201706,735,405,330,378454.3,308273,686727.3
290860,201706,654,289,365,270793,341724,612517
290870,201706,656,476,180,445175,168660,613835
290880,201706,124,68,56,63716,52472,116188
290890,201706,362,261,101,244557,94637,339194
290900,201706,167,129,38,120873,35606,156479
290910,201706,362,276,86,258612,80582,339194
290920,201706,230,190,40,178030,37480,215510
290930,201706,788,600,188,561422.29,176156,737578.29
290940,201706,252,205,47,191335.4,44039,235374.4
290950,201706,166,93,73,87141,68401,155542
290960,201706,426,283,143,263953.72,133709.9,397663.62
290970,201706,245,216,29,202204.6,27173,229377.6
290980,201706,1446,1021,425,952602.02,397195.1,1349797.12
290990,201706,362,302,60,282965,56164.89,339129.89
291000,201706,840,234,606,219258,567540.9,786798.9
291005,201706,1951,832,1119,777841.28,1048489.32,1826330.60
291010,201706,157,144,13,134928,12181,147109
291020,201706,99,80,19,74960,17803,92763
291030,201706,88,66,22,61842,20614,82456
291040,201706,573,286,287,267972.63,268919,536891.63
291050,201706,1250,706,544,660250.92,509728,1169978.92
291060,201706,1455,783,672,733015.1,629664,1362679.1
291070,201706,1864,1375,489,1282801.5,454550.18,1737351.68
291072,201706,7158,2613,4545,2445599.28,4256120.7,6701719.98
291075,201706,194,156,38,146172,35606,181778
291077,201706,48,33,15,30921,14055,44976
291080,201706,18708,8170,10538,7634922.89,9861609.92,17496532.81
291085,201706,280,226,54,211762,50593.32,262355.32
291090,201706,311,113,198,105600,185516.63,291116.63
291100,201706,731,214,517,200518,484419.63,684937.63
291110,201706,392,300,92,281100,86204,367304
291120,201706,2494,1151,1343,1078347,1256443.08,2334790.08
291125,201706,56,30,26,28110,24362,52472
291130,201706,206,178,28,166786,26236,193022
291140,201706,119,86,33,80582,30921,111503
291150,201706,371,150,221,140550,207077,347627
291160,201706,332,280,52,261423.25,48724,310147.25
291165,201706,13,10,3,9370,2811,12181
291170,201706,2772,1401,1371,1310301.45,1282191,2592492.45
291180,201706,1304,488,816,457118,764538,1221656
291185,201706,66,63,3,59031,2811,61842
291190,201706,1207,506,701,472616.5,656303.9,1128920.4
291200,201706,157,113,44,105881,41228,147109
291210,201706,2147,816,1331,761509.27,1245376.54,2006885.81
291220,201706,246,186,60,173345.43,56220,229565.43
291230,201706,1018,340,678,317737,635286,953023
291240,201706,441,416,25,388574,23425,411999
291250,201706,417,341,76,319517,71212,390729
291260,201706,37,26,11,24362,10307,34669
291270,201706,1182,475,707,445075,662177.9,1107252.9
291280,201706,369,163,206,152543.6,192711.53,345255.13
291290,201706,1718,868,850,812191.6,795420,1607611.6
291300,201706,229,181,48,168941.1,44976,213917.1
291310,201706,247,220,27,205859,25299,231158
291320,201706,1368,980,388,915167.9,362526.8,1277694.7
291330,201706,126,104,22,95667.7,20614,116281.7
291340,201706,137,77,60,72149,56220,128369
291345,201706,120,81,39,75897,36543,112440
291350,201706,1536,476,1060,445262.5,993033.15,1438295.65
291360,201706,8406,4150,4256,3879572.03,3984918.28,7864490.31
291370,201706,1033,557,476,521628,446012,967640
291380,201706,257,206,51,193022,47787,240809
291390,201706,3815,1659,2156,1549828.25,2020172,3570000.25
291400,201706,2029,1445,584,1347970.79,545274.39,1893245.18
291410,201706,157,140,17,130243,15929,146172
291420,201706,99,70,29,65590,27173,92763
291430,201706,184,102,82,94878.74,75897,170775.74
291440,201706,493,397,96,369594.25,89952,459546.25
291450,201706,845,522,323,486960.54,301714,788674.54
291460,201706,1671,1353,318,1265324.8,297966,1563290.8
291465,201706,2228,1038,1190,972217.27,1114803.89,2087021.16
291470,201706,2701,1368,1333,1278097.95,1248022,2526119.95
291480,201706,11651,5162,6489,4826241.01,6070947.53,10897188.54
291490,201706,543,216,327,202392,306399,508791
291500,201706,364,190,174,178030,163038,341068
291510,201706,1266,481,785,449557.75,735263.9,1184821.65
291520,201706,959,431,528,403847,494726.63,898573.63
291530,201706,1023,271,752,253927,704324.26,958251.26
291535,201706,114,96,18,89952,16866,106818
291540,201706,357,106,251,99322,234250.8,333572.8
291550,201706,1165,538,627,502233.19,586918.9,1089152.09
291560,201706,5561,2880,2681,2686180.33,2500705.89,5186886.22
291570,201706,195,102,93,95574,87141,182715
291580,201706,1181,713,468,667338,438502.32,1105840.32
291590,201706,72,28,44,26236,41228,67464
291600,201706,1353,610,743,570633,695892,1266525
291610,201706,1258,546,712,510341.74,667089,1177430.74
291620,201706,551,250,301,234250,281521.65,515771.65
291630,201706,500,162,338,151794,316706,468500
291640,201706,3793,1872,1921,1747838.04,1798883.71,3546721.75
291650,201706,341,219,122,204088.97,114127,318215.97
291660,201706,452,181,271,168917.3,252849.45,421766.75
291670,201706,215,134,81,124996,75897,200893
291680,201706,704,393,311,368241,291314,659555
291685,201706,557,296,261,277118,244369.6,521487.6
291690,201706,552,278,274,260486,255801,516287
291700,201706,891,703,188,658711,175219,833930
291710,201706,1701,767,934,717995.34,874254.85,1592250.19
291720,201706,388,262,126,245489.32,118062,363551.32
291730,201706,905,510,395,476979.85,370105.63,847085.48
291733,201706,249,173,76,161819.9,71212,233031.9
291735,201706,65,52,13,48724,12181,60905
291740,201706,336,252,84,235421.25,78708,314129.25
291750,201706,1903,1255,648,1169486.48,605553.81,1775040.29
291760,201706,3097,1652,1445,1541404.24,1352278.5,2893682.74
291770,201706,770,524,246,488925.03,230502,719427.03
291780,201706,48,27,21,25299,19677,44976
291790,201706,170,78,92,73086,86204,159290
291800,201706,9669,3730,5939,3486578.16,5561096.2,9047674.36
291810,201706,1155,816,339,763744.22,317643,1081387.22
291820,201706,259,189,70,177093,65590,242683
291830,201706,1040,375,665,350176,622159,972335
291835,201706,631,571,60,534559,56220,590779
291840,201706,4518,2296,2222,2146635.62,2080877.88,4227513.50
291845,201706,315,108,207,101196,193949.63,295145.63
291850,201706,316,275,41,257440.75,38417,295857.75
291855,201706,260,105,155,98385,145235,243620
291860,201706,211,127,84,118063,78708,196771
291870,201706,78,31,47,29047,44039,73086
291875,201706,176,159,17,148983,15929,164912
291880,201706,478,375,103,350579,96511,447090
291890,201706,244,81,163,75887.63,151044.5,226932.13
291900,201706,57,31,26,29047,24362,53409
291905,201706,139,90,49,84049,45913,129962
291910,201706,181,144,37,134928,34669,169597
291915,201706,380,337,43,314131,40291,354422
291920,201706,4693,2419,2274,2264242.71,2129097.34,4393340.05
291930,201706,181,103,78,95574.7,73086,168660.7
291940,201706,301,165,136,153640.39,126804.21,280444.60
291950,201706,1108,911,197,851922,184589,1036511
291955,201706,917,542,375,507854,351375,859229
291960,201706,168,112,56,104944,52472,157416
291970,201706,789,596,193,558452,180841,739293
291980,201706,1481,1311,170,1225055.79,158353.7,1383409.49
291990,201706,120,112,8,104944,7496,112440
291992,201706,154,76,78,70462.4,73086,143548.4
291995,201706,142,100,42,93700,39354,133054
292000,201706,374,275,99,256218.37,92763,348981.37
292010,201706,278,204,74,190492.1,68401,258893.1
292020,201706,263,191,72,178967,67464,246431
292030,201706,136,105,31,98385,29047,127432
292040,201706,605,302,303,282974,283911,566885
292045,201706,82,75,7,70275,6559,76834
292050,201706,873,583,290,545280.26,271730,817010.26
292060,201706,920,768,152,717743.59,142424,860167.59
292070,201706,53,23,30,21551,28110,49661
292080,201706,111,75,36,70275,33732,104007
292090,201706,473,162,311,151586.49,291407,442993.49
292100,201706,1338,560,778,523174.35,727731.26,1250905.61
292105,201706,199,168,31,157416,29047,186463
292110,201706,2065,760,1305,711801.42,1220513.68,1932315.10
292120,201706,614,496,118,463639.96,110566,574205.96
292130,201706,436,255,181,238935,169597,408532
292140,201706,195,154,41,144298,38287.61,182585.61
292145,201706,151,78,73,73086,68372.9,141458.9
292150,201706,1381,1106,275,1036322,256665.57,1292987.57
292160,201706,180,148,32,138394.9,29984,168378.9
292170,201706,1213,1066,147,997460.23,137682.78,1135143.01
292180,201706,189,138,51,129306,47787,177093
292190,201706,160,97,63,90889,59031,149920
292200,201706,1240,448,792,418841.24,741467.68,1160308.92
292205,201706,114,103,11,96229.9,10307,106536.9
292210,201706,350,240,110,223522,102367.25,325889.25
292220,201706,24,17,7,15929,6559,22488
292225,201706,38,33,5,30921,4685,35606
292230,201706,864,704,160,657255.72,149920,807175.72
292240,201706,605,421,184,393400,172408,565808
292250,201706,1610,1013,597,949181,559389,1508570
292260,201706,438,240,198,224880,184776.4,409656.4
292265,201706,276,190,86,177748.9,80582,258330.9
292270,201706,778,334,444,312302.1,415091.4,727393.5
292273,201706,196,113,83,105117.34,77771,182888.34
292275,201706,156,75,81,70275,75615.9,145890.9
292280,201706,134,93,41,87141,38417,125558
292285,201706,57,48,9,44320.1,8433,52753.1
292290,201706,494,323,171,300206.01,159946,460152.01
292300,201706,1585,604,981,565385.9,917476.99,1482862.89
292303,201706,87,59,28,55283,26236,81519
292305,201706,102,71,31,66527,29047,95574
292310,201706,814,499,315,467208,292874.13,760082.13
292320,201706,639,479,160,448541.9,149920,598461.9
292330,201706,195,96,99,89952,92763,182715
292335,201706,267,201,66,188337,61842,250179
292340,201706,551,376,175,351585.93,163975,515560.93
292350,201706,245,129,116,120076.55,108410.9,228487.45
292360,201706,689,520,169,485553.5,158353,643906.5
292370,201706,783,593,190,555641,178030,733671
292380,201706,637,490,147,458193.51,137739,595932.51
292390,201706,501,186,315,174282,293421.75,467703.75
292400,201706,3281,2013,1268,1867347.64,1184305,3051652.64
292405,201706,255,167,88,156010.5,82174.9,238185.4
292410,201706,155,91,64,85267,59968,145235
292420,201706,303,259,44,242401.9,41228,283629.9
292430,201706,488,392,96,367304,89483.5,456787.5
292440,201706,569,482,87,449760,81519,531279
292450,201706,243,187,56,175219,52472,227691
292460,201706,586,429,157,401410.9,146406.25,547817.15
292465,201706,177,151,26,141487,23637.24,165124.24
292467,201706,92,52,40,48724,37480,86204
292470,201706,243,162,81,151794,75897,227691
292480,201706,293,195,98,181778.75,91826,273604.75
292490,201706,225,146,79,136802,74023,210825
292500,201706,1180,505,675,472978,632306.35,1105284.35
292510,201706,3227,1433,1794,1341784.36,1678018.25,3019802.61
292520,201706,1011,478,533,446710.75,499403,946113.75
292525,201706,372,260,112,243615.32,104944,348559.32
292530,201706,4110,1676,2434,1568353.4,2278476.3,3846829.7
292540,201706,482,253,229,237061,214573,451634
292550,201706,1035,550,485,514601.86,453985.01,968586.87
292560,201706,318,297,21,278289,19677,297966
292570,201706,291,222,69,207691,64653,272344
292575,201706,451,276,175,258331,163975,422306
292580,201706,883,554,329,517692.5,307710.9,825403.4
292590,201706,512,439,73,411045.98,68401,479446.98
292593,201706,139,109,30,102133,28110,130243
292595,201706,165,123,42,115251,39354,154605
292600,201706,1224,912,312,854232,292344,1146576
292610,201706,118,90,28,83861.5,25983.01,109844.51
292620,201706,506,417,89,390439,83393,473832
292630,201706,1320,762,558,712434.5,519567.3,1232001.8
292640,201706,753,523,230,490051,215510,705561
292650,201706,188,163,25,152731,23425,176156
292660,201706,1963,1392,571,1298585.02,530056.96,1828641.98
292665,201706,128,93,35,87141,32795,119936
292670,201706,367,311,56,291403,52472,343875
292680,201706,241,186,55,174282,51535,225817
292690,201706,175,132,43,123684,40291,163975
292700,201706,903,588,315,550019.9,294873.9,844893.8
292710,201706,96,84,12,78708,10963,89671
292720,201706,810,454,356,424610.92,333385,757995.92
292730,201706,210,100,110,92763.75,103070,195833.75
292740,201706,63937,31560,32377,29500655.42,30309606.13,59810261.55
292750,201706,376,265,111,247368.07,103211.01,350579.08
292760,201706,311,244,67,227635.25,62779,290414.25
292770,201706,785,335,450,312231.03,418781.64,731012.67
292780,201706,418,157,261,146885.53,244557,391442.53
292790,201706,720,347,373,325139,349266.75,674405.75
292800,201706,1093,668,425,624979,398225,1023204
292805,201706,421,125,296,116487.41,277352,393839.41
292810,201706,1435,838,597,784643.9,559379.63,1344023.53
292820,201706,740,595,145,555642.3,135574.9,691217.2
292830,201706,105,80,25,74960,23425,98385
292840,201706,633,523,110,489583,103055.95,592638.95
292850,201706,133,87,46,81515,43102,124617
292860,201706,2027,1187,840,1107754.07,787080,1894834.07
292870,201706,3280,2202,1078,2062268.9,1010076.63,3072345.53
292880,201706,1401,920,481,858340.33,450697,1309037.33
292890,201706,453,390,63,365402,59031,424433
292895,201706,133,90,43,82995.71,40291,123286.71
292900,201706,379,281,98,263297,91826,355123
292905,201706,443,222,221,208014,206890,414904
292910,201706,382,297,85,277962,79645,357607
292920,201706,524,235,289,220195,270793,490988
292925,201706,516,478,38,447220.73,35371.75,482592.48
292930,201706,548,338,210,316706,196770,513476
292935,201706,297,125,172,117125,161164,278289
292937,201706,226,150,76,140550,71212,211762
292940,201706,189,143,46,133991,43102,177093
292950,201706,1063,550,513,513337.05,479745,993082.05
292960,201706,514,344,170,322328,159290,481618
292970,201706,284,197,87,183934,81519,265453
292975,201706,158,89,69,83393,64466,147859
292980,201706,253,173,80,160349.42,74960,235309.42
292990,201706,1277,940,337,874119.74,315585.26,1189705.00
293000,201706,102,76,26,71212,24352.63,95564.63
293010,201706,2579,1596,983,1490857.92,916762.7,2407620.62
293015,201706,642,506,136,473841,126805,600646
293020,201706,339,276,63,258612,59031,317643
293030,201706,630,548,82,511977.82,76834,588811.82
293040,201706,337,264,73,247368,68401,315769
293050,201706,2623,1537,1086,1431248.13,1013525.39,2444773.52
293060,201706,247,197,50,184589,45913.4,230502.4
293070,201706,3218,1603,1615,1495238.34,1512065.63,3007303.97
293075,201706,88,56,32,52472,29984,82456
293076,201706,73,44,29,41228,27173,68401
293077,201706,414,251,163,230581.43,152731,383312.43
293080,201706,460,400,60,374800,56220,431020
293090,201706,131,111,20,104007,18427.7,122434.7
293100,201706,493,350,143,327950,133991,461941
293105,201706,328,222,106,207733,99322,307055
293110,201706,168,118,50,110566,46850,157416
293120,201706,315,213,102,199581,95386.6,294967.6
293130,201706,243,160,83,149920,77771,227691
293135,201706,7648,3043,4605,2844595.47,4308017.26,7152612.73
293140,201706,177,116,61,108692,56408,165100
293150,201706,326,282,44,262829.1,41228,304057.1
293160,201706,429,238,191,223006,178685.9,401691.9
293170,201706,175,124,51,115906.9,46944,162850.9
293180,201706,446,301,145,281756,135865,417621
293190,201706,1252,865,387,805940.98,362541,1168481.98
293200,201706,513,453,60,423400,56220,479620
293210,201706,333,246,87,230353,80816.25,311169.25
293220,201706,2721,1083,1638,1013593.45,1532464.55,2546058.00
293230,201706,1771,634,1137,592653.9,1065369,1658022.9
293240,201706,220,202,18,189274,16866,206140
293245,201706,111,92,19,86204,17803,104007
293250,201706,741,273,468,255165.24,438235,693400.24
293260,201706,306,255,51,237405.49,47787,285192.49
293270,201706,1178,558,620,520973.48,580940,1101913.48
293280,201706,225,125,100,117125,93700,210825
293290,201706,3038,1977,1061,1851512.5,993863,2845375.5
293300,201706,667,475,192,443252.79,179107.55,622360.34
293305,201706,163,136,27,127432,25299,152731
293310,201706,137,103,34,96511,31858,128369
293315,201706,149,115,34,107755,31858,139613
293317,201706,94,67,27,62779,25299,88078
293320,201706,921,522,399,488177.25,373859,862036.25
293325,201706,188,68,120,63716,112421.26,176137.26
293330,201706,12420,5756,6664,5381974.79,6238037.88,11620012.67
293340,201706,243,174,69,163038,63716,226754
293345,201706,239,189,50,177093,46850,223943
293350,201706,624,316,308,296092,287143.65,583235.65
293360,201706,1530,1089,441,1019175,411999.35,1431174.35
310010,201706,156,79,77,74023,71587,145610
310020,201706,1038,574,464,535339.55,432613.26,967952.81
310030,201706,329,265,64,246637.94,59686.9,306324.84
310040,201706,50,32,18,29984,16866,46850
310050,201706,186,120,66,111503.2,61842,173345.2
310060,201706,237,163,74,152731,69338,222069
310070,201706,18,9,9,8433,8433,16866
310080,201706,51,27,24,25299,22488,47787
310090,201706,925,477,448,442078.14,418370.8,860448.94
310100,201706,287,217,70,203329,65590,268919
310110,201706,732,390,342,364394.09,319517,683911.09
310120,201706,373,211,162,197051.1,151426.61,348477.71
310130,201706,34,21,13,19677,12181,31858
310140,201706,31,17,14,15929,13118,29047
310150,201706,1270,880,390,819503.06,364867.9,1184370.96
310160,201706,2129,1084,1045,1008964.05,976447.8,1985411.85
310163,201706,83,48,35,44976,32795,77771
310170,201706,2509,1014,1495,949716,1398004.3,2347720.3
310180,201706,116,43,73,40291,68026.2,108317.2
310190,201706,472,311,161,291407,150270.95,441677.95
310200,201706,508,318,190,297966,177749,475715
310205,201706,55,42,13,39354,12181,51535
310210,201706,286,228,58,213636,54346,267982
310220,201706,50,29,21,27173,19677,46850
310230,201706,262,184,78,172220.6,73086,245306.6
310240,201706,101,89,12,83393,11244,94637
310250,201706,99,81,18,75897,16866,92763
310260,201706,809,426,383,396539.35,358149.51,754688.86
310270,201706,267,177,90,165306,84330,249636
310280,201706,360,268,92,249524.1,86204,335728.1
310285,201706,214,153,61,143058.35,57157,200215.35
310290,201706,250,145,105,135865,98385,234250
310300,201706,150,124,26,116188,24362,140550
310310,201706,5,4,1,3748,937,4685
310320,201706,23,15,8,14055,7496,21551
310330,201706,32,23,9,21551,8433,29984
310340,201706,1655,1042,613,967813.35,572882.25,1540695.60
310350,201706,2765,1497,1268,1397961.85,1187131.75,2585093.60
310360,201706,42,34,8,31858,7496,39354
310370,201706,120,98,22,91826,20333,112159
310375,201706,108,38,70,35606,65572,101178
310380,201706,50,29,21,27173,19677,46850
310390,201706,101,70,31,65590,29047,94637
310400,201706,2227,1421,806,1327636.9,754922.9,2082559.8
310410,201706,124,67,57,62779,53409,116188
310420,201706,657,356,301,332729.1,281091.43,613820.53
310430,201706,327,214,113,200236.9,105881,306117.9
310440,201706,56,36,20,33732,18740,52472
310445,201706,80,65,15,60905,14055,74960
310450,201706,849,530,319,495142.1,298903,794045.1
310460,201706,268,187,81,175219,75897,251116
310470,201706,494,309,185,289533,173345,462878
310480,201706,88,61,27,57157,25299,82456
310490,201706,477,224,253,208951.1,237061,446012.1
310500,201706,121,54,67,50598,62779,113377
310510,201706,616,396,220,369830.8,206121.63,575952.43
310520,201706,131,85,46,79645,43102,122747
310530,201706,84,40,44,37480,40946.9,78426.9
310540,201706,447,279,168,259082.3,157416,416498.3
310550,201706,76,52,24,48724,22488,71212
310560,201706,2834,1966,868,1831790.75,811718.42,2643509.17
310570,201706,160,103,57,96511,53409,149920
310590,201706,335,223,112,208530,104944,313474
310600,201706,158,95,63,87281.85,59031,146312.85
310610,201706,59,22,37,20614,34669,55283
310620,201706,44413,21234,23179,19821629.62,21682018.51,41503648.13
310630,201706,565,360,205,335072.05,190804.71,525876.76
310640,201706,133,111,22,103819.6,20614,124433.6
310650,201706,156,137,19,127432,17803,145235
310660,201706,91,56,35,52472,32795,85267
310665,201706,48,34,14,31858,13118,44976
310670,201706,6145,2880,3265,2692265.31,3053845.55,5746110.86
310680,201706,52,35,17,32795,15929,48724
310690,201706,561,408,153,378166.73,143361,521527.73
310700,201706,67,43,24,40291,22488,62779
310710,201706,1240,826,414,773343.95,387637,1160980.95
310720,201706,86,29,57,27173,53409,80582
310730,201706,1331,919,412,860822,386044,1246866
310740,201706,1002,565,437,527344.2,409225.63,936569.83
310750,201706,246,146,100,135865.29,93700,229565.29
310760,201706,68,52,16,48724,14992,63716
310770,201706,86,44,42,41228,39354,80582
310780,201706,412,335,77,313886,72149,386035
310790,201706,97,78,19,73086,17803,90889
310800,201706,453,216,237,201923.5,221778.53,423702.03
310810,201706,162,113,49,105497,44976,150473
310820,201706,374,293,81,274541,75615.9,350156.9
310825,201706,184,150,34,140550,31858,172408
310830,201706,465,222,243,207365.61,226472.9,433838.51
310840,201706,392,224,168,209888,157134.9,367022.9
310850,201706,108,88,20,82456,18740,101196
310855,201706,378,299,79,280163,74023,354186
310860,201706,1355,1018,337,949703.45,314064.95,1263768.40
310870,201706,54,43,11,40291,10307,50598
310880,201706,79,60,19,55938.9,17803,73741.9
310890,201706,310,185,125,173345,117125,290470
310900,201706,641,290,351,269354.95,328587.9,597942.85
310910,201706,241,165,76,153294.1,71212,224506.1
310920,201706,498,295,203,272668.2,189274.7,461942.9
310925,201706,24,19,5,17803,4404,22207
310930,201706,1096,651,445,609587.1,416870.88,1026457.98
310940,201706,680,348,332,325485.9,311084,636569.9
310945,201706,122,75,47,70275,44039,114314
310950,201706,257,201,56,188337,52472,240809
310960,201706,85,30,55,28110,51531,79641
310970,201706,170,104,66,97448,60936.2,158384.2
310980,201706,39,20,19,18740,17803,36543
310990,201706,154,86,68,80179,63716,143895
311000,201706,810,417,393,387919.9,368232,756151.9
311010,201706,40,33,7,30921,6559,37480
311020,201706,38,24,14,22488,13118,35606
311030,201706,396,229,167,212700,156479,369179
311040,201706,37,32,5,29984,4685,34669
311050,201706,461,194,267,181216,249616.8,430832.8
311060,201706,751,441,310,411812.2,290470,702282.2
311070,201706,318,143,175,133991,163975,297966
311080,201706,110,57,53,53409,49661,103070
311090,201706,394,181,213,169597,199581,369178
311100,201706,607,365,242,342005,226472.9,568477.9
311110,201706,648,441,207,413217,193950,607167
311115,201706,62,46,16,42821,14992,57813
311120,201706,996,521,475,486253.4,444466.05,930719.45
311130,201706,411,238,173,222818.6,162101,384919.6
311140,201706,157,72,85,67464,78848.55,146312.55
311150,201706,347,223,124,208834,115953.75,324787.75
311160,201706,741,533,208,497547.7,194428,691975.7
311170,201706,73,51,22,47787,20332.9,68119.9
311180,201706,339,221,118,206795.9,110285,317080.9
311190,201706,36,21,15,19677,14055,33732
311200,201706,350,241,109,224224.3,102133,326357.3
311205,201706,29,19,10,17568.75,8995.2,26563.95
311210,201706,48,41,7,38417,6559,44976
311220,201706,11,10,1,9370,937,10307
311230,201706,1609,1035,574,966724.65,537838,1504562.65
311240,201706,165,101,64,94637,59968,154605
311250,201706,64,30,34,28110,31858,59968
311260,201706,557,340,217,318580,203329,521909
311265,201706,106,72,34,67464,31858,99322
311270,201706,276,190,86,178030,80582,258612
311280,201706,216,99,117,92763,109066.8,201829.8
311290,201706,108,87,21,81238,19115,100353
311300,201706,548,342,206,319517.88,192741,512258.88
311310,201706,23,19,4,17803,3748,21551
311320,201706,660,488,172,456319,161164,617483
311330,201706,1006,746,260,698674.75,242683.7,941358.45
311340,201706,2558,1824,734,1701371.82,687074.83,2388446.65
311350,201706,271,211,60,197707,56220,253927
311360,201706,173,108,65,101196,60905,162101
311370,201706,1169,457,712,426208.25,666300.7,1092508.95
311380,201706,7,6,1,5622,937,6559
311390,201706,284,152,132,142424,123215.6,265639.6
311400,201706,149,97,52,90889,48715,139604
311410,201706,92,53,39,49661,36543,86204
311420,201706,291,163,128,150201.1,119936,270137.1
311430,201706,843,549,294,512447.1,275478,787925.1
311440,201706,486,340,146,317643.4,136520.9,454164.3
311450,201706,314,193,121,180841,113377,294218
311455,201706,303,205,98,191794.9,91544.9,283339.8
311460,201706,129,52,77,48724,71169.83,119893.83
311470,201706,20,11,9,10307,8433,18740
311480,201706,24,7,17,6559,15929,22488
311490,201706,17,10,7,9370,6559,15929
311500,201706,19,8,11,7496,10307,17803
311510,201706,624,427,197,399162,184307.9,583469.9
311520,201706,43,32,11,29328.1,10307,39635.1
311530,201706,1816,1352,464,1258956.81,434768,1693724.81
311535,201706,63,49,14,45913,13118,59031
311540,201706,34,29,5,27173,4685,31858
311545,201706,183,138,45,129306,42165,171471
311547,201706,31,22,9,20614,8433,29047
311550,201706,580,266,314,249242,294199.63,543441.63
311560,201706,42,28,14,26236,13118,39354
311570,201706,306,197,109,184026.8,102133,286159.8
311580,201706,287,162,125,151512.9,117125,268637.9
311590,201706,34,29,5,27173,4685,31858
311600,201706,87,70,17,65590,15929,81519
311610,201706,256,222,34,206764.95,31858,238622.95
311615,201706,85,70,15,64962.21,14055,79017.21
311620,201706,16,11,5,10307,4685,14992
311630,201706,77,64,13,59968,12181,72149
311640,201706,117,67,50,62779,46850,109629
311650,201706,124,91,33,84564.25,30921,115485.25
311660,201706,392,185,207,173345,193959,367304
311670,201706,159,102,57,95022,53409,148431
311680,201706,220,161,59,149198.94,54533.4,203732.34
311690,201706,16,9,7,8433,6559,14992
311700,201706,201,136,65,127150.9,60905,188055.9
311710,201706,218,140,78,131051,73086,204137
311720,201706,33,26,7,24362,6559,30921
311730,201706,526,349,177,326451,165849,492300
311740,201706,30,20,10,18740,9370,28110
311750,201706,704,482,222,449760.4,208014,657774.4
311760,201706,64,37,27,34669,25299,59968
311770,201706,396,187,209,173345.61,195833,369178.61
311780,201706,172,100,72,93700,67152,160852
311783,201706,73,64,9,59968,8433,68401
311787,201706,31,13,18,12181,16866,29047
311790,201706,263,127,136,118999,127432,246431
311800,201706,621,427,194,396774.15,181778,578552.15
311810,201706,41,35,6,32795,5622,38417
311820,201706,106,88,18,82456,16866,99322
311830,201706,1823,1177,646,1098371.95,602023.4,1700395.35
311840,201706,986,539,447,500827.95,417095.66,917923.61
311850,201706,6,3,3,2811,2811,5622
311860,201706,9137,4258,4879,3976499.6,4564993.41,8541493.01
311870,201706,160,87,73,81519,68401,149920
311880,201706,946,704,242,658420.9,226754,885174.9
311890,201706,223,114,109,106818,102133,208951
311900,201706,86,36,50,33732,46850,80582
311910,201706,1357,848,509,791719.05,474731.15,1266450.20
311920,201706,232,150,82,140316,76834,217150
311930,201706,896,515,381,482274,356657.68,838931.68
311940,201706,2324,1169,1155,1092496.25,1079471.05,2171967.30
311950,201706,18,12,6,11244,5622,16866
311960,201706,68,48,20,44976,18740,63716
311970,201706,27,15,12,12508.95,11244,23752.95
311980,201706,42,31,11,29047,10307,39354
311990,201706,59,45,14,42165,13118,55283
311995,201706,64,44,20,41228,18740,59968
312000,201706,32,22,10,20332.9,9370,29702.9
312010,201706,85,60,25,56220,23425,79645
312015,201706,90,67,23,62498,21551,84049
312020,201706,143,90,53,84330,49661,133991
312030,201706,37,32,5,29329,4685,34014
312040,201706,76,49,27,45913,25299,71212
312050,201706,226,117,109,109629,102133,211762
312060,201706,71,47,24,44039,21832.1,65871.1
312070,201706,78,44,34,41228,31858,73086
312080,201706,510,211,299,197707,280163,477870
312083,201706,46,34,12,31858,11244,43102
312087,201706,101,79,22,74023,20614,94637
312090,201706,2710,1503,1207,1394822.85,1127515.62,2522338.47
312100,201706,164,115,49,107755,45145,152900
312110,201706,121,81,40,75897,37480,113377
312120,201706,145,105,40,98385,37480,135865
312125,201706,92,49,43,45725.6,40291,86016.6
312130,201706,123,81,42,75897,39354,115251
312140,201706,135,106,29,99322,27173,126495
312150,201706,43,34,9,31858,8433,40291
312160,201706,1509,1004,505,937937.7,471236.24,1409173.94
312170,201706,11,9,2,8433,1874,10307
312180,201706,133,87,46,80582.75,42821,123403.75
312190,201706,33,30,3,28110,2811,30921
312200,201706,700,605,95,565245.35,89015,654260.35
312210,201706,96,61,35,57157,32795,89952
312220,201706,119,86,33,80348,30921,111269
312230,201706,3377,1674,1703,1564257.89,1594121.12,3158379.01
312235,201706,132,87,45,81519,42165,123684
312240,201706,112,73,39,68401,36543,104944
312245,201706,155,104,51,97444,47787,145231
312247,201706,53,37,16,33920,14992,48912
312250,201706,175,85,90,79177,84330,163507
312260,201706,94,65,29,60062.6,27173,87235.6
312270,201706,138,85,53,79645,49661,129306
312280,201706,26,16,10,14992,9370,24362
312290,201706,157,109,48,101851.9,44040,145891.9
312300,201706,195,130,65,121810,60905,182715
312310,201706,58,53,5,49661,4685,54346
312320,201706,422,257,165,238935,153340.25,392275.25
312330,201706,89,78,11,72337,10025.9,82362.9
312340,201706,34,14,20,13118,18740,31858
312350,201706,17,11,6,10307,5622,15929
312352,201706,94,66,28,61842,26236,88078
312360,201706,557,258,299,240809,279507.1,520316.1
312370,201706,281,167,114,156197.9,106818,263015.9
312380,201706,137,87,50,81519,46850,128369
312385,201706,181,146,35,136802,32795,169597
312390,201706,292,187,105,175219,97730,272949
312400,201706,368,275,93,257675,86673,344348
312410,201706,832,270,562,252521.5,526028,778549.5
312420,201706,593,479,114,448823,106818,555641
312430,201706,847,627,220,584924.94,205203.1,790128.04
312440,201706,45,32,13,29984,12181,42165
312450,201706,208,131,77,122747,72149,194896
312460,201706,54,25,29,23425,27173,50598
312470,201706,52,34,18,31858,16866,48724
312480,201706,218,135,83,126495,77489.9,203984.9
312490,201706,244,168,76,157416,71212,228628
312500,201706,31,17,14,15929,13118,29047
312510,201706,416,160,256,149920,239267.36,389187.36
312520,201706,41,15,26,14055,24362,38417
312530,201706,45,35,10,32795,9370,42165
312540,201706,99,87,12,81519,11244,92763
312550,201706,35,27,8,25299,7496,32795
312560,201706,190,138,52,129025,48442.9,177467.9
312570,201706,430,256,174,239497.2,162359.23,401856.43
312580,201706,83,44,39,41228,36543,77771
312590,201706,275,219,56,204127,52472,256599
312595,201706,144,131,13,122747,12181,134928
312600,201706,77,47,30,43618,28110,71728
312610,201706,1608,833,775,775276.29,724395.3,1499671.59
312620,201706,183,128,55,119936,51535,171471
312630,201706,67,54,13,50598,12181,62779
312640,201706,49,15,34,14055,31858,45913
312650,201706,144,117,27,109348,25299,134647
312660,201706,62,46,16,42821,14992,57813
312670,201706,853,560,293,523174.95,274331.15,797506.10
312675,201706,41,31,10,29047,9370,38417
312680,201706,81,54,27,50223.2,25299,75522.2
312690,201706,241,128,113,119926.63,105599.9,225526.53
312695,201706,27,21,6,19677,5622,25299
312700,201706,186,104,82,97448,76834,174282
312705,201706,70,59,11,55283,10025.9,65308.9
312707,201706,89,65,24,60905,22488,83393
312710,201706,1844,981,863,917736,808423,1726159
312720,201706,62,32,30,29984,28110,58094
312730,201706,294,173,121,161164,113095.9,274259.9
312733,201706,46,41,5,38417,4685,43102
312735,201706,20,15,5,14055,4685,18740
312737,201706,74,38,36,35606,33732,69338
312738,201706,49,34,15,31858,14055,45913
312740,201706,70,50,20,46850,18740,65590
312750,201706,72,52,20,48724,18740,67464
312760,201706,273,197,76,184589,71212,255801
312770,201706,7544,3468,4076,3225489.64,3812763.57,7038253.21
312780,201706,438,341,97,319235.9,90889,410124.9
312790,201706,19,15,4,14055,3748,17803
312800,201706,1609,1125,484,1047527.98,452347.11,1499875.09
312810,201706,371,236,135,221132,126495,347627
312820,201706,190,143,47,133991,44039,178030
312825,201706,26,17,9,15929,8433,24362
312830,201706,287,167,120,155543,111813,267356
312840,201706,147,108,39,101196,36543,137739
312850,201706,22,19,3,17803,2811,20614
312860,201706,172,107,65,99978,60905,160883
312870,201706,983,509,474,474840.6,444138,918978.6
312880,201706,148,103,45,96370.45,42071.3,138441.75
312890,201706,161,108,53,101196,49661,150857
312900,201706,212,157,55,146453.1,51535,197988.1
312910,201706,187,92,95,85054.66,89015,174069.66
312920,201706,154,86,68,80582,63716,144298
312930,201706,341,246,95,230502,89015,319517
312940,201706,102,67,35,62779,32795,95574
312950,201706,684,441,243,411905.3,227691,639596.3
312960,201706,177,133,44,124621,41228,165849
312965,201706,44,39,5,36543,4685,41228
312970,201706,283,227,56,211528.1,52472,264000.1
312980,201706,2226,1204,1022,1123737.7,957047.8,2080785.5
312990,201706,48,27,21,25299,19677,44976
313000,201706,39,26,13,24362,12181,36543
313005,201706,162,125,37,116150.75,34388,150538.75
313010,201706,913,372,541,347627.1,506626.9,854254.0
313020,201706,196,101,95,94637,89015,183652
313030,201706,203,128,75,119000,70275,189275
313040,201706,53,20,33,18740,30921,49661
313050,201706,294,205,89,191148.1,83393,274541.1
313055,201706,42,29,13,27173,12181,39354
313060,201706,120,82,38,76385,35324.9,111709.9
313065,201706,58,36,22,33732,20614,54346
313070,201706,156,83,73,77771,68401,146172
313080,201706,39,16,23,14992,21551,36543
313090,201706,699,476,223,444044.4,208951,652995.4
313100,201706,172,64,108,59968,101188,161156
313110,201706,114,67,47,62779,44039,106818
313115,201706,137,74,63,69141.23,58094,127235.23
313120,201706,729,400,329,374519,306774,681293
313130,201706,4959,2654,2305,2468445.97,2152470.02,4620915.99
313140,201706,162,80,82,74960,76834,151794
313150,201706,320,256,64,239872,59686.9,299558.9
313160,201706,171,120,51,112440,47787,160227
313170,201706,1306,924,382,854171.3,357550.2,1211721.5
313180,201706,335,193,142,180203.84,133054,313257.84
313190,201706,693,401,292,372738.6,272855,645593.6
313200,201706,21,20,1,18740,937,19677
313210,201706,1031,859,172,800996.48,161159.32,962155.80
313220,201706,219,150,69,139613,63950.25,203563.25
313230,201706,279,202,77,188338,72149,260487
313240,201706,1881,1018,863,951516.27,804691.62,1756207.89
313250,201706,1228,898,330,836836.8,306401.4,1143238.2
313260,201706,90,53,37,49661,34669,84330
313270,201706,953,547,406,508556.77,380422,888978.77
313280,201706,60,51,9,47318.51,8433,55751.51
313290,201706,225,177,48,165568,44039.9,209607.9
313300,201706,356,176,180,162903.81,168660,331563.81
313310,201706,209,108,101,101196,94637,195833
313320,201706,365,281,84,261376.55,78708,340084.55
313330,201706,1306,777,529,727112.6,494502.75,1221615.35
313340,201706,332,225,107,210825,100259,311084
313350,201706,526,357,169,332635.05,158353,490988.05
313360,201706,115,62,53,58094,49380,107474
313370,201706,195,78,117,73086,109629,182715
313375,201706,259,154,105,144298,98385,242683
313380,201706,1211,619,592,576998.86,553951,1130949.86
313390,201706,47,39,8,35606.4,7496,43102.4
313400,201706,413,262,151,245494,141206,386700
313410,201706,16,9,7,8433,6559,14992
313420,201706,4632,2372,2260,2214668.19,2110490.81,4325159.00
313430,201706,135,60,75,56220,70275,126495
313440,201706,1453,977,476,913997.75,445450,1359447.75
313450,201706,61,26,35,24362,32795,57157
313460,201706,365,174,191,161620,178967,340587
313470,201706,507,226,281,211762,262641.1,474403.1
313480,201706,156,106,50,98386,46850,145236
313490,201706,498,241,257,225812.32,240360,466172.32
313500,201706,15,10,5,9370,4685,14055
313505,201706,919,719,200,672766,187400,860166
313507,201706,90,52,38,48724,35606,84330
313510,201706,2716,1748,968,1633474.9,906079,2539553.9
313520,201706,3563,2777,786,2590178.19,736478,3326656.19
313530,201706,40,29,11,27173,10307,37480
313535,201706,98,81,17,75242,15929,91171
313540,201706,69,53,16,49661,14148.7,63809.7
313545,201706,98,80,18,74960,16866,91826
313550,201706,238,192,46,179904,42540,222444
313560,201706,335,171,164,160227,153668,313895
313570,201706,53,27,26,25299,24362,49661
313580,201706,1269,673,596,629008.1,556650.07,1185658.17
313590,201706,86,49,37,45913,34669,80582
313600,201706,693,407,286,381359,267139,648498
313610,201706,56,45,11,41274.9,10307,51581.9
313620,201706,1292,689,603,635597.16,561881.6,1197478.76
313630,201706,1619,1246,373,1166003.4,349220,1515223.4
313640,201706,124,68,56,63716,52472,116188
313650,201706,220,102,118,95574,110566,206140
313652,201706,11,10,1,9370,937,10307
313655,201706,51,31,20,29047,18740,47787
313657,201706,45,42,3,39354,2811,42165
313660,201706,122,87,35,81519,32795,114314
313665,201706,609,307,302,287659,282739.75,570398.75
313670,201706,9793,6787,3006,6337113.73,2816060,9153173.73
313680,201706,40,30,10,28110,9370,37480
313690,201706,158,121,37,113377,34669,148046
313695,201706,59,44,15,41228,14055,55283
313700,201706,285,227,58,212418,54346,266764
313710,201706,155,108,47,101196,44039,145235
313720,201706,978,457,521,426669.45,486575.83,913245.28
313730,201706,55,40,15,37480,14055,51535
313740,201706,159,126,33,117874.6,30921,148795.6
313750,201706,452,328,124,307054.9,116188,423242.9
313753,201706,242,168,74,156760.1,69338,226098.1
313760,201706,1144,410,734,384170,685070.56,1069240.56
313770,201706,344,243,101,227691,94637,322328
313780,201706,753,393,360,368241,337038.9,705279.9
313790,201706,26,25,1,23425,937,24362
313800,201706,133,83,50,77771,46850,124621
313810,201706,52,33,19,30921,17803,48724
313820,201706,1267,626,641,585344.1,599376,1184720.1
313830,201706,68,51,17,47787,15929,63716
313835,201706,50,46,4,43102,3748,46850
313840,201706,1594,977,617,911084.8,576911,1487995.8
313850,201706,177,61,116,57157,108122.39,165279.39
313860,201706,496,382,114,354843.7,105881.55,460725.25
313862,201706,175,115,60,107755,56220,163975
313865,201706,81,63,18,59031,16866,75897
313867,201706,51,39,12,36543,11244,47787
313868,201706,20,13,7,12181,6559,18740
313870,201706,123,63,60,59031,56220,115251
313880,201706,329,212,117,198362.9,109066.9,307429.8
313890,201706,322,174,148,162288.9,138113.8,300402.7
313900,201706,914,500,414,466908.25,387591,854499.25
313910,201706,132,95,37,88828,33732.1,122560.1
313920,201706,582,416,166,389604.6,155542,545146.6
313925,201706,28,23,5,21551,4685,26236
313930,201706,784,600,184,562200,172385,734585
313940,201706,1727,1082,645,1009430.2,603802.9,1613233.1
313950,201706,931,592,339,552924.8,317409,870333.8
313960,201706,1328,767,561,714471.65,524439,1238910.65
313970,201706,112,82,30,76834,28110,104944
313980,201706,203,130,73,121576,68401,189977
313990,201706,347,208,139,194614.9,130243,324857.9
314000,201706,894,610,284,569088.35,265822.32,834910.67
314010,201706,73,46,27,43102,25299,68401
314015,201706,61,20,41,18740,38417,57157
314020,201706,52,36,16,33732,14898.3,48630.3
314030,201706,102,51,51,47787,47787,95574
314040,201706,41,30,11,28110,10307,38417
314050,201706,307,179,128,167264,118624.2,285888.2
314053,201706,96,62,34,58094,31858,89952
314055,201706,282,162,120,151794,112440,264234
314060,201706,143,121,22,112440,20614,133054
314070,201706,908,472,436,438245.77,407913.63,846159.40
314080,201706,208,136,72,127198,66434.14,193632.14
314085,201706,107,73,34,68401,31858,100259
314090,201706,348,248,100,232376,93695.32,326071.32
314100,201706,456,372,84,344692,78146,422838
314110,201706,681,366,315,341077.37,294452.8,635530.17
314120,201706,105,57,48,53409,44976,98385
314130,201706,21,11,10,10307,9370,19677
314140,201706,1087,644,443,601816.46,412953.93,1014770.39
314150,201706,167,104,63,97448,59031,156479
314160,201706,357,262,95,242404.1,88828,331232.1
314170,201706,64,46,18,43102,16866,59968
314180,201706,730,636,94,595651,87141.25,682792.25
314190,201706,103,62,41,58094,38417,96511
314200,201706,586,399,187,372645.7,174282,546927.7
314210,201706,274,204,70,190866.9,65309,256175.9
314220,201706,314,234,80,217385,74679,292064
314225,201706,63,45,18,42165,16866,59031
314230,201706,100,45,55,42165,51535,93700
314240,201706,134,101,33,94637,30921,125558
314250,201706,57,33,24,30921,22488,53409
314260,201706,189,96,93,89952,87141,177093
314270,201706,326,254,72,237249,67183,304432
314280,201706,671,371,300,347336.9,281100,628436.9
314290,201706,547,438,109,409188.25,101851.9,511040.15
314300,201706,416,295,121,273531.5,113331,386862.5
314310,201706,1408,933,475,873018.76,444774.33,1317793.09
314315,201706,32,25,7,23425,6559,29984
314320,201706,594,374,220,350157,205512.21,555669.21
314330,201706,10590,5324,5266,4976565.12,4928344,9904909.12
314340,201706,574,271,303,253364.9,283349,536713.9
314345,201706,24,18,6,16866,5622,22488
314350,201706,187,111,76,104007,71212,175219
314360,201706,71,40,31,37480,29047,66527
314370,201706,58,48,10,44976,9370,54346
314380,201706,89,63,26,59031,24362,83393
314390,201706,3088,1950,1138,1822372.25,1063401.7,2885773.95
314400,201706,670,487,183,453500.1,171471,624971.1
314410,201706,415,272,143,254864,133991,388855
314420,201706,19,7,12,6559,11244,17803
314430,201706,2470,881,1589,821813.15,1486979.91,2308793.06
314435,201706,265,150,115,140268.9,106818,247086.9
314437,201706,23,18,5,16866,4685,21551
314440,201706,96,68,28,63716,26236,89952
314450,201706,152,116,36,108692,33732,142424
314460,201706,648,295,353,276415,330761,607176
314465,201706,75,52,23,48724,21551,70275
314467,201706,64,54,10,50589,9370,59959
314470,201706,336,169,167,154963.06,155542.75,310505.81
314480,201706,1004,483,521,451634,487989.6,939623.6
314490,201706,90,65,25,60905,23425,84330
314500,201706,298,191,107,178967,100259,279226
314505,201706,122,83,39,77771,36543,114314
314510,201706,223,178,45,166786,42165,208951
314520,201706,1190,614,576,569201.05,538072.45,1107273.50
314530,201706,666,530,136,495806,127432,623238
314535,201706,192,118,74,110284.9,69091.48,179376.38
314537,201706,59,34,25,31858,23425,55283
314540,201706,9,5,4,4685,3748,8433
314545,201706,48,34,14,31858,13118,44976
314550,201706,79,43,36,40291,33732,74023
314560,201706,801,427,374,397944,350438,748382
314570,201706,21,16,5,14992,4685,19677
314580,201706,19,9,10,8433,9370,17803
314585,201706,19,13,6,12181,5622,17803
314587,201706,79,68,11,63716,10307,74023
314590,201706,529,396,133,371052,124621,495673
314600,201706,983,625,358,582132.39,332476.8,914609.19
314610,201706,911,499,412,465361.4,384920.15,850281.55
314620,201706,143,104,39,96511,36543,133054
314625,201706,93,71,22,65684,20614,86298
314630,201706,1245,628,617,586702.65,577847.9,1164550.55
314640,201706,92,62,30,58094,28110,86204
314650,201706,205,116,89,108410.9,82924.5,191335.4
314655,201706,65,51,14,47787,13118,60905
314660,201706,19,14,5,13118,4685,17803
314670,201706,174,142,32,132773,29984,162757
314675,201706,211,116,95,108692,89015,197707
314690,201706,532,293,239,274259.9,223943,498202.9
314700,201706,2427,1302,1125,1214915.6,1053234.95,2268150.55
314710,201706,1608,935,673,871880.15,629710.85,1501591.00
314720,201706,407,243,164,226286,153668,379954
314730,201706,498,267,231,248774,215907.58,464681.58
314740,201706,675,328,347,306633.25,325139,631772.25
314750,201706,22,19,3,17803,2811,20614
314760,201706,306,151,155,141487,145225.63,286712.63
314770,201706,121,83,38,77771,35606,113377
314780,201706,21,6,15,5622,14055,19677
314790,201706,2312,1445,867,1346836.75,811432.73,2158269.48
314795,201706,46,39,7,36309,6559,42868
314800,201706,2802,1622,1180,1513965.56,1104995.1,2618960.66
314810,201706,1458,808,650,754801.25,607457.5,1362258.75
314820,201706,86,48,38,44976,35606,80582
314830,201706,203,156,47,145469.75,43758,189227.75
314840,201706,82,47,35,44039,32795,76834
314850,201706,339,164,175,153668,163975,317643
314860,201706,706,527,179,491113.42,166224.35,657337.77
314870,201706,1403,711,692,665270.5,648404,1313674.5
314875,201706,53,45,8,42165,7496,49661
314880,201706,43,30,13,28110,12181,40291
314890,201706,49,30,19,28110,17803,45913
314900,201706,26,22,4,20614,3748,24362
314910,201706,258,171,87,159945.9,81519,241464.9
314915,201706,147,130,17,121576,15929,137505
314920,201706,127,77,50,72149,46569,118718
314930,201706,992,502,490,468549,458848.9,927397.9
314940,201706,56,44,12,41228,11244,52472
314950,201706,37,29,8,26470.25,7496,33966.25
314960,201706,56,41,15,38417,14055,52472
314970,201706,132,66,66,61280,61842,123122
314980,201706,305,195,110,179858.05,102133,281991.05
314990,201706,465,248,217,231439.25,202439.75,433879.00
314995,201706,169,62,107,58094,100249.63,158343.63
315000,201706,82,66,16,60905.6,14992,75897.6
315010,201706,46,30,16,28110,14992,43102
315015,201706,169,137,32,127656.88,29984,157640.88
315020,201706,52,43,9,40291,8433,48724
315030,201706,123,93,30,86205,28110,114315
315040,201706,60,44,16,41228,14992,56220
315050,201706,195,117,78,109629,73086,182715
315053,201706,34,29,5,27173,4685,31858
315057,201706,99,83,16,77396.2,14992,92388.2
315060,201706,71,64,7,58094.98,6559,64653.98
315070,201706,104,58,46,54346,43102,97448
315080,201706,360,295,65,276415,60905,337320
315090,201706,108,66,42,61842,39354,101196
315100,201706,76,41,35,38417,32795,71212
315110,201706,292,161,131,150013.7,122747,272760.7
315120,201706,1585,791,794,737279.1,742807,1480086.1
315130,201706,310,225,85,210825,79645,290470
315140,201706,528,307,221,285129.18,207077,492206.18
315150,201706,973,447,526,417903,492581,910484
315160,201706,194,98,96,91826,89952,181778
315170,201706,342,222,120,206141.1,112158.9,318300.0
315180,201706,3178,1348,1830,1259656.95,1711853,2971509.95
315190,201706,312,181,131,169223,122747,291970
315200,201706,1172,656,516,611955.53,482273.9,1094229.43
315210,201706,1486,835,651,778086.05,608113.8,1386199.85
315213,201706,34,22,12,20614,11244,31858
315217,201706,188,147,41,137739,38417,176156
315220,201706,1456,1115,341,1044380.3,319423.3,1363803.6
315230,201706,166,122,44,114033,41228,155261
315240,201706,428,280,148,262360,138432.63,400792.63
315250,201706,2495,1241,1254,1161505.3,1173959.47,2335464.77
315260,201706,149,89,60,82081.2,56220,138301.2
315270,201706,126,84,42,77583.6,38641.88,116225.48
315280,201706,697,453,244,424087,228618.63,652705.63
315290,201706,192,111,81,104007,74960.34,178967.34
315300,201706,76,48,28,44976,26236,71212
315310,201706,66,58,8,54346,7496,61842
315320,201706,158,85,73,79645,68401,148046
315330,201706,55,47,8,44039,7496,51535
315340,201706,417,296,121,276190.9,113372.32,389563.22
315350,201706,139,84,55,78708,51535,130243
315360,201706,94,49,45,45913,42165,88078
315370,201706,56,30,26,28110,24080.9,52190.9
315380,201706,11,6,5,5622,4685,10307
315390,201706,48,13,35,12181,32795,44976
315400,201706,800,596,204,552830.8,190492.1,743322.9
315410,201706,338,201,137,188056,128369,316425
315415,201706,63,48,15,44976,14055,59031
315420,201706,196,146,50,135725.5,46850,182575.5
315430,201706,675,404,271,378548,253645.9,632193.9
315440,201706,79,58,21,54346,19677,74023
315445,201706,250,199,51,186153.79,47787,233940.79
315450,201706,193,147,46,137739,43102,180841
315460,201706,3262,1663,1599,1553352.9,1494367.05,3047719.95
315470,201706,44,22,22,20333,20614,40947
315480,201706,61,23,38,21551,35606,57157
315490,201706,606,375,231,349641.55,216447,566088.55
315500,201706,24,13,11,12181,10307,22488
315510,201706,152,96,56,89952,52472,142424
315520,201706,65,58,7,54346,6559,60905
315530,201706,51,28,23,26236,21551,47787
315540,201706,239,152,87,142424,81519,223943
315550,201706,175,134,41,125558,38417,163975
315560,201706,741,587,154,549456.9,144298,693754.9
315570,201706,304,165,139,151748.25,130243,281991.25
315580,201706,624,408,216,382296,202392,584688
315590,201706,214,113,101,105881,94637,200518
315600,201706,283,205,78,192085,72899,264984
315610,201706,96,48,48,44976,44976,89952
315620,201706,31,24,7,22488,6559,29047
315630,201706,135,89,46,83393,43102,126495
315640,201706,51,31,20,29047,18740,47787
315645,201706,68,48,20,44976,18272,63248
315650,201706,163,119,44,111222,41228,152450
315660,201706,478,192,286,179904,267982,447886
315670,201706,2207,1126,1081,1052392.75,1011746.1,2064138.85
315680,201706,860,577,283,537146.81,264458.88,801605.69
315690,201706,706,479,227,446893.51,212699,659592.51
315700,201706,1872,1001,871,935126.51,816127,1751253.51
315710,201706,302,75,227,70275,212699,282974
315720,201706,413,265,148,248305,138394.9,386699.9
315725,201706,197,160,37,149920,34669,184589
315727,201706,40,23,17,21551,15929,37480
315730,201706,42,39,3,36543,2811,39354
315733,201706,84,53,31,49421,29047,78468
315737,201706,51,37,14,34669,13118,47787
315740,201706,42,37,5,34669,4685,39354
315750,201706,158,126,32,118062,29984,148046
315760,201706,44,29,15,27173,14055,41228
315765,201706,108,71,37,66527,34669,101196
315770,201706,229,135,94,126495,87797,214292
315780,201706,3221,1682,1539,1568399.15,1439690.2,3008089.35
315790,201706,201,156,45,146172,42165,188337
315800,201706,277,203,74,189930,69338,259268
315810,201706,88,51,37,47787,34669,82456
315820,201706,797,572,225,533716.77,210825,744541.77
315830,201706,139,81,58,75897,54346,130243
315840,201706,82,54,28,50598,26236,76834
315850,201706,263,193,70,180841,65590,246431
315860,201706,10,2,8,1874,7496,9370
315870,201706,34,28,6,26236,5622,31858
315880,201706,107,68,39,63716,36543,100259
315890,201706,69,50,19,46850,17803,64653
315895,201706,352,235,117,219446,109067,328513
315900,201706,65,34,31,31858,29047,60905
315910,201706,36,23,13,21223.05,12181,33404.05
315920,201706,181,120,61,112440,56220.95,168660.95
315930,201706,36,13,23,12181,21551,33732
315935,201706,145,113,32,105085,29975,135060
315940,201706,84,64,20,59968,18740,78708
315950,201706,63,43,20,40291,18740,59031
315960,201706,583,270,313,252633.94,292719,545352.94
315970,201706,40,31,9,29047,8433,37480
315980,201706,682,307,375,286166.1,351365.63,637531.73
315990,201706,245,147,98,137739,91545,229284
316000,201706,47,30,17,28110,15929,44039
316010,201706,70,61,9,57157,8433,65590
316020,201706,103,85,18,79645,16866,96511
316030,201706,403,205,198,192085,185011,377096
316040,201706,466,210,256,196468.89,239591,436059.89
316045,201706,62,56,6,52472,5622,58094
316050,201706,15,14,1,13118,937,14055
316060,201706,94,63,31,58749.9,29047,87796.9
316070,201706,1014,650,364,602776.25,340319,943095.25
316080,201706,104,63,41,59031,38417,97448
316090,201706,50,29,21,26236.1,19677,45913.1
316095,201706,61,51,10,47516,9370,56886
316100,201706,299,175,124,163412.9,116188,279600.9
316105,201706,31,22,9,20614,8433,29047
316110,201706,1911,1526,385,1420820.27,359058.4,1779878.67
316120,201706,78,56,22,52472,20332.9,72804.9
316130,201706,138,106,32,98667,29984,128651
316140,201706,24,18,6,16866,5622,22488
316150,201706,198,140,58,130477.25,54346,184823.25
316160,201706,87,53,34,49661,31858,81519
316165,201706,59,45,14,41978,12415.25,54393.25
316170,201706,208,140,68,130243,63716,193959
316180,201706,193,89,104,83065.05,97448,180513.05
316190,201706,132,93,39,86204,36543,122747
316200,201706,701,398,303,372926,283724,656650
316210,201706,732,483,249,452231.43,233313,685544.43
316220,201706,117,76,41,71212,38417,109629
316225,201706,18,10,8,9370,7496,16866
316230,201706,33,19,14,17803,13118,30921
316240,201706,604,488,116,456319.1,108692,565011.1
316245,201706,98,81,17,75897,15929,91826
316250,201706,1464,1027,437,953523.8,409244.12,1362767.92
316255,201706,111,89,22,83018.2,20614,103632.2
316257,201706,172,94,78,88078,73086,161164
316260,201706,236,154,82,143023.93,76741,219764.93
316265,201706,24,15,9,14055,8433,22488
316270,201706,671,467,204,434580.8,191148,625728.8
316280,201706,542,334,208,311053.5,194240.3,505293.8
316290,201706,654,430,224,400099.69,209888,609987.69
316292,201706,478,188,290,176156,271355.2,447511.2
316294,201706,106,65,41,60905,38417,99322
316295,201706,269,122,147,112892.5,137739,250631.5
316300,201706,102,71,31,66527,29047,95574
316310,201706,32,17,15,15929,14055,29984
316320,201706,48,28,20,26236,18740,44976
316330,201706,126,79,47,73086.25,43757.9,116844.15
316340,201706,135,97,38,90889,35606,126495
316350,201706,192,136,56,127105,52472,179577
316360,201706,23,18,5,16866,4685,21551
316370,201706,1032,556,476,517243.75,446002.63,963246.38
316380,201706,119,91,28,85267,26236,111503
316390,201706,123,86,37,80582,34669,115251
316400,201706,134,103,31,96511,29047,125558
316410,201706,304,224,80,208529.35,74960,283489.35
316420,201706,185,132,53,122981.25,49661,172642.25
316430,201706,152,75,77,70275,72149,142424
316440,201706,99,48,51,44976,47787,92763
316443,201706,36,34,2,31858,1874,33732
316447,201706,62,50,12,46850,11244,58094
316450,201706,211,163,48,152731,44976,197707
316460,201706,65,29,36,27173,33732,60905
316470,201706,1551,1118,433,1041956.36,403939.77,1445896.13
316480,201706,10,9,1,8433,937,9370
316490,201706,15,5,10,4685,9370,14055
316500,201706,155,104,51,97166.9,47787,144953.9
316510,201706,173,127,46,117734.15,43102,160836.15
316520,201706,192,119,73,110940.8,68401,179341.8
316530,201706,147,106,41,99322,38136,137458
316540,201706,136,74,62,68401,58094,126495
316550,201706,144,99,45,92763,42165,134928
316553,201706,205,103,102,96292.5,95574,191866.5
316555,201706,26,15,11,14055,10307,24362
316556,201706,11,7,4,6559,3748,10307
316557,201706,16,15,1,14055,937,14992
316560,201706,54,43,11,40291,10307,50598
316570,201706,251,226,25,211528,23425,234953
316580,201706,22,15,7,14055,6559,20614
316590,201706,118,102,16,95574,14992,110566
316600,201706,187,150,37,140550,34669,175219
316610,201706,66,44,22,40718.36,20614,61332.36
316620,201706,123,94,29,88078,27173,115251
316630,201706,37,27,10,25299,9370,34669
316640,201706,16,10,6,9370,5622,14992
316650,201706,61,48,13,44976,12181,57157
316660,201706,5,3,2,2811,1874,4685
316670,201706,435,151,284,141469,265546,407015
316680,201706,159,110,49,103070,45726,148796
316690,201706,196,121,75,113377,70275,183652
316695,201706,56,50,6,46850,5622,52472
316700,201706,12,6,6,5622,5622,11244
316710,201706,707,513,194,480165.9,181778,661943.9
316720,201706,4756,2419,2337,2252849.8,2185521.34,4438371.14
316730,201706,15,14,1,13118,937,14055
316740,201706,133,80,53,74960,49661,124621
316750,201706,20,14,6,13118,5622,18740
316760,201706,332,267,65,250179,60905,311084
316770,201706,140,80,60,74960,56220,131180
316780,201706,67,38,29,35306.16,27173,62479.16
316790,201706,56,42,14,39354,13118,52472
316800,201706,1781,1106,675,1032949,630592.1,1663541.1
316805,201706,19,10,9,9370,8433,17803
316810,201706,63,40,23,37480,21270,58750
316820,201706,38,20,18,18740,16866,35606
316830,201706,91,41,50,38417,46569,84986
316840,201706,498,297,201,277539.5,186463,464002.5
316850,201706,339,220,119,204781.35,111503,316284.35
316860,201706,5904,2593,3311,2417090.85,3098322.63,5515413.48
316870,201706,1381,891,490,825734.85,453838.55,1279573.40
316880,201706,99,57,42,52753.9,39354,92107.9
316890,201706,251,168,83,157416,77771,235187
316900,201706,416,284,132,263607.84,123684,387291.84
316905,201706,15,10,5,9370,4685,14055
316910,201706,52,27,25,25299,23425,48724
316920,201706,132,105,27,97683,25299,122982
316930,201706,1900,950,950,884483.15,887995.85,1772479.00
316935,201706,851,510,341,475996.66,318017.8,794014.46
316940,201706,1066,613,453,573163.6,423889.53,997053.13
316950,201706,182,94,88,88078,82456,170534
316960,201706,1092,604,488,564355.9,456956.26,1021312.16
316970,201706,635,496,139,464752,130243,594995
316980,201706,114,70,44,65590,41218.63,106808.63
316990,201706,2137,1395,742,1300510.33,693605.88,1994116.21
317000,201706,315,244,71,228347,66527,294874
317005,201706,243,171,72,160227,67464,227691
317010,201706,6140,3364,2776,3132519.13,2599228.83,5731747.96
317020,201706,15826,6967,8859,6498328.06,8286660.54,14784988.60
317030,201706,85,31,54,29047,50598,79645
317040,201706,3101,1911,1190,1788471.64,1112969.6,2901441.24
317043,201706,70,48,22,44976,20614,65590
317047,201706,33,15,18,14055,16862,30917
317050,201706,191,142,49,133054,45913,178967
317052,201706,118,93,25,87141,23425,110566
317057,201706,194,148,46,138676,42540,181216
317060,201706,55,34,21,31858,19395.9,51253.9
317065,201706,58,48,10,44976,9370,54346
317070,201706,1955,922,1033,858292.85,965859.9,1824152.75
317075,201706,110,57,53,53409,49661,103070
317080,201706,801,431,370,402769.45,346503,749272.45
317090,201706,602,481,121,450275.35,113377,563652.35
317100,201706,403,302,101,281100.6,94637,375737.6
317103,201706,96,81,15,75897,14055,89952
317107,201706,36,33,3,30921,2811,33732
317110,201706,87,40,47,37480,44039,81519
317115,201706,40,34,6,31858,5622,37480
317120,201706,1738,879,859,815880.35,804434,1620314.35
317130,201706,1834,1160,674,1083742.1,630601.9,1714344.0
317140,201706,5,4,1,3748,937,4685
317150,201706,261,158,103,148046,95761.4,243807.4
317160,201706,311,225,86,210544,80582,291126
317170,201706,204,148,56,138676,52472,191148
317180,201706,409,297,112,277586.25,104944,382530.25
317190,201706,252,170,82,159290,76271.8,235561.8
317200,201706,775,556,219,507210,204969,712179
317210,201706,153,88,65,81519.6,60905,142424.6
317220,201706,21,12,9,11244,8433,19677
320010,201706,596,439,157,408251.25,147109,555360.25
320013,201706,130,92,38,86204,35606,121810
320016,201706,280,173,107,162101,100259,262360
320020,201706,693,414,279,384372.37,258828.97,643201.34
320030,201706,147,107,40,100259,37152.05,137411.05
320035,201706,134,98,36,91826,33732,125558
320040,201706,491,263,228,245306.8,213636,458942.8
320050,201706,99,76,23,71212,21551,92763
320060,201706,1459,652,807,610878,755494.3,1366372.3
320070,201706,101,71,30,66527,28110,94637
320080,201706,749,430,319,399847.4,298903,698750.4
320090,201706,1184,828,356,771791.98,332728.8,1104520.78
320100,201706,309,178,131,166318,122747,289065
320110,201706,134,87,47,79833.1,44039,123872.1
320115,201706,107,87,20,81519,18740,100259
320120,201706,3218,1794,1424,1670205.35,1332961.96,3003167.31
320130,201706,7056,3405,3651,3169593.2,3412612.53,6582205.73
320140,201706,415,265,150,246993.6,140310,387303.6
320150,201706,1805,1062,743,989298.3,696181.63,1685479.93
320160,201706,686,299,387,278936.22,361286.36,640222.58
320170,201706,115,89,26,82644,24362,107006
320180,201706,46,27,19,25299,17803,43102
320190,201706,238,165,73,153846.03,68120,221966.03
320200,201706,52,39,13,36543,12181,48724
320210,201706,836,472,364,440765.8,339599,780364.8
320220,201706,301,115,186,106818.86,174001,280819.86
320225,201706,75,62,13,58094,12181,70275
320230,201706,513,333,180,310709.2,167864,478573.2
320240,201706,3044,1538,1506,1438951.9,1409240.1,2848192.0
320245,201706,417,293,124,273416.7,116188,389604.7
320250,201706,207,110,97,100916,90889,191805
320255,201706,143,114,29,105534.31,27033,132567.31
320260,201706,166,122,44,114314,41181.15,155495.15
320265,201706,158,127,31,118203,29047,147250
320270,201706,153,122,31,114314,29047,143361
320280,201706,896,547,349,506918.1,325635.81,832553.91
320290,201706,65,56,9,52472,8433,60905
320300,201706,514,368,146,343383.65,135557.55,478941.20
320305,201706,621,331,290,310147,271543,581690
320310,201706,207,118,89,110285,82651,192936
320313,201706,280,143,137,133991,128088,262079
320316,201706,107,89,18,83393,16866,100259
320320,201706,3241,1452,1789,1355643.8,1672796.5,3028440.3
320330,201706,259,188,71,175506.9,64653.81,240160.71
320332,201706,847,511,336,476515.9,313681.15,790197.05
320334,201706,236,145,91,135583.9,85267,220850.9
320335,201706,146,108,38,100024.95,35606,135630.95
320340,201706,580,397,183,370865,170816,541681
320350,201706,939,403,536,374894.14,501696.44,876590.58
320360,201706,160,85,75,79364,69909,149273
320370,201706,238,181,57,168041,52394,220435
320380,201706,288,197,91,183184.4,85267,268451.4
320390,201706,1080,661,419,618758,390497.56,1009255.56
320400,201706,323,227,96,210825.6,89768,300593.6
320405,201706,825,340,485,318355.34,454038.15,772393.49
320410,201706,935,479,456,447146.7,426907.34,874054.04
320420,201706,473,244,229,228160.2,214573,442733.2
320425,201706,185,104,81,97448,75897,173345
320430,201706,384,217,167,202485.95,156479,358964.95
320435,201706,167,111,56,103201.18,52472,155673.18
320440,201706,190,118,72,110284.9,67464,177748.9
320450,201706,125,73,52,68401,48724,117125
320455,201706,238,190,48,177094,44958,222052
320460,201706,241,153,88,143361,82456,225817
320465,201706,116,80,36,74603.94,33732,108335.94
320470,201706,617,393,224,367942.54,209880,577822.54
320480,201706,161,105,56,98385,52472,150857
320490,201706,2902,1431,1471,1337287.21,1375288.98,2712576.19
320495,201706,91,57,34,53391,31858,85249
320500,201706,9184,4693,4491,4369596.03,4197892.76,8567488.79
320501,201706,510,257,253,240809,237061,477870
320503,201706,265,189,76,176156.6,71212,247368.6
320506,201706,244,189,55,177093,51535,228628
320510,201706,877,422,455,392159.65,424535.05,816694.70
320515,201706,79,66,13,60905.45,12181,73086.45
320517,201706,193,137,56,128369,52472,180841
320520,201706,6456,2869,3587,2674689.45,3353348.93,6028038.38
320530,201706,5042,2550,2492,2380278.19,2330329.93,4710608.12
330010,201706,2843,1467,1376,1366360.9,1286567.91,2652928.81
330015,201706,154,61,93,56220.14,87141,143361.14
330020,201706,3423,1487,1936,1390322.92,1813470,3203792.92
330022,201706,205,115,90,107755,83394,191149
330023,201706,502,173,329,160930.4,308273,469203.4
330025,201706,503,119,384,111503,359526.9,471029.9
330030,201706,1841,1173,668,1091515.43,622987.04,1714502.47
330040,201706,2116,1069,1047,999826.55,979821,1979647.55
330045,201706,8137,2540,5597,2370714.55,5239482.66,7610197.21
330050,201706,768,487,281,456319,263297,719616
330060,201706,822,530,292,492677.05,273604,766281.05
330070,201706,3290,1272,2018,1187724.19,1889818.63,3077542.82
330080,201706,1418,688,730,640431.75,683073.3,1323505.05
330090,201706,350,204,146,191148,136802,327950
330093,201706,273,120,153,112440,143352,255792
330095,201706,103,52,51,48724,47787,96511
330100,201706,9054,4740,4314,4432778.84,4038376.4,8471155.24
330110,201706,469,213,256,197941.8,239872,437813.8
330115,201706,513,303,210,283911,196770,480681
330120,201706,357,182,175,169409.6,163506.5,332916.1
330130,201706,1385,426,959,398449.88,898531,1296980.88
330140,201706,589,307,282,287650,263298,550948
330150,201706,432,258,174,239872,162101,401973
330160,201706,205,128,77,119936,72149,192085
330170,201706,25963,9190,16773,8590381.32,15698783.17,24289164.49
330180,201706,232,147,85,134301.75,78942.25,213244.00
330185,201706,735,317,418,295521.1,391648,687169.1
330187,201706,252,87,165,81519,154605,236124
330190,201706,5497,2174,3323,2028638.25,3109198.63,5137836.88
330200,201706,4228,1472,2756,1375330,2577776.28,3953106.28
330205,201706,387,237,150,221647.35,140269,361916.35
330210,201706,952,584,368,543462.8,343129.95,886592.75
330220,201706,2373,1399,974,1307537.75,911701.1,2219238.85
330225,201706,534,298,236,278599,221132,499731
330227,201706,2338,807,1531,753057.63,1434244.32,2187301.95
330230,201706,197,118,79,109911,74023,183934
330240,201706,3432,1785,1647,1669405.07,1541239.86,3210644.93
330245,201706,144,58,86,54346,79832.4,134178.4
330250,201706,6254,3248,3006,3032620.1,2808577.96,5841198.06
330260,201706,533,165,368,154605,344816,499421
330270,201706,3168,1180,1988,1104536.5,1862383,2966919.5
330280,201706,439,287,152,266034.34,142415,408449.34
330285,201706,6852,2310,4542,2160014.4,4252887.2,6412901.6
330290,201706,571,223,348,208015,325795,533810
330300,201706,715,490,225,455382.85,210808,666190.85
330310,201706,407,240,167,223006.35,156479,379485.35
330320,201706,7686,2859,4827,2671245.15,4518243.6,7189488.75
330330,201706,9324,3612,5712,3379247.16,5347526.77,8726773.93
330340,201706,2565,1550,1015,1450467.53,951036.26,2401503.79
330350,201706,17115,6807,10308,6353410.3,9638762.88,15992173.18
330360,201706,2570,1264,1306,1183225.7,1223713,2406938.7
330370,201706,962,522,440,488364.4,410594.4,898958.8
330380,201706,814,350,464,327217.77,434299.9,761517.67
330385,201706,604,317,287,296093,268919,565012
330390,201706,5015,2792,2223,2604538.19,2081077.52,4685615.71
330395,201706,226,144,82,133242.05,74351.5,207593.55
330400,201706,628,322,306,298622.4,283955.33,582577.73
330410,201706,499,355,144,330987.63,134928,465915.63
330411,201706,220,127,93,118999,87141,206140
330412,201706,248,105,143,98104,133991,232095
330414,201706,6227,2537,3690,2373648.4,3453859.75,5827508.15
330415,201706,540,252,288,236124,268919.4,505043.4
330420,201706,2241,1194,1047,1115386.67,978885.3,2094271.97
330430,201706,1768,755,1013,706677.1,947682,1654359.1
330440,201706,240,107,133,100259,124621,224880
330450,201706,127,52,75,47788,70275,118063
330452,201706,1605,730,875,682071.18,819865.63,1501936.81
330455,201706,107809,38371,69438,35880914.52,65006837.83,100887752.35
330460,201706,260,108,152,101196,142424,243620
330470,201706,1220,668,552,620015.29,517214.63,1137229.92
330475,201706,1372,379,993,353250.3,929878.8,1283129.1
330480,201706,729,390,339,364774.1,316707,681481.1
330490,201706,13056,4657,8399,4357356.09,7862714.27,12220070.36
330500,201706,1302,608,694,569696,649904,1219600
330510,201706,10973,3532,7441,3304734.96,6964962.91,10269697.87
330513,201706,104,52,52,48724,48724,97448
330515,201706,851,349,502,323971.8,470000,793971.8
330520,201706,2324,880,1444,824345,1351997.3,2176342.3
330530,201706,229,121,108,113377,101009,214386
330540,201706,348,177,171,165849,159759,325608
330550,201706,3089,1108,1981,1037062.58,1855005.95,2892068.53
330555,201706,715,266,449,249224,420339,669563
330560,201706,510,197,313,184589,293272,477861
330570,201706,241,166,75,155542,70275,225817
330575,201706,744,335,409,313661,381213.75,694874.75
330580,201706,3285,1860,1425,1737480.8,1333726,3071206.8
330590,201706,297,157,140,147109,131180,278289
330600,201706,1038,671,367,627096.62,343120.03,970216.65
330610,201706,1480,816,664,758766.61,618141.45,1376908.06
330615,201706,180,140,40,131180,37480,168660
330620,201706,878,431,447,399633.06,416401.3,816034.36
330630,201706,3548,2217,1331,2061728.78,1239522.58,3301251.36
350010,201706,600,392,208,365463,194896,560359
350020,201706,38,19,19,17803,17803,35606
350030,201706,506,329,177,307149,164680.66,471829.66
350040,201706,131,47,84,43701.68,78708,122409.68
350050,201706,290,159,131,148926.78,122494.63,271421.41
350055,201706,86,48,38,44976,35606,80582
350060,201706,73,26,47,24362,44039,68401
350070,201706,779,450,329,417345.11,306584.12,723929.23
350075,201706,66,43,23,40291,21551,61842
350080,201706,49,31,18,28422.3,15929,44351.3
350090,201706,100,57,43,53409,40286.32,93695.32
350100,201706,300,186,114,173579.25,106818,280397.25
350110,201706,61,38,23,35606,21551,57157
350115,201706,149,88,61,81800.1,57157,138957.1
350120,201706,111,75,36,70275,33732,104007
350130,201706,353,168,185,156854,173345,330199
350140,201706,35,21,14,18178.4,13118,31296.4
350150,201706,66,52,14,48724,13118,61842
350160,201706,2437,945,1492,882169.67,1396985.16,2279154.83
350170,201706,396,243,153,225536.25,143080,368616.25
350180,201706,178,92,86,85923,80582,166505
350190,201706,910,438,472,408438.84,441687.85,850126.69
350200,201706,72,27,45,25097.46,41904.8,67002.26
350210,201706,1344,748,596,692192.96,557693.03,1249885.99
350220,201706,672,576,96,535654.75,89952,625606.75
350230,201706,75,53,22,49661,20614,70275
350240,201706,61,46,15,43102,14055,57157
350250,201706,1179,592,587,548944.45,549494.93,1098439.38
350260,201706,91,65,26,60905,24362,85267
350270,201706,813,538,275,503403.25,255970.76,759374.01
350275,201706,295,115,180,107381,168660,276041
350280,201706,4590,2324,2266,2166608.2,2121100.44,4287708.64
350290,201706,391,186,205,174001,190585.9,364586.9
350300,201706,48,24,24,22488,22488,44976
350310,201706,99,70,29,65590,27173,92763
350315,201706,37,20,17,18740,15929,34669
350320,201706,3240,1584,1656,1479362.62,1551438.52,3030801.14
350330,201706,1660,877,783,817644.3,732670.7,1550315.0
350335,201706,20,13,7,12181,6559,18740
350340,201706,133,69,64,64653,59968,124621
350350,201706,95,44,51,41228,47787,89015
350360,201706,126,85,41,79641,38136,117777
350370,201706,93,55,38,50910.3,35596.63,86506.93
350380,201706,714,301,413,281381.1,386699.9,668081.0
350390,201706,1373,558,815,522062.25,762530.7,1284592.95
350395,201706,26,18,8,16866,7496,24362
350400,201706,1673,889,784,824213.87,732056.28,1556270.15
350410,201706,2183,964,1219,900515.88,1141889.22,2042405.10
350420,201706,235,141,94,130788.54,88078,218866.54
350430,201706,75,43,32,39729,29984,69713
350440,201706,146,104,42,96464.25,39354,135818.25
350450,201706,1599,1029,570,957080.9,533997,1491077.9
350460,201706,330,119,211,111503,197425.9,308928.9
350470,201706,13,10,3,9370,2811,12181
350480,201706,152,84,68,78053,63716,141769
350490,201706,243,116,127,107755.9,118999,226754.9
350500,201706,34,16,18,14992,16866,31858
350510,201706,166,111,55,104007,51535,155542
350520,201706,444,201,243,185839,227066.3,412905.3
350530,201706,444,221,223,207077,208951,416028
350535,201706,56,44,12,40854,11244,52098
350540,201706,376,192,184,179031.47,172127,351158.47
350550,201706,2747,1616,1131,1507122.95,1058746.51,2565869.46
350560,201706,621,431,190,403842.32,177674.65,581516.97
350570,201706,4245,1755,2490,1640577.06,2330319.77,3970896.83
350580,201706,369,178,191,166786,178953.63,345739.63
350590,201706,897,487,410,456319,383233.3,839552.3
350600,201706,6023,3042,2981,2837302.11,2790370.04,5627672.15
350610,201706,1549,772,777,717683,726910,1444593
350620,201706,39,27,12,25299,11244,36543
350630,201706,238,137,101,127432.3,93701,221133.3
350635,201706,817,314,503,293224.82,470675.54,763900.36
350640,201706,117,85,32,79645,29984,109629
350650,201706,1850,1221,629,1139730.59,588356.1,1728086.69
350660,201706,739,334,405,312958,378544,691502
350670,201706,315,159,156,148749,146172,294921
350680,201706,178,98,80,91826,74679,166505
350690,201706,208,102,106,95574,99322,194896
350700,201706,662,323,339,299376.99,317643,617019.99
350710,201706,314,129,185,119686.1,173345,293031.1
350715,201706,48,42,6,39354,5622,44976
350720,201706,18,13,5,12181,4685,16866
350730,201706,40,25,15,23425,14055,37480
350740,201706,195,109,86,101842.53,80582,182424.53
350745,201706,22,11,11,10283,10307,20590
350750,201706,2092,1360,732,1265991.65,684322.3,1950313.95
350760,201706,3673,1586,2087,1485145.3,1954572.63,3439717.93
350770,201706,60,40,20,37480,18740,56220
350775,201706,47,34,13,31858,12172,44030
350780,201706,410,201,209,188337,195833,384170
350790,201706,381,169,212,158353,198644,356997
350800,201706,420,234,186,219258,174282,393540
350810,201706,500,399,101,371990.3,94637,466627.3
350820,201706,78,50,28,46850,26236,73086
350830,201706,84,50,34,46850,31858,78708
350840,201706,720,327,393,306118,367304,673422
350850,201706,1691,982,709,914506.26,664077,1578583.26
350860,201706,536,309,227,287642.16,212699,500341.16
350870,201706,430,291,139,272667,129868.9,402535.9
350880,201706,292,158,134,144721.3,125558,270279.3
350890,201706,41,26,15,24362,14055,38417
350900,201706,1380,449,931,418763.19,871597.4,1290360.59
350910,201706,28,19,9,17803,8433,26236
350920,201706,588,330,258,308897.7,241746,550643.7
350925,201706,1159,624,535,580835.77,499889.7,1080725.47
350930,201706,94,57,37,53409,34669,88078
350940,201706,676,366,310,341442.8,288661.8,630104.6
350945,201706,102,78,24,72562,22488,95050
350950,201706,14666,7019,7647,6547988.9,7155909.09,13703897.99
350960,201706,1271,585,686,543548.9,642778,1186326.9
350970,201706,1107,623,484,581524.3,453217.63,1034741.93
350980,201706,105,71,34,66527,31858,98385
350990,201706,362,126,236,117378,220850.9,338228.9
350995,201706,28,15,13,14055,12181,26236
351000,201706,628,454,174,423213.26,163038,586251.26
351010,201706,53,28,25,26236,23425,49661
351015,201706,61,43,18,40291,16866,57157
351020,201706,1638,934,704,873482.64,657587.2,1531069.84
351030,201706,316,221,95,204547.1,89015,293562.1
351040,201706,830,449,381,419776,355873.15,775649.15
351050,201706,3181,1534,1647,1430727.03,1541410.33,2972137.36
351060,201706,4814,1984,2830,1849166.16,2648734.25,4497900.41
351070,201706,420,271,149,252039.9,139613,391652.9
351080,201706,804,572,232,535964,216447,752411
351090,201706,65,29,36,27173,33732,60905
351100,201706,448,257,191,238626.35,178953.32,417579.67
351110,201706,2111,1020,1091,949973.62,1018589.22,1968562.84
351120,201706,74,40,34,37396.6,31858,69254.6
351130,201706,170,54,116,50598,108692,159290
351140,201706,335,236,99,219352.5,92763,312115.5
351150,201706,385,196,189,182809,177093,359902
351160,201706,243,159,84,148983,78708,227691
351170,201706,175,88,87,82456,80770,163226
351190,201706,87,59,28,55283,26236,81519
351200,201706,381,248,133,231501.6,124621,356122.6
351210,201706,132,60,72,56220,67464,123684
351220,201706,520,313,207,289970.81,193959,483929.81
351230,201706,274,199,75,185557.3,70256.26,255813.56
351240,201706,226,96,130,89764.6,121810,211574.6
351250,201706,68,48,20,44976,18740,63716
351260,201706,146,108,38,101196,35606,136802
351270,201706,52,22,30,20614,28110,48724
351280,201706,1098,503,595,467565.35,557000.39,1024565.74
351290,201706,221,97,124,90889,115907,206796
351300,201706,3750,1762,1988,1643970.13,1862163,3506133.13
351310,201706,736,390,346,364212,324202,688414
351320,201706,106,64,42,59968,39354,99322
351330,201706,40,28,12,26236,11244,37480
351340,201706,1185,748,437,693876.39,408511.32,1102387.71
351350,201706,2333,1253,1080,1172515.85,1011393.22,2183909.07
351360,201706,767,384,383,357934,357757.19,715691.19
351370,201706,363,192,171,179899.32,159602.3,339501.62
351380,201706,8910,4119,4791,3844711.84,4479378.66,8324090.50
351385,201706,28,19,9,17803,8433,26236
351390,201706,273,198,75,184796.26,70275,255071.26
351400,201706,60,38,22,35606,20568.63,56174.63
351410,201706,415,257,158,240340.5,147765,388105.5
351420,201706,60,49,11,45913,10307,56220
351430,201706,79,45,34,42165,31858,74023
351440,201706,780,531,249,495389.2,233309,728698.2
351450,201706,245,123,122,115251,114314,229565
351460,201706,122,54,68,50598,63716,114314
351470,201706,142,76,66,71203,61842,133045
351480,201706,512,275,237,256738.1,221951.88,478689.98
351490,201706,294,99,195,92763,182715,275478
351492,201706,33,24,9,22488,8433,30921
351495,201706,28,18,10,16866,9370,26236
351500,201706,3527,1518,2009,1416678.37,1877609.1,3294287.47
351510,201706,1755,725,1030,679043.9,962945.54,1641989.44
351512,201706,21,17,4,15929,3748,19677
351515,201706,188,104,84,97448,78708,176156
351518,201706,707,434,273,405717,255660.45,661377.45
351519,201706,73,47,26,44039,24362,68401
351520,201706,139,87,52,80895,48724,129619
351530,201706,18,14,4,13118,3748,16866
351535,201706,133,74,59,69338,55283,124621
351540,201706,425,303,122,281571,113939.2,395510.2
351550,201706,1271,773,498,717558.1,466616.63,1184174.73
351560,201706,73,37,36,34669,33732,68401
351565,201706,10,5,5,4685,4685,9370
351570,201706,2540,1325,1215,1239669.03,1137808.26,2377477.29
351580,201706,35,30,5,28110,4685,32795
351590,201706,69,46,23,43102,21551,64653
351600,201706,188,137,51,128369,47787,176156
351610,201706,59,27,32,25299,29984,55283
351620,201706,5965,3424,2541,3199005.56,2376911.31,5575916.87
351630,201706,2470,1272,1198,1186925.69,1120647.32,2307573.01
351640,201706,1637,787,850,734912.06,794951.4,1529863.46
351650,201706,30,26,4,24362,3748,28110
351660,201706,154,96,58,89952,54346,144298
351670,201706,734,455,279,422869.15,261423,684292.15
351680,201706,77,63,14,59031,13118,72149
351685,201706,41,25,16,23425,14992,38417
351690,201706,305,215,90,199342.17,84330,283672.17
351700,201706,162,113,49,105881,45913,151794
351710,201706,75,52,23,48724,21551,70275
351720,201706,136,63,73,59031,68401,127432
351730,201706,93,66,27,61842,25294.32,87136.32
351740,201706,707,472,235,441983,220190.32,662173.32
351750,201706,356,148,208,137739.7,194896,332635.7
351760,201706,793,613,180,574616,168524,743140
351770,201706,284,245,39,228626.03,36543,265169.03
351780,201706,166,89,77,83393,72149,155542
351790,201706,235,123,112,115251,104944,220195
351800,201706,51,33,18,30921,16866,47787
351810,201706,121,80,41,74679,38417,113096
351820,201706,882,635,247,590711.8,231434.32,822146.12
351830,201706,503,186,317,173532.4,297029,470561.4
351840,201706,1842,938,904,869418.75,845297.79,1714716.54
351850,201706,222,168,54,156807.9,50598,207405.9
351860,201706,748,488,260,453509.77,243615.32,697125.09
351870,201706,5576,2642,2934,2465943.9,2741714.25,5207658.15
351880,201706,18813,8349,10464,7800176.28,9790412.12,17590588.40
351885,201706,94,62,32,58094,29984,88078
351890,201706,76,63,13,59031,12181,71212
351900,201706,223,134,89,124903,83393,208296
351905,201706,76,35,41,32795,38417,71212
351907,201706,3047,1328,1719,1240893.23,1609663.9,2850557.13
351910,201706,177,71,106,66527,99322,165849
351920,201706,133,78,55,73086,51512.96,124598.96
351925,201706,84,57,27,53409,25299,78708
351930,201706,376,258,118,241652.3,110566,352218.3
351940,201706,226,104,122,97448,114314,211762
351950,201706,142,80,62,74960,58094,133054
351960,201706,819,382,437,357602.58,407632.58,765235.16
351970,201706,1874,990,884,925522.04,827884,1753406.04
351980,201706,145,76,69,69338,64653,133991
351990,201706,287,194,93,180841,86353.92,267194.92
352000,201706,354,211,143,197332.2,133991,331323.2
352010,201706,339,199,140,186463,131180,317643
352020,201706,196,71,125,66527,117125,183652
352030,201706,988,501,487,468453.25,454476.2,922929.45
352040,201706,574,245,329,229565,308273,537838
352042,201706,258,90,168,84330,157135,241465
352044,201706,386,229,157,213636.1,147109,360745.1
352050,201706,3095,1270,1825,1182890.2,1708946.53,2891836.73
352060,201706,100,64,36,59968,33732,93700
352070,201706,97,68,29,62780,27173,89953
352080,201706,65,39,26,35606,24362,59968
352090,201706,169,114,55,106818,51535,158353
352100,201706,248,123,125,115251,115993,231244
352110,201706,110,34,76,31858,71212,103070
352115,201706,74,29,45,27173,42165,69338
352120,201706,100,60,40,56220,37480,93700
352130,201706,218,182,36,170346.6,33732,204078.6
352140,201706,182,73,109,67933,102133,170066
352150,201706,120,67,53,61842.7,49661,111503.7
352160,201706,129,87,42,81519,39354,120873
352170,201706,374,255,119,237998.7,111503,349501.7
352180,201706,591,403,188,376534.75,176152,552686.75
352190,201706,268,103,165,96501.63,154558.15,251059.78
352200,201706,31,19,12,17803,11244,29047
352210,201706,3603,1498,2105,1394756.28,1967040.97,3361797.25
352215,201706,48,27,21,25299,19207.13,44506.13
352220,201706,6953,2755,4198,2576625.96,3931358.72,6507984.68
352230,201706,3099,1982,1117,1844180.99,1041199.64,2885380.63
352240,201706,2137,1273,864,1189851.29,808350.25,1998201.54
352250,201706,2550,1352,1198,1263889.6,1120514.7,2384404.3
352260,201706,1121,639,482,597516.32,451353,1048869.32
352265,201706,65,29,36,27173,33732,60905
352270,201706,381,218,163,203329.84,152676,356005.84
352280,201706,382,242,140,225223.9,130894.32,356118.22
352290,201706,173,109,64,101571,59968,161539
352300,201706,104,79,25,74023,23425,97448
352310,201706,5618,2786,2832,2598525.21,2648040.37,5246565.58
352320,201706,907,486,421,452790.99,392462.55,845253.54
352330,201706,524,224,300,209560.05,280819,490379.05
352340,201706,1398,689,709,640929.15,663255.75,1304184.90
352350,201706,314,200,114,187400,106537,293937
352360,201706,223,88,135,81565.85,123945,205510.85
352370,201706,102,70,32,65590,29984,95574
352380,201706,119,74,45,69338,42165,111503
352390,201706,2411,1102,1309,1028199.9,1224660.14,2252860.04
352400,201706,459,192,267,179201.25,249897.9,429099.15
352410,201706,736,527,209,489370.9,195552,684922.9
352420,201706,100,63,37,59031,34669,93700
352430,201706,1740,769,971,713996.55,908158.59,1622155.14
352440,201706,3001,1550,1451,1444644.54,1356736.4,2801380.94
352450,201706,185,157,28,147109,26236,173345
352460,201706,569,290,279,271463.64,260065.2,531528.84
352470,201706,562,193,369,180841,345744,526585
352480,201706,1368,764,604,715244,565385.9,1280629.9
352490,201706,79,32,47,29984,44039,74023
352500,201706,1217,546,671,509822.8,627313,1137135.8
352510,201706,730,389,341,363556.3,319517,683073.3
352520,201706,524,231,293,216166,274400.45,490566.45
352530,201706,1710,895,815,837678,762318.3,1599996.3
352540,201706,76,51,25,47787,23425,71212
352550,201706,186,107,79,100259,73303.25,173562.25
352560,201706,51,41,10,38417,9370,47787
352570,201706,652,344,308,321735,288596,610331
352580,201706,58,40,18,36543.33,16866,53409.33
352585,201706,15,5,10,4685,9370,14055
352590,201706,4226,2127,2099,1987720.7,1965878.11,3953598.81
352600,201706,351,243,108,226754.3,101187,327941.3
352610,201706,905,428,477,398349.51,446949,845298.51
352620,201706,962,379,583,354186.1,546271,900457.1
352630,201706,216,79,137,74023,127937.98,201960.98
352640,201706,543,378,165,352750.15,154605,507355.15
352650,201706,91,61,30,57157,28110,85267
352660,201706,84,50,34,46850,31858,78708
352670,201706,1618,884,734,824895.93,686411.66,1511307.59
352680,201706,891,568,323,528651.85,301402.2,830054.05
352690,201706,4238,1963,2275,1829398.5,2127877.87,3957276.37
352700,201706,113,64,49,59968,45913,105881
352710,201706,1287,672,615,627602.03,573725.6,1201327.63
352720,201706,1188,589,599,549395.1,561258.32,1110653.42
352725,201706,27,25,2,23425,1874,25299
352730,201706,358,176,182,163754.81,169972,333726.81
352740,201706,404,253,151,235141.04,141487,376628.04
352750,201706,25,17,8,15647.9,7496,23143.9
352760,201706,192,139,53,130243,49661,179904
352770,201706,83,66,17,60906,15929,76835
352780,201706,83,44,39,41228,36543,77771
352790,201706,24,21,3,19677,2811,22488
352800,201706,243,166,77,155542,71867.9,227409.9
352810,201706,163,108,55,98723.92,51535,150258.92
352820,201706,65,55,10,51117.1,9370,60487.1
352830,201706,86,61,25,57157,23425,80582
352840,201706,553,286,267,266718.1,249898,516616.1
352850,201706,1310,476,834,445356.1,781458,1226814.1
352860,201706,122,79,43,74023,40291,114314
352870,201706,37,23,14,21551,13118,34669
352880,201706,186,130,56,121810,52472,174282
352885,201706,29,20,9,18740,8433,27173
352890,201706,52,35,17,32795,15648,48443
352900,201706,4922,2374,2548,2208230.83,2381799.88,4590030.71
352910,201706,42,32,10,29984,9370,39354
352920,201706,713,435,278,406658,260486,667144
352930,201706,1242,601,641,561713.34,597405.25,1159118.59
352940,201706,6236,2705,3531,2523079.85,3303536.08,5826615.93
352950,201706,92,38,54,35606,50598,86204
352960,201706,69,45,24,42165,22488,64653
352965,201706,20,8,12,7496,11244,18740
352970,201706,455,337,118,310854.27,109629.7,420483.97
352980,201706,177,92,85,86204,79645,165849
352990,201706,872,413,459,384296.14,428331.79,812627.93
353000,201706,66,30,36,28110,33732,61842
353010,201706,558,345,213,323265,199562.27,522827.27
353020,201706,288,210,78,196770,73086,269856
353030,201706,1149,532,617,498165.63,577454.73,1075620.36
353040,201706,88,54,34,50598,31858,82456
353050,201706,1265,789,476,734016.55,445918.3,1179934.85
353060,201706,7447,3474,3973,3241216.9,3715946.85,6957163.75
353070,201706,1627,1008,619,939285,578736.04,1518021.04
353080,201706,1316,685,631,639268.52,591238.32,1230506.84
353090,201706,59,36,23,33732,21551,55283
353100,201706,62,51,11,47787,10307,58094
353110,201706,1811,589,1222,550192.63,1143319.32,1693511.95
353120,201706,70,35,35,32795,32795,65590
353130,201706,854,416,438,388836.63,410377.89,799214.52
353140,201706,591,231,360,216334,337320,553654
353150,201706,358,198,160,184589,149910.63,334499.63
353160,201706,104,85,19,79645,17803,97448
353170,201706,202,66,136,61832.63,127404.63,189237.26
353180,201706,951,436,515,407299.95,482040,889339.95
353190,201706,452,323,129,301612.95,120873,422485.95
353200,201706,185,90,95,84049,89015,173064
353205,201706,26,19,7,17803,6559,24362
353210,201706,82,51,31,47787,29047,76834
353215,201706,58,34,24,31858,22488,54346
353220,201706,81,45,36,42165,32795.93,74960.93
353230,201706,157,60,97,56220,90889,147109
353240,201706,270,148,122,138676,114314,252990
353250,201706,197,105,92,98385,86204,184589
353260,201706,420,309,111,288418.25,103997.63,392415.88
353270,201706,69,51,18,47787,16210.1,63997.1
353280,201706,92,46,46,42634,43102,85736
353282,201706,114,84,30,78708,28110,106818
353284,201706,24,19,5,17803,4685,22488
353286,201706,1,1,0,937,0,937
353290,201706,78,47,31,44039,29038,73077
353300,201706,390,216,174,200877.55,163038,363915.55
353310,201706,50,46,4,43102,3748,46850
353320,201706,57,37,20,34669,18740,53409
353325,201706,53,35,18,32795,16567,49362
353330,201706,70,54,16,50458,14992,65450
353340,201706,592,191,401,178967,375165.54,554132.54
353350,201706,897,419,478,391797.92,446923,838720.92
353360,201706,109,86,23,80269.7,21270,101539.7
353370,201706,119,69,50,63716.55,46850,110566.55
353380,201706,31,22,9,20610,8433,29043
353390,201706,1025,499,526,467563,492862,960425
353400,201706,46,27,19,25299,17803,43102
353410,201706,116,70,46,65590,42400.1,107990.1
353420,201706,56,25,31,23425,29047,52472
353430,201706,541,354,187,328043.08,174787.9,502830.98
353440,201706,10190,4448,5742,4157373.13,5373749.17,9531122.30
353450,201706,57,29,28,27173,26236,53409
353460,201706,600,321,279,296728.99,259775.25,556504.24
353470,201706,2110,1146,964,1068702.26,901832.82,1970535.08
353475,201706,230,152,78,139785.3,73086,212871.3
353480,201706,190,151,39,141487,36543,178030
353490,201706,228,135,93,126495,87141,213636
353500,201706,178,107,71,99041.3,66527,165568.3
353510,201706,103,74,29,69319.63,27163.63,96483.26
353520,201706,209,145,64,135865,59968,195833
353530,201706,442,240,202,224880,189274,414154
353540,201706,349,232,117,217067.02,109629,326696.02
353550,201706,716,486,230,452290.85,215510,667800.85
353560,201706,625,265,360,247368.6,337016.22,584384.82
353570,201706,60,31,29,29047,27173,56220
353580,201706,356,275,81,257207,75897,333104
353590,201706,79,53,26,49661,24362,74023
353600,201706,262,150,112,140238,104944,245182
353610,201706,114,60,54,56220,50598,106818
353620,201706,553,298,255,276993.52,238653.9,515647.42
353625,201706,51,24,27,22488,25299,47787
353630,201706,235,169,66,154100.07,61842,215942.07
353640,201706,121,82,39,75897.5,36543,112440.5
353650,201706,813,324,489,301526.6,458193,759719.6
353657,201706,21,15,6,14055,5622,19677
353660,201706,254,141,113,132117,105599.9,237716.9
353670,201706,702,422,280,394477.1,262360,656837.1
353680,201706,99,71,28,66527,26236,92763
353690,201706,45,36,9,33732,8433,42165
353700,201706,291,204,87,191148,81519,272667
353710,201706,397,183,214,170534.4,200518,371052.4
353715,201706,45,37,8,34387.9,7496,41883.9
353720,201706,365,166,199,155524,186434,341958
353730,201706,1114,688,426,641518.45,398880.9,1040399.35
353740,201706,636,362,274,338912.9,256738,595650.9
353750,201706,98,60,38,55697.62,35606,91303.62
353760,201706,2583,969,1614,904369.2,1508671.37,2413040.57
353770,201706,99,80,19,74491.5,17803,92294.5
353780,201706,1055,543,512,506156.3,478525.9,984682.2
353790,201706,503,287,216,267773.28,202272,470045.28
353800,201706,3224,1649,1575,1537348.46,1472902.17,3010250.63
353810,201706,236,132,104,122845.75,97421,220266.75
353820,201706,173,87,86,81519,79968.54,161487.54
353830,201706,46,40,6,37480,5622,43102
353850,201706,168,86,82,80582,76834,157416
353860,201706,458,202,256,187895.35,239590.9,427486.25
353870,201706,4901,2450,2451,2281803.5,2287900.48,4569703.98
353880,201706,637,447,190,417387.2,177093.36,594480.56
353890,201706,584,318,266,297404,249242,546646
353900,201706,139,65,74,60905,69338,130243
353910,201706,181,86,95,80582,89015,169597
353920,201706,454,247,207,230268.7,193945.64,424214.34
353930,201706,964,578,386,540180.5,360516.9,900697.4
353940,201706,185,102,83,94824.4,76928,171752.4
353950,201706,512,320,192,299830.63,179904,479734.63
353960,201706,69,55,14,51535,13118,64653
353970,201706,71,46,25,43102,23425,66527
353980,201706,1506,744,762,694521.59,713982,1408503.59
353990,201706,76,42,34,39354,31858,71212
354000,201706,373,173,200,161446,187208.6,348654.6
354010,201706,97,51,46,47787,42634,90421
354020,201706,533,335,198,312958,185244.9,498202.9
354025,201706,52,44,8,41228,7496,48724
354030,201706,62,32,30,29984,28110,58094
354040,201706,90,65,25,60351.21,23425,83776.21
354050,201706,176,104,72,97167,67464,164631
354060,201706,767,375,392,351375,365431.65,716806.65
354070,201706,871,500,371,466372.52,347627,813999.52
354075,201706,198,109,89,102040,82456.9,184496.9
354080,201706,277,121,156,113095.9,146172,259267.9
354085,201706,19,12,7,11244,6559,17803
354090,201706,317,176,141,164833,132117,296950
354100,201706,5380,2211,3169,2061869.17,2964847.55,5026716.72
354105,201706,81,41,40,38417,37480,75897
354110,201706,44,20,24,18740,22488,41228
354120,201706,142,98,44,91689.29,41228,132917.29
354130,201706,671,451,220,422353,205859,628212
354140,201706,3164,1483,1681,1385952.97,1574052.62,2960005.59
354150,201706,624,388,236,362338,219726.5,582064.5
354160,201706,671,416,255,388620.75,238654,627274.75
354165,201706,18,12,6,11244,5622,16866
354170,201706,167,113,54,105225.1,50598,155823.1
354180,201706,66,41,25,38097,23425,61522
354190,201706,199,90,109,82737.1,102133,184870.1
354200,201706,132,72,60,66996,56220,123216
354210,201706,73,36,37,33732,34669,68401
354220,201706,643,402,241,375966.1,224880.18,600846.28
354230,201706,158,66,92,61842,85267.8,147109.8
354240,201706,315,205,110,190867.69,102445.3,293312.99
354250,201706,89,52,37,48724,34669,83393
354260,201706,1872,872,1000,805023.46,934746,1739769.46
354270,201706,96,71,25,66527,23425,89952
354280,201706,32,17,15,15929,14055,29984
354290,201706,149,100,49,92435.55,45913,138348.55
354300,201706,418,290,128,271418,119936,391354
354310,201706,100,72,28,66527.1,26236,92763.1
354320,201706,186,96,90,89952,84330,174282
354323,201706,14,12,2,11244,1874,13118
354325,201706,114,64,50,59968,46850,106818
354330,201706,2468,856,1612,797685.24,1508315.69,2306000.93
354340,201706,10603,5145,5458,4803230.62,5108996.63,9912227.25
354350,201706,130,88,42,82456,39213.45,121669.45
354360,201706,90,48,42,44976,39354,84330
354370,201706,263,137,126,128369,118062,246431
354380,201706,205,120,85,111666,79645,191311
354390,201706,2737,994,1743,931069.6,1631085.04,2562154.64
354400,201706,322,166,156,154465.9,145328.8,299794.7
354410,201706,600,291,309,271726.32,288315.1,560041.42
354420,201706,264,168,96,157416,89952,247368
354425,201706,303,172,131,161164,122738,283902
354430,201706,190,123,67,112927.95,62029.4,174957.35
354440,201706,44,31,13,28929,12181,41110
354450,201706,47,32,15,29984,14055,44039
354460,201706,99,56,43,52472,40291,92763
354470,201706,38,27,11,25299,10307,35606
354480,201706,117,63,54,59022,50588.63,109610.63
354490,201706,143,90,53,84173.81,49661,133834.81
354500,201706,397,194,203,181778,190211,371989
354510,201706,110,74,36,69234.56,33732,102966.56
354515,201706,38,14,24,13118,22488,35606
354520,201706,1558,701,857,653767.6,802671.68,1456439.28
354530,201706,606,317,289,294682.5,269950.1,564632.6
354540,201706,270,150,120,140550,112435.32,252985.32
354550,201706,44,25,19,23425,17803,41228
354560,201706,157,91,66,85267,61832.63,147099.63
354570,201706,147,96,51,89952,47787,137739
354580,201706,1987,947,1040,884456,973249.54,1857705.54
354600,201706,274,148,126,137252.36,118057.32,255309.68
354610,201706,69,61,8,57157,7496,64653
354620,201706,64,18,46,16866,43102,59968
354625,201706,18,12,6,11244,5618,16862
354630,201706,326,215,111,200911.91,104007,304918.91
354640,201706,782,506,276,470266.5,258612,728878.5
354650,201706,73,39,34,36534,31821.26,68355.26
354660,201706,787,571,216,531544.85,202392,733936.85
354670,201706,291,103,188,96511,175220,271731
354680,201706,1221,462,759,432894,710715,1143609
354690,201706,86,59,27,54347,25299,79646
354700,201706,79,55,24,51535,22488,74023
354710,201706,54,37,17,34044.3,15929,49973.3
354720,201706,22,21,1,19677,937,20614
354730,201706,1901,809,1092,755401.5,1023016.6,1778418.1
354740,201706,55,39,16,36543,14992,51535
354750,201706,422,252,170,236115,159290,395405
354760,201706,508,312,196,289932,183371,473303
354765,201706,11,5,6,4685,5622,10307
354770,201706,314,223,91,207860.71,85267,293127.71
354780,201706,8089,3282,4807,3061719.08,4499459.29,7561178.37
354790,201706,116,68,48,63716,44976,108692
354800,201706,396,220,176,206140,164631,370771
354805,201706,104,53,51,49037,47787,96824
354810,201706,140,82,58,76552.9,54346,130898.9
354820,201706,177,78,99,72880,92763,165643
354830,201706,38,22,16,20614,14992,35606
354840,201706,53,35,18,32795,16866,49661
354850,201706,4562,2019,2543,1884810.6,2378195.76,4263006.36
354860,201706,336,164,172,153668,159103.3,312771.3
354870,201706,11467,5241,6226,4884928.88,5824857.85,10709786.73
354880,201706,2955,1107,1848,1035088.55,1729727.96,2764816.51
354890,201706,2806,1549,1257,1446461.1,1176666.12,2623127.22
354900,201706,59,38,21,35606,19677,55283
354910,201706,1162,612,550,570530.4,515350,1085880.4
354920,201706,52,44,8,41228,7496,48724
354925,201706,11,6,5,5622,4685,10307
354930,201706,32,28,4,25970,3748,29718
354940,201706,796,580,216,541307.84,202392,743699.84
354950,201706,229,150,79,139948,74023,213971
354960,201706,171,66,105,61842,98104,159946
354970,201706,813,522,291,485277.09,272039.31,757316.40
354980,201706,8224,3084,5140,2883301.19,4814357.35,7697658.54
354990,201706,9035,4257,4778,3980547.7,4470785.51,8451333.21
354995,201706,519,185,334,173345,312367.69,485712.69
355000,201706,450,147,303,137734.32,282850,420584.32
355010,201706,626,400,226,373863.45,209589.36,583452.81
355020,201706,717,449,268,419771.9,251108,670879.9
355030,201706,200305,77439,122866,72350976.71,115024959.6,187375936.31
355040,201706,703,339,364,317362,340880.6,658242.6
355050,201706,154,103,51,95262.77,47787,143049.77
355060,201706,1329,692,637,643551.78,595042.25,1238594.03
355070,201706,1451,718,733,669942.44,685836,1355778.44
355080,201706,200,117,83,109421.74,76899.9,186321.64
355090,201706,279,188,91,174096,85267,259363
355100,201706,4692,2357,2335,2191607.1,2185778.07,4377385.17
355110,201706,295,193,102,179108.55,95574,274682.55
355120,201706,112,82,30,76365.5,28110,104475.5
355130,201706,50,26,24,24362,22488,46850
355140,201706,182,119,63,111503,59031,170534
355150,201706,676,407,269,380137.1,252053,632190.1
355160,201706,431,197,234,182246.8,219258,401504.8
355170,201706,1998,1037,961,970311.87,900064.28,1870376.15
355180,201706,620,258,362,240527.9,338093.02,578620.92
355190,201706,215,146,69,136802,64653,201455
355200,201706,110,62,48,58094,44976,103070
355210,201706,677,394,283,369178,265143.63,634321.63
355220,201706,6366,3433,2933,3207222.5,2741094.74,5948317.24
355230,201706,106,64,42,59968,39349.32,99317.32
355240,201706,4055,1788,2267,1663759.05,2120176.38,3783935.43
355250,201706,5208,2554,2654,2386260.51,2483650.6,4869911.11
355255,201706,50,29,21,27173,19677,46850
355260,201706,183,111,72,103051.36,67446,170497.36
355270,201706,169,101,68,94637,63014,157651
355280,201706,6081,2606,3475,2436970.75,3251051.07,5688021.82
355290,201706,79,60,19,56220,17803,74023
355300,201706,178,120,58,112112.05,54346,166458.05
355310,201706,106,60,46,56220,43102,99322
355320,201706,94,46,48,42820.9,44280.3,87101.2
355330,201706,269,147,122,137739,114314,252053
355340,201706,1280,529,751,493799.68,702958.2,1196757.88
355350,201706,135,69,66,64653,61842,126495
355360,201706,169,101,68,94430.86,63716,158146.86
355365,201706,26,21,5,19677,4685,24362
355370,201706,1021,577,444,535830.59,414014.39,949844.98
355380,201706,762,512,250,478344.8,234250,712594.8
355385,201706,51,36,15,33732,14055,47787
355390,201706,104,59,45,55283,42165,97448
355395,201706,187,115,72,106954.32,67464,174418.32
355400,201706,1495,936,559,873104.98,523220.9,1396325.88
355410,201706,4782,2231,2551,2074425.41,2381158.48,4455583.89
355420,201706,44,33,11,30921,10307,41228
355430,201706,333,206,127,192366.1,118999,311365.1
355440,201706,75,42,33,39354,30921,70275
355450,201706,418,195,223,178546.87,207358.3,385905.17
355460,201706,69,54,15,49661.51,14055,63716.51
355465,201706,50,32,18,29984,16866,46850
355470,201706,185,71,114,65590.55,106818,172408.55
355475,201706,10,7,3,6559,2811,9370
355480,201706,441,190,251,176906,233303.63,410209.63
355490,201706,113,83,30,77771,28110,105881
355495,201706,52,25,27,23425,25299,48724
355500,201706,1694,960,734,895011.14,687161.54,1582172.68
355510,201706,268,199,69,183066.5,64653,247719.5
355520,201706,37,29,8,27173,7496,34669
355530,201706,20,13,7,12181,6559,18740
355535,201706,77,36,41,33732,38417,72149
355540,201706,2293,923,1370,863286.31,1282734.63,2146020.94
355550,201706,65,40,25,37480,23425,60905
355560,201706,231,118,113,110566,105256.3,215822.3
355570,201706,29,18,11,16866,10307,27173
355580,201706,270,184,86,172408,80577.32,252985.32
355590,201706,22,14,8,13118,7496,20614
355600,201706,269,141,128,132117,119650.32,251767.32
355610,201706,199,130,69,121810,64653,186463
355620,201706,1221,556,665,519238.9,622538.8,1141777.7
355630,201706,403,281,122,262361,114314,376675
355635,201706,131,59,72,55283,67451,122734
355640,201706,568,332,236,310147,221132,531279
355645,201706,827,356,471,331910.64,439481.21,771391.85
355650,201706,1945,898,1047,839900,981020.63,1820920.63
355660,201706,267,142,125,133054,117120.32,250174.32
355670,201706,451,164,287,153668,268919,422587
355680,201706,212,118,94,110566,88078,198644
355690,201706,85,41,44,38417,40890,79307
355695,201706,14,12,2,11244,1874,13118
355700,201706,1109,582,527,539353.61,493518,1032871.61
355710,201706,2166,1190,976,1109863.68,913921.9,2023785.58
355715,201706,20,18,2,16866,1874,18740
355720,201706,201,122,79,112752.66,74019,186771.66
355730,201706,86,52,34,47865.53,31858,79723.53
410010,201706,128,108,20,101196,18740,119936
410020,201706,102,91,11,85267,10307,95574
410030,201706,161,102,59,94918.2,55283,150201.2
410040,201706,976,521,455,487623.79,426148,913771.79
410045,201706,34,29,5,27173,4685,31858
410050,201706,464,259,205,242663,191335.5,433998.5
410060,201706,260,203,57,189930,53409,243339
410070,201706,324,263,61,246431,57157,303588
410080,201706,167,109,58,102133,54346,156479
410090,201706,74,66,8,61636,7496,69132
410100,201706,296,210,86,196770,79879.25,276649.25
410105,201706,39,24,15,22488,14055,36543
410110,201706,309,187,122,175219,114314,289533
410115,201706,27,18,9,16866,8433,25299
410120,201706,446,225,221,210528.9,207077,417605.9
410130,201706,39,26,13,24362,12181,36543
410140,201706,2986,1460,1526,1362871.63,1428594.52,2791466.15
410150,201706,2662,1071,1591,1003264.75,1489993.5,2493258.25
410160,201706,499,320,179,299558.9,167723,467281.9
410165,201706,65,42,23,39354,21551,60905
410170,201706,167,127,40,116803.83,37480,154283.83
410180,201706,2071,1194,877,1114861.69,820411.08,1935272.77
410185,201706,43,39,4,36543,3748,40291
410190,201706,403,246,157,230502,147109,377611
410200,201706,966,729,237,681280.34,221787.9,903068.24
410210,201706,546,280,266,262360,248680,511040
410220,201706,39,23,16,21551,14992,36543
410230,201706,119,71,48,66527,44976,111503
410240,201706,714,471,243,440764.9,227691,668455.9
410250,201706,384,284,100,265514.6,93679.89,359194.49
410260,201706,310,168,142,157416,133054,290470
410270,201706,30,20,10,18740,9370,28110
410275,201706,74,56,18,52472,16866,69338
410280,201706,305,171,134,159972.14,125558,285530.14
410290,201706,216,147,69,136875.92,64210.91,201086.83
410300,201706,83,65,18,60905,16866,77771
410302,201706,24,16,8,14992,7496,22488
410304,201706,50,33,17,30921,15929,46850
410305,201706,185,95,90,88223,84330,172553
410310,201706,259,168,91,157416,85267,242683
410315,201706,58,42,16,39330,14992,54322
410320,201706,136,94,42,88078,39354,127432
410322,201706,33,22,11,20614,10307,30921
410330,201706,167,120,47,112440,44039,156479
410335,201706,97,60,37,56220,34669,90889
410337,201706,36,32,4,29984,3748,33732
410340,201706,31,30,1,28110,937,29047
410345,201706,202,128,74,119195.77,69338,188533.77
410347,201706,51,39,12,36543,11244,47787
410350,201706,231,141,90,132117,84330,216447
410360,201706,451,272,179,252085.2,167442,419527.2
410370,201706,2280,936,1344,874156.36,1256031.11,2130187.47
410380,201706,223,148,75,138676,70275,208951
410390,201706,359,271,88,253923,82456,336379
410395,201706,36,24,12,22488,10870,33358
410400,201706,811,414,397,386799.1,371460,758259.1
410405,201706,88,65,23,60905,21551,82456
410410,201706,44,34,10,31858,9370,41228
410420,201706,1613,801,812,748764.6,759283.3,1508047.9
410425,201706,174,86,88,80395,82765,163160
410430,201706,2175,1273,902,1190364.9,842944.16,2033309.06
410440,201706,399,284,115,265172,107755,372927
410442,201706,363,241,122,224881,114314,339195
410445,201706,418,290,128,271730,119936,391666
410450,201706,399,196,203,183652,190211,373863
410460,201706,398,216,182,202110.9,170534,372644.9
410465,201706,194,125,69,115625.8,64653,180278.8
410470,201706,216,133,83,124621,77771,202392
410480,201706,5543,2752,2791,2563345.7,2610298.99,5173644.69
410490,201706,1352,895,457,837445,426336,1263781
410500,201706,256,144,112,134928,104944,239872
410510,201706,181,129,52,120873,48090.3,168963.3
410520,201706,270,201,69,188337,64653,252990
410530,201706,232,87,145,81519,135861,217380
410540,201706,313,226,87,211191.8,81514.32,292706.12
410550,201706,1559,682,877,638752.9,821182.12,1459935.02
410560,201706,142,108,34,101196,31858,133054
410570,201706,440,307,133,285326.95,124621,409947.95
410580,201706,3111,1400,1711,1309278.36,1601802,2911080.36
410590,201706,391,276,115,258612,107755,366367
410600,201706,171,151,20,141487,18740,160227
410610,201706,50,41,9,38417,8433,46850
410620,201706,230,167,63,156479,59031,215510
410630,201706,443,261,182,244557,169395,413952
410640,201706,928,566,362,528162.44,337334.75,865497.19
410645,201706,100,73,27,68007,25299,93306
410650,201706,361,245,116,228628,108692,337320
410655,201706,77,61,16,57157,14992,72149
410657,201706,42,17,25,15929,23425,39354
410660,201706,573,409,164,381634,153668,535302
410670,201706,74,59,15,55283,14055,69338
410680,201706,191,155,36,145235,32775.57,178010.57
410685,201706,20,14,6,13118,5622,18740
410690,201706,28452,12288,16164,11497532.29,15135712.12,26633244.41
410700,201706,310,228,82,213074,76834,289908
410710,201706,132,107,25,100259,23425,123684
410712,201706,19,11,8,10307,7496,17803
410715,201706,86,65,21,60905,19677,80582
410720,201706,577,352,225,329824,210816,540640
410725,201706,171,124,47,116188,44039,160227
410730,201706,94,59,35,55283,32795,88078
410740,201706,113,85,28,79645,26236,105881
410750,201706,212,159,53,148983,49661,198644
410752,201706,20,14,6,13118,5622,18740
410753,201706,50,22,28,19953.41,26236,46189.41
410754,201706,34,21,13,19677,12181,31858
410755,201706,83,57,26,53127.9,24362,77489.9
410760,201706,684,393,291,368241,272199,640440
410765,201706,1604,773,831,718207.94,777794.63,1496002.57
410770,201706,107,91,16,85267,14992,100259
410773,201706,47,34,13,31858,12181,44039
410775,201706,173,128,45,119280.1,42165,161445.1
410780,201706,82,44,38,41228,35606,76834
410785,201706,73,55,18,51348,16866,68214
410790,201706,65,32,33,29984,30921,60905
410800,201706,295,187,108,174283,101196,275479
410810,201706,34,27,7,25299,6278,31577
410820,201706,179,135,44,126355,41228,167583
410830,201706,8479,3883,4596,3629396.3,4304509.19,7933905.49
410832,201706,107,75,32,69993.9,29984,99977.9
410840,201706,1359,747,612,697433.99,573323.67,1270757.66
410845,201706,59,36,23,33732,21551,55283
410850,201706,191,131,60,122426,56220,178646
410855,201706,43,38,5,35606,4685,40291
410860,201706,671,392,279,366532.75,261423,627955.75
410865,201706,109,82,27,76834,25299,102133
410870,201706,148,130,18,121810,16579,138389
410880,201706,1072,529,543,495358.05,508737,1004095.05
410890,201706,75,58,17,54346,15929,70275
410895,201706,74,54,20,50598,18740,69338
410900,201706,28,21,7,19677,6559,26236
410910,201706,23,20,3,18740,2811,21551
410920,201706,36,24,12,22488,11244,33732
410930,201706,504,323,181,302443.74,169315.9,471759.64
410940,201706,4272,2558,1714,2388249.67,1602620.7,3990870.37
410950,201706,122,87,35,81519,32795,114314
410960,201706,743,331,412,309866,386044,695910
410965,201706,64,50,14,46850,13118,59968
410970,201706,612,433,179,405265.1,167723,572988.1
410975,201706,104,69,35,64292,32795,97087
410980,201706,1492,674,818,629384.9,766176.22,1395561.12
410990,201706,257,173,84,161935.25,78426.9,240362.15
411000,201706,60,42,18,39354,16866,56220
411005,201706,22,15,7,14055,6559,20614
411007,201706,235,136,99,127432,92763,220195
411010,201706,567,400,167,374575,156479,531054
411020,201706,282,191,91,178967,85267,264234
411030,201706,25,15,10,14055,9370,23425
411040,201706,49,34,15,31858,14055,45913
411050,201706,221,177,44,164421.17,41101.12,205522.29
411060,201706,505,344,161,322319,150857,473176
411065,201706,58,52,6,48602.19,5622,54224.19
411070,201706,1160,778,382,725051,357934,1082985
411080,201706,243,174,69,163121,63866.66,226987.66
411090,201706,112,82,30,76834,28110,104944
411095,201706,258,107,151,99791,141477,241268
411100,201706,113,94,19,87953,17803,105756
411110,201706,123,84,39,78708,36543,115251
411120,201706,170,130,40,121810,37480,159290
411125,201706,167,74,93,68682.1,87141,155823.1
411130,201706,114,98,16,91200,14992,106192
411140,201706,167,118,49,110263.9,45397.65,155661.55
411150,201706,1168,778,390,728976.63,365430,1094406.63
411155,201706,116,81,35,75897,32795,108692
411160,201706,21,10,11,9370,10307,19677
411170,201706,61,53,8,49379.9,7496,56875.9
411180,201706,899,590,309,551612,289528.32,841140.32
411190,201706,309,174,135,162382.1,126495,288877.1
411200,201706,661,438,223,409157.09,208341.95,617499.04
411210,201706,662,352,310,328301.83,290470,618771.83
411220,201706,146,110,36,103070,33732,136802
411230,201706,51,45,6,42165,5622,47787
411240,201706,125,87,38,81519,35606,117125
411250,201706,412,296,116,277352,108692,386044
411260,201706,22,15,7,14055,6559,20614
411270,201706,287,158,129,148046,120873,268919
411275,201706,202,177,25,165709,23425,189134
411280,201706,227,159,68,147734.36,63716,211450.36
411290,201706,60,43,17,40291,15929,56220
411295,201706,143,114,29,106818,27173,133991
411300,201706,81,44,37,41228,34669,75897
411310,201706,93,70,23,65590,21551,87141
411320,201706,731,535,196,499937.9,182078.24,682016.14
411325,201706,45,28,17,25486.4,15929,41415.4
411330,201706,878,560,318,522779.75,297122.8,819902.55
411340,201706,26,17,9,15929,8124,24053
411342,201706,84,60,24,56220,22488,78708
411345,201706,118,59,59,55283,55283,110566
411350,201706,468,381,87,356013.92,81228.63,437242.55
411360,201706,51,31,20,29047,18740,47787
411370,201706,13718,5644,8074,5273068.89,7553229.99,12826298.88
411373,201706,198,147,51,137739,47787,185526
411375,201706,84,69,15,64653,14055,78708
411380,201706,101,73,28,67464.89,26236,93700.89
411390,201706,142,93,49,87141,45913,133054
411400,201706,344,254,90,237989,84330,322319
411410,201706,438,223,215,208295.1,201174,409469.1
411420,201706,1012,467,545,435330.2,510196.6,945526.8
411430,201706,398,257,141,240153.1,132108,372261.1
411435,201706,39,28,11,26236,10307,36543
411440,201706,465,373,92,347877.37,86204,434081.37
411450,201706,431,355,76,332635,71212,403847
411460,201706,705,280,425,261391.64,396924.4,658316.04
411470,201706,120,89,31,83393,29047,112440
411480,201706,610,347,263,323640.8,246149.9,569790.7
411490,201706,287,176,111,164912,104007,268919
411500,201706,106,91,15,85267,13399.9,98666.9
411510,201706,214,173,41,161366.39,38417,199783.39
411520,201706,5834,2287,3547,2139375.34,3315919.89,5455295.23
411530,201706,110,72,38,67464,35606,103070
411535,201706,52,20,32,18740,29984,48724
411540,201706,311,211,100,196887.6,93700,290587.6
411545,201706,73,52,21,48724,19677,68401
411550,201706,73,57,16,53409,14992,68401
411560,201706,373,168,205,156788.21,192085,348873.21
411570,201706,771,290,481,271449,450510,721959
411573,201706,36,22,14,20614,13118,33732
411575,201706,254,154,100,144298,93700,237998
411580,201706,1201,475,726,444419.1,678239.7,1122658.8
411585,201706,74,35,39,32795,36543,69338
411590,201706,26,18,8,16866,7496,24362
411600,201706,39,19,20,17803,18740,36543
411605,201706,231,108,123,101036,115251,216287
411610,201706,239,162,77,151794,72149,223943
411620,201706,346,193,153,180653.6,143361,324014.6
411630,201706,55,36,19,33732,17803,51535
411640,201706,41,33,8,30921,7496,38417
411650,201706,13,10,3,9370,2811,12181
411660,201706,41,35,6,32795,5622,38417
411670,201706,247,189,58,176081.81,54326,230407.81
411680,201706,157,135,22,126495,20614,147109
411690,201706,592,324,268,302971.08,250733.6,553704.68
411695,201706,64,49,15,45913,14055,59968
411700,201706,169,145,24,135865,22488,158353
411705,201706,106,68,38,63716,35606,99322
411710,201706,294,193,101,179875.1,94637,274512.1
411720,201706,132,84,48,78708,44976,123684
411721,201706,73,60,13,56220,12181,68401
411722,201706,95,41,54,38417,50598,89015
411725,201706,142,110,32,102789,29984,132773
411727,201706,83,69,14,64653,12836.9,77489.9
411729,201706,35,26,9,24362,8433,32795
411730,201706,547,351,196,327325.3,183652,510977.3
411740,201706,29,22,7,20614,6559,27173
411745,201706,69,47,22,43262,20614,63876
411750,201706,823,398,425,371568.9,397546.36,769115.26
411760,201706,1185,893,292,835233.04,273595,1108828.04
411770,201706,414,285,129,267045,120873,387918
411780,201706,357,231,126,216447,118062,334509
411790,201706,515,282,233,263312.17,218209.67,481521.84
411800,201706,168,133,35,124621,32795,157416
411810,201706,155,120,35,112440,32795,145235
411820,201706,2083,1026,1057,959094.56,990006.86,1949101.42
411830,201706,10,10,0,9370,0,9370
411840,201706,1913,1182,731,1106858.6,684459,1791317.6
411845,201706,49,17,32,15929,29984,45913
411850,201706,1225,714,511,666572.74,476888.81,1143461.55
411860,201706,44,29,15,26892,14055,40947
411870,201706,32,26,6,24362,5622,29984
411880,201706,415,271,144,253673,134197.14,387870.14
411885,201706,108,70,38,65590,35606,101196
411890,201706,323,201,122,188337,114305,302642
411900,201706,72,53,19,49661,17803,67464
411910,201706,167,138,29,129296.63,26236,155532.63
411915,201706,2006,869,1137,813121.11,1064598.93,1877720.04
411920,201706,121,102,19,95574,17803,113377
411925,201706,18,12,6,11244,5622,16866
411930,201706,788,583,205,544399,192085,736484
411940,201706,583,417,166,390729,155517.56,546246.56
411950,201706,872,468,404,438506.63,378235.7,816742.33
411960,201706,949,677,272,632018,254864,886882
411965,201706,28,19,9,17803,8433,26236
411970,201706,71,64,7,59968,6559,66527
411980,201706,198,128,70,119936,65590,185526
411990,201706,4719,2780,1939,2587910.51,1814820.4,4402730.91
411995,201706,443,169,274,158353,256738,415091
412000,201706,268,152,116,141722.56,108692,250414.56
412010,201706,43,26,17,24362,15929,40291
412015,201706,43,32,11,29984,10307,40291
412020,201706,30,26,4,24080.9,3748,27828.9
412030,201706,64,54,10,50598,9370,59968
412033,201706,52,34,18,31834,16866,48700
412035,201706,87,55,32,51535,29984,81519
412040,201706,34,24,10,22207,9370,31577
412050,201706,201,149,52,139613,48724,188337
412060,201706,747,589,158,549082.88,147077.9,696160.78
412065,201706,45,32,13,29984,12181,42165
412070,201706,152,104,48,96792.1,44976,141768.1
412080,201706,270,137,133,128369,124621,252990
412085,201706,30,13,17,12181,15929,28110
412090,201706,718,445,273,415045.1,255801,670846.1
412100,201706,239,198,41,184590,38229.6,222819.6
412110,201706,74,60,14,56220,13118,69338
412120,201706,306,200,106,186837.8,99322,286159.8
412125,201706,81,46,35,42820.9,32795,75615.9
412130,201706,53,36,17,33732,15929,49661
412135,201706,26,14,12,13118,11244,24362
412140,201706,287,213,74,199581,69338,268919
412150,201706,255,172,83,160227.62,77771,237998.62
412160,201706,99,61,38,57157,35606,92763
412170,201706,617,446,171,417902,160227,578129
412175,201706,47,36,11,33732,10307,44039
412180,201706,193,153,40,142772.29,37480,180252.29
412190,201706,329,267,62,249518.41,58094,307612.41
412200,201706,190,124,66,116188,61842,178030
412210,201706,97,77,20,72149,18740,90889
412215,201706,234,159,75,148983,70275,219258
412217,201706,89,70,19,65590,17803,83393
412220,201706,804,607,197,568759,184589,753348
412230,201706,333,208,125,192701.67,116745.75,309447.42
412240,201706,1281,619,662,576102.23,617181.71,1193283.94
412250,201706,380,243,137,227691,128369,356060
412260,201706,125,92,33,86204,30921,117125
412265,201706,161,130,31,121810,29047,150857
412270,201706,82,47,35,44039,32795,76834
412280,201706,86,68,18,63716,16866,80582
412290,201706,97,63,34,59031,31858,90889
412300,201706,224,145,79,135865,74023,209888
412310,201706,44,37,7,34669,6559,41228
412320,201706,95,80,15,74960,14055,89015
412330,201706,163,144,19,134928,17803,152731
412340,201706,138,94,44,88078,40947,129025
412350,201706,568,276,292,257628.15,273417,531045.15
412360,201706,26,23,3,21551,2811,24362
412370,201706,162,136,26,126495,24362,150857
412380,201706,257,189,68,176811.9,63191.65,240003.55
412382,201706,53,27,26,25299,24362,49661
412385,201706,134,95,39,89015,36543,125558
412390,201706,266,197,69,184589,64653,249242
412395,201706,62,50,12,46850,11244,58094
412400,201706,68,49,19,45913,17803,63716
412402,201706,235,106,129,99317.32,120591.9,219909.22
412405,201706,799,322,477,300283.01,446471.64,746754.65
412410,201706,913,564,349,526969,327013,853982
412420,201706,17,12,5,11244,4685,15929
412430,201706,20,15,5,14055,4685,18740
412440,201706,580,316,264,293135.87,245694.4,538830.27
412450,201706,83,69,14,64653,13118,77771
412460,201706,74,59,15,55283,14055,69338
412470,201706,257,208,49,194896,45913,240809
412480,201706,179,134,45,124340.5,42165,166505.5
412490,201706,158,134,24,125558,22488,148046
412500,201706,476,383,93,357653.3,87141,444794.3
412510,201706,193,156,37,145329,34669,179998
412520,201706,129,72,57,67464,53409,120873
412530,201706,106,58,48,54346,44413.9,98759.9
412535,201706,109,83,26,77753,24353,102106
412540,201706,67,32,35,29984,32795,62779
412545,201706,96,71,25,66527,23425,89952
412550,201706,3409,1556,1853,1454136.29,1735043.45,3189179.74
412555,201706,16,12,4,11244,3748,14992
412560,201706,567,428,139,399725.1,130243,529968.1
412570,201706,733,414,319,387318.32,298622,685940.32
412575,201706,90,63,27,59031,25299,84330
412580,201706,152,105,47,98385,44039,142424
412590,201706,33,31,2,29047,1874,30921
412600,201706,173,133,40,124621,37480,162101
412610,201706,35,22,13,20614,11376,31990
412620,201706,150,132,18,123684,16866,140550
412625,201706,2149,1145,1004,1071096.76,939184.72,2010281.48
412627,201706,66,53,13,49661,12181,61842
412630,201706,434,288,146,269665,136802,406467
412635,201706,63,21,42,19677,39354,59031
412640,201706,118,80,38,74960,35606,110566
412650,201706,328,208,120,194896,112435.32,307331.32
412660,201706,480,283,197,264469,184589,449058
412665,201706,54,48,6,44976,5622,50598
412667,201706,314,206,108,192417.6,100832.04,293249.64
412670,201706,65,55,10,51535,9370,60905
412680,201706,278,223,55,208951,51535,260486
412690,201706,110,72,38,67464,35325,102789
412700,201706,169,116,53,108692,49380,158072
412710,201706,1392,867,525,805822.8,489489,1295311.8
412720,201706,226,154,72,144298,67464,211762
412730,201706,201,153,48,143361,44039,187400
412740,201706,400,216,184,202251.45,172408,374659.45
412750,201706,461,263,198,245494,185526,431020
412760,201706,236,119,117,111503,109629,221132
412770,201706,1989,1142,847,1065757.86,793331,1859088.86
412780,201706,149,120,29,112307.88,27173,139480.88
412785,201706,262,133,129,124152.5,120873,245025.5
412788,201706,36,21,15,19677,14055,33732
412790,201706,134,110,24,102414.1,22488,124902.1
412795,201706,161,119,42,111503,39354,150857
412796,201706,299,204,95,190004.83,88883.82,278888.65
412800,201706,540,354,186,331148.36,174273,505421.36
412810,201706,2923,1625,1298,1519045.69,1214722.12,2733767.81
412820,201706,928,612,316,560638,292505.94,853143.94
412830,201706,18,14,4,13118,3748,16866
412840,201706,213,152,61,141487.1,57157,198644.1
412850,201706,773,532,241,496610,225817,722427
412853,201706,177,97,80,90889,74960,165849
412855,201706,219,118,101,109192.21,94637,203829.21
412860,201706,90,69,21,64653,19677,84330
412862,201706,66,48,18,44694.9,16866,61560.9
412863,201706,8,7,1,6559,937,7496
412865,201706,43,33,10,30921,9370,40291
412870,201706,109,69,40,64653,37480,102133
412880,201706,128,100,28,93700,26236,119936
420005,201706,36,33,3,30921,2249,33170
420010,201706,365,243,122,226872.67,114305,341177.67
420020,201706,71,61,10,57157,9370,66527
420030,201706,29,26,3,24362,2811,27173
420040,201706,106,81,25,75897,23425,99322
420050,201706,55,33,22,30559.9,20453.34,51013.24
420055,201706,20,19,1,17782,937,18719
420060,201706,35,27,8,25299,7496,32795
420070,201706,95,83,12,77771,11234.63,89005.63
420075,201706,12,10,2,9370,1874,11244
420080,201706,46,40,6,36589.85,5622,42211.85
420090,201706,36,34,2,31094.34,1874,32968.34
420100,201706,149,125,24,116188.1,22488,138676.1
420110,201706,16,16,0,14992,0,14992
420120,201706,43,32,11,29984,10307,40291
420125,201706,83,66,17,61093,15929,77022
420127,201706,32,29,3,27173,2811,29984
420130,201706,357,226,131,211471.63,122737.63,334209.26
420140,201706,1199,701,498,655872.26,466562,1122434.26
420150,201706,46,39,7,36543,6559,43102
420160,201706,42,39,3,36543,2811,39354
420165,201706,17,13,4,12181,3748,15929
420170,201706,64,41,23,38417,21551,59968
420180,201706,24,23,1,21551,937,22488
420190,201706,32,29,3,27173,2811,29984
420195,201706,123,58,65,54346,60624,114970
420200,201706,1259,560,699,519102.1,654318.89,1173420.99
420205,201706,66,31,35,29047,32795,61842
420207,201706,95,55,40,51535,37470.63,89005.63
420208,201706,25,20,5,18740,3841.7,22581.7
420209,201706,19,15,4,14055,3748,17803
420210,201706,446,207,239,193677.9,223859.04,417536.94
420213,201706,50,39,11,36543,10307,46850
420215,201706,24,20,4,18740,3748,22488
420220,201706,70,47,23,44039,21551,65590
420230,201706,701,402,299,375925,280153.63,656078.63
420240,201706,2217,1515,702,1410349.91,657342.98,2067692.89
420243,201706,33,27,6,25299,5622,30921
420245,201706,83,48,35,44976,32795,77771
420250,201706,49,29,20,27173,18740,45913
420253,201706,41,34,7,31858,6559,38417
420257,201706,11,9,2,8433,1874,10307
420260,201706,93,82,11,76834,10307,87141
420270,201706,36,30,6,28105.32,5622,33727.32
420280,201706,269,197,72,183580.08,66228,249808.08
420285,201706,21,13,8,12181,7496,19677
420287,201706,48,29,19,27173,17803,44976
420290,201706,944,664,280,621204.5,262293.2,883497.7
420300,201706,1326,1046,280,976450.2,261423.77,1237873.97
420310,201706,56,42,14,39354,13118,52472
420315,201706,36,32,4,29984,3748,33732
420320,201706,838,425,413,397264.58,386977,784241.58
420325,201706,0,0,0,0,0,0
420330,201706,120,83,37,77771,34669,112440
420340,201706,152,107,45,99314,42136.89,141450.89
420350,201706,237,175,62,162664.1,58094,220758.1
420360,201706,730,551,179,514630.23,166140.09,680770.32
420370,201706,101,67,34,62592,31577,94169
420380,201706,1107,795,312,741159.76,291231.29,1032391.05
420390,201706,256,159,97,147747.06,89249.25,236996.31
420395,201706,170,122,48,114314,44966.63,159280.63
420400,201706,243,178,65,165850,60905,226755
420410,201706,59,46,13,43102,12181,55283
420415,201706,32,29,3,27173,2811,29984
420417,201706,43,33,10,30921,9370,40291
420419,201706,12,11,1,10307,937,11244
420420,201706,2747,1676,1071,1559459.23,1000990.25,2560449.48
420425,201706,66,57,9,53400,8414.26,61814.26
420430,201706,1264,875,389,816656.16,364464.89,1181121.05
420435,201706,16,14,2,13118,1874,14992
420440,201706,106,71,35,65887.96,32622.6,98510.56
420445,201706,20,18,2,16866,1874,18740
420450,201706,75,35,40,32766,37480,70246
420455,201706,231,181,50,169569.26,46786.63,216355.89
420460,201706,2238,1516,722,1415833.13,676301.82,2092134.95
420470,201706,118,86,32,80582,29984,110566
420475,201706,7,7,0,6559,0,6559
420480,201706,836,620,216,576338.72,201455.1,777793.82
420490,201706,113,88,25,82456,23425,105881
420500,201706,818,290,528,270076.1,494736,764812.1
420510,201706,20,17,3,15929,2811,18740
420515,201706,22,19,3,17803,2811,20614
420517,201706,7,7,0,6559,0,6559
420519,201706,0,0,0,0,0,0
420520,201706,67,50,17,46850,15929,62779
420530,201706,146,101,45,94637,42165,136802
420535,201706,20,17,3,15929,2811,18740
420540,201706,4311,2564,1747,2393279.15,1632413.69,4025692.84
420543,201706,21,21,0,19677,0,19677
420545,201706,186,134,52,125549,48695.89,174244.89
420550,201706,821,656,165,613126.89,154448.75,767575.64
420555,201706,41,31,10,29047,9370,38417
420560,201706,63,48,15,44601.2,14055,58656.2
420570,201706,129,75,54,69712.8,50588.63,120301.43
420580,201706,287,126,161,118062,150576,268638
420590,201706,495,351,144,328887,134928,463815
420600,201706,91,45,46,42165,43102,85267
420610,201706,35,33,2,30640,1874,32514
420620,201706,69,57,12,53409,11244,64653
420630,201706,146,105,41,98376.32,38409,136785.32
420640,201706,101,89,12,83393,11244,94637
420650,201706,238,128,110,119239.99,102174.92,221414.91
420660,201706,59,42,17,38604.9,15929,54533.9
420665,201706,38,29,9,27173,8433,35606
420670,201706,304,234,70,219248.63,65290.53,284539.16
420675,201706,15,15,0,14055,0,14055
420680,201706,34,25,9,23425,8433,31858
420690,201706,177,149,28,139613,26236,165849
420700,201706,591,414,177,387843.78,165600.82,553444.60
420710,201706,144,84,60,78708,56220,134928
420720,201706,100,84,16,78708,14992,93700
420730,201706,478,308,170,288513.15,158008.49,446521.64
420740,201706,43,42,1,39354,937,40291
420750,201706,479,319,160,298601.79,149920,448521.79
420757,201706,17,14,3,12321.55,2811,15132.55
420760,201706,37,29,8,27173,7496,34669
420765,201706,66,55,11,51535,10307,61842
420768,201706,66,59,7,55283,6559,61842
420770,201706,84,71,13,66527,12181,78708
420775,201706,47,43,4,39354,3748,43102
420780,201706,225,177,48,165849,44976,210825
420785,201706,13,9,4,8433,3748,12181
420790,201706,169,143,26,133655.9,23397.63,157053.53
420800,201706,73,55,18,50785.4,16866,67651.4
420810,201706,241,207,34,193950,31061.55,225011.55
420820,201706,2316,1379,937,1284598.56,876460.93,2161059.49
420830,201706,517,299,218,278718.09,203319.63,482037.72
420840,201706,134,103,31,96511,29047,125558
420845,201706,438,196,242,182992.93,225536,408528.93
420850,201706,223,180,43,168660,40291,208951
420860,201706,59,50,9,46850,8433,55283
420870,201706,109,81,28,75897,26236,102133
420880,201706,162,110,52,102404.73,48724,151128.73
420890,201706,838,415,423,385865.67,396342,782207.67
420895,201706,10,10,0,9370,0,9370
420900,201706,389,300,89,279358.22,83365.63,362723.85
420910,201706,5615,3086,2529,2885708.77,2368615.02,5254323.79
420915,201706,80,74,6,69338,5622,74960
420917,201706,18,13,5,12181,4685,16866
420920,201706,20,13,7,12181,6559,18740
420930,201706,2540,1531,1009,1427019.87,938221.48,2365241.35
420940,201706,579,426,153,398863,141737.24,540600.24
420945,201706,7,5,2,4685,1874,6559
420950,201706,56,51,5,47787,4685,52472
420960,201706,113,88,25,82419.26,23416,105835.26
420970,201706,300,243,57,226044.45,53381.63,279426.08
420980,201706,26,25,1,23425,937,24362
420985,201706,60,53,7,49661,6559,56220
420990,201706,70,54,16,50598,14992,65590
421000,201706,35,22,13,20614,12181,32795
421003,201706,66,41,25,38417,23416,61833
421005,201706,8,5,3,4685,2811,7496
421010,201706,740,520,220,486849.78,204086.39,690936.17
421020,201706,27,24,3,22468,2811,25279
421030,201706,126,105,21,98058,19677,117735
421040,201706,56,49,7,45913,6559,52472
421050,201706,291,205,86,190024.1,80582,270606.1
421055,201706,27,23,4,21551,3748,25299
421060,201706,84,58,26,54346,24362,78708
421070,201706,49,45,4,42165,3748,45913
421080,201706,32,30,2,28110,1874,29984
421085,201706,24,19,5,17803,4685,22488
421090,201706,43,33,10,30921,9370,40291
421100,201706,114,85,29,79645,27173,106818
421105,201706,200,160,40,149780,37456.95,187236.95
421110,201706,109,92,17,85594.95,15929,101523.95
421120,201706,154,120,34,111953.13,31839.26,143792.39
421125,201706,16,11,5,10307,4685,14992
421130,201706,779,499,280,466881.3,261338.87,728220.17
421140,201706,30,21,9,18974.25,8433,27407.25
421145,201706,39,32,7,29984,6559,36543
421150,201706,104,75,29,70275,27173,97448
421160,201706,58,39,19,36533.63,17803,54336.63
421165,201706,19,18,1,16866,937,17803
421170,201706,184,159,25,148254.52,23416,171670.52
421175,201706,149,99,50,92763,46794.52,139557.52
421180,201706,57,35,22,32439,20614,53053
421185,201706,16,13,3,12181,2811,14992
421187,201706,0,0,0,0,0,0
421189,201706,38,30,8,28110,7486.63,35596.63
421190,201706,1360,834,526,780709,492177.99,1272886.99
421200,201706,88,68,20,63716,18740,82456
421205,201706,23,15,8,14055,7486.63,21541.63
421210,201706,174,117,57,109629,53409,163038
421220,201706,262,209,53,195223.95,49661,244884.95
421223,201706,55,45,10,42165,9370,51535
421225,201706,55,40,15,37480,14055,51535
421227,201706,91,68,23,63716,21551,85267
421230,201706,44,32,12,29984,11244,41228
421240,201706,19,19,0,17803,0,17803
421250,201706,358,217,141,203236,131339.29,334575.29
421260,201706,28,22,6,20614,5622,26236
421265,201706,0,0,0,0,0,0
421270,201706,53,48,5,44976,4685,49661
421280,201706,334,195,139,182715,129306,312021
421290,201706,298,202,96,189040,88565.56,277605.56
421300,201706,29,24,5,22488,4685,27173
421310,201706,55,41,14,37761.1,13118,50879.1
421315,201706,30,20,10,18740,9370,28110
421320,201706,123,89,34,83393,31858,115251
421330,201706,113,85,28,77283.76,26227,103510.76
421335,201706,40,26,14,24362,13118,37480
421340,201706,276,183,93,169456.5,87141,256597.5
421350,201706,161,95,66,88580,61842,150422
421360,201706,680,502,178,464768.86,166580.63,631349.49
421370,201706,179,137,42,128369,39026.05,167395.05
421380,201706,122,102,20,95569.32,18740,114309.32
421390,201706,17,14,3,13118,2811,15929
421400,201706,115,97,18,90889,16866,107755
421410,201706,21,18,3,16866,2811,19677
421415,201706,18,16,2,14992,1874,16866
421420,201706,154,129,25,120310.8,23425,143735.8
421430,201706,14,11,3,10307,2811,13118
421440,201706,58,46,12,43102,11244,54346
421450,201706,101,89,12,83393,11244,94637
421460,201706,59,51,8,46997.1,7496,54493.1
421470,201706,72,47,25,44039,23425,67464
421480,201706,621,460,161,430551.5,150857,581408.5
421490,201706,24,22,2,19950,1874,21824
421500,201706,506,327,179,304005.4,166884.69,470890.09
421505,201706,24,17,7,15929,6559,22488
421507,201706,31,26,5,24362,4685,29047
421510,201706,73,48,25,44976,23425,68401
421520,201706,67,57,10,52660,9370,62030
421530,201706,54,48,6,44320.1,5622,49942.1
421535,201706,31,30,1,27848,937,28785
421540,201706,59,53,6,49661,5622,55283
421545,201706,93,72,21,66987,19677,86664
421550,201706,272,195,77,182060,72149,254209
421555,201706,22,18,4,16866,3748,20614
421560,201706,8,8,0,7496,0,7496
421565,201706,119,90,29,84330,27173,111503
421567,201706,28,22,6,20614,5622,26236
421568,201706,32,30,2,28110,1874,29984
421569,201706,9,8,1,7496,937,8433
421570,201706,130,87,43,81519,40291,121810
421575,201706,27,22,5,20356.33,4685,25041.33
421580,201706,713,427,286,400099,267045.27,667144.27
421590,201706,20,20,0,18740,0,18740
421600,201706,110,74,36,69318,32796,102114
421605,201706,101,68,33,63389,30921,94310
421610,201706,192,150,42,140550,39354,179904
421620,201706,1106,662,444,617839.76,415989.52,1033829.28
421625,201706,21,18,3,16866,2811,19677
421630,201706,263,169,94,158307,87235,245542
421635,201706,18,8,10,7496,9370,16866
421640,201706,96,85,11,79645,10307,89952
421650,201706,269,156,113,146153.26,105862.26,252015.52
421660,201706,2038,1210,828,1131587.86,774590.16,1906178.02
421670,201706,170,128,42,119936,39354,159290
421680,201706,170,154,16,144298,14983,159281
421690,201706,338,237,101,221488.8,93690.99,315179.79
421700,201706,53,34,19,31858,16960,48818
421710,201706,22,22,0,20614,0,20614
421715,201706,9,8,1,7496,937,8433
421720,201706,546,388,158,361558.3,146350.54,507908.84
421725,201706,12,6,6,5622,5622,11244
421730,201706,40,29,11,26455.48,10307,36762.48
421740,201706,81,38,43,35606,40291,75897
421750,201706,215,156,59,144580.1,55283,199863.1
421755,201706,26,24,2,22488,1874,24362
421760,201706,107,76,31,71202.63,29047,100249.63
421770,201706,539,372,167,347500.52,156414.15,503914.67
421775,201706,23,15,8,14055,7496,21551
421780,201706,186,146,40,136520.9,37480,174000.9
421790,201706,156,130,26,121810,24362,146172
421795,201706,14,12,2,11244,1874,13118
421800,201706,436,279,157,259703.61,147104.32,406807.93
421810,201706,68,54,14,50598,13118,63716
421820,201706,297,199,98,185498.1,91826,277324.1
421825,201706,128,105,23,98385,21551,119936
421830,201706,131,102,29,95574,27173,122747
421835,201706,3,3,0,2811,0,2811
421840,201706,60,52,8,48715,7496,56211
421850,201706,72,63,9,59031,8429,67460
421860,201706,43,32,11,29702.9,10307,40009.9
421870,201706,955,716,239,662660.06,223029.15,885689.21
421875,201706,49,43,6,40291,5622,45913
421880,201706,163,116,47,108692,43758,152450
421885,201706,26,21,5,19677,4404,24081
421890,201706,114,78,36,73086,33732,106818
421895,201706,36,34,2,31858,1874,33732
421900,201706,146,118,28,110492.15,26191,136683.15
421910,201706,64,43,21,40291,19677,59968
421915,201706,31,25,6,23425,5622,29047
421917,201706,37,26,11,24081,10307,34388
421920,201706,33,30,3,28110,2811,30921
421930,201706,748,575,173,537781.78,162064.63,699846.41
421935,201706,57,50,7,46850,6559,53409
421940,201706,38,35,3,32795,2811,35606
421950,201706,825,536,289,496238.21,267864.52,764102.73
421960,201706,40,35,5,32514,4685,37199
421970,201706,363,230,133,215020.12,124570.01,339590.13
421985,201706,28,20,8,18740,7496,26236
422000,201706,0,0,0,0,0,0
430003,201706,211,47,164,43336.25,153668,197004.25
430005,201706,33,26,7,24362,6559,30921
430010,201706,283,200,83,186931.5,77771,264702.5
430020,201706,155,99,56,92482,51535,144017
430030,201706,122,94,28,88078,26236,114314
430040,201706,2968,1712,1256,1596837.05,1175129.68,2771966.73
430045,201706,67,57,10,53409,9370,62779
430047,201706,7,6,1,5622,937,6559
430050,201706,78,65,13,60905,12181,73086
430055,201706,17,14,3,13118,2811,15929
430057,201706,4,2,2,1874,1874,3748
430060,201706,3710,2185,1525,2039855.46,1424444.79,3464300.25
430063,201706,54,47,7,44039,6559,50598
430064,201706,140,119,21,110800.25,19677,130477.25
430066,201706,10,7,3,6559,2811,9370
430070,201706,49,37,12,34669,11244,45913
430080,201706,71,49,22,45225.8,20614,65839.8
430085,201706,37,9,28,8433,26236,34669
430087,201706,38,28,10,26096,9370,35466
430090,201706,70,64,6,59405.8,5622,65027.8
430100,201706,111,75,36,70275,33732,104007
430105,201706,144,73,71,68401,66227.16,134628.16
430107,201706,20,14,6,13118,5622,18740
430110,201706,396,233,163,217524.55,152665.41,370189.96
430120,201706,139,126,13,117125.95,12181,129306.95
430130,201706,781,487,294,455709.95,275196.9,730906.85
430140,201706,125,116,9,108692,8433,117125
430150,201706,103,69,34,63904,31858,95762
430155,201706,29,28,1,26236,937,27173
430160,201706,3789,2240,1549,2080751.35,1447412.11,3528163.46
430163,201706,314,134,180,124462.68,168585.04,293047.72
430165,201706,22,16,6,14992,5622,20614
430170,201706,79,73,6,68401,5622,74023
430175,201706,80,61,19,57157,17147.1,74304.1
430180,201706,94,75,19,70275,17193.95,87468.95
430185,201706,32,24,8,22488,7496,29984
430187,201706,108,44,64,41228,59668.9,100896.9
430190,201706,226,129,97,120826.15,90223.73,211049.88
430192,201706,14,14,0,13118,0,13118
430195,201706,12,8,4,7496,3748,11244
430200,201706,161,140,21,130524.1,19677,150201.1
430205,201706,19,18,1,16866,937,17803
430210,201706,589,446,143,414809.9,132726.15,547536.05
430215,201706,17,14,3,13118,2811,15929
430220,201706,59,41,18,38417,16866,55283
430222,201706,14,7,7,6559,6559,13118
430223,201706,13,7,6,6559,5622,12181
430225,201706,4,3,1,2811,937,3748
430230,201706,294,184,110,171471,103070,274541
430235,201706,47,34,13,31858,12171.63,44029.63
430237,201706,28,22,6,20614,5622,26236
430240,201706,127,77,50,72149,46840.63,118989.63
430245,201706,66,54,12,50598,11244,61842
430250,201706,193,114,79,106808.63,74013.63,180822.26
430258,201706,13,11,2,10307,1874,12181
430260,201706,38,33,5,30921,3879.18,34800.18
430265,201706,35,28,7,26217.26,6559,32776.26
430270,201706,582,431,151,399583.67,139707.81,539291.48
430280,201706,1014,632,382,588520.33,355479.8,944000.13
430290,201706,375,217,158,201455.4,148046,349501.4
430300,201706,2095,1145,950,1066898.76,887153.67,1954052.43
430310,201706,1986,1029,957,958376,894353.11,1852729.11
430320,201706,47,39,8,36528.95,7496,44024.95
430330,201706,97,88,9,81987.5,8433,90420.5
430340,201706,64,58,6,54346,5622,59968
430350,201706,1646,1151,495,1067196.38,462276.47,1529472.85
430355,201706,26,24,2,22488,1874,24362
430360,201706,80,36,44,33732,40291.1,74023.1
430367,201706,30,20,10,18740,8592.29,27332.29
430370,201706,55,48,7,44976,6559,51535
430380,201706,123,92,31,85641.8,29047,114688.8
430390,201706,608,379,229,354841.9,214273.63,569115.53
430400,201706,135,104,31,95761.4,29028.26,124789.66
430410,201706,56,44,12,41228,11244,52472
430420,201706,478,315,163,292439.7,150511.58,442951.28
430430,201706,52,49,3,45288.95,2811,48099.95
430435,201706,147,109,38,101851.9,34903.25,136755.15
430440,201706,510,339,171,317643,160039.6,477682.6
430450,201706,1168,960,208,893056.27,194886.63,1087942.90
430460,201706,5085,2756,2329,2567447.32,2174576.97,4742024.29
430461,201706,21,19,2,17803,1874,19677
430462,201706,11,7,4,6559,3748,10307
430463,201706,976,508,468,473326.39,438170.05,911496.44
430465,201706,29,17,12,15929,11244,27173
430466,201706,634,455,179,424462,167535.6,591997.6
430467,201706,91,53,38,49661,35596.63,85257.63
430468,201706,111,67,44,62779,40981.39,103760.39
430469,201706,22,16,6,14992,5622,20614
430470,201706,1156,645,511,596498.37,476886.15,1073384.52
430471,201706,47,35,12,32776.26,11244,44020.26
430480,201706,96,61,35,56313.7,32785.63,89099.33
430485,201706,5,5,0,4404,0,4404
430490,201706,95,76,19,70781.35,17803,88584.35
430495,201706,33,27,6,25299,5622,30921
430500,201706,191,129,62,120170.25,57724.63,177894.88
430510,201706,2936,1941,995,1813349.35,931725.06,2745074.41
430511,201706,19,19,0,17803,0,17803
430512,201706,136,93,43,87141,40291,127432
430513,201706,53,47,6,43570.5,5622,49192.5
430515,201706,31,28,3,26236,2811,29047
430517,201706,169,149,20,138676.25,18721.26,157397.51
430520,201706,362,247,115,230784,107726.89,338510.89
430530,201706,91,50,41,46850,38417,85267
430535,201706,464,304,160,284632.49,149915.32,434547.81
430537,201706,13,13,0,12181,0,12181
430540,201706,76,49,27,45913,25299,71212
430543,201706,373,116,257,108692,240575,349267
430544,201706,44,40,4,37480,3748,41228
430545,201706,333,149,184,139547.41,171920.76,311468.17
430550,201706,44,36,8,33732,7496,41228
430558,201706,6,4,2,3748,1874,5622
430560,201706,47,19,28,17803,26236,44039
430570,201706,99,45,54,42165,50541.78,92706.78
430580,201706,126,98,28,91826,26189.15,118015.15
430583,201706,15,15,0,14055,0,14055
430585,201706,8,4,4,3748,3748,7496
430587,201706,14,8,6,7496,5622,13118
430590,201706,153,127,26,117780.9,24362,142142.9
430593,201706,4,4,0,3748,0,3748
430595,201706,15,9,6,8433,5622,14055
430597,201706,55,30,25,28110,23425,51535
430600,201706,215,144,71,134918.63,66245.9,201164.53
430605,201706,152,95,57,89015,53399.63,142414.63
430607,201706,25,21,4,19677,3748,23425
430610,201706,1604,739,865,688321.75,805595.49,1493917.24
430613,201706,2,2,0,1874,0,1874
430620,201706,108,76,32,71072,29965.26,101037.26
430630,201706,47,42,5,39354,4685,44039
430632,201706,32,28,4,26236,3748,29984
430635,201706,38,35,3,32795,2811,35606
430637,201706,57,31,26,29047,24362,53409
430640,201706,209,118,91,109722.7,85267,194989.7
430642,201706,28,26,2,24362,1874,26236
430645,201706,30,26,4,24362,3748,28110
430650,201706,247,195,52,182434,48677.15,231111.15
430655,201706,7,7,0,6559,0,6559
430660,201706,958,462,496,431347.95,462540.78,893888.73
430670,201706,71,51,20,47787,18740,66527
430673,201706,74,42,32,39354,29984,69338
430675,201706,13,10,3,9370,2811,12181
430676,201706,458,271,187,253252.36,175148.84,428401.20
430680,201706,243,167,76,154324,71212,225536
430690,201706,521,314,207,293346.59,192332.01,485678.60
430692,201706,7,5,2,4685,1874,6559
430693,201706,128,84,44,78708,40609.58,119317.58
430695,201706,69,62,7,57175.74,6559,63734.74
430697,201706,62,37,25,34669,23425,58094
430700,201706,1556,1087,469,1009777.55,439453,1449230.55
430705,201706,18,17,1,15929,937,16866
430710,201706,257,165,92,154605,86204,240809
430720,201706,108,93,15,86953.6,14055,101008.6
430730,201706,119,101,18,93700,16866,110566
430740,201706,55,38,17,35606,15929,51535
430745,201706,37,29,8,27173,7496,34669
430750,201706,335,231,104,215574.72,96511,312085.72
430755,201706,78,43,35,40291,32795,73086
430760,201706,355,217,138,200097.11,129278.26,329375.37
430770,201706,1455,746,709,696968.81,659946.19,1356915.00
430780,201706,313,198,115,184580.9,107689.78,292270.68
430781,201706,28,24,4,22488,3748,26236
430783,201706,43,35,8,32482.8,7496,39978.8
430786,201706,5,2,3,1874,2811,4685
430790,201706,465,303,162,282692.9,151503.63,434196.53
430800,201706,151,126,25,118062,23425,141487
430805,201706,40,38,2,35606,1874,37480
430807,201706,32,20,12,18740,11244,29984
430810,201706,67,42,25,39354,23425,62779
430820,201706,128,76,52,71212,48068.1,119280.1
430825,201706,11,9,2,8433,1874,10307
430830,201706,220,205,15,191804,14055,205859
430840,201706,118,77,41,72149,37761.1,109910.1
430843,201706,5,3,2,2811,1874,4685
430845,201706,70,40,30,37480,28110,65590
430850,201706,574,393,181,367702.8,169458.67,537161.47
430860,201706,157,100,57,92388.2,52743.73,145131.93
430865,201706,64,30,34,27454.1,31548.79,59002.89
430870,201706,74,60,14,56220,13118,69338
430880,201706,153,115,38,107755,35606,143361
430885,201706,7,6,1,5622,937,6559
430890,201706,334,205,129,190454.94,120873,311327.94
430900,201706,550,372,178,344441.8,166308.13,510749.93
430905,201706,78,33,45,30921,42165,73086
430910,201706,264,147,117,137739,108028,245767
430912,201706,7,7,0,6559,0,6559
430915,201706,29,21,8,19677,7214.9,26891.9
430920,201706,3993,2217,1776,2071302.85,1662082.42,3733385.27
430925,201706,6,5,1,4441.38,937,5378.38
430930,201706,2056,1232,824,1146796.89,769974.46,1916771.35
430940,201706,229,145,84,134918.63,78689.26,213607.89
430950,201706,160,128,32,119936,29702.9,149638.9
430955,201706,20,13,7,12181,6559,18740
430957,201706,17,16,1,14992,937,15929
430960,201706,242,157,85,145375.55,79645,225020.55
430965,201706,96,60,36,56220,33732,89952
430970,201706,78,65,13,60905,11244,72149
430975,201706,33,31,2,29047,1874,30921
430980,201706,44,27,17,25299,15929,41228
430990,201706,107,80,27,74960,25299,100259
430995,201706,112,108,4,100259,3748,104007
431000,201706,297,136,161,126206.1,150857,277063.1
431010,201706,343,207,136,192993.89,127432,320425.89
431020,201706,1917,1096,821,1021071.89,766175.53,1787247.42
431030,201706,41,33,8,30921,7496,38417
431033,201706,374,186,188,173485.6,176156,349641.6
431036,201706,15,10,5,9370,4685,14055
431040,201706,133,79,54,73086,50490.25,123576.25
431041,201706,37,26,11,24362,10307,34669
431043,201706,42,24,18,22488,16866,39354
431046,201706,12,7,5,6559,4685,11244
431050,201706,212,133,79,122238.06,72536.4,194774.46
431053,201706,68,41,27,37667.4,25299,62966.4
431055,201706,64,41,23,38417,21532.26,59949.26
431057,201706,17,17,0,15929,0,15929
431060,201706,1685,1049,636,975549.93,594167.91,1569717.84
431065,201706,16,10,6,9370,5622,14992
431070,201706,70,66,4,61842,3748,65590
431075,201706,9,9,0,8433,0,8433
431080,201706,138,90,48,83111.9,44976,128087.9
431085,201706,29,26,3,24362,2811,27173
431087,201706,15,13,2,12181,1874,14055
431090,201706,54,44,10,41228,9370,50598
431100,201706,1235,736,499,680263.71,467563,1147826.71
431110,201706,245,152,93,142424,87131.63,229555.63
431112,201706,29,18,11,16866,10307,27173
431113,201706,30,20,10,18740,9370,28110
431115,201706,157,106,51,98697.2,47777.63,146474.83
431120,201706,612,359,253,334472.42,236987.52,571459.94
431123,201706,3,2,1,1874,937,2811
431125,201706,89,79,10,74023,9370,83393
431127,201706,7,3,4,2811,3748,6559
431130,201706,610,399,211,372644.9,197407.16,570052.06
431140,201706,698,468,230,433671.96,215305.61,648977.57
431142,201706,32,25,7,22235,6559,28794
431150,201706,204,151,53,141487,49642.26,191129.26
431160,201706,55,49,6,45913,5622,51535
431162,201706,19,14,5,13118,4685,17803
431164,201706,5,5,0,4685,0,4685
431170,201706,100,83,17,77771,15929,93700
431171,201706,48,25,23,23425,21541.63,44966.63
431173,201706,1,1,0,937,0,937
431175,201706,200,97,103,89671,96511,186182
431177,201706,73,55,18,51535,16847.26,68382.26
431179,201706,14,12,2,11244,1874,13118
431180,201706,433,266,167,248305,156460.63,404765.63
431190,201706,88,67,21,62779,19677,82456
431198,201706,68,44,24,41228,22488,63716
431200,201706,18,16,2,14992,1874,16866
431205,201706,26,26,0,24362,0,24362
431210,201706,83,52,31,48397,29047,77444
431213,201706,24,20,4,18740,3748,22488
431215,201706,27,24,3,22488,2811,25299
431217,201706,6,5,1,4685,937,5622
431220,201706,62,53,9,49661,8433,58094
431225,201706,144,96,48,89943,44966.63,134909.63
431230,201706,101,85,16,78989.1,14992,93981.1
431235,201706,7,7,0,6559,0,6559
431237,201706,24,16,8,14992,7496,22488
431238,201706,15,11,4,10026,3748,13774
431240,201706,967,613,354,572770.16,330729.1,903499.26
431242,201706,37,37,0,34669,0,34669
431244,201706,10,7,3,6559,2811,9370
431245,201706,62,47,15,44039,14055,58094
431247,201706,13,9,4,8433,3748,12181
431250,201706,263,131,132,122728.26,123656.26,246384.52
431260,201706,61,45,16,42165,14992,57157
431261,201706,22,15,7,14055,6559,20614
431262,201706,16,16,0,14992,0,14992
431265,201706,164,86,78,80582,73086,153668
431267,201706,15,14,1,13118,937,14055
431270,201706,305,251,54,235187,50598,285785
431275,201706,40,38,2,35606,1874,37480
431280,201706,22,17,5,15109.12,4685,19794.12
431290,201706,22,19,3,17803,2811,20614
431295,201706,5,5,0,4685,0,4685
431300,201706,22,19,3,17803,2811,20614
431301,201706,7,7,0,6559,0,6559
431303,201706,48,34,14,31736.19,12836.9,44573.09
431306,201706,209,111,98,103559.11,91826,195385.11
431308,201706,6,5,1,4685,937,5622
431310,201706,66,57,9,53409,8433,61842
431320,201706,117,72,45,67464,42155.63,109619.63
431330,201706,176,116,60,108692,56220,164912
431333,201706,32,26,6,24362,5622,29984
431335,201706,10,5,5,4685,4685,9370
431337,201706,312,149,163,138799.1,152656.04,291455.14
431339,201706,15,12,3,11244,2811,14055
431340,201706,2988,1693,1295,1582183.78,1211466.89,2793650.67
431342,201706,41,25,16,23425,14992,38417
431344,201706,17,17,0,15929,0,15929
431346,201706,5,5,0,4685,0,4685
431349,201706,37,34,3,31858,2811,34669
431350,201706,894,522,372,484646.73,347589.52,832236.25
431360,201706,40,37,3,34669,2811,37480
431365,201706,306,143,163,133972.26,152721.63,286693.89
431370,201706,1298,777,521,724620.54,487992.19,1212612.73
431380,201706,100,83,17,77115.1,15929,93044.1
431390,201706,486,273,213,254864.1,198673.01,453537.11
431395,201706,273,119,154,111503,144280,255783
431400,201706,36,28,8,26236,7496,33732
431402,201706,88,61,27,57157,25299,82456
431403,201706,14,8,6,7496,5622,13118
431405,201706,649,351,298,327790.81,279199,606989.81
431406,201706,29,25,4,23425,3748,27173
431407,201706,50,44,6,41228,5622,46850
431410,201706,3082,1814,1268,1687766.54,1186879.26,2874645.80
431413,201706,16,14,2,13118,1874,14992
431415,201706,70,51,19,47787,17803,65590
431417,201706,23,12,11,11244,10307,21551
431420,201706,291,209,82,195208.3,76824.63,272032.93
431430,201706,39,15,24,14055,22488,36543
431440,201706,8851,6309,2542,5848855.21,2374054.73,8222909.94
431442,201706,28,15,13,14055,12181,26236
431445,201706,26,20,6,18740,5622,24362
431446,201706,9,8,1,7496,937,8433
431447,201706,85,58,27,54346,25299,79645
431449,201706,47,44,3,41228,2811,44039
431450,201706,398,282,116,262500.55,107989.25,370489.80
431454,201706,0,0,0,0,0,0
431455,201706,47,36,11,33732,10307,44039
431460,201706,513,352,161,326263.4,150435.9,476699.3
431470,201706,120,94,26,87398.86,24362,111760.86
431475,201706,11,10,1,9370,937,10307
431477,201706,35,24,11,22488,10307,32795
431478,201706,6,5,1,4685,937,5622
431480,201706,493,313,180,291698.41,168332.05,460030.46
431490,201706,28156,15884,12272,14814863.13,11465865.82,26280728.95
431500,201706,77,54,23,50598,21551,72149
431505,201706,43,16,27,14992,25299,40291
431507,201706,7,7,0,6559,0,6559
431510,201706,282,176,106,164209.9,97429.26,261639.16
431513,201706,23,17,6,15929,5622,21551
431514,201706,7,6,1,5622,937,6559
431515,201706,77,66,11,61842,10307,72149
431517,201706,3,1,2,937,1874,2811
431520,201706,35,32,3,29984,2811,32795
431530,201706,1618,714,904,667708.42,846593.67,1514302.09
431531,201706,22,20,2,18740,1874,20614
431532,201706,24,17,7,15929,6559,22488
431535,201706,23,14,9,13118,8433,21551
431540,201706,143,127,16,117715.31,14992,132707.31
431545,201706,17,15,2,14055,1874,15929
431550,201706,339,195,144,182715,134834.3,317549.3
431555,201706,11,10,1,9370,937,10307
431560,201706,4250,2995,1255,2778271.59,1173462.32,3951733.91
431570,201706,757,396,361,367960.1,335262.96,703223.06
431575,201706,35,25,10,23425,9370,32795
431580,201706,92,63,29,58094,27173,85267
431590,201706,130,108,22,100961.75,20614,121575.75
431595,201706,13,11,2,10307,1874,12181
431600,201706,208,117,91,109629,85267,194896
431610,201706,126,91,35,84611.1,32795,117406.1
431620,201706,42,34,8,31858,7496,39354
431630,201706,125,108,17,101196,15929,117125
431640,201706,1314,829,485,773306.1,453846.06,1227152.16
431642,201706,44,40,4,37011.5,3748,40759.5
431643,201706,47,21,26,19677,24362,44039
431645,201706,304,174,130,163038,120873,283911
431647,201706,11,11,0,10307,0,10307
431650,201706,34,24,10,22488,9370,31858
431660,201706,268,175,93,162756.9,87141,249897.9
431670,201706,215,102,113,92896.89,105852.89,198749.78
431673,201706,3,3,0,2811,0,2811
431675,201706,29,25,4,23143.9,3748,26891.9
431680,201706,1059,755,304,703687,284586.38,988273.38
431690,201706,4694,2858,1836,2661861.91,1714918.89,4376780.80
431695,201706,25,19,6,17803,5622,23425
431697,201706,0,0,0,0,0,0
431700,201706,164,123,41,115251,38417,153668
431710,201706,3945,1694,2251,1585582.5,2107776.45,3693358.95
431720,201706,1391,817,574,757789.39,535950.63,1293740.02
431725,201706,1,1,0,937,0,937
431730,201706,1169,777,392,723084.1,367304,1090388.1
431740,201706,1353,670,683,623256.26,639420.12,1262676.38
431750,201706,1869,1210,659,1123094.82,614925.36,1738020.18
431755,201706,5,4,1,3748,937,4685
431760,201706,1082,688,394,644281.2,368953.49,1013234.69
431770,201706,387,285,102,267035.63,95555.26,362590.89
431775,201706,26,20,6,18740,5622,24362
431780,201706,560,345,215,322271.78,201445.63,523717.41
431790,201706,144,108,36,100259,33685.15,133944.15
431795,201706,13,12,1,11244,937,12181
431800,201706,3410,1776,1634,1650175.83,1523142.27,3173318.10
431805,201706,17,15,2,14055,1874,15929
431810,201706,614,412,202,384394.88,189152.56,573547.44
431820,201706,314,177,137,165849,127385.15,293234.15
431830,201706,2319,1402,917,1310321.73,858004.39,2168326.12
431840,201706,502,330,172,305651.65,159946,465597.65
431842,201706,33,27,6,25299,5622,30921
431843,201706,9,5,4,4685,3748,8433
431844,201706,15,13,2,12181,1874,14055
431845,201706,29,27,2,25299,1874,27173
431846,201706,30,26,4,24362,3748,28110
431848,201706,13,11,2,10307,1874,12181
431849,201706,8,6,2,5622,1874,7496
431850,201706,777,643,134,601264,125323.75,726587.75
431860,201706,102,73,29,68401,26236,94637
431861,201706,4,2,2,1874,1874,3748
431862,201706,49,35,14,32795,13118,45913
431870,201706,3422,1998,1424,1863168.7,1333007.75,3196176.45
431880,201706,903,665,238,618392,222069,840461
431890,201706,1302,799,503,744372.29,469733,1214105.29
431900,201706,171,121,50,113377,46850,160227
431910,201706,55,41,14,38417,13118,51535
431912,201706,35,20,15,18740,14055,32795
431915,201706,122,98,24,91826,22488,114314
431920,201706,141,106,35,99322,32795,132117
431930,201706,84,66,18,61842,16866,78708
431935,201706,4,3,1,2811,937,3748
431936,201706,12,11,1,10307,937,11244
431937,201706,16,11,5,10307,4685,14992
431940,201706,438,290,148,269059.55,138666.63,407726.18
431950,201706,456,291,165,271468.01,153040.95,424508.96
431960,201706,713,430,283,398817.42,265012.45,663829.87
431970,201706,73,65,8,60905,7496,68401
431971,201706,4,4,0,3748,0,3748
431973,201706,16,13,3,12181,2811,14992
431975,201706,6,5,1,4685,937,5622
431980,201706,200,128,72,118436.8,67464,185900.8
431990,201706,1223,657,566,614162.09,530023.9,1144185.99
432000,201706,1639,871,768,809363.07,716772.12,1526135.19
432010,201706,278,184,94,171315.3,88078,259393.3
432020,201706,161,128,33,119936,30911.63,150847.63
432023,201706,20,16,4,14992,3748,18740
432026,201706,64,57,7,53409,6559,59968
432030,201706,60,32,28,29984,26236,56220
432032,201706,22,18,4,16866,3748,20614
432035,201706,44,36,8,33732,7496,41228
432040,201706,96,66,30,61842,28110,89952
432045,201706,8,7,1,6277.9,937,7214.9
432050,201706,66,39,27,36543,25299,61842
432055,201706,100,77,23,72130.26,21551,93681.26
432057,201706,1,0,1,0,937,937
432060,201706,37,34,3,31155.25,2811,33966.25
432065,201706,30,27,3,25299,2811,28110
432067,201706,96,83,13,77771,12181,89952
432070,201706,399,300,99,279509.29,92735.26,372244.55
432080,201706,808,551,257,515350,240762.89,756112.89
432085,201706,14,11,3,10307,2811,13118
432090,201706,260,168,92,157416,86204,243620
432100,201706,175,114,61,106536.9,57157,163693.9
432110,201706,598,406,192,373461.3,178967,552428.3
432120,201706,960,571,389,534550.1,364455.52,899005.62
432130,201706,488,351,137,327950,128228.45,456178.45
432132,201706,27,24,3,22488,2811,25299
432135,201706,76,64,12,59968,11244,71212
432140,201706,264,204,60,190857.53,56220,247077.53
432143,201706,179,110,69,103070,64653,167723
432145,201706,257,175,82,162757.8,76552.9,239310.7
432146,201706,15,14,1,13118,937,14055
432147,201706,171,60,111,56220,103988.26,160208.26
432149,201706,17,12,5,11244,4685,15929
432150,201706,818,520,298,486068.75,276602.13,762670.88
432160,201706,1388,717,671,670177.25,627856.56,1298033.81
432162,201706,4,3,1,2811,937,3748
432163,201706,18,14,4,13118,3748,16866
432166,201706,125,93,32,87376,29984,117360
432170,201706,228,124,104,114596,97448,212044
432180,201706,525,313,212,292625.1,198363,490988.1
432183,201706,8,6,2,5622,1874,7496
432185,201706,77,65,12,60811.3,11244,72055.3
432190,201706,494,258,236,240603.63,220973.45,461577.08
432195,201706,80,71,9,65824.25,8433,74257.25
432200,201706,398,250,148,234250,138583.52,372833.52
432210,201706,113,74,39,67323.45,36543,103866.45
432215,201706,63,59,4,55283,3982.25,59265.25
432218,201706,19,18,1,16866,937,17803
432220,201706,666,336,330,313831.05,308710.97,622542.02
432225,201706,15,10,5,8901.5,4685,13586.5
432230,201706,162,90,72,84095.75,67464,151559.75
432232,201706,14,12,2,11244,1874,13118
432234,201706,5,4,1,3748,937,4685
432235,201706,1,1,0,937,0,937
432237,201706,29,16,13,14992,12181,27173
432240,201706,4115,2285,1830,2131077.06,1707889.14,3838966.20
432250,201706,1003,614,389,572461.28,363396.71,935857.99
432252,201706,38,31,7,28316.14,6559,34875.14
432253,201706,56,45,11,42165,10307,52472
432254,201706,19,7,12,6559,11244,17803
432255,201706,14,13,1,12181,937,13118
432260,201706,844,658,186,615562.25,173345.75,788908.00
432270,201706,214,156,58,146172,54346,200518
432280,201706,121,87,34,81030.9,31858,112888.9
432285,201706,3,2,1,1874,937,2811
432290,201706,70,64,6,58375.1,5622,63997.1
432300,201706,4620,2621,1999,2443134.39,1869161.7,4312296.09
432310,201706,118,93,25,87141,23425,110566
432320,201706,20,15,5,14055,4685,18740
432330,201706,13,7,6,6559,5622,12181
432335,201706,8,7,1,6559,937,7496
432340,201706,41,37,4,34669,3748,38417
432345,201706,87,63,24,59031,22488,81519
432350,201706,24,23,1,21551,937,22488
432360,201706,7,5,2,4685,1874,6559
432370,201706,25,24,1,22206.9,937,23143.9
432375,201706,42,36,6,33732,5622,39354
432377,201706,7,7,0,6559,0,6559
432380,201706,159,68,91,63060.1,85267,148327.1
500020,201706,235,122,113,114314,105290.69,219604.69
500025,201706,115,58,57,53127.9,53409,106536.9
500060,201706,1361,815,546,763092.8,511007.21,1274100.01
500070,201706,724,336,388,314832,363265.63,678097.63
500080,201706,131,100,31,93700,28766,122466
500085,201706,141,114,27,106537,24479.13,131016.13
500090,201706,332,155,177,145235,165849,311084
500100,201706,689,369,320,342286.3,299278,641564.3
500110,201706,2214,970,1244,908581.63,1164844.93,2073426.56
500124,201706,312,177,135,165849,126213.9,292062.9
500150,201706,322,121,201,113368,187983,301351
500190,201706,520,354,166,331042.1,155061,486103.1
500200,201706,195,166,29,155184.89,27173,182357.89
500210,201706,1427,508,919,474745.48,860041.47,1334786.95
500215,201706,235,134,101,124597.21,94637,219234.21
500220,201706,781,511,270,478566.52,252246.63,730813.15
500230,201706,252,172,80,160461.25,74491.5,234952.75
500240,201706,706,485,221,453695.4,206608.9,660304.3
500260,201706,565,205,360,192085,337320,529405
500270,201706,28168,11879,16289,11102258.66,15245677.36,26347936.02
500280,201706,192,72,120,67464,112431,179895
500290,201706,1178,669,509,625917,476731.56,1102648.56
500295,201706,388,226,162,211762,151784.63,363546.63
500310,201706,67,21,46,19677,43102,62779
500315,201706,698,409,289,383223.63,270502.53,653726.16
500320,201706,3603,1781,1822,1666262.59,1705586.37,3371848.96
500325,201706,953,518,435,484898,406637.32,891535.32
500330,201706,1486,677,809,631511.86,757429.8,1388941.66
500345,201706,325,236,89,220186.1,83393,303579.1
500348,201706,237,138,99,129306,92744.63,222050.63
500350,201706,144,69,75,64653,70275,134928
500370,201706,5363,2374,2989,2215818.61,2797739.06,5013557.67
500375,201706,341,247,94,231429.63,88078,319507.63
500380,201706,575,330,245,309055.4,229546.63,538602.03
500390,201706,70,36,34,33732,31858,65590
500400,201706,215,145,70,135846.26,65581,201427.26
500410,201706,571,217,354,203283.58,331552.42,534836.00
500430,201706,531,366,165,342942,154605,497547
500440,201706,203,104,99,96687.42,92763,189450.42
500450,201706,411,175,236,163286.8,220127.94,383414.74
500460,201706,316,158,158,148036.63,148046,296082.63
500470,201706,432,342,90,318574.04,83384,401958.04
500480,201706,109,65,44,60905,41228,102133
500490,201706,105,40,65,37475.32,60905,98380.32
500500,201706,1414,477,937,445042.68,877095.9,1322138.58
500510,201706,50,37,13,34669,12172,46841
500515,201706,107,72,35,67464,32514,99978
500520,201706,351,199,152,185433,142420,327853
500525,201706,87,50,37,46850,34387.9,81237.9
500540,201706,882,361,521,338191.78,487180.35,825372.13
500560,201706,876,495,381,462097.66,356314.83,818412.49
500568,201706,977,570,407,529236.75,381073.32,910310.07
500570,201706,1210,689,521,643381.72,485596.02,1128977.74
500580,201706,336,170,166,158999.53,155529,314528.53
500600,201706,320,161,159,150158.93,148965,299123.93
500620,201706,874,616,258,571518.61,241549.23,813067.84
500625,201706,81,68,13,62490.78,12181,74671.78
500627,201706,21,9,12,8433,11244,19677
500630,201706,1559,815,744,762437.9,696842.22,1459280.12
500635,201706,517,284,233,265705.09,218161.71,483866.80
500640,201706,423,218,205,202673.5,192048.63,394722.13
500660,201706,5489,2085,3404,1950928.8,3185884.73,5136813.53
500690,201706,570,203,367,189868.39,343106.23,532974.62
500710,201706,358,173,185,161820,173054.9,334874.9
500720,201706,966,568,398,530806.32,372720.26,903526.58
500730,201706,192,109,83,102133,77485.22,179618.22
500740,201706,840,368,472,343534.14,441815,785349.14
500750,201706,135,42,93,39354,86832.16,126186.16
500755,201706,123,90,33,84049,30921,114970
500769,201706,741,415,326,388534.02,305449,693983.02
500770,201706,447,229,218,214563.63,204022.38,418586.01
500780,201706,174,117,57,109629,53409,163038
500790,201706,1037,508,529,475429.32,495351.63,970780.95
500793,201706,252,136,116,127292,108683,235975
500795,201706,179,125,54,117115.63,50589,167704.63
500797,201706,41,34,7,31858,6559,38417
500800,201706,412,180,232,168651,217102.9,385753.9
500830,201706,2135,1183,952,1105257.3,891161.96,1996419.26
500840,201706,145,108,37,101196,34660,135856
510010,201706,168,92,76,86194.63,71212,157406.63
510020,201706,481,223,258,208677.67,241196.01,449873.68
510025,201706,1630,918,712,859311.03,664306.65,1523617.68
510030,201706,610,308,302,288550.26,282223.32,570773.58
510035,201706,127,55,72,51507.63,67445.63,118953.26
510040,201706,373,159,214,148983,200078.53,349061.53
510050,201706,417,224,193,209151.1,180021.89,389172.99
510060,201706,109,52,57,48714.63,53399.63,102114.26
510080,201706,214,82,132,76801.95,123581.3,200383.25
510100,201706,75,34,41,31858,38398.26,70256.26
510120,201706,34,20,14,18740,13118,31858
510125,201706,397,244,153,227958.05,143338.26,371296.31
510130,201706,592,343,249,320961.33,232876.31,553837.64
510140,201706,378,123,255,115242,238910.32,354152.32
510160,201706,87,42,45,39354,42161,81515
510170,201706,848,519,329,486015.93,307667.28,793683.21
510180,201706,2841,1393,1448,1302238.16,1354766.65,2657004.81
510185,201706,9,4,5,3748,4685,8433
510190,201706,221,75,146,70275,136797.32,207072.32
510250,201706,2623,1519,1104,1421985.85,1033363.03,2455348.88
510260,201706,200,143,57,133800.15,53372.63,187172.78
510263,201706,447,246,201,228921.92,187594.89,416516.81
510267,201706,640,351,289,328695.78,270534.47,599230.25
510268,201706,53,28,25,26236,23425,49661
510269,201706,71,26,45,24353,42155.63,66508.63
510270,201706,404,208,196,194720.19,183223.57,377943.76
510279,201706,220,157,63,147081.63,59012.26,206093.89
510285,201706,174,74,100,69299.63,93700,162999.63
510300,201706,551,291,260,272232.85,243546.53,515779.38
510305,201706,211,95,116,88992.63,108590.04,197582.67
510310,201706,119,56,63,52472,59021.63,111493.63
510320,201706,846,525,321,491637.52,300356.26,791993.78
510325,201706,394,158,236,147996.63,220841.53,368838.16
510330,201706,413,233,180,218288,168641.26,386929.26
510335,201706,595,309,286,289486.89,267319.32,556806.21
510336,201706,50,35,15,32774.89,14055,46829.89
510337,201706,119,44,75,41218.63,70265.63,111484.26
510340,201706,17268,8326,8942,7778679.12,8367886.51,16146565.63
510343,201706,70,46,24,43092.63,22488,65580.63
510345,201706,160,104,56,97438.63,52181.63,149620.26
510350,201706,635,357,278,333303.74,260421.89,593725.63
510360,201706,208,121,87,113358.63,81427.89,194786.52
510370,201706,134,67,67,62760.26,62649.67,125409.93
510380,201706,93,63,30,59031,28101,87132
510385,201706,58,27,31,25299,29038,54337
510390,201706,127,51,76,47787,71165.15,118952.15
510395,201706,42,28,14,26236,13118,39354
510410,201706,687,451,236,422554,221108.95,643662.95
510420,201706,596,281,315,262385.77,293610.83,555996.60
510450,201706,51,32,19,29984,17803,47787
510452,201706,39,23,16,21551,14992,36543
510454,201706,71,30,41,28110,38407.63,66517.63
510455,201706,129,80,49,74941.26,45903.63,120844.89
510460,201706,185,94,91,87769.53,85229.89,172999.42
510480,201706,716,399,317,372747.68,296662.34,669410.02
510490,201706,359,183,176,171090.53,164352.76,335443.29
510500,201706,254,188,66,176146.63,61842,237988.63
510510,201706,766,439,327,410472.43,306389.63,716862.06
510515,201706,1144,590,554,552268.11,519040.89,1071309.00
510517,201706,249,106,143,99040.9,133967.95,233008.85
510520,201706,236,153,83,143278.89,77466.52,220745.41
510523,201706,95,60,35,56220,32785.63,89005.63
510525,201706,658,369,289,344980.78,270683.15,615663.93
510530,201706,15,11,4,10307,3748,14055
510550,201706,272,118,154,110085.46,144289,254374.46
510558,201706,282,136,146,127417.95,136774.26,264192.21
510560,201706,371,228,143,213636,133692,347328
510562,201706,640,441,199,411638.25,185974.5,597612.75
510590,201706,837,435,402,407557.89,376655.96,784213.85
510600,201706,256,136,120,127409.26,112398.58,239807.84
510610,201706,162,77,85,72130.26,79626.63,151756.89
510615,201706,188,72,116,67445.26,108692,176137.26
510617,201706,15,8,7,7496,6559,14055
510618,201706,117,55,62,51535,57625.5,109160.5
510619,201706,108,73,35,68392,32786,101178
510620,201706,191,108,83,101186.63,77771,178957.63
510621,201706,193,125,68,116825.53,63697.63,180523.16
510622,201706,443,291,152,272555.89,142096.89,414652.78
510623,201706,356,227,129,212662.26,120835.52,333497.78
510624,201706,87,40,47,37471,44039,81510
510625,201706,514,310,204,290251.78,190551.82,480803.60
510626,201706,105,63,42,59031,39354,98385
510627,201706,54,39,15,36543,14055,50598
510628,201706,164,97,67,90843.26,62722.78,153566.04
510629,201706,249,157,92,147109,85257.63,232366.63
510630,201706,458,227,231,212615.41,216115.85,428731.26
510631,201706,10,3,7,2811,6559,9370
510637,201706,337,185,152,172995.79,142278.52,315274.31
510642,201706,971,528,443,494390.79,414950.82,909341.61
510645,201706,0,0,0,0,0,0
510650,201706,1518,1003,515,939648.89,482445.41,1422094.30
510665,201706,80,39,41,36489,38399,74888
510670,201706,67,36,31,33732,29047,62779
510675,201706,1184,723,461,677389,431914.32,1109303.32
510677,201706,378,175,203,162958.15,190064.04,353022.19
510680,201706,108,62,46,58076,43093,101169
510682,201706,205,91,114,84951,106818,191769
510685,201706,59,43,16,40291,14992,55283
510700,201706,616,356,260,333453.89,243469.04,576922.93
510704,201706,1014,538,476,501910.35,443510.04,945420.39
510706,201706,125,60,65,56215.32,60868.26,117083.58
510710,201706,393,260,133,243426.93,124489.3,367916.23
510715,201706,65,47,18,44029.63,16866,60895.63
510718,201706,218,111,107,103914.78,100240.63,204155.41
510719,201706,32,18,14,16866,13118,29984
510720,201706,197,127,70,118990,65308.9,184298.9
510724,201706,86,33,53,30911.63,49628.89,80540.52
510726,201706,45,25,20,23415.63,18722,42137.63
510729,201706,78,37,41,34669,38379.52,73048.52
510730,201706,468,258,210,241737,196622.63,438359.63
510735,201706,108,42,66,39354,61842,101196
510740,201706,28,15,13,14055,12181,26236
510757,201706,18,14,4,13118,3748,16866
510760,201706,6949,3655,3294,3414590.67,3080965.39,6495556.06
510770,201706,739,350,389,327774.15,364302.15,692076.30
510774,201706,13,6,7,5622,6559,12181
510775,201706,111,82,29,76824.63,27163.63,103988.26
510776,201706,27,6,21,5622,19677,25299
510777,201706,189,84,105,78679.89,98356.89,177036.78
510779,201706,52,24,28,22479,26199.26,48678.26
510780,201706,299,162,137,151722.26,128278.63,280000.89
510785,201706,450,245,205,229499.78,191991.3,421491.08
510787,201706,181,92,89,86190.32,83375.32,169565.64
510788,201706,0,0,0,0,0,0
510790,201706,2355,1226,1129,1146664.59,1055374.53,2202039.12
510792,201706,1036,582,454,544846.52,424992.01,969838.53
510794,201706,107,53,54,49661,50570.26,100231.26
510795,201706,2356,1356,1000,1263344.79,934143.8,2197488.59
510800,201706,171,107,64,100249.63,59959,160208.63
510805,201706,165,117,48,109629,44976,154605
510810,201706,92,36,56,33649.89,52359.93,86009.82
510820,201706,270,129,141,120622.26,131134.71,251756.97
510830,201706,67,40,27,37480,25290,62770
510835,201706,1,0,1,0,937,937
510840,201706,9051,4549,4502,4249337,4210598.08,8459935.08
510850,201706,204,84,120,78698.63,112121.79,190820.42
510860,201706,396,173,223,161916.56,208225.05,370141.61
510880,201706,62,47,15,44020.63,14055,58075.63
510885,201706,69,42,27,39326.26,25261.89,64588.15
510890,201706,74,41,33,38417,30921,69338
510895,201706,180,102,78,95574,72782.63,168356.63
520005,201706,20,16,4,14992,3748,18740
520010,201706,286,126,160,118042,149827,267869
520013,201706,617,359,258,336346.63,241464.9,577811.53
520015,201706,51,35,16,32795,14992,47787
520017,201706,103,59,44,55002,41228,96230
520020,201706,30,15,15,14055,14055,28110
520025,201706,1962,1066,896,998842,838427.7,1837269.7
520030,201706,805,402,403,375605.76,376665,752270.76
520050,201706,75,49,26,45913,24362,70275
520055,201706,45,31,14,29047,13118,42165
520060,201706,176,111,65,104007,60905,164912
520080,201706,582,399,183,373863,171466.32,545329.32
520082,201706,20,14,6,13118,5622,18740
520085,201706,98,72,26,67464,24362,91826
520090,201706,80,54,26,50598,24362,74960
520110,201706,9022,3867,5155,3616553.62,4826273.71,8442827.33
520120,201706,13,8,5,7299.23,4685,11984.23
520130,201706,738,529,209,495664,195543,691207
520140,201706,11650,6552,5098,6132331.85,4773966.91,10906298.76
520145,201706,46,34,12,31858,11244,43102
520150,201706,185,144,41,134928,38417,173345
520160,201706,34,23,11,21551,10307,31858
520170,201706,228,138,90,129275,84294,213569
520180,201706,103,50,53,46850,49661,96511
520215,201706,213,128,85,119654.9,79363.9,199018.8
520235,201706,70,53,17,49661,15929,65590
520250,201706,137,85,52,79645,48442.9,128087.9
520260,201706,112,73,39,68401,35606,104007
520280,201706,48,34,14,31203,13118,44321
520310,201706,38,23,15,21551,14055,35606
520320,201706,169,105,64,98385,59968,158353
520330,201706,774,405,369,379448.63,345726,725174.63
520340,201706,354,199,155,186463,145216.63,331679.63
520350,201706,519,230,289,215510,270747,486257
520355,201706,93,52,41,48724,38417,87141
520357,201706,24,16,8,14992,7496,22488
520360,201706,0,0,0,0,0,0
520380,201706,144,76,68,71212,63696,134908
520390,201706,294,125,169,116376,158343.63,274719.63
520393,201706,12,9,3,8433,2811,11244
520396,201706,97,60,37,56220,34669,90889
520400,201706,230,134,96,123966.1,89952,213918.1
520410,201706,193,99,94,92754,88069,180823
520420,201706,25,17,8,15929,7496,23425
520425,201706,303,135,168,125559,156948.6,282507.6
520430,201706,442,231,211,216165.9,197370.9,413536.8
520440,201706,590,391,199,366367,186463,552830
520450,201706,1873,860,1013,804724.63,948526.95,1753251.58
520455,201706,60,41,19,38417,17803,56220
520460,201706,29,16,13,14992,12181,27173
520465,201706,22,19,3,17803,2811,20614
520470,201706,423,260,163,243420,152731,396151
520480,201706,83,45,38,42165,35552,77717
520485,201706,126,43,83,40291,77490,117781
520490,201706,384,288,96,269675.26,89790.84,359466.10
520495,201706,184,106,78,99322,73086,172408
520500,201706,182,139,43,130243,40291,170534
520505,201706,166,86,80,80582,74960,155542
520510,201706,1736,845,891,787407.56,832614.02,1620021.58
520520,201706,44,31,13,29047,12181,41228
520530,201706,236,171,65,157877.89,60119.79,217997.68
520540,201706,495,322,173,300430.81,162101,462531.81
520545,201706,156,85,71,79645,66527,146172
520547,201706,48,27,21,25299,19677,44976
520549,201706,998,468,530,438198,496073,934271
520551,201706,294,155,139,145235,130243,275478
520552,201706,44,25,19,23425,17803,41228
520570,201706,18,10,8,9370,7496,16866
520580,201706,288,172,116,161155,108692,269847
520590,201706,159,91,68,85267,63434.9,148701.9
520620,201706,1120,526,594,492113.14,555725.53,1047838.67
520630,201706,38,22,16,20614,14992,35606
520640,201706,412,237,175,221600.06,163068.79,384668.85
520650,201706,51,38,13,35606,12181,47787
520660,201706,34,18,16,16866,14992,31858
520670,201706,33,27,6,25299,5622,30921
520680,201706,63,41,22,37948.39,20614,58562.39
520690,201706,32,13,19,12181,17794,29975
520710,201706,38,35,3,32795,2811,35606
520725,201706,199,124,75,116188,70266,186454
520735,201706,56,43,13,40291,12181,52472
520740,201706,401,196,205,182950.2,192076,375026.2
520750,201706,37,28,9,26236,8433,34669
520753,201706,56,40,16,37480,14992,52472
520760,201706,109,73,36,68401,33732,102133
520780,201706,271,209,62,195833,58094,253927
520790,201706,171,79,92,73741.9,86204,159945.9
520800,201706,3549,1857,1692,1736286.78,1584734.77,3321021.55
520810,201706,167,114,53,106818,49661,156479
520815,201706,6,5,1,4685,937,5622
520830,201706,137,89,48,83393,44976,128369
520840,201706,321,210,111,196301.5,104007,300308.5
520850,201706,109,69,40,64644,37330.08,101974.08
520860,201706,1651,1034,617,967743.87,576724.6,1544468.47
520870,201706,30102,14860,15242,13897159.71,14268029.02,28165188.73
520880,201706,983,558,425,522565,398206.26,920771.26
520890,201706,784,447,337,417246.2,315385.63,732631.83
520910,201706,1021,527,494,490287.31,462878,953165.31
520915,201706,97,73,24,68401,22478.63,90879.63
520920,201706,412,201,211,187774.8,197707,385481.8
520929,201706,23,21,2,19677,1874,21551
520940,201706,76,45,31,42165,29047,71212
520945,201706,23,15,8,14055,7496,21551
520960,201706,51,32,19,29984,17803,47787
520970,201706,323,198,125,184908,116843.9,301751.9
520980,201706,95,71,24,66527,22488,89015
520990,201706,465,310,155,290245.12,145235,435480.12
520993,201706,119,58,61,54346,57148,111494
520995,201706,245,137,108,127433,100634,228067
521000,201706,1542,880,662,822874.3,619920,1442794.3
521010,201706,667,301,366,281450.52,342877.15,624327.67
521015,201706,16,9,7,8433,6559,14992
521020,201706,1482,1014,468,949499.95,438151.41,1387651.36
521030,201706,38,27,11,25299,10307,35606
521040,201706,916,558,358,522613,335165,857778
521056,201706,42,29,13,27173,12181,39354
521060,201706,132,81,51,75897,47787,123684
521080,201706,501,368,133,344807,124621,469428
521090,201706,525,311,214,291407,199684.07,491091.07
521100,201706,290,212,78,198644,73086,271730
521120,201706,1034,702,332,657212,310794,968006
521130,201706,359,256,103,239872,95921.8,335793.8
521140,201706,189,106,83,99322,77771,177093
521150,201706,2777,1179,1598,1102522.14,1496075.85,2598597.99
521160,201706,32,17,15,15929,14055,29984
521170,201706,193,111,82,103997.63,76834,180831.63
521180,201706,1104,688,416,643688.43,389089.25,1032777.68
521190,201706,2542,1062,1480,995075.26,1385412.16,2380487.42
521200,201706,44,32,12,29984,11244,41228
521205,201706,16,11,5,10307,4685,14992
521210,201706,150,84,66,78708,61842,140550
521220,201706,801,538,263,501520.78,246376,747896.78
521225,201706,27,17,10,15929,9370,25299
521230,201706,112,71,41,66142.16,38417,104559.16
521250,201706,6421,3620,2801,3385608.75,2621427.83,6007036.58
521260,201706,17,12,5,11244,4685,15929
521270,201706,152,117,35,109629,32795,142424
521280,201706,442,257,185,238933.36,173345,412278.36
521290,201706,34,14,20,13118,18740,31858
521295,201706,101,67,34,62554.12,31858,94412.12
521300,201706,222,113,109,105854,101769.89,207623.89
521305,201706,36,24,12,22488,11244,33732
521308,201706,1074,769,305,720052.78,285485.63,1005538.41
521310,201706,1348,797,551,745714.1,515407.26,1261121.36
521340,201706,22,17,5,15929,4685,20614
521350,201706,131,95,36,89015,33732,122747
521370,201706,196,121,75,112440,69993.9,182433.9
521375,201706,196,108,88,101196,82174.9,183370.9
521377,201706,51,34,17,31858,15929,47787
521380,201706,1058,696,362,648079.26,339194,987273.26
521385,201706,19,11,8,10307,7496,17803
521390,201706,109,87,22,81206.7,20614,101820.7
521400,201706,334,203,131,189929.9,122700.15,312630.05
521405,201706,151,74,77,69338,72149,141487
521410,201706,73,50,23,46850,21551,68401
521440,201706,221,154,67,143501.55,62779,206280.55
521450,201706,715,385,330,360745,308554.1,669299.1
521460,201706,1178,704,474,659367,444119.26,1103486.26
521470,201706,15,10,5,9370,4685,14055
521480,201706,54,34,20,31858,18676,50534
521483,201706,291,153,138,143080,129306,272386
521486,201706,291,182,109,170412.19,101478,271890.19
521487,201706,25,12,13,11244,12181,23425
521490,201706,28,17,11,15929,10307,26236
521500,201706,113,73,40,68401,37480,105881
521520,201706,43,32,11,29984,10307,40291
521523,201706,549,336,213,313285.95,199581,512866.95
521525,201706,48,31,17,29047,15366.8,44413.8
521530,201706,252,129,123,120873,115251,236124
521540,201706,30,16,14,14992,13118,28110
521550,201706,92,40,52,37180.63,48687.63,85868.26
521560,201706,767,529,238,495213.97,222725,717938.97
521565,201706,45,32,13,29984,12181,42165
521570,201706,480,320,160,299830.63,149827.15,449657.78
521580,201706,62,39,23,36543,21551,58094
521590,201706,36,18,18,16866,16866,33732
521600,201706,29,17,12,15929,11244,27173
521630,201706,230,116,114,108682.63,105844.88,214527.51
521640,201706,297,151,146,141487,136802,278289
521645,201706,30,16,14,14992,13118,28110
521680,201706,227,140,87,131180,81519,212699
521690,201706,1,1,0,937,0,937
521710,201706,1174,549,625,513850.9,585335,1099185.9
521720,201706,515,334,181,312958,169550.26,482508.26
521730,201706,627,311,316,291407,295000.8,586407.8
521740,201706,914,355,559,332616.63,522612.96,855229.59
521760,201706,1551,832,719,778034.52,673395,1451429.52
521770,201706,789,498,291,466626,272207.87,738833.87
521800,201706,2113,1298,815,1213682.2,762469.33,1976151.53
521805,201706,36,21,15,19673,14055,33728
521810,201706,98,59,39,54158.9,36543,90701.9
521830,201706,945,656,289,613080.08,270202,883282.08
521839,201706,89,62,27,58094,25299,83393
521850,201706,1087,586,501,547408.26,469107.04,1016515.30
521860,201706,349,211,138,197707,129025,326732
521870,201706,67,36,31,33732,29047,62779
521878,201706,45,21,24,19677,22488,42165
521880,201706,4290,1924,2366,1800538.48,2214522.75,4015061.23
521890,201706,558,383,175,358871,163684.9,522555.9
521900,201706,298,241,57,224911.2,53409,278320.2
521910,201706,152,107,45,100259,42165,142424
521920,201706,56,27,29,25299,27173,52472
521925,201706,34,21,13,19677,12181,31858
521930,201706,1075,607,468,568565.56,437858.53,1006424.09
521935,201706,31,23,8,21551,7496,29047
521940,201706,197,101,96,94637,89916.67,184553.67
521945,201706,16,14,2,13118,1874,14992
521950,201706,7,5,2,4685,1874,6559
521960,201706,73,52,21,48724,19677,68401
521970,201706,408,254,154,237716.9,144298,382014.9
521971,201706,93,47,46,44039,43102,87141
521973,201706,32,14,18,13118,16866,29984
521975,201706,1046,559,487,522659.6,455326.73,977986.33
521980,201706,241,163,78,152572,73086,225658
521990,201706,71,55,16,51535,14992,66527
522000,201706,291,182,109,170534,102133,272667
522005,201706,23,14,9,13118,8433,21551
522010,201706,1109,617,492,577183,460432.43,1037615.43
522015,201706,57,34,23,31849,21551,53400
522020,201706,834,419,415,392603,387899.26,780502.26
522026,201706,28,20,8,18740,7496,26236
522028,201706,16,12,4,11244,3748,14992
522040,201706,720,279,441,261133,413162.63,674295.63
522045,201706,1964,1238,726,1159461.53,679456.8,1838918.33
522050,201706,175,84,91,78708,85267,163975
522060,201706,544,345,199,322983.9,186369.3,509353.2
522068,201706,137,87,50,81519,46850,128369
522070,201706,12,12,0,11244,0,11244
522100,201706,45,23,22,21289,20614,41903
522108,201706,40,30,10,28110,9370,37480
522119,201706,63,30,33,28110,30921,59031
522130,201706,75,23,52,21551,48688,70239
522140,201706,3653,1869,1784,1747611.8,1669763.42,3417375.22
522145,201706,56,33,23,30921,21551,52472
522150,201706,64,51,13,47787,12181,59968
522155,201706,56,40,16,37471,14992,52463
522157,201706,6,4,2,3748,1874,5622
522160,201706,1739,1008,731,943058.98,684656.9,1627715.88
522170,201706,402,268,134,251116,125558,376674
522180,201706,39,21,18,19677,16866,36543
522185,201706,1306,537,769,500258.17,720391.88,1220650.05
522190,201706,48,27,21,25299,19583.3,44882.3
522200,201706,299,182,117,170534,109629,280163
522205,201706,170,116,54,108692,50598,159290
522220,201706,177,123,54,115251,50598,165849
522230,201706,32,25,7,23425,6559,29984
530010,201706,53958,27752,26206,25868904.62,24500964.31,50369868.93
110001,201707,504,395,109,368345.99,101298.64,469644.63
110002,201707,2668,1567,1101,1458321.14,1024861.72,2483182.86
110003,201707,90,71,19,66106.45,17682.89,83789.34
110004,201707,1943,1232,711,1145918.17,661932.93,1807851.10
110005,201707,438,352,86,327017.94,79950.32,406968.26
110006,201707,440,340,100,315613.62,92958.68,408572.30
110007,201707,79,64,15,59767.45,13974.89,73742.34
110008,201707,231,133,98,123203.34,91465.01,214668.35
110009,201707,749,497,252,462826.05,234664.04,697490.09
110010,201707,1761,1088,673,1012702.94,627731.67,1640434.61
110011,201707,1866,1429,437,1329755.87,407013.03,1736768.90
110012,201707,4050,2326,1724,2167324.81,1609070.99,3776395.80
110013,201707,739,545,194,507005.29,180494.81,687500.10
110014,201707,360,305,55,284744.23,51310.21,336054.44
110015,201707,1440,1155,285,1074204.15,265022.29,1339226.44
110018,201707,1114,658,456,612974.64,425294.81,1038269.45
110020,201707,14876,8751,6125,8110705.57,5695255.9,13805961.47
110025,201707,611,443,168,411551.07,156663.81,568214.88
110026,201707,42,30,12,27848.79,11123.56,38972.35
110028,201707,1603,1157,446,1072699.61,413066.77,1485766.38
110029,201707,132,115,17,107514.67,15909,123423.67
110030,201707,2440,1631,809,1514073.92,751964.55,2266038.47
110032,201707,382,291,91,271058.71,84981.9,356040.61
110033,201707,636,484,152,446563,141157.02,587720.02
110034,201707,359,262,97,241879.26,89631.89,331511.15
110037,201707,101,81,20,75836.78,18719.89,94556.67
110040,201707,320,214,106,199093.93,98560.46,297654.39
110045,201707,893,580,313,539010.88,290440.37,829451.25
110050,201707,94,75,19,69934.67,17763,87697.67
110060,201707,88,44,44,41027.89,40787.34,81815.23
110070,201707,129,76,53,70830.46,49058.57,119889.03
110080,201707,392,223,169,205180.65,157013.97,362194.62
110090,201707,29,24,5,22387.56,4644.78,27032.34
110092,201707,104,60,44,55959.01,40876.57,96835.58
110094,201707,198,137,61,127527.46,56635.79,184163.25
110100,201707,26,22,4,20493.78,3727.89,24221.67
110110,201707,71,43,28,40070.56,25734.56,65805.12
110120,201707,73,57,16,53148.56,14891.67,68040.23
110130,201707,298,243,55,224961.71,51234.34,276196.05
110140,201707,246,159,87,148112.96,81068.09,229181.05
110143,201707,42,36,6,33551.45,5561.67,39113.12
110145,201707,27,19,8,17722.89,7476,25198.89
110146,201707,23,12,11,11203.89,10266.89,21470.78
110147,201707,39,30,9,27665.89,8413,36078.89
110148,201707,38,26,12,24169.91,11224,35393.91
110149,201707,288,200,88,186234.94,81993.91,268228.85
110150,201707,81,51,30,47646.78,27829.34,75476.12
110155,201707,9,7,2,6519,1854,8373
110160,201707,71,59,12,54901.24,11163.67,66064.91
110170,201707,217,177,40,164888.45,37239.67,202128.12
110175,201707,27,21,6,19496.12,5601.89,25098.01
110180,201707,93,82,11,76753.78,10266.89,87020.67
120001,201707,131,89,42,82649,39346,121995
120005,201707,191,122,69,114271.12,64466,178737.12
120010,201707,984,639,345,592301.15,320817.52,913118.67
120013,201707,131,89,42,82762.01,38366.86,121128.87
120017,201707,74,50,24,46763.36,22467,69230.36
120020,201707,3447,2740,707,2539453.42,658892.26,3198345.68
120025,201707,605,338,267,314563.12,248262.46,562825.58
120030,201707,1029,857,172,795631.25,160419.12,956050.37
120032,201707,47,39,8,36521.12,7496,44017.12
120033,201707,214,188,26,175814.94,24340.12,200155.06
120034,201707,151,110,41,101174.12,38373.24,139547.36
120035,201707,27,18,9,16866,8433,25299
120038,201707,381,241,140,225006.2,131136.24,356142.44
120039,201707,20,18,2,16866,1874,18740
120040,201707,13768,9531,4237,8804252.26,3928564.22,12732816.48
120042,201707,41,35,6,32795,5622,38417
120043,201707,12,2,10,1874,9349.89,11223.89
120045,201707,530,338,192,315148.05,179639.48,494787.53
120050,201707,1234,941,293,876282.02,273232.46,1149514.48
120060,201707,1360,1094,266,1008863.28,245354.86,1254218.14
120070,201707,504,361,143,332198.58,132605.95,464804.53
120080,201707,140,89,51,82216.73,47224.55,129441.28
130002,201707,149,103,46,96511,43102,139613
130006,201707,74,41,33,38417,30921,69338
130008,201707,142,75,67,69554.72,62056.96,131611.68
130010,201707,140,73,67,68401,62779,131180
130014,201707,242,173,69,162101,64653,226754
130020,201707,85,48,37,44976,34669,79645
130030,201707,863,539,324,505043,303578.63,808621.63
130040,201707,320,164,156,153668,144533.09,298201.09
130050,201707,549,308,241,288314.9,225817,514131.9
130060,201707,872,599,273,556114.42,252942.46,809056.88
130063,201707,535,285,250,267045,234228.12,501273.12
130068,201707,188,120,68,112440,63434.9,175874.9
130070,201707,1329,925,404,840820.23,369051.38,1209871.61
130080,201707,663,435,228,407220.2,213627,620847.2
130083,201707,67,36,31,33732,29047,62779
130090,201707,380,190,190,176380.88,178030,354410.88
130100,201707,1108,519,589,486303,551611.9,1037914.9
130110,201707,705,311,394,291257,369158,660415
130115,201707,174,71,103,66527,96511,163038
130120,201707,1604,1007,597,943559,559389,1502948
130130,201707,623,423,200,396351,187400,583751
130140,201707,1552,1167,385,1092848.95,359808.1,1452657.05
130150,201707,428,360,68,337320,63716,401036
130160,201707,473,260,213,243620,199581,443201
130165,201707,26,18,8,16866,7496,24362
130170,201707,958,674,284,630685.36,265665.69,896351.05
130180,201707,158,95,63,88546.5,59031,147577.5
130185,201707,2072,1113,959,1040986.89,898000.89,1938987.78
130190,201707,3577,2270,1307,2123242.4,1223099.09,3346341.49
130195,201707,293,235,58,220195,54346,274541
130200,201707,182,81,101,75887.63,94637,170524.63
130210,201707,76,36,40,33732,37480,71212
130220,201707,184,127,57,118999,53409,172408
130230,201707,333,211,122,197707,114314,312021
130240,201707,1470,921,549,861620.98,514127.22,1375748.20
130250,201707,4663,3003,1660,2809292.6,1555286.93,4364579.53
130255,201707,418,209,209,195833,195551.9,391384.9
130260,201707,51706,24639,27067,23054147.23,25353652.17,48407799.40
130270,201707,1444,932,512,872815.5,479703.78,1352519.28
130280,201707,109,67,42,62779,39354,102133
130290,201707,2068,1512,556,1416339.22,520690.9,1937030.12
130300,201707,423,304,119,284566.9,111503,396069.9
130310,201707,904,487,417,456319,390729,847048
130320,201707,443,236,207,220195,193959,414154
130330,201707,703,431,272,403847,254582.9,658429.9
130340,201707,3178,1958,1220,1831085.6,1141734.6,2972820.2
130350,201707,490,305,185,285662.57,173345,459007.57
130353,201707,740,300,440,280819,412280,693099
130356,201707,724,330,394,309190,368896.9,678086.9
130360,201707,71,41,30,38417,28110,66527
130370,201707,698,500,198,468500,185526,654026
130380,201707,650,437,213,409469,199581,609050
130390,201707,498,394,104,369178,97448,466626
130395,201707,173,41,132,38417,123684,162101
130400,201707,65,45,20,42165,18740,60905
130406,201707,2042,1310,732,1223925.15,685256.16,1909181.31
130410,201707,525,222,303,208014,283892.26,491906.26
130420,201707,3198,2539,659,2376232.35,617483,2993715.35
130423,201707,166,76,90,71212,84330,155542
130426,201707,140,82,58,76834,54346,131180
130430,201707,405,268,137,251116,128369,379485
130440,201707,202,73,129,68401,120873,189274
140002,201707,35,14,21,13118,19677,32795
140005,201707,192,117,75,109394.75,70275,179669.75
140010,201707,10268,6905,3363,6439579.91,3147361.92,9586941.83
140015,201707,156,69,87,64653,81519,146172
140017,201707,105,71,34,66527,31858,98385
140020,201707,484,327,157,305462,147109,452571
140023,201707,24,17,7,15433,6559,21992
140028,201707,15,10,5,9370,4685,14055
140030,201707,357,250,107,234250,99668.69,333918.69
140040,201707,51,36,15,33732,13961.3,47693.3
140045,201707,250,118,132,109910.1,123684,233594.1
140047,201707,537,355,182,329963.52,169784.5,499748.02
140050,201707,152,100,52,92902,48724,141626
140060,201707,34,25,9,22703.51,8433,31136.51
140070,201707,30,28,2,26236,1874,28110
150010,201707,4701,2909,1792,2723062.75,1676741.66,4399804.41
150013,201707,141,94,47,88078,44039,132117
150020,201707,1102,573,529,536901,495673,1032574
150030,201707,751,303,448,283911,419776,703687
150034,201707,186,113,73,105881,68401,174282
150040,201707,1350,809,541,758033,506917,1264950
150050,201707,718,425,293,397241.9,274341,671582.9
150060,201707,4658,3012,1646,2818553.88,1541777.28,4360331.16
150070,201707,312,139,173,130243,162101,292344
150080,201707,14321,7178,7143,6715747.42,6685714,13401461.42
150085,201707,354,219,135,205193.63,126495,331688.63
150090,201707,756,642,114,601554,106818,708372
150095,201707,346,210,136,196013.84,126626.18,322640.02
150100,201707,53,37,16,34669,14992,49661
150110,201707,168,82,86,76834,80582,157416
150120,201707,434,321,113,300777,105881,406658
150125,201707,49,20,29,18740,27173,45913
150130,201707,1879,994,885,931378,829240.32,1760618.32
150140,201707,54248,25261,28987,23638002.43,27147057.77,50785060.20
150145,201707,169,98,71,91826,66527,158353
150150,201707,2742,1163,1579,1089517.37,1475648.7,2565166.07
150157,201707,450,304,146,284848,136797.32,421645.32
150160,201707,110,85,25,79645,23425,103070
150170,201707,3668,2704,964,2530743.4,902049.9,3432793.3
150172,201707,296,205,91,192085,85267,277352
150175,201707,90,56,34,52472,31858,84330
150178,201707,744,492,252,460067,236124,696191
150180,201707,2927,1388,1539,1299759.8,1441743.86,2741503.66
150190,201707,334,212,122,198644,114314,312958
150195,201707,120,61,59,57157,55283,112440
150200,201707,208,94,114,88078,106818,194896
150210,201707,3111,2518,593,2358326.84,555402.75,2913729.59
150215,201707,492,330,162,308929,151794,460723
150220,201707,3988,2669,1319,2499391.35,1233842.36,3733233.71
150230,201707,1143,911,232,853037.7,217384,1070421.7
150240,201707,5638,3287,2351,3076350.47,2202874,5279224.47
150250,201707,29,14,15,13118,14055,27173
150260,201707,71,42,29,39354,27173,66527
150270,201707,2281,1499,782,1404001,732171.9,2136172.9
150275,201707,586,351,235,328887,220195,549082
150276,201707,99,40,59,37480,55283,92763
150277,201707,753,323,430,302632.63,402910,705542.63
150280,201707,339,203,136,190211,127432,317643
150285,201707,72,35,37,32795,34669,67464
150290,201707,960,579,381,542232.53,356716,898948.53
150293,201707,689,316,373,295670.63,349501,645171.63
150295,201707,454,197,257,184589,240677.82,425266.82
150300,201707,79,43,36,40291,33732,74023
150304,201707,135,87,48,81519,44976,126495
150307,201707,388,317,71,297029,66527,363556
150309,201707,518,368,150,344816,140550,485366
150310,201707,251,170,81,159290,75897,235187
150320,201707,1786,1229,557,1151296.59,521909,1673205.59
150330,201707,2064,1179,885,1104067.1,829245,1933312.1
150340,201707,196,128,68,119701.75,63716,183417.75
150345,201707,605,321,284,300598.97,266108,566706.97
150350,201707,425,332,93,308732.13,87141,395873.13
150360,201707,4364,2805,1559,2625599.74,1460773.63,4086373.37
150370,201707,725,516,209,482710,195542.9,678252.9
150375,201707,193,104,89,97448,83393,180841
150380,201707,1201,779,422,729923,395059,1124982
150390,201707,719,411,308,385107,288587,673694
150400,201707,93,75,18,70275,16866,87141
150405,201707,1238,814,424,761693.86,396725.8,1158419.66
150410,201707,147,94,53,88078,49661,137739
150420,201707,7140,3911,3229,3662975.44,3024381.49,6687356.93
150430,201707,468,318,150,297966,140550,438516
150440,201707,595,350,245,327201,229284,556485
150442,201707,2078,1138,940,1064535.07,880780,1945315.07
150445,201707,508,318,190,297966,177093,475059
150450,201707,272,127,145,118999,135865,254864
150460,201707,779,588,191,548880.66,178948.26,727828.92
150470,201707,1339,801,538,750256,504106,1254362
150475,201707,28,22,6,20614,5622,26236
150480,201707,1221,852,369,798324,345753,1144077
150490,201707,612,322,290,301714,271730,573444
150495,201707,318,215,103,201455,96511,297966
150497,201707,300,207,93,193959,87131.63,281090.63
150500,201707,431,289,142,270793,133054,403847
150503,201707,780,374,406,350157,380404,730561
150506,201707,1041,659,382,617483,357925,975408
150510,201707,1214,691,523,647186,490051,1137237
150520,201707,263,174,89,163038,83393,246431
150530,201707,1514,835,679,779022.55,636223,1415245.55
150540,201707,237,166,71,155542,66527,222069
150543,201707,670,373,297,349201.16,278007.9,627209.06
150548,201707,493,334,159,312958,148983,461941
150549,201707,57,38,19,35606,17803,53409
150550,201707,2872,1486,1386,1391054.52,1298120,2689174.52
150553,201707,2980,1777,1203,1663438.3,1126930,2790368.3
150555,201707,140,72,68,67464,63716,131180
150560,201707,53,40,13,37480,12181,49661
150563,201707,66,35,31,32795,29047,61842
150565,201707,160,92,68,86204,63716,149920
150570,201707,399,266,133,249223.26,124621,373844.26
150580,201707,1466,593,873,554985.1,818001,1372986.1
150590,201707,772,455,317,426335,297029,723364
150600,201707,445,273,172,255801,161164,416965
150610,201707,140,120,20,111607,18740,130347
150611,201707,129,89,40,83393,37480,120873
150613,201707,3109,1902,1207,1782174,1130950,2913124
150616,201707,473,294,179,275244,167723,442967
150618,201707,1111,604,507,565723.49,475059,1040782.49
150619,201707,397,302,95,282974,89015,371989
150620,201707,1279,728,551,682136,516005.9,1198141.9
150630,201707,314,209,105,195833,98385,294218
150635,201707,498,204,294,191148,275478,466626
150640,201707,63,30,33,28110,30921,59031
150650,201707,2299,1316,983,1232820.27,919852.9,2152673.17
150655,201707,256,188,68,176156,63716,239872
150658,201707,97,54,43,50598,40291,90889
150660,201707,480,331,149,310147,139613,449760
150670,201707,980,342,638,320163.9,597787.63,917951.53
150680,201707,9585,5279,4306,4942180.86,4031875.06,8974055.92
150690,201707,51,32,19,29984,17803,47787
150700,201707,554,357,197,334321.6,184589,518910.6
150710,201707,254,157,97,147109,90889,237998
150715,201707,868,523,345,489086.26,323236.89,812323.15
150720,201707,453,340,113,318580,105599.9,424179.9
150730,201707,871,463,408,433822,382014.9,815836.9
150740,201707,244,174,70,163038,65590,228628
150745,201707,779,399,380,373863,356060,729923
150746,201707,55,33,22,30921,20614,51535
150747,201707,272,212,60,198644,56220,254864
150750,201707,126,74,52,69338,48724,118062
150760,201707,1706,1104,602,1034166.9,564074,1598240.9
150770,201707,357,183,174,171471,162866.07,334337.07
150775,201707,81,39,42,36543,39354,75897
150780,201707,179,97,82,90889,76834,167723
150790,201707,897,477,420,446949,393540,840489
150795,201707,1406,814,592,762718,554704,1317422
150796,201707,406,231,175,216447,163975,380422
150797,201707,267,155,112,145235,104944,250179
150800,201707,1403,844,559,789886.31,523674.01,1313560.32
150803,201707,584,481,103,450697,96511,547208
150805,201707,188,118,70,110566,65576.63,176142.63
150808,201707,944,513,431,480681,403847,884528
150810,201707,3356,2306,1050,2155046.63,983550.26,3138596.89
150812,201707,424,223,201,208951,188337,397288
150815,201707,923,609,314,569279.04,294218,863497.04
150820,201707,1589,972,617,909827,578110.26,1487937.26
150830,201707,834,586,248,548145,232376,780521
150835,201707,179,104,75,97448,70275,167723
150840,201707,1266,810,456,758970,427272,1186242
160005,201707,48,29,19,27173,17803,44976
160010,201707,197,122,75,114314,70271,184585
160015,201707,115,66,49,61842,45913,107755
160020,201707,116,67,49,62779,45913,108692
160021,201707,40,21,19,19677,17803,37480
160023,201707,108,60,48,56220,44976,101196
160025,201707,34,15,19,14055,17803,31858
160027,201707,1431,806,625,751756.1,584888,1336644.1
160030,201707,15153,7725,7428,7229375.5,6954146,14183521.5
160040,201707,314,176,138,164912,129306,294218
160050,201707,625,320,305,299840,285503.9,585343.9
160053,201707,338,187,151,174938,141487,316425
160055,201707,18,13,5,12181,4685,16866
160060,201707,6280,3258,3022,3040897.09,2830673.1,5871570.19
160070,201707,159,96,63,89952,59031,148983
160080,201707,76,39,37,36543,34669,71212
170025,201707,22,15,7,14055,6559,20614
170030,201707,222,176,46,164718,43102,207820
170035,201707,230,107,123,99322,115251,214573
170040,201707,185,146,39,136520.9,36543,173063.9
170070,201707,333,187,146,175219,136802,312021
170100,201707,379,268,111,250882,104007,354889
170105,201707,63,51,12,47787,11244,59031
170110,201707,101,62,39,58094,36543,94637
170130,201707,71,31,40,29047,37199,66246
170190,201707,112,69,43,64653,40291,104944
170200,201707,399,265,134,247640.1,125455.78,373095.88
170210,201707,5934,3041,2893,2843787.99,2707537.33,5551325.32
170215,201707,69,32,37,29984,34669,64653
170220,201707,1444,1051,393,982425.76,367960,1350385.76
170230,201707,153,98,55,91826,51535,143361
170240,201707,572,376,196,352312,183652,535964
170255,201707,1113,886,227,830182,212417.9,1042599.9
170270,201707,37,27,10,25299,9182.6,34481.6
170290,201707,71,52,19,48724,17803,66527
170300,201707,79,50,29,46100.4,27173,73273.4
170305,201707,37,30,7,28110,6559,34669
170307,201707,59,43,16,40291,14992,55283
170310,201707,98,52,46,48724,43102,91826
170320,201707,17,13,4,12181,3748,15929
170330,201707,18,15,3,14055,2811,16866
170360,201707,23,15,8,14055,7496,21551
170370,201707,168,82,86,76834,80582,157416
170380,201707,79,54,25,50598,23425,74023
170382,201707,48,43,5,40291,4685,44976
170384,201707,122,86,36,80582,33732,114314
170386,201707,59,28,31,26236,29047,55283
170388,201707,48,18,30,16866,28110,44976
170389,201707,23,17,6,15929,5622,21551
170390,201707,49,29,20,27173,18740,45913
170410,201707,33,22,11,20614,10307,30921
170460,201707,17,12,5,11244,4685,15929
170510,201707,27,20,7,18740,6559,25299
170550,201707,1466,823,643,771130.89,601741.5,1372872.39
170555,201707,110,75,35,70275,32795,103070
170560,201707,101,70,31,65590,29047,94637
170600,201707,37,18,19,16866,17803,34669
170610,201707,193,103,90,96356.4,84312,180668.4
170625,201707,37,17,20,15929,18740,34669
170650,201707,83,62,21,58094,19677,77771
170700,201707,548,413,135,385997.15,125698.55,511695.70
170710,201707,155,96,59,89952,55274,145226
170720,201707,80,66,14,61842,13118,74960
170730,201707,55,32,23,29984,21551,51535
170740,201707,70,51,19,47787,17803,65590
170755,201707,115,54,61,49988.95,57157,107145.95
170765,201707,149,68,81,63107,75897,139004
170770,201707,226,128,98,118858.45,91826,210684.45
170820,201707,594,382,212,357215.52,198223,555438.52
170825,201707,31,19,12,17803,11244,29047
170830,201707,72,49,23,45725.6,21551,67276.6
170900,201707,205,154,51,144298,47787,192085
170930,201707,772,390,382,365112,357372,722484
170950,201707,2945,1267,1678,1184865.88,1570018.93,2754884.81
170980,201707,16,9,7,8433,6559,14992
171050,201707,127,96,31,89952,29047,118999
171070,201707,34,27,7,25299,6559,31858
171090,201707,36,25,11,23425,10307,33732
171110,201707,21,14,7,13118,6559,19677
171150,201707,36,18,18,16866,16866,33732
171180,201707,22,10,12,9370,11244,20614
171190,201707,122,70,52,65590,48724,114314
171195,201707,64,49,15,45913,14055,59968
171200,201707,47,21,26,19677,24362,44039
171215,201707,1,1,0,937,0,937
171240,201707,53,43,10,40291,9370,49661
171245,201707,49,44,5,41228,4685,45913
171250,201707,66,34,32,31858,29974.63,61832.63
171270,201707,16,12,4,11244,3748,14992
171280,201707,36,33,3,30781,2811,33592
171320,201707,977,547,430,512539,401973,914512
171330,201707,409,192,217,179904,203329,383233
171360,201707,82,61,21,57157,19677,76834
171370,201707,22,11,11,10307,10307,20614
171380,201707,126,102,24,95574,22262.19,117836.19
171395,201707,50,31,19,29047,17803,46850
171420,201707,317,210,107,196770,99977.9,296747.9
171430,201707,61,49,12,45913,11244,57157
171488,201707,210,109,101,102133,94637,196770
171500,201707,55,30,25,28110,23425,51535
171510,201707,63,42,21,39354,19677,59031
171515,201707,43,36,7,33732,6559,40291
171525,201707,30,26,4,24362,3748,28110
171550,201707,12,6,6,5622,5622,11244
171570,201707,59,29,30,27173,28110,55283
171575,201707,351,212,139,198504,130233.63,328737.63
171610,201707,1629,810,819,757113.83,765834.99,1522948.82
171620,201707,131,89,42,82849.54,39072.9,121922.44
171630,201707,55,28,27,26236,25299,51535
171650,201707,277,177,100,165849,93700,259549
171660,201707,255,134,121,125558,113377,238935
171665,201707,41,26,15,24362,14055,38417
171670,201707,437,253,184,235458.98,171845.8,407304.78
171700,201707,60,53,7,49661,6559,56220
171720,201707,24,9,15,8433,14055,22488
171750,201707,99,54,45,50598,42165,92763
171780,201707,69,56,13,52472,12181,64653
171790,201707,78,64,14,59968,13118,73086
171800,201707,36,27,9,25299,8433,33732
171820,201707,1914,1091,823,1021570.47,766626.21,1788196.68
171830,201707,37,29,8,27173,7496,34669
171840,201707,57,32,25,29984,23425,53409
171845,201707,33,20,13,18740,12181,30921
171850,201707,36,24,12,22488,11244,33732
171855,201707,71,57,14,53409,13118,66527
171865,201707,9,6,3,5622,2811,8433
171870,201707,31,22,9,20614,8433,29047
171875,201707,75,52,23,48724,21551,70275
171880,201707,27,20,7,18740,6559,25299
171884,201707,43,22,21,20614,19677,40291
171886,201707,111,40,71,37480,66245.9,103725.9
171888,201707,21,15,6,14055,5622,19677
171889,201707,21,15,6,14055,5622,19677
171890,201707,58,47,11,44039,10307,54346
171900,201707,42,29,13,27173,12181,39354
172000,201707,43,36,7,33732,6559,40291
172010,201707,38,31,7,28250.55,6559,34809.55
172015,201707,26,16,10,14992,9088.9,24080.9
172020,201707,124,76,48,71212,44976,116188
172025,201707,33,20,13,18740,12181,30921
172030,201707,34,20,14,18740,13118,31858
172049,201707,75,46,29,43102,27173,70275
172065,201707,151,99,52,92763,48724,141487
172080,201707,75,56,19,51311.02,17803,69114.02
172085,201707,22,11,11,10307,10307,20614
172090,201707,412,311,101,290471,93888,384359
172093,201707,27,18,9,16866,8433,25299
172097,201707,18,9,9,8433,8152,16585
172100,201707,4492,2479,2013,2317614.67,1883459.93,4201074.60
172110,201707,78,51,27,47787,25299,73086
172120,201707,1740,1487,253,1387516.9,235973.14,1623490.04
172125,201707,2,2,0,1874,0,1874
172130,201707,13,11,2,10307,1874,12181
172208,201707,188,119,69,111503,64653,176156
172210,201707,478,227,251,212699,234906,447605
210005,201707,2925,1815,1110,1697375.76,1037489,2734864.76
210010,201707,203,100,103,93700,96511,190211
210015,201707,23,15,8,14055,7496,21551
210020,201707,347,177,170,165849,159290,325139
210030,201707,349,214,135,200518,126486,327004
210040,201707,156,120,36,112440,33732,146172
210043,201707,256,170,86,159290,80582,239872
210047,201707,625,303,322,283536.2,301704.63,585240.83
210050,201707,297,214,83,200518,77771,278289
210055,201707,42,32,10,29984,9370,39354
210060,201707,578,440,138,412182.56,129306,541488.56
210070,201707,415,295,120,276415,112158.9,388573.9
210080,201707,100,91,9,85267,8433,93700
210083,201707,312,125,187,117125,175219,292344
210087,201707,50,32,18,29984,16866,46850
210090,201707,495,338,157,316706,147109,463815
210095,201707,506,355,151,332625.63,141487,474112.63
210100,201707,684,512,172,479416.05,160227.35,639643.40
210110,201707,155,82,73,76834,68401,145235
210120,201707,5544,4118,1426,3853621.2,1335192.14,5188813.34
210125,201707,221,118,103,110566,96511,207077
210130,201707,569,287,282,267982,264234,532216
210135,201707,34,20,14,18740,13118,31858
210140,201707,4002,3094,908,2895939.22,850625,3746564.22
210150,201707,350,219,131,205203,122574,327777
210160,201707,3307,2755,552,2578626.68,516943,3095569.68
210170,201707,1108,847,261,793639,244557,1038196
210173,201707,112,92,20,86204,18740,104944
210177,201707,498,234,264,219258,247368,466626
210180,201707,28,14,14,13118,13118,26236
210190,201707,402,254,148,237998,138676,376674
210193,201707,0,0,0,0,0,0
210197,201707,85,55,30,51535,28092.2,79627.2
210200,201707,639,500,139,468500,130243,598743
210203,201707,271,175,96,163975,89952,253927
210207,201707,376,286,90,267982,84330,352312
210210,201707,767,695,72,651215,67464,718679
210215,201707,77,64,13,59968,12181,72149
210220,201707,400,326,74,305462,69338,374800
210230,201707,305,221,84,207077,78708,285785
210232,201707,1516,933,583,873940,546271,1420211
210235,201707,153,118,35,110379,32795,143174
210237,201707,45,24,21,22488,19677,42165
210240,201707,95,77,18,72149,16866,89015
210250,201707,178,138,40,129306,37480,166786
210255,201707,308,221,87,207077,81519,288596
210260,201707,435,254,181,237998,169597,407595
210270,201707,711,441,270,413217,252990,666207
210275,201707,42,33,9,30921,8433,39354
210280,201707,1026,648,378,604104.38,352874.25,956978.63
210290,201707,489,304,185,284848,173345,458193
210300,201707,6202,3537,2665,3309614.53,2495916.37,5805530.90
210310,201707,102,69,33,64653,30921,95574
210312,201707,130,79,51,74023,47787,121810
210315,201707,117,83,34,77771,31858,109629
210317,201707,121,83,38,77771,35606,113377
210320,201707,2404,1958,446,1832685.88,416965,2249650.88
210325,201707,127,84,43,77771,40010,117781
210330,201707,5902,2856,3046,2672872.7,2854092.63,5526965.33
210340,201707,1446,1015,431,950269,403776.85,1354045.85
210350,201707,605,485,120,454210.75,112440,566650.75
210355,201707,128,100,28,93700,26236,119936
210360,201707,2719,1673,1046,1564510.36,980102,2544612.36
210370,201707,1271,519,752,486303,703968.1,1190271.1
210375,201707,190,97,93,90355,87141,177496
210380,201707,730,544,186,509728,174262,683990
210390,201707,194,159,35,148983,32795,181778
210400,201707,414,344,70,322328,65590,387918
210405,201707,982,643,339,601897.87,317643,919540.87
210407,201707,54,42,12,39354,11244,50598
210408,201707,64,57,7,53409,6559,59968
210409,201707,315,259,56,242683,52472,295155
210410,201707,434,332,102,311084,95565,406649
210420,201707,191,156,35,146172,32795,178967
210430,201707,33,25,8,23425,7496,30921
210440,201707,386,225,161,210825,150857,361682
210450,201707,147,109,38,102133,35606,137739
210455,201707,209,111,98,104007,91826,195833
210460,201707,341,214,127,200518,118999,319517
210462,201707,54,45,9,42165,8433,50598
210465,201707,186,130,56,121810,52472,174282
210467,201707,517,368,149,344816,139613,484429
210470,201707,42,31,11,29047,10307,39354
210480,201707,1277,885,392,829245,367304,1196549
210490,201707,219,128,91,119936,85267,205203
210500,201707,549,288,261,269856,244557,514413
210510,201707,550,419,131,392603,122747,515350
210515,201707,452,235,217,220195,203329,423524
210520,201707,398,344,54,322046.9,50598,372644.9
210530,201707,9267,4961,4306,4633751.15,4029535.61,8663286.76
210535,201707,139,98,41,91826,38417,130243
210540,201707,1550,911,639,852483.4,597337.5,1449820.9
210542,201707,1148,598,550,559951.2,515350,1075301.2
210545,201707,12,11,1,10307,937,11244
210547,201707,133,114,19,106818,17803,124621
210550,201707,747,511,236,477735.9,221132,698867.9
210560,201707,176,144,32,134928,29984,164912
210565,201707,29,20,9,18740,8433,27173
210570,201707,1386,1072,314,1004464,294208.63,1298672.63
210580,201707,107,92,15,86204,14055,100259
210590,201707,779,598,181,559576.4,169597,729173.4
210592,201707,34,30,4,28110,3748,31858
210594,201707,98,82,16,76834,14992,91826
210596,201707,76,65,11,60905,10307,71212
210598,201707,122,87,35,81519,32795,114314
210600,201707,355,296,59,277352,55283,332635
210610,201707,242,225,17,209888,15929,225817
210620,201707,48,28,20,26236,18740,44976
210630,201707,60,56,4,52472,3748,56220
210632,201707,1142,725,417,679325,389979.4,1069304.4
210635,201707,14,12,2,11244,1874,13118
210637,201707,106,75,31,70275,29047,99322
210640,201707,593,511,82,478807,76834,555641
210650,201707,401,320,81,299652.6,74960,374612.6
210660,201707,404,286,118,267982,110319,378301
210663,201707,17,11,6,10307,5622,15929
210667,201707,120,38,82,35606,76834,112440
210670,201707,266,235,31,219493,29047,248540
210675,201707,570,289,281,270793,263297,534090
210680,201707,224,135,89,126495,83393,209888
210690,201707,647,501,146,469437,136802,606239
210700,201707,192,138,54,129306,50598,179904
210710,201707,311,171,140,160227,131180,291407
210720,201707,122,100,22,93700,20614,114314
210725,201707,62,55,7,51535,6559,58094
210730,201707,23,17,6,15929,5622,21551
210735,201707,409,268,141,251116,131836,382952
210740,201707,538,453,85,424461,79645,504106
210745,201707,149,103,46,96511,43102,139613
210750,201707,2433,1060,1373,991300,1286482.26,2277782.26
210760,201707,282,201,81,188337,75882.95,264219.95
210770,201707,404,312,92,291407,85922.9,377329.9
210780,201707,422,301,121,282037,113377,395414
210790,201707,185,141,44,132117,41228,173345
210800,201707,130,97,33,90889,30921,121810
210805,201707,37,34,3,31858,2811,34669
210810,201707,493,365,128,341349.1,119936,461285.1
210820,201707,2317,1804,513,1682095.39,480681,2162776.39
210825,201707,178,91,87,85267,81519,166786
210830,201707,824,483,341,451634,318580,770214
210840,201707,219,142,77,133054,72149,205203
210845,201707,257,152,105,142424,98385,240809
210850,201707,883,556,327,520659.7,306399,827058.7
210860,201707,4195,2077,2118,1945212,1984566,3929778
210870,201707,474,348,126,326076,118062,444138
210880,201707,56,37,19,34669,17803,52472
210890,201707,343,279,64,261423,59968,321391
210900,201707,532,333,199,311291.07,186463,497754.07
210905,201707,78,35,43,32795,40291,73086
210910,201707,2002,1465,537,1371989.2,503169,1875158.2
210920,201707,244,70,174,65590,163038,228628
210923,201707,78,56,22,52472,20614,73086
210927,201707,448,171,277,160227,259549,419776
210930,201707,58,45,13,42165,12181,54346
210940,201707,96,70,26,65590,24362,89952
210945,201707,201,87,114,81519,106818,188337
210950,201707,503,359,144,336383,134923.32,471306.32
210955,201707,75,51,24,47787,22488,70275
210960,201707,2466,990,1476,926037.7,1382731,2308768.7
210970,201707,110,93,17,87141,15929,103070
210975,201707,83,74,9,69338,8433,77771
210980,201707,1282,536,746,502119.56,698721,1200840.56
210990,201707,4475,2713,1762,2541800,1650974,4192774
211000,201707,1392,1075,317,1006974,296747.9,1303721.9
211003,201707,924,622,302,582814,282965,865779
211010,201707,474,413,61,386981,57157,444138
211020,201707,1629,565,1064,529405,996752.49,1526157.49
211023,201707,23,20,3,18458.9,2811,21269.9
211027,201707,60,39,21,36543,19677,56220
211030,201707,387,249,138,233313,129306,362619
211040,201707,313,232,81,217103,75897,293000
211050,201707,1193,731,462,684947,432608.32,1117555.32
211060,201707,682,577,105,540649,98385,639034
211065,201707,24,20,4,18740,3748,22488
211070,201707,913,732,181,684769.97,169597,854366.97
211080,201707,89,85,4,79645,3748,83393
211085,201707,61,32,29,29703,27173,56876
211090,201707,96,78,18,73086,16866,89952
211100,201707,499,399,100,373863,93700,467563
211102,201707,273,175,98,163975,91826,255801
211105,201707,205,138,67,129306,62779,192085
211107,201707,124,71,53,66527,49661,116188
211110,201707,808,521,287,487615,268910,756525
211120,201707,5830,2299,3531,2148710.87,3307475.32,5456186.19
211125,201707,34,27,7,25299,6559,31858
211130,201707,46497,18658,27839,17452189.8,26071862.95,43524052.75
211140,201707,447,371,76,347623,71212,418835
211150,201707,1253,766,487,717742,456034,1173776
211153,201707,176,99,77,92763,72149,164912
211157,201707,57,42,15,39354,14055,53409
211160,201707,689,561,128,524708.25,119936,644644.25
211163,201707,0,0,0,0,0,0
211167,201707,5,3,2,2811,1874,4685
211170,201707,453,309,144,289533,134928,424461
211172,201707,118,78,40,73086,37480,110566
211174,201707,293,167,126,156479,118062,274541
211176,201707,526,366,160,342942,149920,492862
211178,201707,92,58,34,54346,31858,86204
211180,201707,211,163,48,152731,44816.71,197547.71
211190,201707,62,57,5,53409,4685,58094
211195,201707,18,10,8,9370,7496,16866
211200,201707,158,137,21,128031.68,19677,147708.68
211210,201707,640,311,329,290751.1,308273,599024.1
211220,201707,3935,2190,1745,2045216.16,1626858.03,3672074.19
211223,201707,96,90,6,84151.97,5622,89773.97
211227,201707,67,46,21,43102,19677,62779
211230,201707,784,631,153,591106.45,143342.26,734448.71
211240,201707,421,307,114,287659,106818,394477
211245,201707,212,87,125,81519,117125,198644
211250,201707,1647,1389,258,1300647,241746,1542393
211260,201707,800,625,175,585625,163975,749600
211270,201707,2120,1635,485,1531995,453508.1,1985503.1
211280,201707,1834,1077,757,1007276.08,709309,1716585.08
211285,201707,217,121,96,113377,89670.9,203047.9
211290,201707,695,458,237,428958.6,222069,651027.6
211300,201707,817,617,200,577856.7,187400,765256.7
211400,201707,1641,894,747,837678,699939,1537617
220005,201707,19,18,1,16866,937,17803
220010,201707,89,67,22,62779,20332.9,83111.9
220020,201707,540,422,118,394820.6,110566,505386.6
220025,201707,107,103,4,96511,3748,100259
220027,201707,42,34,8,31858,7496,39354
220030,201707,88,73,15,68401,14055,82456
220040,201707,1091,809,282,755878.5,264234,1020112.5
220045,201707,37,28,9,26236,8433,34669
220050,201707,641,515,126,481413.88,118043.26,599457.14
220060,201707,172,145,27,135865,25299,161164
220070,201707,135,123,12,115251,11244,126495
220080,201707,9,8,1,7496,937,8433
220090,201707,33,26,7,24081,6559,30640
220095,201707,3,2,1,1874,937,2811
220100,201707,28,24,4,22488,3748,26236
220105,201707,40,37,3,34669,2811,37480
220110,201707,201,185,16,173063.9,14992,188055.9
220115,201707,42,39,3,36543,2811,39354
220117,201707,20,20,0,18740,0,18740
220120,201707,1522,1034,488,968990.11,457237.26,1426227.37
220130,201707,24,23,1,21551,937,22488
220140,201707,105,85,20,78708,18740,97448
220150,201707,443,308,135,288596,126495,415091
220155,201707,4,4,0,3748,0,3748
220157,201707,19,15,4,14055,3748,17803
220160,201707,70,62,8,58094,7496,65590
220170,201707,34,32,2,29984,1874,31858
220173,201707,8,8,0,7496,0,7496
220177,201707,5,5,0,4685,0,4685
220180,201707,67,66,1,61833.32,937,62770.32
220190,201707,1036,930,106,871410,98572.4,969982.4
220191,201707,44,39,5,36543,4685,41228
220192,201707,68,65,3,60905,2811,63716
220194,201707,23,19,4,17803,3748,21551
220196,201707,103,86,17,80442,15929,96371
220198,201707,6,4,2,3748,1874,5622
220200,201707,429,343,86,322112,80582,402694
220202,201707,36,32,4,29984,3748,33732
220205,201707,38,32,6,29984,5622,35606
220207,201707,18,17,1,15929,937,16866
220208,201707,83,42,41,39354,38417,77771
220209,201707,32,29,3,27173,2811,29984
220210,201707,16,15,1,14055,937,14992
220211,201707,45,44,1,41228,937,42165
220213,201707,42,37,5,34669,4685,39354
220217,201707,37,29,8,27173,7496,34669
220220,201707,1974,1254,720,1171457.04,673403.76,1844860.80
220225,201707,13,6,7,5622,6559,12181
220230,201707,912,729,183,682632.61,170843.21,853475.82
220240,201707,142,128,14,119936,13118,133054
220245,201707,54,50,4,46472,3748,50220
220250,201707,136,120,16,112440,14992,127432
220253,201707,42,34,8,31858,7496,39354
220255,201707,29,25,4,23425,3748,27173
220260,201707,690,505,185,473185,173345,646530
220265,201707,12,8,4,7496,3748,11244
220270,201707,633,560,73,524007.88,67932.5,591940.38
220271,201707,44,35,9,32795,8433,41228
220272,201707,29,27,2,25299,1874,27173
220273,201707,17,14,3,13118,2811,15929
220275,201707,48,37,11,34669,10307,44976
220277,201707,10,8,2,7496,1874,9370
220280,201707,21,19,2,17803,1874,19677
220285,201707,54,50,4,46850,3748,50598
220290,201707,1379,1174,205,1097556,192039,1289595
220300,201707,60,58,2,54346,1874,56220
220310,201707,303,253,50,236919.27,46841,283760.27
220320,201707,440,405,35,378080.5,32795,410875.5
220323,201707,0,0,0,0,0,0
220325,201707,14,9,5,8433,4685,13118
220327,201707,11,10,1,9370,937,10307
220330,201707,191,128,63,119654.9,59031,178685.9
220335,201707,139,123,16,115232.26,14992,130224.26
220340,201707,22,12,10,11244,9370,20614
220342,201707,51,44,7,41228,6559,47787
220345,201707,120,106,14,99322,13118,112440
220350,201707,434,383,51,356295.01,47787,404082.01
220360,201707,41,31,10,29047,9370,38417
220370,201707,1047,833,214,779584,200518,980102
220375,201707,26,25,1,23425,937,24362
220380,201707,35,27,8,25299,7496,32795
220385,201707,28,24,4,22488,3748,26236
220390,201707,2186,1247,939,1163829.2,878485.25,2042314.45
220400,201707,27,26,1,24362,937,25299
220410,201707,18,15,3,14055,2811,16866
220415,201707,12,11,1,10307,937,11244
220420,201707,130,108,22,101196,20332.9,121528.9
220430,201707,131,118,13,108927.4,12181,121108.4
220435,201707,26,19,7,17799,6559,24358
220440,201707,290,247,43,231439,40291,271730
220450,201707,309,162,147,150649.74,137739,288388.74
220455,201707,61,59,2,55283,1874,57157
220460,201707,22,21,1,19021.1,937,19958.1
220465,201707,104,66,38,61842,35606,97448
220470,201707,238,207,31,193022.8,29047,222069.8
220480,201707,72,60,12,56220,11244,67464
220490,201707,83,72,11,66707,10307,77014
220500,201707,98,85,13,79645,12181,91826
220510,201707,371,296,75,276603,70087.6,346690.6
220515,201707,21,17,4,15929,3748,19677
220520,201707,362,324,38,301905,35588,337493
220525,201707,26,18,8,16866,7496,24362
220527,201707,37,31,6,29047,5622,34669
220530,201707,35,13,22,12181,20614,32795
220535,201707,14,13,1,12181,937,13118
220540,201707,58,45,13,42165,12181,54346
220545,201707,64,41,23,38417,21551,59968
220550,201707,617,467,150,437579,140550,578129
220551,201707,26,19,7,17803,6559,24362
220552,201707,8,8,0,7496,0,7496
220553,201707,63,57,6,53409,5622,59031
220554,201707,15,9,6,8151.9,5622,13773.9
220555,201707,22,18,4,16866,3748,20614
220556,201707,60,56,4,52472,3748,56220
220557,201707,59,52,7,48724,6559,55283
220558,201707,7,2,5,1874,4685,6559
220559,201707,6,5,1,4685,937,5622
220560,201707,56,37,19,34481.6,17803,52284.6
220570,201707,757,448,309,419530.14,289533,709063.14
220580,201707,597,540,57,505980,52454.26,558434.26
220585,201707,6,5,1,4685,937,5622
220590,201707,14,14,0,13118,0,13118
220595,201707,62,47,15,43758,14055,57813
220600,201707,19,10,9,9370,8433,17803
220605,201707,21,20,1,18740,937,19677
220610,201707,58,50,8,46850,7496,54346
220620,201707,550,422,128,395179.75,119936,515115.75
220630,201707,8,6,2,5622,1874,7496
220635,201707,35,32,3,29984,2811,32795
220640,201707,98,74,24,69338,22488,91826
220650,201707,117,110,7,103070,6559,109629
220660,201707,24,18,6,16866,5622,22488
220665,201707,5,4,1,3748,937,4685
220667,201707,10,10,0,9370,0,9370
220669,201707,21,18,3,16866,2811,19677
220670,201707,65,51,14,47599.6,13118,60717.6
220672,201707,49,34,15,31858,13773.9,45631.9
220675,201707,34,26,8,24362,7496,31858
220680,201707,33,28,5,26236,4685,30921
220690,201707,51,46,5,43102,4685,47787
220695,201707,66,31,35,29047,32795,61842
220700,201707,1463,1117,346,1044118.09,323921,1368039.09
220710,201707,4,2,2,1874,1874,3748
220720,201707,121,97,24,90654.75,22347.45,113002.20
220730,201707,20,19,1,17803,937,18740
220735,201707,3,1,2,937,1874,2811
220740,201707,39,37,2,34669,1874,36543
220750,201707,100,81,19,75897,17803,93700
220755,201707,15,15,0,14055,0,14055
220760,201707,49,46,3,43102,2811,45913
220770,201707,5611,2769,2842,2589060.52,2657207.13,5246267.65
220775,201707,26,12,14,11244,13118,24362
220777,201707,14,14,0,13118,0,13118
220779,201707,15,12,3,11244,2811,14055
220780,201707,851,723,128,676795.1,119655,796450.1
220785,201707,8,5,3,4685,2811,7496
220790,201707,996,787,209,735060.34,195833,930893.34
220793,201707,14,14,0,13118,0,13118
220795,201707,25,24,1,22488,937,23425
220800,201707,3776,2866,910,2684121.88,851719.74,3535841.62
220810,201707,52,48,4,44976,3748,48724
220820,201707,236,215,21,201455,19677,221132
220830,201707,1115,937,178,877964.32,166786,1044750.32
220840,201707,2381,1568,813,1456725.34,759439,2216164.34
220850,201707,50,39,11,36543,10307,46850
220855,201707,15,10,5,9370,4685,14055
220860,201707,13,12,1,11244,937,12181
220865,201707,19,17,2,15929,1874,17803
220870,201707,57,54,3,50598,2811,53409
220880,201707,336,254,82,237342.1,76553,313895.1
220885,201707,44,39,5,36543,4685,41228
220887,201707,20,19,1,17803,937,18740
220890,201707,105,92,13,86204,12181,98385
220900,201707,46,26,20,24362,18740,43102
220910,201707,55,46,9,43102,8433,51535
220915,201707,16,15,1,14055,937,14992
220920,201707,37,33,4,30921,3748,34669
220930,201707,42,41,1,37617.73,937,38554.73
220935,201707,20,19,1,17803,937,18740
220937,201707,44,41,3,38417,2811,41228
220940,201707,48,43,5,40291,4685,44976
220945,201707,0,0,0,0,0,0
220950,201707,48,44,4,41228,3748,44976
220955,201707,41,38,3,35606,2811,38417
220960,201707,4,4,0,3748,0,3748
220965,201707,25,21,4,19677,3748,23425
220970,201707,46,37,9,34669,8433,43102
220975,201707,9,8,1,7496,937,8433
220980,201707,39,35,4,32795,3748,36543
220985,201707,60,55,5,51535,4685,56220
220987,201707,32,30,2,28110,1874,29984
220990,201707,12,11,1,10307,937,11244
220995,201707,38,33,5,30921,4685,35606
220997,201707,30,24,6,22488,5622,28110
221000,201707,1066,954,112,891324.81,104662.9,995987.71
221005,201707,65,60,5,56220,4685,60905
221010,201707,16,13,3,12181,2811,14992
221020,201707,49,48,1,44976,937,45913
221030,201707,36,29,7,27173,6559,33732
221035,201707,18,17,1,15929,937,16866
221037,201707,12,6,6,5622,5622,11244
221038,201707,12,11,1,10307,937,11244
221039,201707,23,23,0,21551,0,21551
221040,201707,246,212,34,198644,31858,230502
221050,201707,227,191,36,178967,33732,212699
221060,201707,1440,1252,188,1172327.55,176156,1348483.55
221062,201707,32,31,1,29047,937,29984
221063,201707,15,12,3,11244,2811,14055
221065,201707,40,35,5,32795,4685,37480
221070,201707,151,130,21,121810,19677,141487
221080,201707,371,326,45,305462,41883.9,347345.9
221090,201707,40,39,1,36291,937,37228
221093,201707,72,50,22,46850,20614,67464
221095,201707,11,10,1,9370,937,10307
221097,201707,27,24,3,22488,2811,25299
221100,201707,23942,13649,10293,12766340.87,9640805.79,22407146.66
221110,201707,997,732,265,685583,248305,933888
221120,201707,501,369,132,345472,123684,469156
221130,201707,902,737,165,689042.69,153950,842992.69
221135,201707,32,29,3,27173,2811,29984
221140,201707,41,31,10,29047,9370,38417
221150,201707,15,11,4,10307,3748,14055
221160,201707,11,11,0,10307,0,10307
221170,201707,11,11,0,10307,0,10307
230010,201707,156,144,12,134928,11244,146172
230015,201707,113,96,17,89952,15929,105881
230020,201707,1473,1267,206,1184463,192289.03,1376752.03
230030,201707,1559,1112,447,1036474.62,418839,1455313.62
230040,201707,197,174,23,162101,21551,183652
230050,201707,194,143,51,133991,47787,181778
230060,201707,140,112,28,104194.4,26236,130430.4
230070,201707,276,244,32,228628,29984,258612
230075,201707,787,687,100,641284.5,93418.9,734703.4
230080,201707,173,153,20,143361,18740,162101
230090,201707,90,63,27,57532.4,25299,82831.4
230100,201707,1856,1112,744,1039680,696888,1736568
230110,201707,2580,1630,950,1524012.6,889587.9,2413600.5
230120,201707,902,715,187,667612.91,175201,842813.91
230125,201707,132,106,26,99322,24362,123684
230130,201707,443,396,47,371052,44039,415091
230140,201707,212,183,29,171471,27173,198644
230150,201707,152,116,36,108692,33732,142424
230160,201707,901,793,108,742338.5,101196,843534.5
230170,201707,565,518,47,481621.1,44039,525660.1
230180,201707,78,73,5,68401,4685,73086
230185,201707,389,335,54,312554.16,50598,363152.16
230190,201707,2150,1731,419,1618852.69,392291,2011143.69
230195,201707,479,417,62,390729,58094,448823
230200,201707,360,314,46,293271.63,42437,335708.63
230205,201707,336,210,126,195312.96,118062,313374.96
230210,201707,1233,984,249,921082.18,232563.4,1153645.58
230220,201707,1332,928,404,868786.4,378548,1247334.4
230230,201707,891,788,103,736170.65,96511,832681.65
230240,201707,1598,1375,223,1286721.85,208951,1495672.85
230250,201707,1708,1396,312,1304723.47,291782,1596505.47
230260,201707,2839,1681,1158,1570278.79,1084109.75,2654388.54
230270,201707,1313,1056,257,987617.33,237764.95,1225382.28
230280,201707,2636,1961,675,1832118.97,631538,2463656.97
230290,201707,391,354,37,325481.07,34669,360150.07
230300,201707,498,367,131,342642.16,122747,465389.16
230310,201707,405,303,102,283911,95293,379204
230320,201707,867,740,127,690311.17,118990,809301.17
230330,201707,288,232,56,216634.4,52472,269106.4
230340,201707,448,358,90,333760.4,84330,418090.4
230350,201707,2886,1811,1075,1696868.26,1004465.24,2701333.50
230360,201707,240,213,27,198687,25299,223986
230365,201707,170,136,34,126730,31858,158588
230370,201707,9331,4505,4826,4211825.09,4518163.65,8729988.74
230380,201707,451,386,65,361401,59968.8,421369.8
230390,201707,494,270,224,251219.07,209888,461107.07
230393,201707,270,226,44,210922.4,41228,252150.4
230395,201707,321,262,59,245251,55283,300534
230400,201707,596,475,121,442826.9,112889.76,555716.66
230410,201707,2510,1555,955,1452013.49,894554,2346567.49
230420,201707,5661,3659,2002,3409207.74,1871205.9,5280413.64
230423,201707,297,255,42,237061.8,39354,276415.8
230425,201707,324,269,55,252053,51535,303588
230426,201707,105,94,11,87365.88,10025.9,97391.78
230427,201707,78,75,3,70275,2811,73086
230428,201707,1313,675,638,632250.12,597806,1230056.12
230430,201707,434,343,91,321200,84503.34,405703.34
230435,201707,742,514,228,480578,212418.17,692996.17
230440,201707,80896,35454,45442,33144179.2,42538667.07,75682846.27
230445,201707,258,181,77,169409.6,71867.9,241277.5
230450,201707,540,438,102,410406,95574,505980
230460,201707,53,44,9,41228,8433,49661
230465,201707,289,233,56,218321,52472,270793
230470,201707,1799,1390,409,1302430,382145.59,1684575.59
230480,201707,141,137,4,128087.9,3748,131835.9
230490,201707,273,221,52,207077,48724,255801
230495,201707,409,307,102,286822,95574,382396
230500,201707,920,690,230,644656,215501,860157
230510,201707,40,33,7,30921,6559,37480
230520,201707,387,304,83,284848,77771,362619
230523,201707,1811,1165,646,1090200.4,604862,1695062.4
230526,201707,286,240,46,224880,43102,267982
230530,201707,658,496,162,461793.38,150857.6,612650.98
230533,201707,171,166,5,155542,4685,160227
230535,201707,334,247,87,231439,81519,312958
230540,201707,1822,1590,232,1487231.7,217103,1704334.7
230550,201707,3562,2264,1298,2114240.43,1215382.7,3329623.13
230560,201707,579,442,137,412093.4,127150.9,539244.3
230565,201707,180,130,50,121810,46850,168660
230570,201707,306,270,36,252990,33732,286722
230580,201707,1081,797,284,745355.39,264889.9,1010245.29
230590,201707,913,708,205,659227.15,191616.9,850844.05
230600,201707,243,225,18,209157.32,16866,226023.32
230610,201707,324,259,65,242496,60905,303401
230620,201707,159,130,29,120873,27173,148046
230625,201707,707,507,200,473701.25,186267.04,659968.29
230630,201707,1207,946,261,886402,244182.2,1130584.2
230640,201707,3347,2914,433,2723313.56,405706.95,3129020.51
230650,201707,384,338,46,315889.49,42446.1,358335.59
230655,201707,604,526,78,491925.4,73034.95,564960.35
230660,201707,321,268,53,251116,49379.9,300495.9
230670,201707,416,375,41,351375,38417,389792
230680,201707,198,183,15,171471,14055,185526
230690,201707,828,725,103,679325,96511,775836
230700,201707,696,594,102,556578,95011.8,651589.8
230710,201707,713,671,42,628540,39354,667894
230720,201707,136,113,23,105684.23,21551,127235.23
230725,201707,215,171,44,160227,41219,201446
230730,201707,11241,6076,5165,5676469.99,4831315.39,10507785.38
230740,201707,643,508,135,475715,125816.63,601531.63
230750,201707,780,661,119,618186.15,111503,729689.15
230760,201707,1200,1039,161,969569.59,150857,1120426.59
230763,201707,334,275,59,255754.41,55283,311037.41
230765,201707,6517,3021,3496,2824192.25,3273504.1,6097696.35
230770,201707,4837,2489,2348,2322242.94,2197134.14,4519377.08
230780,201707,670,590,80,550045.57,74960,625005.57
230790,201707,182,147,35,137739,32008.66,169747.66
230800,201707,1078,788,290,738351.32,271730,1010081.32
230810,201707,1241,1100,141,1029435.05,131929.6,1161364.65
230820,201707,312,222,90,207078,84330,291408
230830,201707,928,806,122,751590.57,114314,865904.57
230835,201707,268,232,36,216447,33030,249477
230837,201707,162,134,28,125558,26236,151794
230840,201707,860,686,174,641564.5,161820,803384.5
230850,201707,1427,1253,174,1173779.9,162757,1336536.9
230860,201707,308,223,85,208951,78708.25,287659.25
230870,201707,1740,1475,265,1380857,246993.4,1627850.4
230880,201707,17,10,7,9370,6559,15929
230890,201707,564,521,43,488056.98,40291,528347.98
230900,201707,257,196,61,183652,56964,240616
230910,201707,187,149,38,138863.4,35606,174469.4
230920,201707,391,310,81,290470,75897,366367
230930,201707,899,641,258,597806.92,241746,839552.92
230940,201707,825,660,165,618138.9,154418,772556.9
230945,201707,439,370,69,346503,64653,411156
230950,201707,364,312,52,292344,48724,341068
230960,201707,2357,1575,782,1469175.51,732453,2201628.51
230970,201707,1635,921,714,862081.45,668155.96,1530237.41
230980,201707,200,167,33,156479,30921,187400
230990,201707,138,112,26,104944,23618.95,128562.95
231000,201707,193,177,16,163975.74,14992,178967.74
231010,201707,133,104,29,97448,27173,124621
231020,201707,1206,843,363,788298.5,340111,1128409.5
231025,201707,900,669,231,624445.6,214929.9,839375.5
231030,201707,1137,955,182,894831,170253,1065084
231040,201707,134,93,41,86410.14,37699,124109.14
231050,201707,1002,889,113,831120.5,105881,937001.5
231060,201707,133,117,16,109629,14992,124621
231070,201707,1361,962,399,898865.05,373863,1272728.05
231080,201707,258,240,18,224083.55,16866,240949.55
231085,201707,503,313,190,292345,178030,470375
231090,201707,224,189,35,177093,32795,209888
231095,201707,161,127,34,118999,31858,150857
231100,201707,116,94,22,88078,19395.9,107473.9
231110,201707,325,280,45,260865.39,42165,303030.39
231120,201707,303,261,42,243606.88,39167,282773.88
231123,201707,135,127,8,118999,7496,126495
231126,201707,272,233,39,218321,36543,254864
231130,201707,4446,3466,980,3239131.34,917660.42,4156791.76
231135,201707,190,165,25,154605,22183.2,176788.2
231140,201707,3003,2210,793,2067204.79,742066.52,2809271.31
231150,201707,339,323,16,302651,14992,317643
231160,201707,1181,933,248,871223.35,232151.12,1103374.47
231170,201707,536,347,189,325139,177093,502232
231180,201707,1497,1260,237,1179730.4,222069,1401799.4
231190,201707,212,190,22,178030,20614,198644
231195,201707,209,181,28,168885.91,26236,195121.91
231200,201707,814,667,147,624979,136501,761480
231210,201707,591,493,98,460826.52,91826,552652.52
231220,201707,990,716,274,669937.26,256738,926675.26
231230,201707,1323,1064,259,995601.3,241652.3,1237253.6
231240,201707,1268,920,348,861758.9,324858.1,1186617.0
231250,201707,106,99,7,92763,6559,99322
231260,201707,294,189,105,177093,98104,275197
231270,201707,976,814,162,758378.49,151785,910163.49
231280,201707,48,38,10,35606,9370,44976
231290,201707,7045,3871,3174,3618320.71,2971454.05,6589774.76
231300,201707,612,565,47,529405,44039,573444
231310,201707,683,637,46,595393,43097.32,638490.32
231320,201707,541,419,122,392136,114314,506450
231325,201707,84,73,11,68401,10307,78708
231330,201707,1977,1535,442,1432818.19,411251.3,1844069.49
231335,201707,247,215,32,201455,29984,231439
231340,201707,1537,1134,403,1061434.24,377611,1439045.24
231350,201707,1104,906,198,848922,184682.9,1033604.9
231355,201707,375,327,48,306399,44976,351375
231360,201707,449,360,89,334617.09,83393,418010.09
231370,201707,86,69,17,64653,15929,80582
231375,201707,269,197,72,184589,67421,252010
231380,201707,416,341,75,317950.36,70087.6,388037.96
231390,201707,191,156,35,146172,32795,178967
231395,201707,715,438,277,409131.68,259549,668680.68
231400,201707,1025,848,177,792049.55,165511.9,957561.45
231410,201707,1262,1012,250,943701.7,233314,1177015.7
240010,201707,391,185,206,171932.54,192827,364759.54
240020,201707,2109,1616,493,1512746.07,461941,1974687.07
240030,201707,173,142,31,133054,29047,162101
240040,201707,33,33,0,30921,0,30921
240050,201707,489,418,71,390078.06,66527,456605.06
240060,201707,69,64,5,59968,4685,64653
240070,201707,161,120,41,112440,38417,150857
240080,201707,388,250,138,234246,129306,363552
240090,201707,108,95,13,88716,12181,100897
240100,201707,1403,1323,80,1236731.18,74752.49,1311483.67
240110,201707,942,590,352,551172.28,329824,880996.28
240120,201707,139,116,23,108692,21551,130243
240130,201707,285,267,18,249475.31,16866,266341.31
240140,201707,86,66,20,61842,18740,80582
240145,201707,648,567,81,530763.65,75690.86,606454.51
240150,201707,19,16,3,14992,2796.95,17788.95
240160,201707,47,39,8,36543,7496,44039
240165,201707,33,30,3,27876,2811,30687
240170,201707,89,71,18,66527,16866,83393
240180,201707,72,58,14,54346,13118,67464
240185,201707,42,39,3,36533.63,2811,39344.63
240190,201707,20,17,3,15929,2811,18740
240200,201707,2913,1628,1285,1519962.3,1202828,2722790.3
240210,201707,161,126,35,118062,32795,150857
240220,201707,1116,796,320,745852,299830.63,1045682.63
240230,201707,795,738,57,688722.68,52772,741494.68
240240,201707,141,101,40,94637,37480,132117
240250,201707,98,87,11,81519,10307,91826
240260,201707,1758,1296,462,1213677.36,431928.89,1645606.25
240270,201707,183,164,19,153293.2,17803,171096.2
240280,201707,43,33,10,30921,9370,40291
240290,201707,61,59,2,55283,1874,57157
240300,201707,172,99,73,92763,68401,161164
240310,201707,1875,1017,858,944221.66,800505.06,1744726.72
240320,201707,214,204,10,191148,9370,200518
240325,201707,4120,2508,1612,2341611.17,1508309.41,3849920.58
240330,201707,73,70,3,65590,2811,68401
240340,201707,102,72,30,67464,28110,95574
240350,201707,92,80,12,74960,11244,86204
240360,201707,344,250,94,233969,88078,322047
240370,201707,39,37,2,34669,1874,36543
240375,201707,80,48,32,44976,29984,74960
240380,201707,242,198,44,184629,41135,225764
240390,201707,19,16,3,14992,2811,17803
240400,201707,82,79,3,74023,2811,76834
240410,201707,10,7,3,6559,2811,9370
240420,201707,841,651,190,608677.07,177018.04,785695.11
240430,201707,257,242,15,225048.11,14055,239103.11
240440,201707,67,36,31,33732,29047,62779
240450,201707,187,123,64,114688.9,59968,174656.9
240460,201707,60,46,14,43102,13118,56220
240470,201707,228,195,33,182167.79,30921,213088.79
240480,201707,17,17,0,15835.3,0,15835.3
240485,201707,68,59,9,55392,8433,63825
240490,201707,48,48,0,44770,0,44770
240500,201707,85,69,16,64653,14992,79645
240510,201707,47,33,14,30921,13118,44039
240520,201707,131,125,6,117125,5622,122747
240530,201707,46,40,6,37480,5622,43102
240540,201707,81,69,12,64653,11234.63,75887.63
240550,201707,17,14,3,13118,2811,15929
240560,201707,362,264,98,246752.4,91826,338578.4
240570,201707,434,266,168,248117.6,157416,405533.6
240580,201707,1252,1009,243,939297.35,226553.6,1165850.95
240590,201707,30,27,3,25299,2811,28110
240600,201707,117,117,0,109629,0,109629
240610,201707,511,427,84,399818,77959,477777
240615,201707,41,39,2,36543,1874,38417
240620,201707,92,88,4,81519,3748,85267
240630,201707,40,38,2,35606,1874,37480
240640,201707,27,23,4,21551,3748,25299
240650,201707,223,189,34,176251,31858,208109
240660,201707,91,80,11,74960,10307,85267
240670,201707,277,160,117,147859.15,109629,257488.15
240680,201707,55,43,12,40291,11244,51535
240690,201707,52,49,3,45913,2811,48724
240700,201707,196,165,31,154605,29047,183652
240710,201707,1834,1167,667,1092824.3,623208.07,1716032.37
240720,201707,1009,737,272,689623.23,254864,944487.23
240725,201707,68,64,4,59968,3748,63716
240730,201707,130,114,16,106818,14992,121810
240740,201707,229,193,36,179501.09,33732,213233.09
240750,201707,37,23,14,21551,13118,34669
240760,201707,34,30,4,28110,3748,31858
240770,201707,145,111,34,104007,31858,135865
240780,201707,696,583,113,544575.03,105881,650456.03
240790,201707,40,38,2,35606,1874,37480
240800,201707,8323,5641,2682,5249569.82,2506898.6,7756468.42
240810,201707,19534,10694,8840,9980115.77,8273433.23,18253549.00
240820,201707,186,119,67,111217.22,62779,173996.22
240830,201707,1551,1275,276,1188253.14,257676,1445929.14
240840,201707,77,65,12,60905,11244,72149
240850,201707,91,79,12,74023,11244,85267
240860,201707,115,113,2,105881,1874,107755
240870,201707,54,47,7,44039,6559,50598
240880,201707,26,25,1,23415.63,937,24352.63
240890,201707,1098,644,454,599589.29,424457,1024046.29
240895,201707,43,32,11,29984,10307,40291
240910,201707,150,135,15,126495,14055,140550
240920,201707,17,13,4,12181,3748,15929
240930,201707,367,331,36,309210,33732,342942
240933,201707,21,15,6,14055,5622,19677
240940,201707,2382,2103,279,1960053.59,258874.36,2218927.95
240950,201707,47,46,1,43102,937,44039
240960,201707,34,26,8,24362,7496,31858
240970,201707,151,109,42,102133,38617,140750
240980,201707,180,142,38,133054,35606,168660
240990,201707,115,75,40,70275,37480,107755
241000,201707,83,74,9,69151,8433,77584
241010,201707,60,46,14,43102,13118,56220
241020,201707,116,109,7,102133,6559,108692
241025,201707,9,3,6,2811,5622,8433
241030,201707,121,98,23,91826,21551,113377
241040,201707,30,25,5,23425,4685,28110
241050,201707,97,84,13,78708,12181,90889
241060,201707,35,32,3,29984,2811,32795
241070,201707,18,18,0,16866,0,16866
241080,201707,64,56,8,52190.9,7496,59686.9
241090,201707,53,43,10,40291,9327.9,49618.9
241100,201707,74,67,7,62779,6559,69338
241105,201707,8,3,5,2811,4685,7496
241110,201707,50,47,3,44039,2811,46850
241120,201707,1364,1057,307,987477.4,286796.96,1274274.36
241140,201707,230,186,44,173346,41228,214574
241142,201707,43,42,1,39354,937,40291
241150,201707,1190,1046,144,977432.5,134928,1112360.5
241160,201707,27,25,2,23425,1874,25299
241170,201707,41,39,2,36543,1874,38417
241180,201707,49,39,10,36371.53,9370,45741.53
241190,201707,46,45,1,42165,937,43102
241200,201707,3688,2036,1652,1902304.01,1546037.74,3448341.75
241210,201707,76,61,15,57157,13212,70369
241220,201707,1327,880,447,823950.7,418820.26,1242770.96
241230,201707,234,196,38,182746.23,35606,218352.23
241240,201707,51,39,12,36543,11244,47787
241250,201707,1042,970,72,908328,67183,975511
241255,201707,41,33,8,30921,7496,38417
241260,201707,622,492,130,460999.32,121810,582809.32
241270,201707,48,32,16,29984,14992,44976
241280,201707,101,87,14,81519,13118,94637
241290,201707,107,80,27,74960,25299,100259
241300,201707,81,57,24,53409,22488,75897
241310,201707,52,40,12,37340,11244,48584
241320,201707,30,17,13,15553,12181,27734
241330,201707,59,53,6,49661,5622,55283
241335,201707,53,45,8,42165,7496,49661
241340,201707,183,138,45,129306,42165,171471
241350,201707,57,53,4,49661,3748,53409
241355,201707,42,39,3,36543,2811,39354
241360,201707,48,48,0,44976,0,44976
241370,201707,44,37,7,34669,6559,41228
241380,201707,44,42,2,39354,1874,41228
241390,201707,72,57,15,53221.6,14055,67276.6
241400,201707,187,153,34,142706,31858,174564
241410,201707,176,159,17,148983,15836,164819
241415,201707,91,72,19,67464,17803,85267
241420,201707,92,70,22,65590,20446,86036
241430,201707,27,26,1,24362,937,25299
241440,201707,437,370,67,346690,62779,409469
241445,201707,32,30,2,28110,1874,29984
241450,201707,279,228,51,213512,47787,261299
241460,201707,130,117,13,109395,12181,121576
241470,201707,46,38,8,35606,7496,43102
241475,201707,72,68,4,63716,3748,67464
241480,201707,90,66,24,61842,22488,84330
241490,201707,10,8,2,7496,1593,9089
241500,201707,49,36,13,33732,12181,45913
250010,201707,99,87,12,81519,11244,92763
250020,201707,24,20,4,18740,3748,22488
250030,201707,800,582,218,544013.1,202422.51,746435.61
250040,201707,310,259,51,242683,47787,290470
250050,201707,215,180,35,168660,32795,201455
250053,201707,55,43,12,40291,11244,51535
250057,201707,0,0,0,0,0,0
250060,201707,439,343,96,321391,89952,411343
250070,201707,673,577,96,538669,89952,628621
250073,201707,8,8,0,7496,0,7496
250077,201707,210,155,55,144851.6,51535,196386.6
250080,201707,416,321,95,299185.1,89015,388200.1
250090,201707,216,145,71,134928.2,65671.26,200599.46
250100,201707,454,370,84,346690,78334,425024
250110,201707,475,355,120,330883.6,112440,443323.6
250115,201707,29,8,21,7496,19677,27173
250120,201707,99,75,24,70275,22488,92763
250130,201707,582,457,125,428209,116938,545147
250135,201707,13,8,5,7496,4685,12181
250140,201707,71,63,8,59031,7496,66527
250150,201707,545,405,140,377358,130870.79,508228.79
250153,201707,11,10,1,9370,937,10307
250157,201707,28,22,6,20614,5622,26236
250160,201707,210,165,45,154605,42165,196770
250170,201707,67,47,20,44039,18740,62779
250180,201707,3882,2623,1259,2444686.86,1174918.75,3619605.61
250190,201707,925,602,323,562434.25,301948.25,864382.50
250200,201707,50,43,7,40291,6559,46850
250205,201707,17,14,3,13118,2811,15929
250210,201707,87,75,12,70275,11244,81519
250215,201707,62,53,9,49661,8433,58094
250220,201707,27,20,7,18740,6559,25299
250230,201707,68,63,5,59031,4685,63716
250240,201707,233,191,42,178170.55,39354,217524.55
250250,201707,388,331,57,310147,53409,363556
250260,201707,29,25,4,23425,3748,27173
250270,201707,58,45,13,42165,12181,54346
250280,201707,387,324,63,303588,59031,362619
250290,201707,90,83,7,77489.9,6559,84048.9
250300,201707,562,385,177,360109.24,165836,525945.24
250310,201707,43,37,6,34669,5622,40291
250320,201707,1841,1261,580,1175259.84,542233,1717492.84
250330,201707,79,68,11,63716,10307,74023
250340,201707,25,21,4,19677,3748,23425
250350,201707,132,82,50,76552.9,46287.8,122840.7
250355,201707,24,19,5,17803,4685,22488
250360,201707,198,162,36,151794,33498,185292
250370,201707,2309,1569,740,1464346.59,691850.71,2156197.30
250375,201707,21,17,4,15929,3748,19677
250380,201707,50,34,16,31858,14992,46850
250390,201707,35,29,6,27173,5622,32795
250400,201707,15256,7714,7542,7206611.84,7059880.29,14266492.13
250403,201707,409,335,74,313885.64,69338,383223.64
250407,201707,52,46,6,43102,5622,48724
250410,201707,29,24,5,22488,4685,27173
250415,201707,45,29,16,27173,14973.26,42146.26
250420,201707,47,38,9,35606,8433,44039
250430,201707,1659,1390,269,1300276,252053,1552329
250435,201707,13,11,2,10307,1874,12181
250440,201707,687,592,95,552372.29,89015,641387.29
250450,201707,83,69,14,64653,12462.1,77115.1
250460,201707,402,269,133,252053,124488.42,376541.42
250470,201707,89,64,25,59968,23425,83393
250480,201707,322,253,69,237061,64653,301714
250485,201707,1,1,0,937,0,937
250490,201707,202,166,36,155542,33732,189274
250500,201707,71,51,20,47787,18740,66527
250510,201707,717,555,162,518723.8,150803.41,669527.21
250520,201707,172,117,55,109610.28,51530.32,161140.60
250523,201707,109,90,19,84330,17803,102133
250527,201707,103,79,24,74018.32,22488,96506.32
250530,201707,6,5,1,4685,937,5622
250535,201707,27,22,5,20614,4685,25299
250540,201707,124,93,31,86438.25,29047,115485.25
250550,201707,68,65,3,60905,2811,63716
250560,201707,36,31,5,29047,4685,33732
250570,201707,152,119,33,111503,30921,142424
250580,201707,140,109,31,101851.9,29047,130898.9
250590,201707,18,14,4,13118,3748,16866
250600,201707,1273,867,406,809101.64,380324.32,1189425.96
250610,201707,151,130,21,121810,19677,141487
250620,201707,20,16,4,14992,3748,18740
250625,201707,57,42,15,39354,14055,53409
250630,201707,2968,1898,1070,1772333.29,1001253.92,2773587.21
250640,201707,199,166,33,155542,30921,186463
250650,201707,31,21,10,19677,9370,29047
250660,201707,37,30,7,28110,6559,34669
250670,201707,53,34,19,31858,17803,49661
250680,201707,387,314,73,294218,68401,362619
250690,201707,1740,1192,548,1113672.76,513101.9,1626774.66
250700,201707,933,816,117,760210.3,109422.86,869633.16
250710,201707,444,345,99,323265,92763,416028
250720,201707,100,79,21,74023,19677,93700
250730,201707,362,304,58,284848,54346,339194
250740,201707,45,41,4,38417,3748,42165
250750,201707,19623,11717,7906,10923070.88,7398874.03,18321944.91
250760,201707,63,49,14,45913,13118,59031
250770,201707,338,227,111,211762.31,102859.27,314621.58
250780,201707,55,43,12,40291,11244,51535
250790,201707,482,305,177,282974.76,165146.25,448121.01
250800,201707,149,137,12,127666.25,11244,138910.25
250810,201707,82,61,21,57157,19677,76834
250820,201707,156,125,31,117125,29047,146172
250830,201707,430,286,144,266998.25,134928,401926.25
250840,201707,52,49,3,45913,2811,48724
250850,201707,49,39,10,35868.36,9370,45238.36
250855,201707,13,11,2,10307,1874,12181
250860,201707,199,144,55,134928,51253.9,186181.9
250870,201707,32,29,3,27173,2811,29984
250880,201707,74,56,18,52425.15,16866,69291.15
250890,201707,2284,1683,601,1575659.2,562289.57,2137948.77
250900,201707,56,47,9,44039,8433,52472
250905,201707,130,100,30,93700,28110,121810
250910,201707,1150,817,333,764114.14,311739.9,1075854.04
250915,201707,111,76,35,71212,32795,104007
250920,201707,136,103,33,96511,30921,127432
250930,201707,150,95,55,89015,51535,140550
250933,201707,0,0,0,0,0,0
250937,201707,8,7,1,6559,937,7496
250939,201707,31,24,7,22488,6559,29047
250940,201707,101,74,27,69338,25299,94637
250950,201707,77,52,25,48724,23425,72149
250960,201707,91,50,41,46829.89,38417,85246.89
250970,201707,1180,831,349,777055,326731.9,1103786.9
250980,201707,89,62,27,58094,25299,83393
250990,201707,160,122,38,113878.35,35577.9,149456.25
251000,201707,72,66,6,61654.6,5622,67276.6
251010,201707,90,70,20,65586,17975.4,83561.4
251020,201707,79,69,10,63856.55,9370,73226.55
251030,201707,41,31,10,29047,9370,38417
251040,201707,52,36,16,33732,14992,48724
251050,201707,25,23,2,21551,1874,23425
251060,201707,45,37,8,33732,7496,41228
251065,201707,4,3,1,2811,937,3748
251070,201707,26,20,6,18731,5622,24353
251080,201707,4618,2232,2386,2079230.78,2229245.41,4308476.19
251090,201707,198,169,29,158353,27173,185526
251100,201707,18,17,1,15929,937,16866
251110,201707,46,36,10,33732,9370,43102
251120,201707,1750,1036,714,965763.2,669018,1634781.2
251130,201707,339,273,66,255801,61842,317643
251140,201707,491,313,178,292158,166620.34,458778.34
251150,201707,289,251,38,234429,35606,270035
251160,201707,89,73,16,68397,14992,83389
251170,201707,101,79,22,73994.92,20604.64,94599.56
251180,201707,290,181,109,169597,102124.32,271721.32
251190,201707,190,130,60,121487.68,56220,177707.68
251200,201707,249,199,50,186463,46850,233313
251203,201707,30,28,2,26236,1874,28110
251207,201707,92,76,16,71212,14992,86204
251210,201707,1212,855,357,799608.89,333853.1,1133461.99
251220,201707,46,36,10,33732,9370,43102
251230,201707,512,435,77,407575,72149,479724
251240,201707,102,72,30,66527,28110,94637
251250,201707,1302,933,369,872113.1,345613,1217726.1
251260,201707,13,8,5,7496,4685,12181
251270,201707,337,248,89,232376,83253,315629
251272,201707,71,65,6,60905,5622,66527
251274,201707,25,20,5,18740,4685,23425
251275,201707,20,14,6,13118,5622,18740
251276,201707,17,14,3,13118,2811,15929
251278,201707,9,7,2,6559,1874,8433
251280,201707,90,86,4,80582,3748,84330
251290,201707,693,523,170,490051,159290,649341
251300,201707,17,15,2,14055,1874,15929
251310,201707,352,253,99,237057,92763,329820
251315,201707,15,14,1,13118,937,14055
251320,201707,59,46,13,43102,12181,55283
251330,201707,79,70,9,65590,8433,74023
251335,201707,9,5,4,4685,3748,8433
251340,201707,679,411,268,385107,250109.63,635216.63
251350,201707,33,31,2,29047,1874,30921
251360,201707,63,54,9,50395.61,8433,58828.61
251365,201707,14,14,0,13118,0,13118
251370,201707,5158,3485,1673,3260950.13,1565728.3,4826678.43
251380,201707,50,40,10,37480,9370,46850
251385,201707,2,2,0,1874,0,1874
251390,201707,624,500,124,467376.6,114970,582346.6
251392,201707,28,18,10,16866,9370,26236
251394,201707,9,9,0,8433,0,8433
251396,201707,18,14,4,13118,3748,16866
251398,201707,18,15,3,14055,2811,16866
251400,201707,35,29,6,27173,5622,32795
251410,201707,33,29,4,27173,3748,30921
251420,201707,107,82,25,76834,23425,100259
251430,201707,36,34,2,31858,1874,33732
251440,201707,39,25,14,23416,13118,36534
251445,201707,47,42,5,39354,4685,44039
251450,201707,408,361,47,336631.4,44039,380670.4
251455,201707,2,1,1,937,937,1874
251460,201707,15,11,4,10307,3748,14055
251465,201707,5,2,3,1874,2811,4685
251470,201707,44,36,8,33732,7496,41228
251480,201707,24,22,2,20614,1874,22488
251490,201707,131,92,39,85736,35607,121343
251500,201707,115,92,23,86204,20802,107006
251510,201707,31,24,7,22488,6559,29047
251520,201707,23,23,0,21551,0,21551
251530,201707,4566,3194,1372,2988108.09,1285273.53,4273381.62
251540,201707,74,66,8,61842,7496,69338
251550,201707,424,323,101,301714.6,94403,396117.6
251560,201707,23,18,5,16866,4685,21551
251570,201707,17,17,0,15929,0,15929
251580,201707,115,93,22,87141,20614,107755
251590,201707,128,94,34,88078,31858,119936
251593,201707,18,10,8,9370,7496,16866
251597,201707,60,49,11,45913,10307,56220
251600,201707,1095,776,319,725800.94,297206.26,1023007.20
251610,201707,208,158,50,147390.1,46006,193396.1
251615,201707,1,1,0,937,0,937
251620,201707,4213,2821,1392,2634690.07,1301869.34,3936559.41
251630,201707,419,306,113,286722,105881,392603
251640,201707,147,103,44,96511,41228,137739
251650,201707,254,185,69,171546.55,64653,236199.55
251660,201707,219,199,20,185526.55,18322.18,203848.73
251670,201707,346,272,74,253300.07,69338,322638.07
251675,201707,3,3,0,2811,0,2811
251680,201707,87,81,6,75897,5622,81519
251690,201707,335,279,56,261423,52128.13,313551.13
251700,201707,279,227,52,212122.75,48709.95,260832.70
251710,201707,18,12,6,11244,5622,16866
251720,201707,33,22,11,20614,10026,30640
251740,201707,9,7,2,6559,1874,8433
260005,201707,3037,1725,1312,1606092.43,1228199.55,2834291.98
260010,201707,1282,906,376,845759.76,350344.96,1196104.72
260020,201707,431,378,53,354186,49661,403847
260030,201707,560,407,153,380605.65,143361,523966.65
260040,201707,850,520,330,485375.45,309060.08,794435.53
260050,201707,1119,787,332,736717,310522,1047239
260060,201707,412,372,40,347814.4,37480,385294.4
260070,201707,1398,886,512,826151,477764.58,1303915.58
260080,201707,729,567,162,530061.55,151794,681855.55
260090,201707,565,346,219,323977.86,205203,529180.86
260100,201707,223,155,68,144251.6,63716,207967.6
260105,201707,240,132,108,123684,101196,224880
260110,201707,2647,1971,676,1846808.63,632616,2479424.63
260120,201707,2876,1571,1305,1461107.31,1220538.55,2681645.86
260130,201707,145,100,45,93700,42165,135865
260140,201707,2022,1320,702,1229436.25,656257.63,1885693.88
260150,201707,231,150,81,140550,75897,216447
260160,201707,282,246,36,230502,33732,264234
260170,201707,3224,1992,1232,1859593.04,1153306.45,3012899.49
260180,201707,131,114,17,106818,15929,122747
260190,201707,2269,1618,651,1512972.03,609987,2122959.03
260200,201707,877,726,151,679500.24,141206,820706.24
260210,201707,1382,964,418,903119.96,391376,1294495.96
260220,201707,697,638,59,597034,55283,652317
260230,201707,1184,894,290,835526.15,271730,1107256.15
260240,201707,210,153,57,142208.49,53409,195617.49
260250,201707,70,56,14,52472,13118,65590
260260,201707,957,686,271,642782,253927,896709
260270,201707,438,354,84,330480.1,78426.9,408907.0
260280,201707,949,717,232,671641.6,216822,888463.6
260290,201707,6269,3304,2965,3076817.17,2772065.06,5848882.23
260300,201707,799,698,101,651721.23,94356,746077.23
260310,201707,488,385,103,358735.13,96511,455246.13
260320,201707,878,660,218,617987.13,204266,822253.13
260330,201707,28,22,6,20614,5622,26236
260340,201707,64,47,17,44039,15929,59968
260345,201707,5450,3101,2349,2899288.92,2199760.01,5099048.93
260350,201707,465,339,126,315930.16,117126,433056.16
260360,201707,291,149,142,139613,133054,272667
260370,201707,619,400,219,372236.7,205066,577302.7
260380,201707,596,427,169,400099,157229.14,557328.14
260390,201707,290,247,43,230263.19,39354,269617.19
260392,201707,90,78,12,73086,11244,84330
260400,201707,4069,2316,1753,2159937.83,1642205.41,3802143.24
260410,201707,13891,7554,6337,7063512.06,5935086.5,12998598.56
260415,201707,122,107,15,100259,14055,114314
260420,201707,1774,1039,735,968209.55,687243.8,1655453.35
260430,201707,196,177,19,164658.14,17803,182461.14
260440,201707,227,164,63,152395,59031,211426
260450,201707,482,340,142,317318,132773,450091
260460,201707,852,448,404,417154.4,378543.32,795697.72
260470,201707,365,218,147,203516.4,136942.55,340458.95
260480,201707,197,120,77,112440,72149,184589
260490,201707,202,163,39,152731,36543,189274
260500,201707,1119,746,373,695864.5,347768,1043632.5
260510,201707,722,565,157,529405,146172,675577
260515,201707,251,222,29,208014,26705,234719
260520,201707,3262,1915,1347,1786753.23,1260256.21,3047009.44
260530,201707,733,597,136,557556.92,127432,684988.92
260540,201707,586,436,150,408532,139613.66,548145.66
260545,201707,14,10,4,9370,3748,13118
260550,201707,326,201,125,188337,117125,305462
260560,201707,513,388,125,362976,116843.9,479819.9
260570,201707,1004,833,171,777570.9,160227,937797.9
260580,201707,283,251,32,235187,29984,265171
260590,201707,631,362,269,337807.24,252053,589860.24
260600,201707,8006,4051,3955,3773783.06,3703394.62,7477177.68
260610,201707,494,328,166,307336,155542,462878
260620,201707,3492,1846,1646,1719879.1,1537399.26,3257278.36
260630,201707,71,68,3,63716,2811,66527
260640,201707,3556,1938,1618,1811711.24,1515720.05,3327431.29
260650,201707,336,230,106,215510,99279.85,314789.85
260660,201707,498,339,159,317268.2,148092.85,465361.05
260670,201707,100,75,25,70275,23425,93700
260680,201707,3640,2014,1626,1870202.99,1521633.52,3391836.51
260690,201707,192,153,39,142705.1,36543,179248.1
260700,201707,339,200,139,186650.4,129426,316076.4
260710,201707,39,37,2,34669,1874,36543
260720,201707,2179,1306,873,1217939.23,817223.29,2035162.52
260730,201707,591,448,143,419776,132117.45,551893.45
260740,201707,65,61,4,57157,3748,60905
260750,201707,650,452,198,423524,185526,609050
260760,201707,633,347,286,325139,267652,592791
260765,201707,963,503,460,468421.9,430785.75,899207.65
260770,201707,216,160,56,149920,52472,202392
260775,201707,817,487,330,455149.3,309210,764359.3
260780,201707,264,168,96,157416,89820.82,247236.82
260790,201707,12352,6769,5583,6314341.3,5224126.64,11538467.94
260795,201707,149,101,48,93493.86,44976,138469.86
260800,201707,362,298,64,278756,59968,338724
260805,201707,199,128,71,119220.13,66527,185747.13
260810,201707,737,644,93,602200.53,87141,689341.53
260820,201707,314,208,106,193590,99322,292912
260825,201707,198,135,63,126124.71,59031,185155.71
260830,201707,256,164,92,153527.45,86204,239731.45
260840,201707,220,159,61,147723,56876,204599
260845,201707,210,145,65,135865,60905,196770
260850,201707,511,368,143,343181.64,133991,477172.64
260860,201707,249,185,64,173150.86,59968,233118.86
260870,201707,372,261,111,244557,104007,348564
260875,201707,673,463,210,432737.53,196770,629507.53
260880,201707,1398,898,500,840720.31,468312.6,1309032.91
260890,201707,2446,1713,733,1597102.49,685885,2282987.49
260900,201707,1029,693,336,648062.95,314832,962894.95
260910,201707,271,214,57,200518,53409,253927
260915,201707,306,203,103,190211,96391,286602
260920,201707,165,95,70,89015,65590,154605
260930,201707,395,336,59,314832,55212.8,370044.8
260940,201707,2657,1466,1191,1369708.55,1115199.26,2484907.81
260950,201707,1862,1090,772,1014987.45,723364,1738351.45
260960,201707,14214,7384,6830,6883366.9,6391701.37,13275068.27
260970,201707,423,365,58,342005,54346,396351
260980,201707,206,178,28,166496,26236,192732
260990,201707,2492,2057,435,1926913.01,407595,2334508.01
261000,201707,4305,2504,1801,2333866.23,1685007.9,4018874.13
261010,201707,191,137,54,128369,49794.8,178163.8
261020,201707,616,453,163,424321,151934.55,576255.55
261030,201707,210,151,59,141487,55254.9,196741.9
261040,201707,357,321,36,300777,33450.9,334227.9
261050,201707,463,407,56,381359,52472,433831
261060,201707,1301,849,452,793405.88,423524,1216929.88
261070,201707,8892,4563,4329,4249597.33,4047875.09,8297472.42
261080,201707,395,298,97,279226,90889,370115
261090,201707,2127,1637,490,1526306.92,458381,1984687.92
261100,201707,1058,747,311,698112.8,290095.2,988208.0
261110,201707,7839,4767,3072,4461437.93,2876231.5,7337669.43
261120,201707,280,236,44,220851,41224,262075
261130,201707,571,320,251,299512.45,235187,534699.45
261140,201707,187,120,67,112440,62779,175219
261150,201707,650,378,272,352977.77,254864,607841.77
261153,201707,71,68,3,62779.12,2811,65590.12
261160,201707,75732,38517,37215,35972784.44,34846895.26,70819679.70
261170,201707,457,337,120,315488,112440,427928
261180,201707,1734,1057,677,985246.43,634349,1619595.43
261190,201707,620,424,196,396741.33,183643,580384.33
261200,201707,212,187,25,174514.09,23425,197939.09
261210,201707,30,27,3,25299,2811,28110
261220,201707,2404,1689,715,1577067.11,668831,2245898.11
261230,201707,317,236,81,220663.5,75882.95,296546.45
261240,201707,436,373,63,345559.47,59031,404590.47
261245,201707,207,172,35,161164,32795,193959
261247,201707,138,101,37,94637,34669,129306
261250,201707,2734,1345,1389,1258765.9,1300683.71,2559449.61
261255,201707,248,227,21,212699,19677,232376
261260,201707,825,714,111,669018,104007,773025
261270,201707,169,131,38,122747,35606,158353
261280,201707,139,112,27,104944,25299,130243
261290,201707,132,90,42,84095.75,39354,123449.75
261300,201707,1213,856,357,801238.44,334509,1135747.44
261310,201707,742,494,248,462878,231766.95,694644.95
261320,201707,523,349,174,327013,163038,490051
261330,201707,782,627,155,584555.25,144404.53,728959.78
261340,201707,320,175,145,163975,135865,299840
261350,201707,747,530,217,495673.1,203289,698962.1
261360,201707,1159,739,420,692048.53,393540,1085588.53
261370,201707,4849,2986,1863,2783640.4,1743967.2,4527607.6
261380,201707,572,413,159,385116.92,148702,533818.92
261390,201707,3345,2232,1113,2086333.94,1039781.53,3126115.47
261400,201707,286,261,25,243713.7,23425,267138.7
261410,201707,1010,666,344,624042,322323.32,946365.32
261420,201707,862,534,328,498457.63,307317.63,805775.26
261430,201707,329,298,31,278395,28765.9,307160.9
261440,201707,89,78,11,73086,10307,83393
261450,201707,2477,2057,420,1924984.13,392548.12,2317532.25
261460,201707,666,534,132,499421.81,123684,623105.81
261470,201707,240,184,56,171612,52472,224084
261480,201707,327,268,59,249993,55279,305272
261485,201707,334,203,131,189555.1,122747,312302.1
261500,201707,616,412,204,386044,191148,577192
261510,201707,39,28,11,26236,10307,36543
261520,201707,168,155,13,144299,12181,156480
261530,201707,4122,2609,1513,2436814.99,1416449.95,3853264.94
261540,201707,1059,642,417,601357.23,390729,992086.23
261550,201707,283,138,145,127948,135865,263813
261560,201707,760,508,252,473561.1,234709.8,708270.9
261570,201707,358,279,79,261423,74023,335446
261580,201707,372,291,81,271920,75897,347817
261590,201707,186,152,34,142424,31858,174282
261600,201707,277,226,51,211013,47319,258332
261610,201707,99,86,13,80234,12181,92415
261618,201707,64,50,14,46850,13118,59968
261620,201707,211,128,83,119936,77771,197707
261630,201707,587,448,139,417459.8,130056,547515.8
261640,201707,6142,3258,2884,3044393.75,2699507.26,5743901.01
261650,201707,472,294,178,274812.73,166786,441598.73
270010,201707,510,445,65,416965,60156,477121
270020,201707,308,242,66,226000.4,61842,287842.4
270030,201707,8970,5725,3245,5351671.25,3038113.54,8389784.79
270040,201707,1879,1143,736,1070887.94,689350.9,1760238.84
270050,201707,184,135,49,126495,45913,172408
270060,201707,121,66,55,61842,51535,113377
270070,201707,913,651,262,608006.26,244248.16,852254.42
270080,201707,44,37,7,34669,6559,41228
270090,201707,20,16,4,14992,3748,18740
270100,201707,1294,840,454,783225.28,423290.35,1206515.63
270110,201707,168,123,45,115251,42165,157416
270120,201707,219,179,40,166886.72,37198.9,204085.62
270130,201707,266,182,84,170252.9,78426.9,248679.8
270135,201707,100,58,42,54346,39354,93700
270140,201707,1236,729,507,682677.34,472615.26,1155292.60
270150,201707,271,218,53,204266,49661,253927
270160,201707,515,376,139,351425,130243,481668
270170,201707,667,422,245,393821.1,228768.55,622589.65
270180,201707,67,50,17,46537.7,15722.86,62260.56
270190,201707,103,90,13,84330,12181,96511
270200,201707,111,100,11,93512.6,10307,103819.6
270210,201707,494,254,240,237998,224598.9,462596.9
270220,201707,201,160,41,149920,38417,188337
270230,201707,2036,1206,830,1123773.86,774905.2,1898679.06
270235,201707,735,545,190,510356.29,177671.48,688027.77
270240,201707,3056,2347,709,2189497.07,659987.21,2849484.28
270250,201707,176,123,53,114501.4,49661,164162.4
270255,201707,223,196,27,183652,24924.2,208576.2
270260,201707,313,251,62,235000,57812.9,292812.9
270270,201707,119,46,73,43093,68401,111494
270280,201707,214,136,78,127432,73086,200518
270290,201707,1130,843,287,788551.59,268038.89,1056590.48
270300,201707,250,160,90,149920,84048.9,233968.9
270310,201707,950,752,198,702431.18,184823.99,887255.17
270320,201707,895,757,138,707195.8,129306,836501.8
270330,201707,259,211,48,196770,44976,241746
270340,201707,60,47,13,44039,12181,56220
270350,201707,94,49,45,45913,42165,88078
270360,201707,77,42,35,39354,32795,72149
270370,201707,50,36,14,33732,13118,46850
270375,201707,63,35,28,32795,26232,59027
270380,201707,1066,585,481,547208,450697,997905
270390,201707,198,105,93,98385,87141,185526
270400,201707,691,497,194,464495.43,181769,646264.43
270410,201707,715,503,212,471301.63,198634.63,669936.26
270420,201707,388,249,139,231646,130160.89,361806.89
270430,201707,31611,22421,9190,20955672.13,8601172.83,29556844.96
270440,201707,495,385,110,359761.55,102788.9,462550.45
270450,201707,771,389,382,364258.75,356997.73,721256.48
270460,201707,203,147,56,137739,52472,190211
270470,201707,1329,873,456,817652.95,427048,1244700.95
270480,201707,509,407,102,378894.89,94871.25,473766.14
270490,201707,26,20,6,18740,5622,24362
270500,201707,519,416,103,389792,96511,486303
270510,201707,737,453,284,424461,266108,690569
270520,201707,409,248,161,232029.45,150857,382886.45
270530,201707,67,58,9,54346,8433,62779
270540,201707,126,96,30,89952,28110,118062
270550,201707,1715,1291,424,1208132.37,397189.62,1605321.99
270560,201707,324,147,177,137739,165849,303588
270570,201707,428,270,158,252174.73,148046,400220.73
270580,201707,74,52,22,48724,20614,69338
270590,201707,83,69,14,64653,13097.89,77750.89
270600,201707,178,145,33,135865,30921,166786
270610,201707,166,131,35,122738,32795,155533
270620,201707,32,31,1,29047,937,29984
270630,201707,3808,2881,927,2688539.96,866482.38,3555022.34
270640,201707,898,649,249,605508.3,233004.9,838513.2
270642,201707,195,164,31,153668,29047,182715
270644,201707,295,198,97,185338.97,90884.32,276223.29
270650,201707,230,137,93,128369,87141,215510
270660,201707,258,208,50,194896,46850,241746
270670,201707,3159,2379,780,2218302.84,728696.12,2946998.96
270680,201707,454,263,191,246422,178962.32,425384.32
270690,201707,1109,685,424,640143.24,397278.63,1037421.87
270700,201707,37,29,8,27173,7496,34669
270710,201707,854,631,223,589660.86,208951,798611.86
270720,201707,250,187,63,175219,58749.9,233968.9
270730,201707,1801,1033,768,965439.7,717547.6,1682987.3
270740,201707,47,28,19,26236,17803,44039
270750,201707,624,454,170,425398,158635,584033
270760,201707,309,225,84,210825,78708,289533
270770,201707,2666,1644,1022,1532487.84,956677,2489164.84
270780,201707,91,56,35,52467.32,32777.64,85244.96
270790,201707,284,190,94,178030,88078,266108
270800,201707,1958,1543,415,1444967.12,388124.14,1833091.26
270810,201707,320,250,70,234235.95,65581.32,299817.27
270820,201707,157,99,58,92763,54253,147016
270830,201707,1019,731,288,684194,269856,954050
270840,201707,1400,1007,393,943067.2,367305,1310372.2
270850,201707,1749,1056,693,984934.95,649308.58,1634243.53
270860,201707,2440,1568,872,1464388.63,814079.26,2278467.89
270870,201707,123,67,56,62779,52472,115251
270880,201707,912,651,261,607416.93,243671.49,851088.42
270890,201707,379,277,102,259018.63,95569.32,354587.95
270895,201707,71,61,10,57157,9370,66527
270900,201707,113,90,23,84330,21551,105881
270910,201707,336,264,72,246243.6,67464,313707.6
270915,201707,1770,1035,735,964842.45,688212.94,1653055.39
270920,201707,504,416,88,389792,82456,472248
270930,201707,6211,4430,1781,4145475.57,1666977.3,5812452.87
270940,201707,2414,1811,603,1695721.69,563647.93,2259369.62
280010,201707,43,39,4,36543,3748,40291
280020,201707,696,595,101,555610.31,93700,649310.31
280030,201707,18531,11837,6694,11016059.64,6243230.07,17259289.71
280040,201707,349,221,128,207077,118530.5,325607.5
280050,201707,374,286,88,267700.9,82456,350156.9
280060,201707,312,206,106,191640.48,99322,290962.48
280067,201707,976,679,297,632671.43,277071.12,909742.55
280070,201707,125,103,22,96511,20614,117125
280100,201707,600,468,132,434508.88,123497,558005.88
280110,201707,76,69,7,64653,6559,71212
280120,201707,618,492,126,460207.55,118062,578269.55
280130,201707,1284,785,499,733999.9,467422.45,1201422.35
280140,201707,464,368,96,343972.7,89952,433924.7
280150,201707,314,228,86,212968.21,79645,292613.21
280160,201707,98,83,15,77771,14055,91826
280170,201707,570,378,192,352729.68,179107.55,531837.23
280190,201707,29,26,3,24362,2811,27173
280200,201707,18,12,6,11244,5622,16866
280210,201707,2700,1906,794,1768000.54,739156.09,2507156.63
280220,201707,38,30,8,28110,7496,35606
280230,201707,301,247,54,230619.95,49661.1,280281.05
280240,201707,109,103,6,96371,5622,101993
280250,201707,21,12,9,11244,8433,19677
280260,201707,76,68,8,63716,7496,71212
280270,201707,157,119,38,111503,35606,147109
280280,201707,198,124,74,116188,69338,185526
280290,201707,2964,2145,819,1995788.6,766115.63,2761904.23
280300,201707,1060,802,258,749838.93,240996.4,990835.33
280310,201707,105,99,6,92576,5622,98198
280320,201707,642,435,207,407586,193959,601545
280330,201707,360,255,105,238051.23,98263.19,336314.42
280340,201707,396,317,79,295584.05,73274,368858.05
280350,201707,3315,2559,756,2388648.36,706136.46,3094784.82
280360,201707,464,295,169,276415,157416,433831
280370,201707,91,79,12,74023,11244,85267
280380,201707,58,43,15,40291,14055,54346
280390,201707,179,148,31,138676,29047,167723
280400,201707,331,226,105,210919.4,98385,309304.4
280410,201707,286,229,57,213431,53399.63,266830.63
280420,201707,170,142,28,133054,26236,159290
280430,201707,107,80,27,74960,25299,100259
280440,201707,658,501,157,464425.8,146902.86,611328.66
280445,201707,114,105,9,98385,8433,106818
280450,201707,1038,887,151,827698.95,141487,969185.95
280460,201707,710,508,202,469258.26,189274,658532.26
280470,201707,190,172,18,161164,15930,177094
280480,201707,2198,1572,626,1460155.19,582545.65,2042700.84
280490,201707,376,343,33,320247,30921,351168
280500,201707,54,49,5,45913,4685,50598
280510,201707,140,106,34,99024.6,31577,130601.6
280520,201707,55,41,14,38417,13118,51535
280530,201707,73,53,20,49661,18740,68401
280540,201707,492,388,104,363556,97166.9,460722.9
280550,201707,696,642,54,598984.3,50598,649582.3
280560,201707,461,394,67,367022.9,62779,429801.9
280570,201707,1727,1304,423,1218563.42,396351,1614914.42
280580,201707,590,447,143,418700,133898,552598
280590,201707,166,101,65,94362.46,60905,155267.46
280600,201707,341,287,54,267251.54,50598,317849.54
280610,201707,142,104,38,97246,35606,132852
280620,201707,558,448,110,418839,102930,521769
280630,201707,167,138,29,129306,27173,156479
280640,201707,202,157,45,146295,42165,188460
280650,201707,84,54,30,50598,28110,78708
280660,201707,127,92,35,86204,32560.75,118764.75
280670,201707,1521,946,575,879838.97,535097.98,1414936.95
280680,201707,176,149,27,137861.62,25299,163160.62
280690,201707,42,36,6,33732,5622,39354
280700,201707,16,16,0,14992,0,14992
280710,201707,1393,1029,364,956568.29,340412.1,1296980.39
280720,201707,108,73,35,65886.7,32795,98681.7
280730,201707,23,19,4,17803,3748,21551
280740,201707,2315,1688,627,1577840.82,585757.07,2163597.89
280750,201707,290,249,41,233313,38417,271730
280760,201707,857,580,277,542335.6,259408.45,801744.05
290010,201707,182,118,64,110566,59968,170534
290020,201707,177,164,13,153668,12181,165849
290030,201707,581,373,208,348845.1,194896,543741.1
290035,201707,137,110,27,99922.8,25299,125221.8
290040,201707,267,167,100,156479,93700,250179
290050,201707,68,50,18,46850,16866,63716
290060,201707,260,111,149,103725.9,139613,243338.9
290070,201707,5415,2630,2785,2457004.07,2606130.85,5063134.92
290080,201707,521,238,283,222518.76,265153,487671.76
290090,201707,385,166,219,155542,205203,360745
290100,201707,1564,1023,541,953494.05,506354.9,1459848.95
290110,201707,729,430,299,401313.1,280069.3,681382.4
290115,201707,218,199,19,185526,17803,203329
290120,201707,772,507,265,474403.1,248305,722708.1
290130,201707,420,244,176,228337.53,164161,392498.53
290135,201707,291,221,70,206411.73,65590,272001.73
290140,201707,283,234,49,218321,45913,264234
290150,201707,131,95,36,89015,33732,122747
290160,201707,245,193,52,179623.05,48724,228347.05
290170,201707,86,57,29,53409,27173,80582
290180,201707,149,117,32,109629,29984,139613
290190,201707,449,364,85,340787,79364,420151
290195,201707,281,152,129,142424,120873,263297
290200,201707,294,249,45,233313,42165,275478
290205,201707,137,80,57,74960,53409,128369
290210,201707,1086,791,295,740043.6,276415,1016458.6
290220,201707,219,119,100,111034.5,93700,204734.5
290225,201707,270,101,169,94637,158353,252990
290230,201707,65,42,23,39354,21551,60905
290240,201707,308,126,182,117780.9,170534,288314.9
290250,201707,261,234,27,218387,25299,243686
290260,201707,260,220,40,205391,37480,242871
290265,201707,183,148,35,137873,32795,170668
290270,201707,1362,1112,250,1040070,233403,1273473
290280,201707,464,344,120,322328,112440,434768
290290,201707,1158,664,494,618666.61,462878,1081544.61
290300,201707,454,385,69,360225.07,64653,424878.07
290310,201707,317,139,178,130243,166786,297029
290320,201707,3855,2409,1446,2254410.46,1352091.5,3606501.96
290323,201707,179,155,24,144954,22488,167442
290327,201707,140,110,30,102802.96,28110,130912.96
290330,201707,64,34,30,31858,28110,59968
290340,201707,903,357,546,333513.88,510979.79,844493.67
290350,201707,548,327,221,306399,207077,513476
290360,201707,358,267,91,248305.86,85267,333572.86
290370,201707,999,370,629,346409,589373,935782
290380,201707,295,178,117,166786,109629,276415
290390,201707,2438,1513,925,1413824.57,864851,2278675.57
290395,201707,236,130,106,121576,99322,220898
290400,201707,278,205,73,191523,68401,259924
290405,201707,257,219,38,205203,35606,240809
290410,201707,542,461,81,429006.9,75897,504903.9
290420,201707,224,173,51,162101,47787,209888
290430,201707,508,315,193,295155,180841,475996
290440,201707,74,65,9,60905,7808.3,68713.3
290450,201707,230,177,53,165849,49661,215510
290460,201707,1822,1074,748,1005428.52,700689.56,1706118.08
290470,201707,1444,602,842,562662.17,788642.08,1351304.25
290475,201707,582,546,36,511602,33732,545334
290480,201707,283,155,128,145235,119936,265171
290485,201707,208,194,14,181685,13118,194803
290490,201707,1088,779,309,729173.4,288596.6,1017770.0
290500,201707,647,322,325,301464.19,304525,605989.19
290510,201707,212,158,54,147391,50594,197985
290515,201707,126,72,54,67464,50598,118062
290520,201707,1322,842,480,787361.61,445985.7,1233347.31
290530,201707,307,279,28,261423,26236,287659
290540,201707,90,56,34,52472,31858,84330
290550,201707,152,130,22,121810,20267.31,142077.31
290560,201707,3366,1353,2013,1266749.04,1885990.4,3152739.44
290570,201707,5611,2865,2746,2680920.69,2570424.39,5251345.08
290580,201707,1220,692,528,646946.97,494736,1141682.97
290590,201707,528,437,91,408560,85267,493827
290600,201707,1673,1166,507,1088889.08,475059,1563948.08
290610,201707,218,197,21,184140,19677,203817
290620,201707,312,273,39,255801,35980.8,291781.8
290630,201707,2097,886,1211,826435,1129183.47,1955618.47
290640,201707,146,118,28,110566,26236,136802
290650,201707,1645,769,876,719607.42,820812,1540419.42
290660,201707,264,215,49,201455,45913,247368
290670,201707,966,513,453,480400,424120.9,904520.9
290680,201707,1144,926,218,866725,203329,1070054
290682,201707,283,208,75,193927.15,70256.63,264183.78
290685,201707,230,146,84,135865,78708,214573
290687,201707,902,598,304,556999.8,282852.29,839852.09
290689,201707,115,69,46,64639,43087.95,107726.95
290690,201707,675,281,394,263288,368306.03,631594.03
290700,201707,255,120,135,112440,126495,238935
290710,201707,673,437,236,409469,221132,630601
290720,201707,1016,832,184,779584,171939.5,951523.5
290730,201707,1116,635,481,593167.85,449760,1042927.85
290740,201707,16,12,4,11244,3748,14992
290750,201707,1316,593,723,554050.73,675377.06,1229427.79
290755,201707,68,60,8,56220,7496,63716
290760,201707,301,264,37,247368,34669,282037
290770,201707,185,174,11,163028.63,10307,173335.63
290780,201707,930,749,181,699904.23,167816.7,867720.93
290790,201707,434,292,142,273035,133054,406089
290800,201707,2626,1039,1587,970475.07,1485922.71,2456397.78
290810,201707,432,298,134,278945,125558,404503
290820,201707,365,225,140,209874,131180,341054
290830,201707,387,258,129,241746,120873,362619
290840,201707,1617,988,629,924210.4,586393.44,1510603.84
290850,201707,735,406,329,379391.3,307336,686727.3
290860,201707,656,291,365,272667,341724,614391
290870,201707,658,477,181,446312,169597,615909
290880,201707,124,68,56,63716,52472,116188
290890,201707,363,262,101,245494,94637,340131
290900,201707,169,130,39,121810,36543,158353
290910,201707,362,276,86,258612,80582,339194
290920,201707,230,190,40,178030,37480,215510
290930,201707,787,600,187,561422.29,175219,736641.29
290940,201707,252,204,48,190398.4,44976,235374.4
290950,201707,168,94,74,88078,69338,157416
290960,201707,426,283,143,263673.47,133709.9,397383.37
290970,201707,247,217,30,203141.6,28110,231251.6
290980,201707,1452,1023,429,954476.02,400943.1,1355419.12
290990,201707,360,301,59,282028,55227.89,337255.89
291000,201707,846,234,612,219258,573162.9,792420.9
291005,201707,1962,833,1129,778778.28,1057859.32,1836637.60
291010,201707,158,145,13,135865,12181,148046
291020,201707,100,80,20,74960,18740,93700
291030,201707,88,66,22,61842,20614,82456
291040,201707,575,288,287,269846.63,268919,538765.63
291050,201707,1255,708,547,662124.92,512539,1174663.92
291060,201707,1463,790,673,739574.1,630601,1370175.1
291070,201707,1859,1372,487,1279990.5,452676.18,1732666.68
291072,201707,7167,2623,4544,2455005.28,4255183.7,6710188.98
291075,201707,194,157,37,147109,34669,181778
291077,201707,48,33,15,30921,14055,44976
291080,201707,18696,8159,10537,7624615.14,9860391.92,17485007.06
291085,201707,280,226,54,211762,50593.32,262355.32
291090,201707,310,113,197,105600,184579.63,290179.63
291100,201707,729,215,514,201455,481608.63,683063.63
291110,201707,392,300,92,281100,86204,367304
291120,201707,2491,1153,1338,1080221,1251758.08,2331979.08
291125,201707,56,30,26,28110,24362,52472
291130,201707,206,178,28,166786,26236,193022
291140,201707,122,88,34,82456,31577,114033
291150,201707,372,150,222,140550,208014,348564
291160,201707,328,277,51,258612.25,47787,306399.25
291165,201707,14,11,3,10307,2811,13118
291170,201707,2784,1404,1380,1313112.45,1290624,2603736.45
291180,201707,1304,488,816,457118,764538,1221656
291185,201707,68,65,3,60905,2811,63716
291190,201707,1212,507,705,473553.5,660051.9,1133605.4
291200,201707,160,115,45,107755,42165,149920
291210,201707,2153,820,1333,765257.27,1247250.54,2012507.81
291220,201707,246,186,60,173345.43,56220,229565.43
291230,201707,1021,340,681,317737,638097,955834
291240,201707,444,419,25,391385,23425,414810
291250,201707,419,341,78,319517,73086,392603
291260,201707,37,26,11,24362,10307,34669
291270,201707,1185,476,709,446012,663584.9,1109596.9
291280,201707,371,165,206,154417.6,192711.53,347129.13
291290,201707,1723,869,854,813128.6,798887,1612015.6
291300,201707,228,181,47,168941.1,44039,212980.1
291310,201707,248,221,27,206796,25299,232095
291320,201707,1372,982,390,917041.9,364400.8,1281442.7
291330,201707,129,106,23,97541.7,21551,119092.7
291340,201707,138,77,61,72149,57157,129306
291345,201707,123,82,41,76834,38417,115251
291350,201707,1542,481,1061,449947.4,993970.15,1443917.55
291360,201707,8413,4158,4255,3887068.03,3983981.28,7871049.31
291370,201707,1038,558,480,522565,449760,972325
291380,201707,258,207,51,193959,47787,241746
291390,201707,3815,1662,2153,1552868.5,2017361,3570229.5
291400,201707,2031,1449,582,1351718.79,543400.39,1895119.18
291410,201707,155,137,18,127432,16866,144298
291420,201707,99,70,29,65590,27173,92763
291430,201707,185,103,82,95815.74,75897,171712.74
291440,201707,493,397,96,369594.25,89952,459546.25
291450,201707,851,525,326,489771.54,304525,794296.54
291460,201707,1682,1361,321,1272820.8,300777,1573597.8
291465,201707,2229,1035,1194,969406.27,1118551.89,2087958.16
291470,201707,2692,1362,1330,1272475.95,1244929.9,2517405.85
291480,201707,11690,5178,6512,4841233.01,6092516.9,10933749.91
291490,201707,538,216,322,202392,301714,504106
291500,201707,363,191,172,178967,161164,340131
291510,201707,1267,480,787,448620.75,737137.9,1185758.65
291520,201707,954,427,527,400099,493789.63,893888.63
291530,201707,1019,271,748,253927,700576.26,954503.26
291535,201707,114,96,18,89952,16866,106818
291540,201707,357,105,252,98385,235187.8,333572.8
291550,201707,1169,542,627,505981.19,586918.9,1092900.09
291560,201707,5557,2875,2682,2681384.74,2501670.26,5183055.00
291570,201707,194,101,93,94637,87141,181778
291580,201707,1187,712,475,666401,445061.32,1111462.32
291590,201707,73,29,44,26751.35,41228,67979.35
291600,201707,1352,611,741,571570,694018,1265588
291610,201707,1286,562,724,525333.74,678333,1203666.74
291620,201707,551,251,300,235187,280584.65,515771.65
291630,201707,502,162,340,151794,318580,470374
291640,201707,3814,1884,1930,1759232.58,1807316.71,3566549.29
291650,201707,340,220,120,205025.97,112253,317278.97
291660,201707,453,182,271,169854.3,252849.45,422703.75
291670,201707,215,133,82,124059,76834,200893
291680,201707,704,394,310,369178,290377,659555
291685,201707,557,297,260,278055,243432.6,521487.6
291690,201707,553,277,276,259549,257675,517224
291700,201707,888,700,188,655900,175219,831119
291710,201707,1705,770,935,720806.34,875233.93,1596040.27
291720,201707,391,264,127,247363.32,118999,366362.32
291730,201707,910,515,395,481664.85,370105.63,851770.48
291733,201707,250,174,76,162756.9,71212,233968.9
291735,201707,66,52,14,48724,13118,61842
291740,201707,335,251,84,234484.25,78708,313192.25
291750,201707,1921,1270,651,1183541.48,608364.81,1791906.29
291760,201707,3088,1646,1442,1535782.24,1349467.5,2885249.74
291770,201707,776,523,253,487988.03,237061,725049.03
291780,201707,48,27,21,25299,19677,44976
291790,201707,169,77,92,72149,86204,158353
291800,201707,9674,3729,5945,3485068.27,5566996.38,9052064.65
291810,201707,1160,817,343,764681.22,321391,1086072.22
291820,201707,260,189,71,177093,66527,243620
291830,201707,1044,378,666,352987,623096,976083
291835,201707,629,569,60,532685,56220,588905
291840,201707,4531,2304,2227,2154131.62,2085875.18,4240006.80
291845,201707,316,108,208,101196,194886.63,296082.63
291850,201707,319,277,42,259314.75,39354,298668.75
291855,201707,262,105,157,98385,147109,245494
291860,201707,213,129,84,119937,78708,198645
291870,201707,78,31,47,29047,44039,73086
291875,201707,175,158,17,148046,15929,163975
291880,201707,480,376,104,351516,97448,448964
291890,201707,242,81,161,75887.63,149170.5,225058.13
291900,201707,57,31,26,29047,24362,53409
291905,201707,138,89,49,83112,45913,129025
291910,201707,183,145,38,135865,35606,171471
291915,201707,379,336,43,313194,40291,353485
291920,201707,4708,2433,2275,2277360.71,2130030.34,4407391.05
291930,201707,181,103,78,95574.7,73086,168660.7
291940,201707,304,166,138,154577.39,128678.21,283255.60
291950,201707,1092,895,197,836930,184589,1021519
291955,201707,937,551,386,516287,361542,877829
291960,201707,170,115,55,107755,51535,159290
291970,201707,791,598,193,560326,180841,741167
291980,201707,1489,1317,172,1230677.79,160227.7,1390905.49
291990,201707,121,113,8,105881,7496,113377
291992,201707,155,76,79,70462.4,74023,144485.4
291995,201707,144,102,42,95574,39354,134928
292000,201707,373,275,98,256457,91826,348283
292010,201707,281,205,76,191429.1,70275,261704.1
292020,201707,264,192,72,179904,67464,247368
292030,201707,137,106,31,99322,29047,128369
292040,201707,608,303,305,283911,285785,569696
292045,201707,81,73,8,68401,7496,75897
292050,201707,875,585,290,547154.26,271730,818884.26
292060,201707,917,765,152,714932.59,142424,857356.59
292070,201707,50,21,29,19677,27173,46850
292080,201707,112,76,36,71212,33732,104944
292090,201707,476,164,312,153460.49,292344,445804.49
292100,201707,1336,562,774,525048.35,724064.26,1249112.61
292105,201707,202,169,33,158353,30921,189274
292110,201707,2076,760,1316,711801.42,1230820.68,1942622.10
292120,201707,619,499,120,466450.96,112440,578890.96
292130,201707,437,255,182,238935,170534,409469
292140,201707,195,154,41,144298,38287.61,182585.61
292145,201707,151,79,72,74023,67435.9,141458.9
292150,201707,1386,1110,276,1040070,257602.57,1297672.57
292160,201707,180,148,32,138394.9,29984,168378.9
292170,201707,1213,1067,146,998397.23,136745.78,1135143.01
292180,201707,190,138,52,129306,48724,178030
292190,201707,161,98,63,91826,59031,150857
292200,201707,1242,451,791,421652.24,740530.68,1162182.92
292205,201707,113,102,11,95292.9,10307,105599.9
292210,201707,353,242,111,225396,103304.25,328700.25
292220,201707,23,16,7,14992,6559,21551
292225,201707,38,33,5,30921,4685,35606
292230,201707,866,708,158,660660.72,148046,808706.72
292240,201707,605,424,181,396211,169597,565808
292250,201707,1618,1020,598,955740,560326,1516066
292260,201707,436,240,196,224880,182902.4,407782.4
292265,201707,273,188,85,175874.9,79645,255519.9
292270,201707,779,335,444,313239.1,415091.4,728330.5
292273,201707,198,114,84,106054.34,78708,184762.34
292275,201707,157,75,82,70275,76552.9,146827.9
292280,201707,133,92,41,86204,38417,124621
292285,201707,57,48,9,44320.1,8433,52753.1
292290,201707,494,324,170,301143.01,159009,460152.01
292300,201707,1591,606,985,567259.9,921320.99,1488580.89
292303,201707,88,60,28,56220,26236,82456
292305,201707,104,73,31,68401,29047,97448
292310,201707,818,504,314,471893,292068.13,763961.13
292320,201707,638,480,158,449478.9,148046,597524.9
292330,201707,195,96,99,89952,92763,182715
292335,201707,268,202,66,189274,61842,251116
292340,201707,554,380,174,355333.93,163038,518371.93
292350,201707,247,129,118,120076.55,110284.9,230361.45
292360,201707,687,518,169,483679.5,158353,642032.5
292370,201707,779,590,189,552830,177093,729923
292380,201707,643,495,148,462878.51,138676,601554.51
292390,201707,501,185,316,173345,294358.75,467703.75
292400,201707,3295,2020,1275,1873818.48,1191051,3064869.48
292405,201707,254,166,88,155073.5,82174.9,237248.4
292410,201707,155,92,63,86204,59031,145235
292420,201707,300,257,43,240527.9,40291,280818.9
292430,201707,491,392,99,367304,92294.5,459598.5
292440,201707,569,481,88,448823,82456,531279
292450,201707,240,186,54,174282,50598,224880
292460,201707,591,430,161,402347.9,150154.25,552502.15
292465,201707,180,153,27,143361,24574.24,167935.24
292467,201707,93,52,41,48724,38417,87141
292470,201707,248,166,82,155542,76834,232376
292480,201707,298,199,99,185526.75,92763,278289.75
292490,201707,222,143,79,133991,74023,208014
292500,201707,1180,507,673,474852,630432.35,1105284.35
292510,201707,3240,1440,1800,1348343.36,1683640.25,3031983.61
292520,201707,1015,481,534,449521.75,500340,949861.75
292525,201707,376,262,114,245489.32,106818,352307.32
292530,201707,4125,1687,2438,1578005.4,2282224.3,3860229.7
292540,201707,481,254,227,237998,212699,450697
292550,201707,1041,551,490,515529.49,458670.01,974199.50
292560,201707,316,295,21,276415,19677,296092
292570,201707,292,223,69,208628,64653,273281
292575,201707,450,278,172,260205,161164,421369
292580,201707,887,558,329,521440.5,307710.9,829151.4
292590,201707,512,438,74,410077.98,69338,479415.98
292593,201707,140,109,31,102133,29047,131180
292595,201707,166,124,42,116188,39354,155542
292600,201707,1227,914,313,856106,293281,1149387
292610,201707,118,89,29,82924.5,26920.01,109844.51
292620,201707,507,419,88,392313,82456,474769
292630,201707,1330,767,563,717119.5,524252.3,1241371.8
292640,201707,750,521,229,488177,214573,702750
292650,201707,189,164,25,153518,23425,176943
292660,201707,1966,1399,567,1305144.02,526308.96,1831452.98
292665,201707,129,94,35,88078,32795,120873
292670,201707,368,312,56,292340,52472,344812
292680,201707,242,187,55,175219,51535,226754
292690,201707,175,132,43,123684,40291,163975
292700,201707,909,593,316,554704.9,295810.9,850515.8
292710,201707,95,83,12,77771,10963,88734
292720,201707,816,458,358,428358.92,335259,763617.92
292730,201707,211,100,111,92763.75,104007,196770.75
292740,201707,64140,31649,32491,29583012.16,30417223.23,60000235.39
292750,201707,375,265,110,247368.07,102274.01,349642.08
292760,201707,313,246,67,229509.25,62779,292288.25
292770,201707,778,330,448,307546.03,416907.64,724453.67
292780,201707,422,158,264,147822.53,247368,395190.53
292790,201707,723,347,376,325139,352077.75,677216.75
292800,201707,1104,673,431,629664,403847,1033511
292805,201707,423,125,298,116609.65,279226,395835.65
292810,201707,1448,844,604,790265.9,565938.63,1356204.53
292820,201707,745,600,145,560327.3,135574.9,695902.2
292830,201707,105,80,25,74960,23425,98385
292840,201707,634,521,113,487709,105866.95,593575.95
292850,201707,135,88,47,82452,44039,126491
292860,201707,2046,1195,851,1115250.07,797387,1912637.07
292870,201707,3273,2195,1078,2055709.9,1010076.63,3065786.53
292880,201707,1403,921,482,859277.33,451634,1310911.33
292890,201707,450,388,62,363528,58094,421622
292895,201707,135,90,45,82995.71,42165,125160.71
292900,201707,379,282,97,264234,90889,355123
292905,201707,440,221,219,207077,205016,412093
292910,201707,380,295,85,276088,79645,355733
292920,201707,530,235,295,220195,276415,496610
292925,201707,516,478,38,447220.73,35371.75,482592.48
292930,201707,547,336,211,314832,197707,512539
292935,201707,297,125,172,117125,161164,278289
292937,201707,227,151,76,141487,71212,212699
292940,201707,189,143,46,133991,43102,177093
292950,201707,1067,549,518,512072.1,484430,996502.1
292960,201707,522,349,173,327013,162101,489114
292970,201707,283,196,87,182997,81519,264516
292975,201707,160,89,71,83393,66340,149733
292980,201707,257,177,80,164097.42,74960,239057.42
292990,201707,1279,942,337,875169.18,315585.26,1190754.44
293000,201707,103,76,27,71212,25289.63,96501.63
293010,201707,2591,1603,988,1497463.77,921790.4,2419254.17
293015,201707,641,506,135,473841,125868,599709
293020,201707,340,278,62,260486,58094,318580
293030,201707,631,550,81,513851.82,75897,589748.82
293040,201707,337,264,73,247368,68401,315769
293050,201707,2623,1536,1087,1430316.13,1014462.39,2444778.52
293060,201707,249,199,50,186463,45913.4,232376.4
293070,201707,3238,1618,1620,1509293.34,1516750.63,3026043.97
293075,201707,87,56,31,52472,29047,81519
293076,201707,73,45,28,42165,26236,68401
293077,201707,419,253,166,232627.04,155542,388169.04
293080,201707,461,402,59,376674,55283,431957
293090,201707,131,111,20,104007,18427.7,122434.7
293100,201707,494,351,143,328887,133991,462878
293105,201707,331,223,108,208670,101196,309866
293110,201707,167,118,49,110566,45913,156479
293120,201707,315,211,104,197707,97260.6,294967.6
293130,201707,244,161,83,150857,77771,228628
293135,201707,7675,3048,4627,2849279.73,4328482.52,7177762.25
293140,201707,179,116,63,108692,58282,166974
293150,201707,326,282,44,262829.1,41228,304057.1
293160,201707,429,238,191,223006,178685.9,401691.9
293170,201707,176,124,52,115906.9,47881,163787.9
293180,201707,447,301,146,281756,136802,418558
293190,201707,1255,868,387,808751.98,362541,1171292.98
293200,201707,515,454,61,424337,57157,481494
293210,201707,335,247,88,231290,81753.25,313043.25
293220,201707,2703,1079,1624,1009845.45,1519346.55,2529192.00
293230,201707,1769,634,1135,592653.9,1063495,1656148.9
293240,201707,221,202,19,189274,17803,207077
293245,201707,111,92,19,86204,17803,104007
293250,201707,737,273,464,255165.24,434680,689845.24
293260,201707,310,256,54,238342.49,50598,288940.49
293270,201707,1178,558,620,520973.48,580940,1101913.48
293280,201707,230,129,101,120873,94637,215510
293290,201707,3046,1984,1062,1858071.5,994800,2852871.5
293300,201707,668,477,191,445126.79,178170.55,623297.34
293305,201707,161,135,26,126495,24362,150857
293310,201707,138,105,33,98385,30921,129306
293315,201707,148,114,34,106818,31858,138676
293317,201707,94,67,27,62779,25299,88078
293320,201707,921,523,398,489114.25,372922,862036.25
293325,201707,185,68,117,63716,109610.26,173326.26
293330,201707,12465,5773,6692,5398016.79,6263399.34,11661416.13
293340,201707,242,173,69,162101,63716,225817
293345,201707,239,189,50,177093,46850,223943
293350,201707,624,316,308,296092,287143.65,583235.65
293360,201707,1534,1093,441,1022923,411999.35,1434922.35
310010,201707,156,79,77,74023,71587,145610
310020,201707,1036,572,464,532809.65,432613.26,965422.91
310030,201707,326,264,62,245700.94,57812.9,303513.84
310040,201707,50,32,18,29984,16866,46850
310050,201707,177,114,63,105881.2,59031,164912.2
310060,201707,240,166,74,154792.4,69338,224130.4
310070,201707,18,9,9,8433,8433,16866
310080,201707,52,28,24,26236,22488,48724
310090,201707,929,478,451,443015.14,421181.8,864196.94
310100,201707,290,220,70,206140,65590,271730
310110,201707,729,392,337,366268.09,314832,681100.09
310120,201707,378,213,165,198925.1,154237.61,353162.71
310130,201707,34,21,13,19677,12181,31858
310140,201707,30,16,14,14992,13118,28110
310150,201707,1276,882,394,821377.06,368615.9,1189992.96
310160,201707,2122,1078,1044,1004278.55,975510.8,1979789.35
310163,201707,85,47,38,44039,35606,79645
310170,201707,2530,1024,1506,959086,1408343.3,2367429.3
310180,201707,119,45,74,42165,68963.2,111128.2
310190,201707,473,313,160,293281,149357.8,442638.8
310200,201707,506,316,190,296092,177749,473841
310205,201707,54,43,11,40291,10307,50598
310210,201707,289,229,60,214573,56220,270793
310220,201707,53,31,22,29047,20614,49661
310230,201707,261,185,76,173157.6,71212,244369.6
310240,201707,103,91,12,85267,11244,96511
310250,201707,99,81,18,75897,16866,92763
310260,201707,807,426,381,396539.35,356275.51,752814.86
310270,201707,266,176,90,164369,84330,248699
310280,201707,362,270,92,251398.1,86204,337602.1
310285,201707,216,153,63,143058.35,59031,202089.35
310290,201707,252,145,107,135865,100259,236124
310300,201707,151,125,26,117125,24362,141487
310310,201707,5,4,1,3748,937,4685
310320,201707,23,15,8,14055,7496,21551
310330,201707,32,23,9,21551,8433,29984
310340,201707,1654,1044,610,969687.35,570071.25,1539758.60
310350,201707,2781,1503,1278,1403583.85,1195986.9,2599570.75
310360,201707,42,34,8,31858,7496,39354
310370,201707,120,98,22,91826,20333,112159
310375,201707,107,38,69,35606,64635,100241
310380,201707,51,29,22,27173,20614,47787
310390,201707,100,70,30,65590,28110,93700
310400,201707,2232,1431,801,1337184.9,750237.9,2087422.8
310410,201707,123,66,57,61842,53409,115251
310420,201707,658,355,303,331792.1,282965.43,614757.53
310430,201707,328,215,113,201173.9,105881,307054.9
310440,201707,59,36,23,33732,21551,55283
310445,201707,81,66,15,61842,14055,75897
310450,201707,853,531,322,496079.1,301714,797793.1
310460,201707,266,186,80,174282,74960,249242
310470,201707,496,312,184,292344,172408,464752
310480,201707,88,61,27,57157,25299,82456
310490,201707,479,227,252,211762.1,236124,447886.1
310500,201707,123,55,68,51535,63716,115251
310510,201707,613,395,218,368893.8,204247.63,573141.43
310520,201707,132,86,46,80582,43102,123684
310530,201707,85,40,45,37480,41883.9,79363.9
310540,201707,442,280,162,260019.3,151794,411813.3
310550,201707,80,53,27,49661,25299,74960
310560,201707,2845,1975,870,1840223.75,813592.42,2653816.17
310570,201707,158,102,56,95574,52472,148046
310590,201707,333,222,111,207593,103992.95,311585.95
310600,201707,159,94,65,86344.85,60905,147249.85
310610,201707,60,22,38,20614,35606,56220
310620,201707,44536,21313,23223,19897958.76,21725377.7,41623336.46
310630,201707,572,363,209,337883.05,194552.71,532435.76
310640,201707,135,113,22,105693.6,20614,126307.6
310650,201707,157,138,19,128369,17803,146172
310660,201707,91,56,35,52472,32795,85267
310665,201707,48,34,14,31858,13118,44976
310670,201707,6137,2880,3257,2692265.31,3047099.15,5739364.46
310680,201707,51,35,16,32795,14992,47787
310690,201707,569,413,156,382851.73,146172,529023.73
310700,201707,66,42,24,39354,22488,61842
310710,201707,1246,828,418,774604.22,391385,1165989.22
310720,201707,85,29,56,27173,52472,79645
310730,201707,1346,929,417,870192,390729,1260921
310740,201707,999,567,432,529218.2,404540.63,933758.83
310750,201707,246,144,102,133991.29,95574,229565.29
310760,201707,68,52,16,48724,14992,63716
310770,201707,87,45,42,42165,39354,81519
310780,201707,411,334,77,312949,72149,385098
310790,201707,99,80,19,74960,17803,92763
310800,201707,455,218,237,203797.5,221778.53,425576.03
310810,201707,162,114,48,105778.1,44039.83,149817.93
310820,201707,372,292,80,273604,74678.9,348282.9
310825,201707,185,152,33,142424,30921,173345
310830,201707,462,219,243,204554.61,226472.9,431027.51
310840,201707,388,223,165,208951,154605,363556
310850,201707,108,88,20,82456,18740,101196
310855,201707,379,299,80,280163,74960,355123
310860,201707,1357,1019,338,950640.45,315001.95,1265642.40
310870,201707,54,43,11,40291,10307,50598
310880,201707,79,60,19,55938.9,17803,73741.9
310890,201707,310,183,127,171471,118999,290470
310900,201707,638,288,350,266918.75,327650.9,594569.65
310910,201707,242,167,75,155168.1,70275,225443.1
310920,201707,497,294,203,271731.1,189274.7,461005.8
310925,201707,25,19,6,17803,5341,23144
310930,201707,1097,650,447,608650.1,418744.88,1027394.98
310940,201707,665,340,325,317989.9,304525,622514.9
310945,201707,121,74,47,69338,44039,113377
310950,201707,258,202,56,189274,52472,241746
310960,201707,85,30,55,28110,51531,79641
310970,201707,171,104,67,97448,61873.2,159321.2
310980,201707,39,20,19,18740,17803,36543
310990,201707,154,85,69,79364,64653,144017
311000,201707,807,419,388,389793.9,363547,753340.9
311010,201707,40,33,7,30921,6559,37480
311020,201707,39,25,14,23425,13118,36543
311030,201707,395,229,166,212700,155542,368242
311040,201707,37,32,5,29984,4685,34669
311050,201707,462,194,268,181216,250553.8,431769.8
311060,201707,751,441,310,411812.2,290470,702282.2
311070,201707,318,144,174,134928,163038,297966
311080,201707,109,58,51,54346,47787,102133
311090,201707,396,183,213,171052.49,199581,370633.49
311100,201707,608,365,243,342005,227409.9,569414.9
311110,201707,649,445,204,416965,191139,608104
311115,201707,63,46,17,42821,15929,58750
311120,201707,998,523,475,488127.4,444466.05,932593.45
311130,201707,409,238,171,222818.6,160227,383045.6
311140,201707,158,73,85,68401,78848.55,147249.55
311150,201707,350,224,126,209771,117827.75,327598.75
311160,201707,738,533,205,497547.7,191617,689164.7
311170,201707,77,55,22,51535,20332.9,71867.9
311180,201707,339,221,118,206795.9,110285,317080.9
311190,201707,35,20,15,18740,14055,32795
311200,201707,348,238,110,221413.3,103070,324483.3
311205,201707,29,19,10,17568.75,8995.2,26563.95
311210,201707,48,41,7,38417,6559,44976
311220,201707,11,10,1,9370,937,10307
311230,201707,1613,1036,577,967661.65,540649,1508310.65
311240,201707,166,101,65,94637,60905,155542
311250,201707,64,29,35,27173,32795,59968
311260,201707,559,343,216,321391,202392,523783
311265,201707,107,73,34,68401,31858,100259
311270,201707,281,194,87,181778,81519,263297
311280,201707,217,100,117,93700,109066.8,202766.8
311290,201707,110,89,21,83112,19115,102227
311300,201707,549,342,207,319517.88,193678,513195.88
311310,201707,24,20,4,18740,3748,22488
311320,201707,658,488,170,456319,159290,615609
311330,201707,1009,746,263,698674.75,245494.7,944169.45
311340,201707,2570,1829,741,1706477.82,693633.83,2400111.65
311350,201707,268,209,59,195833,55283,251116
311360,201707,172,107,65,100259,60905,161164
311370,201707,1178,464,714,432813.25,668174.7,1100987.95
311380,201707,7,6,1,5622,937,6559
311390,201707,281,150,131,140550,122278.6,262828.6
311400,201707,150,98,52,91826,48715,140541
311410,201707,94,54,40,50598,37480,88078
311420,201707,291,162,129,150201.1,120873,271074.1
311430,201707,851,555,296,518069.1,277352,795421.1
311440,201707,486,341,145,318580.4,135583.9,454164.3
311450,201707,314,193,121,180841,113377,294218
311455,201707,303,205,98,191794.9,91544.9,283339.8
311460,201707,128,53,75,49661,69295.83,118956.83
311470,201707,19,9,10,8433,9370,17803
311480,201707,25,8,17,7496,15929,23425
311490,201707,17,10,7,9370,6559,15929
311500,201707,20,9,11,8433,10307,18740
311510,201707,626,427,199,398927.75,186181.9,585109.65
311520,201707,45,33,12,30265.1,11244,41509.1
311530,201707,1823,1359,464,1265235.21,434768,1700003.21
311535,201707,63,49,14,45913,13118,59031
311540,201707,34,29,5,27173,4685,31858
311545,201707,185,140,45,131180,42165,173345
311547,201707,31,22,9,20614,8433,29047
311550,201707,594,274,320,256738,299821.63,556559.63
311560,201707,41,28,13,26236,12181,38417
311570,201707,306,198,108,184963.8,101196,286159.8
311580,201707,289,164,125,153386.9,117125,270511.9
311590,201707,34,29,5,27173,4685,31858
311600,201707,88,71,17,66527,15929,82456
311610,201707,262,229,33,213323.95,30921,244244.95
311615,201707,87,72,15,66836.21,14055,80891.21
311620,201707,16,11,5,10307,4685,14992
311630,201707,78,65,13,60905,12181,73086
311640,201707,120,68,52,63716,48724,112440
311650,201707,124,91,33,84564.25,30921,115485.25
311660,201707,394,187,207,175219,193959,369178
311670,201707,159,103,56,95959,52472,148431
311680,201707,222,163,59,151072.94,54533.4,205606.34
311690,201707,18,11,7,10307,6559,16866
311700,201707,201,136,65,127150.9,60905,188055.9
311710,201707,219,141,78,132117,73086,205203
311720,201707,34,27,7,25299,6559,31858
311730,201707,524,347,177,324577,165849,490426
311740,201707,31,21,10,19677,9370,29047
311750,201707,700,479,221,446949.4,207077,654026.4
311760,201707,63,36,27,33732,25299,59031
311770,201707,397,186,211,172408.61,197707,370115.61
311780,201707,171,98,73,91545,68089,159634
311783,201707,73,65,8,60905,7496,68401
311787,201707,31,13,18,12181,16866,29047
311790,201707,265,128,137,119936,128369,248305
311800,201707,619,426,193,395837.15,180841,576678.15
311810,201707,41,35,6,32795,5622,38417
311820,201707,105,87,18,81519,16866,98385
311830,201707,1833,1190,643,1110552.95,599212.4,1709765.35
311840,201707,989,543,446,504575.95,416158.66,920734.61
311850,201707,6,3,3,2811,2811,5622
311860,201707,9179,4265,4914,3983058.6,4597085.66,8580144.26
311870,201707,161,88,73,82456,68401,150857
311880,201707,946,703,243,657483.9,227691,885174.9
311890,201707,222,114,108,106818,101196,208014
311900,201707,86,36,50,33732,46850,80582
311910,201707,1360,847,513,790782.05,478479.15,1269261.20
311920,201707,231,150,81,140316,75897,216213
311930,201707,903,524,379,490707,354889,845596
311940,201707,2351,1183,1168,1105614.25,1091652.05,2197266.30
311950,201707,20,14,6,13118,5622,18740
311960,201707,68,48,20,44976,18740,63716
311970,201707,27,16,11,13445.95,10307,23752.95
311980,201707,43,32,11,29984,10307,40291
311990,201707,57,42,15,39354,14055,53409
311995,201707,64,45,19,42165,17803,59968
312000,201707,33,23,10,21269.9,9370,30639.9
312010,201707,86,61,25,57157,23425,80582
312015,201707,90,67,23,62498,21551,84049
312020,201707,145,92,53,86204,49661,135865
312030,201707,37,32,5,29329,4685,34014
312040,201707,79,49,30,45913,28110,74023
312050,201707,225,116,109,108692,102133,210825
312060,201707,71,47,24,44039,21832.1,65871.1
312070,201707,77,44,33,41228,30921,72149
312080,201707,516,216,300,202392,281100,483492
312083,201707,43,32,11,29984,10307,40291
312087,201707,104,81,23,75897,21551,97448
312090,201707,2722,1511,1211,1402318.85,1131263.62,2533582.47
312100,201707,164,115,49,107755,45145,152900
312110,201707,119,79,40,74023,37480,111503
312120,201707,145,105,40,98385,37480,135865
312125,201707,92,49,43,45725.6,40291,86016.6
312130,201707,123,81,42,75897,39354,115251
312140,201707,134,105,29,98385,27173,125558
312150,201707,43,34,9,31858,8433,40291
312160,201707,1508,1005,503,938874.7,469571.52,1408446.22
312170,201707,12,10,2,9370,1874,11244
312180,201707,134,87,47,80582.75,43758,124340.75
312190,201707,32,29,3,27173,2811,29984
312200,201707,706,609,97,568993.35,90889,659882.35
312210,201707,97,62,35,58094,32795,90889
312220,201707,120,87,33,81285,30921,112206
312230,201707,3377,1677,1700,1567068.89,1591319.49,3158388.38
312235,201707,136,90,46,84330,43102,127432
312240,201707,112,73,39,68401,36543,104944
312245,201707,158,106,52,99318,48724,148042
312247,201707,54,38,16,34857,14992,49849
312250,201707,177,85,92,79177,86204,165381
312260,201707,97,67,30,61936.6,28110,90046.6
312270,201707,137,85,52,79645,48724,128369
312280,201707,25,15,10,14055,9370,23425
312290,201707,158,110,48,102788.9,44040,146828.9
312300,201707,194,130,64,121810,59968,181778
312310,201707,57,52,5,48724,4685,53409
312320,201707,421,257,164,238935,152403.25,391338.25
312330,201707,89,78,11,72337,10025.9,82362.9
312340,201707,36,16,20,14992,18740,33732
312350,201707,16,10,6,9370,5622,14992
312352,201707,94,66,28,61842,26236,88078
312360,201707,555,257,298,239872,278570.1,518442.1
312370,201707,286,171,115,159945.9,107755,267700.9
312380,201707,136,87,49,81519,45913,127432
312385,201707,183,147,36,137739,33732,171471
312390,201707,294,188,106,176156,98667,274823
312400,201707,369,276,93,258612,86673,345285
312410,201707,831,270,561,252521.5,525091,777612.5
312420,201707,596,481,115,450697,107755,558452
312430,201707,847,627,220,584924.94,205203.1,790128.04
312440,201707,45,32,13,29984,12181,42165
312450,201707,208,131,77,122747,72149,194896
312460,201707,54,24,30,22488,28110,50598
312470,201707,54,35,19,32795,17803,50598
312480,201707,218,135,83,126495,77489.9,203984.9
312490,201707,247,169,78,158353,73086,231439
312500,201707,31,17,14,15929,13118,29047
312510,201707,418,161,257,150857,240204.36,391061.36
312520,201707,41,15,26,14055,24362,38417
312530,201707,45,35,10,32795,9370,42165
312540,201707,99,87,12,81519,11244,92763
312550,201707,36,28,8,26236,7496,33732
312560,201707,191,138,53,129025,49379.9,178404.9
312570,201707,427,253,174,236686.2,162359.23,399045.43
312580,201707,83,44,39,41228,36543,77771
312590,201707,273,217,56,202253,52472,254725
312595,201707,142,129,13,120873,12181,133054
312600,201707,76,47,29,43618,27173,70791
312610,201707,1605,833,772,775276.29,721303.2,1496579.49
312620,201707,183,128,55,119936,51535,171471
312630,201707,66,54,12,50598,11244,61842
312640,201707,49,15,34,14055,31858,45913
312650,201707,143,116,27,108411,25018,133429
312660,201707,65,49,16,45632,14992,60624
312670,201707,857,562,295,525048.95,276205.15,801254.10
312675,201707,41,31,10,29047,9370,38417
312680,201707,80,54,26,50223.2,24362,74585.2
312690,201707,240,127,113,118989.63,105599.9,224589.53
312695,201707,27,21,6,19677,5622,25299
312700,201707,188,104,84,97448,78708,176156
312705,201707,71,59,12,55283,10962.9,66245.9
312707,201707,89,66,23,61842,21551,83393
312710,201707,1844,980,864,916799,809360,1726159
312720,201707,62,32,30,29984,28110,58094
312730,201707,292,173,119,161164,111221.9,272385.9
312733,201707,48,42,6,39354,5622,44976
312735,201707,21,15,6,14055,5622,19677
312737,201707,75,38,37,35606,34669,70275
312738,201707,50,35,15,32795,14055,46850
312740,201707,69,50,19,46850,17803,64653
312750,201707,74,53,21,49661,19677,69338
312760,201707,273,197,76,184589,71212,255801
312770,201707,7544,3475,4069,3233223.55,3804484.96,7037708.51
312780,201707,439,341,98,319235.9,91826,411061.9
312790,201707,19,15,4,14055,3748,17803
312800,201707,1595,1117,478,1040031.98,446725.11,1486757.09
312810,201707,377,239,138,223943,129306,353249
312820,201707,190,143,47,133991,44039,178030
312825,201707,26,17,9,15929,8433,24362
312830,201707,288,166,122,154606,113687,268293
312840,201707,148,109,39,102133,36543,138676
312850,201707,22,19,3,17803,2811,20614
312860,201707,171,107,64,99978,59968,159946
312870,201707,980,508,472,472978.94,442264,915242.94
312880,201707,149,104,45,97307.45,42071.3,139378.75
312890,201707,162,110,52,103070,48724,151794
312900,201707,213,158,55,147390.1,51535,198925.1
312910,201707,185,93,92,85991.66,86204,172195.66
312920,201707,154,86,68,80582,63716,144298
312930,201707,342,248,94,232376,88078,320454
312940,201707,101,67,34,62779,31858,94637
312950,201707,688,446,242,416590.3,226754,643344.3
312960,201707,176,133,43,124621,40291,164912
312965,201707,44,39,5,36543,4685,41228
312970,201707,280,226,54,210825.1,50598,261423.1
312980,201707,2235,1207,1028,1126548.7,962669.8,2089218.5
312990,201707,48,28,20,26236,18740,44976
313000,201707,39,26,13,24362,12181,36543
313005,201707,162,125,37,116150.75,34388,150538.75
313010,201707,922,379,543,354186.1,508500.9,862687.0
313020,201707,196,101,95,94168.5,89015,183183.5
313030,201707,203,128,75,119000,70275,189275
313040,201707,53,20,33,18740,30921,49661
313050,201707,292,205,87,191148.1,81519,272667.1
313055,201707,41,29,12,27173,11244,38417
313060,201707,121,83,38,77322,35324.9,112646.9
313065,201707,62,39,23,36543,21551,58094
313070,201707,156,83,73,77771,68401,146172
313080,201707,40,17,23,15929,21551,37480
313090,201707,697,477,220,444981.4,206140,651121.4
313100,201707,171,63,108,59031,101188,160219
313110,201707,115,68,47,63716,44039,107755
313115,201707,137,74,63,69141.23,58094,127235.23
313120,201707,733,405,328,379204,305837,685041
313130,201707,4977,2666,2311,2479356.27,2157714.02,4637070.29
313140,201707,162,80,82,74960,76834,151794
313150,201707,319,256,63,239872,58749.9,298621.9
313160,201707,172,121,51,113377,47787,161164
313170,201707,1312,925,387,854218.14,362235.2,1216453.34
313180,201707,329,192,137,179266.84,128369,307635.84
313190,201707,694,404,290,375268.5,270981,646249.5
313200,201707,22,21,1,19677,937,20614
313210,201707,1032,860,172,802870.48,161159.32,964029.80
313220,201707,221,152,69,141487,63950.25,205437.25
313230,201707,274,199,75,185527,70275,255802
313240,201707,1890,1022,868,955264.27,809376.52,1764640.79
313250,201707,1231,902,329,840584.8,305464.4,1146049.2
313260,201707,90,53,37,49661,34669,84330
313270,201707,953,548,405,509914.77,379485,889399.77
313280,201707,60,51,9,47318.51,8433,55751.51
313290,201707,226,178,48,166505,44039.9,210544.9
313300,201707,356,175,181,162101.4,169597,331698.4
313310,201707,209,107,102,100259,95574,195833
313320,201707,365,281,84,261376.55,78708,340084.55
313330,201707,1317,783,534,732734.6,499187.75,1231922.35
313340,201707,334,227,107,212699,100259,312958
313350,201707,525,356,169,331698.05,158353,490051.05
313360,201707,117,64,53,59968,49380,109348
313370,201707,196,78,118,73086,110566,183652
313375,201707,257,154,103,144298,96511,240809
313380,201707,1224,621,603,579084.84,564258,1143342.84
313390,201707,46,38,8,34669.4,7496,42165.4
313400,201707,418,268,150,251116,140269,391385
313410,201707,17,9,8,8433,7496,15929
313420,201707,4640,2383,2257,2224975.19,2107679.81,4332655.00
313430,201707,133,61,72,57157,67464,124621
313440,201707,1450,976,474,913060.75,443576,1356636.75
313450,201707,62,27,35,25299,32795,58094
313460,201707,365,176,189,163494,177093,340587
313470,201707,512,231,281,216447,262641.1,479088.1
313480,201707,157,108,49,100260,45913,146173
313490,201707,504,246,258,230497.32,241297,471794.32
313500,201707,15,10,5,9370,4685,14055
313505,201707,923,719,204,672766,191148,863914
313507,201707,90,52,38,48724,35606,84330
313510,201707,2731,1759,972,1643781.9,909827,2553608.9
313520,201707,3562,2776,786,2588941.19,736478,3325419.19
313530,201707,39,28,11,26236,10307,36543
313535,201707,96,79,17,73368,15929,89297
313540,201707,68,53,15,49661,14055,63716
313545,201707,97,79,18,74023,16866,90889
313550,201707,239,193,46,180841,42540,223381
313560,201707,329,169,160,158353,149920,308273
313570,201707,56,30,26,28110,24362,52472
313580,201707,1268,675,593,630882.1,553954.8,1184836.9
313590,201707,84,48,36,44976,33732,78708
313600,201707,695,410,285,384170,266202,650372
313610,201707,55,44,11,40337.9,10307,50644.9
313620,201707,1293,689,604,635597.16,562537.5,1198134.66
313630,201707,1620,1247,373,1166940.4,349220,1516160.4
313640,201707,126,71,55,66527,51535,118062
313650,201707,226,105,121,98385,113377,211762
313652,201707,11,10,1,9370,937,10307
313655,201707,50,31,19,29047,17803,46850
313657,201707,42,39,3,36543,2811,39354
313660,201707,123,89,34,83393,31858,115251
313665,201707,613,307,306,287659,286487.75,574146.75
313670,201707,9857,6851,3006,6397278.73,2816060,9213338.73
313680,201707,39,29,10,27173,9370,36543
313690,201707,157,121,36,113377,33732,147109
313695,201707,60,45,15,42165,14055,56220
313700,201707,284,226,58,211481,54346,265827
313710,201707,155,108,47,101196,44039,145235
313720,201707,990,467,523,436079.9,488449.83,924529.73
313730,201707,55,40,15,37480,14055,51535
313740,201707,159,126,33,117874.6,30921,148795.6
313750,201707,450,328,122,307054.9,114314,421368.9
313753,201707,243,169,74,157697.1,69338,227035.1
313760,201707,1158,413,745,386981,695377.56,1082358.56
313770,201707,344,245,99,229565,92763,322328
313780,201707,747,388,359,363556,336101.9,699657.9
313790,201707,26,25,1,23425,937,24362
313800,201707,134,83,51,77771,47787,125558
313810,201707,54,35,19,32795,17803,50598
313820,201707,1264,624,640,583470.1,598439,1181909.1
313830,201707,68,51,17,47787,15929,63716
313835,201707,50,46,4,43102,3748,46850
313840,201707,1595,977,618,911141.2,577848,1488989.2
313850,201707,177,61,116,57157,108122.39,165279.39
313860,201707,493,383,110,355780.7,102133.55,457914.25
313862,201707,176,116,60,108692,56220,164912
313865,201707,81,63,18,59031,16866,75897
313867,201707,51,39,12,36543,11244,47787
313868,201707,21,13,8,12181,7496,19677
313870,201707,123,64,59,59968,55283,115251
313880,201707,328,209,119,195551.9,110940.9,306492.8
313890,201707,320,173,147,161351.9,137176.8,298528.7
313900,201707,911,499,412,465971.25,385717,851688.25
313910,201707,133,95,38,88828,34669.1,123497.1
313920,201707,588,420,168,393352.6,157416,550768.6
313925,201707,28,23,5,21551,4685,26236
313930,201707,780,598,182,560326,170511,730837
313940,201707,1731,1082,649,1009430.2,607550.9,1616981.1
313950,201707,938,597,341,557609.8,319001.9,876611.7
313960,201707,1342,771,571,718219.65,533809,1252028.65
313970,201707,114,84,30,78708,28110,106818
313980,201707,202,131,71,122513,66527,189040
313990,201707,347,209,138,195551.9,129306,324857.9
314000,201707,895,609,286,568151.35,267696.32,835847.67
314010,201707,74,46,28,43102,26236,69338
314015,201707,61,20,41,18740,38417,57157
314020,201707,52,35,17,32795,15835.3,48630.3
314030,201707,102,51,51,47787,47787,95574
314040,201707,41,30,11,28110,10307,38417
314050,201707,307,179,128,167442,118624.2,286066.2
314053,201707,98,64,34,58757.03,31858,90615.03
314055,201707,285,165,120,154605,112440,267045
314060,201707,143,121,22,112440,20614,133054
314070,201707,918,475,443,441056.77,414472.63,855529.40
314080,201707,212,140,72,130946,66434.14,197380.14
314085,201707,106,72,34,67464,31858,99322
314090,201707,345,245,100,229565,93695.32,323260.32
314100,201707,461,377,84,349377,78146,427523
314110,201707,686,370,316,344825.37,295389.8,640215.17
314120,201707,104,57,47,53409,44039,97448
314130,201707,22,12,10,11244,9370,20614
314140,201707,1086,642,444,599942.46,414154.23,1014096.69
314150,201707,166,103,63,96511,59031,155542
314160,201707,356,262,94,242403.2,87891,330294.2
314170,201707,65,47,18,44039,16866,60905
314180,201707,729,635,94,594714,87141.25,681855.25
314190,201707,102,61,41,57157,38417,95574
314200,201707,587,401,186,374519.7,173345,547864.7
314210,201707,272,203,69,189929.9,64372,254301.9
314220,201707,317,236,81,219259,75616,294875
314225,201707,64,45,19,42165,17803,59968
314230,201707,101,46,55,43102,51535,94637
314240,201707,134,101,33,94637,30921,125558
314250,201707,59,35,24,32795,22488,55283
314260,201707,187,96,91,89952,85267,175219
314270,201707,328,254,74,237249,69057,306306
314280,201707,673,373,300,349210.9,280194.23,629405.13
314290,201707,550,437,113,408251.25,105599.9,513851.15
314300,201707,411,291,120,269783.5,112394,382177.5
314310,201707,1409,935,474,875159,443837.33,1318996.33
314315,201707,34,27,7,25299,6559,31858
314320,201707,602,379,223,354560.9,208323.21,562884.11
314330,201707,10609,5333,5276,4984998.12,4937713.9,9922712.02
314340,201707,576,272,304,254301.9,284286,538587.9
314345,201707,25,18,7,16866,6559,23425
314350,201707,184,109,75,102133,70275,172408
314360,201707,72,41,31,38417,29047,67464
314370,201707,59,50,9,46850,8433,55283
314380,201707,91,65,26,60905,24362,85267
314390,201707,3104,1964,1140,1835622.25,1065275.7,2900897.95
314400,201707,668,486,182,452563.1,170534,623097.1
314410,201707,414,272,142,254864,133054,387918
314420,201707,19,8,11,7496,10307,17803
314430,201707,2475,884,1591,824624.15,1488853.91,2313478.06
314435,201707,272,155,117,144953.9,108692,253645.9
314437,201707,24,19,5,17803,4685,22488
314440,201707,97,68,29,63716,27173,90889
314450,201707,153,116,37,108692,34669,143361
314460,201707,648,297,351,278289,328887,607176
314465,201707,77,53,24,49661,22488,72149
314467,201707,64,54,10,50589,9370,59959
314470,201707,338,171,167,156837.06,155542.75,312379.81
314480,201707,1006,487,519,455382,486115.6,941497.6
314490,201707,89,65,24,60905,22488,83393
314500,201707,300,193,107,180841,100259,281100
314505,201707,126,86,40,80582,37480,118062
314510,201707,225,178,47,166786,44039,210825
314520,201707,1198,615,583,569013.95,544350.45,1113364.40
314530,201707,664,528,136,493932,127432,621364
314535,201707,194,120,74,112158.9,69091.48,181250.38
314537,201707,61,36,25,33732,23425,57157
314540,201707,10,6,4,5622,3748,9370
314545,201707,48,34,14,31858,13118,44976
314550,201707,78,42,36,39354,33732,73086
314560,201707,803,431,372,401692,348564,750256
314570,201707,21,16,5,14992,4685,19677
314580,201707,19,9,10,8433,9370,17803
314585,201707,19,13,6,12181,5622,17803
314587,201707,80,69,11,64653,10307,74960
314590,201707,530,394,136,369178,127432,496610
314600,201707,977,624,353,581195.39,327791.8,908987.19
314610,201707,913,501,412,467235.4,384920.15,852155.55
314620,201707,144,105,39,97448,36543,133991
314625,201707,93,71,22,65684,20614,86298
314630,201707,1251,637,614,595135.65,575036.9,1170172.55
314640,201707,92,61,31,57157,29047,86204
314650,201707,204,117,87,109347.9,81050.5,190398.4
314655,201707,65,50,15,46850,14055,60905
314660,201707,18,14,4,13118,3748,16866
314670,201707,177,144,33,134647,30921,165568
314675,201707,213,118,95,110566,89015,199581
314690,201707,531,293,238,274259.9,223006,497265.9
314700,201707,2419,1302,1117,1214915.6,1045756.95,2260672.55
314710,201707,1618,940,678,876565.15,634547.47,1511112.62
314720,201707,406,242,164,225349,153668,379017
314730,201707,499,266,233,247837,217843.5,465680.5
314740,201707,672,325,347,303166.35,325139,628305.35
314750,201707,22,19,3,17803,2811,20614
314760,201707,304,149,155,139613,145225.63,284838.63
314770,201707,120,83,37,77771,34669,112440
314780,201707,21,6,15,5622,14055,19677
314790,201707,2309,1443,866,1345159.75,810495.73,2155655.48
314795,201707,45,38,7,35372,6559,41931
314800,201707,2821,1637,1184,1528020.56,1108743.1,2636763.66
314810,201707,1459,814,645,760423.25,602772.5,1363195.75
314820,201707,86,48,38,44976,35606,80582
314830,201707,207,160,47,149217.75,43758,192975.75
314840,201707,81,47,34,44039,31858,75897
314850,201707,341,165,176,154605,164912,319517
314860,201707,704,526,178,490894.79,165287.35,656182.14
314870,201707,1410,714,696,668081.5,652152,1320233.5
314875,201707,54,46,8,43102,7496,50598
314880,201707,45,32,13,29984,12181,42165
314890,201707,49,30,19,28110,17803,45913
314900,201707,26,22,4,20614,3748,24362
314910,201707,259,171,88,159945.9,82456,242401.9
314915,201707,148,131,17,122513,15929,138442
314920,201707,127,77,50,72149,46569,118718
314930,201707,997,507,490,473234,458848.9,932082.9
314940,201707,54,42,12,39354,11244,50598
314950,201707,36,28,8,25533.25,7496,33029.25
314960,201707,58,42,16,39354,14992,54346
314970,201707,132,66,66,61280,61842,123122
314980,201707,304,194,110,178736.42,102133,280869.42
314990,201707,466,251,215,234250.25,200565.75,434816.00
314995,201707,174,63,111,59031,103997.63,163028.63
315000,201707,82,66,16,60905.6,14992,75897.6
315010,201707,46,30,16,28110,14992,43102
315015,201707,172,140,32,130467.88,29984,160451.88
315020,201707,53,44,9,41228,8433,49661
315030,201707,123,93,30,86205,28110,114315
315040,201707,65,48,17,44976,15929,60905
315050,201707,195,116,79,108692,74023,182715
315053,201707,36,31,5,29047,4685,33732
315057,201707,99,83,16,77396.2,14992,92388.2
315060,201707,70,63,7,57157.98,6559,63716.98
315070,201707,102,58,44,54346,41228,95574
315080,201707,360,295,65,276415,60905,337320
315090,201707,109,67,42,62779,39354,102133
315100,201707,75,40,35,37480,32795,70275
315110,201707,293,162,131,150950.7,122747,273697.7
315120,201707,1603,799,804,744775.1,752177,1496952.1
315130,201707,313,227,86,212699,80582,293281
315140,201707,526,306,220,284192.18,206140,490332.18
315150,201707,974,450,524,420714,490707,911421
315160,201707,198,101,97,94637,90889,185526
315170,201707,341,220,121,204267.1,113095.9,317363.0
315180,201707,3178,1351,1827,1262748.95,1709042,2971790.95
315190,201707,313,182,131,170160,122747,292907
315200,201707,1175,661,514,616640.53,480399.9,1097040.43
315210,201707,1498,842,656,783427.45,612798.8,1396226.25
315213,201707,36,23,13,21551,12181,33732
315217,201707,190,149,41,139613,38417,178030
315220,201707,1461,1115,346,1044380.3,324108.3,1368488.6
315230,201707,167,124,43,115907,40291,156198
315240,201707,429,278,151,260486,141243.63,401729.63
315250,201707,2500,1240,1260,1160568.3,1179581.47,2340149.77
315260,201707,148,90,58,83018.2,54346,137364.2
315270,201707,126,84,42,77583.6,38641.88,116225.48
315280,201707,698,457,241,427835,225807.63,653642.63
315290,201707,194,114,80,106818,74023.34,180841.34
315300,201707,75,47,28,44039,26236,70275
315310,201707,65,57,8,53409,7496,60905
315320,201707,156,84,72,78708,67464,146172
315330,201707,54,46,8,43102,7496,50598
315340,201707,416,296,120,276190.9,112440,388630.9
315350,201707,139,85,54,79645,50598,130243
315360,201707,93,49,44,45913,41228,87141
315370,201707,56,30,26,28110,24080.9,52190.9
315380,201707,11,6,5,5622,4685,10307
315390,201707,48,13,35,12181,32795,44976
315400,201707,802,597,205,553767.8,191429.1,745196.9
315410,201707,337,201,136,188056,127432,315488
315415,201707,63,48,15,44976,14055,59031
315420,201707,197,146,51,135725.5,47787,183512.5
315430,201707,679,407,272,380873,254114.9,634987.9
315440,201707,79,57,22,53409,20614,74023
315445,201707,249,199,50,186153.79,46850,233003.79
315450,201707,194,148,46,138676,43102,181778
315460,201707,3270,1670,1600,1560473.9,1495304.05,3055777.95
315470,201707,44,22,22,20333,20614,40947
315480,201707,62,23,39,21551,36543,58094
315490,201707,606,375,231,349641.55,216447,566088.55
315500,201707,24,13,11,12181,10307,22488
315510,201707,155,97,58,90889,54346,145235
315520,201707,66,59,7,55283,6559,61842
315530,201707,51,28,23,26236,21551,47787
315540,201707,239,154,85,144298,79645,223943
315550,201707,176,135,41,126495,38417,164912
315560,201707,738,585,153,547582.9,143361,690943.9
315570,201707,306,164,142,150811.25,133054,283865.25
315580,201707,627,411,216,385107,202392,587499
315590,201707,213,114,99,106818,92763,199581
315600,201707,283,204,79,191148,73836,264984
315610,201707,96,48,48,44976,44976,89952
315620,201707,31,24,7,22488,6559,29047
315630,201707,134,88,46,82456,43102,125558
315640,201707,50,31,19,29047,17803,46850
315645,201707,65,45,20,42165,18272,60437
315650,201707,164,119,45,111222,42165,153387
315660,201707,479,193,286,180841,267982,448823
315670,201707,2220,1142,1078,1067384.75,1008935.1,2076319.85
315680,201707,858,575,283,535272.81,264458.88,799731.69
315690,201707,703,479,224,447768.63,209888,657656.63
315700,201707,1878,1004,874,937937.51,818938,1756875.51
315710,201707,300,73,227,68401,212699,281100
315720,201707,417,269,148,252053,138676,390729
315725,201707,197,159,38,148983,35606,184589
315727,201707,39,22,17,20614,15929,36543
315730,201707,42,39,3,36543,2811,39354
315733,201707,85,53,32,49661,29984,79645
315737,201707,51,37,14,34669,13118,47787
315740,201707,42,37,5,34669,4685,39354
315750,201707,158,126,32,118062,29984,148046
315760,201707,43,28,15,26236,14055,40291
315765,201707,108,71,37,66527,34669,101196
315770,201707,230,135,95,126495,88734,215229
315780,201707,3225,1692,1533,1578518.75,1434079.41,3012598.16
315790,201707,200,155,45,145235,42165,187400
315800,201707,277,203,74,189930,69338,259268
315810,201707,89,51,38,47787,35325,83112
315820,201707,799,577,222,538401.77,208014,746415.77
315830,201707,140,81,59,75897,55283,131180
315840,201707,82,54,28,50598,26236,76834
315850,201707,261,192,69,179904,64653,244557
315860,201707,11,3,8,2811,7496,10307
315870,201707,34,28,6,26236,5622,31858
315880,201707,106,67,39,62779,36543,99322
315890,201707,70,51,19,47787,17803,65590
315895,201707,358,241,117,224506,109067,333573
315900,201707,65,34,31,31858,29047,60905
315910,201707,37,24,13,22160.05,12181,34341.05
315920,201707,182,121,61,113377,56220.95,169597.95
315930,201707,35,13,22,12181,20614,32795
315935,201707,145,113,32,105881,29975,135856
315940,201707,84,64,20,59968,18740,78708
315950,201707,63,43,20,40291,18740,59031
315960,201707,582,270,312,252633.94,291781.9,544415.84
315970,201707,40,31,9,29047,8433,37480
315980,201707,685,309,376,288040.1,352302.63,640342.73
315990,201707,244,145,99,135865,92482,228347
316000,201707,49,32,17,29984,15929,45913
316010,201707,71,62,9,58094,8433,66527
316020,201707,102,84,18,78708,16866,95574
316030,201707,404,205,199,192085,185948,378033
316040,201707,473,211,262,197405.89,245213,442618.89
316045,201707,61,55,6,51535,5622,57157
316050,201707,16,14,2,13118,1874,14992
316060,201707,96,63,33,58749.9,30921,89670.9
316070,201707,1017,652,365,604650.25,341256,945906.25
316080,201707,104,63,41,59031,38417,97448
316090,201707,47,27,20,24362.1,18740,43102.1
316095,201707,62,51,11,47516,10307,57823
316100,201707,300,174,126,162475.9,118062,280537.9
316105,201707,33,23,10,21551,9370,30921
316110,201707,1904,1524,380,1418946.27,354373.4,1773319.67
316120,201707,79,57,22,53409,20332.9,73741.9
316130,201707,138,106,32,98667,29984,128651
316140,201707,26,20,6,18740,5622,24362
316150,201707,197,140,57,130477.25,53409,183886.25
316160,201707,87,53,34,49661,31858,81519
316165,201707,59,45,14,41978,12415.25,54393.25
316170,201707,208,140,68,130243,63716,193959
316180,201707,192,89,103,83065.05,96511,179576.05
316190,201707,131,93,38,86204,35606,121810
316200,201707,699,398,301,372926,281850,654776
316210,201707,739,490,249,458790.43,233313,692103.43
316220,201707,116,76,40,71212,37480,108692
316225,201707,18,10,8,9370,7496,16866
316230,201707,33,19,14,17803,13118,30921
316240,201707,605,490,115,458193.1,107755,565948.1
316245,201707,98,81,17,75897,15929,91826
316250,201707,1467,1031,436,957271.8,408307.12,1365578.92
316255,201707,110,89,21,83018.2,19677,102695.2
316257,201707,175,95,80,89015,74960,163975
316260,201707,237,154,83,143023.93,77678,220701.93
316265,201707,24,15,9,14055,8433,22488
316270,201707,674,470,204,437391.8,191148,628539.8
316280,201707,542,335,207,311990.5,193303.3,505293.8
316290,201707,656,432,224,401973.69,209888,611861.69
316292,201707,480,188,292,176156,273369.75,449525.75
316294,201707,103,62,41,58094,38417,96511
316295,201707,265,118,147,109144.5,137739,246883.5
316300,201707,101,70,31,65590,29047,94637
316310,201707,32,17,15,15929,14055,29984
316320,201707,48,28,20,26236,18740,44976
316330,201707,126,79,47,73086.25,43757.9,116844.15
316340,201707,136,97,39,90889,36543,127432
316350,201707,189,133,56,124294,52472,176766
316360,201707,23,18,5,16866,4685,21551
316370,201707,1035,559,476,520054.75,446002.63,966057.38
316380,201707,119,91,28,85267,26236,111503
316390,201707,119,85,34,79645,31858,111503
316400,201707,134,103,31,96511,29047,125558
316410,201707,304,223,81,207592.35,75897,283489.35
316420,201707,181,130,51,121107.25,47787,168894.25
316430,201707,152,75,77,70275,72149,142424
316440,201707,101,48,53,44976,49661,94637
316443,201707,36,34,2,31858,1874,33732
316447,201707,61,49,12,45913,11244,57157
316450,201707,210,162,48,151794,44976,196770
316460,201707,65,29,36,27173,33732,60905
316470,201707,1545,1114,431,1038208.61,402065.77,1440274.38
316480,201707,10,9,1,8433,937,9370
316490,201707,16,5,11,4685,10307,14992
316500,201707,155,104,51,97166.9,47787,144953.9
316510,201707,172,127,45,118015.15,42165,160180.15
316520,201707,189,117,72,109066.8,67464,176530.8
316530,201707,146,105,41,98385,38136,136521
316540,201707,136,74,62,68401,58094,126495
316550,201707,144,99,45,92763,42165,134928
316553,201707,210,106,104,99103.5,97448,196551.5
316555,201707,26,16,10,14992,9370,24362
316556,201707,11,7,4,6559,3748,10307
316557,201707,16,14,2,13118,1874,14992
316560,201707,55,44,11,41228,10307,51535
316570,201707,251,227,24,212465,22488,234953
316580,201707,22,15,7,14055,6559,20614
316590,201707,118,102,16,95574,14992,110566
316600,201707,185,148,37,138395,34669,173064
316610,201707,68,45,23,41883.9,21551,63434.9
316620,201707,125,96,29,89952,27173,117125
316630,201707,37,27,10,25299,9370,34669
316640,201707,16,10,6,9370,5622,14992
316650,201707,61,48,13,44976,12181,57157
316660,201707,5,3,2,2811,1874,4685
316670,201707,439,151,288,141469,269294,410763
316680,201707,160,110,50,103070,46663,149733
316690,201707,194,122,72,114314,67464,181778
316695,201707,56,50,6,46850,5622,52472
316700,201707,13,7,6,6559,5622,12181
316710,201707,713,519,194,485225.7,181778,667003.7
316720,201707,4767,2419,2348,2251631.7,2195828.24,4447459.94
316730,201707,15,14,1,13118,937,14055
316740,201707,135,82,53,76834,49661,126495
316750,201707,20,14,6,13118,5622,18740
316760,201707,330,266,64,249242,59968,309210
316770,201707,140,80,60,74960,56220,131180
316780,201707,67,38,29,35306.16,27173,62479.16
316790,201707,57,43,14,40291,13118,53409
316800,201707,1784,1106,678,1032949,633600.1,1666549.1
316805,201707,18,9,9,8433,8433,16866
316810,201707,63,40,23,37480,21270,58750
316820,201707,38,20,18,18740,16866,35606
316830,201707,94,41,53,38417,49380,87797
316840,201707,498,298,200,278476.5,185526,464002.5
316850,201707,343,224,119,208529.35,111503,320032.35
316860,201707,5917,2601,3316,2424450.75,3103007.63,5527458.38
316870,201707,1379,893,486,827608.85,450887,1278495.85
316880,201707,101,59,42,54627.9,39354,93981.9
316890,201707,249,165,84,154605,78708,233313
316900,201707,416,283,133,262670.84,124621,387291.84
316905,201707,16,11,5,10307,4685,14992
316910,201707,52,27,25,25299,23425,48724
316920,201707,132,105,27,97683,25299,122982
316930,201707,1898,950,948,884483.15,886121.85,1770605.00
316935,201707,856,513,343,478807.66,319891.8,798699.46
316940,201707,1072,616,456,575974.6,426700.53,1002675.13
316950,201707,186,96,90,89952,84330,174282
316960,201707,1096,606,490,566229.9,458830.26,1025060.16
316970,201707,636,497,139,465689,130243,595932
316980,201707,116,70,46,65590,43092.63,108682.63
316990,201707,2152,1408,744,1312691.33,695479.88,2008171.21
317000,201707,319,248,71,232095,66527,298622
317005,201707,241,170,71,159290,66527,225817
317010,201707,6130,3351,2779,3120895.51,2602039.83,5722935.34
317020,201707,15832,6972,8860,6503279.96,8286096.84,14789376.80
317030,201707,83,30,53,28110,49167.02,77277.02
317040,201707,3090,1904,1186,1781912.64,1109221.6,2891134.24
317043,201707,68,46,22,43102,20614,63716
317047,201707,33,15,18,14055,16862,30917
317050,201707,187,140,47,131180,44039,175219
317052,201707,116,93,23,87141,21551,108692
317057,201707,198,151,47,141487,43477,184964
317060,201707,55,34,21,31858,19395.9,51253.9
317065,201707,58,48,10,44976,9370,54346
317070,201707,1948,920,1028,856418.85,961174.9,1817593.75
317075,201707,110,57,53,53409,49661,103070
317080,201707,800,427,373,399021.45,349314,748335.45
317090,201707,608,486,122,454960.35,114314,569274.35
317100,201707,403,302,101,281100.6,94637,375737.6
317103,201707,98,83,15,77771,14055,91826
317107,201707,37,33,4,30921,3748,34669
317110,201707,93,44,49,41228,45913,87141
317115,201707,40,34,6,31858,5622,37480
317120,201707,1741,875,866,812132.35,810993,1623125.35
317130,201707,1840,1166,674,1089645.2,630883,1720528.2
317140,201707,5,4,1,3748,937,4685
317150,201707,264,159,105,148983,97635.4,246618.4
317160,201707,310,224,86,209014,80582,289596
317170,201707,201,145,56,135865,52472,188337
317180,201707,412,300,112,280397.25,104944,385341.25
317190,201707,251,168,83,157416,77208.8,234624.8
317200,201707,777,556,221,507210,206843,714053
317210,201707,154,87,67,80582.6,62779,143361.6
317220,201707,21,12,9,11244,8433,19677
320010,201707,603,447,156,415560.25,146172,561732.25
320013,201707,129,91,38,85267,35606,120873
320016,201707,279,172,107,161164,100259,261423
320020,201707,698,418,280,388120.37,259765.97,647886.34
320030,201707,148,108,40,101196,37152.05,138348.05
320035,201707,133,97,36,90889,33732,124621
320040,201707,489,260,229,242495.8,214573,457068.8
320050,201707,99,77,22,72149,20614,92763
320060,201707,1457,651,806,609941,754557.3,1364498.3
320070,201707,101,71,30,66527,28110,94637
320080,201707,749,431,318,400784.5,297966,698750.5
320090,201707,1183,826,357,770385.98,333665.8,1104051.78
320100,201707,308,176,132,164912,123684,288596
320110,201707,134,87,47,79833.1,44039,123872.1
320115,201707,107,87,20,81519,18740,100259
320120,201707,3213,1797,1416,1673016.35,1325465.96,2998482.31
320130,201707,7088,3408,3680,3172404.2,3439456.93,6611861.13
320140,201707,417,268,149,249804.6,139373,389177.6
320150,201707,1810,1066,744,993071.3,697118.63,1690189.93
320160,201707,686,300,386,279873.22,360349.36,640222.58
320170,201707,114,88,26,81707,24362,106069
320180,201707,46,27,19,25299,17803,43102
320190,201707,236,163,73,151972.03,68120,220092.03
320200,201707,52,38,14,35606,13118,48724
320210,201707,838,475,363,443576.8,338920,782496.8
320220,201707,300,114,186,105881.86,174001,279882.86
320225,201707,72,59,13,55283,12181,67464
320230,201707,517,335,182,312583.2,169738,482321.2
320240,201707,3054,1541,1513,1441762.9,1415799.1,2857562.0
320245,201707,426,300,126,279975.7,118062,398037.7
320250,201707,207,110,97,100916,90889,191805
320255,201707,142,113,29,104597.31,27033,131630.31
320260,201707,170,123,47,115251,43992.15,159243.15
320265,201707,157,126,31,117266,29047,146313
320270,201707,152,122,30,114314,28110,142424
320280,201707,902,547,355,506918.1,331257.81,838175.91
320290,201707,65,56,9,52472,8433,60905
320300,201707,519,371,148,346194.65,137431.55,483626.20
320305,201707,625,333,292,312021,273417,585438
320310,201707,207,118,89,110285,82651,192936
320313,201707,280,143,137,133991,128088,262079
320316,201707,108,90,18,84330,16866,101196
320320,201707,3266,1471,1795,1373446.8,1677200.4,3050647.2
320330,201707,259,188,71,175506.9,64653.81,240160.71
320332,201707,857,519,338,484011.9,315555.15,799567.05
320334,201707,237,145,92,135584,86204,221788
320335,201707,146,108,38,100024.95,35606,135630.95
320340,201707,578,397,181,370865,168942,539807
320350,201707,942,403,539,374894.14,504507.44,879401.58
320360,201707,162,87,75,81238,69963,151201
320370,201707,238,180,58,167104,53331,220435
320380,201707,286,195,91,181310.4,85267,266577.4
320390,201707,1095,675,420,631876,391434.56,1023310.56
320400,201707,325,229,96,212699.6,89952,302651.6
320405,201707,839,345,494,323080.56,462471.15,785551.71
320410,201707,940,483,457,450912.7,427844.34,878757.04
320420,201707,473,243,230,227223.2,215510,442733.2
320425,201707,188,106,82,99322,76834,176156
320430,201707,384,217,167,202485.95,156479,358964.95
320435,201707,164,109,55,101327.18,51535,152862.18
320440,201707,192,120,72,112158.9,67464,179622.9
320450,201707,125,73,52,68401,48724,117125
320455,201707,238,190,48,177094,44958,222052
320460,201707,240,152,88,142424,82456,224880
320465,201707,115,79,36,73666.94,33732,107398.94
320470,201707,621,396,225,370753.54,210817,581570.54
320480,201707,160,104,56,97448,52472,149920
320490,201707,2924,1444,1480,1348230.32,1383896.98,2732127.30
320495,201707,91,57,34,53391,31858,85249
320500,201707,9190,4695,4495,4370251.87,4201876.76,8572128.63
320501,201707,512,257,255,240809,238935,479744
320503,201707,271,194,77,180841.6,72149,252990.6
320506,201707,244,189,55,177093,51535,228628
320510,201707,883,427,456,397031.65,425572.05,822603.70
320515,201707,79,66,13,60905.45,12181,73086.45
320517,201707,196,139,57,130243,53409,183652
320520,201707,6462,2876,3586,2681453.45,3352620.93,6034074.38
320530,201707,5061,2561,2500,2390603.56,2337902.93,4728506.49
330010,201707,2859,1477,1382,1376424.68,1292189.91,2668614.59
330015,201707,156,61,95,56220.14,89015,145235.14
330020,201707,3431,1491,1940,1393870.92,1817218,3211088.92
330022,201707,203,114,89,106818,82457,189275
330023,201707,505,175,330,162804.4,309210,472014.4
330025,201707,509,119,390,111503,364867.9,476370.9
330030,201707,1854,1176,678,1094540.43,632357.04,1726897.47
330040,201707,2138,1083,1055,1012944.55,987317,2000261.55
330045,201707,8146,2555,5591,2385687.71,5233823.92,7619511.63
330050,201707,769,486,283,455382,265171,720553
330060,201707,826,531,295,493614.05,276415,770029.05
330070,201707,3304,1277,2027,1192409.19,1898297.18,3090706.37
330080,201707,1421,688,733,641134.5,685884.3,1327018.8
330090,201707,353,206,147,193022,137739,330761
330093,201707,276,122,154,114314,144272,258586
330095,201707,102,52,50,48724,46850,95574
330100,201707,9131,4757,4374,4449810.84,4094521.4,8544332.24
330110,201707,472,214,258,198878.8,241746,440624.8
330115,201707,509,303,206,283911,193022,476933
330120,201707,361,185,176,172220.6,164443.5,336664.1
330130,201707,1400,425,975,397512.88,913532,1311044.88
330140,201707,588,307,281,287650,262361,550011
330150,201707,432,258,174,239872,162101,401973
330160,201707,207,129,78,120873,73086,193959
330170,201707,26034,9225,16809,8624740.96,15734109.09,24358850.05
330180,201707,237,150,87,137112.75,80816.25,217929.00
330185,201707,744,319,425,297395.1,398207,695602.1
330187,201707,256,88,168,82456,157416,239872
330190,201707,5519,2192,3327,2045738.25,3113146.92,5158885.17
330200,201707,4265,1475,2790,1378141,2609634.28,3987775.28
330205,201707,386,238,148,222584.35,138395,360979.35
330210,201707,953,581,372,540651.8,346877.95,887529.75
330220,201707,2379,1403,976,1311285.75,913575.1,2224860.85
330225,201707,537,301,236,281410,221132,502542
330227,201707,2348,804,1544,750246.63,1446425.32,2196671.95
330230,201707,198,120,78,111785,73086,184871
330240,201707,3454,1802,1652,1684107.77,1545893.86,3230001.63
330245,201707,147,59,88,55283,81706.4,136989.4
330250,201707,6299,3279,3020,3061869.15,2820918.25,5882787.40
330260,201707,542,166,376,155542,352312,507854
330270,201707,3193,1187,2006,1111095.5,1879249,2990344.5
330280,201707,438,287,151,266034.34,141478,407512.34
330285,201707,6896,2315,4581,2164699.4,4290366.2,6455065.6
330290,201707,571,222,349,207078,326732,533810
330300,201707,714,487,227,452571.85,212682,665253.85
330310,201707,410,241,169,223943.35,158353,382296.35
330320,201707,7729,2871,4858,2682540.8,4547290.6,7229831.4
330330,201707,9304,3604,5700,3371751.16,5336336.4,8708087.56
330340,201707,2576,1559,1017,1458900.53,952910.26,2411810.79
330350,201707,17245,6863,10382,6406163.3,9707285.69,16113448.99
330360,201707,2571,1265,1306,1184162.7,1223713,2407875.7
330370,201707,966,524,442,490238.4,412468.4,902706.8
330380,201707,819,355,464,331902.77,434299.9,766202.67
330385,201707,607,318,289,297030,270793,567823
330390,201707,5014,2785,2229,2597979.19,2086699.52,4684678.71
330395,201707,227,144,83,133242.05,75288.5,208530.55
330400,201707,622,322,300,298622.4,278443.29,577065.69
330410,201707,498,356,142,331924.63,133054,464978.63
330411,201707,220,126,94,118062,88078,206140
330412,201707,243,101,142,94356,133054,227410
330414,201707,6206,2530,3676,2367089.4,3441180.75,5808270.15
330415,201707,544,256,288,239872,268919.4,508791.4
330420,201707,2245,1193,1052,1115152.42,983570.3,2098722.72
330430,201707,1770,761,1009,712299.1,943934,1656233.1
330440,201707,243,109,134,102133,125558,227691
330450,201707,126,51,75,47787,70275,118062
330452,201707,1613,733,880,684882.18,824550.63,1509432.81
330455,201707,108129,38486,69643,35989161.87,65197921.33,101187083.20
330460,201707,261,108,153,101196,143361,244557
330470,201707,1212,664,548,616267.29,513466.63,1129733.92
330475,201707,1372,381,991,355124.3,928004.8,1283129.1
330480,201707,727,391,336,365711.1,313896,679607.1
330490,201707,13092,4678,8414,4377033.09,7876769.17,12253802.26
330500,201707,1307,609,698,570633,653652,1224285
330510,201707,11055,3570,7485,3339255.36,7006546.91,10345802.27
330513,201707,107,54,53,50598,49661,100259
330515,201707,856,352,504,326452.8,471874,798326.8
330520,201707,2339,883,1456,827156,1364131.45,2191287.45
330530,201707,228,120,108,112440,101009,213449
330540,201707,351,178,173,166786,161633,328419
330550,201707,3090,1108,1982,1036462.9,1855942.95,2892405.85
330555,201707,721,269,452,252035,423150,675185
330560,201707,515,197,318,184589,297957,482546
330570,201707,238,163,75,152731,70275,223006
330575,201707,743,333,410,311787,382150.75,693937.75
330580,201707,3284,1855,1429,1732055.8,1337474,3069529.8
330590,201707,300,158,142,148046,133054,281100
330600,201707,1050,679,371,634124.72,346868.03,980992.75
330610,201707,1493,823,670,765325.61,623763.45,1389089.06
330615,201707,179,139,40,130243,37480,167723
330620,201707,881,435,446,403381.06,415464.3,818845.36
330630,201707,3566,2239,1327,2080683.41,1236458.59,3317142.00
350010,201707,599,393,206,366509.79,193022,559531.79
350020,201707,38,19,19,17803,17803,35606
350030,201707,507,331,176,309023,163743.66,472766.66
350040,201707,129,47,82,43701.68,76834,120535.68
350050,201707,294,162,132,151794,123431.63,275225.63
350055,201707,85,47,38,44039,35606,79645
350060,201707,70,26,44,24362,41228,65590
350070,201707,787,458,329,424841.11,306584.12,731425.23
350075,201707,65,42,23,39354,21551,60905
350080,201707,50,32,18,29359.3,15929,45288.3
350090,201707,101,58,43,54346,40286.32,94632.32
350100,201707,301,186,115,173579.25,107755,281334.25
350110,201707,60,38,22,35606,20614,56220
350115,201707,153,91,62,84611.1,58094,142705.1
350120,201707,113,75,38,70275,35606,105881
350130,201707,353,168,185,156854,173345,330199
350140,201707,35,21,14,18178.4,13118,31296.4
350150,201707,67,53,14,49661,13118,62779
350160,201707,2440,944,1496,881349.67,1400733.16,2282082.83
350170,201707,392,241,151,223662.25,141206,364868.25
350180,201707,178,92,86,85923,80582,166505
350190,201707,928,447,481,416871.84,450401.85,867273.69
350200,201707,71,26,45,24160.46,41904.8,66065.26
350210,201707,1351,751,600,695628.66,560848.03,1256476.69
350220,201707,677,581,96,540339.75,89952,630291.75
350230,201707,76,54,22,50598,20614,71212
350240,201707,63,47,16,44039,14992,59031
350250,201707,1183,589,594,546133.45,556053.93,1102187.38
350260,201707,91,65,26,60905,24362,85267
350270,201707,813,538,275,503403.25,255970.76,759374.01
350275,201707,297,117,180,109255,168660,277915
350280,201707,4595,2326,2269,2168482.2,2122733.12,4291215.32
350290,201707,390,187,203,174938,189648.9,364586.9
350300,201707,46,24,22,22488,20614,43102
350310,201707,97,70,27,65590,25299,90889
350315,201707,39,22,17,20614,15929,36543
350320,201707,3247,1593,1654,1487985.62,1549564.52,3037550.14
350330,201707,1660,877,783,817644.3,732670.7,1550315.0
350335,201707,20,13,7,12181,6559,18740
350340,201707,133,69,64,64653,59968,124621
350350,201707,95,44,51,41228,47787,89015
350360,201707,126,86,40,80578,37199,117777
350370,201707,93,55,38,50910.3,35596.63,86506.93
350380,201707,716,305,411,285129.1,384825.9,669955.0
350390,201707,1377,561,816,524873.25,763467.7,1288340.95
350395,201707,26,18,8,16866,7496,24362
350400,201707,1670,892,778,827024.87,726434.28,1553459.15
350410,201707,2186,968,1218,904263.88,1140671.12,2044935.00
350420,201707,235,142,93,131725.54,87141,218866.54
350430,201707,75,42,33,38792,30921,69713
350440,201707,149,107,42,99275.25,39354,138629.25
350450,201707,1590,1021,569,949584.9,533060,1482644.9
350460,201707,330,120,210,112440,196488.9,308928.9
350470,201707,13,10,3,9370,2811,12181
350480,201707,150,84,66,78053,61842,139895
350490,201707,241,116,125,107755.9,117125,224880.9
350500,201707,35,17,18,15929,16866,32795
350510,201707,166,112,54,104944,50598,155542
350520,201707,442,200,242,184902,226129.3,411031.3
350530,201707,449,223,226,208951,211762,420713
350535,201707,57,45,12,41791,11244,53035
350540,201707,375,190,185,177230.55,173064,350294.55
350550,201707,2733,1608,1125,1500563.65,1053124.51,2553688.16
350560,201707,617,430,187,402905.32,174863.65,577768.97
350570,201707,4241,1751,2490,1636314.43,2330377,3966691.43
350580,201707,370,176,194,164912,181764.63,346676.63
350590,201707,899,488,411,457256,384170.3,841426.3
350600,201707,6057,3066,2991,2859805.67,2799889.23,5659694.90
350610,201707,1554,780,774,725085.3,724292,1449377.3
350620,201707,39,27,12,25299,11244,36543
350630,201707,236,137,99,127432.3,91827,219259.3
350635,201707,819,314,505,293224.82,472549.54,765774.36
350640,201707,120,88,32,82456,29984,112440
350650,201707,1856,1219,637,1138549.97,595852.1,1734402.07
350660,201707,743,334,409,312958,382292,695250
350670,201707,311,158,153,147812,143361,291173
350680,201707,179,98,81,91826,75776,167602
350690,201707,206,100,106,93700,99322,193022
350700,201707,664,325,339,301250.99,317643,618893.99
350710,201707,313,128,185,118749.1,173345,292094.1
350715,201707,47,41,6,38417,5622,44039
350720,201707,18,13,5,12181,4685,16866
350730,201707,41,26,15,24362,14055,38417
350740,201707,198,112,86,104653.53,80582,185235.53
350745,201707,22,11,11,10283,10307,20590
350750,201707,2097,1365,732,1270583.65,684322.3,1954905.95
350760,201707,3679,1582,2097,1481397.3,1963342.95,3444740.25
350770,201707,61,42,19,39354,17803,57157
350775,201707,48,35,13,32795,12172,44967
350780,201707,412,201,211,188337,197707,386044
350790,201707,380,167,213,156479,199581,356060
350800,201707,422,234,188,219258,176156,395414
350810,201707,502,399,103,371991,96511,468502
350820,201707,79,50,29,46850,27173,74023
350830,201707,84,50,34,46850,31858,78708
350840,201707,718,328,390,307055,364493,671548
350850,201707,1702,984,718,916380.26,672510,1588890.26
350860,201707,547,316,231,294201.16,216447,510648.16
350870,201707,434,294,140,275197,130805.9,406002.9
350880,201707,293,158,135,144722.2,126495,271217.2
350890,201707,41,26,15,24362,14055,38417
350900,201707,1385,450,935,419700.19,875345.4,1295045.59
350910,201707,27,18,9,16866,8433,25299
350920,201707,592,334,258,312645.7,241746,554391.7
350925,201707,1159,624,535,581699.69,499889.7,1081589.39
350930,201707,95,58,37,54346,34669,89015
350940,201707,676,368,308,343316.8,286787.8,630104.6
350945,201707,102,78,24,72562,22488,95050
350950,201707,14694,7048,7646,6575105.74,7154972.09,13730077.83
350960,201707,1270,585,685,543548.9,641841,1185389.9
350970,201707,1111,621,490,579650.3,458839.63,1038489.93
350980,201707,103,69,34,64653,31858,96511
350990,201707,364,128,236,119252,220850.9,340102.9
350995,201707,31,16,15,14992,14055,29047
351000,201707,629,454,175,423213.26,163975,587188.26
351010,201707,52,29,23,27173,21551,48724
351015,201707,58,40,18,37480,16866,54346
351020,201707,1644,944,700,882852.64,653839.2,1536691.84
351030,201707,318,222,96,205484.1,89952,295436.1
351040,201707,836,451,385,421650,359621.15,781271.15
351050,201707,3182,1537,1645,1433558.14,1539536.33,2973094.47
351060,201707,4816,1987,2829,1851321.26,2647792.57,4499113.83
351070,201707,424,272,152,253024.9,142424,395448.9
351080,201707,803,571,232,535027,216447,751474
351090,201707,66,29,37,27173,34669,61842
351100,201707,452,261,191,242374.35,178953.32,421327.67
351110,201707,2117,1022,1095,950629.72,1023228.92,1973858.64
351120,201707,74,40,34,37396.6,31858,69254.6
351130,201707,169,53,116,49661,108692,158353
351140,201707,333,235,98,218415.5,91826,310241.5
351150,201707,386,197,189,183746,177093,360839
351160,201707,245,160,85,149920,79645,229565
351170,201707,174,87,87,81519,80770,162289
351190,201707,90,62,28,58094,26236,84330
351200,201707,381,250,131,233375.6,122747,356122.6
351210,201707,131,59,72,55283,67464,122747
351220,201707,520,314,206,290907.81,193022,483929.81
351230,201707,273,198,75,184620.3,70256.26,254876.56
351240,201707,225,96,129,89764.6,120873,210637.6
351250,201707,71,51,20,47787,18740,66527
351260,201707,146,108,38,101196,35606,136802
351270,201707,52,22,30,20614,28110,48724
351280,201707,1102,506,596,470376.35,557937.39,1028313.74
351290,201707,221,99,122,92763,114033,206796
351300,201707,3748,1765,1983,1647221.13,1857759,3504980.13
351310,201707,731,390,341,364212,319517,683729
351320,201707,105,64,41,59968,38417,98385
351330,201707,40,28,12,26236,11244,37480
351340,201707,1186,749,437,695749.42,408511.32,1104260.74
351350,201707,2348,1260,1088,1179074.85,1018889.22,2197964.07
351360,201707,770,385,385,358871,359631.19,718502.19
351370,201707,365,192,173,179899.32,161476.3,341375.62
351380,201707,8915,4125,4790,3850044.33,4478328.59,8328372.92
351385,201707,28,19,9,17803,8433,26236
351390,201707,275,199,76,185733.26,71212,256945.26
351400,201707,60,37,23,34669,21505.63,56174.63
351410,201707,415,258,157,241277.5,146828,388105.5
351420,201707,61,50,11,46850,10307,57157
351430,201707,82,45,37,42165,34669,76834
351440,201707,779,533,246,497263.2,230498,727761.2
351450,201707,240,122,118,114314,110566,224880
351460,201707,121,54,67,50598,62779,113377
351470,201707,140,73,67,68392,62779,131171
351480,201707,510,275,235,256145.1,220077.88,476222.98
351490,201707,294,100,194,93700,181778,275478
351492,201707,33,24,9,22488,8433,30921
351495,201707,28,18,10,16866,9370,26236
351500,201707,3537,1522,2015,1420426.37,1882950,3303376.37
351510,201707,1764,729,1035,682791.9,967630.54,1650422.44
351512,201707,21,17,4,15929,3748,19677
351515,201707,191,106,85,99322,79645,178967
351518,201707,711,437,274,408528,256597.45,665125.45
351519,201707,72,46,26,43102,24362,67464
351520,201707,140,88,52,81832,48724,130556
351530,201707,19,14,5,13118,4685,17803
351535,201707,136,75,61,70275,57157,127432
351540,201707,428,304,124,282508,115813.2,398321.2
351550,201707,1285,783,502,726928.1,470364.63,1197292.73
351560,201707,75,37,38,34669,35606,70275
351565,201707,11,6,5,5622,4685,10307
351570,201707,2536,1324,1212,1238732.03,1134997.26,2373729.29
351580,201707,36,30,6,28110,5622,33732
351590,201707,68,45,23,42165,21551,63716
351600,201707,191,141,50,132117,46850,178967
351610,201707,61,29,32,27173,29984,57157
351620,201707,5950,3416,2534,3191509.56,2370352.31,5561861.87
351630,201707,2478,1279,1199,1193484.69,1121584.32,2315069.01
351640,201707,1637,790,847,737723.06,792140.4,1529863.46
351650,201707,30,26,4,24362,3748,28110
351660,201707,154,96,58,89952,54346,144298
351670,201707,729,452,277,420058.15,259549,679607.15
351680,201707,77,63,14,59031,13118,72149
351685,201707,42,26,16,24362,14992,39354
351690,201707,305,215,90,199342.17,84330,283672.17
351700,201707,162,113,49,105881,45913,151794
351710,201707,74,51,23,47787,21551,69338
351720,201707,137,63,74,59031,69338,128369
351730,201707,95,69,26,64653,24357.32,89010.32
351740,201707,707,470,237,440109,222064.32,662173.32
351750,201707,360,149,211,138676.7,197707,336383.7
351760,201707,799,620,179,581175,167587,748762
351770,201707,285,245,40,229565,37480,267045
351780,201707,168,91,77,85267,72149,157416
351790,201707,236,124,112,116188,104944,221132
351800,201707,52,34,18,31858,16866,48724
351810,201707,123,81,42,75616,39354,114970
351820,201707,876,633,243,589655.9,227686.32,817342.22
351830,201707,504,187,317,174469.4,297029,471498.4
351840,201707,1846,942,904,873166.75,845297.79,1718464.54
351850,201707,221,167,54,155870.9,50598,206468.9
351860,201707,744,488,256,453509.77,239867.32,693377.09
351870,201707,5578,2643,2935,2466927.75,2742651.25,5209579.00
351880,201707,18824,8358,10466,7808113.54,9792940.23,17601053.77
351885,201707,94,62,32,58094,29984,88078
351890,201707,77,64,13,59968,12181,72149
351900,201707,222,134,88,124903,82456,207359
351905,201707,76,35,41,32795,38417,71212
351907,201707,3047,1326,1721,1239019.23,1611537.9,2850557.13
351910,201707,174,70,104,65590,97448,163038
351920,201707,138,80,58,74960,54323.96,129283.96
351925,201707,85,58,27,54346,25299,79645
351930,201707,374,258,116,241652.3,108692,350344.3
351940,201707,228,104,124,97448,116188,213636
351950,201707,142,80,62,74960,58094,133054
351960,201707,817,379,438,354791.58,408569.58,763361.16
351970,201707,1882,997,885,932081.04,828955,1761036.04
351980,201707,144,74,70,67464,65590,133054
351990,201707,288,195,93,181778,86353.92,268131.92
352000,201707,355,211,144,197332.2,134928,332260.2
352010,201707,339,199,140,186463,131180,317643
352020,201707,198,71,127,66527,118999,185526
352030,201707,995,504,491,471264.25,458390.51,929654.76
352040,201707,574,245,329,229565,308273,537838
352042,201707,260,92,168,86204,157135,243339
352044,201707,391,232,159,216447.1,148983,365430.1
352050,201707,3100,1273,1827,1185419.9,1710820.53,2896240.43
352060,201707,101,65,36,60905,33732,94637
352070,201707,97,68,29,62780,27173,89953
352080,201707,65,39,26,35606,24362,59968
352090,201707,169,114,55,106818,51535,158353
352100,201707,246,121,125,113377,115993,229370
352110,201707,111,34,77,31858,72149,104007
352115,201707,73,28,45,26236,42165,68401
352120,201707,100,60,40,56220,37480,93700
352130,201707,221,185,36,173157.6,33732,206889.6
352140,201707,181,73,108,67933,101196,169129
352150,201707,120,67,53,61842.7,49661,111503.7
352160,201707,127,85,42,79645,39354,118999
352170,201707,374,256,118,238935.7,110566,349501.7
352180,201707,593,403,190,376534.75,178026,554560.75
352190,201707,263,101,162,94627.63,151747.15,246374.78
352200,201707,31,19,12,17803,11244,29047
352210,201707,3621,1509,2112,1405202.28,1973515.95,3378718.23
352215,201707,50,27,23,25299,21101.24,46400.24
352220,201707,6959,2752,4207,2573948.24,3939791.72,6513739.96
352230,201707,3116,1984,1132,1846946.7,1055254.64,2902201.34
352240,201707,2138,1273,865,1189851.29,809287.25,1999138.54
352250,201707,2552,1353,1199,1264826.6,1121451.7,2386278.3
352260,201707,1119,633,486,591894.32,454819.9,1046714.22
352265,201707,64,29,35,27173,32795,59968
352270,201707,385,221,164,206140.84,153613,359753.84
352280,201707,387,246,141,228971.9,131831.32,360803.22
352290,201707,173,109,64,101571,59968,161539
352300,201707,103,78,25,73086,23425,96511
352310,201707,5634,2795,2839,2607895.21,2655322.25,5263217.46
352320,201707,913,493,420,459349.99,391525.55,850875.54
352330,201707,525,224,301,209560.05,281756,491316.05
352340,201707,1390,684,706,637367.5,660444.75,1297812.25
352350,201707,316,198,118,185526,110285,295811
352360,201707,223,88,135,81565.85,123945,205510.85
352370,201707,102,70,32,65590,29984,95574
352380,201707,118,73,45,68401,42165,110566
352390,201707,2406,1101,1305,1027262.9,1220912.14,2248175.04
352400,201707,460,193,267,180138.25,249897.9,430036.15
352410,201707,738,528,210,490307.9,196489,686796.9
352420,201707,99,62,37,58094,34669,92763
352430,201707,1748,769,979,714652.55,915654.59,1630307.14
352440,201707,3012,1561,1451,1455005.91,1356736.4,2811742.31
352450,201707,186,158,28,148046,26236,174282
352460,201707,567,288,279,269308.54,260065.2,529373.74
352470,201707,568,194,374,181778,350429,532207
352480,201707,1359,757,602,708685,563511.9,1272196.9
352490,201707,81,32,49,29984,45913,75897
352500,201707,1210,541,669,505137.8,625670.76,1130808.56
352510,201707,731,392,339,366367.3,317643,684010.3
352520,201707,527,233,294,218040,275337.45,493377.45
352530,201707,1711,901,810,843300,757658.3,1600958.3
352540,201707,76,51,25,47787,23425,71212
352550,201707,186,107,79,100259,73367.1,173626.1
352560,201707,51,41,10,38417,9370,47787
352570,201707,653,343,310,320798,290470,611268
352580,201707,59,41,18,37480.33,16866,54346.33
352585,201707,15,5,10,4685,9370,14055
352590,201707,4238,2130,2108,1990194.83,1974311.11,3964505.94
352600,201707,355,247,108,230502.3,101187,331689.3
352610,201707,908,430,478,400223.51,447886,848109.51
352620,201707,965,380,585,355123.1,547864,902987.1
352630,201707,218,80,138,74960,128874.98,203834.98
352640,201707,543,380,163,353532.06,152731,506263.06
352650,201707,92,62,30,58094,28110,86204
352660,201707,82,49,33,45913,30921,76834
352670,201707,1627,888,739,828625.88,691096.66,1519722.54
352680,201707,883,564,319,524332.68,297654.2,821986.88
352690,201707,4235,1962,2273,1828648.5,2126003.87,3954652.37
352700,201707,112,63,49,59031,45913,104944
352710,201707,1294,681,613,636223.1,571851.6,1208074.7
352720,201707,1197,589,608,549395.1,569691.32,1119086.42
352725,201707,27,25,2,23425,1874,25299
352730,201707,358,174,184,161880.81,171846,333726.81
352740,201707,402,250,152,232330.04,142424,374754.04
352750,201707,25,17,8,15647.9,7496,23143.9
352760,201707,194,141,53,132117,49661,181778
352770,201707,84,67,17,61843,15929,77772
352780,201707,83,45,38,42165,35606,77771
352790,201707,26,22,4,20614,3748,24362
352800,201707,243,166,77,155542,71867.9,227409.9
352810,201707,162,105,57,95918.92,53409,149327.92
352820,201707,64,54,10,50180.1,9370,59550.1
352830,201707,87,61,26,57157,24362,81519
352840,201707,559,292,267,272340.1,249898,522238.1
352850,201707,1308,474,834,443482.1,781458,1224940.1
352860,201707,125,81,44,75897,41228,117125
352870,201707,37,23,14,21551,13118,34669
352880,201707,186,130,56,121791.26,52472,174263.26
352885,201707,30,21,9,19677,8433,28110
352890,201707,54,37,17,34669,15648,50317
352900,201707,4932,2392,2540,2225096.73,2374081.46,4599178.19
352910,201707,42,32,10,29984,9370,39354
352920,201707,715,439,276,410406,258612,669018
352930,201707,1237,602,635,562683.58,591800.88,1154484.46
352940,201707,6245,2706,3539,2524016.85,3311043.71,5835060.56
352950,201707,91,38,53,35606,49661,85267
352960,201707,70,44,26,41228,24362,65590
352965,201707,20,8,12,7496,11244,18740
352970,201707,456,340,116,313868.44,107755.7,421624.14
352980,201707,177,91,86,85267,80582,165849
352990,201707,881,415,466,386150.14,434910.9,821061.04
353000,201707,66,30,36,28110,33732,61842
353010,201707,555,344,211,322328,197688.27,520016.27
353020,201707,290,212,78,198644,73086,271730
353030,201707,1154,535,619,500976.63,579328.73,1080305.36
353040,201707,87,54,33,50598,30921,81519
353050,201707,1275,800,475,744136.55,444981.3,1189117.85
353060,201707,7500,3480,4020,3247462.9,3759977.17,7007440.07
353070,201707,1634,1015,619,945825.26,578736.04,1524561.30
353080,201707,1313,686,627,640205.52,587490.32,1227695.84
353090,201707,58,35,23,32795,21551,54346
353100,201707,61,50,11,46850,10307,57157
353110,201707,1827,591,1236,552066.63,1156437.32,1708503.95
353120,201707,71,36,35,33732,32795,66527
353130,201707,864,422,442,394458.63,414125.89,808584.52
353140,201707,589,229,360,214514,337320,551834
353150,201707,359,199,160,185526,149910.63,335436.63
353160,201707,104,85,19,79645,17803,97448
353170,201707,202,67,135,62769.63,126467.63,189237.26
353180,201707,954,437,517,407955.95,483914,891869.95
353190,201707,452,321,131,299738.95,122747,422485.95
353200,201707,183,90,93,84314,87141,171455
353205,201707,26,19,7,17803,6559,24362
353210,201707,82,51,31,47787,29047,76834
353215,201707,57,33,24,30921,22488,53409
353220,201707,82,46,36,43102,32795.93,75897.93
353230,201707,158,61,97,57157,90889,148046
353240,201707,273,149,124,139613,116188,255801
353250,201707,198,105,93,98385,87141,185526
353260,201707,418,308,110,287481.25,103060.63,390541.88
353270,201707,70,51,19,47787,17147.1,64934.1
353280,201707,93,46,47,42634,44039,86673
353282,201707,114,85,29,79645,27173,106818
353284,201707,24,19,5,17803,4685,22488
353286,201707,1,1,0,937,0,937
353290,201707,79,47,32,44039,29975,74014
353300,201707,390,218,172,202751.55,161164,363915.55
353310,201707,51,47,4,44039,3748,47787
353320,201707,58,38,20,35606,18740,54346
353325,201707,54,36,18,33732,16567,50299
353330,201707,70,54,16,50458,14992,65450
353340,201707,598,192,406,179904,379850.54,559754.54
353350,201707,901,421,480,393671.92,448797,842468.92
353360,201707,111,88,23,82143.7,21270,103413.7
353370,201707,118,68,50,62779.55,46850,109629.55
353380,201707,31,22,9,20610,8433,29043
353390,201707,1026,501,525,469437,491925,961362
353400,201707,47,28,19,26236,17803,44039
353410,201707,115,69,46,64653,42400.1,107053.1
353420,201707,57,25,32,23425,29984,53409
353430,201707,544,355,189,328980.08,176661.9,505641.98
353440,201707,10180,4450,5730,4159247.13,5362238.12,9521485.25
353450,201707,57,29,28,27173,26236,53409
353460,201707,598,320,278,295791.99,258838.25,554630.24
353470,201707,2115,1152,963,1074324.26,900895.82,1975220.08
353475,201707,232,154,78,141659.3,73086,214745.3
353480,201707,190,151,39,141487,36543,178030
353490,201707,231,140,91,131180,85267,216447
353500,201707,179,108,71,99978.3,66527,166505.3
353510,201707,103,74,29,69319.63,27163.63,96483.26
353520,201707,208,144,64,134928,59968,194896
353530,201707,445,241,204,225817,191148,416965
353540,201707,351,234,117,218941.02,109629,328570.02
353550,201707,723,492,231,457912.85,216447,674359.85
353560,201707,625,266,359,248305.6,336079.22,584384.82
353570,201707,60,31,29,29047,27173,56220
353580,201707,356,273,83,255333,77771,333104
353590,201707,79,53,26,49661,24362,74023
353600,201707,263,149,114,139301,106818,246119
353610,201707,115,60,55,56220,51535,107755
353620,201707,552,300,252,279148.52,235842.9,514991.42
353625,201707,52,26,26,24362,24362,48724
353630,201707,234,169,65,154100.07,59999.23,214099.30
353640,201707,121,83,38,76834.5,35606,112440.5
353650,201707,817,324,493,301526.6,461941,763467.6
353657,201707,21,15,6,14055,5622,19677
353660,201707,256,142,114,133054,106536.9,239590.9
353670,201707,708,429,279,401036.1,261423,662459.1
353680,201707,101,73,28,68401,26236,94637
353690,201707,47,37,10,34669,9370,44039
353700,201707,289,202,87,189274,81519,270793
353710,201707,403,185,218,172408.4,204266,376674.4
353715,201707,47,37,10,34387.9,9370,43757.9
353720,201707,363,166,197,155524,184569,340093
353730,201707,1119,688,431,641687.45,403565.9,1045253.35
353740,201707,633,358,275,335164.9,257675,592839.9
353750,201707,100,61,39,56634.62,36543,93177.62
353760,201707,2593,972,1621,908679.3,1515338.37,2424017.67
353770,201707,99,80,19,74491.5,17803,92294.5
353780,201707,1062,549,513,511790.3,479462.9,991253.2
353790,201707,503,289,214,268538.34,200398,468936.34
353800,201707,3221,1647,1574,1535193.46,1471965.17,3007158.63
353810,201707,238,132,106,122845.75,99295,222140.75
353820,201707,172,86,86,80582,79968.54,160550.54
353830,201707,46,40,6,37480,5622,43102
353850,201707,168,87,81,81519,75897,157416
353860,201707,457,203,254,188832.35,237716.9,426549.25
353870,201707,4910,2457,2453,2287790.5,2288565.8,4576356.3
353880,201707,650,459,191,428031.52,178030.36,606061.88
353890,201707,585,320,265,299278,248305,547583
353900,201707,139,65,74,60905,69338,130243
353910,201707,179,84,95,78708,89015,167723
353920,201707,452,244,208,227457.7,194882.64,422340.34
353930,201707,969,581,388,542991.5,362390.9,905382.4
353940,201707,186,102,84,94824.4,77865,172689.4
353950,201707,514,321,193,300767.63,180841,481608.63
353960,201707,69,55,14,51535,13118,64653
353970,201707,70,47,23,44039,21551,65590
353980,201707,1508,747,761,697332.59,713045,1410377.59
353990,201707,76,42,34,39354,31858,71212
354000,201707,371,172,199,160509,186271.6,346780.6
354010,201707,97,51,46,47787,42634,90421
354020,201707,536,336,200,313895,187118.9,501013.9
354025,201707,52,44,8,41228,7496,48724
354030,201707,63,32,31,29984,29047,59031
354040,201707,90,65,25,60623.9,23425,84048.9
354050,201707,179,104,75,97167,70275,167442
354060,201707,771,377,394,353249,367305.65,720554.65
354070,201707,879,507,372,472931.52,348564,821495.52
354075,201707,201,110,91,102977,84330.9,187307.9
354080,201707,281,123,158,114969.9,148046,263015.9
354085,201707,19,12,7,11244,6559,17803
354090,201707,317,176,141,164833,132117,296950
354100,201707,5387,2220,3167,2070302.17,2962977.87,5033280.04
354105,201707,80,41,39,38417,36543,74960
354110,201707,46,22,24,20614,22488,43102
354120,201707,141,98,43,91689.29,40291,131980.29
354130,201707,671,449,222,420479,207733,628212
354140,201707,3175,1494,1681,1396259.42,1574052.62,2970312.04
354150,201707,628,389,239,363275,222537.5,585812.5
354160,201707,672,415,257,387683.75,240528,628211.75
354165,201707,18,12,6,11244,5622,16866
354170,201707,166,113,53,105225.1,49661,154886.1
354180,201707,67,42,25,39034,23425,62459
354190,201707,199,91,108,83674.1,101196,184870.1
354200,201707,130,69,61,64185,57157,121342
354210,201707,74,35,39,32795,36543,69338
354220,201707,649,403,246,376955.1,229284.18,606239.28
354230,201707,159,65,94,60905,87141.8,148046.8
354240,201707,315,203,112,188993.69,104319.3,293312.99
354250,201707,89,52,37,48724,34669,83393
354260,201707,1870,870,1000,804105.92,934746,1738851.92
354270,201707,97,73,24,68401,22488,90889
354280,201707,32,17,15,15929,14055,29984
354290,201707,149,101,48,93372.55,44976,138348.55
354300,201707,417,287,130,268607,121810,390417
354310,201707,100,72,28,66527.1,26236,92763.1
354320,201707,185,96,89,89952,83393,173345
354323,201707,14,12,2,11244,1874,13118
354325,201707,115,66,49,61007.91,45913,106920.91
354330,201707,2481,858,1623,799425.24,1518622.69,2318047.93
354340,201707,10594,5145,5449,4804792.72,5100845,9905637.72
354350,201707,130,88,42,82456,39213.45,121669.45
354360,201707,89,48,41,44976,38417,83393
354370,201707,262,136,126,127432,118062,245494
354380,201707,203,118,85,109792,79645,189437
354390,201707,2744,995,1749,932006.5,1636707.04,2568713.54
354400,201707,324,168,156,156339.9,145609.9,301949.8
354410,201707,602,293,309,273600.32,288437.1,562037.42
354420,201707,262,166,96,155542,89952,245494
354425,201707,308,176,132,164912,123675,288587
354430,201707,191,122,69,111990.95,63903.4,175894.35
354440,201707,43,30,13,28110,12181,40291
354450,201707,48,33,15,30921,14055,44976
354460,201707,99,55,44,51535,41228,92763
354470,201707,39,28,11,26236,10307,36543
354480,201707,117,63,54,59022,50588.63,109610.63
354490,201707,143,90,53,84173.81,49661,133834.81
354500,201707,394,192,202,179904,189274,369178
354510,201707,110,75,35,70171.56,32795,102966.56
354515,201707,39,15,24,14055,22488,36543
354520,201707,1567,703,864,654985.7,809230.68,1464216.38
354530,201707,611,319,292,296556.5,272761.1,569317.6
354540,201707,273,151,122,141487,114309.32,255796.32
354550,201707,44,25,19,23425,17803,41228
354560,201707,158,92,66,86204,61832.63,148036.63
354570,201707,144,95,49,89015,45913,134928
354580,201707,1981,943,1038,880708,971375.54,1852083.54
354600,201707,273,147,126,135528.36,118057.32,253585.68
354610,201707,69,63,6,59031,5622,64653
354620,201707,64,18,46,16866,43102,59968
354625,201707,18,12,6,11244,5618,16862
354630,201707,326,212,114,198144.21,106818,304962.21
354640,201707,784,508,276,472140.5,258612,730752.5
354650,201707,73,39,34,36534,31821.26,68355.26
354660,201707,800,583,217,542790.25,203329,746119.25
354670,201707,290,104,186,96824,173346,270170
354680,201707,1221,460,761,431020,712589,1143609
354690,201707,87,60,27,54581.25,25299,79880.25
354700,201707,77,55,22,51535,20614,72149
354710,201707,53,37,16,34044.3,14992,49036.3
354720,201707,22,21,1,19677,937,20614
354730,201707,1915,809,1106,755401.5,1036134.6,1791536.1
354740,201707,55,39,16,36543,14992,51535
354750,201707,424,252,172,236115,161164,397279
354760,201707,507,312,195,290026,182434,472460
354765,201707,11,5,6,4685,5622,10307
354770,201707,318,224,94,208797.71,88078,296875.71
354780,201707,8086,3283,4803,3062656.08,4495711.29,7558367.37
354790,201707,116,68,48,63716,44976,108692
354800,201707,398,222,176,208014,164631,372645
354805,201707,105,54,51,49974,47787,97761
354810,201707,139,81,58,75615.9,54346,129961.9
354820,201707,178,78,100,72880,93700,166580
354830,201707,39,22,17,20614,15929,36543
354840,201707,53,35,18,32795,16866,49661
354850,201707,4563,2029,2534,1893524.7,2369782.76,4263307.46
354860,201707,338,165,173,154605,160040.3,314645.3
354870,201707,11518,5261,6257,4903668.88,5854162.78,10757831.66
354880,201707,2944,1101,1843,1029466.55,1725042.96,2754509.51
354890,201707,2807,1553,1254,1450210.44,1173864.64,2624075.08
354900,201707,60,39,21,36543,19677,56220
354910,201707,1163,616,547,574344.22,512539,1086883.22
354920,201707,52,44,8,41228,7496,48724
354925,201707,11,6,5,5622,4685,10307
354930,201707,32,28,4,25970,3748,29718
354940,201707,798,584,214,545260.64,200518,745778.64
354950,201707,227,149,78,139011,73086,212097
354960,201707,171,66,105,61842,98104,159946
354970,201707,823,531,292,492492.39,272976.31,765468.70
354980,201707,8245,3095,5150,2893851.71,4823727.72,7717579.43
354990,201707,9054,4270,4784,3992728.7,4476406.77,8469135.47
354995,201707,518,184,334,172408,312367.69,484775.69
355000,201707,453,147,306,137734.32,285661,423395.32
355010,201707,624,398,226,372926,209589.36,582515.36
355020,201707,713,444,269,415086.9,252045,667131.9
355030,201707,200764,77661,123103,72560098.37,115249098.3,187809196.67
355040,201707,702,338,364,316425,340880.6,657305.6
355050,201707,154,102,52,94325.77,48724,143049.77
355060,201707,1349,698,651,649265.97,608160.25,1257426.22
355070,201707,1451,716,735,668068.44,687710,1355778.44
355080,201707,200,117,83,109421.74,76899.9,186321.64
355090,201707,281,189,92,175033,86204,261237
355100,201707,4712,2362,2350,2194942,2199552.07,4394494.07
355110,201707,293,191,102,177234.55,95574,272808.55
355120,201707,112,82,30,76365.5,28110,104475.5
355130,201707,50,26,24,24362,22488,46850
355140,201707,182,119,63,111503,59031,170534
355150,201707,675,407,268,380137.1,251116,631253.1
355160,201707,436,200,236,185057.8,221132,406189.8
355170,201707,2001,1039,962,972185.87,901094.28,1873280.15
355180,201707,622,261,361,243420.5,337156.02,580576.52
355190,201707,217,148,69,138676,64653,203329
355200,201707,112,63,49,59031,45913,104944
355210,201707,677,393,284,368241,266080.63,634321.63
355220,201707,6382,3448,2934,3221010.66,2742031.44,5963042.10
355230,201707,109,66,43,61842,40286.32,102128.32
355240,201707,4073,1791,2282,1665945.47,2134231.38,3800176.85
355250,201707,5232,2574,2658,2404344.61,2487398.6,4891743.21
355255,201707,50,29,21,27173,19677,46850
355260,201707,187,112,75,103988.36,70257,174245.36
355270,201707,167,99,68,92763,63014,155777
355280,201707,6109,2609,3500,2439781.75,3274643.07,5714424.82
355290,201707,80,60,20,56220,18740,74960
355300,201707,178,119,59,111175.05,55283,166458.05
355310,201707,104,58,46,54346,43102,97448
355320,201707,94,47,47,43757.9,43343.3,87101.2
355330,201707,267,147,120,137739,112440,250179
355340,201707,1295,528,767,492862.68,717950.2,1210812.88
355350,201707,135,69,66,64653,61842,126495
355360,201707,171,104,67,97241.86,62779,160020.86
355365,201707,26,21,5,19677,4685,24362
355370,201707,1021,575,446,533947.59,415879.02,949826.61
355380,201707,763,512,251,478344.8,234906,713250.8
355385,201707,51,36,15,33732,14055,47787
355390,201707,104,60,44,56220,41228,97448
355395,201707,188,115,73,106954.32,68401,175355.32
355400,201707,1508,940,568,876852.98,531653.9,1408506.88
355410,201707,4784,2235,2549,2078023.58,2379278.23,4457301.81
355420,201707,45,34,11,31858,10307,42165
355430,201707,337,209,128,195177.1,119936,315113.1
355440,201707,73,41,32,38417,29984,68401
355450,201707,418,193,225,177469.32,209513.3,386982.62
355460,201707,71,56,15,51535.51,14055,65590.51
355465,201707,50,32,18,29984,16866,46850
355470,201707,188,73,115,67464.55,107755,175219.55
355475,201707,11,7,4,6559,3748,10307
355480,201707,443,190,253,176906,235177.63,412083.63
355490,201707,115,84,31,78708,29047,107755
355495,201707,50,25,25,23425,23425,46850
355500,201707,1700,968,732,902507.14,685526.58,1588033.72
355510,201707,266,196,70,180255.5,65590,245845.5
355520,201707,37,29,8,27173,7496,34669
355530,201707,21,14,7,13118,6559,19677
355535,201707,78,37,41,34669,38417,73086
355540,201707,2297,925,1372,865292.42,1283391.63,2148684.05
355550,201707,67,41,26,38417,24362,62779
355560,201707,230,117,113,109629,105256.3,214885.3
355570,201707,30,19,11,17803,10307,28110
355580,201707,268,183,85,171471,79640.32,251111.32
355590,201707,23,15,8,14055,7496,21551
355600,201707,273,143,130,133991,121524.32,255515.32
355610,201707,204,133,71,124621,66527,191148
355620,201707,1219,552,667,515490.9,624412.8,1139903.7
355630,201707,404,282,122,263298,114314,377612
355635,201707,130,59,71,55283,66514,121797
355640,201707,569,333,236,311084,221132,532216
355645,201707,825,356,469,331910.64,437607.21,769517.85
355650,201707,1970,897,1073,838213.4,1005382.63,1843596.03
355660,201707,265,140,125,131180,117120.32,248300.32
355670,201707,456,167,289,156479,270793,427272
355680,201707,212,118,94,110566,87516,198082
355690,201707,83,40,43,37480,39953,77433
355695,201707,14,12,2,11244,1874,13118
355700,201707,1120,587,533,544038.61,499140,1043178.61
355710,201707,2175,1187,988,1107052.68,925165.9,2032218.58
355715,201707,20,18,2,16866,1874,18740
355720,201707,204,124,80,114626.66,74956,189582.66
355730,201707,87,51,36,46928.53,33732,80660.53
410010,201707,128,108,20,101196,18740,119936
410020,201707,104,92,12,86204,11244,97448
410030,201707,161,102,59,94918.2,55283,150201.2
410040,201707,974,520,454,486724.65,425211,911935.65
410045,201707,34,29,5,27173,4685,31858
410050,201707,468,262,206,245474,192553.5,438027.5
410060,201707,262,203,59,189930,55283,245213
410070,201707,321,261,60,244557,56220,300777
410080,201707,165,108,57,101196,53409,154605
410090,201707,74,66,8,61636,7496,69132
410100,201707,295,209,86,195833,79879.25,275712.25
410105,201707,40,24,16,22488,14992,37480
410110,201707,308,186,122,174282,114314,288596
410115,201707,27,18,9,16866,8433,25299
410120,201707,448,226,222,211465.9,208014,419479.9
410130,201707,39,26,13,24362,12181,36543
410140,201707,2989,1467,1522,1369430.63,1425823.63,2795254.26
410150,201707,2665,1071,1594,1003264.75,1492804.5,2496069.25
410160,201707,499,319,180,298621.9,168660,467281.9
410165,201707,64,41,23,38417,21551,59968
410170,201707,166,125,41,114929.83,38417,153346.83
410180,201707,2089,1205,884,1125168.69,826970.08,1952138.77
410185,201707,44,40,4,37480,3748,41228
410190,201707,405,247,158,231439,148046,379485
410200,201707,963,725,238,677563.88,222724.9,900288.78
410210,201707,548,280,268,262360,250554,512914
410220,201707,40,22,18,20614,16866,37480
410230,201707,119,71,48,66527,44976,111503
410240,201707,720,476,244,445449.9,228628,674077.9
410250,201707,385,285,100,266451.6,93679.89,360131.49
410260,201707,313,169,144,158353,134928,293281
410270,201707,29,19,10,17803,9370,27173
410275,201707,73,55,18,51535,16866,68401
410280,201707,307,172,135,160909.14,126495,287404.14
410290,201707,220,147,73,136896.03,67979.02,204875.05
410300,201707,84,66,18,61842,16866,78708
410302,201707,24,16,8,14992,7496,22488
410304,201707,49,33,16,30921,14992,45913
410305,201707,184,96,88,89160,82456,171616
410310,201707,257,167,90,156479,84330,240809
410315,201707,58,42,16,39330,14992,54322
410320,201707,139,96,43,89952,40291,130243
410322,201707,33,22,11,20614,10307,30921
410330,201707,166,119,47,111503,44039,155542
410335,201707,94,58,36,54346,33732,88078
410337,201707,37,32,5,29984,4685,34669
410340,201707,30,29,1,27173,937,28110
410345,201707,205,129,76,120132.77,71212,191344.77
410347,201707,51,40,11,37480,10307,47787
410350,201707,230,140,90,131180,84330,215510
410360,201707,456,275,181,254896.2,169316,424212.2
410370,201707,2290,945,1345,882589.46,1257178.11,2139767.57
410380,201707,221,145,76,135865,71212,207077
410390,201707,358,268,90,251112,84330,335442
410395,201707,36,24,12,22488,10870,33358
410400,201707,812,415,397,387736.1,371460,759196.1
410405,201707,89,65,24,60905,22488,83393
410410,201707,43,33,10,30921,9370,40291
410420,201707,1618,801,817,748764.6,763968.3,1512732.9
410425,201707,175,86,89,80395,83393,163788
410430,201707,2179,1278,901,1195049.9,842007.16,2037057.06
410440,201707,400,286,114,267046,106818,373864
410442,201707,366,242,124,225818,116188,342006
410445,201707,417,288,129,269856,120873,390729
410450,201707,398,195,203,182715,190211,372926
410460,201707,399,216,183,202110.9,171471,373581.9
410465,201707,192,124,68,114688.8,63716,178404.8
410470,201707,213,132,81,123684,75897,199581
410480,201707,5569,2762,2807,2572895.79,2625317.99,5198213.78
410490,201707,1350,896,454,838382,423525,1261907
410500,201707,261,150,111,140550,104007,244557
410510,201707,180,128,52,119936,48090.3,168026.3
410520,201707,267,198,69,185526,64653,250179
410530,201707,232,86,146,80582,136798,217380
410540,201707,315,227,88,212128.8,82451.32,294580.12
410550,201707,1563,683,880,639689.9,823993.12,1463683.02
410560,201707,140,107,33,100259,30921,131180
410570,201707,436,304,132,282762.11,123684,406446.11
410580,201707,3127,1404,1723,1313026.36,1613046,2926072.36
410590,201707,393,279,114,261423,106818,368241
410600,201707,169,149,20,139613,18740,158353
410610,201707,50,41,9,38417,8433,46850
410620,201707,228,165,63,154605,59031,213636
410630,201707,446,261,185,244537,172206,416743
410640,201707,931,565,366,527225.44,341347.43,868572.87
410645,201707,99,72,27,67070,25299,92369
410650,201707,359,243,116,226754,108692,335446
410655,201707,79,61,18,57157,16866,74023
410657,201707,42,17,25,15929,23425,39354
410660,201707,576,412,164,384528,153668,538196
410670,201707,76,61,15,57157,14055,71212
410680,201707,190,154,36,144298,32775.29,177073.29
410685,201707,20,13,7,12181,6559,18740
410690,201707,28434,12280,16154,11490145.53,15126572.17,26616717.70
410700,201707,311,228,83,213074,77771,290845
410710,201707,133,107,26,100259,24362,124621
410712,201707,20,12,8,11244,7496,18740
410715,201707,86,66,20,61842,18740,80582
410720,201707,576,351,225,328887,210816,539703
410725,201707,175,125,50,117125,46850,163975
410730,201707,92,57,35,53409,32795,86204
410740,201707,113,85,28,79645,26236,105881
410750,201707,214,161,53,150853,49656.32,200509.32
410752,201707,21,14,7,13118,6559,19677
410753,201707,51,22,29,19953.41,27173,47126.41
410754,201707,35,21,14,19677,13118,32795
410755,201707,83,57,26,53127.9,24362,77489.9
410760,201707,691,398,293,372926,274073,646999
410765,201707,1608,776,832,721018.94,778731.63,1499750.57
410770,201707,107,91,16,85267,14992,100259
410773,201707,46,34,12,31858,11244,43102
410775,201707,173,129,44,120217.1,41228,161445.1
410780,201707,83,44,39,41228,36543,77771
410785,201707,72,55,17,51348,15929,67277
410790,201707,65,32,33,29984,30921,60905
410800,201707,296,187,109,174283,102133,276416
410810,201707,33,27,6,25299,5341,30640
410820,201707,179,134,45,125418,42165,167583
410830,201707,8478,3881,4597,3627522.3,4305305.64,7932827.94
410832,201707,106,75,31,69993.9,29047,99040.9
410840,201707,1371,757,614,706803.99,575197.67,1282001.66
410845,201707,60,37,23,34669,21551,56220
410850,201707,193,132,61,123363,57157,180520
410855,201707,44,38,6,35606,5622,41228
410860,201707,666,386,280,360910.75,262360,623270.75
410865,201707,109,83,26,77771,24362,102133
410870,201707,148,129,19,120873,17516,138389
410880,201707,1079,535,544,500980.05,509674,1010654.05
410890,201707,76,59,17,55283,15929,71212
410895,201707,74,54,20,50598,18740,69338
410900,201707,28,21,7,19677,6559,26236
410910,201707,22,19,3,17803,2811,20614
410920,201707,36,24,12,22488,11244,33732
410930,201707,505,324,181,303380.74,169315.9,472696.64
410940,201707,4275,2563,1712,2393121.67,1600841.7,3993963.37
410950,201707,121,87,34,81519,31858,113377
410960,201707,745,332,413,310803,386981,697784
410965,201707,63,49,14,45913,13118,59031
410970,201707,610,433,177,405265.1,165849,571114.1
410975,201707,104,70,34,65229,31858,97087
410980,201707,1504,681,823,635943,770861.22,1406804.22
410990,201707,257,174,83,162872.25,77489.9,240362.15
411000,201707,61,42,19,39354,17803,57157
411005,201707,22,16,6,14992,5622,20614
411007,201707,235,136,99,127432,92763,220195
411010,201707,567,400,167,374575,156479,531054
411020,201707,283,191,92,178967,86204,265171
411030,201707,25,15,10,14055,9370,23425
411040,201707,49,34,15,31858,14055,45913
411050,201707,221,176,45,163505.17,42038.12,205543.29
411060,201707,510,347,163,325130,152731,477861
411065,201707,58,52,6,48602.19,5622,54224.19
411070,201707,1167,787,380,733484,356060,1089544
411080,201707,241,173,68,162184,62929.66,225113.66
411090,201707,111,81,30,75897,28110,104007
411095,201707,257,106,151,98854,141477,240331
411100,201707,113,94,19,88078,17803,105881
411110,201707,123,84,39,78708,36543,115251
411120,201707,171,130,41,121810,38417,160227
411125,201707,168,75,93,69619.1,87141,156760.1
411130,201707,116,98,18,91200,16866,108066
411140,201707,167,117,50,109326.02,46334.65,155660.67
411150,201707,1172,777,395,728039.63,370115,1098154.63
411155,201707,117,81,36,75897,33732,109629
411160,201707,21,10,11,9370,10307,19677
411170,201707,62,54,8,50316.9,7496,57812.9
411180,201707,910,597,313,558171,293276.32,851447.32
411190,201707,314,176,138,164256.1,129306,293562.1
411200,201707,662,438,224,409157.09,209278.95,618436.04
411210,201707,667,355,312,331112.83,292344,623456.83
411220,201707,145,111,34,104007,31858,135865
411230,201707,51,45,6,42165,5622,47787
411240,201707,125,87,38,81519,35606,117125
411250,201707,415,300,115,281100,107755,388855
411260,201707,22,15,7,14055,6559,20614
411270,201707,290,159,131,148983,122747,271730
411275,201707,201,177,24,165709,22488,188197
411280,201707,230,161,69,149608.36,64653,214261.36
411290,201707,57,41,16,38417,14992,53409
411295,201707,141,112,29,104944,27173,132117
411300,201707,81,44,37,41228,34669,75897
411310,201707,91,69,22,64653,20614,85267
411320,201707,731,534,197,499000.8,183015.24,682016.04
411325,201707,45,28,17,26236,15929,42165
411330,201707,884,563,321,525778.15,299933.8,825711.95
411340,201707,27,18,9,16866,8124,24990
411342,201707,83,60,23,56220,21551,77771
411345,201707,118,59,59,55283,55283,110566
411350,201707,471,379,92,354139.92,85257.73,439397.65
411360,201707,50,30,20,28110,18740,46850
411370,201707,13740,5651,8089,5278989.27,7565969.92,12844959.19
411373,201707,192,141,51,132117,47787,179904
411375,201707,82,69,13,64653,12181,76834
411380,201707,99,72,27,66527.89,25299,91826.89
411390,201707,142,93,49,87141,45913,133054
411400,201707,343,254,89,237989,83393,321382
411410,201707,440,224,216,209232.1,202111,411343.1
411420,201707,1018,469,549,437204.2,513944.6,951148.8
411430,201707,400,258,142,241090.1,132764,373854.1
411435,201707,39,28,11,26236,10307,36543
411440,201707,467,375,92,349751.37,86204,435955.37
411450,201707,431,355,76,332635,71212,403847
411460,201707,708,280,428,261391.2,399734.96,661126.16
411470,201707,121,89,32,83393,29984,113377
411480,201707,609,349,260,325514.8,243338.9,568853.7
411490,201707,288,177,111,165849,104007,269856
411500,201707,107,91,16,85267,14336.9,99603.9
411510,201707,215,173,42,161366.39,39354,200720.39
411520,201707,5839,2288,3551,2140312.34,3319105.79,5459418.13
411530,201707,112,74,38,69338,35606,104944
411535,201707,52,20,32,18740,29984,48724
411540,201707,312,213,99,198761.6,92763,291524.6
411545,201707,74,53,21,49661,19677,69338
411550,201707,72,56,16,52472,14992,67464
411560,201707,370,167,203,155851.21,190211,346062.21
411570,201707,769,290,479,271449,448636,720085
411573,201707,37,22,15,20614,14055,34669
411575,201707,256,156,100,146172,93700,239872
411580,201707,1197,475,722,444419.1,674585.7,1119004.8
411585,201707,76,37,39,34669,36543,71212
411590,201707,26,18,8,16866,7496,24362
411600,201707,38,18,20,16866,18740,35606
411605,201707,234,109,125,101973,117125,219098
411610,201707,239,162,77,151794,72149,223943
411620,201707,347,193,154,180653.6,144298,324951.6
411630,201707,56,37,19,34669,17803,52472
411640,201707,42,33,9,30921,8433,39354
411650,201707,13,10,3,9370,2811,12181
411660,201707,41,35,6,32795,5622,38417
411670,201707,246,188,58,175144.81,54326,229470.81
411680,201707,158,135,23,126495,21551,148046
411690,201707,590,324,266,302992.08,248859.6,551851.68
411695,201707,63,49,14,45913,13118,59031
411700,201707,172,148,24,138676,22488,161164
411705,201707,105,68,37,63716,34669,98385
411710,201707,295,192,103,178937.86,96511,275448.86
411720,201707,131,85,46,79645,43102,122747
411721,201707,76,63,13,59031,12181,71212
411722,201707,97,42,55,39354,51535,90889
411725,201707,143,110,33,102789,30921,133710
411727,201707,84,70,14,65590,12836.9,78426.9
411729,201707,35,26,9,24362,8433,32795
411730,201707,546,349,197,325451.3,184589,510040.3
411740,201707,29,22,7,20614,6559,27173
411745,201707,68,46,22,42325,20614,62939
411750,201707,828,401,427,374379.9,399419.68,773799.58
411760,201707,1181,891,290,833359.04,271721,1105080.04
411770,201707,418,287,131,268919,122747,391666
411780,201707,361,234,127,219258,118999,338257
411790,201707,520,285,235,266123.17,220083.67,486206.84
411800,201707,168,133,35,124621,32795,157416
411810,201707,155,120,35,112440,32795,145235
411820,201707,2075,1020,1055,953472.56,988132.86,1941605.42
411830,201707,9,9,0,8433,0,8433
411840,201707,1913,1181,732,1105921.6,685396,1791317.6
411845,201707,48,17,31,15929,29047,44976
411850,201707,1223,710,513,662824.74,478762.81,1141587.55
411860,201707,44,29,15,26892,14055,40947
411870,201707,33,26,7,24362,6559,30921
411880,201707,413,270,143,252736,133260.14,385996.14
411885,201707,106,69,37,64653,34669,99322
411890,201707,322,201,121,188337,113368,301705
411900,201707,72,54,18,50598,16866,67464
411910,201707,169,139,30,130233.63,27173,157406.63
411915,201707,2008,869,1139,813121.11,1066472.93,1879594.04
411920,201707,121,102,19,95574,17803,113377
411925,201707,18,12,6,11244,5622,16866
411930,201707,791,583,208,544399,194896,739295
411940,201707,586,419,167,392603,156454.56,549057.56
411950,201707,873,468,405,438506.63,379172.7,817679.33
411960,201707,949,679,270,633892,252990,886882
411965,201707,28,19,9,17803,8433,26236
411970,201707,69,62,7,58094,6559,64653
411980,201707,197,128,69,119936,64653,184589
411990,201707,4746,2792,1954,2599904.18,1828875.4,4428779.58
411995,201707,443,170,273,159290,255801,415091
412000,201707,272,155,117,144533.56,109629,254162.56
412010,201707,43,26,17,24362,15929,40291
412015,201707,43,32,11,29984,10307,40291
412020,201707,30,26,4,24080.9,3748,27828.9
412030,201707,63,53,10,49661,9370,59031
412033,201707,52,34,18,31834,16866,48700
412035,201707,86,54,32,50598,29984,80582
412040,201707,34,24,10,22207,9370,31577
412050,201707,201,149,52,139613,48724,188337
412060,201707,742,585,157,545334.88,146140.9,691475.78
412065,201707,45,32,13,29984,12181,42165
412070,201707,153,106,47,98666.1,44039,142705.1
412080,201707,268,137,131,128369,122747,251116
412085,201707,30,13,17,12181,15929,28110
412090,201707,722,447,275,416919.1,257675,674594.1
412100,201707,238,198,40,184590,37292.6,221882.6
412110,201707,74,61,13,57157,12181,69338
412120,201707,305,199,106,185900.8,99322,285222.8
412125,201707,79,46,33,42820.9,30921,73741.9
412130,201707,52,35,17,32795,15929,48724
412135,201707,26,14,12,13118,11244,24362
412140,201707,291,214,77,200518,72149,272667
412150,201707,256,172,84,160227.62,78708,238935.62
412160,201707,99,61,38,57157,35606,92763
412170,201707,617,446,171,417902,160227,578129
412175,201707,49,37,12,34669,11244,45913
412180,201707,194,154,40,143709.29,37480,181189.29
412190,201707,327,266,61,248581.41,57157,305738.41
412200,201707,190,124,66,116188,61842,178030
412210,201707,96,76,20,71212,18740,89952
412215,201707,234,160,74,149920,69338,219258
412217,201707,89,70,19,65590,17803,83393
412220,201707,807,609,198,570633,185526,756159
412230,201707,331,207,124,191764.67,115828.75,307593.42
412240,201707,1291,625,666,581724.23,620929.71,1202653.94
412250,201707,380,244,136,228628,127432,356060
412260,201707,127,93,34,87141,31858,118999
412265,201707,161,129,32,120873,29984,150857
412270,201707,83,48,35,44976,32795,77771
412280,201707,87,69,18,64653,16866,81519
412290,201707,97,63,34,59031,31858,90889
412300,201707,221,144,77,134928,72149,207077
412310,201707,44,37,7,34669,6559,41228
412320,201707,96,81,15,75897,14055,89952
412330,201707,162,143,19,133991,17803,151794
412340,201707,139,95,44,89015,40947,129962
412350,201707,576,282,294,263250.15,275291,538541.15
412360,201707,26,23,3,21551,2811,24362
412370,201707,163,136,27,126495,25299,151794
412380,201707,257,188,69,175874.9,64128.65,240003.55
412382,201707,53,27,26,25299,24362,49661
412385,201707,134,95,39,89015,36543,125558
412390,201707,267,197,70,184589,65590,250179
412395,201707,63,51,12,47787,11244,59031
412400,201707,67,48,19,44976,17803,62779
412402,201707,236,107,129,100254.32,120591.9,220846.22
412405,201707,800,321,479,299346.01,448345.64,747691.65
412410,201707,922,572,350,534465,327950,862415
412420,201707,17,12,5,11244,4685,15929
412430,201707,20,15,5,14055,4685,18740
412440,201707,576,314,262,291261.87,243539.4,534801.27
412450,201707,83,69,14,64653,13118,77771
412460,201707,77,61,16,57157,14992,72149
412470,201707,258,207,51,193959,47787,241746
412480,201707,175,132,43,122466.5,40291,162757.5
412490,201707,160,136,24,127432,22488,149920
412500,201707,479,385,94,359482,88078,447560
412510,201707,192,155,37,144599,34669,179268
412520,201707,128,71,57,66527,53409,119936
412530,201707,107,58,49,54346,45410.9,99756.9
412535,201707,110,84,26,78690,24353,103043
412540,201707,66,31,35,29047,32795,61842
412545,201707,97,71,26,66527,24362,90889
412550,201707,3406,1562,1844,1460214.57,1726610.45,3186825.02
412555,201707,17,12,5,11244,4685,15929
412560,201707,572,430,142,401599.1,133054,534653.1
412570,201707,736,413,323,386381.32,302370,688751.32
412575,201707,89,63,26,59031,24362,83393
412580,201707,151,105,46,98385,43102,141487
412590,201707,34,31,3,29047,2811,31858
412600,201707,174,135,39,126495,36543,163038
412610,201707,35,22,13,20614,11376,31990
412620,201707,150,132,18,123684,16866,140550
412625,201707,2154,1148,1006,1073907.76,941058.72,2014966.48
412627,201707,65,53,12,49661,11244,60905
412630,201707,430,287,143,268728,133991,402719
412635,201707,63,21,42,19677,39354,59031
412640,201707,118,79,39,74023,36543,110566
412650,201707,331,212,119,198644,111498.32,310142.32
412660,201707,482,286,196,267280,183652,450932
412665,201707,53,47,6,44039,5622,49661
412667,201707,313,205,108,191480.6,100832.04,292312.64
412670,201707,67,56,11,52472,10307,62779
412680,201707,279,224,55,209888,51535,261423
412690,201707,110,73,37,68401,34388,102789
412700,201707,167,115,52,107755,48443,156198
412710,201707,1393,872,521,811443.8,485460.87,1296904.67
412720,201707,225,153,72,143361,67464,210825
412730,201707,204,158,46,148046,42165,190211
412740,201707,403,218,185,204125.45,173345,377470.45
412750,201707,458,262,196,244557,183652,428209
412760,201707,239,121,118,113377,110566,223943
412770,201707,1995,1144,851,1067631.86,797079,1864710.86
412780,201707,149,119,30,111370.88,28110,139480.88
412785,201707,262,133,129,124152.5,120873,245025.5
412788,201707,37,22,15,20614,14055,34669
412790,201707,134,110,24,102414.1,22488,124902.1
412795,201707,159,119,40,111503,37480,148983
412796,201707,301,205,96,190941.83,89820.82,280762.65
412800,201707,547,359,188,335833.36,176147,511980.36
412810,201707,2931,1631,1300,1524667.69,1216596.12,2741263.81
412820,201707,933,613,320,561574.78,296301.21,857875.99
412830,201707,18,14,4,13118,3748,16866
412840,201707,211,151,60,140550.1,56220,196770.1
412850,201707,766,529,237,493799,222069,715868
412853,201707,177,97,80,90889,74960,165849
412855,201707,221,118,103,109192.21,96511,205703.21
412860,201707,90,69,21,64653,19677,84330
412862,201707,66,48,18,44694.9,16866,61560.9
412863,201707,8,7,1,6559,937,7496
412865,201707,45,34,11,31858,10307,42165
412870,201707,108,69,39,64653,36543,101196
412880,201707,130,102,28,95574,26236,121810
420005,201707,36,33,3,30921,2249,33170
420010,201707,363,241,122,224998.67,114305,339303.67
420020,201707,72,61,11,57157,10307,67464
420030,201707,27,25,2,23425,1874,25299
420040,201707,108,82,26,76834,24362,101196
420050,201707,56,33,23,30559.9,21390.34,51950.24
420055,201707,19,18,1,16866,937,17803
420060,201707,35,27,8,25299,7496,32795
420070,201707,96,83,13,77771,12171.63,89942.63
420075,201707,12,10,2,9370,1874,11244
420080,201707,46,40,6,36589.85,5622,42211.85
420090,201707,35,33,2,30157.34,1874,32031.34
420100,201707,153,129,24,119936.1,22488,142424.1
420110,201707,16,16,0,14992,0,14992
420120,201707,43,32,11,29984,10307,40291
420125,201707,85,68,17,63716,15929,79645
420127,201707,32,29,3,27173,2811,29984
420130,201707,355,225,130,210534.63,121800.63,332335.26
420140,201707,1201,702,499,656799.89,467499,1124298.89
420150,201707,46,39,7,36543,6559,43102
420160,201707,42,39,3,36543,2811,39354
420165,201707,17,13,4,12181,3748,15929
420170,201707,63,40,23,37480,21551,59031
420180,201707,23,22,1,20614,937,21551
420190,201707,32,29,3,27173,2811,29984
420195,201707,123,58,65,54346,60624,114970
420200,201707,1255,558,697,517228.1,652444.89,1169672.99
420205,201707,65,31,34,29047,31858,60905
420207,201707,96,55,41,51535,38407.63,89942.63
420208,201707,24,19,5,17803,3841.7,21644.7
420209,201707,19,15,4,14055,3748,17803
420210,201707,452,209,243,195551.9,227607.04,423158.94
420213,201707,48,38,10,35606,9370,44976
420215,201707,25,21,4,19677,3748,23425
420220,201707,70,47,23,44039,21551,65590
420230,201707,706,406,300,379673,281090.63,660763.63
420240,201707,2218,1518,700,1413343.56,655468.98,2068812.54
420243,201707,33,27,6,25299,5622,30921
420245,201707,84,49,35,45913,32795,78708
420250,201707,51,29,22,27173,20614,47787
420253,201707,41,34,7,31858,6559,38417
420257,201707,11,9,2,8433,1874,10307
420260,201707,93,82,11,76834,10307,87141
420270,201707,37,30,7,28105.32,6559,34664.32
420280,201707,271,199,72,185454.08,66228,251682.08
420285,201707,20,13,7,12181,6559,18740
420287,201707,48,29,19,27173,17803,44976
420290,201707,943,663,280,620267.5,262293.2,882560.7
420300,201707,1336,1051,285,981135.2,266108.77,1247243.97
420310,201707,57,43,14,40291,13118,53409
420315,201707,37,33,4,30921,3748,34669
420320,201707,833,422,411,394453.58,385103,779556.58
420325,201707,0,0,0,0,0,0
420330,201707,121,84,37,78708,34669,113377
420340,201707,154,108,46,100251,43073.89,143324.89
420350,201707,232,172,60,159853.1,56220,216073.1
420360,201707,730,553,177,516504.23,164266.09,680770.32
420370,201707,100,68,32,63529,29703,93232
420380,201707,1113,797,316,743033.76,294979.29,1038013.05
420390,201707,255,159,96,147747.06,88312.25,236059.31
420395,201707,170,123,47,115251,44029.63,159280.63
420400,201707,246,181,65,168661,60905,229566
420410,201707,59,46,13,43102,12181,55283
420415,201707,32,29,3,27173,2811,29984
420417,201707,43,33,10,30921,9370,40291
420419,201707,12,11,1,10307,937,11244
420420,201707,2742,1676,1066,1559459.23,996283.37,2555742.60
420425,201707,67,58,9,54337,8124.16,62461.16
420430,201707,1266,877,389,818722.16,362497.19,1181219.35
420435,201707,16,14,2,13118,1874,14992
420440,201707,106,71,35,65887.96,32622.6,98510.56
420445,201707,22,20,2,18740,1874,20614
420450,201707,75,35,40,32766,37480,70246
420455,201707,234,184,50,172380.26,46786.63,219166.89
420460,201707,2258,1523,735,1422392.96,688201.82,2110594.78
420470,201707,120,87,33,81519,30921,112440
420475,201707,6,6,0,5622,0,5622
420480,201707,836,621,215,577455.36,200518.1,777973.46
420490,201707,112,87,25,81519,23425,104944
420500,201707,813,290,523,270076.1,490051,760127.1
420510,201707,20,17,3,15929,2811,18740
420515,201707,23,19,4,17803,3748,21551
420517,201707,9,9,0,8433,0,8433
420519,201707,0,0,0,0,0,0
420520,201707,70,53,17,49661,15929,65590
420530,201707,151,104,47,97448,44039,141487
420535,201707,20,17,3,15929,2811,18740
420540,201707,4359,2591,1768,2418578.15,1652090.69,4070668.84
420543,201707,21,21,0,19677,0,19677
420545,201707,184,131,53,122747,49632.89,172379.89
420550,201707,818,652,166,609378.89,155385.75,764764.64
420555,201707,41,31,10,29047,9370,38417
420560,201707,62,48,14,44601.2,13118,57719.2
420570,201707,128,75,53,69712.8,49651.63,119364.43
420580,201707,292,127,165,118999,154324,273323
420590,201707,498,353,145,330761,135865,466626
420600,201707,92,45,47,42165,44039,86204
420610,201707,35,33,2,30640,1874,32514
420620,201707,70,58,12,54346,11244,65590
420630,201707,146,106,40,99313.32,37476,136789.32
420640,201707,99,88,11,82456,10307,92763
420650,201707,237,128,109,119239.99,101150.46,220390.45
420660,201707,60,43,17,39541.9,15929,55470.9
420665,201707,38,29,9,27173,8433,35606
420670,201707,303,232,71,217374.63,66227.53,283602.16
420675,201707,15,15,0,14055,0,14055
420680,201707,33,24,9,22488,8433,30921
420690,201707,175,147,28,137739,26236,163975
420700,201707,593,418,175,391583.15,163744.82,555327.97
420710,201707,144,84,60,78708,56220,134928
420720,201707,101,83,18,77771,16866,94637
420730,201707,482,311,171,291324.15,158945.49,450269.64
420740,201707,43,42,1,39354,937,40291
420750,201707,483,320,163,299538.79,152731,452269.79
420757,201707,17,14,3,12321.55,2811,15132.55
420760,201707,37,29,8,27173,7496,34669
420765,201707,67,56,11,52472,10307,62779
420768,201707,66,59,7,55283,6559,61842
420770,201707,82,69,13,64653,12181,76834
420775,201707,46,42,4,38417,3748,42165
420780,201707,224,175,49,163975,45913,209888
420785,201707,13,9,4,8433,3748,12181
420790,201707,171,144,27,134592.9,24334.63,158927.53
420800,201707,73,54,19,49848.4,17803,67651.4
420810,201707,241,207,34,193950,31061.55,225011.55
420820,201707,2321,1383,938,1288346.56,877397.93,2165744.49
420830,201707,514,297,217,276844.09,202382.63,479226.72
420840,201707,134,103,31,96511,29047,125558
420845,201707,441,196,245,182992.93,228347,411339.93
420850,201707,225,181,44,169597,41228,210825
420860,201707,59,50,9,46850,8433,55283
420870,201707,111,82,29,76834,27173,104007
420880,201707,163,111,52,103341.73,48724,152065.73
420890,201707,840,415,425,385865.67,398216,784081.67
420895,201707,10,10,0,9370,0,9370
420900,201707,388,299,89,278421.22,83365.63,361786.85
420910,201707,5655,3114,2541,2911284.6,2379392.02,5290676.62
420915,201707,80,74,6,69338,5622,74960
420917,201707,18,13,5,12181,4685,16866
420920,201707,21,14,7,13118,6559,19677
420930,201707,2554,1536,1018,1431406.14,946812.09,2378218.23
420940,201707,581,427,154,399800,142674.24,542474.24
420945,201707,8,6,2,5622,1874,7496
420950,201707,56,51,5,47787,4685,52472
420960,201707,113,88,25,82419.26,23416,105835.26
420970,201707,297,241,56,224170.45,52444.63,276615.08
420980,201707,25,24,1,22488,937,23425
420985,201707,59,52,7,48724,6559,55283
420990,201707,69,53,16,49661,14992,64653
421000,201707,35,22,13,20614,12181,32795
421003,201707,66,41,25,38417,23416,61833
421005,201707,8,5,3,4685,2811,7496
421010,201707,744,521,223,488067.78,206897.39,694965.17
421020,201707,27,24,3,22468,2811,25279
421030,201707,125,104,21,97121,19677,116798
421040,201707,57,50,7,46850,6559,53409
421050,201707,288,203,85,188150.1,79645,267795.1
421055,201707,27,23,4,21551,3748,25299
421060,201707,84,58,26,54346,24362,78708
421070,201707,49,45,4,42165,3748,45913
421080,201707,32,30,2,28110,1874,29984
421085,201707,24,19,5,17803,4685,22488
421090,201707,43,33,10,30921,9370,40291
421100,201707,117,87,30,81519,28110,109629
421105,201707,205,164,41,153528,38393.95,191921.95
421110,201707,109,92,17,85594.95,15929,101523.95
421120,201707,153,120,33,111953.13,30902.26,142855.39
421125,201707,16,11,5,10307,4685,14992
421130,201707,788,504,284,471117.91,265086.87,736204.78
421140,201707,30,21,9,18974.25,8433,27407.25
421145,201707,39,32,7,29984,6559,36543
421150,201707,106,77,29,72149,27173,99322
421160,201707,59,40,19,37470.63,17803,55273.63
421165,201707,18,17,1,15929,937,16866
421170,201707,184,159,25,148263.89,23416,171679.89
421175,201707,148,97,51,90889,47731.52,138620.52
421180,201707,57,35,22,32439,20614,53053
421185,201707,16,13,3,12181,2811,14992
421187,201707,0,0,0,0,0,0
421189,201707,37,30,7,28110,6549.63,34659.63
421190,201707,1370,841,529,787268,494988.99,1282256.99
421200,201707,88,68,20,62499,18740,81239
421205,201707,23,15,8,14055,7486.63,21541.63
421210,201707,174,117,57,109629,53409,163038
421220,201707,262,210,52,195919.95,48724,244643.95
421223,201707,57,47,10,44039,9370,53409
421225,201707,56,41,15,38417,14055,52472
421227,201707,91,68,23,63716,21551,85267
421230,201707,45,33,12,30921,11244,42165
421240,201707,19,19,0,17803,0,17803
421250,201707,356,216,140,202299,130402.29,332701.29
421260,201707,28,22,6,20614,5622,26236
421265,201707,0,0,0,0,0,0
421270,201707,53,48,5,44976,4685,49661
421280,201707,337,196,141,183652,130430.4,314082.4
421290,201707,300,204,96,190914,88565.56,279479.56
421300,201707,28,23,5,21551,4685,26236
421310,201707,54,40,14,36824.1,13118,49942.1
421315,201707,29,19,10,17803,9370,27173
421320,201707,124,89,35,83393,32795,116188
421330,201707,113,85,28,77451.45,26227,103678.45
421335,201707,40,26,14,24362,13118,37480
421340,201707,283,187,96,173204.5,89952,263156.5
421350,201707,161,95,66,88580,61842,150422
421360,201707,678,501,177,464087.58,165643.63,629731.21
421370,201707,182,139,43,130243,39963.05,170206.05
421380,201707,123,103,20,96506.32,18740,115246.32
421390,201707,17,14,3,13118,2811,15929
421400,201707,116,98,18,91826,16866,108692
421410,201707,22,18,4,16866,3748,20614
421415,201707,19,16,3,14992,2811,17803
421420,201707,154,128,26,119373.8,24362,143735.8
421430,201707,14,11,3,10307,2811,13118
421440,201707,58,46,12,43102,11244,54346
421450,201707,101,89,12,83393,11244,94637
421460,201707,60,51,9,46997.1,8433,55430.1
421470,201707,72,46,26,43102,24362,67464
421480,201707,622,464,158,434299.5,148046,582345.5
421490,201707,24,22,2,19950,1874,21824
421500,201707,508,328,180,304962.51,167821.69,472784.20
421505,201707,25,18,7,16866,6559,23425
421507,201707,31,26,5,24362,4685,29047
421510,201707,72,48,24,44976,22488,67464
421520,201707,67,57,10,52660,9370,62030
421530,201707,54,48,6,44320.1,5622,49942.1
421535,201707,31,30,1,27848,937,28785
421540,201707,59,53,6,49661,5622,55283
421545,201707,93,72,21,66987,19677,86664
421550,201707,275,198,77,184871,72149,257020
421555,201707,23,19,4,17803,3748,21551
421560,201707,8,8,0,7496,0,7496
421565,201707,119,90,29,84330,27173,111503
421567,201707,28,22,6,20614,5622,26236
421568,201707,33,31,2,29047,1874,30921
421569,201707,9,8,1,7496,937,8433
421570,201707,133,89,44,83393,41228,124621
421575,201707,27,22,5,20356.33,4685,25041.33
421580,201707,709,422,287,395414,267982.27,663396.27
421590,201707,21,20,1,18740,937,19677
421600,201707,110,74,36,69318,32796,102114
421605,201707,100,70,30,65263,28110,93373
421610,201707,190,147,43,137739,40291,178030
421620,201707,1113,670,443,625335.76,415052.52,1040388.28
421625,201707,21,18,3,16866,2811,19677
421630,201707,264,169,95,158119.6,88172,246291.6
421635,201707,18,8,10,7496,9370,16866
421640,201707,95,84,11,78708,10307,89015
421650,201707,268,156,112,146153.26,104925.26,251078.52
421660,201707,2041,1211,830,1132524.86,776464.16,1908989.02
421670,201707,170,128,42,119936,39354,159290
421680,201707,168,153,15,143361,14046,157407
421690,201707,342,240,102,224299.8,94627.99,318927.79
421700,201707,53,34,19,31858,16960,48818
421710,201707,22,22,0,20614,0,20614
421715,201707,9,8,1,7496,937,8433
421720,201707,553,395,158,368117.3,146350.54,514467.84
421725,201707,12,6,6,5622,5622,11244
421730,201707,40,29,11,26455.48,10307,36762.48
421740,201707,83,40,43,37480,40291,77771
421750,201707,216,157,59,144767.5,55283,200050.5
421755,201707,26,24,2,22488,1874,24362
421760,201707,107,76,31,71202.63,29047,100249.63
421770,201707,539,372,167,347500.52,156414.15,503914.67
421775,201707,23,15,8,14055,7496,21551
421780,201707,184,144,40,134646.9,37480,172126.9
421790,201707,156,129,27,120873,25299,146172
421795,201707,14,12,2,11244,1874,13118
421800,201707,436,280,156,260640.61,146167.32,406807.93
421810,201707,69,55,14,51535,13118,64653
421820,201707,300,204,96,190183.1,89952,280135.1
421825,201707,130,107,23,100259,21551,121810
421830,201707,129,99,30,92763,28110,120873
421835,201707,3,3,0,2811,0,2811
421840,201707,61,52,9,48715,8433,57148
421850,201707,78,69,9,64653,8429,73082
421860,201707,42,32,10,29702.9,9370,39072.9
421870,201707,960,723,237,669219.5,221203.59,890423.09
421875,201707,50,44,6,41228,5622,46850
421880,201707,165,118,47,110566,43758,154324
421885,201707,27,22,5,20614,4404,25018
421890,201707,113,77,36,72149,33732,105881
421895,201707,38,36,2,33732,1874,35606
421900,201707,148,119,29,111429.15,27128,138557.15
421910,201707,63,43,20,40291,18740,59031
421915,201707,31,25,6,23425,5622,29047
421917,201707,37,26,11,24081,10307,34388
421920,201707,33,30,3,28110,2811,30921
421930,201707,749,578,171,540592.78,160190.63,700783.41
421935,201707,57,50,7,46850,6559,53409
421940,201707,41,38,3,35606,2811,38417
421950,201707,819,534,285,494363.33,264428.52,758791.85
421960,201707,39,35,4,32514,3748,36262
421970,201707,363,232,131,216894.12,122696.01,339590.13
421985,201707,28,20,8,18740,7496,26236
422000,201707,0,0,0,0,0,0
430003,201707,211,47,164,43336.25,153668,197004.25
430005,201707,33,26,7,24362,6559,30921
430010,201707,279,197,82,184120.5,76834,260954.5
430020,201707,155,99,56,92482,51535,144017
430030,201707,123,95,28,89015,26236,115251
430040,201707,2973,1716,1257,1599367.8,1176235.68,2775603.48
430045,201707,68,58,10,54346,9370,63716
430047,201707,7,6,1,5622,937,6559
430050,201707,78,66,12,61842,11244,73086
430055,201707,17,14,3,13118,2811,15929
430057,201707,4,2,2,1874,1874,3748
430060,201707,3703,2182,1521,2037091.31,1421351.79,3458443.10
430063,201707,57,50,7,46850,6559,53409
430064,201707,141,119,22,111503,20614,132117
430066,201707,10,7,3,6559,2811,9370
430070,201707,49,37,12,34669,11244,45913
430080,201707,68,47,21,43351.8,19677,63028.8
430085,201707,37,10,27,9370,25299,34669
430087,201707,39,28,11,26096,10307,36403
430090,201707,69,63,6,58517.81,5622,64139.81
430100,201707,110,74,36,69338,33732,103070
430105,201707,143,72,71,67464,66227.16,133691.16
430107,201707,20,14,6,13118,5622,18740
430110,201707,400,235,165,219398.55,154539.41,373937.96
430120,201707,139,126,13,117125.95,12181,129306.95
430130,201707,776,486,290,454772.95,271448.9,726221.85
430140,201707,125,116,9,108692,8433,117125
430150,201707,107,72,35,66715,31658.65,98373.65
430155,201707,29,28,1,26236,937,27173
430160,201707,3793,2243,1550,2084218.25,1448349.11,3532567.36
430163,201707,316,137,179,127254.94,167666.78,294921.72
430165,201707,22,16,6,14992,5622,20614
430170,201707,79,73,6,68401,5622,74023
430175,201707,80,61,19,57157,17147.1,74304.1
430180,201707,93,74,19,69338,17193.95,86531.95
430185,201707,32,24,8,22488,7496,29984
430187,201707,107,44,63,41228,58731.9,99959.9
430190,201707,224,128,96,119889.15,89286.73,209175.88
430192,201707,14,14,0,13118,0,13118
430195,201707,12,8,4,7496,3748,11244
430200,201707,161,140,21,130524.1,19677,150201.1
430205,201707,19,18,1,16866,937,17803
430210,201707,590,449,141,417620.9,130852.15,548473.05
430215,201707,17,14,3,13118,2811,15929
430220,201707,60,42,18,39354,16866,56220
430222,201707,14,7,7,6559,6559,13118
430223,201707,13,7,6,6559,5622,12181
430225,201707,4,3,1,2811,937,3748
430230,201707,294,184,110,171471,103070,274541
430235,201707,47,34,13,31858,12171.63,44029.63
430237,201707,28,22,6,20614,5622,26236
430240,201707,128,78,50,73086,46840.63,119926.63
430245,201707,69,57,12,53409,11244,64653
430250,201707,195,114,81,106808.63,75887.63,182696.26
430258,201707,14,12,2,11244,1874,13118
430260,201707,38,33,5,30921,3879.18,34800.18
430265,201707,35,28,7,26217.26,6559,32776.26
430270,201707,582,430,152,398646.67,140644.81,539291.48
430280,201707,1017,636,381,592268.33,354542.8,946811.13
430290,201707,375,219,156,203329.4,146172,349501.4
430300,201707,2086,1140,946,1062494.86,883405.67,1945900.53
430310,201707,1981,1032,949,961187,886857.11,1848044.11
430320,201707,47,39,8,36528.95,7496,44024.95
430330,201707,95,86,9,80113.5,8433,88546.5
430340,201707,67,59,8,55283,7496,62779
430350,201707,1652,1154,498,1070007.38,465183.76,1535191.14
430355,201707,27,24,3,22488,2811,25299
430360,201707,80,37,43,34669,39354.1,74023.1
430367,201707,30,20,10,18740,8592.29,27332.29
430370,201707,55,49,6,45913,5622,51535
430380,201707,123,92,31,85641.8,29047,114688.8
430390,201707,605,377,228,352967.9,213336.63,566304.53
430400,201707,134,102,32,93887.4,29965.26,123852.66
430410,201707,55,44,11,41228,10307,51535
430420,201707,477,315,162,292439.7,149574.58,442014.28
430430,201707,51,49,2,45288.95,1874,47162.95
430435,201707,146,108,38,100914.9,34903.25,135818.15
430440,201707,507,340,167,318580,156291.6,474871.6
430450,201707,1163,958,205,891182.27,192075.63,1083257.90
430460,201707,5096,2764,2332,2574000.57,2177397.34,4751397.91
430461,201707,18,16,2,14992,1874,16866
430462,201707,11,7,4,6559,3748,10307
430463,201707,982,513,469,478011.39,439107.05,917118.44
430465,201707,29,17,12,15929,11244,27173
430466,201707,639,459,180,428209.1,168472.6,596681.7
430467,201707,94,55,39,51535,36533.63,88068.63
430468,201707,112,67,45,62779,41918.39,104697.39
430469,201707,22,16,6,14992,5622,20614
430470,201707,1164,647,517,598372.37,482508.15,1080880.52
430471,201707,48,35,13,32776.26,12181,44957.26
430480,201707,96,61,35,56313.7,32785.63,89099.33
430485,201707,5,5,0,4404,0,4404
430490,201707,95,76,19,70780.98,17803,88583.98
430495,201707,33,27,6,25299,5622,30921
430500,201707,191,130,61,121107.25,56787.63,177894.88
430510,201707,2972,1969,1003,1839641.35,939221.06,2778862.41
430511,201707,19,19,0,17803,0,17803
430512,201707,136,90,46,84330,43102,127432
430513,201707,54,48,6,44507.5,5622,50129.5
430515,201707,30,28,2,26236,1874,28110
430517,201707,170,150,20,139613.25,18721.26,158334.51
430520,201707,361,246,115,229847,107726.89,337573.89
430530,201707,91,50,41,46850,38417,85267
430535,201707,464,304,160,284628.49,149915.32,434543.81
430537,201707,13,13,0,12181,0,12181
430540,201707,74,47,27,44039,25299,69338
430543,201707,373,115,258,107755,241231,348986
430544,201707,45,40,5,37480,4685,42165
430545,201707,335,150,185,140484.41,172857.76,313342.17
430550,201707,44,36,8,33732,7496,41228
430558,201707,6,4,2,3748,1874,5622
430560,201707,47,19,28,17803,26236,44039
430570,201707,99,45,54,42165,50541.78,92706.78
430580,201707,122,95,27,89015,25252.15,114267.15
430583,201707,14,14,0,13118,0,13118
430585,201707,8,4,4,3748,3748,7496
430587,201707,14,8,6,7496,5622,13118
430590,201707,152,126,26,116843.9,24362,141205.9
430593,201707,4,4,0,3748,0,3748
430595,201707,14,9,5,8433,4685,13118
430597,201707,54,30,24,28110,22488,50598
430600,201707,217,145,72,135855.63,67182.9,203038.53
430605,201707,152,94,58,88078,54336.63,142414.63
430607,201707,26,21,5,19677,4685,24362
430610,201707,1610,744,866,692724.95,806532.49,1499257.44
430613,201707,2,2,0,1874,0,1874
430620,201707,109,79,30,73883,28100.63,101983.63
430630,201707,48,43,5,40291,4685,44976
430632,201707,32,28,4,26236,3748,29984
430635,201707,38,35,3,32795,2811,35606
430637,201707,56,31,25,29047,23425,52472
430640,201707,212,117,95,108785.7,89015,197800.7
430642,201707,27,25,2,23425,1874,25299
430645,201707,30,26,4,24362,3748,28110
430650,201707,250,198,52,185245,48677.15,233922.15
430655,201707,7,7,0,6559,0,6559
430660,201707,952,460,492,429473.95,458792.78,888266.73
430670,201707,71,51,20,47787,18740,66527
430673,201707,72,41,31,38417,29047,67464
430675,201707,13,10,3,9370,2811,12181
430676,201707,456,271,185,253252.36,173274.84,426527.20
430680,201707,243,168,75,155261,70275,225536
430690,201707,517,313,204,292409.59,189521.01,481930.60
430692,201707,7,5,2,4685,1874,6559
430693,201707,130,86,44,80582,40609.58,121191.58
430695,201707,71,64,7,59049.74,6559,65608.74
430697,201707,63,37,26,34669,24362,59031
430700,201707,1565,1093,472,1015399.55,442264,1457663.55
430705,201707,19,18,1,16866,937,17803
430710,201707,259,166,93,155542,87141,242683
430720,201707,110,94,16,87890.6,14992,102882.6
430730,201707,121,104,17,96511,15929,112440
430740,201707,56,39,17,36543,15929,52472
430745,201707,38,29,9,27173,8433,35606
430750,201707,338,233,105,217448.72,97448,314896.72
430755,201707,77,41,36,38417,33732,72149
430760,201707,358,217,141,200097.11,132089.26,332186.37
430770,201707,1450,747,703,697868.33,654324.19,1352192.52
430780,201707,314,199,115,185517.9,107689.78,293207.68
430781,201707,28,24,4,22488,3748,26236
430783,201707,43,35,8,32482.8,7496,39978.8
430786,201707,6,3,3,2811,2811,5622
430790,201707,468,305,163,284004.7,152440.63,436445.33
430800,201707,151,126,25,118062,23425,141487
430805,201707,42,38,4,35606,3748,39354
430807,201707,33,21,12,19677,11244,30921
430810,201707,68,43,25,40291,23425,63716
430820,201707,131,79,52,74023,48068.1,122091.1
430825,201707,11,9,2,8433,1874,10307
430830,201707,222,207,15,193678,14055,207733
430840,201707,118,77,41,72149,37761.1,109910.1
430843,201707,5,3,2,2811,1874,4685
430845,201707,70,40,30,37480,28110,65590
430850,201707,573,391,182,365988.09,170395.67,536383.76
430860,201707,157,99,58,91451.2,53680.73,145131.93
430865,201707,64,30,34,27454.1,31548.79,59002.89
430870,201707,76,61,15,57157,14055,71212
430880,201707,154,116,38,108692,35606,144298
430885,201707,7,6,1,5622,937,6559
430890,201707,334,206,128,191391.94,119936,311327.94
430900,201707,545,372,173,344441.7,161623.13,506064.83
430905,201707,81,33,48,30921,44976,75897
430910,201707,267,150,117,140550,108028,248578
430912,201707,7,7,0,6559,0,6559
430915,201707,30,22,8,20614,7214.9,27828.9
430920,201707,4004,2228,1776,2082034.85,1662054.31,3744089.16
430925,201707,6,5,1,4441.38,937,5378.38
430930,201707,2072,1239,833,1152148.25,778407.46,1930555.71
430940,201707,227,144,83,133981.63,77752.26,211733.89
430950,201707,161,129,32,120873,29702.9,150575.9
430955,201707,20,13,7,12181,6559,18740
430957,201707,17,16,1,14992,937,15929
430960,201707,241,158,83,146312.55,77771,224083.55
430965,201707,98,61,37,57157,34669,91826
430970,201707,81,68,13,63716,11244,74960
430975,201707,33,31,2,29047,1874,30921
430980,201707,44,27,17,25299,15929,41228
430990,201707,110,83,27,77771,25299,103070
430995,201707,112,108,4,100259,3748,104007
431000,201707,299,137,162,127143.1,151794,278937.1
431010,201707,340,205,135,191119.89,126495,317614.89
431020,201707,1922,1104,818,1027911.99,763364.53,1791276.52
431030,201707,41,33,8,30921,7496,38417
431033,201707,377,189,188,176296.6,176156,352452.6
431036,201707,15,10,5,9370,4685,14055
431040,201707,135,81,54,74960,50490.25,125450.25
431041,201707,38,26,12,24362,11244,35606
431043,201707,42,24,18,22488,16866,39354
431046,201707,12,7,5,6559,4685,11244
431050,201707,214,134,80,123175.06,73473.4,196648.46
431053,201707,68,41,27,37667.4,25299,62966.4
431055,201707,64,41,23,38417,21532.26,59949.26
431057,201707,17,17,0,15929,0,15929
431060,201707,1686,1053,633,979680.93,591365.91,1571046.84
431065,201707,16,10,6,9370,5622,14992
431070,201707,69,65,4,60905,3748,64653
431075,201707,9,9,0,8433,0,8433
431080,201707,138,90,48,84048.9,44976,129024.9
431085,201707,29,26,3,24362,2811,27173
431087,201707,15,13,2,12181,1874,14055
431090,201707,55,44,11,41228,10307,51535
431100,201707,1234,736,498,680263.71,466626,1146889.71
431110,201707,245,152,93,142424,87131.63,229555.63
431112,201707,30,18,12,16866,11244,28110
431113,201707,30,20,10,18740,9370,28110
431115,201707,156,105,51,97760.2,47777.63,145537.83
431120,201707,611,360,251,335409.42,235113.52,570522.94
431123,201707,3,2,1,1874,937,2811
431125,201707,91,81,10,75897,9370,85267
431127,201707,7,3,4,2811,3748,6559
431130,201707,609,399,210,372644.9,196470.16,569115.06
431140,201707,704,473,231,438542.68,216372.04,654914.72
431142,201707,32,25,7,22235,6559,28794
431150,201707,204,151,53,141487,49642.26,191129.26
431160,201707,57,51,6,47787,5622,53409
431162,201707,20,14,6,13118,5622,18740
431164,201707,5,5,0,4685,0,4685
431170,201707,102,84,18,78708,16866,95574
431171,201707,49,26,23,24362,21541.63,45903.63
431173,201707,1,1,0,937,0,937
431175,201707,199,95,104,87797,97448,185245
431177,201707,71,54,17,50598,15910.26,66508.26
431179,201707,14,12,2,11244,1874,13118
431180,201707,433,263,170,245494,159271.63,404765.63
431190,201707,89,69,20,64653,18740,83393
431198,201707,67,44,23,41228,21551,62779
431200,201707,18,16,2,14992,1874,16866
431205,201707,25,25,0,23425,0,23425
431210,201707,83,52,31,48397,29047,77444
431213,201707,24,20,4,18740,3748,22488
431215,201707,27,24,3,22488,2811,25299
431217,201707,6,5,1,4685,937,5622
431220,201707,63,54,9,50598,8433,59031
431225,201707,147,97,50,90880,46840.63,137720.63
431230,201707,100,85,15,78989.1,14055,93044.1
431235,201707,7,7,0,6559,0,6559
431237,201707,24,16,8,14992,7496,22488
431238,201707,15,11,4,10026,3748,13774
431240,201707,968,615,353,574644.16,329984.21,904628.37
431242,201707,36,36,0,33732,0,33732
431244,201707,10,7,3,6559,2811,9370
431245,201707,62,47,15,44039,14055,58094
431247,201707,13,9,4,8433,3748,12181
431250,201707,267,135,132,126429.41,123001.26,249430.67
431260,201707,61,45,16,42165,14992,57157
431261,201707,22,15,7,14055,6559,20614
431262,201707,16,16,0,14992,0,14992
431265,201707,167,88,79,82456,74023,156479
431267,201707,15,14,1,13118,937,14055
431270,201707,303,250,53,234250,49661,283911
431275,201707,41,39,2,36543,1874,38417
431280,201707,22,17,5,15109.12,4685,19794.12
431290,201707,22,19,3,17803,2811,20614
431295,201707,5,5,0,4685,0,4685
431300,201707,23,20,3,18740,2811,21551
431301,201707,8,8,0,7496,0,7496
431303,201707,48,34,14,31736.19,12836.9,44573.09
431306,201707,209,111,98,103559.11,91826,195385.11
431308,201707,6,5,1,4685,937,5622
431310,201707,66,57,9,53409,8433,61842
431320,201707,118,72,46,67464,43092.63,110556.63
431330,201707,176,117,59,109629,55283,164912
431333,201707,32,26,6,24362,5622,29984
431335,201707,10,5,5,4685,4685,9370
431337,201707,312,150,162,139736.1,151719.04,291455.14
431339,201707,15,12,3,11244,2811,14055
431340,201707,3010,1707,1303,1595301.78,1218972.26,2814274.04
431342,201707,43,26,17,24362,15929,40291
431344,201707,17,17,0,15929,0,15929
431346,201707,4,4,0,3748,0,3748
431349,201707,37,34,3,31858,2811,34669
431350,201707,897,525,372,487457.73,347589.52,835047.25
431360,201707,42,38,4,35606,3748,39354
431365,201707,306,142,164,133035.26,153658.63,286693.89
431370,201707,1297,775,522,722494.49,488919.82,1211414.31
431380,201707,99,82,17,76178.1,15929,92107.1
431390,201707,486,272,214,253927.1,199610.01,453537.11
431395,201707,273,120,153,112440,143343,255783
431400,201707,36,28,8,26236,7496,33732
431402,201707,89,62,27,58094,25299,83393
431403,201707,13,8,5,7496,4685,12181
431405,201707,650,352,298,328727.81,279199,607926.81
431406,201707,29,25,4,23425,3748,27173
431407,201707,51,45,6,42165,5622,47787
431410,201707,3101,1822,1279,1695524.79,1197186.16,2892710.95
431413,201707,16,14,2,13118,1874,14992
431415,201707,70,51,19,47787,17803,65590
431417,201707,23,12,11,11244,10307,21551
431420,201707,291,207,84,193334.3,78698.63,272032.93
431430,201707,40,15,25,14055,23425,37480
431440,201707,8845,6302,2543,5842969.75,2374991.73,8217961.48
431442,201707,28,15,13,14055,12181,26236
431445,201707,26,20,6,18740,5622,24362
431446,201707,8,7,1,6559,937,7496
431447,201707,85,58,27,54346,25299,79645
431449,201707,47,44,3,41228,2811,44039
431450,201707,402,285,117,265311.55,108926.25,374237.80
431454,201707,0,0,0,0,0,0
431455,201707,47,36,11,33732,10307,44039
431460,201707,522,357,165,330948.4,154183.9,485132.3
431470,201707,123,95,28,88335.86,26236,114571.86
431475,201707,11,10,1,9370,937,10307
431477,201707,34,24,10,22488,9370,31858
431478,201707,6,5,1,4685,937,5622
431480,201707,488,308,180,287013.41,168332.05,455345.46
431490,201707,28169,15897,12272,14825143.32,11466099.88,26291243.20
431500,201707,78,55,23,51535,21551,73086
431505,201707,45,18,27,16866,25299,42165
431507,201707,8,7,1,6559,937,7496
431510,201707,282,178,104,166083.9,95555.26,261639.16
431513,201707,24,18,6,16866,5622,22488
431514,201707,8,7,1,6559,937,7496
431515,201707,76,65,11,60905,10307,71212
431517,201707,3,1,2,937,1874,2811
431520,201707,35,32,3,29984,2811,32795
431530,201707,1614,714,900,667708.42,842845.67,1510554.09
431531,201707,22,20,2,18740,1874,20614
431532,201707,24,17,7,15929,6559,22488
431535,201707,25,15,10,14055,9370,23425
431540,201707,145,130,15,120526.31,14055,134581.31
431545,201707,17,15,2,14055,1874,15929
431550,201707,339,195,144,182715,134834.3,317549.3
431555,201707,12,11,1,10307,937,11244
431560,201707,4269,3009,1260,2791411.57,1178388.65,3969800.22
431570,201707,757,398,359,369834.1,333498.04,703332.14
431575,201707,36,26,10,24362,9370,33732
431580,201707,93,64,29,59031,27173,86204
431590,201707,131,109,22,101196,20614,121810
431595,201707,12,11,1,10307,937,11244
431600,201707,211,119,92,111503,86204,197707
431610,201707,125,91,34,84611.1,31858,116469.1
431620,201707,42,34,8,31858,7496,39354
431630,201707,125,108,17,101196,15929,117125
431640,201707,1314,828,486,772369.1,454764.32,1227133.42
431642,201707,44,40,4,37011.5,3748,40759.5
431643,201707,48,21,27,19677,25299,44976
431645,201707,304,173,131,162101,121810,283911
431647,201707,11,11,0,10307,0,10307
431650,201707,35,25,10,23425,9370,32795
431660,201707,272,177,95,163694.84,89015,252709.84
431670,201707,213,102,111,92997.25,103978.89,196976.14
431673,201707,3,3,0,2811,0,2811
431675,201707,29,25,4,23143.9,3748,26891.9
431680,201707,1067,760,307,708372,287397.38,995769.38
431690,201707,4715,2875,1840,2677106.93,1718666.89,4395773.82
431695,201707,26,20,6,18740,5622,24362
431697,201707,0,0,0,0,0,0
431700,201707,167,124,43,116188,40291,156479
431710,201707,3952,1698,2254,1589330.5,2110587.45,3699917.95
431720,201707,1390,818,572,758726.39,534076.63,1292803.02
431725,201707,1,1,0,937,0,937
431730,201707,1166,776,390,722147.1,365430,1087577.1
431740,201707,1355,671,684,624193.26,640357.12,1264550.38
431750,201707,1861,1202,659,1116301.57,614925.36,1731226.93
431755,201707,5,4,1,3748,937,4685
431760,201707,1081,688,393,644281.2,368016.49,1012297.69
431770,201707,389,286,103,267972.63,96492.26,364464.89
431775,201707,27,21,6,19677,5622,25299
431780,201707,561,345,216,322271.78,202382.63,524654.41
431790,201707,144,108,36,100259,33685.15,133944.15
431795,201707,13,12,1,11244,937,12181
431800,201707,3396,1771,1625,1645208.83,1515973.85,3161182.68
431805,201707,17,15,2,14055,1874,15929
431810,201707,617,414,203,386268.88,190098.93,576367.81
431820,201707,314,176,138,164912,128322.15,293234.15
431830,201707,2316,1403,913,1311256.05,854247.39,2165503.44
431840,201707,503,332,171,307525.65,159009,466534.65
431842,201707,33,27,6,25299,5622,30921
431843,201707,10,6,4,5622,3748,9370
431844,201707,15,13,2,12181,1874,14055
431845,201707,28,26,2,24362,1874,26236
431846,201707,30,26,4,24362,3748,28110
431848,201707,13,11,2,10307,1874,12181
431849,201707,8,6,2,5622,1874,7496
431850,201707,789,654,135,611571,126260.75,737831.75
431860,201707,101,72,29,67464,26236,93700
431861,201707,4,2,2,1874,1874,3748
431862,201707,48,33,15,30921,14055,44976
431870,201707,3429,2014,1415,1878258.13,1324556.01,3202814.14
431880,201707,907,666,241,619329,224880,844209
431890,201707,1301,800,501,744257.72,467859,1212116.72
431900,201707,174,123,51,115251,47787,163038
431910,201707,55,41,14,38417,13118,51535
431912,201707,34,19,15,17803,14055,31858
431915,201707,125,101,24,94637,22488,117125
431920,201707,144,107,37,100259,34669,134928
431930,201707,82,64,18,59968,16866,76834
431935,201707,4,3,1,2811,937,3748
431936,201707,12,11,1,10307,937,11244
431937,201707,16,11,5,10307,4685,14992
431940,201707,441,291,150,269996.55,140540.63,410537.18
431950,201707,457,292,165,272405.01,153040.95,425445.96
431960,201707,710,427,283,396006.42,265012.45,661018.87
431970,201707,73,65,8,60905,7496,68401
431971,201707,4,4,0,3748,0,3748
431973,201707,16,13,3,12181,2811,14992
431975,201707,6,5,1,4685,937,5622
431980,201707,200,127,73,117499.8,68401,185900.8
431990,201707,1231,660,571,616973.09,534708.9,1151681.99
432000,201707,1652,881,771,818860.07,719583.12,1538443.19
432010,201707,277,183,94,170378.3,88078,258456.3
432020,201707,166,130,36,121810,33722.63,155532.63
432023,201707,20,16,4,14992,3748,18740
432026,201707,64,57,7,53409,6559,59968
432030,201707,59,31,28,29047,26236,55283
432032,201707,21,18,3,16866,2811,19677
432035,201707,44,36,8,33732,7496,41228
432040,201707,96,66,30,61842,28110,89952
432045,201707,8,7,1,6277.9,937,7214.9
432050,201707,66,39,27,36543,25299,61842
432055,201707,100,77,23,72130.26,21551,93681.26
432057,201707,1,0,1,0,937,937
432060,201707,35,33,2,30218.25,1874,32092.25
432065,201707,30,27,3,25280.26,2811,28091.26
432067,201707,94,82,12,76834,11244,88078
432070,201707,399,299,100,278590.29,93672.26,372262.55
432080,201707,812,556,256,520035,239825.89,759860.89
432085,201707,14,11,3,10307,2811,13118
432090,201707,260,168,92,157416,86204,243620
432100,201707,172,112,60,104662.9,56220,160882.9
432110,201707,599,409,190,376271.66,177093,553364.66
432120,201707,962,569,393,532216.1,368203.52,900419.62
432130,201707,497,360,137,336383,128228.45,464611.45
432132,201707,26,22,4,20614,3748,24362
432135,201707,75,64,11,59968,10307,70275
432140,201707,267,207,60,193387.43,56220,249607.43
432143,201707,178,111,67,104007,62779,166786
432145,201707,259,176,83,163694.8,77489.9,241184.7
432146,201707,15,14,1,13118,937,14055
432147,201707,170,60,110,56220,103051.26,159271.26
432149,201707,17,12,5,11244,4685,15929
432150,201707,823,522,301,487942.75,279396.03,767338.78
432160,201707,1388,717,671,670181.25,627856.56,1298037.81
432162,201707,4,3,1,2811,937,3748
432163,201707,18,14,4,13118,3748,16866
432166,201707,125,93,32,87376,29984,117360
432170,201707,227,124,103,114596,96511,211107
432180,201707,518,310,208,288780.8,194615,483395.8
432183,201707,8,6,2,5622,1874,7496
432185,201707,78,65,13,60811.3,12181,72992.3
432190,201707,491,257,234,239666.63,219099.45,458766.08
432195,201707,84,73,11,67698.25,10307,78005.25
432200,201707,400,252,148,236124,138583.52,374707.52
432210,201707,113,75,38,68260.45,35606,103866.45
432215,201707,63,59,4,55283,3748,59031
432218,201707,19,18,1,16866,937,17803
432220,201707,666,337,329,314768.05,307773.97,622542.02
432225,201707,16,10,6,8901.5,5622,14523.5
432230,201707,161,91,70,85032.75,65590,150622.75
432232,201707,14,12,2,11244,1874,13118
432234,201707,5,4,1,3748,937,4685
432235,201707,1,1,0,937,0,937
432237,201707,28,16,12,14992,11244,26236
432240,201707,4119,2292,1827,2137181.86,1704778.4,3841960.26
432250,201707,1007,620,387,578083.28,361522.71,939605.99
432252,201707,38,31,7,28316.14,6559,34875.14
432253,201707,57,45,12,42165,11244,53409
432254,201707,19,7,12,6559,11244,17803
432255,201707,13,12,1,11244,937,12181
432260,201707,840,656,184,613688.25,171471.75,785160.00
432270,201707,218,160,58,149920,54346,204266
432280,201707,121,87,34,81030.9,31858,112888.9
432285,201707,2,1,1,937,937,1874
432290,201707,71,65,6,59312.1,5622,64934.1
432300,201707,4614,2620,1994,2442188.13,1864457.96,4306646.09
432310,201707,117,93,24,87141,22488,109629
432320,201707,20,15,5,14055,4685,18740
432330,201707,14,8,6,7496,5622,13118
432335,201707,8,7,1,6559,937,7496
432340,201707,41,37,4,34669,3748,38417
432345,201707,88,64,24,59968,22488,82456
432350,201707,23,22,1,20614,937,21551
432360,201707,7,5,2,4685,1874,6559
432370,201707,25,24,1,22206.9,937,23143.9
432375,201707,41,35,6,32795,5622,38417
432377,201707,7,7,0,6559,0,6559
432380,201707,162,70,92,64934.1,86204,151138.1
500020,201707,237,124,113,116188,105290.69,221478.69
500025,201707,114,57,57,52190.9,53409,105599.9
500060,201707,1363,820,543,767777.8,508196.21,1275974.01
500070,201707,724,337,387,315769,362328.63,678097.63
500080,201707,131,99,32,92763,29703,122466
500085,201707,141,114,27,106537,24479.13,131016.13
500090,201707,334,156,178,146172,166786,312958
500100,201707,691,373,318,346034.3,297404,643438.3
500110,201707,2207,973,1234,911392.63,1155474.93,2066867.56
500124,201707,310,176,134,164912,125276.9,290188.9
500150,201707,326,123,203,115242,189857,305099
500190,201707,522,354,168,331042.1,156935,487977.1
500200,201707,195,167,28,156121.89,26236,182357.89
500210,201707,1428,512,916,478493.48,857230.47,1335723.95
500215,201707,236,135,101,125534.21,94637,220171.21
500220,201707,780,510,270,477629.52,252246.63,729876.15
500230,201707,253,173,80,161398.25,74491.5,235889.75
500240,201707,707,485,222,453695.4,207545.9,661241.3
500260,201707,565,207,358,193959,335446,529405
500270,201707,28195,11908,16287,11130351.7,15243971.33,26374323.03
500280,201707,192,72,120,67464,112431,179895
500290,201707,1179,674,505,630602,473176,1103778
500295,201707,385,227,158,212699,148036.63,360735.63
500310,201707,65,19,46,17803,43102,60905
500315,201707,698,410,288,384160.63,269565.53,653726.16
500320,201707,3608,1785,1823,1669880.29,1706523.37,3376403.66
500325,201707,955,520,435,486772,406637.32,893409.32
500330,201707,1488,678,810,632448.86,758357.43,1390806.29
500345,201707,322,236,86,220186.1,80582,300768.1
500348,201707,238,139,99,130243,92744.63,222987.63
500350,201707,144,69,75,64653,70275,134928
500370,201707,5385,2375,3010,2217347.14,2817448.9,5034796.04
500375,201707,346,249,97,233303.63,90889,324192.63
500380,201707,572,329,243,308118.4,227672.63,535791.03
500390,201707,69,35,34,32795,31858,64653
500400,201707,215,145,70,135846.26,65581,201427.26
500410,201707,571,217,354,203283.58,331543.42,534827.00
500430,201707,531,368,163,344816,152731,497547
500440,201707,205,106,99,98561.42,92763,191324.42
500450,201707,415,176,239,164223.8,222938.94,387162.74
500460,201707,318,158,160,148036.63,149920,297956.63
500470,201707,428,338,90,315513.05,83384,398897.05
500480,201707,108,64,44,59968,41228,101196
500490,201707,106,40,66,37475.32,61842,99317.32
500500,201707,1419,477,942,445150.8,881767.22,1326918.02
500510,201707,49,37,12,34669,11235,45904
500515,201707,108,73,35,68401,32514,100915
500520,201707,353,200,153,186370,143357,329727
500525,201707,88,51,37,47787,34387.9,82174.9
500540,201707,878,359,519,336317.78,485311.03,821628.81
500560,201707,888,499,389,465845.66,363810.83,829656.49
500568,201707,971,570,401,529405.2,375451.32,904856.52
500570,201707,1209,685,524,639633.72,488407.02,1128040.74
500580,201707,336,171,165,159936.53,154592,314528.53
500600,201707,320,162,158,151095.93,148028,299123.93
500620,201707,873,616,257,571518.61,240612.23,812130.84
500625,201707,79,66,13,60965.78,12181,73146.78
500627,201707,20,9,11,8433,10307,18740
500630,201707,1560,820,740,767122.9,693094.22,1460217.12
500635,201707,514,283,231,264758.72,216297.08,481055.80
500640,201707,422,218,204,202673.5,191111.63,393785.13
500660,201707,5497,2088,3409,1953739.8,3190569.73,5144309.53
500690,201707,571,202,369,188931.39,344998.97,533930.36
500710,201707,361,175,186,163694,173991.9,337685.9
500720,201707,962,567,395,529869.32,369909.26,899778.58
500730,201707,189,109,80,102133,74674.22,176807.22
500740,201707,841,370,471,345408.14,440878,786286.14
500750,201707,135,42,93,39354,86832.16,126186.16
500755,201707,124,91,33,84986,30921,115907
500769,201707,742,415,327,388534.02,306386,694920.02
500770,201707,450,231,219,216437.63,204959.38,421397.01
500780,201707,168,111,57,104007,53409,157416
500790,201707,1036,509,527,476366.32,493477.63,969843.95
500793,201707,250,136,114,127292,106809,234101
500795,201707,179,125,54,117115.63,50589,167704.63
500797,201707,41,34,7,31858,6559,38417
500800,201707,413,181,232,169588,217102.9,386690.9
500830,201707,2149,1194,955,1115564.3,893972.96,2009537.26
500840,201707,143,106,37,99322,34660,133982
510010,201707,166,91,75,85257.63,70275,155532.63
510020,201707,481,223,258,208677.67,241196.01,449873.68
510025,201707,1634,921,713,862122.03,664971.65,1527093.68
510030,201707,610,308,302,288550.26,282223.32,570773.58
510035,201707,127,55,72,51507.63,67445.63,118953.26
510040,201707,374,160,214,149920,200078.53,349998.53
510050,201707,422,228,194,212899.1,180958.89,393857.99
510060,201707,109,51,58,47777.63,54336.63,102114.26
510080,201707,218,84,134,78675.95,125455.3,204131.25
510100,201707,75,34,41,31858,38398.26,70256.26
510120,201707,34,20,14,18740,13118,31858
510125,201707,397,244,153,227958.05,143338.26,371296.31
510130,201707,590,342,248,320043.07,231939.31,551982.38
510140,201707,380,126,254,118053,237973.32,356026.32
510160,201707,88,42,46,39354,43098,82452
510170,201707,851,524,327,490734.03,305802.65,796536.68
510180,201707,2853,1399,1454,1307860.16,1360388.65,2668248.81
510185,201707,9,4,5,3748,4685,8433
510190,201707,219,73,146,68401,136797.32,205198.32
510250,201707,2617,1513,1104,1416377.22,1033344.66,2449721.88
510260,201707,199,142,57,132863.15,53372.63,186235.78
510263,201707,452,249,203,231871.04,189468.89,421339.93
510267,201707,643,354,289,331506.78,270534.47,602041.25
510268,201707,56,31,25,29047,23425,52472
510269,201707,71,27,44,25290,41228,66518
510270,201707,408,210,198,196594.19,185106.57,381700.76
510279,201707,220,158,62,148018.63,58075.26,206093.89
510285,201707,174,74,100,69299.63,93700,162999.63
510300,201707,554,295,259,275980.85,242609.53,518590.38
510305,201707,211,95,116,88992.63,108590.04,197582.67
510310,201707,118,56,62,52472,58084.63,110556.63
510320,201707,849,526,323,492574.52,302230.26,794804.78
510325,201707,398,162,236,151744.63,220841.53,372586.16
510330,201707,411,233,178,218308,166767.26,385075.26
510335,201707,595,312,283,292297.89,264508.32,556806.21
510336,201707,50,35,15,32774.89,14055,46829.89
510337,201707,121,46,75,43092.63,70265.63,113358.26
510340,201707,17315,8349,8966,7799582.16,8390346.77,16189928.93
510343,201707,71,46,25,43092.63,23425,66517.63
510345,201707,161,104,57,97438.63,53118.63,150557.26
510350,201707,640,362,278,337988.74,260421.89,598410.63
510360,201707,209,123,86,115232.63,80490.89,195723.52
510370,201707,134,68,66,63697.26,61712.67,125409.93
510380,201707,93,63,30,59031,28101,87132
510385,201707,58,27,31,25299,29038,54337
510390,201707,127,51,76,47787,71165.15,118952.15
510395,201707,41,28,13,26236,12181,38417
510410,201707,689,452,237,423491,222045.95,645536.95
510420,201707,594,281,313,262385.77,291764.2,554149.97
510450,201707,51,32,19,29984,17803,47787
510452,201707,39,23,16,21551,14992,36543
510454,201707,70,30,40,28110,37470.63,65580.63
510455,201707,130,81,49,75878.26,45903.63,121781.89
510460,201707,185,95,90,88706.53,84292.89,172999.42
510480,201707,713,399,314,372747.68,293851.34,666599.02
510490,201707,360,183,177,171090.53,165289.76,336380.29
510500,201707,255,189,66,177083.63,61842,238925.63
510510,201707,773,447,326,417968.43,305452.63,723421.06
510515,201707,1145,591,554,553214.48,519040.89,1072255.37
510517,201707,251,108,143,100914.9,133967.95,234882.85
510520,201707,236,153,83,143278.89,77466.52,220745.41
510523,201707,95,61,34,57157,31848.63,89005.63
510525,201707,670,378,292,353413.78,273494.15,626907.93
510530,201707,15,11,4,10307,3748,14055
510550,201707,274,119,155,111022.46,145226,256248.46
510558,201707,280,136,144,127417.95,134900.26,262318.21
510560,201707,373,227,146,212699,136503,349202
510562,201707,638,439,199,409954.25,185974.5,595928.75
510590,201707,838,434,404,406620.89,378529.96,785150.85
510600,201707,257,138,119,129283.26,111461.58,240744.84
510610,201707,162,77,85,72130.26,79626.63,151756.89
510615,201707,188,72,116,67445.26,108692,176137.26
510617,201707,15,8,7,7496,6559,14055
510618,201707,119,56,63,52472,58562.5,111034.5
510619,201707,108,73,35,68392,32786,101178
510620,201707,191,107,84,100249.63,78708,178957.63
510621,201707,194,125,69,116825.53,64634.63,181460.16
510622,201707,440,288,152,269744.52,142096.89,411841.41
510623,201707,358,231,127,216410.26,118961.52,335371.78
510624,201707,85,37,48,34660,44976,79636
510625,201707,519,312,207,292401.78,193353.45,485755.23
510626,201707,104,63,41,59031,38417,97448
510627,201707,54,39,15,36543,14055,50598
510628,201707,164,97,67,90843.26,62722.78,153566.04
510629,201707,252,159,93,148983,86194.63,235177.63
510630,201707,457,226,231,211678.41,216115.85,427794.26
510631,201707,10,3,7,2811,6559,9370
510637,201707,337,183,154,171402.89,144152.52,315555.41
510642,201707,974,532,442,498138.79,414013.82,912152.61
510645,201707,0,0,0,0,0,0
510650,201707,1522,1002,520,938711.89,487130.41,1425842.30
510665,201707,81,40,41,37426,38399,75825
510670,201707,67,36,31,33732,29047,62779
510675,201707,1186,719,467,673632,437536.32,1111168.32
510677,201707,377,175,202,162958.15,188836.67,351794.82
510680,201707,109,62,47,58076,44030,102106
510682,201707,204,91,113,84951,105881,190832
510685,201707,58,43,15,40291,14055,54346
510700,201707,621,359,262,336264.89,245343.04,581607.93
510704,201707,1021,545,476,508460.35,443510.04,951970.39
510706,201707,128,62,66,58089.32,61805.26,119894.58
510710,201707,391,258,133,241552.93,124489.3,366042.23
510715,201707,65,47,18,44029.63,16866,60895.63
510718,201707,219,112,107,104851.78,100240.63,205092.41
510719,201707,32,18,14,16866,13118,29984
510720,201707,199,128,71,119927,66245.9,186172.9
510724,201707,86,34,52,31848.63,48691.89,80540.52
510726,201707,45,25,20,23415.63,18722,42137.63
510729,201707,77,36,41,33732,38379.52,72111.52
510730,201707,468,258,210,241737,196622.63,438359.63
510735,201707,109,43,66,40291,61842,102133
510740,201707,29,15,14,14055,13118,27173
510757,201707,18,14,4,13118,3748,16866
510760,201707,6958,3668,3290,3427155.57,3077254.13,6504409.70
510770,201707,736,349,387,326828.15,362428.15,689256.30
510774,201707,14,7,7,6559,6559,13118
510775,201707,112,83,29,77761.63,27163.63,104925.26
510776,201707,27,6,21,5622,19677,25299
510777,201707,189,85,104,79616.89,97419.89,177036.78
510779,201707,53,25,28,23416,26199.26,49615.26
510780,201707,295,161,134,150785.26,125467.63,276252.89
510785,201707,445,244,201,228562.78,188252.67,416815.45
510787,201707,185,93,92,87127.32,86186.32,173313.64
510788,201707,0,0,0,0,0,0
510790,201707,2358,1230,1128,1150412.59,1054446.9,2204859.49
510792,201707,1040,584,456,546729.52,426865.64,973595.16
510794,201707,107,53,54,49661,50570.26,100231.26
510795,201707,2347,1359,988,1266240.07,922899.8,2189139.87
510800,201707,176,110,66,103060.63,61833,164893.63
510805,201707,163,116,47,108692,44039,152731
510810,201707,92,36,56,33649.89,52359.93,86009.82
510820,201707,270,128,142,119685.26,132071.71,251756.97
510830,201707,67,40,27,37480,25290,62770
510835,201707,1,0,1,0,937,937
510840,201707,9087,4570,4517,4269037.47,4224644.45,8493681.92
510850,201707,204,84,120,78698.63,112121.79,190820.42
510860,201707,393,173,220,161916.56,205414.05,367330.61
510880,201707,63,48,15,44957.63,14055,59012.63
510885,201707,69,42,27,39326.63,25261.89,64588.52
510890,201707,72,39,33,36543,30921,67464
510895,201707,180,102,78,95574,72782.63,168356.63
520005,201707,22,17,5,15929,4685,20614
520010,201707,287,126,161,118042,150764,268806
520013,201707,618,360,258,337283.63,241464.9,578748.53
520015,201707,52,35,17,32795,15929,48724
520017,201707,103,59,44,55002,41228,96230
520020,201707,30,15,15,14055,14055,28110
520025,201707,1977,1068,909,999404.4,850599.7,1850004.1
520030,201707,804,401,403,374791,376665,751456
520050,201707,75,49,26,45913,24362,70275
520055,201707,45,31,14,29047,13118,42165
520060,201707,176,111,65,104007,60905,164912
520080,201707,581,398,183,372926,171466.32,544392.32
520082,201707,20,14,6,13118,5622,18740
520085,201707,96,71,25,66527,23425,89952
520090,201707,80,55,25,51535,23425,74960
520110,201707,9037,3871,5166,3620521.81,4836750.07,8457271.88
520120,201707,13,8,5,7299.23,4685,11984.23
520130,201707,742,532,210,498475,196480,694955
520140,201707,11671,6564,5107,6143575.85,4782056.26,10925632.11
520145,201707,44,32,12,29984,11244,41228
520150,201707,187,146,41,136802,38417,175219
520160,201707,33,23,10,21551,9370,30921
520170,201707,228,139,89,130212,83357,213569
520180,201707,109,54,55,50598,51535,102133
520215,201707,214,129,85,120591.9,79363.9,199955.8
520235,201707,69,52,17,48724,15929,64653
520250,201707,138,86,52,80582,48442.9,129024.9
520260,201707,112,73,39,68401,35606,104007
520280,201707,48,34,14,31203,13118,44321
520310,201707,41,26,15,24362,14055,38417
520320,201707,167,105,62,98385,58094,156479
520330,201707,778,408,370,382250.63,346663,728913.63
520340,201707,355,201,154,188337,144279.63,332616.63
520350,201707,521,229,292,214573,273558,488131
520355,201707,94,53,41,49661,38417,88078
520357,201707,24,16,8,14992,7496,22488
520360,201707,0,0,0,0,0,0
520380,201707,144,77,67,72149,62759,134908
520390,201707,294,126,168,117313,157406.63,274719.63
520393,201707,12,9,3,8433,2811,11244
520396,201707,98,60,38,56220,35606,91826
520400,201707,231,135,96,124903.1,89952,214855.1
520410,201707,196,100,96,93691,89943,183634
520420,201707,25,17,8,15929,7496,23425
520425,201707,303,135,168,125559,156948.6,282507.6
520430,201707,439,232,207,217102.9,193622.9,410725.8
520440,201707,589,389,200,364493,187400,551893
520450,201707,1871,859,1012,803787.63,947589.95,1751377.58
520455,201707,59,40,19,37480,17803,55283
520460,201707,28,15,13,14055,12181,26236
520465,201707,22,19,3,17803,2811,20614
520470,201707,421,259,162,242483,151794,394277
520480,201707,84,46,38,43102,35552,78654
520485,201707,127,44,83,41228,77490,118718
520490,201707,383,288,95,269675.26,88853.84,358529.10
520495,201707,183,106,77,99322,72149,171471
520500,201707,185,139,46,130243,43102,173345
520505,201707,166,86,80,80582,74960,155542
520510,201707,1733,846,887,788316.82,828820.28,1617137.10
520520,201707,43,31,12,29047,11244,40291
520530,201707,236,171,65,157877.89,60119.79,217997.68
520540,201707,500,326,174,304178.81,163038,467216.81
520545,201707,155,85,70,79645,65590,145235
520547,201707,48,27,21,25299,19677,44976
520549,201707,1011,474,537,443820,502632,946452
520551,201707,296,155,141,145235,132117,277352
520552,201707,43,25,18,23425,16866,40291
520570,201707,17,9,8,8433,7496,15929
520580,201707,285,172,113,161155,105881,267036
520590,201707,161,94,67,88078,62497.9,150575.9
520620,201707,1120,524,596,490239.14,557599.53,1047838.67
520630,201707,40,24,16,22488,14992,37480
520640,201707,408,235,173,220195,162101,382296
520650,201707,52,38,14,35606,13118,48724
520660,201707,34,18,16,16866,14992,31858
520670,201707,32,27,5,25299,4685,29984
520680,201707,62,40,22,37480,20614,58094
520690,201707,32,13,19,12171.63,17794,29965.63
520710,201707,37,34,3,31858,2811,34669
520725,201707,198,124,74,116188,69338,185526
520735,201707,56,43,13,40291,12181,52472
520740,201707,403,198,205,184824.2,192076,376900.2
520750,201707,35,26,9,24362,8433,32795
520753,201707,53,38,15,35606,14055,49661
520760,201707,109,73,36,68401,33732,102133
520780,201707,271,209,62,195833,58094,253927
520790,201707,171,80,91,74678.9,85267,159945.9
520800,201707,3542,1860,1682,1739293.78,1575364.77,3314658.55
520810,201707,167,114,53,106818,49661,156479
520815,201707,6,5,1,4685,937,5622
520830,201707,136,88,48,82456,44976,127432
520840,201707,325,213,112,199112.5,104944,304056.5
520850,201707,110,70,40,65581,37330.08,102911.08
520860,201707,1652,1035,617,968353.12,576724.6,1545077.72
520870,201707,30271,14931,15340,13964574.46,14358861.14,28323435.60
520880,201707,988,558,430,522565,402891.26,925456.26
520890,201707,785,449,336,419120.2,314448.63,733568.83
520910,201707,1026,531,495,494035.31,463815,957850.31
520915,201707,97,73,24,68401,22478.63,90879.63
520920,201707,414,203,211,189648.8,197707,387355.8
520929,201707,23,21,2,19677,1874,21551
520940,201707,76,46,30,43102,28110,71212
520945,201707,23,15,8,14055,7496,21551
520960,201707,50,31,19,29047,17803,46850
520970,201707,322,199,123,185845,114969.9,300814.9
520980,201707,95,71,24,66527,22488,89015
520990,201707,469,313,156,293056.12,146172,439228.12
520993,201707,119,58,61,54346,57148,111494
520995,201707,246,136,110,126496,102508,229004
521000,201707,1542,887,655,829433.3,613361,1442794.3
521010,201707,666,302,364,282647.53,341012.52,623660.05
521015,201707,17,9,8,8433,7496,15929
521020,201707,1483,1016,467,951373.95,437214.41,1388588.36
521030,201707,38,27,11,25299,10307,35606
521040,201707,903,546,357,511369,334228,845597
521056,201707,42,29,13,27173,12181,39354
521060,201707,132,81,51,75897,47787,123684
521080,201707,502,370,132,346681,123684,470365
521090,201707,527,314,213,294218,199309.27,493527.27
521100,201707,290,212,78,198635,73086,271721
521120,201707,1035,705,330,658805.4,308920,967725.4
521130,201707,360,257,103,240809,95921.8,336730.8
521140,201707,186,105,81,98385,75897,174282
521150,201707,2779,1185,1594,1108144.14,1492327.85,2600471.99
521160,201707,31,17,14,15929,13118,29047
521170,201707,194,112,82,104934.63,76834,181768.63
521180,201707,1106,692,414,647458.43,387216.1,1034674.53
521190,201707,2558,1070,1488,1002571.26,1392908.16,2395479.42
521200,201707,44,32,12,29984,11244,41228
521205,201707,16,11,5,10307,4685,14992
521210,201707,153,86,67,80582,62779,143361
521220,201707,804,539,265,502457.78,248250,750707.78
521225,201707,28,18,10,16866,9370,26236
521230,201707,111,71,40,66245.9,37480,103725.9
521250,201707,6448,3628,2820,3392745.5,2639511.93,6032257.43
521260,201707,18,13,5,12181,4685,16866
521270,201707,152,117,35,109629,32795,142424
521280,201707,437,252,185,235468.1,173345,408813.1
521290,201707,34,14,20,13118,18740,31858
521295,201707,102,68,34,63491.12,31858,95349.12
521300,201707,223,113,110,105863,102706.89,208569.89
521305,201707,36,24,12,22488,11244,33732
521308,201707,1075,768,307,719115.78,287359.63,1006475.41
521310,201707,1345,798,547,746651.1,511659.26,1258310.36
521340,201707,22,17,5,15929,4685,20614
521350,201707,131,95,36,89015,33732,122747
521370,201707,195,120,75,111503,69993.9,181496.9
521375,201707,198,110,88,103070,82174.9,185244.9
521377,201707,51,34,17,31858,15929,47787
521380,201707,1057,695,362,647142.26,339194,986336.26
521385,201707,19,11,8,10307,7496,17803
521390,201707,110,89,21,83080.7,19677,102757.7
521400,201707,332,205,127,191803.9,118952.15,310756.05
521405,201707,151,75,76,70275,71212,141487
521410,201707,72,49,23,45913,21551,67464
521440,201707,221,153,68,142564.55,63716,206280.55
521450,201707,717,387,330,362619,308554.1,671173.1
521460,201707,1181,707,474,662178,444119.26,1106297.26
521470,201707,14,9,5,8433,4685,13118
521480,201707,52,34,18,31858,16802,48660
521483,201707,296,154,142,144017,133054,277071
521486,201707,293,185,108,173223.19,100541,273764.19
521487,201707,25,12,13,11244,12181,23425
521490,201707,28,17,11,15929,10307,26236
521500,201707,113,74,39,69338,36543,105881
521520,201707,43,32,11,29984,10307,40291
521523,201707,552,338,214,314422.95,200518,514940.95
521525,201707,47,31,16,29047,14992,44039
521530,201707,251,130,121,121810,113377,235187
521540,201707,30,16,14,14992,13118,28110
521550,201707,91,40,51,37180.63,47750.63,84931.26
521560,201707,771,531,240,496806.87,224599,721405.87
521565,201707,45,32,13,29984,12181,42165
521570,201707,482,322,160,301704.63,149827.15,451531.78
521580,201707,63,40,23,37480,21551,59031
521590,201707,35,18,17,16866,15929,32795
521600,201707,29,17,12,15929,11244,27173
521630,201707,230,116,114,108682.63,105844.88,214527.51
521640,201707,299,151,148,141487,138676,280163
521645,201707,29,15,14,14055,13118,27173
521680,201707,229,140,89,131180,83393,214573
521690,201707,1,1,0,937,0,937
521710,201707,1172,551,621,515724.9,581868,1097592.9
521720,201707,511,333,178,312021,166739.26,478760.26
521730,201707,625,310,315,290470,294068.18,584538.18
521740,201707,913,358,555,335427.63,518855.96,854283.59
521760,201707,1556,836,720,781782.52,674332,1456114.52
521770,201707,789,498,291,466626,272207.87,738833.87
521800,201707,2107,1296,811,1211808.2,758928.16,1970736.36
521805,201707,36,21,15,19673,14055,33728
521810,201707,98,59,39,54158.9,36543,90701.9
521830,201707,948,660,288,616828.08,269847,886675.08
521839,201707,93,62,31,58094,29047,87141
521850,201707,1085,584,501,545645.26,469107.04,1014752.30
521860,201707,351,213,138,199581,129025,328606
521870,201707,67,36,31,33732,29047,62779
521878,201707,45,21,24,19677,22488,42165
521880,201707,4310,1933,2377,1808971.48,2224838.75,4033810.23
521890,201707,561,384,177,359808,165558.9,525366.9
521900,201707,296,239,57,223037.2,53409,276446.2
521910,201707,152,107,45,100259,42165,142424
521920,201707,56,27,29,25299,27173,52472
521925,201707,34,21,13,19677,12181,31858
521930,201707,1094,624,470,584494.56,439451.53,1023946.09
521935,201707,33,25,8,23425,7496,30921
521940,201707,197,100,97,93700,90889,184589
521945,201707,16,14,2,13118,1874,14992
521950,201707,7,5,2,4685,1874,6559
521960,201707,77,56,21,52472,19677,72149
521970,201707,407,255,152,238653.9,142424,381077.9
521971,201707,95,48,47,44976,44039,89015
521973,201707,31,13,18,12181,16866,29047
521975,201707,1056,559,497,522659.6,464696.73,987356.33
521980,201707,243,165,78,154446,73086,227532
521990,201707,70,54,16,50598,14992,65590
522000,201707,290,181,109,169597,102133,271730
522005,201707,22,14,8,13118,7496,20614
522010,201707,1112,621,491,580931,459495.43,1040426.43
522015,201707,57,34,23,31849,21551,53400
522020,201707,845,428,417,401036,389680.26,790716.26
522026,201707,29,20,9,18740,8433,27173
522028,201707,16,12,4,11244,3748,14992
522040,201707,720,281,439,263007,411288.63,674295.63
522045,201707,1971,1244,727,1164802.43,680393.8,1845196.23
522050,201707,175,83,92,77771,86204,163975
522060,201707,544,346,198,323920.9,185432.3,509353.2
522068,201707,137,88,49,82456,45913,128369
522070,201707,12,12,0,11244,0,11244
522100,201707,45,23,22,21289,20614,41903
522108,201707,40,30,10,28110,9370,37480
522119,201707,61,30,31,28110,29047,57157
522130,201707,75,23,52,21551,48688,70239
522140,201707,3667,1879,1788,1756981.8,1673511.42,3430493.22
522145,201707,56,34,22,31858,20614,52472
522150,201707,64,51,13,47787,12181,59968
522155,201707,56,40,16,37471,14992,52463
522157,201707,6,4,2,3748,1874,5622
522160,201707,1742,1013,729,948056.6,682782.9,1630839.5
522170,201707,402,267,135,250179,126495,376674
522180,201707,38,20,18,18740,16866,35606
522185,201707,1307,543,764,505880.17,715706.88,1221587.05
522190,201707,48,27,21,25299,19583.3,44882.3
522200,201707,300,182,118,170534,110566,281100
522205,201707,165,112,53,104944,49661,154605
522220,201707,174,123,51,115251,47787,163038
522230,201707,32,25,7,23425,6559,29984
530010,201707,54037,27813,26224,25925158.27,24516325.83,50441484.10
110001,201708,507,399,108,372113.99,100361.64,472475.63
110002,201708,2676,1572,1104,1464574.6,1028334.26,2492908.86
110003,201708,91,72,19,67143.78,17682.89,84826.67
110004,201708,1953,1243,710,1156585.94,661176.37,1817762.31
110005,201708,438,354,84,329092.27,78116.43,407208.70
110006,201708,442,343,99,318765.83,92061.9,410827.73
110007,201708,82,67,15,62578.45,13974.89,76553.34
110008,201708,232,133,99,123243.45,92402.01,215645.46
110009,201708,752,501,251,466614.27,233787.37,700401.64
110010,201708,1781,1104,677,1028818.79,632001.21,1660820.00
110011,201708,1866,1432,434,1333017.08,404242.03,1737259.11
110012,201708,4072,2343,1729,2183936.56,1614258.08,3798194.64
110013,201708,739,547,192,509039.95,178640.92,687680.87
110014,201708,362,307,55,286618.23,51310.21,337928.44
110015,201708,1439,1156,283,1075602.25,263288.4,1338890.65
110018,201708,1108,655,453,610243.86,422584.03,1032827.89
110020,201708,15072,8824,6248,8216554.8,5837206.45,14053761.25
110025,201708,620,450,170,418250.62,158557.92,576808.54
110026,201708,42,30,12,27868.9,11123.56,38992.46
110028,201708,1618,1167,451,1082190.27,417751.77,1499942.04
110029,201708,135,118,17,110325.67,15909,126234.67
110030,201708,2451,1640,811,1523089.01,754039.21,2277128.22
110032,201708,385,294,91,273909.82,84981.9,358891.72
110033,201708,642,488,154,452134.52,143291.02,595425.54
110034,201708,355,261,94,241203.03,86941.11,328144.14
110037,201708,102,82,20,76773.78,18719.89,95493.67
110040,201708,319,213,106,198257.37,98600.57,296857.94
110045,201708,900,586,314,544693.1,291397.37,836090.47
110050,201708,95,76,19,70871.67,17763,88634.67
110060,201708,89,45,44,41964.89,40807.34,82772.23
110070,201708,126,75,51,69893.46,47184.57,117078.03
110080,201708,396,227,169,209611.84,157802.61,367414.45
110090,201708,29,24,5,22387.56,4644.78,27032.34
110092,201708,106,60,46,55959.01,42750.57,98709.58
110094,201708,200,138,62,128484.46,57572.79,186057.25
110100,201708,27,22,5,20493.78,4664.89,25158.67
110110,201708,71,44,27,41047.67,24857.67,65905.34
110120,201708,73,57,16,53148.56,14891.67,68040.23
110130,201708,299,244,55,225998.71,51234.34,277233.05
110140,201708,246,159,87,148133.18,81108.09,229241.27
110143,201708,43,37,6,34508.56,5561.67,40070.23
110145,201708,27,19,8,17722.89,7476,25198.89
110146,201708,22,11,11,10266.89,10266.89,20533.78
110147,201708,40,31,9,28705.89,8413,37118.89
110148,201708,38,26,12,24169.91,11224,35393.91
110149,201708,292,205,87,190919.94,81056.91,271976.85
110150,201708,81,52,29,48583.78,26646.23,75230.01
110155,201708,9,7,2,6519,1854,8373
110160,201708,71,59,12,54901.24,11183.78,66085.02
110170,201708,215,175,40,163034.45,37239.67,200274.12
110175,201708,27,21,6,19516.23,5601.89,25118.12
110180,201708,95,84,11,78627.78,10266.89,88894.67
120001,201708,128,87,41,81477,38409,119886
120005,201708,193,123,70,115208.12,65403,180611.12
120010,201708,993,644,349,597007.15,324565.52,921572.67
120013,201708,133,91,42,84582.88,38366.86,122949.74
120017,201708,78,53,25,49552.48,23404,72956.48
120020,201708,3472,2762,710,2559029.37,661723.26,3220752.63
120025,201708,604,338,266,313766.67,247325.46,561092.13
120030,201708,1026,853,173,791883.25,161356.12,953239.37
120032,201708,47,39,8,36521.12,7496,44017.12
120033,201708,214,188,26,175814.94,24340.12,200155.06
120034,201708,152,110,42,101174.12,39310.24,140484.36
120035,201708,27,17,10,15929,9370,25299
120038,201708,380,241,139,225006.2,130199.24,355205.44
120039,201708,21,19,2,17803,1874,19677
120040,201708,13867,9580,4287,8851335.87,3975596.81,12826932.68
120042,201708,42,36,6,33732,5622,39354
120043,201708,12,2,10,1874,9349.89,11223.89
120045,201708,531,339,192,316105.93,179639.48,495745.41
120050,201708,1239,944,295,879093.02,275106.46,1154199.48
120060,201708,1357,1095,262,1009821.28,241650.62,1251471.90
120070,201708,506,361,145,332199.46,134479.95,466679.41
120080,201708,141,90,51,83153.73,47224.55,130378.28
130002,201708,149,103,46,96511,43102,139613
130006,201708,75,42,33,39354,30921,70275
130008,201708,142,75,67,69554.72,62056.96,131611.68
130010,201708,140,73,67,68401,62779,131180
130014,201708,241,173,68,162101,63716,225817
130020,201708,84,47,37,44039,34669,78708
130030,201708,863,540,323,505980,302641.63,808621.63
130040,201708,320,163,157,152731,145470.09,298201.09
130050,201708,547,308,239,288314.9,223943,512257.9
130060,201708,875,600,275,557073.3,254838.34,811911.64
130063,201708,538,286,252,267982,236102.12,504084.12
130068,201708,189,121,68,113377,63434.9,176811.9
130070,201708,1330,924,406,839946.11,371009.36,1210955.47
130080,201708,662,432,230,404409.2,215501,619910.2
130083,201708,68,36,32,33732,29984,63716
130090,201708,380,190,190,176380.88,178030,354410.88
130100,201708,1107,519,588,486303,550674.9,1036977.9
130110,201708,704,311,393,291257,368241,659498
130115,201708,173,69,104,64653,97448,162101
130120,201708,1612,1014,598,950118,560326,1510444
130130,201708,626,422,204,395414,191148,586562
130140,201708,1548,1164,384,1090037.95,358871.1,1448909.05
130150,201708,426,359,67,336383,62779,399162
130160,201708,476,263,213,246431,199581,446012
130165,201708,25,18,7,16866,6559,23425
130170,201708,953,670,283,627680.44,265150.89,892831.33
130180,201708,158,95,63,88546.5,59031,147577.5
130185,201708,2103,1124,979,1051293.89,916740.89,1968034.78
130190,201708,3584,2269,1315,2122305.4,1230595.09,3352900.49
130195,201708,293,235,58,220195,54346,274541
130200,201708,182,81,101,75887.63,94637,170524.63
130210,201708,76,36,40,33732,37480,71212
130220,201708,186,125,61,117125,57157,174282
130230,201708,334,211,123,197707,115251,312958
130240,201708,1470,923,547,863515.09,511972.12,1375487.21
130250,201708,4664,3005,1659,2811166.6,1554349.93,4365516.53
130255,201708,420,209,211,195833,197425.9,393258.9
130260,201708,51973,24750,27223,23158581.91,25499844.17,48658426.08
130270,201708,1450,938,512,878437.5,479723.89,1358161.39
130280,201708,109,67,42,62779,39354,102133
130290,201708,2071,1512,559,1416339.22,523501.9,1939841.12
130300,201708,421,304,117,284566.9,109629,394195.9
130310,201708,904,488,416,457256,389792,847048
130320,201708,444,237,207,221132,193959,415091
130330,201708,696,427,269,400099,251771.9,651870.9
130340,201708,3192,1962,1230,1834833.6,1151104.6,2985938.2
130350,201708,492,304,188,284725.57,176156,460881.57
130353,201708,742,304,438,284567,410406,694973
130356,201708,727,332,395,311084,369833.9,680917.9
130360,201708,72,42,30,39354,28110,67464
130370,201708,695,499,196,467563,183652,651215
130380,201708,652,440,212,412280,198644,610924
130390,201708,496,393,103,368241,96511,464752
130395,201708,174,41,133,38417,124621,163038
130400,201708,65,45,20,42165,18740,60905
130406,201708,2046,1309,737,1222988.15,689941.16,1912929.31
130410,201708,523,221,302,207077,282955.26,490032.26
130420,201708,3199,2544,655,2380636.25,613735,2994371.25
130423,201708,165,76,89,71212,83393,154605
130426,201708,140,82,58,76834,54346,131180
130430,201708,407,270,137,252990,128369,381359
130440,201708,203,73,130,68401,121810,190211
140002,201708,36,14,22,13118,20614,33732
140005,201708,197,120,77,112205.75,72149,184354.75
140010,201708,10279,6919,3360,6451898.2,3144550.92,9596449.12
140015,201708,158,70,88,65590,82456,148046
140017,201708,106,72,34,67464,31858,99322
140020,201708,485,328,157,306399,147109,453508
140023,201708,24,17,7,15433,6559,21992
140028,201708,17,12,5,11244,4685,15929
140030,201708,358,251,107,235187,99668.69,334855.69
140040,201708,52,36,16,33732,14898.3,48630.3
140045,201708,250,118,132,109910.1,123684,233594.1
140047,201708,542,361,181,335585.52,168847.5,504433.02
140050,201708,151,100,51,92902,47787,140689
140060,201708,36,26,10,23640.51,9370,33010.51
140070,201708,29,27,2,25299,1874,27173
150010,201708,4705,2911,1794,2724936.75,1678615.66,4403552.41
150013,201708,140,94,46,88078,43102,131180
150020,201708,1103,574,529,537838,495673,1033511
150030,201708,750,303,447,283911,418839,702750
150034,201708,185,112,73,104944,68401,173345
150040,201708,1357,810,547,758970,512539,1271509
150050,201708,723,427,296,399115.9,277152,676267.9
150060,201708,4665,3015,1650,2821364.88,1545525.28,4366890.16
150070,201708,315,142,173,133054,162101,295155
150080,201708,14381,7205,7176,6741046.42,6716909.76,13457956.18
150085,201708,359,225,134,210815.63,125558,336373.63
150090,201708,756,643,113,602491,105881,708372
150095,201708,347,210,137,196013.84,127563.18,323577.02
150100,201708,53,37,16,34669,14992,49661
150110,201708,170,83,87,77771,81519,159290
150120,201708,434,321,113,300777,105881,406658
150125,201708,48,21,27,19677,25299,44976
150130,201708,1897,1004,893,940748,836736.32,1777484.32
150140,201708,54412,25342,29070,23713880.69,27225195.97,50939076.66
150145,201708,169,99,70,92763,65590,158353
150150,201708,2755,1175,1580,1100761.37,1476585.7,2577347.07
150157,201708,453,303,150,283911,140545.32,424456.32
150160,201708,116,91,25,85267,23425,108692
150170,201708,3668,2705,963,2531680.4,902049.9,3433730.3
150172,201708,301,208,93,194896,87141,282037
150175,201708,90,56,34,52472,31858,84330
150178,201708,746,495,251,462878,235187,698065
150180,201708,2933,1391,1542,1302570.8,1444550.18,2747120.98
150190,201708,335,213,122,199581,114314,313895
150195,201708,120,59,61,55283,57157,112440
150200,201708,209,96,113,89952,105881,195833
150210,201708,3112,2520,592,2360200.84,554465.75,2914666.59
150215,201708,488,327,161,306118,150857,456975
150220,201708,3986,2667,1319,2497164.9,1233824.36,3730989.26
150230,201708,1144,912,232,853974.7,217384,1071358.7
150240,201708,5665,3305,2360,3093216.47,2211307,5304523.47
150250,201708,29,14,15,13118,14055,27173
150260,201708,71,42,29,39354,27173,66527
150270,201708,2296,1509,787,1412877.02,736856.9,2149733.92
150275,201708,586,351,235,328887,220195,549082
150276,201708,103,41,62,38417,58094,96511
150277,201708,753,324,429,303569.63,401973,705542.63
150280,201708,341,206,135,193022,126495,319517
150285,201708,74,37,37,34669,34669,69338
150290,201708,960,581,379,544106.53,354842,898948.53
150293,201708,690,317,373,296607.63,349501,646108.63
150295,201708,455,198,257,185526,240677.82,426203.82
150300,201708,80,43,37,40291,34669,74960
150304,201708,135,86,49,80582,45913,126495
150307,201708,393,321,72,300777,67464,368241
150309,201708,519,368,151,344816,141487,486303
150310,201708,251,170,81,159290,75897,235187
150320,201708,1788,1226,562,1148485.59,526594,1675079.59
150330,201708,2067,1180,887,1105004.1,831119,1936123.1
150340,201708,194,126,68,117827.75,63716,181543.75
150345,201708,606,322,284,301535.97,266108,567643.97
150350,201708,425,332,93,308732.13,87141,395873.13
150360,201708,4388,2824,1564,2642365.57,1465449.26,4107814.83
150370,201708,731,519,212,485521,198353.9,683874.9
150375,201708,195,106,89,99322,83393,182715
150380,201708,1218,793,425,743041,397944,1140985
150390,201708,727,416,311,389792,291398,681190
150400,201708,93,75,18,70275,16866,87141
150405,201708,1234,812,422,759819.86,394851.8,1154671.66
150410,201708,146,94,52,88078,48724,136802
150420,201708,7220,3938,3282,3688555.44,3074015.49,6762570.93
150430,201708,469,317,152,297029,142424,439453
150440,201708,595,351,244,328138,228347,556485
150442,201708,2108,1147,961,1072827.52,900452.32,1973279.84
150445,201708,512,320,192,299840,178967,478807
150450,201708,274,130,144,121810,134928,256738
150460,201708,780,588,192,548880.66,179885.26,728765.92
150470,201708,1342,804,538,753067,504106,1257173
150475,201708,29,23,6,21551,5622,27173
150480,201708,1223,852,371,798324,347346,1145670
150490,201708,614,324,290,303588,271730,575318
150495,201708,320,217,103,203329,96511,299840
150497,201708,299,205,94,192085,88068.63,280153.63
150500,201708,430,288,142,269856,133054,402910
150503,201708,801,381,420,356716,393522,750238
150506,201708,1044,662,382,620294,357925,978219
150510,201708,1212,688,524,644375,490988,1135363
150520,201708,266,177,89,165849,83393,249242
150530,201708,1520,837,683,781177.55,639971,1421148.55
150540,201708,238,168,70,157416,65590,223006
150543,201708,679,379,300,354823.16,280818.9,635642.06
150548,201708,492,336,156,314832,146172,461004
150549,201708,59,39,20,36543,18740,55283
150550,201708,2870,1489,1381,1394491,1293435,2687926
150553,201708,2992,1777,1215,1663550.3,1138174,2801724.3
150555,201708,140,72,68,67464,63716,131180
150560,201708,53,39,14,36543,13118,49661
150563,201708,65,34,31,31858,29047,60905
150565,201708,164,96,68,89912,63716,153628
150570,201708,399,268,131,251097.26,122747,373844.26
150580,201708,1474,598,876,559670.1,820812,1380482.1
150590,201708,762,451,311,422587,291407,713994
150600,201708,442,272,170,254864,159290,414154
150610,201708,141,121,20,112544,18740,131284
150611,201708,128,89,39,83393,36543,119936
150613,201708,3117,1906,1211,1785922,1134698,2920620
150616,201708,477,298,179,278992,167723,446715
150618,201708,1113,603,510,564786.49,477870,1042656.49
150619,201708,396,301,95,282037,89015,371052
150620,201708,1278,728,550,682136,515068.9,1197204.9
150630,201708,314,210,104,196770,97448,294218
150635,201708,498,202,296,189274,277352,466626
150640,201708,63,30,33,28110,30921,59031
150650,201708,2305,1323,982,1239379.27,918911.22,2158290.49
150655,201708,254,187,67,175219,62779,237998
150658,201708,98,56,42,52472,39354,91826
150660,201708,479,332,147,311084,137739,448823
150670,201708,984,349,635,326722.9,594976.63,921699.53
150680,201708,9621,5295,4326,4957172.86,4050605.69,9007778.55
150690,201708,51,32,19,29984,17803,47787
150700,201708,551,355,196,332447.6,183652,516099.6
150710,201708,262,161,101,150857,94637,245494
150715,201708,877,525,352,490960.26,329795.89,820756.15
150720,201708,454,340,114,318580,106536.9,425116.9
150730,201708,880,466,414,436633,387636.9,824269.9
150740,201708,242,174,68,163038,63716,226754
150745,201708,781,404,377,378548,353249,731797
150746,201708,55,33,22,30921,20614,51535
150747,201708,272,213,59,199581,55283,254864
150750,201708,130,75,55,70275,51535,121810
150760,201708,1708,1105,603,1035103.9,565011,1600114.9
150770,201708,357,183,174,171471,162866.07,334337.07
150775,201708,80,38,42,35606,39354,74960
150780,201708,181,99,82,92763,76834,169597
150790,201708,894,479,415,448823,388855,837678
150795,201708,1415,820,595,768340,557515,1325855
150796,201708,409,233,176,218321,164912,383233
150797,201708,272,155,117,145235,109629,254864
150800,201708,1413,847,566,792697.31,530342,1323039.31
150803,201708,588,485,103,454445,96511,550956
150805,201708,190,120,70,112440,65576.63,178016.63
150808,201708,953,522,431,488801.66,403847,892648.66
150810,201708,3358,2305,1053,2154250.38,986361.26,3140611.64
150812,201708,426,224,202,209888,189274,399162
150815,201708,933,613,320,573027.04,299840,872867.04
150820,201708,1593,977,616,914512,577173.26,1491685.26
150830,201708,839,592,247,553767,231439,785206
150835,201708,182,106,76,99322,71212,170534
150840,201708,1279,819,460,767403,431020,1198423
160005,201708,51,30,21,28110,19677,47787
160010,201708,196,121,75,113377,70271,183648
160015,201708,115,66,49,61842,45913,107755
160020,201708,115,66,49,61842,45913,107755
160021,201708,40,21,19,19677,17803,37480
160023,201708,107,60,47,56220,44039,100259
160025,201708,34,15,19,14055,17803,31858
160027,201708,1443,817,626,762062.35,585825,1347887.35
160030,201708,15292,7823,7469,7321075.87,6992563,14313638.87
160040,201708,316,178,138,166786,129306,296092
160050,201708,634,329,305,308273,285503.9,593776.9
160053,201708,338,190,148,177749,138676,316425
160055,201708,17,12,5,11244,4685,15929
160060,201708,6293,3269,3024,3052140.74,2832547.1,5884687.84
160070,201708,159,95,64,89015,59968,148983
160080,201708,74,38,36,35606,33732,69338
170025,201708,22,15,7,14055,6559,20614
170030,201708,221,176,45,164718,42165,206883
170035,201708,228,107,121,99322,113377,212699
170040,201708,185,145,40,135583.9,37480,173063.9
170070,201708,332,186,146,174282,136802,311084
170100,201708,378,268,110,250882,103070,353952
170105,201708,63,51,12,47787,11244,59031
170110,201708,101,62,39,58094,36543,94637
170130,201708,72,32,40,29984,37199,67183
170190,201708,109,68,41,63716,38417,102133
170200,201708,397,263,134,245766.1,125455.78,371221.88
170210,201708,5958,3065,2893,2864396.65,2707537.33,5571933.98
170215,201708,73,35,38,32795,35606,68401
170220,201708,1443,1050,393,981488.76,367960,1349448.76
170230,201708,154,98,56,91826,52472,144298
170240,201708,570,376,194,352312,181778,534090
170255,201708,1112,886,226,830182,211480.9,1041662.9
170270,201708,37,27,10,25299,9182.6,34481.6
170290,201708,73,54,19,50598,17803,68401
170300,201708,81,52,29,47974.4,27173,75147.4
170305,201708,38,31,7,29047,6559,35606
170307,201708,59,43,16,40291,14992,55283
170310,201708,101,54,47,50598,44039,94637
170320,201708,17,13,4,12181,3748,15929
170330,201708,19,16,3,14992,2811,17803
170360,201708,23,15,8,14055,7496,21551
170370,201708,167,81,86,75897,80582,156479
170380,201708,79,55,24,51535,22488,74023
170382,201708,48,43,5,40291,4685,44976
170384,201708,124,88,36,82456,33732,116188
170386,201708,59,28,31,26236,29047,55283
170388,201708,48,18,30,16866,28110,44976
170389,201708,23,17,6,15929,5622,21551
170390,201708,48,28,20,26236,18740,44976
170410,201708,32,21,11,19677,10307,29984
170460,201708,17,12,5,11244,4685,15929
170510,201708,27,20,7,18740,6559,25299
170550,201708,1473,828,645,775836,603615.5,1379451.5
170555,201708,111,75,36,70275,33732,104007
170560,201708,101,70,31,65590,29047,94637
170600,201708,37,18,19,16866,17803,34669
170610,201708,192,102,90,95419.4,84312,179731.4
170625,201708,37,17,20,15929,18740,34669
170650,201708,83,62,21,58094,19677,77771
170700,201708,552,415,137,387871.15,127572.55,515443.70
170710,201708,155,96,59,89764.26,55274,145038.26
170720,201708,82,68,14,63716,13118,76834
170730,201708,54,31,23,29047,21551,50598
170740,201708,71,52,19,48724,17803,66527
170755,201708,114,53,61,49051.95,57157,106208.95
170765,201708,149,70,79,64981,74023,139004
170770,201708,226,128,98,118858.45,91826,210684.45
170820,201708,588,380,208,356060,194475,550535
170825,201708,31,19,12,17803,11244,29047
170830,201708,73,50,23,46662.6,21551,68213.6
170900,201708,204,153,51,143361,47787,191148
170930,201708,779,398,381,372608,356435,729043
170950,201708,2964,1280,1684,1197046.88,1575640.93,2772687.81
170980,201708,17,9,8,8433,7496,15929
171050,201708,127,97,30,90889,28110,118999
171070,201708,37,30,7,28110,6559,34669
171090,201708,37,26,11,24362,10307,34669
171110,201708,21,14,7,13118,6559,19677
171150,201708,36,18,18,16866,16866,33732
171180,201708,22,10,12,9370,11244,20614
171190,201708,125,73,52,68401,48724,117125
171195,201708,63,48,15,44976,14055,59031
171200,201708,47,21,26,19677,24362,44039
171215,201708,1,1,0,937,0,937
171240,201708,54,44,10,41228,9370,50598
171245,201708,50,45,5,42165,4685,46850
171250,201708,67,34,33,31858,30911.63,62769.63
171270,201708,16,12,4,11244,3748,14992
171280,201708,37,33,4,30781,3748,34529
171320,201708,986,553,433,518161,404784,922945
171330,201708,410,194,216,181778,202392,384170
171360,201708,83,62,21,58094,19677,77771
171370,201708,22,11,11,10307,10307,20614
171380,201708,127,103,24,96511,22262.19,118773.19
171395,201708,52,33,19,30921,17803,48724
171420,201708,317,210,107,196770,99977.9,296747.9
171430,201708,61,49,12,45913,11244,57157
171488,201708,212,110,102,103070,95574,198644
171500,201708,56,31,25,29047,23425,52472
171510,201708,66,44,22,41228,20614,61842
171515,201708,44,37,7,34669,6559,41228
171525,201708,30,26,4,24362,3748,28110
171550,201708,11,5,6,4685,5622,10307
171570,201708,59,29,30,27173,28110,55283
171575,201708,352,212,140,198504,131170.63,329674.63
171610,201708,1639,813,826,759915.83,772393.99,1532309.82
171620,201708,133,90,43,83786.54,40009.9,123796.44
171630,201708,54,28,26,26236,24362,50598
171650,201708,276,177,99,165849,92763,258612
171660,201708,254,134,120,125558,112440,237998
171665,201708,42,27,15,25299,14055,39354
171670,201708,436,252,184,234475.13,171845.8,406320.93
171700,201708,60,53,7,49661,6559,56220
171720,201708,24,9,15,8433,14055,22488
171750,201708,100,54,46,50598,43102,93700
171780,201708,69,56,13,52472,12181,64653
171790,201708,79,65,14,60905,13118,74023
171800,201708,37,27,10,25299,9370,34669
171820,201708,1923,1096,827,1026255.47,770374.21,1796629.68
171830,201708,37,29,8,27173,7496,34669
171840,201708,59,33,26,30921,24362,55283
171845,201708,33,21,12,19677,11244,30921
171850,201708,38,26,12,24362,11244,35606
171855,201708,70,56,14,52472,13118,65590
171865,201708,7,6,1,5622,937,6559
171870,201708,31,22,9,20614,8433,29047
171875,201708,77,53,24,49661,22488,72149
171880,201708,27,20,7,18740,6559,25299
171884,201708,43,22,21,20614,19677,40291
171886,201708,111,40,71,37480,66245.9,103725.9
171888,201708,20,14,6,13118,5622,18740
171889,201708,21,15,6,14055,5622,19677
171890,201708,57,46,11,43102,10307,53409
171900,201708,42,29,13,27173,12181,39354
172000,201708,42,35,7,32795,6559,39354
172010,201708,39,32,7,29187.55,6559,35746.55
172015,201708,29,16,13,14992,11899.9,26891.9
172020,201708,127,77,50,72149,46850,118999
172025,201708,33,20,13,18740,12181,30921
172030,201708,34,20,14,18740,13118,31858
172049,201708,75,46,29,43102,27173,70275
172065,201708,151,100,51,93700,47787,141487
172080,201708,76,56,20,51311.02,18740,70051.02
172085,201708,24,12,12,11244,11244,22488
172090,201708,406,306,100,286722,92951,379673
172093,201708,27,18,9,16866,8433,25299
172097,201708,17,8,9,7496,8152,15648
172100,201708,4527,2507,2020,2344084.67,1890018.93,4234103.60
172110,201708,79,52,27,48724,25299,74023
172120,201708,1741,1488,253,1388529.2,235973.14,1624502.34
172125,201708,2,2,0,1874,0,1874
172130,201708,13,11,2,10307,1874,12181
172208,201708,188,120,68,112440,63716,176156
172210,201708,477,227,250,212699,233969,446668
210005,201708,2927,1818,1109,1700186.76,1036604,2736790.76
210010,201708,203,100,103,93700,96511,190211
210015,201708,25,17,8,15929,7496,23425
210020,201708,351,178,173,166786,162101,328887
210030,201708,348,212,136,198644,127423,326067
210040,201708,157,121,36,113377,33732,147109
210043,201708,254,169,85,158353,79645,237998
210047,201708,628,307,321,287284.2,300767.63,588051.83
210050,201708,294,211,83,197707,77771,275478
210055,201708,41,31,10,29047,9370,38417
210060,201708,579,442,137,414056.56,128369,542425.56
210070,201708,414,295,119,276415,111221.9,387636.9
210080,201708,100,91,9,85267,8433,93700
210083,201708,310,125,185,117125,173345,290470
210087,201708,49,33,16,30921,14992,45913
210090,201708,495,338,157,316706,147109,463815
210095,201708,504,356,148,333562.63,138676,472238.63
210100,201708,685,516,169,483164.05,157416.35,640580.40
210110,201708,156,83,73,77771,68401,146172
210120,201708,5553,4130,1423,3865146.3,1332401.14,5197547.44
210125,201708,217,117,100,109629,93700,203329
210130,201708,573,290,283,270793,265171,535964
210135,201708,33,19,14,17803,13118,30921
210140,201708,4023,3113,910,2913742.22,852499,3766241.22
210150,201708,352,220,132,206140,123511,329651
210160,201708,3317,2769,548,2591744.68,513195,3104939.68
210170,201708,1092,833,259,780521,242683,1023204
210173,201708,113,93,20,87141,18740,105881
210177,201708,492,233,259,218321,242683,461004
210180,201708,30,16,14,14992,13118,28110
210190,201708,403,256,147,239872,137739,377611
210193,201708,0,0,0,0,0,0
210197,201708,85,56,29,52472,27155.2,79627.2
210200,201708,643,505,138,473185,129306,602491
210203,201708,272,176,96,164912,89952,254864
210207,201708,379,290,89,271730,83393,355123
210210,201708,767,694,73,650278,68401,718679
210215,201708,76,63,13,59031,12181,71212
210220,201708,399,326,73,305462,68401,373863
210230,201708,304,222,82,208014,76834,284848
210232,201708,1514,936,578,876751,541586,1418337
210235,201708,153,117,36,109442,33732,143174
210237,201708,45,24,21,22488,19677,42165
210240,201708,96,78,18,73086,16866,89952
210250,201708,178,138,40,129306,37480,166786
210255,201708,312,226,86,211762,80582,292344
210260,201708,434,253,181,237061,169597,406658
210270,201708,709,444,265,416028,248305,664333
210275,201708,42,33,9,30921,8433,39354
210280,201708,1029,650,379,605490.21,353811.25,959301.46
210290,201708,496,312,184,292344,172408,464752
210300,201708,6196,3531,2665,3303992.53,2495916.37,5799908.90
210310,201708,102,69,33,64653,30921,95574
210312,201708,131,80,51,74960,47787,122747
210315,201708,117,83,34,77771,31858,109629
210317,201708,120,83,37,77771,34669,112440
210320,201708,2395,1952,443,1827173.96,414154,2241327.96
210325,201708,127,84,43,77771,40010,117781
210330,201708,5847,2859,2988,2675074.65,2799746.63,5474821.28
210340,201708,1439,1013,426,948395,399091.85,1347486.85
210350,201708,607,488,119,457021.75,111503,568524.75
210355,201708,128,100,28,93700,26236,119936
210360,201708,2714,1671,1043,1562636.36,977291,2539927.36
210370,201708,1276,524,752,490988,703968.1,1194956.1
210375,201708,188,95,93,88481,87141,175622
210380,201708,736,545,191,510665,178947,689612
210390,201708,192,157,35,147109,32795,179904
210400,201708,415,342,73,320454,68401,388855
210405,201708,979,641,338,600023.87,316706,916729.87
210407,201708,54,42,12,39354,11244,50598
210408,201708,66,59,7,55283,6559,61842
210409,201708,316,260,56,243620,52472,296092
210410,201708,434,333,101,312021,94628,406649
210420,201708,191,156,35,146172,32795,178967
210430,201708,33,25,8,23425,7496,30921
210440,201708,385,226,159,211762,148983,360745
210450,201708,148,110,38,103070,35606,138676
210455,201708,211,112,99,104944,92763,197707
210460,201708,342,214,128,200518,119936,320454
210462,201708,54,45,9,42165,8433,50598
210465,201708,186,130,56,121810,52472,174282
210467,201708,518,369,149,345753,139613,485366
210470,201708,44,33,11,30921,10307,41228
210480,201708,1278,886,392,830182,367304,1197486
210490,201708,222,131,91,122747,85267,208014
210500,201708,554,289,265,270793,248305,519098
210510,201708,554,420,134,393540,125558,519098
210515,201708,451,235,216,220195,202392,422587
210520,201708,396,342,54,320172.9,50598,370770.9
210530,201708,9288,4970,4318,4642652.65,4040799.72,8683452.37
210535,201708,139,98,41,91826,38417,130243
210540,201708,1556,917,639,858105.4,597337.5,1455442.9
210542,201708,1146,594,552,556203.2,517224,1073427.2
210545,201708,12,11,1,10307,937,11244
210547,201708,133,114,19,106818,17803,124621
210550,201708,748,512,236,478672.9,221132,699804.9
210560,201708,175,143,32,133991,29984,163975
210565,201708,29,21,8,19677,7496,27173
210570,201708,1385,1072,313,1004464,293271.63,1297735.63
210580,201708,107,92,15,86204,14055,100259
210590,201708,780,600,180,561450.4,168660,730110.4
210592,201708,33,29,4,27173,3748,30921
210594,201708,99,82,17,76834,15929,92763
210596,201708,77,66,11,61842,10307,72149
210598,201708,122,87,35,81519,32795,114314
210600,201708,354,297,57,278289,53409,331698
210610,201708,244,227,17,211762,15929,227691
210620,201708,49,29,20,27173,18740,45913
210630,201708,60,56,4,52472,3748,56220
210632,201708,1142,725,417,679325,389979.4,1069304.4
210635,201708,14,12,2,11244,1874,13118
210637,201708,105,74,31,69338,29047,98385
210640,201708,595,513,82,480681,76834,557515
210650,201708,405,323,82,302463.6,75897,378360.6
210660,201708,406,287,119,268919,111382,380301
210663,201708,17,11,6,10307,5622,15929
210667,201708,119,37,82,34669,76834,111503
210670,201708,267,235,32,219493,29984,249477
210675,201708,568,288,280,269856,262360,532216
210680,201708,225,136,89,127432,83393,210825
210690,201708,649,502,147,470374,137739,608113
210700,201708,192,139,53,130243,49661,179904
210710,201708,309,169,140,158353,131180,289533
210720,201708,123,101,22,94637,20614,115251
210725,201708,61,54,7,50598,6559,57157
210730,201708,23,17,6,15929,5622,21551
210735,201708,409,268,141,251116,131836,382952
210740,201708,541,457,84,428209,78708,506917
210745,201708,148,104,44,97448,41228,138676
210750,201708,2413,1054,1359,985678,1273364.26,2259042.26
210760,201708,282,202,80,189274,74945.95,264219.95
210770,201708,406,311,95,290470,88733.9,379203.9
210780,201708,422,301,121,282037,113377,395414
210790,201708,186,142,44,133054,41228,174282
210800,201708,132,99,33,92763,30921,123684
210805,201708,39,36,3,33732,2811,36543
210810,201708,492,363,129,339475.1,120873,460348.1
210820,201708,2317,1811,506,1689590.77,474122,2163712.77
210825,201708,179,92,87,86204,81519,167723
210830,201708,821,485,336,453508,313895,767403
210840,201708,217,141,76,132117,71212,203329
210845,201708,257,153,104,143361,97448,240809
210850,201708,881,556,325,520972,304525,825497
210860,201708,4193,2087,2106,1954301,1973322,3927623
210870,201708,475,350,125,327950,117125,445075
210880,201708,58,39,19,36543,17803,54346
210890,201708,346,282,64,264234,59968,324202
210900,201708,535,335,200,313165.07,187400,500565.07
210905,201708,78,35,43,32795,40291,73086
210910,201708,1994,1460,534,1367304.2,500358,1867662.2
210920,201708,241,70,171,65590,160227,225817
210923,201708,78,57,21,53409,19677,73086
210927,201708,451,174,277,163038,259549,422587
210930,201708,59,46,13,43102,12181,55283
210940,201708,94,69,25,64653,23425,88078
210945,201708,201,87,114,81519,106818,188337
210950,201708,502,358,144,335446,134923.32,470369.32
210955,201708,73,49,24,45913,22488,68401
210960,201708,2461,994,1467,929785.7,1374298,2304083.7
210970,201708,111,94,17,88078,15929,104007
210975,201708,83,74,9,69338,8433,77771
210980,201708,1283,535,748,501182.56,700595,1201777.56
210990,201708,4460,2712,1748,2540863,1637876,4178739
211000,201708,1390,1074,316,1006037,295810.9,1301847.9
211003,201708,930,625,305,585625,285776,871401
211010,201708,473,412,61,386044,57157,443201
211020,201708,1632,570,1062,534090,994878.49,1528968.49
211023,201708,24,21,3,19395.9,2811,22206.9
211027,201708,60,39,21,36543,19677,56220
211030,201708,384,251,133,235187,124621,359808
211040,201708,313,233,80,218040,74960,293000
211050,201708,1194,733,461,686821,431671.32,1118492.32
211060,201708,680,575,105,538775,98385,637160
211065,201708,24,20,4,18740,3748,22488
211070,201708,915,736,179,687768.97,167723,855491.97
211080,201708,89,85,4,79645,3748,83393
211085,201708,61,32,29,29703,27173,56876
211090,201708,95,77,18,72149,16866,89015
211100,201708,500,399,101,373863,94637,468500
211102,201708,274,176,98,164912,91826,256738
211105,201708,203,136,67,127432,62779,190211
211107,201708,132,73,59,68401,55283,123684
211110,201708,814,526,288,492300,269847,762147
211120,201708,5835,2320,3515,2168387.87,3292483.32,5460871.19
211125,201708,34,27,7,25299,6559,31858
211130,201708,46554,18744,27810,17532952.25,26044757.02,43577709.27
211140,201708,444,368,76,344812,71212,416024
211150,201708,1256,771,485,721956.7,454160,1176116.7
211153,201708,174,99,75,92763,70275,163038
211157,201708,56,41,15,38417,14055,52472
211160,201708,690,563,127,526582.25,118999,645581.25
211163,201708,0,0,0,0,0,0
211167,201708,5,3,2,2811,1874,4685
211170,201708,450,307,143,287659,133991,421650
211172,201708,119,79,40,74023,37480,111503
211174,201708,289,165,124,154605,116188,270793
211176,201708,530,370,160,346690,149920,496610
211178,201708,93,58,35,54346,32795,87141
211180,201708,212,164,48,153668,44816.71,198484.71
211190,201708,62,57,5,53409,4685,58094
211195,201708,22,12,10,11244,9370,20614
211200,201708,157,136,21,127094.68,19677,146771.68
211210,201708,638,311,327,290751.1,306399,597150.1
211220,201708,3948,2203,1745,2056248.29,1626858.03,3683106.32
211223,201708,95,89,6,83214.97,5622,88836.97
211227,201708,68,46,22,43102,20614,63716
211230,201708,790,636,154,595791.45,144279.26,740070.71
211240,201708,422,310,112,290470,104944,395414
211245,201708,211,87,124,81519,116188,197707
211250,201708,1651,1395,256,1306269,239872,1546141
211260,201708,802,627,175,587499,163975,751474
211270,201708,2117,1635,482,1531995,450697.1,1982692.1
211280,201708,1833,1078,755,1008213.08,707435,1715648.08
211285,201708,216,121,95,113377,88733.9,202110.9
211290,201708,697,461,236,431769.6,221132,652901.6
211300,201708,814,614,200,575045.7,187400,762445.7
211400,201708,1639,891,748,834867,700876,1535743
220005,201708,19,18,1,16866,937,17803
220010,201708,89,67,22,62779,20332.9,83111.9
220020,201708,539,421,118,393883.6,110566,504449.6
220025,201708,107,103,4,96511,3748,100259
220027,201708,43,35,8,32795,7496,40291
220030,201708,88,73,15,68401,14055,82456
220040,201708,1101,817,284,763374.5,266108,1029482.5
220045,201708,37,28,9,26236,8433,34669
220050,201708,641,516,125,482350.88,117106.26,599457.14
220060,201708,170,144,26,134928,24362,159290
220070,201708,135,123,12,115251,11244,126495
220080,201708,8,7,1,6559,937,7496
220090,201708,33,26,7,24081,6559,30640
220095,201708,3,2,1,1874,937,2811
220100,201708,28,24,4,22488,3748,26236
220105,201708,40,37,3,34669,2811,37480
220110,201708,201,186,15,174000.9,14055,188055.9
220115,201708,42,39,3,36543,2811,39354
220117,201708,21,20,1,18740,937,19677
220120,201708,1522,1034,488,968990.11,457237.26,1426227.37
220130,201708,23,22,1,20614,937,21551
220140,201708,105,85,20,78708,18740,97448
220150,201708,445,311,134,291407,125558,416965
220155,201708,4,4,0,3748,0,3748
220157,201708,19,15,4,14055,3748,17803
220160,201708,70,62,8,58094,7496,65590
220170,201708,34,32,2,29984,1874,31858
220173,201708,8,8,0,7496,0,7496
220177,201708,5,5,0,4685,0,4685
220180,201708,67,66,1,61833.32,937,62770.32
220190,201708,1037,929,108,870473,100446.4,970919.4
220191,201708,43,38,5,35606,4685,40291
220192,201708,69,66,3,61842,2811,64653
220194,201708,23,19,4,17803,3748,21551
220196,201708,102,85,17,79505,15929,95434
220198,201708,6,4,2,3748,1874,5622
220200,201708,428,342,86,321175,80582,401757
220202,201708,37,33,4,30921,3748,34669
220205,201708,39,33,6,30921,5622,36543
220207,201708,18,17,1,15929,937,16866
220208,201708,83,42,41,39354,38417,77771
220209,201708,32,29,3,27173,2811,29984
220210,201708,16,15,1,14055,937,14992
220211,201708,46,45,1,42165,937,43102
220213,201708,43,37,6,34669,5622,40291
220217,201708,38,29,9,27173,8433,35606
220220,201708,1981,1256,725,1173331.04,678088.76,1851419.80
220225,201708,13,6,7,5622,6559,12181
220230,201708,916,732,184,685443.61,171780.21,857223.82
220240,201708,144,131,13,122747,12181,134928
220245,201708,55,51,4,47409,3748,51157
220250,201708,137,121,16,113377,14992,128369
220253,201708,43,35,8,32795,7496,40291
220255,201708,29,25,4,23425,3748,27173
220260,201708,692,507,185,475059,173345,648404
220265,201708,15,11,4,10307,3748,14055
220270,201708,634,562,72,525881.88,66995.5,592877.38
220271,201708,45,36,9,33732,8433,42165
220272,201708,28,26,2,24362,1874,26236
220273,201708,17,14,3,13118,2811,15929
220275,201708,48,37,11,34669,10307,44976
220277,201708,10,8,2,7496,1874,9370
220280,201708,22,20,2,18740,1874,20614
220285,201708,54,50,4,46850,3748,50598
220290,201708,1381,1180,201,1103178,188291,1291469
220300,201708,61,59,2,55283,1874,57157
220310,201708,305,255,50,238793.27,46841,285634.27
220320,201708,437,403,34,376206.5,31858,408064.5
220323,201708,0,0,0,0,0,0
220325,201708,14,9,5,8433,4685,13118
220327,201708,11,10,1,9370,937,10307
220330,201708,191,128,63,119654.9,59031,178685.9
220335,201708,140,124,16,116169.26,14992,131161.26
220340,201708,21,11,10,10307,9370,19677
220342,201708,52,44,8,41228,7496,48724
220345,201708,120,106,14,99322,13118,112440
220350,201708,434,382,52,355358.01,48724,404082.01
220360,201708,40,30,10,28110,9370,37480
220370,201708,1052,837,215,783332,201455,984787
220375,201708,25,24,1,22488,937,23425
220380,201708,35,27,8,25299,7496,32795
220385,201708,28,24,4,22488,3748,26236
220390,201708,2191,1247,944,1164558.94,883170.25,2047729.19
220400,201708,27,26,1,24362,937,25299
220410,201708,19,16,3,14992,2811,17803
220415,201708,12,11,1,10307,937,11244
220420,201708,133,111,22,104007,20332.9,124339.9
220430,201708,131,118,13,108927.4,12181,121108.4
220435,201708,25,18,7,16862,6559,23421
220440,201708,293,250,43,234250,40291,274541
220450,201708,311,163,148,151794,138676,290470
220455,201708,63,61,2,57157,1874,59031
220460,201708,22,21,1,19021.1,937,19958.1
220465,201708,104,66,38,61842,35606,97448
220470,201708,236,205,31,191148.8,29047,220195.8
220480,201708,73,61,12,57157,11244,68401
220490,201708,82,71,11,65770,10307,76077
220500,201708,99,86,13,80582,12181,92763
220510,201708,373,296,77,276603,71961.6,348564.6
220515,201708,21,17,4,15929,3748,19677
220520,201708,363,325,38,302842,35588,338430
220525,201708,26,18,8,16866,7496,24362
220527,201708,37,31,6,29047,5622,34669
220530,201708,35,13,22,12181,20614,32795
220535,201708,16,15,1,14055,937,14992
220540,201708,60,47,13,44039,12181,56220
220545,201708,64,41,23,38417,21551,59968
220550,201708,620,468,152,437766.4,142424,580190.4
220551,201708,27,20,7,18740,6559,25299
220552,201708,8,8,0,7496,0,7496
220553,201708,63,57,6,53409,5622,59031
220554,201708,15,9,6,8151.9,5622,13773.9
220555,201708,22,18,4,16866,3748,20614
220556,201708,61,57,4,53409,3748,57157
220557,201708,60,53,7,49661,6559,56220
220558,201708,7,2,5,1874,4685,6559
220559,201708,6,5,1,4685,937,5622
220560,201708,55,37,18,34481.6,16866,51347.6
220570,201708,764,453,311,424215.14,291407,715622.14
220580,201708,599,541,58,506917,53391.26,560308.26
220585,201708,6,5,1,4685,937,5622
220590,201708,14,14,0,13118,0,13118
220595,201708,62,47,15,43828,14055,57883
220600,201708,18,9,9,8433,8433,16866
220605,201708,21,20,1,18740,937,19677
220610,201708,59,51,8,47787,7496,55283
220620,201708,549,423,126,396116.75,118062,514178.75
220630,201708,8,6,2,5622,1874,7496
220635,201708,34,31,3,29047,2811,31858
220640,201708,99,75,24,70275,22488,92763
220650,201708,117,110,7,103070,6559,109629
220660,201708,25,19,6,17803,5622,23425
220665,201708,5,4,1,3748,937,4685
220667,201708,10,10,0,9370,0,9370
220669,201708,21,18,3,16866,2811,19677
220670,201708,66,52,14,48536.6,13118,61654.6
220672,201708,53,37,16,34669,14710.9,49379.9
220675,201708,34,26,8,24362,7496,31858
220680,201708,34,28,6,26236,5622,31858
220690,201708,52,47,5,44039,4685,48724
220695,201708,65,31,34,29047,31858,60905
220700,201708,1466,1119,347,1046382.52,324858,1371240.52
220710,201708,4,2,2,1874,1874,3748
220720,201708,121,97,24,90654.75,22347.45,113002.20
220730,201708,20,19,1,17803,937,18740
220735,201708,3,1,2,937,1874,2811
220740,201708,39,37,2,34669,1874,36543
220750,201708,100,81,19,75897,17803,93700
220755,201708,15,15,0,14055,0,14055
220760,201708,49,46,3,43102,2811,45913
220770,201708,5642,2788,2854,2606863.52,2668451.13,5275314.65
220775,201708,26,12,14,11244,13118,24362
220777,201708,15,14,1,13118,937,14055
220779,201708,16,13,3,12181,2811,14992
220780,201708,855,725,130,678669.1,121529,800198.1
220785,201708,8,5,3,4685,2811,7496
220790,201708,1000,789,211,736934.34,197707,934641.34
220793,201708,14,14,0,13118,0,13118
220795,201708,25,24,1,22488,937,23425
220800,201708,3782,2867,915,2685054.88,856400.74,3541455.62
220810,201708,52,48,4,44976,3748,48724
220820,201708,236,215,21,201455,19677,221132
220830,201708,1123,946,177,886397.32,165849,1052246.32
220840,201708,2385,1574,811,1462427.1,757667,2220094.1
220850,201708,51,40,11,37480,10307,47787
220855,201708,15,10,5,9370,4685,14055
220860,201708,12,11,1,10307,937,11244
220865,201708,19,17,2,15929,1874,17803
220870,201708,57,54,3,50598,2811,53409
220880,201708,339,257,82,240153.1,76553,316706.1
220885,201708,45,40,5,37480,4685,42165
220887,201708,20,19,1,17803,937,18740
220890,201708,105,92,13,86204,12181,98385
220900,201708,46,26,20,24362,18740,43102
220910,201708,54,45,9,42165,8433,50598
220915,201708,16,15,1,14055,937,14992
220920,201708,40,36,4,33732,3748,37480
220930,201708,41,40,1,36680.73,937,37617.73
220935,201708,20,19,1,17803,937,18740
220937,201708,42,39,3,36543,2811,39354
220940,201708,48,43,5,40291,4685,44976
220945,201708,0,0,0,0,0,0
220950,201708,48,44,4,41228,3748,44976
220955,201708,42,39,3,36543,2811,39354
220960,201708,4,4,0,3748,0,3748
220965,201708,26,22,4,20614,3748,24362
220970,201708,46,37,9,34669,8433,43102
220975,201708,9,8,1,7496,937,8433
220980,201708,40,36,4,33732,3748,37480
220985,201708,61,55,6,51535,5622,57157
220987,201708,32,30,2,28110,1874,29984
220990,201708,12,11,1,10307,937,11244
220995,201708,38,33,5,30921,4685,35606
220997,201708,31,25,6,23425,5622,29047
221000,201708,1068,956,112,893198.81,104662.9,997861.71
221005,201708,66,61,5,57157,4685,61842
221010,201708,15,13,2,12181,1874,14055
221020,201708,51,48,3,44976,2811,47787
221030,201708,36,29,7,27173,6559,33732
221035,201708,19,18,1,16866,937,17803
221037,201708,12,6,6,5622,5622,11244
221038,201708,14,12,2,11244,1874,13118
221039,201708,24,24,0,22488,0,22488
221040,201708,248,213,35,199581,32795,232376
221050,201708,226,191,35,178967,32795,211762
221060,201708,1445,1258,187,1177949.55,175219,1353168.55
221062,201708,32,31,1,29047,937,29984
221063,201708,16,12,4,11244,3748,14992
221065,201708,41,36,5,33732,4685,38417
221070,201708,152,131,21,122747,19677,142424
221080,201708,370,325,45,304525,41883.9,346408.9
221090,201708,41,40,1,37228,937,38165
221093,201708,71,49,22,45913,20614,66527
221095,201708,12,10,2,9370,1874,11244
221097,201708,27,24,3,22488,2811,25299
221100,201708,23996,13696,10300,12809442.48,9646399.34,22455841.82
221110,201708,1001,733,268,686540,251116,937656
221120,201708,507,375,132,351094,123684,474778
221130,201708,905,738,167,689979.69,155824,845803.69
221135,201708,32,29,3,27173,2811,29984
221140,201708,40,31,9,29047,8433,37480
221150,201708,15,11,4,10307,3748,14055
221160,201708,11,11,0,10307,0,10307
221170,201708,11,11,0,10307,0,10307
230010,201708,156,145,11,135865,10307,146172
230015,201708,117,99,18,92763,16866,109629
230020,201708,1478,1271,207,1188679,193211.93,1381890.93
230030,201708,1569,1117,452,1041159.62,423524,1464683.62
230040,201708,197,174,23,162101,21551,183652
230050,201708,196,143,53,133991,49661,183652
230060,201708,140,112,28,104194.4,26236,130430.4
230070,201708,280,248,32,232376,29984,262360
230075,201708,786,687,99,641753,92481.9,734234.9
230080,201708,173,153,20,143361,18740,162101
230090,201708,88,62,26,57344.4,24362,81706.4
230100,201708,1861,1113,748,1040617,700876,1741493
230110,201708,2592,1643,949,1536193.6,888650.9,2424844.5
230120,201708,908,717,191,669486.91,178949,848435.91
230125,201708,132,105,27,98385,25299,123684
230130,201708,445,398,47,372926,44039,416965
230140,201708,211,183,28,171471,26236,197707
230150,201708,155,121,34,113377,31858,145235
230160,201708,902,793,109,742338.5,102133,844471.5
230170,201708,568,520,48,483495.1,44976,528471.1
230180,201708,78,73,5,68401,4685,73086
230185,201708,390,336,54,313491.16,50598,364089.16
230190,201708,2160,1741,419,1628222.69,392291,2020513.69
230195,201708,481,419,62,392603,58094,450697
230200,201708,360,312,48,291397.63,44311,335708.63
230205,201708,335,211,124,195968.86,116188,312156.86
230210,201708,1238,987,251,923893.18,234437.4,1158330.58
230220,201708,1338,934,404,874408.4,378548,1252956.4
230230,201708,897,791,106,739167.03,99322,838489.03
230240,201708,1598,1374,224,1285784.85,209888,1495672.85
230250,201708,1721,1408,313,1315967.47,292719,1608686.47
230260,201708,2852,1687,1165,1575900.79,1090668.75,2666569.54
230270,201708,1319,1063,256,994176.33,236827.95,1231004.28
230280,201708,2655,1976,679,1846173.97,635286,2481459.97
230290,201708,392,354,38,325481.07,35606,361087.07
230300,201708,501,368,133,343579.16,124621,468200.16
230310,201708,409,306,103,286722,96230,382952
230320,201708,871,747,124,696870.17,116179,813049.17
230330,201708,289,233,56,217571.4,52285,269856.4
230340,201708,450,359,91,334697.4,85267,419964.4
230350,201708,2912,1827,1085,1711880.26,1013835.24,2725715.50
230360,201708,243,215,28,200561,26236,226797
230365,201708,169,136,33,126730,30921,157651
230370,201708,9367,4517,4850,4223867.99,4540370.65,8764238.64
230380,201708,451,387,64,362338,59031.8,421369.8
230390,201708,491,267,224,248408.07,209888,458296.07
230393,201708,269,225,44,209985.4,41228,251213.4
230395,201708,326,267,59,249936,55283,305219
230400,201708,600,477,123,444700.9,114763.76,559464.66
230410,201708,2530,1568,962,1463689.14,901113,2364802.14
230420,201708,5718,3706,2012,3453503.74,1880744.9,5334248.64
230423,201708,299,257,42,238935.8,39354,278289.8
230425,201708,329,273,56,255801,52472,308273
230426,201708,105,94,11,87365.88,10025.9,97391.78
230427,201708,77,74,3,69338,2811,72149
230428,201708,1317,676,641,633187.12,600617,1233804.12
230430,201708,436,347,89,324948,82629.34,407577.34
230435,201708,749,520,229,486200,213355.17,699555.17
230440,201708,81218,35604,45614,33281924.98,42700012.65,75981937.63
230445,201708,258,181,77,169409.6,71867.9,241277.5
230450,201708,538,437,101,409469,94637,504106
230460,201708,53,44,9,41228,8433,49661
230465,201708,288,232,56,217384,52472,269856
230470,201708,1797,1388,409,1300556,382296.25,1682852.25
230480,201708,145,140,5,130898.9,4685,135583.9
230490,201708,272,221,51,207077,47787,254864
230495,201708,413,310,103,289633,96511,386144
230500,201708,926,695,231,649341,216438,865779
230510,201708,40,33,7,30921,6559,37480
230520,201708,388,305,83,285785,77771,363556
230523,201708,1821,1163,658,1088205.4,616106,1704311.4
230526,201708,285,239,46,223943,43102,267045
230530,201708,660,497,163,462730.38,151794.6,614524.98
230533,201708,170,165,5,154605,4685,159290
230535,201708,336,251,85,235187,79645,314832
230540,201708,1830,1599,231,1495664.7,216166,1711830.7
230550,201708,3574,2268,1306,2117988.43,1222878.7,3340867.13
230560,201708,581,444,137,413967.4,127180.54,541147.94
230565,201708,181,131,50,122747,46850,169597
230570,201708,307,271,36,253927,33732,287659
230580,201708,1088,800,288,748166.39,268637.9,1016804.29
230590,201708,916,711,205,662038.15,191616.5,853654.65
230600,201708,244,226,18,210094.32,16866,226960.32
230610,201708,325,260,65,243433,60905,304338
230620,201708,159,130,29,120873,27173,148046
230625,201708,708,508,200,474638.25,186267.04,660905.29
230630,201708,1210,949,261,889213,244182.2,1133395.2
230640,201708,3365,2927,438,2735775.66,409661.09,3145436.75
230650,201708,384,338,46,315889.49,43102,358991.49
230655,201708,611,532,79,497547.4,73957.9,571505.3
230660,201708,323,270,53,252990,49379.9,302369.9
230670,201708,419,375,44,351375,41228,392603
230680,201708,200,185,15,173345,14055,187400
230690,201708,838,734,104,687758,97448,785206
230700,201708,703,598,105,560326,97822.8,658148.8
230710,201708,719,677,42,634162,39354,673516
230720,201708,137,114,23,106621.23,21551,128172.23
230725,201708,217,173,44,162101,41219,203320
230730,201708,11328,6128,5200,5723975.89,4864234.39,10588210.28
230740,201708,646,511,135,478526,125816.63,604342.63
230750,201708,783,666,117,622871.15,109629,732500.15
230760,201708,1233,1067,166,995805.59,155542,1151347.59
230763,201708,331,272,59,252943.41,55283,308226.41
230765,201708,6569,3035,3534,2837310.25,3309130.1,6146440.35
230770,201708,4861,2491,2370,2325053.34,2217658.14,4542711.48
230780,201708,667,587,80,547234.57,74960,622194.57
230790,201708,182,147,35,137739,32795,170534
230800,201708,1086,793,293,743036.32,274541,1017577.32
230810,201708,1246,1106,140,1035057.05,130992.6,1166049.65
230820,201708,313,223,90,208015,84330,292345
230830,201708,932,810,122,755519.6,114314,869833.6
230835,201708,269,233,36,217384,33030,250414
230837,201708,161,134,27,125558,25299,150857
230840,201708,864,689,175,644375.5,162757,807132.5
230850,201708,1437,1262,175,1182212.9,163694,1345906.9
230860,201708,308,224,84,209888,77771.25,287659.25
230870,201708,1753,1484,269,1389290,250741.4,1640031.4
230880,201708,19,12,7,11244,6559,17803
230890,201708,567,524,43,490867.98,40291,531158.98
230900,201708,259,198,61,185526,56964,242490
230910,201708,188,151,37,140737.4,34669,175406.4
230920,201708,390,309,81,289533,75897,365430
230930,201708,899,640,259,596869.92,242683,839552.92
230940,201708,826,664,162,621886.9,151607,773493.9
230945,201708,442,373,69,349314,64653,413967
230950,201708,369,315,54,295155,50598,345753
230960,201708,2372,1587,785,1480419.51,735264,2215683.51
230970,201708,1658,932,726,872388.45,679399.96,1551788.41
230980,201708,201,168,33,157416,30921,188337
230990,201708,138,112,26,104944,23618.95,128562.95
231000,201708,197,181,16,167723.74,14992,182715.74
231010,201708,130,101,29,94637,27173,121810
231020,201708,1216,850,366,794857.5,342942,1137799.5
231025,201708,906,674,232,629316.6,215866.9,845183.5
231030,201708,1145,960,185,899516,173064,1072580
231040,201708,135,93,42,86410.14,38636,125046.14
231050,201708,1011,897,114,838617.5,106818,945435.5
231060,201708,137,119,18,111503,16866,128369
231070,201708,1373,971,402,907485.45,376674,1284159.45
231080,201708,259,242,17,225957.55,15929,241886.55
231085,201708,507,316,191,295156,178967,474123
231090,201708,224,189,35,177093,32795,209888
231095,201708,162,128,34,119936,31858,151794
231100,201708,118,96,22,89952,19395.9,109347.9
231110,201708,328,282,46,262739.39,43102,305841.39
231120,201708,302,260,42,242669.88,39167,281836.88
231123,201708,132,125,7,117125,6559,123684
231126,201708,274,235,39,220195,36543,256738
231130,201708,4462,3470,992,3243816.34,928623.32,4172439.66
231135,201708,195,169,26,158353,23120.2,181473.2
231140,201708,3009,2217,792,2073763.79,741129.52,2814893.31
231150,201708,342,326,16,305462,14992,320454
231160,201708,1179,933,246,871223.35,230277.12,1101500.47
231170,201708,538,347,191,325139,178967,504106
231180,201708,1511,1271,240,1190037.4,224880,1414917.4
231190,201708,212,190,22,178030,20614,198644
231195,201708,210,182,28,169822.91,26236,196058.91
231200,201708,814,668,146,625916,135564,761480
231210,201708,594,495,99,462878,92763,555641
231220,201708,994,717,277,670874.26,259549,930423.26
231230,201708,1334,1072,262,1003097.3,244744.4,1247841.7
231240,201708,1284,931,353,872065.9,329543.1,1201609.0
231250,201708,107,100,7,93700,6559,100259
231260,201708,295,189,106,177093,99041,276134
231270,201708,978,815,163,759315.49,152722,912037.49
231280,201708,50,40,10,37480,9370,46850
231290,201708,7072,3887,3185,3634249.3,2981834.61,6616083.91
231300,201708,610,563,47,527531,44039,571570
231310,201708,688,641,47,599239,44034.32,643273.32
231320,201708,543,422,121,394947,113377,508324
231325,201708,85,74,11,69338,10307,79645
231330,201708,1985,1540,445,1437503.19,414062.3,1851565.49
231335,201708,246,214,32,200518,29984,230502
231340,201708,1540,1138,402,1065182.24,376674,1441856.24
231350,201708,1108,909,199,851733,185901,1037634
231355,201708,377,328,49,307336,45913,353249
231360,201708,457,365,92,339343.1,86204,425547.1
231370,201708,86,69,17,64653,15929,80582
231375,201708,270,197,73,184589,68401,252990
231380,201708,421,346,75,322635.36,70087.6,392722.96
231390,201708,191,157,34,147109,31858,178967
231395,201708,719,440,279,411005.68,261423,672428.68
231400,201708,1025,848,177,792049.55,165511.9,957561.45
231410,201708,1268,1017,251,948386.7,234251,1182637.7
240010,201708,391,186,205,172869.54,191890,364759.54
240020,201708,2116,1630,486,1525864.07,455382,1981246.07
240030,201708,173,142,31,133054,29047,162101
240040,201708,31,31,0,29047,0,29047
240050,201708,491,421,70,393638.66,65590,459228.66
240060,201708,71,66,5,61842,4685,66527
240070,201708,163,123,40,115251,37480,152731
240080,201708,389,250,139,234246,130243,364489
240090,201708,108,95,13,88716,12181,100897
240100,201708,1410,1328,82,1241416.18,76626.49,1318042.67
240110,201708,944,591,353,552109.28,330761,882870.28
240120,201708,144,121,23,113377,21551,134928
240130,201708,286,268,18,250412.31,16866,267278.31
240140,201708,87,66,21,61842,19677,81519
240145,201708,651,572,79,535448.65,73816.86,609265.51
240150,201708,19,16,3,14992,2796.95,17788.95
240160,201708,47,39,8,36543,7496,44039
240165,201708,33,30,3,27876,2811,30687
240170,201708,90,72,18,67464,16866,84330
240180,201708,76,62,14,58094,13118,71212
240185,201708,42,39,3,36533.63,2811,39344.63
240190,201708,20,17,3,15929,2811,18740
240200,201708,2929,1635,1294,1526521.3,1211261,2737782.3
240210,201708,164,128,36,119936,33732,153668
240220,201708,1110,794,316,743978,296082.63,1040060.63
240230,201708,803,745,58,695281.68,53709,748990.68
240240,201708,141,101,40,94637,37480,132117
240250,201708,100,89,11,83393,10307,93700
240260,201708,1760,1304,456,1221173.36,426306.89,1647480.25
240270,201708,185,165,20,154230.2,18740,172970.2
240280,201708,43,33,10,30921,9370,40291
240290,201708,62,60,2,56220,1874,58094
240300,201708,174,101,73,94637,68401,163038
240310,201708,1890,1027,863,953591.66,805454.06,1759045.72
240320,201708,212,202,10,189274,9370,198644
240325,201708,4154,2537,1617,2368784.17,1512994.41,3881778.58
240330,201708,72,69,3,64653,2811,67464
240340,201708,103,73,30,68401,28110,96511
240350,201708,93,81,12,75897,11244,87141
240360,201708,355,259,96,242402,89952,332354
240370,201708,39,37,2,34669,1874,36543
240375,201708,81,49,32,45913,29984,75897
240380,201708,243,199,44,185566,41135,226701
240390,201708,18,15,3,14055,2811,16866
240400,201708,82,79,3,74023,2811,76834
240410,201708,11,7,4,6559,3748,10307
240420,201708,848,656,192,613362.07,178892.04,792254.11
240430,201708,257,242,15,225048.11,14055,239103.11
240440,201708,66,36,30,33732,28110,61842
240450,201708,190,124,66,115625.9,61842,177467.9
240460,201708,60,46,14,43102,13118,56220
240470,201708,231,198,33,184978.79,30921,215899.79
240480,201708,17,17,0,15835.3,0,15835.3
240485,201708,70,60,10,56329,9370,65699
240490,201708,47,47,0,43833,0,43833
240500,201708,84,68,16,63716,14992,78708
240510,201708,49,35,14,32795,13118,45913
240520,201708,130,124,6,116188,5622,121810
240530,201708,46,40,6,37480,5622,43102
240540,201708,81,69,12,64653,11234.63,75887.63
240550,201708,16,13,3,12181,2811,14992
240560,201708,362,265,97,247689.4,90889,338578.4
240570,201708,435,266,169,248117.6,158353,406470.6
240580,201708,1253,1011,242,941171.35,225616.6,1166787.95
240590,201708,30,27,3,25299,2811,28110
240600,201708,116,116,0,108692,0,108692
240610,201708,513,429,84,401692,77959,479651
240615,201708,42,40,2,37480,1874,39354
240620,201708,93,89,4,82456,3748,86204
240630,201708,40,38,2,35606,1874,37480
240640,201708,27,23,4,21551,3748,25299
240650,201708,225,190,35,177188,32795,209983
240660,201708,93,81,12,75897,11244,87141
240670,201708,275,160,115,147859.15,107755,255614.15
240680,201708,55,43,12,40291,11244,51535
240690,201708,53,50,3,46850,2811,49661
240700,201708,198,165,33,154605,30921,185526
240710,201708,1841,1173,668,1098446.3,625082.07,1723528.37
240720,201708,1013,739,274,691497.23,256738,948235.23
240725,201708,67,64,3,59968,2811,62779
240730,201708,130,114,16,106818,14992,121810
240740,201708,231,194,37,180438.09,34669,215107.09
240750,201708,36,23,13,21551,12181,33732
240760,201708,34,30,4,28110,3748,31858
240770,201708,147,113,34,105881,31858,137739
240780,201708,695,583,112,544575.03,104944,649519.03
240790,201708,41,39,2,36543,1874,38417
240800,201708,8319,5639,2680,5247878.91,2505024.6,7752903.51
240810,201708,19628,10768,8860,10048961.21,8292079.5,18341040.71
240820,201708,188,120,68,112154.22,63716,175870.22
240830,201708,1557,1279,278,1192015.15,259550,1451565.15
240840,201708,78,66,12,61842,11244,73086
240850,201708,92,80,12,74960,11244,86204
240860,201708,115,113,2,105881,1874,107755
240870,201708,54,47,7,44039,6559,50598
240880,201708,26,25,1,23415.63,937,24352.63
240890,201708,1108,649,459,604274.29,429142,1033416.29
240895,201708,43,32,11,29984,10307,40291
240910,201708,151,136,15,127432,14055,141487
240920,201708,17,13,4,12181,3748,15929
240930,201708,368,332,36,310147,33732,343879
240933,201708,24,17,7,15929,6559,22488
240940,201708,2383,2107,276,1961944.31,256063.36,2218007.67
240950,201708,48,47,1,44039,937,44976
240960,201708,33,25,8,23425,7496,30921
240970,201708,151,109,42,102133,38617,140750
240980,201708,184,146,38,136802,35606,172408
240990,201708,120,79,41,74023,38417,112440
241000,201708,82,73,9,68401,8433,76834
241010,201708,59,46,13,43102,12181,55283
241020,201708,116,109,7,102133,6559,108692
241025,201708,9,3,6,2811,5622,8433
241030,201708,120,98,22,91826,20614,112440
241040,201708,30,25,5,23425,4685,28110
241050,201708,101,84,17,78708,15929,94637
241060,201708,36,32,4,29984,3748,33732
241070,201708,18,18,0,16866,0,16866
241080,201708,65,57,8,53127.9,7496,60623.9
241090,201708,54,45,9,42165,8404.95,50569.95
241100,201708,75,68,7,63716,6559,70275
241105,201708,8,3,5,2811,4685,7496
241110,201708,50,47,3,44039,2811,46850
241120,201708,1368,1057,311,987477.4,290544.96,1278022.36
241140,201708,230,187,43,174283,40291,214574
241142,201708,43,42,1,39354,937,40291
241150,201708,1192,1048,144,979306.5,134928,1114234.5
241160,201708,27,25,2,23425,1874,25299
241170,201708,42,39,3,36543,2811,39354
241180,201708,49,39,10,36371.53,9370,45741.53
241190,201708,47,46,1,43102,937,44039
241200,201708,3713,2045,1668,1911486.61,1561029.74,3472516.35
241210,201708,72,59,13,55283,11338,66621
241220,201708,1329,881,448,824887.7,419757.26,1244644.96
241230,201708,232,194,38,181590.6,35606,217196.6
241240,201708,51,39,12,36543,11244,47787
241250,201708,1041,969,72,907533,67183,974716
241255,201708,42,34,8,31858,7496,39354
241260,201708,626,496,130,464747.32,121810,586557.32
241270,201708,48,32,16,29984,14992,44976
241280,201708,101,87,14,81519,13118,94637
241290,201708,107,80,27,74960,25299,100259
241300,201708,81,57,24,53409,22488,75897
241310,201708,52,40,12,37340,11244,48584
241320,201708,29,16,13,14616,12181,26797
241330,201708,58,52,6,48724,5622,54346
241335,201708,55,47,8,44039,7496,51535
241340,201708,183,138,45,129306,42165,171471
241350,201708,58,53,5,49661,4685,54346
241355,201708,42,39,3,36543,2811,39354
241360,201708,48,48,0,44976,0,44976
241370,201708,44,37,7,34433.32,6559,40992.32
241380,201708,44,42,2,39354,1874,41228
241390,201708,71,56,15,52284.6,14055,66339.6
241400,201708,185,151,34,140832,31858,172690
241410,201708,179,162,17,151794,15836,167630
241415,201708,90,71,19,66527,17803,84330
241420,201708,93,71,22,66527,20446,86973
241430,201708,27,26,1,24362,937,25299
241440,201708,443,375,68,351375,63716,415091
241445,201708,34,32,2,29984,1874,31858
241450,201708,283,231,52,216323,48724,265047
241460,201708,130,117,13,109395,12181,121576
241470,201708,47,39,8,36543,7496,44039
241475,201708,72,68,4,63716,3748,67464
241480,201708,91,67,24,62779,22488,85267
241490,201708,10,8,2,7496,1593,9089
241500,201708,49,36,13,33732,12181,45913
250010,201708,100,87,13,81519,12181,93700
250020,201708,23,20,3,18740,2811,21551
250030,201708,801,581,220,543076.1,204296.51,747372.61
250040,201708,311,259,52,242683,48724,291407
250050,201708,215,178,37,166782,34669,201451
250053,201708,55,43,12,40291,11244,51535
250057,201708,0,0,0,0,0,0
250060,201708,435,340,95,318580,89015,407595
250070,201708,676,578,98,539606,91826,631432
250073,201708,7,7,0,6559,0,6559
250077,201708,211,156,55,145788.6,51535,197323.6
250080,201708,415,321,94,299185.1,88078,387263.1
250090,201708,217,146,71,135865.2,65671.26,201536.46
250100,201708,453,370,83,346690,77397,424087
250110,201708,472,354,118,329946.6,110566,440512.6
250115,201708,29,8,21,7496,19677,27173
250120,201708,102,77,25,72149,23425,95574
250130,201708,582,458,124,429146,116001,545147
250135,201708,13,8,5,7496,4685,12181
250140,201708,73,64,9,59968,8433,68401
250150,201708,547,407,140,379232,130870.79,510102.79
250153,201708,11,10,1,9370,937,10307
250157,201708,29,24,5,22488,4685,27173
250160,201708,209,163,46,152731,43102,195833
250170,201708,67,47,20,44039,18740,62779
250180,201708,3899,2631,1268,2452182.76,1183342.75,3635525.51
250190,201708,924,601,323,561497.25,301948.25,863445.50
250200,201708,52,44,8,41228,7496,48724
250205,201708,18,15,3,14055,2811,16866
250210,201708,87,75,12,70275,11244,81519
250215,201708,62,53,9,49661,8433,58094
250220,201708,27,20,7,18740,6559,25299
250230,201708,70,65,5,60905,4685,65590
250240,201708,235,193,42,180044.55,39354,219398.55
250250,201708,386,332,54,311084,50598,361682
250260,201708,30,25,5,23425,4685,28110
250270,201708,58,46,12,43102,11244,54346
250280,201708,386,323,63,302651,59031,361682
250290,201708,89,84,5,78426.9,4685,83111.9
250300,201708,558,385,173,360109.24,162088,522197.24
250310,201708,44,37,7,34669,6559,41228
250320,201708,1844,1269,575,1183035.84,537548,1720583.84
250330,201708,81,70,11,65590,10307,75897
250340,201708,24,20,4,18740,3748,22488
250350,201708,132,81,51,75615.9,47224.8,122840.7
250355,201708,25,20,5,18740,4685,23425
250360,201708,199,162,37,151794,34435,186229
250370,201708,2321,1576,745,1470905.59,696535.71,2167441.30
250375,201708,21,17,4,15929,3748,19677
250380,201708,50,34,16,31858,14992,46850
250390,201708,35,29,6,27173,5622,32795
250400,201708,15319,7753,7566,7241950.79,7082431.29,14324382.08
250403,201708,424,347,77,325129.64,72149,397278.64
250407,201708,52,46,6,43102,5622,48724
250410,201708,29,24,5,22488,4685,27173
250415,201708,45,29,16,27173,14973.26,42146.26
250420,201708,47,38,9,35606,8433,44039
250430,201708,1664,1393,271,1303087,253927,1557014
250435,201708,13,11,2,10307,1874,12181
250440,201708,686,593,93,553309.29,87141,640450.29
250450,201708,84,70,14,65590,12462.1,78052.1
250460,201708,407,271,136,253927,127299.42,381226.42
250470,201708,89,64,25,59968,23425,83393
250480,201708,322,253,69,237061,64653,301714
250485,201708,1,1,0,937,0,937
250490,201708,205,168,37,157416,34669,192085
250500,201708,70,50,20,46850,18740,65590
250510,201708,726,561,165,524345.8,153614.41,677960.21
250520,201708,173,118,55,110547.28,51530.32,162077.60
250523,201708,108,89,19,83393,17803,101196
250527,201708,103,79,24,74018.32,22488,96506.32
250530,201708,6,5,1,4685,937,5622
250535,201708,27,22,5,20614,4685,25299
250540,201708,125,94,31,87375.25,29047,116422.25
250550,201708,68,65,3,60905,2811,63716
250560,201708,36,31,5,29047,4685,33732
250570,201708,152,119,33,111503,30921,142424
250580,201708,140,109,31,101851.9,29047,130898.9
250590,201708,19,15,4,14055,3748,17803
250600,201708,1286,873,413,814723.64,386883.32,1201606.96
250610,201708,152,131,21,122747,19677,142424
250620,201708,20,16,4,14992,3748,18740
250625,201708,58,43,15,40291,14055,54346
250630,201708,2978,1904,1074,1776727.07,1003787.75,2780514.82
250640,201708,201,168,33,157416,30921,188337
250650,201708,31,21,10,19677,9370,29047
250660,201708,38,31,7,29047,6559,35606
250670,201708,53,33,20,30921,18740,49661
250680,201708,391,318,73,297966,68401,366367
250690,201708,1755,1200,555,1121022.03,519660.9,1640682.93
250700,201708,938,822,116,765832.3,108485.86,874318.16
250710,201708,444,344,100,322328,93700,416028
250720,201708,100,79,21,74023,19677,93700
250730,201708,363,304,59,284848,55283,340131
250740,201708,47,43,4,40291,3748,44039
250750,201708,19698,11763,7935,10966185.45,7426223.03,18392408.48
250760,201708,63,49,14,45913,13118,59031
250770,201708,344,232,112,216447.31,103796.27,320243.58
250780,201708,57,45,12,42165,11244,53409
250790,201708,482,305,177,282974.76,165146.25,448121.01
250800,201708,149,138,11,128603.25,10307,138910.25
250810,201708,80,60,20,56220,18740,74960
250820,201708,157,126,31,118062,29047,147109
250830,201708,429,285,144,266061.25,134928,400989.25
250840,201708,53,50,3,46850,2811,49661
250850,201708,49,39,10,35868.36,9370,45238.36
250855,201708,13,11,2,10307,1874,12181
250860,201708,199,142,57,133054,53127.9,186181.9
250870,201708,33,30,3,28110,2811,30921
250880,201708,75,56,19,52425.15,17803,70228.15
250890,201708,2293,1685,608,1577533.2,568848.57,2146381.77
250900,201708,62,51,11,47787,10307,58094
250905,201708,130,100,30,93700,28110,121810
250910,201708,1158,822,336,768794.46,314550.9,1083345.36
250915,201708,111,76,35,71212,32795,104007
250920,201708,138,104,34,97448,31858,129306
250930,201708,150,96,54,89952,50598,140550
250933,201708,0,0,0,0,0,0
250937,201708,8,7,1,6559,937,7496
250939,201708,30,23,7,21551,6559,28110
250940,201708,103,77,26,72149,24362,96511
250950,201708,75,50,25,46850,23425,70275
250960,201708,89,49,40,45892.89,37480,83372.89
250970,201708,1183,833,350,778929,327668.9,1106597.9
250980,201708,90,62,28,58094,26236,84330
250990,201708,158,122,36,113878.35,33689.85,147568.20
251000,201708,72,66,6,61654.6,5622,67276.6
251010,201708,90,70,20,65586,17975.4,83561.4
251020,201708,81,71,10,65730.55,9370,75100.55
251030,201708,42,32,10,29984,9370,39354
251040,201708,54,38,16,35606,14992,50598
251050,201708,25,23,2,21551,1874,23425
251060,201708,46,38,8,34669,7496,42165
251065,201708,4,3,1,2811,937,3748
251070,201708,26,20,6,18731,5622,24353
251080,201708,4643,2242,2401,2088600.78,2243300.41,4331901.19
251090,201708,198,169,29,158353,27173,185526
251100,201708,19,18,1,16866,937,17803
251110,201708,46,37,9,34669,8433,43102
251120,201708,1752,1038,714,967830.05,669018,1636848.05
251130,201708,341,275,66,257675,61842,319517
251140,201708,495,317,178,295906,166620.34,462526.34
251150,201708,290,252,38,235366,35606,270972
251160,201708,91,75,16,70271,14992,85263
251170,201708,102,80,22,74931.92,20604.64,95536.56
251180,201708,288,179,109,167718.32,102124.32,269842.64
251190,201708,191,131,60,122424.68,56220,178644.68
251200,201708,249,199,50,186463,46850,233313
251203,201708,30,28,2,26236,1874,28110
251207,201708,93,77,16,72149,14992,87141
251210,201708,1216,860,356,804293.89,332916.1,1137209.99
251220,201708,47,37,10,34669,9370,44039
251230,201708,511,432,79,404764,74023,478787
251240,201708,103,73,30,67464,28110,95574
251250,201708,1303,932,371,871176.1,347487,1218663.1
251260,201708,13,8,5,7496,4685,12181
251270,201708,336,247,89,231439,83253,314692
251272,201708,71,65,6,60905,5622,66527
251274,201708,26,21,5,19677,4685,24362
251275,201708,21,15,6,14055,5622,19677
251276,201708,17,14,3,13118,2811,15929
251278,201708,9,7,2,6559,1874,8433
251280,201708,89,85,4,79645,3748,83393
251290,201708,692,522,170,489114,159290,648404
251300,201708,17,15,2,14055,1874,15929
251310,201708,351,252,99,236120,92763,328883
251315,201708,15,14,1,13118,937,14055
251320,201708,58,46,12,43102,11244,54346
251330,201708,79,70,9,65590,8433,74023
251335,201708,9,5,4,4685,3748,8433
251340,201708,681,408,273,382296,254794.63,637090.63
251350,201708,33,31,2,29047,1874,30921
251360,201708,62,54,8,50395.61,7496,57891.61
251365,201708,14,14,0,13118,0,13118
251370,201708,5177,3497,1680,3271050.39,1572348.7,4843399.09
251380,201708,50,40,10,37480,9370,46850
251385,201708,2,2,0,1874,0,1874
251390,201708,635,508,127,474872.6,117781,592653.6
251392,201708,28,18,10,16866,9370,26236
251394,201708,9,9,0,8433,0,8433
251396,201708,18,14,4,13118,3748,16866
251398,201708,18,15,3,14055,2811,16866
251400,201708,35,29,6,27173,5622,32795
251410,201708,33,29,4,27173,3748,30921
251420,201708,107,82,25,76834,23425,100259
251430,201708,36,34,2,31858,1874,33732
251440,201708,38,24,14,22479,13118,35597
251445,201708,48,42,6,39354,5622,44976
251450,201708,412,364,48,339442.4,44976,384418.4
251455,201708,2,1,1,937,937,1874
251460,201708,16,12,4,11244,3748,14992
251465,201708,5,2,3,1874,2811,4685
251470,201708,44,36,8,33732,7496,41228
251480,201708,23,21,2,19677,1874,21551
251490,201708,131,92,39,85736,35607,121343
251500,201708,114,92,22,86204,19865,106069
251510,201708,31,24,7,22488,6559,29047
251520,201708,23,23,0,21551,0,21551
251530,201708,4547,3183,1364,2977801.09,1277777.53,4255578.62
251540,201708,74,66,8,61842,7496,69338
251550,201708,423,323,100,301714.6,93466,395180.6
251560,201708,23,18,5,16866,4685,21551
251570,201708,17,17,0,15929,0,15929
251580,201708,115,93,22,87141,20614,107755
251590,201708,130,96,34,89952,31858,121810
251593,201708,18,10,8,9370,7496,16866
251597,201708,60,49,11,45913,10307,56220
251600,201708,1098,779,319,728611.94,297206.26,1025818.20
251610,201708,207,157,50,146453.1,46195,192648.1
251615,201708,1,1,0,937,0,937
251620,201708,4223,2830,1393,2643123.07,1302806.34,3945929.41
251630,201708,419,307,112,287659,104944,392603
251640,201708,148,104,44,97448,41228,138676
251650,201708,257,186,71,172483.55,66527,239010.55
251660,201708,218,198,20,184589.55,18552.6,203142.15
251670,201708,352,276,76,257048.07,71212,328260.07
251675,201708,3,3,0,2811,0,2811
251680,201708,87,80,7,74960,6559,81519
251690,201708,335,279,56,261423,52128.13,313551.13
251700,201708,278,226,52,211185.75,48709.95,259895.70
251710,201708,18,12,6,11244,5622,16866
251720,201708,34,23,11,21551,10026,31577
251740,201708,9,7,2,6559,1874,8433
260005,201708,3040,1732,1308,1612642.06,1224451.55,2837093.61
260010,201708,1298,914,384,853255.76,357840.96,1211096.72
260020,201708,433,380,53,356060,49661,405721
260030,201708,561,407,154,380605.65,144298,524903.65
260040,201708,852,519,333,484438.45,311871.08,796309.53
260050,201708,1118,786,332,735780,310522,1046302
260060,201708,409,369,40,345003.4,37480,382483.4
260070,201708,1403,886,517,826151,482449.58,1308600.58
260080,201708,727,570,157,532872.55,147109,679981.55
260090,201708,561,344,217,322103.86,203329,525432.86
260100,201708,223,154,69,143314.6,64653,207967.6
260105,201708,240,133,107,124621,100259,224880
260110,201708,2657,1980,677,1855241.63,633553,2488794.63
260120,201708,2920,1576,1344,1465842.31,1257081.55,2722923.86
260130,201708,145,100,45,93700,42165,135865
260140,201708,2024,1321,703,1230373.25,657194.63,1887567.88
260150,201708,231,151,80,141487,74960,216447
260160,201708,288,248,40,232376,37480,269856
260170,201708,3244,2005,1239,1871724.04,1159865.45,3031589.49
260180,201708,134,117,17,109629,15929,125558
260190,201708,2273,1617,656,1512035.03,614672,2126707.03
260200,201708,879,730,149,683248.24,139332,822580.24
260210,201708,1385,966,419,904993.96,392313,1297306.96
260220,201708,703,644,59,602656,55283,657939
260230,201708,1190,898,292,839274.15,273604,1112878.15
260240,201708,211,156,55,145019.49,51535,196554.49
260250,201708,69,55,14,51535,13118,64653
260260,201708,961,690,271,646530,253927,900457
260270,201708,439,356,83,332336.1,77489.9,409826.0
260280,201708,979,719,260,673515.6,243115,916630.6
260290,201708,6277,3311,2966,3083435.17,2773002.06,5856437.23
260300,201708,799,701,98,654532.23,91545,746077.23
260310,201708,493,389,104,362483.13,97448,459931.13
260320,201708,874,658,216,616262.6,202392,818654.6
260330,201708,28,22,6,20614,5622,26236
260340,201708,65,47,18,44039,16866,60905
260345,201708,5470,3105,2365,2903036.92,2214752.01,5117788.93
260350,201708,466,340,126,316867.16,117126,433993.16
260360,201708,289,149,140,139613,131180,270793
260370,201708,624,404,220,375984.7,206003,581987.7
260380,201708,601,432,169,404784,157229.14,562013.14
260390,201708,291,248,43,231200.19,39354,270554.19
260392,201708,92,79,13,74023,12181,86204
260400,201708,4073,2321,1752,2164804.88,1641268.41,3806073.29
260410,201708,13956,7596,6360,7102865.87,5956637.5,13059503.37
260415,201708,125,110,15,103070,14055,117125
260420,201708,1777,1047,730,975784.55,682558.8,1658343.35
260430,201708,192,175,17,162784.14,15929,178713.14
260440,201708,228,164,64,152395,59968,212363
260450,201708,479,340,139,317318,130243,447561
260460,201708,857,450,407,419028.4,381354.32,800382.72
260470,201708,366,221,145,206327.4,134881.55,341208.95
260480,201708,201,125,76,117125,71212,188337
260490,201708,200,162,38,151794,35606,187400
260500,201708,1118,747,371,696801.5,345894,1042695.5
260510,201708,719,563,156,527531,145235,672766
260515,201708,252,223,29,208951,26705,235656
260520,201708,3276,1934,1342,1804556.23,1255571.21,3060127.44
260530,201708,739,602,137,561023.82,128369,689392.82
260540,201708,588,436,152,408532,141487.66,550019.66
260545,201708,15,10,5,9370,4685,14055
260550,201708,329,204,125,191148,117125,308273
260560,201708,513,388,125,362976,116843.9,479819.9
260570,201708,1003,832,171,776633.9,160227,936860.9
260580,201708,282,250,32,234250,29984,264234
260590,201708,633,363,270,338744.24,252990,591734.24
260600,201708,8100,4068,4032,3790122.53,3773950.72,7564073.25
260610,201708,496,328,168,307336,157134.9,464470.9
260620,201708,3511,1859,1652,1730974.5,1543021.26,3273995.76
260630,201708,71,68,3,63716,2811,66527
260640,201708,3571,1954,1617,1826696.38,1514783.05,3341479.43
260650,201708,336,230,106,215510,99279.85,314789.85
260660,201708,494,337,157,315394.2,146218.85,461613.05
260670,201708,101,75,26,70275,24362,94637
260680,201708,3647,2012,1635,1867725.06,1530066.52,3397791.58
260690,201708,196,156,40,145516.1,37480,182996.1
260700,201708,336,198,138,184776.4,128489,313265.4
260710,201708,38,36,2,33732,1874,35606
260720,201708,2185,1309,876,1220750.23,819753.19,2040503.42
260730,201708,594,451,143,422587,132117.45,554704.45
260740,201708,66,62,4,58094,3748,61842
260750,201708,651,453,198,424461,185526,609987
260760,201708,634,346,288,324202,269526,593728
260765,201708,967,505,462,470295.9,432659.75,902955.65
260770,201708,215,160,55,149920,51535,201455
260775,201708,816,487,329,454886.82,308264,763150.82
260780,201708,265,168,97,157416,90757.82,248173.82
260790,201708,12376,6786,5590,6330972.3,5230685.64,11561657.94
260795,201708,155,105,50,97241.86,46850,144091.86
260800,201708,361,297,64,277821,59968,337789
260805,201708,201,130,71,121094.13,66527,187621.13
260810,201708,739,645,94,603137.53,88078,691215.53
260820,201708,315,208,107,193590,100259,293849
260825,201708,200,137,63,127998.71,59031,187029.71
260830,201708,256,164,92,153527.45,86204,239731.45
260840,201708,221,159,62,148328,57813,206141
260845,201708,211,146,65,136802,60905,197707
260850,201708,511,368,143,343181.64,133991,477172.64
260860,201708,250,186,64,174087.86,59968,234055.86
260870,201708,369,260,109,243620,102133,345753
260875,201708,673,465,208,434611.53,194896,629507.53
260880,201708,1426,905,521,847279.31,487989.6,1335268.91
260890,201708,2454,1716,738,1600087.49,690570,2290657.49
260900,201708,1033,695,338,649936.95,316706,966642.95
260910,201708,270,212,58,198644,54346,252990
260915,201708,309,207,102,193959,95454,289413
260920,201708,169,97,72,90889,67464,158353
260930,201708,398,338,60,316706,56135.75,372841.75
260940,201708,2691,1479,1212,1381889.55,1134876.26,2516765.81
260950,201708,1871,1096,775,1020609.45,726146,1746755.45
260960,201708,14215,7383,6832,6882653.86,6393852.61,13276506.47
260970,201708,423,364,59,341068,55283,396351
260980,201708,207,180,27,168370,25299,193669
260990,201708,2491,2055,436,1925039.01,408532,2333571.01
261000,201708,4317,2518,1799,2346281.48,1683133.9,4029415.38
261010,201708,193,138,55,129306,50731.8,180037.8
261020,201708,615,454,161,425258,150060.55,575318.55
261030,201708,208,150,58,140550,53956.84,194506.84
261040,201708,357,321,36,300777,33450.9,334227.9
261050,201708,463,408,55,382296,51535,433831
261060,201708,1304,853,451,797153.88,422587,1219740.88
261070,201708,8911,4567,4344,4254451.77,4062156.46,8316608.23
261080,201708,394,297,97,278289,90889,369178
261090,201708,2146,1653,493,1541298.92,461192,2002490.92
261100,201708,1063,754,309,704671.8,287696.48,992368.28
261110,201708,7907,4817,3090,4508287.93,2893097.5,7401385.43
261120,201708,284,238,46,222725,43098,265823
261130,201708,572,321,251,300449.45,235187,535636.45
261140,201708,187,120,67,112440,62779,175219
261150,201708,655,382,273,356725.77,255801,612526.77
261153,201708,71,68,3,62779.12,2811,65590.12
261160,201708,75862,38637,37225,36086797.2,34856752.5,70943549.7
261170,201708,459,340,119,318299,111503,429802
261180,201708,1744,1064,680,991805.43,637160,1628965.43
261190,201708,619,425,194,397822.89,181769,579591.89
261200,201708,213,188,25,175451.09,23425,198876.09
261210,201708,31,28,3,26236,2811,29047
261220,201708,2424,1700,724,1587374.11,677264,2264638.11
261230,201708,313,235,78,219726.5,73071.95,292798.45
261240,201708,439,378,61,350244.47,57157,407401.47
261245,201708,212,176,36,164912,33732,198644
261247,201708,144,105,39,98385,36543,134928
261250,201708,2743,1350,1393,1263450.9,1304150.71,2567601.61
261255,201708,249,228,21,213636,19677,233313
261260,201708,827,714,113,669018,105881,774899
261270,201708,173,134,39,125558,36543,162101
261280,201708,144,116,28,108692,26236,134928
261290,201708,132,91,41,85032.75,38417,123449.75
261300,201708,1219,858,361,803946,338257,1142203
261310,201708,749,500,249,468500,232703.95,701203.95
261320,201708,534,357,177,334509,165849,500358
261330,201708,787,631,156,588303.25,145341.53,733644.78
261340,201708,318,174,144,163038,134928,297966
261350,201708,752,534,218,499421.1,204226,703647.1
261360,201708,1177,750,427,702355.53,400099,1102454.53
261370,201708,4878,3002,1876,2797060.25,1756148.2,4553208.45
261380,201708,570,413,157,385116.92,146828,531944.92
261390,201708,3369,2242,1127,2096078.74,1052206.15,3148284.89
261400,201708,285,260,25,242776.7,23425,266201.7
261410,201708,1013,663,350,621231,327945.32,949176.32
261420,201708,858,533,325,497520.63,304506.63,802027.26
261430,201708,330,299,31,279332,28765.9,308097.9
261440,201708,92,81,11,75897,10307,86204
261450,201708,2478,2061,417,1928076.23,389737.12,2317813.35
261460,201708,683,546,137,510665.81,128369,639034.81
261470,201708,243,185,58,172549,54346,226895
261480,201708,329,269,60,250930,56216,307146
261485,201708,335,206,129,192366.1,120873,313239.1
261500,201708,620,416,204,389792,191148,580940
261510,201708,41,30,11,28110,10307,38417
261520,201708,170,157,13,146173,12181,158354
261530,201708,4131,2609,1522,2436533.99,1424882.95,3861416.94
261540,201708,1061,644,417,603231.23,390729,993960.23
261550,201708,283,139,144,128885,134928,263813
261560,201708,768,512,256,477309.1,238457.8,715766.9
261570,201708,359,281,78,263297,73086,336383
261580,201708,374,292,82,272857,76834,349691
261590,201708,186,152,34,142424,31858,174282
261600,201708,282,228,54,212887,50130,263017
261610,201708,99,86,13,80234,12181,92415
261618,201708,64,50,14,46850,13118,59968
261620,201708,214,130,84,121810,78708,200518
261630,201708,588,449,139,418396.8,130056,548452.8
261640,201708,6165,3274,2891,3059385.75,2706066.26,5765452.01
261650,201708,473,294,179,274812.73,167723,442535.73
270010,201708,514,448,66,419776,61093,480869
270020,201708,308,243,65,227687,60905,288592
270030,201708,8975,5736,3239,5361978.25,3032500.54,8394478.79
270040,201708,1904,1158,746,1084942.94,698720.9,1783663.84
270050,201708,184,136,48,127432,44976,172408
270060,201708,121,66,55,61842,51535,113377
270070,201708,912,654,258,610817.26,241437.16,852254.42
270080,201708,44,37,7,34669,6559,41228
270090,201708,20,16,4,14992,3748,18740
270100,201708,1293,839,454,782288.28,423290.35,1205578.63
270110,201708,167,122,45,114314,42165,156479
270120,201708,221,180,41,167823.72,38135.9,205959.62
270130,201708,265,182,83,170252.9,77489.9,247742.8
270135,201708,98,57,41,53409,38417,91826
270140,201708,1237,734,503,687362.34,468867.26,1156229.60
270150,201708,271,219,52,205203,48724,253927
270160,201708,517,379,138,354236,129306,483542
270170,201708,673,424,249,396444.7,232516.55,628961.25
270180,201708,68,51,17,47474.7,15722.86,63197.56
270190,201708,104,91,13,85267,12181,97448
270200,201708,111,99,12,92575.6,11244,103819.6
270210,201708,492,253,239,237061,223661.9,460722.9
270220,201708,196,156,40,146172,37480,183652
270230,201708,2046,1215,831,1132602.74,775842.2,1908444.94
270235,201708,735,546,189,511293.29,176734.48,688027.77
270240,201708,3064,2351,713,2193245.07,663839.8,2857084.87
270250,201708,178,124,54,115438.4,50598,166036.4
270255,201708,223,196,27,183652,24924.2,208576.2
270260,201708,318,256,62,239685,57812.9,297497.9
270270,201708,120,48,72,44967,67464,112431
270280,201708,212,135,77,126495,72149,198644
270290,201708,1140,847,293,792299.59,273660.89,1065960.48
270300,201708,256,163,93,152731,86859.9,239590.9
270310,201708,947,751,196,701494.18,182949.99,884444.17
270320,201708,896,758,138,708132.8,129306,837438.8
270330,201708,268,220,48,205203,44976,250179
270340,201708,60,47,13,44039,12181,56220
270350,201708,95,49,46,45913,43102,89015
270360,201708,77,42,35,39354,32795,72149
270370,201708,48,35,13,32795,12181,44976
270375,201708,63,34,29,31858,27169,59027
270380,201708,1070,590,480,551893,449760,1001653
270390,201708,198,105,93,98385,87141,185526
270400,201708,693,498,195,465432.43,182706,648138.43
270410,201708,707,498,209,466626,195823.63,662449.63
270420,201708,386,248,138,230709,129223.89,359932.89
270430,201708,31720,22540,9180,21068267.2,8591566.73,29659833.93
270440,201708,495,385,110,359761.55,102788.9,462550.45
270450,201708,772,392,380,367069.75,355123.73,722193.48
270460,201708,200,146,54,136802,50598,187400
270470,201708,1329,873,456,817652.95,427048,1244700.95
270480,201708,509,409,100,380956.29,92997.25,473953.54
270490,201708,27,21,6,19677,5622,25299
270500,201708,525,422,103,395414,96511,491925
270510,201708,740,456,284,427272,266108,693380
270520,201708,408,247,161,231092.45,150857,381949.45
270530,201708,67,58,9,54346,8433,62779
270540,201708,126,96,30,89952,28110,118062
270550,201708,1711,1293,418,1210287.37,391567.62,1601854.99
270560,201708,322,147,175,137739,163975,301714
270570,201708,427,270,157,252174.73,147109,399283.73
270580,201708,74,52,22,48724,20614,69338
270590,201708,82,68,14,63716,13097.89,76813.89
270600,201708,177,145,32,135865,29984,165849
270610,201708,168,132,36,123675,33732,157407
270620,201708,32,31,1,29047,937,29984
270630,201708,3815,2889,926,2696035.96,865545.38,3561581.34
270640,201708,902,654,248,610193.3,232067.9,842261.2
270642,201708,198,167,31,156479,29047,185526
270644,201708,293,198,95,185338.97,89010.32,274349.29
270650,201708,233,140,93,131180,87141,218321
270660,201708,258,208,50,194896,46850,241746
270670,201708,3167,2385,782,2223923.94,730570.12,2954494.06
270680,201708,458,266,192,249233,179899.32,429132.32
270690,201708,1111,687,424,642017.24,397278.63,1039295.87
270700,201708,35,27,8,25299,7496,32795
270710,201708,852,632,220,590597.86,206140,796737.86
270720,201708,247,185,62,173345,57812.9,231157.9
270730,201708,1830,1057,773,987927.7,722232.6,1710160.3
270740,201708,47,28,19,26236,17803,44039
270750,201708,625,453,172,424461,160509,584970
270760,201708,308,225,83,210825,77771,288596
270770,201708,2679,1663,1016,1550290.84,951055,2501345.84
270780,201708,92,56,36,52467.32,33714.64,86181.96
270790,201708,281,188,93,176156,87141,263297
270800,201708,1961,1545,416,1445650.71,389061.14,1834711.85
270810,201708,323,253,70,237046.95,65581.32,302628.27
270820,201708,156,98,58,91826,54253,146079
270830,201708,1012,731,281,684194,263297,947491
270840,201708,1399,1006,393,942130.2,367023.9,1309154.1
270850,201708,1745,1056,689,984653.85,645560.58,1630214.43
270860,201708,2452,1578,874,1474383.3,816072.9,2290456.2
270870,201708,122,66,56,61842,52472,114314
270880,201708,912,654,258,610237.3,240841.75,851079.05
270890,201708,374,274,100,256297.61,93695.32,349992.93
270895,201708,71,62,9,58094,8433,66527
270900,201708,113,90,23,84330,21551,105881
270910,201708,335,264,71,246243.6,66527,312770.6
270915,201708,1788,1052,736,980771.82,689159.31,1669931.13
270920,201708,502,415,87,388855,81519,470374
270930,201708,6218,4440,1778,4154854.94,1664166.67,5819021.61
270940,201708,2409,1811,598,1694972.09,559261.79,2254233.88
280010,201708,43,39,4,36543,3748,40291
280020,201708,702,601,101,561232.31,93700,654932.31
280030,201708,18649,11928,6721,11102646.39,6266596.69,17369243.08
280040,201708,346,221,125,207077,116656.5,323733.5
280050,201708,374,286,88,267700.9,82456,350156.9
280060,201708,310,205,105,190703.48,98385,289088.48
280067,201708,974,679,295,633515.26,275197.12,908712.38
280070,201708,126,104,22,97448,20614,118062
280100,201708,608,475,133,441187.2,124434,565621.2
280110,201708,75,69,6,64653,5622,70275
280120,201708,621,494,127,462878,118999,581877
280130,201708,1287,788,499,736810.9,467422.45,1204233.35
280140,201708,465,369,96,344909.7,89952,434861.7
280150,201708,317,231,86,215779.21,79645,295424.21
280160,201708,99,84,15,78708,14055,92763
280170,201708,571,378,193,352729.68,180044.55,532774.23
280190,201708,28,26,2,24362,1874,26236
280200,201708,21,14,7,13118,6559,19677
280210,201708,2721,1917,804,1777239.24,747307.89,2524547.13
280220,201708,39,31,8,29047,7496,36543
280230,201708,302,248,54,231556.95,49661.1,281218.05
280240,201708,111,105,6,98245,5622,103867
280250,201708,21,12,9,11244,8433,19677
280260,201708,75,67,8,62779,7496,70275
280270,201708,160,122,38,114314,35606,149920
280280,201708,197,124,73,116188,68401,184589
280290,201708,2975,2154,821,2004221.6,767989.63,2772211.23
280300,201708,1067,811,256,758271.93,239122.4,997394.33
280310,201708,105,99,6,92576,5622,98198
280320,201708,640,433,207,405712,193959,599671
280330,201708,359,255,104,238091.7,97326.19,335417.89
280340,201708,402,321,81,299332.05,75148,374480.05
280350,201708,3335,2574,761,2402703.36,710248.41,3112951.77
280360,201708,466,296,170,277352,158353,435705
280370,201708,93,81,12,75897,11244,87141
280380,201708,58,43,15,40291,14055,54346
280390,201708,179,147,32,137739,29984,167723
280400,201708,334,226,108,210919.4,101196,312115.4
280410,201708,289,233,56,217179,52462.63,269641.63
280420,201708,168,141,27,132117,25299,157416
280430,201708,107,80,27,74960,25299,100259
280440,201708,660,504,156,468173.7,145975.23,614148.93
280445,201708,115,105,10,98385,9370,107755
280450,201708,1039,887,152,827839.5,142424,970263.5
280460,201708,710,507,203,469258.26,190211,659469.26
280470,201708,191,173,18,162101,15930,178031
280480,201708,2210,1579,631,1466105.19,587230.65,2053335.84
280490,201708,373,340,33,317436,30921,348357
280500,201708,52,47,5,44039,4685,48724
280510,201708,141,106,35,99024.6,32514,131538.6
280520,201708,55,41,14,38417,13118,51535
280530,201708,72,52,20,48724,18740,67464
280540,201708,493,388,105,363556,98103.9,461659.9
280550,201708,702,650,52,606480.3,48724,655204.3
280560,201708,466,400,66,372644.9,61842,434486.9
280570,201708,1746,1321,425,1234492.42,398225,1632717.42
280580,201708,590,449,141,420292.9,132024,552316.9
280590,201708,163,98,65,91551.46,60905,152456.46
280600,201708,341,286,55,266314.54,51535,317849.54
280610,201708,143,104,39,97246,36543,133789
280620,201708,554,445,109,416028,101993,518021
280630,201708,166,137,29,128369,27173,155542
280640,201708,206,161,45,150043,42165,192208
280650,201708,83,53,30,49661,28110,77771
280660,201708,127,92,35,86204,32560.75,118764.75
280670,201708,1524,945,579,880007.23,538845.98,1418853.21
280680,201708,176,149,27,137861.62,25299,163160.62
280690,201708,42,36,6,33732,5622,39354
280700,201708,17,17,0,15929,0,15929
280710,201708,1391,1032,359,959379.29,335727.1,1295106.39
280720,201708,108,73,35,65886.7,32795,98681.7
280730,201708,23,19,4,17803,3748,21551
280740,201708,2321,1692,629,1581588.82,587631.07,2169219.89
280750,201708,290,249,41,233313,38417,271730
280760,201708,861,583,278,545146.6,260345.45,805492.05
290010,201708,184,121,63,113377,59031,172408
290020,201708,175,162,13,151794,12181,163975
290030,201708,578,371,207,346971.1,193959,540930.1
290035,201708,136,109,27,98985.8,25299,124284.8
290040,201708,271,171,100,160227,93700,253927
290050,201708,69,51,18,47787,16866,64653
290060,201708,261,111,150,103725.9,140550,244275.9
290070,201708,5439,2646,2793,2471996.07,2613626.85,5085622.92
290080,201708,518,238,280,222518.76,262342,484860.76
290090,201708,385,167,218,156479,204266,360745
290100,201708,1562,1024,538,954431.05,503543.9,1457974.95
290110,201708,740,434,306,405061.1,286628.3,691689.4
290115,201708,216,197,19,183652,17803,201455
290120,201708,778,509,269,476277.1,252053,728330.1
290130,201708,420,244,176,228337.53,164161,392498.53
290135,201708,292,222,70,207348.73,65590,272938.73
290140,201708,283,234,49,218321,45913,264234
290150,201708,133,97,36,90889,33732,124621
290160,201708,245,193,52,179623.05,48724,228347.05
290170,201708,88,59,29,55283,27173,82456
290180,201708,150,118,32,110566,29984,140550
290190,201708,450,366,84,342661,78427,421088
290195,201708,290,161,129,150857,120873,271730
290200,201708,294,249,45,233313,42165,275478
290205,201708,137,81,56,75897,52472,128369
290210,201708,1090,794,296,742854.6,277352,1020206.6
290220,201708,217,119,98,111034.5,91826,202860.5
290225,201708,274,102,172,95574,161164,256738
290230,201708,65,42,23,39354,21551,60905
290240,201708,312,128,184,119654.9,172408,292062.9
290250,201708,262,235,27,219324,25299,244623
290260,201708,264,223,41,208202,38417,246619
290265,201708,184,149,35,138810,32795,171605
290270,201708,1374,1121,253,1048503,236214,1284717
290280,201708,467,345,122,323265,114314,437579
290290,201708,1163,665,498,618548.33,466626,1085174.33
290300,201708,454,385,69,360225.07,64653,424878.07
290310,201708,320,140,180,131180,168660,299840
290320,201708,3872,2416,1456,2261064.46,1361461.5,3622525.96
290323,201708,180,156,24,145891,22488,168379
290327,201708,143,113,30,105613.96,28110,133723.96
290330,201708,67,35,32,32795,29984,62779
290340,201708,910,362,548,338198.78,512853.79,851052.57
290350,201708,559,332,227,311084,212699,523783
290360,201708,359,270,89,250835.86,83393,334228.86
290370,201708,994,370,624,346409,584688,931097
290380,201708,297,181,116,169597,108692,278289
290390,201708,2442,1512,930,1413073.57,869536,2282609.57
290395,201708,236,130,106,121576,99322,220898
290400,201708,277,204,73,190586,68401,258987
290405,201708,256,218,38,204266,35606,239872
290410,201708,548,467,81,434628.9,75897,510525.9
290420,201708,225,174,51,163038,47787,210825
290430,201708,510,316,194,296092,181778,477870
290440,201708,74,65,9,60905,7808.3,68713.3
290450,201708,232,178,54,166786,50598,217384
290460,201708,1838,1090,748,1020429.89,700689.56,1721119.45
290470,201708,1441,600,841,560788.17,787705.08,1348493.25
290475,201708,585,549,36,514413,33732,548145
290480,201708,286,158,128,148046,119936,267982
290485,201708,209,196,13,183632,12181,195813
290490,201708,1098,782,316,731984.4,295155.6,1027140.0
290500,201708,648,324,324,302651,303588,606239
290510,201708,213,160,53,149265,49657,198922
290515,201708,126,71,55,66527,51535,118062
290520,201708,1330,849,481,793920.61,447513.01,1241433.62
290530,201708,308,280,28,262360,26236,288596
290540,201708,91,56,35,52472,32795,85267
290550,201708,153,130,23,121810,21204.31,143014.31
290560,201708,3369,1358,2011,1271434.04,1884116.4,3155550.44
290570,201708,5650,2894,2756,2707025.69,2579325.89,5286351.58
290580,201708,1227,700,527,654681.9,493096.25,1147778.15
290590,201708,524,433,91,404972,85267,490239
290600,201708,1689,1174,515,1095260.37,482555,1577815.37
290610,201708,218,197,21,184140,19677,203817
290620,201708,316,277,39,259549,35980.8,295529.8
290630,201708,2112,890,1222,830183,1139490.47,1969673.47
290640,201708,149,121,28,113377,26236,139613
290650,201708,1662,775,887,725229.42,831119,1556348.42
290660,201708,269,219,50,205203,46850,252053
290670,201708,973,513,460,480400,430679.9,911079.9
290680,201708,1152,932,220,872347,205203,1077550
290682,201708,284,208,76,193927.15,71193.63,265120.78
290685,201708,227,144,83,133991,77771,211762
290687,201708,905,602,303,560747.8,281915.29,842663.09
290689,201708,118,72,46,67450,43087.95,110537.95
290690,201708,675,282,393,264225,367369.03,631594.03
290700,201708,253,119,134,111503,125558,237061
290710,201708,677,439,238,411343,223006,634349
290720,201708,1012,830,182,777710,170065.5,947775.5
290730,201708,1112,632,480,590356.85,448823,1039179.85
290740,201708,16,12,4,11244,3748,14992
290750,201708,1319,596,723,557047.27,675377.06,1232424.33
290755,201708,69,60,9,56220,8433,64653
290760,201708,302,264,38,247368,35606,282974
290770,201708,185,173,12,162091.63,11244,173335.63
290780,201708,936,752,184,702715.23,170627.7,873342.93
290790,201708,435,292,143,273035,133991,407026
290800,201708,2622,1039,1583,970732.07,1482174.71,2452906.78
290810,201708,432,298,134,278945,125558,404503
290820,201708,369,228,141,212685,132117,344802
290830,201708,390,260,130,243620,121810,365430
290840,201708,1627,997,630,932643.4,587330.44,1519973.84
290850,201708,740,409,331,382202.3,309210,691412.3
290860,201708,656,293,363,274541,339850,614391
290870,201708,660,478,182,447249,170534,617783
290880,201708,125,69,56,64653,52472,117125
290890,201708,364,263,101,246431,94637,341068
290900,201708,168,129,39,120873,36543,157416
290910,201708,363,276,87,258612,81519,340131
290920,201708,230,190,40,178030,37480,215510
290930,201708,793,604,189,565170.29,177093,742263.29
290940,201708,252,204,48,190398.4,44976,235374.4
290950,201708,169,95,74,89015,69338,158353
290960,201708,432,287,145,267701.72,135583.9,403285.62
290970,201708,248,218,30,204078.6,28110,232188.6
290980,201708,1448,1025,423,956350.02,395321.1,1351671.12
290990,201708,359,301,58,282028,54290.89,336318.89
291000,201708,845,234,611,219258,572225.9,791483.9
291005,201708,1978,840,1138,785337.28,1065542.72,1850880.00
291010,201708,159,145,14,135865,13118,148983
291020,201708,102,81,21,75897,19677,95574
291030,201708,89,67,22,62779,20614,83393
291040,201708,575,289,286,270783.63,267982,538765.63
291050,201708,1270,717,553,670557.92,518161,1188718.92
291060,201708,1472,800,672,748944.1,629664,1378608.1
291070,201708,1871,1379,492,1286549.5,458157.18,1744706.68
291072,201708,7191,2635,4556,2466249.28,4266146.7,6732395.98
291075,201708,193,156,37,146172,34669,180841
291077,201708,48,33,15,30921,14055,44976
291080,201708,18836,8203,10633,7664794.14,9950343.92,17615138.06
291085,201708,281,226,55,211762,51530.32,263292.32
291090,201708,311,115,196,107474,183642.63,291116.63
291100,201708,730,217,513,203329,480671.63,684000.63
291110,201708,395,302,93,282974,87141,370115
291120,201708,2500,1158,1342,1084906,1255506.08,2340412.08
291125,201708,58,30,28,28110,26236,54346
291130,201708,207,179,28,167723,26236,193959
291140,201708,124,90,34,84330,31577,115907
291150,201708,376,150,226,140550,211762,352312
291160,201708,334,282,52,263297.25,48724,312021.25
291165,201708,17,13,4,12181,3748,15929
291170,201708,2797,1411,1386,1319919.68,1296246,2616165.68
291180,201708,1306,488,818,457118,766412,1223530
291185,201708,69,66,3,61842,2811,64653
291190,201708,1219,508,711,474490.5,665673.9,1140164.4
291200,201708,161,115,46,107755,43102,150857
291210,201708,2165,826,1339,770879.27,1252872.54,2023751.81
291220,201708,248,188,60,175219.43,56220,231439.43
291230,201708,1022,342,680,319611,637160,956771
291240,201708,443,418,25,390448,23425,413873
291250,201708,422,343,79,321391,74023,395414
291260,201708,37,26,11,24362,10307,34669
291270,201708,1195,481,714,450697,668502.9,1119199.9
291280,201708,368,164,204,153480.6,190837.53,344318.13
291290,201708,1729,872,857,815939.6,801882,1617821.6
291300,201708,228,181,47,168941.1,44039,212980.1
291310,201708,245,219,26,204922,24362,229284
291320,201708,1372,983,389,917978.9,363182.8,1281161.7
291330,201708,127,106,21,97541.7,19677,117218.7
291340,201708,141,79,62,74023,58094,132117
291345,201708,131,83,48,77771,44976,122747
291350,201708,1547,484,1063,452943.68,995844.15,1448787.83
291360,201708,8436,4168,4268,3896438.03,3996171.28,7892609.31
291370,201708,1049,568,481,531935,450697,982632
291380,201708,259,207,52,193959,48724,242683
291390,201708,3847,1669,2178,1559479.5,2039280.75,3598760.25
291400,201708,2045,1458,587,1361087.79,548085.39,1909173.18
291410,201708,153,135,18,125558,16866,142424
291420,201708,101,72,29,67464,27173,94637
291430,201708,186,103,83,95815.74,76834,172649.74
291440,201708,493,396,97,368657.25,90889,459546.25
291450,201708,850,524,326,488834.54,304525,793359.54
291460,201708,1687,1366,321,1277505.8,300777,1578282.8
291465,201708,2231,1039,1192,973269.67,1116677.89,2089947.56
291470,201708,2706,1371,1335,1280908.95,1249638.45,2530547.40
291480,201708,11746,5192,6554,4854351.01,6131599.27,10985950.28
291490,201708,538,217,321,203329,300777,504106
291500,201708,365,193,172,180841,161164,342005
291510,201708,1271,476,795,444872.75,744633.9,1189506.65
291520,201708,955,428,527,401036,493789.63,894825.63
291530,201708,1019,269,750,252053,702450.26,954503.26
291535,201708,114,96,18,89952,16866,106818
291540,201708,360,106,254,99322,237061.8,336383.8
291550,201708,1173,542,631,505981.19,590666.9,1096648.09
291560,201708,5542,2863,2679,2670848.55,2498809.26,5169657.81
291570,201708,201,103,98,96511,91826,188337
291580,201708,1192,712,480,666401,449746.32,1116147.32
291590,201708,73,29,44,26751.35,41228,67979.35
291600,201708,1357,614,743,574381,695892,1270273
291610,201708,1305,572,733,534703.74,686766,1221469.74
291620,201708,547,250,297,234250,277914.2,512164.2
291630,201708,509,163,346,152731,324202,476933
291640,201708,3842,1909,1933,1782189.42,1810127.71,3592317.13
291650,201708,342,222,120,206899.97,112253,319152.97
291660,201708,450,179,271,167723,252849.45,420572.45
291670,201708,218,135,83,125933,77771,203704
291680,201708,706,397,309,371989,289440,661429
291685,201708,554,295,259,276181,242495.6,518676.6
291690,201708,553,273,280,255801,261423,517224
291700,201708,893,705,188,660585,175219,835804
291710,201708,1701,773,928,723617.34,868674.93,1592292.27
291720,201708,392,265,127,248300.32,118999,367299.32
291730,201708,920,522,398,488223.85,372916.63,861140.48
291733,201708,253,177,76,165567.9,71212,236779.9
291735,201708,67,52,15,48724,14055,62779
291740,201708,339,255,84,238232.25,78708,316940.25
291750,201708,1922,1270,652,1183541.48,609301.81,1792843.29
291760,201708,3081,1644,1437,1533627.14,1344782.5,2878409.64
291770,201708,784,525,259,489862.03,242683,732545.03
291780,201708,48,27,21,25299,19677,44976
291790,201708,168,77,91,72149,85267,157416
291800,201708,9716,3754,5962,3508493.27,5582928.3,9091421.57
291810,201708,1155,814,341,761870.22,319517,1081387.22
291820,201708,262,190,72,178030,67464,245494
291830,201708,1055,383,672,357672,628718,986390
291835,201708,628,567,61,530811,57157,587968
291840,201708,4563,2317,2246,2166312.62,2103678.18,4269990.80
291845,201708,316,108,208,101196,194867.89,296063.89
291850,201708,321,278,43,260251.75,40291,300542.75
291855,201708,265,106,159,99322,148983,248305
291860,201708,212,129,83,119937,77771,197708
291870,201708,79,32,47,29984,44039,74023
291875,201708,176,159,17,148983,15929,164912
291880,201708,484,379,105,354327,98385,452712
291890,201708,243,81,162,75887.63,150107.5,225995.13
291900,201708,57,32,25,29984,23425,53409
291905,201708,140,92,48,85923,44976,130899
291910,201708,181,145,36,135865,33732,169597
291915,201708,379,335,44,312257,41228,353485
291920,201708,4742,2449,2293,2292352.71,2146896.34,4439249.05
291930,201708,180,103,77,95574.7,72149,167723.7
291940,201708,305,166,139,154577.39,129025.21,283602.60
291950,201708,1103,904,199,845363,186463,1031826
291955,201708,943,553,390,518161,365290,883451
291960,201708,169,115,54,107755,50598,158353
291970,201708,790,597,193,559389,180841,740230
291980,201708,1492,1319,173,1232551.79,161164.7,1393716.49
291990,201708,121,113,8,105881,7496,113377
291992,201708,158,79,79,73273.4,74023,147296.4
291995,201708,146,104,42,97448,39354,136802
292000,201708,375,279,96,260205,89952,350157
292010,201708,280,204,76,190492.1,69994,260486.1
292020,201708,263,193,70,180841,65590,246431
292030,201708,138,108,30,101196,28110,129306
292040,201708,609,306,303,286722,283911,570633
292045,201708,83,75,8,70275,7496,77771
292050,201708,880,588,292,549965.26,273604,823569.26
292060,201708,916,763,153,713058.59,143361,856419.59
292070,201708,50,21,29,19677,27173,46850
292080,201708,113,78,35,73086,32795,105881
292090,201708,481,166,315,155334.49,295155,450489.49
292100,201708,1344,570,774,532544.35,724264.26,1256808.61
292105,201708,202,169,33,158353,30921,189274
292110,201708,2080,766,1314,717423.42,1228946.68,1946370.10
292120,201708,626,502,124,469261.96,116188,585449.96
292130,201708,437,255,182,238935,170534,409469
292140,201708,196,154,42,144298,39224.61,183522.61
292145,201708,151,79,72,74023,67435.9,141458.9
292150,201708,1395,1117,278,1046629,259476.57,1306105.57
292160,201708,180,148,32,138394.9,29984,168378.9
292170,201708,1215,1067,148,998397.23,138619.78,1137017.01
292180,201708,191,139,52,130243,48724,178967
292190,201708,160,98,62,91826,58094,149920
292200,201708,1241,453,788,423526.24,737719.68,1161245.92
292205,201708,114,102,12,95292.9,11244,106536.9
292210,201708,352,242,110,225396,102367.25,327763.25
292220,201708,22,15,7,14055,6559,20614
292225,201708,40,35,5,32795,4685,37480
292230,201708,881,717,164,669179.72,153668,822847.72
292240,201708,604,426,178,398085,166786,564871
292250,201708,1631,1026,605,961362,566885,1528247
292260,201708,439,243,196,227691,182902.4,410593.4
292265,201708,273,189,84,176811.9,78708,255519.9
292270,201708,782,337,445,315113.1,416028.4,731141.5
292273,201708,197,114,83,106054.34,77771,183825.34
292275,201708,159,74,85,69338,79363.9,148701.9
292280,201708,133,92,41,86204,38417,124621
292285,201708,57,48,9,44320.1,8433,52753.1
292290,201708,497,328,169,304891.01,158072,462963.01
292300,201708,1594,606,988,567259.9,924131.99,1491391.89
292303,201708,88,61,27,57157,25299,82456
292305,201708,105,74,31,69338,29047,98385
292310,201708,823,507,316,474704,293942.13,768646.13
292320,201708,639,482,157,451352.9,147109,598461.9
292330,201708,194,96,98,89952,91826,181778
292335,201708,267,201,66,188337,61842,250179
292340,201708,556,382,174,357207.93,163038,520245.93
292350,201708,253,132,121,122887.55,113095.9,235983.45
292360,201708,688,518,170,483679.5,159290,642969.5
292370,201708,778,590,188,552830,176156,728986
292380,201708,642,492,150,460067.51,140550,600617.51
292390,201708,506,186,320,174282,298106.75,472388.75
292400,201708,3310,2032,1278,1885074.93,1193956,3079030.93
292405,201708,255,166,89,155073.5,83111.9,238185.4
292410,201708,155,92,63,86204,59031,145235
292420,201708,302,259,43,242401.9,40291,282692.9
292430,201708,496,394,102,369178,95105.5,464283.5
292440,201708,571,483,88,450697,82456,533153
292450,201708,241,187,54,175219,50598,225817
292460,201708,588,430,158,402347.9,147343.25,549691.15
292465,201708,182,155,27,145235,24574.24,169809.24
292467,201708,94,53,41,49661,38417,88078
292470,201708,250,168,82,157416,76834,234250
292480,201708,301,202,99,188337.75,92763,281100.75
292490,201708,224,143,81,133991,75897,209888
292500,201708,1184,510,674,477663,631088.35,1108751.35
292510,201708,3249,1445,1804,1353028.36,1687497.73,3040526.09
292520,201708,1026,486,540,454206.75,505962,960168.75
292525,201708,380,266,114,249237.32,106818,356055.32
292530,201708,4137,1696,2441,1586177.3,2285055.3,3871232.6
292540,201708,483,257,226,240809,211762,452571
292550,201708,1042,550,492,514620.6,460544.01,975164.61
292560,201708,320,298,22,279226,20614,299840
292570,201708,291,221,70,206754,65590,272344
292575,201708,449,279,170,261142,159290,420432
292580,201708,893,562,331,525188.5,309584.9,834773.4
292590,201708,513,438,75,410108.98,70275,480383.98
292593,201708,140,110,30,103070,28110,131180
292595,201708,173,131,42,122747,39354,162101
292600,201708,1231,917,314,858917,294218,1153135
292610,201708,122,91,31,84798.5,28794.01,113592.51
292620,201708,513,424,89,396998,83393,480391
292630,201708,1339,774,565,723678.5,526126.3,1249804.8
292640,201708,750,522,228,489114,213636,702750
292650,201708,188,163,25,152581,23425,176006
292660,201708,1969,1403,566,1308892.02,525371.96,1834263.98
292665,201708,132,96,36,89952,33732,123684
292670,201708,371,313,58,293277,54346,347623
292680,201708,244,189,55,177093,51535,228628
292690,201708,175,132,43,123684,40291,163975
292700,201708,904,592,312,553767.9,292066.01,845833.91
292710,201708,98,86,12,80582,10963,91545
292720,201708,820,459,361,429295.92,338070,767365.92
292730,201708,212,100,112,92763.75,104944,197707.75
292740,201708,64483,31852,32631,29773969.07,30548504.89,60322473.96
292750,201708,376,265,111,247368.07,103211.01,350579.08
292760,201708,314,248,66,231383.25,61842,293225.25
292770,201708,781,333,448,310657.47,417549.51,728206.98
292780,201708,426,162,264,151570.53,247368,398938.53
292790,201708,718,344,374,322328,350203.75,672531.75
292800,201708,1108,676,432,632475,404784,1037259
292805,201708,423,123,300,114735.65,281100,395835.65
292810,201708,1445,843,602,789047.9,563783.63,1352831.53
292820,201708,740,597,143,557516.3,133700.9,691217.2
292830,201708,102,79,23,74023,21551,95574
292840,201708,636,522,114,488646,106803.95,595449.95
292850,201708,137,90,47,84326,44039,128365
292860,201708,2047,1201,846,1120872.07,792702,1913574.07
292870,201708,3291,2206,1085,2066016.9,1016635.63,3082652.53
292880,201708,1409,927,482,864899.33,451634,1316533.33
292890,201708,452,389,63,364465,59031,423496
292895,201708,135,90,45,82995.71,42165,125160.71
292900,201708,388,289,99,270793,92763,363556
292905,201708,441,221,220,207077,205953,413030
292910,201708,382,297,85,277962,79645,357607
292920,201708,530,234,296,219258,277352,496610
292925,201708,515,476,39,445346.73,36308.75,481655.48
292930,201708,548,338,210,316706,196770,513476
292935,201708,299,125,174,117125,163038,280163
292937,201708,232,155,77,145235,72149,217384
292940,201708,189,143,46,133991,43102,177093
292950,201708,1066,546,520,509541.6,486304,995845.6
292960,201708,529,352,177,329824,165849,495673
292970,201708,284,196,88,182997,82456,265453
292975,201708,159,88,71,82456,66340,148796
292980,201708,257,176,81,163160.42,75897,239057.42
292990,201708,1282,942,340,875278.69,318396.26,1193674.95
293000,201708,102,75,27,70275,25289.63,95564.63
293010,201708,2605,1606,999,1500218.55,933970.4,2434188.95
293015,201708,641,505,136,472476.01,126805,599281.01
293020,201708,339,277,62,259549,58094,317643
293030,201708,627,547,80,511040.82,74960,586000.82
293040,201708,337,263,74,246431,69338,315769
293050,201708,2642,1543,1099,1436875.13,1025706.39,2462581.52
293060,201708,250,199,51,186463,46850.4,233313.4
293070,201708,3251,1629,1622,1518803.89,1518624.63,3037428.52
293075,201708,87,56,31,52472,29047,81519
293076,201708,74,46,28,43102,26236,69338
293077,201708,424,256,168,235438.04,157416,392854.04
293080,201708,459,401,58,375737,54346,430083
293090,201708,131,111,20,104007,18427.7,122434.7
293100,201708,505,357,148,334509,138676,473185
293105,201708,334,224,110,209607,103070,312677
293110,201708,168,118,50,110566,46850,157416
293120,201708,318,213,105,199581,98197.6,297778.6
293130,201708,246,164,82,153668,76834,230502
293135,201708,7721,3053,4668,2853993.21,4366881.52,7220874.73
293140,201708,181,118,63,110566,58282,168848
293150,201708,326,281,45,261892.1,42165,304057.1
293160,201708,428,237,191,222069,178945.75,401014.75
293170,201708,182,127,55,118717.9,50692,169409.9
293180,201708,444,301,143,281756,133991,415747
293190,201708,1263,874,389,814373.98,364415,1178788.98
293200,201708,518,456,62,426211,58094,484305
293210,201708,334,247,87,231290,80816.25,312106.25
293220,201708,2695,1076,1619,1007034.45,1514661.55,2521696.00
293230,201708,1780,638,1142,596401.9,1070054,1666455.9
293240,201708,223,202,21,189274,19677,208951
293245,201708,110,92,18,86204,16866,103070
293250,201708,736,271,465,253291.24,435705,688996.24
293260,201708,311,257,54,239279.49,50598,289877.49
293270,201708,1178,558,620,520973.48,580940,1101913.48
293280,201708,233,131,102,122747,95574,218321
293290,201708,3073,1996,1077,1869076.57,1008855,2877931.57
293300,201708,674,479,195,447000.79,181918.55,628919.34
293305,201708,161,135,26,126495,24362,150857
293310,201708,138,105,33,98385,30921,129306
293315,201708,149,115,34,107755,31858,139613
293317,201708,96,69,27,64653,25299,89952
293320,201708,924,526,398,491925.25,372922,864847.25
293325,201708,183,67,116,62779,108673.26,171452.26
293330,201708,12520,5801,6719,5424252.79,6289572.88,11713825.67
293340,201708,241,173,68,162101,62779,224880
293345,201708,242,192,50,179904,46850,226754
293350,201708,626,319,307,298903,286206.65,585109.65
293360,201708,1540,1097,443,1026671,413873.35,1440544.35
310010,201708,155,77,78,72149,72524,144673
310020,201708,1043,576,467,536557.65,435097.26,971654.91
310030,201708,325,263,62,245326.14,57812.9,303139.04
310040,201708,50,32,18,29984,16866,46850
310050,201708,176,113,63,104944.2,59031,163975.2
310060,201708,240,167,73,155729.4,68401,224130.4
310070,201708,17,8,9,7496,8433,15929
310080,201708,53,28,25,26236,23425,49661
310090,201708,937,484,453,448637.14,423336.8,871973.94
310100,201708,295,220,75,206140,70275,276415
310110,201708,729,391,338,365331.09,315769,681100.09
310120,201708,384,215,169,200799.1,157985.61,358784.71
310130,201708,34,21,13,19677,12181,31858
310140,201708,30,17,13,15929,12181,28110
310150,201708,1278,881,397,820440.06,371426.9,1191866.96
310160,201708,2129,1076,1053,1002404.55,983943.8,1986348.35
310163,201708,87,49,38,45913,35606,81519
310170,201708,2543,1037,1506,971267,1408592.3,2379859.3
310180,201708,121,45,76,42165,70837.2,113002.2
310190,201708,473,312,161,292344,150294.8,442638.8
310200,201708,507,316,191,296092,178686,474778
310205,201708,54,42,12,39354,11244,50598
310210,201708,289,229,60,214573,56220,270793
310220,201708,52,31,21,29047,19677,48724
310230,201708,260,185,75,173157.6,70275,243432.6
310240,201708,105,93,12,86906.75,11244,98150.75
310250,201708,98,80,18,74960,16866,91826
310260,201708,809,428,381,398413.35,356275.51,754688.86
310270,201708,269,179,90,167180,84330,251510
310280,201708,363,270,93,251398.1,87141,338539.1
310285,201708,215,153,62,143058.35,58094,201152.35
310290,201708,254,147,107,137739,100259,237998
310300,201708,153,126,27,118062,25299,143361
310310,201708,5,4,1,3748,937,4685
310320,201708,22,15,7,14055,6559,20614
310330,201708,32,23,9,21551,8433,29984
310340,201708,1662,1054,608,979057.35,568197.25,1547254.60
310350,201708,2787,1507,1280,1407331.85,1198788.9,2606120.75
310360,201708,42,34,8,31858,7496,39354
310370,201708,120,98,22,91826,20333,112159
310375,201708,107,38,69,35606,64635,100241
310380,201708,51,29,22,27173,20614,47787
310390,201708,100,70,30,65590,28110,93700
310400,201708,2248,1444,804,1349468.9,753048.9,2102517.8
310410,201708,124,67,57,62779,53409,116188
310420,201708,664,357,307,332448.9,286713.43,619162.33
310430,201708,330,216,114,202110.9,106818,308928.9
310440,201708,60,37,23,34669,21551,56220
310445,201708,81,66,15,61842,14055,75897
310450,201708,851,532,319,497016.1,298903,795919.1
310460,201708,265,187,78,175219,73086,248305
310470,201708,493,310,183,290470,171471,461941
310480,201708,88,61,27,57157,25299,82456
310490,201708,478,227,251,211762.1,235187,446949.1
310500,201708,124,56,68,52472,63716,116188
310510,201708,616,398,218,371704.8,204247.63,575952.43
310520,201708,130,86,44,80582,41228,121810
310530,201708,85,40,45,37480,41883.9,79363.9
310540,201708,447,280,167,260019.3,156479,416498.3
310550,201708,84,54,30,50598,28110,78708
310560,201708,2864,1985,879,1849593.75,822025.42,2671619.17
310570,201708,157,101,56,94637,52472,147109
310590,201708,333,222,111,207593,103992.95,311585.95
310600,201708,160,93,67,85407.85,62779,148186.85
310610,201708,60,22,38,20193,35606,55799
310620,201708,44752,21398,23354,19977172.51,21848125.34,41825297.85
310630,201708,569,361,208,336290.05,193615.71,529905.76
310640,201708,134,112,22,104756.6,20614,125370.6
310650,201708,157,138,19,128369,17803,146172
310660,201708,91,57,34,53409,31858,85267
310665,201708,50,34,16,31858,14992,46850
310670,201708,6146,2889,3257,2699480.41,3047099.15,5746579.56
310680,201708,52,36,16,33732,14992,48724
310690,201708,575,416,159,385662.73,148983,534645.73
310700,201708,65,42,23,39354,21410.45,60764.45
310710,201708,1249,829,420,775541.22,392978,1168519.22
310720,201708,86,29,57,27173,53409,80582
310730,201708,1350,932,418,873003,391666,1264669
310740,201708,996,564,432,525189.1,404540.63,929729.73
310750,201708,244,143,101,133054.29,94637,227691.29
310760,201708,66,50,16,46850,14992,61842
310770,201708,89,45,44,42165,41228,83393
310780,201708,409,333,76,312012,71212,383224
310790,201708,99,80,19,74960,17803,92763
310800,201708,457,219,238,204734.5,222715.53,427450.03
310810,201708,163,115,48,106715.1,44039.83,150754.93
310820,201708,371,292,79,273604,73741.9,347345.9
310825,201708,186,152,34,142424,31858,174282
310830,201708,460,218,242,203617.61,225535.9,429153.51
310840,201708,391,225,166,210825,155542,366367
310850,201708,108,88,20,82456,18740,101196
310855,201708,381,300,81,281100,75897,356997
310860,201708,1366,1027,339,957668.45,315938.95,1273607.40
310870,201708,54,43,11,40291,10307,50598
310880,201708,79,60,19,55938.9,17803,73741.9
310890,201708,311,183,128,171471,119936,291407
310900,201708,642,292,350,270704.67,327650.9,598355.57
310910,201708,245,169,76,157042.1,71212,228254.1
310920,201708,491,292,199,270794.1,185526.7,456320.8
310925,201708,27,20,7,18740,6278,25018
310930,201708,1092,647,445,605843.1,416870.88,1022713.98
310940,201708,673,344,329,321737.9,308273,630010.9
310945,201708,121,75,46,70275,43102,113377
310950,201708,259,202,57,189274,53409,242683
310960,201708,84,29,55,27173,51531,78704
310970,201708,170,103,67,96511,61873.2,158384.2
310980,201708,41,22,19,20614,17803,38417
310990,201708,155,87,68,81238,63716,144954
311000,201708,811,417,394,387919.9,369169,757088.9
311010,201708,40,33,7,30921,6559,37480
311020,201708,40,25,15,23425,14055,37480
311030,201708,391,228,163,211763,152731,364494
311040,201708,38,33,5,30921,4685,35606
311050,201708,458,192,266,179342,248679.8,428021.8
311060,201708,754,442,312,412749.2,292344,705093.2
311070,201708,318,144,174,134928,163038,297966
311080,201708,110,59,51,55283,47787,103070
311090,201708,393,183,210,170534,196770,367304
311100,201708,609,364,245,341068,229283.9,570351.9
311110,201708,654,448,206,419776,193013,612789
311115,201708,65,48,17,44695,15929,60624
311120,201708,1003,529,474,493749.4,443247.95,936997.35
311130,201708,406,238,168,222818.6,157416,380234.6
311140,201708,161,76,85,71212,78848.55,150060.55
311150,201708,356,228,128,213519,119701.75,333220.75
311160,201708,735,530,205,494736.7,191617,686353.7
311170,201708,79,57,22,53409,20332.9,73741.9
311180,201708,343,225,118,210543.9,110285,320828.9
311190,201708,36,20,16,18740,14992,33732
311200,201708,346,235,111,218602.3,104007,322609.3
311205,201708,29,19,10,17568.75,8995.2,26563.95
311210,201708,48,41,7,38417,6559,44976
311220,201708,11,10,1,9370,937,10307
311230,201708,1620,1041,579,972346.65,542523,1514869.65
311240,201708,166,101,65,94310.06,60905,155215.06
311250,201708,63,29,34,27173,31858,59031
311260,201708,551,342,209,320454,195833,516287
311265,201708,107,73,34,68401,31858,100259
311270,201708,282,195,87,182715,81519,264234
311280,201708,216,100,116,93700,108129.8,201829.8
311290,201708,110,89,21,83112,19115,102227
311300,201708,543,340,203,317643.88,189930,507573.88
311310,201708,24,20,4,18740,3748,22488
311320,201708,664,495,169,462878,158353,621231
311330,201708,1013,751,262,703359.75,244557.7,947917.45
311340,201708,2578,1839,739,1715847.82,691759.73,2407607.55
311350,201708,270,210,60,196770,56220,252990
311360,201708,171,106,65,99322,60905,160227
311370,201708,1190,471,719,439372.25,672859.7,1112231.95
311380,201708,7,6,1,5622,937,6559
311390,201708,281,152,129,142424,120404.6,262828.6
311400,201708,151,98,53,91826,49652,141478
311410,201708,93,53,40,49661,37480,87141
311420,201708,292,162,130,150201.1,121810,272011.1
311430,201708,852,556,296,519006.1,277352,796358.1
311440,201708,484,338,146,315769.4,136520.9,452290.3
311450,201708,314,193,121,180841,113377,294218
311455,201708,305,206,99,192731.9,92481.9,285213.8
311460,201708,128,53,75,49661,69295.83,118956.83
311470,201708,20,10,10,9370,9370,18740
311480,201708,24,8,16,7496,14992,22488
311490,201708,17,10,7,9370,6559,15929
311500,201708,20,9,11,8433,10307,18740
311510,201708,627,433,194,403813.75,181496.9,585310.65
311520,201708,44,33,11,30265.1,10307,40572.1
311530,201708,1829,1362,467,1267858.56,437579,1705437.56
311535,201708,62,48,14,44976,13118,58094
311540,201708,35,30,5,28110,4685,32795
311545,201708,186,140,46,131180,43102,174282
311547,201708,31,22,9,20614,8433,29047
311550,201708,598,275,323,257675,302632.63,560307.63
311560,201708,41,28,13,26236,12181,38417
311570,201708,304,197,107,184026.8,100259,284285.8
311580,201708,291,165,126,154323.9,118062,272385.9
311590,201708,34,29,5,27173,4685,31858
311600,201708,87,70,17,65590,15929,81519
311610,201708,263,230,33,214260.95,30921,245181.95
311615,201708,90,75,15,69647.21,14055,83702.21
311620,201708,16,11,5,10307,4685,14992
311630,201708,80,67,13,62779,12181,74960
311640,201708,122,69,53,64653,49661,114314
311650,201708,123,90,33,83627.25,30921,114548.25
311660,201708,393,188,205,176156,192085,368241
311670,201708,158,103,55,96271,51535,147806
311680,201708,223,165,58,152946.94,53596.4,206543.34
311690,201708,18,11,7,10307,6559,16866
311700,201708,200,136,64,127150.9,59968,187118.9
311710,201708,219,141,78,132117,73086,205203
311720,201708,35,27,8,25299,7496,32795
311730,201708,523,348,175,325514,163975,489489
311740,201708,32,22,10,20614,9370,29984
311750,201708,701,480,221,447886.4,207077,654963.4
311760,201708,64,37,27,34669,25299,59968
311770,201708,399,188,211,174282.61,197707,371989.61
311780,201708,168,97,71,90482.96,66215,156697.96
311783,201708,74,65,9,60905,8433,69338
311787,201708,35,16,19,14992,17803,32795
311790,201708,263,126,137,118062,128369,246431
311800,201708,622,425,197,394900.15,184589,579489.15
311810,201708,42,36,6,33732,5622,39354
311820,201708,105,87,18,81519,16866,98385
311830,201708,1833,1187,646,1107741.95,602023.4,1709765.35
311840,201708,996,549,447,510197.95,417095.66,927293.61
311850,201708,7,4,3,3748,2811,6559
311860,201708,9208,4280,4928,3997093.49,4610185.66,8607279.15
311870,201708,159,87,72,81519,67464,148983
311880,201708,948,706,242,660294.9,226754,887048.9
311890,201708,222,115,107,107755,100259,208014
311900,201708,87,37,50,34669,46850,81519
311910,201708,1366,853,513,796404.05,478479.15,1274883.20
311920,201708,229,149,80,139379,74960,214339
311930,201708,904,522,382,488833,357700,846533
311940,201708,2369,1194,1175,1115921.15,1098210.95,2214132.10
311950,201708,25,16,9,14992,8433,23425
311960,201708,70,49,21,45913,19677,65590
311970,201708,25,14,11,13118,10307,23425
311980,201708,42,31,11,29047,10307,39354
311990,201708,56,41,15,38417,14055,52472
311995,201708,64,44,20,41228,18740,59968
312000,201708,33,23,10,21269.9,9370,30639.9
312010,201708,86,62,24,58094,22488,80582
312015,201708,91,67,24,62498,22488,84986
312020,201708,144,91,53,85267,49661,134928
312030,201708,38,32,6,29329,5622,34951
312040,201708,78,48,30,44976,28110,73086
312050,201708,226,116,110,108692,103070,211762
312060,201708,71,47,24,44039,21832.1,65871.1
312070,201708,77,44,33,41228,30921,72149
312080,201708,514,217,297,203329,278289,481618
312083,201708,42,31,11,29047,10307,39354
312087,201708,106,83,23,77771,21551,99322
312090,201708,2739,1527,1212,1417310.85,1132200.62,2549511.47
312100,201708,163,115,48,107755,44208,151963
312110,201708,119,78,41,73086,38417,111503
312120,201708,143,103,40,96511,37480,133991
312125,201708,91,49,42,45725.6,39354,85079.6
312130,201708,125,82,43,76834,40291,117125
312140,201708,134,105,29,98385,27173,125558
312150,201708,43,35,8,32795,7496,40291
312160,201708,1510,1009,501,941505.54,467769.34,1409274.88
312170,201708,12,10,2,9370,1874,11244
312180,201708,135,88,47,81519.75,43758,125277.75
312190,201708,32,29,3,27173,2811,29984
312200,201708,713,613,100,572741.35,93700,666441.35
312210,201708,97,62,35,58094,32795,90889
312220,201708,119,87,32,81285,29984,111269
312230,201708,3382,1680,1702,1569879.89,1593193.49,3163073.38
312235,201708,138,91,47,85267,44039,129306
312240,201708,113,74,39,69338,36543,105881
312245,201708,159,107,52,100255,48724,148979
312247,201708,54,38,16,34857,14992,49849
312250,201708,179,86,93,80114,87141,167255
312260,201708,98,67,31,61936.6,29047,90983.6
312270,201708,137,85,52,79645,48724,128369
312280,201708,25,15,10,14055,9370,23425
312290,201708,158,110,48,102788.9,44040,146828.9
312300,201708,192,129,63,120873,59031,179904
312310,201708,57,52,5,48724,4685,53409
312320,201708,426,264,162,245494,150529.25,396023.25
312330,201708,88,77,11,71400,10025.9,81425.9
312340,201708,36,16,20,14992,18740,33732
312350,201708,16,10,6,9370,5622,14992
312352,201708,92,64,28,59968,26236,86204
312360,201708,564,260,304,242683,284192.1,526875.1
312370,201708,286,172,114,160882.9,106818,267700.9
312380,201708,136,85,51,79645,47787,127432
312385,201708,184,148,36,138676,33732,172408
312390,201708,295,187,108,175219,100541,275760
312400,201708,372,278,94,260486,87610,348096
312410,201708,838,271,567,253458.5,530713,784171.5
312420,201708,603,485,118,454445,110566,565011
312430,201708,855,632,223,589609.94,208014.1,797624.04
312440,201708,44,32,12,29984,11244,41228
312450,201708,210,131,79,122747,74023,196770
312460,201708,55,25,30,23425,28110,51535
312470,201708,56,35,21,32795,19677,52472
312480,201708,218,135,83,126495,77489.9,203984.9
312490,201708,246,168,78,157416,73086,230502
312500,201708,32,17,15,15929,14055,29984
312510,201708,422,160,262,149920,244889.36,394809.36
312520,201708,40,14,26,13118,24362,37480
312530,201708,45,35,10,32795,9370,42165
312540,201708,101,88,13,82456,12181,94637
312550,201708,36,28,8,26236,7496,33732
312560,201708,193,140,53,130899,49379.9,180278.9
312570,201708,433,257,176,240434.2,164233.23,404667.43
312580,201708,82,43,39,40291,36543,76834
312590,201708,272,216,56,201316,52472,253788
312595,201708,143,130,13,121810,12181,133991
312600,201708,76,47,29,43618,27173,70791
312610,201708,1609,836,773,778087.29,722446.2,1500533.49
312620,201708,184,129,55,120873,51535,172408
312630,201708,65,53,12,49661,11244,60905
312640,201708,47,14,33,13118,30921,44039
312650,201708,140,113,27,105600,25018,130618
312660,201708,63,48,15,44695,14055,58750
312670,201708,861,564,297,526922.95,278079.15,805002.10
312675,201708,41,31,10,29047,9370,38417
312680,201708,82,56,26,52097.2,24362,76459.2
312690,201708,242,130,112,121800.63,104662.9,226463.53
312695,201708,28,22,6,20614,5622,26236
312700,201708,193,108,85,101196,79645,180841
312705,201708,72,60,12,56220,10962.9,67182.9
312707,201708,90,67,23,62498,21551,84049
312710,201708,1848,988,860,924295,805612,1729907
312720,201708,63,32,31,29984,29047,59031
312730,201708,293,174,119,162101,111221.9,273322.9
312733,201708,50,43,7,40291,6559,46850
312735,201708,21,15,6,14055,5622,19677
312737,201708,70,38,32,35606,29984,65590
312738,201708,51,36,15,33732,14055,47787
312740,201708,69,50,19,46850,17803,64653
312750,201708,75,54,21,50598,19677,70275
312760,201708,273,198,75,185526,70275,255801
312770,201708,7563,3480,4083,3237951.74,3816746.38,7054698.12
312780,201708,441,341,100,319235.9,93700,412935.9
312790,201708,18,14,4,13118,3748,16866
312800,201708,1596,1117,479,1040265.98,447662.11,1487928.09
312810,201708,377,239,138,223943,129306,353249
312820,201708,194,147,47,137739,44039,181778
312825,201708,27,18,9,16866,8433,25299
312830,201708,289,168,121,156480,112750,269230
312840,201708,149,111,38,104007,35606,139613
312850,201708,22,19,3,17803,2811,20614
312860,201708,171,107,64,99978,59968,159946
312870,201708,978,509,469,474184.85,439453,913637.85
312880,201708,150,105,45,98010.45,42071.3,140081.75
312890,201708,164,113,51,105881,47787,153668
312900,201708,212,157,55,146453.1,51535,197988.1
312910,201708,184,93,91,85991.66,85267,171258.66
312920,201708,155,86,69,80582,64653,145235
312930,201708,339,246,93,230502,87141,317643
312940,201708,102,67,35,62779,32795,95574
312950,201708,684,443,241,413779.3,225817,639596.3
312960,201708,176,134,42,125558,39354,164912
312965,201708,46,41,5,38417,4685,43102
312970,201708,281,228,53,212699.1,49661,262360.1
312980,201708,2249,1211,1038,1130296.7,972039.8,2102336.5
312990,201708,48,28,20,26236,18740,44976
313000,201708,39,26,13,24362,12181,36543
313005,201708,161,124,37,115213.75,34388,149601.75
313010,201708,924,380,544,354842,509437.9,864279.9
313020,201708,196,101,95,94168.5,89015,183183.5
313030,201708,205,129,76,119937,71212,191149
313040,201708,55,20,35,18740,32795,51535
313050,201708,294,206,88,192085.1,82456,274541.1
313055,201708,42,30,12,28110,11244,39354
313060,201708,126,86,40,80133,37198.9,117331.9
313065,201708,61,39,22,36543,20614,57157
313070,201708,156,83,73,77771,68401,146172
313080,201708,40,17,23,15929,21551,37480
313090,201708,698,478,220,445918.4,206140,652058.4
313100,201708,170,63,107,59031,100251,159282
313110,201708,119,71,48,66527,44976,111503
313115,201708,141,76,65,71015.23,59968,130983.23
313120,201708,740,404,336,378267,313333,691600
313130,201708,5030,2690,2340,2500851.97,2184327.67,4685179.64
313140,201708,164,82,82,76834,76834,153668
313150,201708,316,253,63,237061,58749.9,295810.9
313160,201708,173,123,50,115251,46850,162101
313170,201708,1312,925,387,853937.04,362235.2,1216172.24
313180,201708,332,193,139,180203.84,130243,310446.84
313190,201708,705,409,296,379956.59,276603,656559.59
313200,201708,22,21,1,19677,937,20614
313210,201708,1028,857,171,800059.48,160222.32,960281.80
313220,201708,224,153,71,142424,65824.25,208248.25
313230,201708,275,199,76,185527,71212,256739
313240,201708,1906,1026,880,959012.27,820620.52,1779632.79
313250,201708,1237,905,332,842177.7,308275.4,1150453.1
313260,201708,90,54,36,50598,33732,84330
313270,201708,951,549,402,510430.77,376674,887104.77
313280,201708,60,51,9,47318.51,8433,55751.51
313290,201708,227,179,48,167442,44039.9,211481.9
313300,201708,358,177,181,163975.4,169597,333572.4
313310,201708,213,109,104,102133,97448,199581
313320,201708,365,279,86,259502.55,80582,340084.55
313330,201708,1329,792,537,741167.6,501998.75,1243166.35
313340,201708,335,228,107,213636,100259,313895
313350,201708,526,355,171,330761.05,160227,490988.05
313360,201708,115,64,51,59968,47506,107474
313370,201708,196,78,118,73086,110566,183652
313375,201708,256,154,102,144298,95574,239872
313380,201708,1232,622,610,580021.84,571004,1151025.84
313390,201708,48,40,8,36543.4,7496,44039.4
313400,201708,418,268,150,251116,140269,391385
313410,201708,17,9,8,8433,7496,15929
313420,201708,4651,2390,2261,2231534.19,2111427.81,4342962.00
313430,201708,134,62,72,58094,67464,125558
313440,201708,1454,978,476,914934.75,445450,1360384.75
313450,201708,62,27,35,25299,32795,58094
313460,201708,372,177,195,164431,182715,347146
313470,201708,517,234,283,219258,264515.1,483773.1
313480,201708,159,110,49,102134,45913,148047
313490,201708,504,247,257,231434.32,240763,472197.32
313500,201708,16,10,6,9370,5622,14992
313505,201708,934,722,212,675577,198644,874221
313507,201708,90,53,37,49661,34669,84330
313510,201708,2744,1767,977,1650575.15,914512,2565087.15
313520,201708,3560,2776,784,2588941.19,734604,3323545.19
313530,201708,40,29,11,27173,10307,37480
313535,201708,99,82,17,76179,15929,92108
313540,201708,70,55,15,51535,14055,65590
313545,201708,99,81,18,75897,16866,92763
313550,201708,237,191,46,178967,42540,221507
313560,201708,331,169,162,158353,151794,310147
313570,201708,56,30,26,28110,24362,52472
313580,201708,1274,681,593,636752.05,553954.8,1190706.85
313590,201708,82,48,34,44976,31858,76834
313600,201708,693,409,284,383233,265265,648498
313610,201708,54,43,11,39400.9,10307,49707.9
313620,201708,1300,690,610,636534.16,568159.5,1204693.66
313630,201708,1618,1244,374,1164129.4,350157,1514286.4
313640,201708,126,71,55,66527,51535,118062
313650,201708,232,110,122,103070,114314,217384
313652,201708,12,10,2,9370,1874,11244
313655,201708,51,31,20,29047,18740,47787
313657,201708,44,41,3,38417,2811,41228
313660,201708,125,91,34,85267,31858,117125
313665,201708,618,311,307,291407,287424.75,578831.75
313670,201708,9946,6905,3041,6448812.83,2848855,9297667.83
313680,201708,39,29,10,27173,9370,36543
313690,201708,157,121,36,113377,33732,147109
313695,201708,61,46,15,43102,14055,57157
313700,201708,286,228,58,213355,54346,267701
313710,201708,154,107,47,100259,44039,144298
313720,201708,999,471,528,439827.9,493134.83,932962.73
313730,201708,56,41,15,38417,14055,52472
313740,201708,158,125,33,117125,30921,148046
313750,201708,453,329,124,307991.9,116188,424179.9
313753,201708,242,168,74,156760.1,69338,226098.1
313760,201708,1161,417,744,390729,694440.56,1085169.56
313770,201708,342,245,97,229565,90889,320454
313780,201708,751,391,360,366367,337038.9,703405.9
313790,201708,26,25,1,23425,937,24362
313800,201708,137,84,53,78708,49661,128369
313810,201708,54,34,20,31858,18740,50598
313820,201708,1273,629,644,588209.1,602329.6,1190538.7
313830,201708,68,51,17,47787,15929,63716
313835,201708,53,48,5,44976,4685,49661
313840,201708,1612,986,626,919574.2,585344,1504918.2
313850,201708,179,62,117,58094,109059.39,167153.39
313860,201708,489,379,110,352147.7,102133.55,454281.25
313862,201708,172,115,57,107755,53409,161164
313865,201708,81,63,18,59031,16866,75897
313867,201708,51,39,12,36543,11244,47787
313868,201708,24,15,9,13306,8433,21739
313870,201708,124,65,59,60905,55283,116188
313880,201708,327,208,119,194614.9,110940.9,305555.8
313890,201708,320,173,147,161351.9,137176.8,298528.7
313900,201708,919,499,420,465971.25,393213,859184.25
313910,201708,131,94,37,88078,33732.1,121810.1
313920,201708,590,420,170,393352.6,159290,552642.6
313925,201708,31,26,5,24362,4685,29047
313930,201708,791,606,185,567822,173322,741144
313940,201708,1728,1078,650,1005682.2,608231.52,1613913.72
313950,201708,936,593,343,553861.8,320875.9,874737.7
313960,201708,1348,773,575,720093.65,537557,1257650.65
313970,201708,115,84,31,78708,29047,107755
313980,201708,205,133,72,124387,67464,191851
313990,201708,348,211,137,197425.9,128369,325794.9
314000,201708,898,613,285,571899.35,266917.32,838816.67
314010,201708,75,48,27,44976,25299,70275
314015,201708,61,20,41,18740,38417,57157
314020,201708,51,35,16,32795,14898.3,47693.3
314030,201708,101,50,51,46850,47787,94637
314040,201708,40,29,11,27173,10307,37480
314050,201708,306,180,126,168379,116750.2,285129.2
314053,201708,99,64,35,59031.2,32795,91826.2
314055,201708,284,164,120,153668,112440,266108
314060,201708,143,121,22,112440,20614,133054
314070,201708,931,473,458,439182.67,428246.63,867429.30
314080,201708,214,142,72,132820,66434.14,199254.14
314085,201708,109,73,36,68401,33732,102133
314090,201708,343,245,98,229565,91821.32,321386.32
314100,201708,465,380,85,352188,79083,431271
314110,201708,685,373,312,347636.37,291641.8,639278.17
314120,201708,103,56,47,52472,44039,96511
314130,201708,23,11,12,10307,11244,21551
314140,201708,1089,645,444,602753.46,414154.23,1016907.69
314150,201708,167,104,63,97448,59031,156479
314160,201708,356,263,93,243339.3,86954,330293.3
314170,201708,66,48,18,44976,16866,61842
314180,201708,727,634,93,593777,86204.25,679981.25
314190,201708,102,61,41,57157,38417,95574
314200,201708,589,401,188,374519.7,175219,549738.7
314210,201708,272,203,69,189929.9,64372,254301.9
314220,201708,317,236,81,219259,75616,294875
314225,201708,63,44,19,41228,17803,59031
314230,201708,101,46,55,43102,51535,94637
314240,201708,135,102,33,95574,30921,126495
314250,201708,58,34,24,31858,22488,54346
314260,201708,187,96,91,89952,85267,175219
314270,201708,329,256,73,239123,68120,307243
314280,201708,676,374,302,350147.9,282974,633121.9
314290,201708,552,439,113,410125.25,105599.9,515725.15
314300,201708,412,291,121,269783.5,113331,383114.5
314310,201708,1419,941,478,880781,447585.33,1328366.33
314315,201708,34,27,7,25299,6559,31858
314320,201708,604,381,223,356434.9,208042.21,564477.11
314330,201708,10626,5355,5271,5005986.57,4933310,9939296.57
314340,201708,577,272,305,254301.9,285223,539524.9
314345,201708,25,18,7,16866,6559,23425
314350,201708,185,110,75,103070,70275,173345
314360,201708,71,40,31,37480,29047,66527
314370,201708,59,50,9,46850,8433,55283
314380,201708,91,65,26,60905,24362,85267
314390,201708,3115,1972,1143,1843267.25,1068086.7,2911353.95
314400,201708,670,485,185,451626.1,173345,624971.1
314410,201708,413,269,144,252053,134928,386981
314420,201708,19,8,11,7496,10307,17803
314430,201708,2483,887,1596,827435.15,1492814.79,2320249.94
314435,201708,273,158,115,147764.9,106818,254582.9
314437,201708,24,18,6,16866,5622,22488
314440,201708,98,69,29,64653,27173,91826
314450,201708,153,116,37,108692,34669,143361
314460,201708,648,299,349,280163,327013,607176
314465,201708,78,54,24,50598,22488,73086
314467,201708,68,58,10,54337,9370,63707
314470,201708,343,174,169,159648.06,157416.75,317064.81
314480,201708,1015,490,525,459130,491737.6,950867.6
314490,201708,88,66,22,61842,20614,82456
314500,201708,301,194,107,181778,100259,282037
314505,201708,128,84,44,78708,41228,119936
314510,201708,227,180,47,168660,44039,212699
314520,201708,1201,618,583,571262.85,544350.45,1115613.30
314530,201708,667,530,137,495806,128369,624175
314535,201708,195,121,74,113095.9,69091.48,182187.38
314537,201708,60,35,25,32795,23425,56220
314540,201708,10,6,4,5622,3748,9370
314545,201708,48,33,15,30921,14055,44976
314550,201708,77,41,36,38417,33732,72149
314560,201708,805,433,372,403566,348283,751849
314570,201708,21,16,5,14992,4685,19677
314580,201708,19,9,10,8433,9370,17803
314585,201708,19,13,6,12181,5622,17803
314587,201708,81,70,11,65590,10307,75897
314590,201708,531,396,135,371052,126495,497547
314600,201708,977,623,354,580258.39,328980.9,909239.29
314610,201708,912,502,410,468172.4,383046.15,851218.55
314620,201708,146,106,40,98385,37480,135865
314625,201708,92,70,22,64747,20614,85361
314630,201708,1244,637,607,595135.65,568477.9,1163613.55
314640,201708,91,61,30,57157,28110,85267
314650,201708,203,117,86,109347.9,80113.5,189461.4
314655,201708,65,50,15,46850,14055,60905
314660,201708,18,14,4,13118,3748,16866
314670,201708,178,144,34,134647,31858,166505
314675,201708,213,118,95,110566,89015,199581
314690,201708,537,295,242,276133.9,226754,502887.9
314700,201708,2421,1305,1116,1217726.6,1045082.95,2262809.55
314710,201708,1623,942,681,878439.15,637487.95,1515927.10
314720,201708,408,242,166,225349,155542,380891
314730,201708,504,267,237,248774,221591.5,470365.5
314740,201708,677,327,350,305040.35,327950,632990.35
314750,201708,22,19,3,17803,2811,20614
314760,201708,305,151,154,141487,144288.63,285775.63
314770,201708,119,82,37,76834,34669,111503
314780,201708,21,6,15,5622,14055,19677
314790,201708,2308,1444,864,1346338.28,808621.73,2154960.01
314795,201708,47,40,7,37246,6559,43805
314800,201708,2837,1645,1192,1535516.56,1115064.33,2650580.89
314810,201708,1480,822,658,767919.25,614953.5,1382872.75
314820,201708,87,48,39,44976,36317.02,81293.02
314830,201708,206,161,45,150154.75,41884,192038.75
314840,201708,82,48,34,44976,31858,76834
314850,201708,343,166,177,155542,165849,321391
314860,201708,708,529,179,493705.79,166224.35,659930.14
314870,201708,1415,714,701,668081.5,656837,1324918.5
314875,201708,54,46,8,43102,7496,50598
314880,201708,45,33,12,30921,11244,42165
314890,201708,50,31,19,29047,17803,46850
314900,201708,27,22,5,20614,4685,25299
314910,201708,259,171,88,159945.9,82456,242401.9
314915,201708,150,132,18,123450,16866,140316
314920,201708,127,76,51,71212,47505.9,118717.9
314930,201708,1000,508,492,474171,460722.9,934893.9
314940,201708,54,42,12,39354,11244,50598
314950,201708,38,28,10,25533.25,9370,34903.25
314960,201708,58,42,16,39354,14992,54346
314970,201708,129,65,64,60343,59968,120311
314980,201708,301,194,107,179576.05,99322,278898.05
314990,201708,463,250,213,233313.25,198691.75,432005.00
314995,201708,182,64,118,59968,110556.63,170524.63
315000,201708,84,68,16,62779.6,14992,77771.6
315010,201708,46,30,16,28110,14992,43102
315015,201708,175,143,32,133278.88,29984,163262.88
315020,201708,54,45,9,42165,8433,50598
315030,201708,121,92,29,85268,27173,112441
315040,201708,64,48,16,44976,14992,59968
315050,201708,195,116,79,108692,74023,182715
315053,201708,37,32,5,29984,4685,34669
315057,201708,99,83,16,77396.2,14992,92388.2
315060,201708,70,64,6,58094.98,5622,63716.98
315070,201708,103,59,44,55283,41228,96511
315080,201708,364,299,65,280163,60905,341068
315090,201708,111,67,44,62779,41228,104007
315100,201708,73,39,34,36543,31858,68401
315110,201708,291,161,130,150014,121810,271824
315120,201708,1611,803,808,748523.1,755925,1504448.1
315130,201708,316,230,86,215510,80582,296092
315140,201708,524,304,220,283255.1,206140,489395.1
315150,201708,970,449,521,419777,487896,907673
315160,201708,200,99,101,92763,94637,187400
315170,201708,340,219,121,203330.1,113095.9,316426.0
315180,201708,3197,1358,1839,1269307.95,1720286,2989593.95
315190,201708,310,181,129,169223,120873,290096
315200,201708,1172,664,508,619451.53,474777.9,1094229.43
315210,201708,1502,848,654,790137.35,610924.8,1401062.15
315213,201708,37,24,13,22488,12181,34669
315217,201708,193,152,41,142424,38417,180841
315220,201708,1466,1118,348,1046675.95,325982.3,1372658.25
315230,201708,167,123,44,114970,41228,156198
315240,201708,427,274,153,256738,142414.88,399152.88
315250,201708,2511,1249,1262,1168720.3,1181455.47,2350175.77
315260,201708,149,90,59,83018.2,55283,138301.2
315270,201708,126,84,42,77583.6,38641.88,116225.48
315280,201708,693,453,240,424087,224870.63,648957.63
315290,201708,196,116,80,108692,74023.34,182715.34
315300,201708,74,47,27,44039,25299,69338
315310,201708,64,57,7,53409,6559,59968
315320,201708,157,85,72,79645,67464,147109
315330,201708,55,47,8,44039,7496,51535
315340,201708,415,296,119,276190.9,111503,387693.9
315350,201708,139,85,54,79645,50598,130243
315360,201708,93,49,44,45913,41228,87141
315370,201708,55,30,25,28110,23143.9,51253.9
315380,201708,11,6,5,5622,4685,10307
315390,201708,50,13,37,12181,34669,46850
315400,201708,808,604,204,560326.8,190492.1,750818.9
315410,201708,345,206,139,192741,130243,322984
315415,201708,62,47,15,44039,14055,58094
315420,201708,198,146,52,136052.5,48724,184776.5
315430,201708,687,406,281,379485.1,262785.9,642271.0
315440,201708,79,57,22,53409,20614,74023
315445,201708,252,202,50,188964.79,46850,235814.79
315450,201708,195,149,46,139613,43102,182715
315460,201708,3275,1676,1599,1566095.9,1494367.05,3060462.95
315470,201708,45,23,22,21270,20614,41884
315480,201708,62,23,39,21551,36543,58094
315490,201708,613,380,233,353764.35,218321,572085.35
315500,201708,24,13,11,12181,10307,22488
315510,201708,157,100,57,93700,53409,147109
315520,201708,68,59,9,55283,8433,63716
315530,201708,51,28,23,26236,21551,47787
315540,201708,239,154,85,144298,79645,223943
315550,201708,176,135,41,126495,38417,164912
315560,201708,744,589,155,551330.9,145235,696565.9
315570,201708,307,165,142,151748.25,133054,284802.25
315580,201708,631,414,217,387918,203329,591247
315590,201708,215,113,102,105881,95574,201455
315600,201708,283,204,79,190273.46,73836,264109.46
315610,201708,96,48,48,44976,44976,89952
315620,201708,31,24,7,22488,6559,29047
315630,201708,134,88,46,82456,43102,125558
315640,201708,51,30,21,28110,19677,47787
315645,201708,66,45,21,42165,19209,61374
315650,201708,166,119,47,111222,44039,155261
315660,201708,477,194,283,181778,265171,446949
315670,201708,2247,1155,1092,1079706.75,1022053.1,2101759.85
315680,201708,851,571,280,531524.81,261647.88,793172.69
315690,201708,702,477,225,445894.63,210825,656719.63
315700,201708,1886,1007,879,940748.51,823623,1764371.51
315710,201708,308,75,233,70275,218321,288596
315720,201708,417,268,149,251116,139613,390729
315725,201708,197,159,38,148983,35606,184589
315727,201708,40,23,17,21551,15929,37480
315730,201708,41,38,3,35606,2811,38417
315733,201708,85,53,32,49661,29984,79645
315737,201708,51,37,14,34669,13118,47787
315740,201708,42,37,5,34669,4685,39354
315750,201708,159,127,32,118999,29984,148983
315760,201708,44,29,15,27173,14055,41228
315765,201708,108,71,37,66527,34669,101196
315770,201708,229,134,95,125558,88734,214292
315780,201708,3232,1691,1541,1577581.75,1441744.08,3019325.83
315790,201708,205,159,46,148983,42539.8,191522.8
315800,201708,278,204,74,191074,69338,260412
315810,201708,92,52,40,48724,37199,85923
315820,201708,790,570,220,531842.77,206140,737982.77
315830,201708,144,81,63,75897,59031,134928
315840,201708,83,55,28,51535,26236,77771
315850,201708,259,191,68,178967,63716,242683
315860,201708,11,3,8,2811,7496,10307
315870,201708,34,28,6,26236,5622,31858
315880,201708,106,68,38,63716,35606,99322
315890,201708,70,50,20,46850,18740,65590
315895,201708,376,252,124,235086,115626,350712
315900,201708,67,34,33,31858,30921,62779
315910,201708,37,24,13,22160.05,12181,34341.05
315920,201708,185,122,63,114314,58094.95,172408.95
315930,201708,35,13,22,12181,20614,32795
315935,201708,145,114,31,106818,29038,135856
315940,201708,85,65,20,60905,18740,79645
315950,201708,63,44,19,41228,17803,59031
315960,201708,575,267,308,249541.94,288033.9,537575.84
315970,201708,39,30,9,28110,8433,36543
315980,201708,688,310,378,288977.1,354176.63,643153.73
315990,201708,249,151,98,141487,91545,233032
316000,201708,48,31,17,29047,15929,44976
316010,201708,71,62,9,58094,8433,66527
316020,201708,104,85,19,79645,17803,97448
316030,201708,410,210,200,196770,186885,383655
316040,201708,477,215,262,201153.89,245213,446366.89
316045,201708,60,54,6,50598,5622,56220
316050,201708,16,14,2,13118,1874,14992
316060,201708,96,63,33,58749.9,30921,89670.9
316070,201708,1022,657,365,609335.25,341256,950591.25
316080,201708,104,63,41,59031,38417,97448
316090,201708,46,27,19,24362.1,17803,42165.1
316095,201708,62,51,11,47516,10307,57823
316100,201708,302,176,126,164349.9,118062,282411.9
316105,201708,33,23,10,21551,9370,30921
316110,201708,1917,1534,383,1428316.27,357184.4,1785500.67
316120,201708,81,59,22,55283,20332.9,75615.9
316130,201708,138,106,32,98667,29984,128651
316140,201708,27,20,7,18740,6559,25299
316150,201708,195,139,56,129540.25,52472,182012.25
316160,201708,87,54,33,50598,30921,81519
316165,201708,60,45,15,41978,13352.25,55330.25
316170,201708,207,139,68,129306,63716,193022
316180,201708,195,90,105,84002.05,98385,182387.05
316190,201708,132,94,38,87141,35606,122747
316200,201708,696,397,299,371989,279976,651965
316210,201708,739,492,247,460664.43,231439,692103.43
316220,201708,116,76,40,71212,37480,108692
316225,201708,20,12,8,11244,7496,18740
316230,201708,33,19,14,17803,13118,30921
316240,201708,607,492,115,460067.1,107755,567822.1
316245,201708,99,81,18,75897,16866,92763
316250,201708,1472,1036,436,961582,407089.26,1368671.26
316255,201708,110,89,21,83018.2,19677,102695.2
316257,201708,176,95,81,89015,75615.9,164630.9
316260,201708,239,155,84,143960.93,78615,222575.93
316265,201708,24,15,9,14055,8433,22488
316270,201708,675,469,206,436506.8,193022,629528.8
316280,201708,544,337,207,313864.5,193303.3,507167.8
316290,201708,663,438,225,407595.69,210825,618420.69
316292,201708,481,187,294,175219,275244,450463
316294,201708,106,63,43,59031,40291,99322
316295,201708,270,119,151,110081.5,141487,251568.5
316300,201708,102,71,31,66527,29047,95574
316310,201708,33,18,15,16866,14055,30921
316320,201708,48,28,20,26236,18740,44976
316330,201708,127,80,47,74023.25,43757.9,117781.15
316340,201708,138,97,41,90889,38417,129306
316350,201708,186,130,56,121483,52472,173955
316360,201708,23,18,5,16866,4685,21551
316370,201708,1036,557,479,518180.75,448813.63,966994.38
316380,201708,117,89,28,83393,26236,109629
316390,201708,120,87,33,81519,30921,112440
316400,201708,135,103,32,96511,29984,126495
316410,201708,304,223,81,208295.1,75897,284192.1
316420,201708,186,132,54,122981.25,50598,173579.25
316430,201708,152,75,77,70275,72149,142424
316440,201708,99,48,51,44976,47787,92763
316443,201708,36,34,2,31858,1874,33732
316447,201708,63,50,13,46850,12181,59031
316450,201708,211,162,49,151794,45913,197707
316460,201708,64,28,36,26236,33732,59968
316470,201708,1550,1117,433,1037209.91,404217.73,1441427.64
316480,201708,10,9,1,8433,937,9370
316490,201708,16,5,11,4685,10307,14992
316500,201708,153,102,51,95292.9,47787,143079.9
316510,201708,172,127,45,118015.15,42165,160180.15
316520,201708,189,117,72,109066.8,67464,176530.8
316530,201708,147,105,42,98385,39073,137458
316540,201708,136,75,61,69338,57157,126495
316550,201708,144,100,44,93700,41228,134928
316553,201708,213,106,107,99103.5,100259,199362.5
316555,201708,30,19,11,17803,10307,28110
316556,201708,11,7,4,6559,3748,10307
316557,201708,16,14,2,13118,1874,14992
316560,201708,56,45,11,42165,10307,52472
316570,201708,248,225,23,210591,21551,232142
316580,201708,21,15,6,14055,5622,19677
316590,201708,119,103,16,96511,14992,111503
316600,201708,185,149,36,139332,33732,173064
316610,201708,68,45,23,41883.9,21551,63434.9
316620,201708,124,95,29,89015,27173,116188
316630,201708,37,27,10,25299,9370,34669
316640,201708,16,10,6,9370,5622,14992
316650,201708,60,47,13,44039,12181,56220
316660,201708,5,3,2,2811,1874,4685
316670,201708,436,149,287,139595,268357,407952
316680,201708,158,109,49,102133,45726,147859
316690,201708,192,121,71,113377,66527,179904
316695,201708,56,50,6,46850,5622,52472
316700,201708,13,7,6,6559,5622,12181
316710,201708,711,518,193,484100.42,180841,664941.42
316720,201708,4789,2439,2350,2270560.08,2197625.4,4468185.48
316730,201708,14,13,1,12181,937,13118
316740,201708,134,81,53,75897,49661,125558
316750,201708,19,13,6,12181,5622,17803
316760,201708,327,265,62,248305,58094,306399
316770,201708,139,81,58,75897,54346,130243
316780,201708,66,37,29,34369.16,27173,61542.16
316790,201708,56,42,14,39354,13118,52472
316800,201708,1785,1104,681,1031356.1,636692.1,1668048.2
316805,201708,18,9,9,8433,8433,16866
316810,201708,63,40,23,37480,21270,58750
316820,201708,38,20,18,18740,16866,35606
316830,201708,94,41,53,38417,49380,87797
316840,201708,501,300,201,280350.5,186463,466813.5
316850,201708,342,224,118,208529.35,110566,319095.35
316860,201708,5931,2613,3318,2435694.75,3104412.74,5540107.49
316870,201708,1391,901,490,835380.85,454635,1290015.85
316880,201708,101,59,42,54627.9,39354,93981.9
316890,201708,249,165,84,154605,78708,233313
316900,201708,419,285,134,264544.84,125558,390102.84
316905,201708,16,11,5,10307,4685,14992
316910,201708,51,26,25,24362,23425,47787
316920,201708,135,106,29,98620,27173,125793
316930,201708,1893,953,940,887294.15,878625.85,1765920.00
316935,201708,856,514,342,479744.66,318954.8,798699.46
316940,201708,1071,616,455,575974.6,425763.53,1001738.13
316950,201708,189,98,91,91826,85267,177093
316960,201708,1093,605,488,565486.9,456956.26,1022443.16
316970,201708,635,497,138,465689,129306,594995
316980,201708,115,68,47,63716,44029.63,107745.63
316990,201708,2149,1409,740,1313628.33,691731.88,2005360.21
317000,201708,317,244,73,228347,68401,296748
317005,201708,241,169,72,158353,67464,225817
317010,201708,6144,3364,2780,3132836.49,2602976.83,5735813.32
317020,201708,15858,6987,8871,6517316.32,8296684.94,14814001.26
317030,201708,85,32,53,29984,49167.02,79151.02
317040,201708,3102,1912,1190,1789408.64,1112969.6,2902378.24
317043,201708,69,47,22,44039,20614,64653
317047,201708,32,14,18,13118,16862,29980
317050,201708,184,138,46,129306,43102,172408
317052,201708,117,94,23,88078,21551,109629
317057,201708,197,150,47,140550,43477,184027
317060,201708,56,35,21,32795,19395.9,52190.9
317065,201708,59,48,11,44976,10307,55283
317070,201708,1955,921,1034,857355.85,966796.8,1824152.65
317075,201708,110,58,52,54346,48724,103070
317080,201708,813,433,380,404362.35,355873,760235.35
317090,201708,618,493,125,459220.01,117125,576345.01
317100,201708,405,303,102,282037.6,95574,377611.6
317103,201708,99,84,15,78708,14055,92763
317107,201708,37,33,4,30921,3748,34669
317110,201708,95,45,50,42165,46850,89015
317115,201708,40,34,6,31858,5622,37480
317120,201708,1742,876,866,813069.35,810993,1624062.35
317130,201708,1860,1186,674,1108254.02,630883,1739137.02
317140,201708,6,5,1,4685,937,5622
317150,201708,261,156,105,146172,97635.4,243807.4
317160,201708,311,225,86,210192,80582,290774
317170,201708,202,144,58,134928,54346,189274
317180,201708,414,301,113,281334.25,105881,387215.25
317190,201708,251,169,82,158353,76271.8,234624.8
317200,201708,780,555,225,506273,210591,716864
317210,201708,152,86,66,79645.6,61842,141487.6
317220,201708,21,12,9,11244,8433,19677
320010,201708,607,450,157,418371.25,147109,565480.25
320013,201708,131,93,38,87141,35606,122747
320016,201708,278,173,105,162101,98385,260486
320020,201708,711,429,282,398427.37,261639.97,660067.34
320030,201708,147,109,38,102133,35278.05,137411.05
320035,201708,131,95,36,89015,33732,122747
320040,201708,488,259,229,241558.8,214573,456131.8
320050,201708,99,77,22,72149,20614,92763
320060,201708,1481,671,810,628681,758305.3,1386986.3
320070,201708,100,70,30,65590,28110,93700
320080,201708,755,434,321,403595.5,300777,704372.5
320090,201708,1188,828,360,772259.98,336476.8,1108736.78
320100,201708,311,177,134,165849,125558,291407
320110,201708,135,87,48,79833.1,44976,124809.1
320115,201708,107,87,20,81519,18740,100259
320120,201708,3224,1804,1420,1679575.35,1328611.15,3008186.50
320130,201708,7134,3421,3713,3184585.2,3471314.38,6655899.58
320140,201708,416,268,148,249804.6,138436,388240.6
320150,201708,1814,1068,746,994945.3,698992.63,1693937.93
320160,201708,689,304,385,283621.22,359608.36,643229.58
320170,201708,114,88,26,81707,24362,106069
320180,201708,47,28,19,26236,17803,44039
320190,201708,234,162,72,151035.03,67183,218218.03
320200,201708,52,38,14,35606,13118,48724
320210,201708,838,474,364,442639.8,340114,782753.8
320220,201708,301,115,186,106818.86,174001,280819.86
320225,201708,72,59,13,55283,12181,67464
320230,201708,517,334,183,311646.2,170675,482321.2
320240,201708,3056,1546,1510,1446447.9,1412251.05,2858698.95
320245,201708,431,304,127,283723.7,118999,402722.7
320250,201708,210,111,99,101853,92763,194616
320255,201708,144,114,30,105534.31,27970,133504.31
320260,201708,173,123,50,115251,46803.15,162054.15
320265,201708,158,127,31,118203,29047,147250
320270,201708,150,121,29,113377,27173,140550
320280,201708,904,549,355,508792.1,331538.81,840330.91
320290,201708,65,56,9,52472,8433,60905
320300,201708,520,372,148,347131.65,137431.55,484563.20
320305,201708,630,335,295,313895,276228,590123
320310,201708,210,120,90,112159,83588,195747
320313,201708,283,145,138,135865,129025,264890
320316,201708,108,90,18,84330,16866,101196
320320,201708,3274,1476,1798,1377475.9,1680011.4,3057487.3
320330,201708,259,188,71,175506.9,64653.81,240160.71
320332,201708,865,525,340,489633.9,317550.15,807184.05
320334,201708,239,145,94,135584,88078,223662
320335,201708,146,107,39,99087.95,36543,135630.95
320340,201708,579,397,182,370865,169879,540744
320350,201708,946,405,541,376858.14,506401.44,883259.58
320360,201708,163,87,76,81238,70900,152138
320370,201708,242,183,59,169915,54268,224183
320380,201708,285,195,90,181310.4,84330,265640.4
320390,201708,1094,674,420,630939,391715.66,1022654.66
320400,201708,323,228,95,212699.5,89015,301714.5
320405,201708,846,353,493,330596.56,461554.15,792150.71
320410,201708,948,486,462,453723.7,432529.34,886253.04
320420,201708,474,243,231,227223.2,216447,443670.2
320425,201708,189,103,86,96511,80582,177093
320430,201708,387,220,167,205296.95,156479,361775.95
320435,201708,163,109,54,101327.18,50598,151925.18
320440,201708,195,122,73,114032.9,68401,182433.9
320450,201708,126,73,53,68401,49661,118062
320455,201708,238,190,48,177094,44958,222052
320460,201708,239,152,87,142424,81519,223943
320465,201708,117,80,37,74603.94,34669,109272.94
320470,201708,626,399,227,373564.54,212691,586255.54
320480,201708,162,106,56,99322,52472,151794
320490,201708,2939,1452,1487,1356511.32,1390473.98,2746985.30
320495,201708,90,57,33,53391,30921,84312
320500,201708,9189,4688,4501,4363965.87,4206956.76,8570922.63
320501,201708,517,257,260,240809,243620,484429
320503,201708,269,192,77,178967.6,72149,251116.6
320506,201708,245,189,56,177093,52472,229565
320510,201708,891,431,460,400124.65,429501.05,829625.70
320515,201708,79,66,13,60905.45,12181,73086.45
320517,201708,199,140,59,131180,55283,186463
320520,201708,6505,2898,3607,2702143.05,3372150.03,6074293.08
320530,201708,5107,2587,2520,2415620.56,2357345.68,4772966.24
330010,201708,2881,1486,1395,1384857.68,1304370.91,2689228.59
330015,201708,155,60,95,55283.14,89015,144298.14
330020,201708,3447,1504,1943,1406251.92,1820029,3226280.92
330022,201708,204,114,90,106818,83394,190212
330023,201708,508,176,332,163741.4,311084,474825.4
330025,201708,514,119,395,111503,369552.9,481055.9
330030,201708,1878,1192,686,1109552.43,639853.04,1749405.47
330040,201708,2158,1096,1062,1025125.55,994109,2019234.55
330045,201708,8161,2572,5589,2401335.61,5231013.52,7632349.13
330050,201708,776,492,284,461004,266108,727112
330060,201708,824,525,299,488179.45,279525.84,767705.29
330070,201708,3335,1305,2030,1218645.19,1901108.18,3119753.37
330080,201708,1428,688,740,641134.5,692443.3,1333577.8
330090,201708,350,205,145,192085,135865,327950
330093,201708,282,126,156,118062,146146,264208
330095,201708,102,52,50,48724,46850,95574
330100,201708,9188,4775,4413,4466790.84,4131139.4,8597930.24
330110,201708,474,216,258,200752.8,241746,442498.8
330115,201708,513,303,210,283911,196770,480681
330120,201708,360,185,175,172220.6,163506.5,335727.1
330130,201708,1412,423,989,395638.88,926650,1322288.88
330140,201708,593,311,282,291398,263298,554696
330150,201708,430,257,173,238935,161164,400099
330160,201708,207,129,78,120873,73086,193959
330170,201708,26194,9283,16911,8678421.11,15829908.35,24508329.46
330180,201708,237,150,87,137112.75,80816.25,217929.00
330185,201708,745,318,427,296458.1,400081,696539.1
330187,201708,262,88,174,82456,163038,245494
330190,201708,5531,2208,3323,2060730.25,3109479.73,5170209.98
330200,201708,4310,1494,2816,1394725.9,2633715.28,4028441.18
330205,201708,385,239,146,223521.35,136521,360042.35
330210,201708,962,586,376,544681.8,350625.95,895307.75
330220,201708,2409,1424,985,1330962.75,922008.1,2252970.85
330225,201708,539,302,237,282347,222069,504416
330227,201708,2374,802,1572,748372.63,1472661.32,2221033.95
330230,201708,199,120,79,111785,74023,185808
330240,201708,3481,1817,1664,1698154.77,1556800.43,3254955.20
330245,201708,150,63,87,59031,80769.4,139800.4
330250,201708,6317,3284,3033,3066808.15,2833099.25,5899907.40
330260,201708,554,169,385,158353,360745,519098
330270,201708,3214,1193,2021,1116717.5,1893304,3010021.5
330280,201708,435,285,150,264160.34,140541,404701.34
330285,201708,6970,2325,4645,2173880.7,4350085.2,6523965.9
330290,201708,574,224,350,208952,327669,536621
330300,201708,715,487,228,452571.85,213619,666190.85
330310,201708,413,240,173,223006.35,162101,385107.35
330320,201708,7772,2903,4869,2712524.8,4557578.86,7270103.66
330330,201708,9286,3597,5689,3365192.16,5326256.4,8691448.56
330340,201708,2587,1561,1026,1460774.53,961343.26,2422117.79
330350,201708,17419,6923,10496,6461830.3,9814758.69,16276588.99
330360,201708,2587,1263,1324,1182288.7,1240579,2422867.7
330370,201708,963,524,439,490238.4,409657.4,899895.8
330380,201708,819,356,463,332839.77,433362.9,766202.67
330385,201708,607,319,288,297967,269856,567823
330390,201708,5045,2816,2229,2627962.95,2086699.52,4714662.47
330395,201708,229,145,84,134179.05,76225.5,210404.55
330400,201708,625,325,300,301433.4,278443.29,579876.69
330410,201708,503,359,144,334735.63,134928,469663.63
330411,201708,221,127,94,118999,88078,207077
330412,201708,245,102,143,95293,133991,229284
330414,201708,6205,2525,3680,2362404.4,3444723.75,5807128.15
330415,201708,548,261,287,244557,267982.4,512539.4
330420,201708,2263,1206,1057,1127324.05,988255.3,2115579.35
330430,201708,1769,764,1005,715119.1,941123,1656242.1
330440,201708,246,111,135,104007,126495,230502
330450,201708,124,50,74,46850,69338,116188
330452,201708,1618,733,885,684865.18,829235.63,1514100.81
330455,201708,108865,38769,70096,36253278.38,65621960.31,101875238.69
330460,201708,263,109,154,102133,144298,246431
330470,201708,1210,661,549,612911.75,514403.63,1127315.38
330475,201708,1372,381,991,355124.3,928004.8,1283129.1
330480,201708,725,392,333,366648.1,311085,677733.1
330490,201708,13172,4697,8475,4394826.72,7933899.11,12328725.83
330500,201708,1315,609,706,570633,660867,1231500
330510,201708,11148,3609,7539,3375947.36,7057207.91,10433155.27
330513,201708,107,54,53,50598,49661,100259
330515,201708,856,352,504,325796.9,471874,797670.9
330520,201708,2346,890,1456,833715,1364131.45,2197846.45
330530,201708,227,120,107,112440,100072,212512
330540,201708,348,178,170,166786,158822,325608
330550,201708,3119,1113,2006,1041147.9,1877607.65,2918755.55
330555,201708,727,266,461,249224,430833.4,680057.4
330560,201708,523,199,324,186463,303579,490042
330570,201708,241,164,77,153668,72149,225817
330575,201708,750,331,419,309913,390583.75,700496.75
330580,201708,3301,1858,1443,1734977.06,1350592,3085569.06
330590,201708,302,158,144,148046,134928,282974
330600,201708,1046,678,368,633187.72,344057.03,977244.75
330610,201708,1500,826,674,767340.16,627511.45,1394851.61
330615,201708,180,140,40,131180,37480,168660
330620,201708,892,440,452,409002.7,421086.3,830089.0
330630,201708,3586,2250,1336,2090128.31,1244891.59,3335019.90
350010,201708,597,393,204,366509.79,191148,557657.79
350020,201708,38,19,19,17803,17803,35606
350030,201708,511,333,178,310897,165617.66,476514.66
350040,201708,127,47,80,43701.68,74960,118661.68
350050,201708,287,160,127,149920,118746.63,268666.63
350055,201708,85,47,38,44039,35606,79645
350060,201708,70,26,44,24362,41228,65590
350070,201708,794,460,334,426715.99,311269.12,737985.11
350075,201708,65,42,23,39354,21551,60905
350080,201708,51,33,18,30296.3,15929,46225.3
350090,201708,100,57,43,53409,40286.32,93695.32
350100,201708,302,187,115,174516.25,107755,282271.25
350110,201708,60,38,22,35606,20614,56220
350115,201708,154,91,63,84611.1,59031,143642.1
350120,201708,112,74,38,69338,35606,104944
350130,201708,355,170,185,158728,173345,332073
350140,201708,34,20,14,17991,13118,31109
350150,201708,68,54,14,50598,13118,63716
350160,201708,2446,947,1499,884323.99,1403540.16,2287864.15
350170,201708,395,244,151,226473.25,141206,367679.25
350180,201708,183,96,87,89671,81519,171190
350190,201708,949,465,484,433737.84,453212.85,886950.69
350200,201708,71,26,45,24362,41904.8,66266.8
350210,201708,1353,753,600,697502.66,561098.03,1258600.69
350220,201708,676,580,96,539402.75,89952,629354.75
350230,201708,76,54,22,50598,20614,71212
350240,201708,63,48,15,44976,14055,59031
350250,201708,1197,597,600,553629.45,561675.93,1115305.38
350260,201708,90,65,25,60905,23425,84330
350270,201708,820,540,280,505277.25,260655.76,765933.01
350275,201708,299,118,181,110192,169597,279789
350280,201708,4616,2337,2279,2178789.2,2131719.76,4310508.96
350290,201708,392,189,203,176812,189648.9,366460.9
350300,201708,46,24,22,22488,20614,43102
350310,201708,97,70,27,65590,25299,90889
350315,201708,38,22,16,20614,14992,35606
350320,201708,3254,1593,1661,1488172.62,1555842.52,3044015.14
350330,201708,1659,880,779,820532.3,728922.7,1549455.0
350335,201708,20,13,7,12181,6559,18740
350340,201708,133,69,64,64653,59968,124621
350350,201708,94,45,49,42165,45913,88078
350360,201708,126,86,40,80578,37199,117777
350370,201708,94,55,39,50910.3,36533.63,87443.93
350380,201708,719,306,413,286066.1,386699.9,672766.0
350390,201708,1368,558,810,522062.25,757845.7,1279907.95
350395,201708,26,18,8,16866,7496,24362
350400,201708,1674,897,777,831709.87,725497.28,1557207.15
350410,201708,2193,972,1221,908011.88,1143606.37,2051618.25
350420,201708,234,142,92,132461,86204,218665
350430,201708,73,42,31,38792,29047,67839
350440,201708,150,108,42,100212.25,39354,139566.25
350450,201708,1586,1018,568,946773.9,532123,1478896.9
350460,201708,336,122,214,114314,200236.9,314550.9
350470,201708,13,10,3,9370,2811,12181
350480,201708,150,82,68,76834,63716,140550
350490,201708,239,115,124,106818.9,116188,223006.9
350500,201708,37,17,20,15929,18740,34669
350510,201708,165,111,54,104007,50598,154605
350520,201708,438,200,238,184902,222381.3,407283.3
350530,201708,458,222,236,208014,221132,429146
350535,201708,60,48,12,44602,11244,55846
350540,201708,375,191,184,178167.55,172127,350294.55
350550,201708,2731,1604,1127,1495602.45,1054717.41,2550319.86
350560,201708,620,433,187,405716.32,174863.65,580579.97
350570,201708,4229,1748,2481,1632940.51,2321953,3954893.51
350580,201708,369,174,195,163038,182701.63,345739.63
350590,201708,898,487,411,456319,384170.3,840489.3
350600,201708,6082,3077,3005,2870459.67,2813036.07,5683495.74
350610,201708,1562,783,779,728065.3,728977,1457042.3
350620,201708,39,27,12,25299,11244,36543
350630,201708,239,139,100,129306.3,92764,222070.3
350635,201708,824,321,503,299783.82,470675.54,770459.36
350640,201708,120,88,32,82456,29984,112440
350650,201708,1871,1230,641,1148856.97,599604.1,1748461.07
350660,201708,749,337,412,315769,385103,700872
350670,201708,310,156,154,145938,144298,290236
350680,201708,178,98,80,91826,74960,166786
350690,201708,205,100,105,93700,98385,192085
350700,201708,670,333,337,308746.99,315769,624515.99
350710,201708,315,128,187,118749.1,175219,293968.1
350715,201708,47,41,6,38417,5622,44039
350720,201708,18,13,5,12181,4685,16866
350730,201708,42,27,15,25299,14055,39354
350740,201708,202,113,89,105590.53,83393,188983.53
350745,201708,21,11,10,10283,9370,19653
350750,201708,2100,1367,733,1271239.55,685259.3,1956498.85
350760,201708,3688,1588,2100,1487019.3,1965254.53,3452273.83
350770,201708,61,42,19,39354,17803,57157
350775,201708,48,35,13,32795,12172,44967
350780,201708,413,201,212,188337,198644,386981
350790,201708,381,167,214,156479,200518,356997
350800,201708,419,230,189,215510,177093,392603
350810,201708,503,400,103,372928,96511,469439
350820,201708,80,49,31,45913,29047,74960
350830,201708,82,49,33,45913,30921,76834
350840,201708,716,325,391,304244,365430,669674
350850,201708,1711,990,721,922002.26,675321,1597323.26
350860,201708,552,320,232,297949.16,217384,515333.16
350870,201708,437,296,141,277071,131742.9,408813.9
350880,201708,289,157,132,143785.2,123684,267469.2
350890,201708,41,26,15,24362,14055,38417
350900,201708,1400,454,946,423448.19,885652.4,1309100.59
350910,201708,25,17,8,15929,7496,23425
350920,201708,593,336,257,314519.7,240809,555328.7
350925,201708,1161,623,538,580762.69,502700.7,1083463.39
350930,201708,96,59,37,55283,34669,89952
350940,201708,680,372,308,347064.8,286787.8,633852.6
350945,201708,102,78,24,72562,22488,95050
350950,201708,14792,7105,7687,6627702.61,7193583.09,13821285.70
350960,201708,1274,585,689,543548.9,645589,1189137.9
350970,201708,1111,621,490,579650.3,458839.63,1038489.93
350980,201708,102,68,34,63716,31858,95574
350990,201708,364,130,234,121126,218976.9,340102.9
350995,201708,31,16,15,14992,14055,29047
351000,201708,632,454,178,423213.26,166786,589999.26
351010,201708,52,29,23,27173,21551,48724
351015,201708,59,41,18,38417,16866,55283
351020,201708,1644,942,702,880978.64,655713.2,1536691.84
351030,201708,319,222,97,205484.1,90889,296373.1
351040,201708,831,449,382,419776,356810.15,776586.15
351050,201708,3190,1545,1645,1440492.14,1539526.96,2980019.10
351060,201708,4827,2003,2824,1867250.26,2643107.57,4510357.83
351070,201708,424,273,151,253961.9,141487,395448.9
351080,201708,804,575,229,538775,213636,752411
351090,201708,66,29,37,27173,34669,61842
351100,201708,454,262,192,243311.35,179890.32,423201.67
351110,201708,2125,1023,1102,952142.02,1029732.86,1981874.88
351120,201708,76,40,36,37396.6,33732,71128.6
351130,201708,171,55,116,51535,108692,160227
351140,201708,334,237,97,220289.5,90889,311178.5
351150,201708,383,196,187,182899,175219,358118
351160,201708,244,160,84,149920,78708,228628
351170,201708,176,89,87,83393,80770,164163
351190,201708,92,63,29,59031,27173,86204
351200,201708,381,251,130,234518.87,121810,356328.87
351210,201708,131,59,72,55283,67464,122747
351220,201708,519,311,208,288096.81,194896,482992.81
351230,201708,275,199,76,185582.3,71193.26,256775.56
351240,201708,229,99,130,92575.6,121810,214385.6
351250,201708,70,49,21,45913,19677,65590
351260,201708,147,108,39,101196,36543,137739
351270,201708,51,22,29,20614,27173,47787
351280,201708,1095,505,590,469439.35,552315.39,1021754.74
351290,201708,225,100,125,93700,116844,210544
351300,201708,3750,1765,1985,1647062.13,1859633,3506695.13
351310,201708,744,394,350,367258,327950,695208
351320,201708,105,64,41,59968,38417,98385
351330,201708,40,28,12,26236,11244,37480
351340,201708,1187,752,435,698560.42,406637.32,1105197.74
351350,201708,2342,1263,1079,1181885.85,1010456.22,2192342.07
351360,201708,770,385,385,358871,359631.19,718502.19
351370,201708,369,196,173,183647.32,161476.3,345123.62
351380,201708,8921,4121,4800,3846753.5,4487693.46,8334446.96
351385,201708,27,19,8,17803,7496,25299
351390,201708,287,211,76,196977.26,71212,268189.26
351400,201708,58,36,22,33732,20568.63,54300.63
351410,201708,417,260,157,241970.9,146546.9,388517.8
351420,201708,62,51,11,47787,10307,58094
351430,201708,81,43,38,40291,35606,75897
351440,201708,778,533,245,497263.2,229561,726824.2
351450,201708,241,123,118,115251,110566,225817
351460,201708,120,55,65,50833,60905,111738
351470,201708,139,71,68,66518,63716,130234
351480,201708,514,279,235,259268.4,220077.88,479346.28
351490,201708,294,100,194,93700,181778,275478
351492,201708,32,23,9,21551,8433,29984
351495,201708,28,18,10,16866,9370,26236
351500,201708,3554,1530,2024,1427922.37,1891383,3319305.37
351510,201708,1761,734,1027,687476.9,960134.54,1647611.44
351512,201708,21,17,4,15929,3748,19677
351515,201708,194,109,85,102133,79645,181778
351518,201708,709,434,275,405717,257534.45,663251.45
351519,201708,72,46,26,43102,24362,67464
351520,201708,142,90,52,83706,48724,132430
351530,201708,20,14,6,13118,5622,18740
351535,201708,136,73,63,68401,59031,127432
351540,201708,432,306,126,284382,117687.2,402069.2
351550,201708,1291,786,505,730020.1,473175.63,1203195.73
351560,201708,75,37,38,34669,35606,70275
351565,201708,11,6,5,5622,4685,10307
351570,201708,2548,1329,1219,1243417.03,1141556.26,2384973.29
351580,201708,37,31,6,29047,5622,34669
351590,201708,68,45,23,42165,21551,63716
351600,201708,189,140,49,131180,45913,177093
351610,201708,59,29,30,27173,28110,55283
351620,201708,5946,3416,2530,3190367.56,2367540.61,5557908.17
351630,201708,2493,1281,1212,1195358.69,1133765.32,2329124.01
351640,201708,1640,793,847,740534.06,792140.4,1532674.46
351650,201708,29,25,4,23425,3748,27173
351660,201708,157,99,58,91545.5,54346,145891.5
351670,201708,731,454,277,422239.43,259549,681788.43
351680,201708,76,62,14,58094,13118,71212
351685,201708,42,26,16,24362,14992,39354
351690,201708,304,215,89,199578.17,83393,282971.17
351700,201708,163,113,50,105881,46850,152731
351710,201708,74,51,23,47787,21551,69338
351720,201708,136,63,73,59031,68401,127432
351730,201708,95,69,26,64653,24357.32,89010.32
351740,201708,706,469,237,439172,222064.32,661236.32
351750,201708,361,152,209,141487.7,195833,337320.7
351760,201708,799,621,178,582112,166650,748762
351770,201708,286,247,39,231439,36543,267982
351780,201708,167,91,76,85267,71212,156479
351790,201708,237,125,112,117125,104944,222069
351800,201708,52,34,18,31858,16866,48724
351810,201708,121,79,42,73742,39354,113096
351820,201708,879,638,241,594340.9,225812.32,820153.22
351830,201708,504,185,319,172595.4,298903,471498.4
351840,201708,1852,946,906,876914.75,847171.79,1724086.54
351850,201708,226,170,56,158681.9,52472,211153.9
351860,201708,750,490,260,454166.77,243615.32,697782.09
351870,201708,5568,2641,2927,2465053.75,2735426.54,5200480.29
351880,201708,18848,8360,10488,7810244.37,9813483.39,17623727.76
351885,201708,94,62,32,58094,29984,88078
351890,201708,78,64,14,59968,13118,73086
351900,201708,219,132,87,123029,81519,204548
351905,201708,78,34,44,31858,41228,73086
351907,201708,3061,1333,1728,1245578.23,1617815.9,2863394.13
351910,201708,175,71,104,66527,97448,163975
351920,201708,138,80,58,74960,54323.96,129283.96
351925,201708,87,60,27,56220,25299,81519
351930,201708,374,258,116,241652.3,108692,350344.3
351940,201708,228,104,124,97448,116188,213636
351950,201708,142,81,61,75897,57157,133054
351960,201708,824,384,440,359632.75,410443.58,770076.33
351970,201708,1891,997,894,932081.04,837388,1769469.04
351980,201708,147,74,73,67464,68401,135865
351990,201708,289,196,93,182715,86353.92,269068.92
352000,201708,351,211,140,197332.2,131180,328512.2
352010,201708,341,201,140,188337,131180,319517
352020,201708,198,71,127,66527,118999,185526
352030,201708,994,507,487,474356.25,454757.3,929113.55
352040,201708,576,246,330,230502,309210,539712
352042,201708,270,96,174,89952,162476,252428
352044,201708,391,232,159,216447.1,148983,365430.1
352050,201708,3111,1277,1834,1188886.8,1717379.53,2906266.33
352060,201708,101,65,36,60905,33732,94637
352070,201708,100,71,29,65591,27173,92764
352080,201708,64,39,25,35606,23425,59031
352090,201708,170,115,55,107755,51535,159290
352100,201708,250,121,129,113377,119741,233118
352110,201708,113,35,78,32795,73086,105881
352115,201708,73,28,45,26236,42165,68401
352120,201708,100,61,39,57157,36543,93700
352130,201708,221,185,36,173157.6,33732,206889.6
352140,201708,181,73,108,67933,101196,169129
352150,201708,120,67,53,61842.7,49661,111503.7
352160,201708,129,85,44,79645,41228,120873
352170,201708,375,254,121,237061.7,113377,350438.7
352180,201708,595,405,190,378408.75,178026,556434.75
352190,201708,265,103,162,96501.63,151747.15,248248.78
352200,201708,31,19,12,17803,11244,29047
352210,201708,3664,1525,2139,1420194.28,1999179.42,3419373.70
352215,201708,50,27,23,25299,21101.24,46400.24
352220,201708,6961,2752,4209,2573948.24,3941665.72,6515613.96
352230,201708,3125,1987,1138,1849754.38,1060690.64,2910445.02
352240,201708,2150,1281,869,1197347.29,813035.25,2010382.54
352250,201708,2551,1352,1199,1263889.6,1121170.6,2385060.2
352260,201708,1109,624,485,583461.32,454162.25,1037623.57
352265,201708,62,28,34,26236,31858,58094
352270,201708,389,223,166,208014.84,155487,363501.84
352280,201708,388,247,141,230047.97,131831.32,361879.29
352290,201708,174,109,65,101571,60905,162476
352300,201708,102,78,24,73086,22488,95574
352310,201708,5661,2788,2873,2601336.21,2687180.25,5288516.46
352320,201708,918,493,425,459349.99,396210.55,855560.54
352330,201708,528,227,301,212371.05,281756,494127.05
352340,201708,1389,686,703,639241.5,657633.75,1296875.25
352350,201708,318,200,118,187400,110285,297685
352360,201708,223,88,135,81565.85,124882,206447.85
352370,201708,104,70,34,65590,31858,97448
352380,201708,121,74,47,69338,44039,113377
352390,201708,2398,1093,1305,1019766.9,1220912.14,2240679.04
352400,201708,461,195,266,182012.25,248960.9,430973.15
352410,201708,737,527,210,489370.9,196489,685859.9
352420,201708,100,63,37,59031,34669,93700
352430,201708,1752,775,977,720273.55,913780.59,1634054.14
352440,201708,3013,1561,1452,1454764.14,1357673.4,2812437.54
352450,201708,186,157,29,147109,27173,174282
352460,201708,570,292,278,273056.54,259128.2,532184.74
352470,201708,573,195,378,182715,354177,536892
352480,201708,1360,759,601,709934.3,562574.9,1272509.2
352490,201708,82,32,50,29984,46850,76834
352500,201708,1209,542,667,506074.8,623846.1,1129920.9
352510,201708,734,396,338,370115.3,316706,686821.3
352520,201708,533,237,296,221985,277211.45,499196.45
352530,201708,1710,899,811,841426,758595.3,1600021.3
352540,201708,76,51,25,47787,23425,71212
352550,201708,187,107,80,100259,74304.1,174563.1
352560,201708,50,40,10,37480,9370,46850
352570,201708,650,343,307,320798,287659,608457
352580,201708,59,41,18,37480.33,16866,54346.33
352585,201708,14,5,9,4685,8433,13118
352590,201708,4231,2127,2104,1987533.3,1970563.11,3958096.41
352600,201708,355,248,107,231439.3,100250,331689.3
352610,201708,911,429,482,399286.51,451634,850920.51
352620,201708,970,385,585,359808.1,548145,907953.1
352630,201708,217,80,137,74960,127937.98,202897.98
352640,201708,544,384,160,357435.75,149920,507355.75
352650,201708,92,62,30,58094,28110,86204
352660,201708,82,49,33,45913,30921,76834
352670,201708,1634,889,745,829562.88,696713.98,1526276.86
352680,201708,888,567,321,527143.68,299528.2,826671.88
352690,201708,4261,1974,2287,1841015.5,2139121.87,3980137.37
352700,201708,112,63,49,59031,45913,104944
352710,201708,1306,688,618,642782.1,576536.6,1219318.7
352720,201708,1207,591,616,551269.1,577187.32,1128456.42
352725,201708,27,25,2,23425,1874,25299
352730,201708,365,181,184,168439.81,171846,340285.81
352740,201708,404,251,153,233267.04,143361,376628.04
352750,201708,24,16,8,14710.9,7496,22206.9
352760,201708,193,140,53,131180,49661,180841
352770,201708,82,65,17,60905,15929,76834
352780,201708,81,45,36,42165,33732,75897
352790,201708,27,23,4,21551,3748,25299
352800,201708,243,166,77,155542,71867.9,227409.9
352810,201708,162,106,56,96855.92,52472,149327.92
352820,201708,67,56,11,52054.1,10307,62361.1
352830,201708,87,61,26,57157,24362,81519
352840,201708,564,294,270,274214.1,252709,526923.1
352850,201708,1315,475,840,444419.1,787080,1231499.1
352860,201708,128,84,44,78708,41228,119936
352870,201708,38,24,14,22488,13118,35606
352880,201708,188,130,58,121791.26,54346,176137.26
352885,201708,30,21,9,19677,8433,28110
352890,201708,53,37,16,34669,14711,49380
352900,201708,4938,2393,2545,2225237.28,2377583.36,4602820.64
352910,201708,42,32,10,29984,9370,39354
352920,201708,713,438,275,409469,257675,667144
352930,201708,1238,603,635,563620.58,592099.88,1155720.46
352940,201708,6279,2717,3562,2534229.85,3333015.27,5867245.12
352950,201708,90,37,53,34669,49661,84330
352960,201708,70,44,26,41228,24362,65590
352965,201708,20,8,12,7496,11244,18740
352970,201708,461,344,117,317616.44,108693,426309.44
352980,201708,176,90,86,84330,80582,164912
352990,201708,890,420,470,390835.14,438638.9,829474.04
353000,201708,66,30,36,28110,33732,61842
353010,201708,555,345,210,323265,196751.27,520016.27
353020,201708,287,210,77,196770,72149,268919
353030,201708,1158,534,624,500039.63,584013.73,1084053.36
353040,201708,86,53,33,49661,30921,80582
353050,201708,1280,805,475,748540.55,444981.3,1193521.85
353060,201708,7543,3499,4044,3264984.6,3782465.17,7047449.77
353070,201708,1644,1026,618,954728.26,577799.04,1532527.30
353080,201708,1317,688,629,642349.39,589364.32,1231713.71
353090,201708,58,35,23,32795,21551,54346
353100,201708,61,50,11,46850,10307,57157
353110,201708,1859,594,1265,554877.63,1183610.32,1738487.95
353120,201708,71,36,35,33732,32795,66527
353130,201708,861,420,441,392584.63,413188.89,805773.52
353140,201708,592,228,364,213577,341068,554645
353150,201708,356,196,160,182715,149910.63,332625.63
353160,201708,104,85,19,79645,17803,97448
353170,201708,199,67,132,62769.63,123656.63,186426.26
353180,201708,948,436,512,407018.95,479229,886247.95
353190,201708,458,324,134,302549.95,125558,428107.95
353200,201708,181,90,91,84330,85267,169597
353205,201708,27,19,8,17803,7496,25299
353210,201708,82,51,31,47787,29047,76834
353215,201708,57,33,24,30921,22488,53409
353220,201708,83,47,36,44039,32795.93,76834.93
353230,201708,158,62,96,58094,89952,148046
353240,201708,276,151,125,141487,117125,258612
353250,201708,199,107,92,100259,86204,186463
353260,201708,421,309,112,288418.25,104934.63,393352.88
353270,201708,70,51,19,47787,17147.1,64934.1
353280,201708,92,46,46,42634,43102,85736
353282,201708,114,85,29,79645,27173,106818
353284,201708,25,20,5,18740,4685,23425
353286,201708,1,1,0,937,0,937
353290,201708,79,48,31,44976,29038,74014
353300,201708,398,220,178,204625.55,166786,371411.55
353310,201708,51,47,4,44039,3748,47787
353320,201708,58,38,20,35606,18740,54346
353325,201708,55,36,19,33732,17504,51236
353330,201708,69,53,16,49521,14992,64513
353340,201708,606,192,414,179904,387346.54,567250.54
353350,201708,904,425,479,397419.92,447579,844998.92
353360,201708,112,89,23,83080.7,21270,104350.7
353370,201708,119,68,51,62779.55,47787,110566.55
353380,201708,29,21,8,19673,7496,27169
353390,201708,1028,502,526,470374,492862,963236
353400,201708,48,28,20,26236,18740,44976
353410,201708,117,70,47,65590,43337.1,108927.1
353420,201708,56,24,32,22488,29984,52472
353430,201708,547,360,187,333665.08,174787.9,508452.98
353440,201708,10184,4449,5735,4157607.38,5366923.12,9524530.50
353450,201708,58,30,28,28110,26236,54346
353460,201708,600,321,279,296728.99,259775.25,556504.24
353470,201708,2119,1153,966,1075261.26,903706.82,1978968.08
353475,201708,235,157,78,144470.3,73086,217556.3
353480,201708,189,151,38,141487,35606,177093
353490,201708,229,138,91,129306,85267,214573
353500,201708,179,107,72,99041.3,67464,166505.3
353510,201708,102,73,29,68382.63,27163.63,95546.26
353520,201708,211,144,67,134928,62779,197707
353530,201708,450,244,206,228628,193022,421650
353540,201708,348,231,117,216130.02,109629,325759.02
353550,201708,724,491,233,456975.85,218321,675296.85
353560,201708,629,269,360,251116.6,337016.22,588132.82
353570,201708,60,32,28,29984,26236,56220
353580,201708,353,271,82,253459,76834,330293
353590,201708,79,53,26,49067.6,24362,73429.6
353600,201708,267,151,116,141175,108692,249867
353610,201708,113,59,54,55283,50598,105881
353620,201708,552,300,252,279148.25,235842.9,514991.15
353625,201708,53,27,26,25299,24362,49661
353630,201708,232,168,64,153163.07,59968,213131.07
353640,201708,122,83,39,76834.5,36543,113377.5
353650,201708,818,324,494,301526.6,462878,764404.6
353657,201708,21,15,6,14055,5622,19677
353660,201708,255,142,113,133054,105599.9,238653.9
353670,201708,713,434,279,405721.1,261423,667144.1
353680,201708,101,73,28,68401,26236,94637
353690,201708,46,36,10,33732,9370,43102
353700,201708,290,204,86,191148,80582,271730
353710,201708,405,188,217,175219.4,203329,378548.4
353715,201708,46,37,9,34387.9,8433,42820.9
353720,201708,365,168,197,157398,184569,341967
353730,201708,1129,697,432,650232.45,404502.9,1054735.35
353740,201708,633,357,276,334227.9,258612,592839.9
353750,201708,100,61,39,56634.62,36543,93177.62
353760,201708,2609,988,1621,923671.3,1515338.37,2439009.67
353770,201708,99,80,19,74491.5,17803,92294.5
353780,201708,1070,550,520,512727.3,486021.9,998749.2
353790,201708,504,289,215,268760.55,201335,470095.55
353800,201708,3225,1650,1575,1538193.46,1473370.17,3011563.63
353810,201708,239,133,106,123782.75,99295,223077.75
353820,201708,174,85,89,79645,82779.54,162424.54
353830,201708,49,42,7,39354,6559,45913
353850,201708,168,88,80,82456,74960,157416
353860,201708,461,204,257,189789.35,240527.9,430317.25
353870,201708,4905,2460,2445,2290861.2,2281004.33,4571865.53
353880,201708,663,471,192,439489.65,178967.36,618457.01
353890,201708,583,321,262,300215,245494,545709
353900,201708,138,65,73,60905,68401,129306
353910,201708,180,85,95,79645,89015,168660
353920,201708,450,244,206,227457.7,193008.64,420466.34
353930,201708,967,580,387,541329.44,361453.9,902783.34
353940,201708,186,102,84,94824.4,77865,172689.4
353950,201708,512,319,193,298893.63,180841,479734.63
353960,201708,68,54,14,50598,13118,63716
353970,201708,71,46,25,43102,23425,66527
353980,201708,1506,747,759,697332.59,711171,1408503.59
353990,201708,77,43,34,40291,31858,72149
354000,201708,369,172,197,160509,184397.6,344906.6
354010,201708,96,51,45,47787,41697,89484
354020,201708,537,337,200,314832,187305.11,502137.11
354025,201708,51,42,9,39354,8433,47787
354030,201708,63,33,30,30921,28110,59031
354040,201708,90,65,25,60623.9,23425,84048.9
354050,201708,181,104,77,97167,72149,169316
354060,201708,771,375,396,351375,369179.65,720554.65
354070,201708,879,507,372,472931.52,348564,821495.52
354075,201708,202,110,92,102977,85267.9,188244.9
354080,201708,288,128,160,119654.9,149920,269574.9
354085,201708,19,12,7,11244,6559,17803
354090,201708,317,176,141,164833,132117,296950
354100,201708,5398,2224,3174,2074050.17,2969714.87,5043765.04
354105,201708,80,41,39,38417,36543,74960
354110,201708,46,22,24,20614,22488,43102
354120,201708,144,100,44,93563.29,41228,134791.29
354130,201708,677,457,220,427975,205855,633830
354140,201708,3177,1492,1685,1394385.42,1577800.62,2972186.04
354150,201708,630,391,239,365149,222537.5,587686.5
354160,201708,676,421,255,393305.75,238654,631959.75
354165,201708,18,12,6,11244,5622,16866
354170,201708,168,115,53,107099.1,49661,156760.1
354180,201708,67,42,25,39034,23425,62459
354190,201708,201,92,109,84611.1,102133,186744.1
354200,201708,130,69,61,64185,57157,121342
354210,201708,72,34,38,31858,35606,67464
354220,201708,645,400,245,374144.1,228347.18,602491.28
354230,201708,158,65,93,60905,86204.8,147109.8
354240,201708,318,205,113,190867.69,105256.3,296123.99
354250,201708,90,53,37,49661,34669,84330
354260,201708,1876,869,1007,804761.82,941305,1746066.82
354270,201708,98,74,24,69338,22488,91826
354280,201708,32,17,15,15929,14055,29984
354290,201708,152,103,49,95246.55,45913,141159.55
354300,201708,417,286,131,267670,122747,390417
354310,201708,101,73,28,67464.1,26236,93700.1
354320,201708,183,96,87,89952,81519,171471
354323,201708,15,13,2,12181,1874,14055
354325,201708,115,67,48,61987,44976,106963
354330,201708,2492,856,1636,798175.94,1530803.69,2328979.63
354340,201708,10604,5143,5461,4804276.72,5111061.93,9915338.65
354350,201708,127,87,40,81519,37339.45,118858.45
354360,201708,87,48,39,44976,36543,81519
354370,201708,261,136,125,127432,117125,244557
354380,201708,209,121,88,112603,82456,195059
354390,201708,2735,993,1742,930132.5,1630803.94,2560936.44
354400,201708,324,168,156,156339.9,145609.9,301949.8
354410,201708,608,294,314,274537.32,293281.1,567818.42
354420,201708,260,165,95,154605,89015,243620
354425,201708,311,178,133,166786,124612,291398
354430,201708,194,123,71,112927.95,65777.4,178705.35
354440,201708,41,29,12,27173,11244,38417
354450,201708,47,32,15,29984,14055,44039
354460,201708,98,55,43,51535,40291,91826
354470,201708,38,27,11,25299,10307,35606
354480,201708,117,63,54,59022,50588.63,109610.63
354490,201708,144,90,54,84173.81,50598,134771.81
354500,201708,393,192,201,179904,188337,368241
354510,201708,107,72,35,67464,32795,100259
354515,201708,40,15,25,14055,23425,37480
354520,201708,1580,709,871,661173.6,815789.68,1476963.28
354530,201708,614,320,294,297493.5,274635.1,572128.6
354540,201708,274,153,121,143361,113372.32,256733.32
354550,201708,43,24,19,22488,17803,40291
354560,201708,159,93,66,87141,61832.63,148973.63
354570,201708,144,95,49,89015,45913,134928
354580,201708,1975,942,1033,879842,967626.54,1847468.54
354600,201708,275,148,127,136465.36,118994.32,255459.68
354610,201708,70,64,6,59968,5622,65590
354620,201708,65,18,47,16866,44039,60905
354625,201708,17,11,6,10307,5618,15925
354630,201708,322,212,110,198144.21,103070,301214.21
354640,201708,788,510,278,474014.5,260486,734500.5
354650,201708,73,39,34,36534,31821.26,68355.26
354660,201708,814,593,221,551691.55,207077,758768.55
354670,201708,289,104,185,96824,172409,269233
354680,201708,1228,462,766,432894,717274,1150168
354690,201708,87,60,27,54581.25,25299,79880.25
354700,201708,76,55,21,51535,19677,71212
354710,201708,54,37,17,34044.3,15929,49973.3
354720,201708,21,20,1,18740,937,19677
354730,201708,1922,809,1113,755401.5,1042693.6,1798095.1
354740,201708,56,40,16,37480,14992,52472
354750,201708,427,254,173,237989,162101,400090
354760,201708,513,314,199,291900,185901,477801
354765,201708,11,5,6,4685,5622,10307
354770,201708,322,225,97,209734.71,90889,300623.71
354780,201708,8093,3301,4792,3080271.68,4485394.92,7565666.60
354790,201708,116,68,48,63716,44976,108692
354800,201708,402,224,178,209888,166505,376393
354805,201708,105,54,51,49974,47787,97761
354810,201708,136,79,57,73741.9,53409,127150.9
354820,201708,179,78,101,72880,94637,167517
354830,201708,39,23,16,21551,14992,36543
354840,201708,53,35,18,32795,16866,49661
354850,201708,4555,2028,2527,1892587.7,2363294.03,4255881.73
354860,201708,333,163,170,152731,157229.3,309960.3
354870,201708,11551,5241,6310,4885855.88,5903809.63,10789665.51
354880,201708,2946,1107,1839,1035088.55,1721294.96,2756383.51
354890,201708,2813,1558,1255,1454894.29,1174801.64,2629695.93
354900,201708,61,40,21,37480,19677,57157
354910,201708,1181,624,557,581840.22,521909,1103749.22
354920,201708,52,44,8,41228,7496,48724
354925,201708,11,6,5,5622,4685,10307
354930,201708,30,27,3,25033,2811,27844
354940,201708,804,590,214,550912.09,200518,751430.09
354950,201708,225,149,76,139011,71212,210223
354960,201708,170,66,104,61842,97167,159009
354970,201708,826,536,290,497428.39,271102.31,768530.70
354980,201708,8275,3102,5173,2900410.71,4844997.72,7745408.43
354990,201708,9091,4295,4796,4016153.7,4487650.77,8503804.47
354995,201708,518,182,336,170534,314232.32,484766.32
355000,201708,453,147,306,137734.32,285661,423395.32
355010,201708,625,400,225,374800,208652.36,583452.36
355020,201708,717,446,271,416960.9,253919,670879.9
355030,201708,201311,77885,123426,72770752.39,115548111.5,188318863.89
355040,201708,709,343,366,321110,342754.6,663864.6
355050,201708,155,103,52,95262.77,48724,143986.77
355060,201708,1370,701,669,652076.97,625026.25,1277103.22
355070,201708,1452,713,739,665257.44,691467,1356724.44
355080,201708,202,117,85,109421.74,78773.9,188195.64
355090,201708,288,195,93,180655,87141,267796
355100,201708,4738,2373,2365,2205786.12,2213607.07,4419393.19
355110,201708,292,191,101,177234.55,94637,271871.55
355120,201708,115,84,31,78239.5,29047,107286.5
355130,201708,50,26,24,24362,22488,46850
355140,201708,180,119,61,111503,57157,168660
355150,201708,674,406,268,379200.1,250647.5,629847.6
355160,201708,433,200,233,184776.8,218321,403097.8
355170,201708,2019,1050,969,982492.87,907653.28,1890146.15
355180,201708,620,263,357,245494,333408.02,578902.02
355190,201708,216,147,69,137739,64653,202392
355200,201708,116,67,49,62779,45913,108692
355210,201708,683,395,288,370115,269828.63,639943.63
355220,201708,6405,3459,2946,3231397.6,2752277.27,5983674.87
355230,201708,110,67,43,62779,40286.32,103065.32
355240,201708,4100,1805,2295,1679063.47,2146412.38,3825475.85
355250,201708,5250,2589,2661,2418399.61,2490209.6,4908609.21
355255,201708,51,30,21,28110,19677,47787
355260,201708,189,113,76,104925.36,71194,176119.36
355270,201708,165,98,67,91826,62077,153903
355280,201708,6138,2615,3523,2445403.75,3296476.07,5741879.82
355290,201708,79,60,19,56220,17803,74023
355300,201708,178,119,59,111503,55283,166786
355310,201708,104,58,46,54346,43102,97448
355320,201708,94,47,47,43757.9,43343.3,87101.2
355330,201708,269,147,122,137739,114314,252053
355340,201708,1333,532,801,496610.68,749808.2,1246418.88
355350,201708,138,69,69,64653,64653,129306
355360,201708,173,105,68,98178.86,63716,161894.86
355365,201708,26,21,5,19677,4685,24362
355370,201708,1026,576,450,534884.59,419896.91,954781.50
355380,201708,762,512,250,478344.8,233969,712313.8
355385,201708,51,35,16,32795,14992,47787
355390,201708,104,60,44,56220,41228,97448
355395,201708,189,117,72,108828.32,67464,176292.32
355400,201708,1513,940,573,876852.98,536338.9,1413191.88
355410,201708,4796,2247,2549,2088075.95,2379071.32,4467147.27
355420,201708,45,34,11,31858,10307,42165
355430,201708,339,211,128,197051.1,119936,316987.1
355440,201708,75,43,32,40291,29984,70275
355450,201708,417,196,221,179484.67,205765.3,385249.97
355460,201708,70,54,16,49661.51,14992,64653.51
355465,201708,50,32,18,29984,16866,46850
355470,201708,189,74,115,68401.55,107755,176156.55
355475,201708,11,7,4,6559,3748,10307
355480,201708,443,189,254,175969,236583.13,412552.13
355490,201708,114,83,31,77771,29047,106818
355495,201708,52,26,26,24362,24362,48724
355500,201708,1705,972,733,906255.14,686501.64,1592756.78
355510,201708,266,194,72,178381.5,67464,245845.5
355520,201708,37,29,8,27173,7496,34669
355530,201708,21,14,7,13118,6559,19677
355535,201708,76,36,40,33732,37480,71212
355540,201708,2302,925,1377,865292.42,1288076.63,2153369.05
355550,201708,66,40,26,37480,24362,61842
355560,201708,235,119,116,111503,108067.3,219570.3
355570,201708,29,18,11,16866,10307,27173
355580,201708,268,183,85,171471,79640.32,251111.32
355590,201708,24,15,9,14055,8433,22488
355600,201708,273,142,131,133054,122461.32,255515.32
355610,201708,207,134,73,125558,68401,193959
355620,201708,1230,561,669,523923.9,626286.8,1150210.7
355630,201708,406,285,121,266109,113377,379486
355635,201708,128,60,68,56220,63703,119923
355640,201708,571,335,236,312958,221132,534090
355645,201708,829,359,470,334721.64,438544.21,773265.85
355650,201708,2000,897,1103,838213.4,1033258.63,1871472.03
355660,201708,263,139,124,130243,116183.32,246426.32
355670,201708,463,169,294,158353,275478,433831
355680,201708,213,120,93,112440,86579,199019
355690,201708,83,40,43,37480,39953,77433
355695,201708,13,11,2,10307,1874,12181
355700,201708,1132,586,546,543756.61,511321,1055077.61
355710,201708,2183,1194,989,1114235.68,926101.9,2040337.58
355715,201708,20,18,2,16866,1874,18740
355720,201708,201,121,80,111815.66,74956,186771.66
355730,201708,89,52,37,47865.53,34669,82534.53
410010,201708,128,108,20,101196,18740,119936
410020,201708,103,92,11,86204,10307,96511
410030,201708,160,100,60,93044.2,56220,149264.2
410040,201708,974,522,452,488598.65,423337,911935.65
410045,201708,34,29,5,27173,4685,31858
410050,201708,469,262,207,245474,193771.6,439245.6
410060,201708,263,204,59,190867,55283,246150
410070,201708,317,258,59,241746,55283,297029
410080,201708,165,109,56,102133,52472,154605
410090,201708,77,68,9,63510,8433,71943
410100,201708,294,208,86,194896,79879.25,274775.25
410105,201708,42,25,17,23425,15929,39354
410110,201708,307,186,121,174282,113377,287659
410115,201708,27,18,9,16866,8433,25299
410120,201708,449,226,223,211465.9,208951,420416.9
410130,201708,39,26,13,24362,12181,36543
410140,201708,3014,1484,1530,1385640.63,1433319.63,2818960.26
410150,201708,2676,1078,1598,1009233.75,1496552.5,2505786.25
410160,201708,502,321,181,300495.9,169597,470092.9
410165,201708,64,41,23,38417,21551,59968
410170,201708,164,124,40,113992.83,37480,151472.83
410180,201708,2099,1210,889,1129572.59,831655.08,1961227.67
410185,201708,45,41,4,38417,3748,42165
410190,201708,406,251,155,235187,145235,380422
410200,201708,968,728,240,680374.88,224598.9,904973.78
410210,201708,550,282,268,264234,250554,514788
410220,201708,39,21,18,19677,16866,36543
410230,201708,121,70,51,65590,47787,113377
410240,201708,724,481,243,450134.9,227691,677825.9
410250,201708,385,283,102,264577.6,95553.89,360131.49
410260,201708,316,169,147,158353,137739,296092
410270,201708,29,19,10,17803,9370,27173
410275,201708,73,55,18,51535,16866,68401
410280,201708,309,172,137,160909.14,128369,289278.14
410290,201708,221,147,74,136896.03,68895.91,205791.94
410300,201708,83,65,18,60905,16866,77771
410302,201708,24,16,8,14992,7496,22488
410304,201708,49,33,16,30921,14992,45913
410305,201708,192,104,88,96656,82456,179112
410310,201708,257,167,90,156479,84330,240809
410315,201708,58,42,16,39330,14992,54322
410320,201708,141,98,43,91826,40291,132117
410322,201708,34,23,11,21551,10307,31858
410330,201708,166,118,48,110566,44976,155542
410335,201708,95,59,36,55283,33732,89015
410337,201708,37,32,5,29984,4685,34669
410340,201708,32,31,1,29047,937,29984
410345,201708,205,130,75,121810,70275,192085
410347,201708,52,41,11,38417,10307,48724
410350,201708,231,141,90,132117,84330,216447
410360,201708,457,275,182,254896.2,170253,425149.2
410370,201708,2313,959,1354,895707.46,1265682.11,2161389.57
410380,201708,221,145,76,135865,71212,207077
410390,201708,362,270,92,252986,86204,339190
410395,201708,35,23,12,21551,10870,32421
410400,201708,822,415,407,387549.1,380830,768379.1
410405,201708,89,65,24,60905,22488,83393
410410,201708,43,33,10,30921,9370,40291
410420,201708,1618,802,816,749701.6,763031.3,1512732.9
410425,201708,173,83,90,77584,84330,161914
410430,201708,2179,1275,904,1192238.9,844818.16,2037057.06
410440,201708,399,286,113,267046,105881,372927
410442,201708,368,244,124,227692,116188,343880
410445,201708,418,288,130,269856,121810,391666
410450,201708,394,194,200,181778,187400,369178
410460,201708,400,215,185,201173.9,173345,374518.9
410465,201708,194,126,68,116562.8,63716,180278.8
410470,201708,213,132,81,123684,75897,199581
410480,201708,5595,2783,2812,2592018.4,2630256.99,5222275.39
410490,201708,1354,901,453,843067,422588,1265655
410500,201708,261,150,111,140550,104007,244557
410510,201708,177,126,51,118062,47153.3,165215.3
410520,201708,269,199,70,186463,65590,252053
410530,201708,233,86,147,80582,137735,218317
410540,201708,317,228,89,213065.8,83388.32,296454.12
410550,201708,1571,685,886,641563.9,829690.26,1471254.16
410560,201708,145,109,36,102133,33732,135865
410570,201708,433,304,129,282797.05,120873,403670.05
410580,201708,3158,1422,1736,1329892.36,1625227,2955119.36
410590,201708,393,281,112,263297,104944,368241
410600,201708,173,152,21,142424,19677,162101
410610,201708,53,43,10,40291,9370,49661
410620,201708,230,167,63,156479,59031,215510
410630,201708,450,265,185,248285,172206,420491
410640,201708,936,568,368,528836.49,343237.85,872074.34
410645,201708,98,72,26,67070,24362,91432
410650,201708,359,243,116,226754,108692,335446
410655,201708,79,61,18,57157,16866,74023
410657,201708,43,18,25,16866,23425,40291
410660,201708,573,410,163,382668,152731,535399
410670,201708,77,62,15,58094,14055,72149
410680,201708,190,155,35,145235,31858.4,177093.4
410685,201708,20,13,7,12181,6559,18740
410690,201708,28480,12321,16159,11528762.39,15130003.07,26658765.46
410700,201708,312,229,83,214011,77771,291782
410710,201708,131,106,25,99322,23425,122747
410712,201708,21,13,8,12181,7496,19677
410715,201708,84,65,19,60905,17803,78708
410720,201708,580,353,227,330761,212409,543170
410725,201708,175,126,49,118062,45913,163975
410730,201708,90,56,34,52472,31858,84330
410740,201708,112,83,29,77771,27173,104944
410750,201708,215,161,54,150853,50593.32,201446.32
410752,201708,21,14,7,13118,6559,19677
410753,201708,51,22,29,19953.41,27173,47126.41
410754,201708,35,21,14,19677,13118,32795
410755,201708,82,56,26,52190.9,24362,76552.9
410760,201708,696,399,297,373863,277821,651684
410765,201708,1610,773,837,718207.94,783416.63,1501624.57
410770,201708,110,93,17,87141,15929,103070
410773,201708,46,34,12,31858,11244,43102
410775,201708,174,130,44,121154.1,41228,162382.1
410780,201708,82,44,38,41228,35606,76834
410785,201708,73,56,17,52285,15929,68214
410790,201708,67,32,35,29984,32795,62779
410800,201708,293,186,107,173346,100259,273605
410810,201708,31,26,5,24362,4404,28766
410820,201708,179,133,46,124481,43102,167583
410830,201708,8484,3882,4602,3629591.49,4309981.64,7939573.13
410832,201708,107,76,31,70930.9,29047,99977.9
410840,201708,1372,756,616,706147.99,576790.67,1282938.66
410845,201708,62,39,23,36543,21551,58094
410850,201708,192,132,60,123363,56220,179583
410855,201708,44,38,6,35606,5622,41228
410860,201708,668,387,281,361847.75,263297,625144.75
410865,201708,111,85,26,79645,24362,104007
410870,201708,149,130,19,121810,17516,139326
410880,201708,1079,537,542,502854.05,507800,1010654.05
410890,201708,77,59,18,55283,16866,72149
410895,201708,74,54,20,50598,18740,69338
410900,201708,28,21,7,19677,6559,26236
410910,201708,22,19,3,17803,2811,20614
410920,201708,36,24,12,22488,11244,33732
410930,201708,507,324,183,303380.74,171189.9,474570.64
410940,201708,4285,2564,1721,2394058.67,1609274.7,4003333.37
410950,201708,122,87,35,81519,32795,114314
410960,201708,751,335,416,313614,389792,703406
410965,201708,63,49,14,45913,13118,59031
410970,201708,609,433,176,405265.1,164912,570177.1
410975,201708,108,72,36,67103,33732,100835
410980,201708,1519,690,829,643748.21,776483.22,1420231.43
410990,201708,261,177,84,165683.25,78426.9,244110.15
411000,201708,61,42,19,39354,17803,57157
411005,201708,22,16,6,14992,5622,20614
411007,201708,236,136,100,127432,93700,221132
411010,201708,566,400,166,374575,155542,530117
411020,201708,285,194,91,181778,85267,267045
411030,201708,28,17,11,15929,10307,26236
411040,201708,49,34,15,31858,14055,45913
411050,201708,220,175,45,162568.17,42038.12,204606.29
411060,201708,509,349,160,327004,149920,476924
411065,201708,59,52,7,48724,6559,55283
411070,201708,1168,789,379,735358,355123,1090481
411080,201708,239,170,69,159373,63866.66,223239.66
411090,201708,113,83,30,77771,28110,105881
411095,201708,256,105,151,97917,141477,239394
411100,201708,114,96,18,89952,16866,106818
411110,201708,124,85,39,79645,36543,116188
411120,201708,175,131,44,122747,41228,163975
411125,201708,171,77,94,71493.1,88078,159571.1
411130,201708,117,99,18,92137,16866,109003
411140,201708,170,117,53,109326.02,49145.65,158471.67
411150,201708,1169,775,394,726165.63,369178,1095343.63
411155,201708,118,81,37,75897,34669,110566
411160,201708,21,10,11,9370,10307,19677
411170,201708,62,54,8,50316.9,7496,57812.9
411180,201708,912,600,312,560982,292339.32,853321.32
411190,201708,315,176,139,164256.1,130243,294499.1
411200,201708,665,443,222,413842.09,207404.95,621247.04
411210,201708,666,355,311,331112.83,291407,622519.83
411220,201708,146,112,34,104944,31858,136802
411230,201708,50,44,6,41228,5622,46850
411240,201708,124,85,39,79645,36543,116188
411250,201708,418,303,115,283911,107755,391666
411260,201708,22,15,7,14055,6559,20614
411270,201708,287,158,129,148046,120873,268919
411275,201708,201,176,25,164772,23425,188197
411280,201708,230,162,68,150545.36,63716,214261.36
411290,201708,57,41,16,38417,14992,53409
411295,201708,141,111,30,104007,28110,132117
411300,201708,81,43,38,40291,35606,75897
411310,201708,91,69,22,64653,20614,85267
411320,201708,740,541,199,505559.8,184889.24,690449.04
411325,201708,45,28,17,26236,15929,42165
411330,201708,878,559,319,522311.24,298059.8,820371.04
411340,201708,30,21,9,19677,8124,27801
411342,201708,84,61,23,57157,21551,78708
411345,201708,119,60,59,56220,55283,111503
411350,201708,476,383,93,357887.92,86194.73,444082.65
411360,201708,54,33,21,30921,19677,50598
411370,201708,13832,5684,8148,5309659.99,7620836.25,12930496.24
411373,201708,192,141,51,132117,47787,179904
411375,201708,81,68,13,63716,12181,75897
411380,201708,99,72,27,67464,25299,92763
411390,201708,139,91,48,85267,44976,130243
411400,201708,342,253,89,237052,83393,320445
411410,201708,443,226,217,211106.1,203048,414154.1
411420,201708,1027,471,556,439078.2,520503.6,959581.8
411430,201708,404,260,144,242964.1,134638,377602.1
411435,201708,40,29,11,27173,10307,37480
411440,201708,468,375,93,349751.37,87141,436892.37
411450,201708,432,356,76,333572,71212,404784
411460,201708,707,281,426,262328.2,397860.96,660189.16
411470,201708,122,90,32,84330,29984,114314
411480,201708,618,352,266,328325.8,248960.9,577286.7
411490,201708,292,182,110,170534,103070,273604
411500,201708,107,92,15,86204,13681,99885
411510,201708,217,175,42,163240.39,39354,202594.39
411520,201708,5873,2290,3583,2142186.34,3349459.61,5491645.95
411530,201708,112,74,38,69338,35606,104944
411535,201708,52,20,32,18740,29984,48724
411540,201708,317,217,100,202509.6,93700,296209.6
411545,201708,76,53,23,49661,21551,71212
411550,201708,70,56,14,52472,13118,65590
411560,201708,371,166,205,154914.21,192085,346999.21
411570,201708,775,292,483,273323,452384,725707
411573,201708,39,24,15,22488,14055,36543
411575,201708,258,158,100,148046,93700,241746
411580,201708,1206,481,725,450041.1,677397,1127438.1
411585,201708,76,38,38,35606,35606,71212
411590,201708,26,18,8,16866,7496,24362
411600,201708,38,18,20,16866,18740,35606
411605,201708,234,108,126,101036,118062,219098
411610,201708,241,162,79,151794,74023,225817
411620,201708,349,196,153,183464.6,143361,326825.6
411630,201708,56,37,19,34669,17803,52472
411640,201708,41,33,8,30921,7496,38417
411650,201708,14,10,4,9370,3748,13118
411660,201708,41,35,6,32795,5622,38417
411670,201708,247,188,59,176156,55263,231419
411680,201708,158,135,23,126495,21551,148046
411690,201708,594,324,270,302992.08,252607.6,555599.68
411695,201708,63,49,14,45913,13118,59031
411700,201708,172,147,25,137739,23425,161164
411705,201708,103,66,37,61842,34669,96511
411710,201708,296,194,102,180811.86,95574,276385.86
411720,201708,132,86,46,80582,43102,123684
411721,201708,76,64,12,59968,11244,71212
411722,201708,98,42,56,39354,52472,91826
411725,201708,142,109,33,101852,30921,132773
411727,201708,85,70,15,65590,13773.9,79363.9
411729,201708,35,26,9,24362,8433,32795
411730,201708,545,352,193,328262.3,180841,509103.3
411740,201708,28,21,7,19677,6559,26236
411745,201708,68,47,21,43262,19677,62939
411750,201708,830,402,428,375316.9,400356.68,775673.58
411760,201708,1179,892,287,834296.04,268910,1103206.04
411770,201708,420,287,133,268919,124621,393540
411780,201708,363,237,126,222069,118062,340131
411790,201708,520,285,235,266123.17,220083.67,486206.84
411800,201708,168,133,35,124621,32795,157416
411810,201708,154,119,35,111503,32795,144298
411820,201708,2082,1022,1060,955346.56,992817.86,1948164.42
411830,201708,10,10,0,9370,0,9370
411840,201708,1931,1192,739,1116228.6,691673.9,1807902.5
411845,201708,48,17,31,15929,29047,44976
411850,201708,1231,713,518,665635.74,483447.81,1149083.55
411860,201708,43,28,15,25955,14055,40010
411870,201708,33,26,7,24362,6559,30921
411880,201708,417,272,145,254610,135134.14,389744.14
411885,201708,105,68,37,63716,34669,98385
411890,201708,321,200,121,187400,113368,300768
411900,201708,73,54,19,50598,17803,68401
411910,201708,168,139,29,130233.63,26348.44,156582.07
411915,201708,2017,874,1143,817806.11,1070220.93,1888027.04
411920,201708,119,100,19,93700,17803,111503
411925,201708,19,12,7,11244,6559,17803
411930,201708,788,582,206,543462,193022,736484
411940,201708,586,418,168,391666,157391.56,549057.56
411950,201708,873,466,407,436632.63,381046.7,817679.33
411960,201708,947,676,271,631049.76,253927,884976.76
411965,201708,27,19,8,17803,7496,25299
411970,201708,69,62,7,58094,6559,64653
411980,201708,198,128,70,119936,65590,185526
411990,201708,4759,2802,1957,2608993.08,1831967.4,4440960.48
411995,201708,447,169,278,158353,260486,418839
412000,201708,274,157,117,146407.56,109629,256036.56
412010,201708,44,26,18,24362,16866,41228
412015,201708,43,32,11,29984,10307,40291
412020,201708,28,25,3,23143.9,2811,25954.9
412030,201708,64,54,10,50598,9370,59968
412033,201708,53,36,17,33708,15929,49637
412035,201708,87,55,32,51535,29984,81519
412040,201708,34,24,10,22207,9370,31577
412050,201708,201,149,52,139613,48724,188337
412060,201708,744,584,160,544397.88,148951.9,693349.78
412065,201708,44,31,13,29047,12181,41228
412070,201708,154,106,48,98666.1,44976,143642.1
412080,201708,266,136,130,127432,121810,249242
412085,201708,30,13,17,12181,15929,28110
412090,201708,725,451,274,420667.1,256738,677405.1
412100,201708,240,199,41,185527,38229.6,223756.6
412110,201708,75,62,13,58094,12181,70275
412120,201708,308,199,109,185900.8,102133,288033.8
412125,201708,78,46,32,42820.9,29984,72804.9
412130,201708,54,37,17,34669,15929,50598
412135,201708,26,14,12,13118,11244,24362
412140,201708,292,214,78,200518,73086,273604
412150,201708,256,172,84,160227.62,78708,238935.62
412160,201708,98,61,37,57157,34669,91826
412170,201708,622,447,175,418839,163975,582814
412175,201708,49,36,13,33732,12181,45913
412180,201708,194,155,39,144646.29,36543,181189.29
412190,201708,329,266,63,248581.41,59031,307612.41
412200,201708,191,124,67,116188,62779,178967
412210,201708,96,76,20,71212,18740,89952
412215,201708,235,161,74,150857,69338,220195
412217,201708,88,69,19,64653,17803,82456
412220,201708,806,607,199,568759,186463,755222
412230,201708,331,208,123,192701.67,114891.75,307593.42
412240,201708,1306,630,676,586409.23,631236.26,1217645.49
412250,201708,381,245,136,229565,127151,356716
412260,201708,128,94,34,88078,31858,119936
412265,201708,161,129,32,120873,29984,150857
412270,201708,84,49,35,45913,32795,78708
412280,201708,86,68,18,63716,16866,80582
412290,201708,96,64,32,59968,29984,89952
412300,201708,220,145,75,135865,70275,206140
412310,201708,43,36,7,33732,6559,40291
412320,201708,96,81,15,75897,14055,89952
412330,201708,161,142,19,133054,17803,150857
412340,201708,141,96,45,89952,41884,131836
412350,201708,585,284,301,265124.15,282037,547161.15
412360,201708,27,24,3,22488,2811,25299
412370,201708,165,138,27,128369,25299,153668
412380,201708,256,188,68,175874.9,63191.65,239066.55
412382,201708,53,27,26,25299,24362,49661
412385,201708,135,96,39,89952,36543,126495
412390,201708,267,197,70,184589,65590,250179
412395,201708,64,51,13,47787,12181,59968
412400,201708,67,48,19,44976,17803,62779
412402,201708,239,111,128,104002.32,119654.9,223657.22
412405,201708,796,318,478,296535.01,447221.24,743756.25
412410,201708,924,574,350,536339,327950,864289
412420,201708,19,14,5,13118,4685,17803
412430,201708,20,15,5,14055,4685,18740
412440,201708,579,314,265,291261.87,246349.96,537611.83
412450,201708,86,71,15,66527,14055,80582
412460,201708,78,62,16,58094,14992,73086
412470,201708,259,207,52,193959,48724,242683
412480,201708,176,133,43,123403.5,40291,163694.5
412490,201708,163,139,24,130243,22488,152731
412500,201708,477,385,92,359482,86204,445686
412510,201708,190,154,36,143736,33732,177468
412520,201708,128,71,57,66527,53409,119936
412530,201708,107,58,49,54346,45631.9,99977.9
412535,201708,109,83,26,77753,24353,102106
412540,201708,66,30,36,28110,33732,61842
412545,201708,98,72,26,67464,24362,91826
412550,201708,3420,1562,1858,1460214.57,1739728.45,3199943.02
412555,201708,17,12,5,11244,4685,15929
412560,201708,573,429,144,400662.1,134928,535590.1
412570,201708,737,413,324,386381.32,303307,689688.32
412575,201708,87,61,26,57157,24362,81519
412580,201708,151,105,46,98385,43102,141487
412590,201708,34,31,3,29047,2811,31858
412600,201708,175,135,40,126495,37480,163975
412610,201708,33,21,12,19677,10439,30116
412620,201708,149,131,18,122747,16866,139613
412625,201708,2150,1151,999,1076437.76,934499.72,2010937.48
412627,201708,66,54,12,50598,11244,61842
412630,201708,431,289,142,270602,133054,403656
412635,201708,62,20,42,18740,39354,58094
412640,201708,119,79,40,74023,37480,111503
412650,201708,333,212,121,198644,113372.32,312016.32
412660,201708,486,289,197,270091,184589,454680
412665,201708,53,47,6,44039,5622,49661
412667,201708,318,208,110,194291.6,102706.04,296997.64
412670,201708,65,55,10,51535,9370,60905
412680,201708,282,226,56,211762,52472,264234
412690,201708,112,73,39,68401,36262,104663
412700,201708,166,114,52,106818,48443,155261
412710,201708,1401,872,529,811443.8,492956.87,1304400.67
412720,201708,226,152,74,142424,69338,211762
412730,201708,203,158,45,148046,41228,189274
412740,201708,404,219,185,205062.45,173345,378407.45
412750,201708,457,261,196,243620,183652,427272
412760,201708,238,121,117,113377,109629,223006
412770,201708,2007,1155,852,1077929.86,798016,1875945.86
412780,201708,151,119,32,111370.88,29984,141354.88
412785,201708,260,131,129,122278.5,120873,243151.5
412788,201708,37,22,15,20614,14055,34669
412790,201708,136,111,25,103351.1,23425,126776.1
412795,201708,159,119,40,111503,37480,148983
412796,201708,299,204,95,190004.83,88883.82,278888.65
412800,201708,550,361,189,337707.36,177084,514791.36
412810,201708,2936,1632,1304,1525604.69,1220344.12,2745948.81
412820,201708,927,610,317,558763.89,293510.21,852274.10
412830,201708,18,14,4,13118,3748,16866
412840,201708,210,152,58,141487.1,54346,195833.1
412850,201708,769,530,239,494736,223943,718679
412853,201708,178,98,80,91826,74960,166786
412855,201708,220,119,101,110297.21,94637,204934.21
412860,201708,90,69,21,64653,19677,84330
412862,201708,65,48,17,44694.9,15929,60623.9
412863,201708,8,7,1,6559,937,7496
412865,201708,45,34,11,31858,10307,42165
412870,201708,108,69,39,64653,36543,101196
412880,201708,128,100,28,93700,26236,119936
420005,201708,37,34,3,31858,2249,34107
420010,201708,366,243,123,226263.67,115242,341505.67
420020,201708,75,63,12,59031,11244,70275
420030,201708,28,25,3,23425,2811,26236
420040,201708,109,83,26,77771,24362,102133
420050,201708,56,33,23,30559.9,21390.34,51950.24
420055,201708,19,18,1,16866,937,17803
420060,201708,36,28,8,26236,7496,33732
420070,201708,96,83,13,77771,12171.63,89942.63
420075,201708,12,10,2,9370,1874,11244
420080,201708,45,40,5,36589.85,4685,41274.85
420090,201708,35,33,2,30157.34,1874,32031.34
420100,201708,153,129,24,119936.1,22488,142424.1
420110,201708,16,16,0,14992,0,14992
420120,201708,44,32,12,29984,11244,41228
420125,201708,85,68,17,63716,15929,79645
420127,201708,32,29,3,27173,2811,29984
420130,201708,359,228,131,213345.63,122737.63,336083.26
420140,201708,1208,706,502,660397.89,470310,1130707.89
420150,201708,46,39,7,36543,6559,43102
420160,201708,43,40,3,37480,2811,40291
420165,201708,16,12,4,11244,3748,14992
420170,201708,63,40,23,37480,21551,59031
420180,201708,23,22,1,20614,937,21551
420190,201708,32,29,3,27173,2811,29984
420195,201708,123,57,66,53409,61561,114970
420200,201708,1258,559,699,518165.1,654318.89,1172483.99
420205,201708,65,31,34,29047,31858,60905
420207,201708,97,56,41,52472,38407.63,90879.63
420208,201708,24,19,5,17803,3841.7,21644.7
420209,201708,19,15,4,14055,3748,17803
420210,201708,457,215,242,201173.9,226660.67,427834.57
420213,201708,49,38,11,35606,10307,45913
420215,201708,25,21,4,19677,3748,23425
420220,201708,70,47,23,44039,21551,65590
420230,201708,713,406,307,379673,287368.63,667041.63
420240,201708,2241,1524,717,1418965.56,671397.98,2090363.54
420243,201708,34,27,7,25299,6559,31858
420245,201708,85,49,36,45913,33732,79645
420250,201708,52,30,22,28110,20614,48724
420253,201708,40,34,6,31858,5622,37480
420257,201708,11,9,2,8433,1874,10307
420260,201708,93,82,11,76834,10307,87141
420270,201708,38,30,8,28105.32,7496,35601.32
420280,201708,272,199,73,185454.08,67165.82,252619.90
420285,201708,19,12,7,11244,6559,17803
420287,201708,48,29,19,27173,17803,44976
420290,201708,952,669,283,625869.39,265104.2,890973.59
420300,201708,1347,1057,290,986757.2,270793.77,1257550.97
420310,201708,57,43,14,40291,13118,53409
420315,201708,37,33,4,30921,3748,34669
420320,201708,833,422,411,394453.58,385103,779556.58
420325,201708,0,0,0,0,0,0
420330,201708,121,83,38,77771,35493.56,113264.56
420340,201708,159,108,51,100251,47758.89,148009.89
420350,201708,237,174,63,161727.1,59031,220758.1
420360,201708,730,554,176,517441.23,163329.09,680770.32
420370,201708,101,68,33,63529,30640,94169
420380,201708,1116,795,321,741159.76,299664.29,1040824.05
420390,201708,251,158,93,146810.06,85501.25,232311.31
420395,201708,174,125,49,117125,45903.63,163028.63
420400,201708,249,184,65,171681,60905,232586
420410,201708,59,46,13,43102,12181,55283
420415,201708,32,29,3,27173,2811,29984
420417,201708,44,33,11,30921,10307,41228
420419,201708,12,11,1,10307,937,11244
420420,201708,2748,1677,1071,1560911.68,1000696.74,2561608.42
420425,201708,67,57,10,53400,9061.16,62461.16
420430,201708,1268,875,393,816937.16,366517.79,1183454.95
420435,201708,16,14,2,13118,1874,14992
420440,201708,105,71,34,65887.96,31685.6,97573.56
420445,201708,22,20,2,18740,1874,20614
420450,201708,77,36,41,33703,38417,72120
420455,201708,236,185,51,173317.26,47723.63,221040.89
420460,201708,2285,1541,744,1438876.41,696634.82,2135511.23
420470,201708,123,89,34,83393,31858,115251
420475,201708,6,6,0,5622,0,5622
420480,201708,839,624,215,580266.36,200518.1,780784.46
420490,201708,112,87,25,81519,23425,104944
420500,201708,780,283,497,263517.1,465689,729206.1
420510,201708,20,17,3,15929,2811,18740
420515,201708,23,19,4,17803,3748,21551
420517,201708,9,9,0,8433,0,8433
420519,201708,0,0,0,0,0,0
420520,201708,69,52,17,48724,15929,64653
420530,201708,155,106,49,98176.95,45913,144089.95
420535,201708,19,17,2,15929,1874,17803
420540,201708,4420,2633,1787,2456696.95,1669893.69,4126590.64
420543,201708,21,21,0,19677,0,19677
420545,201708,185,132,53,123684,49642.26,173326.26
420550,201708,822,655,167,612189.89,156322.75,768512.64
420555,201708,41,31,10,29047,9370,38417
420560,201708,62,48,14,44601.2,13118,57719.2
420570,201708,130,75,55,69712.8,51525.63,121238.43
420580,201708,295,128,167,119936,156198,276134
420590,201708,498,354,144,331172.87,134928,466100.87
420600,201708,94,45,49,42165,45913,88078
420610,201708,35,33,2,30640,1874,32514
420620,201708,72,59,13,55283,12181,67464
420630,201708,149,106,43,99313.32,40287,139600.32
420640,201708,97,86,11,80582,10307,90889
420650,201708,239,130,109,121113.99,101525.26,222639.25
420660,201708,59,43,16,39541.9,14992,54533.9
420665,201708,38,29,9,27173,8433,35606
420670,201708,306,233,73,218311.63,68101.53,286413.16
420675,201708,15,15,0,14055,0,14055
420680,201708,34,25,9,23425,8433,31858
420690,201708,175,147,28,137739,26236,163975
420700,201708,591,414,177,387835.15,165627.82,553462.97
420710,201708,146,85,61,79645,57157,136802
420720,201708,101,83,18,77771,16866,94637
420730,201708,484,309,175,289450.15,162693.49,452143.64
420740,201708,44,43,1,40291,937,41228
420750,201708,484,319,165,298601.79,154605,453206.79
420757,201708,17,14,3,12321.55,2811,15132.55
420760,201708,37,29,8,27173,7496,34669
420765,201708,67,56,11,52472,10307,62779
420768,201708,66,59,7,55283,6559,61842
420770,201708,82,69,13,64653,12181,76834
420775,201708,47,43,4,39354,3748,43102
420780,201708,226,176,50,164912,46850,211762
420785,201708,13,9,4,8433,3748,12181
420790,201708,174,146,28,136466.9,25271.63,161738.53
420800,201708,73,54,19,49848.4,17803,67651.4
420810,201708,242,208,34,194887,31061.55,225948.55
420820,201708,2324,1381,943,1286472.56,882082.93,2168555.49
420830,201708,516,298,218,277781.09,203319.63,481100.72
420840,201708,135,104,31,97448,29047,126495
420845,201708,439,195,244,182055.93,227410,409465.93
420850,201708,224,181,43,169597,40291,209888
420860,201708,61,52,9,48724,8433,57157
420870,201708,113,82,31,76834,29047,105881
420880,201708,164,114,50,106152.73,46850,153002.73
420890,201708,846,421,425,391581.67,398216,789797.67
420895,201708,10,10,0,9370,0,9370
420900,201708,395,305,90,284043.22,84302.63,368345.85
420910,201708,5706,3150,2556,2945016.6,2392930.57,5337947.17
420915,201708,80,74,6,69338,5622,74960
420917,201708,18,13,5,12181,4685,16866
420920,201708,22,15,7,14055,6559,20614
420930,201708,2558,1540,1018,1435154.14,946867.77,2382021.91
420940,201708,586,430,156,402382.9,144548.24,546931.14
420945,201708,8,6,2,5622,1874,7496
420950,201708,56,51,5,47787,4685,52472
420960,201708,112,87,25,81482.26,23416,104898.26
420970,201708,297,240,57,223233.45,53381.63,276615.08
420980,201708,26,25,1,23425,937,24362
420985,201708,55,49,6,45913,5622,51535
420990,201708,65,49,16,45913,14992,60905
421000,201708,34,22,12,20614,11244,31858
421003,201708,66,41,25,38417,23416,61833
421005,201708,8,5,3,4685,2811,7496
421010,201708,752,528,224,494345.78,207834.39,702180.17
421020,201708,27,24,3,22468,2811,25279
421030,201708,126,104,22,97121,20614,117735
421040,201708,58,51,7,47787,6559,54346
421050,201708,290,206,84,190961.1,78708,269669.1
421055,201708,27,23,4,21551,3748,25299
421060,201708,85,59,26,55283,24362,79645
421070,201708,50,46,4,43102,3748,46850
421080,201708,33,31,2,29047,1874,30921
421085,201708,24,19,5,17803,4685,22488
421090,201708,44,34,10,31858,9370,41228
421100,201708,116,86,30,80582,28110,108692
421105,201708,206,167,39,156339,36519.95,192858.95
421110,201708,108,90,18,83720.95,16866,100586.95
421120,201708,152,118,34,110079.13,31839.26,141918.39
421125,201708,16,11,5,10307,4685,14992
421130,201708,790,507,283,473928.91,264149.87,738078.78
421140,201708,29,21,8,18974.25,7496,26470.25
421145,201708,39,32,7,29984,6559,36543
421150,201708,107,77,30,72149,28110,100259
421160,201708,59,40,19,37470.63,17803,55273.63
421165,201708,18,17,1,15929,937,16866
421170,201708,184,160,24,149200.89,22479,171679.89
421175,201708,149,98,51,91826,47731.52,139557.52
421180,201708,57,35,22,32439,20614,53053
421185,201708,16,13,3,12181,2811,14992
421187,201708,0,0,0,0,0,0
421189,201708,38,30,8,28110,7486.63,35596.63
421190,201708,1388,854,534,799449,499673.99,1299122.99
421200,201708,87,67,20,61703,18740,80443
421205,201708,24,16,8,14992,7486.63,22478.63
421210,201708,176,118,58,110566,54346,164912
421220,201708,263,210,53,195919.95,49661,245580.95
421223,201708,56,46,10,43102,9370,52472
421225,201708,56,41,15,38417,14055,52472
421227,201708,90,68,22,63716,20614,84330
421230,201708,47,34,13,31858,12181,44039
421240,201708,19,19,0,17803,0,17803
421250,201708,354,215,139,201362,129465.29,330827.29
421260,201708,28,22,6,20614,5622,26236
421265,201708,0,0,0,0,0,0
421270,201708,53,48,5,44976,4685,49661
421280,201708,335,195,140,182715,129493.4,312208.4
421290,201708,304,205,99,191851,91376.56,283227.56
421300,201708,27,22,5,20614,4685,25299
421310,201708,54,40,14,36824.1,13118,49942.1
421315,201708,28,19,9,17803,8433,26236
421320,201708,125,90,35,84330,32795,117125
421330,201708,113,85,28,77564.86,26227,103791.86
421335,201708,40,26,14,24362,13118,37480
421340,201708,289,191,98,176952.5,91826,268778.5
421350,201708,161,95,66,88580,61842,150422
421360,201708,680,502,178,463806.48,166560.52,630367.00
421370,201708,186,141,45,132117,41837.05,173954.05
421380,201708,126,104,22,97443.32,20614,118057.32
421390,201708,19,15,4,14055,3748,17803
421400,201708,116,98,18,91826,16866,108692
421410,201708,23,18,5,16866,4685,21551
421415,201708,19,16,3,14992,2811,17803
421420,201708,148,124,24,115625.8,22488,138113.8
421430,201708,14,11,3,10307,2811,13118
421440,201708,58,46,12,43102,11244,54346
421450,201708,100,88,12,82456,11244,93700
421460,201708,59,50,9,46060.1,8433,54493.1
421470,201708,72,46,26,43102,24362,67464
421480,201708,625,467,158,437110.5,148037,585147.5
421490,201708,24,22,2,19950,1874,21824
421500,201708,517,334,183,310584.51,170632.69,481217.20
421505,201708,25,18,7,16866,6559,23425
421507,201708,32,26,6,24362,5622,29984
421510,201708,73,49,24,45913,22113.2,68026.2
421520,201708,68,58,10,53597,9370,62967
421530,201708,54,48,6,44320.1,5622,49942.1
421535,201708,31,30,1,27848,937,28785
421540,201708,58,52,6,48724,5622,54346
421545,201708,94,72,22,66987,20614,87601
421550,201708,275,198,77,184871,72149,257020
421555,201708,23,19,4,17803,3748,21551
421560,201708,8,8,0,7496,0,7496
421565,201708,121,90,31,84330,29047,113377
421567,201708,29,23,6,21551,5622,27173
421568,201708,33,31,2,29047,1874,30921
421569,201708,9,8,1,7496,937,8433
421570,201708,134,90,44,84330,41228,125558
421575,201708,27,22,5,20356.33,4685,25041.33
421580,201708,712,423,289,396351,269856.27,666207.27
421590,201708,21,20,1,18740,937,19677
421600,201708,109,73,36,68381,32796,101177
421605,201708,100,70,30,65263,28110,93373
421610,201708,191,147,44,137458,41228,178686
421620,201708,1111,672,439,627209.76,411304.52,1038514.28
421625,201708,21,18,3,16866,2811,19677
421630,201708,267,170,97,159244,90046,249290
421635,201708,17,8,9,7496,8433,15929
421640,201708,96,85,11,79645,10307,89952
421650,201708,268,156,112,146153.26,104925.26,251078.52
421660,201708,2043,1214,829,1135335.86,775527.16,1910863.02
421670,201708,169,127,42,118999,39354,158353
421680,201708,168,153,15,143361,14046,157407
421690,201708,340,237,103,221488.8,95564.99,317053.79
421700,201708,53,34,19,31858,16960,48818
421710,201708,23,23,0,21551,0,21551
421715,201708,9,8,1,7496,937,8433
421720,201708,556,397,159,370131.3,147287.54,517418.84
421725,201708,12,6,6,5622,5622,11244
421730,201708,41,29,12,26455.48,11244,37699.48
421740,201708,83,40,43,37480,40291,77771
421750,201708,215,156,59,143830.5,55283,199113.5
421755,201708,26,24,2,22488,1874,24362
421760,201708,108,76,32,71202.63,29984,101186.63
421770,201708,546,375,171,349468.52,160153.15,509621.67
421775,201708,24,16,8,14992,7496,22488
421780,201708,185,145,40,135583.9,37480,173063.9
421790,201708,157,130,27,121294.65,25299,146593.65
421795,201708,15,13,2,12181,1874,14055
421800,201708,438,281,157,261577.61,147104.32,408681.93
421810,201708,69,55,14,51535,13118,64653
421820,201708,298,204,94,190183.1,88078,278261.1
421825,201708,127,104,23,97448,21551,118999
421830,201708,132,100,32,93700,29984,123684
421835,201708,3,3,0,2811,0,2811
421840,201708,60,51,9,47778,8433,56211
421850,201708,79,70,9,65590,8429,74019
421860,201708,41,31,10,28765.9,9370,38135.9
421870,201708,970,734,236,679807.5,220266.59,900074.09
421875,201708,50,44,6,41228,5622,46850
421880,201708,164,118,46,110566,42821,153387
421885,201708,27,22,5,20614,4404,25018
421890,201708,111,77,34,72149,31858,104007
421895,201708,39,36,3,33732,2811,36543
421900,201708,148,118,30,110492.15,28065,138557.15
421910,201708,64,43,21,40291,19677,59968
421915,201708,31,25,6,23425,5622,29047
421917,201708,38,27,11,25018,10307,35325
421920,201708,33,30,3,28110,2811,30921
421930,201708,756,583,173,544575.03,162064.63,706639.66
421935,201708,56,49,7,45913,6559,52472
421940,201708,41,38,3,35606,2811,38417
421950,201708,820,536,284,496260.09,263542.76,759802.85
421960,201708,41,37,4,34388,3748,38136
421970,201708,368,233,135,217831.12,126444.01,344275.13
421985,201708,29,20,9,18740,8433,27173
422000,201708,0,0,0,0,0,0
430003,201708,210,47,163,43336.25,152731,196067.25
430005,201708,33,26,7,24362,6559,30921
430010,201708,278,195,83,182246.5,77771,260017.5
430020,201708,154,98,56,91545,51535,143080
430030,201708,125,97,28,90889,26236,117125
430040,201708,2984,1727,1257,1610091.31,1176217.68,2786308.99
430045,201708,67,57,10,53128,9370,62498
430047,201708,7,6,1,5622,937,6559
430050,201708,79,67,12,62779,11244,74023
430055,201708,17,14,3,13118,2811,15929
430057,201708,4,2,2,1874,1874,3748
430060,201708,3716,2192,1524,2046461.31,1424153.53,3470614.84
430063,201708,56,50,6,46850,5622,52472
430064,201708,143,119,24,111503,22488,133991
430066,201708,10,7,3,6559,2811,9370
430070,201708,49,37,12,34669,11244,45913
430080,201708,68,47,21,43351.8,19677,63028.8
430085,201708,37,10,27,9370,25299,34669
430087,201708,40,29,11,27033,10307,37340
430090,201708,71,63,8,58749.9,7496,66245.9
430100,201708,112,75,37,70275,34669,104944
430105,201708,141,72,69,67464,64353.16,131817.16
430107,201708,20,14,6,13118,5622,18740
430110,201708,405,236,169,220335.55,158287.41,378622.96
430120,201708,142,129,13,119918.21,12181,132099.21
430130,201708,776,487,289,455709.95,270511.9,726221.85
430140,201708,126,117,9,109629,8433,118062
430150,201708,109,72,37,66715,33732,100447
430155,201708,32,29,3,27173,2811,29984
430160,201708,3794,2241,1553,2080517.54,1451160.11,3531677.65
430163,201708,319,140,179,130056.57,167666.78,297723.35
430165,201708,22,16,6,14992,5622,20614
430170,201708,79,73,6,68401,5622,74023
430175,201708,81,62,19,58094,17147.1,75241.1
430180,201708,93,74,19,69338,17193.95,86531.95
430185,201708,32,24,8,22488,7496,29984
430187,201708,107,44,63,41228,58731.9,99959.9
430190,201708,225,130,95,121763.15,88349.73,210112.88
430192,201708,14,14,0,13118,0,13118
430195,201708,13,8,5,7496,4685,12181
430200,201708,159,139,20,129587.1,18740,148327.1
430205,201708,19,18,1,16866,937,17803
430210,201708,602,464,138,430832.7,128041.15,558873.85
430215,201708,17,14,3,13118,2811,15929
430220,201708,59,42,17,39354,15929,55283
430222,201708,15,8,7,7496,6559,14055
430223,201708,13,7,6,6559,5622,12181
430225,201708,4,3,1,2811,937,3748
430230,201708,292,183,109,170534,102133,272667
430235,201708,46,33,13,30921,12171.63,43092.63
430237,201708,27,21,6,19677,5622,25299
430240,201708,131,80,51,74960,47777.63,122737.63
430245,201708,70,58,12,54346,11244,65590
430250,201708,195,114,81,106808.63,75887.63,182696.26
430258,201708,14,12,2,11244,1874,13118
430260,201708,38,33,5,30921,3879.18,34800.18
430265,201708,36,29,7,27154.26,6559,33713.26
430270,201708,580,429,151,398583.94,139707.81,538291.75
430280,201708,1019,636,383,592268.33,356416.8,948685.13
430290,201708,376,219,157,203329.4,147109,350438.4
430300,201708,2087,1143,944,1065305.86,881531.67,1946837.53
430310,201708,1986,1038,948,965807.2,886135.62,1851942.82
430320,201708,47,39,8,36528.95,7496,44024.95
430330,201708,98,89,9,82924.5,8433,91357.5
430340,201708,67,60,7,56220,6559,62779
430350,201708,1656,1153,503,1069070.38,469587.76,1538658.14
430355,201708,27,24,3,22488,2811,25299
430360,201708,81,38,43,35606,39354.1,74960.1
430367,201708,30,20,10,18740,8592.29,27332.29
430370,201708,55,49,6,45913,5622,51535
430380,201708,124,93,31,86578.8,29047,115625.8
430390,201708,600,374,226,350156.9,211462.63,561619.53
430400,201708,134,102,32,93887.4,29965.26,123852.66
430410,201708,55,44,11,41228,10307,51535
430420,201708,482,318,164,295249.8,151448.58,446698.38
430430,201708,53,51,2,47162.95,1874,49036.95
430435,201708,149,110,39,102133,35840.25,137973.25
430440,201708,507,337,170,315769,159102.6,474871.6
430450,201708,1170,965,205,897741.27,192075.63,1089816.90
430460,201708,5092,2773,2319,2581249.47,2165447.69,4746697.16
430461,201708,18,16,2,14992,1874,16866
430462,201708,11,7,4,6559,3748,10307
430463,201708,989,516,473,480822.39,442855.05,923677.44
430465,201708,29,17,12,15929,11244,27173
430466,201708,641,456,185,425398.1,173157.6,598555.7
430467,201708,97,57,40,53409,37470.63,90879.63
430468,201708,113,68,45,63716,41918.39,105634.39
430469,201708,22,16,6,14992,5622,20614
430470,201708,1173,653,520,603994.37,485319.15,1089313.52
430471,201708,49,36,13,33713.26,12181,45894.26
430480,201708,97,61,36,56313.7,33722.63,90036.33
430485,201708,5,5,0,4404,0,4404
430490,201708,95,75,20,69843.98,18740,88583.98
430495,201708,34,27,7,25299,6559,31858
430500,201708,193,133,60,123918.25,55850.63,179768.88
430510,201708,2986,1984,1002,1853696.35,938284.06,2791980.41
430511,201708,18,18,0,16866,0,16866
430512,201708,135,90,45,84330,42165,126495
430513,201708,53,47,6,43570.5,5622,49192.5
430515,201708,31,29,2,27173,1874,29047
430517,201708,171,151,20,140550.25,18721.26,159271.51
430520,201708,361,247,114,230784,106789.89,337573.89
430530,201708,91,50,41,46850,38417,85267
430535,201708,471,308,163,288404.6,152707.58,441112.18
430537,201708,13,13,0,12181,0,12181
430540,201708,74,47,27,44039,25299,69338
430543,201708,368,113,255,105881,238420,344301
430544,201708,44,40,4,37480,3748,41228
430545,201708,336,151,185,141421.41,172857.76,314279.17
430550,201708,45,36,9,33732,8433,42165
430558,201708,6,4,2,3748,1874,5622
430560,201708,47,19,28,17803,26236,44039
430570,201708,102,45,57,42165,53352.78,95517.78
430580,201708,123,97,26,90889,24315.15,115204.15
430583,201708,14,14,0,13118,0,13118
430585,201708,8,4,4,3748,3748,7496
430587,201708,14,8,6,7496,5622,13118
430590,201708,152,128,24,118717.9,22488,141205.9
430593,201708,4,4,0,3748,0,3748
430595,201708,14,9,5,8433,4685,13118
430597,201708,51,27,24,25299,22488,47787
430600,201708,216,145,71,135855.63,66245.9,202101.53
430605,201708,152,93,59,87141,55273.63,142414.63
430607,201708,26,21,5,19677,4685,24362
430610,201708,1614,751,863,699283.95,803721.49,1503005.44
430613,201708,3,3,0,2811,0,2811
430620,201708,111,79,32,73883,29974.63,103857.63
430630,201708,48,43,5,40291,4685,44976
430632,201708,32,28,4,26236,3748,29984
430635,201708,38,34,4,31858,3748,35606
430637,201708,56,31,25,29047,23425,52472
430640,201708,212,119,93,110659.7,87141,197800.7
430642,201708,27,25,2,23425,1874,25299
430645,201708,30,26,4,24362,3748,28110
430650,201708,251,198,53,185245,49614.15,234859.15
430655,201708,7,7,0,6559,0,6559
430660,201708,954,458,496,427599.95,463252.9,890852.85
430670,201708,72,52,20,48724,18740,67464
430673,201708,75,43,32,40291,29984,70275
430675,201708,13,10,3,9370,2811,12181
430676,201708,463,278,185,259792.62,173274.84,433067.46
430680,201708,246,171,75,157417,70275,227692
430690,201708,518,314,204,293346.59,189521.01,482867.60
430692,201708,7,5,2,4685,1874,6559
430693,201708,133,88,45,82456,41546.58,124002.58
430695,201708,71,64,7,59049.74,6559,65608.74
430697,201708,63,37,26,34669,24362,59031
430700,201708,1568,1095,473,1017273.55,443201,1460474.55
430705,201708,19,18,1,16866,937,17803
430710,201708,261,168,93,157416,87141,244557
430720,201708,111,94,17,87890.6,15929,103819.6
430730,201708,119,103,16,95574,14992,110566
430740,201708,59,41,18,38417,16866,55283
430745,201708,38,29,9,27173,8433,35606
430750,201708,338,233,105,217448.72,97448,314896.72
430755,201708,78,42,36,39354,33732,73086
430760,201708,358,217,141,200097.11,132089.26,332186.37
430770,201708,1464,755,709,705354.96,659946.19,1365301.15
430780,201708,313,199,114,185499.16,106752.78,292251.94
430781,201708,28,24,4,22488,3748,26236
430783,201708,44,36,8,33419.8,7496,40915.8
430786,201708,6,3,3,2811,2811,5622
430790,201708,468,307,161,285878.7,150566.63,436445.33
430800,201708,154,129,25,120873,23425,144298
430805,201708,41,36,5,33732,4685,38417
430807,201708,32,20,12,18740,11244,29984
430810,201708,69,44,25,41228,23425,64653
430820,201708,131,79,52,74023,48068.1,122091.1
430825,201708,11,9,2,8433,1874,10307
430830,201708,226,211,15,197426,14055,211481
430840,201708,121,80,41,74960,37761.1,112721.1
430843,201708,5,3,2,2811,1874,4685
430845,201708,70,40,30,37480,28110,65590
430850,201708,577,395,182,368902.16,170395.67,539297.83
430860,201708,157,100,57,92388.2,52743.73,145131.93
430865,201708,64,31,33,28391.1,30611.79,59002.89
430870,201708,77,62,15,58094,14055,72149
430880,201708,157,119,38,111503,35606,147109
430885,201708,8,7,1,6559,937,7496
430890,201708,336,205,131,190454.94,122747,313201.94
430900,201708,548,376,172,348189.7,160686.13,508875.83
430905,201708,82,34,48,31858,44976,76834
430910,201708,266,148,118,138676,108965,247641
430912,201708,5,5,0,4685,0,4685
430915,201708,31,23,8,21551,7214.9,28765.9
430920,201708,4038,2257,1781,2109477.1,1666739.31,3776216.41
430925,201708,6,5,1,4441.38,937,5378.38
430930,201708,2069,1235,834,1147858.92,780279.81,1928138.73
430940,201708,234,147,87,137073.73,81500.26,218573.99
430950,201708,162,130,32,121810,29702.9,151512.9
430955,201708,21,13,8,12181,7496,19677
430957,201708,17,16,1,14992,937,15929
430960,201708,243,159,84,147249.55,78708,225957.55
430965,201708,100,61,39,57157,36543,93700
430970,201708,80,67,13,62779,11244,74023
430975,201708,34,32,2,29984,1874,31858
430980,201708,44,27,17,25299,15929,41228
430990,201708,109,82,27,76834,25299,102133
430995,201708,114,110,4,101851.9,3748,105599.9
431000,201708,297,136,161,126206.1,150857,277063.1
431010,201708,341,205,136,191119.89,127432,318551.89
431020,201708,1923,1105,818,1028848.99,763364.53,1792213.52
431030,201708,42,34,8,31858,7496,39354
431033,201708,377,188,189,175359.6,177093,352452.6
431036,201708,15,10,5,9370,4685,14055
431040,201708,136,82,54,75897,50490.25,126387.25
431041,201708,41,28,13,26236,12181,38417
431043,201708,45,25,20,23425,18740,42165
431046,201708,12,7,5,6559,4685,11244
431050,201708,210,133,77,122258.17,70682.51,192940.68
431053,201708,70,42,28,38604.4,26236,64840.4
431055,201708,64,41,23,38417,21532.26,59949.26
431057,201708,17,17,0,15929,0,15929
431060,201708,1686,1057,629,983308.19,587627.28,1570935.47
431065,201708,16,10,6,9370,5622,14992
431070,201708,71,65,6,60905,5622,66527
431075,201708,8,8,0,7496,0,7496
431080,201708,137,89,48,83111.9,44976,128087.9
431085,201708,30,27,3,25299,2811,28110
431087,201708,15,13,2,12181,1874,14055
431090,201708,56,44,12,41228,11244,52472
431100,201708,1232,737,495,681200.96,463815,1145015.96
431110,201708,243,151,92,141487,86194.63,227681.63
431112,201708,30,18,12,16866,11244,28110
431113,201708,29,19,10,17803,9370,27173
431115,201708,157,105,52,97760.2,48714.63,146474.83
431120,201708,615,363,252,338220.42,236050.52,574270.94
431123,201708,3,2,1,1874,937,2811
431125,201708,91,81,10,75897,9370,85267
431127,201708,7,3,4,2811,3748,6559
431130,201708,607,398,209,371707.9,195533.16,567241.06
431140,201708,713,479,234,444260.06,219183.04,663443.10
431142,201708,32,25,7,22235,6559,28794
431150,201708,205,151,54,141487,50579.26,192066.26
431160,201708,56,50,6,46850,5622,52472
431162,201708,20,14,6,13118,5622,18740
431164,201708,5,5,0,4685,0,4685
431170,201708,103,85,18,79645,16866,96511
431171,201708,50,27,23,25299,21541.63,46840.63
431173,201708,1,1,0,937,0,937
431175,201708,198,94,104,86860,97448,184308
431177,201708,72,54,18,50598,16847.26,67445.26
431179,201708,12,10,2,9370,1874,11244
431180,201708,438,264,174,247368,163019.63,410387.63
431190,201708,91,70,21,64934.1,19677,84611.1
431198,201708,68,45,23,42165,21551,63716
431200,201708,19,17,2,15929,1874,17803
431205,201708,25,25,0,23425,0,23425
431210,201708,86,53,33,49334,30921,80255
431213,201708,24,20,4,18740,3748,22488
431215,201708,27,24,3,22488,2811,25299
431217,201708,6,5,1,4685,937,5622
431220,201708,65,56,9,52472,8433,60905
431225,201708,145,97,48,90880,44966.63,135846.63
431230,201708,100,86,14,79926.1,13118,93044.1
431235,201708,7,7,0,6559,0,6559
431237,201708,24,16,8,14992,7496,22488
431238,201708,15,11,4,10026,3748,13774
431240,201708,971,619,352,578392.16,329133.96,907526.12
431242,201708,36,36,0,33732,0,33732
431244,201708,10,7,3,6559,2811,9370
431245,201708,60,46,14,43102,13118,56220
431247,201708,14,10,4,9370,3748,13118
431250,201708,269,138,131,129240.41,122064.26,251304.67
431260,201708,59,43,16,40291,14992,55283
431261,201708,21,14,7,13118,6559,19677
431262,201708,16,16,0,14992,0,14992
431265,201708,166,87,79,81519,74023,155542
431267,201708,15,14,1,13118,937,14055
431270,201708,308,258,50,241746,46850,288596
431275,201708,41,39,2,36543,1874,38417
431280,201708,21,16,5,14172.12,4685,18857.12
431290,201708,23,20,3,18740,2811,21551
431295,201708,5,5,0,4685,0,4685
431300,201708,23,20,3,18740,2811,21551
431301,201708,8,8,0,7496,0,7496
431303,201708,48,33,15,30799.19,13773.9,44573.09
431306,201708,215,113,102,105433.11,95574,201007.11
431308,201708,6,5,1,4685,937,5622
431310,201708,65,56,9,52472,8433,60905
431320,201708,122,72,50,67464,46831.26,114295.26
431330,201708,175,116,59,108692,55283,163975
431333,201708,33,27,6,25299,5622,30921
431335,201708,10,5,5,4685,4685,9370
431337,201708,316,149,167,138799.1,155186.14,293985.24
431339,201708,16,13,3,12181,2811,14992
431340,201708,3020,1721,1299,1609075.68,1215214.89,2824290.57
431342,201708,44,27,17,25299,15929,41228
431344,201708,18,17,1,15929,937,16866
431346,201708,4,4,0,3748,0,3748
431349,201708,37,34,3,31858,2811,34669
431350,201708,905,533,372,494953.73,347589.52,842543.25
431360,201708,43,39,4,36543,3748,40291
431365,201708,309,144,165,134928,154595.63,289523.63
431370,201708,1309,784,525,731232.54,491730.82,1222963.36
431380,201708,99,83,16,77115.1,14992,92107.1
431390,201708,491,272,219,253927.1,204014.01,457941.11
431395,201708,272,119,153,111503,143343,254846
431400,201708,37,29,8,27173,7496,34669
431402,201708,88,61,27,57157,25299,82456
431403,201708,13,8,5,7496,4685,12181
431405,201708,652,351,301,327790.81,282010,609800.81
431406,201708,30,26,4,24362,3748,28110
431407,201708,51,45,6,42165,5622,47787
431410,201708,3139,1849,1290,1721779.64,1207493.16,2929272.80
431413,201708,16,14,2,13118,1874,14992
431415,201708,70,51,19,47787,17803,65590
431417,201708,22,11,11,10307,10307,20614
431420,201708,296,210,86,196145.3,80572.63,276717.93
431430,201708,40,15,25,14055,23425,37480
431440,201708,8820,6285,2535,5826317.63,2367239.76,8193557.39
431442,201708,28,15,13,14055,12181,26236
431445,201708,26,20,6,18740,5622,24362
431446,201708,9,7,2,6559,1874,8433
431447,201708,86,59,27,55283,25299,80582
431449,201708,46,43,3,40291,2811,43102
431450,201708,408,288,120,268122.55,111737.25,379859.80
431454,201708,0,0,0,0,0,0
431455,201708,47,36,11,33732,10307,44039
431460,201708,525,359,166,332822.4,155120.9,487943.3
431470,201708,122,94,28,87398.86,26236,113634.86
431475,201708,11,10,1,9370,937,10307
431477,201708,34,24,10,22488,9370,31858
431478,201708,6,5,1,4685,937,5622
431480,201708,490,309,181,287950.41,169269.05,457219.46
431490,201708,28219,15958,12261,14879189.04,11455857.31,26335046.35
431500,201708,76,53,23,49661,21551,71212
431505,201708,46,19,27,17803,25299,43102
431507,201708,8,7,1,6559,937,7496
431510,201708,277,175,102,163272.9,93681.26,256954.16
431513,201708,24,18,6,16866,5622,22488
431514,201708,7,6,1,5622,937,6559
431515,201708,76,65,11,60905,10307,71212
431517,201708,3,1,2,937,1874,2811
431520,201708,35,32,3,29984,2811,32795
431530,201708,1618,715,903,668645.42,845656.67,1514302.09
431531,201708,22,20,2,18740,1874,20614
431532,201708,24,17,7,15929,6559,22488
431535,201708,25,16,9,14992,8433,23425
431540,201708,142,127,15,117715.31,14055,131770.31
431545,201708,17,15,2,14055,1874,15929
431550,201708,340,197,143,184589,133897.3,318486.3
431555,201708,12,11,1,10307,937,11244
431560,201708,4302,3037,1265,2817227.68,1182832.42,4000060.10
431570,201708,756,399,357,370771.1,331670.89,702441.99
431575,201708,36,26,10,24362,9370,33732
431580,201708,94,65,29,59968,27173,87141
431590,201708,132,110,22,102133,20614,122747
431595,201708,12,11,1,10307,937,11244
431600,201708,215,119,96,111503,89952,201455
431610,201708,126,92,34,85548.1,31858,117406.1
431620,201708,42,34,8,31858,7496,39354
431630,201708,124,107,17,100259,15929,116188
431640,201708,1314,823,491,767684.1,459449.32,1227133.42
431642,201708,43,39,4,36074.5,3748,39822.5
431643,201708,47,21,26,19677,24362,44039
431645,201708,304,174,130,163038,120873,283911
431647,201708,11,11,0,10307,0,10307
431650,201708,34,24,10,22488,9370,31858
431660,201708,271,176,95,162757.84,89015,251772.84
431670,201708,212,102,110,92997.25,103041.89,196039.14
431673,201708,3,3,0,2811,0,2811
431675,201708,29,25,4,23143.9,3748,26891.9
431680,201708,1078,770,308,717742,288316.38,1006058.38
431690,201708,4729,2885,1844,2686121.71,1722414.89,4408536.60
431695,201708,26,20,6,18740,5622,24362
431697,201708,0,0,0,0,0,0
431700,201708,166,124,42,116188,39354,155542
431710,201708,3969,1710,2259,1600574.5,2115263.45,3715837.95
431720,201708,1389,816,573,756852.65,535013.63,1291866.28
431725,201708,1,1,0,937,0,937
431730,201708,1171,784,387,729847.1,362619,1092466.1
431740,201708,1363,677,686,629815.26,642231.12,1272046.38
431750,201708,1874,1209,665,1122693.92,620547.36,1743241.28
431755,201708,5,4,1,3748,937,4685
431760,201708,1089,693,396,648622.63,370827.49,1019450.12
431770,201708,386,284,102,266098.63,95555.26,361653.89
431775,201708,27,21,6,19677,5622,25299
431780,201708,562,344,218,320950.61,204256.63,525207.24
431790,201708,146,109,37,101196,34622.15,135818.15
431795,201708,13,12,1,11244,937,12181
431800,201708,3398,1779,1619,1652997.93,1510098.22,3163096.15
431805,201708,17,15,2,14055,1874,15929
431810,201708,620,415,205,387205.88,191972.93,579178.81
431820,201708,315,176,139,164912,129259.15,294171.15
431830,201708,2316,1401,915,1309382.05,856130.76,2165512.81
431840,201708,505,333,172,308461.7,159946,468407.7
431842,201708,34,28,6,26236,5622,31858
431843,201708,10,6,4,5622,3748,9370
431844,201708,14,12,2,11244,1874,13118
431845,201708,28,26,2,24362,1874,26236
431846,201708,30,26,4,24362,3748,28110
431848,201708,14,12,2,11244,1874,13118
431849,201708,8,6,2,5622,1874,7496
431850,201708,790,655,135,611968.11,125979.65,737947.76
431860,201708,101,73,28,68401,25299,93700
431861,201708,4,2,2,1874,1874,3748
431862,201708,48,33,15,30921,14055,44976
431870,201708,3427,2019,1408,1883975.02,1317997.01,3201972.03
431880,201708,916,669,247,622140,230502,852642
431890,201708,1306,804,502,748120.37,468796,1216916.37
431900,201708,176,123,53,115251,49661,164912
431910,201708,55,41,14,38417,13118,51535
431912,201708,34,19,15,17803,14055,31858
431915,201708,124,100,24,93700,22488,116188
431920,201708,144,106,38,99322,35606,134928
431930,201708,85,67,18,62779,16866,79645
431935,201708,4,3,1,2811,937,3748
431936,201708,12,11,1,10307,937,11244
431937,201708,16,11,5,10307,4685,14992
431940,201708,443,292,151,270933.55,141477.63,412411.18
431950,201708,459,294,165,273498.17,153040.95,426539.12
431960,201708,710,427,283,395978.31,265012.45,660990.76
431970,201708,73,65,8,60905,7496,68401
431971,201708,4,4,0,3748,0,3748
431973,201708,17,14,3,13118,2811,15929
431975,201708,6,5,1,4685,937,5622
431980,201708,200,127,73,117499.8,68401,185900.8
431990,201708,1233,656,577,613225.09,540612,1153837.09
432000,201708,1652,881,771,818860.07,719583.12,1538443.19
432010,201708,275,182,93,169441.3,87141,256582.3
432020,201708,168,130,38,121810,35596.63,157406.63
432023,201708,20,16,4,14992,3748,18740
432026,201708,64,57,7,53409,6559,59968
432030,201708,59,29,30,27173,28110,55283
432032,201708,21,18,3,16866,2811,19677
432035,201708,43,35,8,32795,7496,40291
432040,201708,97,66,31,61842,29047,90889
432045,201708,8,7,1,6277.9,937,7214.9
432050,201708,69,42,27,39354,25299,64653
432055,201708,100,77,23,72130.26,21551,93681.26
432057,201708,1,0,1,0,937,937
432060,201708,37,34,3,31155.25,2811,33966.25
432065,201708,30,27,3,25280.26,2811,28091.26
432067,201708,92,80,12,74960,11244,86204
432070,201708,400,300,100,279527.29,93672.26,373199.55
432080,201708,807,555,252,518385.88,236077.89,754463.77
432085,201708,14,11,3,10307,2811,13118
432090,201708,261,168,93,157416,87141,244557
432100,201708,172,112,60,104662.9,56220,160882.9
432110,201708,598,409,189,376271.66,176156,552427.66
432120,201708,965,573,392,536171.1,367266.52,903437.62
432130,201708,497,357,140,333572,131039.45,464611.45
432132,201708,27,24,3,22488,2811,25299
432135,201708,77,65,12,60905,11244,72149
432140,201708,270,209,61,195261.43,57157,252418.43
432143,201708,181,113,68,105881,63716,169597
432145,201708,263,179,84,166505.8,78426.9,244932.7
432146,201708,15,14,1,13118,937,14055
432147,201708,159,60,99,56220,92744.26,148964.26
432149,201708,17,12,5,11244,4685,15929
432150,201708,828,522,306,487942.75,284081.03,772023.78
432160,201708,1388,713,675,665824.2,631604.56,1297428.76
432162,201708,4,3,1,2811,937,3748
432163,201708,18,14,4,13118,3748,16866
432166,201708,126,94,32,88313,29984,118297
432170,201708,224,124,100,114596,93700,208296
432180,201708,519,313,206,291407.8,192741,484148.8
432183,201708,8,6,2,5622,1874,7496
432185,201708,79,67,12,62685.3,11244,73929.3
432190,201708,489,257,232,239666.63,217234.82,456901.45
432195,201708,85,73,12,67698.25,11244,78942.25
432200,201708,401,255,146,238935,136709.52,375644.52
432210,201708,113,75,38,68260.45,35606,103866.45
432215,201708,62,58,4,54346,3748,58094
432218,201708,19,18,1,16866,937,17803
432220,201708,671,339,332,316642.05,310584.97,627227.02
432225,201708,16,10,6,8901.5,5622,14523.5
432230,201708,158,90,68,84095.75,63716,147811.75
432232,201708,15,13,2,12181,1874,14055
432234,201708,5,4,1,3748,937,4685
432235,201708,1,1,0,937,0,937
432237,201708,28,16,12,14992,11244,26236
432240,201708,4132,2303,1829,2147830.52,1706869.76,3854700.28
432250,201708,1013,629,384,586516.28,359648.71,946164.99
432252,201708,38,31,7,28316.14,6559,34875.14
432253,201708,59,47,12,44039,11244,55283
432254,201708,20,8,12,7496,11244,18740
432255,201708,14,13,1,12181,937,13118
432260,201708,839,655,184,612751.25,171471.75,784223.00
432270,201708,220,161,59,150857,55283,206140
432280,201708,125,91,34,84798.9,31858,116656.9
432285,201708,2,1,1,937,937,1874
432290,201708,69,63,6,57438.1,5622,63060.1
432300,201708,4620,2620,2000,2441514.8,1870023.11,4311537.91
432310,201708,117,93,24,87141,22488,109629
432320,201708,19,14,5,13118,4685,17803
432330,201708,14,8,6,7496,5622,13118
432335,201708,8,7,1,6559,937,7496
432340,201708,41,37,4,34669,3748,38417
432345,201708,88,64,24,59968,22488,82456
432350,201708,23,22,1,20614,937,21551
432360,201708,7,5,2,4685,1874,6559
432370,201708,24,24,0,22206.9,0,22206.9
432375,201708,41,35,6,32795,5622,38417
432377,201708,7,7,0,6559,0,6559
432380,201708,163,70,93,64934.1,87094.15,152028.25
500020,201708,238,124,114,116188,106227.69,222415.69
500025,201708,115,56,59,51316.71,55283,106599.71
500060,201708,1371,827,544,774336.8,509133.21,1283470.01
500070,201708,726,337,389,315769,364202.63,679971.63
500080,201708,131,99,32,92763,29703,122466
500085,201708,143,115,28,107474,25416.13,132890.13
500090,201708,333,155,178,145235,166786,312021
500100,201708,692,372,320,345697.99,298997,644694.99
500110,201708,2217,977,1240,915140.63,1161106.3,2076246.93
500124,201708,309,176,133,164912,124339.9,289251.9
500150,201708,327,125,202,117116,188920,306036
500190,201708,525,356,169,332897.36,157872,490769.36
500200,201708,198,168,30,157058.89,28110,185168.89
500210,201708,1424,509,915,475682.48,856293.47,1331975.95
500215,201708,238,136,102,126471.21,95574,222045.21
500220,201708,778,510,268,477629.52,250372.63,728002.15
500230,201708,258,178,80,166083.25,74491.5,240574.75
500240,201708,706,488,218,456506.4,203797.9,660304.3
500260,201708,565,205,360,192085,337320,529405
500270,201708,28263,11942,16321,11161410.26,15277285.07,26438695.33
500280,201708,194,74,120,69338,112440,181778
500290,201708,1177,676,501,631570.23,469428,1100998.23
500295,201708,390,230,160,215510,149910.63,365420.63
500310,201708,65,19,46,17803,43102,60905
500315,201708,702,411,291,385097.63,272376.53,657474.16
500320,201708,3613,1791,1822,1675572.41,1705586.37,3381158.78
500325,201708,956,521,435,487709,406637.32,894346.32
500330,201708,1491,681,810,635259.86,758357.43,1393617.29
500345,201708,319,234,85,218312.1,79645,297957.1
500348,201708,240,140,100,131180,93681.63,224861.63
500350,201708,146,70,76,65590,71212,136802
500370,201708,5418,2397,3021,2238898.14,2828004.16,5066902.30
500375,201708,348,251,97,235177.63,90889,326066.63
500380,201708,573,330,243,309055.4,227672.63,536728.03
500390,201708,69,35,34,32795,31858,64653
500400,201708,213,145,68,135846.26,63707,199553.26
500410,201708,571,219,352,205157.58,329678.42,534836.00
500430,201708,530,368,162,344816,151794,496610
500440,201708,205,105,100,97624.42,93700,191324.42
500450,201708,415,176,239,164223.8,222938.94,387162.74
500460,201708,319,159,160,148973.63,149920,298893.63
500470,201708,434,344,90,321135.05,83384,404519.05
500480,201708,111,66,45,61842,42165,104007
500490,201708,106,41,65,38412.32,60905,99317.32
500500,201708,1434,487,947,454520.8,886452.22,1340973.02
500510,201708,49,37,12,34669,11235,45904
500515,201708,108,73,35,68401,32514,100915
500520,201708,352,198,154,184496,144294,328790
500525,201708,88,51,37,47787,34387.9,82174.9
500540,201708,885,362,523,339128.78,489059.03,828187.81
500560,201708,902,508,394,474278.66,368495.83,842774.49
500568,201708,968,563,405,522846.2,379199.32,902045.52
500570,201708,1213,687,526,641517.09,490280.65,1131797.74
500580,201708,337,173,164,161810.53,153655,315465.53
500600,201708,321,164,157,152969.93,147091,300060.93
500620,201708,873,616,257,571518.61,240612.23,812130.84
500625,201708,78,65,13,60210.78,12181,72391.78
500627,201708,21,9,12,8433,11244,19677
500630,201708,1569,826,743,772744.9,695905.22,1468650.12
500635,201708,517,283,234,264758.72,219108.08,483866.80
500640,201708,422,218,204,201456.5,191111.63,392568.13
500660,201708,5499,2094,3405,1959361.8,3186821.73,5146183.53
500690,201708,574,202,372,188931.39,347800.6,536731.99
500710,201708,357,173,184,161820,172117.9,333937.9
500720,201708,965,568,397,530806.32,371783.26,902589.58
500730,201708,188,108,80,101196,74674.22,175870.22
500740,201708,845,371,474,346345.14,443689,790034.14
500750,201708,137,44,93,41228,86832.16,128060.16
500755,201708,123,90,33,84049,30921,114970
500769,201708,746,418,328,391345.02,307323,698668.02
500770,201708,452,232,220,217374.63,205896.38,423271.01
500780,201708,173,116,57,108692,53409,162101
500790,201708,1041,512,529,479177.32,495351.63,974528.95
500793,201708,251,133,118,124481,110557,235038
500795,201708,177,126,51,118052.63,47778,165830.63
500797,201708,41,34,7,31858,6559,38417
500800,201708,412,181,231,169588,216165.9,385753.9
500830,201708,2162,1202,960,1123060.3,898657.96,2021718.26
500840,201708,145,108,37,101196,34660,135856
510010,201708,166,91,75,85257.63,70275,155532.63
510020,201708,479,222,257,207740.67,240268.38,448009.05
510025,201708,1635,924,711,864933.03,663097.65,1528030.68
510030,201708,612,307,305,287613.26,285034.32,572647.58
510035,201708,126,54,72,50570.63,67445.63,118016.26
510040,201708,376,160,216,149920,201952.53,351872.53
510050,201708,422,227,195,211962.1,181895.89,393857.99
510060,201708,112,53,59,49631.63,55273.63,104905.26
510080,201708,221,87,134,81486.95,125455.3,206942.25
510100,201708,75,34,41,31858,38398.26,70256.26
510120,201708,35,21,14,19677,13118,32795
510125,201708,401,245,156,228895.05,146149.26,375044.31
510130,201708,590,344,246,321907.7,230083.68,551991.38
510140,201708,382,126,256,118053,239867.32,357920.32
510160,201708,87,42,45,39354,42161,81515
510170,201708,853,525,328,491661.66,306739.65,798401.31
510180,201708,2859,1400,1459,1308797.16,1365074.02,2673871.18
510185,201708,9,4,5,3748,4685,8433
510190,201708,221,74,147,69338,137734.32,207072.32
510250,201708,2627,1526,1101,1428744.22,1030533.66,2459277.88
510260,201708,199,142,57,132863.15,53372.63,186235.78
510263,201708,450,248,202,230934.04,188531.89,419465.93
510267,201708,644,357,287,334317.78,268660.47,602978.25
510268,201708,56,31,25,29047,23425,52472
510269,201708,70,28,42,26227,39354,65581
510270,201708,409,210,199,196594.19,186043.57,382637.76
510279,201708,222,160,62,149892.63,58075.26,207967.89
510285,201708,174,74,100,69299.63,93700,162999.63
510300,201708,556,297,259,277854.85,242609.53,520464.38
510305,201708,214,95,119,88992.63,111401.04,200393.67
510310,201708,118,56,62,52472,58084.63,110556.63
510320,201708,853,526,327,492574.52,305978.26,798552.78
510325,201708,402,164,238,153618.63,222715.53,376334.16
510330,201708,414,233,181,218308,169578.26,387886.26
510335,201708,602,314,288,294171.89,269193.32,563365.21
510336,201708,50,35,15,32774.89,14055,46829.89
510337,201708,122,47,75,44029.63,70265.63,114295.26
510340,201708,17362,8381,8981,7827769.98,8404389.87,16232159.85
510343,201708,71,47,24,44029.63,22488,66517.63
510345,201708,161,104,57,97438.63,53118.63,150557.26
510350,201708,648,368,280,343610.74,262295.89,605906.63
510360,201708,211,123,88,115232.63,82364.89,197597.52
510370,201708,133,68,65,63697.26,60775.67,124472.93
510380,201708,93,63,30,59031,28101,87132
510385,201708,58,27,31,25299,29038,54337
510390,201708,127,51,76,47787,71165.15,118952.15
510395,201708,41,28,13,26236,12181,38417
510410,201708,693,456,237,427239,222045.95,649284.95
510420,201708,591,281,310,262385.77,289000.05,551385.82
510450,201708,51,32,19,29984,17803,47787
510452,201708,38,22,16,20614,14992,35606
510454,201708,71,30,41,28110,38407.63,66517.63
510455,201708,129,81,48,75878.26,44976,120854.26
510460,201708,181,94,87,87769.53,81481.89,169251.42
510480,201708,719,399,320,372757.05,299473.34,672230.39
510490,201708,362,184,178,172027.53,166226.76,338254.29
510500,201708,255,189,66,177083.63,61842,238925.63
510510,201708,777,450,327,420779.43,306389.63,727169.06
510515,201708,1152,597,555,558836.48,519977.89,1078814.37
510517,201708,254,109,145,101851.9,135841.95,237693.85
510520,201708,233,151,82,141395.52,76529.52,217925.04
510523,201708,95,62,33,58094,30911.63,89005.63
510525,201708,677,383,294,358089.78,275368.15,633457.93
510530,201708,17,12,5,11244,4685,15929
510550,201708,272,118,154,110085.46,144289,254374.46
510558,201708,277,134,143,125543.95,133963.26,259507.21
510560,201708,375,230,145,215510,135566,351076
510562,201708,638,439,199,410045.25,185965.13,596010.38
510590,201708,836,434,402,406620.89,376655.96,783276.85
510600,201708,257,138,119,129283.26,111461.58,240744.84
510610,201708,163,78,85,73067.26,79626.63,152693.89
510615,201708,189,74,115,69319.26,107755,177074.26
510617,201708,15,8,7,7496,6559,14055
510618,201708,119,56,63,52472,58562.5,111034.5
510619,201708,107,72,35,67455,32786,100241
510620,201708,191,108,83,101186.63,77771,178957.63
510621,201708,192,125,67,116825.53,62760.63,179586.16
510622,201708,439,286,153,267870.52,143033.89,410904.41
510623,201708,358,231,127,216410.26,118961.52,335371.78
510624,201708,87,38,49,35597,45913,81510
510625,201708,520,314,206,293718.78,192434.82,486153.60
510626,201708,105,63,42,59031,39354,98385
510627,201708,54,39,15,36543,14055,50598
510628,201708,163,97,66,90843.26,61785.78,152629.04
510629,201708,248,158,90,148046,83383.63,231429.63
510630,201708,455,225,230,210741.41,215178.85,425920.26
510631,201708,11,3,8,2811,7496,10307
510637,201708,335,182,153,170474.89,143215.52,313690.41
510642,201708,981,539,442,504697.79,414013.82,918711.61
510645,201708,0,0,0,0,0,0
510650,201708,1527,1003,524,939648.89,490878.41,1430527.30
510665,201708,83,42,41,39300,38399,77699
510670,201708,67,36,31,33732,29047,62779
510675,201708,1181,713,468,668010,438473.32,1106483.32
510677,201708,376,175,201,162958.15,187899.67,350857.82
510680,201708,109,63,46,59013,43093,102106
510682,201708,204,93,111,86825,104007,190832
510685,201708,56,40,16,37480,14992,52472
510700,201708,621,359,262,336264.89,245343.04,581607.93
510704,201708,1025,549,476,512173.09,443523.41,955696.50
510706,201708,126,61,65,57152.32,60868.26,118020.58
510710,201708,392,258,134,241552.93,125446.3,366999.23
510715,201708,64,47,17,44029.63,15929,59958.63
510718,201708,217,111,106,103914.78,99303.63,203218.41
510719,201708,32,18,14,16866,13118,29984
510720,201708,199,129,70,120864,65308.9,186172.9
510724,201708,84,33,51,30911.63,47754.89,78666.52
510726,201708,49,26,23,24352.63,21533,45885.63
510729,201708,77,36,41,33732,38379.52,72111.52
510730,201708,465,256,209,239863,195685.63,435548.63
510735,201708,110,43,67,40291,62779,103070
510740,201708,29,15,14,14055,13118,27173
510757,201708,21,17,4,15929,3748,19677
510760,201708,6969,3681,3288,3439366.05,3075389.13,6514755.18
510770,201708,739,347,392,324954.15,367113.15,692067.30
510774,201708,14,7,7,6559,6559,13118
510775,201708,111,83,28,77761.63,26226.63,103988.26
510776,201708,27,6,21,5622,19677,25299
510777,201708,187,84,103,78679.89,96482.89,175162.78
510779,201708,52,24,28,22479,26199.26,48678.26
510780,201708,296,162,134,151722.26,125477,277199.26
510785,201708,444,242,202,226688.78,189189.67,415878.45
510787,201708,187,95,92,89001.32,86186.32,175187.64
510788,201708,0,0,0,0,0,0
510790,201708,2356,1230,1126,1150421.96,1052572.9,2202994.86
510792,201708,1046,585,461,547666.15,431550.64,979216.79
510794,201708,109,53,56,49661,52444.26,102105.26
510795,201708,2368,1375,993,1281477.89,927584.8,2209062.69
510800,201708,177,111,66,103997.63,61833,165830.63
510805,201708,164,116,48,108692,44976,153668
510810,201708,92,36,56,33649.89,52359.93,86009.82
510820,201708,266,126,140,117820.63,130197.71,248018.34
510830,201708,67,40,27,37480,25290,62770
510835,201708,2,1,1,937,937,1874
510840,201708,9120,4582,4538,4279771.32,4244335.13,8524106.45
510850,201708,205,84,121,78698.63,113058.79,191757.42
510860,201708,391,172,219,160979.56,204477.05,365456.61
510880,201708,62,48,14,44957.63,13118,58075.63
510885,201708,69,41,28,38398.63,26198.89,64597.52
510890,201708,73,40,33,37480,30921,68401
510895,201708,184,105,79,98385,73719.63,172104.63
520005,201708,24,17,7,15929,6559,22488
520010,201708,281,122,159,114314,148890,263204
520013,201708,620,363,257,340094.63,240527.9,580622.53
520015,201708,51,35,16,32795,14992,47787
520017,201708,102,59,43,55002,40291,95293
520020,201708,30,15,15,14055,14055,28110
520025,201708,2000,1090,910,1020224.4,851812.7,1872037.1
520030,201708,802,399,403,372917,376674,749591
520050,201708,75,49,26,45913,24362,70275
520055,201708,43,29,14,27173,13118,40291
520060,201708,177,112,65,104944,60905,165849
520080,201708,584,399,185,373863,173340.32,547203.32
520082,201708,20,14,6,13118,5622,18740
520085,201708,97,72,25,67464,23425,90889
520090,201708,82,57,25,53409,23425,76834
520110,201708,9067,3891,5176,3639261.91,4846110.7,8485372.61
520120,201708,13,8,5,7299.23,4685,11984.23
520130,201708,747,529,218,495664,204257,699921
520140,201708,11723,6600,5123,6176616.95,4797695.85,10974312.80
520145,201708,44,32,12,29984,11244,41228
520150,201708,189,148,41,138676,38417,177093
520160,201708,33,23,10,21551,9370,30921
520170,201708,226,138,88,129275,82420,211695
520180,201708,110,55,55,51535,51535,103070
520215,201708,213,129,84,120591.9,78426.9,199018.8
520235,201708,69,52,17,48724,15929,64653
520250,201708,138,86,52,80582,48442.9,129024.9
520260,201708,111,72,39,67464,35606,103070
520280,201708,50,36,14,33077,13118,46195
520310,201708,41,26,15,24362,14055,38417
520320,201708,167,105,62,98385,58094,156479
520330,201708,782,412,370,385998.63,346663,732661.63
520340,201708,355,202,153,189274,143342.63,332616.63
520350,201708,517,232,285,217384,266999,484383
520355,201708,95,53,42,49661,39354,89015
520357,201708,25,17,8,15929,7496,23425
520360,201708,0,0,0,0,0,0
520380,201708,144,77,67,72149,62759,134908
520390,201708,296,126,170,117500,159280.63,276780.63
520393,201708,12,9,3,8433,2811,11244
520396,201708,97,59,38,55283,35606,90889
520400,201708,230,135,95,124903.1,89015,213918.1
520410,201708,195,99,96,92754,89943,182697
520420,201708,25,17,8,15929,7496,23425
520425,201708,302,134,168,124622,156948.6,281570.6
520430,201708,439,232,207,217102.9,193904,411006.9
520440,201708,595,394,201,369178,188337,557515
520450,201708,1881,855,1026,800039.63,960717.32,1760756.95
520455,201708,59,40,19,37480,17803,55283
520460,201708,29,15,14,14055,13118,27173
520465,201708,22,19,3,17803,2811,20614
520470,201708,421,258,163,241546,152731,394277
520480,201708,84,46,38,43102,35552,78654
520485,201708,128,45,83,42165,77490,119655
520490,201708,385,289,96,270612.26,89790.84,360403.10
520495,201708,183,107,76,100259,71212,171471
520500,201708,183,138,45,129306,42165,171471
520505,201708,168,87,81,81519,75897,157416
520510,201708,1737,848,889,790490.19,830666.17,1621156.36
520520,201708,43,31,12,29047,11244,40291
520530,201708,235,171,64,157877.89,59182.79,217060.68
520540,201708,506,331,175,308863.81,163975,472838.81
520545,201708,156,86,70,80582,65590,146172
520547,201708,48,27,21,25299,19677,44976
520549,201708,1023,479,544,448505,509191,957696
520551,201708,297,155,142,145235,133054,278289
520552,201708,44,26,18,24362,16866,41228
520570,201708,17,9,8,8433,7496,15929
520580,201708,286,171,115,160218,107755,267973
520590,201708,159,93,66,87141,61560.9,148701.9
520620,201708,1133,536,597,501483.14,558536.53,1060019.67
520630,201708,42,25,17,23425,15929,39354
520640,201708,411,238,173,223006,162101,385107
520650,201708,53,39,14,36543,13118,49661
520660,201708,34,18,16,16866,14992,31858
520670,201708,31,26,5,24362,4685,29047
520680,201708,62,40,22,37480,20614,58094
520690,201708,33,13,20,12171.63,18731,30902.63
520710,201708,36,32,4,29984,3748,33732
520725,201708,199,126,73,118062,68401,186463
520735,201708,56,43,13,40291,12181,52472
520740,201708,399,192,207,179202.2,193950,373152.2
520750,201708,37,27,10,25299,9370,34669
520753,201708,53,38,15,35606,14055,49661
520760,201708,107,72,35,67464,32795,100259
520780,201708,276,213,63,199581,59031,258612
520790,201708,170,79,91,73741.9,85267,159008.9
520800,201708,3537,1865,1672,1743978.78,1565994.77,3309973.55
520810,201708,167,114,53,106818,49661,156479
520815,201708,6,5,1,4685,937,5622
520830,201708,137,89,48,83393,44976,128369
520840,201708,331,217,114,202860.5,106818,309678.5
520850,201708,110,71,39,66518,36393.08,102911.08
520860,201708,1657,1040,617,972569.23,576724.6,1549293.83
520870,201708,30449,15017,15432,14044615.71,14445276.14,28489891.85
520880,201708,1001,563,438,527250,410387.26,937637.26
520890,201708,790,454,336,423805.2,314631.63,738436.83
520910,201708,1026,531,495,494035.31,463815,957850.31
520915,201708,99,75,24,70275,22478.63,92753.63
520920,201708,412,201,211,187774.8,197707,385481.8
520929,201708,22,20,2,18740,1874,20614
520940,201708,76,46,30,43102,28110,71212
520945,201708,23,15,8,14055,7496,21551
520960,201708,50,31,19,29047,17803,46850
520970,201708,322,200,122,186782,114032.9,300814.9
520980,201708,95,71,24,66527,22488,89015
520990,201708,477,320,157,299615.12,147109,446724.12
520993,201708,123,58,65,54346,60896,115242
520995,201708,244,135,109,125559,101571,227130
521000,201708,1548,889,659,831307.3,617241,1448548.3
521010,201708,669,305,364,285458.53,341012.52,626471.05
521015,201708,17,9,8,8433,7496,15929
521020,201708,1476,1015,461,950436.95,431592.41,1382029.36
521030,201708,40,27,13,25299,12181,37480
521040,201708,901,547,354,512306,331417,843723
521056,201708,42,29,13,27173,12181,39354
521060,201708,133,82,51,76834,47787,124621
521080,201708,504,372,132,348555,123684,472239
521090,201708,532,318,214,297966,200246.27,498212.27
521100,201708,289,212,77,198635,72149,270784
521120,201708,1030,701,329,655057.4,307983,963040.4
521130,201708,360,257,103,240809,95921.8,336730.8
521140,201708,186,106,80,99322,74960,174282
521150,201708,2791,1208,1583,1129686.14,1482020.85,2611706.99
521160,201708,31,17,14,15929,13118,29047
521170,201708,192,112,80,104934.63,74960,179894.63
521180,201708,1114,694,420,648676.53,392838.1,1041514.63
521190,201708,2565,1073,1492,1005382.26,1396775.16,2402157.42
521200,201708,44,32,12,29984,11244,41228
521205,201708,17,12,5,11244,4685,15929
521210,201708,152,85,67,79645,62779,142424
521220,201708,805,539,266,502457.78,249187,751644.78
521225,201708,28,18,10,16866,9370,26236
521230,201708,112,72,40,67182.9,37480,104662.9
521250,201708,6539,3678,2861,3439604.5,2677928.93,6117533.43
521260,201708,18,13,5,12181,4685,16866
521270,201708,151,116,35,108692,32795,141487
521280,201708,437,252,185,235468.1,173345,408813.1
521290,201708,34,14,20,13118,18740,31858
521295,201708,101,67,34,62554.12,31858,94412.12
521300,201708,221,111,110,103989,102706.89,206695.89
521305,201708,36,24,12,22488,11244,33732
521308,201708,1074,766,308,717241.41,288296.63,1005538.04
521310,201708,1344,796,548,744777.1,512596.26,1257373.36
521340,201708,22,17,5,15929,4685,20614
521350,201708,132,96,36,89952,33732,123684
521370,201708,193,119,74,110566,69056.9,179622.9
521375,201708,194,108,86,101196,80300.9,181496.9
521377,201708,52,35,17,32795,15929,48724
521380,201708,1053,691,362,643113.26,339194,982307.26
521385,201708,19,11,8,10307,7496,17803
521390,201708,111,89,22,83080.7,20614,103694.7
521400,201708,332,206,126,192740.9,118015.15,310756.05
521405,201708,150,76,74,71212,69338,140550
521410,201708,70,47,23,44039,21551,65590
521440,201708,222,154,68,143501.55,63716,207217.55
521450,201708,714,387,327,362619,305743.1,668362.1
521460,201708,1177,708,469,663115,439434.26,1102549.26
521470,201708,14,9,5,8433,4685,13118
521480,201708,52,34,18,31858,16802,48660
521483,201708,301,159,142,148702,133054,281756
521486,201708,295,186,109,174160.19,101478,275638.19
521487,201708,24,11,13,10307,12181,22488
521490,201708,29,17,12,15929,11244,27173
521500,201708,112,73,39,68401,36543,104944
521520,201708,43,32,11,29984,10307,40291
521523,201708,560,344,216,320044.9,202392,522436.9
521525,201708,47,31,16,29047,14992,44039
521530,201708,249,130,119,121810,111503,233313
521540,201708,31,17,14,15929,13118,29047
521550,201708,91,40,51,37180.63,47750.63,84931.26
521560,201708,780,539,241,504302.87,225536,729838.87
521565,201708,45,31,14,29047,13118,42165
521570,201708,485,322,163,301704.63,152638.15,454342.78
521580,201708,62,39,23,36543,21551,58094
521590,201708,34,18,16,16866,14992,31858
521600,201708,28,16,12,14992,11244,26236
521630,201708,233,118,115,110556.63,106781.88,217338.51
521640,201708,300,151,149,141487,139613,281100
521645,201708,29,15,14,14055,13118,27173
521680,201708,229,141,88,132117,82456,214573
521690,201708,1,1,0,937,0,937
521710,201708,1180,555,625,519472.9,585616,1105088.9
521720,201708,510,334,176,312948.63,164865.26,477813.89
521730,201708,628,311,317,291407,295942.18,587349.18
521740,201708,920,366,554,342914.26,517918.96,860833.22
521760,201708,1554,833,721,778971.52,675269,1454240.52
521770,201708,787,500,287,468500,268459.87,736959.87
521800,201708,2097,1293,804,1208997.2,752368.79,1961365.99
521805,201708,34,20,14,18736,13118,31854
521810,201708,98,59,39,54158.9,36543,90701.9
521830,201708,950,662,288,618702.08,269847,888549.08
521839,201708,94,63,31,59031,29047,88078
521850,201708,1095,590,505,551437.26,472855.04,1024292.30
521860,201708,348,213,135,199581,126214,325795
521870,201708,69,38,31,35606,29047,64653
521878,201708,43,20,23,18740,21551,40291
521880,201708,4326,1935,2391,1811033.24,2238144.31,4049177.55
521890,201708,564,386,178,361682,166495.9,528177.9
521900,201708,297,241,56,224911.2,52472,277383.2
521910,201708,154,109,45,102133,42165,144298
521920,201708,55,26,29,24362,27173,51535
521925,201708,34,21,13,19677,12181,31858
521930,201708,1096,627,469,587305.19,438505.53,1025810.72
521935,201708,33,25,8,23425,7496,30921
521940,201708,196,100,96,93700,89952,183652
521945,201708,16,14,2,13118,1874,14992
521950,201708,7,5,2,4685,1874,6559
521960,201708,75,55,20,51535,18740,70275
521970,201708,409,257,152,240527.9,142424,382951.9
521971,201708,97,48,49,44976,45913,90889
521973,201708,31,13,18,12181,16866,29047
521975,201708,1069,561,508,524533.6,475003.73,999537.33
521980,201708,242,165,77,154446,72149,226595
521990,201708,70,54,16,50598,14992,65590
522000,201708,289,181,108,169597,101196,270793
522005,201708,22,14,8,13118,7496,20614
522010,201708,1115,622,493,581868,461369.43,1043237.43
522015,201708,56,33,23,30912,21551,52463
522020,201708,872,453,419,424461,391554.26,816015.26
522026,201708,29,20,9,18740,8433,27173
522028,201708,17,13,4,12181,3748,15929
522040,201708,726,284,442,265818,414099.63,679917.63
522045,201708,1981,1249,732,1169202.43,685078.8,1854281.23
522050,201708,173,83,90,77771,84330,162101
522060,201708,548,350,198,327668.9,185432.3,513101.2
522068,201708,138,89,49,83393,45913,129306
522070,201708,12,12,0,11244,0,11244
522100,201708,46,24,22,22226,20614,42840
522108,201708,40,30,10,28110,9370,37480
522119,201708,60,29,31,27173,29047,56220
522130,201708,76,23,53,21551,49625,71176
522140,201708,3665,1870,1795,1747923.92,1680070.05,3427993.97
522145,201708,56,34,22,31858,20614,52472
522150,201708,64,51,13,47787,12181,59968
522155,201708,56,40,16,37471,14992,52463
522157,201708,6,4,2,3748,1874,5622
522160,201708,1747,1020,727,954615.6,680908.9,1635524.5
522170,201708,400,265,135,248305,126495,374800
522180,201708,36,20,16,18740,14992,33732
522185,201708,1312,547,765,508878.57,716643.88,1225522.45
522190,201708,48,27,21,25299,19583.3,44882.3
522200,201708,299,181,118,169597,110566,280163
522205,201708,169,115,54,107755,50598,158353
522220,201708,174,123,51,115251,47787,163038
522230,201708,32,25,7,23425,6559,29984
530010,201708,54345,28017,26328,26116806.5,24614987.32,50731793.82
110001,201709,507,400,107,373351.65,99504.86,472856.51
110002,201709,2692,1588,1104,1484557.27,1031762.29,2516319.56
110003,201709,90,72,18,67424,16866,84290
110004,201709,1965,1252,713,1168508.95,666151.99,1834660.94
110005,201709,435,351,84,328285.67,78618.52,406904.19
110006,201709,444,344,100,321706.35,93499.89,415206.24
110007,201709,83,67,16,62658.78,14972,77630.78
110008,201709,231,132,99,122506.67,92642.45,215149.12
110009,201709,757,507,250,473399.9,233572.79,706972.69
110010,201709,1772,1099,673,1027868.31,629979.92,1657848.23
110011,201709,1881,1445,436,1348428.09,407179.44,1755607.53
110012,201709,4089,2361,1728,2204556.42,1615975,3820531.42
110013,201709,744,553,191,516447.12,178566.23,695013.35
110014,201709,362,307,55,287198.45,51470.32,338668.77
110015,201709,1443,1158,285,1081042.85,265903.4,1346946.25
110018,201709,1111,659,452,615456.04,422729.45,1038185.49
110020,201709,15221,8895,6326,8291368.68,5917199.62,14208568.30
110025,201709,624,454,170,422882.58,159039.9,581922.48
110026,201709,41,30,11,28029.67,10226.67,38256.34
110028,201709,1625,1171,454,1089769.05,422187.28,1511956.33
110029,201709,136,119,17,111322.67,15929,127251.67
110030,201709,2458,1650,808,1540699.69,754977.34,2295677.03
110032,201709,385,294,91,274632.68,85142.45,359775.13
110033,201709,649,497,152,462972.58,141998.67,604971.25
110034,201709,359,263,96,243819.34,89176.1,332995.44
110037,201709,105,85,20,79584.78,18719.89,98304.67
110040,201709,321,215,106,201214.56,99121.67,300336.23
110045,201709,913,596,317,555880.95,295311.34,851192.29
110050,201709,97,78,19,72965.89,17783,90748.89
110060,201709,90,46,44,43001.89,41228,84229.89
110070,201709,127,74,53,69277.78,49299.78,118577.56
110080,201709,397,229,168,212189.14,157287.59,369476.73
110090,201709,30,25,5,23404.89,4664.89,28069.78
110092,201709,106,60,46,56039.34,42831.01,98870.35
110094,201709,202,140,62,130739.34,58013.67,188753.01
110100,201709,27,22,5,20574,4664.89,25238.89
110110,201709,70,44,26,41228,24061,65289
110120,201709,74,58,16,54286,14931.89,69217.89
110130,201709,301,245,56,227615.93,52351.78,279967.71
110140,201709,247,160,87,149531.94,81409.3,230941.24
110143,201709,44,38,6,35505.78,5601.89,41107.67
110145,201709,28,20,8,18700,7476,26176
110146,201709,22,11,11,10307,10266.89,20573.89
110147,201709,40,31,9,28785.89,8433,37218.89
110148,201709,38,26,12,24270.35,11224,35494.35
110149,201709,296,208,88,194253.36,82255.01,276508.37
110150,201709,82,53,29,49600.78,26746.45,76347.23
110155,201709,9,7,2,6539,1854,8393
110160,201709,72,60,12,56019.23,11183.78,67203.01
110170,201709,215,175,40,163694.89,37359.78,201054.67
110175,201709,27,21,6,19636.89,5601.89,25238.78
110180,201709,94,83,11,77731,10287,88018
120001,201709,127,87,40,81477,37472,118949
120005,201709,192,122,70,114271.12,65403,179674.12
120010,201709,1000,645,355,597943.27,330336.52,928279.79
120013,201709,136,93,43,86435,39303.86,125738.86
120017,201709,81,56,25,52363.48,23404,75767.48
120020,201709,3461,2750,711,2547645.74,662660.26,3210306.00
120025,201709,601,337,264,312829.67,246238.46,559068.13
120030,201709,1033,857,176,795631.25,164167.12,959798.37
120032,201709,47,39,8,36521.12,7496,44017.12
120033,201709,214,188,26,175814.94,24362,200176.94
120034,201709,152,110,42,101174.12,39310.24,140484.36
120035,201709,28,18,10,16866,9370,26236
120038,201709,381,242,139,225943.2,130199.24,356142.44
120039,201709,21,19,2,17803,1874,19677
120040,201709,13924,9613,4311,8882513.93,3998239.42,12880753.35
120042,201709,42,36,6,33732,5622,39354
120043,201709,12,2,10,1874,9370,11244
120045,201709,537,341,196,317979.05,183387.48,501366.53
120050,201709,1244,949,295,883757.02,276043.46,1159800.48
120060,201709,1368,1103,265,1017275.28,244461.62,1261736.90
120070,201709,506,361,145,332219.58,134500.95,466720.53
120080,201709,144,91,53,84090.73,49098.55,133189.28
130002,201709,150,104,46,97448,43102,140550
130006,201709,76,43,33,40291,30921,71212
130008,201709,142,76,66,70491.72,61119.96,131611.68
130010,201709,139,73,66,68401,61842,130243
130014,201709,242,175,67,163975,62779,226754
130020,201709,83,46,37,43102,34669,77771
130030,201709,877,541,336,506917,314822.63,821739.63
130040,201709,318,162,156,151794,144533.09,296327.09
130050,201709,550,308,242,288314.9,226754,515068.9
130060,201709,873,597,276,554262.3,255775.34,810037.64
130063,201709,539,285,254,267045,237976.12,505021.12
130068,201709,189,122,67,114314,62497.9,176811.9
130070,201709,1325,920,405,836240.1,370072.36,1206312.46
130080,201709,663,433,230,405346.2,215501,620847.2
130083,201709,69,37,32,34669,29984,64653
130090,201709,376,188,188,174506.88,176156,350662.88
130100,201709,1113,520,593,487240,555359.9,1042599.9
130110,201709,707,313,394,293131,369178,662309
130115,201709,175,71,104,66527,97448,163975
130120,201709,1610,1012,598,948244,560326,1508570
130130,201709,625,422,203,395414,190211,585625
130140,201709,1544,1160,384,1086289.95,358871.1,1445161.05
130150,201709,427,359,68,336383,63716,400099
130160,201709,476,263,213,246431,199581,446012
130165,201709,25,18,7,16866,6559,23425
130170,201709,952,671,281,628637.55,263297,891934.55
130180,201709,156,94,62,87609.5,58094,145703.5
130185,201709,2124,1131,993,1057852.89,929858.89,1987711.78
130190,201709,3585,2264,1321,2117620.4,1236217.09,3353837.49
130195,201709,293,235,58,220195,54346,274541
130200,201709,182,81,101,75887.63,94637,170524.63
130210,201709,76,36,40,33732,37480,71212
130220,201709,186,126,60,118062,56220,174282
130230,201709,330,207,123,193959,115251,309210
130240,201709,1466,918,548,858850.2,512628.12,1371478.32
130250,201709,4652,3003,1649,2809292.6,1544979.93,4354272.53
130255,201709,418,208,210,194896,196488.9,391384.9
130260,201709,52271,24894,27377,23292549.32,25644162.17,48936711.49
130270,201709,1458,941,517,881248.5,484429,1365677.5
130280,201709,110,67,43,62779,40291,103070
130290,201709,2074,1517,557,1421024.22,521627.9,1942652.12
130300,201709,422,304,118,284566.9,110566,395132.9
130310,201709,900,486,414,455382,387918,843300
130320,201709,445,236,209,220195,195833,416028
130330,201709,699,428,271,401036,253645.9,654681.9
130340,201709,3198,1960,1238,1832594.2,1158600.6,2991194.8
130350,201709,489,303,186,283788.57,174282,458070.57
130353,201709,743,305,438,285504,410406,695910
130356,201709,731,334,397,312958,371707.9,684665.9
130360,201709,71,42,29,39354,27173,66527
130370,201709,690,495,195,463815,182715,646530
130380,201709,649,438,211,410406,197707,608113
130390,201709,497,394,103,369178,96511,465689
130395,201709,176,41,135,38417,126495,164912
130400,201709,66,46,20,43102,18740,61842
130406,201709,2058,1310,748,1223925.15,700248.16,1924173.31
130410,201709,520,221,299,207077,280144.26,487221.26
130420,201709,3184,2537,647,2374077.25,606239,2980316.25
130423,201709,165,76,89,71212,83393,154605
130426,201709,140,82,58,76834,54346,131180
130430,201709,407,270,137,252990,128369,381359
130440,201709,201,72,129,67464,120873,188337
140002,201709,36,14,22,13118,20614,33732
140005,201709,199,121,78,113142.75,73086,186228.75
140010,201709,10297,6954,3343,6483542.09,3129184.12,9612726.21
140015,201709,158,70,88,65590,82456,148046
140017,201709,105,71,34,66527,31858,98385
140020,201709,479,323,156,301714,146172,447886
140023,201709,23,15,8,13559,7496,21055
140028,201709,17,12,5,11244,4685,15929
140030,201709,360,252,108,236124,100605.69,336729.69
140040,201709,53,37,16,34669,14898.3,49567.3
140045,201709,250,118,132,109910.1,123684,233594.1
140047,201709,549,365,184,339150.81,171658.5,510809.31
140050,201709,155,100,55,92902,51535,144437
140060,201709,34,24,10,21766.51,9370,31136.51
140070,201709,31,29,2,27173,1874,29047
150010,201709,4703,2916,1787,2729621.75,1672337.66,4401959.41
150013,201709,140,93,47,87141,44039,131180
150020,201709,1099,572,527,535964,493799,1029763
150030,201709,748,303,445,283911,416965,700876
150034,201709,185,114,71,106818,66527,173345
150040,201709,1359,812,547,760844,512539,1273383
150050,201709,718,425,293,397241.9,274341,671582.9
150060,201709,4668,3024,1644,2829797.88,1539903.28,4369701.16
150070,201709,313,141,172,132117,161164,293281
150080,201709,14447,7222,7225,6757912.02,6762541.66,13520453.68
150085,201709,360,227,133,212689.63,124621,337310.63
150090,201709,760,650,110,609050,103070,712120
150095,201709,348,211,137,196950.84,127563.18,324514.02
150100,201709,53,37,16,34669,14992,49661
150110,201709,169,82,87,76834,81519,158353
150120,201709,432,321,111,300777,104007,404784
150125,201709,48,21,27,19677,25299,44976
150130,201709,1892,1002,890,938874,833925.32,1772799.32
150140,201709,54521,25405,29116,23772172.69,27268624.57,51040797.26
150145,201709,170,100,70,93700,65590,159290
150150,201709,2767,1201,1566,1125123.37,1463467.7,2588591.07
150157,201709,446,300,146,281100,136797.32,417897.32
150160,201709,119,94,25,88078,23425,111503
150170,201709,3656,2706,950,2532617.4,889868.9,3422486.3
150172,201709,306,212,94,198644,88078,286722
150175,201709,89,56,33,52472,30921,83393
150178,201709,743,491,252,459130,236124,695254
150180,201709,2985,1424,1561,1333491.8,1462353.18,2795844.98
150190,201709,335,213,122,199581,114314,313895
150195,201709,119,59,60,55283,56220,111503
150200,201709,211,99,112,92763,104944,197707
150210,201709,3111,2521,590,2361137.84,552591.75,2913729.59
150215,201709,489,327,162,306118,151794,457912
150220,201709,3975,2664,1311,2494353.9,1226328.36,3720682.26
150230,201709,1140,913,227,854911.7,212699,1067610.7
150240,201709,5672,3311,2361,3099025.97,2212244,5311269.97
150250,201709,30,15,15,14055,14055,28110
150260,201709,72,42,30,39354,28110,67464
150270,201709,2297,1508,789,1411727.14,738730.9,2150458.04
150275,201709,586,354,232,331698,217384,549082
150276,201709,101,42,59,39354,55283,94637
150277,201709,751,326,425,305443.63,398225,703668.63
150280,201709,345,211,134,197707,125558,323265
150285,201709,75,37,38,34669,35606,70275
150290,201709,953,579,374,542232.53,350157,892389.53
150293,201709,690,318,372,297544.63,348564,646108.63
150295,201709,460,200,260,187400,243488.82,430888.82
150300,201709,80,43,37,40291,34669,74960
150304,201709,137,88,49,82456,45913,128369
150307,201709,392,321,71,300777,66527,367304
150309,201709,527,377,150,353249,140550,493799
150310,201709,252,170,82,159290,76834,236124
150320,201709,1787,1227,560,1149422.59,524720,1674142.59
150330,201709,2071,1186,885,1110626.1,829245,1939871.1
150340,201709,195,127,68,118764.75,63716,182480.75
150345,201709,602,322,280,301535.97,262360,563895.97
150350,201709,426,333,93,309669.13,87141,396810.13
150360,201709,4403,2834,1569,2651855.74,1470134.26,4121990.00
150370,201709,733,523,210,489269,196479.9,685748.9
150375,201709,196,106,90,99322,84330,183652
150380,201709,1231,802,429,751474,401411,1152885
150390,201709,728,416,312,389792,292335,682127
150400,201709,96,77,19,72149,17803,89952
150405,201709,1236,814,422,761693.86,394851.8,1156545.66
150410,201709,146,94,52,88078,48724,136802
150420,201709,7273,3972,3301,3720132.44,3091845.86,6811978.30
150430,201709,471,318,153,297966,143361,441327
150440,201709,598,352,246,329075,230502,559577
150442,201709,2126,1156,970,1081260.52,908604.22,1989864.74
150445,201709,519,325,194,304525,180841,485366
150450,201709,270,126,144,118062,134928,252990
150460,201709,779,586,193,547287.66,180822.26,728109.92
150470,201709,1333,800,533,749319,499421,1248740
150475,201709,29,23,6,21551,5622,27173
150480,201709,1224,855,369,801135,345471.9,1146606.9
150490,201709,629,336,293,314832,274541,589373
150495,201709,320,219,101,205203,94637,299840
150497,201709,295,201,94,188337,88068.63,276405.63
150500,201709,429,289,140,270793,131180,401973
150503,201709,808,384,424,359527,397270,756797
150506,201709,1037,662,375,620294,351366,971660
150510,201709,1222,691,531,647186,497547,1144733
150520,201709,266,178,88,166786,82456,249242
150530,201709,1525,836,689,780521.65,644374.9,1424896.55
150540,201709,239,167,72,156479,67464,223943
150543,201709,674,375,299,351075.16,279881.9,630957.06
150548,201709,485,333,152,312021,142424,454445
150549,201709,60,41,19,38417,17803,56220
150550,201709,2871,1494,1377,1399176,1289687,2688863
150553,201709,2997,1778,1219,1664487.3,1141922,2806409.3
150555,201709,139,72,67,67464,62779,130243
150560,201709,53,39,14,36543,13118,49661
150563,201709,68,36,32,33732,29984,63716
150565,201709,164,97,67,90849,62779,153628
150570,201709,400,268,132,251097.26,123684,374781.26
150580,201709,1497,618,879,578410.1,823623,1402033.1
150590,201709,765,456,309,427272,289533,716805
150600,201709,442,272,170,254864,159290,414154
150610,201709,144,124,20,115355,18740,134095
150611,201709,128,89,39,83393,36543,119936
150613,201709,3121,1909,1212,1788733,1135635,2924368
150616,201709,478,298,180,278992,168660,447652
150618,201709,1115,607,508,568534.49,475996,1044530.49
150619,201709,395,300,95,281100,89015,370115
150620,201709,1278,733,545,686821,510383.9,1197204.9
150630,201709,313,210,103,196770,96511,293281
150635,201709,496,202,294,189274,275478,464752
150640,201709,62,30,32,28110,29984,58094
150650,201709,2309,1328,981,1244064.27,917974.22,2162038.49
150655,201709,253,186,67,174282,62779,237061
150658,201709,97,56,41,52472,38417,90889
150660,201709,480,332,148,311084,138676,449760
150670,201709,987,354,633,331407.9,593102.63,924510.53
150680,201709,9669,5313,4356,4972830.13,4077497.59,9050327.72
150690,201709,52,33,19,30921,17803,48724
150700,201709,552,354,198,331510.6,185526,517036.6
150710,201709,262,159,103,148983,96511,245494
150715,201709,872,522,350,488149.26,327921.89,816071.15
150720,201709,454,341,113,319517,105599.9,425116.9
150730,201709,879,464,415,434759,388573.9,823332.9
150740,201709,239,172,67,161164,62779,223943
150745,201709,785,405,380,379485,356060,735545
150746,201709,54,33,21,30921,19677,50598
150747,201709,269,210,59,196770,55283,252053
150750,201709,130,75,55,70275,51535,121810
150760,201709,1705,1100,605,1030418.9,566885,1597303.9
150770,201709,360,183,177,171471,165677.07,337148.07
150775,201709,79,37,42,34669,39354,74023
150780,201709,180,98,82,91826,76834,168660
150790,201709,902,485,417,454445,390729,845174
150795,201709,1421,823,598,771151,560326,1331477
150796,201709,411,234,177,219258,165849,385107
150797,201709,270,153,117,143361,109629,252990
150800,201709,1412,847,565,792697.31,529405,1322102.31
150803,201709,587,485,102,454445,95574,550019
150805,201709,186,117,69,109629,64639.63,174268.63
150808,201709,963,529,434,495392,406658,902050
150810,201709,3350,2301,1049,2150501.48,982613.26,3133114.74
150812,201709,427,224,203,209888,190211,400099
150815,201709,945,622,323,581460.04,302651,884111.04
150820,201709,1581,968,613,906079,574362.26,1480441.26
150830,201709,837,590,247,551893,231439,783332
150835,201709,183,109,74,102133,69338,171471
150840,201709,1285,821,464,769277,434768,1204045
160005,201709,52,31,21,29047,19677,48724
160010,201709,195,120,75,112440,70271,182711
160015,201709,116,67,49,62779,45913,108692
160020,201709,120,68,52,63716,48724,112440
160021,201709,40,21,19,19677,17803,37480
160023,201709,109,60,49,56220,45913,102133
160025,201709,34,15,19,14055,17803,31858
160027,201709,1437,816,621,761125.35,581140,1342265.35
160030,201709,15350,7845,7505,7340963.33,7026295,14367258.33
160040,201709,314,178,136,166786,127432,294218
160050,201709,635,328,307,307336,287377.9,594713.9
160053,201709,333,188,145,175875,135865,311740
160055,201709,19,14,5,13118,4685,17803
160060,201709,6335,3294,3041,3076502.74,2848476.1,5924978.84
160070,201709,161,97,64,90889,59968,150857
160080,201709,77,41,36,38417,33732,72149
170025,201709,22,15,7,14055,6559,20614
170030,201709,218,173,45,161907,42165,204072
170035,201709,225,108,117,100259,109629,209888
170040,201709,187,146,41,136520.9,38417,174937.9
170070,201709,331,189,142,177093,133054,310147
170100,201709,380,269,111,251819,104007,355826
170105,201709,63,51,12,47787,11244,59031
170110,201709,100,61,39,57157,36543,93700
170130,201709,72,32,40,29984,37199,67183
170190,201709,105,67,38,62779,35606,98385
170200,201709,396,265,131,247640.1,122644.78,370284.88
170210,201709,5976,3071,2905,2869294.53,2718781.33,5588075.86
170215,201709,71,35,36,32795,33732,66527
170220,201709,1443,1053,390,984299.76,365149,1349448.76
170230,201709,155,99,56,92763,52472,145235
170240,201709,568,374,194,350438,181778,532216
170255,201709,1112,888,224,832056,209606.9,1041662.9
170270,201709,38,28,10,26236,9182.6,35418.6
170290,201709,77,58,19,54346,17803,72149
170300,201709,81,52,29,47974.4,27173,75147.4
170305,201709,38,31,7,29047,6559,35606
170307,201709,61,45,16,42165,14992,57157
170310,201709,103,56,47,52472,44039,96511
170320,201709,17,13,4,12181,3748,15929
170330,201709,19,16,3,14992,2811,17803
170360,201709,22,15,7,14055,6559,20614
170370,201709,168,81,87,75897,81519,157416
170380,201709,82,58,24,54346,22488,76834
170382,201709,48,43,5,40291,4685,44976
170384,201709,123,87,36,81519,33732,115251
170386,201709,60,28,32,26236,29984,56220
170388,201709,48,17,31,15929,29047,44976
170389,201709,23,17,6,15929,5622,21551
170390,201709,49,28,21,26236,19677,45913
170410,201709,32,21,11,19677,10307,29984
170460,201709,17,12,5,11244,4685,15929
170510,201709,28,21,7,19677,6559,26236
170550,201709,1478,833,645,780521,603615.5,1384136.5
170555,201709,110,74,36,69338,33732,103070
170560,201709,99,70,29,65590,27173,92763
170600,201709,37,18,19,16866,17803,34669
170610,201709,191,102,89,95419.4,83375,178794.4
170625,201709,37,18,19,16866,17803,34669
170650,201709,84,63,21,59031,19677,78708
170700,201709,552,416,136,388808.15,127432,516240.15
170710,201709,153,94,59,88078,55274,143352
170720,201709,82,68,14,63716,13118,76834
170730,201709,56,33,23,30921,21551,52472
170740,201709,72,53,19,49661,17803,67464
170755,201709,113,53,60,49052,56220,105272
170765,201709,148,70,78,64981,73086,138067
170770,201709,227,129,98,119795.45,91826,211621.45
170820,201709,588,381,207,356997,193819,550816
170825,201709,29,18,11,16866,10307,27173
170830,201709,75,52,23,48536.6,21551,70087.6
170900,201709,204,153,51,143361,47787,191148
170930,201709,791,404,387,378230,362057,740287
170950,201709,2967,1288,1679,1204542.88,1570955.93,2775498.81
170980,201709,17,9,8,8433,7496,15929
171050,201709,126,95,31,89015,29047,118062
171070,201709,36,29,7,27173,6559,33732
171090,201709,38,27,11,25299,10307,35606
171110,201709,21,14,7,13118,6559,19677
171150,201709,36,18,18,16866,16866,33732
171180,201709,22,10,12,9370,11244,20614
171190,201709,126,74,52,69338,48724,118062
171195,201709,63,48,15,44976,14055,59031
171200,201709,46,21,25,19677,23425,43102
171215,201709,1,1,0,937,0,937
171240,201709,54,44,10,41228,9370,50598
171245,201709,49,44,5,41228,4685,45913
171250,201709,67,34,33,31858,30911.63,62769.63
171270,201709,17,13,4,12181,3748,15929
171280,201709,36,33,3,30781,2811,33592
171320,201709,987,557,430,521909,401973,923882
171330,201709,411,195,216,182715,202392,385107
171360,201709,82,61,21,57157,19677,76834
171370,201709,22,11,11,10307,10307,20614
171380,201709,127,103,24,96511,22262.19,118773.19
171395,201709,54,34,20,31858,18740,50598
171420,201709,315,208,107,194896,99977.9,294873.9
171430,201709,62,50,12,46850,11244,58094
171488,201709,212,110,102,103070,95574,198644
171500,201709,57,31,26,29047,24362,53409
171510,201709,66,44,22,41228,20614,61842
171515,201709,44,37,7,34669,6559,41228
171525,201709,30,26,4,24362,3748,28110
171550,201709,12,6,6,5622,5622,11244
171570,201709,59,29,30,27173,28110,55283
171575,201709,349,210,139,196630,130233.63,326863.63
171610,201709,1660,822,838,768348.83,783637.99,1551986.82
171620,201709,133,90,43,83786.54,40009.9,123796.44
171630,201709,53,28,25,26236,23425,49661
171650,201709,276,178,98,166786,91826,258612
171660,201709,255,134,121,125558,113377,238935
171665,201709,42,27,15,25299,14055,39354
171670,201709,437,254,183,236349.13,170908.8,407257.93
171700,201709,61,54,7,50598,6559,57157
171720,201709,24,9,15,8433,14055,22488
171750,201709,102,55,47,51535,44039,95574
171780,201709,68,55,13,51535,12181,63716
171790,201709,80,66,14,61842,13118,74960
171800,201709,36,27,9,25299,8433,33732
171820,201709,1938,1106,832,1035625.47,775059.21,1810684.68
171830,201709,37,29,8,27173,7496,34669
171840,201709,61,33,28,30921,26236,57157
171845,201709,33,21,12,19677,11244,30921
171850,201709,38,26,12,24362,11244,35606
171855,201709,70,56,14,52472,13118,65590
171865,201709,7,6,1,5622,937,6559
171870,201709,31,22,9,20614,8433,29047
171875,201709,78,54,24,50598,22488,73086
171880,201709,26,19,7,17803,6559,24362
171884,201709,43,22,21,20614,19677,40291
171886,201709,113,41,72,38417,67182.9,105599.9
171888,201709,20,14,6,13118,5622,18740
171889,201709,20,15,5,14055,4685,18740
171890,201709,57,46,11,43102,10307,53409
171900,201709,42,29,13,27173,12181,39354
172000,201709,42,35,7,32795,6559,39354
172010,201709,39,32,7,29187.55,6559,35746.55
172015,201709,27,16,11,14992,10025.9,25017.9
172020,201709,127,78,49,73086,45913,118999
172025,201709,33,20,13,18740,12181,30921
172030,201709,33,19,14,17803,13118,30921
172049,201709,75,46,29,43102,27173,70275
172065,201709,152,100,52,93700,48724,142424
172080,201709,79,57,22,52248.02,20614,72862.02
172085,201709,25,13,12,12181,11244,23425
172090,201709,405,305,100,285785,92951,378736
172093,201709,27,18,9,16866,8433,25299
172097,201709,17,8,9,7496,8152,15648
172100,201709,4595,2559,2036,2390982.02,1905010.93,4295992.95
172110,201709,79,52,27,48724,25299,74023
172120,201709,1743,1490,253,1390403.2,235973.14,1626376.34
172125,201709,2,2,0,1874,0,1874
172130,201709,13,11,2,10307,1874,12181
172208,201709,189,122,67,114314,62779,177093
172210,201709,471,223,248,208951,232095,441046
210005,201709,2930,1821,1109,1702997.76,1036323,2739320.76
210010,201709,202,100,102,93700,95574,189274
210015,201709,27,18,9,16866,8433,25299
210020,201709,352,178,174,166786,163038,329824
210030,201709,344,213,131,199581,122738,322319
210040,201709,157,121,36,113377,33732,147109
210043,201709,254,170,84,159290,78708,237998
210047,201709,622,308,314,288221.2,294208.63,582429.83
210050,201709,292,210,82,196770,76834,273604
210055,201709,41,31,10,29047,9370,38417
210060,201709,572,436,136,408434.56,127432,535866.56
210070,201709,415,298,117,279226,109347.9,388573.9
210080,201709,102,93,9,87141,8433,95574
210083,201709,311,126,185,118062,173345,291407
210087,201709,50,34,16,31858,14992,46850
210090,201709,496,338,158,316706,148046,464752
210095,201709,501,355,146,332625.63,136802,469427.63
210100,201709,685,516,169,483164.05,157416.35,640580.40
210110,201709,151,80,71,74960,66527,141487
210120,201709,5531,4120,1411,3856733.3,1321157.14,5177890.44
210125,201709,218,120,98,112440,91826,204266
210130,201709,568,288,280,268919,262360,531279
210135,201709,33,19,14,17803,13118,30921
210140,201709,4057,3147,910,2945600.22,851984,3797584.22
210150,201709,355,223,132,208951,123511,332462
210160,201709,3329,2780,549,2602051.68,514132,3116183.68
210170,201709,1111,852,259,798324,242683,1041007
210173,201709,113,93,20,87141,18740,105881
210177,201709,485,230,255,215510,238935,454445
210180,201709,30,16,14,14992,13118,28110
210190,201709,404,254,150,237998,140550,378548
210193,201709,0,0,0,0,0,0
210197,201709,84,56,28,52472,26236,78708
210200,201709,642,505,137,473185,128369,601554
210203,201709,273,176,97,164912,90889,255801
210207,201709,378,290,88,271730,82456,354186
210210,201709,765,691,74,647467,69338,716805
210215,201709,75,62,13,58094,12181,70275
210220,201709,397,323,74,302651,69338,371989
210230,201709,303,222,81,208014,75897,283911
210232,201709,1510,938,572,878625,535964,1414589
210235,201709,152,116,36,108505,33732,142237
210237,201709,45,25,20,23425,18740,42165
210240,201709,96,78,18,73086,16866,89952
210250,201709,179,139,40,130243,37480,167723
210255,201709,317,229,88,214573,82456,297029
210260,201709,433,255,178,238935,166786,405721
210270,201709,706,444,262,416028,245494,661522
210275,201709,39,30,9,28110,8433,36543
210280,201709,1030,650,380,606285.45,354748.25,961033.70
210290,201709,493,312,181,292344,169597,461941
210300,201709,6157,3520,2637,3293685.53,2469680.37,5763365.90
210310,201709,101,69,32,64653,29984,94637
210312,201709,130,79,51,74023,47787,121810
210315,201709,118,84,34,78708,31858,110566
210317,201709,119,84,35,78708,32795,111503
210320,201709,2388,1949,439,1824533.98,410406,2234939.98
210325,201709,127,84,43,77771,40010,117781
210330,201709,5801,2855,2946,2670246.34,2760392.63,5430638.97
210340,201709,1438,1013,425,948395,398154.85,1346549.85
210350,201709,605,488,117,457021.75,109629,566650.75
210355,201709,128,100,28,93700,26236,119936
210360,201709,2700,1666,1034,1557951.36,968559,2526510.36
210370,201709,1271,522,749,489114,701157.1,1190271.1
210375,201709,190,98,92,91292,86204,177496
210380,201709,735,545,190,510665,178030,688695
210390,201709,194,158,36,148046,33732,181778
210400,201709,410,339,71,317643,66527,384170
210405,201709,983,643,340,601897.87,318580,920477.87
210407,201709,55,43,12,40291,11244,51535
210408,201709,67,60,7,56220,6559,62779
210409,201709,318,262,56,245494,52472,297966
210410,201709,431,331,100,310147,93691,403838
210420,201709,192,156,36,146172,33732,179904
210430,201709,33,25,8,23425,7496,30921
210440,201709,385,225,160,210825,149920,360745
210450,201709,147,110,37,103070,34669,137739
210455,201709,211,112,99,104944,92763,197707
210460,201709,341,213,128,199581,119932,319513
210462,201709,53,44,9,41228,8433,49661
210465,201709,186,130,56,121810,52472,174282
210467,201709,525,374,151,350438,141487,491925
210470,201709,45,33,12,30921,11244,42165
210480,201709,1281,891,390,834867,365430,1200297
210490,201709,224,133,91,124621,85267,209888
210500,201709,567,291,276,272667,258612,531279
210510,201709,557,423,134,396351,125558,521909
210515,201709,448,234,214,219258,200518,419776
210520,201709,403,348,55,325794.9,51535,377329.9
210530,201709,9322,4986,4336,4657644.65,4057665.72,8715310.37
210535,201709,138,98,40,91826,37480,129306
210540,201709,1543,913,630,854357.4,588904.5,1443261.9
210542,201709,1151,594,557,556203.2,521909,1078112.2
210545,201709,12,11,1,10307,937,11244
210547,201709,134,115,19,107755,17803,125558
210550,201709,753,519,234,484014.9,219258,703272.9
210560,201709,174,142,32,133054,29984,163038
210565,201709,30,21,9,19677,8433,28110
210570,201709,1382,1070,312,1002590,292334.63,1294924.63
210580,201709,107,92,15,86204,14055,100259
210590,201709,774,600,174,561450.4,163038,724488.4
210592,201709,33,29,4,27173,3748,30921
210594,201709,99,82,17,76834,15929,92763
210596,201709,79,68,11,63716,10307,74023
210598,201709,123,88,35,82456,32795,115251
210600,201709,354,297,57,278289,53409,331698
210610,201709,244,227,17,211762,15929,227691
210620,201709,48,28,20,26236,18740,44976
210630,201709,62,58,4,54346,3748,58094
210632,201709,1141,727,414,681199,387151.4,1068350.4
210635,201709,15,12,3,11244,2811,14055
210637,201709,107,75,32,70275,29984,100259
210640,201709,592,511,81,478807,75897,554704
210650,201709,406,323,83,302463.6,76834,379297.6
210660,201709,404,285,119,267045,111382,378427
210663,201709,18,11,7,10307,6559,16866
210667,201709,119,37,82,34669,76834,111503
210670,201709,269,237,32,221367,29984,251351
210675,201709,564,287,277,268919,259549,528468
210680,201709,220,135,85,126495,79645,206140
210690,201709,649,505,144,473185,134928,608113
210700,201709,192,139,53,130243,49661,179904
210710,201709,310,170,140,158821.5,131180,290001.5
210720,201709,126,104,22,97448,20614,118062
210725,201709,65,58,7,54346,6559,60905
210730,201709,23,17,6,15929,5622,21551
210735,201709,412,270,142,252990,132773,385763
210740,201709,540,456,84,427272,78708,505980
210745,201709,148,104,44,97448,41228,138676
210750,201709,2406,1058,1348,989426,1263057.26,2252483.26
210760,201709,280,202,78,189274,73071.95,262345.95
210770,201709,403,308,95,287659,88733.9,376392.9
210780,201709,418,299,119,280163,111503,391666
210790,201709,188,143,45,133991,42165,176156
210800,201709,132,99,33,92763,30921,123684
210805,201709,38,35,3,32795,2811,35606
210810,201709,488,365,123,341349.1,115251,456600.1
210820,201709,2307,1810,497,1688794.32,465689,2154483.32
210825,201709,178,91,87,85267,81519,166786
210830,201709,818,485,333,453508,311084,764592
210840,201709,218,142,76,133054,71212,204266
210845,201709,256,153,103,143361,96511,239872
210850,201709,876,557,319,521909,298903,820812
210860,201709,4181,2092,2089,1958985.9,1957374.26,3916360.16
210870,201709,471,349,122,327013,114314,441327
210880,201709,58,39,19,36543,17803,54346
210890,201709,339,277,62,259549,58094,317643
210900,201709,540,340,200,318580,187400,505980
210905,201709,77,35,42,32795,39354,72149
210910,201709,1993,1458,535,1365379.99,501295,1866674.99
210920,201709,237,68,169,63716,158353,222069
210923,201709,76,55,21,51535,19677,71212
210927,201709,446,173,273,162101,255801,417902
210930,201709,58,45,13,42165,12181,54346
210940,201709,92,68,24,63716,22488,86204
210945,201709,200,89,111,83393,104007,187400
210950,201709,503,359,144,336383,134923.32,471306.32
210955,201709,75,50,25,46850,23425,70275
210960,201709,2470,999,1471,934470.7,1378046,2312516.7
210970,201709,111,94,17,88078,15929,104007
210975,201709,83,74,9,69338,8433,77771
210980,201709,1279,532,747,498371.56,699658,1198029.56
210990,201709,4444,2709,1735,2537584,1625695,4163279
211000,201709,1392,1086,306,1017301,286440.9,1303741.9
211003,201709,926,624,302,584688,282965,867653
211010,201709,470,410,60,384170,56220,440390
211020,201709,1619,569,1050,533153,983634.49,1516787.49
211023,201709,24,21,3,19395.9,2811,22206.9
211027,201709,59,38,21,35606,19677,55283
211030,201709,381,249,132,233313,123684,356997
211040,201709,314,234,80,218977,74960,293937
211050,201709,1198,740,458,693380,428860.32,1122240.32
211060,201709,679,575,104,538775,97448,636223
211065,201709,24,20,4,18740,3748,22488
211070,201709,918,739,179,690672.97,167723,858395.97
211080,201709,89,85,4,79645,3748,83393
211085,201709,59,30,29,27829,27173,55002
211090,201709,95,77,18,72149,16866,89015
211100,201709,497,397,100,371989,93700,465689
211102,201709,273,176,97,164912,90889,255801
211105,201709,203,136,67,127432,62779,190211
211107,201709,134,74,60,69338,56220,125558
211110,201709,812,523,289,489489,270784,760273
211120,201709,5836,2348,3488,2194653.87,3267184.32,5461838.19
211125,201709,33,26,7,24362,6559,30921
211130,201709,46447,18774,27673,17561120.25,25916110.13,43477230.38
211140,201709,443,367,76,343875,71212,415087
211150,201709,1258,778,480,728658.05,449475,1178133.05
211153,201709,174,99,75,92763,70275,163038
211157,201709,56,40,16,37480,14992,52472
211160,201709,691,564,127,527519.25,118999,646518.25
211163,201709,0,0,0,0,0,0
211167,201709,5,3,2,2811,1874,4685
211170,201709,447,304,143,284848,133991,418839
211172,201709,120,79,41,74023,38417,112440
211174,201709,286,163,123,152731,115251,267982
211176,201709,530,370,160,346690,149920,496610
211178,201709,95,59,36,55283,33732,89015
211180,201709,209,161,48,150857,44816.71,195673.71
211190,201709,63,58,5,54346,4685,59031
211195,201709,24,14,10,13118,9370,22488
211200,201709,157,136,21,127094.68,19677,146771.68
211210,201709,640,314,326,293562.1,305462,599024.1
211220,201709,3940,2196,1744,2049909.29,1625921.03,3675830.32
211223,201709,95,88,7,82277.97,6559,88836.97
211227,201709,69,47,22,44039,20614,64653
211230,201709,787,633,154,592980.45,144279.26,737259.71
211240,201709,420,310,110,290470,103070,393540
211245,201709,213,88,125,82456,117125,199581
211250,201709,1648,1395,253,1306269,237061,1543330
211260,201709,797,624,173,584688,162101,746789
211270,201709,2110,1634,476,1531058,445075.1,1976133.1
211280,201709,1824,1075,749,1005402.08,701813,1707215.08
211285,201709,213,120,93,112440,86859.9,199299.9
211290,201709,695,458,237,428958.6,222069,651027.6
211300,201709,813,614,199,575045.7,186463,761508.7
211400,201709,1629,891,738,834867,691506,1526373
220005,201709,19,18,1,16866,937,17803
220010,201709,91,69,22,64653,20332.9,84985.9
220020,201709,545,427,118,399505.6,110566,510071.6
220025,201709,107,103,4,96511,3748,100259
220027,201709,43,35,8,32795,7496,40291
220030,201709,89,73,16,68401,14992,83393
220040,201709,1105,818,287,764311.62,268919,1033230.62
220045,201709,37,28,9,26236,8433,34669
220050,201709,641,517,124,483287.88,116169.26,599457.14
220060,201709,171,145,26,135865,24362,160227
220070,201709,138,126,12,118062,11244,129306
220080,201709,8,7,1,6559,937,7496
220090,201709,33,26,7,24081,6559,30640
220095,201709,3,2,1,1874,937,2811
220100,201709,28,24,4,22488,3748,26236
220105,201709,40,37,3,34669,2811,37480
220110,201709,205,189,16,176811.9,14992,191803.9
220115,201709,42,39,3,36543,2811,39354
220117,201709,21,20,1,18740,937,19677
220120,201709,1534,1047,487,980421.51,456300.26,1436721.77
220130,201709,25,24,1,22488,937,23425
220140,201709,104,84,20,77771,18740,96511
220150,201709,443,310,133,290470,124621,415091
220155,201709,4,4,0,3748,0,3748
220157,201709,19,15,4,14055,3748,17803
220160,201709,72,63,9,59031,8433,67464
220170,201709,34,32,2,29984,1874,31858
220173,201709,8,8,0,7496,0,7496
220177,201709,5,5,0,4685,0,4685
220180,201709,66,65,1,60896.32,937,61833.32
220190,201709,1040,932,108,873284,100446.4,973730.4
220191,201709,42,37,5,34669,4685,39354
220192,201709,69,66,3,61842,2811,64653
220194,201709,23,19,4,17803,3748,21551
220196,201709,102,85,17,79505,15929,95434
220198,201709,6,4,2,3748,1874,5622
220200,201709,429,345,84,323986,78708,402694
220202,201709,38,34,4,31858,3748,35606
220205,201709,37,32,5,29984,4685,34669
220207,201709,18,17,1,15929,937,16866
220208,201709,84,43,41,40291,38417,78708
220209,201709,32,29,3,27173,2811,29984
220210,201709,17,16,1,14992,937,15929
220211,201709,45,44,1,41228,937,42165
220213,201709,44,38,6,35606,5622,41228
220217,201709,37,29,8,27173,7496,34669
220220,201709,1985,1259,726,1176142.04,678604.76,1854746.80
220225,201709,14,6,8,5622,7496,13118
220230,201709,918,733,185,686380.61,172717.21,859097.82
220240,201709,146,133,13,124621,12181,136802
220245,201709,55,50,5,46472,4685,51157
220250,201709,138,123,15,115251,14055,129306
220253,201709,43,35,8,32795,7496,40291
220255,201709,29,25,4,23425,3748,27173
220260,201709,691,506,185,474122,173345,647467
220265,201709,15,11,4,10307,3748,14055
220270,201709,643,569,74,532440.88,68869.5,601310.38
220271,201709,45,36,9,33732,8433,42165
220272,201709,27,26,1,24362,937,25299
220273,201709,17,14,3,13118,2811,15929
220275,201709,48,37,11,34669,10307,44976
220277,201709,10,8,2,7496,1874,9370
220280,201709,22,20,2,18740,1874,20614
220285,201709,54,50,4,46850,3748,50598
220290,201709,1380,1179,201,1102241,188291,1290532
220300,201709,61,59,2,55283,1874,57157
220310,201709,304,254,50,237971.05,46841,284812.05
220320,201709,434,400,34,373395.5,31858,405253.5
220323,201709,0,0,0,0,0,0
220325,201709,14,9,5,8433,4685,13118
220327,201709,11,10,1,9370,937,10307
220330,201709,198,132,66,123402.9,61842,185244.9
220335,201709,140,124,16,116188,14992,131180
220340,201709,23,12,11,11244,10307,21551
220342,201709,55,46,9,43102,8433,51535
220345,201709,120,106,14,99322,13118,112440
220350,201709,432,381,51,354421.01,47787,402208.01
220360,201709,42,31,11,29047,10307,39354
220370,201709,1063,843,220,788954,206140,995094
220375,201709,26,25,1,23425,937,24362
220380,201709,35,27,8,25299,7496,32795
220385,201709,28,24,4,22488,3748,26236
220390,201709,2200,1247,953,1163829.2,891603.25,2055432.45
220400,201709,28,26,2,24362,1874,26236
220410,201709,17,15,2,14055,1874,15929
220415,201709,12,11,1,10307,937,11244
220420,201709,133,110,23,103070,21269.9,124339.9
220430,201709,130,117,13,107990.4,12181,120171.4
220435,201709,25,18,7,16862,6559,23421
220440,201709,289,246,43,230502,40291,270793
220450,201709,316,165,151,153253.55,141487,294740.55
220455,201709,65,63,2,59031,1874,60905
220460,201709,22,21,1,19021.1,937,19958.1
220465,201709,104,66,38,61842,35606,97448
220470,201709,239,208,31,193959.8,29047,223006.8
220480,201709,72,61,11,57157,10307,67464
220490,201709,84,73,11,67644,10307,77951
220500,201709,101,88,13,82456,12181,94637
220510,201709,373,296,77,276603,71961.6,348564.6
220515,201709,21,17,4,15929,3748,19677
220520,201709,362,325,37,302991,34651,337642
220525,201709,26,18,8,16866,7496,24362
220527,201709,38,31,7,29047,5763,34810
220530,201709,34,13,21,12181,19677,31858
220535,201709,13,12,1,11244,937,12181
220540,201709,59,46,13,43102,12181,55283
220545,201709,64,41,23,38417,21551,59968
220550,201709,621,471,150,440577.4,140550,581127.4
220551,201709,27,20,7,18740,6559,25299
220552,201709,8,8,0,7496,0,7496
220553,201709,66,60,6,56220,5622,61842
220554,201709,15,9,6,8151.9,5622,13773.9
220555,201709,23,19,4,17803,3748,21551
220556,201709,60,56,4,52472,3748,56220
220557,201709,58,51,7,47787,6559,54346
220558,201709,7,2,5,1874,4685,6559
220559,201709,6,5,1,4685,937,5622
220560,201709,54,36,18,33544.6,16866,50410.6
220570,201709,768,454,314,425152.14,294218,719370.14
220580,201709,596,540,56,505980,51517.26,557497.26
220585,201709,6,5,1,4685,937,5622
220590,201709,14,14,0,13118,0,13118
220595,201709,61,46,15,43102,14055,57157
220600,201709,18,9,9,8433,8433,16866
220605,201709,21,20,1,18740,937,19677
220610,201709,59,51,8,47787,7496,55283
220620,201709,553,429,124,401738.75,116188,517926.75
220630,201709,8,6,2,5622,1874,7496
220635,201709,35,32,3,29984,2811,32795
220640,201709,100,76,24,71212,22488,93700
220650,201709,117,110,7,103070,6559,109629
220660,201709,25,19,6,17803,5622,23425
220665,201709,5,4,1,3748,937,4685
220667,201709,10,10,0,9370,0,9370
220669,201709,22,19,3,17803,2811,20614
220670,201709,68,53,15,49473.6,14055,63528.6
220672,201709,52,37,15,34669,14055,48724
220675,201709,35,27,8,25299,7496,32795
220680,201709,34,28,6,26236,5622,31858
220690,201709,51,47,4,44039,3748,47787
220695,201709,65,31,34,29047,31858,60905
220700,201709,1481,1133,348,1059812.59,325795,1385607.59
220710,201709,4,2,2,1874,1874,3748
220720,201709,122,98,24,91591.75,22347.45,113939.20
220730,201709,19,18,1,16866,937,17803
220735,201709,3,1,2,937,1874,2811
220740,201709,39,37,2,34669,1874,36543
220750,201709,99,81,18,75897,16866,92763
220755,201709,16,16,0,14992,0,14992
220760,201709,48,45,3,42165,2811,44976
220770,201709,5656,2802,2854,2619981.52,2668451.13,5288432.65
220775,201709,27,13,14,12181,13118,25299
220777,201709,15,14,1,13118,937,14055
220779,201709,16,13,3,12181,2811,14992
220780,201709,859,728,131,681480.1,122466,803946.1
220785,201709,8,5,3,4685,2811,7496
220790,201709,1004,794,210,741620,196770,938390
220793,201709,14,14,0,13118,0,13118
220795,201709,25,24,1,22488,937,23425
220800,201709,3786,2875,911,2692542.2,852888.74,3545430.94
220810,201709,53,49,4,45913,3748,49661
220820,201709,237,215,22,201455,20614,222069
220830,201709,1137,956,181,895767.32,169579,1065346.32
220840,201709,2391,1577,814,1465238.1,760657,2225895.1
220850,201709,51,40,11,37480,10307,47787
220855,201709,15,10,5,9370,4685,14055
220860,201709,12,11,1,10307,937,11244
220865,201709,20,18,2,16866,1874,18740
220870,201709,58,55,3,51535,2811,54346
220880,201709,340,257,83,240153.1,77490,317643.1
220885,201709,45,40,5,37480,4685,42165
220887,201709,20,19,1,17803,937,18740
220890,201709,104,92,12,86204,11244,97448
220900,201709,46,26,20,24362,18740,43102
220910,201709,54,45,9,42165,8433,50598
220915,201709,16,15,1,14055,937,14992
220920,201709,40,36,4,33732,3748,37480
220930,201709,42,41,1,37502.95,937,38439.95
220935,201709,20,19,1,17803,937,18740
220937,201709,44,41,3,38417,2811,41228
220940,201709,49,44,5,41228,4685,45913
220945,201709,0,0,0,0,0,0
220950,201709,49,45,4,42165,3748,45913
220955,201709,41,37,4,34669,3748,38417
220960,201709,4,4,0,3748,0,3748
220965,201709,28,24,4,22488,3748,26236
220970,201709,46,37,9,34669,8433,43102
220975,201709,9,8,1,7496,937,8433
220980,201709,40,36,4,33732,3748,37480
220985,201709,63,56,7,52472,6559,59031
220987,201709,32,30,2,28110,1874,29984
220990,201709,12,11,1,10307,937,11244
220995,201709,38,33,5,30921,4685,35606
220997,201709,34,28,6,26236,5622,31858
221000,201709,1071,960,111,896946.81,103725.9,1000672.71
221005,201709,67,62,5,58094,4685,62779
221010,201709,15,13,2,12181,1874,14055
221020,201709,51,48,3,44976,2811,47787
221030,201709,36,29,7,27173,6559,33732
221035,201709,20,19,1,17803,937,18740
221037,201709,12,6,6,5622,5622,11244
221038,201709,15,13,2,12181,1874,14055
221039,201709,24,24,0,22488,0,22488
221040,201709,250,215,35,201455,32795,234250
221050,201709,227,190,37,178030,34669,212699
221060,201709,1453,1265,188,1184489.81,176156,1360645.81
221062,201709,31,30,1,28110,937,29047
221063,201709,17,13,4,12181,3748,15929
221065,201709,43,38,5,35606,4685,40291
221070,201709,153,132,21,123684,19677,143361
221080,201709,374,328,46,307336,42820.9,350156.9
221090,201709,41,40,1,37228,937,38165
221093,201709,71,49,22,45913,20614,66527
221095,201709,11,10,1,9370,937,10307
221097,201709,27,24,3,22488,2811,25299
221100,201709,24092,13749,10343,12859657.62,9685708.74,22545366.36
221110,201709,1011,736,275,689351,257675,947026
221120,201709,508,377,131,352968,122747,475715
221130,201709,909,740,169,691853.69,157698,849551.69
221135,201709,33,30,3,28110,2811,30921
221140,201709,40,31,9,29047,8433,37480
221150,201709,15,11,4,10307,3748,14055
221160,201709,11,11,0,10307,0,10307
221170,201709,11,11,0,10307,0,10307
230010,201709,156,145,11,135865,10307,146172
230015,201709,115,97,18,90889,16866,107755
230020,201709,1494,1283,211,1199360.8,196945.88,1396306.68
230030,201709,1578,1130,448,1053340.62,419776,1473116.62
230040,201709,197,174,23,162101,21551,183652
230050,201709,197,144,53,134928,49661,184589
230060,201709,142,114,28,106068.4,26236,132304.4
230070,201709,282,250,32,234250,29984,264234
230075,201709,785,687,98,641753,91544.9,733297.9
230080,201709,173,152,21,142424,19677,162101
230090,201709,90,62,28,57344.4,26236,83580.4
230100,201709,1883,1124,759,1050924,711183,1762107
230110,201709,2604,1653,951,1545563.6,890524.9,2436088.5
230120,201709,914,722,192,674171.91,179886,854057.91
230125,201709,132,106,26,99322,24362,123684
230130,201709,445,398,47,372926,44039,416965
230140,201709,209,181,28,169597,26236,195833
230150,201709,155,121,34,113377,31858,145235
230160,201709,903,793,110,742338.5,103070,845408.5
230170,201709,573,525,48,488180.1,44976,533156.1
230180,201709,77,72,5,67464,4685,72149
230185,201709,391,337,54,314428.16,50598,365026.16
230190,201709,2157,1737,420,1624474.69,393228,2017702.69
230195,201709,482,421,61,394477,57157,451634
230200,201709,363,315,48,294208.63,44311,338519.63
230205,201709,336,211,125,195968.86,117125,313093.86
230210,201709,1236,986,250,922671.18,233500.4,1156171.58
230220,201709,1345,940,405,880030.4,379485,1259515.4
230230,201709,897,791,106,739262.85,99322,838584.85
230240,201709,1604,1380,224,1291406.85,209888,1501294.85
230250,201709,1728,1412,316,1319715.47,295779,1615494.47
230260,201709,2852,1688,1164,1576556.79,1089731.75,2666288.54
230270,201709,1321,1065,256,995362.1,236827.95,1232190.05
230280,201709,2664,1981,683,1850858.97,639034,2489892.97
230290,201709,395,357,38,327545.09,35606,363151.09
230300,201709,500,367,133,342642.16,124621,467263.16
230310,201709,409,307,102,287659,95293,382952
230320,201709,880,755,125,704366.17,117116,821482.17
230330,201709,290,233,57,217571.4,53222,270793.4
230340,201709,450,360,90,335634.4,84330,419964.4
230350,201709,2934,1839,1095,1723124.26,1023205.24,2746329.50
230360,201709,246,217,29,202435,27173,229608
230365,201709,169,136,33,126730,30921,157651
230370,201709,9423,4567,4856,4270062.84,4545992.65,8816055.49
230380,201709,454,390,64,365149,59031.8,424180.8
230390,201709,491,266,225,247471.07,210825,458296.07
230393,201709,270,225,45,209985.4,42165,252150.4
230395,201709,330,270,60,252747,56220,308967
230400,201709,600,477,123,445075,114763.76,559838.76
230410,201709,2546,1582,964,1476807.14,902987,2379794.14
230420,201709,5737,3715,2022,3461597.69,1890114.9,5351712.59
230423,201709,298,258,40,239872.8,37480,277352.8
230425,201709,328,271,57,253927,53409,307336
230426,201709,105,94,11,87365.88,10025.9,97391.78
230427,201709,77,74,3,69338,2811,72149
230428,201709,1317,681,636,637872.12,595932,1233804.12
230430,201709,437,348,89,325885,82629.34,408514.34
230435,201709,757,526,231,491822,215229.17,707051.17
230440,201709,81592,35790,45802,33455709.6,42876402.15,76332111.75
230445,201709,258,181,77,169409.6,71958.07,241367.67
230450,201709,540,438,102,410406,95574,505980
230460,201709,54,45,9,42165,8433,50598
230465,201709,289,233,56,218321,52472,270793
230470,201709,1802,1395,407,1307115,380422.25,1687537.25
230480,201709,144,139,5,129961.9,4685,134646.9
230490,201709,273,223,50,208951,46850,255801
230495,201709,419,315,104,294318,97448,391766
230500,201709,929,699,230,653089,215501,868590
230510,201709,41,34,7,31858,6559,38417
230520,201709,387,305,82,285785,76834,362619
230523,201709,1864,1186,678,1108975.16,634846,1743821.16
230526,201709,287,241,46,225817,43102,268919
230530,201709,661,496,165,461793.38,153668.6,615461.98
230533,201709,173,166,7,155542,6559,162101
230535,201709,337,253,84,237061,78708,315769
230540,201709,1829,1597,232,1493790.7,217103,1710893.7
230550,201709,3581,2276,1305,2125484.43,1221941.7,3347426.13
230560,201709,577,440,137,410219.4,127432,537651.4
230565,201709,182,132,50,123684,46850,170534
230570,201709,309,273,36,255801,33732,289533
230580,201709,1085,798,287,746292.39,267700.9,1013993.29
230590,201709,921,715,206,665787.05,192553.5,858340.55
230600,201709,247,229,18,212905.32,16866,229771.32
230610,201709,326,261,65,244370,60905,305275
230620,201709,159,130,29,120873,27173,148046
230625,201709,707,510,197,476512.25,183456.04,659968.29
230630,201709,1210,951,259,891087,242308.2,1133395.2
230640,201709,3372,2930,442,2738024.3,413409.09,3151433.39
230650,201709,384,337,47,314952.49,44039,358991.49
230655,201709,610,531,79,496610.4,73943.85,570554.25
230660,201709,326,272,54,254864,50316.9,305180.9
230670,201709,418,374,44,350438,41228,391666
230680,201709,203,187,16,175219,14992,190211
230690,201709,836,733,103,686821,96511,783332
230700,201709,707,604,103,565929.26,95948.8,661878.06
230710,201709,721,679,42,636036,39354,675390
230720,201709,138,116,22,108495.23,20614,129109.23
230725,201709,216,172,44,161164,41219,202383
230730,201709,11405,6169,5236,5763984.84,4896942.53,10660927.37
230740,201709,646,514,132,481337,123005.63,604342.63
230750,201709,781,665,116,621934.15,108692,730626.15
230760,201709,1235,1068,167,996742.59,156479,1153221.59
230763,201709,331,273,58,253881.2,54346,308227.2
230765,201709,6600,3051,3549,2852990.25,3323446.1,6176436.35
230770,201709,4888,2496,2392,2329077.76,2238362.14,4567439.90
230780,201709,672,594,78,553775.57,73086,626861.57
230790,201709,182,148,34,138676,31858,170534
230800,201709,1093,796,297,745828.58,278289,1024117.58
230810,201709,1251,1110,141,1038805.05,131929.6,1170734.65
230820,201709,315,224,91,208952,85267,294219
230830,201709,928,808,120,753645.02,112440,866085.02
230835,201709,270,234,36,218321,33030,251351
230837,201709,161,134,27,125558,25299,150857
230840,201709,870,693,177,648123.5,164631,812754.5
230850,201709,1440,1263,177,1183118.9,165568,1348686.9
230860,201709,308,225,83,210825,76834.25,287659.25
230870,201709,1758,1488,270,1393038,251678.4,1644716.4
230880,201709,24,17,7,15929,6559,22488
230890,201709,567,524,43,490867.98,40277,531144.98
230900,201709,259,198,61,185526,56964,242490
230910,201709,193,155,38,144485.4,35606,180091.4
230920,201709,389,309,80,289533,74960,364493
230930,201709,903,642,261,598743.92,244557,843300.92
230940,201709,822,662,160,620151.23,149733,769884.23
230945,201709,446,377,69,353062,64653,417715
230950,201709,372,316,56,296092,52472,348564
230960,201709,2387,1603,784,1495402.51,734327,2229729.51
230970,201709,1674,940,734,879884.45,686895.96,1566780.41
230980,201709,202,170,32,159290,29984,189274
230990,201709,138,112,26,104944,23618.95,128562.95
231000,201709,198,181,17,167723.74,15929,183652.74
231010,201709,131,102,29,95011.8,27173,122184.8
231020,201709,1223,854,369,798605.5,345753,1144358.5
231025,201709,912,675,237,630348.6,220551.9,850900.5
231030,201709,1138,954,184,893894,172127,1066021
231040,201709,135,93,42,86410.14,38636,125046.14
231050,201709,1015,900,115,841708.5,107755,949463.5
231060,201709,139,122,17,114314,15929,130243
231070,201709,1380,972,408,908422.45,382296,1290718.45
231080,201709,259,242,17,225957.55,15929,241886.55
231085,201709,518,325,193,303589,180841,484430
231090,201709,224,189,35,177093,32795,209888
231095,201709,163,129,34,120873,31858,152731
231100,201709,120,98,22,91826,19395.9,111221.9
231110,201709,329,283,46,263676.39,43102,306778.39
231120,201709,303,261,42,243606.88,39167,282773.88
231123,201709,132,126,6,118062,5622,123684
231126,201709,275,236,39,221132,36543,257675
231130,201709,4475,3476,999,3248431.37,935182.32,4183613.69
231135,201709,196,169,27,158353,24057.2,182410.2
231140,201709,3012,2217,795,2073745.05,743940.52,2817685.57
231150,201709,345,329,16,308273,14992,323265
231160,201709,1184,939,245,876845.35,229340.12,1106185.47
231170,201709,536,346,190,324202,178030,502232
231180,201709,1521,1283,238,1201281.4,223006,1424287.4
231190,201709,213,190,23,178030,21551,199581
231195,201709,209,181,28,168885.91,26236,195121.91
231200,201709,814,668,146,625916,135564,761480
231210,201709,594,495,99,462878,92763,555641
231220,201709,993,715,278,669000.26,260486,929486.26
231230,201709,1343,1081,262,1011530.3,244744.4,1256274.7
231240,201709,1298,941,357,881435.9,333291.1,1214727.0
231250,201709,106,99,7,92763,6559,99322
231260,201709,296,189,107,177093,99978,277071
231270,201709,978,817,161,761189.49,150848,912037.49
231280,201709,52,41,11,38417,10307,48724
231290,201709,7083,3891,3192,3638653.6,2989537.45,6628191.05
231300,201709,614,567,47,531279,44039,575318
231310,201709,689,641,48,599422,44976,644398
231320,201709,547,426,121,398695,113377,512072
231325,201709,86,75,11,70275,10307,80582
231330,201709,1989,1543,446,1440314.19,414999.3,1855313.49
231335,201709,247,215,32,201455,29984,231439
231340,201709,1544,1140,404,1066494.24,378548,1445042.24
231350,201709,1114,913,201,855481,187775,1043256
231355,201709,381,332,49,311084,45913,356997
231360,201709,457,365,92,339343.1,86204,425547.1
231370,201709,87,70,17,65590,15929,81519
231375,201709,277,201,76,188337,71212,259549
231380,201709,421,346,75,322635.36,70087.6,392722.96
231390,201709,190,155,35,145235,32795,178030
231395,201709,719,440,279,411005.68,261423,672428.68
231400,201709,1023,847,176,791112.55,164574.9,955687.45
231410,201709,1270,1020,250,951197.7,233314,1184511.7
240010,201709,391,185,206,171932.54,193013,364945.54
240020,201709,2126,1643,483,1538045.07,452571,1990616.07
240030,201709,173,142,31,133054,29047,162101
240040,201709,33,33,0,30921,0,30921
240050,201709,491,422,69,394575.66,64653,459228.66
240060,201709,70,65,5,60905,4685,65590
240070,201709,163,124,39,116188,36543,152731
240080,201709,392,253,139,237057,130243,367300
240090,201709,108,95,13,88716,12181,100897
240100,201709,1413,1331,82,1244227.18,76646.6,1320873.78
240110,201709,950,595,355,555857.28,332635,888492.28
240120,201709,145,121,24,113377,22488,135865
240130,201709,286,268,18,250412.31,16866,267278.31
240140,201709,87,66,21,61842,19677,81519
240145,201709,655,575,80,538259.65,74753.86,613013.51
240150,201709,20,16,4,14992,3733.95,18725.95
240160,201709,47,39,8,36543,7496,44039
240165,201709,36,32,4,29750,3748,33498
240170,201709,91,73,18,68401,16866,85267
240180,201709,74,60,14,56220,13118,69338
240185,201709,43,40,3,37470.63,2811,40281.63
240190,201709,19,17,2,15929,1874,17803
240200,201709,2915,1626,1289,1518088.3,1206576,2724664.3
240210,201709,165,129,36,120873,33732,154605
240220,201709,1113,795,318,744915,297956.63,1042871.63
240230,201709,805,744,61,694344.68,56520,750864.68
240240,201709,143,103,40,96511,37480,133991
240250,201709,100,89,11,83393,10307,93700
240260,201709,1767,1305,462,1222110.36,431928.89,1654039.25
240270,201709,184,164,20,153293.2,18740,172033.2
240280,201709,43,33,10,30921,9370,40291
240290,201709,63,61,2,57157,1874,59031
240300,201709,180,105,75,98385,70275,168660
240310,201709,1901,1036,865,962024.66,807328.06,1769352.72
240320,201709,212,201,11,188337,10307,198644
240325,201709,4194,2568,1626,2397454.5,1521427.41,3918881.91
240330,201709,72,69,3,64653,2811,67464
240340,201709,104,74,30,69338,28110,97448
240350,201709,95,83,12,77771,11244,89015
240360,201709,360,264,96,247087,89952,337039
240370,201709,39,37,2,34669,1874,36543
240375,201709,80,49,31,45913,29047,74960
240380,201709,242,198,44,184629,41135,225764
240390,201709,18,15,3,14055,2811,16866
240400,201709,82,79,3,74023,2811,76834
240410,201709,11,7,4,6559,3748,10307
240420,201709,845,653,192,610551.07,178892.04,789443.11
240430,201709,258,243,15,225985.11,14055,240040.11
240440,201709,66,36,30,33732,28110,61842
240450,201709,193,127,66,118436.9,61842,180278.9
240460,201709,61,47,14,44039,13118,57157
240470,201709,231,198,33,184978.79,30921,215899.79
240480,201709,17,17,0,15835.3,0,15835.3
240485,201709,70,60,10,56329,9370,65699
240490,201709,46,46,0,42896,0,42896
240500,201709,85,69,16,64653,14992,79645
240510,201709,48,34,14,31858,13118,44976
240520,201709,130,124,6,116188,5622,121810
240530,201709,49,43,6,40291,5622,45913
240540,201709,81,70,11,65590,10307,75897
240550,201709,16,13,3,12181,2811,14992
240560,201709,365,268,97,250500.4,90889,341389.4
240570,201709,468,290,178,270605.6,166786,437391.6
240580,201709,1248,1007,241,937423.35,224679.6,1162102.95
240590,201709,30,27,3,25299,2811,28110
240600,201709,116,116,0,108692,0,108692
240610,201709,511,427,84,399818,77959,477777
240615,201709,42,40,2,37480,1874,39354
240620,201709,94,90,4,83393,3748,87141
240630,201709,38,36,2,33732,1874,35606
240640,201709,27,23,4,21551,3748,25299
240650,201709,229,193,36,179999,33732,213731
240660,201709,94,82,12,76834,11244,88078
240670,201709,276,162,114,149733.15,106818,256551.15
240680,201709,55,43,12,40291,11244,51535
240690,201709,53,50,3,46850,2811,49661
240700,201709,197,164,33,153668,30921,184589
240710,201709,1856,1179,677,1104068.3,633515.07,1737583.37
240720,201709,1013,739,274,691497.23,256738,948235.23
240725,201709,67,64,3,59968,2811,62779
240730,201709,131,115,16,107755,14992,122747
240740,201709,233,198,35,184186.09,32795,216981.09
240750,201709,35,22,13,20614,12181,32795
240760,201709,34,30,4,28110,3748,31858
240770,201709,150,116,34,108692,31858,140550
240780,201709,698,585,113,546449.03,105881,652330.03
240790,201709,42,40,2,37480,1874,39354
240800,201709,8371,5674,2697,5279952.61,2519726.5,7799679.11
240810,201709,19650,10782,8868,10061517.21,8298358.05,18359875.26
240820,201709,188,121,67,113091.22,62779,175870.22
240830,201709,1565,1285,280,1197637.15,261424,1459061.15
240840,201709,79,67,12,62779,11244,74023
240850,201709,86,75,11,70275,10307,80582
240860,201709,114,112,2,104944,1874,106818
240870,201709,54,47,7,44039,6559,50598
240880,201709,26,25,1,23415.63,937,24352.63
240890,201709,1118,655,463,609896.29,432890,1042786.29
240895,201709,42,31,11,29047,10307,39354
240910,201709,150,135,15,126495,14055,140550
240920,201709,18,14,4,13118,3748,16866
240930,201709,365,329,36,307336,33732,341068
240933,201709,26,17,9,15929,8433,24362
240940,201709,2385,2107,278,1961944.31,257937.36,2219881.67
240950,201709,50,48,2,44976,1874,46850
240960,201709,33,25,8,23425,7496,30921
240970,201709,151,109,42,102133,38617,140750
240980,201709,187,148,39,138676,36543,175219
240990,201709,123,83,40,77771,37480,115251
241000,201709,84,75,9,70275,8433,78708
241010,201709,59,46,13,43102,12181,55283
241020,201709,116,109,7,102133,6559,108692
241025,201709,9,3,6,2811,5622,8433
241030,201709,120,98,22,91826,20614,112440
241040,201709,29,25,4,23425,3748,27173
241050,201709,99,84,15,78708,14055,92763
241060,201709,35,31,4,29047,3748,32795
241070,201709,17,17,0,15929,0,15929
241080,201709,66,58,8,54064.9,7496,61560.9
241090,201709,54,45,9,42165,8404.95,50569.95
241100,201709,76,68,8,63716,7496,71212
241105,201709,9,4,5,3748,4685,8433
241110,201709,50,47,3,44039,2811,46850
241120,201709,1369,1055,314,985603.4,293355.96,1278959.36
241140,201709,229,186,43,173346,40291,213637
241142,201709,42,41,1,38417,937,39354
241150,201709,1193,1047,146,978369.5,136802,1115171.5
241160,201709,26,24,2,22488,1874,24362
241170,201709,42,39,3,36543,2811,39354
241180,201709,50,40,10,37308.53,9370,46678.53
241190,201709,47,46,1,43102,937,44039
241200,201709,3745,2060,1685,1925541.61,1576958.74,3502500.35
241210,201709,73,60,13,56220,11338,67558
241220,201709,1330,881,449,825037.7,420694.26,1245731.96
241230,201709,234,196,38,183464.6,35606,219070.6
241240,201709,50,38,12,35606,11244,46850
241250,201709,1037,967,70,905798,65309,971107
241255,201709,44,35,9,32795,8433,41228
241260,201709,622,491,131,460062.32,122747,582809.32
241270,201709,47,32,15,29984,14055,44039
241280,201709,101,87,14,81519,13118,94637
241290,201709,109,81,28,75897,26236,102133
241300,201709,80,56,24,52472,22488,74960
241310,201709,52,40,12,37340,11244,48584
241320,201709,28,15,13,14055,12181,26236
241330,201709,58,52,6,48724,5622,54346
241335,201709,56,48,8,44976,7496,52472
241340,201709,183,138,45,129306,42165,171471
241350,201709,58,53,5,49661,4685,54346
241355,201709,43,40,3,37480,2811,40291
241360,201709,48,48,0,44976,0,44976
241370,201709,44,37,7,34547.19,6559,41106.19
241380,201709,44,42,2,39354,1874,41228
241390,201709,72,57,15,53221.6,14055,67276.6
241400,201709,187,153,34,142705.1,31858,174563.1
241410,201709,182,164,18,153668,16773,170441
241415,201709,88,69,19,64653,17803,82456
241420,201709,94,72,22,67464,20446,87910
241430,201709,28,27,1,25299,937,26236
241440,201709,443,376,67,352312,62779,415091
241445,201709,34,32,2,29984,1874,31858
241450,201709,283,232,51,217260,47787,265047
241460,201709,133,120,13,112206,12181,124387
241470,201709,47,39,8,36543,7496,44039
241475,201709,72,68,4,63716,3748,67464
241480,201709,92,67,25,62779,23425,86204
241490,201709,10,8,2,7496,1593,9089
241500,201709,50,37,13,34669,12181,46850
250010,201709,101,88,13,82456,12181,94637
250020,201709,23,20,3,18740,2811,21551
250030,201709,810,588,222,549635.1,206170.51,755805.61
250040,201709,313,261,52,244557,48724,293281
250050,201709,221,183,38,171467,35606,207073
250053,201709,55,43,12,40291,11244,51535
250057,201709,0,0,0,0,0,0
250060,201709,436,340,96,318580,89952,408532
250070,201709,682,582,100,543354,93700,637054
250073,201709,7,7,0,6559,0,6559
250077,201709,211,156,55,145787.83,51535,197322.83
250080,201709,416,322,94,300122.1,88078,388200.1
250090,201709,219,145,74,134929,68482.26,203411.26
250100,201709,455,371,84,347627,78334,425961
250110,201709,474,358,116,333694.6,108692,442386.6
250115,201709,29,8,21,7496,19677,27173
250120,201709,105,79,26,74023,24362,98385
250130,201709,581,459,122,430083,114127,544210
250135,201709,13,8,5,7496,4685,12181
250140,201709,73,64,9,59968,8433,68401
250150,201709,547,407,140,379232,130870.79,510102.79
250153,201709,11,10,1,9370,937,10307
250157,201709,29,24,5,22488,4685,27173
250160,201709,208,164,44,153668,41228,194896
250170,201709,67,47,20,44039,18740,62779
250180,201709,3925,2655,1270,2474525.76,1184982.5,3659508.26
250190,201709,921,600,321,560560.25,300074.25,860634.50
250200,201709,51,44,7,41228,6559,47787
250205,201709,19,16,3,14992,2811,17803
250210,201709,88,76,12,71212,11244,82456
250215,201709,62,53,9,49661,8433,58094
250220,201709,27,20,7,18740,6559,25299
250230,201709,72,66,6,61842,5622,67464
250240,201709,237,195,42,181918.55,39354,221272.55
250250,201709,386,332,54,311084,50598,361682
250260,201709,30,25,5,23425,4685,28110
250270,201709,58,46,12,43102,11244,54346
250280,201709,384,321,63,300777,59031,359808
250290,201709,90,85,5,79363.9,4685,84048.9
250300,201709,557,384,173,359172.24,162088,521260.24
250310,201709,48,41,7,38417,6559,44976
250320,201709,1851,1274,577,1187158.84,539422,1726580.84
250330,201709,81,70,11,65590,10307,75897
250340,201709,25,21,4,19677,3748,23425
250350,201709,134,83,51,77489.9,47224.8,124714.7
250355,201709,25,20,5,18740,4685,23425
250360,201709,200,163,37,152731,34435,187166
250370,201709,2331,1585,746,1479338.59,697472.71,2176811.30
250375,201709,20,16,4,14992,3748,18740
250380,201709,50,34,16,31858,14992,46850
250390,201709,36,30,6,28110,5622,33732
250400,201709,15401,7795,7606,7280885.45,7119911.29,14400796.74
250403,201709,424,343,81,321381.64,75897,397278.64
250407,201709,52,46,6,43102,5622,48724
250410,201709,28,23,5,21551,4685,26236
250415,201709,45,29,16,27173,14973.26,42146.26
250420,201709,48,39,9,36543,8433,44976
250430,201709,1661,1393,268,1303087,251116,1554203
250435,201709,16,14,2,13118,1874,14992
250440,201709,687,593,94,553309.29,88078,641387.29
250450,201709,85,71,14,66527,12462.1,78989.1
250460,201709,410,275,135,257675,126362.42,384037.42
250470,201709,90,65,25,60905,23425,84330
250480,201709,321,252,69,236124,64653,300777
250485,201709,1,1,0,937,0,937
250490,201709,206,169,37,158353,34669,193022
250500,201709,73,52,21,48724,19677,68401
250510,201709,727,565,162,528093.8,150803.41,678897.21
250520,201709,172,119,53,111484.28,49656.32,161140.60
250523,201709,108,89,19,83393,17803,101196
250527,201709,104,80,24,74955.32,22488,97443.32
250530,201709,6,5,1,4685,937,5622
250535,201709,29,23,6,21551,5622,27173
250540,201709,124,94,30,87375.25,28110,115485.25
250550,201709,67,64,3,59968,2811,62779
250560,201709,33,28,5,26236,4685,30921
250570,201709,151,119,32,111503,29984,141487
250580,201709,139,108,31,100914.9,29047,129961.9
250590,201709,19,15,4,14055,3748,17803
250600,201709,1283,874,409,815660.64,383135.32,1198795.96
250610,201709,152,131,21,122747,19677,142424
250620,201709,20,16,4,14992,3748,18740
250625,201709,58,43,15,40291,14055,54346
250630,201709,2998,1911,1087,1783498.31,1017068.28,2800566.59
250640,201709,202,168,34,157416,31858,189274
250650,201709,31,21,10,19677,9370,29047
250660,201709,37,30,7,28110,6559,34669
250670,201709,53,33,20,30921,18740,49661
250680,201709,388,317,71,297029,66527,363556
250690,201709,1766,1212,554,1132266.03,518723.9,1650989.93
250700,201709,949,833,116,775233.53,108485.86,883719.39
250710,201709,443,344,99,322328,92763,415091
250720,201709,101,80,21,74960,19677,94637
250730,201709,363,304,59,284848,55283,340131
250740,201709,48,44,4,41228,3748,44976
250750,201709,19780,11821,7959,11021673.45,7448664.03,18470337.48
250760,201709,65,49,16,45913,14992,60905
250770,201709,347,234,113,218321.31,104733.27,323054.58
250780,201709,57,44,13,41228,12181,53409
250790,201709,483,308,175,285785.76,163272.25,449058.01
250800,201709,149,138,11,128603.25,10307,138910.25
250810,201709,80,60,20,56220,18740,74960
250820,201709,157,126,31,118062,29047,147109
250830,201709,424,284,140,265124.25,131180,396304.25
250840,201709,54,51,3,47787,2811,50598
250850,201709,49,39,10,35868.36,9370,45238.36
250855,201709,14,12,2,11244,1874,13118
250860,201709,202,145,57,135865,53127.9,188992.9
250870,201709,31,28,3,26236,2811,29047
250880,201709,75,56,19,52425.15,17803,70228.15
250890,201709,2297,1687,610,1579407.2,570722.57,2150129.77
250900,201709,68,55,13,51535,12181,63716
250905,201709,129,99,30,92763,28110,120873
250910,201709,1148,817,331,764195.52,309865.9,1074061.42
250915,201709,110,75,35,70275,32795,103070
250920,201709,138,105,33,98385,30921,129306
250930,201709,156,99,57,92763,53409,146172
250933,201709,0,0,0,0,0,0
250937,201709,8,7,1,6559,937,7496
250939,201709,28,21,7,19677,6559,26236
250940,201709,102,77,25,72149,23425,95574
250950,201709,74,49,25,45913,23425,69338
250960,201709,89,49,40,45913,37480,83393
250970,201709,1187,841,346,786425,323920.9,1110345.9
250980,201709,89,62,27,58094,25299,83393
250990,201709,159,123,36,114815.35,33689.85,148505.20
251000,201709,72,66,6,61654.6,5622,67276.6
251010,201709,90,70,20,65586,17975.4,83561.4
251020,201709,81,71,10,65730.55,9370,75100.55
251030,201709,41,31,10,29047,9370,38417
251040,201709,54,38,16,35606,14992,50598
251050,201709,25,23,2,21551,1874,23425
251060,201709,45,37,8,33732,7496,41228
251065,201709,3,3,0,2811,0,2811
251070,201709,26,20,6,18731,5622,24353
251080,201709,4655,2245,2410,2091420.78,2251733.41,4343154.19
251090,201709,200,171,29,160227,27173,187400
251100,201709,18,17,1,15929,937,16866
251110,201709,46,37,9,34669,8433,43102
251120,201709,1754,1040,714,969704.05,669018,1638722.05
251130,201709,345,278,67,260486,62779,323265
251140,201709,499,321,178,299654,166620.34,466274.34
251150,201709,290,252,38,235366,35606,270972
251160,201709,90,75,15,70271,14055,84326
251170,201709,101,81,20,75868.92,18735.32,94604.24
251180,201709,289,180,109,168655.32,102124.32,270779.64
251190,201709,194,133,61,124298.68,57157,181455.68
251200,201709,251,201,50,188337,46850,235187
251203,201709,33,31,2,29047,1874,30921
251207,201709,94,77,17,72149,15929,88078
251210,201709,1223,865,358,808978.34,334790.1,1143768.44
251220,201709,47,37,10,34669,9370,44039
251230,201709,508,429,79,401953,74023,475976
251240,201709,103,73,30,67464,28110,95574
251250,201709,1310,939,371,877454.1,347487,1224941.1
251260,201709,12,7,5,6559,4685,11244
251270,201709,339,250,89,234250,83253,317503
251272,201709,72,66,6,61842,5622,67464
251274,201709,27,22,5,20614,4685,25299
251275,201709,22,15,7,14055,6559,20614
251276,201709,18,15,3,14055,2811,16866
251278,201709,9,7,2,6559,1874,8433
251280,201709,90,86,4,80582,3748,84330
251290,201709,693,521,172,488177,161164,649341
251300,201709,17,15,2,14055,1874,15929
251310,201709,355,257,98,240805,91826,332631
251315,201709,15,14,1,13118,937,14055
251320,201709,62,50,12,46850,11244,58094
251330,201709,79,70,9,65590,8433,74023
251335,201709,9,5,4,4685,3748,8433
251340,201709,682,407,275,381359,256668.63,638027.63
251350,201709,33,31,2,29047,1874,30921
251360,201709,61,53,8,49458.61,7496,56954.61
251365,201709,14,14,0,13118,0,13118
251370,201709,5208,3526,1682,3299367.29,1574723.5,4874090.79
251380,201709,50,40,10,37480,9370,46850
251385,201709,2,2,0,1874,0,1874
251390,201709,643,513,130,479557.6,120592,600149.6
251392,201709,29,19,10,17803,9370,27173
251394,201709,9,9,0,8433,0,8433
251396,201709,18,14,4,13118,3748,16866
251398,201709,17,15,2,14055,1874,15929
251400,201709,36,29,7,27173,6559,33732
251410,201709,33,29,4,27173,3748,30921
251420,201709,108,83,25,77771,23425,101196
251430,201709,36,34,2,31858,1874,33732
251440,201709,38,24,14,22479,13118,35597
251445,201709,50,44,6,41228,5622,46850
251450,201709,410,363,47,338505.4,44039,382544.4
251455,201709,2,1,1,937,937,1874
251460,201709,16,12,4,11244,3748,14992
251465,201709,5,2,3,1874,2811,4685
251470,201709,44,36,8,33732,7496,41228
251480,201709,23,21,2,19677,1874,21551
251490,201709,129,91,38,84799,34670,119469
251500,201709,115,93,22,87141,19865,107006
251510,201709,31,24,7,22488,6559,29047
251520,201709,25,25,0,23425,0,23425
251530,201709,4552,3187,1365,2981549.09,1278714.53,4260263.62
251540,201709,74,66,8,61842,7496,69338
251550,201709,420,323,97,301714.6,90655,392369.6
251560,201709,23,18,5,16866,4685,21551
251570,201709,17,17,0,15929,0,15929
251580,201709,118,95,23,89015,21551,110566
251590,201709,129,95,34,89015,31858,120873
251593,201709,18,10,8,9370,7496,16866
251597,201709,60,49,11,45913,10307,56220
251600,201709,1105,785,320,734083.94,298143.26,1032227.20
251610,201709,205,155,50,144579.1,46195,190774.1
251615,201709,1,1,0,937,0,937
251620,201709,4224,2836,1388,2648211.06,1298121.34,3946332.40
251630,201709,422,312,110,292344,103070,395414
251640,201709,150,107,43,100259,40291,140550
251650,201709,257,187,70,173420.55,65590,239010.55
251660,201709,220,200,20,186463.55,18552.6,205016.15
251670,201709,355,279,76,259859.07,71212,331071.07
251675,201709,3,3,0,2811,0,2811
251680,201709,89,82,7,76834,6559,83393
251690,201709,335,280,55,262360,51191.13,313551.13
251700,201709,279,228,51,213059.75,47772.95,260832.70
251710,201709,17,12,5,11244,4685,15929
251720,201709,34,23,11,21551,10026,31577
251740,201709,9,7,2,6559,1874,8433
260005,201709,3052,1739,1313,1619201.06,1229155.29,2848356.35
260010,201709,1304,925,379,863562.76,353155.96,1216718.72
260020,201709,435,382,53,357934,49661,407595
260030,201709,565,411,154,384353.65,144298,528651.65
260040,201709,853,520,333,485375.37,311871.08,797246.45
260050,201709,1121,790,331,739659,309585,1049244
260060,201709,415,374,41,349688.4,38417,388105.4
260070,201709,1407,890,517,829899,482449.58,1312348.58
260080,201709,726,569,157,531935.55,147109,679044.55
260090,201709,563,348,215,325851.86,201455,527306.86
260100,201709,226,154,72,143314.6,67464,210778.6
260105,201709,239,132,107,123684,100259,223943
260110,201709,2678,1993,685,1867422.63,641049,2508471.63
260120,201709,2946,1576,1370,1465383.18,1281443.55,2746826.73
260130,201709,146,100,46,93700,43102,136802
260140,201709,2035,1330,705,1238806.25,659068.63,1897874.88
260150,201709,229,150,79,140550,74023,214573
260160,201709,290,250,40,234250,37480,271730
260170,201709,3280,2012,1268,1878283.04,1187038.45,3065321.49
260180,201709,140,122,18,114314,16866,131180
260190,201709,2263,1607,656,1502665.03,614672,2117337.03
260200,201709,875,729,146,682311.24,136521,818832.24
260210,201709,1387,968,419,906867.96,392313,1299180.96
260220,201709,703,645,58,603593,54346,657939
260230,201709,1194,900,294,841148.15,275478,1116626.15
260240,201709,213,159,54,147830.49,50598,198428.49
260250,201709,70,56,14,52472,13118,65590
260260,201709,965,691,274,647467,256738,904205
260270,201709,441,357,84,333291.1,78426.9,411718.0
260280,201709,1003,725,278,679137.6,260205,939342.6
260290,201709,6275,3313,2962,3085960.25,2769254.06,5855214.31
260300,201709,806,709,97,662237.8,90608,752845.8
260310,201709,496,393,103,366231.13,96511,462742.13
260320,201709,872,657,215,615325.6,201455,816780.6
260330,201709,28,22,6,20614,5622,26236
260340,201709,64,46,18,43102,16866,59968
260345,201709,5474,3112,2362,2909595.92,2211941.01,5121536.93
260350,201709,465,338,127,314993.16,118063,433056.16
260360,201709,283,145,138,135865,129306,265171
260370,201709,630,411,219,382543.7,205066,587609.7
260380,201709,601,431,170,403847,158166.14,562013.14
260390,201709,292,248,44,231200.19,40291,271491.19
260392,201709,93,80,13,74960,12181,87141
260400,201709,4087,2336,1751,2178958.93,1640331.41,3819290.34
260410,201709,13999,7620,6379,7125353.87,5974440.5,13099794.37
260415,201709,125,110,15,103070,14055,117125
260420,201709,1770,1042,728,970753.55,680684.8,1651438.35
260430,201709,192,176,16,163721.14,14992,178713.14
260440,201709,230,166,64,154831,59968,214799
260450,201709,477,340,137,317318,128369,445687
260460,201709,853,451,402,419965.4,376669.32,796634.72
260470,201709,366,222,144,207264.4,134038.55,341302.95
260480,201709,200,124,76,116188,71212,187400
260490,201709,199,160,39,149920,36543,186463
260500,201709,1115,747,368,696984.83,343738.9,1040723.73
260510,201709,716,561,155,525657,144298,669955
260515,201709,256,227,29,212699,26705,239404
260520,201709,3276,1933,1343,1803432.51,1256508.21,3059940.72
260530,201709,742,604,138,563100.26,129306,692406.26
260540,201709,584,435,149,407595,138676.66,546271.66
260545,201709,15,10,5,9370,4685,14055
260550,201709,327,202,125,189274,117125,306399
260560,201709,516,391,125,365787,116843.9,482630.9
260570,201709,995,823,172,768200.9,161164,929364.9
260580,201709,281,249,32,233313,29984,263297
260590,201709,639,366,273,341555.24,255801,597356.24
260600,201709,8182,4074,4108,3795414.64,3846006.02,7641420.66
260610,201709,496,328,168,307336,157134.9,464470.9
260620,201709,3521,1864,1657,1735789.5,1547706.26,3283495.76
260630,201709,71,68,3,63716,2811,66527
260640,201709,3575,1954,1621,1827639.49,1518531.05,3346170.54
260650,201709,335,229,106,214573,99279.85,313852.85
260660,201709,491,335,156,313520.2,145329.08,458849.28
260670,201709,101,75,26,70275,24362,94637
260680,201709,3658,2026,1632,1880824.68,1527255.52,3408080.20
260690,201709,195,156,39,145517,36543,182060
260700,201709,331,198,133,184776.4,123804,308580.4
260710,201709,38,36,2,33732,1874,35606
260720,201709,2188,1316,872,1227309.23,815724.09,2043033.32
260730,201709,597,453,144,424461,133054.45,557515.45
260740,201709,64,61,3,57157,2811,59968
260750,201709,645,449,196,420113.32,183652,603765.32
260760,201709,631,345,286,323265,267652,590917
260765,201709,976,511,465,475917.9,435470.75,911388.65
260770,201709,214,160,54,149920,50598,200518
260775,201709,815,485,330,453087.9,309201,762288.9
260780,201709,266,167,99,156479,92631.82,249110.82
260790,201709,12395,6799,5596,6343153.3,5236288.9,11579442.2
260795,201709,156,106,50,98178.86,46850,145028.86
260800,201709,370,305,65,285317,60905,346222
260805,201709,200,130,70,121094.13,65590,186684.13
260810,201709,743,648,95,605948.53,89015,694963.53
260820,201709,311,207,104,192653,97448,290101
260825,201709,201,137,64,127998.71,59968,187966.71
260830,201709,258,166,92,155401.45,86204,241605.45
260840,201709,227,163,64,152076,59687,211763
260845,201709,212,147,65,137194.98,60905,198099.98
260850,201709,514,372,142,346929.64,133054,479983.64
260860,201709,249,185,64,173150.86,59968,233118.86
260870,201709,364,256,108,239872,101196,341068
260875,201709,680,472,208,441170.53,194896,636066.53
260880,201709,1463,919,544,860397.31,509540.6,1369937.91
260890,201709,2446,1707,739,1592029.29,691507,2283536.29
260900,201709,1030,695,335,649936.95,313895,963831.95
260910,201709,272,214,58,200518,54346,254864
260915,201709,309,207,102,193959,95454,289413
260920,201709,168,97,71,90889,66527,157416
260930,201709,401,340,61,318580,57072.75,375652.75
260940,201709,2715,1482,1233,1384700.55,1154553.26,2539253.81
260950,201709,1894,1110,784,1033727.45,734608,1768335.45
260960,201709,14176,7371,6805,6870349.09,6368639.47,13238988.56
260970,201709,426,366,60,342942,56220,399162
260980,201709,208,181,27,169307,25299,194606
260990,201709,2497,2062,435,1931598.01,407595,2339193.01
261000,201709,4316,2528,1788,2354981.52,1672836.27,4027817.79
261010,201709,192,137,55,128369,50731.8,179100.8
261020,201709,617,457,160,428069,149123.55,577192.55
261030,201709,209,151,58,141487,54144.55,195631.55
261040,201709,361,325,36,304525,33450.9,337975.9
261050,201709,461,406,55,380422,51535,431957
261060,201709,1305,853,452,797153.88,423524,1220677.88
261070,201709,8909,4569,4340,4257421.71,4058258.8,8315680.51
261080,201709,395,300,95,281100,89015,370115
261090,201709,2147,1655,492,1543172.92,460255,2003427.92
261100,201709,1061,753,308,703734.8,286759.48,990494.28
261110,201709,7944,4845,3099,4534692.44,2901521.14,7436213.58
261120,201709,286,239,47,223662,44035,267697
261130,201709,566,323,243,302323.45,227691,530014.45
261140,201709,185,118,67,110566,62779,173345
261150,201709,657,380,277,355592,258893.1,614485.1
261153,201709,73,70,3,64653.12,2811,67464.12
261160,201709,75987,38702,37285,36144911.93,34911719.48,71056631.41
261170,201709,463,344,119,321429,111503,432932
261180,201709,1743,1062,681,990212.53,638097,1628309.53
261190,201709,621,428,193,400633.89,180832,581465.89
261200,201709,211,188,23,175451.09,21551,197002.09
261210,201709,31,28,3,26236,2811,29047
261220,201709,2440,1711,729,1597681.11,681949,2279630.11
261230,201709,313,234,79,219258,74008.95,293266.95
261240,201709,438,379,59,351181.47,55283,406464.47
261245,201709,215,180,35,168660,32795,201455
261247,201709,143,104,39,97448,36543,133991
261250,201709,2754,1355,1399,1269072.9,1309772.71,2578845.61
261255,201709,248,227,21,212699,19677,232376
261260,201709,830,716,114,670892,106818,777710
261270,201709,176,136,40,127432,37480,164912
261280,201709,143,115,28,107755,26236,133991
261290,201709,132,91,41,85032.75,38417,123449.75
261300,201709,1221,863,358,808631,335446,1144077
261310,201709,749,501,248,469437,231766.95,701203.95
261320,201709,526,352,174,329824,163038,492862
261330,201709,805,642,163,598610.25,151900.53,750510.78
261340,201709,315,172,143,161164,133991,295155
261350,201709,762,541,221,505980.1,207077,713057.1
261360,201709,1180,751,429,703292.53,401973,1105265.53
261370,201709,4900,3017,1883,2810990.32,1762707.2,4573697.52
261380,201709,572,416,156,387927.92,145891,533818.92
261390,201709,3369,2243,1126,2097015.74,1051269.15,3148284.89
261400,201709,287,262,25,244650.7,23425,268075.7
261410,201709,1029,668,361,625916,338252.32,964168.32
261420,201709,857,532,325,496583.63,304506.63,801090.26
261430,201709,330,299,31,279332,28765.9,308097.9
261440,201709,93,82,11,76834,10307,87141
261450,201709,2476,2062,414,1929669.13,386926.12,2316595.25
261460,201709,688,551,137,515350.81,128369,643719.81
261470,201709,243,185,58,172549,54346,226895
261480,201709,328,269,59,250930,55279,306209
261485,201709,338,209,129,195177.1,120873,316050.1
261500,201709,625,419,206,392603,193022,585625
261510,201709,40,29,11,27173,10307,37480
261520,201709,170,156,14,146172,13118,159290
261530,201709,4139,2619,1520,2445903.99,1423008.95,3868912.94
261540,201709,1057,643,414,602035.62,387918,989953.62
261550,201709,284,139,145,128885,135865,264750
261560,201709,770,513,257,478246.1,239394.8,717640.9
261570,201709,361,282,79,264234,74023,338257
261580,201709,376,294,82,274731,76834,351565
261590,201709,187,153,34,143361,31858,175219
261600,201709,282,227,55,211950,51067,263017
261610,201709,100,87,13,81171,12181,93352
261618,201709,67,52,15,48724,14055,62779
261620,201709,213,128,85,119936,79645,199581
261630,201709,589,449,140,418396.8,130993,549389.8
261640,201709,6185,3280,2905,3065007.75,2719184.26,5784192.01
261650,201709,474,295,179,275749.73,167723,443472.73
270010,201709,512,447,65,418839,60156,478995
270020,201709,304,239,65,223939,60905,284844
270030,201709,9015,5757,3258,5381645.88,3050303.91,8431949.79
270040,201709,1909,1161,748,1087753.94,700594.9,1788348.84
270050,201709,184,137,47,128369,44039,172408
270060,201709,120,66,54,61842,50598,112440
270070,201709,903,647,256,604258.26,239563.16,843821.42
270080,201709,44,37,7,34669,6559,41228
270090,201709,20,16,4,14992,3748,18740
270100,201709,1288,837,451,780414.28,420479.35,1200893.63
270110,201709,161,118,43,110566,40291,150857
270120,201709,222,181,41,168760.72,38135.9,206896.62
270130,201709,263,181,82,169315.9,76552.9,245868.8
270135,201709,96,57,39,53409,36543,89952
270140,201709,1243,741,502,694108.74,468866.4,1162975.14
270150,201709,270,218,52,204266,48724,252990
270160,201709,516,379,137,354236,127713.1,481949.1
270170,201709,669,422,247,394570.7,230642.55,625213.25
270180,201709,68,51,17,47474.7,15722.86,63197.56
270190,201709,106,93,13,87141,12181,99322
270200,201709,110,98,12,91638.6,11244,102882.6
270210,201709,492,253,239,237061,223661.9,460722.9
270220,201709,193,154,39,144298,36543,180841
270230,201709,2056,1222,834,1138116.76,778653.2,1916769.96
270235,201709,730,542,188,507554.66,175797.48,683352.14
270240,201709,3074,2361,713,2202052.76,664494.8,2866547.56
270250,201709,177,123,54,114501.4,50598,165099.4
270255,201709,223,196,27,183652,24924.2,208576.2
270260,201709,323,258,65,241559,60623.9,302182.9
270270,201709,120,48,72,44967,67464,112431
270280,201709,212,133,79,124621,74023,198644
270290,201709,1134,844,290,789488.59,270859.26,1060347.85
270300,201709,258,162,96,151794,89670.9,241464.9
270310,201709,940,748,192,698683.18,179201.99,877885.17
270320,201709,896,761,135,711193.66,126213.9,837407.56
270330,201709,267,219,48,204266,44976,249242
270340,201709,59,46,13,43102,12181,55283
270350,201709,95,49,46,45913,43102,89015
270360,201709,76,41,35,38417,32795,71212
270370,201709,48,35,13,32795,12181,44976
270375,201709,63,34,29,31858,27169,59027
270380,201709,1071,591,480,552830,449760,1002590
270390,201709,198,105,93,98385,87141,185526
270400,201709,690,498,192,465432.43,179895,645327.43
270410,201709,701,495,206,463815,193012.63,656827.63
270420,201709,390,251,139,233520,130160.89,363680.89
270430,201709,31758,22580,9178,21105944.2,8589692.73,29695636.93
270440,201709,496,385,111,359761.55,103725.9,463487.45
270450,201709,768,395,373,369880.75,349501,719381.75
270460,201709,198,147,51,137739,47787,185526
270470,201709,1323,868,455,812967.95,426111,1239078.95
270480,201709,513,413,100,384704.29,92997.25,477701.54
270490,201709,27,21,6,19677,5622,25299
270500,201709,527,424,103,397288,96511,493799
270510,201709,736,454,282,425398,264234,689632
270520,201709,404,245,159,229218.45,148983,378201.45
270530,201709,65,57,8,53409,7496,60905
270540,201709,125,95,30,89015,28110,117125
270550,201709,1706,1290,416,1207476.37,389787.32,1597263.69
270560,201709,322,147,175,137739,163975,301714
270570,201709,432,275,157,256859.73,147109,403968.73
270580,201709,74,52,22,48724,20614,69338
270590,201709,82,68,14,63716,13118,76834
270600,201709,178,145,33,135865,30921,166786
270610,201709,169,134,35,125549,32795,158344
270620,201709,31,30,1,28110,937,29047
270630,201709,3799,2875,924,2682917.96,863671.38,3546589.34
270640,201709,905,656,249,612067.3,233004.9,845072.2
270642,201709,199,168,31,157416,29047,186463
270644,201709,292,198,94,185338.97,88073.32,273412.29
270650,201709,234,140,94,131180,88078,219258
270660,201709,258,208,50,194896,46850,241746
270670,201709,3181,2397,784,2235167.84,732435.12,2967602.96
270680,201709,456,264,192,247359,179899.32,427258.32
270690,201709,1115,694,421,648576.24,394467.63,1043043.87
270700,201709,35,27,8,25299,7496,32795
270710,201709,862,643,219,600904.86,205203,806107.86
270720,201709,249,187,62,175219,57812.9,233031.9
270730,201709,1834,1060,774,990927.47,723169.6,1714097.07
270740,201709,46,27,19,25299,17803,43102
270750,201709,621,451,170,422587,158635,581222
270760,201709,312,226,86,211762,80582,292344
270770,201709,2682,1671,1011,1557786.84,946370,2504156.84
270780,201709,91,56,35,52467.32,32777.64,85244.96
270790,201709,277,184,93,172408,87141,259549
270800,201709,1960,1549,411,1449652.12,384376.14,1834028.26
270810,201709,321,250,71,234235.95,66518.32,300754.27
270820,201709,157,100,57,93700,53316,147016
270830,201709,1002,722,280,675761,262360,938121
270840,201709,1400,1010,390,945878.2,364494,1310372.2
270850,201709,1735,1051,684,979490.98,640875.58,1620366.56
270860,201709,2456,1580,876,1475570.16,817946.9,2293517.06
270870,201709,122,66,56,61842,52472,114314
270880,201709,912,653,259,609300.3,241778.75,851079.05
270890,201709,370,270,100,252549.61,93695.32,346244.93
270895,201709,73,63,10,59031,9370,68401
270900,201709,110,87,23,81519,21551,103070
270910,201709,336,264,72,246243.6,67464,313707.6
270915,201709,1796,1060,736,988267.82,689168.31,1677436.13
270920,201709,503,417,86,390729,80582,471311
270930,201709,6196,4428,1768,4143620.31,1653877.67,5797497.98
270940,201709,2408,1810,598,1694035.09,559371,2253406.09
280010,201709,43,39,4,36543,3748,40291
280020,201709,702,601,101,561232.31,93700,654932.31
280030,201709,18745,11991,6754,11163273.61,6300171.83,17463445.44
280040,201709,347,221,126,207077,116562.83,323639.83
280050,201709,372,285,87,266763.9,81519,348282.9
280060,201709,316,209,107,194451.48,100259,294710.48
280067,201709,969,679,290,633515.26,270758.12,904273.38
280070,201709,126,104,22,97448,20614,118062
280100,201709,612,479,133,445096.98,124434,569530.98
280110,201709,75,70,5,65590,4685,70275
280120,201709,626,498,128,466626,119936,586562
280130,201709,1291,795,496,743369.9,464611.45,1207981.35
280140,201709,458,364,94,340224.7,88078,428302.7
280150,201709,315,229,86,213905.21,79645,293550.21
280160,201709,98,83,15,77771,14055,91826
280170,201709,573,381,192,355540.68,179107.55,534648.23
280190,201709,28,26,2,24362,1874,26236
280200,201709,21,14,7,13118,6559,19677
280210,201709,2724,1917,807,1777435.24,750117.99,2527553.23
280220,201709,39,31,8,29047,7496,36543
280230,201709,307,251,56,234367.95,51535.1,285903.05
280240,201709,112,105,7,98244.45,6550,104794.45
280250,201709,22,13,9,12181,8433,20614
280260,201709,77,69,8,64653,7496,72149
280270,201709,162,124,38,116188,35606,151794
280280,201709,196,124,72,116188,67464,183652
280290,201709,2997,2172,825,2021087.6,771737.63,2792825.23
280300,201709,1072,813,259,760145.93,241933.4,1002079.33
280310,201709,105,99,6,92576,5622,98198
280320,201709,645,435,210,407586,196770,604356
280330,201709,357,254,103,237154.7,96389.19,333543.89
280340,201709,404,322,82,300269.05,76085,376354.05
280350,201709,3365,2598,767,2425191.36,715988.41,3141179.77
280360,201709,465,295,170,276415,158353,434768
280370,201709,93,82,11,76834,10307,87141
280380,201709,57,42,15,39354,14055,53409
280390,201709,185,153,32,143361,29984,173345
280400,201709,335,226,109,210919.4,102133,313052.4
280410,201709,290,233,57,217179,53399.63,270578.63
280420,201709,172,145,27,135865,25299,161164
280430,201709,107,79,28,74023,26236,100259
280440,201709,662,505,157,469110.7,146912.23,616022.93
280445,201709,114,104,10,97448,9370,106818
280450,201709,1047,896,151,836272.5,141487,977759.5
280460,201709,719,512,207,472865.76,193959,666824.76
280470,201709,192,174,18,163038,15930,178968
280480,201709,2216,1582,634,1468260.29,590041.65,2058301.94
280490,201709,373,340,33,317436,30921,348357
280500,201709,51,47,4,44039,3748,47787
280510,201709,144,109,35,101835.6,32514,134349.6
280520,201709,56,41,15,38417,14055,52472
280530,201709,75,54,21,50598,19677,70275
280540,201709,490,387,103,362619,96229.9,458848.9
280550,201709,701,648,53,604606.3,49661,654267.3
280560,201709,468,401,67,373581.9,62779,436360.9
280570,201709,1757,1326,431,1239177.42,403847,1643024.42
280580,201709,591,451,140,422166.9,131087,553253.9
280590,201709,161,97,64,90614.46,59968,150582.46
280600,201709,344,289,55,269125.54,51535,320660.54
280610,201709,143,104,39,97246,36543,133789
280620,201709,556,447,109,417902.75,101992.45,519895.20
280630,201709,166,137,29,128369,27173,155542
280640,201709,209,164,45,152854,42165,195019
280650,201709,81,53,28,49661,26236,75897
280660,201709,127,92,35,86204,32560.75,118764.75
280670,201709,1538,948,590,882725.23,549152.98,1431878.21
280680,201709,176,149,27,137862,25299,163161
280690,201709,42,36,6,33732,5622,39354
280700,201709,16,16,0,14992,0,14992
280710,201709,1405,1046,359,972778.39,335727.1,1308505.49
280720,201709,107,73,34,65886.7,31858,97744.7
280730,201709,23,19,4,17803,3748,21551
280740,201709,2331,1699,632,1588147.82,590442.07,2178589.89
280750,201709,291,250,41,234250,38417,272667
280760,201709,862,584,278,546083.6,260345.45,806429.05
290010,201709,188,125,63,117125,59031,176156
290020,201709,175,162,13,151794,12181,163975
290030,201709,583,375,208,350719.1,194896,545615.1
290035,201709,136,109,27,98985.8,25299,124284.8
290040,201709,269,170,99,159290,92763,252053
290050,201709,70,52,18,48724,16866,65590
290060,201709,257,110,147,102788.9,137739,240527.9
290070,201709,5442,2648,2794,2474057.07,2614563.85,5088620.92
290080,201709,518,238,280,222518.76,262342,484860.76
290090,201709,386,167,219,156479,205203,361682
290100,201709,1557,1024,533,955367.05,498858.9,1454225.95
290110,201709,755,444,311,414431.1,291313.3,705744.4
290115,201709,215,197,18,183652,16866,200518
290120,201709,780,511,269,478151.1,252053,730204.1
290130,201709,420,244,176,228337.53,164912,393249.53
290135,201709,294,224,70,209222.73,65590,274812.73
290140,201709,286,236,50,221132,46662.6,267794.6
290150,201709,129,96,33,89952,30921,120873
290160,201709,245,192,53,178686.05,49661,228347.05
290170,201709,86,58,28,54346,26236,80582
290180,201709,150,117,33,109629,30921,140550
290190,201709,446,364,82,340787,76552.9,417339.9
290195,201709,293,163,130,152731,121810,274541
290200,201709,292,248,44,232376,41228,273604
290205,201709,136,80,56,74960,52472,127432
290210,201709,1104,801,303,749413.6,283911,1033324.6
290220,201709,217,120,97,111971.5,90889,202860.5
290225,201709,271,99,172,92763,161164,253927
290230,201709,65,42,23,39354,21551,60905
290240,201709,312,126,186,117780.9,174282,292062.9
290250,201709,265,238,27,222135,25299,247434
290260,201709,264,223,41,208202,38417,246619
290265,201709,186,150,36,139747,33732,173479
290270,201709,1376,1126,250,1053188,233403,1286591
290280,201709,467,346,121,324202,113377,437579
290290,201709,1174,674,500,627099.61,468500,1095599.61
290300,201709,454,385,69,360225.07,64653,424878.07
290310,201709,321,141,180,132117,168660,300777
290320,201709,3882,2415,1467,2260127.46,1371768.5,3631895.96
290323,201709,182,158,24,147765,22488,170253
290327,201709,145,113,32,105613.96,29984,135597.96
290330,201709,69,37,32,34669,29984,64653
290340,201709,915,363,552,339176.1,516641.9,855818.0
290350,201709,564,337,227,315769,212699,528468
290360,201709,360,270,90,251116.86,84330,335446.86
290370,201709,991,370,621,346409,581877,928286
290380,201709,292,176,116,164912,108692,273604
290390,201709,2442,1516,926,1416916.57,865788,2282704.57
290395,201709,235,130,105,121576,98385,219961
290400,201709,281,206,75,192460,70275,262735
290405,201709,258,220,38,206140,35606,241746
290410,201709,553,471,82,438376.9,76834,515210.9
290420,201709,224,173,51,162101,47787,209888
290430,201709,514,319,195,298903,182715,481618
290440,201709,74,64,10,59968,8745.3,68713.3
290450,201709,232,179,53,167723,49661,217384
290460,201709,1839,1087,752,1017618.89,704437.56,1722056.45
290470,201709,1435,598,837,558914.17,783957.08,1342871.25
290475,201709,589,552,37,517224,34669,551893
290480,201709,287,158,129,148046,120873,268919
290485,201709,208,195,13,182715,12181,194896
290490,201709,1100,780,320,730110.4,298903.6,1029014.0
290500,201709,653,327,326,305462,305462,610924
290510,201709,217,163,54,152076,50594,202670
290515,201709,129,73,56,68401,52472,120873
290520,201709,1338,858,480,802353.61,446576.01,1248929.62
290530,201709,308,280,28,262360,26236,288596
290540,201709,90,55,35,51535,32795,84330
290550,201709,152,129,23,120873,21204.31,142077.31
290560,201709,3365,1361,2004,1274245.04,1877557.4,3151802.44
290570,201709,5674,2906,2768,2718392.32,2590569.89,5308962.21
290580,201709,1225,702,523,656555.9,489348.25,1145904.15
290590,201709,530,437,93,408720,87141,495861
290600,201709,1698,1179,519,1100133.08,486303,1586436.08
290610,201709,218,197,21,184140,19677,203817
290620,201709,321,282,39,264234,35980.8,300214.8
290630,201709,2119,891,1228,831120,1145112.47,1976232.47
290640,201709,150,122,28,114314,26236,140550
290650,201709,1663,780,883,729914.42,827371,1557285.42
290660,201709,275,223,52,208951,48724,257675
290670,201709,970,510,460,477308,430679.9,907987.9
290680,201709,1158,934,224,874221,208951,1083172
290682,201709,285,208,77,193927.15,72130.63,266057.78
290685,201709,227,144,83,133991,77771,211762
290687,201709,908,600,308,558873.8,286600.29,845474.09
290689,201709,121,72,49,67450,45898.95,113348.95
290690,201709,671,279,392,261414,366432.03,627846.03
290700,201709,247,116,131,108692,122747,231439
290710,201709,679,445,234,416965,219258,636223
290720,201709,1019,833,186,780521,173813.5,954334.5
290730,201709,1118,637,481,595041.85,449760,1044801.85
290740,201709,16,12,4,11244,3748,14992
290750,201709,1326,600,726,560890.83,678970.55,1239861.38
290755,201709,67,59,8,55283,7496,62779
290760,201709,304,266,38,249242,35606,284848
290770,201709,186,173,13,162091.63,12181,174272.63
290780,201709,945,759,186,709274.23,172501.7,881775.93
290790,201709,433,293,140,273972,131180,405152
290800,201709,2610,1035,1575,966470.07,1474678.71,2441148.78
290810,201709,435,301,134,281756,125558,407314
290820,201709,371,229,142,213622,133054,346676
290830,201709,389,259,130,242683,121810,364493
290840,201709,1636,1005,631,939858.4,588267.44,1528125.84
290850,201709,744,408,336,381265.3,313895,695160.3
290860,201709,652,292,360,273604,337039,610643
290870,201709,658,478,180,447249,168660,615909
290880,201709,126,70,56,65590,52472,118062
290890,201709,366,264,102,247368,95574,342942
290900,201709,168,129,39,120873,36543,157416
290910,201709,365,277,88,259549,82456,342005
290920,201709,230,191,39,178967,36543,215510
290930,201709,799,608,191,568918.29,178967,747885.29
290940,201709,251,203,48,189461.4,44976,234437.4
290950,201709,171,97,74,90889,69338,160227
290960,201709,431,288,143,268638.72,133709.9,402348.62
290970,201709,249,218,31,204078.6,29047,233125.6
290980,201709,1458,1033,425,963846.02,397195.1,1361041.12
290990,201709,364,304,60,284839,56164.89,341003.89
291000,201709,846,235,611,220195,572225.9,792420.9
291005,201709,1988,841,1147,786274.28,1073975.72,1860250.00
291010,201709,157,143,14,133991,13118,147109
291020,201709,102,80,22,74960,20614,95574
291030,201709,88,66,22,61842,20614,82456
291040,201709,580,288,292,269856,273604,543460
291050,201709,1300,732,568,684612.92,532216,1216828.92
291060,201709,1470,797,673,746133.1,630601,1376734.1
291070,201709,1878,1388,490,1294982.5,456283.18,1751265.68
291072,201709,7198,2638,4560,2468518.28,4269954.92,6738473.20
291075,201709,193,156,37,146172,34669,180841
291077,201709,48,33,15,30921,14055,44976
291080,201709,18923,8224,10699,7684065.64,10012227.92,17696293.56
291085,201709,283,228,55,213636,51530.32,265166.32
291090,201709,314,117,197,109348,184579.63,293927.63
291100,201709,727,215,512,201455,479744,681199
291110,201709,394,302,92,282974,86204,369178
291120,201709,2495,1153,1342,1080221,1255510.76,2335731.76
291125,201709,59,31,28,29047,26236,55283
291130,201709,207,179,28,167723,26236,193959
291140,201709,120,87,33,81519,30640,112159
291150,201709,379,150,229,140550,214573,355123
291160,201709,340,286,54,267045.25,50598,317643.25
291165,201709,17,13,4,12181,3748,15929
291170,201709,2821,1421,1400,1329322.55,1308801.9,2638124.45
291180,201709,1303,486,817,455244,765475,1220719
291185,201709,70,67,3,62779,2811,65590
291190,201709,1220,510,710,476364.5,664736.9,1141101.4
291200,201709,160,115,45,107755,42165,149920
291210,201709,2149,822,1327,767131.27,1241628.54,2008759.81
291220,201709,249,189,60,176156.43,56220,232376.43
291230,201709,1018,342,676,319611,633412,953023
291240,201709,443,418,25,390448,23425,413873
291250,201709,424,345,79,323265,74023,397288
291260,201709,39,29,10,27173,9370,36543
291270,201709,1190,476,714,446012,668502.9,1114514.9
291280,201709,373,166,207,155354.6,193668.53,349023.13
291290,201709,1736,874,862,817813.6,806664,1624477.6
291300,201709,227,181,46,168941.1,43102,212043.1
291310,201709,242,216,26,202111,24362,226473
291320,201709,1372,983,389,917978.9,363412.8,1281391.7
291330,201709,128,108,20,99415.7,18740,118155.7
291340,201709,140,78,62,73086,58094,131180
291345,201709,126,82,44,76834,41228,118062
291350,201709,1553,487,1066,455850.5,998655.15,1454505.65
291360,201709,8454,4172,4282,3900186.03,4009289.28,7909475.31
291370,201709,1052,568,484,531935,453508,985443
291380,201709,258,206,52,193022,48724,241746
291390,201709,3849,1662,2187,1552920.5,2047720,3600640.5
291400,201709,2045,1455,590,1358276.79,550896.39,1909173.18
291410,201709,153,135,18,125558,16866,142424
291420,201709,103,74,29,69338,27173,96511
291430,201709,187,104,83,96753,76834.96,173587.96
291440,201709,496,397,99,369594.25,92763,462357.25
291450,201709,854,528,326,492582.54,304525,797107.54
291460,201709,1693,1375,318,1285938.8,297966,1583904.8
291465,201709,2220,1030,1190,964817.93,1114776.15,2079594.08
291470,201709,2715,1379,1336,1288404.95,1250833,2539237.95
291480,201709,11756,5193,6563,4854794.01,6140052.38,10994846.39
291490,201709,541,220,321,206140,300777,506917
291500,201709,365,194,171,181778,160227,342005
291510,201709,1271,476,795,444872.75,744633.9,1189506.65
291520,201709,955,428,527,401036,493789.63,894825.63
291530,201709,1016,269,747,252053,699639.26,951692.26
291535,201709,113,96,17,89952,15929,105881
291540,201709,363,108,255,101196,237998.8,339194.8
291550,201709,1171,541,630,505044.19,589729.9,1094774.09
291560,201709,5543,2852,2691,2659465.11,2510025.89,5169491.00
291570,201709,200,102,98,95574,91826,187400
291580,201709,1194,720,474,673887.63,444124.32,1118011.95
291590,201709,72,28,44,25814.35,41228,67042.35
291600,201709,1358,613,745,573444,697766,1271210
291610,201709,1334,593,741,554380.74,694262,1248642.74
291620,201709,554,255,299,238935,279788.2,518723.2
291630,201709,501,162,339,151794,317643,469437
291640,201709,3860,1913,1947,1785588.88,1823245.71,3608834.59
291650,201709,344,223,121,207836.97,113190,321026.97
291660,201709,455,181,274,168917.3,255660.45,424577.75
291670,201709,221,138,83,128744,77771,206515
291680,201709,704,398,306,372926,286629,659555
291685,201709,557,296,261,277118,244369.6,521487.6
291690,201709,559,280,279,262360,260486,522846
291700,201709,899,711,188,666207,175219,841426
291710,201709,1705,775,930,725491.34,870548.93,1596040.27
291720,201709,399,268,131,251080.01,122747,373827.01
291730,201709,923,528,395,493845.85,370105.63,863951.48
291733,201709,253,177,76,165567.9,71212,236779.9
291735,201709,67,52,15,48724,14055,62779
291740,201709,340,257,83,240106.25,77771,317877.25
291750,201709,1920,1273,647,1186352.48,604616.81,1790969.29
291760,201709,3073,1642,1431,1531752.26,1339160.5,2870912.76
291770,201709,795,534,261,498295.03,244557,742852.03
291780,201709,48,27,21,25299,19677,44976
291790,201709,168,79,89,74023,83393,157416
291800,201709,9741,3774,5967,3527233.27,5585923.67,9113156.94
291810,201709,1150,814,336,761870.22,314832,1076702.22
291820,201709,266,193,73,180841,68401,249242
291830,201709,1052,384,668,358609,624970,983579
291835,201709,633,571,62,534559,58094,592653
291840,201709,4601,2350,2251,2197242.62,2108363.18,4305605.80
291845,201709,312,107,205,100259,192056.89,292315.89
291850,201709,327,283,44,264936.75,41228,306164.75
291855,201709,264,107,157,100259,147109,247368
291860,201709,211,127,84,118063,78708,196771
291870,201709,79,32,47,29984,44039,74023
291875,201709,178,161,17,150857,15929,166786
291880,201709,484,378,106,353390,99322,452712
291890,201709,242,81,161,75887.63,149170.5,225058.13
291900,201709,57,32,25,29984,23425,53409
291905,201709,141,93,48,86860,44976,131836
291910,201709,181,145,36,135865,33732,169597
291915,201709,384,340,44,316942,41228,358170
291920,201709,4777,2459,2318,2301441.71,2170321.34,4471763.05
291930,201709,179,102,77,94637.7,72149,166786.7
291940,201709,308,168,140,156493.57,129962.21,286455.78
291950,201709,1102,903,199,845362,186463,1031825
291955,201709,953,560,393,524720,367820,892540
291960,201709,168,114,54,106818,50598,157416
291970,201709,787,597,190,559389,178030,737419
291980,201709,1492,1318,174,1231614.79,162101.7,1393716.49
291990,201709,121,113,8,105881,7496,113377
291992,201709,157,78,79,72336.4,74023,146359.4
291995,201709,146,104,42,97448,39354,136802
292000,201709,382,285,97,265827,90889,356716
292010,201709,280,204,76,190493,70066,260559
292020,201709,263,194,69,181778,64653,246431
292030,201709,141,110,31,103070,29047,132117
292040,201709,614,311,303,291407,283911,575318
292045,201709,83,75,8,70275,7496,77771
292050,201709,885,593,292,554650.26,273604,828254.26
292060,201709,922,768,154,717743.59,144298,862041.59
292070,201709,51,22,29,20614,27173,47787
292080,201709,111,76,35,71212,32795,104007
292090,201709,485,167,318,156291.6,297966,454257.6
292100,201709,1359,585,774,546599.35,724264.26,1270863.61
292105,201709,203,170,33,159290,30921,190211
292110,201709,2084,769,1315,720234.42,1229883.68,1950118.10
292120,201709,630,505,125,472072.96,117125,589197.96
292130,201709,439,256,183,239872,171471,411343
292140,201709,198,156,42,146172,39224.61,185396.61
292145,201709,151,79,72,74023,67435.9,141458.9
292150,201709,1397,1119,278,1048503,259476.57,1307979.57
292160,201709,181,149,32,139331.9,29984,169315.9
292170,201709,1214,1067,147,998116.13,137682.78,1135798.91
292180,201709,194,139,55,130243,51535,181778
292190,201709,160,98,62,91826,58094,149920
292200,201709,1249,455,794,425400.24,743341.68,1168741.92
292205,201709,112,101,11,94355.9,10307,104662.9
292210,201709,353,244,109,227270,101430.25,328700.25
292220,201709,22,15,7,14055,6559,20614
292225,201709,41,36,5,33732,4685,38417
292230,201709,893,725,168,676675.72,157416,834091.72
292240,201709,606,426,180,398085,168660,566745
292250,201709,1642,1036,606,970732,567822,1538554
292260,201709,435,243,192,227691,179154.4,406845.4
292265,201709,274,190,84,177748.9,78708,256456.9
292270,201709,781,336,445,314176.1,416028.4,730204.5
292273,201709,198,112,86,104180.34,80582,184762.34
292275,201709,157,72,85,67464,79363.9,146827.9
292280,201709,133,92,41,86204,38417,124621
292285,201709,57,48,9,44320.1,8433,52753.1
292290,201709,490,323,167,300206.01,156198,456404.01
292300,201709,1588,601,987,562574.9,923194.99,1485769.89
292303,201709,91,63,28,59031,26236,85267
292305,201709,106,74,32,69338,29984,99322
292310,201709,827,512,315,479389,293005.15,772394.15
292320,201709,636,481,155,450415.9,145235,595650.9
292330,201709,192,95,97,89015,90889,179904
292335,201709,269,204,65,191148,60905,252053
292340,201709,560,384,176,359081.93,164912,523993.93
292350,201709,256,133,123,123824.55,114969.9,238794.45
292360,201709,684,516,168,481805.5,157416,639221.5
292370,201709,783,595,188,557515,176156,733671
292380,201709,645,493,152,459787.01,142424,602211.01
292390,201709,507,187,320,175219,298106.75,473325.75
292400,201709,3328,2048,1280,1900060.63,1195830,3095890.63
292405,201709,255,167,88,156010.5,82174.9,238185.4
292410,201709,155,92,63,86204,59031,145235
292420,201709,304,260,44,243338.9,41228,284566.9
292430,201709,500,396,104,371052,96979.5,468031.5
292440,201709,576,487,89,454253.36,83393,537646.36
292450,201709,242,186,56,174282,52472,226754
292460,201709,586,429,157,401410.9,146406.25,547817.15
292465,201709,184,156,28,146172,25511.24,171683.24
292467,201709,93,52,41,48724,38417,87141
292470,201709,249,167,82,156479,76834,233313
292480,201709,302,202,100,188337.75,93419,281756.75
292490,201709,223,144,79,134928,74023,208951
292500,201709,1181,509,672,476726,629214.35,1105940.35
292510,201709,3256,1451,1805,1358650.36,1688606.35,3047256.71
292520,201709,1032,487,545,455143.75,510656,965799.75
292525,201709,378,265,113,248300.32,105881,354181.32
292530,201709,4155,1702,2453,1591859.41,2296439.85,3888299.26
292540,201709,478,254,224,237998,209888,447886
292550,201709,1045,553,492,517431.6,460534.64,977966.24
292560,201709,321,299,22,280163,20614,300777
292570,201709,290,220,70,205817,65590,271407
292575,201709,453,280,173,262079,162101,424180
292580,201709,898,567,331,529873.5,309584.9,839458.4
292590,201709,513,438,75,410108.98,70275,480383.98
292593,201709,142,112,30,104944,28110,133054
292595,201709,175,132,43,123684,40291,163975
292600,201709,1235,922,313,863602,292625.1,1156227.1
292610,201709,121,91,30,84798.5,27857.01,112655.51
292620,201709,513,425,88,397935,82456,480391
292630,201709,1351,778,573,727426.5,534558.9,1261985.4
292640,201709,761,529,232,495673,217384,713057
292650,201709,187,161,26,150426,24362,174788
292660,201709,1969,1401,568,1307018.02,527245.96,1834263.98
292665,201709,133,95,38,89015,35606,124621
292670,201709,370,312,58,292340,54346,346686
292680,201709,242,187,55,175219,50786,226005
292690,201709,178,134,44,125558,41228,166786
292700,201709,907,596,311,557515.9,291407,848922.9
292710,201709,98,86,12,80582,10963,91545
292720,201709,820,459,361,429295.92,338070,767365.92
292730,201709,208,98,110,90889.75,103070,193959.75
292740,201709,64731,31997,32734,29910037.07,30645056.37,60555093.44
292750,201709,377,266,111,248305.07,103211.01,351516.08
292760,201709,314,253,61,236068.25,57157,293225.25
292770,201709,777,335,442,313373.56,413773.01,727146.57
292780,201709,424,163,261,152507.53,244557,397064.53
292790,201709,722,346,376,324202,352077.75,676279.75
292800,201709,1114,681,433,637160,405721,1042881
292805,201709,422,123,299,114735.65,280163,394898.65
292810,201709,1457,851,606,796543.9,567531.63,1364075.53
292820,201709,740,597,143,557516.3,133700.9,691217.2
292830,201709,102,79,23,74023,21551,95574
292840,201709,640,527,113,493331,105866.95,599197.95
292850,201709,137,91,46,85263,43102,128365
292860,201709,2063,1212,851,1131553.07,797387,1928940.07
292870,201709,3298,2206,1092,2065781.9,1023194.63,3088976.53
292880,201709,1418,932,486,869584.33,455382,1324966.33
292890,201709,460,394,66,369150,61842,430992
292895,201709,135,90,45,82995.71,42165,125160.71
292900,201709,383,285,98,267045,91826,358871
292905,201709,441,223,218,208951,204079,413030
292910,201709,385,299,86,279836,80582,360418
292920,201709,537,239,298,223943,279226,503169
292925,201709,516,477,39,446283.73,36308.75,482592.48
292930,201709,555,342,213,320454,199581,520035
292935,201709,301,127,174,118999,163038,282037
292937,201709,235,157,78,147109,73086,220195
292940,201709,190,143,47,133991,44039,178030
292950,201709,1076,556,520,518911.6,486304,1005215.6
292960,201709,536,357,179,334509,167723,502232
292970,201709,284,196,88,182997,82456,265453
292975,201709,160,88,72,82456,67277,149733
292980,201709,255,174,81,161286.42,75897,237183.42
292990,201709,1284,943,341,876308.58,319333.26,1195641.84
293000,201709,102,76,26,71212,24352.63,95564.63
293010,201709,2623,1614,1009,1507508.52,942404.4,2449912.92
293015,201709,645,508,137,475626.37,127742,603368.37
293020,201709,337,275,62,257675,58094,315769
293030,201709,625,545,80,509166.82,74960,584126.82
293040,201709,339,265,74,248305,69338,317643
293050,201709,2657,1547,1110,1440904.23,1036013.39,2476917.62
293060,201709,252,200,52,187400,47787.4,235187.4
293070,201709,3266,1635,1631,1523582.79,1527057.63,3050640.42
293075,201709,87,56,31,52472,29047,81519
293076,201709,74,46,28,43102,26236,69338
293077,201709,428,260,168,239186.04,157416,396602.04
293080,201709,454,398,56,372926,52472,425398
293090,201709,132,112,20,104944,18427.7,123371.7
293100,201709,503,356,147,333572,137739,471311
293105,201709,336,227,109,212418,101851.9,314269.9
293110,201709,169,118,51,110566,47787,158353
293120,201709,314,210,104,196770,97260.6,294030.6
293130,201709,248,165,83,154605,77771,232376
293135,201709,7746,3057,4689,2857442.95,4386558.52,7244001.47
293140,201709,181,117,64,109629,59219,168848
293150,201709,328,282,46,263578.1,43102,306680.1
293160,201709,430,240,190,224880,178030,402910
293170,201709,186,129,57,120591.9,52566,173157.9
293180,201709,450,306,144,286441,134928,421369
293190,201709,1264,875,389,815310.98,364415,1179725.98
293200,201709,521,459,62,429022,58094,487116
293210,201709,333,244,89,228479,82690.25,311169.25
293220,201709,2685,1078,1607,1008185.08,1503417.55,2511602.63
293230,201709,1785,642,1143,600149.9,1070991,1671140.9
293240,201709,223,202,21,189274,19677,208951
293245,201709,109,92,17,86204,15929,102133
293250,201709,743,274,469,256102.24,439453,695555.24
293260,201709,310,257,53,239279.49,49661,288940.49
293270,201709,1173,557,616,520036.48,577192,1097228.48
293280,201709,239,135,104,126495,97448,223943
293290,201709,3072,1991,1081,1864391.57,1012603,2876994.57
293300,201709,676,479,197,447000.79,183792.55,630793.34
293305,201709,163,137,26,128369,24362,152731
293310,201709,135,102,33,95574,30921,126495
293315,201709,151,118,33,110566,30921,141487
293317,201709,95,68,27,63716,25299,89015
293320,201709,934,530,404,495673.25,378544,874217.25
293325,201709,182,66,116,61842,108673.26,170515.26
293330,201709,12557,5805,6752,5428000.79,6320493.88,11748494.67
293340,201709,241,173,68,162101,62779,224880
293345,201709,242,192,50,179904,46850,226754
293350,201709,628,320,308,299840,287143.65,586983.65
293360,201709,1555,1106,449,1035104,419495.35,1454599.35
310010,201709,156,77,79,72149,73461,145610
310020,201709,1043,575,468,535620.65,436034.26,971654.91
310030,201709,323,261,62,243452.14,57812.9,301265.04
310040,201709,50,32,18,29984,16866,46850
310050,201709,174,111,63,103070.2,59031,162101.2
310060,201709,240,166,74,154792.4,69338,224130.4
310070,201709,16,7,9,6559,8433,14992
310080,201709,52,28,24,26236,22488,48724
310090,201709,943,487,456,451448.14,426147.8,877595.94
310100,201709,293,218,75,204266,70275,274541
310110,201709,730,393,337,367205.09,314832,682037.09
310120,201709,385,215,170,200799.1,158922.61,359721.71
310130,201709,34,21,13,19677,12181,31858
310140,201709,31,17,14,15929,13118,29047
310150,201709,1277,877,400,816692.06,374237.9,1190929.96
310160,201709,2116,1070,1046,996782.55,977384.8,1974167.35
310163,201709,89,48,41,44976,38417,83393
310170,201709,2546,1038,1508,972262,1410466.3,2382728.3
310180,201709,123,45,78,42165,72711.2,114876.2
310190,201709,475,315,160,295155,149357.8,444512.8
310200,201709,510,320,190,299840,177749,477589
310205,201709,54,42,12,39354,11244,50598
310210,201709,286,228,58,213636,54346,267982
310220,201709,52,31,21,29047,19677,48724
310230,201709,261,185,76,173157.6,71212,244369.6
310240,201709,104,92,12,85969.75,11244,97213.75
310250,201709,98,79,19,74023,17803,91826
310260,201709,802,427,375,397476.35,350653.51,748129.86
310270,201709,270,180,90,168117,84330,252447
310280,201709,364,271,93,253272,87141,340413
310285,201709,214,153,61,143058.35,57157,200215.35
310290,201709,255,147,108,137739,101196,238935
310300,201709,155,127,28,118999,26236,145235
310310,201709,5,4,1,3748,937,4685
310320,201709,22,15,7,14055,6559,20614
310330,201709,32,23,9,21551,8433,29984
310340,201709,1678,1066,612,991237.75,571945.25,1563183.00
310350,201709,2797,1512,1285,1412016.85,1203473.9,2615490.75
310360,201709,42,34,8,31858,7496,39354
310370,201709,120,98,22,91826,20333,112159
310375,201709,106,37,69,34669,64635,99304
310380,201709,50,29,21,27173,19677,46850
310390,201709,101,71,30,66527,28110,94637
310400,201709,2274,1464,810,1367927.9,758670.9,2126598.8
310410,201709,125,67,58,62779,54346,117125
310420,201709,665,356,309,331511.9,288587.43,620099.33
310430,201709,333,218,115,203984.9,107755,311739.9
310440,201709,60,37,23,34669,21551,56220
310445,201709,83,67,16,62779,14992,77771
310450,201709,855,535,320,499827.1,299840,799667.1
310460,201709,264,186,78,174282,73086,247368
310470,201709,494,311,183,291407,171471,462878
310480,201709,78,56,22,52472,20614,73086
310490,201709,484,230,254,214573.1,237998,452571.1
310500,201709,126,56,70,52472,65590,118062
310510,201709,620,402,218,375452.8,204247.63,579700.43
310520,201709,128,85,43,79645,40291,119936
310530,201709,85,40,45,37480,41883.9,79363.9
310540,201709,440,276,164,256271.3,153668,409939.3
310550,201709,85,55,30,51535,28110,79645
310560,201709,2876,1989,887,1853341.75,829521.42,2682863.17
310570,201709,157,101,56,94637,52472,147109
310590,201709,339,223,116,208530,108677.95,317207.95
310600,201709,160,93,67,85407.85,62779,148186.85
310610,201709,58,21,37,19494,34669,54163
310620,201709,44853,21455,23398,20030216.61,21888267.1,41918483.71
310630,201709,576,367,209,341912.05,194258.71,536170.76
310640,201709,137,115,22,107567.6,20614,128181.6
310650,201709,157,138,19,128369,17803,146172
310660,201709,90,56,34,52472,31858,84330
310665,201709,50,34,16,31858,14992,46850
310670,201709,6169,2893,3276,2702487.81,3064621.15,5767108.96
310680,201709,53,35,18,32795,16866,49661
310690,201709,582,422,160,391284.73,149920,541204.73
310700,201709,65,42,23,39354,21410.45,60764.45
310710,201709,1246,827,419,773667.22,392040.9,1165708.12
310720,201709,82,28,54,26236,50598,76834
310730,201709,1352,931,421,872066,394477,1266543
310740,201709,1004,569,435,529620.39,407351.63,936972.02
310750,201709,245,143,102,133054.29,95574,228628.29
310760,201709,65,50,15,46850,14055,60905
310770,201709,89,44,45,41228,42165,83393
310780,201709,405,332,73,311075,68401,379476
310790,201709,99,80,19,74960,17803,92763
310800,201709,455,221,234,206608.5,218967.53,425576.03
310810,201709,163,115,48,106715.1,44039,150754.1
310820,201709,368,290,78,271730,72804.9,344534.9
310825,201709,192,157,35,147109,32795,179904
310830,201709,463,221,242,206428.61,225535.9,431964.51
310840,201709,390,225,165,210825,154605,365430
310850,201709,110,89,21,83393,19677,103070
310855,201709,377,296,81,277352,75897,353249
310860,201709,1378,1034,344,963150.55,320623.95,1283774.50
310870,201709,54,43,11,40291,10307,50598
310880,201709,78,60,18,55938.9,16866,72804.9
310890,201709,312,183,129,171471,120873,292344
310900,201709,645,297,348,275417.3,325776.9,601194.2
310910,201709,243,168,75,156105.1,69994,226099.1
310920,201709,492,295,197,272668.1,183652.7,456320.8
310925,201709,28,21,7,19677,6278,25955
310930,201709,1089,646,443,604906.1,414996.88,1019902.98
310940,201709,674,344,330,321737.9,309210,630947.9
310945,201709,120,74,46,69338,43102,112440
310950,201709,254,198,56,185526,52472,237998
310960,201709,86,31,55,29047,51531,80578
310970,201709,167,103,64,96511,59062.2,155573.2
310980,201709,44,23,21,21551,19677,41228
310990,201709,155,87,68,81238,63716,144954
311000,201709,815,417,398,387919.9,372917,760836.9
311010,201709,38,31,7,29047,6559,35606
311020,201709,41,26,15,24362,14055,38417
311030,201709,392,229,163,212700,152731,365431
311040,201709,38,33,5,30921,4685,35606
311050,201709,463,193,270,180279,252427.8,432706.8
311060,201709,747,434,313,405253.2,293000,698253.2
311070,201709,317,144,173,134928,162101,297029
311080,201709,108,58,50,54346,46850,101196
311090,201709,396,184,212,171471,198644,370115
311100,201709,613,366,247,342942,231157.9,574099.9
311110,201709,665,456,209,427272,195824,623096
311115,201709,65,47,18,44039,16866,60905
311120,201709,1014,534,480,498434.4,448869.95,947304.35
311130,201709,408,239,169,223755.6,158353,382108.6
311140,201709,161,77,84,72149,77911.55,150060.55
311150,201709,355,229,126,214456,117827.75,332283.75
311160,201709,737,532,205,496610.7,191617,688227.7
311170,201709,78,56,22,52472,20332.9,72804.9
311180,201709,342,225,117,210543.9,109348,319891.9
311190,201709,37,20,17,18740,15929,34669
311200,201709,342,234,108,217665.3,101196,318861.3
311205,201709,29,19,10,17568.75,8995.2,26563.95
311210,201709,47,40,7,36918,6559,43477
311220,201709,13,11,2,10307,1874,12181
311230,201709,1619,1045,574,976094.65,537838,1513932.65
311240,201709,167,102,65,95373.96,60905,156278.96
311250,201709,66,30,36,28110,33732,61842
311260,201709,556,345,211,323265,197707,520972
311265,201709,107,73,34,68401,31858,100259
311270,201709,282,196,86,183652,80582,264234
311280,201709,212,97,115,90889,107192.8,198081.8
311290,201709,111,90,21,84049,19115,103164
311300,201709,544,341,203,318580.88,189930,508510.88
311310,201709,23,19,4,17803,3748,21551
311320,201709,670,500,170,467563,159290,626853
311330,201709,1019,751,268,703359.75,250179.7,953539.45
311340,201709,2587,1848,739,1724280.82,691759.73,2416040.55
311350,201709,268,208,60,194896,56220,251116
311360,201709,171,107,64,100259,59968,160227
311370,201709,1189,472,717,440309.25,671118.85,1111428.10
311380,201709,7,6,1,5622,937,6559
311390,201709,279,150,129,140550,120404.6,260954.6
311400,201709,150,97,53,90889,49652,140541
311410,201709,93,53,40,49661,37480,87141
311420,201709,295,163,132,151138.15,123684,274822.15
311430,201709,854,554,300,518069,281100,799169
311440,201709,479,335,144,312958.4,134646.9,447605.3
311450,201709,315,194,121,181778,113377,295155
311455,201709,304,205,99,191794.9,92481.9,284276.8
311460,201709,130,54,76,50598,70232.83,120830.83
311470,201709,20,10,10,9370,9370,18740
311480,201709,23,8,15,7496,14055,21551
311490,201709,17,10,7,9370,6559,15929
311500,201709,20,9,11,8433,10307,18740
311510,201709,624,434,190,404750.75,177748.9,582499.65
311520,201709,44,33,11,30265.1,10307,40572.1
311530,201709,1826,1358,468,1264110.56,438516,1702626.56
311535,201709,63,49,14,45913,13118,59031
311540,201709,35,30,5,28110,4685,32795
311545,201709,183,138,45,129306,42165,171471
311547,201709,31,22,9,20614,8433,29047
311550,201709,604,279,325,261423,303600.86,565023.86
311560,201709,42,28,14,26236,13118,39354
311570,201709,306,200,106,186837.8,99322,286159.8
311580,201709,296,171,125,159945.9,117125,277070.9
311590,201709,33,29,4,27173,3748,30921
311600,201709,89,71,18,66527,16866,83393
311610,201709,264,231,33,215197.95,30921,246118.95
311615,201709,91,76,15,70584.21,14055,84639.21
311620,201709,17,11,6,10307,5622,15929
311630,201709,82,69,13,64653,12181,76834
311640,201709,118,67,51,62779,47787,110566
311650,201709,126,93,33,86438.25,30921,117359.25
311660,201709,394,188,206,176156,193022,369178
311670,201709,158,104,54,97208,50598,147806
311680,201709,224,166,58,153883.94,53596.4,207480.34
311690,201709,19,12,7,11244,6559,17803
311700,201709,200,136,64,127150.9,59968,187118.9
311710,201709,218,140,78,131180,73086,204266
311720,201709,39,29,10,27173,9370,36543
311730,201709,532,350,182,327388,170534,497922
311740,201709,32,22,10,20614,9370,29984
311750,201709,710,484,226,451634.4,211762,663396.4
311760,201709,65,37,28,34669,26236,60905
311770,201709,396,188,208,174282.61,194896,369178.61
311780,201709,164,94,70,88078,65278,153356
311783,201709,76,67,9,62779,8433,71212
311787,201709,35,16,19,14992,17803,32795
311790,201709,263,127,136,118999,127432,246431
311800,201709,626,429,197,398648.15,184589,583237.15
311810,201709,41,35,6,32795,5622,38417
311820,201709,105,87,18,81519,16866,98385
311830,201709,1838,1188,650,1108585.25,605772.4,1714357.65
311840,201709,1004,558,446,518630.95,416158.66,934789.61
311850,201709,8,5,3,4685,2811,7496
311860,201709,9265,4288,4977,4002848.04,4655826.56,8658674.60
311870,201709,158,87,71,81519,66527,148046
311880,201709,946,704,242,658420.9,226754,885174.9
311890,201709,221,114,107,106818,100259,207077
311900,201709,88,37,51,34669,47787,82456
311910,201709,1373,855,518,798278.05,483164.15,1281442.20
311920,201709,226,147,79,137505,74023,211528
311930,201709,898,520,378,486959,353952,840911
311940,201709,2374,1200,1174,1121855.36,1097273.95,2219129.31
311950,201709,30,20,10,18740,9370,28110
311960,201709,70,49,21,45913,19677,65590
311970,201709,25,14,11,13118,10307,23425
311980,201709,42,31,11,29047,10307,39354
311990,201709,58,43,15,40291,14055,54346
311995,201709,64,44,20,41228,18740,59968
312000,201709,33,23,10,21269.9,9370,30639.9
312010,201709,85,62,23,58094,21551,79645
312015,201709,92,68,24,63435,22488,85923
312020,201709,142,89,53,83393,49661,133054
312030,201709,39,33,6,29985,5622,35607
312040,201709,76,48,28,44976,26236,71212
312050,201709,226,117,109,109629,102133,211762
312060,201709,71,47,24,44039,21832.1,65871.1
312070,201709,77,44,33,41228,30921,72149
312080,201709,518,220,298,206140,279226,485366
312083,201709,44,33,11,30921,10307,41228
312087,201709,106,83,23,77771,21551,99322
312090,201709,2756,1541,1215,1430428.85,1134992.88,2565421.73
312100,201709,162,114,48,106818,44208,151026
312110,201709,122,79,43,74023,40291,114314
312120,201709,143,104,39,97448,36543,133991
312125,201709,91,50,41,46662.6,38417,85079.6
312130,201709,126,83,43,77771,40291,118062
312140,201709,135,106,29,99322,27173,126495
312150,201709,43,35,8,32795,7496,40291
312160,201709,1513,1010,503,943279.44,469643.34,1412922.78
312170,201709,12,10,2,9370,1874,11244
312180,201709,135,88,47,81520,43758,125278
312190,201709,32,29,3,27173,2811,29984
312200,201709,721,621,100,580237.35,93700,673937.35
312210,201709,98,63,35,59031,32795,91826
312220,201709,122,90,32,84096,29984,114080
312230,201709,3391,1682,1709,1571943.92,1599752.49,3171696.41
312235,201709,142,94,48,88078,44976,133054
312240,201709,114,75,39,70275,36543,106818
312245,201709,157,107,50,100255,46850,147105
312247,201709,55,39,16,35794,14992,50786
312250,201709,178,84,94,78240,88078,166318
312260,201709,96,65,31,60717.6,29047,89764.6
312270,201709,136,86,50,80582,46850,127432
312280,201709,24,14,10,13118,9370,22488
312290,201709,159,111,48,103725.9,44040,147765.9
312300,201709,192,130,62,121810,58094,179904
312310,201709,57,52,5,48724,4685,53409
312320,201709,431,267,164,248305,152403.25,400708.25
312330,201709,89,76,13,70463,11899.9,82362.9
312340,201709,36,16,20,14992,18740,33732
312350,201709,16,10,6,9370,5622,14992
312352,201709,93,64,29,59968,27173,87141
312360,201709,564,259,305,241746,285129.1,526875.1
312370,201709,290,174,116,162756.9,108692,271448.9
312380,201709,138,86,52,80582,48724,129306
312385,201709,182,147,35,137739,32795,170534
312390,201709,299,190,109,178030,101478,279508
312400,201709,375,282,93,264234,86673,350907
312410,201709,840,271,569,253458.5,532587,786045.5
312420,201709,604,486,118,454726.1,110566,565292.1
312430,201709,855,632,223,589609.94,208014.1,797624.04
312440,201709,44,32,12,29984,11244,41228
312450,201709,211,131,80,122747,74960,197707
312460,201709,57,27,30,25299,28110,53409
312470,201709,56,35,21,32795,19677,52472
312480,201709,215,133,82,124621,76552.9,201173.9
312490,201709,247,168,79,157416,74023,231439
312500,201709,33,18,15,16866,14055,30921
312510,201709,418,158,260,148046,243015.36,391061.36
312520,201709,40,14,26,13118,24362,37480
312530,201709,47,36,11,33732,10307,44039
312540,201709,100,87,13,81519,12181,93700
312550,201709,36,28,8,26236,7496,33732
312560,201709,196,141,55,131836,51253.9,183089.9
312570,201709,435,258,177,241371.2,165170.23,406541.43
312580,201709,82,43,39,40291,36543,76834
312590,201709,273,217,56,202253,52472,254725
312595,201709,146,132,14,123684,13118,136802
312600,201709,75,46,29,42681,27173,69854
312610,201709,1607,839,768,780617.29,718051.93,1498669.22
312620,201709,185,129,56,120873,52467.32,173340.32
312630,201709,65,53,12,49661,11244,60905
312640,201709,47,14,33,13118,30921,44039
312650,201709,145,118,27,110285,25018,135303
312660,201709,65,49,16,45632,14992,60624
312670,201709,863,567,296,529733.95,277142.15,806876.10
312675,201709,42,31,11,29047,10307,39354
312680,201709,83,57,26,53034.2,24362,77396.2
312690,201709,246,133,113,124611.63,105599.9,230211.53
312695,201709,29,23,6,21551,5622,27173
312700,201709,196,110,86,103070,80582,183652
312705,201709,74,62,12,58094,10962.9,69056.9
312707,201709,91,68,23,63435,21551,84986
312710,201709,1858,996,862,930604.23,807486,1738090.23
312720,201709,64,32,32,29984,29984,59968
312730,201709,289,171,118,159290,110284.9,269574.9
312733,201709,50,43,7,40291,6559,46850
312735,201709,21,15,6,14055,5622,19677
312737,201709,70,38,32,35606,29984,65590
312738,201709,50,36,14,33732,13118,46850
312740,201709,70,50,20,46850,18740,65590
312750,201709,74,54,20,50598,18740,69338
312760,201709,274,199,75,186463,70275,256738
312770,201709,7589,3488,4101,3245072.94,3833797.3,7078870.24
312780,201709,438,339,99,317361.9,92763,410124.9
312790,201709,20,15,5,14055,4685,18740
312800,201709,1593,1113,480,1036049.98,448599.11,1484649.09
312810,201709,377,241,136,225817,127432,353249
312820,201709,194,147,47,137739,44039,181778
312825,201709,27,18,9,16866,8433,25299
312830,201709,292,168,124,156480,115561,272041
312840,201709,149,111,38,104007,35606,139613
312850,201709,22,19,3,17803,2811,20614
312860,201709,171,107,64,99978,59968,159946
312870,201709,979,509,470,474184.85,440390,914574.85
312880,201709,148,103,45,96136.45,42071.3,138207.75
312890,201709,163,112,51,104944,47787,152731
312900,201709,212,157,55,146453.1,51535,197988.1
312910,201709,185,94,91,86928.66,85267,172195.66
312920,201709,155,86,69,80582,64653,145235
312930,201709,339,246,93,230502,87141,317643
312940,201709,101,67,34,62779,31858,94637
312950,201709,690,446,244,416590.3,227973,644563.3
312960,201709,176,134,42,125558,39354,164912
312965,201709,47,42,5,39354,4685,44039
312970,201709,278,225,53,209888.1,49661,259549.1
312980,201709,2269,1219,1050,1137792.7,983283.8,2121076.5
312990,201709,48,28,20,26236,18740,44976
313000,201709,39,25,14,23425,13118,36543
313005,201709,163,125,38,116150.75,35325,151475.75
313010,201709,932,384,548,358589.9,513185.9,871775.8
313020,201709,192,98,94,91357.5,88078,179435.5
313030,201709,207,130,77,120218.1,72149,192367.1
313040,201709,56,20,36,18740,33732,52472
313050,201709,292,206,86,192085.1,80582,272667.1
313055,201709,45,32,13,29984,12181,42165
313060,201709,122,82,40,76834,37198.9,114032.9
313065,201709,61,39,22,36543,20614,57157
313070,201709,156,83,73,77771,68401,146172
313080,201709,39,17,22,15929,20614,36543
313090,201709,696,478,218,445918.4,204266,650184.4
313100,201709,167,63,104,59031,97440,156471
313110,201709,122,73,49,68401,45913,114314
313115,201709,143,77,66,71952.23,60905,132857.23
313120,201709,740,402,338,376393,315207,691600
313130,201709,5063,2707,2356,2511879.31,2197868.42,4709747.73
313140,201709,164,84,80,78708,74960,153668
313150,201709,314,251,63,235187,58749.9,293936.9
313160,201709,179,129,50,120873,46850,167723
313170,201709,1315,926,389,854874.04,364109.2,1218983.24
313180,201709,331,192,139,179266.84,130243,309509.84
313190,201709,709,416,293,386793.6,273792,660585.6
313200,201709,22,21,1,19677,937,20614
313210,201709,1033,862,171,804744.48,160222.32,964966.80
313220,201709,223,152,71,141487,65824.25,207311.25
313230,201709,277,200,77,186464,72149,258613
313240,201709,1897,1020,877,953671.27,817809.52,1771480.79
313250,201709,1240,911,329,847799.7,305464.4,1153264.1
313260,201709,91,54,37,50598,34669,85267
313270,201709,952,554,398,515115.77,372926,888041.77
313280,201709,60,52,8,48255.51,7496,55751.51
313290,201709,227,182,45,170253,41228.9,211481.9
313300,201709,360,179,181,165568.3,169597,335165.3
313310,201709,212,110,102,103070,95574,198644
313320,201709,362,276,86,256691.55,80582,337273.55
313330,201709,1338,799,539,747726.6,503872.75,1251599.35
313340,201709,336,228,108,213636,101196,314832
313350,201709,526,353,173,328887.05,162101,490988.05
313360,201709,117,66,51,61842,47506,109348
313370,201709,195,77,118,72149,110566,182715
313375,201709,257,154,103,144298,96511,240809
313380,201709,1235,628,607,585643.84,568193,1153836.84
313390,201709,48,40,8,36543.4,7496,44039.4
313400,201709,418,269,149,252053,139332,391385
313410,201709,18,9,9,8433,8433,16866
313420,201709,4655,2399,2256,2239611.19,2106963.81,4346575.00
313430,201709,133,62,71,58094,66527,124621
313440,201709,1451,972,479,909563.75,448261,1357824.75
313450,201709,63,28,35,26236,32795,59031
313460,201709,371,178,193,165368,180841,346209
313470,201709,517,234,283,219258,264515.1,483773.1
313480,201709,159,109,50,101197,46850,148047
313490,201709,504,247,257,231434.32,240763,472197.32
313500,201709,17,10,7,9370,6559,15929
313505,201709,936,726,210,679606.1,196770,876376.1
313507,201709,90,53,37,49661,34669,84330
313510,201709,2750,1771,979,1654979.05,916386,2571365.05
313520,201709,3564,2783,781,2595527.19,731793,3327320.19
313530,201709,40,29,11,27173,10307,37480
313535,201709,101,84,17,78053,15929,93982
313540,201709,70,55,15,51535,14055,65590
313545,201709,102,83,19,77771,17803,95574
313550,201709,235,191,44,178967,40947,219914
313560,201709,329,169,160,158353,149920,308273
313570,201709,57,31,26,29047,24362,53409
313580,201709,1283,690,593,645218.2,553954.8,1199173.0
313590,201709,81,47,34,44039,31858,75897
313600,201709,690,408,282,382296,263391,645687
313610,201709,55,44,11,40353.9,10307,50660.9
313620,201709,1311,700,611,645904.16,569096.5,1215000.66
313630,201709,1626,1245,381,1164747,356716,1521463
313640,201709,125,71,54,66527,50598,117125
313650,201709,232,110,122,103070,114314,217384
313652,201709,14,12,2,11244,1874,13118
313655,201709,52,31,21,29047,19677,48724
313657,201709,45,41,4,38417,3748,42165
313660,201709,125,91,34,85267,31858,117125
313665,201709,620,310,310,290470,290235.75,580705.75
313670,201709,9992,6934,3058,6475985.83,2864784,9340769.83
313680,201709,38,28,10,26236,9370,35606
313690,201709,159,122,37,114314,34669,148983
313695,201709,63,48,15,44976,14055,59031
313700,201709,291,232,59,217103,55283,272386
313710,201709,153,105,48,98385,44976,143361
313720,201709,1008,479,529,447323.9,494071.83,941395.73
313730,201709,55,40,15,37480,14055,51535
313740,201709,161,127,34,118999,31858,150857
313750,201709,450,326,124,305180.9,116188,421368.9
313753,201709,243,169,74,157697.1,69338,227035.1
313760,201709,1177,421,756,394477,705684.56,1100161.56
313770,201709,348,247,101,231439,94637,326076
313780,201709,755,395,360,370115,337038.9,707153.9
313790,201709,26,25,1,23425,937,24362
313800,201709,138,84,54,78708,50598,129306
313810,201709,54,34,20,31858,18740,50598
313820,201709,1278,637,641,595932.1,599657.1,1195589.2
313830,201709,67,51,16,47787,14992,62779
313835,201709,53,48,5,44976,4685,49661
313840,201709,1623,990,633,923041.2,591903,1514944.2
313850,201709,180,62,118,58094,109996.39,168090.39
313860,201709,488,379,109,352313.7,101196.55,453510.25
313862,201709,172,115,57,107755,53409,161164
313865,201709,82,63,19,59031,17803,76834
313867,201709,50,38,12,35606,11244,46850
313868,201709,24,15,9,13306,8433,21739
313870,201709,123,65,58,60905,54346,115251
313880,201709,326,208,118,194614.9,110003.9,304618.8
313890,201709,322,175,147,163225.9,137176.8,300402.7
313900,201709,923,498,425,465034.25,398179,863213.25
313910,201709,134,94,40,88078,36543.1,124621.1
313920,201709,596,427,169,399911.6,158353,558264.6
313925,201709,31,26,5,24362,4685,29047
313930,201709,795,612,183,573444,171448,744892
313940,201709,1733,1084,649,1011304.2,607457.2,1618761.4
313950,201709,935,593,342,553861.8,319938.9,873800.7
313960,201709,1359,779,580,725715.65,542242,1267957.65
313970,201709,115,84,31,78708,29047,107755
313980,201709,204,131,73,122513,68401,190914
313990,201709,350,211,139,197425.9,130243,327668.9
314000,201709,900,614,286,572836.35,267977.32,840813.67
314010,201709,75,48,27,44976,25299,70275
314015,201709,61,19,42,17803,39354,57157
314020,201709,50,34,16,31858,14898.3,46756.3
314030,201709,98,48,50,44976,46850,91826
314040,201709,43,31,12,29047,11244,40291
314050,201709,306,179,127,167442,117687.2,285129.2
314053,201709,100,65,35,59968.2,32795,92763.2
314055,201709,286,167,119,156479,111503,267982
314060,201709,144,121,23,112440,21551,133991
314070,201709,935,468,467,434497.67,436679.63,871177.30
314080,201709,215,143,72,133757,66434.14,200191.14
314085,201709,113,75,38,70275,35606,105881
314090,201709,339,244,95,228628,89010.32,317638.32
314100,201709,470,383,87,354999,80957,435956
314110,201709,691,375,316,349510.37,295389.8,644900.17
314120,201709,100,54,46,50598,43102,93700
314130,201709,24,12,12,11244,11244,22488
314140,201709,1089,643,446,600879.46,416028.23,1016907.69
314150,201709,167,104,63,97448,59031,156479
314160,201709,356,262,94,242402.3,87891,330293.3
314170,201709,66,49,17,45163.4,15929,61092.4
314180,201709,726,634,92,593777,85267.25,679044.25
314190,201709,101,60,41,56220,38417,94637
314200,201709,592,404,188,377018.7,175219,552237.7
314210,201709,271,203,68,189929.9,63435,253364.9
314220,201709,314,235,79,218322,73742,292064
314225,201709,64,44,20,41228,18740,59968
314230,201709,102,46,56,43102,52472,95574
314240,201709,138,105,33,98385,30921,129306
314250,201709,58,34,24,31858,22488,54346
314260,201709,187,97,90,90889,84330,175219
314270,201709,331,257,74,240060,69057,309117
314280,201709,681,378,303,353895.9,283911,637806.9
314290,201709,553,441,112,411999.25,104662.9,516662.15
314300,201709,411,292,119,270720.5,111457,382177.5
314310,201709,1419,944,475,883592,444774.33,1328366.33
314315,201709,34,27,7,25299,6559,31858
314320,201709,603,380,223,355497.9,208042.21,563540.11
314330,201709,10646,5358,5288,5008797.47,4950171.32,9958968.79
314340,201709,571,269,302,251490.9,282412,533902.9
314345,201709,26,19,7,17803,6559,24362
314350,201709,183,109,74,102133,69338,171471
314360,201709,73,42,31,39354,29047,68401
314370,201709,57,48,9,44976,8433,53409
314380,201709,91,66,25,61842,23425,85267
314390,201709,3133,1987,1146,1857041.15,1070897.7,2927938.85
314400,201709,674,486,188,452563.1,176156,628719.1
314410,201709,420,273,147,255801,137739,393540
314420,201709,19,9,10,8433,9370,17803
314430,201709,2489,892,1597,832120.15,1493751.79,2325871.94
314435,201709,277,159,118,148701.9,109629,258330.9
314437,201709,26,20,6,18740,5622,24362
314440,201709,98,69,29,64653,27173,91826
314450,201709,153,116,37,108692,34669,143361
314460,201709,650,299,351,280163,328887,609050
314465,201709,79,55,24,51535,22488,74023
314467,201709,69,59,10,55274,9370,64644
314470,201709,347,176,171,161522.06,159290.75,320812.81
314480,201709,1013,494,519,462878,486115.6,948993.6
314490,201709,89,67,22,62779,20614,83393
314500,201709,311,201,110,188337,103070,291407
314505,201709,128,84,44,78708,41228,119936
314510,201709,228,181,47,169597,44039,213636
314520,201709,1209,621,588,574073.85,549035.45,1123109.30
314530,201709,672,534,138,499554,129306,628860
314535,201709,199,124,75,115157.3,70028.48,185185.78
314537,201709,60,35,25,32795,23425,56220
314540,201709,10,6,4,5622,3748,9370
314545,201709,48,33,15,30921,14055,44976
314550,201709,78,42,36,39354,33732,73086
314560,201709,804,434,370,404503,346592,751095
314570,201709,21,16,5,14992,4685,19677
314580,201709,19,9,10,8433,9370,17803
314585,201709,20,14,6,13118,5622,18740
314587,201709,83,71,12,66527,11244,77771
314590,201709,531,394,137,369178,128369,497547
314600,201709,976,624,352,581929.39,327575.4,909504.79
314610,201709,917,505,412,470983.4,384920.15,855903.55
314620,201709,143,105,38,97448,35606,133054
314625,201709,92,70,22,64747,20614,85361
314630,201709,1241,639,602,597009.65,563792.9,1160802.55
314640,201709,90,60,30,56220,28110,84330
314650,201709,204,118,86,110284.9,80113.5,190398.4
314655,201709,66,51,15,47787,14055,61842
314660,201709,18,14,4,13118,3748,16866
314670,201709,183,146,37,136521,34669,171190
314675,201709,212,118,94,110566,88078,198644
314690,201709,543,300,243,280818.9,227691,508509.9
314700,201709,2424,1319,1105,1230844.6,1034775.95,2265620.55
314710,201709,1627,947,680,883233.15,636550.95,1519784.10
314720,201709,410,244,166,227223,155542,382765
314730,201709,503,268,235,249711,219717.5,469428.5
314740,201709,678,327,351,304759.25,328887,633646.25
314750,201709,23,20,3,18740,2811,21551
314760,201709,309,152,157,142424,147099.63,289523.63
314770,201709,119,82,37,76834,34669,111503
314780,201709,21,6,15,5622,14055,19677
314790,201709,2307,1443,864,1345524.85,808621.73,2154146.58
314795,201709,48,41,7,38183,6559,44742
314800,201709,2847,1646,1201,1537109.46,1123735.1,2660844.56
314810,201709,1478,821,657,766982.25,614016.5,1380998.75
314820,201709,87,47,40,44039,37480,81519
314830,201709,207,163,44,152028.75,40947,192975.75
314840,201709,81,47,34,44039,31858,75897
314850,201709,342,168,174,157416,163038,320454
314860,201709,705,530,175,494642.79,162476.35,657119.14
314870,201709,1423,719,704,672766.5,659648,1332414.5
314875,201709,55,47,8,44039,7496,51535
314880,201709,46,33,13,30921,12181,43102
314890,201709,50,31,19,29047,17803,46850
314900,201709,28,23,5,21551,4685,26236
314910,201709,258,171,87,159945.9,81519,241464.9
314915,201709,150,132,18,123450,16866,140316
314920,201709,128,76,52,71212,48442.9,119654.9
314930,201709,1007,512,495,477919,463533.9,941452.9
314940,201709,54,42,12,39354,11244,50598
314950,201709,39,29,10,26470.25,9370,35840.25
314960,201709,58,42,16,39354,14992,54346
314970,201709,132,67,65,62217,60905,123122
314980,201709,301,194,107,179576.05,99322,278898.05
314990,201709,466,252,214,235187.25,199628.75,434816.00
314995,201709,185,64,121,59968,113367.63,173335.63
315000,201709,83,66,17,61842,15929,77771
315010,201709,47,31,16,29047,14992,44039
315015,201709,175,143,32,133278.88,29984,163262.88
315020,201709,61,52,9,48724,8433,57157
315030,201709,120,92,28,85268,26236,111504
315040,201709,66,49,17,45913,15929,61842
315050,201709,195,116,79,108692,74023,182715
315053,201709,39,34,5,31858,4685,36543
315057,201709,98,82,16,76459.2,14992,91451.2
315060,201709,70,64,6,58094.98,5622,63716.98
315070,201709,104,59,45,55283,42165,97448
315080,201709,365,300,65,281100,60905,342005
315090,201709,110,67,43,62779,40291,103070
315100,201709,72,38,34,35606,31858,67464
315110,201709,290,162,128,150951,119936,270887
315120,201709,1617,810,807,755082.1,754988,1510070.1
315130,201709,321,233,88,218321,82456,300777
315140,201709,530,307,223,286066.1,208951,495017.1
315150,201709,967,451,516,421651,483211,904862
315160,201709,205,104,101,97448,94637,192085
315170,201709,342,222,120,206141.1,112158.9,318300.0
315180,201709,3208,1363,1845,1273337.05,1725627.6,2998964.65
315190,201709,310,179,131,167349,122747,290096
315200,201709,1166,662,504,617577.53,471479.73,1089057.26
315210,201709,1505,850,655,792141.35,611861.8,1404003.15
315213,201709,39,24,15,22488,14055,36543
315217,201709,196,155,41,145235,38417,183652
315220,201709,1478,1129,349,1056983.3,326919.3,1383902.6
315230,201709,168,123,45,114970,42165,157135
315240,201709,427,274,153,256738,142415.25,399153.25
315250,201709,2526,1255,1271,1174342.3,1189562.99,2363905.29
315260,201709,148,90,58,83018.2,54346,137364.2
315270,201709,125,83,42,76646.6,38641.88,115288.48
315280,201709,693,451,242,422213,226744.63,648957.63
315290,201709,193,115,78,107755,72149.34,179904.34
315300,201709,72,46,26,43102,24362,67464
315310,201709,63,56,7,52472,6559,59031
315320,201709,156,84,72,78708,67464,146172
315330,201709,54,46,8,43102,7496,50598
315340,201709,416,295,121,275534.9,113377,388911.9
315350,201709,139,85,54,79645,50598,130243
315360,201709,94,50,44,46850,41228,88078
315370,201709,54,30,24,28110,22206.9,50316.9
315380,201709,11,6,5,5622,4685,10307
315390,201709,51,13,38,12181,35606,47787
315400,201709,808,604,204,560446.8,190492.1,750938.9
315410,201709,345,206,139,192741,130243,322984
315415,201709,62,47,15,44039,14055,58094
315420,201709,200,147,53,136989.5,49661,186650.5
315430,201709,683,402,281,375737.1,262828.9,638566.0
315440,201709,80,57,23,53409,21551,74960
315445,201709,258,208,50,194586.79,46850,241436.79
315450,201709,195,149,46,139613,43102,182715
315460,201709,3300,1691,1609,1579918.52,1503737.05,3083655.57
315470,201709,46,24,22,22207,20614,42821
315480,201709,62,23,39,21551,36543,58094
315490,201709,617,380,237,353764.35,222069,575833.35
315500,201709,24,13,11,12181,10307,22488
315510,201709,158,101,57,94637,53409,148046
315520,201709,70,61,9,57157,8433,65590
315530,201709,51,28,23,26236,21551,47787
315540,201709,240,156,84,146172,78708,224880
315550,201709,175,135,40,126495,37480,163975
315560,201709,745,589,156,551330.9,146172,697502.9
315570,201709,310,168,142,154559.25,133054,287613.25
315580,201709,633,415,218,388855,204266,593121
315590,201709,211,110,101,103070,94637,197707
315600,201709,285,205,80,192085,74773,266858
315610,201709,97,48,49,44976,45913,90889
315620,201709,31,24,7,22488,6559,29047
315630,201709,134,87,47,81519,44039,125558
315640,201709,52,30,22,28110,20614,48724
315645,201709,65,45,20,42165,18272,60437
315650,201709,167,120,47,112159,44039,156198
315660,201709,474,193,281,180841,263297,444138
315670,201709,2280,1171,1109,1094838.75,1037982.1,2132820.85
315680,201709,848,570,278,530587.81,259773.88,790361.69
315690,201709,699,474,225,443083.63,210825,653908.63
315700,201709,1881,1006,875,939811.51,819875,1759686.51
315710,201709,314,79,235,74023,220195,294218
315720,201709,422,271,151,253927,141487,395414
315725,201709,199,161,38,150857,35606,186463
315727,201709,39,22,17,20614,15929,36543
315730,201709,40,37,3,34669,2811,37480
315733,201709,86,54,32,50598,29984,80582
315737,201709,51,37,14,34669,13118,47787
315740,201709,43,38,5,35606,4685,40291
315750,201709,159,128,31,119936,29047,148983
315760,201709,44,29,15,27173,14055,41228
315765,201709,110,71,39,66527,36543,103070
315770,201709,229,135,94,126495,87797,214292
315780,201709,3227,1685,1542,1571959.75,1442793.51,3014753.26
315790,201709,205,158,47,148046,43476.8,191522.8
315800,201709,277,202,75,189274,70275,259549
315810,201709,89,51,38,47787,35325,83112
315820,201709,790,569,221,530905.77,207077,737982.77
315830,201709,143,80,63,74960,59031,133991
315840,201709,84,56,28,52472,26236,78708
315850,201709,261,191,70,178967,65590,244557
315860,201709,12,4,8,3748,7496,11244
315870,201709,34,28,6,26236,5622,31858
315880,201709,106,68,38,63716,35606,99322
315890,201709,69,49,20,45913,18740,64653
315895,201709,382,250,132,232752,123122,355874
315900,201709,69,34,35,31858,32795,64653
315910,201709,36,23,13,21316.75,12181,33497.75
315920,201709,187,122,65,114314,59968.95,174282.95
315930,201709,36,13,23,12181,21551,33732
315935,201709,146,115,31,107755,29038,136793
315940,201709,84,64,20,59968,18740,78708
315950,201709,64,45,19,42165,17803,59968
315960,201709,566,262,304,244856.94,284285.9,529142.84
315970,201709,38,30,8,28110,7496,35606
315980,201709,694,316,378,294599.1,354176.63,648775.73
315990,201709,246,149,97,139613,90608,230221
316000,201709,49,31,18,29047,16866,45913
316010,201709,72,62,10,58094,9370,67464
316020,201709,103,84,19,78708,17803,96511
316030,201709,405,207,198,193959,185011,378970
316040,201709,481,215,266,201153.89,248961,450114.89
316045,201709,59,54,5,50598,4685,55283
316050,201709,16,14,2,13118,1874,14992
316060,201709,97,63,34,58749.9,31858,90607.9
316070,201709,1022,655,367,607461.25,343130,950591.25
316080,201709,103,62,41,58094,38417,96511
316090,201709,46,27,19,24362.1,17803,42165.1
316095,201709,63,52,11,48453,10307,58760
316100,201709,298,175,123,163412.9,115251,278663.9
316105,201709,32,22,10,20614,9370,29984
316110,201709,1929,1547,382,1440233.27,356247.4,1796480.67
316120,201709,80,59,21,55283,19395.9,74678.9
316130,201709,138,106,32,98667,29984,128651
316140,201709,26,19,7,17803,6559,24362
316150,201709,195,138,57,128603.25,53409,182012.25
316160,201709,89,54,35,50598,32795,83393
316165,201709,61,45,16,41978,14289.25,56267.25
316170,201709,207,139,68,129306,63716,193022
316180,201709,195,90,105,84002.05,98385,182387.05
316190,201709,132,94,38,87141,35606,122747
316200,201709,694,395,299,370115,279976,650091
316210,201709,742,492,250,460664.43,234250,694914.43
316220,201709,116,76,40,71212,37480,108692
316225,201709,20,12,8,11244,7496,18740
316230,201709,33,19,14,17803,13118,30921
316240,201709,608,493,115,461004.1,107755,568759.1
316245,201709,101,83,18,77771,16866,94637
316250,201709,1479,1042,437,967204,408026.26,1375230.26
316255,201709,110,89,21,83018.2,19677,102695.2
316257,201709,178,96,82,89952,76552.9,166504.9
316260,201709,238,156,82,144897.93,76741,221638.93
316265,201709,25,16,9,14992,8433,23425
316270,201709,679,469,210,436735.8,196770,633505.8
316280,201709,538,333,205,311053.1,191429.3,502482.4
316290,201709,665,442,223,411343.69,208951,620294.69
316292,201709,482,188,294,176156,275244,451400
316294,201709,105,62,43,58094,40291,98385
316295,201709,271,119,152,110081.5,142424,252505.5
316300,201709,105,72,33,67464,30921,98385
316310,201709,33,18,15,16866,14055,30921
316320,201709,47,28,19,26236,17803,44039
316330,201709,130,82,48,75897.25,44694.9,120592.15
316340,201709,138,96,42,89952,39354,129306
316350,201709,188,132,56,123357,52472,175829
316360,201709,23,18,5,16866,4685,21551
316370,201709,1039,558,481,519117.75,450375.3,969493.05
316380,201709,120,91,29,85267,27173,112440
316390,201709,119,87,32,81519,29984,111503
316400,201709,136,104,32,97448,29984,127432
316410,201709,306,224,82,208529.35,76834,285363.35
316420,201709,188,134,54,124855.25,50598,175453.25
316430,201709,153,76,77,71212,72149,143361
316440,201709,99,48,51,44976,47787,92763
316443,201709,36,34,2,31858,1874,33732
316447,201709,65,51,14,47787,13118,60905
316450,201709,215,164,51,153668,47787,201455
316460,201709,64,28,36,26236,33732,59968
316470,201709,1558,1122,436,1042439.39,407031.87,1449471.26
316480,201709,11,9,2,8433,1874,10307
316490,201709,16,5,11,4685,10307,14992
316500,201709,151,100,51,93418.9,47787,141205.9
316510,201709,173,128,45,118952.15,42165,161117.15
316520,201709,189,116,73,108129.8,68401,176530.8
316530,201709,148,107,41,100259,38136,138395
316540,201709,138,77,61,71212,57157,128369
316550,201709,144,100,44,93700,41228,134928
316553,201709,212,105,107,98166.5,100259,198425.5
316555,201709,30,21,9,19677,8433,28110
316556,201709,11,7,4,6559,3748,10307
316557,201709,16,14,2,13118,1874,14992
316560,201709,56,45,11,42165,10307,52472
316570,201709,245,222,23,207780,21551,229331
316580,201709,21,15,6,14055,5622,19677
316590,201709,118,102,16,95574,14992,110566
316600,201709,184,149,35,139332,32795,172127
316610,201709,68,45,23,41883.9,21551,63434.9
316620,201709,125,96,29,89952,27173,117125
316630,201709,37,27,10,25299,9370,34669
316640,201709,16,10,6,9370,5622,14992
316650,201709,60,47,13,44039,12181,56220
316660,201709,6,4,2,3748,1874,5622
316670,201709,441,154,287,144280,268357,412637
316680,201709,158,110,48,103070,44789,147859
316690,201709,192,121,71,113377,66527,179904
316695,201709,58,51,7,47787,6559,54346
316700,201709,13,7,6,6559,5622,12181
316710,201709,712,520,192,486724.9,179904,666628.9
316720,201709,4794,2442,2352,2273463.8,2199853.92,4473317.72
316730,201709,14,13,1,12181,937,13118
316740,201709,132,81,51,75897,47787,123684
316750,201709,19,13,6,12181,5622,17803
316760,201709,324,264,60,247368,56220,303588
316770,201709,140,82,58,76834,54346,131180
316780,201709,65,37,28,34369.16,26236,60605.16
316790,201709,56,42,14,39354,13118,52472
316800,201709,1791,1105,686,1033230.1,640709.1,1673939.2
316805,201709,18,9,9,8433,8433,16866
316810,201709,62,40,22,37480,20333,57813
316820,201709,36,18,18,16866,16866,33732
316830,201709,93,40,53,37480,49380,86860
316840,201709,497,301,196,281287.5,181778,463065.5
316850,201709,343,225,118,209466.35,110566,320032.35
316860,201709,5929,2610,3319,2431975.25,3105584.38,5537559.63
316870,201709,1395,902,493,836669.55,457330.45,1294000.00
316880,201709,103,59,44,54627.9,41228,95855.9
316890,201709,248,164,84,153668,78708,232376
316900,201709,417,285,132,264544.84,123684,388228.84
316905,201709,18,11,7,10307,6559,16866
316910,201709,51,26,25,24362,23425,47787
316920,201709,136,107,29,99557,27173,126730
316930,201709,1898,951,947,885420.15,885184.85,1770605.00
316935,201709,857,513,344,478807.66,320828.8,799636.46
316940,201709,1081,621,460,580870.32,430448.53,1011318.85
316950,201709,187,98,89,91826,83393,175219
316960,201709,1087,606,481,566510.9,450397.26,1016908.16
316970,201709,636,497,139,465689,130243,595932
316980,201709,113,67,46,62779,43092.63,105871.63
316990,201709,2158,1412,746,1316449.32,697353.88,2013803.20
317000,201709,320,247,73,231158,68401,299559
317005,201709,244,173,71,162101,66527,228628
317010,201709,6173,3382,2791,3150608.26,2613283.83,5763892.09
317020,201709,15902,7010,8892,6538867.32,8315668.7,14854536.02
317030,201709,85,32,53,29984,49167.02,79151.02
317040,201709,3103,1919,1184,1795967.64,1107347.6,2903315.24
317043,201709,69,47,22,44039,20614,64653
317047,201709,32,14,18,13118,16862,29980
317050,201709,185,138,47,129306,44039,173345
317052,201709,120,95,25,89015,23425,112440
317057,201709,197,151,46,141487,42540,184027
317060,201709,56,35,21,32795,19395.9,52190.9
317065,201709,59,48,11,44976,10307,55283
317070,201709,1957,923,1034,859229.85,966796.8,1826026.65
317075,201709,111,58,53,54346,49661,104007
317080,201709,809,432,377,403425.35,353062,756487.35
317090,201709,625,498,127,464330.75,118999,583329.75
317100,201709,407,304,103,282974.6,96511,379485.6
317103,201709,102,87,15,81519,14055,95574
317107,201709,37,33,4,30921,3748,34669
317110,201709,93,42,51,39354,47787,87141
317115,201709,40,34,6,31858,5622,37480
317120,201709,1753,879,874,815880.35,818489,1634369.35
317130,201709,1874,1201,673,1122674.2,629946,1752620.2
317140,201709,6,5,1,4685,937,5622
317150,201709,266,158,108,148046,100446.4,248492.4
317160,201709,312,227,85,212106,79645,291751
317170,201709,207,147,60,137739,56220,193959
317180,201709,415,300,115,280397.25,107755,388152.25
317190,201709,252,170,82,159290,76271.8,235561.8
317200,201709,778,558,220,509084,205906,714990
317210,201709,151,88,63,81519.6,59031,140550.6
317220,201709,20,12,8,11244,7496,18740
320010,201709,608,453,155,421182.25,145235,566417.25
320013,201709,130,93,37,87141,34669,121810
320016,201709,277,171,106,160227,99322,259549
320020,201709,710,428,282,397490.37,261639.97,659130.34
320030,201709,148,110,38,103070,35278.05,138348.05
320035,201709,131,95,36,89015,33732,122747
320040,201709,488,258,230,240621.8,215510,456131.8
320050,201709,101,79,22,74023,20614,94637
320060,201709,1490,684,806,640862,754557.3,1395419.3
320070,201709,100,70,30,65590,28110,93700
320080,201709,752,432,320,401804.5,299840,701644.5
320090,201709,1185,823,362,767828.83,338350.8,1106179.63
320100,201709,312,178,134,166786,125558,292344
320110,201709,136,85,51,77959.1,47225,125184.1
320115,201709,106,87,19,81519,17803,99322
320120,201709,3229,1814,1415,1688945.76,1323926.15,3012871.91
320130,201709,7147,3422,3725,3185989.25,3482402.38,6668391.63
320140,201709,416,268,148,249804.6,138436,388240.6
320150,201709,1819,1075,744,1000120.2,697118.63,1697238.83
320160,201709,689,304,385,283902.32,359697.36,643599.68
320170,201709,117,91,26,84518,24362,108880
320180,201709,49,28,21,26236,19677,45913
320190,201709,232,159,73,148224.03,68120,216344.03
320200,201709,52,38,14,35606,13118,48724
320210,201709,837,473,364,441702.8,340114,781816.8
320220,201709,303,115,188,106818.86,175875,282693.86
320225,201709,72,59,13,55283,12181,67464
320230,201709,525,339,186,316331.2,173486,489817.2
320240,201709,3069,1552,1517,1452069.9,1418810.05,2870879.95
320245,201709,433,304,129,283723.7,120873,404596.7
320250,201709,210,111,99,103070,92763,195833
320255,201709,144,114,30,105534.31,27970,133504.31
320260,201709,175,124,51,116188,47740.15,163928.15
320265,201709,159,127,32,118203,29984,148187
320270,201709,151,122,29,114314,27173,141487
320280,201709,915,552,363,511884.1,339034.81,850918.91
320290,201709,65,56,9,52472,8433,60905
320300,201709,523,374,149,349005.55,138368.55,487374.10
320305,201709,635,338,297,316706,278102,594808
320310,201709,210,120,90,112159,83588,195747
320313,201709,286,148,138,138676,129025,267701
320316,201709,108,90,18,84330,16866,101196
320320,201709,3280,1482,1798,1383097.9,1681147.47,3064245.37
320330,201709,258,188,70,175506.9,63716.81,239223.71
320332,201709,861,523,338,487759.9,315676.15,803436.05
320334,201709,237,143,94,133710,88078,221788
320335,201709,145,105,40,97213.95,37480,134693.95
320340,201709,589,407,182,380235,169879,550114
320350,201709,952,407,545,378923.14,510149.44,889072.58
320360,201709,162,87,75,81238,69963,151201
320370,201709,243,184,59,170852,54268,225120
320380,201709,280,192,88,178499.4,82456,260955.4
320390,201709,1093,673,420,630002,391715.66,1021717.66
320400,201709,323,229,94,213637,88078,301715
320405,201709,862,360,502,337316,470067.26,807383.26
320410,201709,943,485,458,452786.7,428781.34,881568.04
320420,201709,475,242,233,226286.2,218321,444607.2
320425,201709,192,104,88,97448,82456,179904
320430,201709,387,219,168,204359.95,157416,361775.95
320435,201709,163,109,54,101327.18,50598,151925.18
320440,201709,195,122,73,114032.9,68401,182433.9
320450,201709,130,77,53,72149,49661,121810
320455,201709,238,191,47,178031,44021,222052
320460,201709,238,152,86,142424,80582,223006
320465,201709,115,78,37,72729.94,34669,107398.94
320470,201709,627,398,229,372627.54,214569,587196.54
320480,201709,164,108,56,101196,52472,153668
320490,201709,2953,1462,1491,1366146.43,1394221.98,2760368.41
320495,201709,89,57,32,53391,29984,83375
320500,201709,9224,4708,4516,4385510.32,4220931.16,8606441.48
320501,201709,527,263,264,246431,247368,493799
320503,201709,269,193,76,179904.6,71212,251116.6
320506,201709,247,190,57,178030,53409,231439
320510,201709,895,429,466,398250.65,435143.05,833393.70
320515,201709,79,66,13,60905.45,12181,73086.45
320517,201709,200,141,59,132117,55283,187400
320520,201709,6543,2915,3628,2718092.16,3391050.9,6109143.06
320530,201709,5151,2604,2547,2431596.41,2383350.17,4814946.58
330010,201709,2929,1516,1413,1412967.68,1321236.91,2734204.59
330015,201709,155,60,95,55283.14,89015,144298.14
330020,201709,3481,1512,1969,1413303.6,1844391,3257694.6
330022,201709,204,114,90,106818,83394,190212
330023,201709,514,180,334,167489.4,312958,480447.4
330025,201709,517,119,398,111503,372363.9,483866.9
330030,201709,1885,1194,691,1110676.83,644538.04,1755214.87
330040,201709,2176,1097,1079,1026062.55,1009759,2035821.55
330045,201709,8198,2592,5606,2420731.51,5247065.78,7667797.29
330050,201709,780,493,287,461941,268919,730860
330060,201709,838,529,309,491927.45,288240.84,780168.29
330070,201709,3339,1306,2033,1218364.63,1903919.18,3122283.81
330080,201709,1436,691,745,642827.9,697128.3,1339956.2
330090,201709,352,212,140,198644,131180,329824
330093,201709,284,128,156,119936,146146,266082
330095,201709,101,52,49,48724,45913,94637
330100,201709,9233,4799,4434,4488162.14,4150535.3,8638697.44
330110,201709,469,210,259,196067.25,242683,438750.25
330115,201709,518,306,212,286722,198644,485366
330120,201709,360,186,174,173157.6,162569.5,335727.1
330130,201709,1442,427,1015,399386.88,951004,1350390.88
330140,201709,598,313,285,293272,266109,559381
330150,201709,438,262,176,243612.98,163975,407587.98
330160,201709,204,126,78,118062,73086,191148
330170,201709,26317,9305,17012,8699326.11,15925122.35,24624448.46
330180,201709,234,147,87,134301.75,80816.25,215118.00
330185,201709,759,320,439,298332.1,411325,709657.1
330187,201709,270,88,182,82456,170534,252990
330190,201709,5531,2212,3319,2064197.15,3105778.73,5169975.88
330200,201709,4299,1508,2791,1407843.5,2610290.18,4018133.68
330205,201709,389,241,148,225395.35,138395,363790.35
330210,201709,971,590,381,548429.8,355310.95,903740.75
330220,201709,2424,1435,989,1341269.75,925561.54,2266831.29
330225,201709,537,300,237,280473,222069,502542
330227,201709,2408,801,1607,747435.63,1505456.32,2252891.95
330230,201709,196,117,79,109629,74023,183652
330240,201709,3512,1840,1672,1719697.95,1564263.14,3283961.09
330245,201709,150,64,86,59968,79832.4,139800.4
330250,201709,6342,3291,3051,3073367.15,2849777.85,5923145.00
330260,201709,557,172,385,161164,360745,521909
330270,201709,3241,1203,2038,1126087.5,1909233,3035320.5
330280,201709,434,285,149,264160.34,139604,403764.34
330285,201709,6978,2332,4646,2180439.7,4350990.2,6531429.9
330290,201709,574,225,349,209847,326732,536579
330300,201709,720,488,232,453789.85,217367,671156.85
330310,201709,414,239,175,222069.35,163975,386044.35
330320,201709,7800,2924,4876,2732201.8,4564137.86,7296339.66
330330,201709,9321,3616,5705,3382995.16,5341243.72,8724238.88
330340,201709,2613,1576,1037,1474829.53,971650.26,2446479.79
330350,201709,17581,6978,10603,6512935.3,9914634.15,16427569.45
330360,201709,2585,1264,1321,1183225.7,1237768,2420993.7
330370,201709,966,527,439,493049.4,409376.3,902425.7
330380,201709,822,359,463,335650.77,433362.9,769013.67
330385,201709,607,321,286,299841,267982,567823
330390,201709,5072,2830,2242,2639362,2098880.52,4738242.52
330395,201709,231,147,84,136053.05,76225.5,212278.55
330400,201709,628,326,302,302370.4,280317.29,582687.69
330410,201709,502,358,144,333798.63,134928,468726.63
330411,201709,224,129,95,120873,88968.15,209841.15
330412,201709,246,103,143,96230,133991,230221
330414,201709,6218,2528,3690,2364934.4,3454093.75,5819028.15
330415,201709,551,262,289,245494,269856.4,515350.4
330420,201709,2266,1208,1058,1129198.05,989186.57,2118384.62
330430,201709,1777,777,1000,727300.1,936438,1663738.1
330440,201709,250,112,138,104944,129306,234250
330450,201709,122,49,73,45913,68401,114314
330452,201709,1627,741,886,692361.18,830172.63,1522533.81
330455,201709,109543,39007,70536,36474742.08,66034222.99,102508965.07
330460,201709,264,110,154,103070,144298,247368
330470,201709,1222,670,552,621608.19,517214.63,1138822.82
330475,201709,1373,381,992,355124.3,928941.8,1284066.1
330480,201709,739,396,343,370396.1,320455,690851.1
330490,201709,13247,4710,8537,4407194.72,7991997.11,12399191.83
330500,201709,1320,609,711,570633,665833,1236466
330510,201709,11155,3624,7531,3390002.36,7049430.91,10439433.27
330513,201709,108,54,54,50598,50598,101196
330515,201709,859,353,506,326829.9,473748,800577.9
330520,201709,2379,901,1478,844022,1384745.45,2228767.45
330530,201709,225,118,107,110566,100072,210638
330540,201709,348,177,171,165849,159759,325608
330550,201709,3125,1109,2016,1037589.08,1886977.65,2924566.73
330555,201709,725,262,463,245476,432707.4,678183.4
330560,201709,528,200,328,187400,307327,494727
330570,201709,245,167,78,156479,73086,229565
330575,201709,764,333,431,311787,401827.75,713614.75
330580,201709,3316,1868,1448,1744517.9,1355277,3099794.9
330590,201709,301,159,142,148983,133054,282037
330600,201709,1051,681,370,635998.72,345040.88,981039.60
330610,201709,1514,832,682,772962.16,635007.45,1407969.61
330615,201709,183,140,43,131180,40291,171471
330620,201709,900,446,454,414624.7,422960.3,837585.0
330630,201709,3629,2273,1356,2111726.61,1264522.59,3376249.20
350010,201709,599,392,207,365573.02,193959,559532.02
350020,201709,37,18,19,16866,17803,34669
350030,201709,514,335,179,312771,166554.66,479325.66
350040,201709,126,47,79,43701.68,74023,117724.68
350050,201709,289,161,128,150857,119683.63,270540.63
350055,201709,85,47,38,44039,35606,79645
350060,201709,70,26,44,24362,41228,65590
350070,201709,800,465,335,431400.55,312206.12,743606.67
350075,201709,65,42,23,39354,21551,60905
350080,201709,51,32,19,29359.3,16866,46225.3
350090,201709,101,58,43,54346,40286.32,94632.32
350100,201709,300,187,113,174516.25,105881,280397.25
350110,201709,59,37,22,34669,20614,55283
350115,201709,155,91,64,84611.1,59968,144579.1
350120,201709,110,74,36,69338,33732,103070
350130,201709,357,172,185,160602,173345,333947
350140,201709,33,19,14,17054,13118,30172
350150,201709,69,55,14,51535,13118,64653
350160,201709,2445,953,1492,889945.99,1396981.16,2286927.15
350170,201709,399,247,152,229284.25,142143,371427.25
350180,201709,184,96,88,89671,82456,172127
350190,201709,969,485,484,452477.84,453212.85,905690.69
350200,201709,72,26,46,24362,42841.8,67203.8
350210,201709,1350,753,597,697502.66,558318.03,1255820.69
350220,201709,677,582,95,541276.75,89015,630291.75
350230,201709,76,54,22,50598,20614,71212
350240,201709,64,49,15,45913,14055,59968
350250,201709,1211,612,599,566950.54,560738.93,1127689.47
350260,201709,91,65,26,60905,24362,85267
350270,201709,827,544,283,509025.25,263747.76,772773.01
350275,201709,297,118,179,110192,167723,277915
350280,201709,4634,2346,2288,2187222.2,2140156.76,4327378.96
350290,201709,395,188,207,175870.32,193396.9,369267.22
350300,201709,45,24,21,22488,19677,42165
350310,201709,98,70,28,65590,26236,91826
350315,201709,38,22,16,20614,14992,35606
350320,201709,3266,1602,1664,1496625.35,1558653.52,3055278.87
350330,201709,1662,881,781,821469.3,730796.7,1552266.0
350335,201709,20,13,7,12181,6559,18740
350340,201709,128,64,64,59968,59968,119936
350350,201709,96,47,49,44039,45913,89952
350360,201709,128,88,40,82452,37199,119651
350370,201709,95,55,40,50910.3,37470.63,88380.93
350380,201709,724,306,418,286066.1,390916.9,676983.0
350390,201709,1366,559,807,522999.25,755034.7,1278033.95
350395,201709,26,18,8,16866,7496,24362
350400,201709,1688,906,782,840142.87,728964.58,1569107.45
350410,201709,2197,978,1219,913633.88,1141889.22,2055523.10
350420,201709,237,145,92,135272,86204,221476
350430,201709,74,42,32,38792,29984,68776
350440,201709,150,109,41,101149.25,38417,139566.25
350450,201709,1592,1024,568,952395.9,532123,1484518.9
350460,201709,335,119,216,111503,202110.9,313613.9
350470,201709,13,10,3,9370,2811,12181
350480,201709,155,84,71,78708,66527,145235
350490,201709,242,116,126,107755.9,118062,225817.9
350500,201709,38,18,20,16866,18740,35606
350510,201709,165,112,53,104944,49661,154605
350520,201709,444,202,242,186776,226129.3,412905.3
350530,201709,460,223,237,208951,222069,431020
350535,201709,61,49,12,45539,11244,56783
350540,201709,377,190,187,177230.55,174938,352168.55
350550,201709,2724,1597,1127,1489244.18,1054717.41,2543961.59
350560,201709,624,436,188,408527.32,175800.65,584327.97
350570,201709,4239,1752,2487,1636688.51,2327575,3964263.51
350580,201709,367,172,195,160571,182701.63,343272.63
350590,201709,897,486,411,455382,384170,839552
350600,201709,6105,3073,3032,2865823.21,2838339.07,5704162.28
350610,201709,1557,778,779,723492.3,728977,1452469.3
350620,201709,39,27,12,25299,11244,36543
350630,201709,241,140,101,130243.3,93701,223944.3
350635,201709,823,321,502,300496,469457.54,769953.54
350640,201709,122,90,32,84330,29984,114314
350650,201709,1862,1221,641,1140423.97,599604.1,1740028.07
350660,201709,745,338,407,316706,380418,697124
350670,201709,309,156,153,145938,143361,289299
350680,201709,176,97,79,90889,74023,164912
350690,201709,204,100,104,93700,97448,191148
350700,201709,675,334,341,309683.99,319236,628919.99
350710,201709,315,128,187,118749.1,175219,293968.1
350715,201709,47,42,5,39354,4685,44039
350720,201709,18,13,5,12181,4685,16866
350730,201709,42,27,15,25299,14055,39354
350740,201709,203,113,90,105590.53,84330,189920.53
350745,201709,21,11,10,10283,9370,19653
350750,201709,2102,1365,737,1269365.55,689944.3,1959309.85
350760,201709,3698,1594,2104,1492641.3,1969002.53,3461643.83
350770,201709,61,42,19,39354,17803,57157
350775,201709,49,36,13,33732,12172,45904
350780,201709,416,202,214,189274,200518,389792
350790,201709,376,163,213,152731,199581,352312
350800,201709,422,232,190,217384,178030,395414
350810,201709,512,409,103,381359.11,96511,477870.11
350820,201709,82,51,31,47787,29047,76834
350830,201709,81,48,33,44976,30921,75897
350840,201709,713,322,391,301498,365430,666928
350850,201709,1722,998,724,929498.26,678132,1607630.26
350860,201709,557,325,232,302634.16,217384,520018.16
350870,201709,442,300,142,280819,132772.9,413591.9
350880,201709,290,157,133,144300.55,124621,268921.55
350890,201709,42,26,16,24362,14992,39354
350900,201709,1413,457,956,426259.19,895022.4,1321281.59
350910,201709,25,17,8,15929,7496,23425
350920,201709,600,338,262,316393.7,245494,561887.7
350925,201709,1162,624,538,581699.69,502700.7,1084400.39
350930,201709,96,59,37,55283,34669,89952
350940,201709,686,381,305,355497.8,283976.8,639474.6
350945,201709,104,80,24,74436,22488,96924
350950,201709,14853,7147,7706,6668586.01,7211464.09,13880050.10
350960,201709,1279,595,684,552918.8,640904,1193822.8
350970,201709,1114,618,496,576839.3,464461.63,1041300.93
350980,201709,102,68,34,63716,31858,95574
350990,201709,366,131,235,121482.06,219913.9,341395.96
350995,201709,31,16,15,14992,14055,29047
351000,201709,632,451,181,420402.26,169597,589999.26
351010,201709,51,28,23,26236,21551,47787
351015,201709,59,42,17,39354,15929,55283
351020,201709,1651,950,701,888474.64,654776.2,1543250.84
351030,201709,321,223,98,206422.7,91826,298248.7
351040,201709,838,451,387,421650,361495.15,783145.15
351050,201709,3210,1548,1662,1443340.14,1555456.64,2998796.78
351060,201709,4839,2003,2836,1867250.26,2654351.57,4521601.83
351070,201709,422,272,150,253091.32,140550,393641.32
351080,201709,807,576,231,539712,215510,755222
351090,201709,65,29,36,27173,33732,60905
351100,201709,455,263,192,244248.35,179890.32,424138.67
351110,201709,2117,1023,1094,952404.39,1022449.81,1974854.20
351120,201709,75,40,35,37396.6,32795,70191.6
351130,201709,173,57,116,53409,108692,162101
351140,201709,333,234,99,217478.5,92763,310241.5
351150,201709,383,194,189,181216,177093,358309
351160,201709,245,160,85,149920,79645,229565
351170,201709,178,91,87,85267,80770,166037
351190,201709,90,61,29,57157,27173,84330
351200,201709,379,249,130,232719.7,121810,354529.7
351210,201709,134,62,72,57562.82,67464,125026.82
351220,201709,519,311,208,288096.81,194896,482992.81
351230,201709,278,202,76,188649.3,71193.26,259842.56
351240,201709,229,100,129,93512.6,120873,214385.6
351250,201709,69,49,20,45913,18740,64653
351260,201709,152,111,41,104007,38136,142143
351270,201709,51,23,28,21551,26236,47787
351280,201709,1102,506,596,470376.35,557937.39,1028313.74
351290,201709,225,100,125,93700,116844,210544
351300,201709,3747,1762,1985,1644251.13,1859633,3503884.13
351310,201709,747,395,352,368226,329824,698050
351320,201709,106,65,41,60905,38417,99322
351330,201709,40,28,12,26236,11244,37480
351340,201709,1187,750,437,695065.47,408502.32,1103567.79
351350,201709,2345,1268,1077,1186570.85,1008863.22,2195434.07
351360,201709,766,384,382,357934,357132.49,715066.49
351370,201709,367,193,174,180836.32,162413.3,343249.62
351380,201709,8925,4109,4816,3835509.5,4502685.36,8338194.86
351385,201709,29,20,9,18740,8433,27173
351390,201709,290,214,76,199788.26,71212,271000.26
351400,201709,59,36,23,33732,21505.63,55237.63
351410,201709,420,265,155,246899.9,144672.9,391572.8
351420,201709,62,51,11,47787,10307,58094
351430,201709,78,41,37,38417,34669,73086
351440,201709,779,535,244,499137.2,228624,727761.2
351450,201709,242,124,118,116188,110566,226754
351460,201709,120,55,65,50833,60905,111738
351470,201709,139,71,68,66518,63716,130234
351480,201709,516,279,237,259268.4,221951.88,481220.28
351490,201709,297,101,196,94637,183652,278289
351492,201709,33,23,10,21551,9370,30921
351495,201709,28,18,10,16866,9370,26236
351500,201709,3531,1524,2007,1422300.37,1875454,3297754.37
351510,201709,1760,734,1026,687476.9,959197.54,1646674.44
351512,201709,21,17,4,15929,3748,19677
351515,201709,193,108,85,101196,79645,180841
351518,201709,712,434,278,405717,260345.45,666062.45
351519,201709,73,47,26,44039,24362,68401
351520,201709,144,91,53,84643,49661,134304
351530,201709,19,13,6,12181,5622,17803
351535,201709,138,74,64,69338,59968,129306
351540,201709,431,307,124,285319,115813.2,401132.2
351550,201709,1292,794,498,737516.1,466616.63,1204132.73
351560,201709,75,37,38,34669,35606,70275
351565,201709,11,6,5,5622,4685,10307
351570,201709,2551,1324,1227,1238732.03,1149052.26,2387784.29
351580,201709,37,32,5,29984,4685,34669
351590,201709,68,45,23,42165,21551,63716
351600,201709,190,142,48,133054,44976,178030
351610,201709,59,29,30,27173,28110,55283
351620,201709,5940,3416,2524,3190573.56,2361918.61,5552492.17
351630,201709,2498,1289,1209,1201636.59,1130954.32,2332590.91
351640,201709,1640,794,846,741471.06,791203.4,1532674.46
351650,201709,29,25,4,23425,3748,27173
351660,201709,157,99,58,91545.5,54346,145891.5
351670,201709,733,460,273,428725,255801,684526
351680,201709,76,62,14,58094,13118,71212
351685,201709,44,27,17,25299,15929,41228
351690,201709,306,216,90,200560.17,84330,284890.17
351700,201709,165,115,50,107755,46850,154605
351710,201709,75,52,23,48724,21551,70275
351720,201709,135,62,73,58094,68401,126495
351730,201709,95,69,26,64653,24357.32,89010.32
351740,201709,707,472,235,441983,220190.32,662173.32
351750,201709,363,153,210,142424.7,196770,339194.7
351760,201709,796,620,176,581175,164776,745951
351770,201709,285,245,40,229565,37480,267045
351780,201709,168,92,76,86204,71212,157416
351790,201709,238,127,111,118999,104007,223006
351800,201709,52,34,18,31858,16866,48724
351810,201709,119,77,42,71868,39354,111222
351820,201709,880,640,240,596214.9,224875.32,821090.22
351830,201709,504,185,319,172595.4,298903,471498.4
351840,201709,1857,952,905,882536.75,846854.11,1729390.86
351850,201709,226,170,56,158681.9,52472,211153.9
351860,201709,751,492,259,456081.77,242678.32,698760.09
351870,201709,5581,2658,2923,2481208.32,2732906.1,5214114.42
351880,201709,18841,8332,10509,7783633.51,9831372,17615005.51
351885,201709,92,60,32,56220,29984,86204
351890,201709,78,64,14,59968,13118,73086
351900,201709,222,133,89,123966,83393,207359
351905,201709,76,34,42,31858,39354,71212
351907,201709,3068,1344,1724,1255292.23,1614348.9,2869641.13
351910,201709,176,71,105,66527,98385,164912
351920,201709,139,81,58,75897,54323.96,130220.96
351925,201709,85,59,26,55283,24362,79645
351930,201709,377,260,117,243526.3,109629,353155.3
351940,201709,229,104,125,97448,117125,214573
351950,201709,142,81,61,75897,57157,133054
351960,201709,826,384,442,359632.75,412317.58,771950.33
351970,201709,1896,1002,894,936766.04,837388,1774154.04
351980,201709,146,74,72,67464,67464,134928
351990,201709,286,195,91,181778,84479.92,266257.92
352000,201709,353,210,143,196395.2,133991,330386.2
352010,201709,342,201,141,188337,132117,320454
352020,201709,196,69,127,64653,118999,183652
352030,201709,994,510,484,477167.25,451946.3,929113.55
352040,201709,569,245,324,229565,303588,533153
352042,201709,269,94,175,88078,163413,251491
352044,201709,393,235,158,219258.1,148046,367304.1
352050,201709,3116,1279,1837,1190104.9,1720190.53,2910295.43
352060,201709,101,65,36,60905,33732,94637
352070,201709,100,72,28,66528,26236,92764
352080,201709,63,38,25,34669,23425,58094
352090,201709,173,117,56,109629,52472,162101
352100,201709,250,122,128,114314,118804,233118
352110,201709,113,35,78,32795,73086,105881
352115,201709,72,27,45,25299,42165,67464
352120,201709,99,62,37,58094,34669,92763
352130,201709,221,185,36,173157.6,33732,206889.6
352140,201709,177,72,105,66996,98385,165381
352150,201709,120,68,52,62779.7,48724,111503.7
352160,201709,131,87,44,81519,41228,122747
352170,201709,376,255,121,237998.7,113377,351375.7
352180,201709,596,404,192,377471.75,179900,557371.75
352190,201709,263,104,159,97438.63,148936.15,246374.78
352200,201709,31,18,13,16866,12181,29047
352210,201709,3694,1531,2163,1425816.28,2020449.72,3446266.00
352215,201709,49,27,22,25299,20164.24,45463.24
352220,201709,6934,2724,4210,2547851.24,3942602.72,6490453.96
352230,201709,3126,1997,1129,1859123.52,1052913.54,2912037.06
352240,201709,2156,1284,872,1200158.29,815846.25,2016004.54
352250,201709,2567,1358,1209,1269511.6,1128698.5,2398210.1
352260,201709,1105,622,483,581587.32,452290,1033877.32
352265,201709,62,28,34,26236,31858,58094
352270,201709,395,225,170,209888.84,159235,369123.84
352280,201709,385,243,142,226442,132768.32,359210.32
352290,201709,176,110,66,102508,61842,164350
352300,201709,102,78,24,73086,22488,95574
352310,201709,5692,2790,2902,2604449.78,2713726.68,5318176.46
352320,201709,926,495,431,461223.99,401832.55,863056.54
352330,201709,528,229,299,214245.05,279882,494127.05
352340,201709,1393,687,706,640178.5,660725.75,1300904.25
352350,201709,318,202,116,189274,108411,297685
352360,201709,225,89,136,82502.85,125819,208321.85
352370,201709,104,70,34,65590,31858,97448
352380,201709,118,72,46,67464,43102,110566
352390,201709,2413,1103,1310,1029136.9,1225597.14,2254734.04
352400,201709,461,194,267,181075.25,249897.9,430973.15
352410,201709,739,531,208,493118.9,194428,687546.9
352420,201709,101,64,37,59968,34669,94637
352430,201709,1754,780,974,724958.55,910969.59,1635928.14
352440,201709,3005,1570,1435,1463197,1341744.4,2804941.4
352450,201709,186,158,28,148046,26236,174282
352460,201709,565,292,273,273056.54,254443.2,527499.74
352470,201709,572,194,378,181778,354177,535955
352480,201709,1365,761,604,711527.3,565385.9,1276913.2
352490,201709,82,31,51,29047,47787,76834
352500,201709,1203,540,663,504763,620098.1,1124861.1
352510,201709,734,398,336,371989.3,314832,686821.3
352520,201709,538,242,296,226754,277211.45,503965.45
352530,201709,1709,902,807,844237,755784.3,1600021.3
352540,201709,75,50,25,46850,23425,70275
352550,201709,188,108,80,101196,74304.1,175500.1
352560,201709,50,40,10,37480,9370,46850
352570,201709,655,344,311,321735,291407,613142
352580,201709,57,39,18,35606.33,16866,52472.33
352585,201709,14,5,9,4685,8433,13118
352590,201709,4252,2137,2115,1996903.3,1980870.11,3977773.41
352600,201709,357,250,107,233313.3,100250,333563.3
352610,201709,914,427,487,397412.51,456319,853731.51
352620,201709,973,386,587,360745.1,550019,910764.1
352630,201709,217,81,136,75897,127000.98,202897.98
352640,201709,549,386,163,359309.15,152731,512040.15
352650,201709,90,60,30,56220,28110,84330
352660,201709,82,49,33,45913,30921,76834
352670,201709,1638,892,746,832373.88,697650.98,1530024.86
352680,201709,879,563,316,523395.68,294843.2,818238.88
352690,201709,4269,1986,2283,1852167.9,2135373.87,3987541.77
352700,201709,110,61,49,57157,45913,103070
352710,201709,1308,689,619,643719.1,577661,1221380.1
352720,201709,1229,596,633,555954.1,593116.32,1149070.42
352725,201709,27,25,2,23425,1874,25299
352730,201709,366,181,185,168439.81,172783,341222.81
352740,201709,402,252,150,234204.04,140550,374754.04
352750,201709,24,16,8,14710.9,7496,22206.9
352760,201709,192,140,52,131180,48724,179904
352770,201709,82,65,17,60905,15929,76834
352780,201709,81,45,36,42165,33732,75897
352790,201709,27,23,4,21551,3748,25299
352800,201709,244,165,79,154605,73741.9,228346.9
352810,201709,162,105,57,95918.92,53409,149327.92
352820,201709,66,55,11,51117.1,10307,61424.1
352830,201709,87,61,26,57157,24362,81519
352840,201709,569,298,271,277962.1,253851,531813.1
352850,201709,1324,480,844,449104.1,790828,1239932.1
352860,201709,127,83,44,77771,41228,118999
352870,201709,39,24,15,22488,14055,36543
352880,201709,186,128,58,119917.26,54346,174263.26
352885,201709,29,20,9,18740,8433,27173
352890,201709,53,37,16,34669,14711,49380
352900,201709,4936,2401,2535,2232733.28,2368447.08,4601180.36
352910,201709,41,32,9,29984,8433,38417
352920,201709,716,439,277,410406,259549,669955
352930,201709,1242,602,640,562683.58,596766.51,1159450.09
352940,201709,6309,2726,3583,2542007.6,3353401.95,5895409.55
352950,201709,88,35,53,32795,49661,82456
352960,201709,68,44,24,41228,22488,63716
352965,201709,20,8,12,7496,11244,18740
352970,201709,459,340,119,313868.44,110567,424435.44
352980,201709,176,90,86,84330,80582,164912
352990,201709,893,424,469,394603.25,437802.45,832405.70
353000,201709,65,30,35,28110,32795,60905
353010,201709,551,343,208,321391,194877.27,516268.27
353020,201709,286,209,77,195833,72149,267982
353030,201709,1163,532,631,498165.63,590572.73,1088738.36
353040,201709,86,53,33,49661,30921,80582
353050,201709,1285,812,473,755286.45,443107.3,1198393.75
353060,201709,7564,3540,4024,3302697.71,3763929.17,7066626.88
353070,201709,1638,1027,611,955674.63,571240.04,1526914.67
353080,201709,1307,687,620,641423.62,580931.32,1222354.94
353090,201709,58,35,23,32795,21551,54346
353100,201709,61,49,12,45913,11244,57157
353110,201709,1872,596,1276,556751.63,1193917.32,1750668.95
353120,201709,72,37,35,34669,32795,67464
353130,201709,861,426,435,398206.63,407557.89,805764.52
353140,201709,589,226,363,211703,340131,551834
353150,201709,356,196,160,182715,149910.63,332625.63
353160,201709,104,85,19,79645,17803,97448
353170,201709,197,65,132,60895.63,123656.63,184552.26
353180,201709,948,435,513,406081.95,480166,886247.95
353190,201709,460,325,135,304423,126495,430918
353200,201709,181,90,91,84330,85267,169597
353205,201709,27,19,8,17803,7496,25299
353210,201709,81,50,31,46850,29047,75897
353215,201709,57,33,24,30921,22488,53409
353220,201709,83,48,35,44976,31858.93,76834.93
353230,201709,159,62,97,58094,90889,148983
353240,201709,273,149,124,139613,116188,255801
353250,201709,202,108,94,101196,88078,189274
353260,201709,420,308,112,287481.25,104934.63,392415.88
353270,201709,69,50,19,46850,17147.1,63997.1
353280,201709,93,46,47,42634,44039,86673
353282,201709,117,87,30,81519,28110,109629
353284,201709,25,20,5,18740,4685,23425
353286,201709,1,1,0,937,0,937
353290,201709,78,48,30,44976,28101,73077
353300,201709,399,221,178,205562.55,166786,372348.55
353310,201709,51,47,4,44039,3748,47787
353320,201709,61,38,23,35606,21551,57157
353325,201709,54,35,19,32795,17504,50299
353330,201709,69,53,16,49521,14992,64513
353340,201709,615,194,421,181778,393905.54,575683.54
353350,201709,902,423,479,395545.92,447588,843133.92
353360,201709,111,88,23,82143.7,21270,103413.7
353370,201709,120,68,52,62779.55,48724,111503.55
353380,201709,29,21,8,19673,7496,27169
353390,201709,1027,500,527,468500,493799,962299
353400,201709,51,30,21,28110,19677,47787
353410,201709,118,72,46,67464,43056,110520
353420,201709,56,24,32,22488,29984,52472
353430,201709,545,361,184,334602.08,171976.9,506578.98
353440,201709,10174,4432,5742,4140850.03,5373763.22,9514613.25
353450,201709,57,30,27,28110,25299,53409
353460,201709,602,327,275,302350.99,256027.25,558378.24
353470,201709,2114,1144,970,1066828.26,906236.72,1973064.98
353475,201709,235,157,78,144470.3,73086,217556.3
353480,201709,190,151,39,141487,36543,178030
353490,201709,232,139,93,130243,87141,217384
353500,201709,178,107,71,99041.3,66527,165568.3
353510,201709,102,73,29,68382.63,27163.63,95546.26
353520,201709,210,144,66,134928,61842,196770
353530,201709,450,242,208,226754,194896,421650
353540,201709,354,235,119,219878.02,111503,331381.02
353550,201709,728,493,235,458849.85,220195,679044.85
353560,201709,633,271,362,252990.6,338890.22,591880.82
353570,201709,61,32,29,29984,27173,57157
353580,201709,355,272,83,254396,77771,332167
353590,201709,80,54,26,50253.98,24362,74615.98
353600,201709,267,148,119,138364,111503,249867
353610,201709,115,60,55,56220,51535,107755
353620,201709,560,303,257,281322.09,240527.9,521849.99
353625,201709,52,27,25,25299,23425,48724
353630,201709,234,168,66,153163.07,61842,215005.07
353640,201709,124,85,39,78708.5,36543,115251.5
353650,201709,821,326,495,303400.6,463815,767215.6
353657,201709,21,15,6,14055,5622,19677
353660,201709,254,140,114,131180,106536.9,237716.9
353670,201709,719,439,280,410406.1,262360,672766.1
353680,201709,100,72,28,67464,26236,93700
353690,201709,46,36,10,33732,9370,43102
353700,201709,287,202,85,189274,79645,268919
353710,201709,400,187,213,174282.4,199581,373863.4
353715,201709,45,36,9,33450.9,8433,41883.9
353720,201709,364,168,196,157398,183632,341030
353730,201709,1130,697,433,650232.45,405439.9,1055672.35
353740,201709,634,357,277,334227.9,259549,593776.9
353750,201709,100,61,39,56634.62,36543,93177.62
353760,201709,2644,1004,1640,938683.3,1533141.37,2471824.67
353770,201709,99,80,19,74491.5,17803,92294.5
353780,201709,1083,554,529,516475.3,493799,1010274.3
353790,201709,503,286,217,265949.55,203209,469158.55
353800,201709,3224,1646,1578,1533479.46,1476181.17,3009660.63
353810,201709,239,134,105,124719.75,98358,223077.75
353820,201709,175,85,90,79645,83716.54,163361.54
353830,201709,49,42,7,39354,6559,45913
353850,201709,166,87,79,81519,74023,155542
353860,201709,461,204,257,189789.35,240527.9,430317.25
353870,201709,4907,2468,2439,2298079.83,2275439.33,4573519.16
353880,201709,662,469,193,438610.2,179904.36,618514.56
353890,201709,584,322,262,301152,245494,546646
353900,201709,138,65,73,60905,68401,129306
353910,201709,178,85,93,79645,87141,166786
353920,201709,452,246,206,229331.7,193008.64,422340.34
353930,201709,972,586,386,546951.44,360516.9,907468.34
353940,201709,187,102,85,94824.4,78802,173626.4
353950,201709,511,315,196,294864.53,183652,478516.53
353960,201709,68,54,14,50598,13118,63716
353970,201709,72,47,25,44039,23425,67464
353980,201709,1502,744,758,694521.59,710234,1404755.59
353990,201709,76,42,34,39354,31858,71212
354000,201709,371,172,199,160509,186271.6,346780.6
354010,201709,96,51,45,47787,41697,89484
354020,201709,536,338,198,315769,185526,501295
354025,201709,54,44,10,41228,9370,50598
354030,201709,65,34,31,31858,29047,60905
354040,201709,91,65,26,60623.9,24362,84985.9
354050,201709,183,104,79,97167,74023,171190
354060,201709,769,371,398,347627,370444.6,718071.6
354070,201709,877,507,370,472931.52,346690,819621.52
354075,201709,206,113,93,105788,86204.9,191992.9
354080,201709,290,130,160,121528.9,149920,271448.9
354085,201709,19,12,7,11244,6559,17803
354090,201709,312,173,139,162022,130243,292265
354100,201709,5397,2221,3176,2071239.17,2971593.55,5042832.72
354105,201709,81,42,39,39354,36543,75897
354110,201709,46,20,26,18740,24362,43102
354120,201709,145,100,45,93563.29,42165,135728.29
354130,201709,685,463,222,433597,207729,641326
354140,201709,3169,1479,1690,1382486.42,1582106.88,2964593.30
354150,201709,635,395,240,368897,223474.5,592371.5
354160,201709,684,429,255,400801.75,238654,639455.75
354165,201709,18,12,6,11244,5622,16866
354170,201709,170,116,54,108036.1,50598,158634.1
354180,201709,66,41,25,38097,23425,61522
354190,201709,205,94,111,86485.1,104007,190492.1
354200,201709,131,69,62,64185,58094,122279
354210,201709,71,34,37,31858,34669,66527
354220,201709,648,403,245,376955.1,228347.18,605302.28
354230,201709,157,65,92,60905,85267.8,146172.8
354240,201709,316,203,113,188993.69,105256.3,294249.99
354250,201709,90,53,37,49661,34669,84330
354260,201709,1882,873,1009,808509.82,943179,1751688.82
354270,201709,96,72,24,67464,22488,89952
354280,201709,32,17,15,15929,14055,29984
354290,201709,151,103,48,95246.55,44976,140222.55
354300,201709,414,285,129,266733,120873,387606
354310,201709,102,74,28,68401.1,26236,94637.1
354320,201709,182,96,86,89952,80582,170534
354323,201709,16,14,2,13118,1874,14992
354325,201709,111,64,47,59176,44039,103215
354330,201709,2490,856,1634,798456.94,1528929.69,2327386.63
354340,201709,10597,5151,5446,4811491.76,5097282.2,9908773.96
354350,201709,130,88,42,82456,39213.45,121669.45
354360,201709,88,49,39,45913,36543,82456
354370,201709,267,139,128,130243,119936,250179
354380,201709,209,122,87,113540,81519,195059
354390,201709,2730,992,1738,929195.5,1626774.94,2555970.44
354400,201709,323,168,155,156058.9,144672.9,300731.8
354410,201709,607,295,312,275474.32,291407.1,566881.42
354420,201709,264,168,96,157416,89952,247368
354425,201709,315,181,134,169597,125549,295146
354430,201709,193,123,70,113704.95,64840.4,178545.35
354440,201709,41,29,12,27173,11244,38417
354450,201709,47,32,15,29984,14055,44039
354460,201709,100,57,43,53409,40291,93700
354470,201709,37,27,10,25299,9370,34669
354480,201709,118,63,55,59022,51525.63,110547.63
354490,201709,144,92,52,86047.81,48724,134771.81
354500,201709,396,196,200,183652,187400,371052
354510,201709,107,73,34,68401,31858,100259
354515,201709,40,15,25,14055,23425,37480
354520,201709,1593,712,881,664199.6,824878.58,1489078.18
354530,201709,627,325,302,302178.5,282131.1,584309.6
354540,201709,274,153,121,143361,113372.32,256733.32
354550,201709,43,24,19,22488,17803,40291
354560,201709,158,93,65,87141,60895.63,148036.63
354570,201709,142,93,49,87141,45913,133054
354580,201709,1969,939,1030,877031,964815.54,1841846.54
354600,201709,278,151,127,139276.36,118994.32,258270.68
354610,201709,70,64,6,59968,5622,65590
354620,201709,64,19,45,17803,42165,59968
354625,201709,17,11,6,10307,5618,15925
354630,201709,321,212,109,198144.21,102133,300277.21
354640,201709,784,507,277,471203.5,259549,730752.5
354650,201709,73,39,34,36534,31821.26,68355.26
354660,201709,813,594,219,553252.05,205203,758455.05
354670,201709,290,104,186,96824,173346,270170
354680,201709,1227,458,769,429146,720085,1149231
354690,201709,88,61,27,55518.25,25299,80817.25
354700,201709,78,57,21,53409,19677,73086
354710,201709,55,38,17,34981.3,15929,50910.3
354720,201709,21,20,1,18740,937,19677
354730,201709,1923,811,1112,757275.5,1041756.6,1799032.1
354740,201709,56,40,16,37480,14992,52472
354750,201709,436,260,176,243611,164912,408523
354760,201709,514,316,198,293724,185214,478938
354765,201709,11,5,6,4685,5622,10307
354770,201709,323,224,99,208797.71,92013.4,300811.11
354780,201709,8107,3304,4803,3083082.68,4495841.92,7578924.60
354790,201709,116,68,48,63716,44976,108692
354800,201709,406,227,179,212699,167442,380141
354805,201709,105,53,52,49037,48724,97761
354810,201709,136,79,57,73741.9,53409,127150.9
354820,201709,179,78,101,72880,94637,167517
354830,201709,38,21,17,19677,15929,35606
354840,201709,53,36,17,33732,15929,49661
354850,201709,4548,2031,2517,1895398.7,2353924.03,4249322.73
354860,201709,333,162,171,151794,158166.3,309960.3
354870,201709,11598,5250,6348,4894547.88,5939242.63,10833790.51
354880,201709,2963,1117,1846,1044458.55,1727853.96,2772312.51
354890,201709,2822,1560,1262,1456768.49,1181360.64,2638129.13
354900,201709,61,40,21,37480,19677,57157
354910,201709,1185,626,559,583714.22,523783,1107497.22
354920,201709,52,44,8,41228,7496,48724
354925,201709,11,6,5,5622,4685,10307
354930,201709,30,27,3,25033,2811,27844
354940,201709,806,590,216,550912.09,202392,753304.09
354950,201709,224,149,75,139011,70275,209286
354960,201709,170,65,105,60905,98104,159009
354970,201709,824,539,285,500269.39,266417.31,766686.70
354980,201709,8311,3107,5204,2903877.61,4873763.62,7777641.23
354990,201709,9095,4285,4810,4005575.07,4500760.14,8506335.21
354995,201709,517,182,335,170534,313304.69,483838.69
355000,201709,453,147,306,137734.32,285661,423395.32
355010,201709,623,399,224,373863,207715.36,581578.36
355020,201709,719,449,270,419771.9,252982,672753.9
355030,201709,201524,78000,123524,72877162.47,115643415.6,188520578.07
355040,201709,705,341,364,319236,340880.6,660116.6
355050,201709,153,102,51,94325.77,47787,142112.77
355060,201709,1383,708,675,658635.97,630648.25,1289284.22
355070,201709,1449,713,736,665257.44,688656,1353913.44
355080,201709,203,118,85,110358.74,78773.9,189132.64
355090,201709,287,194,93,179718,87141,266859
355100,201709,4756,2382,2374,2213958.55,2222035.39,4435993.94
355110,201709,291,189,102,175360.55,95574,270934.55
355120,201709,115,83,32,77302.5,29984,107286.5
355130,201709,50,26,24,24362,22488,46850
355140,201709,180,119,61,111503,57157,168660
355150,201709,669,404,265,377326.1,247836.5,625162.6
355160,201709,435,203,232,187587.8,217384,404971.8
355170,201709,2023,1051,972,983429.87,910464.28,1893894.15
355180,201709,624,266,358,248305,334345.02,582650.02
355190,201709,217,147,70,137739,65590,203329
355200,201709,117,68,49,63716,45913,109629
355210,201709,690,400,290,374800,271711.63,646511.63
355220,201709,6444,3477,2967,3248267.78,2770798.62,6019066.40
355230,201709,107,64,43,59968,40286.32,100254.32
355240,201709,4112,1813,2299,1686559.47,2150160.38,3836719.85
355250,201709,5267,2594,2673,2422469.61,2501453.6,4923923.21
355255,201709,50,30,20,28110,18740,46850
355260,201709,191,114,77,105862.36,72131,177993.36
355270,201709,165,97,68,90889,63014,153903
355280,201709,6155,2607,3548,2438281.75,3319909.07,5758190.82
355290,201709,78,59,19,55283,17803,73086
355300,201709,176,117,59,109629,55283,164912
355310,201709,104,58,46,54346,43102,97448
355320,201709,93,47,46,43759.68,42406.3,86165.98
355330,201709,272,149,123,139613,115251,254864
355340,201709,1360,536,824,499671.76,771359.2,1271030.96
355350,201709,138,70,68,65590,63716,129306
355360,201709,176,109,67,101926.86,62779,164705.86
355365,201709,26,21,5,19677,4685,24362
355370,201709,1024,577,447,534323.59,417086.04,951409.63
355380,201709,763,512,251,478344.8,234906,713250.8
355385,201709,53,37,16,34669,14992,49661
355390,201709,102,59,43,55283,40291,95574
355395,201709,188,115,73,106954.32,68401,175355.32
355400,201709,1517,946,571,882474.98,534464.9,1416939.88
355410,201709,4819,2251,2568,2092066.38,2396938.91,4489005.29
355420,201709,45,34,11,31858,10307,42165
355430,201709,344,211,133,197051.1,124621,321672.1
355440,201709,75,43,32,40291,29984,70275
355450,201709,416,196,220,179484.67,204828.3,384312.97
355460,201709,70,54,16,49661.51,14992,64653.51
355465,201709,51,32,19,29984,17803,47787
355470,201709,188,74,114,68401.55,106818,175219.55
355475,201709,12,8,4,7496,3748,11244
355480,201709,450,194,256,180654,238457.13,419111.13
355490,201709,113,82,31,76834,29047,105881
355495,201709,52,26,26,24362,24362,48724
355500,201709,1700,969,731,903444.14,684818.64,1588262.78
355510,201709,266,194,72,178381.5,67464,245845.5
355520,201709,37,29,8,27173,7496,34669
355530,201709,22,15,7,14055,6559,20614
355535,201709,76,36,40,33732,37480,71212
355540,201709,2319,936,1383,875599.42,1293698.63,2169298.05
355550,201709,65,39,26,36543,24362,60905
355560,201709,239,121,118,113377,109941.3,223318.3
355570,201709,29,18,11,16866,10307,27173
355580,201709,270,185,85,173345,79640.32,252985.32
355590,201709,24,15,9,14055,8433,22488
355600,201709,271,143,128,133991,119650.32,253641.32
355610,201709,206,134,72,125558,67464,193022
355620,201709,1234,566,668,527651.1,625349.8,1153000.9
355630,201709,406,287,119,267983,111503,379486
355635,201709,126,59,67,55283,62766,118049
355640,201709,566,330,236,308273,221132,529405
355645,201709,824,358,466,333784.64,434796.21,768580.85
355650,201709,2011,891,1120,832591.4,1049421.63,1882013.03
355660,201709,262,139,123,130243,115246.32,245489.32
355670,201709,466,173,293,162101,274541,436642
355680,201709,216,123,93,115251,86796,202047
355690,201709,85,40,45,37480,41827,79307
355695,201709,13,11,2,10307,1874,12181
355700,201709,1122,584,538,541882.61,503825,1045707.61
355710,201709,2199,1203,996,1122668.68,932661.9,2055330.58
355715,201709,21,19,2,17803,1874,19677
355720,201709,201,121,80,111815.66,74956,186771.66
355730,201709,89,52,37,47865.53,34669,82534.53
410010,201709,129,110,19,103070,17803,120873
410020,201709,103,92,11,86204,10307,96511
410030,201709,157,99,58,92107.2,54346,146453.2
410040,201709,973,523,450,489535.65,421463,910998.65
410045,201709,27,22,5,20614,4685,25299
410050,201709,469,262,207,245494,193771.6,439265.6
410060,201709,265,206,59,192741,55283,248024
410070,201709,318,259,59,242683,55283,297966
410080,201709,165,109,56,102133,52472,154605
410090,201709,78,69,9,64447,8433,72880
410100,201709,293,208,85,194586.79,78942.25,273529.04
410105,201709,42,25,17,23425,15929,39354
410110,201709,309,189,120,177093,112440,289533
410115,201709,27,18,9,16866,8433,25299
410120,201709,454,227,227,212402.9,212699,425101.9
410130,201709,39,26,13,24362,12181,36543
410140,201709,3032,1493,1539,1394385.63,1441752.63,2836138.26
410150,201709,2675,1078,1597,1009486.75,1495615.5,2505102.25
410160,201709,503,321,182,300495.9,170534,471029.9
410165,201709,66,43,23,40291,21551,61842
410170,201709,165,124,41,113992.83,38417,152409.83
410180,201709,2102,1212,890,1131446.59,832592.08,1964038.67
410185,201709,44,40,4,37480,3748,41228
410190,201709,409,252,157,236124,147109,383233
410200,201709,967,725,242,677563.88,226472.9,904036.78
410210,201709,550,281,269,263297,251491,514788
410220,201709,39,21,18,19677,16866,36543
410230,201709,121,70,51,65590,47787,113377
410240,201709,719,478,241,447323.9,225817,673140.9
410250,201709,385,281,104,262703.6,97448,360151.6
410260,201709,299,169,130,158353,121810,280163
410270,201709,28,18,10,16866,9370,26236
410275,201709,72,55,17,51535,15929,67464
410280,201709,311,169,142,158098.14,133054,291152.14
410290,201709,221,145,76,135022.03,70769.91,205791.94
410300,201709,82,65,17,60905,15929,76834
410302,201709,25,17,8,15929,7496,23425
410304,201709,51,35,16,32795,14992,47787
410305,201709,195,105,90,97593,84330,181923
410310,201709,257,167,90,156479,84330,240809
410315,201709,58,42,16,39330,14992,54322
410320,201709,139,98,41,91826,38417,130243
410322,201709,34,23,11,21551,10307,31858
410330,201709,168,119,49,111503,45913,157416
410335,201709,95,59,36,55283,33732,89015
410337,201709,40,34,6,31858,5622,37480
410340,201709,32,31,1,29047,937,29984
410345,201709,210,133,77,124621,72149,196770
410347,201709,52,41,11,38417,10307,48724
410350,201709,231,141,90,132117,84330,216447
410360,201709,456,275,181,254941.2,169316,424257.2
410370,201709,2324,959,1365,895707.46,1275989.11,2171696.57
410380,201709,220,144,76,134928,71212,206140
410390,201709,367,276,91,258608,85267,343875
410395,201709,34,22,12,20614,10870,31484
410400,201709,836,421,415,393170.7,388326,781496.7
410405,201709,89,65,24,60905,22488,83393
410410,201709,43,33,10,30921,9370,40291
410420,201709,1629,804,825,751575.6,771464.3,1523039.9
410425,201709,176,86,90,80395,84330,164725
410430,201709,2183,1278,905,1195049.9,846841.96,2041891.86
410440,201709,396,284,112,265172,104944,370116
410442,201709,365,242,123,225818,115251,341069
410445,201709,421,290,131,271730,122747,394477
410450,201709,399,194,205,181778,192085,373863
410460,201709,402,215,187,201173.9,175219,376392.9
410465,201709,193,125,68,115625.8,63434.9,179060.7
410470,201709,217,136,81,127432,75897,203329
410480,201709,5609,2789,2820,2596208.16,2636856.78,5233064.94
410490,201709,1355,899,456,841193,425399,1266592
410500,201709,260,149,111,139613,104007,243620
410510,201709,176,128,48,119936,44342.3,164278.3
410520,201709,267,198,69,185526,64653,250179
410530,201709,231,85,146,79645,136798,216443
410540,201709,321,232,89,216813.8,83388.32,300202.12
410550,201709,1575,685,890,641563.9,833648.9,1475212.8
410560,201709,149,111,38,104007,35606,139613
410570,201709,433,304,129,282797.05,120873,403670.05
410580,201709,3179,1432,1747,1338700.16,1635253,2973953.16
410590,201709,397,284,113,266108,105881,371989
410600,201709,175,155,20,145235,18740,163975
410610,201709,52,42,10,39354,9370,48724
410620,201709,235,169,66,158353,61842,220195
410630,201709,451,266,185,249222,172206,421428
410640,201709,942,573,369,533749.73,344174.85,877924.58
410645,201709,98,73,25,68007,23425,91432
410650,201709,357,242,115,225817,107755,333572
410655,201709,77,59,18,55283,16866,72149
410657,201709,43,18,25,16866,23425,40291
410660,201709,574,411,163,383886,152731,536617
410670,201709,78,63,15,59031,14055,73086
410680,201709,192,156,36,146172,32795.4,178967.4
410685,201709,19,13,6,12181,5622,17803
410690,201709,28511,12364,16147,11568397.49,15118513.97,26686911.46
410700,201709,313,230,83,214948,77771,292719
410710,201709,132,107,25,100259,23425,123684
410712,201709,21,13,8,12181,7496,19677
410715,201709,84,65,19,60905,17803,78708
410720,201709,579,350,229,327950,214282.9,542232.9
410725,201709,176,127,49,118999,45913,164912
410730,201709,89,55,34,51535,31858,83393
410740,201709,112,83,29,77771,27173,104944
410750,201709,216,160,56,149916,52467.32,202383.32
410752,201709,22,14,8,13118,7496,20614
410753,201709,52,23,29,20890.41,27173,48063.41
410754,201709,35,21,14,19677,13118,32795
410755,201709,82,56,26,52190.9,24362,76552.9
410760,201709,696,398,298,372926,278758,651684
410765,201709,1628,781,847,725703.94,792761.34,1518465.28
410770,201709,111,94,17,88078,15929,104007
410773,201709,45,34,11,31858,10307,42165
410775,201709,174,129,45,120217.1,42165,162382.1
410780,201709,82,44,38,41228,35606,76834
410785,201709,73,56,17,52285,15929,68214
410790,201709,67,32,35,29984,32795,62779
410800,201709,294,185,109,172409,102133,274542
410810,201709,31,26,5,24362,4404,28766
410820,201709,178,131,47,122607,44039,166646
410830,201709,8499,3891,4608,3638110.3,4315603.64,7953713.94
410832,201709,107,76,31,70930.9,29047,99977.9
410840,201709,1377,767,610,716454.99,571168.67,1287623.66
410845,201709,62,38,24,35606,22488,58094
410850,201709,193,133,60,124300,56220,180520
410855,201709,44,38,6,35606,5622,41228
410860,201709,670,390,280,364658.75,262360,627018.75
410865,201709,110,84,26,78708,24362,103070
410870,201709,148,130,18,121810,16579,138389
410880,201709,1081,537,544,502666.65,509683,1012349.65
410890,201709,82,61,21,57157,19677,76834
410895,201709,75,55,20,51535,18740,70275
410900,201709,28,21,7,19677,6559,26236
410910,201709,21,18,3,16866,2811,19677
410920,201709,35,24,11,22488,10307,32795
410930,201709,503,323,180,302443.74,168660,471103.74
410940,201709,4308,2573,1735,2402492.16,1622434.7,4024926.86
410950,201709,123,88,35,82456,32795,115251
410960,201709,758,335,423,313614,395883,709497
410965,201709,63,49,14,45547.6,13118,58665.6
410970,201709,611,434,177,406202.1,165849,572051.1
410975,201709,106,70,36,65019,33732,98751
410980,201709,1529,695,834,648497.21,781168.22,1429665.43
410990,201709,263,178,85,166620.25,79363.9,245984.15
411000,201709,61,41,20,38417,18740,57157
411005,201709,22,16,6,14992,5622,20614
411007,201709,242,138,104,129306,97448,226754
411010,201709,569,403,166,377611,155542,533153
411020,201709,284,193,91,180841,85267,266108
411030,201709,27,16,11,14992,10307,25299
411040,201709,49,34,15,31858,14055,45913
411050,201709,217,172,45,160467.48,42038.12,202505.60
411060,201709,512,348,164,326067,153668,479735
411065,201709,60,53,7,49661,6559,56220
411070,201709,1173,793,380,738919,356060,1094979
411080,201709,238,168,70,157499,65590,223089
411090,201709,113,84,29,78708,27173,105881
411095,201709,258,106,152,98854,142414,241268
411100,201709,116,97,19,90889,17803,108692
411110,201709,123,84,39,78708,36543,115251
411120,201709,177,132,45,123684,42165,165849
411125,201709,174,77,97,71493.1,90889,162382.1
411130,201709,121,104,17,96822,15929,112751
411140,201709,172,119,53,111200.02,49145.65,160345.67
411150,201709,1169,776,393,727102.63,368241,1095343.63
411155,201709,118,81,37,75897,34669,110566
411160,201709,21,10,11,9370,10307,19677
411170,201709,61,54,7,50316.9,6559,56875.9
411180,201709,908,598,310,559108,290465.32,849573.32
411190,201709,318,177,141,165193.1,132117,297310.1
411200,201709,665,443,222,413842.09,207404.95,621247.04
411210,201709,665,355,310,331112.83,290470,621582.83
411220,201709,146,112,34,104944,31858,136802
411230,201709,49,44,5,41228,4685,45913
411240,201709,124,85,39,79645,36543,116188
411250,201709,416,302,114,282974,106818,389792
411260,201709,22,15,7,14055,6559,20614
411270,201709,288,158,130,148046,121810,269856
411275,201709,201,177,24,165146.8,22488,187634.8
411280,201709,230,164,66,152419.36,61842,214261.36
411290,201709,58,43,15,40291,14055,54346
411295,201709,141,111,30,104007,28110,132117
411300,201709,82,44,38,41228,35606,76834
411310,201709,94,71,23,66527,21551,88078
411320,201709,747,548,199,511837.7,184889.24,696726.94
411325,201709,46,29,17,27173,15929,43102
411330,201709,880,560,320,523268.36,298996.8,822265.16
411340,201709,30,21,9,19677,8124,27801
411342,201709,83,61,22,57157,20614,77771
411345,201709,120,60,60,56220,56220,112440
411350,201709,480,387,93,361354.82,86195.1,447549.92
411360,201709,55,35,20,32795,18740,51535
411370,201709,13873,5698,8175,5323666.94,7647485.07,12971152.01
411373,201709,194,143,51,133991,47787,181778
411375,201709,81,68,13,63716,12181,75897
411380,201709,97,72,25,67464,23425,90889
411390,201709,140,92,48,86204,44976,131180
411400,201709,347,256,91,239863,85267,325130
411410,201709,443,227,216,212043.1,202111,414154.1
411420,201709,1035,478,557,445637.2,521440.6,967077.8
411430,201709,401,260,141,242964.1,131827,374791.1
411435,201709,40,29,11,27173,10307,37480
411440,201709,471,378,93,352562.37,87141,439703.37
411450,201709,432,356,76,333572,71212,404784
411460,201709,714,284,430,265139.2,401608.96,666748.16
411470,201709,120,88,32,82456,29984,112440
411480,201709,618,350,268,326451.8,250834.9,577286.7
411490,201709,295,184,111,172408,104007,276415
411500,201709,110,93,17,87141,15555,102696
411510,201709,216,174,42,162303.39,39354,201657.39
411520,201709,5897,2307,3590,2158115.34,3356304.39,5514419.73
411530,201709,111,74,37,69338,34669,104007
411535,201709,47,19,28,17803,26236,44039
411540,201709,321,219,102,204383.6,95574,299957.6
411545,201709,76,53,23,49661,21551,71212
411550,201709,69,55,14,51535,13118,64653
411560,201709,374,170,204,158662.21,191148,349810.21
411570,201709,780,293,487,274260,456132,730392
411573,201709,39,24,15,22488,14055,36543
411575,201709,259,160,99,149920,92763,242683
411580,201709,1210,480,730,449104.1,682082,1131186.1
411585,201709,76,38,38,35606,35606,71212
411590,201709,26,18,8,16866,7496,24362
411600,201709,39,19,20,17803,18740,36543
411605,201709,233,107,126,100119,118062,218181
411610,201709,240,160,80,149920,74960,224880
411620,201709,350,198,152,185338.6,142424,327762.6
411630,201709,57,38,19,35606,17803,53409
411640,201709,42,34,8,31858,7496,39354
411650,201709,14,10,4,9370,3748,13118
411660,201709,41,35,6,32795,5622,38417
411670,201709,242,183,59,171471,55263,226734
411680,201709,156,134,22,125558,20614,146172
411690,201709,596,323,273,302055.08,255418.6,557473.68
411695,201709,64,50,14,46850,13118,59968
411700,201709,171,146,25,136802,23425,160227
411705,201709,103,66,37,61842,34669,96511
411710,201709,298,197,101,183622.86,94637,278259.86
411720,201709,132,85,47,79645,44039,123684
411721,201709,76,64,12,59968,11244,71212
411722,201709,97,41,56,38417,52472,90889
411725,201709,141,109,32,101852,29984,131836
411727,201709,85,69,16,64653,14710.9,79363.9
411729,201709,35,26,9,24362,8433,32795
411730,201709,548,356,192,332010.3,179904,511914.3
411740,201709,30,22,8,20614,7496,28110
411745,201709,70,47,23,43262,21551,64813
411750,201709,838,403,435,376535,406634.58,783169.58
411760,201709,1177,892,285,834577.14,267036,1101613.14
411770,201709,422,287,135,268919,126495,395414
411780,201709,366,238,128,223006,119936,342942
411790,201709,526,289,237,268654.17,221957.67,490611.84
411800,201709,169,133,36,124621,33732,158353
411810,201709,154,119,35,111503,32795,144298
411820,201709,2095,1027,1068,960031.56,1000313.86,1960345.42
411830,201709,10,10,0,9370,0,9370
411840,201709,1922,1181,741,1105921.6,693547.9,1799469.5
411845,201709,47,17,30,15929,28110,44039
411850,201709,1234,714,520,666572.74,485321.81,1151894.55
411860,201709,44,29,15,26892,14055,40947
411870,201709,34,27,7,25299,6559,31858
411880,201709,416,270,146,252736,136071.14,388807.14
411885,201709,105,68,37,63716,34669,98385
411890,201709,321,201,120,187916,112431,300347
411900,201709,71,52,19,48724,17803,66527
411910,201709,171,142,29,133044.63,26348.44,159393.07
411915,201709,2025,879,1146,822491.11,1072670.59,1895161.70
411920,201709,122,102,20,95574,18740,114314
411925,201709,18,12,6,11244,5622,16866
411930,201709,794,586,208,547210,194896,742106
411940,201709,581,414,167,387918,156454.56,544372.56
411950,201709,880,469,411,439443.63,384138.8,823582.43
411960,201709,943,673,270,628270,252990,881260
411965,201709,27,19,8,17803,7496,25299
411970,201709,69,62,7,58094,6559,64653
411980,201709,195,129,66,120873,61842,182715
411990,201709,4772,2812,1960,2618550.08,1834778.4,4453328.48
411995,201709,452,170,282,159290,264234,423524
412000,201709,277,160,117,149218.56,109629,258847.56
412010,201709,44,26,18,24362,16866,41228
412015,201709,44,33,11,30921,10307,41228
412020,201709,28,25,3,23143.9,2811,25954.9
412030,201709,63,53,10,49661,9370,59031
412033,201709,57,37,20,34645,18740,53385
412035,201709,86,54,32,50598,29984,80582
412040,201709,35,25,10,23144,9370,32514
412050,201709,202,150,52,140550,48724,189274
412060,201709,748,589,159,549082.88,148014.9,697097.78
412065,201709,45,31,14,29047,13118,42165
412070,201709,152,104,48,96792.1,44976,141768.1
412080,201709,267,136,131,127432,122747,250179
412085,201709,31,14,17,13118,15929,29047
412090,201709,723,449,274,418793.1,256738,675531.1
412100,201709,245,203,42,189275,39166.6,228441.6
412110,201709,73,60,13,56220,12181,68401
412120,201709,313,205,108,191522.8,101196,292718.8
412125,201709,78,46,32,42820.9,29984,72804.9
412130,201709,53,37,16,34669,14992,49661
412135,201709,26,14,12,13118,11244,24362
412140,201709,296,216,80,201764.21,74960,276724.21
412150,201709,254,171,83,159290.62,77771,237061.62
412160,201709,96,60,36,56220,33732,89952
412170,201709,624,449,175,420713,163975,584688
412175,201709,50,36,14,33732,13118,46850
412180,201709,197,158,39,147457.29,36543,184000.29
412190,201709,331,268,63,250455.41,59031,309486.41
412200,201709,189,124,65,116188,60905,177093
412210,201709,95,75,20,70275,18740,89015
412215,201709,237,162,75,151794,70275,222069
412217,201709,88,69,19,64653,17803,82456
412220,201709,809,609,200,570633,187400,758033
412230,201709,331,207,124,191764.67,115828.75,307593.42
412240,201709,1301,631,670,587346.23,625687.14,1213033.37
412250,201709,383,247,136,231439,127151,358590
412260,201709,126,92,34,86204,31858,118062
412265,201709,161,129,32,120873,29984,150857
412270,201709,87,53,34,49661,31858,81519
412280,201709,86,67,19,62779,17803,80582
412290,201709,96,64,32,59968,29984,89952
412300,201709,221,144,77,134928,72149,207077
412310,201709,43,36,7,33732,6559,40291
412320,201709,95,80,15,74960,14055,89015
412330,201709,168,149,19,139613,17803,157416
412340,201709,142,96,46,89952,42821,132773
412350,201709,582,284,298,265124.15,279226,544350.15
412360,201709,28,25,3,23425,2811,26236
412370,201709,167,140,27,130243,25299,155542
412380,201709,256,189,67,176811.9,62254.65,239066.55
412382,201709,53,28,25,26236,23425,49661
412385,201709,134,96,38,89952,35606,125558
412390,201709,270,200,70,187400,65590,252990
412395,201709,63,50,13,46850,12181,59031
412400,201709,68,48,20,44976,18740,63716
412402,201709,233,109,124,102128.32,115906.9,218035.22
412405,201709,796,316,480,294661.01,449095.24,743756.25
412410,201709,930,579,351,541024,328887,869911
412420,201709,17,13,4,12181,3748,15929
412430,201709,20,15,5,14055,4685,18740
412440,201709,585,314,271,291261.87,251971.96,543233.83
412450,201709,83,68,15,63716,14055,77771
412460,201709,80,63,17,59031,15929,74960
412470,201709,257,205,52,192085,48724,240809
412480,201709,175,133,42,123402.95,39354,162756.95
412490,201709,164,139,25,130243,23425,153668
412500,201709,477,386,91,360419,85267,445686
412510,201709,188,153,35,142799,32795,175594
412520,201709,128,71,57,66527,53409,119936
412530,201709,107,58,49,54346,45631.9,99977.9
412535,201709,107,82,25,76816,23425,100241
412540,201709,68,30,38,28110,35606,63716
412545,201709,98,71,27,66527,25299,91826
412550,201709,3447,1571,1876,1468647.57,1756594.45,3225242.02
412555,201709,17,12,5,11244,4685,15929
412560,201709,576,431,145,402536.1,135865,538401.1
412570,201709,731,411,320,384507.32,299559,684066.32
412575,201709,90,62,28,58094,26236,84330
412580,201709,155,107,48,100259,44976,145235
412590,201709,34,31,3,29047,2811,31858
412600,201709,175,135,40,126495,37480,163975
412610,201709,34,22,12,20614,10439,31053
412620,201709,146,128,18,119936,16866,136802
412625,201709,2160,1160,1000,1084589.76,935155.72,2019745.48
412627,201709,67,55,12,51535,11244,62779
412630,201709,431,287,144,268728,134647,403375
412635,201709,64,20,44,18740,41228,59968
412640,201709,115,77,38,72149,35606,107755
412650,201709,333,213,120,199581,112435.32,312016.32
412660,201709,487,292,195,272902,182715,455617
412665,201709,51,45,6,42165,5622,47787
412667,201709,316,208,108,194291.6,100880.92,295172.52
412670,201709,64,54,10,50598,9370,59968
412680,201709,283,227,56,212699,52472,265171
412690,201709,113,74,39,69338,36262,105600
412700,201709,168,116,52,108692,48443,157135
412710,201709,1400,871,529,810506.8,492956.87,1303463.67
412720,201709,223,150,73,140550,68401,208951
412730,201709,202,158,44,148046,40291,188337
412740,201709,407,221,186,206936.45,174282,381218.45
412750,201709,461,265,196,247368,183652,431020
412760,201709,241,125,116,117125,108692,225817
412770,201709,2021,1159,862,1081677.86,807395,1889072.86
412780,201709,149,117,32,109496.88,29984,139480.88
412785,201709,263,134,129,125089.5,120873,245962.5
412788,201709,36,21,15,19677,14055,33732
412790,201709,139,114,25,106162.1,23425,129587.1
412795,201709,157,117,40,109629,37480,147109
412796,201709,297,205,92,190941.83,86072.82,277014.65
412800,201709,554,363,191,339581.36,178958,518539.36
412810,201709,2942,1632,1310,1524948.79,1225966.12,2750914.91
412820,201709,932,612,320,560657.79,296321.1,856978.89
412830,201709,18,14,4,13118,3748,16866
412840,201709,211,154,57,143361.1,53409,196770.1
412850,201709,773,529,244,493799,228628,722427
412853,201709,175,95,80,89015,74960,163975
412855,201709,219,119,100,110410.21,93700,204110.21
412860,201709,90,69,21,64653,19677,84330
412862,201709,64,48,16,44694.9,14992,59686.9
412863,201709,7,6,1,5622,937,6559
412865,201709,44,34,10,31858,9370,41228
412870,201709,110,71,39,66527,36543,103070
412880,201709,127,99,28,92763,26236,118999
420005,201709,36,33,3,30921,2249,33170
420010,201709,363,241,122,224389.67,114314,338703.67
420020,201709,74,63,11,59031,10307,69338
420030,201709,28,25,3,23425,2811,26236
420040,201709,108,82,26,76834,24362,101196
420050,201709,56,33,23,30559.9,21390.34,51950.24
420055,201709,19,18,1,16866,937,17803
420060,201709,35,27,8,25299,7496,32795
420070,201709,97,84,13,78708,12171.63,90879.63
420075,201709,12,10,2,9370,1874,11244
420080,201709,46,41,5,37526.85,4685,42211.85
420090,201709,36,34,2,31094.34,1874,32968.34
420100,201709,154,130,24,120873.1,22488,143361.1
420110,201709,17,17,0,15929,0,15929
420120,201709,44,32,12,29984,11244,41228
420125,201709,85,68,17,63716,15929,79645
420127,201709,32,29,3,27173,2811,29984
420130,201709,365,234,131,218967.63,122339.46,341307.09
420140,201709,1229,721,508,674509.89,475932,1150441.89
420150,201709,47,40,7,37480,6559,44039
420160,201709,42,39,3,36543,2811,39354
420165,201709,17,13,4,12181,3748,15929
420170,201709,63,42,21,39354,19677,59031
420180,201709,23,22,1,20614,937,21551
420190,201709,31,28,3,26236,2811,29047
420195,201709,125,59,66,55283,61561,116844
420200,201709,1259,559,700,518165.1,655536.89,1173701.99
420205,201709,65,31,34,29047,31858,60905
420207,201709,100,57,43,53409,40281.63,93690.63
420208,201709,23,18,5,16866,3841.7,20707.7
420209,201709,19,15,4,14055,3748,17803
420210,201709,459,215,244,201173.9,228534.67,429708.57
420213,201709,49,38,11,35606,10307,45913
420215,201709,24,20,4,18740,3748,22488
420220,201709,69,46,23,43102,21551,64653
420230,201709,716,410,306,383421,286634.63,670055.63
420240,201709,2232,1518,714,1413343.56,668586.98,2081930.54
420243,201709,34,27,7,25299,6559,31858
420245,201709,87,51,36,47787,33732,81519
420250,201709,53,31,22,29047,20614,49661
420253,201709,40,34,6,31858,5622,37480
420257,201709,10,8,2,7496,1874,9370
420260,201709,92,82,10,76834,9370,86204
420270,201709,39,30,9,28106,8433,36539
420280,201709,274,200,74,186391.08,68102.82,254493.90
420285,201709,20,12,8,11244,7496,18740
420287,201709,48,29,19,27173,17803,44976
420290,201709,965,680,285,636196.5,266978.2,903174.7
420300,201709,1356,1061,295,990224.2,275478.77,1265702.97
420310,201709,58,45,13,42165,12181,54346
420315,201709,37,33,4,30921,3748,34669
420320,201709,838,426,412,398201.58,386040,784241.58
420325,201709,0,0,0,0,0,0
420330,201709,122,84,38,78708,35493.56,114201.56
420340,201709,160,108,52,100251,48695.89,148946.89
420350,201709,240,175,65,162664.1,60905,223569.1
420360,201709,736,560,176,523063.23,163329.09,686392.32
420370,201709,102,68,34,63529,31577,95106
420380,201709,1111,788,323,733382.66,301538.29,1034920.95
420390,201709,249,157,92,145873.06,85501.25,231374.31
420395,201709,177,128,49,119936,45903.63,165839.63
420400,201709,248,183,65,170909,60905,231814
420410,201709,61,47,14,44039,13118,57157
420415,201709,32,29,3,27173,2811,29984
420417,201709,48,36,12,33732,11234.63,44966.63
420419,201709,12,11,1,10307,937,11244
420420,201709,2750,1683,1067,1565272.02,996688.88,2561960.90
420425,201709,68,58,10,54337,9061.16,63398.16
420430,201709,1273,884,389,825370.16,362778.29,1188148.45
420435,201709,15,13,2,12181,1874,14055
420440,201709,107,73,34,67761.96,31685.6,99447.56
420445,201709,23,21,2,19677,1874,21551
420450,201709,75,36,39,33703,36543,70246
420455,201709,240,187,53,175191.26,49597.63,224788.89
420460,201709,2289,1534,755,1432475.08,706941.72,2139416.80
420470,201709,123,89,34,83393,31858,115251
420475,201709,6,6,0,5622,0,5622
420480,201709,836,621,215,576238.16,200518.1,776756.26
420490,201709,112,87,25,81519,23425,104944
420500,201709,739,280,459,260706.1,430083,690789.1
420510,201709,20,17,3,15929,2811,18740
420515,201709,24,19,5,17803,4685,22488
420517,201709,9,9,0,8433,0,8433
420519,201709,0,0,0,0,0,0
420520,201709,68,51,17,47787,15929,63716
420530,201709,155,106,49,98385.95,45913,144298.95
420535,201709,20,18,2,16866,1874,18740
420540,201709,4463,2653,1810,2475968.8,1691444.69,4167413.49
420543,201709,21,21,0,19677,0,19677
420545,201709,186,133,53,124621,49642.26,174263.26
420550,201709,827,658,169,615001.26,158196.75,773198.01
420555,201709,42,31,11,29047,10307,39354
420560,201709,62,49,13,45538.2,12181,57719.2
420570,201709,131,75,56,69712.8,52462.63,122175.43
420580,201709,291,126,165,118062,154324,272386
420590,201709,496,353,143,330479.9,133991,464470.9
420600,201709,93,45,48,42165,44976,87141
420610,201709,35,33,2,30640,1874,32514
420620,201709,73,60,13,56220,12181,68401
420630,201709,150,106,44,99313.32,41224,140537.32
420640,201709,96,86,10,80582,9370,89952
420650,201709,240,128,112,119239.99,104336.26,223576.25
420660,201709,57,42,15,38604.9,14055,52659.9
420665,201709,39,30,9,28110,8433,36543
420670,201709,308,234,74,219248.63,69038.53,288287.16
420675,201709,15,15,0,14055,0,14055
420680,201709,33,24,9,22488,8433,30921
420690,201709,174,147,27,137739,25299,163038
420700,201709,599,420,179,393466.15,167501.45,560967.60
420710,201709,145,83,62,77771,58094,135865
420720,201709,100,82,18,76834,16866,93700
420730,201709,491,314,177,294135.15,164567.49,458702.64
420740,201709,45,44,1,41228,937,42165
420750,201709,487,321,166,300495.9,155542,456037.9
420757,201709,17,14,3,12321.55,2811,15132.55
420760,201709,37,29,8,27173,7496,34669
420765,201709,67,56,11,52472,10307,62779
420768,201709,65,58,7,54346,6559,60905
420770,201709,81,68,13,63716,12181,75897
420775,201709,47,43,4,39354,3748,43102
420780,201709,229,180,49,168660,45913,214573
420785,201709,13,9,4,8433,3748,12181
420790,201709,175,146,29,136466.9,26208.63,162675.53
420800,201709,74,55,19,50785.4,17803,68588.4
420810,201709,244,210,34,196761,31061.55,227822.55
420820,201709,2320,1381,939,1287383.57,878334.93,2165718.50
420830,201709,526,304,222,283403.09,207067.63,490470.72
420840,201709,136,104,32,97448,29984,127432
420845,201709,445,200,245,186740.93,228347,415087.93
420850,201709,227,183,44,171471,41228,212699
420860,201709,60,51,9,47787,8433,56220
420870,201709,116,85,31,79645,29047,108692
420880,201709,167,116,51,108026.73,47787,155813.73
420890,201709,849,421,428,391403.64,401027,792430.64
420895,201709,10,10,0,9370,0,9370
420900,201709,397,309,88,287791.22,82428.63,370219.85
420910,201709,5713,3162,2551,2957197.6,2387544.25,5344741.85
420915,201709,80,74,6,69338,5622,74960
420917,201709,18,13,5,12181,4685,16866
420920,201709,22,15,7,14055,6559,20614
420930,201709,2563,1553,1010,1447607.24,939399.14,2387006.38
420940,201709,587,431,156,403556.9,144548.24,548105.14
420945,201709,8,6,2,5622,1874,7496
420950,201709,56,51,5,47787,4685,52472
420960,201709,114,89,25,83356.26,23416,106772.26
420970,201709,298,240,58,223233.45,54318.63,277552.08
420980,201709,26,25,1,23425,937,24362
420985,201709,58,52,6,48724,5622,54346
420990,201709,64,48,16,44976,14992,59968
421000,201709,33,22,11,20614,10307,30921
421003,201709,67,42,25,39354,23416,62770
421005,201709,9,6,3,5622,2811,8433
421010,201709,763,541,222,506526.78,205960.39,712487.17
421020,201709,27,24,3,22468,2811,25279
421030,201709,126,104,22,97121,20614,117735
421040,201709,60,51,9,47787,8433,56220
421050,201709,296,211,85,195646.1,79645,275291.1
421055,201709,26,22,4,20614,3748,24362
421060,201709,85,59,26,55283,24362,79645
421070,201709,50,46,4,43102,3748,46850
421080,201709,33,31,2,29047,1874,30921
421085,201709,24,19,5,17803,4685,22488
421090,201709,43,33,10,30921,9370,40291
421100,201709,118,88,30,82456,28110,110566
421105,201709,207,167,40,156339,37456.95,193795.95
421110,201709,109,91,18,84657.95,16866,101523.95
421120,201709,150,117,33,109142.13,30902.26,140044.39
421125,201709,15,11,4,10307,3748,14055
421130,201709,792,510,282,476739.91,263212.87,739952.78
421140,201709,30,22,8,19911.25,7496,27407.25
421145,201709,39,32,7,29984,6559,36543
421150,201709,108,77,31,72149,29047,101196
421160,201709,59,40,19,37470.63,17803,55273.63
421165,201709,18,17,1,15929,937,16866
421170,201709,185,161,24,150128.52,22479,172607.52
421175,201709,151,99,52,92763,48687.26,141450.26
421180,201709,58,35,23,32439,21551,53990
421185,201709,16,13,3,12181,2811,14992
421187,201709,0,0,0,0,0,0
421189,201709,38,30,8,28110,7486.63,35596.63
421190,201709,1402,868,534,812567,499673.99,1312240.99
421200,201709,89,68,21,62780,19677,82457
421205,201709,24,16,8,14992,7486.63,22478.63
421210,201709,176,118,58,110566,54346,164912
421220,201709,265,211,54,196856.95,50598,247454.95
421223,201709,56,46,10,43102,9370,52472
421225,201709,59,41,18,38417,16866,55283
421227,201709,91,68,23,63716,21551,85267
421230,201709,48,35,13,32795,12181,44976
421240,201709,19,19,0,17803,0,17803
421250,201709,354,214,140,200425,130402.29,330827.29
421260,201709,29,23,6,21551,5622,27173
421265,201709,0,0,0,0,0,0
421270,201709,52,47,5,44039,4685,48724
421280,201709,335,197,138,184589,127619.4,312208.4
421290,201709,307,207,100,193725,92313.56,286038.56
421300,201709,27,22,5,20614,4685,25299
421310,201709,54,41,13,37761.1,12181,49942.1
421315,201709,28,20,8,18740,7496,26236
421320,201709,125,91,34,85267,31858,117125
421330,201709,111,84,27,76627.86,25290,101917.86
421335,201709,41,27,14,25299,13118,38417
421340,201709,285,192,93,177889.5,87141,265030.5
421350,201709,163,96,67,89517,62779,152296
421360,201709,681,502,179,463895.71,167497.52,631393.23
421370,201709,184,140,44,131180,40900.05,172080.05
421380,201709,124,102,22,95569.32,20614,116183.32
421390,201709,19,15,4,14055,3748,17803
421400,201709,113,96,17,89952,15929,105881
421410,201709,23,18,5,16866,4685,21551
421415,201709,19,16,3,14992,2811,17803
421420,201709,150,125,25,116562.8,23425,139987.8
421430,201709,14,11,3,10307,2811,13118
421440,201709,60,46,14,43102,13118,56220
421450,201709,98,85,13,79645,12181,91826
421460,201709,58,50,8,46060.1,7496,53556.1
421470,201709,70,46,24,43102,22488,65590
421480,201709,629,470,159,439921.5,148974,588895.5
421490,201709,24,22,2,19950,1874,21824
421500,201709,515,333,182,309628.77,169695.69,479324.46
421505,201709,24,17,7,15929,6559,22488
421507,201709,32,26,6,24362,5622,29984
421510,201709,72,48,24,44664,22113.2,66777.2
421520,201709,68,58,10,53597,9370,62967
421530,201709,54,48,6,44320.1,5622,49942.1
421535,201709,31,30,1,27848,937,28785
421540,201709,57,51,6,47787,5622,53409
421545,201709,95,72,23,66987,21551,88538
421550,201709,276,199,77,185808,72149,257957
421555,201709,23,19,4,17803,3655,21458
421560,201709,8,8,0,7496,0,7496
421565,201709,122,91,31,85267,29047,114314
421567,201709,29,23,6,21551,5622,27173
421568,201709,32,30,2,28110,1874,29984
421569,201709,9,8,1,7496,937,8433
421570,201709,136,92,44,86204,41228,127432
421575,201709,27,22,5,20356.33,4685,25041.33
421580,201709,711,424,287,397288,267982.27,665270.27
421590,201709,21,20,1,18740,937,19677
421600,201709,109,73,36,68381,32515,100896
421605,201709,99,70,29,65263,27173,92436
421610,201709,188,145,43,135584,40291,175875
421620,201709,1111,670,441,625335.76,413178.52,1038514.28
421625,201709,21,18,3,16866,2811,19677
421630,201709,267,169,98,158307,90983,249290
421635,201709,17,8,9,7496,8433,15929
421640,201709,97,85,12,79645,11244,90889
421650,201709,266,155,111,145216.26,103988.26,249204.52
421660,201709,2048,1223,825,1143768.86,771779.16,1915548.02
421670,201709,169,126,43,118062,40291,158353
421680,201709,165,149,16,139613,14983,154596
421690,201709,345,243,102,227101.8,94627.99,321729.79
421700,201709,53,34,19,31858,16960,48818
421710,201709,24,24,0,22488,0,22488
421715,201709,9,8,1,7496,937,8433
421720,201709,562,402,160,374836.3,148224.54,523060.84
421725,201709,12,6,6,5622,5622,11244
421730,201709,42,29,13,26455.48,12181,38636.48
421740,201709,84,40,44,37480,41228,78708
421750,201709,216,158,58,145703.6,54346,200049.6
421755,201709,25,24,1,22488,937,23425
421760,201709,103,73,30,68391.63,28110,96501.63
421770,201709,545,373,172,347603.89,161090.15,508694.04
421775,201709,24,15,9,14055,8433,22488
421780,201709,184,145,39,135583.9,36543,172126.9
421790,201709,156,129,27,120357.65,25299,145656.65
421795,201709,14,12,2,11244,1874,13118
421800,201709,442,283,159,263451.61,148978.32,412429.93
421810,201709,71,57,14,53409,13118,66527
421820,201709,302,207,95,192994.1,89015,282009.1
421825,201709,125,103,22,96511,20614,117125
421830,201709,133,101,32,94637,29984,124621
421835,201709,3,3,0,2811,0,2811
421840,201709,59,50,9,46841,8433,55274
421850,201709,81,72,9,67464,8429,75893
421860,201709,41,31,10,28765.9,9370,38135.9
421870,201709,976,737,239,681599.9,223077.59,904677.49
421875,201709,50,44,6,41228,5622,46850
421880,201709,163,117,46,109629,42821,152450
421885,201709,28,23,5,21551,4404,25955
421890,201709,112,77,35,72149,32795,104944
421895,201709,41,38,3,35606,2811,38417
421900,201709,152,122,30,114240.15,28065,142305.15
421910,201709,64,42,22,39354,20614,59968
421915,201709,31,25,6,23425,5622,29047
421917,201709,38,27,11,25018,10307,35325
421920,201709,33,30,3,28110,2811,30921
421930,201709,755,583,172,544575.03,161127.63,705702.66
421935,201709,57,50,7,46850,6559,53409
421940,201709,41,38,3,35606,2811,38417
421950,201709,821,536,285,496300.33,264457,760757.33
421960,201709,40,35,5,32514,4685,37199
421970,201709,375,236,139,220642.12,130192.01,350834.13
421985,201709,29,20,9,18740,8433,27173
422000,201709,0,0,0,0,0,0
430003,201709,210,48,162,44273.25,151794,196067.25
430005,201709,35,27,8,25299,7496,32795
430010,201709,277,194,83,181309.5,77771,259080.5
430020,201709,153,99,54,92482,49661,142143
430030,201709,126,98,28,91826,26236,118062
430040,201709,2987,1730,1257,1613271.93,1176217.68,2789489.61
430045,201709,68,58,10,54065,9370,63435
430047,201709,7,6,1,5622,937,6559
430050,201709,81,67,14,62779,13118,75897
430055,201709,17,14,3,13118,2811,15929
430057,201709,4,2,2,1874,1874,3748
430060,201709,3719,2200,1519,2053630.21,1419467.79,3473098.00
430063,201709,55,49,6,45913,5622,51535
430064,201709,146,123,23,115251,21551,136802
430066,201709,10,7,3,6559,2811,9370
430070,201709,49,37,12,34669,11244,45913
430080,201709,69,49,20,45225.8,18740,63965.8
430085,201709,35,10,25,9370,23425,32795
430087,201709,40,29,11,27033,10307,37340
430090,201709,71,63,8,58749.9,7496,66245.9
430100,201709,116,78,38,71867.99,35606,107473.99
430105,201709,142,72,70,67464,65290.16,132754.16
430107,201709,20,14,6,13118,5622,18740
430110,201709,408,237,171,221272.55,160161.41,381433.96
430120,201709,141,128,13,118999.95,12181,131180.95
430130,201709,782,492,290,460394.95,271448.9,731843.85
430140,201709,127,116,11,108692,10307,118999
430150,201709,109,72,37,66715,33732,100447
430155,201709,32,29,3,27173,2811,29984
430160,201709,3802,2247,1555,2086326.5,1453034.11,3539360.61
430163,201709,324,140,184,130056.57,172351.78,302408.35
430165,201709,22,16,6,14992,5622,20614
430170,201709,78,72,6,67464,5622,73086
430175,201709,82,63,19,59031,17147.1,76178.1
430180,201709,91,72,19,67464,17193.95,84657.95
430185,201709,32,24,8,22488,7496,29984
430187,201709,106,44,62,41228,57794.9,99022.9
430190,201709,222,129,93,120826.15,86475.73,207301.88
430192,201709,14,14,0,13118,0,13118
430195,201709,13,8,5,7496,4685,12181
430200,201709,161,141,20,131461.1,18740,150201.1
430205,201709,19,18,1,16866,937,17803
430210,201709,608,470,138,436454.7,128041.15,564495.85
430215,201709,17,14,3,13118,2811,15929
430220,201709,61,43,18,40291,16866,57157
430222,201709,14,7,7,6559,6559,13118
430223,201709,14,8,6,7496,5622,13118
430225,201709,4,3,1,2811,937,3748
430230,201709,293,183,110,170534,103070,273604
430235,201709,46,33,13,30921,12171.63,43092.63
430237,201709,27,21,6,19677,5622,25299
430240,201709,130,79,51,74023,47777.63,121800.63
430245,201709,70,58,12,54346,11244,65590
430250,201709,195,113,82,105871.63,76824.63,182696.26
430258,201709,14,12,2,11244,1874,13118
430260,201709,39,34,5,31858,3879.18,35737.18
430265,201709,36,29,7,27154.26,6559,33713.26
430270,201709,578,427,151,397709.47,139707.81,537417.28
430280,201709,1026,640,386,596016.93,359227.8,955244.73
430290,201709,375,219,156,203329.4,146172,349501.4
430300,201709,2084,1140,944,1062494.86,881531.67,1944026.53
430310,201709,1984,1038,946,965123.4,884261.62,1849385.02
430320,201709,49,41,8,38402.95,7496,45898.95
430330,201709,99,90,9,83861.5,8433,92294.5
430340,201709,66,58,8,54346,7496,61842
430350,201709,1653,1150,503,1066279.49,469587.66,1535867.15
430355,201709,27,24,3,22488,2811,25299
430360,201709,81,39,42,36543,38417.1,74960.1
430367,201709,30,20,10,18740,8592.29,27332.29
430370,201709,56,50,6,46850,5622,52472
430380,201709,128,95,33,88452.8,30921,119373.8
430390,201709,602,376,226,352030.9,211462.63,563493.53
430400,201709,133,102,31,93887.4,29028.26,122915.66
430410,201709,56,45,11,42165,10307,52472
430420,201709,482,319,163,296186.8,150511.58,446698.38
430430,201709,54,52,2,48099.95,1874,49973.95
430435,201709,151,112,39,104007,35840.25,139847.25
430440,201709,507,337,170,315769,159102.6,474871.6
430450,201709,1172,966,206,897566.43,193012.63,1090579.06
430460,201709,5113,2792,2321,2599098.53,2168046.08,4767144.61
430461,201709,17,15,2,14055,1874,15929
430462,201709,12,7,5,6559,4685,11244
430463,201709,1003,527,476,491129.39,445666.05,936795.44
430465,201709,29,17,12,15929,11244,27173
430466,201709,645,461,184,430083.1,172220.6,602303.7
430467,201709,98,57,41,53409,38407.63,91816.63
430468,201709,112,68,44,63716,40981.39,104697.39
430469,201709,23,17,6,15929,5622,21551
430470,201709,1164,647,517,598372.37,482508.15,1080880.52
430471,201709,49,36,13,33713.26,12181,45894.26
430480,201709,94,59,35,54439.7,32785.63,87225.33
430485,201709,5,5,0,4404,0,4404
430490,201709,94,75,19,69198.35,17803,87001.35
430495,201709,34,27,7,25299,6559,31858
430500,201709,198,135,63,125792.25,58661.63,184453.88
430510,201709,3008,1998,1010,1866533.25,945498.96,2812032.21
430511,201709,18,18,0,16866,0,16866
430512,201709,135,90,45,84330,42165,126495
430513,201709,53,47,6,43570.5,5622,49192.5
430515,201709,31,29,2,27173,1874,29047
430517,201709,169,149,20,138676.25,18721.26,157397.51
430520,201709,360,246,114,229847,106789.89,336636.89
430530,201709,89,51,38,47787,35606,83393
430535,201709,470,307,163,287462.92,152707.58,440170.50
430537,201709,13,13,0,12181,0,12181
430540,201709,74,47,27,44039,25299,69338
430543,201709,366,112,254,104944,237838,342782
430544,201709,44,40,4,37480,3748,41228
430545,201709,338,153,185,143296.15,172857.76,316153.91
430550,201709,44,36,8,33732,7496,41228
430558,201709,6,4,2,3748,1874,5622
430560,201709,46,19,27,17803,25299,43102
430570,201709,104,46,58,43102,54289.78,97391.78
430580,201709,122,96,26,89952,24315.15,114267.15
430583,201709,14,14,0,13118,0,13118
430585,201709,9,4,5,3748,4685,8433
430587,201709,14,8,6,7496,5622,13118
430590,201709,152,128,24,118717.9,22488,141205.9
430593,201709,4,4,0,3748,0,3748
430595,201709,13,8,5,7496,4685,12181
430597,201709,52,28,24,26236,22488,48724
430600,201709,215,145,70,135855.63,65308.9,201164.53
430605,201709,152,94,58,88078,54336.63,142414.63
430607,201709,26,21,5,19677,4685,24362
430610,201709,1618,754,864,702094.95,804377.49,1506472.44
430613,201709,3,3,0,2811,0,2811
430620,201709,114,81,33,75757,30911.63,106668.63
430630,201709,48,43,5,40291,4685,44976
430632,201709,33,28,5,26236,4685,30921
430635,201709,38,34,4,31858,3748,35606
430637,201709,57,32,25,29984,23425,53409
430640,201709,215,119,96,110659.7,89952,200611.7
430642,201709,27,25,2,23425,1874,25299
430645,201709,31,27,4,25299,3748,29047
430650,201709,252,200,52,187119,48677.15,235796.15
430655,201709,6,6,0,5622,0,5622
430660,201709,957,462,495,431347.95,462315.9,893663.85
430670,201709,71,51,20,47787,18740,66527
430673,201709,74,42,32,39354,29984,69338
430675,201709,13,10,3,9370,2811,12181
430676,201709,465,277,188,258855.62,176085.84,434941.46
430680,201709,245,169,76,156198,71212,227410
430690,201709,522,313,209,292390.85,194187.27,486578.12
430692,201709,7,5,2,4685,1874,6559
430693,201709,135,89,46,83393,42483.58,125876.58
430695,201709,74,67,7,61860.74,6559,68419.74
430697,201709,63,37,26,34669,24362,59031
430700,201709,1572,1099,473,1019147.58,443201,1462348.58
430705,201709,19,18,1,16866,937,17803
430710,201709,259,166,93,155542,87141,242683
430720,201709,111,94,17,87890.6,15929,103819.6
430730,201709,118,101,17,93700,15929,109629
430740,201709,60,41,19,38417,17803,56220
430745,201709,38,30,8,27829,7496,35325
430750,201709,335,230,105,214526.08,97448,311974.08
430755,201709,79,44,35,41228,32795,74023
430760,201709,359,218,141,201034.11,132089.26,333123.37
430770,201709,1471,759,712,709103.7,662785.3,1371889.0
430780,201709,317,202,115,188965.16,107689.78,296654.94
430781,201709,28,24,4,22488,3748,26236
430783,201709,47,38,9,35293.8,8433,43726.8
430786,201709,6,3,3,2811,2811,5622
430790,201709,469,306,163,284941.7,152440.63,437382.33
430800,201709,152,127,25,118999,23425,142424
430805,201709,41,36,5,33732,4685,38417
430807,201709,34,22,12,20614,11244,31858
430810,201709,70,44,26,41228,24362,65590
430820,201709,132,79,53,74023,49005.1,123028.1
430825,201709,11,9,2,8433,1874,10307
430830,201709,232,217,15,203048,14055,217103
430840,201709,123,81,42,75897,38698.1,114595.1
430843,201709,5,3,2,2811,1874,4685
430845,201709,69,39,30,36543,28110,64653
430850,201709,570,394,176,367965.16,164773.67,532738.83
430860,201709,155,100,55,93044.1,50869.73,143913.83
430865,201709,63,31,32,28391.1,29674.79,58065.89
430870,201709,78,63,15,59031,14055,73086
430880,201709,157,119,38,111503,35606,147109
430885,201709,7,6,1,5622,937,6559
430890,201709,337,206,131,191391.94,122747,314138.94
430900,201709,545,373,172,345378.7,160686.13,506064.83
430905,201709,81,33,48,30921,44976,75897
430910,201709,270,151,119,141487,109902,251389
430912,201709,3,3,0,2811,0,2811
430915,201709,32,24,8,22488,7214.9,29702.9
430920,201709,4094,2284,1810,2134776.1,1693912.31,3828688.41
430925,201709,6,5,1,4441.38,937,5378.38
430930,201709,2066,1234,832,1147715.25,778359.81,1926075.06
430940,201709,237,149,88,138947.73,82437.26,221384.99
430950,201709,162,130,32,121810,29702.9,151512.9
430955,201709,21,13,8,12181,7496,19677
430957,201709,17,16,1,14992,937,15929
430960,201709,244,159,85,147249.55,79645,226894.55
430965,201709,100,61,39,57157,36543,93700
430970,201709,79,67,12,62779,10307,73086
430975,201709,35,33,2,30921,1874,32795
430980,201709,44,27,17,25299,15929,41228
430990,201709,110,83,27,77771,25299,103070
430995,201709,115,111,4,102788.9,3748,106536.9
431000,201709,296,138,158,127193.1,148046,275239.1
431010,201709,341,205,136,191119.89,127432,318551.89
431020,201709,1916,1102,814,1026037.99,759616.53,1785654.52
431030,201709,42,34,8,31858,7496,39354
431033,201709,378,188,190,175359.6,178030,353389.6
431036,201709,15,10,5,9370,4685,14055
431040,201709,138,83,55,76834,51427.25,128261.25
431041,201709,37,24,13,22488,12181,34669
431043,201709,44,25,19,23425,17803,41228
431046,201709,12,7,5,6559,4685,11244
431050,201709,209,132,77,121321.17,70682.51,192003.68
431053,201709,72,44,28,40478.4,26236,66714.4
431055,201709,63,41,22,38417,20595.26,59012.26
431057,201709,18,18,0,16866,0,16866
431060,201709,1686,1059,627,985182.19,585762.65,1570944.84
431065,201709,16,10,6,9370,5622,14992
431070,201709,71,65,6,60905,5622,66527
431075,201709,8,8,0,7496,0,7496
431080,201709,136,88,48,82174.9,44976,127150.9
431085,201709,29,26,3,24362,2811,27173
431087,201709,15,13,2,12181,1874,14055
431090,201709,56,44,12,41228,11244,52472
431100,201709,1224,733,491,678389.16,460067,1138456.16
431110,201709,244,150,94,140550,88068.63,228618.63
431112,201709,30,18,12,16866,11244,28110
431113,201709,29,19,10,17803,9370,27173
431115,201709,155,105,50,97760.2,46840.63,144600.83
431120,201709,613,361,252,336346.42,236050.52,572396.94
431123,201709,3,2,1,1874,937,2811
431125,201709,91,81,10,75897,9370,85267
431127,201709,7,3,4,2811,3748,6559
431130,201709,611,400,211,373581.9,197407.16,570989.06
431140,201709,709,479,230,444839.8,215435.04,660274.84
431142,201709,32,25,7,22235,6559,28794
431150,201709,206,152,54,142424,50579.26,193003.26
431160,201709,56,50,6,46850,5622,52472
431162,201709,20,14,6,13118,5622,18740
431164,201709,4,4,0,3748,0,3748
431170,201709,103,85,18,79645,16866,96511
431171,201709,49,27,22,25299,20604.63,45903.63
431173,201709,1,1,0,937,0,937
431175,201709,198,95,103,87797,96511,184308
431177,201709,72,54,18,50598,16192.26,66790.26
431179,201709,13,11,2,10307,1874,12181
431180,201709,435,262,173,245494,162082.63,407576.63
431190,201709,90,69,21,64653,19677,84330
431198,201709,70,46,24,43102,22488,65590
431200,201709,18,16,2,14992,1874,16866
431205,201709,24,24,0,22488,0,22488
431210,201709,86,53,33,49334,30921,80255
431213,201709,25,20,5,18740,4685,23425
431215,201709,26,23,3,21551,2811,24362
431217,201709,6,5,1,4685,937,5622
431220,201709,65,57,8,53409,7496,60905
431225,201709,148,100,48,93691,44966.63,138657.63
431230,201709,99,85,14,78989.1,13118,92107.1
431235,201709,7,7,0,6559,0,6559
431237,201709,24,16,8,14992,7496,22488
431238,201709,15,11,4,10026,3748,13774
431240,201709,980,631,349,589617.42,326507.02,916124.44
431242,201709,35,35,0,32795,0,32795
431244,201709,10,7,3,6559,2811,9370
431245,201709,63,48,15,44976,14055,59031
431247,201709,14,10,4,9370,3748,13118
431250,201709,271,140,131,131114.41,122064.26,253178.67
431260,201709,61,44,17,41228,15929,57157
431261,201709,22,15,7,14055,6559,20614
431262,201709,16,16,0,14992,0,14992
431265,201709,165,86,79,80582,74023,154605
431267,201709,15,14,1,13118,937,14055
431270,201709,312,261,51,244557,47787,292344
431275,201709,41,39,2,36543,1874,38417
431280,201709,21,16,5,14172.12,4685,18857.12
431290,201709,23,20,3,18740,2811,21551
431295,201709,5,5,0,4685,0,4685
431300,201709,23,20,3,18740,2811,21551
431301,201709,8,8,0,7496,0,7496
431303,201709,48,33,15,30799.19,13773.9,44573.09
431306,201709,218,114,104,106370.11,97448,203818.11
431308,201709,6,5,1,4685,937,5622
431310,201709,63,54,9,50598,8433,59031
431320,201709,121,73,48,68401,44685.53,113086.53
431330,201709,176,117,59,109629,55283,164912
431333,201709,33,27,6,25299,5622,30921
431335,201709,10,5,5,4685,4685,9370
431337,201709,316,150,166,139736.1,154249.14,293985.24
431339,201709,17,14,3,13118,2811,15929
431340,201709,3022,1725,1297,1611962.41,1213340.89,2825303.30
431342,201709,45,28,17,26236,15929,42165
431344,201709,18,17,1,15929,937,16866
431346,201709,3,3,0,2811,0,2811
431349,201709,37,34,3,31858,2811,34669
431350,201709,912,540,372,501512.73,347589.52,849102.25
431360,201709,44,38,6,35606,5622,41228
431365,201709,315,150,165,140531.26,153377.53,293908.79
431370,201709,1311,784,527,731118.17,493604.82,1224722.99
431380,201709,100,84,16,78052.1,14992,93044.1
431390,201709,489,271,218,252990.1,203111.01,456101.11
431395,201709,273,118,155,110566,145217,255783
431400,201709,37,29,8,27173,7496,34669
431402,201709,90,62,28,58094,26236,84330
431403,201709,14,9,5,8433,4685,13118
431405,201709,651,352,299,328727.81,280136,608863.81
431406,201709,30,26,4,24362,3748,28110
431407,201709,50,44,6,41228,5622,46850
431410,201709,3164,1877,1287,1747380.75,1204682.16,2952062.91
431413,201709,15,13,2,12181,1874,14055
431415,201709,71,52,19,48724,17803,66527
431417,201709,23,12,11,11244,10307,21551
431420,201709,296,209,87,195208.3,81509.63,276717.93
431430,201709,39,15,24,14055,22488,36543
431440,201709,8835,6294,2541,5833859.83,2373081.15,8206940.98
431442,201709,28,15,13,14055,12181,26236
431445,201709,26,20,6,18740,5622,24362
431446,201709,7,6,1,5622,937,6559
431447,201709,85,59,26,55283,24362,79645
431449,201709,48,45,3,42165,2811,44976
431450,201709,409,288,121,268122.55,112674.25,380796.80
431454,201709,0,0,0,0,0,0
431455,201709,48,36,12,33732,11244,44976
431460,201709,521,358,163,331885.4,152309.9,484195.3
431470,201709,120,93,27,86461.86,25299,111760.86
431475,201709,11,10,1,9370,937,10307
431477,201709,35,25,10,23425,9370,32795
431478,201709,6,5,1,4685,937,5622
431480,201709,491,310,181,288887.41,169269.05,458156.46
431490,201709,28172,15969,12203,14889693.26,11400074.44,26289767.70
431500,201709,77,53,24,49661,22488,72149
431505,201709,46,19,27,17803,25299,43102
431507,201709,8,7,1,6559,937,7496
431510,201709,278,176,102,164209.9,93681.26,257891.16
431513,201709,24,18,6,16866,5622,22488
431514,201709,8,7,1,6559,937,7496
431515,201709,77,66,11,61842,10307,72149
431517,201709,3,1,2,937,1874,2811
431520,201709,35,32,3,29984,2811,32795
431530,201709,1614,714,900,667708.42,842845.67,1510554.09
431531,201709,22,20,2,18740,1874,20614
431532,201709,24,17,7,15929,6559,22488
431535,201709,25,16,9,14992,8433,23425
431540,201709,141,127,14,117153.11,13118,130271.11
431545,201709,19,17,2,15929,1874,17803
431550,201709,340,199,141,186463,132023.3,318486.3
431555,201709,12,11,1,10307,937,11244
431560,201709,4333,3061,1272,2839779.68,1189372.68,4029152.36
431570,201709,758,403,355,374519.1,329796.89,704315.99
431575,201709,37,26,11,24362,10307,34669
431580,201709,94,65,29,59968,27173,87141
431590,201709,135,113,22,104944,20614,125558
431595,201709,12,11,1,10307,937,11244
431600,201709,216,120,96,112440,89952,202392
431610,201709,128,93,35,86485.1,32795,119280.1
431620,201709,42,34,8,31858,7496,39354
431630,201709,126,108,18,101196,16866,118062
431640,201709,1314,826,488,768383.21,456638.32,1225021.53
431642,201709,41,37,4,34200.5,3748,37948.5
431643,201709,47,21,26,19677,24362,44039
431645,201709,304,174,130,163038,120873,283911
431647,201709,11,11,0,10307,0,10307
431650,201709,35,25,10,23425,9370,32795
431660,201709,272,175,97,161820.84,90889,252709.84
431670,201709,216,104,112,94871.25,104915.89,199787.14
431673,201709,3,3,0,2811,0,2811
431675,201709,28,24,4,22206.9,3748,25954.9
431680,201709,1087,776,311,723364,290087.35,1013451.35
431690,201709,4746,2897,1849,2696147.61,1727736.65,4423884.26
431695,201709,26,20,6,18740,5622,24362
431697,201709,0,0,0,0,0,0
431700,201709,166,125,41,117125,38417,155542
431710,201709,3977,1711,2266,1601511.5,2121813.45,3723324.95
431720,201709,1416,839,577,778685.86,538761.63,1317447.49
431725,201709,1,1,0,937,0,937
431730,201709,1181,793,388,737121,363556,1100677
431740,201709,1364,676,688,628877.66,644105.12,1272982.78
431750,201709,1873,1208,665,1121801.66,620547.36,1742349.02
431755,201709,5,4,1,3748,937,4685
431760,201709,1095,698,397,653651.2,371764.49,1025415.69
431770,201709,387,284,103,266098.63,96492.26,362590.89
431775,201709,27,21,6,19677,5622,25299
431780,201709,558,342,216,319307.28,202382.63,521689.91
431790,201709,151,113,38,104944,35559.15,140503.15
431795,201709,13,12,1,11244,937,12181
431800,201709,3389,1776,1613,1651393.18,1504485.59,3155878.77
431805,201709,17,15,2,14055,1874,15929
431810,201709,622,417,205,387861.87,191954.19,579816.06
431820,201709,313,174,139,163038,129259.15,292297.15
431830,201709,2319,1406,913,1314067.05,854261.44,2168328.49
431840,201709,505,333,172,308461.7,159946,468407.7
431842,201709,34,28,6,26236,5622,31858
431843,201709,10,6,4,5622,3748,9370
431844,201709,14,12,2,11244,1874,13118
431845,201709,28,26,2,24362,1874,26236
431846,201709,29,25,4,23425,3748,27173
431848,201709,14,12,2,11244,1874,13118
431849,201709,8,6,2,5622,1874,7496
431850,201709,797,661,136,617590.11,126916.65,744506.76
431860,201709,99,72,27,67464,24362,91826
431861,201709,4,2,2,1874,1874,3748
431862,201709,49,33,16,30921,14992,45913
431870,201709,3449,2032,1417,1895686.78,1326430.01,3222116.79
431880,201709,926,678,248,630573,231439,862012
431890,201709,1304,807,497,750650.37,464111,1214761.37
431900,201709,179,126,53,118062,49661,167723
431910,201709,54,40,14,37480,13118,50598
431912,201709,34,19,15,17803,14055,31858
431915,201709,123,100,23,93700,21551,115251
431920,201709,143,106,37,99322,34669,133991
431930,201709,86,68,18,63716,16866,80582
431935,201709,4,3,1,2811,937,3748
431936,201709,12,11,1,10307,937,11244
431937,201709,16,11,5,10307,4685,14992
431940,201709,443,292,151,270700.15,141477.63,412177.78
431950,201709,458,295,163,275206.64,151963.4,427170.04
431960,201709,705,419,286,388482.31,267823.45,656305.76
431970,201709,73,65,8,60905,7496,68401
431971,201709,4,4,0,3748,0,3748
431973,201709,19,16,3,14992,2811,17803
431975,201709,6,5,1,4685,937,5622
431980,201709,200,126,74,116562.8,69338,185900.8
431990,201709,1237,660,577,616691.99,540612,1157303.99
432000,201709,1668,893,775,830104.07,723331.12,1553435.19
432010,201709,274,183,91,170378.3,85267,255645.3
432020,201709,171,134,37,125558,34659.63,160217.63
432023,201709,21,17,4,15929,3748,19677
432026,201709,65,58,7,54346,6559,60905
432030,201709,60,30,30,28110,28110,56220
432032,201709,22,19,3,17803,2811,20614
432035,201709,45,37,8,34669,7496,42165
432040,201709,98,68,30,63716,28110,91826
432045,201709,8,7,1,6277.9,937,7214.9
432050,201709,70,42,28,39354,26236,65590
432055,201709,103,78,25,73067.26,23425,96492.26
432057,201709,1,0,1,0,937,937
432060,201709,39,36,3,33029.25,2811,35840.25
432065,201709,32,29,3,27154.26,2811,29965.26
432067,201709,90,79,11,74023,10307,84330
432070,201709,401,301,100,280464.29,93672.26,374136.55
432080,201709,800,553,247,516511.88,231392.89,747904.77
432085,201709,14,11,3,10307,2811,13118
432090,201709,267,172,95,161164,89015,250179
432100,201709,170,112,58,104662.9,54346,159008.9
432110,201709,599,407,192,374499.66,178967,553466.66
432120,201709,966,573,393,536245.1,368203.52,904448.62
432130,201709,494,355,139,331698,130102.45,461800.45
432132,201709,26,23,3,21551,2811,24362
432135,201709,79,67,12,62779,11244,74023
432140,201709,268,209,59,195261.43,55283,250544.43
432143,201709,181,113,68,105881,63716,169597
432145,201709,262,178,84,164725.5,78426.9,243152.4
432146,201709,15,14,1,13118,937,14055
432147,201709,149,61,88,57157,82446.63,139603.63
432149,201709,17,12,5,11244,4685,15929
432150,201709,827,519,308,485131.75,285955.03,771086.78
432160,201709,1393,721,672,673320.2,628793.56,1302113.76
432162,201709,4,3,1,2811,937,3748
432163,201709,18,14,4,13118,3748,16866
432166,201709,124,93,31,87376,29047,116423
432170,201709,226,123,103,114314.9,96511,210825.9
432180,201709,524,312,212,289269.09,198363,487632.09
432183,201709,8,6,2,5622,1874,7496
432185,201709,81,69,12,64559.3,11244,75803.3
432190,201709,480,256,224,238729.63,209748.19,448477.82
432195,201709,85,73,12,67698.25,11244,78942.25
432200,201709,401,256,145,239872,135772.52,375644.52
432210,201709,114,75,39,68260.45,36543,104803.45
432215,201709,62,58,4,54346,3748,58094
432218,201709,19,18,1,16866,937,17803
432220,201709,673,340,333,317579.42,311521.97,629101.39
432225,201709,16,10,6,8901.5,5622,14523.5
432230,201709,155,87,68,81284.75,63716,145000.75
432232,201709,15,13,2,12181,1874,14055
432234,201709,5,4,1,3748,937,4685
432235,201709,1,1,0,937,0,937
432237,201709,29,17,12,15929,11244,27173
432240,201709,4150,2313,1837,2158081.2,1713202.03,3871283.23
432250,201709,1014,634,380,591201.28,355900.71,947101.99
432252,201709,39,32,7,29253.14,6559,35812.14
432253,201709,59,47,12,44039,11244,55283
432254,201709,20,8,12,7496,11244,18740
432255,201709,14,13,1,12181,937,13118
432260,201709,839,655,184,612751.25,171471.75,784223.00
432270,201709,218,160,58,149920,54346,204266
432280,201709,123,89,34,82924.9,31858,114782.9
432285,201709,2,1,1,937,937,1874
432290,201709,69,63,6,57438.1,5622,63060.1
432300,201709,4635,2635,2000,2456063.29,1869714.75,4325778.04
432310,201709,116,93,23,87141,21551,108692
432320,201709,19,14,5,13118,4685,17803
432330,201709,14,8,6,7496,5622,13118
432335,201709,8,7,1,6559,937,7496
432340,201709,41,37,4,34669,3748,38417
432345,201709,88,64,24,59968,22488,82456
432350,201709,23,22,1,20614,937,21551
432360,201709,7,5,2,4685,1874,6559
432370,201709,24,24,0,22206.9,0,22206.9
432375,201709,42,36,6,33732,5622,39354
432377,201709,7,7,0,6559,0,6559
432380,201709,165,71,94,65871.1,88031.15,153902.25
500020,201709,241,128,113,119936,105290.69,225226.69
500025,201709,116,57,59,52472,55283,107755
500060,201709,1373,831,542,778084.8,507259.21,1285344.01
500070,201709,739,346,393,324202,367950.63,692152.63
500080,201709,134,102,32,95574,29984,125558
500085,201709,142,115,27,107474,24479.13,131953.13
500090,201709,333,157,176,147109,164912,312021
500100,201709,696,373,323,346783.9,301809,648592.9
500110,201709,2226,983,1243,920762.63,1163917.3,2084679.93
500124,201709,310,175,135,163975,126213.9,290188.9
500150,201709,328,127,201,118990,187983,306973
500190,201709,524,355,169,331960.36,157872,489832.36
500200,201709,202,172,30,160827,28110,188937
500210,201709,1437,521,916,486926.48,857230.47,1344156.95
500215,201709,238,136,102,126471.21,95574,222045.21
500220,201709,782,510,272,477629.52,254120.63,731750.15
500230,201709,258,179,79,167020.25,73554.5,240574.75
500240,201709,711,493,218,461191.4,203797.9,664989.3
500260,201709,566,205,361,192085,338257,530342
500270,201709,28273,11981,16292,11198088.68,15250209.29,26448297.97
500280,201709,193,74,119,69338,111503,180841
500290,201709,1177,676,501,632476,469428,1101904
500295,201709,388,232,156,217384,146162.63,363546.63
500310,201709,65,19,46,17803,43102,60905
500315,201709,701,413,288,386971.63,269565.53,656537.16
500320,201709,3639,1809,1830,1692649.39,1713082.37,3405731.76
500325,201709,948,519,429,485835,401015.32,886850.32
500330,201709,1499,688,811,641818.86,759294.43,1401113.29
500345,201709,321,235,86,219249.1,80582,299831.1
500348,201709,240,140,100,131180,93681.63,224861.63
500350,201709,147,71,76,66527,71212,137739
500370,201709,5430,2410,3020,2251099.14,2826786.16,5077885.30
500375,201709,351,252,99,236114.63,92763,328877.63
500380,201709,575,330,245,309055.4,229546.63,538602.03
500390,201709,70,36,34,33732,31858,65590
500400,201709,212,144,68,134909.26,63707,198616.26
500410,201709,568,221,347,207031.58,324993.42,532025.00
500430,201709,527,368,159,344816,148983,493799
500440,201709,206,106,100,98561.42,93700,192261.42
500450,201709,412,173,239,161412.8,222938.94,384351.74
500460,201709,320,159,161,148973.63,150857,299830.63
500470,201709,434,342,92,319261.05,85258,404519.05
500480,201709,111,66,45,61842,42165,104007
500490,201709,106,41,65,38412.32,60905,99317.32
500500,201709,1445,492,953,459205.8,892087.9,1351293.7
500510,201709,49,37,12,34669,11235,45904
500515,201709,108,74,34,69338,31577,100915
500520,201709,351,197,154,183559,144294,327853
500525,201709,89,51,38,47787,35324.9,83111.9
500540,201709,893,365,528,341939.78,493744.03,835683.81
500560,201709,900,503,397,469374.32,371306.83,840681.15
500568,201709,973,564,409,524720.1,382947.32,907667.42
500570,201709,1212,686,526,640580.09,490271.65,1130851.74
500580,201709,336,174,162,162747.53,151781,314528.53
500600,201709,322,165,157,153906.93,147091,300997.93
500620,201709,884,627,257,581825.61,240612.23,822437.84
500625,201709,77,64,13,59273.78,12181,71454.78
500627,201709,20,9,11,8433,10307,18740
500630,201709,1579,833,746,779471.9,698716.22,1478188.12
500635,201709,514,283,231,264758.72,216297.08,481055.80
500640,201709,423,219,204,202654.5,191129.63,393784.13
500660,201709,5507,2098,3409,1963109.8,3190850.73,5153960.53
500690,201709,572,200,372,187057.39,347791.23,534848.62
500710,201709,356,173,183,161820,171180.9,333000.9
500720,201709,965,566,399,528932.32,373657.26,902589.58
500730,201709,190,110,80,103070,74674.22,177744.22
500740,201709,846,371,475,346349.82,444345.68,790695.50
500750,201709,138,44,94,41228,87904.29,129132.29
500755,201709,123,90,33,84049,30921,114970
500769,201709,745,418,327,391345.02,306386,697731.02
500770,201709,452,233,219,218311.63,204959.38,423271.01
500780,201709,174,117,57,109629,53409,163038
500790,201709,1037,512,525,479177.32,491603.63,970780.95
500793,201709,249,132,117,123684,109620,233304
500795,201709,176,126,50,118052.63,46841,164893.63
500797,201709,41,34,7,31858,6559,38417
500800,201709,412,181,231,169588,216165.9,385753.9
500830,201709,2167,1207,960,1127765.3,898564.26,2026329.56
500840,201709,144,107,37,100259,34660,134919
510010,201709,166,91,75,85257.63,70275,155532.63
510020,201709,483,223,260,208668.67,243079.38,451748.05
510025,201709,1637,927,710,867744.03,662472.87,1530216.90
510030,201709,614,311,303,291361.26,283160.32,574521.58
510035,201709,127,55,72,51507.63,67445.63,118953.26
510040,201709,381,166,215,155542,201015.53,356557.53
510050,201709,423,227,196,211962.1,182832.89,394794.99
510060,201709,111,53,58,49631.52,54336.63,103968.15
510080,201709,221,87,134,81486.95,125455.3,206942.25
510100,201709,75,34,41,31858,38398.26,70256.26
510120,201709,35,21,14,19677,13118,32795
510125,201709,407,248,159,231706.05,148960.26,380666.31
510130,201709,592,346,246,323828.55,230083.68,553912.23
510140,201709,390,129,261,120864,244552.32,365416.32
510160,201709,87,42,45,39354,42161,81515
510170,201709,849,521,328,487913.66,306730.28,794643.94
510180,201709,2858,1398,1460,1306923.16,1366020.39,2672943.55
510185,201709,11,6,5,5622,4685,10307
510190,201709,219,74,145,69338,135860.32,205198.32
510250,201709,2624,1525,1099,1427906.9,1028659.66,2456566.56
510260,201709,199,142,57,132872.52,53372.63,186245.15
510263,201709,450,247,203,229997.04,189468.89,419465.93
510267,201709,638,355,283,331546.57,264912.47,596459.04
510268,201709,55,30,25,28110,23425,51535
510269,201709,70,28,42,26227,39354,65581
510270,201709,409,208,201,194720.19,187917.57,382637.76
510279,201709,220,159,61,148955.63,57138.26,206093.89
510285,201709,172,75,97,70236.63,90889,161125.63
510300,201709,555,298,257,278795.85,240735.53,519531.38
510305,201709,215,97,118,90866.63,110464.04,201330.67
510310,201709,118,57,61,53409,57147.63,110556.63
510320,201709,855,530,325,496041.42,304104.26,800145.68
510325,201709,408,165,243,154575.63,227400.53,381976.16
510330,201709,415,231,184,216434,172389.26,388823.26
510335,201709,605,319,286,298856.89,267319.32,566176.21
510336,201709,51,36,15,33711.89,14055,47766.89
510337,201709,122,47,75,44029.63,70265.63,114295.26
510340,201709,17390,8384,9006,7831618.09,8427854.72,16259472.81
510343,201709,72,49,23,45903.63,21551,67454.63
510345,201709,162,106,56,99312.63,52181.63,151494.26
510350,201709,648,367,281,342664.37,263232.89,605897.26
510360,201709,207,121,86,113358.63,80490.89,193849.52
510370,201709,133,69,64,64634.26,59838.3,124472.56
510380,201709,94,64,30,59968,28101,88069
510385,201709,57,26,31,24362,29038,53400
510390,201709,126,50,76,46850,71165.15,118015.15
510395,201709,41,28,13,26236,12181,38417
510410,201709,696,459,237,430059,222045.95,652104.95
510420,201709,588,283,305,264231.66,284314.68,548546.34
510450,201709,51,32,19,29984,17803,47787
510452,201709,37,22,15,20614,14055,34669
510454,201709,68,28,40,26236,37470.63,63706.63
510455,201709,128,80,48,74941.26,44976,119917.26
510460,201709,183,97,86,90440.53,80544.89,170985.42
510480,201709,723,400,323,373694.05,302284.34,675978.39
510490,201709,362,184,178,172027.53,166236.13,338263.66
510500,201709,253,190,63,178020.63,59031,237051.63
510510,201709,780,447,333,417968.43,312011.63,729980.06
510515,201709,1150,599,551,560721.48,516229.89,1076951.37
510517,201709,254,109,145,101851.9,135841.95,237693.85
510520,201709,234,151,83,141395.52,77466.52,218862.04
510523,201709,93,62,31,58094,29037.63,87131.63
510525,201709,687,391,296,365616.52,277233.15,642849.67
510530,201709,17,12,5,11244,4685,15929
510550,201709,272,117,155,109168.46,145226,254394.46
510558,201709,278,135,143,126480.95,133963.26,260444.21
510560,201709,376,228,148,213636,138377,352013
510562,201709,645,445,200,415667.25,186922.13,602589.38
510590,201709,830,432,398,404746.89,372907.96,777654.85
510600,201709,257,137,120,128346.26,112403.26,240749.52
510610,201709,161,78,83,73067.26,77752.63,150819.89
510615,201709,188,74,114,69319.26,106818,176137.26
510617,201709,15,8,7,7496,6559,14055
510618,201709,122,60,62,56220,57625.5,113845.5
510619,201709,105,72,33,67455,30912,98367
510620,201709,190,107,83,100249.63,77771,178020.63
510621,201709,190,123,67,115232.63,62760.63,177993.26
510622,201709,448,296,152,277240.52,142096.89,419337.41
510623,201709,359,234,125,219221.26,117096.89,336318.15
510624,201709,86,38,48,35597,44976,80573
510625,201709,520,316,204,295592.78,190579.19,486171.97
510626,201709,106,64,42,59968,39354,99322
510627,201709,54,39,15,36543,14055,50598
510628,201709,163,97,66,90843.26,61785.78,152629.04
510629,201709,248,158,90,148046,83383.63,231429.63
510630,201709,451,222,229,207939.78,214241.85,422181.63
510631,201709,10,3,7,2811,6559,9370
510637,201709,339,184,155,172348.89,145089.52,317438.41
510642,201709,975,534,441,500012.79,413076.82,913089.61
510645,201709,0,0,0,0,0,0
510650,201709,1527,1003,524,939648.89,490878.41,1430527.30
510665,201709,82,41,41,38363,38399,76762
510670,201709,67,36,31,33732,29047,62779
510675,201709,1184,712,472,667093,442241.32,1109334.32
510677,201709,368,175,193,162978.15,180412.67,343390.82
510680,201709,107,62,45,58076,42156,100232
510682,201709,202,91,111,84951,104007,188958
510685,201709,55,39,16,36543,14992,51535
510700,201709,626,364,262,340950.26,245343.04,586293.30
510704,201709,1024,553,471,515902.72,439783.54,955686.26
510706,201709,126,61,65,57152.32,60868.26,118020.58
510710,201709,395,260,135,243426.93,126383.3,369810.23
510715,201709,64,47,17,44029.63,15929,59958.63
510718,201709,214,110,104,102977.78,97429.63,200407.41
510719,201709,32,18,14,16866,13118,29984
510720,201709,199,129,70,120864,65308.9,186172.9
510724,201709,86,34,52,31848.63,48691.89,80540.52
510726,201709,50,27,23,25289.63,21533,46822.63
510729,201709,77,36,41,33732,38379.52,72111.52
510730,201709,466,256,210,239854,196622.63,436476.63
510735,201709,110,43,67,40291,62779,103070
510740,201709,27,13,14,12181,13118,25299
510757,201709,19,15,4,14055,3748,17803
510760,201709,6989,3696,3293,3453610.42,3079306.76,6532917.18
510770,201709,735,346,389,324017.15,364302.15,688319.30
510774,201709,14,7,7,6559,6559,13118
510775,201709,112,84,28,78698.63,26226.63,104925.26
510776,201709,29,8,21,7496,19677,27173
510777,201709,187,84,103,78679.89,96482.89,175162.78
510779,201709,52,24,28,22479,26199.26,48678.26
510780,201709,294,163,131,152659.26,122666,275325.26
510785,201709,445,242,203,226688.78,190136.04,416824.82
510787,201709,187,94,93,88064.32,87123.32,175187.64
510788,201709,0,0,0,0,0,0
510790,201709,2359,1230,1129,1150440.33,1055401.9,2205842.23
510792,201709,1058,589,469,551414.15,439047.01,990461.16
510794,201709,109,53,56,49661,52444.26,102105.26
510795,201709,2383,1383,1000,1288993.53,934134.43,2223127.96
510800,201709,177,111,66,103997.63,61833,165830.63
510805,201709,164,117,47,109629,44039,153668
510810,201709,93,37,56,34586.89,52350.56,86937.45
510820,201709,262,123,139,115018.63,129260.71,244279.34
510830,201709,67,40,27,37480,25290,62770
510835,201709,2,1,1,937,937,1874
510840,201709,9127,4579,4548,4277012.54,4253714.13,8530726.67
510850,201709,207,84,123,78698.63,114932.79,193631.42
510860,201709,392,174,218,162853.56,203540.05,366393.61
510880,201709,62,48,14,44957.63,13118,58075.63
510885,201709,69,42,27,39335.63,25270.89,64606.52
510890,201709,73,40,33,37480,30921,68401
510895,201709,184,106,78,99322,72782.63,172104.63
520005,201709,23,16,7,14992,6559,21551
520010,201709,280,123,157,115251,147016,262267
520013,201709,622,365,257,341968.63,240527.9,582496.53
520015,201709,51,35,16,32795,14992,47787
520017,201709,102,59,43,55002,40291,95293
520020,201709,30,15,15,14055,14055,28110
520025,201709,2015,1095,920,1024703.3,861187.7,1885891.0
520030,201709,790,397,393,371043,367304,738347
520050,201709,75,50,25,46850,23425,70275
520055,201709,43,29,14,27173,13118,40291
520060,201709,176,112,64,104944,59968,164912
520080,201709,588,404,184,378266.9,172408,550674.9
520082,201709,20,14,6,13118,5622,18740
520085,201709,96,72,24,67464,22488,89952
520090,201709,83,58,25,54346,23425,77771
520110,201709,9050,3902,5148,3650787.01,4819874.7,8470661.71
520120,201709,13,8,5,7299.23,4685,11984.23
520130,201709,753,531,222,497538,208005,705543
520140,201709,11726,6592,5134,6169858.95,4806933.09,10976792.04
520145,201709,42,32,10,29984,9370,39354
520150,201709,187,148,39,138676,36543,175219
520160,201709,33,23,10,21551,9370,30921
520170,201709,227,139,88,130212,82420,212632
520180,201709,112,56,56,52472,52472,104944
520215,201709,212,128,84,119654.9,78426.9,198081.8
520235,201709,68,52,16,48724,14992,63716
520250,201709,137,85,52,79645,48442.9,128087.9
520260,201709,111,72,39,67464,35606,103070
520280,201709,49,35,14,32140,13118,45258
520310,201709,39,26,13,24362,12181,36543
520320,201709,166,104,62,97448,58094,155542
520330,201709,777,411,366,385061.63,342915,727976.63
520340,201709,354,202,152,189274,142405.63,331679.63
520350,201709,516,233,283,218321,265125,483446
520355,201709,95,53,42,49661,39354,89015
520357,201709,26,18,8,16866,7496,24362
520360,201709,0,0,0,0,0,0
520380,201709,142,76,66,71212,61821.89,133033.89
520390,201709,297,126,171,117500,160217.63,277717.63
520393,201709,12,9,3,8433,2811,11244
520396,201709,97,59,38,55283,35606,90889
520400,201709,229,133,96,123029.1,89952,212981.1
520410,201709,197,99,98,92754,91817,184571
520420,201709,25,17,8,15929,7496,23425
520425,201709,303,134,169,124622,157885.6,282507.6
520430,201709,445,234,211,218976.9,197652,416628.9
520440,201709,593,390,203,365430,190211,555641
520450,201709,1899,863,1036,807535.63,970087.32,1777622.95
520455,201709,58,39,19,36543,17803,54346
520460,201709,29,15,14,14055,13118,27173
520465,201709,22,19,3,17803,2811,20614
520470,201709,421,258,163,241439.42,152731,394170.42
520480,201709,83,46,37,43102,34615,77717
520485,201709,128,45,83,42165,77490,119655
520490,201709,383,286,97,267801.26,90727.84,358529.10
520495,201709,184,109,75,102133,70275,172408
520500,201709,182,137,45,128369,42165,170534
520505,201709,170,88,82,82456,76834,159290
520510,201709,1745,855,890,797039.82,831622.8,1628662.62
520520,201709,43,31,12,29047,11244,40291
520530,201709,234,171,63,156971.78,58245.79,215217.57
520540,201709,509,333,176,310737.81,164912,475649.81
520545,201709,156,86,70,80582,65590,146172
520547,201709,49,27,22,25299,20614,45913
520549,201709,1041,489,552,457875,516687,974562
520551,201709,295,155,140,145235,131180,276415
520552,201709,43,26,17,24362,15929,40291
520570,201709,16,8,8,7496,7496,14992
520580,201709,286,171,115,160218,107755,267973
520590,201709,159,93,66,87141,61560.9,148701.9
520620,201709,1130,535,595,500546.14,556662.53,1057208.67
520630,201709,42,25,17,23425,15929,39354
520640,201709,413,238,175,223006,163975,386981
520650,201709,52,39,13,36543,12181,48724
520660,201709,34,19,15,17803,14055,31858
520670,201709,31,26,5,24362,4685,29047
520680,201709,61,40,21,37480,19677,57157
520690,201709,32,12,20,11234.63,18731,29965.63
520710,201709,36,32,4,29984,3748,33732
520725,201709,200,126,74,118062,69338,187400
520735,201709,55,41,14,38417,13118,51535
520740,201709,403,194,209,181076.2,195824,376900.2
520750,201709,37,27,10,25299,9370,34669
520753,201709,54,38,16,35606,14992,50598
520760,201709,109,73,36,68401,33732,102133
520780,201709,278,215,63,201455,59031,260486
520790,201709,170,79,91,73179.21,85267,158446.21
520800,201709,3524,1859,1665,1738637.78,1559435.77,3298073.55
520810,201709,164,113,51,105881,47787,153668
520815,201709,6,5,1,4685,937,5622
520830,201709,138,91,47,85267,43757.9,129024.9
520840,201709,334,217,117,202860.5,109629,312489.5
520850,201709,110,71,39,66518,36393.08,102911.08
520860,201709,1652,1039,613,971962.87,573201.6,1545164.47
520870,201709,30547,15081,15466,14103834.71,14476932.88,28580767.59
520880,201709,1017,573,444,536895,416009.26,952904.26
520890,201709,799,458,341,427544.2,319414.63,746958.83
520910,201709,1023,531,492,494035.31,461004,955039.31
520915,201709,97,75,22,70275,20604.63,90879.63
520920,201709,411,201,210,187774.8,196770,384544.8
520929,201709,23,21,2,19677,1874,21551
520940,201709,76,46,30,43102,28110,71212
520945,201709,22,14,8,13118,7496,20614
520960,201709,49,31,18,29047,16866,45913
520970,201709,325,203,122,189593,114032.9,303625.9
520980,201709,95,71,24,66527,22488,89015
520990,201709,478,320,158,299840,148046,447886
520993,201709,124,60,64,56220,59959,116179
520995,201709,245,136,109,126496,101571,228067
521000,201709,1548,894,654,835992.3,612705,1448697.3
521010,201709,670,304,366,284521.53,342877.15,627398.68
521015,201709,16,9,7,8433,6559,14992
521020,201709,1476,1014,462,949499.95,432529.41,1382029.36
521030,201709,41,27,14,25299,13118,38417
521040,201709,895,545,350,510432,327669,838101
521056,201709,43,29,14,27173,13118,40291
521060,201709,133,83,50,77771,46850,124621
521080,201709,500,369,131,345744,122747,468491
521090,201709,532,321,211,300777,197435.27,498212.27
521100,201709,288,212,76,198635,71212,269847
521120,201709,1035,704,331,657319.79,309857,967176.79
521130,201709,360,257,103,240799.63,95921.8,336721.43
521140,201709,187,107,80,100259,74960,175219
521150,201709,2797,1208,1589,1129686.14,1487642.85,2617328.99
521160,201709,31,17,14,15929,13118,29047
521170,201709,191,111,80,103997.63,74960,178957.63
521180,201709,1110,695,415,649613.53,388153.1,1037766.63
521190,201709,2556,1071,1485,1003508.26,1390387.16,2393895.42
521200,201709,44,32,12,29984,11244,41228
521205,201709,18,13,5,12181,4685,16866
521210,201709,150,84,66,78708,61842,140550
521220,201709,803,538,265,501520.78,248250,749770.78
521225,201709,28,18,10,16866,9370,26236
521230,201709,110,72,38,67182.9,35606,102788.9
521250,201709,6592,3699,2893,3459179.5,2708194.03,6167373.53
521260,201709,18,13,5,12181,4685,16866
521270,201709,151,116,35,108692,32795,141487
521280,201709,438,254,184,237342.1,172408,409750.1
521290,201709,34,14,20,13118,18740,31858
521295,201709,99,67,32,62554.12,29984,92538.12
521300,201709,225,114,111,106800,103643.89,210443.89
521305,201709,36,24,12,22488,11244,33732
521308,201709,1075,766,309,717241.41,289233.63,1006475.04
521310,201709,1350,796,554,744786.1,517928.26,1262714.36
521340,201709,22,17,5,15929,4685,20614
521350,201709,133,97,36,90889,33732,124621
521370,201709,193,119,74,110566,69056.9,179622.9
521375,201709,195,108,87,101196,81237.9,182433.9
521377,201709,52,35,17,32795,15929,48724
521380,201709,1064,695,369,646861.26,345753,992614.26
521385,201709,19,11,8,10307,7496,17803
521390,201709,109,88,21,82143.7,19677,101820.7
521400,201709,332,209,123,195551.9,115204.15,310756.05
521405,201709,152,77,75,72149,70275,142424
521410,201709,70,47,23,44039,21551,65590
521440,201709,222,154,68,143501.55,63716,207217.55
521450,201709,719,390,329,365430,307617.1,673047.1
521460,201709,1177,709,468,664052,438497.26,1102549.26
521470,201709,14,9,5,8433,4685,13118
521480,201709,52,34,18,31858,16802,48660
521483,201709,306,163,143,152450,133991,286441
521486,201709,294,186,108,174160.19,100541,274701.19
521487,201709,24,11,13,10307,12181,22488
521490,201709,29,17,12,15929,11244,27173
521500,201709,111,72,39,67464,36543,104007
521520,201709,41,30,11,28110,10307,38417
521523,201709,570,353,217,327827.45,203329,531156.45
521525,201709,47,31,16,29047,14992,44039
521530,201709,247,130,117,121810,109629,231439
521540,201709,30,16,14,14992,13118,28110
521550,201709,90,40,50,37180.63,46813.63,83994.26
521560,201709,784,542,242,507113.87,226473,733586.87
521565,201709,46,31,15,29047,14055,43102
521570,201709,479,320,159,299830.63,148890.15,448720.78
521580,201709,62,39,23,36543,21551,58094
521590,201709,35,19,16,17803,14992,32795
521600,201709,28,16,12,14992,11244,26236
521630,201709,235,118,117,110556.63,108655.88,219212.51
521640,201709,300,151,149,141487,139613,281100
521645,201709,28,15,13,14055,12181,26236
521680,201709,228,141,87,132117,81519,213636
521690,201709,1,1,0,937,0,937
521710,201709,1181,555,626,519472.9,586553,1106025.9
521720,201709,514,336,178,314822.63,166739.26,481561.89
521730,201709,625,308,317,288596,295942.18,584538.18
521740,201709,919,368,551,344788.26,515107.96,859896.22
521760,201709,1568,838,730,783656.52,683702,1467358.52
521770,201709,793,503,290,471311,271270.87,742581.87
521800,201709,2102,1294,808,1209473.2,756116.79,1965589.99
521805,201709,33,19,14,17799,13118,30917
521810,201709,98,59,39,54158.9,36543,90701.9
521830,201709,951,665,286,621513.08,267973,889486.08
521839,201709,94,64,30,59968,28110,88078
521850,201709,1092,586,506,547689.26,473792.04,1021481.30
521860,201709,349,214,135,200518,126214,326732
521870,201709,71,39,32,36543,29984,66527
521878,201709,43,20,23,18740,21551,40291
521880,201709,4350,1946,2404,1821433.58,2250137.85,4071571.43
521890,201709,569,392,177,367304,165558.9,532862.9
521900,201709,298,242,56,225848.2,52472,278320.2
521910,201709,153,108,45,101196,42165,143361
521920,201709,55,26,29,24362,27173,51535
521925,201709,34,21,13,19677,12181,31858
521930,201709,1102,632,470,591990.19,439451.9,1031442.09
521935,201709,33,25,8,23425,7496,30921
521940,201709,194,98,96,91826,89952,181778
521945,201709,16,14,2,13118,1874,14992
521950,201709,7,5,2,4685,1874,6559
521960,201709,75,56,19,52472,17803,70275
521970,201709,414,262,152,245212.9,142424,387636.9
521971,201709,96,47,49,44039,45913,89952
521973,201709,31,13,18,12181,16866,29047
521975,201709,1078,561,517,524533.6,483436.73,1007970.33
521980,201709,243,165,78,154446,73086,227532
521990,201709,72,55,17,51535,15929,67464
522000,201709,288,179,109,167723,102133,269856
522005,201709,22,14,8,13118,7496,20614
522010,201709,1116,623,493,582805,461369.43,1044174.43
522015,201709,56,34,22,31849,20614,52463
522020,201709,875,464,411,433550.1,384370.59,817920.69
522026,201709,30,21,9,19677,8433,28110
522028,201709,17,13,4,12181,3748,15929
522040,201709,737,289,448,270494,419721.63,690215.63
522045,201709,1990,1254,736,1173887.43,688910.19,1862797.62
522050,201709,171,82,89,76834,83393,160227
522060,201709,555,352,203,329542.9,189305.23,518848.13
522068,201709,137,89,48,83393,44976,128369
522070,201709,12,12,0,11244,0,11244
522100,201709,46,24,22,22225.64,20614,42839.64
522108,201709,40,30,10,28110,9370,37480
522119,201709,60,29,31,27173,29047,56220
522130,201709,77,24,53,22488,49625,72113
522140,201709,3663,1874,1789,1751390.92,1674448.05,3425838.97
522145,201709,56,34,22,31858,20614,52472
522150,201709,64,51,13,47787,12181,59968
522155,201709,54,39,15,36534,14055,50589
522157,201709,6,4,2,3748,1874,5622
522160,201709,1731,1008,723,943371.6,677160.9,1620532.5
522170,201709,402,268,134,251116,125558,376674
522180,201709,36,20,16,18740,14992,33732
522185,201709,1311,543,768,505880.17,719454.88,1225335.05
522190,201709,48,27,21,25299,19583.3,44882.3
522200,201709,298,181,117,169597,109629,279226
522205,201709,168,115,53,107755,49661,157416
522220,201709,173,123,50,115251,46850,162101
522230,201709,32,25,7,23425,6559,29984
530010,201709,54706,28056,26650,26152011.76,24915493.79,51067505.55
110001,201710,512,403,109,376644.52,101499.3,478143.82
110002,201710,2712,1602,1110,1499779.23,1039090.47,2538869.70
110003,201710,90,72,18,67464,16866,84330
110004,201710,1962,1248,714,1166505.57,668071.63,1834577.20
110005,201710,433,348,85,325795,79635.63,405430.63
110006,201710,446,344,102,322046.9,95556,417602.9
110007,201710,83,66,17,61842,15929,77771
110008,201710,233,133,100,123684,93700,217384
110009,201710,762,512,250,478787.1,234054,712841.1
110010,201710,1772,1099,673,1028544.06,630441.46,1658985.52
110011,201710,1880,1447,433,1354272.1,405691.52,1759963.62
110012,201710,4093,2364,1729,2208639.77,1618818.71,3827458.48
110013,201710,747,559,188,523753.63,176156,699909.63
110014,201710,360,305,55,285744.89,51510.32,337255.21
110015,201710,1447,1161,286,1086058.14,267401.06,1353459.20
110018,201710,1111,659,452,617174,423511.32,1040685.32
110020,201710,15204,8888,6316,8286060.27,5906216.85,14192277.12
110025,201710,629,459,170,428120.45,159260.89,587381.34
110026,201710,42,31,11,29047,10307,39354
110028,201710,1632,1182,450,1102682.32,419401.7,1522084.02
110029,201710,138,121,17,113377,15929,129306
110030,201710,2456,1648,808,1541291.3,756039.52,2297330.82
110032,201710,387,297,90,277985,84326,362311
110033,201710,652,498,154,463728.35,144013,607741.35
110034,201710,360,266,94,246971,87423,334394
110037,201710,107,87,20,81519,18740,100259
110040,201710,325,217,108,203309,101196,304505
110045,201710,924,606,318,566263,297029.66,863292.66
110050,201710,97,78,19,73086,17803,90889
110060,201710,90,46,44,43102,41228,84330
110070,201710,128,75,53,70275,49380,119655
110080,201710,396,231,165,214263.8,154556.81,368820.61
110090,201710,30,25,5,23425,4685,28110
110092,201710,106,60,46,56220,43011.89,99231.89
110094,201710,201,140,61,131180,57157,188337
110100,201710,27,22,5,20614,4685,25299
110110,201710,73,46,27,43102,25018,68120
110120,201710,73,58,15,54346,14055,68401
110130,201710,300,246,54,229013.81,50578,279591.81
110140,201710,247,160,87,149900,81509.63,231409.63
110143,201710,46,39,7,36543,6559,43102
110145,201710,28,20,8,18740,7496,26236
110146,201710,22,11,11,10307,10307,20614
110147,201710,40,31,9,29047,8433,37480
110148,201710,38,26,12,24310.57,11244,35554.57
110149,201710,298,209,89,195551.9,83393,278944.9
110150,201710,82,53,29,49661,26906.89,76567.89
110155,201710,9,7,2,6559,1874,8433
110160,201710,72,60,12,56220,11244,67464
110170,201710,213,174,39,163018,36543,199561
110175,201710,28,22,6,20614,5622,26236
110180,201710,96,84,12,78708,11244,89952
120001,201710,128,87,41,81477,38409,119886
120005,201710,190,121,69,113334.12,64466,177800.12
120010,201710,1006,650,356,602649.64,331295.4,933945.04
120013,201710,138,94,44,87372,40218.98,127590.98
120017,201710,86,57,29,53300.48,27130.12,80430.60
120020,201710,3477,2763,714,2559826.74,665471.26,3225298.00
120025,201710,601,336,265,311892.67,247175.46,559068.13
120030,201710,1021,851,170,790009.25,158545.12,948554.37
120032,201710,47,39,8,36521.12,7496,44017.12
120033,201710,214,187,27,174877.94,25299,200176.94
120034,201710,151,109,42,100237.12,39310.24,139547.36
120035,201710,27,18,9,16866,8433,25299
120038,201710,386,244,142,227817.2,133010.24,360827.44
120039,201710,21,19,2,17803,1874,19677
120040,201710,13979,9644,4335,8911717.7,4020796.02,12932513.72
120042,201710,42,36,6,33732,5622,39354
120043,201710,13,2,11,1874,10307,12181
120045,201710,537,345,192,321705.17,179639.48,501344.65
120050,201710,1242,949,293,883757.47,274169.46,1157926.93
120060,201710,1377,1110,267,1023855.28,246357.5,1270212.78
120070,201710,507,363,144,334093.58,133542.95,467636.53
120080,201710,149,96,53,88731.97,49098.55,137830.52
130002,201710,150,104,46,97448,43102,140550
130006,201710,76,43,33,40291,30921,71212
130008,201710,143,76,67,70491.72,62056.96,132548.68
130010,201710,139,73,66,68401,61842,130243
130014,201710,241,175,66,163975,61842,225817
130020,201710,83,46,37,43102,34669,77771
130030,201710,882,541,341,506917,319507.63,826424.63
130040,201710,320,165,155,154605,144298.84,298903.84
130050,201710,551,308,243,288314.9,227691,516005.9
130060,201710,876,599,277,556136.3,256712.34,812848.64
130063,201710,542,286,256,267982,239850.12,507832.12
130068,201710,188,121,67,113377,62497.9,175874.9
130070,201710,1342,934,408,850182.28,372983.91,1223166.19
130080,201710,663,433,230,405346.2,215501,620847.2
130083,201710,69,37,32,34669,29984,64653
130090,201710,384,198,186,183876.88,174282,358158.88
130100,201710,1122,520,602,487240,563792.9,1051032.9
130110,201710,706,313,393,293131,368241,661372
130115,201710,173,70,103,65590,96511,162101
130120,201710,1612,1011,601,947307,563137,1510444
130130,201710,622,420,202,393540,189274,582814
130140,201710,1546,1162,384,1088163.95,358871.1,1447035.05
130150,201710,426,358,68,335446,63716,399162
130160,201710,476,263,213,246431,199581,446012
130165,201710,25,18,7,16866,6559,23425
130170,201710,951,670,281,627700.55,263297,890997.55
130180,201710,155,93,62,86672.5,58094,144766.5
130185,201710,2134,1132,1002,1058789.89,938312,1997101.89
130190,201710,3586,2258,1328,2111998.4,1242776.09,3354774.49
130195,201710,293,235,58,220195,54346,274541
130200,201710,180,82,98,76824.63,91826,168650.63
130210,201710,76,36,40,33732,37480,71212
130220,201710,187,127,60,118999,56220,175219
130230,201710,328,205,123,192085,115251,307336
130240,201710,1460,915,545,856039.2,509817.12,1365856.32
130250,201710,4660,3008,1652,2813977.6,1547790.93,4361768.53
130255,201710,420,208,212,194896,198362.9,393258.9
130260,201710,52597,24994,27603,23386342.97,25856231.17,49242574.14
130270,201710,1472,947,525,886870.5,491925,1378795.5
130280,201710,111,67,44,62779,41228,104007
130290,201710,2068,1514,554,1418213.22,518816.9,1937030.12
130300,201710,423,304,119,284566.9,111503,396069.9
130310,201710,895,482,413,451634,386981,838615
130320,201710,451,240,211,223943,197707,421650
130330,201710,703,430,273,402910,255519.9,658429.9
130340,201710,3199,1956,1243,1828274.6,1163285.6,2991560.2
130350,201710,489,304,185,284725.57,173345,458070.57
130353,201710,750,309,441,289252,413217,702469
130356,201710,737,337,400,315769,374518.9,690287.9
130360,201710,70,42,28,39354,26236,65590
130370,201710,694,499,195,467563,182715,650278
130380,201710,648,437,211,409469,197707,607176
130390,201710,492,393,99,368241,92763,461004
130395,201710,178,41,137,38417,128369,166786
130400,201710,66,45,21,42165,19677,61842
130406,201710,2066,1317,749,1230484.15,701185.16,1931669.31
130410,201710,516,218,298,204266,279207.26,483473.26
130420,201710,3181,2539,642,2375951.25,601554,2977505.25
130423,201710,165,76,89,71212,83393,154605
130426,201710,140,82,58,76834,54346,131180
130430,201710,408,270,138,252990,129306,382296
130440,201710,198,71,127,66527,118999,185526
140002,201710,36,14,22,13118,20614,33732
140005,201710,199,121,78,113142.75,73086,186228.75
140010,201710,10324,6975,3349,6503004.2,3134825.92,9637830.12
140015,201710,155,69,86,64653,80582,145235
140017,201710,107,73,34,68401,31858,100259
140020,201710,482,323,159,301714,148983,450697
140023,201710,24,15,9,13559,8433,21992
140028,201710,17,12,5,11244,4685,15929
140030,201710,361,252,109,236124,101542.69,337666.69
140040,201710,54,38,16,35606,14898.3,50504.3
140045,201710,250,118,132,109910.1,123684,233594.1
140047,201710,551,366,185,340128.03,172595.5,512723.53
140050,201710,156,101,55,93839,51535,145374
140060,201710,34,24,10,21766.51,9370,31136.51
140070,201710,31,29,2,27173,1874,29047
150010,201710,4711,2921,1790,2734306.75,1675148.66,4409455.41
150013,201710,141,94,47,88078,44039,132117
150020,201710,1102,574,528,537838,494736,1032574
150030,201710,748,303,445,283911,416965,700876
150034,201710,187,115,72,107755,67464,175219
150040,201710,1371,818,553,766466,518161,1284627
150050,201710,717,424,293,396304.9,274341,670645.9
150060,201710,4681,3037,1644,2841978.88,1539903.28,4381882.16
150070,201710,308,140,168,131180,157416,288596
150080,201710,14469,7228,7241,6761961.42,6777533.66,13539495.08
150085,201710,365,230,135,215500.63,126495,341995.63
150090,201710,766,655,111,613735,104007,717742
150095,201710,346,208,138,194139.84,128500.18,322640.02
150100,201710,52,36,16,33732,14992,48724
150110,201710,169,83,86,77771,80582,158353
150120,201710,433,319,114,298903,106818,405721
150125,201710,48,21,27,19677,25299,44976
150130,201710,1901,1009,892,945433,835799.32,1781232.32
150140,201710,54683,25433,29250,23798666.69,27393076.76,51191743.45
150145,201710,170,100,70,93700,65590,159290
150150,201710,2783,1214,1569,1137304.37,1466278.7,2603583.07
150157,201710,442,299,143,280163,133986.32,414149.32
150160,201710,120,95,25,89015,23425,112440
150170,201710,3666,2712,954,2537583.5,893616.9,3431200.4
150172,201710,307,212,95,198644,89015,287659
150175,201710,87,54,33,50598,30921,81519
150178,201710,745,491,254,459130,237998,697128
150180,201710,3002,1435,1567,1343798.8,1467974.5,2811773.3
150190,201710,334,211,123,197707,115251,312958
150195,201710,119,59,60,55283,56220,111503
150200,201710,211,99,112,92763,104944,197707
150210,201710,3113,2523,590,2363011.84,552591.75,2915603.59
150215,201710,493,330,163,308929,152731,461660
150220,201710,3967,2664,1303,2494353.9,1218832.36,3713186.26
150230,201710,1143,916,227,857722.7,212699,1070421.7
150240,201710,5695,3327,2368,3114018.57,2218803,5332821.57
150250,201710,32,16,16,14992,14992,29984
150260,201710,73,43,30,40291,28110,68401
150270,201710,2309,1511,798,1414538.14,747163.9,2161702.04
150275,201710,584,352,232,329824,217384,547208
150276,201710,100,42,58,39354,54346,93700
150277,201710,753,326,427,305443.63,400099,705542.63
150280,201710,344,210,134,196770,125558,322328
150285,201710,75,37,38,34669,35606,70275
150290,201710,963,586,377,548791.53,352968,901759.53
150293,201710,694,320,374,299418.63,350438,649856.63
150295,201710,459,200,259,187400,242551.82,429951.82
150300,201710,80,42,38,39354,35606,74960
150304,201710,138,90,48,84330,44976,129306
150307,201710,392,321,71,300777,66527,367304
150309,201710,527,377,150,353249,140550,493799
150310,201710,252,170,82,159290,76834,236124
150320,201710,1789,1230,559,1152233.59,523783,1676016.59
150330,201710,2081,1193,888,1117185.1,832056,1949241.1
150340,201710,196,128,68,119701.75,63716,183417.75
150345,201710,606,325,281,304346.97,263297,567643.97
150350,201710,426,332,94,308732.13,88078,396810.13
150360,201710,4403,2833,1570,2650918.74,1471071.26,4121990.00
150370,201710,734,524,210,490206,196479.9,686685.9
150375,201710,195,104,91,97448,85267,182715
150380,201710,1246,814,432,762718,404222,1166940
150390,201710,730,416,314,389792,294209,684001
150400,201710,98,79,19,74023,17803,91826
150405,201710,1240,817,423,764504.86,395788.8,1160293.66
150410,201710,144,94,50,88078,46850,134928
150420,201710,7297,3993,3304,3739809.44,3094674.86,6834484.30
150430,201710,473,320,153,299840,143361,443201
150440,201710,595,350,245,327201,229565,556766
150442,201710,2127,1151,976,1076575.52,914226.22,1990801.74
150445,201710,519,325,194,304525,180841,485366
150450,201710,273,128,145,119936,135865,255801
150460,201710,775,583,192,544476.66,179885.26,724361.92
150470,201710,1330,797,533,746508,499421,1245929
150475,201710,30,24,6,22488,5622,28110
150480,201710,1226,854,372,800198,348282.9,1148480.9
150490,201710,628,335,293,313895,274541,588436
150495,201710,324,222,102,208014,95574,303588
150497,201710,295,200,95,187400,89005.63,276405.63
150500,201710,429,289,140,270793,131180,401973
150503,201710,820,387,433,362338,405703,768041
150506,201710,1030,660,370,618420,346680.63,965100.63
150510,201710,1229,695,534,650934,500358,1151292
150520,201710,266,177,89,165849,83393,249242
150530,201710,1531,838,693,782395.65,648122.9,1430518.55
150540,201710,241,169,72,158353,67464,225817
150543,201710,677,374,303,349857.06,283629.9,633486.96
150548,201710,489,337,152,315769,142424,458193
150549,201710,61,42,19,39354,17803,57157
150550,201710,2884,1504,1380,1408546,1292498,2701044
150553,201710,3011,1786,1225,1671983.3,1147811.63,2819794.93
150555,201710,142,75,67,70275,62779,133054
150560,201710,54,40,14,37480,13118,50598
150563,201710,69,37,32,34669,29984,64653
150565,201710,166,98,68,91826,63716,155542
150570,201710,404,270,134,252971.26,125558,378529.26
150580,201710,1501,625,876,584969.1,820812,1405781.1
150590,201710,769,462,307,432894,287659,720553
150600,201710,447,272,175,254864,163975,418839
150610,201710,145,125,20,116292,18740,135032
150611,201710,129,90,39,84330,36543,120873
150613,201710,3136,1919,1217,1798103,1140320,2938423
150616,201710,483,300,183,280866,171471,452337
150618,201710,1122,611,511,572282.49,478807,1051089.49
150619,201710,395,300,95,281100,89015,370115
150620,201710,1279,733,546,686821,511320.9,1198141.9
150630,201710,316,213,103,199581,96511,296092
150635,201710,496,203,293,190211,274541,464752
150640,201710,62,30,32,28110,29984,58094
150650,201710,2316,1335,981,1250623.27,917974.22,2168597.49
150655,201710,251,186,65,174282,60905,235187
150658,201710,98,57,41,53409,38417,91826
150660,201710,478,331,147,310147,137739,447886
150670,201710,980,351,629,328596.9,589354.63,917951.53
150680,201710,9720,5332,4388,4989751.24,4107728.96,9097480.20
150690,201710,52,33,19,30921,17803,48724
150700,201710,547,351,196,328699.6,183652,512351.6
150710,201710,267,161,106,150857,99322,250179
150715,201710,870,522,348,488149.26,326047.89,814197.15
150720,201710,450,341,109,319517,101851.9,421368.9
150730,201710,879,466,413,436633,386699.9,823332.9
150740,201710,237,170,67,159290,62779,222069
150745,201710,775,404,371,378548,347627,726175
150746,201710,53,32,21,29984,19677,49661
150747,201710,269,209,60,195833,56220,252053
150750,201710,131,76,55,71212,51535,122747
150760,201710,1702,1099,603,1029603.11,565011,1594614.11
150770,201710,365,187,178,175219,166614.07,341833.07
150775,201710,81,39,42,36543,39354,75897
150780,201710,186,102,84,95574,78708,174282
150790,201710,906,489,417,458193,390729,848922
150795,201710,1427,827,600,774899,562200,1337099
150796,201710,410,233,177,218321,165849,384170
150797,201710,274,155,119,145235,111503,256738
150800,201710,1417,846,571,791760.31,535027,1326787.31
150803,201710,591,487,104,456319,97448,553767
150805,201710,187,117,70,109629,65576.63,175205.63
150808,201710,971,528,443,494736,415091,909827
150810,201710,3350,2301,1049,2152589.5,982613.26,3135202.76
150812,201710,426,222,204,208014,191148,399162
150815,201710,951,629,322,588019.04,301714,889733.04
150820,201710,1589,972,617,909827,578110.26,1487937.26
150830,201710,838,591,247,552830,231439,784269
150835,201710,184,109,75,102133,70275,172408
150840,201710,1292,824,468,772088,438516,1210604
160005,201710,52,31,21,29047,19677,48724
160010,201710,195,120,75,112440,70271,182711
160015,201710,115,66,49,61842,45913,107755
160020,201710,120,68,52,63716,48724,112440
160021,201710,40,21,19,19677,17803,37480
160023,201710,109,61,48,57157,44976,102133
160025,201710,34,15,19,14055,17803,31858
160027,201710,1436,819,617,763936.35,577392,1341328.35
160030,201710,15415,7861,7554,7356245.31,7072358.2,14428603.51
160040,201710,317,180,137,168660,128369,297029
160050,201710,636,329,307,308273,287377.9,595650.9
160053,201710,331,186,145,174001,135865,309866
160055,201710,19,14,5,13118,4685,17803
160060,201710,6356,3305,3051,3087045.74,2857846.1,5944891.84
160070,201710,165,99,66,92763,61842,154605
160080,201710,77,41,36,38417,33732,72149
170025,201710,21,14,7,13118,6559,19677
170030,201710,218,173,45,161907,42165,204072
170035,201710,226,108,118,100259,110566,210825
170040,201710,188,147,41,137457.9,38417,175874.9
170070,201710,330,190,140,178030,131180,309210
170100,201710,379,269,110,251819,103070,354889
170105,201710,63,52,11,48724,10307,59031
170110,201710,102,62,40,58094,37480,95574
170130,201710,72,33,39,30921,36262,67183
170190,201710,105,67,38,62779,35606,98385
170200,201710,397,267,130,249514.1,121707.78,371221.88
170210,201710,5985,3081,2904,2879357.43,2717844.33,5597201.76
170215,201710,76,39,37,36543,34669,71212
170220,201710,1441,1050,391,981488.76,366086,1347574.76
170230,201710,155,99,56,92763,52472,145235
170240,201710,564,374,190,350438,178030,528468
170255,201710,1111,888,223,832056,208669.9,1040725.9
170270,201710,38,28,10,26236,9182.6,35418.6
170290,201710,76,57,19,53409,17803,71212
170300,201710,80,52,28,47974.4,26236,74210.4
170305,201710,39,31,8,29047,7496,36543
170307,201710,61,45,16,42165,14992,57157
170310,201710,104,57,47,53409,44039,97448
170320,201710,17,13,4,12181,3748,15929
170330,201710,20,17,3,15929,2811,18740
170360,201710,22,15,7,14055,6559,20614
170370,201710,137,68,69,63716,64653,128369
170380,201710,82,58,24,54346,22488,76834
170382,201710,47,42,5,39354,4685,44039
170384,201710,124,88,36,82456,33732,116188
170386,201710,60,28,32,26236,29984,56220
170388,201710,49,17,32,15929,29984,45913
170389,201710,23,17,6,15929,5622,21551
170390,201710,48,27,21,25299,19677,44976
170410,201710,33,22,11,20614,10307,30921
170460,201710,17,12,5,11244,4685,15929
170510,201710,28,21,7,19677,6559,26236
170550,201710,1475,833,642,780521,600804.5,1381325.5
170555,201710,110,74,36,69338,33732,103070
170560,201710,100,71,29,66527,27173,93700
170600,201710,37,18,19,16866,17803,34669
170610,201710,191,102,89,95419.4,83375,178794.4
170625,201710,38,19,19,17803,17803,35606
170650,201710,85,64,21,59968,19677,79645
170700,201710,553,417,136,389745.15,127432,517177.15
170710,201710,155,95,60,89015,56211,145226
170720,201710,83,67,16,62779,14992,77771
170730,201710,56,33,23,30921,21551,52472
170740,201710,75,56,19,52472,17803,70275
170755,201710,97,47,50,43430,46850,90280
170765,201710,144,69,75,64044,70275,134319
170770,201710,229,130,99,120732.45,92763,213495.45
170820,201710,588,380,208,356060,194194,550254
170825,201710,31,20,11,18740,10307,29047
170830,201710,74,52,22,48536.6,20614,69150.6
170900,201710,204,154,50,144298,46850,191148
170930,201710,795,409,386,382915,361120,744035
170950,201710,2978,1297,1681,1212975.88,1572829.93,2785805.81
170980,201710,17,9,8,8433,7496,15929
171050,201710,126,95,31,89015,29047,118062
171070,201710,38,31,7,29047,6559,35606
171090,201710,37,26,11,24362,10307,34669
171110,201710,21,14,7,13118,6559,19677
171150,201710,36,18,18,16866,16866,33732
171180,201710,22,10,12,9370,11244,20614
171190,201710,128,76,52,71212,48724,119936
171195,201710,64,49,15,45913,14055,59968
171200,201710,46,21,25,19677,23425,43102
171215,201710,1,1,0,937,0,937
171240,201710,54,44,10,41228,9370,50598
171245,201710,49,44,5,41228,4685,45913
171250,201710,68,35,33,32795,30911.63,63706.63
171270,201710,17,13,4,12181,3748,15929
171280,201710,37,34,3,31718,2811,34529
171320,201710,990,559,431,523783,402910,926693
171330,201710,420,200,220,187400,206140,393540
171360,201710,84,63,21,59031,19677,78708
171370,201710,23,12,11,11244,10307,21551
171380,201710,128,103,25,96511,23199.19,119710.19
171395,201710,56,34,22,31858,20614,52472
171420,201710,314,206,108,193022,100914.9,293936.9
171430,201710,63,51,12,47787,11244,59031
171488,201710,211,110,101,103070,94637,197707
171500,201710,58,32,26,29984,24362,54346
171510,201710,67,44,23,41228,21551,62779
171515,201710,44,37,7,34669,6559,41228
171525,201710,30,26,4,24362,3748,28110
171550,201710,13,7,6,6559,5622,12181
171570,201710,59,29,30,27173,28110,55283
171575,201710,344,208,136,194756,127422.63,322178.63
171610,201710,1678,833,845,778655.83,790196.99,1568852.82
171620,201710,131,89,42,82849.54,39072.9,121922.44
171630,201710,53,28,25,26236,23425,49661
171650,201710,276,179,97,167723,90889,258612
171660,201710,256,134,122,125558,114314,239872
171665,201710,43,28,15,26236,14055,40291
171670,201710,434,253,181,235412.13,169034.8,404446.93
171700,201710,61,54,7,50598,6559,57157
171720,201710,23,8,15,7496,14055,21551
171750,201710,103,56,47,52472,44039,96511
171780,201710,68,55,13,51535,12181,63716
171790,201710,81,67,14,62779,13118,75897
171800,201710,35,26,9,24362,8433,32795
171820,201710,2008,1142,866,1069357.47,806917.21,1876274.68
171830,201710,37,29,8,27173,7496,34669
171840,201710,61,34,27,31858,25299,57157
171845,201710,33,21,12,19677,11244,30921
171850,201710,38,26,12,24362,11244,35606
171855,201710,71,57,14,53409,13118,66527
171865,201710,7,6,1,5622,937,6559
171870,201710,31,22,9,20614,8433,29047
171875,201710,79,54,25,50598,23425,74023
171880,201710,26,19,7,17803,6559,24362
171884,201710,44,22,22,20614,20614,41228
171886,201710,112,40,72,37480,67182.9,104662.9
171888,201710,21,15,6,14055,5622,19677
171889,201710,20,15,5,14055,4685,18740
171890,201710,56,45,11,42165,10307,52472
171900,201710,42,29,13,27173,12181,39354
172000,201710,41,35,6,32795,5622,38417
172010,201710,39,32,7,29187.55,6559,35746.55
172015,201710,27,16,11,14992,10025.9,25017.9
172020,201710,127,78,49,73086,45913,118999
172025,201710,34,21,13,19677,12181,31858
172030,201710,33,19,14,17803,13118,30921
172049,201710,75,46,29,43102,27173,70275
172065,201710,150,98,52,91826,48724,140550
172080,201710,81,59,22,54122.02,20614,74736.02
172085,201710,25,13,12,12181,11244,23425
172090,201710,405,305,100,285785,92951,378736
172093,201710,27,18,9,16866,8433,25299
172097,201710,17,8,9,7496,8152,15648
172100,201710,4612,2578,2034,2409019.02,1903136.93,4312155.95
172110,201710,81,54,27,50598,25299,75897
172120,201710,1744,1494,250,1394151.2,233162.14,1627313.34
172125,201710,2,2,0,1874,0,1874
172130,201710,13,11,2,10307,1874,12181
172208,201710,187,122,65,114314,60905,175219
172210,201710,463,219,244,205203,228347,433550
210005,201710,2936,1825,1111,1706745.76,1038197,2744942.76
210010,201710,199,100,99,93700,92763,186463
210015,201710,27,18,9,16866,8433,25299
210020,201710,352,177,175,165849,163975,329824
210030,201710,343,213,130,199581,121801,321382
210040,201710,157,121,36,113377,33732,147109
210043,201710,253,170,83,159290,77771,237061
210047,201710,621,307,314,287284.2,294208.63,581492.83
210050,201710,293,211,82,197707,76834,274541
210055,201710,41,31,10,29047,9370,38417
210060,201710,570,437,133,409371.56,124621,533992.56
210070,201710,416,299,117,280163,109347.9,389510.9
210080,201710,104,95,9,89015,8433,97448
210083,201710,312,127,185,118999,173345,292344
210087,201710,50,34,16,31858,14992,46850
210090,201710,495,338,157,316706,147109,463815
210095,201710,498,353,145,330751.63,135865,466616.63
210100,201710,686,515,171,482227.05,159290.35,641517.40
210110,201710,151,80,71,74960,66527,141487
210120,201710,5529,4125,1404,3859919.6,1314598.14,5174517.74
210125,201710,218,120,98,112440,91826,204266
210130,201710,568,290,278,270793,260486,531279
210135,201710,33,19,14,17803,13118,30921
210140,201710,4087,3174,913,2970899.22,854959,3825858.22
210150,201710,357,224,133,209888,124448,334336
210160,201710,3347,2796,551,2617043.68,516006,3133049.68
210170,201710,1121,860,261,805820,244557,1050377
210173,201710,115,95,20,89015,18740,107755
210177,201710,481,228,253,213636,237061,450697
210180,201710,30,16,14,14992,13118,28110
210190,201710,404,255,149,238935,139613,378548
210193,201710,0,0,0,0,0,0
210197,201710,83,56,27,52472,25299,77771
210200,201710,650,511,139,478807,130243,609050
210203,201710,272,176,96,164912,89952,254864
210207,201710,378,290,88,271730,82456,354186
210210,201710,768,695,73,651215,68401,719616
210215,201710,75,62,13,58094,12181,70275
210220,201710,397,324,73,303588,68401,371989
210230,201710,304,222,82,208014,76834,284848
210232,201710,1504,938,566,878625,530342,1408967
210235,201710,152,116,36,108505,33732,142237
210237,201710,45,25,20,23425,18740,42165
210240,201710,96,78,18,73086,16866,89952
210250,201710,179,140,39,131180,36543,167723
210255,201710,324,235,89,220195,83393,303588
210260,201710,435,259,176,242683,164912,407595
210270,201710,704,441,263,413217,246431,659648
210275,201710,41,32,9,29984,8433,38417
210280,201710,1033,652,381,608159.45,355685.25,963844.70
210290,201710,498,313,185,293281,173345,466626
210300,201710,6157,3532,2625,3304929.94,2458436.37,5763366.31
210310,201710,102,69,33,64653,30921,95574
210312,201710,131,79,52,74023,48724,122747
210315,201710,118,84,34,78708,31858,110566
210317,201710,121,85,36,79645,33732,113377
210320,201710,2396,1952,444,1827344.98,414810,2242154.98
210325,201710,128,84,44,77771,40947,118718
210330,201710,5768,2851,2917,2666641.65,2733219.63,5399861.28
210340,201710,1438,1013,425,948395,398154.85,1346549.85
210350,201710,605,488,117,457021.75,109629,566650.75
210355,201710,128,100,28,93700,26236,119936
210360,201710,2700,1669,1031,1560762.36,965766,2526528.36
210370,201710,1275,527,748,493799,700220.1,1194019.1
210375,201710,191,100,91,93166,85267,178433
210380,201710,737,545,192,510665,179904,690569
210390,201710,195,158,37,148046,34669,182715
210400,201710,409,340,69,318580,64653,383233
210405,201710,992,651,341,609393.87,319517,928910.87
210407,201710,54,42,12,39354,11244,50598
210408,201710,69,62,7,58094,6559,64653
210409,201710,319,263,56,246431,52472,298903
210410,201710,433,334,99,312958,92754,405712
210420,201710,193,156,37,146172,34669,180841
210430,201710,33,25,8,23425,7496,30921
210440,201710,382,225,157,210825,147109,357934
210450,201710,146,109,37,102133,34669,136802
210455,201710,211,114,97,106818,90889,197707
210460,201710,344,213,131,199581,122743,322324
210462,201710,56,46,10,43102,9370,52472
210465,201710,185,130,55,121810,51535,173345
210467,201710,525,372,153,348564,143361,491925
210470,201710,46,34,12,31858,11244,43102
210480,201710,1288,897,391,840489,366367,1206856
210490,201710,225,133,92,124621,86204,210825
210500,201710,574,294,280,275478,262360,537838
210510,201710,555,424,131,397288,122747,520035
210515,201710,449,237,212,222069,198644,420713
210520,201710,405,349,56,326731.9,52472,379203.9
210530,201710,9358,4999,4359,4670762.65,4079216.72,8749979.37
210535,201710,137,97,40,90889,37480,128369
210540,201710,1541,916,625,857168.4,584219.5,1441387.9
210542,201710,1158,595,563,557140.2,527531,1084671.2
210545,201710,13,12,1,11244,937,12181
210547,201710,135,116,19,108692,17803,126495
210550,201710,754,521,233,485888.9,218321,704209.9
210560,201710,175,143,32,133991,29984,163975
210565,201710,30,21,9,19677,8433,28110
210570,201710,1379,1070,309,1002590,289523.63,1292113.63
210580,201710,108,93,15,87141,14055,101196
210590,201710,775,601,174,562387.4,163038,725425.4
210592,201710,32,29,3,27173,2811,29984
210594,201710,99,82,17,76834,15929,92763
210596,201710,80,68,12,63716,11244,74960
210598,201710,124,89,35,83393,32795,116188
210600,201710,349,292,57,273604,53409,327013
210610,201710,245,228,17,212699,15929,228628
210620,201710,48,28,20,26236,18740,44976
210630,201710,63,59,4,55283,3748,59031
210632,201710,1142,732,410,685884,383403.4,1069287.4
210635,201710,15,12,3,11244,2811,14055
210637,201710,106,74,32,69338,29984,99322
210640,201710,588,510,78,477870,73086,550956
210650,201710,405,323,82,302463.6,75897,378360.6
210660,201710,408,288,120,269201,112319,381520
210663,201710,18,11,7,10307,6559,16866
210667,201710,119,37,82,34669,76834,111503
210670,201710,269,237,32,221367,29984,251351
210675,201710,562,286,276,267982,258612,526594
210680,201710,220,136,84,127432,78708,206140
210690,201710,649,504,145,472248,135865,608113
210700,201710,193,140,53,131180,49661,180841
210710,201710,311,171,140,159758.5,131180,290938.5
210720,201710,126,104,22,97448,20614,118062
210725,201710,64,58,6,54346,5622,59968
210730,201710,23,17,6,15929,5622,21551
210735,201710,414,271,143,253927,133710,387637
210740,201710,541,457,84,428209,78708,506917
210745,201710,149,105,44,98385,41228,139613
210750,201710,2416,1069,1347,999733,1262120.26,2261853.26
210760,201710,281,203,78,190211,73071.95,263282.95
210770,201710,404,309,95,288596,88733.9,377329.9
210780,201710,420,301,119,282037,111503,393540
210790,201710,186,142,44,133054,41228,174282
210800,201710,133,100,33,93700,30921,124621
210805,201710,41,38,3,35606,2811,38417
210810,201710,489,367,122,343223.1,114314,457537.1
210820,201710,2313,1815,498,1693479.32,466626,2160105.32
210825,201710,175,88,87,82456,81519,163975
210830,201710,816,485,331,453508,309210,762718
210840,201710,219,143,76,133991,71212,205203
210845,201710,256,152,104,142424,97448,239872
210850,201710,874,557,317,521909,297029,818938
210860,201710,4174,2099,2075,1965544.9,1943975.16,3909520.06
210870,201710,472,351,121,328887,113377,442264
210880,201710,55,37,18,34669,16866,51535
210890,201710,344,281,63,263297,59031,322328
210900,201710,549,350,199,327950,186463,514413
210905,201710,77,35,42,32795,39354,72149
210910,201710,1993,1460,533,1367253.99,499421,1866674.99
210920,201710,233,67,166,62779,155542,218321
210923,201710,77,56,21,52472,19677,72149
210927,201710,447,175,272,163975,254864,418839
210930,201710,58,45,13,42165,12181,54346
210940,201710,92,68,24,63716,22488,86204
210945,201710,202,90,112,84330,104944,189274
210950,201710,503,359,144,336383,134923.32,471306.32
210955,201710,75,49,26,45913,24362,70275
210960,201710,2476,1007,1469,941966.7,1376172,2318138.7
210970,201710,112,95,17,89015,15929,104944
210975,201710,84,75,9,70275,8433,78708
210980,201710,1277,532,745,498371.56,697784,1196155.56
210990,201710,4448,2716,1732,2544143,1622884,4167027
211000,201710,1397,1093,304,1023860,284567,1308427
211003,201710,919,621,298,581877,279217,861094
211010,201710,469,409,60,383233,56220,439453
211020,201710,1619,571,1048,535027,981760.49,1516787.49
211023,201710,26,22,4,20332.9,3748,24080.9
211027,201710,61,38,23,35606,21551,57157
211030,201710,386,253,133,237061,124621,361682
211040,201710,315,235,80,219914,74960,294874
211050,201710,1203,741,462,694317,432608.32,1126925.32
211060,201710,686,580,106,543460,99322,642782
211065,201710,24,20,4,18740,3748,22488
211070,201710,913,736,177,688049.97,165849,853898.97
211080,201710,89,85,4,79645,3748,83393
211085,201710,59,31,28,28766,26236,55002
211090,201710,94,76,18,71212,16866,88078
211100,201710,499,398,101,372926,94637,467563
211102,201710,275,179,96,167723,89952,257675
211105,201710,207,139,68,130243,63716,193959
211107,201710,135,75,60,70275,56220,126495
211110,201710,816,523,293,489489,274532,764021
211120,201710,5866,2373,3493,2218329.87,3271869.32,5490199.19
211125,201710,33,26,7,24362,6559,30921
211130,201710,46416,18814,27602,17597246.89,25849794.46,43447041.35
211140,201710,441,366,75,342463.41,70275,412738.41
211150,201710,1257,778,479,728658.05,448538,1177196.05
211153,201710,174,99,75,92763,70275,163038
211157,201710,56,40,16,37480,14992,52472
211160,201710,697,571,126,534078.25,118062,652140.25
211163,201710,0,0,0,0,0,0
211167,201710,5,3,2,2811,1874,4685
211170,201710,446,303,143,283911,133991,417902
211172,201710,121,80,41,74960,38417,113377
211174,201710,287,163,124,152731,116188,268919
211176,201710,528,368,160,344816,149920,494736
211178,201710,98,61,37,57157,34669,91826
211180,201710,208,160,48,149920,44816.71,194736.71
211190,201710,62,57,5,53409,4685,58094
211195,201710,24,14,10,13118,9370,22488
211200,201710,155,134,21,125220.68,19677,144897.68
211210,201710,640,316,324,295436.1,303588,599024.1
211220,201710,3948,2199,1749,2052781.29,1631542.98,3684324.27
211223,201710,95,88,7,82277.97,6559,88836.97
211227,201710,70,48,22,44976,20614,65590
211230,201710,786,633,153,592980.45,143342.26,736322.71
211240,201710,423,313,110,293281,103070,396351
211245,201710,213,90,123,84330,115251,199581
211250,201710,1651,1398,253,1309080,237061,1546141
211260,201710,800,627,173,587499,162101,749600
211270,201710,2110,1635,475,1531995,444138.1,1976133.1
211280,201710,1822,1079,743,1009150.08,696191,1705341.08
211285,201710,213,121,92,113377,85922.9,199299.9
211290,201710,696,461,235,431769.6,220195,651964.6
211300,201710,813,614,199,575045.7,186463,761508.7
211400,201710,1630,893,737,836741,690569,1527310
220005,201710,19,18,1,16866,937,17803
220010,201710,92,70,22,65590,20332.9,85922.9
220020,201710,555,436,119,407938.6,111503,519441.6
220025,201710,108,104,4,97448,3748,101196
220027,201710,43,36,7,33732,6559,40291
220030,201710,90,74,16,69338,14992,84330
220040,201710,1102,814,288,760544.88,269856,1030400.88
220045,201710,36,27,9,25299,8433,33732
220050,201710,647,521,126,487035.88,118043.26,605079.14
220060,201710,171,145,26,135865,24362,160227
220070,201710,106,97,9,90889,8433,99322
220080,201710,8,7,1,6559,937,7496
220090,201710,34,27,7,25018,6559,31577
220095,201710,3,2,1,1874,937,2811
220100,201710,28,24,4,22488,3748,26236
220105,201710,40,37,3,34669,2811,37480
220110,201710,207,190,17,177748.9,15929,193677.9
220115,201710,42,39,3,36543,2811,39354
220117,201710,21,20,1,18740,937,19677
220120,201710,1534,1050,484,983232.51,453489.26,1436721.77
220130,201710,25,24,1,22488,937,23425
220140,201710,98,78,20,72149,18740,90889
220150,201710,444,313,131,293281,122747,416028
220155,201710,4,4,0,3748,0,3748
220157,201710,20,16,4,14992,3748,18740
220160,201710,73,64,9,59968,8433,68401
220170,201710,33,31,2,29047,1874,30921
220173,201710,8,8,0,7496,0,7496
220177,201710,5,5,0,4685,0,4685
220180,201710,66,65,1,60896.32,937,61833.32
220190,201710,1045,936,109,877032,101383.4,978415.4
220191,201710,42,37,5,34669,4685,39354
220192,201710,63,60,3,56220,2811,59031
220194,201710,23,19,4,17803,3748,21551
220196,201710,102,84,18,78568,16866,95434
220198,201710,6,4,2,3748,1874,5622
220200,201710,428,345,83,323986,77771,401757
220202,201710,38,34,4,31858,3748,35606
220205,201710,38,33,5,30921,4685,35606
220207,201710,20,19,1,17803,937,18740
220208,201710,84,43,41,40291,38417,78708
220209,201710,32,29,3,27173,2811,29984
220210,201710,15,14,1,13118,937,14055
220211,201710,43,42,1,39354,937,40291
220213,201710,44,38,6,35606,5622,41228
220217,201710,37,29,8,27173,7496,34669
220220,201710,1986,1261,725,1178016.04,677671.76,1855687.80
220225,201710,14,6,8,5622,7496,13118
220230,201710,925,739,186,692002.61,173654.21,865656.82
220240,201710,141,128,13,119936,12181,132117
220245,201710,44,40,4,37102,3748,40850
220250,201710,112,99,13,92763,12181,104944
220253,201710,42,34,8,31858,7496,39354
220255,201710,31,26,5,24362,4685,29047
220260,201710,690,503,187,471311,175219,646530
220265,201710,14,10,4,9370,3748,13118
220270,201710,645,571,74,534314.88,68869.5,603184.38
220271,201710,47,38,9,35606,8433,44039
220272,201710,27,26,1,24362,937,25299
220273,201710,16,13,3,12181,2811,14992
220275,201710,48,37,11,34669,10307,44976
220277,201710,10,8,2,7496,1874,9370
220280,201710,16,14,2,13118,1874,14992
220285,201710,46,43,3,40291,2811,43102
220290,201710,1386,1185,201,1107863,188291,1296154
220300,201710,60,58,2,54346,1874,56220
220310,201710,303,253,50,237057,46841,283898
220320,201710,431,397,34,370584.5,31858,402442.5
220323,201710,0,0,0,0,0,0
220325,201710,14,9,5,8433,4685,13118
220327,201710,11,10,1,9370,937,10307
220330,201710,196,132,64,123402.9,59968,183370.9
220335,201710,139,122,17,114314,15929,130243
220340,201710,23,12,11,11244,10307,21551
220342,201710,55,46,9,43102,8433,51535
220345,201710,94,81,13,75897,12181,88078
220350,201710,433,382,51,355358.01,47787,403145.01
220360,201710,41,30,11,28110,10307,38417
220370,201710,1069,849,220,794576,206140,1000716
220375,201710,28,27,1,25299,937,26236
220380,201710,34,27,7,25299,6559,31858
220385,201710,28,24,4,22488,3748,26236
220390,201710,2211,1255,956,1171325.2,894414.25,2065739.45
220400,201710,28,26,2,24362,1874,26236
220410,201710,14,12,2,11244,1874,13118
220415,201710,12,11,1,10307,937,11244
220420,201710,129,108,21,101196,19395.9,120591.9
220430,201710,129,116,13,107053.4,12181,119234.4
220435,201710,26,19,7,17799,6559,24358
220440,201710,290,247,43,231439,40291,271730
220450,201710,317,167,150,155334.74,140550,295884.74
220455,201710,56,54,2,50598,1874,52472
220460,201710,20,19,1,17147.1,937,18084.1
220465,201710,106,67,39,62779,36543,99322
220470,201710,243,212,31,197707.8,29047,226754.8
220480,201710,72,61,11,57157,10307,67464
220490,201710,85,74,11,68581,10307,78888
220500,201710,99,86,13,80582,12181,92763
220510,201710,376,300,76,280351,71024.6,351375.6
220515,201710,21,17,4,15929,3748,19677
220520,201710,364,326,38,303928,35588,339516
220525,201710,27,19,8,17803,7496,25299
220527,201710,37,29,8,27173,6700,33873
220530,201710,34,12,22,11244,20614,31858
220535,201710,14,13,1,12181,937,13118
220540,201710,61,48,13,44976,12181,57157
220545,201710,64,41,23,38417,21551,59968
220550,201710,622,472,150,441514.4,140550,582064.4
220551,201710,27,20,7,18740,6559,25299
220552,201710,8,8,0,7496,0,7496
220553,201710,57,51,6,47787,5622,53409
220554,201710,14,9,5,8151.9,4685,12836.9
220555,201710,23,19,4,17803,3748,21551
220556,201710,59,55,4,51535,3748,55283
220557,201710,56,50,6,46850,5622,52472
220558,201710,7,2,5,1874,4685,6559
220559,201710,6,5,1,4685,937,5622
220560,201710,55,36,19,33544.6,17803,51347.6
220570,201710,778,458,320,428900.14,299840,728740.14
220580,201710,593,537,56,503169,51517.26,554686.26
220585,201710,6,5,1,4685,937,5622
220590,201710,14,14,0,13118,0,13118
220595,201710,59,44,15,41228,14055,55283
220600,201710,18,9,9,8433,8433,16866
220605,201710,21,20,1,18740,937,19677
220610,201710,59,51,8,47787,7496,55283
220620,201710,552,429,123,401738.75,115251,516989.75
220630,201710,8,6,2,5622,1874,7496
220635,201710,35,32,3,29984,2811,32795
220640,201710,98,74,24,69338,22488,91826
220650,201710,116,109,7,102133,6559,108692
220660,201710,25,19,6,17803,5622,23425
220665,201710,5,4,1,3748,937,4685
220667,201710,11,11,0,10307,0,10307
220669,201710,22,19,3,17803,2811,20614
220670,201710,68,53,15,49473.6,14055,63528.6
220672,201710,53,37,16,34669,14992,49661
220675,201710,35,27,8,25299,7496,32795
220680,201710,32,27,5,25299,4685,29984
220690,201710,50,46,4,43102,3748,46850
220695,201710,65,31,34,29047,31858,60905
220700,201710,1495,1145,350,1071056.59,327950,1399006.59
220710,201710,4,2,2,1874,1874,3748
220720,201710,120,97,23,90654.75,21410.45,112065.20
220730,201710,19,18,1,16866,937,17803
220735,201710,3,1,2,937,1874,2811
220740,201710,39,37,2,34669,1874,36543
220750,201710,100,82,18,76834,16866,93700
220755,201710,16,16,0,14992,0,14992
220760,201710,49,46,3,43102,2811,45913
220770,201710,5678,2816,2862,2633099.52,2675947.13,5309046.65
220775,201710,27,13,14,12181,13118,25299
220777,201710,15,14,1,13118,937,14055
220779,201710,18,14,4,13118,3748,16866
220780,201710,869,739,130,691787.1,121529,813316.1
220785,201710,8,5,3,4685,2811,7496
220790,201710,1010,799,211,746305,197707,944012
220793,201710,14,14,0,13118,0,13118
220795,201710,25,24,1,22488,937,23425
220800,201710,3798,2887,911,2703786.2,852652.74,3556438.94
220810,201710,55,50,5,46850,4685,51535
220820,201710,238,215,23,201455,21551,223006
220830,201710,1139,960,179,899515.32,167705,1067220.32
220840,201710,2412,1590,822,1477419.1,768153,2245572.1
220850,201710,52,41,11,38417,10307,48724
220855,201710,15,10,5,9370,4685,14055
220860,201710,9,8,1,7496,937,8433
220865,201710,21,19,2,17803,1874,19677
220870,201710,57,54,3,50598,2811,53409
220880,201710,335,253,82,236405.1,76553,312958.1
220885,201710,44,38,6,35606,5622,41228
220887,201710,19,18,1,16866,937,17803
220890,201710,103,91,12,85267,11244,96511
220900,201710,46,26,20,24362,18740,43102
220910,201710,54,45,9,42165,8433,50598
220915,201710,11,10,1,9370,937,10307
220920,201710,40,36,4,33732,3748,37480
220930,201710,41,40,1,37480,937,38417
220935,201710,19,18,1,16866,937,17803
220937,201710,44,41,3,38417,2811,41228
220940,201710,46,43,3,40291,2811,43102
220945,201710,0,0,0,0,0,0
220950,201710,47,43,4,40291,3748,44039
220955,201710,39,36,3,33732,2811,36543
220960,201710,3,3,0,2811,0,2811
220965,201710,28,24,4,22488,3748,26236
220970,201710,47,38,9,35606,8433,44039
220975,201710,9,8,1,7496,937,8433
220980,201710,37,34,3,31858,2811,34669
220985,201710,64,57,7,53409,6559,59968
220987,201710,31,30,1,28110,937,29047
220990,201710,12,11,1,10307,937,11244
220995,201710,39,33,6,30921,5622,36543
220997,201710,36,29,7,27173,6559,33732
221000,201710,1082,971,111,907253.81,103725.9,1010979.71
221005,201710,66,61,5,57157,4685,61842
221010,201710,15,13,2,12181,1874,14055
221020,201710,51,48,3,44976,2811,47787
221030,201710,36,29,7,27173,6559,33732
221035,201710,20,19,1,17803,937,18740
221037,201710,12,6,6,5622,5622,11244
221038,201710,21,19,2,17803,1874,19677
221039,201710,24,24,0,22488,0,22488
221040,201710,248,213,35,199581,32795,232376
221050,201710,231,194,37,181778,34669,216447
221060,201710,1590,1394,196,1305362.81,183652,1489014.81
221062,201710,30,29,1,27173,937,28110
221063,201710,16,12,4,11244,3748,14992
221065,201710,44,38,6,35606,5622,41228
221070,201710,153,132,21,123684,19677,143361
221080,201710,373,326,47,305462,43757.9,349219.9
221090,201710,40,39,1,36291,937,37228
221093,201710,70,48,22,44976,20614,65590
221095,201710,11,10,1,9370,937,10307
221097,201710,25,22,3,20614,2811,23425
221100,201710,24207,13830,10377,12936022.83,9717798.64,22653821.47
221110,201710,1013,738,275,691225,257675,948900
221120,201710,513,380,133,355779,124621,480400
221130,201710,914,744,170,695601.69,158635,854236.69
221135,201710,34,31,3,29047,2811,31858
221140,201710,40,31,9,29047,8433,37480
221150,201710,15,11,4,10307,3748,14055
221160,201710,11,11,0,10307,0,10307
221170,201710,12,12,0,11244,0,11244
230010,201710,157,146,11,136802,10307,147109
230015,201710,115,95,20,89015,18740,107755
230020,201710,1503,1289,214,1204983,199756.88,1404739.88
230030,201710,1588,1138,450,1060836.62,421650,1482486.62
230040,201710,197,174,23,162101,21551,183652
230050,201710,198,145,53,135865,49661,185526
230060,201710,143,116,27,107942.4,25299,133241.4
230070,201710,283,251,32,235187,29984,265171
230075,201710,784,686,98,640816,91544.9,732360.9
230080,201710,171,150,21,140550,19677,160227
230090,201710,90,62,28,57344.4,26236,83580.4
230100,201710,1899,1130,769,1056564,720553,1777117
230110,201710,2616,1661,955,1553059.6,894272.9,2447332.5
230120,201710,921,728,193,679793.91,180823,860616.91
230125,201710,136,110,26,103070,24362,127432
230130,201710,447,400,47,374800,44039,418839
230140,201710,208,180,28,168660,26236,194896
230150,201710,151,120,31,112440,29047,141487
230160,201710,898,787,111,736716.5,104007,840723.5
230170,201710,574,528,46,490991.1,43102,534093.1
230180,201710,77,72,5,67464,4685,72149
230185,201710,395,341,54,318176.16,50598,368774.16
230190,201710,2153,1737,416,1624193.69,389480,2013673.69
230195,201710,485,423,62,396351,58094,454445
230200,201710,364,317,47,296082.63,43374,339456.63
230205,201710,339,211,128,195968.86,119936,315904.86
230210,201710,1241,991,250,927451.16,233500.4,1160951.56
230220,201710,1345,942,403,881904.4,377611,1259515.4
230230,201710,900,794,106,742354.85,99322,841676.85
230240,201710,1610,1388,222,1298902.85,208014,1506916.85
230250,201710,1742,1424,318,1330959.47,297685,1628644.47
230260,201710,2861,1694,1167,1582178.79,1092542.75,2674721.54
230270,201710,1319,1063,256,993478.73,236827.95,1230306.68
230280,201710,2671,1982,689,1851795.97,644656,2496451.97
230290,201710,395,357,38,327545.09,35606,363151.09
230300,201710,505,372,133,347327.16,124621,471948.16
230310,201710,412,309,103,289106.67,96230,385336.67
230320,201710,880,755,125,704366.17,117116,821482.17
230330,201710,289,233,56,217571.4,52285,269856.4
230340,201710,450,360,90,335634.4,84330,419964.4
230350,201710,2956,1858,1098,1740927.26,1026016.24,2766943.50
230360,201710,250,218,32,203372,29984,233356
230365,201710,149,118,31,109864,29047,138911
230370,201710,9471,4589,4882,4290676.84,4570335.91,8861012.75
230380,201710,456,392,64,367023,59031.8,426054.8
230390,201710,491,268,223,249345.07,208951,458296.07
230393,201710,271,225,46,209985.4,43102,253087.4
230395,201710,330,269,61,251810,57157,308967
230400,201710,599,475,124,443201,115700.76,558901.76
230410,201710,2561,1590,971,1484303.14,909546,2393849.14
230420,201710,5780,3741,2039,3485959.69,1906043.9,5392003.59
230423,201710,298,258,40,239872.8,37480,277352.8
230425,201710,335,278,57,260486,53409,313895
230426,201710,105,95,10,88302.88,9088.9,97391.78
230427,201710,77,74,3,69338,2811,72149
230428,201710,1323,683,640,639746.12,599680,1239426.12
230430,201710,436,347,89,324948,82629.34,407577.34
230435,201710,763,533,230,498381,214292.17,712673.17
230440,201710,82047,36020,46027,33669328.26,43087015.89,76756344.15
230445,201710,259,181,78,169409.6,73086,242495.6
230450,201710,541,438,103,410406,96511,506917
230460,201710,57,47,10,44039,9370,53409
230465,201710,291,235,56,220195,52472,272667
230470,201710,1802,1397,405,1308989,378116.49,1687105.49
230480,201710,145,140,5,130898.9,4685,135583.9
230490,201710,274,224,50,209888,46850,256738
230495,201710,425,320,105,299003,98385,397388
230500,201710,928,696,232,650278,217375,867653
230510,201710,42,35,7,32795,6559,39354
230520,201710,386,305,81,285785,75897,361682
230523,201710,1890,1200,690,1122909.4,646090,1768999.4
230526,201710,284,237,47,222069,43262,265331
230530,201710,666,500,166,465541.38,154605.6,620146.98
230533,201710,175,168,7,157416,6559,163975
230535,201710,338,254,84,237998,78708,316706
230540,201710,1828,1596,232,1492853.7,217102.9,1709956.6
230550,201710,3611,2303,1308,2149576.56,1224003.1,3373579.66
230560,201710,580,442,138,412093.4,128369.85,540463.25
230565,201710,183,133,50,124621,46850,171471
230570,201710,305,270,35,252990,32795,285785
230580,201710,1088,802,286,750040.39,266763.9,1016804.29
230590,201710,926,719,207,669535.05,193490.5,863025.55
230600,201710,250,229,21,213842.32,19677,233519.32
230610,201710,324,259,65,242496,60905,303401
230620,201710,160,131,29,121810,27173,148983
230625,201710,706,510,196,476512.25,182519.04,659031.29
230630,201710,1214,956,258,895491,241371.2,1136862.2
230640,201710,3396,2946,450,2753297.31,420905.09,3174202.40
230650,201710,385,337,48,314952.49,44976,359928.49
230655,201710,611,531,80,496610.4,74880.85,571491.25
230660,201710,326,272,54,254864,50316.9,305180.9
230670,201710,416,374,42,350438,39354,389792
230680,201710,203,186,17,174282,15929,190211
230690,201710,840,735,105,688695,98385,787080
230700,201710,706,603,103,564992.26,95948.8,660941.06
230710,201710,724,682,42,638847,39354,678201
230720,201710,141,119,22,111306.23,20614,131920.23
230725,201710,221,174,47,163038,44030,207068
230730,201710,11457,6201,5256,5793968.84,4916470.53,10710439.37
230740,201710,645,514,131,481337,122068.63,603405.63
230750,201710,784,668,116,624745.15,108692,733437.15
230760,201710,1255,1086,169,1013608.59,158353,1171961.59
230763,201710,325,267,58,248259.2,54346,302605.2
230765,201710,6652,3081,3571,2881100.25,3344060.1,6225160.35
230770,201710,4917,2517,2400,2348754.76,2246139.14,4594893.90
230780,201710,673,594,79,553494.47,74023,627517.47
230790,201710,184,148,36,138676,32945.66,171621.66
230800,201710,1096,799,297,748639.58,278289,1026928.58
230810,201710,1253,1113,140,1041897.15,130992.6,1172889.75
230820,201710,318,226,92,210826,86204,297030
230830,201710,929,807,122,752708.02,114314,867022.02
230835,201710,272,236,36,220195,33030,253225
230837,201710,162,135,27,126495,25299,151794
230840,201710,869,691,178,646249.5,165568,811817.5
230850,201710,1445,1267,178,1186897.9,166505,1353402.9
230860,201710,309,226,83,211762,76834.25,288596.25
230870,201710,1762,1492,270,1396786,251678.4,1648464.4
230880,201710,23,17,6,15929,5622,21551
230890,201710,565,521,44,488056.98,41214,529270.98
230900,201710,263,202,61,189274,56964,246238
230910,201710,190,154,36,143548.4,33732,177280.4
230920,201710,391,309,82,289533,76834,366367
230930,201710,907,648,259,604365.92,242683,847048.92
230940,201710,823,663,160,621231,149733,770964
230945,201710,448,377,71,353062,66527,419589
230950,201710,370,315,55,295155,51535,346690
230960,201710,2415,1626,789,1516953.51,739012,2255965.51
230970,201710,1694,954,740,893002.45,692517.96,1585520.41
230980,201710,204,172,32,161164,29984,191148
230990,201710,139,112,27,104944,24555.95,129499.95
231000,201710,200,181,19,167723.74,17803,185526.74
231010,201710,131,103,28,95948.8,26236,122184.8
231020,201710,1238,862,376,806101.5,352312,1158413.5
231025,201710,915,684,231,638781.6,214929.9,853711.5
231030,201710,1138,955,183,894831,171190,1066021
231040,201710,137,94,43,87347.14,39573,126920.14
231050,201710,1008,894,114,836086.5,106818,942904.5
231060,201710,139,122,17,114314,15929,130243
231070,201710,1385,976,409,912227.24,383233,1295460.24
231080,201710,259,242,17,225957.55,15929,241886.55
231085,201710,523,330,193,308274,180841,489115
231090,201710,225,190,35,178030,32795,210825
231095,201710,164,130,34,121810,31858,153668
231100,201710,122,100,22,93700,19395.9,113095.9
231110,201710,333,287,46,267424.39,43102,310526.39
231120,201710,298,256,42,238930.88,39167,278097.88
231123,201710,131,125,6,117125,5622,122747
231126,201710,275,237,38,222069,35606,257675
231130,201710,4506,3500,1006,3270976.28,941300.93,4212277.21
231135,201710,202,173,29,162101,25931.2,188032.2
231140,201710,3017,2224,793,2080285.31,742066.52,2822351.83
231150,201710,345,330,15,309210,14055,323265
231160,201710,1185,936,249,874034.35,233088.12,1107122.47
231170,201710,537,348,189,326076,177093,503169
231180,201710,1533,1293,240,1210651.4,224880,1435531.4
231190,201710,209,186,23,174282,21551,195833
231195,201710,208,181,27,168885.91,25299,194184.91
231200,201710,816,671,145,628727,134627,763354
231210,201710,600,501,99,468500,92763,561263
231220,201710,1005,730,275,683055.26,257675,940730.26
231230,201710,1349,1086,263,1016215.3,245681.4,1261896.7
231240,201710,1318,956,362,895490.9,337976.1,1233467.0
231250,201710,107,100,7,93700,6559,100259
231260,201710,298,192,106,179904,99041,278945
231270,201710,978,818,160,762126.49,149911,912037.49
231280,201710,53,41,12,38417,11244,49661
231290,201710,7107,3909,3198,3654727.83,2995159.45,6649887.28
231300,201710,618,570,48,534090,44976,579066
231310,201710,689,642,47,600359,44039,644398
231320,201710,552,430,122,402443,114314,516757
231325,201710,86,75,11,70275,10307,80582
231330,201710,1992,1545,447,1442188.19,415936.3,1858124.49
231335,201710,243,214,29,200518,27173,227691
231340,201710,1548,1143,405,1069305.24,379485,1448790.24
231350,201710,1120,917,203,859229,189649,1048878
231355,201710,383,334,49,312958,45913,358871
231360,201710,459,363,96,337469.1,89952,427421.1
231370,201710,88,71,17,66527,15929,82456
231375,201710,280,203,77,190211,72149,262360
231380,201710,428,351,77,327320.36,71961.6,399281.96
231390,201710,190,155,35,145235,32795,178030
231395,201710,719,439,280,410068.68,262078.9,672147.58
231400,201710,1026,848,178,792049.55,166448.9,958498.45
231410,201710,1268,1020,248,951197.7,231440,1182637.7
240010,201710,389,183,206,170071.54,193013,363084.54
240020,201710,2146,1662,484,1555848.07,453508,2009356.07
240030,201710,163,138,25,129306,23425,152731
240040,201710,33,33,0,30921,0,30921
240050,201710,494,424,70,396449.66,65590,462039.66
240060,201710,70,65,5,60905,4685,65590
240070,201710,165,125,40,117125,37480,154605
240080,201710,400,260,140,243616,131180,374796
240090,201710,108,95,13,88716,12181,100897
240100,201710,1419,1337,82,1249849.18,76646.6,1326495.78
240110,201710,952,599,353,559605.28,330761,890366.28
240120,201710,146,121,25,113377,23425,136802
240130,201710,286,268,18,250412.31,16866,267278.31
240140,201710,87,66,21,61842,19677,81519
240145,201710,661,579,82,542007.65,76627.86,618635.51
240150,201710,20,16,4,14992,3733.95,18725.95
240160,201710,46,38,8,35606,7496,43102
240165,201710,36,32,4,29750,3748,33498
240170,201710,90,72,18,67464,16866,84330
240180,201710,73,60,13,56220,12181,68401
240185,201710,44,40,4,37470.63,3748,41218.63
240190,201710,19,17,2,15929,1874,17803
240200,201710,2947,1645,1302,1536165.54,1218757,2754922.54
240210,201710,163,127,36,118999,33732,152731
240220,201710,1113,795,318,744915,297956.63,1042871.63
240230,201710,808,748,60,698092.68,55583,753675.68
240240,201710,137,99,38,92763,35606,128369
240250,201710,96,85,11,79645,10307,89952
240260,201710,1774,1312,462,1228669.36,431928.89,1660598.25
240270,201710,185,165,20,154230.2,18740,172970.2
240280,201710,42,32,10,29984,9370,39354
240290,201710,57,55,2,51535,1874,53409
240300,201710,179,103,76,96511,71212,167723
240310,201710,1929,1053,876,977953.66,817635.06,1795588.72
240320,201710,212,201,11,188337,10307,198644
240325,201710,4221,2582,1639,2411885.53,1533608.41,3945493.94
240330,201710,66,63,3,59031,2811,61842
240340,201710,103,74,29,69338,27173,96511
240350,201710,96,84,12,78708,11244,89952
240360,201710,368,269,99,251772,92763,344535
240370,201710,38,36,2,33732,1874,35606
240375,201710,78,48,30,44976,28110,73086
240380,201710,238,194,44,180881,41135,222016
240390,201710,17,14,3,13118,2811,15929
240400,201710,81,78,3,73086,2811,75897
240410,201710,11,7,4,6559,3748,10307
240420,201710,850,658,192,615236.07,178892.04,794128.11
240430,201710,258,244,14,226922.11,13118,240040.11
240440,201710,66,36,30,33732,28110,61842
240450,201710,198,131,67,122184.9,62779,184963.9
240460,201710,60,46,14,43102,13118,56220
240470,201710,233,200,33,186852.79,30921,217773.79
240480,201710,16,16,0,14898.3,0,14898.3
240485,201710,72,62,10,58094,9370,67464
240490,201710,46,46,0,42896,0,42896
240500,201710,83,67,16,62779,14992,77771
240510,201710,48,34,14,31858,13118,44976
240520,201710,129,123,6,115251,5622,120873
240530,201710,49,43,6,40291,5622,45913
240540,201710,79,67,12,62779,10963,73742
240550,201710,16,13,3,12181,2811,14992
240560,201710,366,270,96,252374.4,89952,342326.4
240570,201710,467,290,177,270605.6,165849,436454.6
240580,201710,1256,1012,244,942108.35,227490.6,1169598.95
240590,201710,31,28,3,26236,2811,29047
240600,201710,115,115,0,107755,0,107755
240610,201710,512,428,84,400755,77959,478714
240615,201710,42,40,2,37480,1874,39354
240620,201710,95,91,4,84330,3748,88078
240630,201710,36,35,1,32795,937,33732
240640,201710,27,23,4,21551,3748,25299
240650,201710,233,196,37,182810,34669,217479
240660,201710,97,84,13,78708,12181,90889
240670,201710,280,165,115,152544.15,107755,260299.15
240680,201710,54,41,13,38417,12181,50598
240690,201710,52,49,3,45913,2811,48724
240700,201710,196,163,33,152731,30921,183652
240710,201710,1872,1187,685,1111564.3,641011.07,1752575.37
240720,201710,1020,744,276,696182.23,258612,954794.23
240725,201710,66,63,3,59031,2811,61842
240730,201710,132,116,16,108692,14992,123684
240740,201710,233,198,35,184186.09,32795,216981.09
240750,201710,34,21,13,19677,12181,31858
240760,201710,34,30,4,28110,3748,31858
240770,201710,151,116,35,108692,32795,141487
240780,201710,697,584,113,545512.03,105881,651393.03
240790,201710,40,38,2,35606,1874,37480
240800,201710,8410,5704,2706,5307284.71,2528239.35,7835524.06
240810,201710,19728,10825,8903,10101152.31,8331432.18,18432584.49
240820,201710,187,123,64,114589.22,59968,174557.22
240830,201710,1567,1290,277,1202322.15,258613,1460935.15
240840,201710,78,68,10,63716,9370,73086
240850,201710,86,75,11,70275,10307,80582
240860,201710,114,111,3,104007,2811,106818
240870,201710,54,47,7,44039,6559,50598
240880,201710,27,26,1,24352.63,937,25289.63
240890,201710,1124,661,463,615518.29,433827,1049345.29
240895,201710,43,32,11,29984,10307,40291
240910,201710,147,133,14,124621,13118,137739
240920,201710,18,14,4,13118,3748,16866
240930,201710,364,329,35,307336,32795,340131
240933,201710,25,17,8,15929,7496,23425
240940,201710,2388,2111,277,1965692.31,257000.36,2222692.67
240950,201710,48,47,1,44039,937,44976
240960,201710,33,25,8,23425,7496,30921
240970,201710,147,106,41,99322,37680,137002
240980,201710,186,147,39,137739,36543,174282
240990,201710,122,82,40,76834,37480,114314
241000,201710,84,75,9,70275,8433,78708
241010,201710,58,46,12,43102,11244,54346
241020,201710,114,107,7,100259,6559,106818
241025,201710,9,3,6,2811,5622,8433
241030,201710,121,99,22,92763,20614,113377
241040,201710,29,25,4,23425,3748,27173
241050,201710,93,78,15,73086,14055,87141
241060,201710,35,31,4,29047,3748,32795
241070,201710,17,17,0,15929,0,15929
241080,201710,65,57,8,53127.9,7496,60623.9
241090,201710,53,44,9,41228,8404.95,49632.95
241100,201710,77,68,9,63716,8433,72149
241105,201710,8,3,5,2811,4685,7496
241110,201710,50,47,3,44039,2811,46850
241120,201710,1386,1071,315,1000595.4,294292.96,1294888.36
241140,201710,230,187,43,174283,40291,214574
241142,201710,43,42,1,39354,937,40291
241150,201710,1198,1051,147,982117.5,137739,1119856.5
241160,201710,25,24,1,22488,937,23425
241170,201710,42,39,3,36543,2811,39354
241180,201710,51,41,10,38245.53,9370,47615.53
241190,201710,45,44,1,41228,937,42165
241200,201710,3763,2063,1700,1928352.61,1591013.74,3519366.35
241210,201710,73,60,13,56220,11338,67558
241220,201710,1340,890,450,833470.7,421631.26,1255101.96
241230,201710,237,199,38,186275.6,35606,221881.6
241240,201710,50,38,12,35606,11244,46850
241250,201710,1067,995,72,932034,67183,999217
241255,201710,44,35,9,32795,8433,41228
241260,201710,620,489,131,458188.32,122747,580935.32
241270,201710,46,31,15,29047,14055,43102
241280,201710,100,88,12,82456,11244,93700
241290,201710,109,80,29,74960,27173,102133
241300,201710,80,56,24,52472,22488,74960
241310,201710,52,40,12,37340,11244,48584
241320,201710,28,15,13,14055,12181,26236
241330,201710,58,52,6,48724,5622,54346
241335,201710,57,50,7,46850,6559,53409
241340,201710,185,139,46,130243,43102,173345
241350,201710,59,54,5,50598,4685,55283
241355,201710,43,40,3,37480,2811,40291
241360,201710,47,47,0,44039,0,44039
241370,201710,44,37,7,34547.19,6559,41106.19
241380,201710,45,43,2,40291,1874,42165
241390,201710,75,60,15,56032.6,14055,70087.6
241400,201710,187,153,34,142705.1,31858,174563.1
241410,201710,183,165,18,154605,16773,171378
241415,201710,91,72,19,67464,17803,85267
241420,201710,94,72,22,67464,20446,87910
241430,201710,28,27,1,25299,937,26236
241440,201710,446,380,66,356046,61842,417888
241445,201710,34,32,2,29984,1874,31858
241450,201710,281,230,51,215386,47787,263173
241460,201710,136,123,13,115017,12181,127198
241470,201710,46,38,8,35606,7496,43102
241475,201710,65,61,4,57157,3748,60905
241480,201710,93,67,26,62779,24362,87141
241490,201710,10,8,2,7496,1593,9089
241500,201710,49,36,13,33732,12181,45913
250010,201710,101,88,13,82456,12181,94637
250020,201710,23,20,3,18740,2811,21551
250030,201710,808,590,218,551509.1,202422.51,753931.61
250040,201710,317,263,54,246431,50598,297029
250050,201710,224,185,39,173341,36543,209884
250053,201710,55,43,12,40291,11244,51535
250057,201710,0,0,0,0,0,0
250060,201710,440,342,98,320454,91826,412280
250070,201710,683,580,103,541480,96511,637991
250073,201710,7,7,0,6559,0,6559
250077,201710,209,154,55,143913.83,51535,195448.83
250080,201710,420,325,95,302933.1,89015,391948.1
250090,201710,213,141,72,131181,66608.26,197789.26
250100,201710,462,377,85,353249,79271,432520
250110,201710,476,361,115,336504.81,107755,444259.81
250115,201710,29,8,21,7496,19677,27173
250120,201710,107,81,26,75897,24362,100259
250130,201710,581,458,123,429146,115064,544210
250135,201710,14,8,6,7496,5622,13118
250140,201710,74,64,10,59968,9370,69338
250150,201710,557,413,144,384854,134618.79,519472.79
250153,201710,11,10,1,9370,937,10307
250157,201710,30,25,5,23425,4685,28110
250160,201710,211,166,45,155542,42165,197707
250170,201710,68,48,20,44976,18740,63716
250180,201710,3936,2656,1280,2474349.48,1194352.5,3668701.98
250190,201710,915,602,313,562434.25,292578.25,855012.50
250200,201710,52,45,7,42165,6559,48724
250205,201710,19,16,3,14992,2811,17803
250210,201710,87,75,12,70275,11244,81519
250215,201710,62,53,9,49661,8433,58094
250220,201710,26,20,6,18740,5622,24362
250230,201710,72,66,6,61842,5622,67464
250240,201710,238,196,42,182855.55,39354,222209.55
250250,201710,388,333,55,312021,51535,363556
250260,201710,31,25,6,23425,5622,29047
250270,201710,58,46,12,43102,11244,54346
250280,201710,387,324,63,303588,59031,362619
250290,201710,92,87,5,81237.9,4685,85922.9
250300,201710,558,385,173,360109.24,162088,522197.24
250310,201710,48,41,7,38417,6559,44976
250320,201710,1867,1282,585,1194654.84,546881.26,1741536.10
250330,201710,82,71,11,66527,10307,76834
250340,201710,25,21,4,19677,3748,23425
250350,201710,135,85,50,79363.9,46287.8,125651.7
250355,201710,25,20,5,18740,4685,23425
250360,201710,201,163,38,152731,35372,188103
250370,201710,2346,1590,756,1484023.59,706842.71,2190866.30
250375,201710,20,16,4,14992,3748,18740
250380,201710,49,34,15,31858,14055,45913
250390,201710,38,32,6,29984,5622,35606
250400,201710,15483,7841,7642,7324537.13,7153760.19,14478297.32
250403,201710,424,343,81,321381.64,75897,397278.64
250407,201710,52,46,6,43102,5622,48724
250410,201710,28,23,5,21551,4685,26236
250415,201710,44,29,15,27173,14036.26,41209.26
250420,201710,48,39,9,36543,8433,44976
250430,201710,1667,1399,268,1308709,251116,1559825
250435,201710,17,14,3,13118,2811,15929
250440,201710,687,593,94,552715.89,88078,640793.89
250450,201710,87,72,15,67464,13399.1,80863.1
250460,201710,412,276,136,258612,127299.42,385911.42
250470,201710,88,63,25,59031,23425,82456
250480,201710,320,252,68,236124,63716,299840
250485,201710,2,1,1,937,937,1874
250490,201710,204,167,37,156479,34669,191148
250500,201710,74,53,21,49661,19677,69338
250510,201710,722,562,160,525282.8,148929.41,674212.21
250520,201710,173,120,53,112421.28,49656.32,162077.60
250523,201710,108,90,18,84330,16866,101196
250527,201710,103,79,24,74018.32,22488,96506.32
250530,201710,6,5,1,4685,937,5622
250535,201710,30,24,6,22488,5622,28110
250540,201710,124,94,30,87375.25,28110,115485.25
250550,201710,69,66,3,61842,2811,64653
250560,201710,34,28,6,26236,5622,31858
250570,201710,151,119,32,111503,29984,141487
250580,201710,140,109,31,101851.9,29047,130898.9
250590,201710,21,17,4,15929,3748,19677
250600,201710,1287,875,412,816787.64,385951,1202738.64
250610,201710,152,131,21,122747,19677,142424
250620,201710,20,16,4,14992,3748,18740
250625,201710,59,44,15,41228,14055,55283
250630,201710,2998,1915,1083,1787310.07,1013436.28,2800746.35
250640,201710,206,170,36,159290,33732,193022
250650,201710,32,21,11,19677,10307,29984
250660,201710,39,31,8,29047,7496,36543
250670,201710,53,33,20,30921,18740,49661
250680,201710,389,318,71,297966,66527,364493
250690,201710,1772,1216,556,1136014.03,520597.9,1656611.93
250700,201710,950,835,115,778013.3,107548.86,885562.16
250710,201710,445,344,101,322328,94637,416965
250720,201710,101,80,21,74960,19677,94637
250730,201710,371,310,61,290470,57157,347627
250740,201710,47,43,4,40291,3748,44039
250750,201710,19892,11880,8012,11076947.18,7498383.77,18575330.95
250760,201710,66,49,17,45913,15929,61842
250770,201710,346,233,113,217384.31,104733.27,322117.58
250780,201710,57,44,13,41228,12181,53409
250790,201710,488,314,174,291407.76,162335.25,453743.01
250800,201710,151,140,11,130477.25,10307,140784.25
250810,201710,80,61,19,57157,17803,74960
250820,201710,156,124,32,116188,29984,146172
250830,201710,424,283,141,264187.25,132117,396304.25
250840,201710,55,52,3,48724,2811,51535
250850,201710,49,39,10,35868.36,9370,45238.36
250855,201710,13,11,2,10307,1874,12181
250860,201710,201,144,57,134928,53127.9,188055.9
250870,201710,33,30,3,28110,2811,30921
250880,201710,77,57,20,53362.15,18740,72102.15
250890,201710,2321,1703,618,1594399.2,578218.57,2172617.77
250900,201710,76,62,14,58094,13118,71212
250905,201710,132,102,30,95574,28110,123684
250910,201710,1150,818,332,765323.56,310802.9,1076126.46
250915,201710,111,77,34,72149,31858,104007
250920,201710,139,106,33,99322,30921,130243
250930,201710,159,101,58,94637,54346,148983
250933,201710,0,0,0,0,0,0
250937,201710,8,7,1,6559,937,7496
250939,201710,29,22,7,20614,6559,27173
250940,201710,105,80,25,74960,23425,98385
250950,201710,73,48,25,44976,23425,68401
250960,201710,90,49,41,45913,38417,84330
250970,201710,1192,845,347,790173,324857.9,1115030.9
250980,201710,89,62,27,58094,25299,83393
250990,201710,159,123,36,114815.35,33689.85,148505.20
251000,201710,71,65,6,60717.6,5622,66339.6
251010,201710,92,72,20,67460,17975.4,85435.4
251020,201710,82,72,10,66667.55,9370,76037.55
251030,201710,41,31,10,29047,9370,38417
251040,201710,53,38,15,35606,14055,49661
251050,201710,25,23,2,21551,1874,23425
251060,201710,47,38,9,34669,8433,43102
251065,201710,3,3,0,2811,0,2811
251070,201710,26,21,5,19668,4685,24353
251080,201710,4675,2250,2425,2096096.78,2265788.41,4361885.19
251090,201710,197,168,29,157416,27173,184589
251100,201710,19,18,1,16866,937,17803
251110,201710,48,38,10,35606,9370,44976
251120,201710,1754,1046,708,974922.98,663396,1638318.98
251130,201710,348,281,67,263297,62779,326076
251140,201710,504,325,179,303402,167557.34,470959.34
251150,201710,293,254,39,237240,36543,273783
251160,201710,90,75,15,70271,14055,84326
251170,201710,101,82,19,76805.92,17798.32,94604.24
251180,201710,289,181,108,169587.64,101187.32,270774.96
251190,201710,196,134,62,125235.68,58094,183329.68
251200,201710,252,202,50,189274,46850,236124
251203,201710,33,31,2,29047,1874,30921
251207,201710,95,78,17,73086,15929,89015
251210,201710,1237,876,361,819285.89,337601.1,1156886.99
251220,201710,45,35,10,32795,9370,42165
251230,201710,502,424,78,397288,73086,470374
251240,201710,102,72,30,66527,28110,94637
251250,201710,1315,944,371,882139.1,347487,1229626.1
251260,201710,12,7,5,6559,4685,11244
251270,201710,339,251,88,235187,82316,317503
251272,201710,72,65,7,60905,6559,67464
251274,201710,28,23,5,21551,4685,26236
251275,201710,22,15,7,14055,6559,20614
251276,201710,19,15,4,14055,3748,17803
251278,201710,9,7,2,6559,1874,8433
251280,201710,90,86,4,80582,3748,84330
251290,201710,692,521,171,488177,160227,648404
251300,201710,17,15,2,14055,1874,15929
251310,201710,355,257,98,240805,91826,332631
251315,201710,15,14,1,13118,937,14055
251320,201710,62,50,12,46850,11244,58094
251330,201710,79,70,9,65590,8433,74023
251335,201710,9,5,4,4685,3748,8433
251340,201710,684,407,277,381359,258542.63,639901.63
251350,201710,33,31,2,29047,1874,30921
251360,201710,63,55,8,51332.61,7496,58828.61
251365,201710,14,14,0,13118,0,13118
251370,201710,5214,3538,1676,3310611.29,1569101.5,4879712.79
251380,201710,50,39,11,36543,10307,46850
251385,201710,2,2,0,1874,0,1874
251390,201710,652,519,133,485179.6,123403,608582.6
251392,201710,31,21,10,19677,9370,29047
251394,201710,9,9,0,8433,0,8433
251396,201710,18,14,4,13118,3748,16866
251398,201710,17,15,2,14055,1874,15929
251400,201710,37,30,7,28110,6559,34669
251410,201710,33,29,4,27173,3748,30921
251420,201710,109,83,26,77771,24362,102133
251430,201710,36,34,2,31858,1874,33732
251440,201710,36,23,13,21542,12181,33723
251445,201710,50,44,6,41228,5622,46850
251450,201710,415,368,47,343190.4,44039,387229.4
251455,201710,2,1,1,937,937,1874
251460,201710,16,12,4,11244,3748,14992
251465,201710,5,2,3,1874,2811,4685
251470,201710,44,36,8,33732,7496,41228
251480,201710,23,21,2,19677,1874,21551
251490,201710,129,91,38,84799,34670,119469
251500,201710,116,94,22,88078,19865,107943
251510,201710,32,25,7,23425,6559,29984
251520,201710,24,24,0,22488,0,22488
251530,201710,4546,3187,1359,2980312.25,1273092.53,4253404.78
251540,201710,74,66,8,61842,7496,69338
251550,201710,419,322,97,300777.6,90655,391432.6
251560,201710,22,17,5,15929,4685,20614
251570,201710,17,17,0,15929,0,15929
251580,201710,119,96,23,89952,21551,111503
251590,201710,129,95,34,89015,31858,120873
251593,201710,18,10,8,9370,7496,16866
251597,201710,60,49,11,45913,10307,56220
251600,201710,1099,782,317,731272.94,295350.26,1026623.20
251610,201710,207,156,51,145516.1,47132,192648.1
251615,201710,1,1,0,937,0,937
251620,201710,4231,2843,1388,2655022.97,1298121.34,3953144.31
251630,201710,430,318,112,297966,104663,402629
251640,201710,149,106,43,99322,40291,139613
251650,201710,260,190,70,176231.55,65590,241821.55
251660,201710,222,202,20,188337.55,18552.6,206890.15
251670,201710,358,282,76,262670.07,71212,333882.07
251675,201710,3,3,0,2811,0,2811
251680,201710,87,80,7,74960,6559,81519
251690,201710,335,281,54,263297,50254.13,313551.13
251700,201710,280,230,50,214933.75,46835.95,261769.70
251710,201710,18,12,6,11244,5622,16866
251720,201710,34,23,11,21551,10026,31577
251740,201710,9,7,2,6559,1874,8433
260005,201710,3057,1743,1314,1622949.06,1230073.55,2853022.61
260010,201710,1342,956,386,892609.76,359714.96,1252324.72
260020,201710,434,382,52,357934,48724,406658
260030,201710,575,411,164,384353.65,153668,538021.65
260040,201710,855,521,334,486312.37,312808.08,799120.45
260050,201710,1120,791,329,740746,307711,1048457
260060,201710,419,378,41,353436.4,38417,391853.4
260070,201710,1409,891,518,830836,483386.58,1314222.58
260080,201710,726,570,156,532872.55,146172,679044.55
260090,201710,561,349,212,326788.86,198644,525432.86
260100,201710,228,157,71,146125.6,66527,212652.6
260105,201710,239,133,106,124621,99322,223943
260110,201710,2694,2005,689,1878666.63,644797,2523463.63
260120,201710,2977,1578,1399,1467819.38,1308616.55,2776435.93
260130,201710,146,100,46,93700,43102,136802
260140,201710,2044,1332,712,1240180.32,665627.63,1905807.95
260150,201710,226,148,78,138676,73086,211762
260160,201710,289,250,39,234250,36543,270793
260170,201710,3306,2029,1277,1893699.84,1195471.45,3089171.29
260180,201710,142,122,20,114314,18740,133054
260190,201710,2261,1604,657,1499854.03,615609,2115463.03
260200,201710,880,731,149,684185.24,139332,823517.24
260210,201710,1394,976,418,914363.96,390279,1304642.96
260220,201710,710,650,60,608278,56220,664498
260230,201710,1189,897,292,838337.15,273604,1111941.15
260240,201710,212,159,53,147830.49,49661,197491.49
260250,201710,71,57,14,53409,13118,66527
260260,201710,970,694,276,650278,258612,908890
260270,201710,436,353,83,329122.1,77489.9,406612.0
260280,201710,1029,729,300,682323.4,280819,963142.4
260290,201710,6300,3327,2973,3098929.82,2779561.06,5878490.88
260300,201710,816,718,98,670593.4,91545,762138.4
260310,201710,495,393,102,366231.13,95574,461805.13
260320,201710,878,662,216,620010.6,202392,822402.6
260330,201710,28,22,6,20614,5622,26236
260340,201710,66,47,19,44039,17803,61842
260345,201710,5532,3128,2404,2924587.92,2251268.92,5175856.84
260350,201710,461,336,125,313119.16,116189,429308.16
260360,201710,283,146,137,136802,128369,265171
260370,201710,632,409,223,380669.7,208814,589483.7
260380,201710,600,433,167,405721,155355.14,561076.14
260390,201710,293,249,44,232137.19,40291,272428.19
260392,201710,94,81,13,75897,12181,88078
260400,201710,4100,2347,1753,2189265.93,1642205.41,3831471.34
260410,201710,14038,7633,6405,7137615.87,5998802.5,13136418.37
260415,201710,124,110,14,103070,13118,116188
260420,201710,1769,1043,726,971950.55,678810.8,1650761.35
260430,201710,190,174,16,161847.14,14992,176839.14
260440,201710,230,166,64,154831,59968,214799
260450,201710,479,344,135,321066,126495,447561
260460,201710,852,452,400,420902.4,374795.32,795697.72
260470,201710,365,221,144,206327.4,134038.55,340365.95
260480,201710,201,124,77,116188,72149,188337
260490,201710,204,164,40,153668,37480,191148
260500,201710,1117,747,370,697082.6,345612.9,1042695.5
260510,201710,718,563,155,527531,144298,671829
260515,201710,256,227,29,212699,26705,239404
260520,201710,3269,1930,1339,1800808.91,1252760.21,3053569.12
260530,201710,744,607,137,565989.92,128369,694358.92
260540,201710,577,430,147,402910,136802.66,539712.66
260545,201710,15,10,5,9370,4685,14055
260550,201710,327,201,126,188337,118062,306399
260560,201710,517,392,125,366724,116843.9,483567.9
260570,201710,996,823,173,768200.9,162101,930301.9
260580,201710,277,248,29,232376,27173,259549
260590,201710,647,368,279,343429.24,261423,604852.24
260600,201710,8219,4086,4133,3804910.19,3869431.02,7674341.21
260610,201710,496,328,168,307336,157134.9,464470.9
260620,201710,3540,1868,1672,1739537.5,1561761.26,3301298.76
260630,201710,71,68,3,63716,2811,66527
260640,201710,3585,1962,1623,1835135.49,1520405.05,3355540.54
260650,201710,334,228,106,213636,99279.85,312915.85
260660,201710,495,338,157,316331.2,146499.95,462831.15
260670,201710,102,76,26,71212,24362,95574
260680,201710,3665,2032,1633,1886464.16,1528173.78,3414637.94
260690,201710,162,128,34,119281,31858,151139
260700,201710,331,200,131,186650.4,121930,308580.4
260710,201710,37,35,2,32795,1874,34669
260720,201710,2183,1318,865,1229183.23,809165.09,2038348.32
260730,201710,585,442,143,414154,131836.45,545990.45
260740,201710,64,61,3,57157,2811,59968
260750,201710,648,451,197,421987.32,184589,606576.32
260760,201710,628,345,283,323265,264859,588124
260765,201710,978,513,465,478728.9,435470.75,914199.65
260770,201710,218,163,55,152731,51535,204266
260775,201710,814,481,333,449339.9,312012,761351.9
260780,201710,266,167,99,156479,92631.82,249110.82
260790,201710,12430,6824,5606,6366578.3,5245658.9,11612237.2
260795,201710,155,104,51,96304.86,47787,144091.86
260800,201710,355,292,63,273136,59031,332167
260805,201710,196,129,67,120157.13,62779,182936.13
260810,201710,742,648,94,605948.53,88078,694026.53
260820,201710,311,208,103,193590,96511,290101
260825,201710,202,137,65,127998.71,60905,188903.71
260830,201710,259,167,92,156338.45,86204,242542.45
260840,201710,227,163,64,152076,59687,211763
260845,201710,212,150,62,140268.9,58094,198362.9
260850,201710,507,367,140,342244.64,131180,473424.64
260860,201710,251,187,64,175024.86,59968,234992.86
260870,201710,366,258,108,241746,101196,342942
260875,201710,681,472,209,441170.53,195833,637003.53
260880,201710,1484,927,557,867893.31,521721.6,1389614.91
260890,201710,2440,1704,736,1589218.29,688696,2277914.29
260900,201710,1025,694,331,648999,310147,959146
260910,201710,270,212,58,198644,54346,252990
260915,201710,309,206,103,193022,96391,289413
260920,201710,170,97,73,90889,68401,159290
260930,201710,398,339,59,317643,55198.75,372841.75
260940,201710,2731,1492,1239,1394070.55,1160175.26,2554245.81
260950,201710,1912,1118,794,1041185.97,743978,1785163.97
260960,201710,14186,7380,6806,6879972.54,6370325.47,13250298.01
260970,201710,428,368,60,344816,56220,401036
260980,201710,199,173,26,161811,24362,186173
260990,201710,2516,2073,443,1941905.01,415091,2356996.01
261000,201710,4306,2533,1773,2359892.52,1659717.87,4019610.39
261010,201710,189,136,53,127432,48857.8,176289.8
261020,201710,615,456,159,427132,148186.55,575318.55
261030,201710,210,152,58,142424,54144.55,196568.55
261040,201710,363,328,35,307336,32513.9,339849.9
261050,201710,462,407,55,381359,51535,432894
261060,201710,1314,860,454,803712.88,425398,1229110.88
261070,201710,8945,4580,4365,4268009.71,4081701.8,8349711.51
261080,201710,390,299,91,279404.03,85267,364671.03
261090,201710,2162,1666,496,1552730.82,464003,2016733.82
261100,201710,1069,757,312,707482.8,290507.48,997990.28
261110,201710,7967,4867,3100,4555306.44,2902458.14,7457764.58
261120,201710,282,234,48,218977,44972,263949
261130,201710,571,325,246,304197.45,230502,534699.45
261140,201710,187,120,67,112440,62779,175219
261150,201710,661,382,279,357466,260767.1,618233.1
261153,201710,74,71,3,65590.12,2811,68401.12
261160,201710,76207,38809,37398,36245443.03,35017407.25,71262850.28
261170,201710,447,331,116,309247.58,108692,417939.58
261180,201710,1741,1060,681,988338.53,638097,1626435.53
261190,201710,614,424,190,396885.89,178021,574906.89
261200,201710,212,187,25,174514.09,23425,197939.09
261210,201710,33,29,4,27173,3748,30921
261220,201710,2453,1717,736,1603303.11,688507.9,2291811.01
261230,201710,311,231,80,216447,74945.95,291392.95
261240,201710,439,380,59,352118.47,55283,407401.47
261245,201710,215,181,34,169597,31858,201455
261247,201710,145,107,38,100259,35606,135865
261250,201710,2764,1363,1401,1276006.7,1311646.61,2587653.31
261255,201710,252,230,22,215510,20614,236124
261260,201710,837,720,117,674640,109629,784269
261270,201710,174,135,39,126495,36543,163038
261280,201710,146,117,29,109629,27173,136802
261290,201710,130,91,39,85032.75,36543,121575.75
261300,201710,1217,863,354,808631,331698,1140329
261310,201710,748,501,247,469437,230829.95,700266.95
261320,201710,525,353,172,330761,161164,491925
261330,201710,805,640,165,596736.25,153774.53,750510.78
261340,201710,313,172,141,161164,132117,293281
261350,201710,767,542,225,506917.1,210825,717742.1
261360,201710,1189,757,432,708914.53,404784,1113698.53
261370,201710,4896,3014,1882,2808160.58,1761770.2,4569930.78
261380,201710,572,417,155,388864.92,144954,533818.92
261390,201710,3379,2255,1124,2108241,1049395.15,3157636.15
261400,201710,283,258,25,240902.7,23425,264327.7
261410,201710,1033,676,357,633412,334504.32,967916.32
261420,201710,861,534,327,498457.63,306380.63,804838.26
261430,201710,328,297,31,277458,28765.9,306223.9
261440,201710,98,87,11,81519,10307,91826
261450,201710,2482,2067,415,1934354.13,387863.12,2322217.25
261460,201710,689,552,137,516287.81,128369,644656.81
261470,201710,243,185,58,172549,54346,226895
261480,201710,335,276,59,257489,55279,312768
261485,201710,341,210,131,196114.1,122747,318861.1
261500,201710,626,420,206,393540,193022,586562
261510,201710,40,29,11,27173,10307,37480
261520,201710,170,156,14,146172,13118,159290
261530,201710,4148,2629,1519,2455273.99,1422071.95,3877345.94
261540,201710,1061,648,413,606720.62,386981,993701.62
261550,201710,285,139,146,128885,136802,265687
261560,201710,772,514,258,478434.1,240331.8,718765.9
261570,201710,364,284,80,266108,74960,341068
261580,201710,376,294,82,274731,76834,351565
261590,201710,191,155,36,145235,33732,178967
261600,201710,284,229,55,213824,51067,264891
261610,201710,101,87,14,81171,13118,94289
261618,201710,66,51,15,47787,14055,61842
261620,201710,212,128,84,119936,78708,198644
261630,201710,591,452,139,421207.8,130243,551450.8
261640,201710,6225,3308,2917,3092180.75,2730428.26,5822609.01
261650,201710,475,296,179,276686.73,167723,444409.73
270010,201710,511,446,65,417340,60156,477496
270020,201710,303,238,65,223002,60905,283907
270030,201710,9046,5774,3272,5397565.88,3063422.28,8460988.16
270040,201710,1922,1173,749,1098154.64,701531.9,1799686.54
270050,201710,181,134,47,125558,44039,169597
270060,201710,118,65,53,60905,49661,110566
270070,201710,907,650,257,607069.26,240500.16,847569.42
270080,201710,43,36,7,33732,6559,40291
270090,201710,20,16,4,14992,3748,18740
270100,201710,1282,834,448,777696.98,417668.35,1195365.33
270110,201710,160,118,42,110566,39354,149920
270120,201710,225,184,41,171571.72,38135.9,209707.62
270130,201710,264,183,81,171189.9,75615.9,246805.8
270135,201710,97,58,39,54346,36543,90889
270140,201710,1246,744,502,696919.74,468866.4,1165786.14
270150,201710,267,215,52,201455,48724,250179
270160,201710,518,381,137,356997,127713.1,484710.1
270170,201710,681,428,253,400192.7,236264.55,636457.25
270180,201710,72,54,18,50285.7,16659.86,66945.56
270190,201710,105,92,13,86204,12181,98385
270200,201710,110,98,12,91638.6,11244,102882.6
270210,201710,487,249,238,233313,222724.9,456037.9
270220,201710,193,154,39,144298,36543,180841
270230,201710,2071,1233,838,1148771.23,782401.2,1931172.43
270235,201710,731,544,187,509428.66,174860.48,684289.14
270240,201710,3071,2358,713,2198775.22,664494.8,2863270.02
270250,201710,175,121,54,112627.4,50598,163225.4
270255,201710,223,194,29,181778,26798.2,208576.2
270260,201710,324,259,65,242683,60653.18,303336.18
270270,201710,119,48,71,44967,66527,111494
270280,201710,213,134,79,125558,74023,199581
270290,201710,1142,853,289,798045.59,269922.26,1067967.85
270300,201710,261,165,96,154605,89670.9,244275.9
270310,201710,938,749,189,699611.18,176390.99,876002.17
270320,201710,890,757,133,707945.4,124550.85,832496.25
270330,201710,267,219,48,204266,44976,249242
270340,201710,59,46,13,43102,12181,55283
270350,201710,94,48,46,44976,43102,88078
270360,201710,75,40,35,37480,32795,70275
270370,201710,50,37,13,34669,12181,46850
270375,201710,62,33,29,30921,27169,58090
270380,201710,1075,595,480,556578,449760,1006338
270390,201710,197,105,92,98385,86204,184589
270400,201710,695,500,195,467306.43,182706,650012.43
270410,201710,700,494,206,462878,193012.63,655890.63
270420,201710,390,251,139,233520,130160.89,363680.89
270430,201710,31810,22631,9179,21151560.48,8591439.36,29742999.84
270440,201710,496,384,112,358824.55,104662.9,463487.45
270450,201710,766,398,368,372691.75,344816,717507.75
270460,201710,200,150,50,140550,46850,187400
270470,201710,1323,869,454,813904.95,425174,1239078.95
270480,201710,514,413,101,383907.84,93934.25,477842.09
270490,201710,26,21,5,19677,4685,24362
270500,201710,521,423,98,396351,91826,488177
270510,201710,736,453,283,424461,265171,689632
270520,201710,402,244,158,228281.45,148046,376327.45
270530,201710,64,56,8,52472,7496,59968
270540,201710,126,96,30,89952,28110,118062
270550,201710,1714,1294,420,1211224.37,393535.32,1604759.69
270560,201710,319,144,175,134928,163975,298903
270570,201710,435,278,157,259670.73,147109,406779.73
270580,201710,75,54,21,50598,19677,70275
270590,201710,82,68,14,63716,13118,76834
270600,201710,181,148,33,138676,30921,169597
270610,201710,169,134,35,125549,32795,158344
270620,201710,31,30,1,28110,937,29047
270630,201710,3811,2886,925,2693517.96,864608.38,3558126.34
270640,201710,906,660,246,615815.3,230193.9,846009.2
270642,201710,202,170,32,159290,29984,189274
270644,201710,290,198,92,185338.97,86199.32,271538.29
270650,201710,235,140,95,131180,89015,220195
270660,201710,255,205,50,192085,46850,238935
270670,201710,3172,2395,777,2233303.21,726110.27,2959413.48
270680,201710,454,262,192,245485,179899.32,425384.32
270690,201710,1113,694,419,648576.24,392593.63,1041169.87
270700,201710,35,27,8,25299,7496,32795
270710,201710,865,645,220,602778.86,206140,808918.86
270720,201710,247,186,61,174282,56875.9,231157.9
270730,201710,1839,1067,772,997235.23,721295.6,1718530.83
270740,201710,47,28,19,26236,17803,44039
270750,201710,620,452,168,423524,156761,580285
270760,201710,310,226,84,211762,78708,290470
270770,201710,2688,1679,1009,1565282.84,944496,2509778.84
270780,201710,92,57,35,53404.32,32777.64,86181.96
270790,201710,276,183,93,171471,87141,258612
270800,201710,1959,1546,413,1446841.12,386250.14,1833091.26
270810,201710,320,250,70,234235.95,65581.32,299817.27
270820,201710,156,99,57,92763,53316,146079
270830,201710,984,710,274,663768,256738,920506
270840,201710,1404,1015,389,950563.2,362855,1313418.2
270850,201710,1738,1054,684,982581.28,640889.63,1623470.91
270860,201710,2457,1585,872,1481738.75,814198.9,2295937.65
270870,201710,121,66,55,61842,51535,113377
270880,201710,907,650,257,607247.67,239904.75,847152.42
270890,201710,368,269,99,251612.61,92758.32,344370.93
270895,201710,74,64,10,59968,9370,69338
270900,201710,109,86,23,80582,21551,102133
270910,201710,331,262,69,244369.6,64653,309022.6
270915,201710,1797,1061,736,989195.45,688934.06,1678129.51
270920,201710,493,409,84,383233,78708,461941
270930,201710,6206,4439,1767,4153454.81,1652931.67,5806386.48
270940,201710,2398,1804,594,1688413.09,555623,2244036.09
280010,201710,43,38,5,35606,4685,40291
280020,201710,702,601,101,561232.31,93700,654932.31
280030,201710,18856,12073,6783,11240466.26,6327528.93,17567995.19
280040,201710,346,219,127,205203,117593.5,322796.5
280050,201710,372,285,87,266763.9,81519,348282.9
280060,201710,316,208,108,193514.48,101196,294710.48
280067,201710,973,683,290,637263.26,270793.12,908056.38
280070,201710,127,105,22,98385,20614,118999
280100,201710,606,477,129,444159.98,120686,564845.98
280110,201710,73,69,4,64653,3748,68401
280120,201710,629,504,125,472248,117125,589373
280130,201710,1304,805,499,752739.9,467422.45,1220162.35
280140,201710,458,365,93,341161.7,87141,428302.7
280150,201710,311,227,84,212031.21,77771,289802.21
280160,201710,97,83,14,77771,13118,90889
280170,201710,575,383,192,357414.68,179107.55,536522.23
280190,201710,28,26,2,24362,1874,26236
280200,201710,21,14,7,13118,6559,19677
280210,201710,2724,1911,813,1772329.34,755739.99,2528069.33
280220,201710,39,31,8,29047,7496,36543
280230,201710,308,252,56,235304.95,51535.1,286840.05
280240,201710,111,105,6,98244.45,5622,103866.45
280250,201710,21,12,9,11244,8433,19677
280260,201710,77,69,8,64653,7496,72149
280270,201710,162,124,38,116188,35606,151794
280280,201710,194,123,71,115251,66527,181778
280290,201710,3001,2172,829,2021087.6,775485.63,2796573.23
280300,201710,1073,813,260,760145.93,242870.4,1003016.33
280310,201710,102,98,4,91639,3748,95387
280320,201710,651,442,209,414145,195833,609978
280330,201710,355,253,102,237061,95452.19,332513.19
280340,201710,404,322,82,300269.05,76085,376354.05
280350,201710,3378,2606,772,2432687.36,720673.41,3153360.77
280360,201710,467,297,170,278289,158353,436642
280370,201710,93,82,11,76834,10307,87141
280380,201710,56,41,15,38417,14055,52472
280390,201710,185,153,32,143361,29984,173345
280400,201710,337,227,110,211856.4,103070,314926.4
280410,201710,291,233,58,217179,54336.63,271515.63
280420,201710,172,145,27,135865,25299,161164
280430,201710,108,79,29,74023,26960.15,100983.15
280440,201710,662,506,156,470047.7,145975.23,616022.93
280445,201710,111,103,8,96511,7496,104007
280450,201710,1051,898,153,838146.5,143361,981507.5
280460,201710,721,516,205,476754.26,192085,668839.26
280470,201710,190,173,17,162101,14993,177094
280480,201710,2220,1584,636,1470134.29,592852.65,2062986.94
280490,201710,373,341,32,318373,29984,348357
280500,201710,47,43,4,40291,3748,44039
280510,201710,145,111,34,103709.6,31577,135286.6
280520,201710,55,41,14,38417,13118,51535
280530,201710,76,55,21,51535,19677,71212
280540,201710,497,394,103,369178,96229.9,465407.9
280550,201710,702,647,55,603669.3,51535,655204.3
280560,201710,468,403,65,375455.9,60905,436360.9
280570,201710,1761,1329,432,1241988.42,404775,1646763.42
280580,201710,594,452,142,423103.9,132961,556064.9
280590,201710,161,97,64,90614.46,59968,150582.46
280600,201710,348,291,57,270999.54,53409,324408.54
280610,201710,144,106,38,99120,35606,134726
280620,201710,554,448,106,418839.75,99181.45,518021.20
280630,201710,166,137,29,128369,27173,155542
280640,201710,211,167,44,155665,41228,196893
280650,201710,81,53,28,49661,26236,75897
280660,201710,127,92,35,86204,32560.75,118764.75
280670,201710,1547,953,594,888112.98,552900.98,1441013.96
280680,201710,177,150,27,138799,25299,164098
280690,201710,44,38,6,35606,5622,41228
280700,201710,16,16,0,14992,0,14992
280710,201710,1406,1048,358,974371.39,334790.1,1309161.49
280720,201710,107,73,34,65886.7,31858,97744.7
280730,201710,23,19,4,17803,3748,21551
280740,201710,2339,1707,632,1595643.82,590442.07,2186085.89
280750,201710,293,251,42,235187,39354,274541
280760,201710,862,586,276,547957.6,258471.45,806429.05
290010,201710,192,127,65,118999,60905,179904
290020,201710,175,162,13,151794,12181,163975
290030,201710,588,378,210,353530.1,196770,550300.1
290035,201710,139,112,27,101796.8,25299,127095.8
290040,201710,270,170,100,159290,93700,252990
290050,201710,69,51,18,47787,16866,64653
290060,201710,259,111,148,103725.9,138676,242401.9
290070,201710,5467,2670,2797,2494484.07,2617093.85,5111577.92
290080,201710,509,230,279,215022.76,261405,476427.76
290090,201710,385,168,217,157416,203329,360745
290100,201710,1557,1023,534,954430.05,499795.9,1454225.95
290110,201710,754,439,315,409746.1,295061.3,704807.4
290115,201710,214,197,17,183652,15929,199581
290120,201710,781,515,266,481899.1,249242,731141.1
290130,201710,422,246,176,230211.53,164912,395123.53
290135,201710,293,223,70,208285.73,65590,273875.73
290140,201710,290,239,51,223943,47599.6,271542.6
290150,201710,130,97,33,90889,30921,121810
290160,201710,243,191,52,177748.95,48724,226472.95
290170,201710,87,60,27,56220,25299,81519
290180,201710,150,117,33,109629,30921,140550
290190,201710,448,365,83,341724,77489.9,419213.9
290195,201710,295,166,129,155542,120873,276415
290200,201710,291,247,44,231439,41228,272667
290205,201710,136,81,55,75897,51535,127432
290210,201710,1105,802,303,750350.6,283911,1034261.6
290220,201710,217,119,98,111034.5,91826,202860.5
290225,201710,272,100,172,93700,161164,254864
290230,201710,64,41,23,38417,21551,59968
290240,201710,313,125,188,116843.9,176156,292999.9
290250,201710,264,237,27,221385,25299,246684
290260,201710,265,221,44,206328,41228,247556
290265,201710,184,149,35,138810,32795,171605
290270,201710,1372,1124,248,1051314,231529,1282843
290280,201710,468,345,123,323265,115251,438516
290290,201710,1185,680,505,632721.61,473185,1105906.61
290300,201710,454,385,69,360225.07,64653,424878.07
290310,201710,322,142,180,133054,168660,301714
290320,201710,3897,2428,1469,2272308.46,1373642.5,3645950.96
290323,201710,182,158,24,147765,22488,170253
290327,201710,145,113,32,105613.96,29984,135597.96
290330,201710,69,37,32,34669,29984,64653
290340,201710,912,363,549,339176,513850.9,853026.9
290350,201710,571,339,232,317643,217384,535027
290360,201710,365,275,90,255801.86,84330,340131.86
290370,201710,967,364,603,341068,565011,906079
290380,201710,295,179,116,167723,108692,276415
290390,201710,2455,1526,929,1426286.57,868599,2294885.57
290395,201710,236,131,105,122231.9,98385,220616.9
290400,201710,280,206,74,192460,69338,261798
290405,201710,259,221,38,207077,35606,242683
290410,201710,558,475,83,442124.9,77771,519895.9
290420,201710,226,175,51,163975,47787,211762
290430,201710,515,320,195,299840,182715,482555
290440,201710,74,64,10,59968,8745.3,68713.3
290450,201710,233,179,54,167723,50598,218321
290460,201710,1854,1098,756,1027925.89,707904.56,1735830.45
290470,201710,1432,596,836,557040.17,783020.08,1340060.25
290475,201710,588,550,38,515350,35606,550956
290480,201710,287,158,129,148046,120873,268919
290485,201710,212,198,14,185526,13118,198644
290490,201710,1101,783,318,732921.4,297029.6,1029951.0
290500,201710,654,327,327,305462,306399,611861
290510,201710,216,163,53,152076,49657,201733
290515,201710,133,74,59,69338,55283,124621
290520,201710,1354,865,489,808912.61,455009.01,1263921.62
290530,201710,307,279,28,261423,26236,287659
290540,201710,92,55,37,51535,34669,86204
290550,201710,152,129,23,120873,21204.31,142077.31
290560,201710,3366,1357,2009,1270497.04,1882242.4,3152739.44
290570,201710,5698,2940,2758,2750251,2581199.89,5331450.89
290580,201710,1235,706,529,660303.9,494970.25,1155274.15
290590,201710,529,436,93,407783,87141,494924
290600,201710,1705,1182,523,1102944.08,490022.89,1592966.97
290610,201710,217,197,20,184140,18740,202880
290620,201710,320,281,39,263297,35980.8,299277.8
290630,201710,2111,888,1223,828309,1140427.47,1968736.47
290640,201710,150,122,28,114314,26236,140550
290650,201710,1668,787,881,736473.42,825497,1561970.42
290660,201710,277,225,52,210825,48724,259549
290670,201710,972,512,460,479182,430679.9,909861.9
290680,201710,1157,935,222,875158,207077,1082235
290682,201710,283,207,76,192990.15,71193.63,264183.78
290685,201710,231,147,84,136802,78708,215510
290687,201710,908,598,310,556999.8,288474.29,845474.09
290689,201710,121,72,49,67450,45898.95,113348.95
290690,201710,670,278,392,260477,366432.03,626909.03
290700,201710,242,112,130,104944,121810,226754
290710,201710,687,451,236,422587,221132,643719
290720,201710,1016,831,185,778647,172876.5,951523.5
290730,201710,1114,635,479,593167.85,447886,1041053.85
290740,201710,16,12,4,11244,3748,14992
290750,201710,1327,604,723,564638.83,676159.04,1240797.87
290755,201710,69,61,8,57157,7496,64653
290760,201710,302,263,39,246431,36543,282974
290770,201710,185,172,13,161154.63,12181,173335.63
290780,201710,949,762,187,712085.23,173438.7,885523.93
290790,201710,406,277,129,258980,120873,379853
290800,201710,2601,1033,1568,964853.07,1468119.71,2432972.78
290810,201710,435,299,136,279882,127432,407314
290820,201710,373,230,143,214559,133991,348550
290830,201710,389,260,129,243620,120873,364493
290840,201710,1633,999,634,933393.3,591078.44,1524471.74
290850,201710,744,407,337,380328.3,314832,695160.3
290860,201710,652,293,359,274541,336102,610643
290870,201710,654,477,177,445749.8,165849,611598.8
290880,201710,128,71,57,66527,53409,119936
290890,201710,348,248,100,232376,93700,326076
290900,201710,169,129,40,120873,37480,158353
290910,201710,359,272,87,254864,81519,336383
290920,201710,230,193,37,180841,34669,215510
290930,201710,802,611,191,571729.29,178967,750696.29
290940,201710,252,205,47,191335.4,44039,235374.4
290950,201710,170,97,73,90889,68401,159290
290960,201710,433,287,146,267701.72,136520.9,404222.62
290970,201710,249,218,31,204078.6,29047,233125.6
290980,201710,1462,1039,423,969468.02,395321.1,1364789.12
290990,201710,359,304,55,284839,51479.89,336318.89
291000,201710,851,235,616,220195,576910.9,797105.9
291005,201710,2009,850,1159,794707.28,1085219.72,1879927.00
291010,201710,157,142,15,133054,14055,147109
291020,201710,102,80,22,74960,20614,95574
291030,201710,87,65,22,60905,20614,81519
291040,201710,585,292,293,273604,274541,548145
291050,201710,1309,739,570,690516.02,534090,1224606.02
291060,201710,1476,802,674,750818.1,631538,1382356.1
291070,201710,1880,1386,494,1292452.6,460031.18,1752483.78
291072,201710,7225,2646,4579,2476014.28,4288079.14,6764093.42
291075,201710,196,158,38,148046,35606,183652
291077,201710,47,32,15,29984,14055,44039
291080,201710,19038,8277,10761,7733027.04,10070398.92,17803425.96
291085,201710,283,227,56,212699,52467.32,265166.32
291090,201710,310,114,196,106537,183642.63,290179.63
291100,201710,710,210,500,196770,468500,665270
291110,201710,394,303,91,283911,85267,369178
291120,201710,2491,1151,1340,1078347,1253636.76,2331983.76
291125,201710,60,31,29,29047,27173,56220
291130,201710,209,181,28,169597,26236,195833
291140,201710,122,89,33,83393,30640,114033
291150,201710,384,151,233,141487,218321,359808
291160,201710,341,286,55,267045.25,51535,318580.25
291165,201710,20,16,4,14992,3748,18740
291170,201710,2828,1425,1403,1333070.55,1311654.07,2644724.62
291180,201710,1301,487,814,456181,762664,1218845
291185,201710,70,68,2,63716,1874,65590
291190,201710,1226,515,711,481049.5,665673.9,1146723.4
291200,201710,163,118,45,110566,42165,152731
291210,201710,2168,836,1332,780249.27,1246313.54,2026562.81
291220,201710,251,190,61,177093.43,57157,234250.43
291230,201710,1020,343,677,320548,634349,954897
291240,201710,446,421,25,393259,23425,416684
291250,201710,427,346,81,324202,75897,400099
291260,201710,40,30,10,28110,9370,37480
291270,201710,1196,479,717,448823,671313.9,1120136.9
291280,201710,375,167,208,156291.6,194605.53,350897.13
291290,201710,1730,870,860,814065.6,804790,1618855.6
291300,201710,227,181,46,168941.1,43102,212043.1
291310,201710,241,215,26,201174,24362,225536
291320,201710,1381,989,392,923600.9,366274.8,1289875.7
291330,201710,127,107,20,98478.7,18740,117218.7
291340,201710,142,80,62,74960,58094,133054
291345,201710,124,82,42,76834,39354,116188
291350,201710,1553,489,1064,457724.5,996781.15,1454505.65
291360,201710,8483,4176,4307,3903934.03,4032705.28,7936639.31
291370,201710,1071,584,487,546927,456319,1003246
291380,201710,255,203,52,190211,48724,238935
291390,201710,3866,1668,2198,1558542.5,2058027,3616569.5
291400,201710,2050,1458,592,1361087.79,552770.39,1913858.18
291410,201710,153,135,18,125558,16866,142424
291420,201710,103,74,29,69338,27173,96511
291430,201710,180,101,79,93942,73086.96,167028.96
291440,201710,493,393,100,365846.25,93700,459546.25
291450,201710,869,538,331,501952.54,309210,811162.54
291460,201710,1700,1382,318,1292497.8,297966,1590463.8
291465,201710,2223,1031,1192,965754.93,1116650.15,2082405.08
291470,201710,2734,1392,1342,1300585.95,1256455,2557040.95
291480,201710,11762,5216,6546,4876345.01,6124176.27,11000521.28
291490,201710,546,221,325,207077,304525,511602
291500,201710,365,195,170,182715,159290,342005
291510,201710,1260,467,793,436439.43,742759.9,1179199.33
291520,201710,956,430,526,402910,492852.63,895762.63
291530,201710,1008,269,739,252053,692143.26,944196.26
291535,201710,113,96,17,89952,15929,105881
291540,201710,364,108,256,101196,238935.8,340131.8
291550,201710,1176,547,629,510666.19,588792.9,1099459.09
291560,201710,5549,2850,2699,2657803.06,2517248.04,5175051.10
291570,201710,201,102,99,95574,92763,188337
291580,201710,1186,714,472,668265.63,442250.32,1110515.95
291590,201710,71,28,43,25934.64,40291,66225.64
291600,201710,1367,616,751,576255,703388,1279643
291610,201710,1339,601,738,561876.74,691451,1253327.74
291620,201710,557,255,302,238935,282599.2,521534.2
291630,201710,502,161,341,150857,319517,470374
291640,201710,3871,1919,1952,1792146.98,1827950.82,3620097.80
291650,201710,382,248,134,231261.97,124585.98,355847.95
291660,201710,454,182,272,169854.3,253786.45,423640.75
291670,201710,219,137,82,127807,76834,204641
291680,201710,706,400,306,374800,286629,661429
291685,201710,559,296,263,277118,246243.6,523361.6
291690,201710,561,283,278,265171,259549,524720
291700,201710,902,711,191,666207,178030,844237
291710,201710,1706,779,927,729239.34,867737.93,1596977.27
291720,201710,395,264,131,247363.32,122747,370110.32
291730,201710,927,530,397,495719.85,371979.63,867699.48
291733,201710,256,179,77,167441.9,72149,239590.9
291735,201710,67,51,16,47787,14992,62779
291740,201710,341,258,83,241043.25,77771,318814.25
291750,201710,1933,1282,651,1194078.48,608364.81,1802443.29
291760,201710,3074,1642,1432,1531787.69,1340097.5,2871885.19
291770,201710,795,534,261,498295.03,244557,742852.03
291780,201710,48,27,21,25299,19677,44976
291790,201710,167,77,90,72149,84330,156479
291800,201710,9793,3815,5978,3564432.37,5595292.94,9159725.31
291810,201710,1151,819,332,766585.22,311084,1077669.22
291820,201710,266,193,73,180841,68401,249242
291830,201710,1051,386,665,360483,622159,982642
291835,201710,631,570,61,533621.5,57157,590778.5
291840,201710,4590,2348,2242,2195368.62,2099930.18,4295298.80
291845,201710,308,105,203,98385,190182.89,288567.89
291850,201710,325,281,44,263062.75,41228,304290.75
291855,201710,264,108,156,101196,146172,247368
291860,201710,201,119,82,110567,76834,187401
291870,201710,81,33,48,30921,44976,75897
291875,201710,181,164,17,153668,15929,169597
291880,201710,485,378,107,353390,100259,453649
291890,201710,244,79,165,74013.63,152918.5,226932.13
291900,201710,57,32,25,29984,23425,53409
291905,201710,143,95,48,88734,44976,133710
291910,201710,181,145,36,135865,33732,169597
291915,201710,387,344,43,320690,40291,360981
291920,201710,4843,2488,2355,2328614.71,2204990.34,4533605.05
291930,201710,180,103,77,95574.7,72149,167723.7
291940,201710,310,170,140,158606.49,130116.21,288722.70
291950,201710,1110,911,199,852858,186463,1039321
291955,201710,964,571,393,535027,367820,902847
291960,201710,170,115,55,107755,51535,159290
291970,201710,786,597,189,559389,177093,736482
291980,201710,1489,1316,173,1229740.79,161164.7,1390905.49
291990,201710,122,114,8,106818,7496,114314
291992,201710,156,78,78,72336.4,73086,145422.4
291995,201710,149,104,45,97448,42165,139613
292000,201710,380,286,94,266764,88078,354842
292010,201710,278,201,77,187682,71212,258894
292020,201710,268,198,70,185526,65590,251116
292030,201710,138,107,31,100259,29047,129306
292040,201710,619,313,306,293281,286722,580003
292045,201710,85,77,8,72149,7496,79645
292050,201710,886,597,289,558398.26,270793,829191.26
292060,201710,928,769,159,718680.59,148983,867663.59
292070,201710,51,22,29,20614,27173,47787
292080,201710,113,78,35,73086,32795,105881
292090,201710,488,170,318,159102.6,297966,457068.6
292100,201710,1384,593,791,554095.35,741139.26,1295234.61
292105,201710,202,169,33,158353,30921,189274
292110,201710,2091,767,1324,718360.42,1238490.38,1956850.80
292120,201710,628,505,123,472072.96,115251,587323.96
292130,201710,441,257,184,240809,172408,413217
292140,201710,199,157,42,147109,39224.61,186333.61
292145,201710,152,80,72,74960,67435.9,142395.9
292150,201710,1396,1118,278,1047566,259476.57,1307042.57
292160,201710,181,149,32,139331.9,29984,169315.9
292170,201710,1213,1068,145,999053.13,135808.78,1134861.91
292180,201710,196,140,56,131180,52472,183652
292190,201710,160,98,62,91826,58094,149920
292200,201710,1259,460,799,430085.24,748026.68,1178111.92
292205,201710,114,103,11,96229.9,10307,106536.9
292210,201710,355,246,109,229144,101430.25,330574.25
292220,201710,22,15,7,14055,6559,20614
292225,201710,40,35,5,32795,4685,37480
292230,201710,898,727,171,678549.72,160227,838776.72
292240,201710,603,424,179,396211,167723,563934
292250,201710,1655,1046,609,980102,570633,1550735
292260,201710,435,241,194,225817,181028.4,406845.4
292265,201710,270,188,82,175874.9,76834,252708.9
292270,201710,778,336,442,314176.1,413217.4,727393.5
292273,201710,197,111,86,103243.34,80582,183825.34
292275,201710,157,73,84,68401,78426.9,146827.9
292280,201710,132,91,41,85267,38417,123684
292285,201710,56,47,9,43383.1,8433,51816.1
292290,201710,501,330,171,306765.01,159946,466711.01
292300,201710,1598,606,992,567259.9,928684.99,1495944.89
292303,201710,93,65,28,60905,26236,87141
292305,201710,108,76,32,71212,29984,101196
292310,201710,793,485,308,454090,287231.15,741321.15
292320,201710,641,487,154,456037.9,144298,600335.9
292330,201710,193,96,97,89952,90889,180841
292335,201710,270,205,65,192085,60905,252990
292340,201710,563,388,175,362829.93,163975,526804.93
292350,201710,261,136,125,126635.55,116843.9,243479.45
292360,201710,691,522,169,487427.5,158353,645780.5
292370,201710,785,597,188,559389,176156,735545
292380,201710,646,495,151,461778.5,141487,603265.5
292390,201710,508,188,320,176156,298106.75,474262.75
292400,201710,3330,2049,1281,1901003.63,1196767,3097770.63
292405,201710,258,171,87,159758.5,81237.9,240996.4
292410,201710,154,91,63,85267,59031,144298
292420,201710,305,262,43,245212.9,40291,285503.9
292430,201710,506,401,105,375737,97916.5,473653.5
292440,201710,574,488,86,455382.36,80582,535964.36
292450,201710,241,186,55,174282,51535,225817
292460,201710,585,429,156,401410.9,145469.25,546880.15
292465,201710,184,156,28,146172,25511.24,171683.24
292467,201710,96,54,42,50598,39354,89952
292470,201710,250,169,81,158353,75897,234250
292480,201710,306,206,100,192085.75,93419,285504.75
292490,201710,221,143,78,133991,73086,207077
292500,201710,1179,510,669,477663,626403.35,1104066.35
292510,201710,3270,1461,1809,1368020.36,1692354.35,3060374.71
292520,201710,1028,484,544,452332.75,509719,962051.75
292525,201710,381,267,114,250174.32,106818,356992.32
292530,201710,4164,1701,2463,1590942.52,2305829.96,3896772.48
292540,201710,480,254,226,237998,211762,449760
292550,201710,1050,557,493,521179.6,461471.64,982651.24
292560,201710,320,301,19,282037,17803,299840
292570,201710,294,224,70,209565,65590,275155
292575,201710,453,280,173,262079,162101,424180
292580,201710,902,567,335,529873.5,313555.82,843429.32
292590,201710,511,438,73,410108.98,68401,478509.98
292593,201710,142,112,30,104944,28110,133054
292595,201710,178,134,44,125558,41228,166786
292600,201710,1236,922,314,863602,293562.1,1157164.1
292610,201710,121,91,30,84798.5,27857.01,112655.51
292620,201710,514,426,88,398872,82456,481328
292630,201710,1351,778,573,727426.5,535308.5,1262735.0
292640,201710,762,530,232,496610,217384,713994
292650,201710,180,153,27,142930,25299,168229
292660,201710,1979,1413,566,1318262.02,525371.96,1843633.98
292665,201710,132,95,37,89015,34669,123684
292670,201710,376,315,61,295151,57157,352308
292680,201710,246,190,56,178030,51723,229753
292690,201710,177,133,44,124621,41228,165849
292700,201710,911,598,313,559389.9,293281,852670.9
292710,201710,98,86,12,80582,10963,91545
292720,201710,823,461,362,431169.92,339007,770176.92
292730,201710,210,100,110,92763.75,103070,195833.75
292740,201710,65082,32190,32892,30088985.83,30792671.37,60881657.20
292750,201710,375,267,108,249242.07,100400.01,349642.08
292760,201710,313,252,61,235131.25,57157,292288.25
292770,201710,783,336,447,314511,418819,733330
292780,201710,423,159,264,148759.53,247368,396127.53
292790,201710,725,350,375,327950,351140.75,679090.75
292800,201710,1116,681,435,637160,407595,1044755
292805,201710,420,123,297,114735.65,278289,393024.65
292810,201710,1467,856,611,801228.9,572216.63,1373445.53
292820,201710,739,595,144,555642.3,134637.9,690280.2
292830,201710,102,79,23,74023,21551,95574
292840,201710,642,529,113,495205,105866.95,601071.95
292850,201710,136,89,47,83389,44039,127428
292860,201710,2068,1213,855,1132490.07,801135,1933625.07
292870,201710,3315,2217,1098,2076088.9,1028816.63,3104905.53
292880,201710,1417,936,481,872630.33,450697,1323327.33
292890,201710,467,398,69,372898,64653,437551
292895,201710,136,91,45,83932.71,42165,126097.71
292900,201710,383,285,98,267045,91826,358871
292905,201710,443,226,217,211762,203142,414904
292910,201710,386,300,86,280773,80582,361355
292920,201710,536,236,300,221132,281100,502232
292925,201710,514,476,38,445346.73,35371.75,480718.48
292930,201710,554,341,213,319517,199581,519098
292935,201710,295,127,168,118999,157416,276415
292937,201710,234,157,77,147109,72149,219258
292940,201710,187,142,45,133054,42165,175219
292950,201710,1085,559,526,521722.6,491926,1013648.6
292960,201710,533,357,176,334509,164912,499421
292970,201710,276,188,88,175501,82456,257957
292975,201710,157,87,70,81519,65403,146922
292980,201710,254,171,83,158475.42,77771,236246.42
292990,201710,1286,947,339,880056.58,317459.26,1197515.84
293000,201710,101,75,26,70275,24352.63,94627.63
293010,201710,2632,1617,1015,1509446.72,948026.4,2457473.12
293015,201710,648,511,137,478593.37,127742,606335.37
293020,201710,337,275,62,257675,58094,315769
293030,201710,624,544,80,508229.82,74960,583189.82
293040,201710,339,265,74,248305,69338,317643
293050,201710,2679,1562,1117,1454959.23,1042572.39,2497531.62
293060,201710,252,200,52,186889,47787.4,234676.4
293070,201710,3292,1649,1643,1536700.79,1538292.26,3074993.05
293075,201710,89,57,32,53409,29984,83393
293076,201710,72,45,27,42165,25299,67464
293077,201710,430,262,168,241060.04,157416,398476.04
293080,201710,452,397,55,371989,51535,423524
293090,201710,129,111,18,104007,16553.7,120560.7
293100,201710,505,357,148,334509,138676,473185
293105,201710,337,228,109,213355,101851.9,315206.9
293110,201710,167,118,49,110566,45913,156479
293120,201710,315,209,106,195833,99134.6,294967.6
293130,201710,248,165,83,154605,77771,232376
293135,201710,7818,3088,4730,2887427.45,4423607.6,7311035.05
293140,201710,181,117,64,109629,59219,168848
293150,201710,329,283,46,263766.1,43102,306868.1
293160,201710,429,239,190,223943,178030,401973
293170,201710,185,128,57,119654.9,52566,172220.9
293180,201710,453,308,145,288315,135865,424180
293190,201710,1268,877,391,817184.98,366289,1183473.98
293200,201710,523,461,62,430896,58094,488990
293210,201710,333,244,89,228479,82690.25,311169.25
293220,201710,2684,1078,1606,1008185.08,1502667.95,2510853.03
293230,201710,1777,638,1139,596401.9,1067243,1663644.9
293240,201710,219,199,20,186463,18740,205203
293245,201710,109,92,17,86204,15929,102133
293250,201710,739,274,465,256102.24,435705,691807.24
293260,201710,308,257,51,239872.89,47787,287659.89
293270,201710,1175,558,617,520973.48,578129,1099102.48
293280,201710,237,131,106,122747,99322,222069
293290,201710,3073,1990,1083,1862236.47,1014477,2876713.47
293300,201710,685,485,200,452622.79,186603.55,639226.34
293305,201710,165,138,27,129306,25299,154605
293310,201710,136,102,34,95574,31858,127432
293315,201710,155,120,35,112440,32795,145235
293317,201710,95,67,28,62779,26236,89015
293320,201710,937,532,405,497547.25,379485,877032.25
293325,201710,182,67,115,62779,107717.52,170496.52
293330,201710,12626,5857,6769,5476744.79,6336422.88,11813167.67
293340,201710,245,178,67,166786,61842,228628
293345,201710,243,193,50,180841,46850,227691
293350,201710,626,320,306,299840,285269.65,585109.65
293360,201710,1560,1109,451,1037915,421314.71,1459229.71
310010,201710,153,75,78,70275,72805,143080
310020,201710,1048,573,475,533746.65,442312.16,976058.81
310030,201710,323,261,62,243452.14,57812.9,301265.04
310040,201710,50,32,18,29984,16866,46850
310050,201710,177,114,63,105881.2,59031,164912.2
310060,201710,237,165,72,153856,67464,221320
310070,201710,17,8,9,7496,8433,15929
310080,201710,51,28,23,26236,21551,47787
310090,201710,953,496,457,459600.04,427084.8,886684.84
310100,201710,294,219,75,205203,70275,275478
310110,201710,735,396,339,370036.09,316706,686742.09
310120,201710,383,215,168,200799.1,157048.61,357847.71
310130,201710,33,21,12,19677,11244,30921
310140,201710,30,16,14,14992,13118,28110
310150,201710,1274,875,399,815754.06,373300.9,1189054.96
310160,201710,2115,1069,1046,995377.55,977384.8,1972762.35
310163,201710,89,47,42,44039,39354,83393
310170,201710,2549,1039,1510,973422,1412340.3,2385762.3
310180,201710,123,45,78,42165,72711.2,114876.2
310190,201710,476,315,161,295155,150294.8,445449.8
310200,201710,509,320,189,299840,177093,476933
310205,201710,58,45,13,42165,12181,54346
310210,201710,288,230,58,215510,54346,269856
310220,201710,52,31,21,29047,19677,48724
310230,201710,262,185,77,173157.6,72149,245306.6
310240,201710,105,92,13,85969.75,12181,98150.75
310250,201710,97,78,19,73086,17803,90889
310260,201710,797,425,372,395602.35,347842.51,743444.86
310270,201710,267,179,88,167180,82456,249636
310280,201710,363,270,93,252335,87141,339476
310285,201710,218,155,63,144932.35,59031,203963.35
310290,201710,256,147,109,137739,102133,239872
310300,201710,155,127,28,118999,26236,145235
310310,201710,6,4,2,3748,1874,5622
310320,201710,21,14,7,13118,6559,19677
310330,201710,32,23,9,21551,8433,29984
310340,201710,1682,1073,609,997796.75,569134.25,1566931.00
310350,201710,2797,1515,1282,1414827.85,1200662.9,2615490.75
310360,201710,41,33,8,30921,7496,38417
310370,201710,119,98,21,91826,19396,111222
310375,201710,108,37,71,34669,66509,101178
310380,201710,52,30,22,28110,20614,48724
310390,201710,102,72,30,67464,28110,95574
310400,201710,2280,1472,808,1375423.5,756796.9,2132220.4
310410,201710,126,68,58,63716,54346,118062
310420,201710,670,359,311,334322.9,290461.43,624784.33
310430,201710,334,219,115,204921.9,107755,312676.9
310440,201710,62,37,25,34669,23425,58094
310445,201710,82,66,16,61842,14992,76834
310450,201710,856,537,319,501701.1,298903,800604.1
310460,201710,263,186,77,174282,72149,246431
310470,201710,492,310,182,290470,170534,461004
310480,201710,77,55,22,51535,20614,72149
310490,201710,483,230,253,214573.1,237061,451634.1
310500,201710,127,57,70,53409,65590,118999
310510,201710,618,402,216,375452.8,202373.63,577826.43
310520,201710,129,87,42,81519,39354,120873
310530,201710,85,40,45,37480,41883.9,79363.9
310540,201710,444,278,166,258145.3,155542,413687.3
310550,201710,86,56,30,52472,28110,80582
310560,201710,2879,1987,892,1852170.5,834206.42,2686376.92
310570,201710,157,101,56,94637,52472,147109
310590,201710,343,226,117,211341,109614.95,320955.95
310600,201710,158,93,65,84770.85,60905,145675.85
310610,201710,57,20,37,18740,34669,53409
310620,201710,45038,21537,23501,20106322.76,21983305.76,42089628.52
310630,201710,577,368,209,342849.05,194365.71,537214.76
310640,201710,136,114,22,106630.6,20614,127244.6
310650,201710,156,137,19,127432,17803,145235
310660,201710,90,56,34,52472,31858,84330
310665,201710,54,38,16,35606,14992,50598
310670,201710,6199,2904,3295,2713066.81,3082554.52,5795621.33
310680,201710,53,35,18,32795,16866,49661
310690,201710,589,426,163,395032.73,152731,547763.73
310700,201710,65,42,23,39354,21410.45,60764.45
310710,201710,1249,825,424,771990.26,396725.9,1168716.16
310720,201710,82,28,54,26236,50598,76834
310730,201710,1358,932,426,873003,399162,1272165
310740,201710,1008,570,438,530811.2,410162.63,940973.83
310750,201710,246,144,102,133991.29,95574,229565.29
310760,201710,66,50,16,46850,14992,61842
310770,201710,90,45,45,42165,42165,84330
310780,201710,408,333,75,312012,70275,382287
310790,201710,99,80,19,74960,17803,92763
310800,201710,457,223,234,208482.5,218976.9,427459.4
310810,201710,165,116,49,107652.1,44976,152628.1
310820,201710,367,290,77,271730,71867.9,343597.9
310825,201710,194,159,35,148983,32795,181778
310830,201710,461,220,241,205491.61,225535.9,431027.51
310840,201710,390,225,165,210544,154605,365149
310850,201710,111,90,21,84330,19677,104007
310855,201710,376,296,80,277352,74960,352312
310860,201710,1373,1028,345,957569.05,321560.95,1279130.00
310870,201710,54,43,11,40291,10307,50598
310880,201710,79,61,18,56875.9,16866,73741.9
310890,201710,312,183,129,171471,120873,292344
310900,201710,642,297,345,275417.3,322965.9,598383.2
310910,201710,246,169,77,157042.1,71868,228910.1
310920,201710,493,297,196,274542.1,182715.7,457257.8
310925,201710,27,21,6,19677,5341,25018
310930,201710,1095,653,442,611465.1,414059.88,1025524.98
310940,201710,677,348,329,325485.9,308273,633758.9
310945,201710,114,71,43,66527,40291,106818
310950,201710,254,199,55,186463,51535,237998
310960,201710,86,31,55,29047,51531,80578
310970,201710,166,103,63,96511,58125.2,154636.2
310980,201710,42,23,19,21551,17803,39354
310990,201710,153,86,67,80301,62779,143080
311000,201710,826,416,410,386327.9,384161,770488.9
311010,201710,38,31,7,29047,6559,35606
311020,201710,41,26,15,24362,14055,38417
311030,201710,391,230,161,213637,150857,364494
311040,201710,38,33,5,30921,4685,35606
311050,201710,466,195,271,182153,253364.8,435517.8
311060,201710,751,435,316,406190.2,295811,702001.2
311070,201710,320,144,176,134928,164912,299840
311080,201710,108,59,49,55283,45913,101196
311090,201710,397,184,213,171471,199581,371052
311100,201710,613,366,247,342942,231157.9,574099.9
311110,201710,671,461,210,431957,196761,628718
311115,201710,66,48,18,44976,16866,61842
311120,201710,1020,537,483,501245.4,451680.95,952926.35
311130,201710,409,240,169,224692.6,158353,383045.6
311140,201710,160,77,83,72149,76974.55,149123.55
311150,201710,355,230,125,215393,116890.75,332283.75
311160,201710,730,529,201,493799.7,187869,681668.7
311170,201710,79,57,22,53409,20332.9,73741.9
311180,201710,343,226,117,211480.9,109348,320828.9
311190,201710,36,19,17,17803,15929,33732
311200,201710,342,235,107,218602.3,100259,318861.3
311205,201710,29,19,10,17568.75,8995.2,26563.95
311210,201710,48,40,8,36975,7496,44471
311220,201710,13,11,2,10307,1874,12181
311230,201710,1628,1053,575,983590.65,538775,1522365.65
311240,201710,167,102,65,95373.96,60905,156278.96
311250,201710,70,30,40,28110,37480,65590
311260,201710,557,347,210,325139,196770,521909
311265,201710,107,72,35,67464,32795,100259
311270,201710,281,198,83,185526,77771,263297
311280,201710,213,98,115,91826,107192.8,199018.8
311290,201710,111,90,21,84049,19115,103164
311300,201710,542,340,202,317643.88,188712,506355.88
311310,201710,23,19,4,17803,3748,21551
311320,201710,674,505,169,472248,158353,630601
311330,201710,1023,757,266,708981.75,248305.7,957287.45
311340,201710,2593,1851,742,1727091.82,694655.67,2421747.49
311350,201710,267,208,59,194896,55283,250179
311360,201710,170,105,65,98385,60905,159290
311370,201710,1198,478,720,445931.25,674077.8,1120009.05
311380,201710,7,6,1,5622,937,6559
311390,201710,279,149,130,139613,121341.6,260954.6
311400,201710,149,97,52,90889,48715,139604
311410,201710,92,53,39,49661,36543,86204
311420,201710,296,164,132,152075.15,123684,275759.15
311430,201710,858,556,302,519943,282974,802917
311440,201710,479,333,146,312021,136520.9,448541.9
311450,201710,315,194,121,181778,113377,295155
311455,201710,305,205,100,191794.9,93418.9,285213.8
311460,201710,128,52,76,48724,70089.83,118813.83
311470,201710,20,10,10,9370,9370,18740
311480,201710,23,9,14,8433,13118,21551
311490,201710,17,10,7,9370,6559,15929
311500,201710,20,9,11,8433,10307,18740
311510,201710,632,437,195,407561.75,182433.9,589995.65
311520,201710,44,33,11,30265.1,10307,40572.1
311530,201710,1820,1352,468,1258488.56,438516,1697004.56
311535,201710,64,50,14,46850,13118,59968
311540,201710,33,29,4,27173,3748,30921
311545,201710,184,138,46,129306,43102,172408
311547,201710,31,22,9,20614,8433,29047
311550,201710,607,280,327,262360,306380.63,568740.63
311560,201710,41,28,13,26236,12181,38417
311570,201710,306,201,105,187774.8,98385,286159.8
311580,201710,296,172,124,160882.9,116188,277070.9
311590,201710,33,29,4,27173,3748,30921
311600,201710,90,71,19,66527,17803,84330
311610,201710,264,231,33,215197.95,30921,246118.95
311615,201710,93,78,15,72458.21,14055,86513.21
311620,201710,17,11,6,10307,5622,15929
311630,201710,82,69,13,64653,12181,76834
311640,201710,119,68,51,63716,47787,111503
311650,201710,126,93,33,86438.25,30921,117359.25
311660,201710,397,190,207,178030,193959,371989
311670,201710,158,103,55,96271,51535,147806
311680,201710,224,164,60,152782.97,55470.4,208253.37
311690,201710,17,10,7,9370,6559,15929
311700,201710,200,136,64,127150.9,59968,187118.9
311710,201710,222,141,81,132117,75897,208014
311720,201710,38,28,10,26236,9370,35606
311730,201710,535,352,183,329262,171471,500733
311740,201710,34,23,11,21551,10307,31858
311750,201710,707,484,223,451634.4,208951,660585.4
311760,201710,65,37,28,34669,26236,60905
311770,201710,399,191,208,177093.61,194896,371989.61
311780,201710,165,95,70,89015,65278,154293
311783,201710,78,69,9,64653,8433,73086
311787,201710,36,16,20,14992,18740,33732
311790,201710,267,130,137,121810,128369,250179
311800,201710,628,432,196,401459.15,183652,585111.15
311810,201710,42,36,6,33732,5622,39354
311820,201710,106,87,19,81519,17803,99322
311830,201710,1839,1190,649,1110459.25,604834.4,1715293.65
311840,201710,1008,559,449,519567.95,418989.77,938557.72
311850,201710,8,5,3,4685,2811,7496
311860,201710,9327,4297,5030,4010543.09,4704485.18,8715028.27
311870,201710,155,85,70,79645,65590,145235
311880,201710,948,708,240,662168.9,224880,887048.9
311890,201710,221,114,107,106818,100259,207077
311900,201710,89,37,52,34669,48724,83393
311910,201710,1366,855,511,798278.05,476605.15,1274883.20
311920,201710,228,148,80,138442,74960,213402
311930,201710,903,523,380,488270.03,355544.9,843814.93
311940,201710,2388,1214,1174,1135223.35,1097273.95,2232497.30
311950,201710,30,20,10,18740,9370,28110
311960,201710,70,49,21,45913,19677,65590
311970,201710,25,14,11,13118,10307,23425
311980,201710,43,32,11,29984,10307,40291
311990,201710,59,44,15,41228,14055,55283
311995,201710,63,43,20,40291,18740,59031
312000,201710,34,24,10,22206.9,9370,31576.9
312010,201710,85,62,23,58094,21551,79645
312015,201710,94,70,24,65309,22488,87797
312020,201710,138,85,53,79645,49661,129306
312030,201710,40,34,6,30922,5622,36544
312040,201710,77,49,28,45913,26236,72149
312050,201710,224,117,107,109629,100259,209888
312060,201710,71,47,24,44039,21832.1,65871.1
312070,201710,77,45,32,42165,29984,72149
312080,201710,524,226,298,211762,279226,490988
312083,201710,45,33,12,30921,11244,42165
312087,201710,106,83,23,77771,21551,99322
312090,201710,2766,1546,1220,1436987.85,1138178.78,2575166.63
312100,201710,161,114,47,106818,43271,150089
312110,201710,120,76,44,71212,41228,112440
312120,201710,146,106,40,99322,37480,136802
312125,201710,93,52,41,48536.6,38417,86953.6
312130,201710,123,81,42,75897,39354,115251
312140,201710,131,103,28,96511,26236,122747
312150,201710,43,35,8,32795,7496,40291
312160,201710,1522,1015,507,947683.44,473447.78,1421131.22
312170,201710,12,10,2,9370,1874,11244
312180,201710,129,85,44,78709,40947,119656
312190,201710,32,29,3,27173,2811,29984
312200,201710,722,621,101,579787.35,94637,674424.35
312210,201710,99,64,35,59968,32795,92763
312220,201710,126,93,33,86907,30921,117828
312230,201710,3415,1689,1726,1578593.79,1615681.86,3194275.65
312235,201710,141,94,47,88078,44039,132117
312240,201710,113,74,39,69338,36543,105881
312245,201710,158,108,50,101192,46850,148042
312247,201710,55,39,16,35794,14992,50786
312250,201710,183,86,97,80114,90889,171003
312260,201710,99,67,32,61936.6,29984,91920.6
312270,201710,136,86,50,80582,46850,127432
312280,201710,24,14,10,13118,9370,22488
312290,201710,159,111,48,103725.9,44040,147765.9
312300,201710,195,133,62,124621,58094,182715
312310,201710,57,52,5,48724,4685,53409
312320,201710,426,267,159,248305.55,147718.25,396023.80
312330,201710,90,77,13,71400,11899.9,83299.9
312340,201710,36,16,20,14992,18740,33732
312350,201710,16,10,6,9370,5622,14992
312352,201710,95,66,29,61842,27173,89015
312360,201710,564,259,305,241746,285785,527531
312370,201710,294,177,117,165567.9,109629,275196.9
312380,201710,138,87,51,81519,47787,129306
312385,201710,183,148,35,138676,32795,171471
312390,201710,299,191,108,178967,100541,279508
312400,201710,376,284,92,266108,85736,351844
312410,201710,841,271,570,253458.5,533524,786982.5
312420,201710,604,486,118,454726.1,110566,565292.1
312430,201710,859,634,225,591483.94,209888.1,801372.04
312440,201710,44,32,12,29984,11244,41228
312450,201710,209,131,78,122747,73086,195833
312460,201710,55,26,29,24362,27173,51535
312470,201710,58,36,22,33732,20614,54346
312480,201710,212,130,82,121810,76552.9,198362.9
312490,201710,250,169,81,158353,75897,234250
312500,201710,33,18,15,16866,14055,30921
312510,201710,417,157,260,147109,243015.36,390124.36
312520,201710,40,14,26,13118,24362,37480
312530,201710,46,35,11,32795,10307,43102
312540,201710,100,87,13,81519,12181,93700
312550,201710,38,30,8,28110,7496,35606
312560,201710,196,141,55,131836,51253.9,183089.9
312570,201710,439,260,179,242964.1,167044.23,410008.33
312580,201710,82,43,39,40291,36543,76834
312590,201710,272,216,56,201316,52472,253788
312595,201710,143,131,12,122747,11244,133991
312600,201710,76,47,29,43618,27173,70791
312610,201710,1611,843,768,784413.29,717836.2,1502249.49
312620,201710,187,129,58,120873,54341.32,175214.32
312630,201710,64,53,11,49661,10307,59968
312640,201710,48,15,33,14055,30921,44976
312650,201710,146,119,27,111222,25018,136240
312660,201710,66,50,16,46569,14992,61561
312670,201710,868,570,298,532544.95,279016.15,811561.10
312675,201710,42,31,11,29047,10307,39354
312680,201710,84,58,26,53971.2,24362,78333.2
312690,201710,245,131,114,122737.63,106536.9,229274.53
312695,201710,30,24,6,22488,5622,28110
312700,201710,197,113,84,105881,78708,184589
312705,201710,71,60,11,56220,10307,66527
312707,201710,92,68,24,63435,22488,85923
312710,201710,1859,989,870,924951,814982,1739933
312720,201710,63,31,32,29047,29984,59031
312730,201710,288,170,118,158353,110284.9,268637.9
312733,201710,50,43,7,40291,6559,46850
312735,201710,21,15,6,14055,5622,19677
312737,201710,70,38,32,35606,29984,65590
312738,201710,50,35,15,32795,14055,46850
312740,201710,71,50,21,46850,19677,66527
312750,201710,73,53,20,49661,18740,68401
312760,201710,273,198,75,185526,70275,255801
312770,201710,7623,3511,4112,3266771.63,3844433.7,7111205.33
312780,201710,436,338,98,316424.9,91826,408250.9
312790,201710,20,15,5,14055,4685,18740
312800,201710,1586,1108,478,1031598.98,446725.11,1478324.09
312810,201710,373,238,135,223006,126495,349501
312820,201710,194,148,46,138676,43102,181778
312825,201710,28,19,9,17803,8433,26236
312830,201710,291,168,123,156480,114624,271104
312840,201710,149,111,38,104007,35606,139613
312850,201710,22,20,2,18740,1874,20614
312860,201710,171,107,64,99978,59968,159946
312870,201710,976,511,465,476058.85,435705,911763.85
312880,201710,149,104,45,97307.45,42071.3,139378.75
312890,201710,162,110,52,103070,48724,151794
312900,201710,210,156,54,145516.1,50598,196114.1
312910,201710,187,95,92,87865.66,86204,174069.66
312920,201710,158,87,71,81519,66527,148046
312930,201710,339,247,92,231439,86204,317643
312940,201710,101,68,33,63716,30921,94637
312950,201710,694,448,246,418464.3,229847,648311.3
312960,201710,175,133,42,124621,39354,163975
312965,201710,47,42,5,39354,4685,44039
312970,201710,277,224,53,208951.1,49661,258612.1
312980,201710,2290,1225,1065,1143414.7,997338.8,2140753.5
312990,201710,49,28,21,26236,19677,45913
313000,201710,39,25,14,23425,13118,36543
313005,201710,164,125,39,116150.75,36262,152412.75
313010,201710,933,384,549,358589.9,514122.9,872712.8
313020,201710,193,99,94,92294.5,88078,180372.5
313030,201710,208,132,76,121580.09,71212,192792.09
313040,201710,57,20,37,18740,34669,53409
313050,201710,293,206,87,192085.1,81519,273604.1
313055,201710,45,32,13,29984,12181,42165
313060,201710,121,81,40,75897,37198.9,113095.9
313065,201710,61,39,22,36543,20614,57157
313070,201710,155,83,72,77771,67464,145235
313080,201710,39,17,22,15929,20614,36543
313090,201710,694,477,217,444981.4,203329,648310.4
313100,201710,167,64,103,59968,96503,156471
313110,201710,122,73,49,68401,45913,114314
313115,201710,144,77,67,71952.23,61842,133794.23
313120,201710,740,399,341,373582,318018,691600
313130,201710,5071,2710,2361,2516291.38,2201803.82,4718095.20
313140,201710,164,84,80,78708,74960,153668
313150,201710,316,253,63,237061,58749.9,295810.9
313160,201710,186,134,52,125558,48724,174282
313170,201710,1309,926,383,854874.04,358487.2,1213361.24
313180,201710,331,193,138,180203.84,129306,309509.84
313190,201710,718,423,295,393352.6,275666,669018.6
313200,201710,22,21,1,19677,937,20614
313210,201710,1037,869,168,811303.48,157411.32,968714.80
313220,201710,225,154,71,143361,65824.25,209185.25
313230,201710,275,200,75,186464,70275,256739
313240,201710,1900,1019,881,952172.27,822025.52,1774197.79
313250,201710,1245,911,334,847050.1,310149.4,1157199.5
313260,201710,90,53,37,49661,34669,84330
313270,201710,953,557,396,517926.77,371052,888978.77
313280,201710,60,52,8,48255.51,7496,55751.51
313290,201710,225,182,43,170253,39354.9,209607.9
313300,201710,366,183,183,169316.3,171471,340787.3
313310,201710,219,113,106,105881,99322,205203
313320,201710,364,279,85,259502.55,79645,339147.55
313330,201710,1347,805,542,753348.6,506683.75,1260032.35
313340,201710,335,229,106,214573,99322,313895
313350,201710,524,352,172,327950.05,161164,489114.05
313360,201710,118,67,51,62779,47506,110285
313370,201710,195,76,119,71212,111503,182715
313375,201710,259,156,103,146172,96511,242683
313380,201710,1246,631,615,588454.84,575689,1164143.84
313390,201710,47,39,8,35606.4,7496,43102.4
313400,201710,417,269,148,252053,138395,390448
313410,201710,18,9,9,8433,8433,16866
313420,201710,4648,2395,2253,2235282.29,2104212.81,4339495.10
313430,201710,131,62,69,58094,64653,122747
313440,201710,1445,966,479,903971.75,447980,1351951.75
313450,201710,63,27,36,25299,33450.9,58749.9
313460,201710,371,178,193,165368,180841,346209
313470,201710,520,235,285,220195,266389.1,486584.1
313480,201710,160,109,51,101197,47787,148984
313490,201710,500,242,258,226749.32,241700,468449.32
313500,201710,18,11,7,10307,6559,16866
313505,201710,947,731,216,684073,202392,886465
313507,201710,89,53,36,49661,33732,83393
313510,201710,2759,1768,991,1651346.47,927630,2578976.47
313520,201710,3587,2801,786,2612881.44,736478,3349359.44
313530,201710,40,29,11,27173,10307,37480
313535,201710,103,84,19,78053,17803,95856
313540,201710,71,55,16,51535,14992,66527
313545,201710,103,84,19,78708,17803,96511
313550,201710,235,191,44,178967,40947,219914
313560,201710,329,172,157,161164,147109,308273
313570,201710,57,31,26,29047,24362,53409
313580,201710,1284,697,587,651777.2,548332.7,1200109.9
313590,201710,79,47,32,44039,29984,74023
313600,201710,694,412,282,386044,263391,649435
313610,201710,54,43,11,39682.9,10307,49989.9
313620,201710,1317,701,616,646841.16,573781.5,1220622.66
313630,201710,1628,1247,381,1166641,356716,1523357
313640,201710,124,70,54,65590,50598,116188
313650,201710,235,110,125,103070,117125,220195
313652,201710,15,14,1,13118,937,14055
313655,201710,52,31,21,29047,19677,48724
313657,201710,46,42,4,39354,3748,43102
313660,201710,125,91,34,85267,31858,117125
313665,201710,623,311,312,291407,292109.75,583516.75
313670,201710,10051,6971,3080,6509667.87,2885398,9395065.87
313680,201710,39,29,10,27173,9370,36543
313690,201710,157,121,36,113377,33732,147109
313695,201710,62,47,15,44039,14055,58094
313700,201710,289,231,58,216166,54346,270512
313710,201710,151,102,49,95574,45913,141487
313720,201710,1013,483,530,449853.8,495236.83,945090.63
313730,201710,56,40,16,37480,14992,52472
313740,201710,161,127,34,118999,31858,150857
313750,201710,446,323,123,302369.9,115251,417620.9
313753,201710,243,170,73,158634.1,68401,227035.1
313760,201710,1193,430,763,402910,712243.56,1115153.56
313770,201710,346,245,101,229565,94637,324202
313780,201710,750,389,361,364493,337975.9,702468.9
313790,201710,26,25,1,23425,937,24362
313800,201710,139,84,55,78708,51535,130243
313810,201710,59,35,24,32795,22488,55283
313820,201710,1282,639,643,597806.1,601531.1,1199337.2
313830,201710,67,51,16,47787,14992,62779
313835,201710,52,47,5,44039,4685,48724
313840,201710,1638,1001,637,933348.2,595651,1528999.2
313850,201710,179,61,118,57157,109996.39,167153.39
313860,201710,485,379,106,352313.7,98385.55,450699.25
313862,201710,175,114,61,106818,57157,163975
313865,201710,82,63,19,59031,17803,76834
313867,201710,50,38,12,35606,11244,46850
313868,201710,26,17,9,15180,8433,23613
313870,201710,122,64,58,59968,54346,114314
313880,201710,325,207,118,193677.9,110003.9,303681.8
313890,201710,320,173,147,161351.9,137176.8,298528.7
313900,201710,924,498,426,465034.25,399116,864150.25
313910,201710,134,94,40,88078,36543.1,124621.1
313920,201710,600,430,170,402722.6,159290,562012.6
313925,201710,31,26,5,24362,4685,29047
313930,201710,794,611,183,572507,171448,743955
313940,201710,1744,1092,652,1018800.2,610268.2,1629068.4
313950,201710,938,594,344,554798.8,322046.9,876845.7
313960,201710,1366,782,584,728546.65,545990,1274536.65
313970,201710,118,85,33,79645,30921,110566
313980,201710,205,131,74,122513,69338,191851
313990,201710,353,213,140,199018.8,131103,330121.8
314000,201710,903,613,290,570681.45,271725.32,842406.77
314010,201710,74,47,27,44039,25299,69338
314015,201710,61,20,41,18740,38417,57157
314020,201710,50,34,16,31858,14898.3,46756.3
314030,201710,97,47,50,44039,46850,90889
314040,201710,44,31,13,29047,12181,41228
314050,201710,309,180,129,168379,119378.49,287757.49
314053,201710,100,65,35,59968.2,32795,92763.2
314055,201710,288,167,121,156479,113377,269856
314060,201710,145,122,23,113377,21551,134928
314070,201710,933,466,467,432623.67,436679.63,869303.30
314080,201710,215,143,72,133757,66434.14,200191.14
314085,201710,117,77,40,72149,37480,109629
314090,201710,340,245,95,229565,89010.32,318575.32
314100,201710,471,384,87,355936,80957,436893
314110,201710,695,377,318,351384.37,297263.8,648648.17
314120,201710,99,54,45,50598,42165,92763
314130,201710,24,12,12,11244,11244,22488
314140,201710,1084,644,440,601816.46,410406.23,1012222.69
314150,201710,168,106,62,99322,58094,157416
314160,201710,358,262,96,242402.3,89765,332167.3
314170,201710,69,51,18,47037.4,16866,63903.4
314180,201710,724,632,92,591903,85267.25,677170.25
314190,201710,101,60,41,56220,38417,94637
314200,201710,591,405,186,377955.7,173345,551300.7
314210,201710,273,205,68,191803.9,63435,255238.9
314220,201710,314,236,78,219259,72805,292064
314225,201710,65,44,21,41228,19677,60905
314230,201710,103,46,57,43102,53409,96511
314240,201710,138,106,32,99322,29984,129306
314250,201710,59,35,24,32795,22488,55283
314260,201710,187,97,90,90889,84330,175219
314270,201710,333,258,75,240997,69994,310991
314280,201710,680,379,301,355114,282037,637151
314290,201710,553,441,112,411999.25,104662.9,516662.15
314300,201710,412,294,118,272594.5,110520,383114.5
314310,201710,1420,947,473,886403,442900.33,1329303.33
314315,201710,35,28,7,26236,6559,32795
314320,201710,600,380,220,355497.9,205231.21,560729.11
314330,201710,10654,5378,5276,5027075.47,4938927.32,9966002.79
314340,201710,570,266,304,248679.9,284286,532965.9
314345,201710,27,20,7,18740,6559,25299
314350,201710,183,111,72,104007,67464,171471
314360,201710,77,46,31,43102,29047,72149
314370,201710,58,49,9,45913,8433,54346
314380,201710,91,66,25,61842,23425,85267
314390,201710,3136,1990,1146,1860133.15,1070897.7,2931030.85
314400,201710,676,487,189,453500.1,177093,630593.1
314410,201710,420,270,150,252990,140550,393540
314420,201710,19,9,10,8433,9370,17803
314430,201710,2492,889,1603,830245.9,1499373.79,2329619.69
314435,201710,276,158,118,147764.9,109629,257393.9
314437,201710,26,20,6,18740,5622,24362
314440,201710,98,69,29,64653,27173,91826
314450,201710,153,116,37,108692,34669,143361
314460,201710,651,299,352,280163,329824,609987
314465,201710,80,56,24,52472,22488,74960
314467,201710,68,58,10,54337,9370,63707
314470,201710,354,179,175,163873.1,163038.75,326911.85
314480,201710,1015,497,518,465689,485178.6,950867.6
314490,201710,89,67,22,62779,20614,83393
314500,201710,314,205,109,192085,102133,294218
314505,201710,129,83,46,77771,43102,120873
314510,201710,228,182,46,170253,43102,213355
314520,201710,1209,628,581,580632.85,542476.45,1123109.30
314530,201710,677,539,138,504239,129306,633545
314535,201710,205,128,77,118905.3,71902.48,190807.78
314537,201710,61,35,26,32795,24362,57157
314540,201710,13,9,4,8433,3748,12181
314545,201710,50,34,16,31858,14992,46850
314550,201710,76,42,34,39354,31858,71212
314560,201710,802,432,370,402629,346690,749319
314570,201710,21,16,5,14992,4685,19677
314580,201710,19,9,10,8433,9370,17803
314585,201710,20,14,6,13118,5622,18740
314587,201710,84,72,12,67464,11244,78708
314590,201710,539,398,141,372926,132117,505043
314600,201710,978,628,350,585056.39,325701.4,910757.79
314610,201710,924,509,415,474731.4,387731.15,862462.55
314620,201710,144,106,38,98104,35606,133710
314625,201710,94,71,23,65684,21551,87235
314630,201710,1239,639,600,597009.65,561918.9,1158928.55
314640,201710,89,59,30,55283,28110,83393
314650,201710,203,117,86,108923.9,80113.5,189037.4
314655,201710,66,51,15,47787,14055,61842
314660,201710,18,14,4,13118,3748,16866
314670,201710,186,147,39,137458,36543,174001
314675,201710,212,118,94,110566,88078,198644
314690,201710,539,299,240,279881.9,224880,504761.9
314700,201710,2425,1322,1103,1233374.6,1032901.95,2266276.55
314710,201710,1635,954,681,890902.05,637487.95,1528390.00
314720,201710,405,239,166,223006,155542,378548
314730,201710,503,269,234,250648,219249,469897
314740,201710,678,330,348,307570.25,326076,633646.25
314750,201710,23,20,3,18740,2811,21551
314760,201710,304,151,153,141487,143351.63,284838.63
314770,201710,119,82,37,76834,34669,111503
314780,201710,21,6,15,5622,14055,19677
314790,201710,2319,1448,871,1350209.85,815253.73,2165463.58
314795,201710,52,45,7,41931,6559,48490
314800,201710,2865,1659,1206,1549290.46,1128420.1,2677710.56
314810,201710,1485,824,661,769793.25,617764.5,1387557.75
314820,201710,89,48,41,44976,38417,83393
314830,201710,206,163,43,152028.75,40010,192038.75
314840,201710,82,48,34,44976,31858,76834
314850,201710,341,169,172,158353,161164,319517
314860,201710,708,532,176,496516.79,163413.35,659930.14
314870,201710,1428,721,707,674640.5,662459,1337099.5
314875,201710,57,49,8,45913,7496,53409
314880,201710,47,34,13,31858,12181,44039
314890,201710,48,30,18,28110,16866,44976
314900,201710,29,24,5,22488,4685,27173
314910,201710,259,172,87,160882.9,81519,242401.9
314915,201710,151,133,18,124387,16866,141253
314920,201710,126,75,51,70275,47505.9,117780.9
314930,201710,1011,514,497,479793,465407.9,945200.9
314940,201710,54,42,12,39354,11244,50598
314950,201710,39,29,10,26470.25,9370,35840.25
314960,201710,60,44,16,41228,14992,56220
314970,201710,133,67,66,62217,61842,124059
314980,201710,304,197,107,182387.05,99322,281709.05
314990,201710,465,253,212,236124.25,197754.75,433879.00
314995,201710,188,64,124,59968,116178.63,176146.63
315000,201710,83,66,17,61842,15929,77771
315010,201710,47,31,16,29047,14992,44039
315015,201710,172,140,32,130467.88,29984,160451.88
315020,201710,61,52,9,48724,8433,57157
315030,201710,118,91,27,84331,25299,109630
315040,201710,66,49,17,45913,15929,61842
315050,201710,196,117,79,109629,74023,183652
315053,201710,39,34,5,31858,4685,36543
315057,201710,98,82,16,76459.2,14992,91451.2
315060,201710,71,65,6,59031.98,5622,64653.98
315070,201710,104,59,45,55283,42165,97448
315080,201710,367,303,64,283911,59968,343879
315090,201710,111,67,44,62779,41228,104007
315100,201710,72,38,34,35606,31858,67464
315110,201710,291,162,129,150951,120873,271824
315120,201710,1621,809,812,754145.1,759673,1513818.1
315130,201710,322,234,88,219258,82456,301714
315140,201710,531,309,222,287940.1,208014,495954.1
315150,201710,973,456,517,426336,484148,910484
315160,201710,205,105,100,98385,93700,192085
315170,201710,339,219,120,204267,112158.9,316425.9
315180,201710,3210,1362,1848,1272119.05,1728251.2,3000370.25
315190,201710,310,179,131,167349,122747,290096
315200,201710,1168,665,503,620388.53,470748.8,1091137.33
315210,201710,1512,855,657,796826.35,613233.6,1410059.95
315213,201710,41,26,15,24362,14055,38417
315217,201710,196,154,42,144298,39354,183652
315220,201710,1482,1134,348,1061948.3,325982.3,1387930.6
315230,201710,169,124,45,115907,42165,158072
315240,201710,426,273,153,255801,142181.25,397982.25
315250,201710,2525,1254,1271,1173405.2,1189616.07,2363021.27
315260,201710,147,90,57,83018.2,53409,136427.2
315270,201710,125,83,42,76646.6,38641.88,115288.48
315280,201710,688,450,238,421276,222996.63,644272.63
315290,201710,191,114,77,106818,71212.34,178030.34
315300,201710,72,46,26,43102,24362,67464
315310,201710,63,56,7,52472,6559,59031
315320,201710,156,84,72,78708,67464,146172
315330,201710,54,46,8,43102,7496,50598
315340,201710,419,297,122,277408.9,114314,391722.9
315350,201710,139,85,54,79645,50598,130243
315360,201710,93,50,43,46850,40291,87141
315370,201710,54,30,24,28110,22347.45,50457.45
315380,201710,12,7,5,6559,4685,11244
315390,201710,52,13,39,12181,36543,48724
315400,201710,809,606,203,562482.25,189555.1,752037.35
315410,201710,346,205,141,191804,132117,323921
315415,201710,61,46,15,43102,14055,57157
315420,201710,199,146,53,136052.5,49661,185713.5
315430,201710,680,399,281,372926.1,262828.9,635755.0
315440,201710,79,56,23,52472,21551,74023
315445,201710,256,207,49,193649.79,45913,239562.79
315450,201710,195,148,47,138676,44039,182715
315460,201710,3323,1691,1632,1579918.52,1524995.05,3104913.57
315470,201710,46,24,22,22207,20614,42821
315480,201710,61,22,39,20614,36543,57157
315490,201710,619,382,237,355842,222069,577911
315500,201710,23,13,10,12181,9370,21551
315510,201710,156,100,56,93700,52472,146172
315520,201710,71,62,9,58094,8433,66527
315530,201710,51,28,23,26236,21551,47787
315540,201710,242,157,85,147109,79645,226754
315550,201710,176,138,38,129306,35606,164912
315560,201710,752,595,157,556198.9,147109,703307.9
315570,201710,309,167,142,153622.25,133054,286676.25
315580,201710,641,419,222,392603,208014,600617
315590,201710,211,110,101,103070,94637,197707
315600,201710,292,210,82,196770,76647,273417
315610,201710,96,47,49,44039,45913,89952
315620,201710,32,25,7,23425,6559,29984
315630,201710,136,88,48,82456,44976,127432
315640,201710,53,31,22,29047,20614,49661
315645,201710,63,45,18,42165,16398,58563
315650,201710,167,120,47,112159,44039,156198
315660,201710,470,193,277,180841,259549,440390
315670,201710,2295,1179,1116,1102334.75,1044541.1,2146875.85
315680,201710,848,570,278,530587.81,259773.88,790361.69
315690,201710,694,473,221,442146.63,207077,649223.63
315700,201710,1887,1004,883,937750.21,827371,1765121.21
315710,201710,317,78,239,73086,223943,297029
315720,201710,430,274,156,256738,146172,402910
315725,201710,198,160,38,149920,35606,185526
315727,201710,40,22,18,20614,16866,37480
315730,201710,40,37,3,34669,2811,37480
315733,201710,86,54,32,50598,29984,80582
315737,201710,51,37,14,34669,13118,47787
315740,201710,43,38,5,35606,4685,40291
315750,201710,159,127,32,118999,29984,148983
315760,201710,44,29,15,27173,14055,41228
315765,201710,113,73,40,68401,37480,105881
315770,201710,226,133,93,124621,86860,211481
315780,201710,3239,1697,1542,1583203.75,1442793.51,3025997.26
315790,201710,207,160,47,149920,43476.8,193396.8
315800,201710,281,205,76,192085,71212,263297
315810,201710,91,52,39,48724,36262,84986
315820,201710,788,569,219,530905.77,205203,736108.77
315830,201710,145,81,64,75897,59968,135865
315840,201710,84,57,27,53409,25299,78708
315850,201710,261,190,71,178030,66527,244557
315860,201710,12,4,8,3748,7496,11244
315870,201710,33,27,6,25299,5622,30921
315880,201710,105,68,37,63716,34669,98385
315890,201710,72,52,20,48724,18740,67464
315895,201710,398,259,139,241185,129681,370866
315900,201710,69,34,35,31858,32795,64653
315910,201710,36,23,13,21316.75,12181,33497.75
315920,201710,187,122,65,114314,59968.95,174282.95
315930,201710,37,13,24,12181,22488,34669
315935,201710,146,115,31,107755,29038,136793
315940,201710,85,64,21,59968,19677,79645
315950,201710,65,46,19,43102,17803,60905
315960,201710,562,260,302,242982.94,282411.9,525394.84
315970,201710,39,31,8,29047,7496,36543
315980,201710,698,321,377,299284.1,353239.63,652523.73
315990,201710,244,149,95,139613,88734,228347
316000,201710,49,31,18,29047,16866,45913
316010,201710,73,62,11,58094,10307,68401
316020,201710,103,84,19,78708,17803,96511
316030,201710,406,207,199,193959,185948,379907
316040,201710,489,218,271,203985,253646,457631
316045,201710,59,54,5,50598,4685,55283
316050,201710,17,15,2,14055,1874,15929
316060,201710,96,62,34,57812.9,31858,89670.9
316070,201710,1020,653,367,605587.25,343130,948717.25
316080,201710,101,60,41,56220,38417,94637
316090,201710,44,26,18,23425.1,16866,40291.1
316095,201710,67,55,12,51264,11244,62508
316100,201710,298,172,126,160601.9,118062,278663.9
316105,201710,34,24,10,22488,9370,31858
316110,201710,1930,1545,385,1438249.45,360089.1,1798338.55
316120,201710,81,60,21,56220,19395.9,75615.9
316130,201710,137,105,32,97730,29984,127714
316140,201710,27,20,7,18740,6559,25299
316150,201710,195,138,57,128603.25,53409,182012.25
316160,201710,87,52,35,48724,32795,81519
316165,201710,61,45,16,41978,14289.25,56267.25
316170,201710,204,137,67,127432,62779,190211
316180,201710,194,90,104,84002.05,97448,181450.05
316190,201710,133,94,39,87141,36543,123684
316200,201710,696,394,302,369178,282787,651965
316210,201710,752,502,250,470034.43,234250,704284.43
316220,201710,116,77,39,72149,36543,108692
316225,201710,21,13,8,12181,7496,19677
316230,201710,33,19,14,17803,13118,30921
316240,201710,611,496,115,463815.1,107755,571570.1
316245,201710,100,83,17,77771,15929,93700
316250,201710,1477,1040,437,965330,408026.26,1373356.26
316255,201710,114,90,24,83955.2,22488,106443.2
316257,201710,178,96,82,89952,76552.9,166504.9
316260,201710,239,157,82,145834.93,76741,222575.93
316265,201710,25,16,9,14992,8433,23425
316270,201710,679,471,208,438609.8,194896,633505.8
316280,201710,544,336,208,313864.1,194240.3,508104.4
316290,201710,673,448,225,416965.69,210825,627790.69
316292,201710,486,190,296,178030,277118,455148
316294,201710,104,61,43,57157,40291,97448
316295,201710,277,120,157,111018.5,147109,258127.5
316300,201710,106,73,33,68401,30921,99322
316310,201710,33,18,15,16866,14055,30921
316320,201710,48,29,19,27173,17803,44976
316330,201710,130,82,48,75897.25,44694.9,120592.15
316340,201710,138,95,43,89015,40291,129306
316350,201710,191,134,57,125395,53409,178804
316360,201710,23,18,5,16866,4685,21551
316370,201710,1045,562,483,522865.75,452280.53,975146.28
316380,201710,122,93,29,87141,27173,114314
316390,201710,118,85,33,79645,30921,110566
316400,201710,138,105,33,98385,30921,129306
316410,201710,307,224,83,208529.35,77771,286300.35
316420,201710,187,134,53,125558,49661,175219
316430,201710,154,77,77,72149,72149,144298
316440,201710,98,48,50,44976,46850,91826
316443,201710,36,34,2,31858,1874,33732
316447,201710,66,52,14,48724,13118,61842
316450,201710,219,167,52,156479,48724,205203
316460,201710,65,28,37,26236,34669,60905
316470,201710,1563,1128,435,1048595.23,406094.87,1454690.10
316480,201710,11,9,2,8433,1874,10307
316490,201710,18,6,12,5622,11244,16866
316500,201710,152,101,51,94355.9,47787,142142.9
316510,201710,171,126,45,117078.15,42165,159243.15
316520,201710,190,116,74,108129.8,69338,177467.8
316530,201710,150,109,41,102133,38136,140269
316540,201710,140,78,62,72149,58094,130243
316550,201710,144,101,43,94637,40291,134928
316553,201710,217,106,111,98822.4,104007,202829.4
316555,201710,29,21,8,19677,7496,27173
316556,201710,11,7,4,6559,3748,10307
316557,201710,16,14,2,13118,1874,14992
316560,201710,56,45,11,42165,10307,52472
316570,201710,245,223,22,208435.9,20614,229049.9
316580,201710,21,15,6,14055,5622,19677
316590,201710,117,101,16,94637,14992,109629
316600,201710,183,149,34,139332,31858,171190
316610,201710,68,45,23,41883.9,21551,63434.9
316620,201710,127,98,29,91826,27173,118999
316630,201710,37,27,10,25299,9370,34669
316640,201710,16,10,6,9370,5622,14992
316650,201710,60,47,13,44039,12181,56220
316660,201710,6,4,2,3748,1874,5622
316670,201710,437,153,284,143343,265546,408889
316680,201710,155,109,46,102133,42915,145048
316690,201710,191,120,71,112440,66527,178967
316695,201710,58,51,7,47787,6559,54346
316700,201710,13,7,6,6559,5622,12181
316710,201710,714,522,192,488598.9,179904,668502.9
316720,201710,4809,2447,2362,2279085.8,2209227.92,4488313.72
316730,201710,14,13,1,12181,937,13118
316740,201710,132,81,51,75897,47787,123684
316750,201710,19,13,6,12181,5622,17803
316760,201710,324,264,60,247368,56220,303588
316770,201710,139,81,58,75897,54346,130243
316780,201710,66,38,28,35306.16,26236,61542.16
316790,201710,56,42,14,39354,13118,52472
316800,201710,1794,1105,689,1033136.4,643907.1,1677043.5
316805,201710,18,9,9,8433,8433,16866
316810,201710,65,43,22,40291,20333,60624
316820,201710,37,18,19,16866,17803,34669
316830,201710,92,40,52,37480,48443,85923
316840,201710,499,302,197,282224.5,182715,464939.5
316850,201710,342,224,118,208529.35,110566,319095.35
316860,201710,5934,2626,3308,2446470.75,3095511.63,5541982.38
316870,201710,1402,904,498,838571.65,461943,1300514.65
316880,201710,104,60,44,55564.1,41228,96792.1
316890,201710,251,165,86,154605,80582,235187
316900,201710,416,283,133,262670.84,124621,387291.84
316905,201710,18,11,7,10307,6559,16866
316910,201710,51,26,25,24362,23425,47787
316920,201710,135,106,29,98620,27173,125793
316930,201710,1905,955,950,889168.15,887991.17,1777159.32
316935,201710,852,510,342,475996.66,318954.8,794951.46
316940,201710,1089,626,463,585625.7,433259.53,1018885.23
316950,201710,187,97,90,90889,84330,175219
316960,201710,1091,607,484,567447.9,453208.26,1020656.16
316970,201710,632,494,138,462878,129306,592184
316980,201710,114,67,47,62779,44029.63,106808.63
316990,201710,2161,1411,750,1315783.43,701101.88,2016885.31
317000,201710,322,249,73,233032,68401,301433
317005,201710,244,173,71,162101,66527,228628
317010,201710,6204,3401,2803,3167708.51,2624527.83,5792236.34
317020,201710,15973,7049,8924,6574614.12,8345017.52,14919631.64
317030,201710,86,33,53,30921,49222.03,80143.03
317040,201710,3104,1922,1182,1798141.64,1105473.6,2903615.24
317043,201710,69,48,21,44976,19677,64653
317047,201710,32,14,18,13118,16862,29980
317050,201710,187,140,47,131180,44039,175219
317052,201710,120,94,26,88078,24362,112440
317057,201710,200,151,49,141487,45351,186838
317060,201710,58,37,21,34669,19395.9,54064.9
317065,201710,58,47,11,44039,10307,54346
317070,201710,1960,925,1035,861103.85,967733.8,1828837.65
317075,201710,112,58,54,54346,50598,104944
317080,201710,810,431,379,402488.35,354936,757424.35
317090,201710,627,500,127,466204.75,118999,585203.75
317100,201710,407,306,101,284848.6,94637,379485.6
317103,201710,104,89,15,83393,14055,97448
317107,201710,37,33,4,30921,3748,34669
317110,201710,96,42,54,39354,50598,89952
317115,201710,39,33,6,30921,5622,36543
317120,201710,1758,884,874,820565.35,818489,1639054.35
317130,201710,1874,1201,673,1122674.2,629946,1752620.2
317140,201710,6,5,1,4685,937,5622
317150,201710,267,159,108,148983,100446.4,249429.4
317160,201710,314,228,86,213043,80582,293625
317170,201710,206,146,60,136802,56220,193022
317180,201710,418,302,116,282271.25,108692,390963.25
317190,201710,253,170,83,159290,77208.8,236498.8
317200,201710,783,560,223,511613,208717,720330
317210,201710,150,86,64,79645.6,59968,139613.6
317220,201710,21,13,8,12181,7496,19677
320010,201710,611,456,155,423993.25,145235,569228.25
320013,201710,129,93,36,87141,33732,120873
320016,201710,280,175,105,163975,98385,262360
320020,201710,715,432,283,401343.78,262576.97,663920.75
320030,201710,148,110,38,103070,35278.05,138348.05
320035,201710,131,96,35,89952,32795,122747
320040,201710,490,259,231,241558.8,216447,458005.8
320050,201710,102,80,22,74960,20614,95574
320060,201710,1497,690,807,646484,755494.3,1401978.3
320070,201710,102,70,32,65590,29984,95574
320080,201710,753,431,322,401065.5,301714,702779.5
320090,201710,1186,823,363,767856.08,339287.8,1107143.88
320100,201710,313,177,136,165849,127432,293281
320110,201710,136,85,51,77959.1,47374,125333.1
320115,201710,108,88,20,82456,18740,101196
320120,201710,3223,1805,1418,1680284.15,1326853.15,3007137.30
320130,201710,7156,3436,3720,3199108.88,3477185.62,6676294.50
320140,201710,418,270,148,251678.6,138436,390114.6
320150,201710,1820,1072,748,998452.2,700866.63,1699318.83
320160,201710,690,303,387,282684.22,361571.36,644255.58
320170,201710,117,91,26,84518,24362,108880
320180,201710,49,28,21,26236,19677,45913
320190,201710,234,159,75,148224.03,69994,218218.03
320200,201710,52,38,14,35606,13118,48724
320210,201710,840,475,365,443576.8,341051,784627.8
320220,201710,299,112,187,104007.86,174938,278945.86
320225,201710,72,59,13,55283,12181,67464
320230,201710,523,336,187,313520.2,174423,487943.2
320240,201710,3080,1559,1521,1457754.36,1422277.05,2880031.41
320245,201710,437,305,132,284660.7,123684,408344.7
320250,201710,212,112,100,104007,93700,197707
320255,201710,144,114,30,105534.31,27970,133504.31
320260,201710,175,123,52,115251,48677.15,163928.15
320265,201710,157,127,30,118203,28110,146313
320270,201710,151,123,28,115251,26236,141487
320280,201710,926,558,368,517506.1,343719.81,861225.91
320290,201710,65,56,9,52472,8433,60905
320300,201710,526,373,153,348068.55,142116.55,490185.10
320305,201710,636,338,298,316706,279039,595745
320310,201710,208,118,90,110285,83588,193873
320313,201710,289,151,138,141487,129025,270512
320316,201710,107,89,18,83393,16866,100259
320320,201710,3289,1485,1804,1385999.9,1687131.5,3073131.4
320330,201710,257,188,69,175506.9,62779.81,238286.71
320332,201710,862,522,340,486730,317550.15,804280.15
320334,201710,238,144,94,134647,88078,222725
320335,201710,144,104,40,96276.95,37480,133756.95
320340,201710,592,409,183,382109,170816,552925
320350,201710,958,411,547,382671.14,512023.44,894694.58
320360,201710,165,91,74,84986,69026,154012
320370,201710,245,186,59,172557,54268,226825
320380,201710,278,189,89,175688.4,83393,259081.4
320390,201710,1090,671,419,628128,390778.66,1018906.66
320400,201710,324,231,93,215511,87141,302652
320405,201710,870,364,506,341064,473815.26,814879.26
320410,201710,948,486,462,453723.7,432529.34,886253.04
320420,201710,473,240,233,224412.2,218321,442733.2
320425,201710,193,102,91,95574,85267,180841
320430,201710,388,220,168,204547.35,157416,361963.35
320435,201710,165,110,55,102264.18,51535,153799.18
320440,201710,196,122,74,114032.9,69338,183370.9
320450,201710,132,78,54,73086,50598,123684
320455,201710,236,191,45,178031,42165,220196
320460,201710,239,152,87,142424,81519,223943
320465,201710,116,79,37,73666.94,34669,108335.94
320470,201710,626,397,229,371690.54,214569,586259.54
320480,201710,165,110,55,103070,51535,154605
320490,201710,2967,1472,1495,1374298.53,1397969.98,2772268.51
320495,201710,89,57,32,53391,29984,83375
320500,201710,9252,4725,4527,4402442.22,4231836.16,8634278.38
320501,201710,531,266,265,249242,248305,497547
320503,201710,271,194,77,180841.6,72149,252990.6
320506,201710,248,191,57,178967,53409,232376
320510,201710,903,432,471,401061.65,439828.05,840889.70
320515,201710,78,65,13,59968.45,12181,72149.45
320517,201710,202,142,60,133054,56220,189274
320520,201710,6598,2944,3654,2744109.52,3415331.88,6159441.40
320530,201710,5154,2613,2541,2440024.41,2377753.23,4817777.64
330010,201710,2932,1531,1401,1427022.68,1309992.91,2737015.59
330015,201710,155,59,96,54346.14,89952,144298.14
330020,201710,3492,1521,1971,1421993.52,1846265,3268258.52
330022,201710,204,113,91,105881,84330.9,190211.9
330023,201710,514,181,333,168426.4,312021,480447.4
330025,201710,524,119,405,111503,378922.9,490425.9
330030,201710,1892,1196,696,1112550.83,649223.04,1761773.87
330040,201710,2206,1113,1093,1040773.55,1022877,2063650.55
330045,201710,8183,2594,5589,2422605.51,5231592.78,7654198.29
330050,201710,788,497,291,465689,272667,738356
330060,201710,847,533,314,495675.45,292925.84,788601.29
330070,201710,3345,1303,2042,1215553.63,1912352.18,3127905.81
330080,201710,1443,692,751,643945.9,702750.3,1346696.2
330090,201710,348,209,139,195833,130243,326076
330093,201710,280,126,154,118062,144264,262326
330095,201710,99,50,49,46850,45913,92763
330100,201710,9285,4819,4466,4507083.14,4180238.3,8687321.44
330110,201710,466,208,258,194193.25,241746,435939.25
330115,201710,520,309,211,289533,197707,487240
330120,201710,364,188,176,175031.6,164443.5,339475.1
330130,201710,1454,428,1026,400323.88,961311,1361634.88
330140,201710,593,312,281,292335,262361,554696
330150,201710,440,263,177,244557,164912,409469
330160,201710,203,125,78,117125,73086,190211
330170,201710,26322,9308,17014,8701538.11,15930566.99,24632105.10
330180,201710,231,145,86,132427.75,79879.25,212307.00
330185,201710,760,320,440,298332.1,412262,710594.1
330187,201710,270,87,183,81519,171471,252990
330190,201710,5534,2211,3323,2063260.15,3109760.73,5173020.88
330200,201710,4302,1511,2791,1410774.65,2610290.18,4021064.83
330205,201710,389,241,148,225395.35,138395,363790.35
330210,201710,983,598,385,555925.8,359058.95,914984.75
330220,201710,2446,1460,986,1364694.75,922945.1,2287639.85
330225,201710,535,300,235,280473,220195,500668
330227,201710,2431,797,1634,743687.63,1530677.32,2274364.95
330230,201710,199,119,80,111503,74960,186463
330240,201710,3535,1855,1680,1733991.58,1571768.51,3305760.09
330245,201710,150,64,86,59968,79832.4,139800.4
330250,201710,6347,3309,3038,3090233.15,2837844.7,5928077.85
330260,201710,559,171,388,160227,363556,523783
330270,201710,3248,1200,2048,1123276.5,1918603,3041879.5
330280,201710,436,286,150,265097.34,140541,405638.34
330285,201710,6952,2326,4626,2174817.7,4332250.2,6507067.9
330290,201710,575,225,350,209847,327950,537797
330300,201710,734,500,234,465033.85,219241,684274.85
330310,201710,416,240,176,223006.35,164912,387918.35
330320,201710,7899,2959,4940,2765230.4,4624070.86,7389301.26
330330,201710,9292,3627,5665,3393302.71,5303768.4,8697071.11
330340,201710,2613,1572,1041,1471081.53,975398.26,2446479.79
330350,201710,17613,6985,10628,6519213.3,9937758.83,16456972.13
330360,201710,2576,1261,1315,1180414.7,1232146,2412560.7
330370,201710,963,530,433,495860.4,403754.3,899614.7
330380,201710,831,361,470,337544.88,439921.9,777466.78
330385,201710,605,319,286,297967,267982,565949
330390,201710,5083,2838,2245,2646985,2101691.52,4748676.52
330395,201710,231,147,84,136053.05,76225.5,212278.55
330400,201710,627,324,303,300496.4,281254.29,581750.69
330410,201710,501,357,144,332861.63,134928,467789.63
330411,201710,227,132,95,123251,88968.15,212219.15
330412,201710,251,107,144,99978,134928,234906
330414,201710,6198,2525,3673,2362123.4,3438164.75,5800288.15
330415,201710,554,262,292,245494,272667.4,518161.4
330420,201710,2274,1210,1064,1130454.27,995741.3,2126195.57
330430,201710,1775,783,992,732922.1,927817.9,1660740.0
330440,201710,251,113,138,105881,129306,235187
330450,201710,122,49,73,45913,68401,114314
330452,201710,1638,753,885,703605.18,828954.63,1532559.81
330455,201710,109539,39053,70486,36518210.1,65985174.76,102503384.86
330460,201710,263,108,155,101196,145235,246431
330470,201710,1228,676,552,627230.19,517214.63,1144444.82
330475,201710,1375,382,993,356061.3,929878.8,1285940.1
330480,201710,743,400,343,374144.1,320455,694599.1
330490,201710,13268,4715,8553,4411879.72,8007003.17,12418882.89
330500,201710,1322,610,712,571570,666770,1238340
330510,201710,11220,3682,7538,3443261.94,7056131.07,10499393.01
330513,201710,107,53,54,49661,50598,100259
330515,201710,863,354,509,327933.9,476559,804492.9
330520,201710,2380,896,1484,839337,1390367.45,2229704.45
330530,201710,226,119,107,111503,100072,211575
330540,201710,345,175,170,163975,158822,322797
330550,201710,3138,1105,2033,1033933,1902906.65,2936839.65
330555,201710,727,265,462,248287,431770.4,680057.4
330560,201710,535,202,333,189274,312012,501286
330570,201710,245,167,78,156479,73086,229565
330575,201710,774,330,444,308976,414008.75,722984.75
330580,201710,3322,1876,1446,1752013.9,1353403,3105416.9
330590,201710,307,160,147,149920,137739,287659
330600,201710,1069,686,383,640683.72,357221.88,997905.60
330610,201710,1524,836,688,776288.51,640629.45,1416917.96
330615,201710,184,141,43,132117,40291,172408
330620,201710,906,450,456,418372.7,425770.3,844143.0
330630,201710,3641,2293,1348,2131403.01,1256985.27,3388388.28
350010,201710,598,391,207,364636.02,193959,558595.02
350020,201710,37,18,19,16866,17803,34669
350030,201710,514,334,180,311834,167491.66,479325.66
350040,201710,126,47,79,43701.68,74023,117724.68
350050,201710,287,159,128,148983,119683.63,268666.63
350055,201710,85,47,38,44039,35606,79645
350060,201710,70,26,44,24362,41228,65590
350070,201710,802,466,336,432313.11,313167.56,745480.67
350075,201710,66,43,23,40291,21551,61842
350080,201710,51,32,19,29359.3,16866,46225.3
350090,201710,101,58,43,54346,40286.32,94632.32
350100,201710,300,187,113,174516.25,105881,280397.25
350110,201710,59,37,22,34669,20614,55283
350115,201710,156,93,63,86485.1,59031,145516.1
350120,201710,111,74,37,69338,34669,104007
350130,201710,360,173,187,161539,175219,336758
350140,201710,34,20,14,17991,13118,31109
350150,201710,71,56,15,52472,14055,66527
350160,201710,2444,952,1492,889008.99,1396700.16,2285709.15
350170,201710,402,247,155,229284.25,144954,374238.25
350180,201710,185,97,88,90869,82456,173325
350190,201710,975,493,482,459973.84,451338.85,911312.69
350200,201710,72,26,46,24362,42841.8,67203.8
350210,201710,1355,760,595,704061.66,557006.23,1261067.89
350220,201710,678,583,95,542213.75,89015,631228.75
350230,201710,74,53,21,49661,19677,69338
350240,201710,65,50,15,46850,14055,60905
350250,201710,1215,614,601,569043.1,562425.93,1131469.03
350260,201710,91,65,26,60905,24362,85267
350270,201710,828,543,285,507924.27,265621.76,773546.03
350275,201710,297,116,181,108318,169597,277915
350280,201710,4682,2384,2298,2222828.2,2149526.76,4372354.96
350290,201710,391,187,204,174933.32,190585.9,365519.22
350300,201710,46,25,21,23425,19677,43102
350310,201710,98,70,28,65590,26236,91826
350315,201710,38,22,16,20614,14992,35606
350320,201710,3271,1612,1659,1505995.35,1553687.52,3059682.87
350330,201710,1662,880,782,820532.3,731452.7,1551985.0
350335,201710,20,13,7,12181,6559,18740
350340,201710,128,64,64,59968,59968,119936
350350,201710,96,47,49,44039,45913,89952
350360,201710,129,88,41,82452,38136,120588
350370,201710,96,55,41,50910.3,38407.63,89317.93
350380,201710,728,307,421,287003.1,393727.4,680730.5
350390,201710,1377,567,810,530495.25,757845.7,1288340.95
350395,201710,26,18,8,16866,7496,24362
350400,201710,1697,913,784,846701.87,731036.58,1577738.45
350410,201710,2212,983,1229,918037.88,1151259.22,2069297.10
350420,201710,235,144,91,134335,85267,219602
350430,201710,73,43,30,39729,28110,67839
350440,201710,152,110,42,102086.25,39354,141440.25
350450,201710,1591,1017,574,945836.9,537745,1483581.9
350460,201710,336,119,217,111503,203047.9,314550.9
350470,201710,13,10,3,9370,2811,12181
350480,201710,156,85,71,79645,66527,146172
350490,201710,240,115,125,106818.9,117125,223943.9
350500,201710,39,18,21,16866,19677,36543
350510,201710,167,113,54,105881,50598,156479
350520,201710,442,201,241,185839,225192.3,411031.3
350530,201710,460,221,239,207077,223943,431020
350535,201710,59,47,12,44039,11244,55283
350540,201710,377,190,187,177230.55,174938,352168.55
350550,201710,2722,1598,1124,1490256.65,1051906.41,2542163.06
350560,201710,623,434,189,406653.32,176737.65,583390.97
350570,201710,4231,1749,2482,1634189.71,2323059.04,3957248.75
350580,201710,369,173,196,161133,183357.63,344490.63
350590,201710,898,485,413,454445,386044,840489
350600,201710,6111,3062,3049,2855667.16,2854272.75,5709939.91
350610,201710,1554,775,779,720681.3,728977,1449658.3
350620,201710,39,27,12,25299,11244,36543
350630,201710,242,142,100,132117.3,92764,224881.3
350635,201710,822,322,500,301433,467709.54,769142.54
350640,201710,122,90,32,84330,29984,114314
350650,201710,1865,1223,642,1142297.6,600541.1,1742838.7
350660,201710,743,336,407,314832,380418,695250
350670,201710,312,159,153,148749,143361,292110
350680,201710,175,97,78,90889,73086,163975
350690,201710,204,100,104,93700,97448,191148
350700,201710,679,338,341,313431.99,319517,632948.99
350710,201710,315,129,186,119686.1,174282,293968.1
350715,201710,48,43,5,40291,4685,44976
350720,201710,18,13,5,12181,4685,16866
350730,201710,42,27,15,25299,14055,39354
350740,201710,208,117,91,109338.53,85267,194605.53
350745,201710,21,11,10,10283,9370,19653
350750,201710,2108,1375,733,1278878.26,686196.3,1965074.56
350760,201710,3708,1603,2105,1500281.11,1969939.53,3470220.64
350770,201710,61,42,19,39354,17803,57157
350775,201710,49,36,13,33732,12172,45904
350780,201710,419,202,217,189274,203329,392603
350790,201710,370,160,210,149920,196770,346690
350800,201710,425,238,187,223006,175219,398225
350810,201710,513,410,103,383234,96511,479745
350820,201710,83,51,32,47787,29984,77771
350830,201710,82,48,34,44321,31858,76179
350840,201710,712,322,390,301714,364493,666207
350850,201710,1734,1002,732,932815.28,685628,1618443.28
350860,201710,564,330,234,307319.16,219258,526577.16
350870,201710,443,301,142,281756,132772.9,414528.9
350880,201710,287,155,132,142426.55,123684,266110.55
350890,201710,42,26,16,24362,14992,39354
350900,201710,1432,461,971,430007.19,909077.4,1339084.59
350910,201710,26,17,9,15929,8433,24362
350920,201710,592,333,259,311708.7,242683,554391.7
350925,201710,1159,623,536,580762.69,500826.7,1081589.39
350930,201710,94,59,35,55283,32795,88078
350940,201710,696,390,306,363930.8,284913.8,648844.6
350945,201710,106,81,25,75373,23425,98798
350950,201710,14909,7171,7738,6691417.71,7241448.09,13932865.80
350960,201710,1274,596,678,553855.8,635282,1189137.8
350970,201710,1128,616,512,574965.3,479453.63,1054418.93
350980,201710,102,67,35,62779,32795,95574
350990,201710,366,130,236,120545.06,220850.9,341395.96
350995,201710,32,16,16,14992,14992,29984
351000,201710,634,453,181,422276.26,169597,591873.26
351010,201710,51,29,22,27173,20614,47787
351015,201710,59,42,17,39354,15929,55283
351020,201710,1656,954,702,892222.64,655713.2,1547935.84
351030,201710,327,227,100,210170.7,93700,303870.7
351040,201710,842,454,388,424461,362619.15,787080.15
351050,201710,3213,1546,1667,1441710.14,1560141.64,3001851.78
351060,201710,4866,2013,2853,1874811.9,2670280.57,4545092.47
351070,201710,423,272,151,253306,141487,394793
351080,201710,811,579,232,542523,216447,758970
351090,201710,63,27,36,25299,33732,59031
351100,201710,451,262,189,243311.35,177079.32,420390.67
351110,201710,2109,1019,1090,948693.39,1018692.44,1967385.83
351120,201710,75,40,35,37396.6,32795,70191.6
351130,201710,171,57,114,53409,106818,160227
351140,201710,334,233,101,216541.5,94637,311178.5
351150,201710,386,198,188,185078,176156,361234
351160,201710,248,162,86,151794,80582,232376
351170,201710,178,91,87,85267,80770,166037
351190,201710,92,63,29,59031,27173,86204
351200,201710,382,252,130,235530.7,121810,357340.7
351210,201710,132,60,72,55892.71,67464,123356.71
351220,201710,519,312,207,288659.01,193959,482618.01
351230,201710,277,199,78,185838.3,73067.26,258905.56
351240,201710,229,98,131,91638.6,122747,214385.6
351250,201710,70,50,20,46850,18740,65590
351260,201710,153,111,42,104007,39073,143080
351270,201710,50,22,28,20614,26236,46850
351280,201710,1103,505,598,469439.35,559530.39,1028969.74
351290,201710,227,101,126,94637,117781,212418
351300,201710,3744,1762,1982,1644251.13,1856818,3501069.13
351310,201710,744,392,352,365665,329824,695489
351320,201710,106,65,41,60905,38417,99322
351330,201710,40,28,12,26236,11244,37480
351340,201710,1201,760,441,704510.57,412250.32,1116760.89
351350,201710,2386,1297,1089,1213743.85,1020107.22,2233851.07
351360,201710,774,386,388,359808,362442.19,722250.19
351370,201710,366,194,172,181773.32,160539.3,342312.62
351380,201710,8928,4112,4816,3838789,4502685.36,8341474.36
351385,201710,29,20,9,18740,8433,27173
351390,201710,289,213,76,198851.26,71212,270063.26
351400,201710,59,36,23,33732,21505.63,55237.63
351410,201710,418,264,154,245962.9,143735.9,389698.8
351420,201710,60,49,11,45913,10307,56220
351430,201710,78,41,37,38417,34669,73086
351440,201710,784,540,244,503909.92,228624,732533.92
351450,201710,244,123,121,115251,113377,228628
351460,201710,119,55,64,50833,59968,110801
351470,201710,140,72,68,67455,63716,131171
351480,201710,517,280,237,260436.4,221951.88,482388.28
351490,201710,297,100,197,93700,184589,278289
351492,201710,33,23,10,21551,9370,30921
351495,201710,28,18,10,16866,9370,26236
351500,201710,3531,1524,2007,1422300.37,1875724.74,3298025.11
351510,201710,1760,736,1024,689350.9,957323.54,1646674.44
351512,201710,22,18,4,16866,3748,20614
351515,201710,192,108,84,101196,78708,179904
351518,201710,709,429,280,401032,261938.35,662970.35
351519,201710,74,47,27,44039,25299,69338
351520,201710,145,92,53,85580,49661,135241
351530,201710,20,14,6,13118,5622,18740
351535,201710,137,74,63,69338,59031,128369
351540,201710,429,308,121,286256,113377,399633
351550,201710,1302,798,504,742201.1,472238.63,1214439.73
351560,201710,73,35,38,32795,35606,68401
351565,201710,11,6,5,5622,4685,10307
351570,201710,2549,1320,1229,1235140.03,1150926.26,2386066.29
351580,201710,38,33,5,30921,4685,35606
351590,201710,68,45,23,42165,21551,63716
351600,201710,188,142,46,133054,43102,176156
351610,201710,60,30,30,28110,28110,56220
351620,201710,5950,3422,2528,3197131.56,2366603.31,5563734.87
351630,201710,2500,1292,1208,1204447.59,1130017.32,2334464.91
351640,201710,1647,796,851,743345.06,795888.4,1539233.46
351650,201710,29,25,4,23425,3748,27173
351660,201710,156,99,57,91545.5,53409,144954.5
351670,201710,738,461,277,429662,259549,689211
351680,201710,76,62,14,58094,13118,71212
351685,201710,44,28,16,26236,14992,41228
351690,201710,306,216,90,200560.17,84330,284890.17
351700,201710,166,115,51,107755,47787,155542
351710,201710,76,53,23,49661,21551,71212
351720,201710,138,63,75,59031,70275,129306
351730,201710,94,69,25,64653,23420.32,88073.32
351740,201710,712,475,237,444794,222064.32,666858.32
351750,201710,367,155,212,144298.7,198644,342942.7
351760,201710,791,616,175,577427,163839,741266
351770,201710,286,246,40,230502,37480,267982
351780,201710,169,94,75,88069,70275,158344
351790,201710,244,130,114,121810,106818,228628
351800,201710,52,34,18,31858,16866,48724
351810,201710,120,78,42,72975,39354,112329
351820,201710,880,639,241,595277.9,225812.32,821090.22
351830,201710,500,183,317,170721.4,297029,467750.4
351840,201710,1859,951,908,881599.75,849041.11,1730640.86
351850,201710,227,170,57,158681.9,53409,212090.9
351860,201710,751,493,258,457258.77,241741.32,699000.09
351870,201710,5591,2668,2923,2490578.32,2732906.1,5223484.42
351880,201710,18839,8334,10505,7785273.18,9828481.65,17613754.83
351885,201710,92,61,31,56455,29047,85502
351890,201710,76,62,14,58094,13118,71212
351900,201710,225,136,89,126777,83393,210170
351905,201710,74,33,41,30921,38417,69338
351907,201710,3084,1352,1732,1263381.23,1621844.9,2885226.13
351910,201710,177,72,105,67464,98385,165849
351920,201710,139,82,57,76834,53386.96,130220.96
351925,201710,85,59,26,55283,24362,79645
351930,201710,377,261,116,244463.3,108692,353155.3
351940,201710,229,105,124,98385,116188,214573
351950,201710,144,83,61,77771,57157,134928
351960,201710,826,385,441,360569.75,411380.58,771950.33
351970,201710,1899,1005,894,939577.04,837388,1776965.04
351980,201710,145,73,72,66527,67464,133991
351990,201710,287,195,92,181778,85416.92,267194.92
352000,201710,353,209,144,195458.2,134928,330386.2
352010,201710,346,206,140,193022,131180,324202
352020,201710,197,73,124,68401,116188,184589
352030,201710,999,515,484,481852.25,451946.3,933798.55
352040,201710,569,247,322,231439,301714,533153
352042,201710,276,96,180,89952,168098,258050
352044,201710,393,236,157,220195.1,147109,367304.1
352050,201710,3127,1280,1847,1190293.04,1729279.53,2919572.57
352060,201710,101,65,36,60905,33732,94637
352070,201710,99,71,28,65591,26236,91827
352080,201710,64,39,25,35606,23425,59031
352090,201710,175,119,56,111503,52472,163975
352100,201710,250,122,128,114314,118804,233118
352110,201710,114,35,79,32795,74023,106818
352115,201710,72,27,45,25299,42165,67464
352120,201710,95,61,34,57157,31858,89015
352130,201710,221,185,36,173157.6,33732,206889.6
352140,201710,179,73,106,67933,99322,167255
352150,201710,120,68,52,62779.7,48724,111503.7
352160,201710,132,88,44,82456,41228,123684
352170,201710,375,256,119,238935.7,111503,350438.7
352180,201710,605,407,198,380282.75,185522,565804.75
352190,201710,265,105,160,98375.63,149882.52,248258.15
352200,201710,32,17,15,15929,14055,29984
352210,201710,3706,1540,2166,1434741.5,2023251.35,3457992.85
352215,201710,51,28,23,26236,21101.24,47337.24
352220,201710,6909,2714,4195,2538132.24,3928266.72,6466398.96
352230,201710,3130,2000,1130,1861934.7,1053855.22,2915789.92
352240,201710,2159,1279,880,1195473.29,823342.25,2018815.54
352250,201710,2572,1359,1213,1270448.6,1132980.7,2403429.3
352260,201710,1100,624,476,582899.32,445731,1028630.32
352265,201710,62,28,34,26236,31858,58094
352270,201710,398,228,170,212699.84,159235,371934.84
352280,201710,384,241,143,224568,133986.32,358554.32
352290,201710,175,110,65,102508,60905,163413
352300,201710,102,78,24,73086,22488,95574
352310,201710,5727,2808,2919,2619585.21,2729651,5349236.21
352320,201710,926,493,433,459349.99,403706.55,863056.54
352330,201710,526,229,297,214245.05,278008,492253.05
352340,201710,1388,683,705,636430.5,659788.75,1296219.25
352350,201710,323,206,117,193022,109348,302370
352360,201710,227,91,136,84376.85,125819,210195.85
352370,201710,105,69,36,64653,33732,98385
352380,201710,118,73,45,68401,42165,110566
352390,201710,2427,1108,1319,1033821.9,1233749.04,2267570.94
352400,201710,464,195,269,182012.25,251771.9,433784.15
352410,201710,744,535,209,496866.9,195365,692231.9
352420,201710,101,64,37,59968,34669,94637
352430,201710,1753,775,978,721491.45,914737.7,1636229.15
352440,201710,3019,1571,1448,1464134,1353364.15,2817498.15
352450,201710,185,158,27,148046,25299,173345
352460,201710,570,296,274,276804.54,255380.2,532184.74
352470,201710,573,192,381,179904,356988,536892
352480,201710,1367,766,601,716212.3,562574.9,1278787.2
352490,201710,83,32,51,29984,47787,77771
352500,201710,1210,544,666,508511,622628,1131139
352510,201710,737,400,337,373863.3,315769,689632.3
352520,201710,538,240,298,224880,279085.45,503965.45
352530,201710,1706,901,805,843300,753910.3,1597210.3
352540,201710,76,50,26,46850,24362,71212
352550,201710,186,107,79,100259,73367.1,173626.1
352560,201710,48,39,9,36543,8433,44976
352570,201710,656,344,312,321735,292344,614079
352580,201710,57,39,18,35606.33,16866,52472.33
352585,201710,16,5,11,4685,10307,14992
352590,201710,4261,2144,2117,2003462.3,1982744.11,3986206.41
352600,201710,356,249,107,232376.3,100250,332626.3
352610,201710,918,429,489,399286.51,458193,857479.51
352620,201710,970,385,585,359808.1,548145,907953.1
352630,201710,218,82,136,76834,127000.98,203834.98
352640,201710,554,393,161,365868.75,150857,516725.75
352650,201710,90,60,30,56220,28110,84330
352660,201710,82,48,34,44976,31858,76834
352670,201710,1647,895,752,835184.88,703522.71,1538707.59
352680,201710,878,565,313,525181.68,292032.2,817213.88
352690,201710,4282,1991,2291,1856852.9,2142869.87,3999722.77
352700,201710,108,61,47,56876,44039,100915
352710,201710,1324,695,629,649341.1,587031,1236372.1
352720,201710,1234,602,632,561857.1,592179.32,1154036.42
352725,201710,26,24,2,22488,1874,24362
352730,201710,365,182,183,169376.81,170909,340285.81
352740,201710,405,253,152,235141.04,142424,377565.04
352750,201710,24,16,8,14710.9,7496,22206.9
352760,201710,189,139,50,130243,46850,177093
352770,201710,82,65,17,60905,15929,76834
352780,201710,81,45,36,42165,33732,75897
352790,201710,27,23,4,21551,3748,25299
352800,201710,247,166,81,155542,75615.9,231157.9
352810,201710,163,106,57,96855.92,53409,150264.92
352820,201710,66,55,11,51117.1,10307,61424.1
352830,201710,87,61,26,57157,24362,81519
352840,201710,581,304,277,283584.1,259549,543133.1
352850,201710,1335,483,852,451915.1,798324,1250239.1
352860,201710,127,83,44,77771,41228,118999
352870,201710,40,25,15,23425,14055,37480
352880,201710,188,128,60,119917.26,56220,176137.26
352885,201710,29,20,9,18740,8433,27173
352890,201710,53,37,16,34669,14711,49380
352900,201710,4920,2392,2528,2223082.18,2361935.46,4585017.64
352910,201710,40,31,9,29047,8433,37480
352920,201710,718,442,276,413217,258612,671829
352930,201710,1254,608,646,568305.58,602406.51,1170712.09
352940,201710,6310,2732,3578,2547442.6,3349249.74,5896692.34
352950,201710,88,35,53,32795,49661,82456
352960,201710,69,45,24,42165,22488,64653
352965,201710,20,8,12,7496,11244,18740
352970,201710,459,341,118,315430.14,109630,425060.14
352980,201710,177,92,85,86204,79645,165849
352990,201710,906,426,480,397059.12,448370.44,845429.56
353000,201710,67,31,36,29047,33732,62779
353010,201710,546,340,206,318580,193003.27,511583.27
353020,201710,285,208,77,194896,72149,267045
353030,201710,1169,531,638,497228.63,597131.73,1094360.36
353040,201710,86,53,33,49661,30921,80582
353050,201710,1288,814,474,755942.56,444044.3,1199986.86
353060,201710,7581,3560,4021,3321664.62,3761099.43,7082764.05
353070,201710,1631,1019,612,948178.63,572177.04,1520355.67
353080,201710,1297,685,612,639549.62,573435.32,1212984.94
353090,201710,58,35,23,32795,21551,54346
353100,201710,60,48,12,44976,11244,56220
353110,201710,1902,600,1302,560499.63,1218279.32,1778778.95
353120,201710,71,37,34,34669,31858,66527
353130,201710,867,431,436,402891.63,408485.89,811377.52
353140,201710,586,224,362,209829,339194,549023
353150,201710,358,196,162,182715,151784.63,334499.63
353160,201710,102,84,18,78708,16866,95574
353170,201710,193,63,130,59031,121782.63,180813.63
353180,201710,953,435,518,406081.95,484851,890932.95
353190,201710,459,325,134,304423,125558,429981
353200,201710,182,91,91,85267,85267,170534
353205,201710,27,19,8,17803,7496,25299
353210,201710,82,51,31,47787,29047,76834
353215,201710,57,33,24,30921,22488,53409
353220,201710,84,48,36,44976,32795.93,77771.93
353230,201710,160,61,99,57157,92763,149920
353240,201710,271,148,123,138676,115251,253927
353250,201710,202,108,94,101196,88078,189274
353260,201710,429,313,116,292166.25,108682.63,400848.88
353270,201710,69,50,19,46850,17147.1,63997.1
353280,201710,94,46,48,42634,44976,87610
353282,201710,118,87,31,81519,29047,110566
353284,201710,24,19,5,17803,4685,22488
353286,201710,1,1,0,937,0,937
353290,201710,78,47,31,44039,29038,73077
353300,201710,399,222,177,206499.55,165849,372348.55
353310,201710,52,48,4,44976,3748,48724
353320,201710,60,38,22,35606,20614,56220
353325,201710,55,36,19,33732,17504,51236
353330,201710,69,53,16,49521,14992,64513
353340,201710,614,192,422,179904,394842.54,574746.54
353350,201710,910,424,486,396482.92,454147,850629.92
353360,201710,112,88,24,82143.7,22207,104350.7
353370,201710,120,68,52,62779.55,48724,111503.55
353380,201710,28,21,7,19673,6559,26232
353390,201710,1037,502,535,470374,501295,971669
353400,201710,52,31,21,29047,19677,48724
353410,201710,119,73,46,68401,43056,111457
353420,201710,56,24,32,22488,29984,52472
353430,201710,545,361,184,334602.08,171976.9,506578.98
353440,201710,10184,4450,5734,4157935.03,5366248.48,9524183.51
353450,201710,57,30,27,28110,25299,53409
353460,201710,603,328,275,303287.99,256251.25,559539.24
353470,201710,2124,1154,970,1076214.04,906236.72,1982450.76
353475,201710,239,160,79,147281.3,74023,221304.3
353480,201710,189,150,39,140550,36543,177093
353490,201710,233,141,92,132117,86204,218321
353500,201710,180,107,73,99041.3,68401,167442.3
353510,201710,102,73,29,68382.63,27163.63,95546.26
353520,201710,211,145,66,135865,61842,197707
353530,201710,460,251,209,235187,195782,430969
353540,201710,351,234,117,218941.02,109629,328570.02
353550,201710,732,496,236,461660.85,221132,682792.85
353560,201710,635,270,365,252053.6,341701.22,593754.82
353570,201710,59,31,28,29047,26236,55283
353580,201710,355,272,83,254396,77771,332167
353590,201710,82,56,26,52159.7,24362,76521.7
353600,201710,268,149,119,139301,111279,250580
353610,201710,116,60,56,56220,52472,108692
353620,201710,562,305,257,283196.09,240527.9,523723.99
353625,201710,53,28,25,26236,23425,49661
353630,201710,235,168,67,153163.07,62779,215942.07
353640,201710,122,84,38,78708,35606,114314
353650,201710,827,326,501,303400.6,469437,772837.6
353657,201710,21,15,6,14055,5622,19677
353660,201710,256,141,115,132117,107473.9,239590.9
353670,201710,728,442,286,413217.1,267982,681199.1
353680,201710,98,70,28,65590,26236,91826
353690,201710,46,36,10,33732,9370,43102
353700,201710,287,202,85,189274,79645,268919
353710,201710,400,187,213,174282.4,199581,373863.4
353715,201710,46,36,10,33450.9,9370,42820.9
353720,201710,358,166,192,155524,179904,335428
353730,201710,1138,703,435,655854.45,407313.9,1063168.35
353740,201710,641,358,283,335164.9,265171,600335.9
353750,201710,100,61,39,56634.62,36543,93177.62
353760,201710,2659,1000,1659,934935.3,1550944.37,2485879.67
353770,201710,99,80,19,74491.5,17803,92294.5
353780,201710,1089,555,534,517412.3,498484,1015896.3
353790,201710,501,285,216,265012.55,202272,467284.55
353800,201710,3228,1652,1576,1540037.46,1474307.17,3014344.63
353810,201710,241,137,104,127530.75,97421,224951.75
353820,201710,179,87,92,81519,85590.54,167109.54
353830,201710,50,43,7,40291,6559,46850
353850,201710,167,86,81,80582,75897,156479
353860,201710,463,207,256,192600.35,239590.9,432191.25
353870,201710,4932,2481,2451,2310257.53,2286683.33,4596940.86
353880,201710,662,470,192,439547.2,178967.36,618514.56
353890,201710,588,326,262,304900,245494,550394
353900,201710,136,66,70,61842,65590,127432
353910,201710,176,86,90,80582,84330,164912
353920,201710,453,248,205,231205.7,192071.64,423277.34
353930,201710,977,588,389,548825.44,363327.9,912153.34
353940,201710,184,101,83,93887.4,76928,170815.4
353950,201710,516,320,196,299549.53,183652,483201.53
353960,201710,69,55,14,51535,13118,64653
353970,201710,72,48,24,44976,22488,67464
353980,201710,1499,742,757,692647.59,709297,1401944.59
353990,201710,77,43,34,40291,31858,72149
354000,201710,370,172,198,160509,185334.6,345843.6
354010,201710,95,51,44,47787,40760,88547
354020,201710,539,340,199,317643,186463,504106
354025,201710,55,44,11,41228,10307,51535
354030,201710,64,33,31,30921,29047,59968
354040,201710,92,66,26,61560.9,24362,85922.9
354050,201710,186,105,81,98104,75897,174001
354060,201710,770,372,398,348564,370444.6,719008.6
354070,201710,873,507,366,472931.52,342942,815873.52
354075,201710,206,114,92,106725,85267.9,191992.9
354080,201710,290,129,161,120591.9,150857,271448.9
354085,201710,19,12,7,11244,6559,17803
354090,201710,313,174,139,162959,130243,293202
354100,201710,5410,2232,3178,2081503.72,2973206.55,5054710.27
354105,201710,81,42,39,39354,36543,75897
354110,201710,44,18,26,16866,24362,41228
354120,201710,148,102,46,95437.29,43102,138539.29
354130,201710,685,464,221,434534,206792,641326
354140,201710,3151,1467,1684,1371242.42,1576672.22,2947914.64
354150,201710,642,399,243,372364.6,226285.5,598650.1
354160,201710,690,436,254,407360.75,237717,645077.75
354165,201710,18,12,6,11244,5622,16866
354170,201710,170,116,54,108036.1,50598,158634.1
354180,201710,65,40,25,37160,23425,60585
354190,201710,208,95,113,87422.1,105881,193303.1
354200,201710,128,69,59,64185,55283,119468
354210,201710,71,34,37,31858,34669,66527
354220,201710,647,400,247,374144.1,230221.08,604365.18
354230,201710,158,65,93,60905,86204.8,147109.8
354240,201710,314,203,111,188993.69,103382.3,292375.99
354250,201710,90,53,37,49661,34669,84330
354260,201710,1888,878,1010,813194.82,945052,1758246.82
354270,201710,95,71,24,66527,22488,89015
354280,201710,33,18,15,16866,14055,30921
354290,201710,150,103,47,95246.55,44039,139285.55
354300,201710,413,284,129,265796,120873,386669
354310,201710,101,74,27,68401.1,25299,93700.1
354320,201710,181,96,85,89952,79645,169597
354323,201710,17,15,2,14055,1874,15929
354325,201710,109,63,46,58239,43102,101341
354330,201710,2510,862,1648,803851.94,1542047.69,2345899.63
354340,201710,10586,5149,5437,4810037.86,5089222.33,9899260.19
354350,201710,131,89,42,83393,39213.45,122606.45
354360,201710,88,50,38,46850,35606,82456
354370,201710,273,143,130,133991,121810,255801
354380,201710,211,126,85,117288,79645,196933
354390,201710,2738,993,1745,929508.5,1633427.94,2562936.44
354400,201710,320,168,152,156058.9,141861.9,297920.8
354410,201710,603,292,311,272663.32,290470.1,563133.42
354420,201710,265,168,97,157416,90889,248305
354425,201710,315,182,133,170534,124621,295155
354430,201710,192,122,70,112767.95,64840.4,177608.35
354440,201710,41,29,12,27173,11244,38417
354450,201710,49,34,15,31858,14055,45913
354460,201710,103,61,42,57157,39354,96511
354470,201710,39,28,11,26236,10307,36543
354480,201710,119,63,56,59022,52462.63,111484.63
354490,201710,144,92,52,86047.81,48724,134771.81
354500,201710,395,197,198,184589,185526,370115
354510,201710,104,71,33,66527,30921,97448
354515,201710,40,15,25,14055,23425,37480
354520,201710,1599,715,884,666629.6,827624.3,1494253.9
354530,201710,631,329,302,305926.5,282131.1,588057.6
354540,201710,273,152,121,142424,113372.32,255796.32
354550,201710,42,23,19,21551,17803,39354
354560,201710,157,93,64,87141,59958.63,147099.63
354570,201710,143,94,49,87797,45913,133710
354580,201710,1967,943,1024,880779,959193.54,1839972.54
354600,201710,279,153,126,141150.36,118047.95,259198.31
354610,201710,71,65,6,60905,5622,66527
354620,201710,64,19,45,17803,42165,59968
354625,201710,17,11,6,10307,5618,15925
354630,201710,323,211,112,197207.21,104944,302151.21
354640,201710,782,505,277,469048.5,259549,728597.5
354650,201710,72,39,33,36534,30884.26,67418.26
354660,201710,814,598,216,557000.05,202392,759392.05
354670,201710,287,103,184,95314,171472,266786
354680,201710,1235,464,771,434768,721959,1156727
354690,201710,89,61,28,56221,26236,82457
354700,201710,78,57,21,53409,19677,73086
354710,201710,57,40,17,36855.3,15929,52784.3
354720,201710,20,19,1,17803,937,18740
354730,201710,1924,810,1114,756338.5,1043630.6,1799969.1
354740,201710,57,41,16,38417,14992,53409
354750,201710,439,261,178,244548,166786,411334
354760,201710,513,316,197,293759,184308,478067
354765,201710,11,5,6,4685,5622,10307
354770,201710,329,227,102,211608.71,94824.4,306433.11
354780,201710,8126,3310,4816,3088432.58,4507641.92,7596074.50
354790,201710,116,68,48,63716,44976,108692
354800,201710,405,227,178,212699,166505,379204
354805,201710,104,53,51,49037,47787,96824
354810,201710,137,80,57,74678.9,53409,128087.9
354820,201710,183,78,105,72880,98385,171265
354830,201710,39,22,17,20614,15929,36543
354840,201710,56,37,19,34669,17803,52472
354850,201710,4539,2018,2521,1883217.7,2357957.98,4241175.68
354860,201710,333,162,171,151794,157884.85,309678.85
354870,201710,11647,5274,6373,4917035.88,5962840.63,10879876.51
354880,201710,2968,1113,1855,1041335.25,1736286.96,2777622.21
354890,201710,2819,1560,1259,1456768.48,1178549.64,2635318.12
354900,201710,60,39,21,36543,19677,56220
354910,201710,1184,629,555,586525.22,520035,1106560.22
354920,201710,52,44,8,41228,7496,48724
354925,201710,11,6,5,5622,4685,10307
354930,201710,30,27,3,25033,2811,27844
354940,201710,805,590,215,550912.09,201455,752367.09
354950,201710,223,147,76,137137,71212,208349
354960,201710,169,64,105,59968,98104,158072
354970,201710,829,544,285,504954.39,266417.31,771371.70
354980,201710,8343,3114,5229,2910566.09,4896345.32,7806911.41
354990,201710,9145,4299,4846,4017644.43,4534491.77,8552136.20
354995,201710,513,180,333,168660,311430.69,480090.69
355000,201710,451,147,304,137734.32,283787,421521.32
355010,201710,621,398,223,372926,206778.36,579704.36
355020,201710,714,446,268,416960.9,251108,668068.9
355030,201710,201983,78181,123802,73042611.64,115906465.9,188949077.54
355040,201710,705,338,367,316425,343691.6,660116.6
355050,201710,155,103,52,95262.77,48724,143986.77
355060,201710,1392,713,679,663320.97,635052.15,1298373.12
355070,201710,1464,718,746,669942.44,698026,1367968.44
355080,201710,206,118,88,110358.74,81584.9,191943.64
355090,201710,290,195,95,180655,89015,269670
355100,201710,4759,2385,2374,2216770.45,2222225.39,4438995.84
355110,201710,293,190,103,176297.55,96511,272808.55
355120,201710,116,83,33,77302.5,30921,108223.5
355130,201710,52,27,25,25299,23425,48724
355140,201710,180,119,61,111503,57157,168660
355150,201710,666,403,263,376389.1,245962.5,622351.6
355160,201710,440,209,231,193209.8,216447,409656.8
355170,201710,2026,1054,972,986240.87,910464.28,1896705.15
355180,201710,620,264,356,246431,332602.46,579033.46
355190,201710,218,148,70,138676,65590,204266
355200,201710,119,69,50,64653,46850,111503
355210,201710,704,408,296,382296,277333.63,659629.63
355220,201710,6473,3495,2978,3265133.78,2781653.79,6046787.57
355230,201710,107,64,43,59968,40286.32,100254.32
355240,201710,4120,1817,2303,1689433.07,2153908.38,3843341.45
355250,201710,5279,2595,2684,2423406.61,2511765.28,4935171.89
355255,201710,49,29,20,27173,18740,45913
355260,201710,189,114,75,105862.36,70257,176119.36
355270,201710,165,97,68,90889,63014,153903
355280,201710,6168,2615,3553,2445877.75,3324828.32,5770706.07
355290,201710,78,59,19,55283,17803,73086
355300,201710,177,117,60,109629,56220,165849
355310,201710,104,59,45,55283,42165,97448
355320,201710,93,47,46,44039,42406.3,86445.3
355330,201710,270,150,120,140550,112440,252990
355340,201710,1385,542,843,505293.76,789162.2,1294455.96
355350,201710,138,71,67,66527,62779,129306
355360,201710,182,114,68,106611.86,63716,170327.86
355365,201710,26,21,5,19677,4685,24362
355370,201710,1023,579,444,536704.22,414396.04,951100.26
355380,201710,765,513,252,479281.8,235843,715124.8
355385,201710,55,38,17,35606,15929,51535
355390,201710,103,60,43,56220,40291,96511
355395,201710,187,113,74,105080.32,69338,174418.32
355400,201710,1518,952,566,888096.98,529779.9,1417876.88
355410,201710,4830,2256,2574,2095827.68,2402176.74,4498004.42
355420,201710,45,34,11,31858,10307,42165
355430,201710,343,209,134,195177.1,125558,320735.1
355440,201710,78,44,34,41228,31858,73086
355450,201710,421,200,221,183232.67,205765.3,388997.97
355460,201710,70,54,16,49661.51,14992,64653.51
355465,201710,51,32,19,29984,17803,47787
355470,201710,187,74,113,68401.55,105881,174282.55
355475,201710,12,8,4,7496,3748,11244
355480,201710,454,197,257,183465,239394.13,422859.13
355490,201710,113,82,31,76834,29047,105881
355495,201710,52,26,26,24362,24362,48724
355500,201710,1697,971,726,905318.14,680223.64,1585541.78
355510,201710,268,195,73,179318.5,68401,247719.5
355520,201710,38,30,8,28110,7496,35606
355530,201710,22,15,7,14055,6559,20614
355535,201710,78,38,40,35606,37480,73086
355540,201710,2333,940,1393,879347.42,1303068.63,2182416.05
355550,201710,65,40,25,37480,23425,60905
355560,201710,241,121,120,113377,111815.3,225192.3
355570,201710,30,19,11,17803,10307,28110
355580,201710,270,187,83,175219,77766.32,252985.32
355590,201710,24,15,9,14055,8433,22488
355600,201710,266,140,126,131180,117776.32,248956.32
355610,201710,206,135,71,126495,66527,193022
355620,201710,1240,572,668,533293.9,625349.8,1158643.7
355630,201710,404,287,117,267983,109629,377612
355635,201710,126,59,67,55283,62766,118049
355640,201710,565,330,235,308273,220195,528468
355645,201710,826,359,467,334721.64,435733.21,770454.85
355650,201710,2037,892,1145,833528.4,1072846.63,1906375.03
355660,201710,260,138,122,129306,114309.32,243615.32
355670,201710,472,179,293,167723,274541,442264
355680,201710,214,122,92,114314,85923,200237
355690,201710,87,40,47,37480,43701,81181
355695,201710,13,11,2,10307,1874,12181
355700,201710,1134,586,548,544103.3,513195,1057298.3
355710,201710,2204,1210,994,1129227.68,930506.9,2059734.58
355715,201710,21,19,2,17803,1874,19677
355720,201710,204,122,82,112752.66,76830,189582.66
355730,201710,88,51,37,46928.53,34669,81597.53
410010,201710,133,112,21,104944,19677,124621
410020,201710,104,93,11,87141,10307,97448
410030,201710,157,99,58,92107.2,54346,146453.2
410040,201710,969,520,449,486724.65,420526,907250.65
410045,201710,27,22,5,20614,4685,25299
410050,201710,465,261,204,244557,190960.6,435517.6
410060,201710,267,206,61,192840,57157,249997
410070,201710,315,259,56,242683,52472,295155
410080,201710,166,109,57,102133,53409,155542
410090,201710,79,70,9,65384,8433,73817
410100,201710,293,208,85,194586.79,78942.25,273529.04
410105,201710,39,23,16,21551,14992,36543
410110,201710,309,190,119,178030,111503,289533
410115,201710,28,19,9,17803,8433,26236
410120,201710,454,229,225,214276.9,210825,425101.9
410130,201710,40,27,13,25299,12181,37480
410140,201710,3047,1494,1553,1395322.63,1451602.43,2846925.06
410150,201710,2670,1073,1597,1004436.75,1495615.5,2500052.25
410160,201710,506,321,185,300495.9,173345,473840.9
410165,201710,66,43,23,40291,21551,61842
410170,201710,165,123,42,113055.83,39354,152409.83
410180,201710,2123,1227,896,1145501.59,837652.08,1983153.67
410185,201710,39,35,4,32795,3748,36543
410190,201710,425,266,159,249242,148983,398225
410200,201710,970,727,243,679437.88,227409.9,906847.78
410210,201710,549,279,270,261423,252428,513851
410220,201710,41,23,18,21551,16866,38417
410230,201710,121,70,51,65590,47787,113377
410240,201710,722,480,242,449197.9,226754,675951.9
410250,201710,385,283,102,264577.6,95574,360151.6
410260,201710,264,167,97,156479,90889,247368
410270,201710,28,17,11,15929,10307,26236
410275,201710,69,53,16,49661,14992,64653
410280,201710,312,170,142,159035.14,133054,292089.14
410290,201710,222,146,76,135959.03,70769.91,206728.94
410300,201710,82,65,17,60905,15929,76834
410302,201710,25,17,8,15929,7496,23425
410304,201710,51,35,16,32795,14992,47787
410305,201710,201,108,93,100404,87141,187545
410310,201710,260,168,92,157416,86204,243620
410315,201710,58,42,16,39330,14992,54322
410320,201710,137,96,41,89952,38417,128369
410322,201710,33,23,10,21551,9370,30921
410330,201710,167,118,49,110566,45913,156479
410335,201710,95,59,36,55283,33732,89015
410337,201710,40,34,6,31858,5622,37480
410340,201710,32,31,1,29047,937,29984
410345,201710,213,134,79,125558,74023,199581
410347,201710,52,40,12,37480,11244,48724
410350,201710,229,139,90,129962,84330,214292
410360,201710,456,276,180,256114.2,168098,424212.2
410370,201710,2346,972,1374,907888.46,1284422.11,2192310.57
410380,201710,222,144,78,134928,73086,208014
410390,201710,367,277,90,259545,84330,343875
410395,201710,34,22,12,20614,10870,31484
410400,201710,832,421,411,393170.7,384578,777748.7
410405,201710,89,65,24,60905,22488,83393
410410,201710,43,33,10,30921,9370,40291
410420,201710,1632,808,824,755323.6,770527.3,1525850.9
410425,201710,177,87,90,81332,84330,165662
410430,201710,2202,1288,914,1204419.9,855274.96,2059694.86
410440,201710,396,283,113,264235,105881,370116
410442,201710,362,240,122,223944,114314,338258
410445,201710,424,293,131,274541,122747,397288
410450,201710,405,199,206,186463,193022,379485
410460,201710,398,211,187,197425.9,175219,372644.9
410465,201710,193,126,67,116562.8,62497.9,179060.7
410470,201710,216,136,80,127432,74960,202392
410480,201710,5628,2791,2837,2597529.06,2652997.99,5250527.05
410490,201710,1365,903,462,844941,431021,1275962
410500,201710,260,149,111,139613,104007,243620
410510,201710,176,129,47,120873,43405.3,164278.3
410520,201710,269,199,70,186463,65590,252053
410530,201710,232,84,148,78708,138672,217380
410540,201710,322,229,93,214002.8,87136.32,301139.12
410550,201710,1587,693,894,648873.9,837396.9,1486270.8
410560,201710,149,112,37,104944,34669,139613
410570,201710,433,307,126,286404.05,118062,404466.05
410580,201710,3189,1436,1753,1342474.16,1640875,2983349.16
410590,201710,394,282,112,264234,104944,369178
410600,201710,177,157,20,147109,18740,165849
410610,201710,54,44,10,41228,9370,50598
410620,201710,240,172,68,161164,63716,224880
410630,201710,452,268,184,251096,171269,422365
410640,201710,945,573,372,533789.12,346985.85,880774.97
410645,201710,98,73,25,68007,23425,91432
410650,201710,359,245,114,228628,106818,335446
410655,201710,77,59,18,55283,16866,72149
410657,201710,43,19,24,17803,22488,40291
410660,201710,575,413,162,385760,151794,537554
410670,201710,78,63,15,59031,14055,73086
410680,201710,191,156,35,146172,31858.4,178030.4
410685,201710,19,13,6,12181,5622,17803
410690,201710,28521,12375,16146,11578868.49,15116452.97,26695321.46
410700,201710,321,237,84,221507,78708,300215
410710,201710,130,105,25,98385,23425,121810
410712,201710,23,14,9,13118,8433,21551
410715,201710,84,65,19,60905,17803,78708
410720,201710,589,355,234,332635,218967.9,551602.9
410725,201710,175,127,48,118999,44976,163975
410730,201710,89,54,35,50598,32795,83393
410740,201710,111,82,29,76834,27173,104007
410750,201710,218,161,57,150853,53404.32,204257.32
410752,201710,22,14,8,13118,7496,20614
410753,201710,53,23,30,20890.41,28110,49000.41
410754,201710,37,24,13,22488,12181,34669
410755,201710,82,56,26,52190.9,24362,76552.9
410760,201710,696,398,298,372926,278758,651684
410765,201710,1643,788,855,732262.94,800282.63,1532545.57
410770,201710,109,93,16,87141,14992,102133
410773,201710,46,34,12,31858,11244,43102
410775,201710,174,129,45,120217.1,42165,162382.1
410780,201710,79,42,37,39354,34669,74023
410785,201710,72,55,17,51348,15929,67277
410790,201710,67,32,35,29984,32795,62779
410800,201710,295,185,110,172409,103070,275479
410810,201710,31,26,5,24362,4404,28766
410820,201710,178,131,47,122607,44039,166646
410830,201710,8514,3890,4624,3636611.1,4330600.32,7967211.42
410832,201710,106,75,31,69993.9,29047,99040.9
410840,201710,1384,766,618,715517.99,578664.67,1294182.66
410845,201710,63,40,23,37480,21551,59031
410850,201710,194,133,61,124300,57157,181457
410855,201710,44,38,6,35606,5622,41228
410860,201710,669,392,277,366532.75,259549,626081.75
410865,201710,109,83,26,77771,24362,102133
410870,201710,149,131,18,122747,16579,139326
410880,201710,1084,541,543,506414.65,508746,1015160.65
410890,201710,82,60,22,56220,20614,76834
410895,201710,75,56,19,52472,17803,70275
410900,201710,24,17,7,15929,6559,22488
410910,201710,20,17,3,15929,2811,18740
410920,201710,37,26,11,24362,10307,34669
410930,201710,499,320,179,299632.74,167723,467355.74
410940,201710,4321,2574,1747,2403429.16,1633729.7,4037158.86
410950,201710,124,89,35,83393,32795,116188
410960,201710,756,334,422,312677,394946,707623
410965,201710,62,48,14,44694.9,13118,57812.9
410970,201710,622,442,180,413698.1,168660,582358.1
410975,201710,107,70,37,65089,34669,99758
410980,201710,1531,695,836,648714.21,783042.22,1431756.43
410990,201710,265,179,86,167557.25,80300.9,247858.15
411000,201710,60,39,21,36543,19677,56220
411005,201710,22,16,6,14992,5622,20614
411007,201710,243,139,104,130243,97448,227691
411010,201710,569,403,166,377611,155542,533153
411020,201710,283,193,90,180841,84330,265171
411030,201710,28,17,11,15929,10307,26236
411040,201710,49,34,15,31858,14055,45913
411050,201710,222,175,47,163278.48,43912.12,207190.60
411060,201710,517,353,164,330752,153668,484420
411065,201710,60,53,7,49661,6559,56220
411070,201710,1182,796,386,741730,361682,1103412
411080,201710,238,168,70,157499,65590,223089
411090,201710,113,84,29,78708,27173,105881
411095,201710,261,108,153,100728,143351,244079
411100,201710,114,95,19,89015,17803,106818
411110,201710,122,83,39,77771,36543,114314
411120,201710,180,134,46,125558,43102,168660
411125,201710,181,79,102,73367.1,95574,168941.1
411130,201710,121,104,17,96822,15929,112751
411140,201710,173,120,53,112137.02,49145.65,161282.67
411150,201710,1180,785,395,735535.63,370115,1105650.63
411155,201710,120,83,37,77771,34669,112440
411160,201710,21,10,11,9370,10307,19677
411170,201710,61,54,7,50316.9,6559,56875.9
411180,201710,909,597,312,558171,292339.32,850510.32
411190,201710,325,180,145,168004.1,135865,303869.1
411200,201710,660,439,221,410094.09,206467.95,616562.04
411210,201710,668,355,313,331112.83,293281,624393.83
411220,201710,147,112,35,104944,32795,137739
411230,201710,42,39,3,36543,2811,39354
411240,201710,125,86,39,80582,36543,117125
411250,201710,415,301,114,282037,106818,388855
411260,201710,22,15,7,14055,6559,20614
411270,201710,289,158,131,148046,122747,270793
411275,201710,201,177,24,165146.8,22488,187634.8
411280,201710,228,161,67,149608.36,62779,212387.36
411290,201710,57,43,14,40291,13118,53409
411295,201710,139,110,29,103070,27173,130243
411300,201710,85,46,39,43102,36543,79645
411310,201710,93,71,22,66527,20614,87141
411320,201710,750,548,202,511902.7,187700.24,699602.94
411325,201710,46,29,17,27173,15929,43102
411330,201710,883,563,320,525798.26,299277.8,825076.06
411340,201710,29,20,9,18740,8124,26864
411342,201710,81,59,22,55283,20614,75897
411345,201710,123,61,62,57157,58094,115251
411350,201710,476,385,91,359480.82,84321.1,443801.92
411360,201710,54,34,20,31858,18740,50598
411370,201710,13901,5707,8194,5331370.45,7665195.07,12996565.52
411373,201710,191,141,50,132117,46850,178967
411375,201710,82,68,14,63716,13118,76834
411380,201710,96,72,24,67464,22488,89952
411390,201710,139,92,47,86204,44039,130243
411400,201710,350,260,90,243611,84330,327941
411410,201710,445,227,218,212043.1,203985,416028.1
411420,201710,1038,479,559,446574.2,523033.6,969607.8
411430,201710,399,258,141,241090.1,132016.15,373106.25
411435,201710,40,29,11,27173,10307,37480
411440,201710,474,379,95,353499.37,89015,442514.37
411450,201710,435,360,75,337320,70275,407595
411460,201710,723,287,436,267950.2,407230.96,675181.16
411470,201710,118,88,30,82456,28110,110566
411480,201710,618,349,269,325514.8,251771.9,577286.7
411490,201710,292,182,110,170534,103070,273604
411500,201710,111,94,17,88078,15555,103633
411510,201710,216,174,42,162303.39,39354,201657.39
411520,201710,5899,2312,3587,2162187.32,3353493.39,5515680.71
411530,201710,110,73,37,68401,34669,103070
411535,201710,47,19,28,17803,26236,44039
411540,201710,320,219,101,204383.6,94637,299020.6
411545,201710,77,54,23,50598,21551,72149
411550,201710,70,56,14,52472,13118,65590
411560,201710,374,171,203,159599.21,190211,349810.21
411570,201710,785,296,489,277062,458006,735068
411573,201710,41,24,17,22488,15929,38417
411575,201710,263,161,102,150857,95574,246431
411580,201710,1212,479,733,448167.1,684913,1133080.1
411585,201710,79,39,40,36543,37480,74023
411590,201710,26,18,8,16866,7496,24362
411600,201710,29,14,15,13118,14055,27173
411605,201710,236,108,128,101056,119936,220992
411610,201710,238,159,79,148983,74023,223006
411620,201710,354,198,156,185338.6,146172,331510.6
411630,201710,57,39,18,36543,16866,53409
411640,201710,38,31,7,29047,6559,35606
411650,201710,14,10,4,9370,3748,13118
411660,201710,42,36,6,33732,5622,39354
411670,201710,243,184,59,172408,55283,227691
411680,201710,156,133,23,124621,21551,146172
411690,201710,595,322,273,301118.08,255439.6,556557.68
411695,201710,64,50,14,46850,13118,59968
411700,201710,169,146,23,136802,21551,158353
411705,201710,104,66,38,61842,35606,97448
411710,201710,295,196,99,182685.86,92763,275448.86
411720,201710,132,85,47,79645,44039,123684
411721,201710,61,51,10,47787,9370,57157
411722,201710,99,41,58,38417,54346,92763
411725,201710,142,110,32,102789,29984,132773
411727,201710,86,70,16,65590,14710.9,80300.9
411729,201710,35,27,8,25299,7496,32795
411730,201710,544,353,191,329199.3,178967,508166.3
411740,201710,30,22,8,20614,7496,28110
411745,201710,69,46,23,42325,21551,63876
411750,201710,842,407,435,380282.45,406634.58,786917.03
411760,201710,1168,888,280,830829.14,262351,1093180.14
411770,201710,426,291,135,272667,126495,399162
411780,201710,365,237,128,222069,119936,342005
411790,201710,519,283,236,263032.17,221020.67,484052.84
411800,201710,170,134,36,125558,33732,159290
411810,201710,154,119,35,111503,32795,144298
411820,201710,2104,1034,1070,966590.56,1002187.86,1968778.42
411830,201710,11,11,0,10307,0,10307
411840,201710,1930,1186,744,1110626.6,696358.9,1806985.5
411845,201710,47,17,30,15929,28110,44039
411850,201710,1241,714,527,666572.74,491880.81,1158453.55
411860,201710,45,29,16,26892,14992,41884
411870,201710,35,28,7,26236,6559,32795
411880,201710,417,271,146,253673,136071.14,389744.14
411885,201710,105,69,36,64653,33732,98385
411890,201710,323,203,120,188501.86,112431,300932.86
411900,201710,72,53,19,49661,17803,67464
411910,201710,170,141,29,132107.63,26348.44,158456.07
411915,201710,2035,881,1154,824365.11,1080528.03,1904893.14
411920,201710,122,101,21,94637,19677,114314
411925,201710,18,12,6,11244,5622,16866
411930,201710,790,583,207,544399,193959,738358
411940,201710,587,418,169,391197.5,158328.56,549526.06
411950,201710,883,473,410,443201,383201.8,826402.8
411960,201710,946,674,272,629207,254864,884071
411965,201710,27,19,8,17803,7496,25299
411970,201710,70,63,7,59031,6559,65590
411980,201710,195,130,65,121810,60905,182715
411990,201710,4790,2823,1967,2628857.08,1841337.4,4470194.48
411995,201710,454,170,284,159290,266108,425398
412000,201710,282,163,119,152029.56,111503,263532.56
412010,201710,44,26,18,24362,16866,41228
412015,201710,45,33,12,30921,11244,42165
412020,201710,28,25,3,23143.9,2811,25954.9
412030,201710,61,51,10,47787,9370,57157
412033,201710,57,37,20,34645,18740,53385
412035,201710,85,53,32,49661,29984,79645
412040,201710,35,25,10,23144,9370,32514
412050,201710,202,150,52,140550,48724,189274
412060,201710,744,585,159,545334.88,148014.9,693349.78
412065,201710,46,32,14,29984,13118,43102
412070,201710,153,104,49,96792.1,45913,142705.1
412080,201710,271,138,133,129306,124621,253927
412085,201710,32,15,17,14055,15929,29984
412090,201710,726,451,275,420667.1,257675,678342.1
412100,201710,245,203,42,189275,39166.6,228441.6
412110,201710,72,59,13,55283,12181,67464
412120,201710,311,203,108,189648.8,101196,290844.8
412125,201710,78,46,32,42820.9,29984,72804.9
412130,201710,52,37,15,34669,14055,48724
412135,201710,28,16,12,14992,11244,26236
412140,201710,297,214,83,199890.21,77771,277661.21
412150,201710,255,171,84,159290.62,78708,237998.62
412160,201710,97,60,37,56220,34669,90889
412170,201710,626,450,176,421650,164912,586562
412175,201710,50,36,14,33732,13118,46850
412180,201710,196,158,38,147457.29,34996.95,182454.24
412190,201710,331,268,63,250455.41,59031,309486.41
412200,201710,190,124,66,116188,61842,178030
412210,201710,95,75,20,70275,18740,89015
412215,201710,239,162,77,151513,72149,223662
412217,201710,84,65,19,60905,17803,78708
412220,201710,812,608,204,569696,191148,760844
412230,201710,333,208,125,192701.67,116765.75,309467.42
412240,201710,1301,634,667,590181.23,622875.7,1213056.93
412250,201710,385,249,136,233313,127151,360464
412260,201710,126,92,34,86204,31858,118062
412265,201710,161,129,32,120873,29984,150857
412270,201710,86,54,32,50598,29984,80582
412280,201710,87,68,19,63716,17803,81519
412290,201710,96,64,32,59968,29984,89952
412300,201710,221,144,77,134928,72149,207077
412310,201710,43,36,7,33732,6559,40291
412320,201710,95,80,15,74960,14055,89015
412330,201710,168,150,18,140550,16866,157416
412340,201710,146,99,47,92763,43758,136521
412350,201710,581,282,299,263250.15,280163,543413.15
412360,201710,29,26,3,24362,2811,27173
412370,201710,166,139,27,129306,25299,154605
412380,201710,258,191,67,178685.9,62254.65,240940.55
412382,201710,55,30,25,28110,23425,51535
412385,201710,138,99,39,92763,36543,129306
412390,201710,270,200,70,187400,65590,252990
412395,201710,63,50,13,46850,12181,59031
412400,201710,70,50,20,46850,18740,65590
412402,201710,232,107,125,100254.32,116843.9,217098.22
412405,201710,798,317,481,295598.01,450032.24,745630.25
412410,201710,943,593,350,554142,327950,882092
412420,201710,18,13,5,12181,4685,16866
412430,201710,20,15,5,14055,4685,18740
412440,201710,586,313,273,290325.31,253894.84,544220.15
412450,201710,85,70,15,65590,14055,79645
412460,201710,80,63,17,59031,15929,74960
412470,201710,255,204,51,191148,47787,238935
412480,201710,177,133,44,123454.95,41228,164682.95
412490,201710,164,139,25,130243,23425,153668
412500,201710,479,389,90,363230,84330,447560
412510,201710,189,155,34,144673,31858,176531
412520,201710,127,70,57,65590,53409,118999
412530,201710,106,57,49,53409,45631.9,99040.9
412535,201710,106,81,25,75879,23425,99304
412540,201710,67,31,36,29047,33732,62779
412545,201710,98,71,27,66527,25299,91826
412550,201710,3454,1577,1877,1474269.57,1757447.04,3231716.61
412555,201710,17,12,5,11244,4685,15929
412560,201710,575,433,142,404410.1,133054,537464.1
412570,201710,731,411,320,384507.32,299559,684066.32
412575,201710,90,62,28,58094,26236,84330
412580,201710,158,109,49,102133,45913,148046
412590,201710,34,31,3,29047,2811,31858
412600,201710,174,134,40,125558,37480,163038
412610,201710,36,23,13,21551,11375.18,32926.18
412620,201710,146,129,17,120873,15929,136802
412625,201710,2168,1168,1000,1091359.5,935155.72,2026515.22
412627,201710,68,55,13,51535,12181,63716
412630,201710,433,289,144,270602,134647,405249
412635,201710,63,20,43,18740,40291,59031
412640,201710,116,78,38,73086,35606,108692
412650,201710,331,211,120,197425.9,112435.32,309861.22
412660,201710,486,293,193,273839,180841,454680
412665,201710,51,45,6,42165,5622,47787
412667,201710,312,206,106,192417.6,99006.92,291424.52
412670,201710,64,54,10,50598,9370,59968
412680,201710,286,228,58,213636,54346,267982
412690,201710,114,75,39,70275,36262,106537
412700,201710,166,113,53,105881,49380,155261
412710,201710,1402,873,529,812553.8,493162.6,1305716.4
412720,201710,225,152,73,142424,68401,210825
412730,201710,199,157,42,147109,38417,185526
412740,201710,405,219,186,205062.45,174282,379344.45
412750,201710,458,263,195,245494,182715,428209
412760,201710,242,124,118,116188,110566,226754
412770,201710,2032,1161,871,1083551.49,815828,1899379.49
412780,201710,150,117,33,109496.88,30921,140417.88
412785,201710,266,135,131,126026.5,122747,248773.5
412788,201710,37,22,15,20614,14055,34669
412790,201710,138,113,25,105225.1,23425,128650.1
412795,201710,159,118,41,110566,38417,148983
412796,201710,297,205,92,190941.83,86072.82,277014.65
412800,201710,555,365,190,341455.36,178021,519476.36
412810,201710,2946,1635,1311,1527759.79,1226903.12,2754662.91
412820,201710,944,620,324,568775.99,300269.98,869045.97
412830,201710,18,14,4,13118,3748,16866
412840,201710,213,154,59,143361.1,55283,198644.1
412850,201710,780,530,250,494736,234250,728986
412853,201710,176,95,81,89015,75897,164912
412855,201710,221,121,100,112284.21,93700,205984.21
412860,201710,90,69,21,64653,19677,84330
412862,201710,62,46,16,42820.9,14992,57812.9
412863,201710,7,6,1,5622,937,6559
412865,201710,43,33,10,30921,9370,40291
412870,201710,109,70,39,65590,36543,102133
412880,201710,128,100,28,93700,26236,119936
420005,201710,35,32,3,29984,2249,32233
420010,201710,362,240,122,223705.67,114314,338019.67
420020,201710,73,62,11,58094,10307,68401
420030,201710,28,25,3,23425,2811,26236
420040,201710,108,82,26,76834,24362,101196
420050,201710,56,33,23,30559.9,21390.34,51950.24
420055,201710,19,18,1,16866,937,17803
420060,201710,34,26,8,24362,7496,31858
420070,201710,98,85,13,79645,12171.63,91816.63
420075,201710,13,11,2,10307,1874,12181
420080,201710,47,42,5,38463.85,4685,43148.85
420090,201710,35,33,2,30157.34,1874,32031.34
420100,201710,156,130,26,120873.1,24362,145235.1
420110,201710,17,17,0,15929,0,15929
420120,201710,44,32,12,29984,11244,41228
420125,201710,83,66,17,61842,15929,77771
420127,201710,32,29,3,27173,2811,29984
420130,201710,366,235,131,219904.63,122503.38,342408.01
420140,201710,1241,726,515,679194.89,482491,1161685.89
420150,201710,47,40,7,37480,6559,44039
420160,201710,42,39,3,36543,2811,39354
420165,201710,17,13,4,12181,3748,15929
420170,201710,62,41,21,38417,19677,58094
420180,201710,23,22,1,20614,937,21551
420190,201710,31,28,3,26236,2811,29047
420195,201710,124,59,65,55283,60624,115907
420200,201710,1261,561,700,520039.1,655536.52,1175575.62
420205,201710,65,31,34,29047,31858,60905
420207,201710,100,57,43,53409,40281.63,93690.63
420208,201710,22,17,5,15929,3841.7,19770.7
420209,201710,19,15,4,14055,3748,17803
420210,201710,458,214,244,200236.9,228534.67,428771.57
420213,201710,48,37,11,34669,10307,44976
420215,201710,25,21,4,19677,3748,23425
420220,201710,69,46,23,43102,21551,64653
420230,201710,723,415,308,388106,288586.63,676692.63
420240,201710,2243,1526,717,1420839.56,670835.88,2091675.44
420243,201710,34,27,7,25299,6559,31858
420245,201710,93,55,38,51535,35606,87141
420250,201710,53,30,23,28110,21551,49661
420253,201710,41,34,7,31858,6559,38417
420257,201710,9,7,2,6559,1874,8433
420260,201710,95,84,11,78708,10307,89015
420270,201710,38,30,8,28106,7496,35602
420280,201710,277,202,75,188222.65,68997.39,257220.04
420285,201710,20,12,8,11244,7496,18740
420287,201710,48,29,19,27173,17803,44976
420290,201710,969,683,286,639007.5,267915.2,906922.7
420300,201710,1371,1076,295,1004279.2,275197.67,1279476.87
420310,201710,56,44,12,40697.03,11244,51941.03
420315,201710,34,30,4,28110,3748,31858
420320,201710,845,428,417,400075.58,390725,790800.58
420325,201710,0,0,0,0,0,0
420330,201710,121,82,39,76834,36430.56,113264.56
420340,201710,157,107,50,99314,46821.89,146135.89
420350,201710,241,175,66,162664.1,61842,224506.1
420360,201710,733,557,176,520252.23,163329.09,683581.32
420370,201710,105,70,35,65403,32514,97917
420380,201710,1115,790,325,735498.83,303412.29,1038911.12
420390,201710,250,160,90,148684.06,83627.25,232311.31
420395,201710,175,126,49,118062,45903.63,163965.63
420400,201710,247,183,64,170909,59968,230877
420410,201710,61,47,14,44039,13118,57157
420415,201710,32,29,3,27173,2811,29984
420417,201710,48,36,12,33732,11234.63,44966.63
420419,201710,12,11,1,10307,937,11244
420420,201710,2756,1689,1067,1570502.03,997250.88,2567752.91
420425,201710,68,58,10,54337,9061.16,63398.16
420430,201710,1279,888,391,829118.16,364652.29,1193770.45
420435,201710,15,13,2,12181,1874,14055
420440,201710,107,73,34,67761.96,31685.6,99447.56
420445,201710,23,21,2,19677,1874,21551
420450,201710,75,35,40,32766,37480,70246
420455,201710,246,190,56,178002.26,52408.63,230410.89
420460,201710,2291,1534,757,1432475.08,708815.72,2141290.80
420470,201710,123,88,35,82456,32795,115251
420475,201710,6,6,0,5622,0,5622
420480,201710,844,623,221,578391.56,206140.1,784531.66
420490,201710,111,86,25,80582,23425,104007
420500,201710,685,280,405,260706.1,379485,640191.1
420510,201710,20,17,3,15929,2811,18740
420515,201710,25,20,5,18740,4685,23425
420517,201710,9,9,0,8433,0,8433
420519,201710,0,0,0,0,0,0
420520,201710,66,49,17,45913,15929,61842
420530,201710,156,107,49,99322.95,45913,145235.95
420535,201710,20,18,2,16866,1874,18740
420540,201710,4517,2685,1832,2505532.8,1712058.69,4217591.49
420543,201710,21,21,0,19677,0,19677
420545,201710,185,132,53,123684,49642.26,173326.26
420550,201710,834,664,170,620742.25,159143.12,779885.37
420555,201710,42,31,11,29047,10307,39354
420560,201710,62,49,13,45538.2,12181,57719.2
420570,201710,133,76,57,70649.8,53399.63,124049.43
420580,201710,293,126,167,118062,156198,274260
420590,201710,501,355,146,332353.9,136802,469155.9
420600,201710,94,47,47,44039,44039,88078
420610,201710,36,34,2,31577,1874,33451
420620,201710,72,59,13,55283,12181,67464
420630,201710,153,107,46,100250.32,43098,143348.32
420640,201710,95,85,10,79645,9370,89015
420650,201710,239,127,112,118302.99,104336.26,222639.25
420660,201710,56,41,15,37667.9,14055,51722.9
420665,201710,39,30,9,28110,8433,36543
420670,201710,309,235,74,219014.43,69038.53,288052.96
420675,201710,16,15,1,14055,937,14992
420680,201710,33,24,9,22488,8433,30921
420690,201710,174,147,27,137739,25299,163038
420700,201710,610,427,183,400025.15,171249.45,571274.60
420710,201710,145,83,62,77771,58094,135865
420720,201710,103,83,20,77771,18740,96511
420730,201710,496,317,179,296946.15,166441.49,463387.64
420740,201710,45,44,1,41228,937,42165
420750,201710,489,323,166,302369.9,155542,457911.9
420757,201710,17,14,3,12321.55,2811,15132.55
420760,201710,40,30,10,28110,9361,37471
420765,201710,69,58,11,54346,10307,64653
420768,201710,66,58,8,54346,7496,61842
420770,201710,82,69,13,64653,12181,76834
420775,201710,46,43,3,39354,2811,42165
420780,201710,233,183,50,171461.63,46850,218311.63
420785,201710,13,9,4,8433,3748,12181
420790,201710,175,146,29,136466.9,26208.63,162675.53
420800,201710,75,56,19,51722.4,17803,69525.4
420810,201710,243,209,34,195824,31061.55,226885.55
420820,201710,2323,1383,940,1289257.57,879271.93,2168529.50
420830,201710,534,306,228,285277.09,212689.63,497966.72
420840,201710,139,106,33,99322,30921,130243
420845,201710,447,200,247,186740.93,230221,416961.93
420850,201710,224,180,44,168660,41228,209888
420860,201710,62,53,9,49661,8433,58094
420870,201710,118,85,33,79645,30921,110566
420880,201710,167,115,52,107089.73,48724,155813.73
420890,201710,848,419,429,389529.64,401964,791493.64
420895,201710,10,10,0,9370,0,9370
420900,201710,396,308,88,286573.12,82428.26,369001.38
420910,201710,5735,3187,2548,2979957.33,2382929.56,5362886.89
420915,201710,80,74,6,69338,5622,74960
420917,201710,18,13,5,12181,4685,16866
420920,201710,23,15,8,14055,7496,21551
420930,201710,2576,1567,1009,1460725.61,938434.77,2399160.38
420940,201710,595,437,158,409178.9,146422.24,555601.14
420945,201710,8,6,2,5622,1874,7496
420950,201710,55,50,5,46850,4685,51535
420960,201710,114,89,25,83347.26,23416,106763.26
420970,201710,298,239,59,222296.45,55255.63,277552.08
420980,201710,26,25,1,23425,937,24362
420985,201710,60,54,6,50598,5622,56220
420990,201710,66,50,16,46850,14992,61842
421000,201710,32,21,11,19677,10307,29984
421003,201710,68,43,25,40291,23416,63707
421005,201710,9,6,3,5622,2811,8433
421010,201710,768,544,224,509337.78,207834.39,717172.17
421020,201710,27,24,3,22488,2811,25299
421030,201710,126,104,22,97121,20614,117735
421040,201710,63,54,9,50598,8433,59031
421050,201710,298,213,85,197520.1,79645,277165.1
421055,201710,26,22,4,20614,3748,24362
421060,201710,83,58,25,54346,23425,77771
421070,201710,51,47,4,44039,3748,47787
421080,201710,33,31,2,29047,1874,30921
421085,201710,24,19,5,17803,4685,22488
421090,201710,43,33,10,30921,9370,40291
421100,201710,118,87,31,81519,29047,110566
421105,201710,211,170,41,159150,38393.95,197543.95
421110,201710,111,92,19,85594.95,17803,103397.95
421120,201710,153,119,34,111016.13,31839.26,142855.39
421125,201710,14,10,4,9370,3748,13118
421130,201710,792,509,283,475802.91,264149.87,739952.78
421140,201710,30,22,8,19911.25,7496,27407.25
421145,201710,39,32,7,29984,6559,36543
421150,201710,107,77,30,72149,28110,100259
421160,201710,59,40,19,37470.63,17803,55273.63
421165,201710,18,17,1,15929,937,16866
421170,201710,186,161,25,150128.52,23416,173544.52
421175,201710,149,97,52,90889,48687.26,139576.26
421180,201710,59,36,23,33376,21551,54927
421185,201710,16,13,3,12181,2811,14992
421187,201710,0,0,0,0,0,0
421189,201710,38,30,8,28110,7486.63,35596.63
421190,201710,1417,878,539,821937,504077.99,1326014.99
421200,201710,89,68,21,62780,19677,82457
421205,201710,24,16,8,14992,7486.63,22478.63
421210,201710,177,119,58,111503,54346,165849
421220,201710,265,211,54,196856.95,50598,247454.95
421223,201710,56,46,10,43102,9370,52472
421225,201710,61,41,20,38417,18740,57157
421227,201710,92,69,23,64653,21551,86204
421230,201710,48,35,13,32795,12181,44976
421240,201710,19,19,0,17803,0,17803
421250,201710,358,218,140,204173,130402.29,334575.29
421260,201710,29,23,6,21551,5622,27173
421265,201710,0,0,0,0,0,0
421270,201710,53,47,6,44039,5622,49661
421280,201710,335,195,140,182715,129493.4,312208.4
421290,201710,308,207,101,193725,93250.56,286975.56
421300,201710,26,21,5,19677,4685,24362
421310,201710,55,42,13,38698.1,12181,50879.1
421315,201710,28,20,8,18740,7496,26236
421320,201710,126,92,34,86204,31858,118062
421330,201710,109,83,26,76627.86,24353,100980.86
421335,201710,41,27,14,25299,13118,38417
421340,201710,287,193,94,178826.5,88078,266904.5
421350,201710,162,96,66,89517,61842,151359
421360,201710,691,509,182,470666.7,170308.52,640975.22
421370,201710,184,140,44,131180,40900.05,172080.05
421380,201710,126,103,23,96506.32,21551,118057.32
421390,201710,19,15,4,14055,3748,17803
421400,201710,112,95,17,89015,15929,104944
421410,201710,23,18,5,16866,4685,21551
421415,201710,19,17,2,15929,1874,17803
421420,201710,150,125,25,116562.8,23425,139987.8
421430,201710,14,11,3,10307,2811,13118
421440,201710,60,46,14,43102,13118,56220
421450,201710,98,85,13,79645,12181,91826
421460,201710,58,50,8,46060.1,7496,53556.1
421470,201710,70,46,24,43102,22488,65590
421480,201710,634,473,161,442732.5,150848,593580.5
421490,201710,24,22,2,19950,1874,21824
421500,201710,514,331,183,307875.21,170672.91,478548.12
421505,201710,24,17,7,15929,6559,22488
421507,201710,32,26,6,24362,5622,29984
421510,201710,71,47,24,44039,22113.2,66152.2
421520,201710,69,59,10,54534,9370,63904
421530,201710,53,47,6,43383.1,5622,49005.1
421535,201710,30,29,1,26911,937,27848
421540,201710,58,52,6,48724,5622,54346
421545,201710,95,72,23,66987,21551,88538
421550,201710,275,197,78,183934,73086,257020
421555,201710,23,19,4,17803,3655,21458
421560,201710,8,8,0,7496,0,7496
421565,201710,122,91,31,85267,29047,114314
421567,201710,29,23,6,21551,5622,27173
421568,201710,32,30,2,28110,1874,29984
421569,201710,9,8,1,7496,937,8433
421570,201710,137,92,45,86204,42165,128369
421575,201710,27,22,5,20356.33,4685,25041.33
421580,201710,709,422,287,395414,267982.27,663396.27
421590,201710,21,20,1,18740,937,19677
421600,201710,109,73,36,68381,32515,100896
421605,201710,99,70,29,65263,27173,92436
421610,201710,188,145,43,135584,40291,175875
421620,201710,1115,669,446,624398.76,417863.52,1042262.28
421625,201710,21,18,3,16866,2811,19677
421630,201710,270,172,98,161118,90983,252101
421635,201710,17,8,9,7496,8433,15929
421640,201710,97,85,12,79645,11244,90889
421650,201710,270,157,113,147090.26,105862.26,252952.52
421660,201710,2061,1230,831,1149625.86,777392.16,1927018.02
421670,201710,168,126,42,118062,39354,157416
421680,201710,167,152,15,142424,14046,156470
421690,201710,347,243,104,227101.8,96220.99,323322.79
421700,201710,54,34,20,31858,17897,49755
421710,201710,24,24,0,22488,0,22488
421715,201710,9,8,1,7496,937,8433
421720,201710,564,406,158,378584.3,146350.54,524934.84
421725,201710,12,6,6,5622,5622,11244
421730,201710,43,30,13,27392.48,12181,39573.48
421740,201710,83,39,44,36543,41228,77771
421750,201710,215,159,56,146767.51,52472,199239.51
421755,201710,25,24,1,22488,937,23425
421760,201710,103,73,30,68391.63,28110,96501.63
421770,201710,550,376,174,350133.89,162973.15,513107.04
421775,201710,25,16,9,14992,8433,23425
421780,201710,185,145,40,135583.9,37480,173063.9
421790,201710,155,129,26,120357.65,24362,144719.65
421795,201710,15,13,2,12181,1874,14055
421800,201710,445,285,160,265325.61,149915.32,415240.93
421810,201710,70,57,13,53409,12181,65590
421820,201710,300,206,94,192057.1,88078,280135.1
421825,201710,128,106,22,99322,20614,119936
421830,201710,131,99,32,92763,29984,122747
421835,201710,3,3,0,2811,0,2811
421840,201710,60,50,10,46841,9370,56211
421850,201710,80,71,9,66527,8429,74956
421860,201710,42,32,10,29702.9,9370,39072.9
421870,201710,974,736,238,680792.9,222140.59,902933.49
421875,201710,51,45,6,42165,5622,47787
421880,201710,162,117,45,109629,41884,151513
421885,201710,28,23,5,21551,4408,25959
421890,201710,113,78,35,73086,32795,105881
421895,201710,41,38,3,35606,2811,38417
421900,201710,154,124,30,116114.15,28065,144179.15
421910,201710,64,42,22,39354,20614,59968
421915,201710,31,25,6,23425,5622,29047
421917,201710,39,27,12,25018,11244,36262
421920,201710,31,28,3,26236,2811,29047
421930,201710,757,585,172,546449.03,161127.63,707576.66
421935,201710,57,50,7,46850,6559,53409
421940,201710,41,38,3,35606,2811,38417
421950,201710,822,540,282,500025.57,261665.24,761690.81
421960,201710,40,35,5,32514,4685,37199
421970,201710,376,237,139,221579.12,130192.01,351771.13
421985,201710,29,19,10,17803,9370,27173
422000,201710,0,0,0,0,0,0
430003,201710,208,48,160,44273.25,149920,194193.25
430005,201710,35,27,8,25299,7496,32795
430010,201710,277,195,82,182246.5,76834,259080.5
430020,201710,154,100,54,93419,49661,143080
430030,201710,126,98,28,91826,26236,118062
430040,201710,2986,1732,1254,1615109.19,1173405.94,2788515.13
430045,201710,66,56,10,52191,9370,61561
430047,201710,7,6,1,5622,937,6559
430050,201710,80,67,13,62779,12181,74960
430055,201710,17,14,3,13118,2811,15929
430057,201710,4,2,2,1874,1874,3748
430060,201710,3705,2194,1511,2048008.21,1412027.16,3460035.37
430063,201710,56,50,6,46850,5622,52472
430064,201710,147,124,23,116188,21551,137739
430066,201710,10,7,3,6559,2811,9370
430070,201710,49,37,12,34669,11244,45913
430080,201710,68,48,20,44288.8,18740,63028.8
430085,201710,36,11,25,10307,23425,33732
430087,201710,40,29,11,27033,10307,37340
430090,201710,71,64,7,59686.9,6559,66245.9
430100,201710,114,77,37,71212,34669,105881
430105,201710,142,72,70,67464,65290.16,132754.16
430107,201710,20,14,6,13118,5622,18740
430110,201710,412,236,176,220335.55,164846.41,385181.96
430120,201710,137,125,12,116188.95,11244,127432.95
430130,201710,780,490,290,458520.95,271448.9,729969.85
430140,201710,127,116,11,108692,10307,118999
430150,201710,110,73,37,67652,33732,101384
430155,201710,33,30,3,28110,2811,30921
430160,201710,3796,2243,1553,2082578.5,1451160.11,3533738.61
430163,201710,324,140,184,130056.57,172351.78,302408.35
430165,201710,22,16,6,14992,5622,20614
430170,201710,81,73,8,68401,7496,75897
430175,201710,82,63,19,59031,17147.1,76178.1
430180,201710,91,72,19,67464,17193.95,84657.95
430185,201710,31,23,8,21551,7496,29047
430187,201710,105,44,61,41228,56857.9,98085.9
430190,201710,221,128,93,119889.15,86475.73,206364.88
430192,201710,14,14,0,13118,0,13118
430195,201710,13,8,5,7496,4685,12181
430200,201710,163,143,20,133335.1,18740,152075.1
430205,201710,19,18,1,16866,937,17803
430210,201710,614,473,141,439546.7,130852.15,570398.85
430215,201710,17,14,3,13118,2811,15929
430220,201710,61,43,18,40291,16866,57157
430222,201710,14,7,7,6559,6559,13118
430223,201710,14,8,6,7496,5622,13118
430225,201710,4,3,1,2811,937,3748
430230,201710,293,181,112,168660,104944,273604
430235,201710,48,35,13,32795,12171.63,44966.63
430237,201710,29,22,7,20614,6559,27173
430240,201710,130,79,51,74023,47777.63,121800.63
430245,201710,68,57,11,53409,10307,63716
430250,201710,196,114,82,106808.63,76824.63,183633.26
430258,201710,14,12,2,11244,1874,13118
430260,201710,37,32,5,29984,3879.18,33863.18
430265,201710,36,29,7,27154.26,6559,33713.26
430270,201710,577,425,152,394617.37,141581.81,536199.18
430280,201710,1021,637,384,593205.93,357353.8,950559.73
430290,201710,371,215,156,199581.4,146172,345753.4
430300,201710,2090,1145,945,1067179.86,882468.67,1949648.53
430310,201710,1992,1046,946,972620,884261.62,1856881.62
430320,201710,50,42,8,39339.95,7496,46835.95
430330,201710,98,89,9,82924.5,8433,91357.5
430340,201710,67,59,8,55283,7496,62779
430350,201710,1650,1150,500,1066279.49,466776.66,1533056.15
430355,201710,25,22,3,20614,2811,23425
430360,201710,82,39,43,36543,39073,75616
430367,201710,30,20,10,18740,8592.29,27332.29
430370,201710,55,49,6,45913,5622,51535
430380,201710,127,94,33,87515.8,30921,118436.8
430390,201710,606,377,229,352967.9,214273.63,567241.53
430400,201710,133,103,30,94824.4,28091.26,122915.66
430410,201710,56,45,11,42165,10307,52472
430420,201710,488,322,166,299173.3,153322.58,452495.88
430430,201710,54,52,2,48099.95,1874,49973.95
430435,201710,155,115,40,106818,36777.25,143595.25
430440,201710,508,337,171,315769,160039.6,475808.6
430450,201710,1170,964,206,895867.27,193012.63,1088879.90
430460,201710,5143,2804,2339,2610540.09,2186082.12,4796622.21
430461,201710,17,15,2,14055,1874,15929
430462,201710,12,7,5,6559,4685,11244
430463,201710,1011,531,480,494877.39,449414.05,944291.44
430465,201710,30,18,12,16866,11244,28110
430466,201710,655,467,188,435705.1,175968.6,611673.7
430467,201710,99,58,41,54346,38407.63,92753.63
430468,201710,111,68,43,63716,40044.39,103760.39
430469,201710,23,17,6,15929,5622,21551
430470,201710,1165,645,520,596498.37,485319.15,1081817.52
430471,201710,48,36,12,33713.26,11244,44957.26
430480,201710,95,59,36,54439.7,33722.63,88162.33
430485,201710,5,5,0,4404,0,4404
430490,201710,94,75,19,69478.35,17803,87281.35
430495,201710,35,28,7,26236,6559,32795
430500,201710,197,134,63,124855.25,58661.63,183516.88
430510,201710,3028,2018,1010,1885273.25,945498.96,2830772.21
430511,201710,18,18,0,16866,0,16866
430512,201710,133,89,44,83393,41228,124621
430513,201710,51,46,5,42633.5,4685,47318.5
430515,201710,31,29,2,27173,1874,29047
430517,201710,170,150,20,139613.25,18721.26,158334.51
430520,201710,365,249,116,232658,108663.89,341321.89
430530,201710,88,50,38,46850,35606,82456
430535,201710,472,312,160,292147.92,149896.58,442044.50
430537,201710,12,12,0,11244,0,11244
430540,201710,73,46,27,43102,25299,68401
430543,201710,368,113,255,105881,238935,344816
430544,201710,43,39,4,36543,3748,40291
430545,201710,344,158,186,147981.15,173794.76,321775.91
430550,201710,45,37,8,34669,7496,42165
430558,201710,6,4,2,3748,1874,5622
430560,201710,47,20,27,18740,25299,44039
430570,201710,105,46,59,43102,55226.78,98328.78
430580,201710,124,97,27,90889,25252.15,116141.15
430583,201710,14,14,0,13118,0,13118
430585,201710,9,4,5,3748,4685,8433
430587,201710,14,8,6,7496,5622,13118
430590,201710,151,126,25,116843.9,23425,140268.9
430593,201710,4,4,0,3748,0,3748
430595,201710,15,10,5,9370,4685,14055
430597,201710,51,27,24,25299,22488,47787
430600,201710,216,146,70,136792.63,65308.9,202101.53
430605,201710,153,95,58,89015,54336.63,143351.63
430607,201710,26,21,5,19677,4685,24362
430610,201710,1624,755,869,703031.95,809062.49,1512094.44
430613,201710,2,2,0,1874,0,1874
430620,201710,113,81,32,75757,29974.63,105731.63
430630,201710,49,43,6,40291,5622,45913
430632,201710,33,28,5,26236,4685,30921
430635,201710,40,36,4,33732,3748,37480
430637,201710,54,30,24,28110,22488,50598
430640,201710,216,119,97,110659.7,90889,201548.7
430642,201710,27,25,2,23425,1874,25299
430645,201710,32,28,4,26236,3748,29984
430650,201710,252,200,52,187119,48677.15,235796.15
430655,201710,5,5,0,4685,0,4685
430660,201710,959,461,498,430410.95,465126.9,895537.85
430670,201710,70,50,20,46850,18740,65590
430673,201710,74,42,32,39354,29984,69338
430675,201710,13,10,3,9370,2811,12181
430676,201710,471,283,188,264477.62,176085.84,440563.46
430680,201710,247,172,75,159009,70275,229284
430690,201710,521,313,208,292390.85,193250.27,485641.12
430692,201710,7,5,2,4685,1874,6559
430693,201710,135,89,46,83393,42483.58,125876.58
430695,201710,75,68,7,62797.74,6559,69356.74
430697,201710,63,37,26,34669,24362,59031
430700,201710,1583,1108,475,1027112.05,445075,1472187.05
430705,201710,19,18,1,16866,937,17803
430710,201710,257,165,92,154605,86204,240809
430720,201710,111,94,17,87890.6,15929,103819.6
430730,201710,119,102,17,94637,15929,110566
430740,201710,60,41,19,38417,17803,56220
430745,201710,39,31,8,28766,7496,36262
430750,201710,335,230,105,214587.72,97448,312035.72
430755,201710,79,44,35,41228,32795,74023
430760,201710,358,217,141,200097.11,132089.26,332186.37
430770,201710,1476,763,713,712850.96,663722.3,1376573.26
430780,201710,317,203,114,189902.16,106752.78,296654.94
430781,201710,29,24,5,22488,4685,27173
430783,201710,49,39,10,36230.8,9370,45600.8
430786,201710,6,3,3,2811,2811,5622
430790,201710,474,306,168,284941.7,157125.63,442067.33
430800,201710,152,127,25,118999,23425,142424
430805,201710,41,37,4,34669,3748,38417
430807,201710,34,22,12,20614,11244,31858
430810,201710,72,45,27,42165,25299,67464
430820,201710,131,79,52,74023,48068.1,122091.1
430825,201710,11,9,2,8433,1874,10307
430830,201710,233,218,15,203985,14055,218040
430840,201710,120,79,41,74023,37761.1,111784.1
430843,201710,5,3,2,2811,1874,4685
430845,201710,69,39,30,36543,28110,64653
430850,201710,573,394,179,367965.16,167584.67,535549.83
430860,201710,153,97,56,90233.1,51806.73,142039.83
430865,201710,64,32,32,29328.1,29674.79,59002.89
430870,201710,77,62,15,58094,14055,72149
430880,201710,158,120,38,112421.26,35606,148027.26
430885,201710,7,6,1,5622,937,6559
430890,201710,337,204,133,189517.94,124621,314138.94
430900,201710,540,371,169,343504.7,157875.13,501379.83
430905,201710,81,33,48,30921,44976,75897
430910,201710,270,150,120,140550,110839,251389
430912,201710,3,3,0,2811,0,2811
430915,201710,32,24,8,22488,7214.9,29702.9
430920,201710,4123,2306,1817,2154846.7,1700471.31,3855318.01
430925,201710,6,5,1,4441.38,937,5378.38
430930,201710,2073,1233,840,1146759.51,785837.07,1932596.58
430940,201710,241,152,89,141758.73,83374.26,225132.99
430950,201710,161,130,31,121810,28765.9,150575.9
430955,201710,21,13,8,12181,7496,19677
430957,201710,17,16,1,14992,937,15929
430960,201710,246,162,84,150060.55,78708,228768.55
430965,201710,102,63,39,59031,36543,95574
430970,201710,78,66,12,61842,10307,72149
430975,201710,37,35,2,32795,1874,34669
430980,201710,42,25,17,23425,15929,39354
430990,201710,113,87,26,81519,24362,105881
430995,201710,115,111,4,102788.9,3748,106536.9
431000,201710,295,137,158,126256.1,148046,274302.1
431010,201710,340,205,135,191119.89,126495,317614.89
431020,201710,1924,1107,817,1030141.95,762427.53,1792569.48
431030,201710,42,34,8,31858,7496,39354
431033,201710,379,190,189,177233.6,177093,354326.6
431036,201710,15,10,5,9370,4685,14055
431040,201710,136,81,55,74960,51427.25,126387.25
431041,201710,37,25,12,23425,11244,34669
431043,201710,44,25,19,23425,17803,41228
431046,201710,12,7,5,6559,4685,11244
431050,201710,209,132,77,121321.17,70702.62,192023.79
431053,201710,72,44,28,40478.4,26236,66714.4
431055,201710,62,41,21,38417,19658.26,58075.26
431057,201710,18,18,0,16866,0,16866
431060,201710,1685,1059,626,985182.19,584825.65,1570007.84
431065,201710,16,10,6,9370,5622,14992
431070,201710,72,67,5,62779,4685,67464
431075,201710,8,8,0,7496,0,7496
431080,201710,137,89,48,83111.9,44976,128087.9
431085,201710,29,26,3,24362,2811,27173
431087,201710,15,13,2,12181,1874,14055
431090,201710,57,45,12,42165,11244,53409
431100,201710,1225,734,491,679326.16,460067,1139393.16
431110,201710,244,150,94,140550,88068.63,228618.63
431112,201710,29,18,11,16866,10307,27173
431113,201710,29,19,10,17803,9370,27173
431115,201710,155,105,50,97760.2,46840.63,144600.83
431120,201710,616,365,251,340094.42,235113.52,575207.94
431123,201710,3,2,1,1874,937,2811
431125,201710,90,80,10,74960,9370,84330
431127,201710,7,3,4,2811,3748,6559
431130,201710,613,400,213,373581.9,199281.16,572863.06
431140,201710,715,483,232,448588.8,217309.04,665897.84
431142,201710,32,25,7,22235,6559,28794
431150,201710,207,152,55,142424,51516.26,193940.26
431160,201710,57,51,6,47787,5622,53409
431162,201710,20,14,6,13118,5622,18740
431164,201710,4,4,0,3748,0,3748
431170,201710,103,85,18,79645,16866,96511
431171,201710,51,28,23,26236,21541.63,47777.63
431173,201710,1,1,0,937,0,937
431175,201710,200,96,104,88734,97438.63,186172.63
431177,201710,73,55,18,51535,16192.26,67727.26
431179,201710,13,11,2,10307,1874,12181
431180,201710,434,261,173,244557,162082.63,406639.63
431190,201710,89,68,21,63716,19677,83393
431198,201710,70,45,25,42165,23425,65590
431200,201710,18,16,2,14992,1874,16866
431205,201710,24,24,0,22488,0,22488
431210,201710,86,53,33,49334,30921,80255
431213,201710,25,20,5,18740,4685,23425
431215,201710,26,23,3,21551,2811,24362
431217,201710,7,6,1,5622,937,6559
431220,201710,66,58,8,54346,7496,61842
431225,201710,151,101,50,94628,46840.63,141468.63
431230,201710,100,86,14,79926.1,13118,93044.1
431235,201710,7,7,0,6559,0,6559
431237,201710,25,17,8,15929,7496,23425
431238,201710,15,11,4,10026,3748,13774
431240,201710,984,634,350,592428.42,327444.02,919872.44
431242,201710,35,35,0,32795,0,32795
431244,201710,10,7,3,6559,2811,9370
431245,201710,60,45,15,42165,14055,56220
431247,201710,14,10,4,9370,3748,13118
431250,201710,270,140,130,131114.41,121127.26,252241.67
431260,201710,61,44,17,41228,15929,57157
431261,201710,22,15,7,14055,6559,20614
431262,201710,16,16,0,14992,0,14992
431265,201710,166,86,80,80582,74960,155542
431267,201710,15,14,1,13118,937,14055
431270,201710,316,262,54,245494,50598,296092
431275,201710,41,39,2,36543,1874,38417
431280,201710,22,17,5,15109.12,4685,19794.12
431290,201710,22,19,3,17803,2811,20614
431295,201710,5,5,0,4685,0,4685
431300,201710,22,19,3,17803,2811,20614
431301,201710,7,7,0,6559,0,6559
431303,201710,49,33,16,30799.19,14710.9,45510.09
431306,201710,222,117,105,109181.11,98385,207566.11
431308,201710,6,5,1,4685,937,5622
431310,201710,62,53,9,49661,8433,58094
431320,201710,122,73,49,68401,45622.53,114023.53
431330,201710,174,116,58,108692,54346,163038
431333,201710,33,27,6,25299,5622,30921
431335,201710,10,5,5,4685,4685,9370
431337,201710,318,152,166,141610.1,154284.14,295894.24
431339,201710,18,15,3,14055,2811,16866
431340,201710,3023,1726,1297,1612955.6,1213303.15,2826258.75
431342,201710,46,29,17,27173,15929,43102
431344,201710,18,17,1,15929,937,16866
431346,201710,3,3,0,2811,0,2811
431349,201710,37,34,3,31858,2811,34669
431350,201710,908,536,372,497764.73,347589.52,845354.25
431360,201710,44,38,6,35606,5622,41228
431365,201710,317,149,168,139594.26,156188.53,295782.79
431370,201710,1313,787,526,734103.08,492677.19,1226780.27
431380,201710,100,84,16,78052.1,14992,93044.1
431390,201710,492,273,219,254864.1,204295.01,459159.11
431395,201710,273,117,156,109629,146154,255783
431400,201710,37,29,8,27173,7496,34669
431402,201710,93,65,28,60905,26236,87141
431403,201710,14,9,5,8433,4685,13118
431405,201710,649,351,298,327790.81,279199,606989.81
431406,201710,30,26,4,24362,3748,28110
431407,201710,50,43,7,40291,6559,46850
431410,201710,3189,1899,1290,1765962.77,1207762.52,2973725.29
431413,201710,15,13,2,12181,1874,14055
431415,201710,71,52,19,48724,17803,66527
431417,201710,23,12,11,11244,10307,21551
431420,201710,295,209,86,195189.56,80572.63,275762.19
431430,201710,40,15,25,14055,23425,37480
431440,201710,8849,6302,2547,5840297.83,2378876.23,8219174.06
431442,201710,28,15,13,14055,12181,26236
431445,201710,26,20,6,18740,5622,24362
431446,201710,7,6,1,5622,937,6559
431447,201710,85,59,26,55283,24362,79645
431449,201710,48,45,3,42165,2811,44976
431450,201710,414,290,124,269996.55,115485.25,385481.80
431454,201710,0,0,0,0,0,0
431455,201710,48,36,12,33732,11244,44976
431460,201710,521,358,163,331885.4,152309.9,484195.3
431470,201710,119,93,26,86461.86,24362,110823.86
431475,201710,11,10,1,9370,937,10307
431477,201710,35,25,10,23425,9370,32795
431478,201710,7,6,1,5622,937,6559
431480,201710,492,311,181,289824.41,169550.15,459374.56
431490,201710,28156,15956,12200,14878259.04,11398012.64,26276271.68
431500,201710,78,54,24,50598,22488,73086
431505,201710,47,20,27,18740,25299,44039
431507,201710,11,9,2,8433,1874,10307
431510,201710,279,177,102,165146.9,93681.26,258828.16
431513,201710,24,18,6,16866,5622,22488
431514,201710,8,7,1,6559,937,7496
431515,201710,76,65,11,60905,10307,71212
431517,201710,3,1,2,937,1874,2811
431520,201710,35,32,3,29984,2811,32795
431530,201710,1618,718,900,671638.96,842845.67,1514484.63
431531,201710,21,19,2,17803,1874,19677
431532,201710,24,17,7,15929,6559,22488
431535,201710,25,16,9,14992,8433,23425
431540,201710,140,126,14,116216.11,13118,129334.11
431545,201710,19,17,2,15929,1874,17803
431550,201710,338,199,139,186463,130149.3,316612.3
431555,201710,12,11,1,10307,937,11244
431560,201710,4362,3085,1277,2862484.58,1194057.68,4056542.26
431570,201710,763,404,359,375456.1,333544.89,709000.99
431575,201710,37,26,11,24362,10307,34669
431580,201710,98,69,29,63716,27173,90889
431590,201710,136,114,22,105881,20614,126495
431595,201710,12,11,1,10307,937,11244
431600,201710,216,122,94,114314,88078,202392
431610,201710,127,92,35,85548.1,32795,118343.1
431620,201710,42,34,8,31858,7496,39354
431630,201710,130,112,18,104944,16866,121810
431640,201710,1315,827,488,769559.1,455420.22,1224979.32
431642,201710,41,37,4,34200.5,3748,37948.5
431643,201710,47,21,26,19677,24362,44039
431645,201710,303,174,129,163038,119936,282974
431647,201710,11,11,0,10307,0,10307
431650,201710,34,24,10,22488,9370,31858
431660,201710,273,176,97,162757.35,90889,253646.35
431670,201710,215,104,111,94871.25,103978.89,198850.14
431673,201710,3,3,0,2811,0,2811
431675,201710,28,24,4,22206.9,3748,25954.9
431680,201710,1084,776,308,723364,287378.64,1010742.64
431690,201710,4752,2900,1852,2698958.61,1730547.65,4429506.26
431695,201710,26,20,6,18740,5622,24362
431697,201710,0,0,0,0,0,0
431700,201710,168,127,41,118999,38417,157416
431710,201710,3981,1710,2271,1600574.5,2126507.82,3727082.32
431720,201710,1410,837,573,776810.36,535950.63,1312760.99
431725,201710,1,1,0,937,0,937
431730,201710,1184,794,390,736979,365430,1102409
431740,201710,1367,677,690,629814.66,645979.12,1275793.78
431750,201710,1875,1210,665,1123675.66,620547.36,1744223.02
431755,201710,5,4,1,3748,937,4685
431760,201710,1098,699,399,654588.2,373638.49,1028226.69
431770,201710,387,283,104,265161.63,97429.26,362590.89
431775,201710,27,21,6,19677,5622,25299
431780,201710,558,344,214,321231.71,200508.63,521740.34
431790,201710,153,114,39,105881,36496.15,142377.15
431795,201710,14,12,2,11244,1874,13118
431800,201710,3388,1771,1617,1647645.08,1508251.59,3155896.67
431805,201710,17,15,2,14055,1874,15929
431810,201710,620,417,203,388142.88,190080.19,578223.07
431820,201710,314,175,139,163975,129259.15,293234.15
431830,201710,2323,1409,914,1316878.05,855198.44,2172076.49
431840,201710,505,334,171,309398.7,159009,468407.7
431842,201710,34,28,6,26236,5622,31858
431843,201710,11,7,4,6559,3748,10307
431844,201710,13,11,2,10307,1874,12181
431845,201710,28,26,2,24362,1874,26236
431846,201710,29,25,4,23425,3748,27173
431848,201710,14,12,2,11244,1874,13118
431849,201710,8,6,2,5622,1874,7496
431850,201710,796,659,137,615716.11,127853.65,743569.76
431860,201710,99,72,27,67464,24362,91826
431861,201710,4,2,2,1874,1874,3748
431862,201710,49,33,16,30921,14992,45913
431870,201710,3454,2033,1421,1896718.52,1330205.75,3226924.27
431880,201710,925,677,248,629636,231439,861075
431890,201710,1306,807,499,750650.37,465985,1216635.37
431900,201710,181,127,54,118999,50598,169597
431910,201710,55,41,14,38417,13118,51535
431912,201710,34,19,15,17803,14055,31858
431915,201710,123,99,24,92763,22488,115251
431920,201710,144,107,37,99977.9,34669,134646.9
431930,201710,87,69,18,64653,16866,81519
431935,201710,4,3,1,2811,937,3748
431936,201710,12,11,1,10307,937,11244
431937,201710,16,11,5,10307,4685,14992
431940,201710,444,294,150,272760.7,140540.63,413301.33
431950,201710,458,296,162,276134.64,151682.3,427816.94
431960,201710,706,421,285,390356.31,266886.45,657242.76
431970,201710,73,65,8,60905,7496,68401
431971,201710,4,4,0,3748,0,3748
431973,201710,19,16,3,14992,2811,17803
431975,201710,6,5,1,4685,937,5622
431980,201710,200,126,74,116562.8,69338,185900.8
431990,201710,1228,655,573,612006.99,536864,1148870.99
432000,201710,1676,898,778,834789.07,726142.12,1560931.19
432010,201710,275,184,91,171315.3,85267,256582.3
432020,201710,172,135,37,126495,34659.63,161154.63
432023,201710,21,17,4,15929,3748,19677
432026,201710,66,59,7,55283,6559,61842
432030,201710,60,30,30,28110,28110,56220
432032,201710,22,19,3,17803,2811,20614
432035,201710,47,38,9,35606,8433,44039
432040,201710,97,67,30,62779,28110,90889
432045,201710,8,7,1,6277.9,937,7214.9
432050,201710,70,42,28,39354,26236,65590
432055,201710,102,78,24,73067.26,22488,95555.26
432057,201710,1,0,1,0,937,937
432060,201710,38,35,3,32092.25,2811,34903.25
432065,201710,33,30,3,28091.26,2811,30902.26
432067,201710,90,79,11,74004.26,10307,84311.26
432070,201710,402,303,99,282338.29,92735.26,375073.55
432080,201710,799,553,246,516511.88,230455.89,746967.77
432085,201710,15,11,4,10307,3748,14055
432090,201710,269,174,95,163038,89015,252053
432100,201710,172,114,58,106536.9,54346,160882.9
432110,201710,594,404,190,371867.66,177093,548960.66
432120,201710,972,578,394,540930.1,369140.52,910070.62
432130,201710,495,355,140,331323.2,131039.45,462362.65
432132,201710,26,23,3,21551,2811,24362
432135,201710,78,66,12,61842,11244,73086
432140,201710,270,212,58,198083.01,54346,252429.01
432143,201710,181,114,67,106818,62779,169597
432145,201710,265,181,84,167536.5,78426.9,245963.4
432146,201710,15,14,1,13118,937,14055
432147,201710,144,61,83,57157,77761.63,134918.63
432149,201710,18,13,5,12181,4685,16866
432150,201710,831,523,308,488879.75,285894.15,774773.90
432160,201710,1394,722,672,674257.2,628793.56,1303050.76
432162,201710,4,3,1,2811,937,3748
432163,201710,18,14,4,13118,3748,16866
432166,201710,123,93,30,87376,28110,115486
432170,201710,225,123,102,114314.9,95574,209888.9
432180,201710,525,315,210,292063.99,196489,488552.99
432183,201710,8,6,2,5622,1874,7496
432185,201710,82,70,12,65496.3,11244,76740.3
432190,201710,475,257,218,239666.63,204126.19,443792.82
432195,201710,84,72,12,66761.25,11244,78005.25
432200,201710,404,259,145,242683,135772.52,378455.52
432210,201710,114,74,40,67323.45,37480,104803.45
432215,201710,62,59,3,55283,2811,58094
432218,201710,19,18,1,16866,937,17803
432220,201710,673,339,334,316642.42,312458.97,629101.39
432225,201710,16,10,6,8901.5,5622,14523.5
432230,201710,154,88,66,82221.75,61842,144063.75
432232,201710,15,13,2,12181,1874,14055
432234,201710,5,4,1,3748,937,4685
432235,201710,1,1,0,937,0,937
432237,201710,29,17,12,15929,11244,27173
432240,201710,4165,2320,1845,2164565.98,1721031.03,3885597.01
432250,201710,1006,635,371,592138.28,347467.71,939605.99
432252,201710,38,31,7,28316.14,6559,34875.14
432253,201710,59,47,12,44039,11244,55283
432254,201710,21,9,12,8433,11244,19677
432255,201710,14,13,1,12181,937,13118
432260,201710,843,661,182,618335.77,169597.75,787933.52
432270,201710,219,161,58,150857,54346,205203
432280,201710,119,85,34,79176.9,31858,111034.9
432285,201710,2,1,1,937,937,1874
432290,201710,68,62,6,56501.1,5622,62123.1
432300,201710,4656,2658,1998,2477717.25,1867943.08,4345660.33
432310,201710,117,93,24,87141,22488,109629
432320,201710,19,14,5,13118,4685,17803
432330,201710,13,8,5,7496,4685,12181
432335,201710,8,7,1,6559,937,7496
432340,201710,41,37,4,34669,3748,38417
432345,201710,87,63,24,59031,22488,81519
432350,201710,23,22,1,20614,937,21551
432360,201710,7,5,2,4685,1874,6559
432370,201710,24,24,0,22206.9,0,22206.9
432375,201710,42,36,6,33732,5622,39354
432377,201710,7,7,0,6559,0,6559
432380,201710,167,72,95,66808.1,88968.15,155776.25
500020,201710,244,131,113,122747,105290.69,228037.69
500025,201710,117,57,60,52472,56220,108692
500060,201710,1378,838,540,784643.8,505385.21,1290029.01
500070,201710,742,349,393,327013,367986.63,694999.63
500080,201710,133,101,32,94637,29984,124621
500085,201710,144,117,27,109348,24479.13,133827.13
500090,201710,332,158,174,148046,163038,311084
500100,201710,701,371,330,344909.9,308648,653557.9
500110,201710,2240,989,1251,926384.63,1170720.3,2097104.93
500124,201710,312,178,134,166786,125276.9,292062.9
500150,201710,328,128,200,119927,187046,306973
500190,201710,523,357,166,333834.36,155061,488895.36
500200,201710,204,172,32,160827,29984,190811
500210,201710,1441,522,919,487863.48,860041.47,1347904.95
500215,201710,240,138,102,128365.21,95574,223939.21
500220,201710,784,511,273,478566.52,255057.63,733624.15
500230,201710,257,179,78,167020.25,72617.5,239637.75
500240,201710,714,495,219,463065.4,204734.9,667800.3
500260,201710,565,207,358,193959,335446,529405
500270,201710,28265,11979,16286,11196265.84,15244780.66,26441046.50
500280,201710,193,74,119,69338,111503,180841
500290,201710,1187,689,498,644657,466617,1111274
500295,201710,396,239,157,223943,147099.63,371042.63
500310,201710,65,19,46,17803,43102,60905
500315,201710,700,414,286,387908.63,267691.53,655600.16
500320,201710,3646,1808,1838,1691703.39,1720587.74,3412291.13
500325,201710,950,521,429,487709,401015.32,888724.32
500330,201710,1500,686,814,639944.86,762105.43,1402050.29
500345,201710,318,232,86,216438.1,80582,297020.1
500348,201710,243,142,101,133054,94618.63,227672.63
500350,201710,146,71,75,66527,70275,136802
500370,201710,5445,2426,3019,2266091.14,2825849.16,5091940.30
500375,201710,351,253,98,237051.63,91826,328877.63
500380,201710,576,329,247,308118.4,231420.63,539539.03
500390,201710,70,36,34,33732,31858,65590
500400,201710,213,144,69,134909.26,64644,199553.26
500410,201710,570,221,349,207031.58,326867.42,533899.00
500430,201710,533,371,162,347627,151794,499421
500440,201710,207,107,100,99498.42,93513,193011.42
500450,201710,410,174,236,162349.8,220315.34,382665.14
500460,201710,317,158,159,148036.63,148983,297019.63
500470,201710,436,344,92,321135.05,85258,406393.05
500480,201710,113,68,45,63716,42165,105881
500490,201710,105,40,65,37475.32,60905,98380.32
500500,201710,1444,491,953,458268.8,892083.9,1350352.7
500510,201710,48,37,11,34669,10298,44967
500515,201710,110,76,34,71212,31577,102789
500520,201710,353,199,154,185433,144294,329727
500525,201710,89,51,38,47787,35324.9,83111.9
500540,201710,905,372,533,348498.78,498429.03,846927.81
500560,201710,898,502,396,468656.66,370378.83,839035.49
500568,201710,977,570,407,530342.1,381073.32,911415.42
500570,201710,1216,687,529,641517.09,493243.92,1134761.01
500580,201710,337,173,164,161810.53,153655,315465.53
500600,201710,321,164,157,152969.93,147091,300060.93
500620,201710,890,628,262,582762.61,245297.23,828059.84
500625,201710,79,66,13,61147.78,12181,73328.78
500627,201710,21,9,12,8433,11244,19677
500630,201710,1581,833,748,779584.9,700403.22,1479988.12
500635,201710,511,287,224,268506.72,209747.45,478254.17
500640,201710,427,222,205,205485.5,192066.63,397552.13
500660,201710,5511,2099,3412,1964046.8,3193661.73,5157708.53
500690,201710,575,204,371,190805.39,346872.6,537677.99
500710,201710,355,173,182,161820,170243.9,332063.9
500720,201710,966,564,402,527058.32,376468.26,903526.58
500730,201710,189,110,79,103070,73737.22,176807.22
500740,201710,849,372,477,347286.82,446219,793505.82
500750,201710,136,43,93,40291,87113.26,127404.26
500755,201710,125,90,35,84049,32795,116844
500769,201710,742,416,326,389471.02,305449,694920.02
500770,201710,454,235,219,220185.63,204959.38,425145.01
500780,201710,170,115,55,107755,51535,159290
500790,201710,1038,512,526,479177.32,492540.63,971717.95
500793,201710,251,133,118,124621,110557,235178
500795,201710,176,126,50,118052.63,46841,164893.63
500797,201710,40,33,7,30921,6559,37480
500800,201710,413,180,233,168651,218039.9,386690.9
500830,201710,2168,1207,961,1127838.56,899482.52,2027321.08
500840,201710,144,107,37,100259,34660,134919
510010,201710,167,91,76,85257.63,71212,156469.63
510020,201710,480,223,257,208668.67,240268.38,448937.05
510025,201710,1645,934,711,874312.4,663514.94,1537827.34
510030,201710,616,314,302,294172.26,282223.32,576395.58
510035,201710,128,56,72,52444.63,67445.63,119890.26
510040,201710,383,168,215,157416,201015.53,358431.53
510050,201710,424,227,197,211971.1,183769.89,395740.99
510060,201710,109,52,57,48714.63,53399.63,102114.26
510080,201710,221,87,134,81486.95,125455.3,206942.25
510100,201710,75,34,41,31858,38398.26,70256.26
510120,201710,35,21,14,19677,13118,32795
510125,201710,406,247,159,230769.05,148960.26,379729.31
510130,201710,592,346,246,323828.92,230083.68,553912.60
510140,201710,389,129,260,120864,243615.32,364479.32
510160,201710,89,42,47,39354,44035,83389
510170,201710,848,521,327,487913.66,305784.65,793698.31
510180,201710,2866,1394,1472,1303184.53,1377273.39,2680457.92
510185,201710,11,6,5,5622,4685,10307
510190,201710,216,74,142,69338,133049.32,202387.32
510250,201710,2631,1534,1097,1436335.22,1026803.66,2463138.88
510260,201710,199,142,57,132872.52,53372.63,186245.15
510263,201710,449,247,202,229997.04,188531.89,418528.93
510267,201710,641,355,286,332452.78,267704.73,600157.51
510268,201710,54,30,24,28110,22488,50598
510269,201710,70,29,41,27164,38417,65581
510270,201710,405,209,196,195657.19,183241.94,378899.13
510279,201710,224,162,62,151766.63,58075.26,209841.89
510285,201710,171,75,96,70256.63,89952,160208.63
510300,201710,554,298,256,278786.48,239798.53,518585.01
510305,201710,217,98,119,91803.63,111401.04,203204.67
510310,201710,116,56,60,52472,56210.63,108682.63
510320,201710,857,531,326,496978.42,305041.26,802019.68
510325,201710,411,165,246,154595.63,230211.53,384807.16
510330,201710,417,233,184,218308,172389.26,390697.26
510335,201710,610,323,287,302604.89,268256.32,570861.21
510336,201710,51,36,15,33732,14055,47787
510337,201710,123,47,76,44029.63,71202.63,115232.26
510340,201710,17463,8399,9064,7845855.72,8482178.8,16328034.52
510343,201710,71,49,22,45903.63,20614,66517.63
510345,201710,163,107,56,100249.63,52181.63,152431.26
510350,201710,652,369,283,344547.74,265106.89,609654.63
510360,201710,207,121,86,113368,80490.89,193858.89
510370,201710,135,70,65,65571.26,60775.3,126346.56
510380,201710,94,64,30,59968,28101,88069
510385,201710,58,26,32,24362,29975,54337
510390,201710,126,50,76,46850,71165.15,118015.15
510395,201710,41,28,13,26236,12181,38417
510410,201710,701,462,239,432870,223919.95,656789.95
510420,201710,588,284,304,265168.66,283377.68,548546.34
510450,201710,52,32,20,29984,18740,48724
510452,201710,37,22,15,20614,14055,34669
510454,201710,68,28,40,26236,37470.63,63706.63
510455,201710,131,82,49,76815.26,45913,122728.26
510460,201710,181,96,85,89503.53,79607.89,169111.42
510480,201710,729,405,324,378379.05,303221.34,681600.39
510490,201710,361,185,176,172964.53,164380.13,337344.66
510500,201710,253,190,63,178020.63,59031,237051.63
510510,201710,780,446,334,417031.43,312948.63,729980.06
510515,201710,1149,597,552,558847.48,517186.89,1076034.37
510517,201710,254,109,145,101851.9,135841.95,237693.85
510520,201710,232,149,83,139530.52,77466.52,216997.04
510523,201710,93,62,31,58094,29037.63,87131.63
510525,201710,697,398,299,372175.52,280053.15,652228.67
510530,201710,17,12,5,11244,4685,15929
510550,201710,271,117,154,109168.46,144289,253457.46
510558,201710,277,135,142,126480.95,133026.26,259507.21
510560,201710,380,233,147,218321,137721,356042
510562,201710,648,447,201,417541.25,187859.13,605400.38
510590,201710,834,433,401,405683.89,375718.96,781402.85
510600,201710,257,137,120,128346.26,112403.26,240749.52
510610,201710,163,79,84,74004.26,78689.63,152693.89
510615,201710,187,74,113,69319.26,105881,175200.26
510617,201710,16,9,7,8433,6559,14992
510618,201710,120,58,62,54346,57625.5,111971.5
510619,201710,106,73,33,68392,30912,99304
510620,201710,192,108,84,101186.63,78708,179894.63
510621,201710,192,124,68,116169.63,63697.63,179867.26
510622,201710,449,294,155,275386.52,144907.89,420294.41
510623,201710,356,232,124,217347.26,116159.89,333507.15
510624,201710,85,38,47,35597,44039,79636
510625,201710,523,318,205,297483.78,191516.19,488999.97
510626,201710,106,66,40,61842,37480,99322
510627,201710,54,39,15,36543,14055,50598
510628,201710,164,97,67,90843.26,62722.78,153566.04
510629,201710,250,160,90,149920,83383.63,233303.63
510630,201710,451,225,226,210750.78,211430.85,422181.63
510631,201710,10,3,7,2811,6559,9370
510637,201710,340,185,155,173004.79,145089.52,318094.31
510642,201710,970,533,437,499075.79,409328.82,908404.61
510645,201710,0,0,0,0,0,0
510650,201710,1528,1007,521,943396.89,488067.41,1431464.30
510665,201710,83,42,41,39300,38399,77699
510670,201710,66,36,30,33732,28110,61842
510675,201710,1188,714,474,668987,444115.32,1113102.32
510677,201710,370,176,194,163915.15,181349.67,345264.82
510680,201710,107,62,45,58076,42156,100232
510682,201710,201,93,108,86825,101196,188021
510685,201710,54,39,15,36543,14055,50598
510700,201710,626,365,261,341887.26,244406.04,586293.30
510704,201710,1020,552,468,514965.35,436972.54,951937.89
510706,201710,129,61,68,57152.32,63679.26,120831.58
510710,201710,394,261,133,244363.93,124528.04,368891.97
510715,201710,64,47,17,44029.63,15929,59958.63
510718,201710,213,110,103,102977.78,96492.63,199470.41
510719,201710,32,18,14,16866,13118,29984
510720,201710,199,130,69,121801,64371.9,186172.9
510724,201710,86,34,52,31848.63,48691.89,80540.52
510726,201710,49,27,22,25289.63,20596,45885.63
510729,201710,77,36,41,33732,38379.52,72111.52
510730,201710,465,257,208,240791,194748.63,435539.63
510735,201710,110,43,67,40291,62779,103070
510740,201710,28,14,14,13118,13118,26236
510757,201710,19,15,4,14055,3748,17803
510760,201710,6986,3700,3286,3456521.15,3072890.13,6529411.28
510770,201710,735,344,391,322143.15,366176.15,688319.30
510774,201710,14,6,8,5622,7496,13118
510775,201710,114,86,28,80572.63,26226.63,106799.26
510776,201710,30,8,22,7496,20614,28110
510777,201710,187,84,103,78679.89,96482.89,175162.78
510779,201710,53,24,29,22479,27136.26,49615.26
510780,201710,295,162,133,151722.26,124540,276262.26
510785,201710,444,241,203,225751.78,190136.04,415887.82
510787,201710,188,94,94,88064.32,88060.32,176124.64
510788,201710,0,0,0,0,0,0
510790,201710,2356,1224,1132,1144827.7,1058434.9,2203262.6
510792,201710,1064,591,473,553288.15,442791.01,996079.16
510794,201710,110,54,56,50598,52444.26,103042.26
510795,201710,2392,1388,1004,1293698.64,937882.43,2231581.07
510800,201710,178,110,68,103060.63,63707,166767.63
510805,201710,162,115,47,107755,44039,151794
510810,201710,95,38,57,35523.89,53287.56,88811.45
510820,201710,260,123,137,115018.63,128322.89,243341.52
510830,201710,67,40,27,37480,25290,62770
510835,201710,2,1,1,937,937,1874
510840,201710,9149,4587,4562,4284555.59,4266827.45,8551383.04
510850,201710,207,84,123,78698.63,114932.79,193631.42
510860,201710,395,174,221,162853.56,206351.05,369204.61
510880,201710,62,47,15,44020.63,14055,58075.63
510885,201710,70,43,27,40272.63,25270.89,65543.52
510890,201710,72,40,32,37480,29984,67464
510895,201710,187,106,81,99322,75593.63,174915.63
520005,201710,26,18,8,16866,7496,24362
520010,201710,280,124,156,116167.89,146079,262246.89
520013,201710,624,367,257,343842.63,240527.9,584370.53
520015,201710,50,35,15,32795,14055,46850
520017,201710,101,59,42,55002,39354,94356
520020,201710,29,15,14,14055,13118,27173
520025,201710,2010,1091,919,1020955.3,860250.7,1881206.0
520030,201710,795,402,393,375728,366694.95,742422.95
520050,201710,76,50,26,46850,24362,71212
520055,201710,43,29,14,27173,13118,40291
520060,201710,177,113,64,105881,59968,165849
520080,201710,589,405,184,379203.9,172408,551611.9
520082,201710,20,14,6,13118,5622,18740
520085,201710,98,74,24,69338,22488,91826
520090,201710,87,61,26,57157,24362,81519
520110,201710,9057,3915,5142,3662959.01,4814533.8,8477492.81
520120,201710,14,8,6,7299.23,5622,12921.23
520130,201710,751,529,222,495664,208005,703669
520140,201710,11772,6619,5153,6195719.95,4825447.45,11021167.40
520145,201710,43,32,11,29984,10307,40291
520150,201710,188,148,40,138676,37480,176156
520160,201710,33,23,10,21551,9370,30921
520170,201710,230,142,88,133023,82420,215443
520180,201710,112,55,57,51535,53409,104944
520215,201710,212,128,84,119654.9,78426.9,198081.8
520235,201710,68,52,16,48724,14992,63716
520250,201710,137,84,53,78708,49379.9,128087.9
520260,201710,110,71,39,66527,35606,102133
520280,201710,49,35,14,32140,13118,45258
520310,201710,39,26,13,24362,12181,36543
520320,201710,167,104,63,97448,59031,156479
520330,201710,781,411,370,385061.63,346663,731724.63
520340,201710,354,201,153,188337,143342.63,331679.63
520350,201710,519,234,285,219258,266999,486257
520355,201710,93,52,41,48724,38417,87141
520357,201710,26,18,8,16866,7496,24362
520360,201710,0,0,0,0,0,0
520380,201710,145,76,69,71212,64653,135865
520390,201710,294,123,171,114783,160217.63,275000.63
520393,201710,12,9,3,8433,2811,11244
520396,201710,98,59,39,55283,36543,91826
520400,201710,229,133,96,123029.1,89952,212981.1
520410,201710,200,100,100,93691,93691,187382
520420,201710,25,17,8,15929,7496,23425
520425,201710,299,132,167,122748,156011.6,278759.6
520430,201710,451,236,215,220850.9,201400,422250.9
520440,201710,591,387,204,362619,191148,553767
520450,201710,1898,864,1034,808472.63,968213.32,1776685.95
520455,201710,58,39,19,36543,17803,54346
520460,201710,29,15,14,14055,13118,27173
520465,201710,23,20,3,18740,2811,21551
520470,201710,419,258,161,241446.07,150857,392303.07
520480,201710,83,46,37,43102,34615,77717
520485,201710,128,45,83,42165,77490,119655
520490,201710,389,288,101,269675.26,94475.84,364151.10
520495,201710,182,107,75,100259,70275,170534
520500,201710,180,136,44,127432,41228,168660
520505,201710,173,91,82,85262.32,76834,162096.32
520510,201710,1746,856,890,797976.82,831622.8,1629599.62
520520,201710,40,30,10,28110,9370,37480
520530,201710,234,171,63,157877.89,58245.79,216123.68
520540,201710,517,339,178,316359.81,166786,483145.81
520545,201710,158,87,71,81519,66527,148046
520547,201710,50,28,22,26236,20614,46850
520549,201710,1056,499,557,467245,521372,988617
520551,201710,294,154,140,144298,131180,275478
520552,201710,44,26,18,24362,16866,41228
520570,201710,16,8,8,7496,7496,14992
520580,201710,285,170,115,159281,107755,267036
520590,201710,161,95,66,89015,61560.9,150575.9
520620,201710,1129,534,595,499609.14,556662.53,1056271.67
520630,201710,42,25,17,23425,15929,39354
520640,201710,412,235,177,220195,165849,386044
520650,201710,53,39,14,36543,13118,49661
520660,201710,34,19,15,17803,14055,31858
520670,201710,32,27,5,25299,4685,29984
520680,201710,61,40,21,37480,19677,57157
520690,201710,32,10,22,9370,20605,29975
520710,201710,36,32,4,29984,3748,33732
520725,201710,200,126,74,118062,69338,187400
520735,201710,55,41,14,38417,13118,51535
520740,201710,404,195,209,182013.2,195824,377837.2
520750,201710,37,27,10,25299,9370,34669
520753,201710,54,38,16,35606,14992,50598
520760,201710,109,73,36,68401,33732,102133
520780,201710,279,215,64,201455,59968,261423
520790,201710,169,79,90,73741.9,84330,158071.9
520800,201710,3504,1852,1652,1733015.78,1547254.77,3280270.55
520810,201710,165,114,51,106818,46911.79,153729.79
520815,201710,6,5,1,4685,937,5622
520830,201710,137,90,47,84330,43757.9,128087.9
520840,201710,340,221,119,206608.5,111503,318111.5
520850,201710,110,71,39,66518,36393.08,102911.08
520860,201710,1661,1049,612,981517.87,572320.6,1553838.47
520870,201710,30727,15152,15575,14170174.21,14578768.08,28748942.29
520880,201710,1043,584,459,547208,430064.26,977272.26
520890,201710,794,454,340,423796.2,318477.63,742273.83
520910,201710,1023,533,490,495909.31,459130,955039.31
520915,201710,96,75,21,70275,19667.63,89942.63
520920,201710,412,202,210,188711.8,196770,385481.8
520929,201710,22,20,2,18740,1874,20614
520940,201710,75,46,29,43102,27173,70275
520945,201710,22,14,8,13118,7496,20614
520960,201710,49,31,18,29047,16866,45913
520970,201710,324,202,122,188656,114032.9,302688.9
520980,201710,92,68,24,63716,22488,86204
520990,201710,480,320,160,299840,149920,449760
520993,201710,127,62,65,58094,60896,118990
520995,201710,245,136,109,126496,101571,228067
521000,201710,1554,899,655,840677.3,613642,1454319.3
521010,201710,669,303,366,283584.53,342877.15,626461.68
521015,201710,16,9,7,8433,6559,14992
521020,201710,1479,1017,462,952310.95,432538.41,1384849.36
521030,201710,43,30,13,28110,12181,40291
521040,201710,895,549,346,514180,323921,838101
521056,201710,43,29,14,27173,13118,40291
521060,201710,133,83,50,77771,46850,124621
521080,201710,487,356,131,333563,122747,456310
521090,201710,533,322,211,301714,197435.27,499149.27
521100,201710,288,213,75,199572,70275,269847
521120,201710,1039,705,334,658804.8,312668,971472.8
521130,201710,361,256,105,239862.63,97514.8,337377.43
521140,201710,186,107,79,100259,74023,174282
521150,201710,2797,1212,1585,1133715.14,1483894.85,2617609.99
521160,201710,31,17,14,15929,13118,29047
521170,201710,192,113,79,105871.63,74023,179894.63
521180,201710,1112,699,413,653361.53,386279.1,1039640.63
521190,201710,2561,1075,1486,1007256.26,1391324.16,2398580.42
521200,201710,44,33,11,30921,10307,41228
521205,201710,16,11,5,10307,4685,14992
521210,201710,149,84,65,78708,60905,139613
521220,201710,805,543,262,506205.78,245485,751690.78
521225,201710,30,19,11,17803,10307,28110
521230,201710,114,76,38,70930.9,35606,106536.9
521250,201710,6651,3719,2932,3478022.5,2744737.03,6222759.53
521260,201710,18,13,5,12181,4685,16866
521270,201710,150,115,35,107755,32795,140550
521280,201710,438,254,184,237342.1,172408,409750.1
521290,201710,34,14,20,13118,18740,31858
521295,201710,99,67,32,62554.12,29984,92538.12
521300,201710,226,114,112,106800,104580.89,211380.89
521305,201710,36,24,12,22488,11244,33732
521308,201710,1074,765,309,716304.04,289233.63,1005537.67
521310,201710,1351,794,557,742903.1,520739.26,1263642.36
521340,201710,22,17,5,15929,4685,20614
521350,201710,132,96,36,89952,33732,123684
521370,201710,192,118,74,109629,69056.9,178685.9
521375,201710,193,108,85,101196,79363.9,180559.9
521377,201710,52,35,17,32795,15929,48724
521380,201710,1065,694,371,645924.26,347627,993551.26
521385,201710,18,10,8,9370,7496,16866
521390,201710,110,88,22,82143.7,20614,102757.7
521400,201710,331,210,121,196488.9,113330.15,309819.05
521405,201710,150,77,73,72149,68401,140550
521410,201710,68,45,23,42165,21551,63716
521440,201710,220,154,66,143501.55,61842,205343.55
521450,201710,722,393,329,368241,308273,676514
521460,201710,1180,713,467,667800,437560.26,1105360.26
521470,201710,14,9,5,8433,4685,13118
521480,201710,52,34,18,31858,16802,48660
521483,201710,303,161,142,150576,133054,283630
521486,201710,290,185,105,173223.19,97730,270953.19
521487,201710,24,11,13,10307,12181,22488
521490,201710,29,17,12,15929,11244,27173
521500,201710,113,72,41,67464,38417,105881
521520,201710,40,29,11,27173,10307,37480
521523,201710,574,355,219,329701.45,205203,534904.45
521525,201710,46,30,16,28110,14992,43102
521530,201710,243,128,115,119936,107755,227691
521540,201710,31,16,15,14992,14055,29047
521550,201710,90,41,49,38117.63,45876.63,83994.26
521560,201710,789,544,245,509165.9,229425,738590.9
521565,201710,46,31,15,29047,14055,43102
521570,201710,480,320,160,299830.63,148952.35,448782.98
521580,201710,62,39,23,36543,21551,58094
521590,201710,35,19,16,17803,14992,32795
521600,201710,29,17,12,15929,11244,27173
521630,201710,235,118,117,110556.63,108655.88,219212.51
521640,201710,304,153,151,143361,141487,284848
521645,201710,28,15,13,14055,12181,26236
521680,201710,226,142,84,133054,78708,211762
521690,201710,1,1,0,937,0,937
521710,201710,1191,560,631,524157.9,591238,1115395.9
521720,201710,514,338,176,316696.63,164874.63,481571.26
521730,201710,625,308,317,288596,295942.18,584538.18
521740,201710,917,365,552,341977.26,516044.96,858022.22
521760,201710,1578,844,734,788903.21,687450,1476353.21
521770,201710,795,504,291,472248,272207.87,744455.87
521800,201710,2098,1293,805,1207779.1,753479.79,1961258.89
521805,201710,34,19,15,17803,14055,31858
521810,201710,98,59,39,54158.9,36543,90701.9
521830,201710,957,671,286,627135.08,267973,895108.08
521839,201710,95,63,32,59031,29984,89015
521850,201710,1108,598,510,558933.26,477540.04,1036473.30
521860,201710,352,217,135,203329,126214,329543
521870,201710,72,40,32,37480,29984,67464
521878,201710,43,21,22,19677,20614,40291
521880,201710,4375,1956,2419,1830803.58,2264192.85,4094996.43
521890,201710,573,394,179,369178,167432.9,536610.9
521900,201710,299,242,57,225848.2,53409,279257.2
521910,201710,155,110,45,103070,42165,145235
521920,201710,55,26,29,24362,27173,51535
521925,201710,34,21,13,19677,12181,31858
521930,201710,1107,635,472,594801.19,441458.27,1036259.46
521935,201710,33,25,8,23425,7496,30921
521940,201710,193,98,95,91826,89010.32,180836.32
521945,201710,16,14,2,12243.04,1874,14117.04
521950,201710,7,5,2,4685,1874,6559
521960,201710,76,57,19,53409,17803,71212
521970,201710,414,263,151,246149.9,141487,387636.9
521971,201710,98,48,50,44976,46850,91826
521973,201710,31,13,18,12181,16866,29047
521975,201710,1083,564,519,527344.6,485310.73,1012655.33
521980,201710,245,167,78,156320,73086,229406
521990,201710,72,54,18,50598,16866,67464
522000,201710,289,179,110,167723,103070,270793
522005,201710,22,14,8,13118,7496,20614
522010,201710,1116,625,491,584679,459495.43,1044174.43
522015,201710,56,34,22,31849,20614,52463
522020,201710,878,468,410,437298.1,383402.36,820700.46
522026,201710,29,20,9,18740,8433,27173
522028,201710,16,12,4,11244,3748,14992
522040,201710,741,293,448,274242,419721.63,693963.63
522045,201710,2018,1271,747,1189816.43,699414.9,1889231.33
522050,201710,171,82,89,76834,83393,160227
522060,201710,556,353,203,330479.9,190117.3,520597.2
522068,201710,138,90,48,84330,44976,129306
522070,201710,12,12,0,11244,0,11244
522100,201710,48,25,23,23162.64,21551,44713.64
522108,201710,40,30,10,28110,9370,37480
522119,201710,58,29,29,27173,27173,54346
522130,201710,78,25,53,23425,49625,73050
522140,201710,3680,1880,1800,1757012.92,1684473.95,3441486.87
522145,201710,55,33,22,30921,20614,51535
522150,201710,64,51,13,47787,12181,59968
522155,201710,59,41,18,38408,16866,55274
522157,201710,6,4,2,3748,1874,5622
522160,201710,1740,1017,723,951804.6,677160.9,1628965.5
522170,201710,398,264,134,247368,125558,372926
522180,201710,36,20,16,18740,14992,33732
522185,201710,1306,544,762,506760.95,713364.38,1220125.33
522190,201710,48,27,21,25299,19583.3,44882.3
522200,201710,298,180,118,168660,110566,279226
522205,201710,168,115,53,107755,49661,157416
522220,201710,171,121,50,113377,46850,160227
522230,201710,31,24,7,22488,6559,29047
530010,201710,54980,28151,26829,26240747.87,25085359.24,51326107.11
110001,201711,512,405,107,378492.22,99614.55,478106.77
110002,201711,2732,1624,1108,1520097.4,1037039.67,2557137.07
110003,201711,91,72,19,67449,17797.8,85246.8
110004,201711,1967,1254,713,1171938.4,667017.69,1838956.09
110005,201711,432,348,84,325705.52,78683.67,404389.19
110006,201711,449,347,102,324770.52,95528.93,420299.45
110007,201711,84,67,17,62774.3,15926,78700.3
110008,201711,237,136,101,126475.14,94626.88,221102.02
110009,201711,776,525,251,489689.43,234950.45,724639.88
110010,201711,1775,1101,674,1030257.06,631294.03,1661551.09
110011,201711,1884,1452,432,1358755.56,404676.45,1763432.01
110012,201711,4104,2384,1720,2226218.84,1610219.97,3836438.81
110013,201711,749,561,188,525544.78,176119.17,701663.95
110014,201711,362,307,55,287589.4,51520.32,339109.72
110015,201711,1447,1161,286,1085831.82,267341.06,1353172.88
110018,201711,1109,658,451,616154.06,422496.98,1038651.04
110020,201711,15233,8910,6323,8305893.11,5911276.52,14217169.63
110025,201711,632,460,172,429014.74,161135.16,590149.90
110026,201711,41,30,11,28106.98,10304.26,38411.24
110028,201711,1636,1186,450,1106246.58,419310.17,1525556.75
110029,201711,139,122,17,114303.35,15928,130231.35
110030,201711,2474,1659,815,1551317.53,762281.09,2313598.62
110032,201711,390,301,89,281696.79,83374.4,365071.19
110033,201711,654,499,155,464553.08,144907.95,609461.03
110034,201711,360,266,94,246916.49,87400.89,334317.38
110037,201711,105,85,20,79639.32,18739.89,98379.21
110040,201711,329,218,111,204225.2,103978.4,308203.6
110045,201711,925,608,317,568074.18,296026.29,864100.47
110050,201711,96,78,18,73070.06,16864,89934.06
110060,201711,87,45,42,42156.53,39337.93,81494.46
110070,201711,131,77,54,72143.76,50312.23,122455.99
110080,201711,395,233,162,216120.5,151730.84,367851.34
110090,201711,30,25,5,23421.93,4685,28106.93
110092,201711,109,61,48,57153.86,44901.78,102055.64
110094,201711,197,137,60,128334.41,56203.62,184538.03
110100,201711,29,24,5,22483.8,4684.86,27168.66
110110,201711,72,45,27,42158.33,25010.54,67168.87
110120,201711,74,59,15,55273.51,14052,69325.51
110130,201711,300,246,54,228970.09,50568.53,279538.62
110140,201711,246,160,86,149885.36,80559.7,230445.06
110143,201711,47,40,7,37472.76,6559,44031.76
110145,201711,28,20,8,18735.06,7495,26230.06
110146,201711,22,11,11,10306,10303.56,20609.56
110147,201711,39,30,9,28103.83,8432,36535.83
110148,201711,38,26,12,24309.57,11242.66,35552.23
110149,201711,297,210,87,196468.56,81509.76,277978.32
110150,201711,83,56,27,52459.36,25025.55,77484.91
110155,201711,8,7,1,6557,937,7494
110160,201711,72,60,12,56215.39,11242.6,67457.99
110170,201711,212,173,39,162043.95,36531.93,198575.88
110175,201711,28,22,6,20610.69,5621.46,26232.15
110180,201711,96,84,12,78702.06,11242.5,89944.56
120001,201711,131,89,42,83326.52,39330,122656.52
120005,201711,191,120,71,112382,66520.74,178902.74
120010,201711,1010,651,359,602959.55,333734.26,936693.81
120013,201711,139,94,45,87357.68,41137.79,128495.47
120017,201711,86,56,30,52343.76,28043.74,80387.50
120020,201711,3498,2779,719,2574636.04,670105.64,3244741.68
120025,201711,604,338,266,313623.66,248077.88,561701.54
120030,201711,1020,851,169,789269.61,157584.99,946854.60
120032,201711,47,39,8,36521.12,7495.66,44016.78
120033,201711,216,188,28,175813.24,26232.73,202045.97
120034,201711,153,112,41,103044.76,38372.13,141416.89
120035,201711,28,19,9,17801.63,8431.83,26233.46
120038,201711,387,244,143,227750.67,133945.66,361696.33
120039,201711,24,22,2,20611.21,1873.46,22484.67
120040,201711,14060,9709,4351,8948746.1,4026476.25,12975222.35
120042,201711,42,36,6,33724.98,5621.4,39346.38
120043,201711,12,2,10,1874,9370,11244
120045,201711,538,345,193,321098.22,180483.13,501581.35
120050,201711,1245,950,295,884584.91,276000.49,1160585.40
120060,201711,1383,1118,265,1029978.34,244281,1274259.34
120070,201711,510,365,145,334849,134131.9,468980.9
120080,201711,156,101,55,93319.01,50968.35,144287.36
130002,201711,150,105,45,98383.98,42165,140548.98
130006,201711,76,43,33,40290.01,30921,71211.01
130008,201711,144,77,67,71403.07,62054.99,133458.06
130010,201711,140,73,67,68399.31,62778.33,131177.64
130014,201711,241,175,66,163968.89,61834.67,225803.56
130020,201711,86,48,38,44974.1,35604.27,80578.37
130030,201711,882,539,343,505030.62,321373.57,826404.19
130040,201711,318,165,153,154602.76,142416.68,297019.44
130050,201711,554,307,247,287375.52,231434.3,518809.82
130060,201711,885,607,278,563529.34,257620.5,821149.84
130063,201711,546,287,259,268902.39,242641.86,511544.25
130068,201711,187,120,67,112437.1,62495.56,174932.66
130070,201711,1338,932,406,856561.6,374107.78,1230669.38
130080,201711,665,433,232,405343.72,217367.72,622711.44
130083,201711,69,37,32,34668.52,29983.76,64652.28
130090,201711,384,198,186,183869.4,174281.08,358150.48
130100,201711,1125,521,604,488173.57,565656.91,1053830.48
130110,201711,711,316,395,295933.98,370105.42,666039.40
130115,201711,173,70,103,65587.43,96509.15,162096.58
130120,201711,1615,1008,607,944454.72,568724.9,1513179.62
130130,201711,619,418,201,391652.37,188330.66,579983.03
130140,201711,1542,1159,383,1085260.83,357924.63,1443185.46
130150,201711,428,360,68,337303.61,63715.59,401019.20
130160,201711,475,262,213,245491.05,199573.24,445064.29
130165,201711,25,18,7,16866,6559,23425
130170,201711,952,672,280,629541.43,262343.03,891884.46
130180,201711,154,92,62,85735.5,58092.79,143828.29
130185,201711,2174,1150,1024,1075611.56,958908.5,2034520.06
130190,201711,3579,2255,1324,2110081.02,1238987.16,3349068.18
130195,201711,293,235,58,220194.77,54345.66,274540.43
130200,201711,182,82,100,76822.2,93698.25,170520.45
130210,201711,76,36,40,33731.66,37474.92,71206.58
130220,201711,188,128,60,119935.66,56218.05,176153.71
130230,201711,329,205,124,192085,116187.04,308272.04
130240,201711,1457,911,546,852262.81,510744.27,1363007.08
130250,201711,4677,3016,1661,2820263.52,1556182.38,4376445.90
130255,201711,421,209,212,195831.69,198362.16,394193.85
130260,201711,52815,25175,27640,23554624.01,25890535.98,49445159.99
130270,201711,1480,952,528,891526.03,494719.87,1386245.90
130280,201711,111,67,44,62776.17,41226.01,104002.18
130290,201711,2082,1522,560,1425668.54,524416.85,1950085.39
130300,201711,425,306,119,286437.73,111498.54,397936.27
130310,201711,899,478,421,447880.78,394468.71,842349.49
130320,201711,448,237,211,221128.36,197700.44,418828.80
130330,201711,703,428,275,401030.03,257387.6,658417.63
130340,201711,3211,1957,1254,1829155.98,1173537.14,3002693.12
130350,201711,484,303,181,283847.95,169595.46,453443.41
130353,201711,759,310,449,290180.86,420703.35,710884.21
130356,201711,753,343,410,321377.91,383873.98,705251.89
130360,201711,70,42,28,39354,26234.56,65588.56
130370,201711,692,501,191,469432.64,178966.28,648398.92
130380,201711,644,436,208,408519.44,194892.98,603412.42
130390,201711,494,395,99,370112.88,92762.83,462875.71
130395,201711,179,42,137,39352.26,128359.95,167712.21
130400,201711,67,46,21,43101.09,19676.36,62777.45
130406,201711,2090,1324,766,1237014.34,716818.69,1953833.03
130410,201711,515,217,298,203327.01,279205.12,482532.13
130420,201711,3184,2545,639,2380831.3,598739.17,2979570.47
130423,201711,165,76,89,71212,83392.93,154604.93
130426,201711,141,83,58,77768.65,54345.26,132113.91
130430,201711,411,271,140,253926.7,131174.11,385100.81
130440,201711,199,72,127,67461.59,118997.46,186459.05
140002,201711,36,14,22,13118,20614,33732
140005,201711,201,122,79,114076.71,74018.51,188095.22
140010,201711,10318,6974,3344,6502727.65,3130086.74,9632814.39
140015,201711,154,69,85,64650.87,79643.27,144294.14
140017,201711,107,73,34,68399.75,31858,100257.75
140020,201711,482,322,160,300750.28,149915.48,450665.76
140023,201711,24,15,9,13553.82,8431.77,21985.59
140028,201711,18,12,6,11244,5622,16866
140030,201711,361,252,109,236121.69,101540.34,337662.03
140040,201711,54,38,16,35600.89,14898.3,50499.19
140045,201711,250,118,132,109907.18,123678.99,233586.17
140047,201711,556,369,187,342915.67,174459.84,517375.51
140050,201711,157,103,54,95703,50597.66,146300.66
140060,201711,33,23,10,20829.01,9368.83,30197.84
140070,201711,31,29,2,27171.94,1874,29045.94
150010,201711,4724,2924,1800,2736967.43,1684427.62,4421395.05
150013,201711,143,97,46,90881.99,43101.16,133983.15
150020,201711,1102,574,528,537826.79,494727.5,1032554.29
150030,201711,747,303,444,283906.39,416026.4,699932.79
150034,201711,190,116,74,108689.82,69335.16,178024.98
150040,201711,1380,821,559,769221.18,523757.06,1292978.24
150050,201711,716,420,296,392536.46,277135.23,669671.69
150060,201711,4709,3051,1658,2855071.92,1552971.51,4408043.43
150070,201711,307,140,167,131175.31,156475.12,287650.43
150080,201711,14584,7291,7293,6821338.89,6825943.7,13647282.59
150085,201711,371,234,137,219238.33,128363.55,347601.88
150090,201711,769,657,112,615589.01,104941.28,720530.29
150095,201711,348,210,138,196006.6,128493.36,324499.96
150100,201711,53,37,16,34668.74,14991.32,49660.06
150110,201711,171,84,87,78707.09,81518.4,160225.49
150120,201711,437,323,114,302644.85,106816.15,409461.00
150125,201711,49,22,27,20614,25299,45913
150130,201711,1912,1014,898,950070.03,841373.74,1791443.77
150140,201711,54890,25516,29374,23875779.21,27508506.89,51384286.10
150145,201711,172,101,71,94630.02,66524.93,161154.95
150150,201711,2802,1233,1569,1155082.17,1466242.56,2621324.73
150157,201711,443,301,142,282031.83,133048.98,415080.81
150160,201711,120,96,24,89944.59,22487.77,112432.36
150170,201711,3674,2716,958,2541187.48,897322.48,3438509.96
150172,201711,312,214,98,200512.07,91821.37,292333.44
150175,201711,89,56,33,52472,30920.1,83392.1
150178,201711,751,495,256,462860.79,239867.44,702728.23
150180,201711,3017,1443,1574,1351265,1474504.23,2825769.23
150190,201711,334,212,122,198637.31,114313.1,312950.41
150195,201711,122,60,62,56218.79,58092.56,114311.35
150200,201711,211,99,112,92760.92,104943.66,197704.58
150210,201711,3140,2543,597,2381680.6,559125.97,2940806.57
150215,201711,497,331,166,309854.12,155537.07,465391.19
150220,201711,3972,2671,1301,2500854.12,1216905.7,3717759.82
150230,201711,1142,916,226,857690.84,211758.29,1069449.13
150240,201711,5724,3341,2383,3126929.03,2232714.05,5359643.08
150250,201711,33,16,17,14992,15927.15,30919.15
150260,201711,72,42,30,39353.4,28108.96,67462.36
150270,201711,2318,1510,808,1413554.65,756222.85,2169777.50
150275,201711,584,354,230,331690.53,215508.29,547198.82
150276,201711,102,44,58,41227.95,54343.77,95571.72
150277,201711,754,326,428,305433.01,401030.61,706463.62
150280,201711,347,213,134,199572.65,125555.23,325127.88
150285,201711,75,37,38,34667.45,35604.87,70272.32
150290,201711,963,589,374,551592.52,350148.27,901740.79
150293,201711,694,321,373,300350.32,349499.42,649849.74
150295,201711,462,203,259,190204.97,242531.86,432736.83
150300,201711,77,40,37,37480,34668.23,72148.23
150304,201711,139,91,48,85263.38,44973.16,130236.54
150307,201711,396,325,71,304520.6,66526.38,371046.98
150309,201711,536,382,154,357920.95,144293.91,502214.86
150310,201711,252,170,82,159288.91,76833.4,236122.31
150320,201711,1798,1235,563,1156889.73,527516.75,1684406.48
150330,201711,2087,1197,890,1120876.29,833894.26,1954770.55
150340,201711,198,129,69,120629.88,64651.36,185281.24
150345,201711,606,324,282,303400.42,264225.25,567625.67
150350,201711,425,331,94,307791.05,88078,395869.05
150360,201711,4454,2860,1594,2676115.59,1493513.25,4169628.84
150370,201711,748,532,216,497675.22,202090.38,699765.60
150375,201711,197,104,93,97446.84,87134.82,184581.66
150380,201711,1255,827,428,774858.76,400674.97,1175533.73
150390,201711,734,415,319,388847.73,298884.08,687731.81
150400,201711,98,80,18,74957.66,16866,91823.66
150405,201711,1251,824,427,771054.06,399525.37,1170579.43
150410,201711,144,94,50,88077.66,46850,134927.66
150420,201711,7358,4033,3325,3777052.71,3114070.61,6891123.32
150430,201711,478,321,157,300771.15,147103.68,447874.83
150440,201711,592,348,244,325316.62,228623.87,553940.49
150442,201711,2129,1132,997,1058746.08,933859.76,1992605.84
150445,201711,522,327,195,306390.97,181770.58,488161.55
150450,201711,277,132,145,123679.69,135863.66,259543.35
150460,201711,779,585,194,546346.27,181755.9,728102.17
150470,201711,1342,806,536,754920.51,502227.85,1257148.36
150475,201711,33,25,8,23422,7496,30918
150480,201711,1238,858,380,803901.06,355766.85,1159667.91
150490,201711,627,336,291,314815.63,272664.48,587480.11
150495,201711,329,225,104,210816.38,97447.31,308263.69
150497,201711,299,202,97,189264.06,90877.83,280141.89
150500,201711,434,293,141,274536.93,132114.22,406651.15
150503,201711,834,390,444,365130.34,415984.8,781115.14
150506,201711,1029,662,367,620254.06,343851.66,964105.72
150510,201711,1233,697,536,652769.47,502211.22,1154980.69
150520,201711,269,179,90,167715.29,84326.98,252042.27
150530,201711,1560,846,714,789581.31,667789.22,1457370.53
150540,201711,237,165,72,154603.5,67463.9,222067.4
150543,201711,681,375,306,350778.76,286432.55,637211.31
150548,201711,495,343,152,321344.2,142404.24,463748.44
150549,201711,60,40,20,37478.89,18738.81,56217.70
150550,201711,2902,1511,1391,1415055.97,1302777.36,2717833.33
150553,201711,3040,1800,1240,1685005.36,1161818.32,2846823.68
150555,201711,142,75,67,70273.96,62778.02,133051.98
150560,201711,54,40,14,37479.29,13117.48,50596.77
150563,201711,71,39,32,36542.9,29983.11,66526.01
150565,201711,165,99,66,92755.84,61839.49,154595.33
150570,201711,403,269,134,252028.97,125552.94,377581.91
150580,201711,1510,632,878,591482.1,822658.23,1414140.33
150590,201711,774,468,306,438505.37,286714.79,725220.16
150600,201711,453,274,179,256732.99,167716.59,424449.58
150610,201711,143,123,20,114401.92,18738.43,133140.35
150611,201711,130,90,40,84328.54,37479.96,121808.50
150613,201711,3152,1928,1224,1806497.31,1146850.52,2953347.83
150616,201711,488,301,187,281794.86,175209.77,457004.63
150618,201711,1131,619,512,579748.32,479722.93,1059471.25
150619,201711,400,302,98,282948.65,91819.58,374768.23
150620,201711,1278,737,541,690550.94,506626.64,1197177.58
150630,201711,318,215,103,201451.97,96507.21,297959.18
150635,201711,501,205,296,192078.9,277349.16,469428.06
150640,201711,62,30,32,28109.6,29983.2,58092.8
150650,201711,2335,1343,992,1258075.56,928264.17,2186339.73
150655,201711,251,187,64,175213.74,59965.19,235178.93
150658,201711,103,59,44,55280.08,41227.26,96507.34
150660,201711,480,334,146,312949.81,136795.63,449745.44
150670,201711,990,354,636,331388.93,595888.49,927277.42
150680,201711,9834,5371,4463,5026301.28,4178176.96,9204478.24
150690,201711,52,33,19,30919.49,17802.62,48722.11
150700,201711,545,349,196,326824.39,183651.14,510475.53
150710,201711,267,161,106,150848.48,99315.37,250163.85
150715,201711,878,529,349,494687.98,326980.88,821668.86
150720,201711,447,339,108,317630.88,100910.4,418541.28
150730,201711,889,473,416,443174.11,389501.96,832676.07
150740,201711,234,167,67,156472.44,62776.81,219249.25
150745,201711,776,409,367,383223.39,343877.27,727100.66
150746,201711,53,32,21,29981.39,19676.06,49657.45
150747,201711,268,207,61,193953.64,57155.59,251109.23
150750,201711,135,78,57,73078.32,53408,126486.32
150760,201711,1705,1101,604,1031554.35,565908.3,1597462.65
150770,201711,366,189,177,177087.9,165671.28,342759.18
150775,201711,83,38,45,35604.69,42163.32,77768.01
150780,201711,185,100,85,93696.44,79643.66,173340.10
150790,201711,902,489,413,458164.5,386962.09,845126.59
150795,201711,1438,836,602,783279.46,564035.15,1347314.61
150796,201711,412,235,177,220188.12,165845.19,386033.31
150797,201711,279,156,123,146170.47,115246.31,261416.78
150800,201711,1425,852,573,797336.44,536862.3,1334198.74
150803,201711,595,490,105,459115.45,98383.13,557498.58
150805,201711,186,115,71,107749.49,66501.36,174250.85
150808,201711,973,531,442,497527.68,414139.48,911667.16
150810,201711,3370,2323,1047,2173171.5,980429.42,3153600.92
150812,201711,428,223,205,208946.31,192081.46,401027.77
150815,201711,955,631,324,589857.61,303565.65,893423.26
150820,201711,1589,969,620,907942.55,580914.61,1488857.16
150830,201711,840,591,249,552810.9,233301.27,786112.17
150835,201711,187,111,76,104001.49,71203.94,175205.43
150840,201711,1296,825,471,773009.02,441312.43,1214321.45
160005,201711,53,31,22,29045.69,20612.56,49658.25
160010,201711,194,120,74,112437.64,69325.12,181762.76
160015,201711,118,67,51,62777.09,47787,110564.09
160020,201711,122,70,52,65589.8,48720.11,114309.91
160021,201711,40,21,19,19677,17803,37480
160023,201711,111,62,49,58094,45912.36,104006.36
160025,201711,33,14,19,13118,17803,30921
160027,201711,1436,820,616,764840.57,576434.16,1341274.73
160030,201711,15515,7914,7601,7406065.76,7117232.8,14523298.56
160040,201711,320,183,137,171466.39,128366.86,299833.25
160050,201711,639,330,309,309196.41,289241.85,598438.26
160053,201711,329,186,143,173998.98,133989.02,307988.00
160055,201711,21,16,5,14992,4685,19677
160060,201711,6364,3313,3051,3093978.85,2857761.22,5951740.07
160070,201711,167,101,66,94631.09,61838.04,156469.13
160080,201711,79,41,38,38416.09,35603.91,74020.00
170025,201711,23,15,8,14054.9,7495.6,21550.5
170030,201711,220,175,45,163770.78,42164.43,205935.21
170035,201711,225,109,116,101194.89,108692,209886.89
170040,201711,191,147,44,137452.36,41225.45,178677.81
170070,201711,327,189,138,177090.37,129303.53,306393.90
170100,201711,378,269,109,251812.18,102131.85,353944.03
170105,201711,63,52,11,48724,10307,59031
170110,201711,103,63,40,59025.45,37477.3,96502.75
170130,201711,72,33,39,30918.11,36259.4,67177.51
170190,201711,106,67,39,62778.24,36543,99321.24
170200,201711,395,266,129,248568.89,120761.78,369330.67
170210,201711,6015,3103,2912,2900088.39,2725262.05,5625350.44
170215,201711,81,40,41,37474.77,38413.23,75888.00
170220,201711,1443,1053,390,984267.32,365139.63,1349406.95
170230,201711,154,99,55,92763,51535,144298
170240,201711,558,371,187,347618.83,175214.68,522833.51
170255,201711,1113,891,222,834859.19,207731.42,1042590.61
170270,201711,38,28,10,26234.74,9182.6,35417.34
170290,201711,74,55,19,51529.05,17801.18,69330.23
170300,201711,80,52,28,47973.4,26235.66,74209.06
170305,201711,39,31,8,29045.09,7494.41,36539.50
170307,201711,60,44,16,41226.28,14992,56218.28
170310,201711,104,57,47,53406.6,44037.94,97444.54
170320,201711,17,13,4,12181,3748,15929
170330,201711,19,16,3,14992,2811,17803
170360,201711,24,15,9,14054,8433,22487
170370,201711,126,66,60,61841.53,56219.74,118061.27
170380,201711,81,57,24,53404.06,22486.75,75890.81
170382,201711,47,42,5,39353.23,4685,44038.23
170384,201711,125,90,35,84328.3,32795,117123.3
170386,201711,60,28,32,26236,29983,56219
170388,201711,48,17,31,15928.78,29045.38,44974.16
170389,201711,23,17,6,15928.42,5621.66,21550.08
170390,201711,48,27,21,25298.42,19677,44975.42
170410,201711,33,22,11,20614,10307,30921
170460,201711,17,12,5,11244,4685,15929
170510,201711,28,21,7,19676.96,6558.98,26235.94
170550,201711,1484,839,645,786118.54,603589.16,1389707.70
170555,201711,108,74,34,69338,31857,101195
170560,201711,101,72,29,67459.27,27171.13,94630.40
170600,201711,37,18,19,16866,17802.19,34668.19
170610,201711,192,102,90,95418.27,84302,179720.27
170625,201711,38,19,19,17802.44,17803,35605.44
170650,201711,86,65,21,60903.3,19677,80580.3
170700,201711,554,417,137,389728.65,128360.99,518089.64
170710,201711,154,96,58,89952,54332,144284
170720,201711,85,69,16,64649.45,14991.23,79640.68
170730,201711,56,33,23,30920.34,21549.42,52469.76
170740,201711,75,56,19,52467.44,17801.52,70268.96
170755,201711,79,42,37,38744.03,34669,73413.03
170765,201711,144,69,75,64043,70273.24,134316.24
170770,201711,229,130,99,120729.3,92762.52,213491.82
170820,201711,588,381,207,356987.4,193525.03,550512.43
170825,201711,31,20,11,18740,10307,29047
170830,201711,75,53,22,49473.43,20613.62,70087.05
170900,201711,204,153,51,143360.53,47785.29,191145.82
170930,201711,801,413,388,386629.43,362970.73,749600.16
170950,201711,2996,1300,1696,1215730.26,1585598.98,2801329.24
170980,201711,17,9,8,8433,7495.04,15928.04
171050,201711,128,97,31,90885.16,29045.68,119930.84
171070,201711,38,31,7,29045.26,6558.28,35603.54
171090,201711,36,26,10,24359.37,9369.7,33729.07
171110,201711,21,14,7,13118,6559,19677
171150,201711,37,18,19,16866,17802.35,34668.35
171180,201711,22,10,12,9370,11244,20614
171190,201711,131,78,53,73081.6,49659.44,122741.04
171195,201711,63,49,14,45913,13117.51,59030.51
171200,201711,46,21,25,19677,23425,43102
171215,201711,2,2,0,1874,0,1874
171240,201711,54,44,10,41227.09,9370,50597.09
171245,201711,48,44,4,41225.86,3748,44973.86
171250,201711,67,34,33,31858,30911.63,62769.63
171270,201711,17,13,4,12181,3748,15929
171280,201711,38,35,3,32649,2811,35460
171320,201711,994,560,434,524704.99,405703.34,930408.33
171330,201711,422,202,220,189251.33,206120.12,395371.45
171360,201711,85,63,22,59028.29,20614,79642.29
171370,201711,24,13,11,12181,10307,22488
171380,201711,131,106,25,99316.77,23198.39,122515.16
171395,201711,56,34,22,31857.05,20613.09,52470.14
171420,201711,310,205,105,192056.85,98087.71,290144.56
171430,201711,64,51,13,47785.38,12181,59966.38
171488,201711,209,112,97,104941.95,90886.96,195828.91
171500,201711,58,32,26,29984,24362,54346
171510,201711,67,44,23,41226.51,21550.82,62777.33
171515,201711,43,36,7,33731,6558.8,40289.8
171525,201711,29,25,4,23425,3748,27173
171550,201711,13,7,6,6558.4,5622,12180.4
171570,201711,59,29,30,27172.66,28109.13,55281.79
171575,201711,344,208,136,194745.95,127421.96,322167.91
171610,201711,1685,835,850,780451.1,794750.58,1575201.68
171620,201711,131,89,42,82845.61,39266.17,122111.78
171630,201711,53,28,25,26235.3,23423.86,49659.16
171650,201711,275,179,96,167711.2,89948.23,257659.43
171660,201711,254,132,122,123684,114308.16,237992.16
171665,201711,44,29,15,27171.03,14055,41226.03
171670,201711,434,252,182,234469.27,169971.06,404440.33
171700,201711,63,55,8,51534.5,7496,59030.5
171720,201711,23,8,15,7495.34,14054.66,21550.00
171750,201711,103,56,47,52470.88,44038.26,96509.14
171780,201711,70,57,13,53408.03,12180.43,65588.46
171790,201711,79,65,14,60903.37,13117.56,74020.93
171800,201711,36,27,9,25298.46,8432.66,33731.12
171820,201711,2054,1160,894,1086170.54,833073.06,1919243.60
171830,201711,38,30,8,28108.03,7496,35604.03
171840,201711,61,34,27,31855.93,25297.41,57153.34
171845,201711,33,21,12,19676.6,11244,30920.6
171850,201711,38,26,12,24362,11244,35606
171855,201711,72,57,15,53403.97,14054.5,67458.47
171865,201711,8,7,1,6559,937,7496
171870,201711,31,22,9,20614,8433,29047
171875,201711,77,52,25,48723.29,23424.1,72147.39
171880,201711,25,18,7,16865.17,6559,23424.17
171884,201711,45,22,23,20611.59,21550.66,42162.25
171886,201711,113,40,73,37477.92,68116.11,105594.03
171888,201711,23,17,6,15929,5622,21551
171889,201711,20,15,5,14055,4685,18740
171890,201711,57,46,11,43098.75,10306.5,53405.25
171900,201711,43,30,13,28110,12181,40291
172000,201711,40,34,6,31855.93,5622,37477.93
172010,201711,39,32,7,29187.55,6558.44,35745.99
172015,201711,26,15,11,14054.92,10025.9,24080.82
172020,201711,127,78,49,73084.15,45912.85,118997.00
172025,201711,34,21,13,19676.05,12178.84,31854.89
172030,201711,35,20,15,18738.76,14054.86,32793.62
172049,201711,76,46,30,43101,28108.03,71209.03
172065,201711,149,97,52,90888.75,48724,139612.75
172080,201711,84,60,24,55044.83,22486.3,77531.13
172085,201711,25,12,13,11244,12181,23425
172090,201711,405,304,101,284846.17,93880.14,378726.31
172093,201711,27,18,9,16866,8433,25299
172097,201711,17,8,9,7495.99,8151,15646.99
172100,201711,4652,2612,2040,2440805.73,1908677.53,4349483.26
172110,201711,81,55,26,51533.75,24361.67,75895.42
172120,201711,1742,1489,253,1389355.64,235961.18,1625316.82
172125,201711,2,2,0,1874,0,1874
172130,201711,15,13,2,12179.12,1874,14053.12
172208,201711,192,122,70,114304.49,65588.71,179893.20
172210,201711,457,218,239,204260.2,223660.09,427920.29
210005,201711,2944,1838,1106,1718891.65,1033481.83,2752373.48
210010,201711,199,101,98,94636.79,91825.66,186462.45
210015,201711,28,19,9,17800.99,8432.56,26233.55
210020,201711,352,178,174,166779.71,163030.55,329810.26
210030,201711,343,212,131,198642.46,122733,321375.46
210040,201711,159,122,37,114313.17,34669,148982.17
210043,201711,251,170,81,159285.92,75896.25,235182.17
210047,201711,622,310,312,290082.3,292332.6,582414.9
210050,201711,295,213,82,199564.17,76823.31,276387.48
210055,201711,41,31,10,29047,9370,38417
210060,201711,571,438,133,410401.12,124621,535022.12
210070,201711,418,301,117,282030.37,109618.97,391649.34
210080,201711,105,97,8,90883.63,7496,98379.63
210083,201711,312,128,184,119929.34,172406.38,292335.72
210087,201711,50,34,16,31856,14992,46848
210090,201711,498,340,158,318574.15,148044.53,466618.68
210095,201711,497,352,145,329808.58,135863.88,465672.46
210100,201711,690,519,171,485965.63,159285.57,645251.20
210110,201711,151,80,71,74960,66527,141487
210120,201711,5546,4135,1411,3867980.08,1321134.88,5189114.96
210125,201711,219,122,97,114308.06,90886.64,205194.70
210130,201711,563,288,275,268913.28,257655.09,526568.37
210135,201711,34,20,14,18740,13118,31858
210140,201711,4169,3252,917,3043809.32,858785.05,3902594.37
210150,201711,356,225,131,210821.48,122745.46,333566.94
210160,201711,3351,2798,553,2618829.09,517872.2,3136701.29
210170,201711,1124,863,261,808611.24,244554.65,1053165.89
210173,201711,117,97,20,90887.22,18740,109627.22
210177,201711,477,229,248,214572.9,232376,446948.9
210180,201711,32,18,14,16865.72,13116.82,29982.54
210190,201711,406,256,150,239865.59,140546.96,380412.55
210193,201711,0,0,0,0,0,0
210197,201711,80,54,26,50598,24362,74960
210200,201711,648,511,137,478790.83,128368.2,607159.03
210203,201711,270,176,94,164906.93,88077.02,252983.95
210207,201711,378,291,87,272665.39,81518.2,354183.59
210210,201711,771,699,72,654949.57,67463.33,722412.90
210215,201711,78,65,13,60904.22,12181,73085.22
210220,201711,398,325,73,304524.25,68119.23,372643.48
210230,201711,302,222,80,208012.22,74959.33,282971.55
210232,201711,1503,940,563,880469.29,527524.3,1407993.59
210235,201711,154,117,37,109438,34669,144107
210237,201711,45,25,20,23424.11,18739.66,42163.77
210240,201711,95,78,17,73085.31,15928.2,89013.51
210250,201711,178,140,38,131175.28,35604.72,166780.00
210255,201711,326,236,90,221110.46,84325.99,305436.45
210260,201711,435,260,175,243614.87,163972.82,407587.69
210270,201711,705,445,260,416957.97,243618.87,660576.84
210275,201711,41,32,9,29981.99,8432.86,38414.85
210280,201711,1036,655,381,610910.32,355659.57,966569.89
210290,201711,504,319,185,298891.99,173344.42,472236.41
210300,201711,6187,3559,2628,3330085.14,2460872.29,5790957.43
210310,201711,102,69,33,64651.61,30920.06,95571.67
210312,201711,129,79,50,74020.33,46849.72,120870.05
210315,201711,117,84,33,78707.75,30920.27,109628.02
210317,201711,119,84,35,78703.91,32795,111498.91
210320,201711,2398,1959,439,1833833.39,410401.1,2244234.49
210325,201711,131,88,43,81517.08,40008.26,121525.34
210330,201711,5731,2856,2875,2671239.1,2693825.91,5365065.01
210340,201711,1429,1012,417,947438.4,390654.94,1338093.34
210350,201711,607,491,116,459822.18,108691.66,568513.84
210355,201711,129,101,28,94631.8,26236,120867.8
210360,201711,2696,1670,1026,1561569.45,960986.95,2522556.40
210370,201711,1279,531,748,497539.07,700213.64,1197752.71
210375,201711,193,101,92,94100,86204,180304
210380,201711,733,543,190,508783.58,178026.52,686810.10
210390,201711,196,159,37,148980.93,34668.68,183649.61
210400,201711,409,340,69,318578.2,64653,383231.2
210405,201711,996,655,341,613103.07,319488.18,932591.25
210407,201711,56,44,12,41226.95,11244,52470.95
210408,201711,70,63,7,59030,6559,65589
210409,201711,318,262,56,245487.49,52472,297959.49
210410,201711,435,337,98,315764.32,91811.53,407575.85
210420,201711,195,158,37,148044.6,34667.88,182712.48
210430,201711,34,26,8,24362,7496,31858
210440,201711,383,227,156,212696.13,146170.89,358867.02
210450,201711,146,109,37,102131.49,34668.76,136800.25
210455,201711,215,115,100,107755,93696.32,201451.32
210460,201711,343,212,131,198639.65,122739.35,321379.00
210462,201711,58,48,10,44973.02,9369.16,54342.18
210465,201711,182,129,53,120869.51,49661,170530.51
210467,201711,527,373,154,349489.74,144297,493786.74
210470,201711,47,35,12,32791.45,11243.16,44034.61
210480,201711,1293,900,393,843267.58,368228.58,1211496.16
210490,201711,226,134,92,125553.13,86201.87,211755.00
210500,201711,575,295,280,276406.51,262355.12,538761.63
210510,201711,559,428,131,401023.94,122746.29,523770.23
210515,201711,451,241,210,225804.59,196770,422574.59
210520,201711,404,349,55,326727.03,51533.53,378260.56
210530,201711,9392,5015,4377,4686435.84,4095729.54,8782165.38
210535,201711,136,96,40,89951.39,37479.35,127430.74
210540,201711,1542,919,623,859949.6,582343.62,1442293.22
210542,201711,1168,596,572,558066.8,535957.05,1094023.85
210545,201711,13,12,1,11243.19,937,12180.19
210547,201711,135,116,19,108690.62,17803,126493.62
210550,201711,755,522,233,486817.14,218321,705138.14
210560,201711,178,145,33,135862.2,30921,166783.2
210565,201711,30,21,9,19677,8433,28110
210570,201711,1371,1067,304,999768.84,284846.82,1284615.66
210580,201711,108,93,15,87138.08,14055,101193.08
210590,201711,774,601,173,562381.36,162100.76,724482.12
210592,201711,33,29,4,27173,3748,30921
210594,201711,100,83,17,77770.55,15928.66,93699.21
210596,201711,80,67,13,62775.89,12180.83,74956.72
210598,201711,125,91,34,85265.32,31858,117123.32
210600,201711,350,293,57,274539.18,53409,327948.18
210610,201711,244,227,17,211754.16,15929,227683.16
210620,201711,48,28,20,26236,18740,44976
210630,201711,62,58,4,54345.29,3748,58093.29
210632,201711,1145,739,406,692430.87,379651.03,1072081.90
210635,201711,15,12,3,11244,2811,14055
210637,201711,106,74,32,69336.2,29982.21,99318.41
210640,201711,588,508,80,475976.65,74958.28,550934.93
210650,201711,404,324,80,303393.76,74022.27,377416.03
210660,201711,410,290,120,271070.47,112314.8,383385.27
210663,201711,19,11,8,10306.56,7495.06,17801.62
210667,201711,118,37,81,34668,75897,110565
210670,201711,269,237,32,221358.16,29983.93,251342.09
210675,201711,568,292,276,273599.07,258608.85,532207.92
210680,201711,219,136,83,127429.37,77770,205199.37
210690,201711,649,504,145,472240.63,135864.03,608104.66
210700,201711,191,138,53,129301.13,49660.78,178961.91
210710,201711,309,170,139,158820.08,130241.83,289061.91
210720,201711,127,105,22,98382.4,20613.22,118995.62
210725,201711,63,55,8,51534,7496,59030
210730,201711,23,17,6,15929,5622,21551
210735,201711,417,274,143,256724.02,133708.49,390432.51
210740,201711,542,458,84,429140.33,78706.46,507846.79
210745,201711,150,106,44,99319.81,41228,140547.81
210750,201711,2418,1074,1344,1004386.3,1259297.44,2263683.74
210760,201711,278,202,76,189270.55,71197.95,260468.50
210770,201711,403,309,94,288593,87796.9,376389.9
210780,201711,420,301,119,282027.21,111501.9,393529.11
210790,201711,187,142,45,133049.99,42163.82,175213.81
210800,201711,132,100,32,93694.61,29983.45,123678.06
210805,201711,41,38,3,35603.58,2811,38414.58
210810,201711,492,370,122,346026.27,114312.23,460338.50
210820,201711,2318,1822,496,1699064.19,464749.37,2163813.56
210825,201711,173,88,85,82452.91,79644.9,162097.81
210830,201711,815,485,330,453500.75,308270.61,761771.36
210840,201711,220,145,75,135859.77,70273.22,206132.99
210845,201711,253,153,100,143354.49,93699.3,237053.79
210850,201711,877,557,320,521905,299838.89,821743.89
210860,201711,4188,2116,2072,1981375.52,1941105.52,3922481.04
210870,201711,468,348,120,326074.75,112440,438514.75
210880,201711,56,38,18,35603.18,16865.65,52468.83
210890,201711,343,279,64,261421.69,59967.33,321389.02
210900,201711,558,361,197,338242.86,184587.72,522830.58
210905,201711,76,35,41,32793.56,38417,71210.56
210910,201711,2004,1465,539,1371912.74,505040.3,1876953.04
210920,201711,232,67,165,62778.37,154604.51,217382.88
210923,201711,77,56,21,52470.42,19675.74,72146.16
210927,201711,446,176,270,164904.59,252989.42,417894.01
210930,201711,58,45,13,42164.31,12181,54345.31
210940,201711,93,69,24,64650.47,22488,87138.47
210945,201711,202,90,112,84328.13,104943.48,189271.61
210950,201711,506,360,146,337317.88,136796.55,474114.43
210955,201711,75,49,26,45911.23,24360.55,70271.78
210960,201711,2472,1010,1462,944745.09,1369594.69,2314339.78
210970,201711,113,96,17,89951.82,15929,105880.82
210975,201711,85,76,9,71209.21,8433,79642.21
210980,201711,1271,531,740,497427.05,693094.33,1190521.38
210990,201711,4454,2727,1727,2553692.64,1618137.81,4171830.45
211000,201711,1394,1093,301,1023806.59,281752.53,1305559.12
211003,201711,921,623,298,583736.31,279207.09,862943.40
211010,201711,473,413,60,386977.94,56219.6,443197.54
211020,201711,1622,575,1047,538760.88,980818.92,1519579.80
211023,201711,26,22,4,20331.53,3748,24079.53
211027,201711,63,39,24,36541.31,22488,59029.31
211030,201711,385,254,131,237991.08,122745.79,360736.87
211040,201711,318,236,82,220841.81,76830.69,297672.50
211050,201711,1201,741,460,694306.21,430728.59,1125034.80
211060,201711,690,583,107,545050.49,100259,645309.49
211065,201711,24,20,4,18740,3748,22488
211070,201711,916,739,177,690839.17,165849,856688.17
211080,201711,89,85,4,79643.56,3748,83391.56
211085,201711,59,31,28,28762.97,26234.71,54997.68
211090,201711,93,75,18,70275,16866,87141
211100,201711,501,399,102,373858.81,95573.58,469432.39
211102,201711,274,178,96,166777.7,89952,256729.7
211105,201711,210,142,68,133051.87,63716,196767.87
211107,201711,133,74,59,69333.84,55279.76,124613.60
211110,201711,818,528,290,494170.35,271716.53,765886.88
211120,201711,5894,2422,3472,2264142.26,3252162.33,5516304.59
211125,201711,32,25,7,23425,6559,29984
211130,201711,46463,18927,27536,17701808.05,25788435.61,43490243.66
211140,201711,437,366,71,341705.25,66527,408232.25
211150,201711,1263,785,478,735198.78,447589.48,1182788.26
211153,201711,172,98,74,91824.73,69337.47,161162.20
211157,201711,56,40,16,37477.79,14992,52469.79
211160,201711,703,577,126,539685.13,118061.56,657746.69
211163,201711,0,0,0,0,0,0
211167,201711,5,3,2,2810.13,1874,4684.13
211170,201711,452,309,143,289530.52,133990.06,423520.58
211172,201711,123,83,40,77766.3,37480,115246.3
211174,201711,285,164,121,153666.77,113375.93,267042.70
211176,201711,527,370,157,346681.8,147106.58,493788.38
211178,201711,97,62,35,58094,32793.75,90887.75
211180,201711,210,162,48,151793,44815.94,196608.94
211190,201711,62,57,5,53406.28,4683.63,58089.91
211195,201711,24,15,9,14055,8433,22488
211200,201711,156,134,22,125218.48,20614,145832.48
211210,201711,574,322,252,301050.98,236123.8,537174.78
211220,201711,3947,2200,1747,2053661.78,1628815.41,3682477.19
211223,201711,97,90,7,84149.43,6558.5,90707.93
211227,201711,70,48,22,44973.29,20614,65587.29
211230,201711,788,633,155,592974.06,145215.66,738189.72
211240,201711,426,315,111,295142.66,104006.56,399149.22
211245,201711,213,91,122,85260.6,114311.41,199572.01
211250,201711,1652,1399,253,1309984.12,237058,1547042.12
211260,201711,801,629,172,589358.78,161161.77,750520.55
211270,201711,2113,1636,477,1532904.69,446008.26,1978912.95
211280,201711,1821,1081,740,1010989.93,693376.11,1704366.04
211285,201711,213,121,92,113376.33,86203.56,199579.89
211290,201711,697,463,234,433628.85,219251.14,652879.99
211300,201711,816,617,199,577849.81,186463,764312.81
211400,201711,1635,901,734,844221.51,687750.9,1531972.41
220005,201711,19,18,1,16866,937,17803
220010,201711,92,70,22,65581.59,20332.23,85913.82
220020,201711,573,448,125,419156.61,117118.14,536274.75
220025,201711,109,105,4,98378.56,3748,102126.56
220027,201711,41,34,7,31856.21,6559,38415.21
220030,201711,93,75,18,70270.62,16865.03,87135.65
220040,201711,1113,823,290,769898.37,271720.82,1041619.19
220045,201711,36,27,9,25299,8433,33732
220050,201711,648,522,126,487959.72,118039.17,605998.89
220060,201711,170,144,26,134927.09,24362,159289.09
220070,201711,97,89,8,83389.15,7495.47,90884.62
220080,201711,9,8,1,7494.03,937,8431.03
220090,201711,33,27,6,25010.63,5621.2,30631.83
220095,201711,2,1,1,937,937,1874
220100,201711,28,24,4,22487.33,3748,26235.33
220105,201711,40,37,3,34668.75,2811,37479.75
220110,201711,207,190,17,177746.32,15928.2,193674.52
220115,201711,43,40,3,37476.59,2811,40287.59
220117,201711,19,18,1,16864.26,937,17801.26
220120,201711,1535,1049,486,982257.04,455353.75,1437610.79
220130,201711,24,23,1,21550.53,936.66,22487.19
220140,201711,97,76,21,70272.78,19675.66,89948.44
220150,201711,445,313,132,293269.99,123679.98,416949.97
220155,201711,4,4,0,3747.08,0,3747.08
220157,201711,19,16,3,14992,2811,17803
220160,201711,73,64,9,59964.2,8432.8,68397.0
220170,201711,33,31,2,29043.89,1874,30917.89
220173,201711,8,8,0,7495.66,0,7495.66
220177,201711,5,5,0,4685,0,4685
220180,201711,66,66,0,61820.52,0,61820.52
220190,201711,1053,942,111,882649.33,103255.53,985904.86
220191,201711,42,37,5,34668.92,4685,39353.92
220192,201711,58,55,3,51529,2811,54340
220194,201711,26,22,4,20613.05,3748,24361.05
220196,201711,104,86,18,80431.93,16865.46,97297.39
220198,201711,6,4,2,3748,1874,5622
220200,201711,432,349,83,327712.43,77769.48,405481.91
220202,201711,39,35,4,32794.38,3748,36542.38
220205,201711,39,34,5,31853.01,4685,36538.01
220207,201711,20,19,1,17803,937,18740
220208,201711,84,43,41,40288.12,38416.73,78704.85
220209,201711,32,29,3,27173,2811,29984
220210,201711,16,15,1,14053.95,937,14990.95
220211,201711,41,40,1,37477.9,937,38414.9
220213,201711,44,39,5,36543,4685,41228
220217,201711,38,30,8,28108.66,7494.4,35603.06
220220,201711,1993,1266,727,1182671.31,679807.24,1862478.55
220225,201711,15,7,8,6559,7496,14055
220230,201711,930,742,188,694790.21,175521.47,870311.68
220240,201711,143,130,13,121801.54,12180.66,133982.20
220245,201711,43,39,4,36159.63,3747.19,39906.82
220250,201711,106,94,12,88070.09,11244,99314.09
220253,201711,43,35,8,32791.39,7495.06,40286.45
220255,201711,31,26,5,24359.95,4685,29044.95
220260,201711,691,504,187,472243.21,175214.03,647457.24
220265,201711,13,9,4,8433,3748,12181
220270,201711,651,578,73,540840.88,67928.7,608769.58
220271,201711,48,39,9,36542.14,8432.5,44974.64
220272,201711,26,25,1,23422.16,937,24359.16
220273,201711,14,12,2,11244,1873.6,13117.6
220275,201711,48,37,11,34668.2,10305.2,44973.4
220277,201711,11,9,2,8432.66,1873.06,10305.72
220280,201711,12,10,2,9369.05,1874,11243.05
220285,201711,41,38,3,35604.33,2811,38415.33
220290,201711,1387,1184,203,1106899.21,190149.61,1297048.82
220300,201711,58,56,2,52469.83,1874,54343.83
220310,201711,309,261,48,244541.12,44961.02,289502.14
220320,201711,427,394,33,367755.92,30920.61,398676.53
220323,201711,0,0,0,0,0,0
220325,201711,14,9,5,8433,4685,13118
220327,201711,12,11,1,10307,937,11244
220330,201711,199,135,64,126203.26,59964.64,186167.90
220335,201711,138,121,17,113370.44,15927.63,129298.07
220340,201711,23,12,11,11243.15,10305.53,21548.68
220342,201711,56,47,9,44039,8432.06,52471.06
220345,201711,82,74,8,69334.41,7496,76830.41
220350,201711,435,384,51,357212.9,47785.06,404997.96
220360,201711,41,30,11,28104.37,10305.59,38409.96
220370,201711,1084,861,223,805792.8,208660.22,1014453.02
220375,201711,29,27,2,25294.9,1874,27168.9
220380,201711,35,27,8,25297.92,7493.52,32791.44
220385,201711,28,24,4,22488,3748,26236
220390,201711,2225,1266,959,1181599.79,897192.25,2078792.04
220400,201711,27,25,2,23418.96,1873.2,25292.16
220410,201711,15,13,2,12179.4,1874,14053.4
220415,201711,12,11,1,10307,937,11244
220420,201711,126,105,21,98381.61,19394.72,117776.33
220430,201711,132,119,13,109851.38,12181,122032.38
220435,201711,26,19,7,17794,6559,24353
220440,201711,286,243,43,227691,40290.8,267981.8
220450,201711,322,167,155,155332.76,145234.13,300566.89
220455,201711,52,50,2,46844.18,1874,48718.18
220460,201711,18,18,0,16208.76,0,16208.76
220465,201711,108,69,39,64653,36543,101196
220470,201711,241,210,31,195817.5,29045.59,224863.09
220480,201711,72,61,11,57152.1,10307,67459.1
220490,201711,86,75,11,69509.81,10306.33,79816.14
220500,201711,102,88,14,82448.77,13117.86,95566.63
220510,201711,376,299,77,279404.43,71958.86,351363.29
220515,201711,20,16,4,14991.12,3748,18739.12
220520,201711,368,330,38,307646.82,35580,343226.82
220525,201711,26,18,8,16866,7496,24362
220527,201711,37,29,8,27173,6698,33871
220530,201711,31,12,19,11243.15,17802.65,29045.80
220535,201711,15,14,1,13118,937,14055
220540,201711,61,48,13,44967.29,12180.16,57147.45
220545,201711,63,40,23,37480,21551,59031
220550,201711,626,475,151,444310.99,141481.12,585792.11
220551,201711,27,20,7,18740,6559,25299
220552,201711,8,8,0,7496,0,7496
220553,201711,48,44,4,41227,3747.13,44974.13
220554,201711,13,8,5,7214.3,4685,11899.3
220555,201711,23,19,4,17803,3748,21551
220556,201711,58,54,4,50595.76,3748,54343.76
220557,201711,56,50,6,46850,5622,52472
220558,201711,7,2,5,1874,4685,6559
220559,201711,7,6,1,5622,937,6559
220560,201711,54,35,19,32602.4,17800.89,50403.29
220570,201711,785,462,323,432632.75,302641.66,735274.41
220580,201711,580,528,52,494731.42,48040.26,542771.68
220585,201711,7,6,1,5621.16,937,6558.16
220590,201711,13,13,0,12181,0,12181
220595,201711,59,44,15,41224.24,14054.06,55278.30
220600,201711,19,9,10,8433,9370,17803
220605,201711,21,20,1,18739.71,937,19676.71
220610,201711,60,51,9,47781.08,8430.52,56211.60
220620,201711,556,433,123,405476.88,115249.6,520726.48
220630,201711,7,5,2,4684.6,1874,6558.6
220635,201711,36,33,3,30920.66,2811,33731.66
220640,201711,99,76,23,71208.4,21550.8,92759.2
220650,201711,114,108,6,101188.57,5621.49,106810.06
220660,201711,25,20,5,18737.74,4683.52,23421.26
220665,201711,4,4,0,3748,0,3748
220667,201711,12,11,1,10307,937,11244
220669,201711,22,19,3,17800.31,2809.78,20610.09
220670,201711,67,52,15,48535.71,14054.33,62590.04
220672,201711,57,38,19,35601.89,17801.2,53403.09
220675,201711,35,27,8,25299,7496,32795
220680,201711,34,29,5,27162.54,4683.55,31846.09
220690,201711,49,46,3,43095.66,2811,45906.66
220695,201711,63,30,33,28110,30921,59031
220700,201711,1507,1155,352,1080388.7,329813.91,1410202.61
220710,201711,3,1,2,937,1874,2811
220720,201711,119,96,23,89714.95,21410.45,111125.40
220730,201711,19,18,1,16866,936.16,17802.16
220735,201711,3,1,2,937,1874,2811
220740,201711,39,37,2,34668.61,1874,36542.61
220750,201711,97,80,17,74959.27,15929,90888.27
220755,201711,16,16,0,14992,0,14992
220760,201711,51,48,3,44971.11,2810.33,47781.44
220770,201711,5713,2832,2881,2648010.81,2693695.3,5341706.11
220775,201711,27,13,14,12181,13118,25299
220777,201711,15,14,1,13113.18,936.73,14049.91
220779,201711,18,14,4,13118,3748,16866
220780,201711,878,747,131,699260.09,122458.3,821718.39
220785,201711,7,5,2,4682.77,1873.83,6556.60
220790,201711,1012,801,211,748140.09,197703.96,945844.05
220793,201711,14,14,0,13118,0,13118
220795,201711,23,22,1,20614,937,21551
220800,201711,3822,2904,918,2719326.22,859167.69,3578493.91
220810,201711,55,50,5,46848.28,4683.82,51532.10
220820,201711,238,215,23,201448.78,21551,222999.78
220830,201711,1144,966,178,905110.83,166764.23,1071875.06
220840,201711,2414,1590,824,1477351.74,770005.16,2247356.90
220850,201711,52,41,11,38411.6,10306.01,48717.61
220855,201711,14,9,5,8433,4685,13118
220860,201711,8,7,1,6559,936.87,7495.87
220865,201711,21,19,2,17803,1874,19677
220870,201711,57,54,3,50593.91,2811,53404.91
220880,201711,331,251,80,234522.12,74677.16,309199.28
220885,201711,44,38,6,35606,5622,41228
220887,201711,19,18,1,16866,937,17803
220890,201711,103,91,12,85266.36,11244,96510.36
220900,201711,46,26,20,24357.71,18737.53,43095.24
220910,201711,54,45,9,42164.45,8433,50597.45
220915,201711,10,9,1,8432.33,937,9369.33
220920,201711,37,34,3,31855.91,2811,34666.91
220930,201711,41,40,1,37478.68,937,38415.68
220935,201711,20,19,1,17803,937,18740
220937,201711,46,43,3,40290.84,2810.53,43101.37
220940,201711,49,45,4,42160.16,3747.56,45907.72
220945,201711,0,0,0,0,0,0
220950,201711,45,41,4,38414.26,3747.67,42161.93
220955,201711,36,33,3,30921,2811,33732
220960,201711,2,2,0,1874,0,1874
220965,201711,28,24,4,22480.29,3748,26228.29
220970,201711,46,38,8,35601.54,7495.13,43096.67
220975,201711,9,8,1,7496,937,8433
220980,201711,35,32,3,29981.67,2811,32792.67
220985,201711,64,57,7,53405.23,6558.45,59963.68
220987,201711,30,29,1,27172.24,937,28109.24
220990,201711,12,11,1,10306.6,937,11243.6
220995,201711,40,34,6,31858,5622,37480
220997,201711,37,30,7,28106.49,6558.13,34664.62
221000,201711,1085,975,110,910945.92,102782.25,1013728.17
221005,201711,66,61,5,57153.62,4685,61838.62
221010,201711,14,12,2,11244,1874,13118
221020,201711,50,48,2,44976,1874,46850
221030,201711,36,29,7,27172.7,6559,33731.7
221035,201711,19,18,1,16864,937,17801
221037,201711,12,6,6,5622,5621.44,11243.44
221038,201711,24,22,2,20608.21,1873,22481.21
221039,201711,23,23,0,21547.21,0,21547.21
221040,201711,250,214,36,200515.24,33731.9,234247.14
221050,201711,232,195,37,182710.69,34667.29,217377.98
221060,201711,1668,1464,204,1370830.51,191134.59,1561965.10
221062,201711,29,28,1,26236,937,27173
221063,201711,14,10,4,9369.25,3747.53,13116.78
221065,201711,46,39,7,36541.49,6557.86,43099.35
221070,201711,149,129,20,120873,18739.33,139612.33
221080,201711,378,331,47,310134.64,43756.53,353891.17
221090,201711,40,39,1,36277.86,936.33,37214.19
221093,201711,70,48,22,44976,20613.72,65589.72
221095,201711,11,10,1,9370,937,10307
221097,201711,24,21,3,19677,2811,22488
221100,201711,24291,13901,10390,13001717.66,9730041.31,22731758.97
221110,201711,1014,738,276,691213.4,258606.05,949819.45
221120,201711,521,388,133,363257.84,124616.37,487874.21
221130,201711,916,743,173,694634.01,161426.72,856060.73
221135,201711,35,32,3,29979.39,2811,32790.39
221140,201711,38,30,8,28106.59,7494.65,35601.24
221150,201711,16,12,4,11244,3748,14992
221160,201711,11,11,0,10306,0,10306
221170,201711,13,13,0,12179.46,0,12179.46
230010,201711,158,147,11,137737.65,10307,148044.65
230015,201711,116,94,22,88071.63,20612.75,108684.38
230020,201711,1509,1292,217,1208037.11,202514.98,1410552.09
230030,201711,1592,1138,454,1060780.47,425379.48,1486159.95
230040,201711,197,173,24,161162.01,22485.59,183647.60
230050,201711,201,148,53,138673.15,49657.19,188330.34
230060,201711,145,117,28,108874.57,26234.15,135108.72
230070,201711,285,253,32,237054.37,29982.69,267037.06
230075,201711,789,690,99,644532.45,92478.32,737010.77
230080,201711,176,153,23,143357.85,21549.39,164907.24
230090,201711,89,60,29,55466.41,27172.33,82638.74
230100,201711,1920,1143,777,1068698.43,728034.31,1796732.74
230110,201711,2629,1677,952,1567729,891443.11,2459172.11
230120,201711,926,733,193,684465.64,180814.17,865279.81
230125,201711,137,111,26,104000,24360.73,128360.73
230130,201711,453,405,48,379476.1,44975.63,424451.73
230140,201711,208,180,28,168659.02,26235.26,194894.28
230150,201711,151,120,31,112438.61,29047,141485.61
230160,201711,900,786,114,735759.05,106811.13,842570.18
230170,201711,575,529,46,492544.82,43101.06,535645.88
230180,201711,79,74,5,69337.05,4685,74022.05
230185,201711,397,342,55,319104.29,51534.88,370639.17
230190,201711,2165,1742,423,1628806.83,396022.55,2024829.38
230195,201711,482,420,62,393537.37,58094,451631.37
230200,201711,368,320,48,298890.79,44302.54,343193.33
230205,201711,342,213,129,197837.44,120865.47,318702.91
230210,201711,1251,1000,251,935668.9,234432.74,1170101.64
230220,201711,1358,951,407,890317.6,381351.15,1271668.75
230230,201711,899,793,106,741402.66,99320.24,840722.90
230240,201711,1616,1392,224,1302605.63,209886.35,1512491.98
230250,201711,1736,1420,316,1326431.69,295803.38,1622235.07
230260,201711,2885,1716,1169,1602736.48,1094372.36,2697108.84
230270,201711,1323,1068,255,998114.62,235869.08,1233983.70
230280,201711,2669,1983,686,1852633.42,641820.18,2494453.60
230290,201711,396,357,39,327486.94,36542.9,364029.84
230300,201711,510,375,135,350123.83,126489.93,476613.76
230310,201711,421,314,107,293861.22,99974.01,393835.23
230320,201711,890,762,128,710613,119915.66,830528.66
230330,201711,295,237,58,221314.72,54155.82,275470.54
230340,201711,449,361,88,336552.77,82455.02,419007.79
230350,201711,2990,1880,1110,1761493.17,1037210.92,2798704.09
230360,201711,252,220,32,205232.37,29982.32,235214.69
230365,201711,136,108,28,100476.31,26234.78,126711.09
230370,201711,9533,4637,4896,4335524.83,4583408.85,8918933.68
230380,201711,455,393,62,367949.51,57146.11,425095.62
230390,201711,493,270,223,251215.11,208942.99,460158.10
230393,201711,269,224,45,209043.47,42163.68,251207.15
230395,201711,330,269,61,251801.44,57156,308957.44
230400,201711,602,477,125,445061.89,116635.2,561697.09
230410,201711,2574,1601,973,1494565.4,911400.75,2405966.15
230420,201711,5834,3787,2047,3529656.56,1913467.01,5443123.57
230423,201711,304,263,41,244541.25,38415.32,282956.57
230425,201711,337,281,56,263287.63,52468.11,315755.74
230426,201711,104,94,10,87363.31,9088.9,96452.21
230427,201711,77,74,3,69336.66,2811,72147.66
230428,201711,1329,686,643,642541.9,602474.16,1245016.06
230430,201711,439,351,88,328674.13,82455.46,411129.59
230435,201711,771,538,233,502569.11,217089.92,719659.03
230440,201711,82524,36275,46249,33906373.6,43294210.47,77200584.07
230445,201711,259,179,80,167528.53,74957.1,242485.63
230450,201711,538,435,103,407589,96509.09,504098.09
230460,201711,56,46,10,43101.64,9368.63,52470.27
230465,201711,291,235,56,220190.02,52470.19,272660.21
230470,201711,1811,1406,405,1317394.68,378358.03,1695752.71
230480,201711,145,140,5,130895.64,4684.16,135579.80
230490,201711,278,226,52,211756.01,48723.39,260479.40
230495,201711,427,322,105,300869.11,98381.68,399250.79
230500,201711,933,701,232,654949.32,217367.27,872316.59
230510,201711,43,35,8,32794.31,7495.72,40290.03
230520,201711,385,303,82,283907.79,76830.75,360738.54
230523,201711,1924,1215,709,1136968.9,663847.04,1800815.94
230526,201711,288,240,48,224875.68,44196.43,269072.11
230530,201711,660,496,164,461782.98,152725.16,614508.14
230533,201711,178,172,6,161161.05,5620.92,166781.97
230535,201711,340,255,85,238930.25,79643.66,318573.91
230540,201711,1831,1600,231,1496588.01,216162.04,1712750.05
230550,201711,3612,2312,1300,2158188.55,1216492.98,3374681.53
230560,201711,577,439,138,409271.97,128367.12,537639.09
230565,201711,184,134,50,125554.05,46847.87,172401.92
230570,201711,304,269,35,252051.51,32794.15,284845.66
230580,201711,1088,802,286,750029.86,266758.65,1016788.51
230590,201711,933,725,208,675131.71,194419.16,869550.87
230600,201711,252,230,22,214777.81,20612.74,235390.55
230610,201711,326,262,64,245298.85,59966.95,305265.80
230620,201711,162,133,29,123682.82,27172.9,150855.72
230625,201711,710,514,196,480240.4,182501.98,662742.38
230630,201711,1218,963,255,902090.01,238557.89,1140647.90
230640,201711,3413,2959,454,2765396.94,424633.12,3190030.06
230650,201711,388,340,48,317757.98,44973.29,362731.27
230655,201711,618,538,80,503155.3,74872.67,578027.97
230660,201711,330,275,55,257656.1,51249.37,308905.47
230670,201711,420,376,44,352303.02,41225.39,393528.41
230680,201711,199,183,16,171468.81,14990.42,186459.23
230690,201711,845,736,109,689624.92,102127.88,791752.80
230700,201711,697,594,103,556550.76,95945.93,652496.69
230710,201711,727,685,42,641638.81,39353.28,680992.09
230720,201711,141,119,22,111000.05,20612.63,131612.68
230725,201711,219,172,47,161161.76,44023.9,205185.66
230730,201711,11535,6251,5284,5841716.26,4942754.94,10784471.20
230740,201711,650,519,131,486005.38,122061.85,608067.23
230750,201711,785,669,116,625667.93,108691.02,734358.95
230760,201711,1272,1102,170,1028549.29,159286.2,1187835.49
230763,201711,322,265,57,246372.23,53407.13,299779.36
230765,201711,6708,3115,3593,2912585.87,3364601.61,6277187.48
230770,201711,4948,2534,2414,2364594,2259215.94,4623809.94
230780,201711,675,595,80,554412.52,74957.28,629369.80
230790,201711,187,150,37,140543.98,33880.51,174424.49
230800,201711,1102,805,297,754251.39,278282.81,1032534.20
230810,201711,1258,1118,140,1046566.63,130986.29,1177552.92
230820,201711,321,231,90,215491.55,84324.86,299816.41
230830,201711,932,808,124,753632.39,116185.19,869817.58
230835,201711,274,238,36,222059.89,33021.95,255081.84
230837,201711,161,135,26,126492.2,24359.95,150852.15
230840,201711,873,694,179,649039.52,166498.06,815537.58
230850,201711,1452,1270,182,1189694.4,170247.37,1359941.77
230860,201711,307,225,82,210820.77,75892.67,286713.44
230870,201711,1776,1504,272,1407999.63,253542.87,1661542.50
230880,201711,26,19,7,17801.22,6558.9,24360.12
230890,201711,569,523,46,489926.64,43087.03,533013.67
230900,201711,270,206,64,193015.53,59760.21,252775.74
230910,201711,189,153,36,142608.25,33731.69,176339.94
230920,201711,394,312,82,292333.43,76828.63,369162.06
230930,201711,909,646,263,602478.08,246427.32,848905.40
230940,201711,826,665,161,623091.77,150660.04,773751.81
230945,201711,448,378,70,353987.16,65587.87,419575.03
230950,201711,378,322,56,301707.91,52469.21,354177.12
230960,201711,2436,1645,791,1534710.56,740868.67,2275579.23
230970,201711,1716,976,740,913589.9,692495.56,1606085.46
230980,201711,208,177,31,165845.76,29046.3,194892.06
230990,201711,140,113,27,105880,24555.95,130435.95
231000,201711,201,182,19,168646.86,17799.88,186446.74
231010,201711,131,103,28,95947.58,26235.84,122183.42
231020,201711,1248,870,378,813582.73,354179.86,1167762.59
231025,201711,925,693,232,647202.01,215855.99,863058.00
231030,201711,1141,959,182,898562.39,170249.73,1068812.12
231040,201711,136,93,43,86406.21,39565.1,125971.31
231050,201711,1002,891,111,832310.25,104004.59,936314.84
231060,201711,139,122,17,114311.95,15928.28,130240.23
231070,201711,1394,985,409,920858.68,383215.51,1304074.19
231080,201711,260,243,17,226894.55,15927.95,242822.50
231085,201711,533,335,198,312938.21,185514.43,498452.64
231090,201711,228,193,35,180836.26,32794.76,213631.02
231095,201711,163,129,34,120872.18,31856.12,152728.30
231100,201711,122,101,21,94633.07,18457.43,113090.50
231110,201711,334,290,44,270224.36,41225.93,311450.29
231120,201711,301,258,43,240792.64,40098.8,280891.44
231123,201711,132,126,6,118058.21,5622,123680.21
231126,201711,274,236,38,221125.56,35604.5,256730.06
231130,201711,4521,3517,1004,3286823.94,939475.4,4226299.34
231135,201711,202,174,28,163028.85,24990.45,188019.30
231140,201711,3024,2227,797,2083055.33,745800.79,2828856.12
231150,201711,348,333,15,312015.92,14053.7,326069.62
231160,201711,1195,938,257,875890.21,240580.15,1116470.36
231170,201711,536,348,188,326073.22,176153.64,502226.86
231180,201711,1561,1318,243,1234181.23,227684.59,1461865.82
231190,201711,204,182,22,170513.02,20608.14,191121.16
231195,201711,207,179,28,167003.38,26232.91,193236.29
231200,201711,823,679,144,636214.86,133675.46,769890.32
231210,201711,602,504,98,471302.71,91824.39,563127.10
231220,201711,1018,739,279,691466.1,261420.82,952886.92
231230,201711,1360,1091,269,1020867.3,251292.26,1272159.56
231240,201711,1333,969,364,907627.46,339828.1,1247455.56
231250,201711,107,100,7,93699,6559,100258
231260,201711,294,191,103,178964.41,96228.93,275193.34
231270,201711,984,824,160,767695.62,149909.03,917604.65
231280,201711,54,42,12,39352.56,11242.63,50595.19
231290,201711,7131,3940,3191,3682970.59,2988567.63,6671538.22
231300,201711,621,573,48,536890.91,44974.19,581865.10
231310,201711,691,641,50,599395.46,46850,646245.46
231320,201711,559,434,125,406167.19,117121.71,523288.90
231325,201711,86,75,11,70273.33,10307,80580.33
231330,201711,1985,1545,440,1441413.86,409352.8,1850766.66
231335,201711,246,217,29,203322.39,27173,230495.39
231340,201711,1569,1154,415,1079592.41,388846.01,1468438.42
231350,201711,1127,923,204,864822.68,190576.86,1055399.54
231355,201711,387,336,51,314820.07,47781.76,362601.83
231360,201711,458,363,95,337455.81,89011.83,426467.64
231370,201711,88,71,17,66526.17,15928.35,82454.52
231375,201711,284,206,78,193017.79,73081.93,266099.72
231380,201711,439,355,84,331043.4,78514.33,409557.73
231390,201711,192,158,34,148044.6,31856.98,179901.58
231395,201711,722,442,280,412872.34,262068.89,674941.23
231400,201711,1030,853,177,796713.27,165504.39,962217.66
231410,201711,1278,1028,250,958644.13,233306.66,1191950.79
240010,201711,388,182,206,169397.83,193006.26,362404.09
240020,201711,2167,1681,486,1573213.81,455363.49,2028577.30
240030,201711,151,128,23,119929.08,21549.55,141478.63
240040,201711,33,33,0,30918.29,0,30918.29
240050,201711,496,426,70,398317.15,65587.78,463904.93
240060,201711,68,64,4,59967.56,3748,63715.56
240070,201711,168,128,40,119926.78,37476.6,157403.38
240080,201711,411,270,141,252970.02,132115.39,385085.41
240090,201711,105,93,12,86828.99,11243.13,98072.12
240100,201711,1422,1339,83,1251704.67,77582.62,1329287.29
240110,201711,960,606,354,566152.83,331692.19,897845.02
240120,201711,144,119,25,111497.92,23424.08,134922.00
240130,201711,288,270,18,252284.99,16865.95,269150.94
240140,201711,85,66,19,61838.54,17801.71,79640.25
240145,201711,665,584,81,546682.35,75687.87,622370.22
240150,201711,21,16,5,14990.98,4670.77,19661.75
240160,201711,45,38,7,35605.25,6559,42164.25
240165,201711,37,31,6,28810,5621.36,34431.36
240170,201711,90,71,19,66525.19,17801.58,84326.77
240180,201711,75,61,14,57156.22,13117.11,70273.33
240185,201711,44,40,4,37466.51,3747.2,41213.71
240190,201711,16,14,2,13118,1874,14992
240200,201711,2956,1654,1302,1543698.31,1218716.16,2762414.47
240210,201711,162,127,35,118992.65,32790.06,151782.71
240220,201711,1116,797,319,746775.48,298886.19,1045661.67
240230,201711,809,748,61,698063.97,56517.14,754581.11
240240,201711,124,91,33,85265.12,30921,116186.12
240250,201711,93,82,11,76831.29,10306.8,87138.09
240260,201711,1787,1322,465,1238010.06,434722.28,1672732.34
240270,201711,189,169,20,157966,18737.11,176703.11
240280,201711,43,33,10,30920.12,9368.53,40288.65
240290,201711,52,50,2,46850,1874,48724
240300,201711,182,102,80,95567.62,74950.21,170517.83
240310,201711,1956,1067,889,990033.79,829768.2,1819801.99
240320,201711,209,198,11,185524.06,10307,195831.06
240325,201711,4267,2613,1654,2440855.98,1547635.45,3988491.43
240330,201711,64,61,3,57154.33,2810.86,59965.19
240340,201711,103,74,29,69336.46,27171.73,96508.19
240350,201711,95,83,12,77768.52,11242.98,89011.50
240360,201711,373,270,103,252697.5,96507.17,349204.67
240370,201711,37,35,2,32792.79,1874,34666.79
240375,201711,76,45,31,42163.97,29046.6,71210.57
240380,201711,237,193,44,179941.79,41123.2,221064.99
240390,201711,17,14,3,13118,2810.6,15928.6
240400,201711,80,77,3,72147.91,2811,74958.91
240410,201711,11,7,4,6558.32,3747.36,10305.68
240420,201711,858,663,195,619902.3,181676.38,801578.68
240430,201711,260,245,15,227575.86,14055,241630.86
240440,201711,68,36,32,33729.99,29983.19,63713.18
240450,201711,200,132,68,123113.11,63712.85,186825.96
240460,201711,61,47,14,44035.91,13117.33,57153.24
240470,201711,233,201,32,187784.74,29983.43,217768.17
240480,201711,15,15,0,13959.26,0,13959.26
240485,201711,72,62,10,57806.37,9369.33,67175.70
240490,201711,45,45,0,41954.53,0,41954.53
240500,201711,83,67,16,62776.64,14991,77767.64
240510,201711,49,35,14,32791.95,13115.19,45907.14
240520,201711,128,122,6,114311.88,5622,119933.88
240530,201711,50,44,6,41223.61,5621.5,46845.11
240540,201711,78,67,11,62774.64,10162.12,72936.76
240550,201711,15,13,2,12179.26,1874,14053.26
240560,201711,367,271,96,253303.03,89948.92,343251.95
240570,201711,465,288,177,268729.8,165847.66,434577.46
240580,201711,1260,1017,243,946760.04,226529.8,1173289.84
240590,201711,31,28,3,26236,2810.03,29046.03
240600,201711,114,114,0,106815.43,0,106815.43
240610,201711,510,425,85,397653.89,78884.22,476538.11
240615,201711,35,34,1,31858,937,32795
240620,201711,95,91,4,84319.45,3747.8,88067.25
240630,201711,36,35,1,32793.4,937,33730.4
240640,201711,27,23,4,21551,3746.86,25297.86
240650,201711,235,198,37,184662.83,34668.46,219331.29
240660,201711,96,84,12,78701.01,11243.5,89944.51
240670,201711,283,167,116,154411.08,108691.6,263102.68
240680,201711,50,38,12,35604.08,11243.17,46847.25
240690,201711,51,48,3,44975.03,2811,47786.03
240700,201711,195,163,32,152724.22,29981.12,182705.34
240710,201711,1888,1200,688,1123699.46,643798.54,1767498.00
240720,201711,1026,750,276,701774.8,258597.57,960372.37
240725,201711,66,63,3,59028.12,2810.2,61838.32
240730,201711,130,115,15,107748.24,14054.03,121802.27
240740,201711,234,198,36,184184.31,33730.89,217915.20
240750,201711,34,21,13,19674.66,12180.4,31855.06
240760,201711,32,28,4,26236,3747.33,29983.33
240770,201711,147,112,35,104938.29,32789.99,137728.28
240780,201711,699,583,116,544572.3,108691.11,653263.41
240790,201711,38,36,2,33730.07,1874,35604.07
240800,201711,8463,5726,2737,5327203.53,2557427.63,7884631.16
240810,201711,19844,10881,8963,10153229.66,8388522.44,18541752.10
240820,201711,191,123,68,114579.87,63710.28,178290.15
240830,201711,1582,1302,280,1213509.13,261403.74,1474912.87
240840,201711,80,70,10,65588.78,9370,74958.78
240850,201711,86,75,11,70270.46,10307,80577.46
240860,201711,114,111,3,104003.61,2810.04,106813.65
240870,201711,54,47,7,44034.02,6559,50593.02
240880,201711,26,25,1,23413.5,937,24350.5
240890,201711,1134,666,468,620161.93,438499.84,1058661.77
240895,201711,44,34,10,31856.84,9370,41226.84
240910,201711,149,134,15,125552.71,14053.38,139606.09
240920,201711,17,13,4,12181,3748,15929
240930,201711,369,333,36,311077.48,33731.22,344808.70
240933,201711,26,18,8,16861.23,7493.51,24354.74
240940,201711,2404,2125,279,1978755.46,258583.71,2237339.17
240950,201711,48,47,1,44038.18,937,44975.18
240960,201711,33,25,8,23425,7496,30921
240970,201711,135,98,37,91825.06,33930.86,125755.92
240980,201711,189,150,39,140542.44,36540.34,177082.78
240990,201711,121,81,40,75891.13,37477.15,113368.28
241000,201711,79,71,8,66525.32,7496,74021.32
241010,201711,57,45,12,42160.57,11242.32,53402.89
241020,201711,111,104,7,97445.7,6559,104004.7
241025,201711,8,3,5,2811,4685,7496
241030,201711,119,97,22,90884.25,20612.88,111497.13
241040,201711,31,27,4,25298.07,3748,29046.07
241050,201711,93,79,14,74021.05,13117.78,87138.83
241060,201711,32,29,3,27171.85,2810.06,29981.91
241070,201711,16,16,0,14991.93,0,14991.93
241080,201711,66,58,8,54062.01,7496,61558.01
241090,201711,49,41,8,38415.97,7481.08,45897.05
241100,201711,76,67,9,62776.14,8432.26,71208.40
241105,201711,7,3,4,2811,3748,6559
241110,201711,50,48,2,44973.69,1874,46847.69
241120,201711,1405,1089,316,1017425.22,295217.46,1312642.68
241140,201711,228,185,43,172395.07,40290.98,212686.05
241142,201711,42,41,1,38416.16,937,39353.16
241150,201711,1203,1056,147,986777.67,137733.63,1124511.30
241160,201711,24,23,1,21547.1,936.93,22484.03
241170,201711,42,39,3,36540.84,2810.89,39351.73
241180,201711,52,42,10,39181.24,9369.69,48550.93
241190,201711,42,41,1,38415.62,937,39352.62
241200,201711,3801,2085,1716,1948899.44,1605935.68,3554835.12
241210,201711,72,60,12,56217.49,10398,66615.49
241220,201711,1353,898,455,840879.34,426292.91,1267172.25
241230,201711,241,203,38,190019.22,35605.48,225624.70
241240,201711,50,38,12,35603.92,11243.06,46846.98
241250,201711,1072,999,73,935734.92,68114.07,1003848.99
241255,201711,45,36,9,33730.07,8431.66,42161.73
241260,201711,625,492,133,460993.33,124619.08,585612.41
241270,201711,46,32,14,29980.3,13116.58,43096.88
241280,201711,98,86,12,80581.63,11243.66,91825.29
241290,201711,108,80,28,74959.23,26234.03,101193.26
241300,201711,79,56,23,52468.78,21549.92,74018.70
241310,201711,52,39,13,36394.86,12180.17,48575.03
241320,201711,28,15,13,14055,12181,26236
241330,201711,59,53,6,49656.18,5620.45,55276.63
241335,201711,60,53,7,49096.71,6559,55655.71
241340,201711,186,141,45,132106.33,42164.16,174270.49
241350,201711,57,52,5,48721.3,4684.43,53405.73
241355,201711,43,40,3,37478.21,2811,40289.21
241360,201711,46,46,0,43097.96,0,43097.96
241370,201711,45,37,8,34546.49,7495.33,42041.82
241380,201711,44,42,2,39353.8,1874,41227.8
241390,201711,77,62,15,57902.56,14053.55,71956.11
241400,201711,188,155,33,144559.56,30919.32,175478.88
241410,201711,185,167,18,156475.09,16763.92,173239.01
241415,201711,93,74,19,69328.18,17802.42,87130.60
241420,201711,95,73,22,68400.05,20437.33,88837.38
241430,201711,28,27,1,25298.22,937,26235.22
241440,201711,452,385,67,360719.28,62778.13,423497.41
241445,201711,35,33,2,30918.55,1873.6,32792.15
241450,201711,277,227,50,212562.61,46849.29,259411.90
241460,201711,135,122,13,114075.79,12181,126256.79
241470,201711,45,36,9,33729.09,8432.86,42161.95
241475,201711,64,60,4,56218.76,3747.53,59966.29
241480,201711,95,68,27,63711.93,25298.66,89010.59
241490,201711,9,8,1,7496,937,8433
241500,201711,49,36,13,33731.4,12181,45912.4
250010,201711,102,89,13,83391.61,12180.2,95571.81
250020,201711,24,21,3,19677,2811,22488
250030,201711,812,596,216,557115.47,200532.2,757647.67
250040,201711,320,267,53,250176.76,49659.94,299836.70
250050,201711,227,189,38,176520.82,35603.66,212124.48
250053,201711,54,42,12,39354,11244,50598
250057,201711,0,0,0,0,0,0
250060,201711,450,344,106,322320.22,99038.21,421358.43
250070,201711,682,579,103,540534.94,96507.61,637042.55
250073,201711,7,7,0,6559,0,6559
250077,201711,207,153,54,142965.38,50596.94,193562.32
250080,201711,419,327,92,304791.81,86203.14,390994.95
250090,201711,209,138,71,128362.36,65669.84,194032.20
250100,201711,463,379,84,355116.31,78325.69,433442.00
250110,201711,478,365,113,340240.61,105875.81,446116.42
250115,201711,28,8,20,7496,18740,26236
250120,201711,109,83,26,77769.24,24359.54,102128.78
250130,201711,583,459,124,430077.98,115995.81,546073.79
250135,201711,14,8,6,7496,5621.24,13117.24
250140,201711,73,63,10,59029.95,9369.17,68399.12
250150,201711,557,412,145,383891.05,135551.7,519442.75
250153,201711,11,10,1,9370,937,10307
250157,201711,30,25,5,23425,4685,28110
250160,201711,211,166,45,155539.65,42164.89,197704.54
250170,201711,68,48,20,44976,18740,63716
250180,201711,3958,2671,1287,2487869.49,1200816.17,3688685.66
250190,201711,911,600,311,560557.03,290700.96,851257.99
250200,201711,51,44,7,41227.2,6559,47786.2
250205,201711,20,17,3,15929,2811,18740
250210,201711,89,77,12,72145.97,11244,83389.97
250215,201711,61,53,8,49659.42,7494.63,57154.05
250220,201711,27,21,6,19677,5622,25299
250230,201711,72,66,6,61838.63,5621.3,67459.93
250240,201711,239,197,42,183787.25,39351.45,223138.70
250250,201711,385,330,55,309209.04,51534.17,360743.21
250260,201711,32,26,6,24361.49,5622,29983.49
250270,201711,59,46,13,43100.09,12180.03,55280.12
250280,201711,386,324,62,303586.99,58093.83,361680.82
250290,201711,92,87,5,81233.78,4685,85918.78
250300,201711,559,386,173,361044.23,162075.38,523119.61
250310,201711,48,41,7,38416,6559,44975
250320,201711,1890,1295,595,1206824.44,555945.83,1762770.27
250330,201711,84,73,11,68397.99,10306.7,78704.69
250340,201711,26,22,4,20612.36,3748,24360.36
250350,201711,137,86,51,80296.35,47224.02,127520.37
250355,201711,26,21,5,19675.8,4685,24360.8
250360,201711,200,163,37,152729.09,34430.19,187159.28
250370,201711,2349,1595,754,1488658.77,704949.37,2193608.14
250375,201711,20,16,4,14992,3748,18740
250380,201711,50,35,15,32793.1,14055,46848.1
250390,201711,39,33,6,30921,5621.89,36542.89
250400,201711,15571,7894,7677,7374110.66,7186223.21,14560333.87
250403,201711,427,346,81,324189.99,75894.44,400084.43
250407,201711,52,46,6,43102,5622,48724
250410,201711,28,23,5,21551,4685,26236
250415,201711,43,28,15,26233.76,14035.26,40269.02
250420,201711,48,39,9,36541.56,8433,44974.56
250430,201711,1670,1405,265,1314302.26,248302.74,1562605.00
250435,201711,18,15,3,14055,2811,16866
250440,201711,686,593,93,552690.5,87139.85,639830.35
250450,201711,86,72,14,67463.64,12461.36,79925.00
250460,201711,413,278,135,260486,126355.84,386841.84
250470,201711,87,64,23,59966.23,21550.99,81517.22
250480,201711,319,251,68,235186.4,63715.06,298901.46
250485,201711,2,1,1,937,937,1874
250490,201711,201,163,38,152730.07,35605.8,188335.87
250500,201711,75,54,21,50597.52,19676.65,70274.17
250510,201711,728,570,158,532757.54,147050.52,679808.06
250520,201711,172,120,52,112419.94,48719.32,161139.26
250523,201711,109,91,18,85265.78,16866,102131.78
250527,201711,104,80,24,74955.32,22486.32,97441.64
250530,201711,7,5,2,4684.55,1874,6558.55
250535,201711,25,21,4,19676.56,3748,23424.56
250540,201711,125,95,30,88312.16,28108.79,116420.95
250550,201711,69,66,3,61842,2811,64653
250560,201711,34,28,6,26234.25,5621.66,31855.91
250570,201711,152,120,32,112438.71,29982.59,142421.30
250580,201711,136,106,30,99040.9,28108.73,127149.63
250590,201711,20,16,4,14992,3748,18740
250600,201711,1303,883,420,824518.61,393423,1217941.61
250610,201711,152,131,21,122746,19677,142423
250620,201711,20,16,4,14991.93,3748,18739.93
250625,201711,61,46,15,43102,14055,57157
250630,201711,3013,1923,1090,1793792.22,1019928.3,2813720.52
250640,201711,202,168,34,157413.16,31858,189271.16
250650,201711,31,21,10,19677,9370,29047
250660,201711,40,31,9,29045.84,8431.75,37477.59
250670,201711,56,36,20,33732,18739.1,52471.1
250680,201711,387,316,71,296091.3,66526.61,362617.91
250690,201711,1784,1225,559,1144389.41,523381.79,1667771.20
250700,201711,953,835,118,777976.15,110354.84,888330.99
250710,201711,446,344,102,322327.66,95572.73,417900.39
250720,201711,101,80,21,74957.57,19675.08,94632.65
250730,201711,372,312,60,291118.34,56218.23,347336.57
250740,201711,48,45,3,42162.8,2811,44973.8
250750,201711,20004,11957,8047,11147989.28,7531238.1,18679227.38
250760,201711,67,50,17,46850,15925.65,62775.65
250770,201711,344,230,114,214564.82,105668.36,320233.18
250780,201711,57,44,13,41227.32,12180.93,53408.25
250790,201711,485,312,173,289514.87,161396.33,450911.20
250800,201711,152,141,11,131410.07,10307,141717.07
250810,201711,81,61,20,57157,18739.46,75896.46
250820,201711,158,126,32,118061.66,29982.74,148044.40
250830,201711,426,285,141,266058.82,132115.49,398174.31
250840,201711,55,52,3,48723.66,2811,51534.66
250850,201711,51,39,12,35867.58,11243.33,47110.91
250855,201711,13,11,2,10307,1874,12181
250860,201711,204,144,60,134925.51,55935.35,190860.86
250870,201711,33,30,3,28110,2811,30921
250880,201711,78,58,20,54297.15,18738.56,73035.71
250890,201711,2352,1730,622,1619684.6,581952.27,2201636.87
250900,201711,88,72,16,67458.58,14992,82450.58
250905,201711,132,103,29,96509.23,27173,123682.23
250910,201711,1164,828,336,774682.92,314547.28,1089230.20
250915,201711,111,76,35,71211,32792.67,104003.67
250920,201711,140,107,33,100254.97,30919.54,131174.51
250930,201711,158,99,59,92760.84,55278.71,148039.55
250933,201711,0,0,0,0,0,0
250937,201711,7,6,1,5622,937,6559
250939,201711,30,23,7,21551,6558.85,28109.85
250940,201711,109,83,26,77766.22,24362,102128.22
250950,201711,71,47,24,44037.79,22487.08,66524.87
250960,201711,90,49,41,45912.56,38415.39,84327.95
250970,201711,1201,854,347,798587.23,324639.02,1123226.25
250980,201711,92,65,27,60902.09,25297.59,86199.68
250990,201711,163,127,36,118559.25,33688.14,152247.39
251000,201711,72,66,6,61652.54,5622,67274.54
251010,201711,94,74,20,69321.36,17974.77,87296.13
251020,201711,83,72,11,66665.55,10307,76972.55
251030,201711,42,32,10,29982.16,9369.53,39351.69
251040,201711,54,39,15,36542.63,14054.33,50596.96
251050,201711,25,23,2,21551,1874,23425
251060,201711,48,39,9,35606,8433,44039
251065,201711,3,3,0,2811,0,2811
251070,201711,26,21,5,19663,4685,24348
251080,201711,4688,2263,2425,2108100.67,2265683.4,4373784.07
251090,201711,197,169,28,158352.89,26236,184588.89
251100,201711,18,17,1,15928.33,937,16865.33
251110,201711,48,38,10,35604.98,9370,44974.98
251120,201711,1759,1049,710,977902.09,665256.71,1643158.80
251130,201711,350,283,67,265167.28,62777.38,327944.66
251140,201711,508,329,179,307123.34,167552.97,474676.31
251150,201711,294,254,40,237224.67,37479.34,274704.01
251160,201711,90,75,15,70260.96,14055,84315.96
251170,201711,102,83,19,77742.25,17797.69,95539.94
251180,201711,288,181,107,169586.99,100241.03,269828.02
251190,201711,194,133,61,124296.14,57156.13,181452.27
251200,201711,255,205,50,192082.5,46849.73,238932.23
251203,201711,33,31,2,29044.13,1874,30918.13
251207,201711,94,77,17,72147,15929,88076
251210,201711,1246,886,360,828636.36,336656.86,1165293.22
251220,201711,45,34,11,31856.99,10307,42163.99
251230,201711,493,416,77,389786.77,72147.63,461934.40
251240,201711,103,73,30,67461.38,28110,95571.38
251250,201711,1324,951,373,888662.64,349343.57,1238006.21
251260,201711,13,8,5,7496,4685,12181
251270,201711,339,249,90,233310.74,84180.32,317491.06
251272,201711,69,63,6,59030.79,5622,64652.79
251274,201711,28,23,5,21551,4685,26236
251275,201711,22,15,7,14054.74,6558.59,20613.33
251276,201711,18,15,3,14055,2811,16866
251278,201711,9,7,2,6559,1874,8433
251280,201711,92,88,4,82448.42,3747.86,86196.28
251290,201711,692,522,170,489110.87,159284.26,648395.13
251300,201711,17,15,2,14055,1874,15929
251310,201711,355,257,98,240794.94,91822.94,332617.88
251315,201711,15,14,1,13117.49,937,14054.49
251320,201711,61,49,12,45911.54,11244,57155.54
251330,201711,78,69,9,64651.39,8433,73084.39
251335,201711,9,5,4,4685,3748,8433
251340,201711,685,406,279,380416.46,260397.32,640813.78
251350,201711,33,31,2,29046.38,1874,30920.38
251360,201711,65,56,9,52269.61,8432.68,60702.29
251365,201711,14,14,0,13118,0,13118
251370,201711,5246,3562,1684,3332976.91,1576534.74,4909511.65
251380,201711,50,39,11,36543,10307,46850
251385,201711,2,2,0,1874,0,1874
251390,201711,653,520,133,486098.43,123400.58,609499.01
251392,201711,31,21,10,19675.52,9370,29045.52
251394,201711,9,9,0,8433,0,8433
251396,201711,18,14,4,13118,3748,16866
251398,201711,17,15,2,14055,1874,15929
251400,201711,37,30,7,28110,6558.72,34668.72
251410,201711,34,29,5,27172.19,4685,31857.19
251420,201711,109,83,26,77771,24362,102133
251430,201711,37,35,2,32793.22,1874,34667.22
251440,201711,37,23,14,21538,13118,34656
251445,201711,51,46,5,43101.14,4685,47786.14
251450,201711,412,365,47,340361.68,44039,384400.68
251455,201711,2,1,1,937,937,1874
251460,201711,16,12,4,11244,3748,14992
251465,201711,5,2,3,1874,2811,4685
251470,201711,44,36,8,33730.66,7495.46,41226.12
251480,201711,24,22,2,20614,1874,22488
251490,201711,129,91,38,84793.72,34658,119451.72
251500,201711,114,92,22,86202.75,19856.59,106059.34
251510,201711,34,26,8,24362,7496,31858
251520,201711,25,25,0,23423.38,0,23423.38
251530,201711,4540,3187,1353,2979981.75,1267455.76,4247437.51
251540,201711,74,66,8,61841.66,7496,69337.66
251550,201711,417,322,95,300769.28,88779,389548.28
251560,201711,21,16,5,14992,4685,19677
251570,201711,18,18,0,16865.08,0,16865.08
251580,201711,119,96,23,89951.51,21550.47,111501.98
251590,201711,128,94,34,88076.91,31858,119934.91
251593,201711,18,10,8,9368.59,7496,16864.59
251597,201711,61,50,11,46848.16,10307,57155.16
251600,201711,1098,780,318,729317.16,296256.11,1025573.27
251610,201711,210,158,52,147387.99,48057.06,195445.05
251615,201711,2,2,0,1874,0,1874
251620,201711,4236,2845,1391,2656800.16,1300891.36,3957691.52
251630,201711,435,323,112,302642.75,104659.67,407302.42
251640,201711,149,106,43,99320.63,40290.78,139611.41
251650,201711,261,190,71,176222.12,66523.53,242745.65
251660,201711,221,202,19,188329.01,17615.09,205944.10
251670,201711,357,281,76,261718.31,71210.39,332928.70
251675,201711,3,3,0,2811,0,2811
251680,201711,87,80,7,74959.8,6558.15,81517.95
251690,201711,337,283,54,265168.03,50253.22,315421.25
251700,201711,281,233,48,217741.72,44961.61,262703.33
251710,201711,18,12,6,11244,5621.63,16865.63
251720,201711,34,23,11,21551,10025,31576
251740,201711,9,7,2,6559,1874,8433
260005,201711,3070,1751,1319,1630367.01,1234699.9,2865066.91
260010,201711,1382,991,391,924704.86,364385.48,1289090.34
260020,201711,434,382,52,357928.3,48722.76,406651.06
260030,201711,575,413,162,386210.94,151790.4,538001.34
260040,201711,859,522,337,487236.48,315611.26,802847.74
260050,201711,1117,791,326,740921.44,304897.23,1045818.67
260060,201711,415,374,41,350434.73,38415.99,388850.72
260070,201711,1439,904,535,842979.26,499299.09,1342278.35
260080,201711,729,571,158,533794.91,148042.7,681837.61
260090,201711,567,354,213,331457.05,199577.39,531034.44
260100,201711,224,156,68,145181.4,63715.03,208896.43
260105,201711,239,133,106,124617.75,99321.23,223938.98
260110,201711,2717,2025,692,1897362.82,647592.22,2544955.04
260120,201711,2849,1455,1394,1352896.11,1303825.13,2656721.24
260130,201711,147,100,47,93692.51,44037.16,137729.67
260140,201711,2072,1353,719,1259286.64,672142.54,1931429.18
260150,201711,227,148,79,138674.87,74022.23,212697.10
260160,201711,295,256,39,239862,36541.64,276403.64
260170,201711,3327,2036,1291,1898326.9,1208551.84,3106878.74
260180,201711,139,120,19,112432.21,17800.85,130233.06
260190,201711,2258,1610,648,1505449.67,607163.56,2112613.23
260200,201711,879,732,147,685096.77,137452.51,822549.28
260210,201711,1395,979,416,917160.72,388548.35,1305709.07
260220,201711,714,653,61,611081.79,57156.22,668238.01
260230,201711,1193,902,291,842979.25,272658.16,1115637.41
260240,201711,213,160,53,148764.35,49660.93,198425.28
260250,201711,73,58,15,54336.46,14054.16,68390.62
260260,201711,975,699,276,654949.02,258606.48,913555.50
260270,201711,437,354,83,329252.02,77487.98,406740.00
260280,201711,1218,869,349,813479.11,326669.47,1140148.58
260290,201711,6301,3332,2969,3103456.78,2775875.48,5879332.26
260300,201711,826,728,98,680051.3,91539.23,771590.53
260310,201711,496,395,101,368090.08,94632.81,462722.89
260320,201711,882,666,216,623754.27,202387.02,826141.29
260330,201711,29,23,6,21551,5621.36,27172.36
260340,201711,66,47,19,44038.92,17803,61841.92
260345,201711,5562,3133,2429,2929201.76,2274641.13,5203842.89
260350,201711,466,340,126,316861.78,117113.57,433975.35
260360,201711,282,145,137,135860.16,128368.22,264228.38
260370,201711,642,418,224,389084.12,209729.68,598813.80
260380,201711,600,431,169,403839.6,157217.8,561057.4
260390,201711,293,250,43,233067.86,39353.9,272421.76
260392,201711,94,82,12,76831.5,11242.68,88074.18
260400,201711,4106,2352,1754,2193526.42,1643111.37,3836637.79
260410,201711,14071,7657,6414,7159997.57,6006997.28,13166994.85
260415,201711,123,110,13,103068.59,12181,115249.59
260420,201711,1775,1049,726,977717.52,678195.31,1655912.83
260430,201711,188,172,16,159961.59,14990.91,174952.50
260440,201711,230,166,64,154817.43,59968,214785.43
260450,201711,477,344,133,321045.46,124619.26,445664.72
260460,201711,849,451,398,419937.71,372919.18,792856.89
260470,201711,370,223,147,208196.28,136837.93,345034.21
260480,201711,200,123,77,115243.67,72146.42,187390.09
260490,201711,205,165,40,154600.86,37479.15,192080.01
260500,201711,1120,748,372,697980.36,347469.39,1045449.75
260510,201711,719,565,154,529388.67,143356.67,672745.34
260515,201711,255,226,29,211753.44,26697.61,238451.05
260520,201711,3284,1936,1348,1806331.97,1261153.2,3067485.17
260530,201711,758,616,142,574397.9,133051.95,707449.85
260540,201711,577,431,146,403834.71,135854.68,539689.39
260545,201711,14,10,4,9370,3748,13118
260550,201711,331,205,126,192078.41,118060.79,310139.20
260560,201711,516,390,126,364835.16,117775.63,482610.79
260570,201711,999,824,175,769108.25,163967.96,933076.21
260580,201711,276,247,29,231427.72,27172.22,258599.94
260590,201711,651,370,281,345288.61,263284.84,608573.45
260600,201711,8256,4118,4138,3834316.4,3873876.79,7708193.19
260610,201711,495,329,166,308266.87,155251.6,463518.47
260620,201711,3563,1874,1689,1745103.52,1577630.38,3322733.90
260630,201711,71,68,3,63712.76,2810.33,66523.09
260640,201711,3611,1979,1632,1850992.35,1528791.95,3379784.30
260650,201711,336,231,105,216447,98339.86,314786.86
260660,201711,493,336,157,314446.89,146496.43,460943.32
260670,201711,102,76,26,71208.88,24360.5,95569.38
260680,201711,3665,2037,1628,1891017.47,1523450.06,3414467.53
260690,201711,131,99,32,92755.16,29983.5,122738.66
260700,201711,331,200,131,186644.85,121930,308574.85
260710,201711,36,34,2,31856.85,1874,33730.85
260720,201711,2186,1317,869,1228181.34,813164.71,2041346.05
260730,201711,585,440,145,412238.79,133691.79,545930.58
260740,201711,63,59,4,55281.95,3748,59029.95
260750,201711,644,449,195,420109.64,182712.23,602821.87
260760,201711,627,344,283,322318.56,264846.8,587165.36
260765,201711,986,518,468,482311.31,438273.81,920585.12
260770,201711,221,165,56,154601.25,52471.07,207072.32
260775,201711,810,480,330,448382.74,309193.93,757576.67
260780,201711,263,167,96,156471.52,89816.54,246288.06
260790,201711,12461,6828,5633,6369985.99,5270772.86,11640758.85
260795,201711,157,107,50,99854.97,46845.1,146700.07
260800,201711,320,263,57,245946.22,53408.93,299355.15
260805,201711,187,122,65,113594.03,60902.76,174496.79
260810,201711,741,647,94,605005.49,88074.73,693080.22
260820,201711,312,209,103,194505.22,96509.36,291014.58
260825,201711,203,138,65,128933.5,60902.04,189835.54
260830,201711,259,167,92,156335.48,86201.81,242537.29
260840,201711,228,165,63,153934.58,58746.81,212681.39
260845,201711,212,150,62,140266.35,58091.67,198358.02
260850,201711,513,372,141,346915.45,132114.11,479029.56
260860,201711,253,188,65,175958.38,60903.52,236861.90
260870,201711,365,258,107,241730.32,100257.66,341987.98
260875,201711,687,477,210,445838.63,196764.72,642603.35
260880,201711,1499,931,568,871604.44,531958.09,1403562.53
260890,201711,2453,1718,735,1602251.9,687735.11,2289987.01
260900,201711,1032,699,333,653661.72,312014.5,965676.22
260910,201711,273,214,59,200513.99,55281.39,255795.38
260915,201711,305,202,103,189265.01,96388.9,285653.91
260920,201711,171,98,73,91818.45,68396.55,160215.00
260930,201711,396,338,58,316700.24,54257.86,370958.10
260940,201711,2737,1507,1230,1408075.82,1151728.88,2559804.70
260950,201711,1929,1124,805,1046773.12,754282.4,1801055.52
260960,201711,14234,7395,6839,6892703.27,6401023.4,13293726.67
260970,201711,430,369,61,345747.62,57156.18,402903.80
260980,201711,199,174,25,162732.89,23423.48,186156.37
260990,201711,2528,2081,447,1949360.07,418831.64,2368191.71
261000,201711,4304,2534,1770,2361617.66,1656870.99,4018488.65
261010,201711,185,133,52,124620.45,47920.46,172540.91
261020,201711,614,454,160,425227.11,149117.33,574344.44
261030,201711,212,153,59,143356.44,55080.07,198436.51
261040,201711,363,327,36,306391.73,33449.24,339840.97
261050,201711,463,409,54,383222.71,50597.67,433820.38
261060,201711,1318,864,454,807429.68,425387.66,1232817.34
261070,201711,8962,4596,4366,4281844.84,4082030.4,8363875.24
261080,201711,386,297,89,277525.32,83392.15,360917.47
261090,201711,2188,1683,505,1568564.95,472411.57,2040976.52
261100,201711,1085,773,312,721978.4,290501.43,1012479.83
261110,201711,8017,4903,3114,4588750.13,2915492.2,7504242.33
261120,201711,280,232,48,217073.96,44958.78,262032.74
261130,201711,573,329,244,307938.38,228628,536566.38
261140,201711,188,121,67,113372.16,62776.17,176148.33
261150,201711,657,380,277,355576.93,258885.79,614462.72
261153,201711,74,71,3,65584.22,2811,68395.22
261160,201711,76448,38877,37571,36308045.03,35177663.76,71485708.79
261170,201711,445,331,114,309208.89,106804.99,416013.88
261180,201711,1763,1073,690,1000499.31,646515.49,1647014.80
261190,201711,614,423,191,395928.95,178948.4,574877.35
261200,201711,211,186,25,173574.87,23422.67,196997.54
261210,201711,34,30,4,28108.41,3746.52,31854.93
261220,201711,2477,1737,740,1621981.26,692230.02,2314211.28
261230,201711,312,232,80,217379.73,74942.95,292322.68
261240,201711,443,384,59,355847.35,55279.25,411126.60
261245,201711,220,185,35,173340.13,32793.03,206133.16
261247,201711,149,111,38,104000.76,35602.76,139603.52
261250,201711,2801,1391,1410,1302736.75,1320030.15,2622766.90
261255,201711,253,231,22,216439.06,20614,237053.06
261260,201711,847,728,119,682118.79,111501.45,793620.24
261270,201711,174,134,40,125549.06,37479.63,163028.69
261280,201711,149,120,29,112435.51,27172.83,139608.34
261290,201711,130,91,39,85031.71,36543,121574.71
261300,201711,1222,866,356,811416.29,333561.28,1144977.57
261310,201711,750,502,248,470353.06,231758.25,702111.31
261320,201711,531,357,174,334500.45,163030.86,497531.31
261330,201711,813,643,170,599507.71,158458.79,757966.50
261340,201711,313,174,139,163035.27,130241.84,293277.11
261350,201711,774,551,223,515341.7,208947.59,724289.29
261360,201711,1187,757,430,708876.45,402889.79,1111766.24
261370,201711,4918,3024,1894,2817389.36,1771438.32,4588827.68
261380,201711,574,420,154,391663.15,144014.96,535678.11
261390,201711,3403,2274,1129,2125983.49,1054042.11,3180025.60
261400,201711,281,256,25,239017.75,23424.5,262442.25
261410,201711,1043,687,356,643698.15,333552.48,977250.63
261420,201711,866,536,330,500305.74,309181.62,809487.36
261430,201711,330,300,30,280260.49,27828.4,308088.89
261440,201711,100,89,11,83389.02,10307,93696.02
261450,201711,2490,2072,418,1938991.8,390656.5,2329648.3
261460,201711,703,557,146,520943.61,136798.7,657742.31
261470,201711,245,186,59,173471.76,55279.93,228751.69
261480,201711,340,281,59,261857.27,55268.7,317125.97
261485,201711,341,208,133,194230.78,124613.85,318844.63
261500,201711,628,422,206,395406.02,193015.74,588421.76
261510,201711,40,29,11,27171.81,10307,37478.81
261520,201711,172,157,15,147099.75,14054.56,161154.31
261530,201711,4161,2638,1523,2463638.2,1425779.23,3889417.43
261540,201711,1067,653,414,611383.97,387914.12,999298.09
261550,201711,285,140,145,129811.1,135841.04,265652.14
261560,201711,782,518,264,482157.76,245943.62,728101.38
261570,201711,365,285,80,267038.01,74959.33,341997.34
261580,201711,374,292,82,272846.15,76831.09,349677.24
261590,201711,192,155,37,145231.81,34669,179900.81
261600,201711,285,229,56,213813.44,51997.52,265810.96
261610,201711,101,87,14,81170.25,13118,94288.25
261618,201711,66,51,15,47783.5,14055,61838.5
261620,201711,209,127,82,118991.05,76830.38,195821.43
261630,201711,591,451,140,420265.25,131172.8,551438.05
261640,201711,6250,3334,2916,3116364.95,2729425.85,5845790.80
261650,201711,476,297,179,277605.55,167718.74,445324.29
270010,201711,518,452,66,423222.38,61086,484308.38
270020,201711,303,238,65,222988.33,60904.12,283892.45
270030,201711,9082,5786,3296,5408516.79,3085639.72,8494156.51
270040,201711,1927,1179,748,1104122.63,700572,1804694.63
270050,201711,178,132,46,123684,43101.46,166785.46
270060,201711,120,66,54,61842,50597.26,112439.26
270070,201711,903,650,253,607063.23,236743.59,843806.82
270080,201711,42,35,7,32795,6559,39354
270090,201711,20,16,4,14992,3747.2,18739.2
270100,201711,1275,831,444,774863.82,413905.48,1188769.30
270110,201711,160,118,42,110565.2,39354,149919.2
270120,201711,225,184,41,171566.83,38135.06,209701.89
270130,201711,262,183,79,171184.49,73739.65,244924.14
270135,201711,96,58,38,54345.12,35605.78,89950.90
270140,201711,1254,754,500,706289.34,466976.18,1173265.52
270150,201711,267,215,52,201453.33,48724,250177.33
270160,201711,518,381,137,356985.43,127706.68,484692.11
270170,201711,693,437,256,408613.7,239064.78,647678.48
270180,201711,72,54,18,50284.71,16659.86,66944.57
270190,201711,105,92,13,86198.3,12180.73,98379.03
270200,201711,108,96,12,89764.6,11243.8,101008.4
270210,201711,486,250,236,234245.74,220845,455090.74
270220,201711,193,155,38,145235,35606,180841
270230,201711,2090,1239,851,1154449.87,794542.94,1948992.81
270235,201711,736,550,186,514980.76,173894.8,688875.56
270240,201711,3082,2373,709,2212277.14,660849.56,2873126.70
270250,201711,174,121,53,112624.41,49659.13,162283.54
270255,201711,223,194,29,181775.15,26797.19,208572.34
270260,201711,320,255,65,238930.96,60904.46,299835.42
270270,201711,117,48,69,44961.36,64650.76,109612.12
270280,201711,216,136,80,127431.53,74957.06,202388.59
270290,201711,1153,864,289,808493.27,269908.62,1078401.89
270300,201711,264,167,97,156472.48,90602.89,247075.37
270310,201711,936,749,187,699583.99,174506.91,874090.90
270320,201711,891,757,134,707925.37,125556.06,833481.43
270330,201711,268,220,48,205185.35,44974.55,250159.90
270340,201711,61,48,13,44973.62,12181,57154.62
270350,201711,94,48,46,44974.45,43101.52,88075.97
270360,201711,74,39,35,36542,32794.33,69336.33
270370,201711,50,37,13,34668.45,12181,46849.45
270375,201711,62,33,29,30921,27160.14,58081.14
270380,201711,1075,597,478,558442.29,447874.41,1006316.70
270390,201711,198,105,93,98385,87139.55,185524.55
270400,201711,703,507,196,473842.9,183637.27,657480.17
270410,201711,700,495,205,463809.6,192075.43,655885.03
270420,201711,394,253,141,235378.42,132006.95,367385.37
270430,201711,31946,22731,9215,21243296.85,8625937.56,29869234.41
270440,201711,497,385,112,359754.47,104660.74,464415.21
270450,201711,766,398,368,372682.65,344800.67,717483.32
270460,201711,201,150,51,140549.15,47787,188336.15
270470,201711,1331,879,452,823257.04,423521.99,1246779.03
270480,201711,521,418,103,388061.09,95806.37,483867.46
270490,201711,26,21,5,19675.19,4685,24360.19
270500,201711,513,418,95,391643.18,89012,480655.18
270510,201711,736,453,283,424452.52,265162.99,689615.51
270520,201711,398,240,158,224531.45,148046,372577.45
270530,201711,65,57,8,53408.86,7495.83,60904.69
270540,201711,125,96,29,89949.44,27173,117122.44
270550,201711,1737,1316,421,1231786.92,394460.32,1626247.24
270560,201711,319,144,175,134927.13,163973.76,298900.89
270570,201711,446,289,157,269968.21,147105.1,417073.31
270580,201711,73,52,21,48720.47,19676.66,68397.13
270590,201711,82,68,14,63716,13117.66,76833.66
270600,201711,181,148,33,138673.96,30920.66,169594.62
270610,201711,172,136,36,127413.25,33731.36,161144.61
270620,201711,31,30,1,28110,937,29047
270630,201711,3824,2903,921,2708465.89,860832.68,3569298.57
270640,201711,906,660,246,615804.59,230174.75,845979.34
270642,201711,203,170,33,159282.66,30920.56,190203.22
270644,201711,287,195,92,182522.97,86198.54,268721.51
270650,201711,240,139,101,130241.72,94634.48,224876.20
270660,201711,255,205,50,192084.84,46850,238934.84
270670,201711,3173,2401,772,2239026.39,721412.48,2960438.87
270680,201711,461,266,195,249220.88,182709.92,431930.80
270690,201711,1118,694,424,648404.61,397270.09,1045674.70
270700,201711,36,27,9,25299,8432.53,33731.53
270710,201711,868,646,222,603695.29,208012.35,811707.64
270720,201711,248,187,61,175217.62,56875.73,232093.35
270730,201711,1855,1073,782,1003168.49,730628.95,1733797.44
270740,201711,47,29,18,27173,16866,44039
270750,201711,629,461,168,431759.06,156745.64,588504.70
270760,201711,308,224,84,209883.91,78701.52,288585.43
270770,201711,2699,1687,1012,1573486.51,947286.37,2520772.88
270780,201711,92,57,35,53404.11,32763.44,86167.55
270790,201711,276,182,94,170533.11,88076.93,258610.04
270800,201711,1966,1555,411,1455246.28,384370.26,1839616.54
270810,201711,320,251,69,235165.23,64634.16,299799.39
270820,201711,156,99,57,92762.29,53307.33,146069.62
270830,201711,970,697,273,651571.54,255794.29,907365.83
270840,201711,1404,1016,388,951484.79,361899.27,1313384.06
270850,201711,1728,1048,680,977182,637133.37,1614315.37
270860,201711,2472,1598,874,1493876.98,816041.12,2309918.10
270870,201711,121,66,55,61841.49,51533.86,113375.35
270880,201711,910,656,254,612783.37,237046.27,849829.64
270890,201711,364,267,97,249738.61,90883.22,340621.83
270895,201711,74,64,10,59967,9370,69337
270900,201711,109,85,24,79643.7,22487.33,102131.03
270910,201711,329,261,68,243431.89,63714.88,307146.77
270915,201711,1800,1067,733,994632.24,686044.03,1680676.27
270920,201711,484,399,85,373852.56,79644.32,453496.88
270930,201711,6226,4463,1763,4175977.29,1649075.35,5825052.64
270940,201711,2400,1807,593,1691179.33,554664.78,2245844.11
280010,201711,43,38,5,35606,4685,40291
280020,201711,700,600,100,560275.48,92762.66,653038.14
280030,201711,18948,12127,6821,11287589.48,6362266.55,17649856.03
280040,201711,344,217,127,203321.77,117593.5,320915.27
280050,201711,374,287,87,268629.83,81518.25,350148.08
280060,201711,315,208,107,193504.47,100259,293763.47
280067,201711,976,683,293,636973.54,273597.57,910571.11
280070,201711,126,104,22,97443.89,20614,118057.89
280100,201711,611,482,129,448823.09,120676.57,569499.66
280110,201711,74,70,4,65589.25,3748,69337.25
280120,201711,626,501,125,469410.11,117117.2,586527.31
280130,201711,1315,813,502,760204.01,469317.42,1229521.43
280140,201711,465,372,93,347713.47,87137.77,434851.24
280150,201711,316,232,84,216704.91,77766.7,294471.61
280160,201711,98,83,15,77768.2,14054.12,91822.32
280170,201711,578,388,190,362080.71,177231.64,539312.35
280190,201711,28,26,2,24362,1874,26236
280200,201711,21,14,7,13116,6558.16,19674.16
280210,201711,2744,1930,814,1790917.8,756916.47,2547834.27
280220,201711,38,30,8,28110,7496,35606
280230,201711,308,252,56,235292.79,51534.1,286826.89
280240,201711,113,107,6,100111.63,5622,105733.63
280250,201711,21,12,9,11244,8433,19677
280260,201711,77,69,8,64652,7496,72148
280270,201711,160,122,38,114312.71,35605.63,149918.34
280280,201711,194,123,71,115247.83,66526.25,181774.08
280290,201711,3016,2184,832,2032316.62,778268.39,2810585.01
280300,201711,1080,820,260,766686.18,242868.42,1009554.60
280310,201711,104,99,5,92151.33,4684.6,96835.93
280320,201711,660,449,211,420687.81,197700.22,618388.03
280330,201711,356,255,101,238930.63,94514.24,333444.87
280340,201711,409,327,82,304939.73,76077.89,381017.62
280350,201711,3394,2618,776,2443825.9,724401.03,3168226.93
280360,201711,468,298,170,279215.85,158351.62,437567.47
280370,201711,95,84,11,78705.22,10307,89012.22
280380,201711,56,41,15,38416.17,14054.02,52470.19
280390,201711,184,153,31,143352.15,29046.66,172398.81
280400,201711,340,229,111,213713.19,104003.02,317716.21
280410,201711,292,234,58,218101.12,54336.22,272437.34
280420,201711,173,145,28,135861.13,26236,162097.13
280430,201711,106,77,29,72145.82,27066.56,99212.38
280440,201711,664,506,158,470957.97,147848.24,618806.21
280445,201711,112,104,8,97447.22,7496,104943.22
280450,201711,1057,903,154,842814.62,144294.98,987109.60
280460,201711,724,517,207,477667.79,193956.61,671624.40
280470,201711,190,173,17,162098.32,14982,177080.32
280480,201711,2231,1591,640,1476298.42,595771.39,2072069.81
280490,201711,369,337,32,314609.46,29984,344593.46
280500,201711,48,43,5,40291,4685,44976
280510,201711,149,115,34,107454.1,31576,139030.1
280520,201711,55,41,14,38417,13117.48,51534.48
280530,201711,76,54,22,50598,20614,71212
280540,201711,501,398,103,372913.53,96227.7,469141.23
280550,201711,705,651,54,607395.16,50594.11,657989.27
280560,201711,469,404,65,376384.45,60905,437289.45
280570,201711,1771,1340,431,1251450.24,402991.52,1654441.76
280580,201711,597,454,143,423733.33,133888.01,557621.34
280590,201711,160,96,64,89673.77,59966.1,149639.87
280600,201711,353,295,58,274731.55,54343.42,329074.97
280610,201711,144,107,37,100047.63,34668.63,134716.26
280620,201711,544,440,104,410739.69,96500.27,507239.96
280630,201711,166,138,28,129298.35,26234.3,155532.65
280640,201711,210,167,43,155648.34,40291,195939.34
280650,201711,81,53,28,49660.37,26236,75896.37
280660,201711,127,91,36,85264.41,33497.75,118762.16
280670,201711,1574,977,597,909304.18,555684.23,1464988.41
280680,201711,179,152,27,140658.86,25297.63,165956.49
280690,201711,46,39,7,36535.32,6559,43094.32
280700,201711,16,16,0,14992,0,14992
280710,201711,1406,1053,353,979014.11,330098.55,1309112.66
280720,201711,106,72,34,64940.52,31858,96798.52
280730,201711,23,19,4,17803,3748,21551
280740,201711,2363,1727,636,1613448.73,593887.29,2207336.02
280750,201711,293,251,42,235184.62,39353.77,274538.39
280760,201711,867,589,278,550753.86,260339.19,811093.05
290010,201711,193,128,65,119928.59,60902.7,180831.29
290020,201711,175,162,13,151793.11,12181,163974.11
290030,201711,588,378,210,353510.95,196761.12,550272.07
290035,201711,140,113,27,102733.41,25299,128032.41
290040,201711,270,171,99,160222.93,92757.97,252980.90
290050,201711,69,51,18,47785.82,16865.33,64651.15
290060,201711,258,111,147,103724.12,137737.56,241461.68
290070,201711,5498,2697,2801,2519700.18,2620780.43,5140480.61
290080,201711,507,229,278,214269.05,260451.24,474720.29
290090,201711,382,166,216,155533.11,202387.62,357920.73
290100,201711,1565,1029,536,960010.61,501661.98,1461672.59
290110,201711,767,445,322,415341.2,301464.6,716805.8
290115,201711,214,198,16,184584.47,14992,199576.47
290120,201711,778,511,267,478138.19,250169.84,728308.03
290130,201711,419,245,174,229271.45,163036.34,392307.79
290135,201711,294,224,70,209217.63,65586.67,274804.30
290140,201711,289,239,50,223939.84,46661.93,270601.77
290150,201711,128,96,32,89948.66,29983.21,119931.87
290160,201711,245,192,53,178683.61,49660.29,228343.90
290170,201711,88,61,27,57156.14,25298.09,82454.23
290180,201711,151,117,34,109628.1,31857.66,141485.76
290190,201711,446,361,85,337967.32,79362.37,417329.69
290195,201711,299,170,129,159273.3,120869.84,280143.14
290200,201711,290,247,43,231437.08,40289.41,271726.49
290205,201711,135,81,54,75893.5,50597.93,126491.43
290210,201711,1111,804,307,752201.7,287654.03,1039855.73
290220,201711,214,117,97,109159.7,90889,200048.7
290225,201711,276,102,174,95564.38,163031.31,258595.69
290230,201711,65,41,24,38416.09,22488,60904.09
290240,201711,311,123,188,114960.82,176145.53,291106.35
290250,201711,266,240,26,224189.44,24361.26,248550.70
290260,201711,268,221,47,206317.33,44038.66,250355.99
290265,201711,185,150,35,139742.91,32792.24,172535.15
290270,201711,1378,1130,248,1056394.19,231508.93,1287903.12
290280,201711,467,344,123,322319.91,115249.28,437569.19
290290,201711,1197,690,507,642782.61,475037.43,1117820.04
290300,201711,454,385,69,360220.96,64652,424872.96
290310,201711,322,142,180,133051.07,168657.35,301708.42
290320,201711,3914,2435,1479,2278790.9,1382968,3661758.9
290323,201711,184,160,24,149636.07,22487.84,172123.91
290327,201711,147,115,32,107485.68,29982.73,137468.41
290330,201711,67,36,31,33729.53,29039.56,62769.09
290340,201711,915,366,549,341969.93,513839.91,855809.84
290350,201711,578,343,235,321387.64,220190.3,541577.94
290360,201711,363,273,90,253911.6,84327.54,338239.14
290370,201711,947,356,591,333526.61,553700.29,887226.90
290380,201711,300,182,118,170529.62,110563.9,281093.52
290390,201711,2465,1532,933,1431884.49,872334.66,2304219.15
290395,201711,241,134,107,125033.77,100258.85,225292.62
290400,201711,279,206,73,192455.65,68399.52,260855.17
290405,201711,258,219,39,205197.81,36543,241740.81
290410,201711,557,475,82,442104.9,76830.7,518935.6
290420,201711,227,176,51,164906.35,47785.17,212691.52
290430,201711,514,320,194,299828.4,181775.17,481603.57
290440,201711,74,64,10,59967.35,8745.3,68712.65
290450,201711,235,180,55,168651.48,51532.93,220184.41
290460,201711,1867,1106,761,1035358.09,712569.32,1747927.41
290470,201711,1436,602,834,562590.26,781051.73,1343641.99
290475,201711,588,552,36,516515.39,33730.56,550245.95
290480,201711,289,160,129,149918.8,120870.29,270789.09
290485,201711,215,202,13,189261.59,12180.7,201442.29
290490,201711,1120,795,325,744154.47,303575.72,1047730.19
290500,201711,658,330,328,308271.34,307329.09,615600.43
290510,201711,218,166,52,154873.51,48722.29,203595.80
290515,201711,135,77,58,72145.14,54342.78,126487.92
290520,201711,1365,872,493,815452.58,458715.51,1274168.09
290530,201711,309,282,27,264229.83,25297.48,289527.31
290540,201711,90,54,36,50596.68,33728.63,84325.31
290550,201711,151,128,23,119920.94,21201.48,141122.42
290560,201711,3376,1362,2014,1275171.91,1886882.12,3162054.03
290570,201711,5731,2962,2769,2770727.8,2591629.18,5362356.98
290580,201711,1247,715,532,668695.8,497758.31,1166454.11
290590,201711,530,437,93,408700.25,87139.06,495839.31
290600,201711,1713,1188,525,1108611,491877.32,1600488.32
290610,201711,217,196,21,183195.66,19677,202872.66
290620,201711,322,283,39,265162.26,35980.8,301143.06
290630,201711,2116,891,1225,831079.36,1142546.48,1973625.84
290640,201711,149,121,28,113374.54,26236,139610.54
290650,201711,1676,788,888,737381.41,832023.26,1569404.67
290660,201711,277,224,53,209882.88,49656.5,259539.38
290670,201711,973,513,460,480113.68,430672.25,910785.93
290680,201711,1164,938,226,877932.88,210814.99,1088747.87
290682,201711,284,207,77,192957.32,72122.67,265079.99
290685,201711,231,147,84,136800.6,78706.38,215506.98
290687,201711,913,602,311,560739.09,289406.15,850145.24
290689,201711,125,74,51,69319.48,47771.8,117091.28
290690,201711,662,273,389,255755.86,363576.87,619332.73
290700,201711,240,113,127,105877.61,118996.92,224874.53
290710,201711,685,451,234,422577.29,219252.35,641829.64
290720,201711,1018,832,186,779570.44,173810.62,953381.06
290730,201711,1112,634,478,592218.51,446939.89,1039158.40
290740,201711,16,12,4,11243.23,3747.03,14990.26
290750,201711,1333,604,729,564628.66,680969.7,1245598.36
290755,201711,69,61,8,57155.93,7495.8,64651.73
290760,201711,300,261,39,244550.77,36541.73,281092.50
290770,201711,186,173,13,162090.32,12180.09,174270.41
290780,201711,961,773,188,722342.95,174369.27,896712.22
290790,201711,394,270,124,252386,116174.31,368560.31
290800,201711,2610,1040,1570,971383.8,1469961.12,2441344.92
290810,201711,438,303,135,283624.4,126489.83,410114.23
290820,201711,377,232,145,216425.75,135857.38,352283.13
290830,201711,391,260,131,243617.15,122746.23,366363.38
290840,201711,1646,1005,641,939084.78,597619.42,1536704.20
290850,201711,757,419,338,391559.72,315763.1,707322.82
290860,201711,653,293,360,274533.01,337032.45,611565.46
290870,201711,655,478,177,446735.97,165844.27,612580.24
290880,201711,127,70,57,65589.33,53408.02,118997.35
290890,201711,326,230,96,215474.89,89944.6,305419.49
290900,201711,169,128,41,119934.22,38413.81,158348.03
290910,201711,357,270,87,252983.6,81518.51,334502.11
290920,201711,227,191,36,178963.99,33729.56,212693.55
290930,201711,814,620,194,580150.31,181773.4,761923.71
290940,201711,251,205,46,191334.07,43100.12,234434.19
290950,201711,169,97,72,90886.32,67461.85,158348.17
290960,201711,434,288,146,268616.21,136515.26,405131.47
290970,201711,250,219,31,205010.92,28623.5,233634.42
290980,201711,1466,1041,425,971309.04,397175.73,1368484.77
290990,201711,360,304,56,284831.56,52400.89,337232.45
291000,201711,860,238,622,222993.37,582220.67,805214.04
291005,201711,2031,862,1169,805916.97,1094518.77,1900435.74
291010,201711,160,145,15,135857.91,14053.33,149911.24
291020,201711,103,81,22,75894.73,20611.18,96505.91
291030,201711,90,68,22,63713.59,20613.7,84327.29
291040,201711,590,294,296,275470.59,277340.65,552811.24
291050,201711,1323,745,578,696396.77,541266.09,1237662.86
291060,201711,1480,807,673,755483.88,630580.32,1386064.20
291070,201711,1886,1391,495,1297094.35,460945.91,1758040.26
291072,201711,7262,2678,4584,2505904.22,4292640.64,6798544.86
291075,201711,193,156,37,146168.06,34667.35,180835.41
291077,201711,50,34,16,31856.19,14990.73,46846.92
291080,201711,19167,8332,10835,7784395.57,10139354.86,17923750.43
291085,201711,286,228,58,213630.51,54340.95,267971.46
291090,201711,308,112,196,104659.2,183639.27,288298.47
291100,201711,704,206,498,193014.33,466610.35,659624.68
291110,201711,394,303,91,283909.69,85266.26,369175.95
291120,201711,2501,1158,1343,1084866.84,1256416.34,2341283.18
291125,201711,59,31,28,29046,26236,55282
291130,201711,211,184,27,172407.42,25299,197706.42
291140,201711,120,89,31,83388.59,28765,112153.59
291150,201711,384,151,233,141482.44,218310.52,359792.96
291160,201711,347,291,56,271722.38,52469.98,324192.36
291165,201711,22,18,4,16863.02,3748,20611.02
291170,201711,2857,1443,1414,1349887.45,1322153.41,2672040.86
291180,201711,1308,493,815,461789.69,763565.84,1225355.53
291185,201711,73,71,2,66524.24,1874,68398.24
291190,201711,1239,523,716,488533.76,670328.59,1158862.35
291200,201711,163,117,46,109628.33,43101.33,152729.66
291210,201711,2191,849,1342,792404.49,1255650.96,2048055.45
291220,201711,254,193,61,179897.02,57156.03,237053.05
291230,201711,1019,343,676,320542.52,633405.58,953948.10
291240,201711,444,420,24,392319.04,22488,414807.04
291250,201711,429,349,80,327004.48,74957.05,401961.53
291260,201711,40,30,10,28107.4,9368.29,37475.69
291270,201711,1205,484,721,453502.05,675055.55,1128557.60
291280,201711,379,172,207,160972.65,193663.9,354636.55
291290,201711,1732,869,863,813117.66,807582.51,1620700.17
291300,201711,228,181,47,168937.35,44038.27,212975.62
291310,201711,234,209,25,195541.6,23423.81,218965.41
291320,201711,1390,995,395,929210.06,369062.01,1298272.07
291330,201711,128,108,20,99413.15,18739.93,118153.08
291340,201711,140,79,61,74021.86,57156.13,131177.99
291345,201711,125,82,43,76832.62,40289.48,117122.10
291350,201711,1557,489,1068,457702.48,1000491.49,1458193.97
291360,201711,8494,4166,4328,3893741.33,4052263.52,7946004.85
291370,201711,1070,584,486,546904.24,455374.63,1002278.87
291380,201711,254,202,52,189267.58,48723.13,237990.71
291390,201711,3865,1668,2197,1558486.84,2057064.31,3615551.15
291400,201711,2072,1474,598,1376037.34,558381.08,1934418.42
291410,201711,153,135,18,125555.2,16865.96,142421.16
291420,201711,104,75,29,70271.53,27171.07,97442.60
291430,201711,176,99,77,92063.29,71209.62,163272.91
291440,201711,492,393,99,365819.51,92758.63,458578.14
291450,201711,879,546,333,509410.78,311073.57,820484.35
291460,201711,1710,1391,319,1300909.04,298899.38,1599808.42
291465,201711,2221,1032,1189,966604.43,1113735.75,2080340.18
291470,201711,2752,1403,1349,1310817.6,1262959.65,2573777.25
291480,201711,11778,5221,6557,4880742.42,6133570.1,11014312.52
291490,201711,547,222,325,208009.02,304516.5,512525.52
291500,201711,368,199,169,186456.95,158351.11,344808.06
291510,201711,1250,467,783,436381.49,733320.05,1169701.54
291520,201711,954,430,524,402901.16,490965.05,893866.21
291530,201711,1015,270,745,252988.11,697752.94,950741.05
291535,201711,114,96,18,89949.17,16866,106815.17
291540,201711,365,108,257,101195.07,239861.68,341056.75
291550,201711,1179,550,629,513443.26,588766.42,1102209.68
291560,201711,5550,2845,2705,2652345.35,2520660.69,5173006.04
291570,201711,200,101,99,94631.65,92759.8,187391.45
291580,201711,1200,727,473,680402.56,443159.98,1123562.54
291590,201711,73,29,44,27030.38,41224.16,68254.54
291600,201711,1367,617,750,577185.91,702427.52,1279613.43
291610,201711,1355,609,746,569337,698919.64,1268256.64
291620,201711,569,264,305,247362.31,285399.48,532761.79
291630,201711,506,162,344,151791.8,322314.47,474106.27
291640,201711,3891,1933,1958,1805196.78,1833197.84,3638394.62
291650,201711,410,267,143,249032.11,133006.35,382038.46
291660,201711,451,179,272,167040.75,253784.98,420825.73
291670,201711,220,139,81,129671.41,75893.76,205565.17
291680,201711,710,404,306,378537.25,286617.88,665155.13
291685,201711,561,298,263,278985.71,246240.15,525225.86
291690,201711,556,281,275,263288.51,256733.7,520022.21
291700,201711,905,714,191,668283.46,178023.85,846307.31
291710,201711,1707,782,925,732036.66,865848.16,1597884.82
291720,201711,398,266,132,249232.77,123682.25,372915.02
291730,201711,928,530,398,494955.3,372906.93,867862.23
291733,201711,256,178,78,166502.82,73083.63,239586.45
291735,201711,67,51,16,47787,14990.89,62777.89
291740,201711,340,258,82,241040.28,76831.12,317871.40
291750,201711,1940,1286,654,1197778.5,611163.86,1808942.36
291760,201711,3070,1640,1430,1530107.83,1337514.14,2867621.97
291770,201711,804,540,264,503872.06,247354.77,751226.83
291780,201711,47,26,21,24361.4,19677,44038.4
291790,201711,167,77,90,72145.01,84330,156475.01
291800,201711,9854,3860,5994,3605298.23,5611185.89,9216484.12
291810,201711,1146,819,327,766825.14,306395.87,1073221.01
291820,201711,265,192,73,179893.91,68396.26,248290.17
291830,201711,1056,391,665,365157.15,622151.05,987308.20
291835,201711,626,568,58,531679.29,54341.24,586020.53
291840,201711,4605,2359,2246,2205636.7,2103626.3,4309263.0
291845,201711,307,105,202,98385,189245.25,287630.25
291850,201711,323,281,42,263054.38,39352.61,302406.99
291855,201711,262,107,155,100251.96,145223.25,245475.21
291860,201711,195,115,80,106800.54,74954.57,181755.11
291870,201711,82,34,48,31856.1,44975.29,76831.39
291875,201711,185,169,16,158350.05,14992,173342.05
291880,201711,481,376,105,351505.95,98383.09,449889.04
291890,201711,245,80,165,74947.2,152912.25,227859.45
291900,201711,57,32,25,29981.94,23424.5,53406.44
291905,201711,143,96,47,89669,44039,133708
291910,201711,180,145,35,135859.98,32791.9,168651.88
291915,201711,386,343,43,319730.8,40291,360021.8
291920,201711,4891,2522,2369,2360407.44,2218046.69,4578454.13
291930,201711,179,104,75,96498.28,70272.58,166770.86
291940,201711,312,171,141,159536.2,131177.8,290714.0
291950,201711,1114,914,200,855656.36,187394.4,1043050.76
291955,201711,976,577,399,540634.62,373420.83,914055.45
291960,201711,170,115,55,107747.76,51530.43,159278.19
291970,201711,782,595,187,557495.42,175209.24,732704.66
291980,201711,1492,1317,175,1230607.39,163027.7,1393635.09
291990,201711,123,114,9,106817.4,8433,115250.4
291992,201711,162,82,80,76080.73,74956.2,151036.93
291995,201711,147,103,44,96508.87,41226.15,137735.02
292000,201711,382,288,94,268623.18,88075.18,356698.36
292010,201711,279,201,78,187674.26,72146.98,259821.24
292020,201711,266,197,69,184585.87,64652.43,249238.30
292030,201711,137,108,29,101194.95,27172.03,128366.98
292040,201711,620,314,306,294202.07,286713.18,580915.25
292045,201711,91,82,9,76830.61,8432.13,85262.74
292050,201711,891,600,291,561190,272661.05,833851.05
292060,201711,933,770,163,719584.31,152729.09,872313.40
292070,201711,51,22,29,20612.72,27173,47785.72
292080,201711,114,78,36,73077.41,33729.33,106806.74
292090,201711,489,172,317,160967.55,297017.02,457984.57
292100,201711,1397,603,794,563437.32,743936.87,1307374.19
292105,201711,199,167,32,156468.74,29981.82,186450.56
292110,201711,2103,771,1332,722095.44,1246026.81,1968122.25
292120,201711,632,509,123,475816.62,115247.88,591064.50
292130,201711,442,260,182,243608.36,170529.05,414137.41
292140,201711,199,157,42,147106.64,39224.3,186330.94
292145,201711,156,83,73,77766.85,68371.06,146137.91
292150,201711,1395,1120,275,1049420.09,256658.03,1306078.12
292160,201711,181,148,33,138392.45,30920.23,169312.68
292170,201711,1211,1067,144,998092.89,134868.12,1132961.01
292180,201711,196,140,56,131179.6,52469.88,183649.48
292190,201711,158,97,61,90889,57155.39,148044.39
292200,201711,1265,463,802,432411.29,750806.2,1183217.49
292205,201711,115,104,11,97164.78,10307,107471.78
292210,201711,359,247,112,230068.12,104238.05,334306.17
292220,201711,22,15,7,14055,6559,20614
292225,201711,41,36,5,33731.26,4684.33,38415.59
292230,201711,903,732,171,683187.95,160218.79,843406.74
292240,201711,611,433,178,404631.6,166783.97,571415.57
292250,201711,1667,1057,610,990374.55,571561.06,1561935.61
292260,201711,434,241,193,225811.92,180090.2,405902.12
292265,201711,269,189,80,176806.22,74957.05,251763.27
292270,201711,776,334,442,312291.97,413202.01,725493.98
292273,201711,198,112,86,104179.55,80580.42,184759.97
292275,201711,158,74,84,69334.68,78424.73,147759.41
292280,201711,131,91,40,85265.14,37479.46,122744.60
292285,201711,58,50,8,46188.89,7495.33,53684.22
292290,201711,522,346,176,321739,164625.58,486364.58
292300,201711,1617,614,1003,574730.14,938956.99,1513687.13
292303,201711,95,66,29,61837.5,27170.78,89008.28
292305,201711,110,78,32,73082.85,29983.46,103066.31
292310,201711,783,478,305,447479.08,284405.19,731884.27
292320,201711,648,493,155,461656.77,145233.19,606889.96
292330,201711,193,97,96,90889,89952,180841
292335,201711,273,207,66,193953.3,61840.62,255793.92
292340,201711,560,388,172,362820.74,161157.08,523977.82
292350,201711,263,139,124,129442.47,115901.91,245344.38
292360,201711,692,524,168,489297.88,157414.42,646712.30
292370,201711,779,593,186,555632.66,174279.84,729912.50
292380,201711,650,498,152,464739.08,142420.93,607160.01
292390,201711,509,189,320,177087.4,298092.32,475179.72
292400,201711,3349,2057,1292,1909324.91,1207027.18,3116352.09
292405,201711,259,172,87,160690.16,81236.35,241926.51
292410,201711,154,91,63,85267,59031,144298
292420,201711,303,260,43,243337.17,40290.65,283627.82
292430,201711,511,403,108,377605.83,100722.67,478328.50
292440,201711,574,490,84,457251.54,78704.7,535956.24
292450,201711,242,187,55,175218.26,51533.15,226751.41
292460,201711,584,427,157,399523.49,146402.81,545926.30
292465,201711,187,158,29,148038.86,26448.2,174487.06
292467,201711,97,55,42,51532.73,39354,90886.73
292470,201711,250,169,81,158349.46,75890.99,234240.45
292480,201711,308,208,100,193948.65,93417.9,287366.55
292490,201711,222,145,77,135863.12,72148.39,208011.51
292500,201711,1177,510,667,477860.25,624519.7,1102379.95
292510,201711,3289,1473,1816,1379220.71,1698859.97,3078080.68
292520,201711,1039,496,543,463556.64,508765.15,972321.79
292525,201711,384,270,114,252978.59,106816.32,359794.91
292530,201711,4191,1717,2474,1605878.49,2316094.36,3921972.85
292540,201711,481,256,225,239867.2,210821.06,450688.26
292550,201711,1050,561,489,524785.67,457612.85,982398.52
292560,201711,320,301,19,282034.13,17803,299837.13
292570,201711,298,227,71,212366.36,66525.9,278892.26
292575,201711,457,284,173,265820.29,162096.68,427916.97
292580,201711,899,566,333,528907.44,311719.82,840627.26
292590,201711,510,439,71,411037.81,66524.65,477562.46
292593,201711,144,113,31,105878.5,29046.86,134925.36
292595,201711,177,134,43,125554.04,40289.11,165843.15
292600,201711,1239,921,318,862644.67,297300.64,1159945.31
292610,201711,126,95,31,88545.44,28794.01,117339.45
292620,201711,516,427,89,399792.95,83389.98,483182.93
292630,201711,1354,780,574,729272.44,536224.72,1265497.16
292640,201711,765,534,231,500349.37,216441.89,716791.26
292650,201711,172,146,26,136516.67,24361.68,160878.35
292660,201711,1992,1427,565,1331316,524414.95,1855730.95
292665,201711,138,99,39,92759.72,36540.25,129299.97
292670,201711,375,313,62,293264.29,58091.9,351356.19
292680,201711,247,190,57,178028.17,52718.95,230747.12
292690,201711,179,135,44,126494.41,41227.12,167721.53
292700,201711,914,600,314,561236.69,294212.32,855449.01
292710,201711,96,84,12,78704.57,10959.95,89664.52
292720,201711,823,462,361,432089.55,338058.99,770148.54
292730,201711,208,98,110,90881.51,103067.29,193948.80
292740,201711,65470,32390,33080,30272646.2,30965486.31,61238132.51
292750,201711,374,267,107,249233.3,99462.75,348696.05
292760,201711,317,256,61,238867.39,57157,296024.39
292770,201711,785,336,449,314465.05,420639.64,735104.69
292780,201711,421,160,261,149692.59,244551.39,394243.98
292790,201711,724,350,374,327941.22,350197.05,678138.27
292800,201711,1130,692,438,647437.66,410393.83,1057831.49
292805,201711,421,122,299,113796.83,280152.36,393949.19
292810,201711,1463,855,608,800270.95,569385.24,1369656.19
292820,201711,742,598,144,558436.35,134632.56,693068.91
292830,201711,103,81,22,75897,20613.33,96510.33
292840,201711,647,532,115,498003.54,107739.19,605742.73
292850,201711,135,89,46,83378.35,43100.69,126479.04
292860,201711,2091,1224,867,1142729.53,812372.12,1955101.65
292870,201711,3341,2237,1104,2094758.84,1034428.23,3129187.07
292880,201711,1418,935,483,871645.72,452560.32,1324206.04
292890,201711,471,403,68,377573.85,63714.75,441288.60
292895,201711,139,90,49,82993.88,45912.17,128906.05
292900,201711,387,288,99,269851.25,92762.3,362613.55
292905,201711,446,228,218,213631.71,204068.85,417700.56
292910,201711,385,298,87,278859.3,81510.64,360369.94
292920,201711,537,236,301,221124.08,282025.51,503149.59
292925,201711,510,474,36,443465.85,33478.28,476944.13
292930,201711,551,339,212,317639.58,198637.25,516276.83
292935,201711,295,127,168,118997.52,157413.1,276410.62
292937,201711,238,161,77,150854.4,72145.65,223000.05
292940,201711,189,144,45,134926,42164.19,177090.19
292950,201711,1090,562,528,524507.92,493773.95,1018281.87
292960,201711,540,362,178,339190.25,166782.39,505972.64
292970,201711,273,188,85,175485.66,79642.62,255128.28
292975,201711,157,87,70,81519,65399,146918
292980,201711,256,173,83,160333.98,77769.19,238103.17
292990,201711,1292,951,341,883779.51,319326.78,1203106.29
293000,201711,101,74,27,69335.88,25288.92,94624.80
293010,201711,2638,1623,1015,1514676.38,947010.34,2461686.72
293015,201711,645,506,139,473896.59,129605.45,603502.04
293020,201711,341,279,62,261421.43,58092.06,319513.49
293030,201711,624,544,80,508212.34,74958.82,583171.16
293040,201711,337,264,73,247357.94,68399.6,315757.54
293050,201711,2693,1567,1126,1459580.08,1050955.89,2510535.97
293060,201711,254,203,51,188658.07,46844.52,235502.59
293070,201711,3333,1671,1662,1556964.4,1556047.04,3113011.44
293075,201711,89,57,32,53408.66,29983.32,83391.98
293076,201711,71,45,26,42164.14,24362,66526.14
293077,201711,430,262,168,241022.89,157406.37,398429.26
293080,201711,453,399,54,373859.28,50596.09,424455.37
293090,201711,129,111,18,104003.66,16553.7,120557.36
293100,201711,512,361,151,338253.26,141478.57,479731.83
293105,201711,336,229,107,214284.36,99974.94,314259.30
293110,201711,167,118,49,110565.33,45912.16,156477.49
293120,201711,318,210,108,196767.95,101004.53,297772.48
293130,201711,247,165,82,154603.66,76831.59,231435.25
293135,201711,7858,3114,4744,2911580.68,4436202.36,7347783.04
293140,201711,179,115,64,107754,59211.13,166965.13
293150,201711,332,283,49,263750.99,45911.69,309662.68
293160,201711,430,240,190,224875.18,178028.08,402903.26
293170,201711,188,131,57,122462.06,52562.26,175024.32
293180,201711,455,308,147,288309.9,137735.77,426045.67
293190,201711,1268,880,388,819977.98,363471.53,1183449.51
293200,201711,526,464,62,433692.71,58093.26,491785.97
293210,201711,339,247,92,231277.33,85499.64,316776.97
293220,201711,2688,1082,1606,1011906.58,1502636.13,2514542.71
293230,201711,1780,639,1141,597314.21,1068817.01,1666131.22
293240,201711,219,200,19,187399.28,17802.4,205201.68
293245,201711,109,92,17,86201.97,15928.33,102130.30
293250,201711,740,274,466,255574.17,435423.79,690997.96
293260,201711,309,258,51,240797.93,47784.54,288582.47
293270,201711,1171,555,616,518138.36,577180.43,1095318.79
293280,201711,238,132,106,123675.18,99314.86,222990.04
293290,201711,3077,1998,1079,1869900.74,1010683.52,2880584.26
293300,201711,690,487,203,454469.36,189407.78,643877.14
293305,201711,166,139,27,130241.14,25298.89,155540.03
293310,201711,136,102,34,95572.99,31858,127430.99
293315,201711,153,117,36,109626.06,33731.56,143357.62
293317,201711,94,66,28,61841.13,26233.8,88074.93
293320,201711,952,541,411,505970.47,385104.88,891075.35
293325,201711,185,67,118,62776.3,110522.87,173299.17
293330,201711,12718,5921,6797,5536974.02,6362112.62,11899086.64
293340,201711,250,183,67,171463.34,61842,233305.34
293345,201711,244,193,51,180837.79,47785.14,228622.93
293350,201711,626,320,306,299833.89,285262.36,585096.25
293360,201711,1573,1120,453,1048203.18,423231.41,1471434.59
310010,201711,154,75,79,70274.96,73737.32,144012.28
310020,201711,1057,579,478,538129.77,445090.23,983220.00
310030,201711,322,260,62,242506.14,57811.79,300317.93
310040,201711,50,32,18,29984,16866,46850
310050,201711,179,116,63,107747.64,59030.22,166777.86
310060,201711,236,164,72,153184.35,67463.16,220647.51
310070,201711,17,8,9,7496,8433,15929
310080,201711,51,29,22,27172.86,20612.78,47785.64
310090,201711,955,497,458,460495.26,427998.66,888493.92
310100,201711,292,218,74,204260.2,69335.95,273596.15
310110,201711,733,394,339,368147.14,316701.09,684848.23
310120,201711,381,213,168,198917.2,157044.81,355962.01
310130,201711,34,21,13,19676.22,12180.31,31856.53
310140,201711,29,16,13,14991.83,12179.65,27171.48
310150,201711,1275,877,398,817587.23,372345.45,1189932.68
310160,201711,2114,1072,1042,996168.33,973801.27,1969969.60
310163,201711,89,47,42,44037.22,39352.35,83389.57
310170,201711,2555,1041,1514,975249.76,1416048.3,2391298.06
310180,201711,123,45,78,42164.56,72709.84,114874.40
310190,201711,478,317,161,297019.96,150291.57,447311.53
310200,201711,507,320,187,299836.64,175215.74,475052.38
310205,201711,56,43,13,40289.42,12180.37,52469.79
310210,201711,284,229,55,214570.02,51535,266105.02
310220,201711,51,31,20,29046.56,18740,47786.56
310230,201711,263,185,78,173150.84,73082.82,246233.66
310240,201711,105,93,12,86906.75,11244,98150.75
310250,201711,97,78,19,73085.56,17803,90888.56
310260,201711,798,427,371,397461.56,346898.66,744360.22
310270,201711,267,179,88,167166.04,82455.66,249621.70
310280,201711,363,271,92,253259.46,86202.81,339462.27
310285,201711,220,156,64,145868.48,59967.86,205836.34
310290,201711,258,149,109,139609.54,102129.01,241738.55
310300,201711,156,128,28,119929.17,26234.18,146163.35
310310,201711,6,4,2,3748,1874,5622
310320,201711,21,14,7,13118,6559,19677
310330,201711,32,23,9,21551,8433,29984
310340,201711,1694,1087,607,1010859.89,567236.24,1578096.13
310350,201711,2802,1518,1284,1417583.49,1202474.87,2620058.36
310360,201711,41,33,8,30921,7495.01,38416.01
310370,201711,120,99,21,92759.1,19394.66,112153.76
310375,201711,104,37,67,34669,62747.73,97416.73
310380,201711,52,30,22,28108.24,20614,48722.24
310390,201711,102,72,30,67460.85,28108.37,95569.22
310400,201711,2289,1484,805,1386619.34,753959.85,2140579.19
310410,201711,128,69,59,64652.19,55283,119935.19
310420,201711,672,360,312,335033.74,291370.83,626404.57
310430,201711,335,220,115,205857.27,107752.76,313610.03
310440,201711,63,37,26,34667.56,24361.24,59028.80
310445,201711,84,67,17,62777.02,15929,78706.02
310450,201711,857,539,318,503556.61,297956.02,801512.63
310460,201711,268,191,77,178960.48,72147.09,251107.57
310470,201711,491,309,182,289529.31,170531.95,460061.26
310480,201711,76,54,22,50597.16,20614,71211.16
310490,201711,480,227,253,211750.78,237050.95,448801.73
310500,201711,128,57,71,53409,66526.33,119935.33
310510,201711,616,399,217,372610.47,203297.69,575908.16
310520,201711,130,87,43,81517.58,40290.16,121807.74
310530,201711,88,41,47,38416.2,43757.76,82173.96
310540,201711,451,282,169,261864.51,158345.37,420209.88
310550,201711,85,55,30,51534.95,28108.58,79643.53
310560,201711,2892,1999,893,1863331.94,835158.43,2698490.37
310570,201711,159,102,57,95572.73,53409,148981.73
310590,201711,341,225,116,210391.72,108675.82,319067.54
310600,201711,160,92,68,83826.49,63711.05,147537.54
310610,201711,58,21,37,19675.08,34667.32,54342.40
310620,201711,45331,21691,23640,20250677.8,22110355.98,42361033.78
310630,201711,584,373,211,347513.91,196232.5,543746.41
310640,201711,137,114,23,106626.55,21550.9,128177.45
310650,201711,159,139,20,129305.83,18739.24,148045.07
310660,201711,90,56,34,52472,31858,84330
310665,201711,55,39,16,36542.93,14992,51534.93
310670,201711,6233,2924,3309,2731644.62,3095588.41,5827233.03
310680,201711,53,35,18,32793.82,16864.75,49658.57
310690,201711,590,428,162,396853.61,151782.52,548636.13
310700,201711,65,42,23,39354,21410.45,60764.45
310710,201711,1242,823,419,770170.27,392019.46,1162189.73
310720,201711,85,28,57,26235.3,53409,79644.3
310730,201711,1362,939,423,879541,396335.17,1275876.17
310740,201711,1011,568,443,528641.11,414838.34,943479.45
310750,201711,245,143,102,133049.03,95572.85,228621.88
310760,201711,66,50,16,46850,14992,61842
310770,201711,91,45,46,42165,43102,85267
310780,201711,406,332,74,311049.66,69334.84,380384.50
310790,201711,99,80,19,74958.46,17803,92761.46
310800,201711,458,223,235,208477.66,219910.11,428387.77
310810,201711,165,116,49,107365.96,44972.76,152338.72
310820,201711,365,288,77,269855.39,71867.9,341723.29
310825,201711,190,155,35,145232,32794,178026
310830,201711,461,222,239,207361.4,223657.42,431018.82
310840,201711,387,222,165,207729.14,154599.67,362328.81
310850,201711,111,90,21,84329,19677,104006
310855,201711,375,295,80,276408.41,74957.99,351366.40
310860,201711,1387,1038,349,967013.55,325293.17,1292306.72
310870,201711,55,43,12,40289.63,11244,51533.63
310880,201711,79,61,18,56875.25,16866,73741.25
310890,201711,311,183,128,171468.28,119930.39,291398.67
310900,201711,641,294,347,272574.31,324821.39,597395.70
310910,201711,250,169,81,157030.33,75894.86,232925.19
310920,201711,488,293,195,270774.33,181770.85,452545.18
310925,201711,31,24,7,22487.66,6277,28764.66
310930,201711,1102,659,443,616932.19,414889.7,1031821.89
310940,201711,674,346,328,323602.58,307332.83,630935.41
310945,201711,118,73,45,68397.23,42165,110562.23
310950,201711,253,198,55,185525.36,51534.79,237060.15
310960,201711,87,32,55,29982.52,51522.33,81504.85
310970,201711,167,104,63,97447.72,58124.7,155572.42
310980,201711,42,24,18,22486.05,16863.85,39349.90
310990,201711,151,85,66,79360.32,61835.83,141196.15
311000,201711,822,418,404,388163.48,378517.54,766681.02
311010,201711,40,33,7,30918.73,6559,37477.73
311020,201711,41,26,15,24362,14055,38417
311030,201711,391,229,162,212687.07,151790.33,364477.40
311040,201711,38,33,5,30920.66,4685,35605.66
311050,201711,469,196,273,183086.38,255231.62,438318.00
311060,201711,752,434,318,405240.47,297672.42,702912.89
311070,201711,328,146,182,136797.41,170525.1,307322.51
311080,201711,108,60,48,56218.1,44976,101194.1
311090,201711,399,186,213,173339.6,199572.61,372912.21
311100,201711,615,366,249,342933.17,233024.57,575957.74
311110,201711,676,466,210,436631.6,196753.3,633384.9
311115,201711,67,49,18,45912,16866,62778
311120,201711,1022,537,485,502157.27,453590.11,955747.38
311130,201711,408,240,168,224692.1,157415.5,382107.6
311140,201711,159,76,83,71206.04,76972.12,148178.16
311150,201711,354,229,125,214566.5,116889.47,331455.97
311160,201711,737,534,203,498002.27,189734.44,687736.71
311170,201711,80,58,22,54342.26,20332.9,74675.16
311180,201711,344,227,117,212416.02,109345.63,321761.65
311190,201711,35,18,17,16865.49,15928.66,32794.15
311200,201711,339,234,105,217661.41,98383.93,316045.34
311205,201711,29,19,10,17568.75,8995.2,26563.95
311210,201711,48,40,8,37196.06,7495.63,44691.69
311220,201711,13,11,2,10306.53,1874,12180.53
311230,201711,1630,1056,574,986383.7,537833.98,1524217.68
311240,201711,168,105,63,98177.22,59026.43,157203.65
311250,201711,72,30,42,28109,39353.6,67462.6
311260,201711,555,346,209,324192.12,195830.05,520022.17
311265,201711,109,74,35,69337.4,32795,102132.4
311270,201711,284,201,83,188332.81,77770.69,266103.50
311280,201711,214,99,115,92759.03,107191.87,199950.90
311290,201711,109,88,21,82174,19112,101286
311300,201711,545,343,202,320437.45,188708.67,509146.12
311310,201711,24,19,5,17802.52,4684.7,22487.22
311320,201711,674,507,167,474111.27,156470.44,630581.71
311330,201711,1026,761,265,712707.62,247354.66,960062.28
311340,201711,2601,1855,746,1730744.67,698534.63,2429279.30
311350,201711,271,211,60,197692.17,56217.05,253909.22
311360,201711,172,106,66,99321,61841.39,161162.39
311370,201711,1201,480,721,447794.64,675009.88,1122804.52
311380,201711,7,6,1,5622,937,6559
311390,201711,278,148,130,138668,121334.7,260002.7
311400,201711,150,98,52,91822.5,48708.78,140531.28
311410,201711,95,55,40,51532.17,37477.67,89009.84
311420,201711,294,162,132,150197.73,123679.16,273876.89
311430,201711,860,558,302,521776.32,282965.57,804741.89
311440,201711,481,334,147,312949.37,137452.7,450402.07
311450,201711,316,194,122,181777.52,114309.93,296087.45
311455,201711,306,205,101,191788.27,94354.98,286143.25
311460,201711,128,52,76,48723.07,70138.56,118861.63
311470,201711,20,10,10,9370,9368.36,18738.36
311480,201711,23,9,14,8431.57,13117.66,21549.23
311490,201711,16,9,7,8433,6559,14992
311500,201711,21,10,11,9369.89,10306.89,19676.78
311510,201711,638,440,198,410361.91,185240.05,595601.96
311520,201711,44,33,11,30264.32,10306.14,40570.46
311530,201711,1820,1349,471,1255579.53,441292.51,1696872.04
311535,201711,66,52,14,48723.68,13118,61841.68
311540,201711,33,29,4,27172.4,3748,30920.4
311545,201711,185,138,47,129302.36,44038.93,173341.29
311547,201711,30,21,9,19677,8433,28110
311550,201711,613,283,330,265152.9,309173.74,574326.64
311560,201711,41,28,13,26234.63,12178.43,38413.06
311570,201711,306,201,105,187773.29,98384.22,286157.51
311580,201711,301,175,126,163686.54,118059.91,281746.45
311590,201711,33,29,4,27173,3748,30921
311600,201711,89,70,19,65588.56,17803,83391.56
311610,201711,260,228,32,212380.05,29983.2,242363.25
311615,201711,93,78,15,72454.61,14055,86509.61
311620,201711,17,11,6,10307,5622,15929
311630,201711,84,71,13,66521.9,12181,78702.9
311640,201711,119,67,52,62777.56,48722.66,111500.22
311650,201711,127,94,33,87375.25,30921,118296.25
311660,201711,400,192,208,179895.13,194876.21,374771.34
311670,201711,162,104,58,97196.33,54344.96,151541.29
311680,201711,225,164,61,152773.91,56405.02,209178.93
311690,201711,17,10,7,9369.88,6559,15928.88
311700,201711,198,134,64,125276.56,59968,185244.56
311710,201711,217,138,79,129304.37,74021.06,203325.43
311720,201711,38,28,10,26234.88,9369.12,35604.00
311730,201711,537,354,183,331116.43,171466.7,502583.13
311740,201711,36,25,11,23425,10307,33732
311750,201711,705,482,223,449751.04,208947.08,658698.12
311760,201711,64,36,28,33730.5,26235.53,59966.03
311770,201711,404,193,211,178955.18,197701.76,376656.94
311780,201711,166,95,71,89011.76,66208.87,155220.63
311783,201711,78,69,9,64649.76,8433,73082.76
311787,201711,36,16,20,14992,18740,33732
311790,201711,269,130,139,121808.11,130238.31,252046.42
311800,201711,629,432,197,401429.97,184572.8,586002.77
311810,201711,43,37,6,34669,5622,40291
311820,201711,107,89,18,83387.69,16866,100253.69
311830,201711,1850,1191,659,1110145.93,614158.78,1724304.71
311840,201711,1008,561,447,521415.3,417097.92,938513.22
311850,201711,8,5,3,4685,2811,7496
311860,201711,9382,4304,5078,4017569.22,4749510.98,8767080.20
311870,201711,154,85,69,79644.69,64652.83,144297.52
311880,201711,945,705,240,659350.83,224880,884230.83
311890,201711,222,114,108,106815.15,101194.69,208009.84
311900,201711,87,36,51,33731.66,47787,81518.66
311910,201711,1371,853,518,796368.24,483142.18,1279510.42
311920,201711,226,146,80,136564.85,74960,211524.85
311930,201711,899,519,380,486009.47,355524.99,841534.46
311940,201711,2402,1222,1180,1142663.41,1102826.46,2245489.87
311950,201711,30,21,9,19677,8433,28110
311960,201711,70,49,21,45913,19677,65590
311970,201711,25,14,11,13116.37,10305.89,23422.26
311980,201711,44,33,11,30919.75,10306.26,41226.01
311990,201711,58,43,15,40291,14054.23,54345.23
311995,201711,62,43,19,40291,17802.06,58093.06
312000,201711,35,24,11,22206.9,10307,32513.9
312010,201711,85,62,23,58092.74,21549.33,79642.07
312015,201711,95,69,26,64369.73,24362,88731.73
312020,201711,139,86,53,80581.08,49661,130242.08
312030,201711,40,34,6,30908.94,5620.8,36529.74
312040,201711,78,50,28,46841.6,26229.9,73071.5
312050,201711,227,118,109,110564.14,102130.64,212694.78
312060,201711,71,47,24,44038.45,21831.26,65869.71
312070,201711,77,45,32,42164.56,29984,72148.56
312080,201711,526,227,299,212684.97,280154.96,492839.93
312083,201711,46,34,12,31858,11241.48,43099.48
312087,201711,108,85,23,79644,21551,101195
312090,201711,2798,1578,1220,1464410.26,1138386.45,2602796.71
312100,201711,160,113,47,105877.93,43267.2,149145.13
312110,201711,116,74,42,69336.68,39353.67,108690.35
312120,201711,143,104,39,97441.46,36541.67,133983.13
312125,201711,93,52,41,48535.6,38416.23,86951.83
312130,201711,123,81,42,75894.61,39350.19,115244.80
312140,201711,132,104,28,97442.97,26235.86,123678.83
312150,201711,43,35,8,32793.64,7495.66,40289.30
312160,201711,1525,1018,507,950445.98,473652.58,1424098.56
312170,201711,11,9,2,8433,1874,10307
312180,201711,114,72,42,66515.26,39072,105587.26
312190,201711,33,29,4,27170.75,3748,30918.75
312200,201711,724,625,99,583691.67,92761.26,676452.93
312210,201711,99,64,35,59968,32795,92763
312220,201711,124,93,31,86902.23,29047,115949.23
312230,201711,3436,1694,1742,1583201.38,1630555.96,3213757.34
312235,201711,142,95,47,89008.59,44039,133047.59
312240,201711,111,72,39,67462,36542.49,104004.49
312245,201711,160,108,52,101179.53,48723.02,149902.55
312247,201711,55,39,16,35786.11,14991.61,50777.72
312250,201711,183,86,97,80103.49,90883.62,170987.11
312260,201711,101,68,33,62863.57,30919.39,93782.96
312270,201711,136,87,49,81517.88,45912.37,127430.25
312280,201711,24,14,10,13118,9369.5,22487.5
312290,201711,158,110,48,102779.36,44021.66,146801.02
312300,201711,198,134,64,125557.36,59965.09,185522.45
312310,201711,58,53,5,49661,4685,54346
312320,201711,426,264,162,245462.31,150515.95,395978.26
312330,201711,89,76,13,70452.4,11899.08,82351.48
312340,201711,36,16,20,14992,18740,33732
312350,201711,16,10,6,9369.56,5622,14991.56
312352,201711,97,67,30,62778,28109.24,90887.24
312360,201711,564,257,307,239865.8,287650.14,527515.94
312370,201711,294,177,117,165564.39,109625.03,275189.42
312380,201711,136,86,50,80582,46850,127432
312385,201711,183,148,35,138674.34,32794.2,171468.54
312390,201711,296,188,108,176145.19,100526.24,276671.43
312400,201711,380,287,93,268916.11,86665.51,355581.62
312410,201711,852,273,579,255329.14,541937.43,797266.57
312420,201711,605,485,120,453784.62,112440,566224.62
312430,201711,860,633,227,590512.65,211757.99,802270.64
312440,201711,44,32,12,29982.57,11244,41226.57
312450,201711,210,132,78,123683.33,73085.66,196768.99
312460,201711,55,26,29,24359.85,27172.26,51532.11
312470,201711,57,36,21,33731.55,19672.88,53404.43
312480,201711,211,129,82,120873,76655.26,197528.26
312490,201711,253,173,80,162098.53,74956.62,237055.15
312500,201711,33,18,15,16866,14055,30921
312510,201711,418,158,260,148043.88,243005.75,391049.63
312520,201711,40,14,26,13118,24361.32,37479.32
312530,201711,47,35,12,32794.33,11244,44038.33
312540,201711,101,88,13,82456,12180,94636
312550,201711,40,31,9,29047,8433,37480
312560,201711,196,140,56,130895.1,52190.09,183085.19
312570,201711,440,261,179,243899.32,167037.46,410936.78
312580,201711,82,43,39,40291,36543,76834
312590,201711,273,216,57,202009,53408.18,255417.18
312595,201711,145,131,14,122745.65,13117.66,135863.31
312600,201711,75,46,29,42673.66,27172.07,69845.73
312610,201711,1623,849,774,790220.62,723414.1,1513634.72
312620,201711,188,131,57,122744.65,53402.94,176147.59
312630,201711,64,53,11,49661,10306.22,59967.22
312640,201711,48,15,33,14055,30921,44976
312650,201711,146,119,27,111221,25016.33,136237.33
312660,201711,69,52,17,48442,15929,64371
312670,201711,866,569,297,531584.3,278058.2,809642.5
312675,201711,42,31,11,29047,10306.96,39353.96
312680,201711,84,58,26,53969.22,24362,78331.22
312690,201711,242,128,114,119926.15,106535.41,226461.56
312695,201711,30,24,6,22488,5622,28110
312700,201711,198,114,84,106811.43,78705.27,185516.70
312705,201711,72,61,11,57157,10306.4,67463.4
312707,201711,93,68,25,63432.65,23425,86857.65
312710,201711,1853,987,866,923014.21,811182.98,1734197.19
312720,201711,65,33,32,30921,29984,60905
312730,201711,289,170,119,158350.96,111221.83,269572.79
312733,201711,50,42,8,39354,7496,46850
312735,201711,21,15,6,14055,5622,19677
312737,201711,69,37,32,34668.86,29982.99,64651.85
312738,201711,51,35,16,32794.78,14991,47785.78
312740,201711,70,49,21,45912,19677,65589
312750,201711,73,53,20,49661,18740,68401
312760,201711,274,201,73,188324.42,68399.46,256723.88
312770,201711,7666,3529,4137,3283951,3867625.75,7151576.75
312780,201711,434,336,98,314549.07,91825.03,406374.10
312790,201711,20,15,5,14055,4685,18740
312800,201711,1585,1113,472,1036476.32,441075.58,1477551.90
312810,201711,370,236,134,221123.9,125553.67,346677.57
312820,201711,193,147,46,137737.13,43098.3,180835.43
312825,201711,27,19,8,17803,7496,25299
312830,201711,290,167,123,155531.17,114609.44,270140.61
312840,201711,150,111,39,104005.67,36542.14,140547.81
312850,201711,23,21,2,19677,1874,21551
312860,201711,172,108,64,100913.39,59967.2,160880.59
312870,201711,983,516,467,480721.43,437559.61,918281.04
312880,201711,149,104,45,97307.24,42071.3,139378.54
312890,201711,162,110,52,103069.27,48724,151793.27
312900,201711,211,156,55,145515.16,51535,197050.16
312910,201711,187,95,92,87862.02,86203.05,174065.07
312920,201711,158,87,71,81516.93,66523.57,148040.50
312930,201711,339,246,93,230500.33,87138.57,317638.90
312940,201711,102,69,33,64649.66,30919.88,95569.54
312950,201711,693,451,242,421257.89,226748.01,648005.90
312960,201711,175,133,42,124621,39353.66,163974.66
312965,201711,48,43,5,40291,4685,44976
312970,201711,282,227,55,211757.42,51535,263292.42
312980,201711,2307,1229,1078,1147091.07,1009450.8,2156541.87
312990,201711,49,28,21,26235.09,19675.8,45910.89
313000,201711,39,25,14,23425,13116.78,36541.78
313005,201711,164,125,39,116134.33,36256.6,152390.93
313010,201711,931,385,546,359500.96,511285.4,870786.36
313020,201711,191,99,92,92292.26,86200.31,178492.57
313030,201711,206,132,74,121792.29,69335.61,191127.90
313040,201711,57,20,37,18740,34668.73,53408.73
313050,201711,294,206,88,192075.61,82452.74,274528.35
313055,201711,45,32,13,29983.6,12180.8,42164.4
313060,201711,122,81,41,75892.77,38134.4,114027.17
313065,201711,61,39,22,36542,20613.4,57155.4
313070,201711,157,85,72,79644.22,67464,147108.22
313080,201711,39,17,22,15929,20614,36543
313090,201711,705,485,220,452463.32,206131.22,658594.54
313100,201711,167,64,103,59968,96486.49,156454.49
313110,201711,122,73,49,68399.36,45912.83,114312.19
313115,201711,148,79,69,73823.44,63712.51,137535.95
313120,201711,746,404,342,378256.11,318941.74,697197.85
313130,201711,5109,2737,2372,2539825.45,2213160.13,4752985.58
313140,201711,164,86,78,80577.31,73085.32,153662.63
313150,201711,314,252,62,236120.5,57812.23,293932.73
313160,201711,185,132,53,123684,49661,173345
313170,201711,1324,937,387,865123.78,362206.01,1227329.79
313180,201711,329,193,136,180196.61,127428.39,307625.00
313190,201711,723,424,299,394402.59,279393.52,673796.11
313200,201711,22,21,1,19677,937,20614
313210,201711,1038,872,166,814072.86,155534,969606.86
313220,201711,227,155,72,144295.3,66758.52,211053.82
313230,201711,274,200,74,186446.8,69333.43,255780.23
313240,201711,1910,1025,885,958674.97,825716.73,1784391.70
313250,201711,1247,914,333,850582.94,309185.7,1159768.64
313260,201711,91,53,38,49661,35606,85267
313270,201711,955,557,398,517888.38,372916.42,890804.80
313280,201711,60,52,8,48254.86,7496,55750.86
313290,201711,227,184,43,172122.12,39344.78,211466.90
313300,201711,370,186,184,172118.7,172403.75,344522.45
313310,201711,221,116,105,108686.17,98380.19,207066.36
313320,201711,364,281,83,261368.59,77770.73,339139.32
313330,201711,1352,807,545,755172.46,509461.86,1264634.32
313340,201711,333,228,105,213631.81,98384.46,312016.27
313350,201711,523,352,171,327943.49,160216.8,488160.29
313360,201711,116,67,49,62778.62,45630.96,108409.58
313370,201711,192,74,118,69336.37,110559.52,179895.89
313375,201711,263,156,107,146162.3,100254.36,246416.66
313380,201711,1245,630,615,588431.68,575925.18,1164356.86
313390,201711,48,40,8,36538.11,7496,44034.11
313400,201711,419,269,150,252050,140266.16,392316.16
313410,201711,21,12,9,11244,8433,19677
313420,201711,4655,2403,2252,2242654.43,2103163.56,4345817.99
313430,201711,133,62,71,58092.67,66525.24,124617.91
313440,201711,1455,977,478,914235.82,447026.75,1361262.57
313450,201711,63,27,36,25297.61,33449.46,58747.07
313460,201711,375,177,198,164428.34,185521.12,349949.46
313470,201711,526,236,290,221130.34,271070.85,492201.19
313480,201711,159,109,50,101183.68,46849.9,148033.58
313490,201711,505,245,260,229558.18,243561.67,473119.85
313500,201711,20,12,8,11244,7496,18740
313505,201711,953,738,215,690899.99,201446.32,892346.31
313507,201711,90,53,37,49660,34669,84329
313510,201711,2763,1774,989,1657829,925723.38,2583552.38
313520,201711,3597,2809,788,2620033.79,738319,3358352.79
313530,201711,41,29,12,27171.35,11244,38415.35
313535,201711,106,85,21,78977.77,19675.51,98653.28
313540,201711,72,55,17,51532.28,15926.79,67459.07
313545,201711,106,87,19,81518.66,17803,99321.66
313550,201711,235,191,44,178966,40946,219912
313560,201711,326,171,155,160225.65,145235,305460.65
313570,201711,58,31,27,29046.3,25299,54345.3
313580,201711,1285,694,591,648957.36,552068.55,1201025.91
313590,201711,80,48,32,44975.42,29981.29,74956.71
313600,201711,692,410,282,384159.01,263383.8,647542.81
313610,201711,55,43,12,39675.85,11242.26,50918.11
313620,201711,1322,708,614,653356.77,571865.75,1225222.52
313630,201711,1635,1255,380,1174089.65,355760.17,1529849.82
313640,201711,125,71,54,66525.05,50597.02,117122.07
313650,201711,237,110,127,103068.82,118998.6,222067.42
313652,201711,15,14,1,13118,937,14055
313655,201711,52,31,21,29047,19677,48724
313657,201711,45,41,4,38417,3748,42165
313660,201711,129,91,38,85259.98,35603.12,120863.10
313665,201711,626,310,316,290453.99,295839.74,586293.73
313670,201711,10136,7033,3103,6568248.04,2906569.35,9474817.39
313680,201711,40,29,11,27173,10307,37480
313690,201711,159,122,37,114313.34,34668.22,148981.56
313695,201711,63,48,15,44976,14055,59031
313700,201711,289,231,58,216161.37,54345.03,270506.40
313710,201711,151,102,49,95573.94,45913,141486.94
313720,201711,1030,492,538,458266.05,502748.64,961014.69
313730,201711,56,40,16,37480,14992,52472
313740,201711,163,128,35,119933.34,32794.73,152728.07
313750,201711,446,324,122,303298.52,114308.81,417607.33
313753,201711,243,172,71,160500.83,66525.88,227026.71
313760,201711,1199,431,768,403835.49,716876.14,1120711.63
313770,201711,352,250,102,234242.85,95570.9,329813.75
313780,201711,751,387,364,362596.77,340763.09,703359.86
313790,201711,27,26,1,24361.8,937,25298.8
313800,201711,142,87,55,81514.89,51532.04,133046.93
313810,201711,60,36,24,33731.5,22487.11,56218.61
313820,201711,1274,635,639,594042.06,597754.91,1191796.97
313830,201711,66,50,16,46848.63,14992,61840.63
313835,201711,51,46,5,43101.66,4684.66,47786.32
313840,201711,1651,1012,639,943587.66,597490.68,1541078.34
313850,201711,179,60,119,56219.81,110933.24,167153.05
313860,201711,487,381,106,354349.18,98376.2,452725.38
313862,201711,176,115,61,107754.38,57157,164911.38
313865,201711,81,63,18,59030.45,16866,75896.45
313867,201711,49,37,12,34669,11244,45913
313868,201711,25,16,9,14240,8433,22673
313870,201711,124,65,59,60902.08,55283,116185.08
313880,201711,328,209,119,195545.42,110931.19,306476.61
313890,201711,316,171,145,159466.61,135297.39,294764.00
313900,201711,920,497,423,464078.14,396282.33,860360.47
313910,201711,135,95,40,89005.43,36535.12,125540.55
313920,201711,604,431,173,403643.57,162097.11,565740.68
313925,201711,33,28,5,26236,4685,30921
313930,201711,790,606,184,567814.85,172379.12,740193.97
313940,201711,1750,1099,651,1025332.22,609312.65,1634644.87
313950,201711,937,596,341,556650.54,319228.96,875879.50
313960,201711,1376,785,591,731314.99,552520.27,1283835.26
313970,201711,117,84,33,78705.76,30919.79,109625.55
313980,201711,205,132,73,123443.36,68398.02,191841.38
313990,201711,357,215,142,200884.72,132967.49,333852.21
314000,201711,912,618,294,575610.97,275456.1,851067.07
314010,201711,74,48,26,44976,24362,69338
314015,201711,52,17,35,15929,32795,48724
314020,201711,50,34,16,31856.13,14897.39,46753.52
314030,201711,93,45,48,41507.73,44974.67,86482.40
314040,201711,43,31,12,29047,11242.18,40289.18
314050,201711,314,184,130,172122.32,120308.91,292431.23
314053,201711,101,66,35,60902.82,32793.81,93696.63
314055,201711,293,170,123,159282.03,115249.29,274531.32
314060,201711,146,123,23,114313.66,21550.36,135864.02
314070,201711,945,467,478,433519.52,446947.61,880467.13
314080,201711,216,143,73,132536.08,67359.77,199895.85
314085,201711,120,80,40,74957,37480,112437
314090,201711,344,248,96,232372.15,89944.23,322316.38
314100,201711,471,385,86,356862.91,80016.6,436879.51
314110,201711,693,377,316,351376.72,295371.23,646747.95
314120,201711,99,54,45,50596.76,42164.56,92761.32
314130,201711,24,12,12,11243.33,11243.2,22486.53
314140,201711,1091,653,438,610235.17,408523.67,1018758.84
314150,201711,168,106,62,99319.81,58093.5,157413.31
314160,201711,359,262,97,242381.41,90692.69,333074.10
314170,201711,70,52,18,47974.4,16866,64840.4
314180,201711,724,632,92,591896.3,85263.91,677160.21
314190,201711,101,60,41,56217.98,38416.03,94634.01
314200,201711,591,407,184,379815.59,171468.94,551284.53
314210,201711,273,205,68,191144.01,63433.42,254577.43
314220,201711,313,236,77,219245.3,71865.71,291111.01
314225,201711,64,44,20,41228,18740,59968
314230,201711,101,46,55,43099.37,51532.8,94632.17
314240,201711,140,106,34,99314.73,31856.83,131171.56
314250,201711,60,36,24,33731.65,22488,56219.65
314260,201711,186,96,90,89951.29,84328.17,174279.46
314270,201711,334,260,74,242859.75,69054.99,311914.74
314280,201711,684,383,301,358853.84,282032.52,640886.36
314290,201711,552,441,111,411992.89,103724.75,515717.64
314300,201711,413,294,119,272565.55,111444.91,384010.46
314310,201711,1430,953,477,890766.21,446622.48,1337388.69
314315,201711,33,26,7,24360.56,6559,30919.56
314320,201711,599,379,220,354551.81,205509.53,560061.34
314330,201711,10678,5389,5289,5037188.7,4950770.84,9987959.54
314340,201711,571,264,307,246796.13,287080.25,533876.38
314345,201711,27,20,7,18740,6559,25299
314350,201711,186,112,74,104942.59,69334.54,174277.13
314360,201711,77,46,31,43102,29047,72149
314370,201711,58,49,9,45913,8433,54346
314380,201711,92,66,26,61839.63,24360.7,86200.33
314390,201711,3155,1991,1164,1860974.38,1087657.3,2948631.68
314400,201711,681,491,190,457219.04,178027.11,635246.15
314410,201711,419,268,151,251109.52,141478.48,392588.00
314420,201711,19,9,10,8433,9369.33,17802.33
314430,201711,2498,896,1602,836767.39,1498402.88,2335170.27
314435,201711,269,154,115,144013.27,106811.08,250824.35
314437,201711,25,19,6,17801,5622,23423
314440,201711,97,69,28,64643.78,26232.81,90876.59
314450,201711,152,116,36,108688.29,33730.44,142418.73
314460,201711,656,302,354,282965.82,331679.26,614645.08
314465,201711,81,56,25,52471.46,23424.68,75896.14
314467,201711,66,57,9,53394.09,8433,61827.09
314470,201711,372,190,182,174310.78,169585.32,343896.10
314480,201711,1034,505,529,473158.51,495446.81,968605.32
314490,201711,88,67,21,62775.74,19676.5,82452.24
314500,201711,316,206,110,193012.74,103068.06,296080.80
314505,201711,130,83,47,77771,44039,121810
314510,201711,226,181,45,169312.34,42165,211477.34
314520,201711,1215,633,582,585819.45,543405.2,1129224.65
314530,201711,685,545,140,509839.01,131179.2,641018.21
314535,201711,206,130,76,120779.3,70965.48,191744.78
314537,201711,62,37,25,34669,23425,58094
314540,201711,13,9,4,8431.25,3746.13,12177.38
314545,201711,50,34,16,31858,14992,46850
314550,201711,77,42,35,39353.02,32794.18,72147.20
314560,201711,807,434,373,404491.47,349485.74,753977.21
314570,201711,22,17,5,15929,4685,20614
314580,201711,19,9,10,8433,9370,17803
314585,201711,20,14,6,13118,5622,18740
314587,201711,84,72,12,67460.99,11243.39,78704.38
314590,201711,546,403,143,377591.89,133983.89,511575.78
314600,201711,988,639,349,594119.59,324755.1,918874.69
314610,201711,926,512,414,477523.49,386774.7,864298.19
314620,201711,146,108,38,99976.62,35606,135582.62
314625,201711,96,72,24,66899,22488,89387
314630,201711,1237,637,600,595126.42,561916.42,1157042.84
314640,201711,90,60,30,56218.89,28110,84328.89
314650,201711,204,118,86,109423.78,80111.66,189535.44
314655,201711,68,53,15,49660,14055,63715
314660,201711,18,14,4,13118,3748,16866
314670,201711,186,148,38,138388.1,35605.94,173994.04
314675,201711,215,119,96,111499.13,89949.79,201448.92
314690,201711,540,299,241,279869.15,225803.86,505673.01
314700,201711,2424,1325,1099,1236134.16,1029098.46,2265232.62
314710,201711,1640,955,685,890567.37,641190.22,1531757.59
314720,201711,409,241,168,224875.18,157407.54,382282.72
314730,201711,507,272,235,253442.25,220166.71,473608.96
314740,201711,679,331,348,308497.62,326063.67,634561.29
314750,201711,23,20,3,18740,2811,21551
314760,201711,304,151,153,141482.39,143342.68,284825.07
314770,201711,119,83,36,77769.49,33732,111501.49
314780,201711,21,6,15,5622,14054.4,19676.4
314790,201711,2331,1457,874,1358561.03,818224.14,2176785.17
314795,201711,51,44,7,40989,6559,47548
314800,201711,2889,1675,1214,1564212.03,1135860.51,2700072.54
314810,201711,1491,828,663,773519.78,619614.03,1393133.81
314820,201711,89,49,40,45911.41,37477.38,83388.79
314830,201711,207,162,45,151084.1,41882.5,192966.6
314840,201711,83,48,35,44976,32795,77771
314850,201711,349,172,177,161160.1,165843.31,327003.41
314860,201711,708,535,173,499318.67,160595.24,659913.91
314870,201711,1427,723,704,676472.2,659621.63,1336093.83
314875,201711,59,50,9,46848.81,8433,55281.81
314880,201711,46,33,13,30919.33,12181,43100.33
314890,201711,51,31,20,29044.96,18739.12,47784.08
314900,201711,30,25,5,23423.99,4685,28108.99
314910,201711,258,172,86,160881.14,80580.01,241461.15
314915,201711,152,134,18,125318.77,16864.71,142183.48
314920,201711,125,75,50,70273.34,46566.45,116839.79
314930,201711,1018,517,501,482567,469133.99,951700.99
314940,201711,54,42,12,39354,11243.7,50597.7
314950,201711,37,27,10,24596.25,9370,33966.25
314960,201711,60,44,16,41226.93,14992,56218.93
314970,201711,136,68,68,63151,63716,126867
314980,201711,305,198,107,183322.77,99321.86,282644.63
314990,201711,464,255,209,237981.2,194925.39,432906.59
314995,201711,197,64,133,59968,124611.63,184579.63
315000,201711,85,68,17,63714.33,15929,79643.33
315010,201711,47,31,16,29047,14992,44039
315015,201711,173,140,33,130464.84,30921,161385.84
315020,201711,61,52,9,48724,8433,57157
315030,201711,119,92,27,85258,25299,110557
315040,201711,66,49,17,45911.99,15928.03,61840.02
315050,201711,197,117,80,109625.06,74958.79,184583.85
315053,201711,39,34,5,31858,4685,36543
315057,201711,99,82,17,76642.37,15928.9,92571.27
315060,201711,70,64,6,58081.67,5622,63703.67
315070,201711,104,59,45,55281.22,42163.99,97445.21
315080,201711,369,304,65,284844.92,60904.26,345749.18
315090,201711,109,66,43,61841.7,40289.95,102131.65
315100,201711,74,39,35,36541.62,32793.56,69335.18
315110,201711,289,160,129,149074.47,120871.65,269946.12
315120,201711,1631,817,814,761614.28,761518.72,1523133.00
315130,201711,322,234,88,219251.59,82456,301707.59
315140,201711,533,310,223,288872.43,208943.55,497815.98
315150,201711,978,461,517,430991.88,484120.94,915112.82
315160,201711,206,104,102,97448,95570.95,193018.95
315170,201711,343,222,121,207060.57,113092.49,320153.06
315180,201711,3220,1368,1852,1277974.5,1732081.1,3010055.6
315190,201711,314,181,133,169210.01,124613.21,293823.22
315200,201711,1176,669,507,624114.8,474202.5,1098317.3
315210,201711,1517,864,653,805211.17,609444.63,1414655.80
315213,201711,41,26,15,24362,14055,38417
315217,201711,198,156,42,146163.03,39353.57,185516.60
315220,201711,1485,1137,348,1064753.08,325978.92,1390732.00
315230,201711,169,124,45,115903.05,42164.3,158067.35
315240,201711,425,274,151,256737.66,140303.25,397040.91
315250,201711,2520,1250,1270,1169621.25,1189637.34,2359258.59
315260,201711,148,91,57,83954.17,53407.54,137361.71
315270,201711,126,85,41,78517.3,37703.22,116220.52
315280,201711,689,451,238,422201.82,222995.52,645197.34
315290,201711,190,114,76,106809.68,70266.17,177075.85
315300,201711,71,45,26,42165,24362,66527
315310,201711,65,58,7,54344.71,6558.35,60903.06
315320,201711,156,84,72,78708,67463.8,146171.8
315330,201711,56,48,8,44976,7496,52472
315340,201711,422,297,125,277390.55,117122.31,394512.86
315350,201711,141,86,55,80576.59,51532.32,132108.91
315360,201711,97,52,45,48724,42164,90888
315370,201711,57,33,24,30920.26,22346.51,53266.77
315380,201711,12,7,5,6558.66,4685,11243.66
315390,201711,54,13,41,12181,38417,50598
315400,201711,816,612,204,568085.66,190488.06,758573.72
315410,201711,345,207,138,193674.49,129022.37,322696.86
315415,201711,58,44,14,41228,13118,54346
315420,201711,201,150,51,139796.53,47785.1,187581.63
315430,201711,679,401,278,374792.77,260008.98,634801.75
315440,201711,80,57,23,53407.05,21548.6,74955.65
315445,201711,256,205,51,191773.99,47786.8,239560.79
315450,201711,194,148,46,138667.15,43099.26,181766.41
315460,201711,3348,1705,1643,1592948.92,1537004.78,3129953.70
315470,201711,45,23,22,21268.19,20611.56,41879.75
315480,201711,61,23,38,21549.52,35605.29,57154.81
315490,201711,615,381,234,354977.78,219255.9,574233.68
315500,201711,22,12,10,11244,9370,20614
315510,201711,156,101,55,94628.47,51533.51,146161.98
315520,201711,72,63,9,59028.41,8430.82,67459.23
315530,201711,53,29,24,27173,22487.43,49660.43
315540,201711,243,158,85,148039.35,79642.82,227682.17
315550,201711,177,139,38,130242.04,35606,165848.04
315560,201711,748,593,155,554316.3,145235,699551.3
315570,201711,306,165,141,151737.2,132116.27,283853.47
315580,201711,651,425,226,398214.46,211758.35,609972.81
315590,201711,211,110,101,103070,94636.76,197706.76
315600,201711,293,211,82,196716.58,76638.89,273355.47
315610,201711,97,48,49,44975.81,45911.85,90887.66
315620,201711,32,25,7,23425,6559,29984
315630,201711,136,89,47,83388.8,44037.39,127426.19
315640,201711,55,33,22,30919.11,20612.53,51531.64
315645,201711,61,43,18,40289.73,16393,56682.73
315650,201711,167,120,47,112156.15,44039,156195.15
315660,201711,476,197,279,184587.46,261422.16,446009.62
315670,201711,2305,1182,1123,1104466.33,1051050.51,2155516.84
315680,201711,850,571,279,531517.53,260710.81,792228.34
315690,201711,692,472,220,441177.13,206134.71,647311.84
315700,201711,1896,1005,891,938669.71,834862.1,1773531.81
315710,201711,321,81,240,75894.06,224875.47,300769.53
315720,201711,429,274,155,256730.01,145227.02,401957.03
315725,201711,200,161,39,150854.5,36543,187397.5
315727,201711,41,22,19,20614,17801,38415
315730,201711,42,39,3,36540.25,2811,39351.25
315733,201711,86,55,31,51532.85,29045.36,80578.21
315737,201711,51,37,14,34669,13118,47787
315740,201711,43,38,5,35606,4685,40291
315750,201711,159,126,33,118060,30920.06,148980.06
315760,201711,44,29,15,27170.62,14054.94,41225.56
315765,201711,116,75,41,70274,38417,108691
315770,201711,227,134,93,125556.08,86857.39,212413.47
315780,201711,3255,1702,1553,1587823.83,1452725.93,3040549.76
315790,201711,206,159,47,148978.36,43476.36,192454.72
315800,201711,282,205,77,192081.5,72146.68,264228.18
315810,201711,92,53,39,49661,36260.89,85921.89
315820,201711,791,570,221,531822.32,207072.67,738894.99
315830,201711,144,81,63,75897,59028.52,134925.52
315840,201711,87,59,28,55277.62,26235.66,81513.28
315850,201711,261,190,71,178028.75,66526.74,244555.49
315860,201711,12,4,8,3748,7495.56,11243.56
315870,201711,34,27,7,25298.78,6559,31857.78
315880,201711,106,69,37,64652.35,34669,99321.35
315890,201711,73,54,19,50598,17803,68401
315895,201711,417,273,144,254551.65,134350.88,388902.53
315900,201711,70,33,37,30920,34669,65589
315910,201711,37,24,13,22253.14,12180.66,34433.80
315920,201711,185,121,64,113374.85,59017.52,172392.37
315930,201711,37,13,24,12181,22487.1,34668.1
315935,201711,148,117,31,109627,29034,138661
315940,201711,89,68,21,63713.63,19675.12,83388.75
315950,201711,65,46,19,43102,17802.16,60904.16
315960,201711,558,259,299,242037.43,279579.96,521617.39
315970,201711,39,31,8,29047,7496,36543
315980,201711,696,318,378,297401.77,354174.94,651576.71
315990,201711,244,148,96,138670.16,89668.86,228339.02
316000,201711,50,31,19,29047,17801.49,46848.49
316010,201711,74,62,12,58094,11244,69338
316020,201711,104,85,19,79645,17803,97448
316030,201711,408,209,199,195832.84,185945.53,381778.37
316040,201711,492,218,274,203976.05,256444.12,460420.17
316045,201711,61,54,7,50598,6559,57157
316050,201711,17,15,2,14054.93,1874,15928.93
316060,201711,95,61,34,56875.73,31858,88733.73
316070,201711,1022,655,367,607403.73,343109.31,950513.04
316080,201711,102,61,41,57156.61,38416.33,95572.94
316090,201711,43,26,17,23419.97,15927.1,39347.07
316095,201711,68,56,12,52191.55,11244,63435.55
316100,201711,299,173,126,161536,118055.01,279591.01
316105,201711,33,22,11,20614,10307,30921
316110,201711,1925,1544,381,1437467.3,356337.41,1793804.71
316120,201711,81,60,21,56217.03,19394.69,75611.72
316130,201711,139,107,32,99593.96,29984,129577.96
316140,201711,28,21,7,19674.78,6558.2,26232.98
316150,201711,197,139,58,129539.85,54345.93,183885.78
316160,201711,88,52,36,48724,33732,82456
316165,201711,63,46,17,42910.8,15226.25,58137.05
316170,201711,203,136,67,126493.46,62776.93,189270.39
316180,201711,195,92,103,85872.74,96510.16,182382.90
316190,201711,136,97,39,89947.68,36537.99,126485.67
316200,201711,698,395,303,370107.65,283531.6,653639.25
316210,201711,751,502,249,470004.51,233307.85,703312.36
316220,201711,116,77,39,72145.19,36542.56,108687.75
316225,201711,22,14,8,13118,7496,20614
316230,201711,33,19,14,17803,13117.35,30920.35
316240,201711,612,497,115,464745.92,107753.14,572499.06
316245,201711,100,83,17,77771,15929,93700
316250,201711,1491,1044,447,968998.89,417371.91,1386370.80
316255,201711,114,90,24,83955.18,22486.66,106441.84
316257,201711,178,95,83,89009.71,77488.8,166498.51
316260,201711,240,158,82,146766.69,76732.83,223499.52
316265,201711,25,16,9,14992,8433,23425
316270,201711,682,473,209,440475.76,195832.03,636307.79
316280,201711,547,340,207,317598.5,193294.38,510892.88
316290,201711,678,452,226,420698.67,211757.74,632456.41
316292,201711,487,194,293,181775.26,274303.35,456078.61
316294,201711,103,60,43,56217.91,40289.25,96507.16
316295,201711,279,121,158,111933.52,148041.9,259975.42
316300,201711,107,74,33,69336.51,30920.45,100256.96
316310,201711,34,18,16,16865.33,14991.65,31856.98
316320,201711,46,28,18,26234.95,16866,43100.95
316330,201711,128,82,46,75886.79,42818.79,118705.58
316340,201711,140,95,45,89013.89,42161.91,131175.80
316350,201711,192,137,55,128190.66,51533.49,179724.15
316360,201711,23,18,5,16866,4685,21551
316370,201711,1055,568,487,528458.39,455996.3,984454.69
316380,201711,123,93,30,87139,28110,115249
316390,201711,120,87,33,81518.36,30921,112439.36
316400,201711,139,105,34,98382.02,31858,130240.02
316410,201711,307,225,82,209463.95,76831.67,286295.62
316420,201711,191,137,54,127666.25,50597.45,178263.70
316430,201711,156,77,79,72147.43,74020.01,146167.44
316440,201711,97,47,50,44038,46849.78,90887.78
316443,201711,36,34,2,31858,1874,33732
316447,201711,66,52,14,48724,13118,61842
316450,201711,221,168,53,157408.15,49657.17,207065.32
316460,201711,66,28,38,26236,35605.69,61841.69
316470,201711,1572,1133,439,1053400.11,409816.05,1463216.16
316480,201711,13,10,3,9370,2811,12181
316490,201711,17,6,11,5622,10306.32,15928.32
316500,201711,151,100,51,93417.72,47786.04,141203.76
316510,201711,171,125,46,116138.43,43100.59,159239.02
316520,201711,190,116,74,108126.55,69336.96,177463.51
316530,201711,149,109,40,102132.08,37196.64,139328.72
316540,201711,143,80,63,74022.71,59031,133053.71
316550,201711,143,100,43,93695,40291,133986
316553,201711,232,110,122,102568.96,114308.65,216877.61
316555,201711,30,22,8,20612.44,7495.46,28107.90
316556,201711,12,7,5,6559,4685,11244
316557,201711,16,14,2,13116.33,1874,14990.33
316560,201711,57,45,12,42164.37,11243.33,53407.70
316570,201711,246,224,22,209367.09,20613.22,229980.31
316580,201711,21,15,6,14055,5622,19677
316590,201711,114,98,16,91824.56,14991.46,106816.02
316600,201711,181,147,34,137454.51,31858,169312.51
316610,201711,69,46,23,42819.66,21550.33,64369.99
316620,201711,129,99,30,92755.9,28107.7,120863.6
316630,201711,37,27,10,25299,9370,34669
316640,201711,16,10,6,9369.47,5622,14991.47
316650,201711,64,50,14,46850,13117.8,59967.8
316660,201711,6,4,2,3748,1873.4,5621.4
316670,201711,436,153,283,143330.99,264601.81,407932.80
316680,201711,156,108,48,101194.72,44783.33,145978.05
316690,201711,189,119,70,111499.6,65585.87,177085.47
316695,201711,59,52,7,48724,6559,55283
316700,201711,13,7,6,6558.09,5622,12180.09
316710,201711,713,520,193,486705.82,180837.11,667542.93
316720,201711,4838,2465,2373,2295810.92,2219365.21,4515176.13
316730,201711,14,13,1,12181,937,13118
316740,201711,133,82,51,76832.31,47785.89,124618.20
316750,201711,19,13,6,12180.53,5622,17802.53
316760,201711,326,265,61,248303.86,57156.21,305460.07
316770,201711,141,82,59,76833.72,55282,132115.72
316780,201711,67,39,28,36229.8,26232.08,62461.88
316790,201711,57,43,14,40287.65,13116.62,53404.27
316800,201711,1803,1107,696,1035000.01,650456.33,1685456.34
316805,201711,18,9,9,8432.67,8433,16865.67
316810,201711,65,42,23,39354,21268.33,60622.33
316820,201711,37,18,19,16866,17802.06,34668.06
316830,201711,92,40,52,37478.96,47502.41,84981.37
316840,201711,501,303,198,283157.61,183650.56,466808.17
316850,201711,344,225,119,209463.72,111498.83,320962.55
316860,201711,5955,2641,3314,2460428.09,3101974.41,5562402.50
316870,201711,1423,913,510,846283.72,473129.76,1319413.48
316880,201711,106,60,46,55552.79,43100.46,98653.25
316890,201711,253,166,87,155539.25,81516.73,237055.98
316900,201711,417,285,132,264521.58,123682.7,388204.28
316905,201711,17,10,7,9368.63,6558.98,15927.61
316910,201711,51,27,24,25298.72,22485.4,47784.12
316920,201711,135,106,29,98604.71,27170.48,125775.19
316930,201711,1920,963,957,896596.13,894492.8,1791088.93
316935,201711,864,517,347,482528.49,323629.71,806158.20
316940,201711,1102,631,471,590279.64,440734.89,1031014.53
316950,201711,191,100,91,93696,85266.41,178962.41
316960,201711,1089,606,483,566487.27,452273.84,1018761.11
316970,201711,636,496,140,464748.33,131178.53,595926.86
316980,201711,114,68,46,63716,43080.6,106796.6
316990,201711,2161,1413,748,1317594.48,699178.54,2016773.02
317000,201711,324,251,73,234901.45,68399.62,303301.07
317005,201711,247,176,71,164904.42,66522.17,231426.59
317010,201711,6233,3418,2815,3182857.6,2635687.19,5818544.79
317020,201711,16013,7074,8939,6596850.44,8357091.39,14953941.83
317030,201711,83,32,51,29984,47574.12,77558.12
317040,201711,3106,1923,1183,1798973.81,1106345.18,2905318.99
317043,201711,70,49,21,45913,19677,65590
317047,201711,33,15,18,14055,16854,30909
317050,201711,187,140,47,131173.57,44034.61,175208.18
317052,201711,122,95,27,89015,25299,114314
317057,201711,200,150,50,140547.26,46284.99,186832.25
317060,201711,55,36,19,33730.01,17520.61,51250.62
317065,201711,58,47,11,44039,10307,54346
317070,201711,1957,923,1034,859191.04,966743.84,1825934.88
317075,201711,112,59,53,55281.64,49661,104942.64
317080,201711,810,431,379,402461.18,354908.33,757369.51
317090,201711,628,505,123,470883.49,115248.89,586132.38
317100,201711,411,309,102,287641.56,95566.97,383208.53
317103,201711,106,91,15,85266.76,14055,99321.76
317107,201711,37,33,4,30920.42,3747.56,34667.98
317110,201711,96,42,54,39352.29,50597.13,89949.42
317115,201711,39,33,6,30920,5622,36542
317120,201711,1781,896,885,831699.98,828759.18,1660459.16
317130,201711,1897,1210,687,1130767.45,642740.09,1773507.54
317140,201711,6,5,1,4685,937,5622
317150,201711,266,158,108,148036.27,100435.51,248471.78
317160,201711,315,228,87,213243.77,81517.65,294761.42
317170,201711,206,144,62,134924.45,58088.58,193013.03
317180,201711,429,308,121,287880.22,113369.53,401249.75
317190,201711,256,171,85,160221.12,79081.09,239302.21
317200,201711,784,561,223,513364.88,208708.69,722073.57
317210,201711,151,86,65,79637.35,60902.88,140540.23
317220,201711,20,13,7,12179.62,6558.69,18738.31
320010,201711,614,458,156,425851.01,146171.36,572022.37
320013,201711,132,96,36,89947.97,33729.99,123677.96
320016,201711,285,179,106,167719.21,99321.22,267040.43
320020,201711,719,432,287,401301.18,266305.35,667606.53
320030,201711,150,111,39,104004.75,36213.53,140218.28
320035,201711,133,97,36,90886.5,33732,124618.5
320040,201711,492,258,234,240617.34,219254.83,459872.17
320050,201711,106,83,23,77770.66,21551,99321.66
320060,201711,1501,691,810,647393.66,758293.32,1405686.98
320070,201711,102,71,31,66527,29047,95574
320080,201711,753,432,321,401983.29,300775.24,702758.53
320090,201711,1185,824,361,768775.17,337411.23,1106186.40
320100,201711,313,178,135,166771.52,126477.63,293249.15
320110,201711,138,87,51,79825.15,47504.6,127329.75
320115,201711,110,90,20,84328.78,18739.33,103068.11
320120,201711,3249,1821,1428,1695231.27,1336337.81,3031569.08
320130,201711,7185,3446,3739,3208493.68,3494877.45,6703371.13
320140,201711,420,271,149,252610.37,139360.21,391970.58
320150,201711,1842,1087,755,1011909.13,707415.48,1719324.61
320160,201711,696,309,387,287546.68,361548.63,649095.31
320170,201711,116,90,26,83574.56,24362,107936.56
320180,201711,50,29,21,27173,19677,46850
320190,201711,235,160,75,149160.29,69991.33,219151.62
320200,201711,55,41,14,38416.56,13118,51534.56
320210,201711,844,475,369,443564.9,344776.08,788340.98
320220,201711,300,112,188,103995.86,175871.63,279867.49
320225,201711,72,59,13,55282,12181,67463
320230,201711,529,342,187,319139.93,174417.43,493557.36
320240,201711,3094,1563,1531,1461932.07,1431893.25,2893825.32
320245,201711,437,304,133,283716.61,124619.75,408336.36
320250,201711,219,117,102,108687.57,95574,204261.57
320255,201711,146,116,30,107407.94,27963.22,135371.16
320260,201711,175,123,52,115248.11,48677.15,163925.26
320265,201711,159,127,32,118196.62,29984,148180.62
320270,201711,150,122,28,114313.56,26236,140549.56
320280,201711,936,565,371,523196.09,346524.38,869720.47
320290,201711,66,56,10,52472,9370,61842
320300,201711,532,379,153,353675.4,142095.74,495771.14
320305,201711,643,342,301,320448.49,281839.29,602287.78
320310,201711,209,118,91,110283.12,84511.57,194794.69
320313,201711,294,150,144,140547.64,134643.02,275190.66
320316,201711,109,91,18,85265.34,16865.51,102130.85
320320,201711,3292,1490,1802,1390212.14,1685201.43,3075413.57
320330,201711,262,193,69,180187.17,62768.69,242955.86
320332,201711,869,530,339,494256.74,316598.5,810855.24
320334,201711,237,144,93,134645.93,87141,221786.93
320335,201711,145,105,40,97211.17,37480,134691.17
320340,201711,593,411,182,383975.76,169868.58,553844.34
320350,201711,963,413,550,384534.64,514815.7,899350.34
320360,201711,165,91,74,84981.59,69019.92,154001.51
320370,201711,245,187,58,173491.32,53321.62,226812.94
320380,201711,281,192,89,178488.72,83392.58,261881.30
320390,201711,1100,672,428,629050.17,399191.94,1028242.11
320400,201711,322,232,90,216438.86,84328.33,300767.19
320405,201711,874,367,507,343856.52,474719.81,818576.33
320410,201711,958,489,469,456382.27,438967.94,895350.21
320420,201711,479,246,233,230023.33,218318.81,448342.14
320425,201711,194,102,92,95572.55,86201.95,181774.50
320430,201711,386,217,169,201731.85,158351.52,360083.37
320435,201711,165,111,54,103199.7,50597.33,153797.03
320440,201711,196,122,74,114030.71,69338,183368.71
320450,201711,131,77,54,72148,50598,122746
320455,201711,239,192,47,178956.56,44038.4,222994.96
320460,201711,238,151,87,141487,81518.32,223005.32
320465,201711,117,79,38,73666.59,35606,109272.59
320470,201711,626,399,227,373546.56,212683.14,586229.70
320480,201711,172,114,58,106816.57,54346,161162.57
320490,201711,2981,1475,1506,1377995.78,1408218.21,2786213.99
320495,201711,89,56,33,52445.32,30921,83366.32
320500,201711,9282,4720,4562,4397399.96,4262111.18,8659511.14
320501,201711,537,271,266,253923.89,249241.2,503165.09
320503,201711,272,195,77,181768.28,72148.02,253916.30
320506,201711,248,189,59,177090.91,55280.23,232371.14
320510,201711,917,438,479,406647.14,447312.48,853959.62
320515,201711,79,66,13,60899.45,12181,73080.45
320517,201711,208,145,63,135863.89,59031,194894.89
320520,201711,6670,2979,3691,2777912.12,3450105.43,6228017.55
320530,201711,5164,2609,2555,2436139.14,2390743.41,4826882.55
330010,201711,2961,1545,1416,1440024.74,1323992.93,2764017.67
330015,201711,156,59,97,54343.27,90886.95,145230.22
330020,201711,3506,1530,1976,1430366.15,1850895.59,3281261.74
330022,201711,207,114,93,106817.15,86191.75,193008.90
330023,201711,520,185,335,172154.27,313885.76,486040.03
330025,201711,528,120,408,112436.7,381717.06,494153.76
330030,201711,1912,1213,699,1128387.81,651717.54,1780105.35
330040,201711,2251,1137,1114,1063211.01,1042496.08,2105707.09
330045,201711,8256,2613,5643,2440300.27,5281326.2,7721626.47
330050,201711,788,499,289,467553.4,270785.47,738338.87
330060,201711,856,537,319,499386.84,297592.47,796979.31
330070,201711,3367,1305,2062,1217364.47,1931003.8,3148368.27
330080,201711,1461,700,761,650711.04,712098.67,1362809.71
330090,201711,347,211,136,197703.59,127427.32,325130.91
330093,201711,285,129,156,120868.8,146127.08,266995.88
330095,201711,102,53,49,49660.23,45910.61,95570.84
330100,201711,9387,4871,4516,4555600.26,4227128.58,8782728.84
330110,201711,472,210,262,196056.73,245490.31,441547.04
330115,201711,517,307,210,287656.69,196768.73,484425.42
330120,201711,370,192,178,178772.37,166029.76,344802.13
330130,201711,1472,426,1046,398439.36,980010.78,1378450.14
330140,201711,593,313,280,293259.26,261402.46,554661.72
330150,201711,438,262,176,243610.87,163969.5,407580.37
330160,201711,206,127,79,118990.27,74019.62,193009.89
330170,201711,26502,9370,17132,8758589.67,16039529.5,24798119.17
330180,201711,232,144,88,131470.82,81746.98,213217.80
330185,201711,765,322,443,300190.85,413932.06,714122.91
330187,201711,271,86,185,80577.14,173333.33,253910.47
330190,201711,5550,2212,3338,2063584.79,3124377.12,5187961.91
330200,201711,4327,1521,2806,1420242.09,2624176.59,4044418.68
330205,201711,391,243,148,227261.31,138387.75,365649.06
330210,201711,989,602,387,559628.63,360919.15,920547.78
330220,201711,2476,1481,995,1384333.74,931361.87,2315695.61
330225,201711,540,302,238,282327.88,223002.62,505330.50
330227,201711,2461,798,1663,744605.14,1557811.23,2302416.37
330230,201711,201,122,79,113649.19,74022.22,187671.41
330240,201711,3587,1880,1707,1757287.37,1596509.3,3353796.67
330245,201711,152,66,86,61834.59,79828.35,141662.94
330250,201711,6367,3317,3050,3097569.86,2848711.99,5946281.85
330260,201711,560,168,392,157410.55,367282.25,524692.80
330270,201711,3278,1213,2065,1135624.97,1934256.79,3069881.76
330280,201711,434,285,149,264145.66,139596.54,403742.20
330285,201711,6996,2341,4655,2188792.79,4359327.36,6548120.15
330290,201711,573,225,348,209830.28,326064.07,535894.35
330300,201711,733,497,236,461925.66,221103.37,683029.03
330310,201711,413,239,174,222063.14,163032.16,385095.30
330320,201711,7967,3007,4960,2810095.33,4642061.05,7452156.38
330330,201711,9312,3645,5667,3408842.1,5305438.13,8714280.23
330340,201711,2624,1578,1046,1476657.53,980052.27,2456709.80
330350,201711,17700,7026,10674,6555992.56,9981145.18,16537137.74
330360,201711,2583,1261,1322,1180392.08,1238663.73,2419055.81
330370,201711,968,535,433,500539.27,403734.89,904274.16
330380,201711,830,364,466,340348.41,436162.1,776510.51
330385,201711,606,320,286,298885.47,267970.53,566856.00
330390,201711,5108,2851,2257,2657983.93,2112881.68,4770865.61
330395,201711,235,149,86,137915.74,78088.8,216004.54
330400,201711,636,329,307,303953.14,284992.02,588945.16
330410,201711,501,356,145,331910.24,135582.53,467492.77
330411,201711,231,134,97,125378.9,90838.96,216217.86
330412,201711,254,108,146,100910.55,136796.35,237706.90
330414,201711,6230,2523,3707,2360178.6,3470016.68,5830195.28
330415,201711,554,260,294,243606.39,274526.96,518133.35
330420,201711,2278,1208,1070,1128922.77,1000105.43,2129028.20
330430,201711,1787,801,986,749477.41,921592.72,1671070.13
330440,201711,253,114,139,106808.61,130237.54,237046.15
330450,201711,123,50,73,46847.52,68400.13,115247.65
330452,201711,1663,770,893,719495.45,836422.89,1555918.34
330455,201711,110028,39290,70738,36741599.04,66219385.55,102960984.59
330460,201711,264,107,157,100256.01,147107.66,247363.67
330470,201711,1233,681,552,631864.38,517201.44,1149065.82
330475,201711,1371,378,993,352296.49,929862.97,1282159.46
330480,201711,745,402,343,376011.38,320437.19,696448.57
330490,201711,13345,4736,8609,4431423.27,8059041.34,12490464.61
330500,201711,1332,614,718,575296.67,672354.23,1247650.90
330510,201711,11274,3737,7537,3494543.36,7055338.03,10549881.39
330513,201711,106,53,53,49660.1,49659.39,99319.49
330515,201711,863,355,508,328848.18,475603.48,804451.66
330520,201711,2413,907,1506,849618.79,1410951.89,2260570.68
330530,201711,226,118,108,110564.4,101001.84,211566.24
330540,201711,342,173,169,162094.67,157876.93,319971.60
330550,201711,3149,1102,2047,1031101.81,1915986.06,2947087.87
330555,201711,735,268,467,251085.49,436426.98,687512.47
330560,201711,543,205,338,192081.83,316686.81,508768.64
330570,201711,247,169,78,158349.47,73085.22,231434.69
330575,201711,790,330,460,308966.56,428963.06,737929.62
330580,201711,3330,1877,1453,1751667.03,1359682.5,3111349.53
330590,201711,310,159,151,148981.04,141481.32,290462.36
330600,201711,1077,691,386,645344.96,360020.36,1005365.32
330610,201711,1522,838,684,778123.59,636844.05,1414967.64
330615,201711,184,140,44,131176.05,41227.4,172403.45
330620,201711,915,453,462,422095.49,431364.91,853460.40
330630,201711,3701,2340,1361,2176246.01,1269086.63,3445332.64
350010,201711,593,389,204,362749.8,191145.55,553895.35
350020,201711,40,20,20,18739.56,18740,37479.56
350030,201711,517,335,182,312762.94,169362.3,482125.24
350040,201711,126,46,80,42764.68,74959.6,117724.28
350050,201711,287,159,128,148980.62,119673.04,268653.66
350055,201711,85,47,38,44038.21,35605.42,79643.63
350060,201711,74,28,46,26235.59,43100.47,69336.06
350070,201711,800,468,332,433744.56,309194.92,742939.48
350075,201711,66,43,23,40290.66,21550.47,61841.13
350080,201711,51,32,19,29358.93,16866,46224.93
350090,201711,101,58,43,54344.27,40286.2,94630.47
350100,201711,301,188,113,175452.14,105880.73,281332.87
350110,201711,60,38,22,35606,20614,56220
350115,201711,157,94,63,87420.29,59029.08,146449.37
350120,201711,111,74,37,69338,34669,104007
350130,201711,358,174,184,162473.56,172408,334881.56
350140,201711,34,20,14,17984,13118,31102
350150,201711,72,56,16,52470.67,14991.63,67462.30
350160,201711,2459,956,1503,892701.24,1406904.67,2299605.91
350170,201711,405,249,156,231148.96,145890,377038.96
350180,201711,186,97,89,90887.33,83392.83,174280.16
350190,201711,981,504,477,470238.13,446597.48,916835.61
350200,201711,72,26,46,24361.33,42841.8,67203.13
350210,201711,1357,762,595,705612.15,556998.53,1262610.68
350220,201711,679,582,97,541235.49,90887.63,632123.12
350230,201711,74,53,21,49661,19676.32,69337.32
350240,201711,64,49,15,45913,14055,59968
350250,201711,1221,614,607,569948.41,568036.43,1137984.84
350260,201711,92,66,26,61841.46,24361.07,86202.53
350270,201711,830,547,283,512152.55,263735.32,775887.87
350275,201711,298,116,182,108306.01,170532,278838.01
350280,201711,4686,2387,2299,2225510.83,2150297.54,4375808.37
350290,201711,397,188,209,175866.54,195267.19,371133.73
350300,201711,47,26,21,24362,19677,44039
350310,201711,99,71,28,66246,26236,92482
350315,201711,37,22,15,20612.4,14054.8,34667.2
350320,201711,3262,1607,1655,1501248.05,1550160.28,3051408.33
350330,201711,1671,885,786,825181.01,735176.19,1560357.20
350335,201711,21,14,7,13118,6559,19677
350340,201711,127,63,64,59030,59967.36,118997.36
350350,201711,97,48,49,44976,45913,90889
350360,201711,129,88,41,82443,38135,120578
350370,201711,97,56,41,51847.3,38406.44,90253.74
350380,201711,729,307,422,286998.43,394653.62,681652.05
350390,201711,1386,572,814,535170.83,761578.71,1296749.54
350395,201711,26,18,8,16866,7496,24362
350400,201711,1700,912,788,845698.63,734809.76,1580508.39
350410,201711,2224,987,1237,921729.62,1158703.72,2080433.34
350420,201711,237,146,91,136203.68,85265.64,221469.32
350430,201711,76,45,31,41601,29046.32,70647.32
350440,201711,153,111,42,103020.93,39354,142374.93
350450,201711,1595,1015,580,943893.7,543335.54,1487229.24
350460,201711,336,118,218,110564.33,203983.11,314547.44
350470,201711,13,10,3,9370,2811,12181
350480,201711,158,88,70,82455.32,65589.31,148044.63
350490,201711,239,116,123,107748.08,115251,222999.08
350500,201711,38,18,20,16865.32,18737.72,35603.04
350510,201711,168,113,55,105877.98,51534.33,157412.31
350520,201711,441,202,239,186764.33,223313.86,410078.19
350530,201711,457,217,240,203323.96,224878.8,428202.76
350535,201711,58,46,12,43102,11244,54346
350540,201711,377,191,186,178165.55,173997.6,352163.15
350550,201711,2738,1610,1128,1501425.01,1055586.58,2557011.59
350560,201711,623,435,188,407587.22,175801.8,583389.02
350570,201711,4229,1750,2479,1634318.94,2320277.83,3954596.77
350580,201711,369,173,196,161160.88,183627.25,344788.13
350590,201711,901,485,416,454439.39,388841.02,843280.41
350600,201711,6147,3082,3065,2873528.26,2868347.6,5741875.86
350610,201711,1550,783,767,728127.76,718630.26,1446758.02
350620,201711,38,26,12,24362,11244,35606
350630,201711,242,141,101,131175.17,93687.93,224863.10
350635,201711,834,327,507,306104.33,474410.26,780514.59
350640,201711,120,89,31,83392.19,29046.39,112438.58
350650,201711,1872,1229,643,1147865.63,601441.11,1749306.74
350660,201711,751,343,408,320758.66,381345.58,702104.24
350670,201711,314,161,153,150616.37,143359.44,293975.81
350680,201711,176,98,78,91826,73085.98,164911.98
350690,201711,201,98,103,91825.19,96510.13,188335.32
350700,201711,683,340,343,315261.69,321380.03,636641.72
350710,201711,321,132,189,122495.93,177091.61,299587.54
350715,201711,49,43,6,40290.02,5621.2,45911.22
350720,201711,18,13,5,12181,4685,16866
350730,201711,42,27,15,25299,14054.33,39353.33
350740,201711,208,117,91,109333.8,85263.73,194597.53
350745,201711,22,12,10,11215,9370,20585
350750,201711,2122,1381,741,1284859.67,693636.88,1978496.55
350760,201711,3726,1614,2112,1510675.5,1976484.5,3487160.0
350770,201711,60,41,19,38417,17803,56220
350775,201711,48,35,13,32795,12167,44962
350780,201711,416,201,215,188336.35,201452.02,389788.37
350790,201711,370,160,210,149918.95,196769.6,346688.55
350800,201711,428,240,188,224876.69,176155.14,401031.83
350810,201711,517,413,104,386025.32,97446.75,483472.07
350820,201711,85,52,33,48723.43,30920.33,79643.76
350830,201711,81,47,34,44037.43,31858,75895.43
350840,201711,708,322,386,301704.06,360735.64,662439.70
350850,201711,1751,1015,736,945066.17,689306.81,1634372.98
350860,201711,569,332,237,309166.15,222065.33,531231.48
350870,201711,440,298,142,279222.97,132765.78,411988.75
350880,201711,288,154,134,141460.03,125557.36,267017.39
350890,201711,43,26,17,24362,15929,40291
350900,201711,1455,467,988,435597.85,924983.98,1360581.83
350910,201711,27,18,9,16866,8433,25299
350920,201711,596,334,262,312634.76,245484.9,558119.66
350925,201711,1166,627,539,584507.25,503631.57,1088138.82
350930,201711,96,59,37,55281.92,34669,89950.92
350940,201711,697,393,304,366735.91,283033.37,649769.28
350945,201711,106,80,26,74431,24362,98793
350950,201711,15047,7265,7782,6779853.27,7281737.5,14061590.77
350960,201711,1278,595,683,552877.01,639940.45,1192817.46
350970,201711,1131,615,516,574007.98,483191.62,1057199.60
350980,201711,98,65,33,60905,30921,91826
350990,201711,366,130,236,120542.84,220845.68,341388.52
350995,201711,33,16,17,14991,15929,30920
351000,201711,639,456,183,425061.95,171470.32,596532.27
351010,201711,50,29,21,27172.6,19676.6,46849.2
351015,201711,58,42,16,39352.28,14991.8,54344.08
351020,201711,1661,960,701,897836.24,654765.66,1552601.90
351030,201711,331,231,100,213910.99,93698.24,307609.23
351040,201711,849,458,391,428195.04,365410.03,793605.07
351050,201711,3221,1557,1664,1452659.02,1557190.15,3009849.17
351060,201711,4898,2030,2868,1891091.69,2684133.88,4575225.57
351070,201711,422,271,151,251278.29,141485.51,392763.80
351080,201711,812,579,233,542517.86,217382.98,759900.84
351090,201711,64,28,36,26236,33732,59968
351100,201711,459,266,193,247049.75,180819.02,427868.77
351110,201711,2116,1027,1089,956096.73,1017614.65,1973711.38
351120,201711,76,41,35,38333.4,32795,71128.4
351130,201711,172,58,114,54344.21,106816.75,161160.96
351140,201711,338,236,102,219341.59,95572.63,314914.22
351150,201711,392,200,192,187109.52,179898.72,367008.24
351160,201711,246,160,86,149919.78,80581.9,230501.68
351170,201711,177,91,86,85264.97,79824.61,165089.58
351190,201711,91,62,29,58094,27172.68,85266.68
351200,201711,382,251,131,234589.48,122744.88,357334.36
351210,201711,132,61,71,56906.89,66526.8,123433.69
351220,201711,521,312,209,289011.83,195830.77,484842.60
351230,201711,278,201,77,187708.18,72129.63,259837.81
351240,201711,229,98,131,91637.18,122746.11,214383.29
351250,201711,70,50,20,46850,18740,65590
351260,201711,152,110,42,103070,39072,142142
351270,201711,49,21,28,19677,26235.17,45912.17
351280,201711,1108,508,600,472210.32,561659.87,1033870.19
351290,201711,227,101,126,94637,117779.22,212416.22
351300,201711,3743,1759,1984,1641372.26,1858365.24,3499737.50
351310,201711,749,394,355,367528.93,332633.45,700162.38
351320,201711,106,66,40,61842,37480,99322
351330,201711,40,28,12,26236,11244,37480
351340,201711,1209,763,446,707244.3,416878,1124122.3
351350,201711,2401,1308,1093,1223998.21,1023782.52,2247780.73
351360,201711,779,391,388,364488.68,362439.3,726927.98
351370,201711,367,194,173,181769.41,161474.31,343243.72
351380,201711,8927,4098,4829,3825124.82,4514335.37,8339460.19
351385,201711,29,20,9,18740,8433,27173
351390,201711,289,212,77,197911.8,72149,270060.8
351400,201711,61,37,24,34668,22423.63,57091.63
351410,201711,419,265,154,246896.68,143954.3,390850.98
351420,201711,61,49,12,45912.22,11244,57156.22
351430,201711,77,40,37,37479.68,34668.39,72148.07
351440,201711,782,543,239,506891.57,223926.97,730818.54
351450,201711,244,123,121,115249.89,113373.89,228623.78
351460,201711,122,56,66,51762.67,61841.14,113603.81
351470,201711,142,74,68,69323.03,63716,133039.03
351480,201711,516,285,231,265823.13,216328.73,482151.86
351490,201711,297,104,193,97446.09,180836.56,278282.65
351492,201711,32,23,9,21551,8433,29984
351495,201711,28,18,10,16866,9370,26236
351500,201711,3543,1529,2014,1426933.06,1882222.46,3309155.52
351510,201711,1760,736,1024,689333.65,957294.76,1646628.41
351512,201711,22,18,4,16865.56,3748,20613.56
351515,201711,192,108,84,101194,78706.89,179900.89
351518,201711,717,436,281,407577.77,263012.68,670590.45
351519,201711,74,47,27,44039,25299,69338
351520,201711,144,90,54,83699.29,50596.11,134295.40
351530,201711,20,14,6,13118,5622,18740
351535,201711,137,74,63,69338,59031,128369
351540,201711,430,307,123,285761.47,115249.06,401010.53
351550,201711,1301,797,504,741219.73,472208.46,1213428.19
351560,201711,74,36,38,33732,35606,69338
351565,201711,11,6,5,5622,4685,10307
351570,201711,2556,1319,1237,1234291.76,1158377.62,2392669.38
351580,201711,39,35,4,32795,3748,36543
351590,201711,68,45,23,42165,21551,63716
351600,201711,190,143,47,133990.02,44038.13,178028.15
351610,201711,59,29,30,27172.33,28110,55282.33
351620,201711,5956,3426,2530,3199974.94,2368347.47,5568322.41
351630,201711,2515,1296,1219,1208136.78,1140274.28,2348411.06
351640,201711,1651,804,847,750814.54,792108.38,1542922.92
351650,201711,29,25,4,23425,3748,27173
351660,201711,156,99,57,91542.46,53409,144951.46
351670,201711,747,469,278,437140.51,260482.65,697623.16
351680,201711,76,62,14,58092.58,13117.89,71210.47
351685,201711,45,29,16,27173,14992,42165
351690,201711,306,219,87,203368.55,81519,284887.55
351700,201711,166,116,50,108690.72,46850,155540.72
351710,201711,73,52,21,48724,19676.49,68400.49
351720,201711,135,61,74,57156.73,69337.46,126494.19
351730,201711,93,68,25,63715.56,23419.88,87135.44
351740,201711,711,476,235,444496.36,220186.4,664682.76
351750,201711,366,154,212,143352.09,198641.1,341993.19
351760,201711,796,623,173,583980.67,161962.09,745942.76
351770,201711,287,247,40,231431.17,37479.49,268910.66
351780,201711,170,94,76,88066.33,71211.56,159277.89
351790,201711,243,129,114,120871.66,106815.26,227686.92
351800,201711,54,35,19,32795,17803,50598
351810,201711,122,80,42,74959,39354,114313
351820,201711,881,637,244,593378.72,228339.77,821718.49
351830,201711,503,184,319,171654.91,298898.32,470553.23
351840,201711,1850,947,903,877770.05,844261.43,1722031.48
351850,201711,226,169,57,157733.96,53408.6,211142.56
351860,201711,756,496,260,460038.32,243612.48,703650.80
351870,201711,5616,2663,2953,2485800.26,2760607.4,5246407.66
351880,201711,18836,8341,10495,7791471.22,9818038.62,17609509.84
351885,201711,91,61,30,56453.89,28110,84563.89
351890,201711,74,62,12,58090.68,11244,69334.68
351900,201711,223,135,88,125829,82455.56,208284.56
351905,201711,76,34,42,31856.15,39353.46,71209.61
351907,201711,3101,1357,1744,1267999.25,1632282.54,2900281.79
351910,201711,178,73,105,68398.86,98384.53,166783.39
351920,201711,138,81,57,75897,53370.79,129267.79
351925,201711,85,59,26,55283,24361.12,79644.12
351930,201711,375,261,114,244461.22,106817.43,351278.65
351940,201711,230,105,125,98383.4,117123.2,215506.6
351950,201711,147,86,61,80581,57157,137738
351960,201711,832,387,445,362432.19,415119.58,777551.77
351970,201711,1906,1009,897,943303.48,840178.45,1783481.93
351980,201711,144,73,71,66525.48,66526.24,133051.72
351990,201711,285,193,92,179902.58,85416.92,265319.50
352000,201711,354,210,144,196391.48,134927.8,331319.28
352010,201711,350,208,142,194894.52,133053,327947.52
352020,201711,194,71,123,66526,115250.6,181776.6
352030,201711,1002,519,483,485593.19,451001.2,936594.39
352040,201711,565,246,319,230493.01,298899.58,529392.59
352042,201711,279,97,182,90888.56,169968.19,260856.75
352044,201711,393,237,156,221128.99,146171.66,367300.65
352050,201711,3136,1287,1849,1197948.38,1731122.97,2929071.35
352060,201711,103,65,38,60905,35605,96510
352070,201711,101,71,30,65577.75,28108.94,93686.69
352080,201711,64,39,25,35604.55,23425,59029.55
352090,201711,172,118,54,110561.54,50596.66,161158.20
352100,201711,253,125,128,117118.02,118781.93,235899.95
352110,201711,114,35,79,32794.06,74020.79,106814.85
352115,201711,73,28,45,26236,42165,68401
352120,201711,95,62,33,58092.29,30921,89013.29
352130,201711,222,186,36,174093.66,33731.8,207825.46
352140,201711,179,74,105,68862,98384.23,167246.23
352150,201711,120,68,52,62771.7,48722.64,111494.34
352160,201711,133,89,44,83393,41228,124621
352170,201711,374,256,118,238924.57,110563.65,349488.22
352180,201711,611,414,197,386827.25,184575.8,571403.05
352190,201711,263,104,159,97438.63,148944.66,246383.29
352200,201711,32,17,15,15929,14054.74,29983.74
352210,201711,3730,1555,2175,1448807.06,2032733.22,3481540.28
352215,201711,52,28,24,26235.73,22036.4,48272.13
352220,201711,6929,2728,4201,2551225.72,3933818.45,6485044.17
352230,201711,3156,2010,1146,1871101.78,1068665.7,2939767.48
352240,201711,2192,1295,897,1210425.42,838468.11,2048893.53
352250,201711,2576,1356,1220,1267576.04,1139485.07,2407061.11
352260,201711,1112,627,485,585696.19,454156.29,1039852.48
352265,201711,62,28,34,26236,31857.8,58093.8
352270,201711,402,231,171,215499.84,160158.06,375657.90
352280,201711,388,242,146,225496.1,136792.4,362288.5
352290,201711,176,113,63,105316,59030.18,164346.18
352300,201711,101,77,24,72149,22487.03,94636.03
352310,201711,5752,2817,2935,2626771.44,2744386.48,5371157.92
352320,201711,935,495,440,461203.12,410255.79,871458.91
352330,201711,525,228,297,213305.68,278003.71,491309.39
352340,201711,1390,689,701,642022.02,656025.6,1298047.62
352350,201711,328,207,121,193954.87,113093,307047.87
352360,201711,228,92,136,85311.67,125809.66,211121.33
352370,201711,105,69,36,64652.08,33732,98384.08
352380,201711,118,73,45,68401,42165,110566
352390,201711,2422,1107,1315,1032823.94,1230880.33,2263704.27
352400,201711,468,200,268,186456.83,250824.89,437281.72
352410,201711,749,537,212,498705.39,198164.23,696869.62
352420,201711,101,64,37,59967.5,34668.5,94636.0
352430,201711,1752,776,976,722108.63,911682.44,1633791.07
352440,201711,3049,1575,1474,1467704.73,1377633.44,2845338.17
352450,201711,186,159,27,148983,25298.33,174281.33
352460,201711,572,295,277,275851.54,258837.62,534689.16
352470,201711,582,195,387,182706.36,362586.48,545292.84
352480,201711,1363,763,600,713372.2,561621.4,1274993.6
352490,201711,84,32,52,29984,48722.34,78706.34
352500,201711,1217,550,667,514112.76,623538.81,1137651.57
352510,201711,737,402,335,375727.71,313891.87,689619.58
352520,201711,535,236,299,221123.19,280012.61,501135.80
352530,201711,1706,904,802,846317.05,751075.57,1597392.62
352540,201711,75,50,25,46850,23425,70275
352550,201711,187,107,80,100257.66,74301.96,174559.62
352560,201711,48,39,9,36543,8433,44976
352570,201711,660,345,315,322656.92,295144.91,617801.83
352580,201711,56,38,18,34665.47,16866,51531.47
352585,201711,16,5,11,4685,10307,14992
352590,201711,4277,2158,2119,2016485.61,1984523.66,4001009.27
352600,201711,353,246,107,229561.25,100242.99,329804.24
352610,201711,923,431,492,401171.5,461001.89,862173.39
352620,201711,967,386,581,360737.38,544388.17,905125.55
352630,201711,220,84,136,78707.13,127000.98,205708.11
352640,201711,556,394,162,366794.7,151790.54,518585.24
352650,201711,89,60,29,56220,27173,83393
352660,201711,80,48,32,44976,29984,74960
352670,201711,1653,901,752,840745.37,703434.92,1544180.29
352680,201711,876,564,312,524309.65,291084.92,815394.57
352690,201711,4310,2001,2309,1866070.87,2159361.41,4025432.28
352700,201711,108,61,47,56874.26,44038.93,100913.19
352710,201711,1334,703,631,656798.91,588856.13,1245655.04
352720,201711,1264,627,637,584979.21,596573.12,1181552.33
352725,201711,26,24,2,22488,1874,24362
352730,201711,366,182,184,169369.06,172123.46,341492.52
352740,201711,410,257,153,238881.07,143360,382241.07
352750,201711,24,16,8,14710.9,7496,22206.9
352760,201711,190,139,51,130235.87,47787,178022.87
352770,201711,81,64,17,59968,15928.35,75896.35
352780,201711,81,45,36,42164.25,33732,75896.25
352790,201711,28,23,5,21551,4685,26236
352800,201711,247,165,82,154604.12,76551.67,231155.79
352810,201711,164,107,57,97779.88,53408.55,151188.43
352820,201711,66,54,12,50179.66,11243.89,61423.55
352830,201711,89,62,27,58094,25299,83393
352840,201711,585,307,278,286378.15,260479.98,546858.13
352850,201711,1343,483,860,451897.91,805788.54,1257686.45
352860,201711,128,83,45,77770,42164.33,119934.33
352870,201711,40,25,15,23425,14055,37480
352880,201711,188,128,60,119916.32,56220,176136.32
352885,201711,29,20,9,18739.45,8433,27172.45
352890,201711,53,37,16,34669,14710,49379
352900,201711,4921,2390,2531,2220981.63,2363977.92,4584959.55
352910,201711,39,30,9,28110,8433,36543
352920,201711,718,442,276,413209.96,258610.89,671820.85
352930,201711,1260,609,651,569139.93,606811.45,1175951.38
352940,201711,6329,2744,3585,2558965.3,3355636.98,5914602.28
352950,201711,89,35,54,32795,50597.09,83392.09
352960,201711,68,45,23,42165,21551,63716
352965,201711,20,8,12,7496,11244,18740
352970,201711,463,348,115,321970.91,106807.53,428778.44
352980,201711,177,93,84,87139,78708,165847
352990,201711,927,429,498,400033.64,465344.23,865377.87
353000,201711,67,31,36,29047,33732,62779
353010,201711,550,342,208,320451.73,194876.13,515327.86
353020,201711,284,209,75,195832.56,70275,266107.56
353030,201711,1166,531,635,497213.69,594301.79,1091515.48
353040,201711,85,52,33,48724,30921,79645
353050,201711,1296,820,476,761716.1,445910.02,1207626.12
353060,201711,7640,3582,4058,3341436.07,3796289.86,7137725.93
353070,201711,1636,1023,613,952284.55,573081.52,1525366.07
353080,201711,1309,690,619,644198.89,579966.49,1224165.38
353090,201711,58,36,22,33731.83,20614,54345.83
353100,201711,61,49,12,45911.65,11244,57155.65
353110,201711,1947,605,1342,565167.48,1255714.57,1820882.05
353120,201711,76,40,36,37479.04,33732,71211.04
353130,201711,871,434,437,405693.12,409416.38,815109.50
353140,201711,578,224,354,209819.18,331694.83,541514.01
353150,201711,358,197,161,183648.61,150843.16,334491.77
353160,201711,101,83,18,77771,16866,94637
353170,201711,196,63,133,59029.99,124581.98,183611.97
353180,201711,955,435,520,405325.25,486705.06,892030.31
353190,201711,466,331,135,308815.22,126210.92,435026.14
353200,201711,184,92,92,86196.79,86201.59,172398.38
353205,201711,26,18,8,16866,7496,24362
353210,201711,81,51,30,47786.8,28110,75896.8
353215,201711,56,32,24,29983.56,22488,52471.56
353220,201711,84,48,36,44975.2,32784.88,77760.08
353230,201711,160,61,99,57155.5,92763,149918.5
353240,201711,279,153,126,143359.97,118059.91,261419.88
353250,201711,203,108,95,101194.52,89014,190208.52
353260,201711,435,314,121,293098.47,113367.31,406465.78
353270,201711,68,49,19,45913,17146.68,63059.68
353280,201711,94,47,47,43565.58,44037.96,87603.54
353282,201711,119,88,31,82454.87,29045.96,111500.83
353284,201711,24,19,5,17803,4685,22488
353286,201711,1,1,0,937,0,937
353290,201711,81,48,33,44976,30907,75883
353300,201711,400,222,178,206488.88,166780.35,373269.23
353310,201711,53,48,5,44976,4685,49661
353320,201711,61,39,22,36543,20613,57156
353325,201711,54,35,19,32795,17494,50289
353330,201711,67,51,16,47640.6,14992,62632.6
353340,201711,621,192,429,179901.25,401392.81,581294.06
353350,201711,917,425,492,397401.74,459739.26,857141.00
353360,201711,111,88,23,82142.42,21268.02,103410.44
353370,201711,121,70,51,64647.55,47786.46,112434.01
353380,201711,28,21,7,19664,6559,26223
353390,201711,1044,503,541,471299.62,506904.68,978204.30
353400,201711,52,31,21,29046.2,19677,48723.2
353410,201711,121,74,47,69337.13,43983.7,113320.83
353420,201711,56,24,32,22488,29983,52471
353430,201711,546,362,184,335520.99,172120.95,507641.94
353440,201711,10197,4453,5744,4159927.15,5375418.44,9535345.59
353450,201711,57,30,27,28110,25299,53409
353460,201711,601,329,272,305130.64,253427.78,558558.42
353470,201711,2134,1162,972,1083899.53,908039.52,1991939.05
353475,201711,241,162,79,149146.55,74022.15,223168.70
353480,201711,191,152,39,142423.66,36543,178966.66
353490,201711,234,142,92,133052.09,86202.99,219255.08
353500,201711,181,108,73,99972.12,68400.32,168372.44
353510,201711,101,73,28,68377.63,26225.85,94603.48
353520,201711,210,144,66,134927.08,61841.03,196768.11
353530,201711,465,257,208,240805.16,194891.68,435696.84
353540,201711,349,231,118,216128.02,110565.23,326693.25
353550,201711,736,497,239,461361.95,223939.89,685301.84
353560,201711,638,272,366,253911.02,342618.19,596529.21
353570,201711,58,30,28,28109.06,26235.63,54344.69
353580,201711,356,272,84,254388.46,78705.07,333093.53
353590,201711,83,56,27,52159.7,25298.26,77457.96
353600,201711,267,148,119,138358.77,111266.92,249625.69
353610,201711,116,59,57,55282.81,53407.73,108690.54
353620,201711,564,306,258,284126.66,241460.78,525587.44
353625,201711,52,28,24,26236,22488,48724
353630,201711,235,169,66,154085.94,61842,215927.94
353640,201711,122,84,38,78707.36,35606,114313.36
353650,201711,836,329,507,306203.02,475041.93,781244.95
353657,201711,21,15,6,14055,5622,19677
353660,201711,255,139,116,130242.47,108409.25,238651.72
353670,201711,737,444,293,415075.97,274537.82,689613.79
353680,201711,98,70,28,65589.5,26236,91825.5
353690,201711,46,36,10,33732,9370,43102
353700,201711,284,199,85,186461.15,79644.56,266105.71
353710,201711,404,188,216,175213.62,202389.94,377603.56
353715,201711,47,36,11,33450.9,10306.4,43757.3
353720,201711,357,165,192,154577,179902.9,334479.9
353730,201711,1138,702,436,654872.22,408228.69,1063100.91
353740,201711,643,357,286,334225.23,267979.29,602204.52
353750,201711,98,60,38,55697.62,35605.02,91302.64
353760,201711,2681,1006,1675,940515.29,1565893.3,2506408.59
353770,201711,100,80,20,74491.5,18740,93231.5
353780,201711,1093,555,538,517388.84,502217.57,1019606.41
353790,201711,503,285,218,264999.87,202924.93,467924.80
353800,201711,3248,1658,1590,1545566.02,1487317.7,3032883.72
353810,201711,240,136,104,126587.05,97405.22,223992.27
353820,201711,180,88,92,82455.58,85587.96,168043.54
353830,201711,50,43,7,40291,6559,46850
353850,201711,168,87,81,81517.91,75895.63,157413.54
353860,201711,459,205,254,191370.15,237705.9,429076.05
353870,201711,4957,2492,2465,2319851.19,2299617.24,4619468.43
353880,201711,673,480,193,448427.69,179896.94,628324.63
353890,201711,588,330,258,308644.57,241744.49,550389.06
353900,201711,137,66,71,61841.53,66526.23,128367.76
353910,201711,178,89,89,83392.36,83393,166785.36
353920,201711,456,250,206,233069.19,192491.12,425560.31
353930,201711,982,592,390,552550.8,364191.86,916742.66
353940,201711,186,103,83,95761.4,76922.75,172684.15
353950,201711,514,318,196,297674.58,183648.91,481323.49
353960,201711,71,57,14,53407.15,13118,66525.15
353970,201711,72,48,24,44976,22488,67464
353980,201711,1500,746,754,696360.91,705820.11,1402181.02
353990,201711,76,42,34,39354,31857,71211
354000,201711,371,172,199,160498.05,186261.23,346759.28
354010,201711,94,50,44,46850,40756,87606
354020,201711,540,341,199,318574.8,186459.42,505034.22
354025,201711,55,44,11,41228,10307,51535
354030,201711,66,35,31,32795,29047,61842
354040,201711,93,67,26,62356.65,24362,86718.65
354050,201711,190,107,83,99974.27,77769.65,177743.92
354060,201711,770,372,398,348557.81,370495.51,719053.32
354070,201711,874,507,367,473034.65,343870.99,816905.64
354075,201711,208,115,93,107654.04,86194.56,193848.60
354080,201711,293,129,164,120589.72,153662.73,274252.45
354085,201711,19,12,7,11244,6559,17803
354090,201711,315,176,139,164824.18,130242.5,295066.68
354100,201711,5435,2251,3184,2099197.51,2977844.42,5077041.93
354105,201711,80,41,39,38416.12,36542.26,74958.38
354110,201711,46,20,26,18739.91,24361,43100.91
354120,201711,148,102,46,95432.29,43102,138534.29
354130,201711,699,472,227,442020.61,212399.35,654419.96
354140,201711,3159,1471,1688,1374948.3,1580355.2,2955303.5
354150,201711,637,392,245,366045.91,228150.98,594196.89
354160,201711,692,437,255,408277.86,238645.44,646923.30
354165,201711,19,12,7,11244,6559,17803
354170,201711,171,116,55,108033.97,51534.33,159568.30
354180,201711,64,39,25,36216,23425,59641
354190,201711,214,99,115,91168.54,107752.74,198921.28
354200,201711,129,70,59,65116,55282.5,120398.5
354210,201711,70,33,37,30921,34667.74,65588.74
354220,201711,649,400,249,374135.86,232085.75,606221.61
354230,201711,157,64,93,59966.71,86194.6,146161.31
354240,201711,313,203,110,188982.46,102442.82,291425.28
354250,201711,92,55,37,51535,34669,86204
354260,201711,1889,875,1014,810569.18,948777.74,1759346.92
354270,201711,97,72,25,67463.22,23425,90888.22
354280,201711,34,18,16,16866,14991.43,31857.43
354290,201711,149,102,47,94773.05,44037.69,138810.74
354300,201711,418,286,132,267665.3,123397,391062.3
354310,201711,103,75,28,69337.1,26236,95573.1
354320,201711,181,96,85,89952,79644.66,169596.66
354323,201711,17,15,2,14055,1874,15929
354325,201711,108,62,46,57300.21,43101.96,100402.17
354330,201711,2525,860,1665,801421.84,1557892.55,2359314.39
354340,201711,10592,5167,5425,4826823.78,5077769.01,9904592.79
354350,201711,132,89,43,83391.51,40150.11,123541.62
354360,201711,87,49,38,45912.5,35605.25,81517.75
354370,201711,273,144,129,134925.97,120872.66,255798.63
354380,201711,210,126,84,117279.96,78708,195987.96
354390,201711,2749,993,1756,929470.2,1643950.47,2573420.67
354400,201711,323,172,151,159788.84,140922.53,300711.37
354410,201711,610,299,311,278552.91,290466,569018.91
354420,201711,265,168,97,157415,90889,248304
354425,201711,316,181,135,169596.33,126494.32,296090.65
354430,201711,189,120,69,110893.55,63901.94,174795.49
354440,201711,40,28,12,26236,11244,37480
354450,201711,50,36,14,33732,13118,46850
354460,201711,103,60,43,56218.46,40291,96509.46
354470,201711,39,28,11,26236,10307,36543
354480,201711,118,62,56,58078.59,52461.86,110540.45
354490,201711,147,93,54,86982.68,50597.69,137580.37
354500,201711,394,197,197,184584.12,184586.53,369170.65
354510,201711,104,71,33,66527,30921,97448
354515,201711,38,13,25,12180.22,23425,35605.22
354520,201711,1601,716,885,667736.98,828748.79,1496485.77
354530,201711,633,330,303,307503.89,283055.97,590559.86
354540,201711,273,154,119,144296.63,111497.78,255794.41
354550,201711,42,23,19,21551,17803,39354
354560,201711,160,95,65,89012.47,60895.02,149907.49
354570,201711,142,93,49,87046.84,45913,132959.84
354580,201711,1967,942,1025,879785.79,960094.46,1839880.25
354600,201711,281,152,129,140205.58,120857.56,261063.14
354610,201711,71,65,6,60905,5622,66527
354620,201711,63,19,44,17803,41228,59031
354625,201711,17,11,6,10307,5610,15917
354630,201711,320,211,109,197198.12,102131.79,299329.91
354640,201711,782,504,278,468126.31,260483.56,728609.87
354650,201711,71,38,33,35591.33,30874.8,66466.13
354660,201711,817,604,213,562611.58,199580.83,762192.41
354670,201711,286,103,183,95566.48,170524.3,266090.78
354680,201711,1237,466,771,436628.69,721935.41,1158564.10
354690,201711,90,61,29,56209.12,27172.66,83381.78
354700,201711,76,56,20,52472,18740,71212
354710,201711,57,40,17,36855.3,15929,52784.3
354720,201711,20,19,1,17802.56,937,18739.56
354730,201711,1919,815,1104,760525.37,1034249.08,1794774.45
354740,201711,58,42,16,39353.8,14992,54345.8
354750,201711,439,261,178,244533.63,166778.88,411312.51
354760,201711,512,317,195,294687.55,182429.49,477117.04
354765,201711,11,5,6,4685,5622,10307
354770,201711,334,230,104,214417.5,96697.59,311115.09
354780,201711,8142,3316,4826,3093854.26,4516846.96,7610701.22
354790,201711,115,68,47,63716,44039,107755
354800,201711,411,231,180,216444.28,168374.19,384818.47
354805,201711,102,52,50,48089,46850,94939
354810,201711,138,80,58,74677.96,54345.14,129023.10
354820,201711,184,79,105,73813.56,98384.46,172198.02
354830,201711,39,22,17,20614,15929,36543
354840,201711,56,37,19,34667.8,17803,52470.8
354850,201711,4571,2033,2538,1897198.69,2373791.74,4270990.43
354860,201711,333,161,172,150855.42,158811.38,309666.80
354870,201711,11728,5301,6427,4941296.7,6012772.91,10954069.61
354880,201711,2999,1130,1869,1056612.82,1749323.82,2805936.64
354890,201711,2812,1562,1250,1458560.75,1170058.81,2628619.56
354900,201711,60,39,21,36543,19677,56220
354910,201711,1202,635,567,592123.35,531231.74,1123355.09
354920,201711,52,44,8,41228,7496,48724
354925,201711,12,7,5,6559,4685,11244
354930,201711,30,27,3,25031,2811,27842
354940,201711,799,585,214,546194.69,200514.69,746709.38
354950,201711,221,145,76,135435.56,71212,206647.56
354960,201711,170,64,106,59967.11,99040,159007.11
354970,201711,839,547,292,507719.86,272963.71,780683.57
354980,201711,8343,3119,5224,2913914.47,4892243.1,7806157.57
354990,201711,9170,4319,4851,4035397.29,4538609.32,8574006.61
354995,201711,511,180,331,168659,309551.4,478210.4
355000,201711,452,149,303,139606.46,282842,422448.46
355010,201711,619,396,223,371047.88,206763.13,577811.01
355020,201711,717,447,270,417888.55,252963.73,670852.28
355030,201711,202681,78453,124228,73290588.63,116300356.5,189590945.13
355040,201711,714,340,374,317067.89,350241.18,667309.07
355050,201711,152,101,51,93374.9,47785.89,141160.79
355060,201711,1417,724,693,673573.84,648105,1321678.84
355070,201711,1465,721,744,672718.95,696127.52,1368846.47
355080,201711,204,117,87,109420.9,80643.9,190064.8
355090,201711,288,193,95,178761.98,89014.21,267776.19
355100,201711,4777,2380,2397,2212733.57,2243771.11,4456504.68
355110,201711,293,190,103,176281.55,96511,272792.55
355120,201711,115,83,32,77301.98,29984,107285.98
355130,201711,53,28,25,26235.66,23425,49660.66
355140,201711,182,121,61,113376.13,57153.34,170529.47
355150,201711,665,403,262,376374.88,245021.69,621396.57
355160,201711,449,213,236,197160.34,220844,418004.34
355170,201711,2045,1059,986,990877.71,923555.99,1914433.70
355180,201711,624,267,357,249238.8,333685.98,582924.78
355190,201711,218,147,71,137738,66525.91,204263.91
355200,201711,119,68,51,63716,47787,111503
355210,201711,715,418,297,391662.32,278262.03,669924.35
355220,201711,6545,3535,3010,3302477.6,2811618.68,6114096.28
355230,201711,109,65,44,60905,41222.59,102127.59
355240,201711,4146,1835,2311,1706270.85,2161252.99,3867523.84
355250,201711,5313,2602,2711,2429842.04,2536886.3,4966728.34
355255,201711,49,29,20,27173,18740,45913
355260,201711,188,114,74,105860.37,69300.05,175160.42
355270,201711,166,98,68,91825.06,63005.33,154830.39
355280,201711,6198,2619,3579,2449074.76,3349104.38,5798179.14
355290,201711,77,58,19,54345.26,17803,72148.26
355300,201711,179,118,61,109346.53,57156.47,166503.00
355310,201711,103,57,46,53408.22,43102,96510.22
355320,201711,92,47,45,44039,41230.3,85269.3
355330,201711,271,151,120,141483.57,112439.26,253922.83
355340,201711,1396,542,854,505272.36,799432.89,1304705.25
355350,201711,139,72,67,67461.72,62777.14,130238.86
355360,201711,182,116,66,108485.86,61841.22,170327.08
355365,201711,26,21,5,19677,4685,24362
355370,201711,1023,580,443,537576.94,413749.5,951326.44
355380,201711,770,516,254,482036.76,237697.69,719734.45
355385,201711,57,40,17,37480,15929,53409
355390,201711,103,60,43,56219.56,40290.47,96510.03
355395,201711,186,112,74,104138.32,69338,173476.32
355400,201711,1522,949,573,884971.3,536311.76,1421283.06
355410,201711,4845,2261,2584,2100595.57,2410752.74,4511348.31
355420,201711,47,35,12,32795,11244,44039
355430,201711,344,210,134,196112.14,125557.23,321669.37
355440,201711,79,45,34,42163.9,31857.22,74021.12
355450,201711,420,199,221,182498,205911.26,388409.26
355460,201711,70,54,16,49654.84,14992,64646.84
355465,201711,51,32,19,29984,17803,47787
355470,201711,187,74,113,68395.55,105878.53,174274.08
355475,201711,12,8,4,7496,3748,11244
355480,201711,453,199,254,184863.04,236577.32,421440.36
355490,201711,113,82,31,76833,29047,105880
355495,201711,51,25,26,23424.6,24361.84,47786.44
355500,201711,1701,973,728,906830.41,682033.78,1588864.19
355510,201711,267,195,72,179292.5,67463.26,246755.76
355520,201711,38,30,8,27555.33,7496,35051.33
355530,201711,23,16,7,14992,6559,21551
355535,201711,76,38,38,35603.98,35606,71209.98
355540,201711,2338,941,1397,880278.24,1306783.37,2187061.61
355550,201711,64,39,25,36542.79,23425,59967.79
355560,201711,241,120,121,112437.76,112746.79,225184.55
355570,201711,30,19,11,17802.39,10307,28109.39
355580,201711,268,187,81,175217.99,75892.32,251110.31
355590,201711,24,15,9,14055,8433,22488
355600,201711,266,139,127,130242.42,118705.73,248948.15
355610,201711,208,136,72,127431.12,67464,194895.12
355620,201711,1251,576,675,537017.35,631372.95,1168390.30
355630,201711,402,287,115,267969.34,107755,375724.34
355635,201711,128,61,67,57156.81,62750.14,119906.95
355640,201711,570,333,237,311082.43,222068.5,533150.93
355645,201711,832,361,471,336581.81,439468.56,776050.37
355650,201711,2047,893,1154,834401.15,1081165.83,1915566.98
355660,201711,262,139,123,130243,115246.32,245489.32
355670,201711,475,181,294,169587.38,275470.6,445057.98
355680,201711,212,120,92,112439.24,85922,198361.24
355690,201711,86,40,46,37480,42756.46,80236.46
355695,201711,14,12,2,11244,1874,13118
355700,201711,1139,591,548,548744.71,512860.66,1061605.37
355710,201711,2205,1208,997,1128242.44,933527.74,2061770.18
355715,201711,21,19,2,17803,1874,19677
355720,201711,207,123,84,113682.96,78694.05,192377.01
355730,201711,90,52,38,47580.54,35604.56,83185.10
410010,201711,132,111,21,104004.62,19677,123681.62
410020,201711,106,95,11,89012.92,10306.16,99319.08
410030,201711,156,98,58,91164,54344.64,145508.64
410040,201711,975,526,449,492615.79,420515.78,913131.57
410045,201711,27,22,5,20612.49,4684.9,25297.39
410050,201711,466,261,205,244552.96,191896.18,436449.14
410060,201711,272,210,62,196762.34,58092.03,254854.37
410070,201711,317,260,57,243609.87,53407.08,297016.95
410080,201711,167,109,58,102131.89,54342.53,156474.42
410090,201711,79,70,9,65380.96,8433,73813.96
410100,201711,298,211,87,197391.76,80811.98,278203.74
410105,201711,41,24,17,22487.55,15927.92,38415.47
410110,201711,311,190,121,178026.57,113376.94,291403.51
410115,201711,27,19,8,17802.57,7495.2,25297.77
410120,201711,451,230,221,215207.59,207067.21,422274.80
410130,201711,41,27,14,25299,13117.46,38416.46
410140,201711,3061,1501,1560,1402758.9,1458687.63,2861446.53
410150,201711,2686,1077,1609,1008274.59,1506820.58,2515095.17
410160,201711,504,320,184,299551.55,172404.65,471956.20
410165,201711,66,44,22,41225.78,20613.46,61839.24
410170,201711,167,125,42,114920.6,39351.72,154272.32
410180,201711,2144,1239,905,1156877.78,846034.11,2002911.89
410185,201711,37,33,4,30919.27,3748,34667.27
410190,201711,429,270,159,252973.66,148972.42,401946.08
410200,201711,979,731,248,683162.29,232087.13,915249.42
410210,201711,549,281,268,263290.61,250544.77,513835.38
410220,201711,40,23,17,21550.56,15927.99,37478.55
410230,201711,126,70,56,65587.97,52467.83,118055.80
410240,201711,726,482,244,451059.72,228623.29,679683.01
410250,201711,381,281,100,262695.08,93697.49,356392.57
410260,201711,269,168,101,157416,94634.63,252050.63
410270,201711,28,17,11,15929,10307,26236
410275,201711,70,54,16,50597.28,14991.2,65588.48
410280,201711,315,175,140,163712.76,131177.27,294890.03
410290,201711,229,147,82,137557.76,76724.29,214282.05
410300,201711,82,66,16,61840.89,14992,76832.89
410302,201711,25,17,8,15928.3,7495.14,23423.44
410304,201711,47,32,15,29984,14055,44039
410305,201711,203,109,94,101320.35,88073.09,189393.44
410310,201711,261,166,95,155540.02,89008.54,244548.56
410315,201711,58,42,16,39324,14992,54316
410320,201711,139,98,41,91817.52,38414.91,130232.43
410322,201711,34,24,10,22488,9370,31858
410330,201711,164,116,48,108689.9,44974.99,153664.89
410335,201711,96,59,37,55281.47,34667.63,89949.10
410337,201711,39,34,5,31855.96,4684.67,36540.63
410340,201711,32,30,2,28110,1874,29984
410345,201711,212,134,78,125552.74,73085.04,198637.78
410347,201711,52,40,12,37480,11244,48724
410350,201711,230,139,91,129958.01,85264.93,215222.94
410360,201711,457,277,180,257032.37,168092.5,425124.87
410370,201711,2354,980,1374,915634.66,1284377.83,2200012.49
410380,201711,224,145,79,135858.33,74021.69,209880.02
410390,201711,370,279,91,261404.34,85261.28,346665.62
410395,201711,34,22,12,20614,10862,31476
410400,201711,829,415,414,387510.82,387355.84,774866.66
410405,201711,89,65,24,60905,22488,83393
410410,201711,43,33,10,30921,9370,40291
410420,201711,1652,818,834,764650.5,779866.56,1544517.06
410425,201711,182,88,94,82262.49,88076.06,170338.55
410430,201711,2209,1297,912,1212163.77,853375.19,2065538.96
410440,201711,394,284,110,265150.85,103066.69,368217.54
410442,201711,360,240,120,223929.56,112439.26,336368.82
410445,201711,424,294,130,275474.29,121807.1,397281.39
410450,201711,408,200,208,187388.6,194882.18,382270.78
410460,201711,403,214,189,200229.5,177091.8,377321.3
410465,201711,195,127,68,117496.98,63430.93,180927.91
410470,201711,220,140,80,131172.94,74958.82,206131.76
410480,201711,5656,2802,2854,2607392.55,2668009.28,5275401.83
410490,201711,1368,906,462,847144.09,430997.59,1278141.68
410500,201711,262,151,111,141479.56,104001.22,245480.78
410510,201711,173,127,46,118996.76,42464.3,161461.06
410520,201711,267,197,70,184584.95,65589.37,250174.32
410530,201711,236,88,148,82453.99,138658.65,221112.64
410540,201711,320,229,91,213980.69,85260.41,299241.10
410550,201711,1596,696,900,651667.69,843006.03,1494673.72
410560,201711,148,111,37,104003.17,34666.53,138669.70
410570,201711,435,309,126,288264.35,118061.56,406325.91
410580,201711,3199,1445,1754,1351362.04,1641773.16,2993135.20
410590,201711,393,281,112,263294.23,104942.97,368237.20
410600,201711,181,158,23,148043.71,21551,169594.71
410610,201711,54,44,10,41226.55,9368.93,50595.48
410620,201711,240,174,66,163030.96,61837.99,224868.95
410630,201711,452,268,184,251108.98,171259.69,422368.67
410640,201711,954,577,377,537513.98,351653.59,889167.57
410645,201711,97,73,24,67997,22488,90485
410650,201711,362,249,113,232370.84,105879.36,338250.20
410655,201711,77,59,18,55281.5,16865.56,72147.06
410657,201711,42,20,22,18739.56,20613.08,39352.64
410660,201711,576,411,165,383858.43,154604.46,538462.89
410670,201711,77,63,14,59028.53,13117.42,72145.95
410680,201711,191,158,33,148040.99,30920.73,178961.72
410685,201711,18,12,6,11244,5621.99,16865.99
410690,201711,28566,12408,16158,11608942.91,15126535.91,26735478.82
410700,201711,324,237,87,221496.05,81515.89,303011.94
410710,201711,129,104,25,97444.92,23425,120869.92
410712,201711,23,14,9,13118,8433,21551
410715,201711,83,63,20,59028.57,18739.49,77768.06
410720,201711,589,354,235,331687.65,219607.24,551294.89
410725,201711,180,130,50,121801.9,46845.26,168647.16
410730,201711,88,54,34,50597.44,31854.41,82451.85
410740,201711,113,82,31,76833.56,29045.91,105879.47
410750,201711,219,163,56,152716.01,52464.16,205180.17
410752,201711,24,15,9,14055,8433,22488
410753,201711,54,23,31,20890.41,29046.17,49936.58
410754,201711,35,22,13,20613.66,12180.29,32793.95
410755,201711,82,56,26,52188.63,24361.53,76550.16
410760,201711,712,404,308,378532.69,288107.05,666639.74
410765,201711,1658,792,866,735972.1,810566.3,1546538.4
410770,201711,108,92,16,86198.63,14990.83,101189.46
410773,201711,46,34,12,31858,11244,43102
410775,201711,177,131,46,122087.08,43101.13,165188.21
410780,201711,80,43,37,40283.15,34665.79,74948.94
410785,201711,65,50,15,46658.66,14055,60713.66
410790,201711,68,32,36,29984,33731.93,63715.93
410800,201711,296,186,110,173330.34,103069.64,276399.98
410810,201711,29,24,5,22485.79,4401.5,26887.29
410820,201711,177,130,47,121664.1,44037.64,165701.74
410830,201711,8530,3886,4644,3632798.98,4349175.95,7981974.93
410832,201711,102,73,29,68118.14,27171.51,95289.65
410840,201711,1394,770,624,719236.51,584251.27,1303487.78
410845,201711,63,39,24,36542.09,22487.66,59029.75
410850,201711,195,134,61,125251.84,57155.82,182407.66
410855,201711,46,40,6,37474.25,5620.81,43095.06
410860,201711,668,394,274,368390.85,256725.57,625116.42
410865,201711,109,83,26,77769.66,24362,102131.66
410870,201711,149,131,18,122743.9,16577,139320.9
410880,201711,1089,547,542,511997.69,507770.42,1019768.11
410890,201711,78,56,22,52467.52,20613.34,73080.86
410895,201711,75,56,19,52472,17802.89,70274.89
410900,201711,19,13,6,12180,5622,17802
410910,201711,20,17,3,15929,2811,18740
410920,201711,35,24,11,22487.96,10307,32794.96
410930,201711,494,319,175,298689.1,163969.48,462658.58
410940,201711,4331,2580,1751,2408994.04,1637420.9,4046414.94
410950,201711,125,90,35,84329.65,32795,117124.65
410960,201711,761,335,426,313602.15,398829.65,712431.80
410965,201711,63,48,15,44694.9,14055,58749.9
410970,201711,624,445,179,416503.05,167719.63,584222.68
410975,201711,110,67,43,62269.93,40290.66,102560.59
410980,201711,1543,703,840,656177.57,785742.76,1441920.33
410990,201711,267,181,86,169422.94,80299.82,249722.76
411000,201711,61,40,21,37479.56,19677,57156.56
411005,201711,23,18,5,16866,4685,21551
411007,201711,245,139,106,130241.37,99317.2,229558.57
411010,201711,571,403,168,377588.47,157409.26,534997.73
411020,201711,283,195,88,182710.18,82455.8,265165.98
411030,201711,22,13,9,12178.98,8431.2,20610.18
411040,201711,49,34,15,31858,14055,45913
411050,201711,220,174,46,162023.59,42919,204942.59
411060,201711,521,354,167,331670.19,156472.01,488142.20
411065,201711,60,53,7,49661,6559,56220
411070,201711,1185,799,386,744503.1,361668.22,1106171.32
411080,201711,242,170,72,159362.37,67457.49,226819.86
411090,201711,113,85,28,79645,26235.73,105880.73
411095,201711,262,108,154,100720.45,144285.97,245006.42
411100,201711,112,94,18,88072.73,16865.5,104938.23
411110,201711,123,83,40,77771,37478.38,115249.38
411120,201711,180,135,45,126492.29,42163.89,168656.18
411125,201711,180,78,102,72446.18,95565.74,168011.92
411130,201711,123,106,17,98686.56,15929,114615.56
411140,201711,174,121,53,113060.81,49143.02,162203.83
411150,201711,1186,789,397,739268.04,371983.2,1111251.24
411155,201711,115,81,34,75894.22,31858,107752.22
411160,201711,22,10,12,9369.76,11243.06,20612.82
411170,201711,60,54,6,50316.44,5622,55938.44
411180,201711,916,602,314,562833.19,294202.79,857035.98
411190,201711,330,184,146,171743.15,136791.47,308534.62
411200,201711,668,446,222,416640.67,207400.46,624041.13
411210,201711,669,356,313,332043.53,293270.77,625314.30
411220,201711,146,110,36,103069.27,33730.93,136800.20
411230,201711,41,38,3,35604,2811,38415
411240,201711,126,86,40,80580.12,37480,118060.12
411250,201711,417,304,113,284829.72,105877.67,390707.39
411260,201711,22,15,7,14055,6559,20614
411270,201711,291,159,132,148978.7,123681.77,272660.47
411275,201711,201,177,24,165137.32,22488,187625.32
411280,201711,231,163,68,151467.92,63714.35,215182.27
411290,201711,56,41,15,38417,14055,52472
411295,201711,138,110,28,103068.66,26235,129303.66
411300,201711,82,45,37,42163.08,34668.33,76831.41
411310,201711,93,71,22,66526.08,20614,87140.08
411320,201711,749,547,202,511002.86,187688.5,698691.36
411325,201711,47,29,18,27173,16866,44039
411330,201711,899,575,324,537020.89,302693.47,839714.36
411340,201711,28,19,9,17803,8122,25925
411342,201711,79,57,22,53406.65,20613.3,74019.95
411345,201711,121,59,62,55282.94,58093.22,113376.16
411350,201711,479,386,93,360401.09,86190.01,446591.10
411360,201711,54,34,20,31858,18739.33,50597.33
411370,201711,14010,5748,8262,5369387.82,7726869.95,13096257.77
411373,201711,190,141,49,132116.51,45912.33,178028.84
411375,201711,83,68,15,63714.96,14054.27,77769.23
411380,201711,96,72,24,67459,22488,89947
411390,201711,139,93,46,87137.99,43101.33,130239.32
411400,201711,348,260,88,243603.42,82450.08,326053.50
411410,201711,451,232,219,216722.33,204918.7,421641.03
411420,201711,1044,479,565,446558.46,528640.5,975198.96
411430,201711,401,260,141,242960.19,132099.09,375059.28
411435,201711,38,28,10,26236,9370,35606
411440,201711,470,375,95,349725.83,89012.61,438738.44
411450,201711,434,359,75,336363.24,70273.47,406636.71
411460,201711,732,291,441,271609.75,411764.08,683373.83
411470,201711,104,77,27,72147.41,25298.16,97445.57
411480,201711,625,352,273,328313.51,255233.84,583547.35
411490,201711,292,182,110,170529.38,103068.28,273597.66
411500,201711,111,94,17,88076.02,15544.49,103620.51
411510,201711,220,176,44,164169.01,41226.33,205395.34
411520,201711,5912,2322,3590,2171313.35,3356198.11,5527511.46
411530,201711,108,72,36,67463.83,33731.5,101195.33
411535,201711,45,17,28,15929,26236,42165
411540,201711,331,226,105,210937.78,98378.75,309316.53
411545,201711,68,47,21,44038.61,19676.74,63715.35
411550,201711,72,57,15,53408.87,14055,67463.87
411560,201711,382,177,205,165189.4,192079.62,357269.02
411570,201711,787,295,492,276117.44,460789.59,736907.03
411573,201711,42,25,17,23425,15928.3,39353.3
411575,201711,266,162,104,151784.83,97440.91,249225.74
411580,201711,1218,480,738,448454.67,689556.16,1138010.83
411585,201711,76,37,39,34667.38,36542.46,71209.84
411590,201711,26,18,8,16866,7495,24361
411600,201711,27,12,15,11244,14055,25299
411605,201711,238,108,130,101046.85,121805.04,222851.89
411610,201711,236,158,78,148042.41,73082.4,221124.81
411620,201711,360,200,160,187210.38,149915.03,337125.41
411630,201711,57,39,18,36542.59,16865.04,53407.63
411640,201711,38,31,7,29046.16,6559,35605.16
411650,201711,14,10,4,9369.11,3747.9,13117.01
411660,201711,38,33,5,30921,4685,35606
411670,201711,245,186,59,174273.78,55280.92,229554.70
411680,201711,154,131,23,122745.62,21550.4,144296.02
411690,201711,601,324,277,302782.11,259079.18,561861.29
411695,201711,61,47,14,44037.19,13118,57155.19
411700,201711,170,146,24,136801.91,22487.4,159289.31
411705,201711,103,67,36,62778.62,33732,96510.62
411710,201711,297,199,98,185492.39,91825.23,277317.62
411720,201711,131,84,47,78705.82,44036.86,122742.68
411721,201711,59,50,9,46848.8,8432.46,55281.26
411722,201711,100,42,58,39353.56,54341.91,93695.47
411725,201711,142,111,31,103717.96,29043.4,132761.36
411727,201711,82,66,16,61840.2,14710.1,76550.3
411729,201711,38,30,8,28107.52,7495.8,35603.32
411730,201711,544,355,189,331056.37,177085.45,508141.82
411740,201711,29,21,8,19675.45,7495.39,27170.84
411745,201711,69,46,23,42313.77,21548.91,63862.68
411750,201711,849,411,438,384003.78,409417.2,793420.98
411760,201711,1170,886,284,828927.84,266089.56,1095017.40
411770,201711,432,292,140,273592.75,131174.87,404767.62
411780,201711,365,237,128,222057.2,119931.13,341988.33
411790,201711,527,293,234,272547.47,219129.36,491676.83
411800,201711,172,135,37,126493.27,34668.08,161161.35
411810,201711,162,126,36,118055.53,33731.22,151786.75
411820,201711,2116,1037,1079,969368.51,1010573.35,1979941.86
411830,201711,12,12,0,11243.19,0,11243.19
411840,201711,1939,1196,743,1119403.16,695388.15,1814791.31
411845,201711,48,18,30,16865.73,28108.99,44974.72
411850,201711,1240,710,530,662805.83,494650.51,1157456.34
411860,201711,44,28,16,25952.45,14990.73,40943.18
411870,201711,38,28,10,26233.33,9370,35603.33
411880,201711,419,270,149,252724.65,138879.75,391604.40
411885,201711,102,69,33,64651.59,30919.01,95570.60
411890,201711,326,206,120,190676.45,112423.51,303099.96
411900,201711,72,52,20,48724,18738.47,67462.47
411910,201711,166,137,29,128355.26,26347.94,154703.20
411915,201711,2048,883,1165,826218.2,1090510.94,1916729.14
411920,201711,125,103,22,96508.67,20614,117122.67
411925,201711,16,11,5,10307,4685,14992
411930,201711,791,588,203,549054.59,190206.22,739260.81
411940,201711,590,420,170,393061.78,159261.78,552323.56
411950,201711,892,474,418,444130.18,390687.04,834817.22
411960,201711,951,675,276,629503.78,258602.12,888105.90
411965,201711,24,16,8,14992,7496,22488
411970,201711,70,63,7,59028.94,6559,65587.94
411980,201711,194,130,64,121805.69,59965.44,181771.13
411990,201711,4844,2852,1992,2656256.44,1864701.82,4520958.26
411995,201711,462,173,289,162094.64,270786.93,432881.57
412000,201711,288,167,121,155761.61,113362.82,269124.43
412010,201711,44,26,18,24361.56,16866,41227.56
412015,201711,45,33,12,30920.21,11244,42164.21
412020,201711,28,25,3,23143.46,2811,25954.46
412030,201711,62,52,10,48724,9370,58094
412033,201711,53,35,18,32764.24,16865.72,49629.96
412035,201711,76,47,29,44039,27173,71212
412040,201711,34,24,10,22205.6,9370,31575.6
412050,201711,202,150,52,140547.27,48722.76,189270.03
412060,201711,745,586,159,546245.32,148010.48,694255.80
412065,201711,46,32,14,29983.22,13118,43101.22
412070,201711,154,105,49,97724.84,45911.26,143636.10
412080,201711,274,143,131,133984.91,122744.28,256729.19
412085,201711,32,15,17,14055,15928.54,29983.54
412090,201711,730,456,274,425323.17,256721.44,682044.61
412100,201711,243,202,41,188326,38228.75,226554.75
412110,201711,71,58,13,54343.56,12180.56,66524.12
412120,201711,312,204,108,190582.89,101193.58,291776.47
412125,201711,79,46,33,42820.9,30920.86,73741.76
412130,201711,51,37,14,34669,13118,47787
412135,201711,28,15,13,14055,12181,26236
412140,201711,299,215,84,200820.46,78700.42,279520.88
412150,201711,259,173,86,161152,80578.5,241730.5
412160,201711,91,57,34,53405.46,31857.73,85263.19
412170,201711,628,454,174,425390.3,163031.75,588422.05
412175,201711,48,35,13,32795,12181,44976
412180,201711,197,158,39,147452.53,35932.65,183385.18
412190,201711,331,268,63,250453.77,59029.77,309483.54
412200,201711,190,123,67,115244.99,62774.71,178019.70
412210,201711,82,64,18,59965.33,16865.27,76830.60
412215,201711,243,165,78,154321.4,73084.27,227405.67
412217,201711,77,61,16,57151.7,14991.22,72142.92
412220,201711,818,610,208,571553.94,194883.36,766437.30
412230,201711,335,207,128,191774.52,119600.07,311374.59
412240,201711,1303,637,666,592652.99,621694.94,1214347.93
412250,201711,384,249,135,233303.29,126492.38,359795.67
412260,201711,126,92,34,86200.89,31858,118058.89
412265,201711,160,125,35,117119.73,32794.19,149913.92
412270,201711,86,54,32,50597.51,29983.8,80581.31
412280,201711,88,69,19,64652.13,17803,82455.13
412290,201711,94,64,30,59965.16,28108.15,88073.31
412300,201711,224,146,78,136794.71,73082.06,209876.77
412310,201711,41,34,7,31857.51,6559,38416.51
412320,201711,96,81,15,75896.33,14055,89951.33
412330,201711,168,149,19,139609.87,17802,157411.87
412340,201711,147,100,47,93693.54,43755.35,137448.89
412350,201711,586,288,298,268862.84,279215.16,548078.00
412360,201711,29,26,3,24362,2811,27173
412370,201711,164,139,25,129303.83,23423.13,152726.96
412380,201711,254,189,65,176810.72,60375.25,237185.97
412382,201711,52,27,25,25298.31,23424.06,48722.37
412385,201711,139,100,39,93700,36543,130243
412390,201711,275,205,70,192081.36,65588.38,257669.74
412395,201711,62,49,13,45908.36,12180.48,58088.84
412400,201711,71,51,20,47786.96,18740,66526.96
412402,201711,233,108,125,101191.18,116842.76,218033.94
412405,201711,808,322,486,300262.79,454700.13,754962.92
412410,201711,954,603,351,563494.31,328876.42,892370.73
412420,201711,16,12,4,11243.38,3748,14991.38
412430,201711,21,15,6,14054.63,5622,19676.63
412440,201711,592,316,276,293525.91,256566.09,550092.00
412450,201711,84,70,14,65585.93,13118,78703.93
412460,201711,79,62,17,58093.15,15928.61,74021.76
412470,201711,255,204,51,191144.45,47786.55,238931.00
412480,201711,176,134,42,124616.06,39353.31,163969.37
412490,201711,167,141,26,132110.12,24361.31,156471.43
412500,201711,479,388,91,362263.99,85265.92,447529.91
412510,201711,187,155,32,144667.78,29983.05,174650.83
412520,201711,126,69,57,64652,53408.6,118060.6
412530,201711,107,57,50,53407.66,46566.3,99973.96
412535,201711,107,82,25,76802.74,23423.51,100226.25
412540,201711,66,30,36,28109.33,33728.21,61837.54
412545,201711,100,73,27,68400.5,25297.05,93697.55
412550,201711,3470,1579,1891,1476099.66,1770681.02,3246780.68
412555,201711,16,11,5,10307,4685,14992
412560,201711,580,438,142,409079.34,133048.37,542127.71
412570,201711,724,406,318,379817.26,297677.8,677495.06
412575,201711,87,60,27,56219.16,25297.53,81516.69
412580,201711,160,109,51,102131.35,47786.3,149917.65
412590,201711,34,31,3,29045.69,2811,31856.69
412600,201711,174,134,40,125556.82,37479.23,163036.05
412610,201711,35,23,12,21550.7,10428.59,31979.29
412620,201711,147,130,17,121809.56,15929,137738.56
412625,201711,2175,1167,1008,1090405.33,942609.52,2033014.85
412627,201711,68,55,13,51535,12181,63716
412630,201711,431,288,143,268151.12,133706.7,401857.82
412635,201711,63,20,43,18738.85,40289.67,59028.52
412640,201711,117,78,39,73086,36542.03,109628.03
412650,201711,336,212,124,198356.09,116179.47,314535.56
412660,201711,485,290,195,271011.41,182706.23,453717.64
412665,201711,51,45,6,42165,5622,47787
412667,201711,306,206,100,192336.33,93352.41,285688.74
412670,201711,61,51,10,47785.74,9369.13,57154.87
412680,201711,286,228,58,213633.87,54345.2,267979.07
412690,201711,113,75,38,70271.99,35324,105595.99
412700,201711,167,114,53,106812.44,49372.97,156185.41
412710,201711,1411,879,532,818231.41,496024.74,1314256.15
412720,201711,225,152,73,142420,68399.31,210819.31
412730,201711,206,163,43,152719.69,39353.97,192073.66
412740,201711,412,222,190,207869.98,178024.45,385894.43
412750,201711,462,266,196,248297.45,183642.62,431940.07
412760,201711,248,129,119,120867.89,111500.48,232368.37
412770,201711,2054,1166,888,1088191.73,831711.28,1919903.01
412780,201711,149,117,32,109627.31,29981.66,139608.97
412785,201711,268,136,132,126950.63,123670.24,250620.87
412788,201711,37,23,14,21551,13118,34669
412790,201711,138,113,25,105223.74,23424.88,128648.62
412795,201711,158,118,40,110564.83,37480,148044.83
412796,201711,297,204,93,190001.51,87007.3,277008.81
412800,201711,557,367,190,343319.56,178010.23,521329.79
412810,201711,2986,1664,1322,1553440.37,1237287.84,2790728.21
412820,201711,949,622,327,572255.24,303759.54,876014.78
412830,201711,17,14,3,13117.16,2811,15928.16
412840,201711,218,157,61,146164.19,57153.96,203318.15
412850,201711,781,531,250,495661.84,234239.13,729900.97
412853,201711,177,95,82,89013.42,76832.26,165845.68
412855,201711,223,121,102,112278.31,95571.85,207850.16
412860,201711,89,68,21,63714.67,19677,83391.67
412862,201711,60,45,15,41881.31,14054.74,55936.05
412863,201711,7,6,1,5622,937,6559
412865,201711,44,33,11,30921,10307,41228
412870,201711,110,71,39,65862,36541.93,102403.93
412880,201711,111,85,26,79642.61,24362,104004.61
420005,201711,36,33,3,30920.2,2247,33167.2
420010,201711,365,241,124,224663.27,116183.03,340846.30
420020,201711,74,63,11,59025.87,10305.31,69331.18
420030,201711,28,25,3,23423.12,2811,26234.12
420040,201711,108,81,27,75895.69,25296.53,101192.22
420050,201711,56,33,23,30548.9,21387.94,51936.84
420055,201711,19,18,1,16866,937,17803
420060,201711,33,25,8,23425,7496,30921
420070,201711,99,86,13,80580.9,12171.63,92752.53
420075,201711,13,11,2,10306.56,1874,12180.56
420080,201711,48,42,6,38463.85,5622,44085.85
420090,201711,35,33,2,30156.9,1874,32030.9
420100,201711,158,132,26,122745.47,24362,147107.47
420110,201711,17,17,0,15929,0,15929
420120,201711,43,32,11,29982.89,10307,40289.89
420125,201711,81,65,16,60903.59,14992,75895.59
420127,201711,33,30,3,28108.52,2811,30919.52
420130,201711,377,241,136,225519.34,127183.11,352702.45
420140,201711,1260,734,526,686653.18,492751.83,1179405.01
420150,201711,48,41,7,38417,6559,44976
420160,201711,42,39,3,36543,2811,39354
420165,201711,18,14,4,13118,3748,16866
420170,201711,63,42,21,39353.13,19675.88,59029.01
420180,201711,23,22,1,20614,937,21551
420190,201711,31,28,3,26236,2811,29047
420195,201711,127,61,66,57156.48,61558.56,118715.04
420200,201711,1268,565,703,523071.52,658314.45,1181385.97
420205,201711,67,33,34,30920.83,31856.85,62777.68
420207,201711,103,58,45,54346,42154.3,96500.3
420208,201711,23,18,5,16866,3841.56,20707.56
420209,201711,20,16,4,14991.12,3747.66,18738.78
420210,201711,463,219,244,204914.16,228526.53,433440.69
420213,201711,48,38,10,35606,9369.43,44975.43
420215,201711,26,22,4,20614,3748,24362
420220,201711,71,46,25,43100.77,23423.6,66524.37
420230,201711,732,419,313,391836.22,293264.53,685100.75
420240,201711,2262,1535,727,1430770.59,680235.65,2111006.24
420243,201711,34,27,7,25297.68,6559,31856.68
420245,201711,94,55,39,51530.42,36541.29,88071.71
420250,201711,54,31,23,29047,21551,50598
420253,201711,40,34,6,31857.3,5622,37479.3
420257,201711,9,7,2,6559,1873.2,8432.2
420260,201711,95,84,11,78707.53,10307,89014.53
420270,201711,37,30,7,28101.97,6559,34660.97
420280,201711,276,204,72,190058.09,66172.32,256230.41
420285,201711,20,12,8,11244,7496,18740
420287,201711,48,30,18,28110,16865.39,44975.39
420290,201711,974,688,286,643653.27,267870.92,911524.19
420300,201711,1375,1081,294,1008900.47,274240.2,1283140.67
420310,201711,56,43,13,40288.77,12180.19,52468.96
420315,201711,34,30,4,28110,3748,31858
420320,201711,845,425,420,397260.54,393521.24,790781.78
420325,201711,0,0,0,0,0,0
420330,201711,120,82,38,76833.65,35492.71,112326.36
420340,201711,158,108,50,100233.09,46819.25,147052.34
420350,201711,240,174,66,161714.93,61841.25,223556.18
420360,201711,745,567,178,529597.85,165194.12,694791.97
420370,201711,105,69,36,64461.89,33447.94,97909.83
420380,201711,1121,793,328,738301.89,306228.99,1044530.88
420390,201711,251,162,89,150543.33,82687.24,233230.57
420395,201711,180,128,52,119930.83,48713,168643.83
420400,201711,246,182,64,169961.54,59968,229929.54
420410,201711,59,46,13,43101.56,12180.65,55282.21
420415,201711,33,30,3,28109.86,2811,30920.86
420417,201711,47,35,12,32793.8,11230.19,44023.99
420419,201711,12,11,1,10306,937,11243
420420,201711,2776,1702,1074,1582411.69,1003754.82,2586166.51
420425,201711,68,58,10,54331.23,9060.12,63391.35
420430,201711,1278,890,388,830194.7,361832.35,1192027.05
420435,201711,15,13,2,12181,1874,14055
420440,201711,109,74,35,68644.65,32590.98,101235.63
420445,201711,23,21,2,19676.27,1874,21550.27
420450,201711,75,35,40,32780,37479.06,70259.06
420455,201711,249,192,57,179866.72,53305.93,233172.65
420460,201711,2314,1548,766,1445516.04,717442.12,2162958.16
420470,201711,124,89,35,83392.08,32793.25,116185.33
420475,201711,6,6,0,5622,0,5622
420480,201711,849,628,221,583017.5,206136.33,789153.83
420490,201711,109,84,25,78705.21,23424.61,102129.82
420500,201711,677,279,398,259744.28,372917.75,632662.03
420510,201711,20,17,3,15929,2811,18740
420515,201711,25,20,5,18740,4685,23425
420517,201711,9,9,0,8432.6,0,8432.6
420519,201711,0,0,0,0,0,0
420520,201711,66,49,17,45912.44,15929,61841.44
420530,201711,158,107,51,99320.95,47785.83,147106.78
420535,201711,18,16,2,14990.33,1873.66,16863.99
420540,201711,4589,2727,1862,2544853.85,1740099,4284952.85
420543,201711,21,21,0,19677,0,19677
420545,201711,187,132,55,122725.29,51513.42,174238.71
420550,201711,839,668,171,624638.69,160060.27,784698.96
420555,201711,41,30,11,28110,10307,38417
420560,201711,61,48,13,44601.2,12181,56782.2
420570,201711,135,77,58,72148.25,54335.35,126483.60
420580,201711,298,131,167,122741.04,156192.11,278933.15
420590,201711,509,361,148,337962.59,138673.07,476635.66
420600,201711,94,48,46,44976,43100.84,88076.84
420610,201711,37,35,2,32513,1874,34387
420620,201711,71,58,13,54345.07,12180.12,66525.19
420630,201711,151,106,45,99309.56,42153,141462.56
420640,201711,96,86,10,80582,9370,89952
420650,201711,238,125,113,116443.97,105270.9,221714.87
420660,201711,55,41,14,37662.62,13118,50780.62
420665,201711,37,28,9,26233.61,8433,34666.61
420670,201711,315,239,76,222995.36,70906.22,293901.58
420675,201711,16,15,1,14054.17,936.57,14990.74
420680,201711,35,25,10,23424.56,9369.22,32793.78
420690,201711,174,145,29,135860.91,27170.58,163031.49
420700,201711,614,429,185,401869.07,173067.19,574936.26
420710,201711,146,84,62,78705.2,57812.17,136517.37
420720,201711,105,85,20,79645,18740,98385
420730,201711,503,323,180,301331.53,167346.1,468677.63
420740,201711,45,44,1,41226.89,936.61,42163.50
420750,201711,488,324,164,303295.67,153661.77,456957.44
420757,201711,17,14,3,12321.55,2811,15132.55
420760,201711,39,30,9,28110,8433,36543
420765,201711,70,59,11,55281.64,10307,65588.64
420768,201711,67,59,8,55282.44,7496,62778.44
420770,201711,83,70,13,65590,12181,77771
420775,201711,47,44,3,40290.66,2810.66,43101.32
420780,201711,241,188,53,175519.24,49660.14,225179.38
420785,201711,13,9,4,8433,3748,12181
420790,201711,174,145,29,135499.98,26197.78,161697.76
420800,201711,77,58,19,53594.88,17803,71397.88
420810,201711,247,212,35,198630.03,31997.1,230627.13
420820,201711,2330,1394,936,1299876.14,875510.19,2175386.33
420830,201711,537,309,228,287265.32,212683.36,499948.68
420840,201711,141,107,34,100254.84,31857.33,132112.17
420845,201711,449,199,250,185797.34,233021.22,418818.56
420850,201711,227,183,44,171458.07,41225.64,212683.71
420860,201711,61,52,9,48724,8433,57157
420870,201711,118,85,33,79644.92,30919.99,110564.91
420880,201711,166,113,53,105214.68,49660.66,154875.34
420890,201711,859,423,436,393237.48,408501.77,801739.25
420895,201711,10,10,0,9368.06,0,9368.06
420900,201711,400,314,86,292179.12,80542.07,372721.19
420910,201711,5791,3235,2556,3024792.42,2390434.25,5415226.67
420915,201711,81,74,7,69337.16,6559,75896.16
420917,201711,18,13,5,12181,4685,16866
420920,201711,23,15,8,14054.56,7495.2,21549.76
420930,201711,2591,1575,1016,1468602.13,944125.4,2412727.53
420940,201711,598,438,160,410106.28,148272.57,558378.85
420945,201711,8,6,2,5621.27,1874,7495.27
420950,201711,55,50,5,46846.56,4684.18,51530.74
420960,201711,115,90,25,84272.39,23410.11,107682.50
420970,201711,308,247,61,229759.78,57119.93,286879.71
420980,201711,26,25,1,23425,937,24362
420985,201711,61,54,7,50597.24,6558.1,57155.34
420990,201711,66,50,16,46847.8,14991.56,61839.36
421000,201711,32,21,11,19676.02,10306.44,29982.46
421003,201711,68,44,24,41226.89,22474,63700.89
421005,201711,8,5,3,4685,2810.34,7495.34
421010,201711,771,545,226,510279.19,209692.88,719972.07
421020,201711,28,24,4,22487,3747.58,26234.58
421030,201711,128,106,22,98983.22,20614,119597.22
421040,201711,65,55,10,51535,9370,60905
421050,201711,298,215,83,199377.68,77764.81,277142.49
421055,201711,26,22,4,20614,3747.43,24361.43
421060,201711,84,57,27,53407.12,25298.49,78705.61
421070,201711,50,46,4,43101,3748,46849
421080,201711,33,30,3,28110,2811,30921
421085,201711,24,19,5,17802,4685,22487
421090,201711,44,34,10,31857.56,9370,41227.56
421100,201711,122,89,33,83390.69,30919.25,114309.94
421105,201711,214,174,40,162885.45,37450.28,200335.73
421110,201711,111,91,20,84657.95,18740,103397.95
421120,201711,153,120,33,111939.17,30901.48,142840.65
421125,201711,14,10,4,9370,3748,13118
421130,201711,797,511,286,477663.06,266952.29,744615.35
421140,201711,29,21,8,18974.25,7496,26470.25
421145,201711,39,31,8,29047,7495.73,36542.73
421150,201711,109,78,31,73085.19,29047,102132.19
421160,201711,59,40,19,37469.95,17802.61,55272.56
421165,201711,18,17,1,15929,937,16866
421170,201711,187,163,24,151970.37,22470,174440.37
421175,201711,146,95,51,89013.11,47740.42,136753.53
421180,201711,59,36,23,33375,21550.5,54925.5
421185,201711,16,13,3,12181,2811,14992
421187,201711,0,0,0,0,0,0
421189,201711,38,30,8,28109.73,7485.69,35595.42
421190,201711,1437,888,549,831274.32,513437.63,1344711.95
421200,201711,90,68,22,62774.61,20612.89,83387.50
421205,201711,24,16,8,14990.98,7486.63,22477.61
421210,201711,180,121,59,113374.75,55282.58,168657.33
421220,201711,268,214,54,199662.64,50595.51,250258.15
421223,201711,56,46,10,43101.02,9369.26,52470.28
421225,201711,61,41,20,38414.99,18740,57154.99
421227,201711,93,70,23,65588.49,21549.9,87138.39
421230,201711,49,36,13,33730.23,12180.21,45910.44
421240,201711,20,20,0,18740,0,18740
421250,201711,358,218,140,204162.16,130401.14,334563.30
421260,201711,29,23,6,21551,5622,27173
421265,201711,0,0,0,0,0,0
421270,201711,53,47,6,44038.18,5622,49660.18
421280,201711,330,192,138,179901.45,127619.08,307520.53
421290,201711,309,207,102,193714.5,94177.44,287891.94
421300,201711,26,21,5,19677,4685,24362
421310,201711,55,42,13,38696.32,12180.26,50876.58
421315,201711,28,20,8,18740,7496,26236
421320,201711,127,93,34,87138.24,31857.5,118995.74
421330,201711,107,82,25,75688.74,23410.49,99099.23
421335,201711,41,27,14,25298.3,13118,38416.3
421340,201711,290,195,95,180696.62,89011.6,269708.22
421350,201711,162,95,67,88574,62778.52,151352.52
421360,201711,692,510,182,471612.06,170307.04,641919.10
421370,201711,186,142,44,133050.96,40897.73,173948.69
421380,201711,127,102,25,95568.33,23424.03,118992.36
421390,201711,19,15,4,14054.89,3747.16,17802.05
421400,201711,111,94,17,88074.75,15928.32,104003.07
421410,201711,23,18,5,16865.51,4685,21550.51
421415,201711,18,17,1,15929,937,16866
421420,201711,150,124,26,115623.86,24080.05,139703.91
421430,201711,14,11,3,10307,2810.66,13117.66
421440,201711,60,46,14,43101.23,13118,56219.23
421450,201711,98,86,12,80580.45,11242.59,91823.04
421460,201711,59,51,8,46995.62,7495.33,54490.95
421470,201711,70,46,24,43101.69,22488,65589.69
421480,201711,635,474,161,443646.23,150843.92,594490.15
421490,201711,24,22,2,19935,1874,21809
421500,201711,515,332,183,309522.32,170935.35,480457.67
421505,201711,25,18,7,16864.48,6559,23423.48
421507,201711,32,26,6,24362,5622,29984
421510,201711,73,47,26,44038.11,23985.54,68023.65
421520,201711,69,58,11,53588.82,10307,63895.82
421530,201711,53,47,6,43383.1,5621.66,49004.76
421535,201711,30,29,1,26907,937,27844
421540,201711,58,52,6,48722.59,5622,54344.59
421545,201711,94,72,22,66975.47,20614,87589.47
421550,201711,278,201,77,187671.48,72149,259820.48
421555,201711,25,20,5,18739.05,4590,23329.05
421560,201711,8,8,0,7496,0,7496
421565,201711,122,91,31,85265.42,29046.61,114312.03
421567,201711,28,23,5,21551,4685,26236
421568,201711,32,30,2,28106.82,1873.56,29980.38
421569,201711,10,9,1,8433,937,9370
421570,201711,138,92,46,86201.6,43101.49,129303.09
421575,201711,27,22,5,20356.33,4685,25041.33
421580,201711,720,432,288,403560.92,268915.62,672476.54
421590,201711,21,20,1,18740,937,19677
421600,201711,109,73,36,68378.15,32503,100881.15
421605,201711,101,71,30,66187.02,28109.33,94296.35
421610,201711,188,146,42,136703.22,39351.08,176054.30
421620,201711,1114,671,443,626247.51,415033.15,1041280.66
421625,201711,21,18,3,16865.5,2811,19676.5
421630,201711,273,174,99,162979.87,91915.89,254895.76
421635,201711,17,8,9,7494.52,8433,15927.52
421640,201711,99,86,13,80581.56,12181,92762.56
421650,201711,269,158,111,148026.15,103988.26,252014.41
421660,201711,2085,1245,840,1163623.5,785794.66,1949418.16
421670,201711,166,124,42,116185.51,39351.49,155537.00
421680,201711,168,153,15,143353.61,14040.16,157393.77
421690,201711,346,242,104,226151.62,96440.3,322591.92
421700,201711,55,34,21,31857,18830.36,50687.36
421710,201711,25,25,0,23425,0,23425
421715,201711,9,8,1,7496,937,8433
421720,201711,571,410,161,382309.41,149147.44,531456.85
421725,201711,12,6,6,5622,5621.29,11243.29
421730,201711,43,30,13,27382.48,12181,39563.48
421740,201711,82,39,43,36542.6,40290.89,76833.49
421750,201711,215,158,57,145972.92,53406.76,199379.68
421755,201711,25,24,1,22486.62,937,23423.62
421760,201711,103,73,30,68389.01,28109.42,96498.43
421770,201711,557,379,178,352893.21,166708.57,519601.78
421775,201711,25,16,9,14991.61,8433,23424.61
421780,201711,188,147,41,137455.19,38415.26,175870.45
421790,201711,154,129,25,120354.59,23425,143779.59
421795,201711,16,13,3,12181,2811,14992
421800,201711,457,291,166,270943.75,155529.8,426473.55
421810,201711,70,56,14,52471.03,13118,65589.03
421820,201711,299,205,94,191107.91,88075.39,279183.30
421825,201711,128,106,22,99321.5,20614,119935.5
421830,201711,128,99,29,92763,27172.74,119935.74
421835,201711,3,3,0,2811,0,2811
421840,201711,60,50,10,46837,9369.3,56206.3
421850,201711,81,72,9,67461.41,8421,75882.41
421860,201711,42,32,10,29701.65,9369.93,39071.58
421870,201711,972,734,238,678656.57,222066.62,900723.19
421875,201711,51,45,6,42165,5621.66,47786.66
421880,201711,163,118,45,110563.13,41882.61,152445.74
421885,201711,28,23,5,21549.82,4684,26233.82
421890,201711,113,78,35,73086,32794.66,105880.66
421895,201711,38,35,3,32794.33,2811,35605.33
421900,201711,153,124,29,116097.54,27104,143201.54
421910,201711,65,43,22,40290.87,20612.72,60903.59
421915,201711,30,24,6,22487.63,5622,28109.63
421917,201711,39,27,12,25216.89,11242.69,36459.58
421920,201711,32,29,3,27173,2810.63,29983.63
421930,201711,755,583,172,544569.63,161111.95,705681.58
421935,201711,57,50,7,46849.23,6559,53408.23
421940,201711,40,38,2,35605.06,1874,37479.06
421950,201711,829,544,285,502376.54,263776.9,766153.44
421960,201711,39,35,4,32512.52,3747.23,36259.75
421970,201711,376,237,139,221568.71,130179.52,351748.23
421985,201711,29,19,10,17803,9369.93,27172.93
422000,201711,0,0,0,0,0,0
430003,201711,207,48,159,44272.06,148982.13,193254.19
430005,201711,36,28,8,26233.09,7494.31,33727.40
430010,201711,278,195,83,182244.14,77769.48,260013.62
430020,201711,154,100,54,93417,49661,143078
430030,201711,125,97,28,90886.08,26235.32,117121.40
430040,201711,2991,1734,1257,1617115.93,1176158.21,2793274.14
430045,201711,69,59,10,54998,9368.43,64366.43
430047,201711,7,6,1,5621.56,937,6558.56
430050,201711,82,69,13,64652.01,12180.59,76832.60
430055,201711,17,14,3,13118,2811,15929
430057,201711,4,2,2,1874,1873.22,3747.22
430060,201711,3703,2191,1512,2045979.84,1412782.44,3458762.28
430063,201711,56,50,6,46848.96,5622,52470.96
430064,201711,145,123,22,115239.36,20610.88,135850.24
430066,201711,10,7,3,6559,2811,9370
430070,201711,48,36,12,33731.64,11244,44975.64
430080,201711,69,49,20,45225.8,18739.26,63965.06
430085,201711,37,11,26,10305.38,24361.42,34666.80
430087,201711,39,28,11,26088.63,10307,36395.63
430090,201711,71,64,7,59684.18,6558.92,66243.10
430100,201711,114,76,38,70273.68,35604.77,105878.45
430105,201711,144,72,72,67461.12,67163.99,134625.11
430107,201711,21,15,6,14055,5622,19677
430110,201711,411,239,172,223135.84,161087.78,384223.62
430120,201711,138,126,12,117111.58,11243.49,128355.07
430130,201711,783,492,291,460375.66,272368.43,732744.09
430140,201711,126,116,10,108691.73,9368.51,118060.24
430150,201711,110,73,37,67638.58,33730.5,101369.08
430155,201711,33,30,3,28109.12,2810.76,30919.88
430160,201711,3806,2245,1561,2084392.39,1458621.86,3543014.25
430163,201711,326,143,183,132853.67,171407.37,304261.04
430165,201711,22,16,6,14992,5622,20614
430170,201711,82,74,8,69335.2,7494.07,76829.27
430175,201711,82,63,19,59028.19,17145.37,76173.56
430180,201711,91,72,19,67462.37,17192.8,84655.17
430185,201711,31,23,8,21551,7496,29047
430187,201711,103,43,60,40289.13,55911.56,96200.69
430190,201711,221,127,94,118948.68,87409.77,206358.45
430192,201711,14,14,0,13118,0,13118
430195,201711,13,8,5,7496,4684.89,12180.89
430200,201711,162,143,19,133334.08,17801.28,151135.36
430205,201711,19,18,1,16866,937,17803
430210,201711,620,480,140,446082.55,129905.98,575988.53
430215,201711,17,14,3,13118,2811,15929
430220,201711,61,43,18,40291,16865.06,57156.06
430222,201711,14,7,7,6559,6559,13118
430223,201711,15,8,7,7495.28,6559,14054.28
430225,201711,4,3,1,2811,937,3748
430230,201711,295,182,113,169588.29,105874.05,275462.34
430235,201711,49,35,14,32794.49,13107.86,45902.35
430237,201711,29,22,7,20612.69,6558.11,27170.80
430240,201711,130,80,50,74957.39,46840.05,121797.44
430245,201711,70,59,11,55279.24,10307,65586.24
430250,201711,194,112,82,104930.91,76820.8,181751.71
430258,201711,14,12,2,11243.66,1874,13117.66
430260,201711,36,31,5,29046.19,3879.18,32925.37
430265,201711,36,29,7,27154.26,6558.66,33712.92
430270,201711,578,425,153,394589.98,141315.97,535905.95
430280,201711,1020,631,389,587563.79,362006.63,949570.42
430290,201711,374,218,156,202381.89,146166.36,348548.25
430300,201711,2110,1162,948,1083048.1,885200.54,1968248.64
430310,201711,1992,1045,947,972073.38,884088.69,1856162.07
430320,201711,50,42,8,39339.95,7495.89,46835.84
430330,201711,98,89,9,82921.91,8433,91354.91
430340,201711,66,58,8,54345.66,7495.46,61841.12
430350,201711,1664,1161,503,1075324.09,469558,1544882.09
430355,201711,25,22,3,20614,2810.61,23424.61
430360,201711,82,39,43,36540.95,39070.51,75611.46
430367,201711,30,20,10,18738.99,8592.29,27331.28
430370,201711,54,48,6,44973.63,5622,50595.63
430380,201711,127,94,33,87513.91,30919.12,118433.03
430390,201711,615,382,233,357647.03,218005.27,575652.30
430400,201711,136,106,30,97633.33,28088.64,125721.97
430410,201711,56,44,12,41228,11244,52472
430420,201711,491,323,168,300197.56,154891.91,455089.47
430430,201711,54,52,2,48099.27,1874,49973.27
430435,201711,158,118,40,109625.21,36773,146398.21
430440,201711,515,344,171,322310.41,160026.84,482337.25
430450,201711,1184,978,206,908931.11,193006.09,1101937.20
430460,201711,5138,2801,2337,2608819.55,2183910.78,4792730.33
430461,201711,17,15,2,14054.53,1874,15928.53
430462,201711,11,7,4,6559,3748,10307
430463,201711,1018,537,481,500463.28,450320.09,950783.37
430465,201711,28,16,12,14991.92,11244,26235.92
430466,201711,655,471,184,439426.68,172210.66,611637.34
430467,201711,100,59,41,54060.84,38406.12,92466.96
430468,201711,110,68,42,63712.16,39105.07,102817.23
430469,201711,23,17,6,15929,5622,21551
430470,201711,1169,647,522,598350.96,487173.85,1085524.81
430471,201711,49,37,12,34648.81,11241.16,45889.97
430480,201711,97,61,36,56308.68,33721.68,90030.36
430485,201711,5,5,0,4403,0,4403
430490,201711,94,75,19,69472.6,17801.99,87274.59
430495,201711,35,28,7,26234.18,6557.99,32792.17
430500,201711,195,132,63,122978.07,58651.95,181630.02
430510,201711,3041,2032,1009,1898280.73,944504.76,2842785.49
430511,201711,18,18,0,16865.57,0,16865.57
430512,201711,134,90,44,84328.86,41227.46,125556.32
430513,201711,51,45,6,41694.69,5620.97,47315.66
430515,201711,31,29,2,27172.6,1874,29046.6
430517,201711,171,151,20,140545.19,18721.26,159266.45
430520,201711,367,252,115,235452.89,107722.84,343175.73
430530,201711,89,51,38,47785.29,35605.41,83390.70
430535,201711,475,313,162,293064.86,151752.88,444817.74
430537,201711,10,10,0,9370,0,9370
430540,201711,74,47,27,44038.36,25299,69337.36
430543,201711,368,114,254,106812.62,237992.95,344805.57
430544,201711,43,39,4,36543,3748,40291
430545,201711,345,159,186,148959.75,173790.39,322750.14
430550,201711,45,37,8,34667.63,7495.73,42163.36
430558,201711,6,4,2,3748,1874,5622
430560,201711,47,20,27,18739.08,25299,44038.08
430570,201711,107,46,61,43101.14,57095.47,100196.61
430580,201711,125,98,27,91824.34,25252.15,117076.49
430583,201711,14,14,0,13118,0,13118
430585,201711,9,4,5,3748,4684.46,8432.46
430587,201711,14,8,6,7496,5622,13118
430590,201711,151,126,25,116843.45,23423.88,140267.33
430593,201711,4,4,0,3748,0,3748
430595,201711,14,9,5,8432.96,4684.86,13117.82
430597,201711,50,26,24,24361.19,22488,46849.19
430600,201711,215,147,68,137727.15,63433.5,201160.65
430605,201711,153,95,58,89013.55,54334.49,143348.04
430607,201711,26,21,5,19674.03,4684.33,24358.36
430610,201711,1640,767,873,714241.13,812773.98,1527015.11
430613,201711,2,2,0,1874,0,1874
430620,201711,112,80,32,74812.58,29971.54,104784.12
430630,201711,46,41,5,38416.55,4684.55,43101.10
430632,201711,32,27,5,25299,4685,29984
430635,201711,40,36,4,33732,3748,37480
430637,201711,55,31,24,29046.48,22488,51534.48
430640,201711,216,121,95,112532.19,89010.55,201542.74
430642,201711,27,25,2,23425,1874,25299
430645,201711,32,28,4,26234.26,3748,29982.26
430650,201711,254,202,52,188988.93,48675.51,237664.44
430655,201711,4,4,0,3747,0,3747
430660,201711,960,464,496,433216.12,463245.39,896461.51
430670,201711,71,51,20,47785.2,18738.07,66523.27
430673,201711,72,40,32,37478.2,29983.9,67462.1
430675,201711,13,10,3,9369.73,2810.66,12180.39
430676,201711,484,296,188,276611.97,176071.61,452683.58
430680,201711,251,176,75,162754.45,70271.82,233026.27
430690,201711,526,313,213,292384.84,197922.23,490307.07
430692,201711,7,5,2,4685,1874,6559
430693,201711,136,90,46,84328.58,42482.17,126810.75
430695,201711,74,67,7,61858.38,6558.37,68416.75
430697,201711,62,37,25,34668.74,23423.67,58092.41
430700,201711,1582,1108,474,1026535.15,444125.56,1470660.71
430705,201711,20,19,1,17802.3,937,18739.3
430710,201711,258,166,92,155541.69,86200.4,241742.09
430720,201711,110,93,17,86951.89,15927.27,102879.16
430730,201711,120,103,17,95569.13,15929,111498.13
430740,201711,63,43,20,40290.26,18737.83,59028.09
430745,201711,37,30,7,27827.33,6558.84,34386.17
430750,201711,335,230,105,214585.68,97445.52,312031.20
430755,201711,80,45,35,42164.92,32792.99,74957.91
430760,201711,363,220,143,203504.37,133954.09,337458.46
430770,201711,1483,761,722,710936.22,672070.42,1383006.64
430780,201711,317,203,114,189230.32,106745.19,295975.51
430781,201711,28,23,5,21551,4685,26236
430783,201711,49,39,10,36229.23,9368.52,45597.75
430786,201711,6,3,3,2810.03,2811,5621.03
430790,201711,482,311,171,289615.91,159926.74,449542.65
430800,201711,152,127,25,118995.56,23424.33,142419.89
430805,201711,41,37,4,34667.78,3746.96,38414.74
430807,201711,33,21,12,19676.69,11243.87,30920.56
430810,201711,71,45,26,42162.68,24361.23,66523.91
430820,201711,132,80,52,74957.43,48065.83,123023.26
430825,201711,11,9,2,8433,1873.33,10306.33
430830,201711,233,218,15,203958.4,14054.39,218012.79
430840,201711,122,82,40,76832.15,36822.76,113654.91
430843,201711,5,3,2,2811,1873.77,4684.77
430845,201711,70,40,30,37475.71,28109.15,65584.86
430850,201711,572,396,176,369826.53,164748.39,534574.92
430860,201711,154,98,56,91166.29,51802.39,142968.68
430865,201711,63,32,31,29325.85,28736.48,58062.33
430870,201711,78,63,15,59029.4,14052.47,73081.87
430880,201711,160,121,39,113351.02,36540.81,149891.83
430885,201711,7,6,1,5622,937,6559
430890,201711,338,204,134,189506.63,125552.5,315059.13
430900,201711,539,370,169,342550.36,157872.71,500423.07
430905,201711,82,33,49,30917.79,45910.05,76827.84
430910,201711,271,152,119,142422.05,110819.65,253241.70
430912,201711,3,3,0,2810.8,0,2810.8
430915,201711,35,27,8,25297.16,7214.9,32512.06
430920,201711,4155,2329,1826,2175459.58,1709045.43,3884505.01
430925,201711,6,5,1,4441.38,937,5378.38
430930,201711,2083,1239,844,1151711.26,789544.4,1941255.66
430940,201711,242,154,88,143627.36,82433.43,226060.79
430950,201711,162,131,31,122742.21,28765.9,151508.11
430955,201711,21,13,8,12179.64,7496,19675.64
430957,201711,17,16,1,14992,937,15929
430960,201711,241,158,83,146304,77768.02,224072.02
430965,201711,102,63,39,59030.7,36539.63,95570.33
430970,201711,78,66,12,61838.5,10306.89,72145.39
430975,201711,37,35,2,32795,1874,34669
430980,201711,43,26,17,24361.62,15928.33,40289.95
430990,201711,113,87,26,81515.05,24360.15,105875.20
430995,201711,115,111,4,102788.16,3748,106536.16
431000,201711,297,138,159,127180.88,148977.27,276158.15
431010,201711,340,205,135,191112.34,126491.53,317603.87
431020,201711,1936,1119,817,1040969.84,762398.83,1803368.67
431030,201711,42,34,8,31855.57,7495.99,39351.56
431033,201711,382,190,192,177231.63,179895.78,357127.41
431036,201711,15,10,5,9370,4685,14055
431040,201711,132,79,53,73083.73,49551.6,122635.33
431041,201711,37,25,12,23425,11244,34669
431043,201711,44,25,19,23423.88,17802.86,41226.74
431046,201711,12,7,5,6559,4685,11244
431050,201711,209,132,77,121465.32,70740.15,192205.47
431053,201711,74,44,30,40477.97,28109.46,68587.43
431055,201711,63,42,21,39351.73,19657.95,59009.68
431057,201711,17,17,0,15928.66,0,15928.66
431060,201711,1692,1064,628,989830.56,586509.38,1576339.94
431065,201711,17,10,7,9370,6559,15929
431070,201711,72,67,5,62776.69,4683.18,67459.87
431075,201711,8,8,0,7496,0,7496
431080,201711,137,89,48,83110.65,44972.79,128083.44
431085,201711,29,26,3,24361.06,2811,27172.06
431087,201711,15,13,2,12181,1873.66,14054.66
431090,201711,57,45,12,42163.52,11242.4,53405.92
431100,201711,1232,737,495,682118.89,463797.41,1145916.30
431110,201711,244,151,93,141484.76,87128.8,228613.56
431112,201711,29,18,11,16866,10307,27173
431113,201711,30,19,11,17803,10306.6,28109.6
431115,201711,154,104,50,96819.94,46840.33,143660.27
431120,201711,620,367,253,341946.47,236965.72,578912.19
431123,201711,3,2,1,1874,937,2811
431125,201711,90,80,10,74960,9369.43,84329.43
431127,201711,7,3,4,2811,3748,6559
431130,201711,616,401,215,374508.91,201143.33,575652.24
431140,201711,721,486,235,451100.81,220110.76,671211.57
431142,201711,32,25,7,22230,6559,28789
431150,201711,205,152,53,142422.95,49651.63,192074.58
431160,201711,57,51,6,47786.06,5622,53408.06
431162,201711,20,14,6,13118,5622,18740
431164,201711,4,4,0,3748,0,3748
431170,201711,104,86,18,80580.39,16865.48,97445.87
431171,201711,51,28,23,26233.87,21540.69,47774.56
431173,201711,1,1,0,937,0,937
431175,201711,204,99,105,91542.53,98369.73,189912.26
431177,201711,72,54,18,50595.95,16188.49,66784.44
431179,201711,13,11,2,10306.24,1873.46,12179.70
431180,201711,440,266,174,249225.43,163003.03,412228.46
431190,201711,89,68,21,63715.05,19675.49,83390.54
431198,201711,69,45,24,42162.35,22485.37,64647.72
431200,201711,18,16,2,14991.32,1874,16865.32
431205,201711,23,23,0,21551,0,21551
431210,201711,86,53,33,49319.85,30920.39,80240.24
431213,201711,26,21,5,19676.33,4685,24361.33
431215,201711,26,23,3,21551,2810.26,24361.26
431217,201711,6,5,1,4685,937,5622
431220,201711,68,59,9,55282.24,8433,63715.24
431225,201711,152,101,51,94619.8,47774.5,142394.3
431230,201711,101,87,14,80861,13118,93979
431235,201711,7,7,0,6559,0,6559
431237,201711,25,17,8,15929,7496,23425
431238,201711,15,11,4,10025,3748,13773
431240,201711,983,634,349,592400.29,326496.19,918896.48
431242,201711,34,34,0,31857.86,0,31857.86
431244,201711,10,7,3,6559,2811,9370
431245,201711,62,47,15,43382.68,14053.47,57436.15
431247,201711,14,10,4,9369.37,3747.07,13116.44
431250,201711,271,141,130,132042.13,121126.01,253168.14
431260,201711,61,44,17,41225.93,15927.96,57153.89
431261,201711,22,15,7,14054.01,6559,20613.01
431262,201711,16,16,0,14992,0,14992
431265,201711,167,88,79,82454.18,74021.97,156476.15
431267,201711,15,14,1,13117.8,937,14054.8
431270,201711,316,263,53,246423.86,49654.52,296078.38
431275,201711,41,39,2,36542.27,1874,38416.27
431280,201711,21,17,4,15108.12,3748,18856.12
431290,201711,21,18,3,16865.33,2811,19676.33
431295,201711,5,5,0,4685,0,4685
431300,201711,22,19,3,17801.89,2811,20612.89
431301,201711,7,7,0,6559,0,6559
431303,201711,51,34,17,31735.87,15647.42,47383.29
431306,201711,222,118,104,110112.04,97439.33,207551.37
431308,201711,6,5,1,4685,937,5622
431310,201711,63,53,10,49661,9369.9,59030.9
431320,201711,122,73,49,68398.35,45620.34,114018.69
431330,201711,177,116,61,108689.32,57154.54,165843.86
431333,201711,33,27,6,25299,5622,30921
431335,201711,10,5,5,4685,4685,9370
431337,201711,320,152,168,141583.25,156392.99,297976.24
431339,201711,18,15,3,14054.96,2811,16865.96
431340,201711,3046,1745,1301,1630411.09,1216574.8,2846985.89
431342,201711,46,29,17,27170.69,15928.76,43099.45
431344,201711,18,17,1,15928.23,936.6,16864.83
431346,201711,3,3,0,2810.66,0,2810.66
431349,201711,37,34,3,31857.62,2811,34668.62
431350,201711,905,537,368,498670.59,343830.67,842501.26
431360,201711,44,38,6,35605.32,5621.85,41227.17
431365,201711,316,149,167,139593.43,155243.87,294837.30
431370,201711,1320,790,530,736329.16,496376.55,1232705.71
431380,201711,101,84,17,78050.35,15928.86,93979.21
431390,201711,496,276,220,257663.61,205210.96,462874.57
431395,201711,274,117,157,109625.32,147078.45,256703.77
431400,201711,37,29,8,27173,7495.66,34668.66
431402,201711,94,66,28,61841.21,26234.98,88076.19
431403,201711,14,9,5,8432.95,4685,13117.95
431405,201711,648,348,300,324965.87,281052.41,606018.28
431406,201711,31,27,4,25298.32,3748,29046.32
431407,201711,48,41,7,38416.36,6558.13,44974.49
431410,201711,3211,1910,1301,1776324.05,1216830.14,2993154.19
431413,201711,15,13,2,12181,1874,14055
431415,201711,73,53,20,49661,18739.49,68400.49
431417,201711,24,13,11,12180.44,10305.09,22485.53
431420,201711,296,208,88,194248.83,82441.78,276690.61
431430,201711,42,17,25,15927.89,23423.59,39351.48
431440,201711,8908,6342,2566,5874687.87,2394229.18,8268917.05
431442,201711,28,15,13,14055,12181,26236
431445,201711,25,19,6,17803,5621.47,23424.47
431446,201711,7,6,1,5622,937,6559
431447,201711,84,59,25,55282.66,23425,78707.66
431449,201711,47,44,3,41226.17,2811,44037.17
431450,201711,413,288,125,268113.35,116416.62,384529.97
431454,201711,0,0,0,0,0,0
431455,201711,50,38,12,35606,11244,46850
431460,201711,519,358,161,331877.8,150422.82,482300.62
431470,201711,118,92,26,85522.72,24361.16,109883.88
431475,201711,11,10,1,9370,937,10307
431477,201711,36,26,10,24358.78,9369.97,33728.75
431478,201711,7,6,1,5621.92,937,6558.92
431480,201711,493,310,183,288878.13,171418.03,460296.16
431490,201711,28229,16012,12217,14927802.02,11411529.53,26339331.55
431500,201711,77,53,24,49658.98,22487.53,72146.51
431505,201711,46,20,26,18738.46,24362,43100.46
431507,201711,11,9,2,8433,1874,10307
431510,201711,278,180,98,167948.43,90869.65,258818.08
431513,201711,23,18,5,16865.8,4684.66,21550.46
431514,201711,8,7,1,6557.61,937,7494.61
431515,201711,78,66,12,61841.34,11244,73085.34
431517,201711,3,1,2,937,1874,2811
431520,201711,35,32,3,29984,2811,32795
431530,201711,1619,719,900,672636.18,842830.6,1515466.78
431531,201711,22,20,2,18739.93,1873.66,20613.59
431532,201711,24,17,7,15928.7,6558.1,22486.8
431535,201711,25,16,9,14992,8432.39,23424.39
431540,201711,143,128,15,118366.48,14054.55,132421.03
431545,201711,19,17,2,15927.32,1874,17801.32
431550,201711,345,203,142,190206.71,132956.58,323163.29
431555,201711,12,11,1,10306.19,937,11243.19
431560,201711,4378,3097,1281,2873456.22,1197825.81,4071282.03
431570,201711,766,408,358,379191.05,332583.9,711774.95
431575,201711,37,26,11,24359.72,10306.66,34666.38
431580,201711,97,68,29,62777.46,27171.79,89949.25
431590,201711,136,114,22,105875.25,20613.29,126488.54
431595,201711,12,11,1,10307,937,11244
431600,201711,215,124,91,116183.73,85261.24,201444.97
431610,201711,127,92,35,85545.11,32794.83,118339.94
431620,201711,42,34,8,31856.84,7495.66,39352.50
431630,201711,130,111,19,103998.31,17801.21,121799.52
431640,201711,1324,832,492,774230.63,459387.62,1233618.25
431642,201711,41,37,4,34200.5,3748,37948.5
431643,201711,46,21,25,19677,23425,43102
431645,201711,304,173,131,160880.53,121803.72,282684.25
431647,201711,11,11,0,10307,0,10307
431650,201711,34,24,10,22488,9369.78,31857.78
431660,201711,274,177,97,163687.83,90882.9,254570.73
431670,201711,219,105,114,95802.07,106787.36,202589.43
431673,201711,3,3,0,2811,0,2811
431675,201711,28,24,4,22206.21,3748,25954.21
431680,201711,1090,780,310,727086.05,289226.68,1016312.73
431690,201711,4763,2907,1856,2705310.63,1734175.1,4439485.73
431695,201711,26,20,6,18740,5621.02,24361.02
431697,201711,0,0,0,0,0,0
431700,201711,167,126,41,118059.35,38416.1,156475.45
431710,201711,3984,1717,2267,1607091.09,2122665.52,3729756.61
431720,201711,1414,840,574,779536.96,536849.46,1316386.42
431725,201711,1,1,0,937,0,937
431730,201711,1190,803,387,745512.84,362604.74,1108117.58
431740,201711,1374,682,692,634471.59,647821.92,1282293.51
431750,201711,1881,1219,662,1130852.96,618377.51,1749230.47
431755,201711,5,4,1,3748,937,4685
431760,201711,1098,701,397,656452.71,371753.26,1028205.97
431770,201711,388,284,104,266094.24,97424.4,363518.64
431775,201711,27,21,6,19676.33,5621.36,25297.69
431780,201711,558,344,214,321220.88,200500.02,521720.90
431790,201711,152,113,39,104939.77,36492.96,141432.73
431795,201711,13,11,2,10307,1873.75,12180.75
431800,201711,3398,1782,1616,1657850,1506692.11,3164542.11
431805,201711,18,15,3,14055,2811,16866
431810,201711,618,416,202,387197.06,189127.26,576324.32
431820,201711,315,177,138,165842.32,128317.53,294159.85
431830,201711,2328,1414,914,1321533.78,855144.56,2176678.34
431840,201711,510,337,173,312179.93,160878.46,473058.39
431842,201711,34,28,6,26236,5621.5,31857.5
431843,201711,11,7,4,6559,3748,10307
431844,201711,14,12,2,11243.56,1874,13117.56
431845,201711,29,26,3,24362,2811,27173
431846,201711,29,25,4,23423.69,3747.66,27171.35
431848,201711,14,12,2,11243.86,1874,13117.86
431849,201711,8,6,2,5622,1874,7496
431850,201711,799,661,138,617560.52,129006.09,746566.61
431860,201711,100,73,27,68401,24361.49,92762.49
431861,201711,4,2,2,1874,1874,3748
431862,201711,49,33,16,30920.79,14991.26,45912.05
431870,201711,3473,2046,1427,1908665.04,1335404.13,3244069.17
431880,201711,931,682,249,634297.4,232357.29,866654.69
431890,201711,1312,811,501,754374.04,467835.47,1222209.51
431900,201711,183,128,55,119929.97,51532.7,171462.67
431910,201711,57,42,15,39352.5,14054.99,53407.49
431912,201711,34,19,15,17803,14054.66,31857.66
431915,201711,126,101,25,94633.37,23423.88,118057.25
431920,201711,143,107,36,99970.92,33729.78,133700.70
431930,201711,87,70,17,65587.15,15928.65,81515.80
431935,201711,4,3,1,2811,937,3748
431936,201711,12,11,1,10307,937,11244
431937,201711,16,11,5,10306.21,4685,14991.21
431940,201711,445,295,150,273689.91,140534.68,414224.59
431950,201711,457,296,161,276124.35,150715.22,426839.57
431960,201711,710,423,287,392213.71,268741.52,660955.23
431970,201711,73,65,8,60905,7496,68401
431971,201711,4,4,0,3747.66,0,3747.66
431973,201711,19,16,3,14989.93,2810.13,17800.06
431975,201711,6,5,1,4685,937,5622
431980,201711,199,126,73,116561.99,68396.55,184958.54
431990,201711,1225,651,574,608239.43,537780.73,1146020.16
432000,201711,1675,903,772,839382.12,720424.26,1559806.38
432010,201711,273,182,91,169430.01,85261.29,254691.30
432020,201711,174,136,38,127428.31,35595,163023.31
432023,201711,20,16,4,14992,3748,18740
432026,201711,67,60,7,56218.73,6558.53,62777.26
432030,201711,61,30,31,28110,29046.63,57156.63
432032,201711,23,20,3,18739.23,2810.66,21549.89
432035,201711,48,38,10,35606,9369.4,44975.4
432040,201711,98,68,30,63715.5,28109.66,91825.16
432045,201711,8,7,1,6277.9,937,7214.9
432050,201711,70,42,28,39351.54,26234.96,65586.50
432055,201711,101,77,24,72108.78,22488,94596.78
432057,201711,1,0,1,0,937,937
432060,201711,39,36,3,33028.14,2810.53,35838.67
432065,201711,32,29,3,27153.12,2811,29964.12
432067,201711,93,81,12,75876.69,11243.2,87119.89
432070,201711,403,305,98,284193.22,91788.42,375981.64
432080,201711,805,558,247,521167.52,231353.13,752520.65
432085,201711,15,11,4,10306.27,3747.54,14053.81
432090,201711,267,171,96,159940.15,89947.9,249888.05
432100,201711,174,116,58,108408.91,54341.97,162750.88
432110,201711,599,410,189,377451.62,176145.1,553596.72
432120,201711,967,576,391,539040.04,366310.77,905350.81
432130,201711,498,358,140,334126.63,131035.15,465161.78
432132,201711,26,23,3,21550.83,2811,24361.83
432135,201711,78,66,12,61841.1,11243.8,73084.9
432140,201711,266,210,56,196469.55,52470.94,248940.49
432143,201711,182,115,67,107752.16,62776.51,170528.67
432145,201711,268,182,86,168461.22,80294.55,248755.77
432146,201711,15,14,1,13117.36,937,14054.36
432147,201711,143,62,81,58092.78,75886.63,133979.41
432149,201711,17,12,5,11243,4685,15928
432150,201711,826,524,302,489808.49,280255.67,770064.16
432160,201711,1399,726,673,677967.36,629689.65,1307657.01
432162,201711,4,3,1,2811,937,3748
432163,201711,18,14,4,13118,3748,16866
432166,201711,122,92,30,86431,28110,114541
432170,201711,225,122,103,113362.47,96505.39,209867.86
432180,201711,527,319,208,295791.38,194603.85,490395.23
432183,201711,8,6,2,5622,1874,7496
432185,201711,83,71,12,66430.02,11242.84,77672.86
432190,201711,479,259,220,241529.84,205991.76,447521.60
432195,201711,84,72,12,66757.34,11242.62,77999.96
432200,201711,408,262,146,245483.93,136683.57,382167.50
432210,201711,115,75,40,68259.05,37478.5,105737.55
432215,201711,62,59,3,55283,2811,58094
432218,201711,19,18,1,16866,937,17803
432220,201711,670,338,332,315675.76,310565.22,626240.98
432225,201711,16,10,6,8901.5,5620.7,14522.2
432230,201711,152,88,64,82217.52,59967.72,142185.24
432232,201711,15,13,2,12180.02,1874,14054.02
432234,201711,5,4,1,3748,937,4685
432235,201711,1,1,0,937,0,937
432237,201711,29,17,12,15926.78,11242.79,27169.57
432240,201711,4182,2330,1852,2173430.34,1727696.67,3901127.01
432250,201711,1015,645,370,601684.2,346519.63,948203.83
432252,201711,39,31,8,28313.85,7496,35809.85
432253,201711,60,48,12,44976,11243.16,56219.16
432254,201711,21,9,12,8433,11244,19677
432255,201711,14,13,1,12181,937,13118
432260,201711,842,664,178,621097.57,165833.03,786930.60
432270,201711,216,159,57,148977.92,53406.47,202384.39
432280,201711,119,85,34,79164.16,31856.63,111020.79
432285,201711,2,1,1,937,937,1874
432290,201711,69,62,7,56499.44,6557.24,63056.68
432300,201711,4671,2667,2004,2484273.01,1873407.26,4357680.27
432310,201711,117,93,24,87118.19,22485.62,109603.81
432320,201711,19,14,5,13118,4685,17803
432330,201711,14,9,5,8432.06,4685,13117.06
432335,201711,8,7,1,6559,937,7496
432340,201711,40,36,4,33732,3748,37480
432345,201711,86,62,24,58094,22487.93,80581.93
432350,201711,23,22,1,20612.28,937,21549.28
432360,201711,7,5,2,4685,1874,6559
432370,201711,25,25,0,23143.9,0,23143.9
432375,201711,42,36,6,33730.83,5622,39352.83
432377,201711,7,7,0,6559,0,6559
432380,201711,170,74,96,68679.99,89898.63,158578.62
500020,201711,247,134,113,125553.91,105286.47,230840.38
500025,201711,117,57,60,52467.46,56218.21,108685.67
500060,201711,1387,847,540,793060.54,505379.47,1298440.01
500070,201711,747,352,395,329813.32,370098.66,699911.98
500080,201711,134,102,32,95570.45,29983,125553.45
500085,201711,145,118,27,110282.34,24479.13,134761.47
500090,201711,330,158,172,148044.65,161162.72,309207.37
500100,201711,701,372,329,346405.08,307700.89,654105.97
500110,201711,2247,993,1254,930095.08,1173467.54,2103562.62
500124,201711,314,181,133,169595.09,124336.67,293931.76
500150,201711,329,128,201,119917.26,187956.07,307873.33
500190,201711,521,356,165,332894.28,154122.56,487016.84
500200,201711,203,172,31,160816.57,29044.4,189860.97
500210,201711,1453,524,929,489718.96,869371.3,1359090.26
500215,201711,241,140,101,130223.37,94635.15,224858.52
500220,201711,780,507,273,474801.94,255044,729845.94
500230,201711,257,179,78,167020.25,72617.5,239637.75
500240,201711,713,496,217,463991.34,202853.64,666844.98
500260,201711,569,210,359,196763.61,336375.64,533139.25
500270,201711,28347,12024,16323,11236907.12,15277180.78,26514087.90
500280,201711,194,73,121,68401,113375.3,181776.3
500290,201711,1187,690,497,645567.36,465668.47,1111235.83
500295,201711,399,241,158,225809.41,148033.15,373842.56
500310,201711,66,20,46,18740,43102,61842
500315,201711,703,415,288,388839.31,269563.23,658402.54
500320,201711,3660,1820,1840,1702913.51,1722393.08,3425306.59
500325,201711,943,517,426,483946.64,398182.51,882129.15
500330,201711,1500,686,814,639910.62,762076.65,1401987.27
500345,201711,321,234,87,218302.41,81519,299821.41
500348,201711,242,140,102,131170.23,95546.28,226716.51
500350,201711,148,73,75,68400.05,70274.28,138674.33
500370,201711,5452,2431,3021,2270440.33,2827647.36,5098087.69
500375,201711,348,252,96,236113.05,89949.27,326062.32
500380,201711,579,330,249,309054.03,233296.93,542350.96
500390,201711,71,36,35,33729.6,32794.74,66524.34
500400,201711,214,145,69,135844.47,64637.14,200481.61
500410,201711,575,222,353,207947.43,330563.71,538511.14
500430,201711,543,378,165,354176.9,154602.57,508779.47
500440,201711,208,107,101,99498.42,94448.26,193946.68
500450,201711,413,175,238,163285.22,222324.34,385609.56
500460,201711,318,159,159,148969.97,148974.59,297944.56
500470,201711,438,346,92,322996.01,85250.89,408246.90
500480,201711,112,68,44,63715.53,41227.29,104942.82
500490,201711,107,42,65,39348.64,60905,100253.64
500500,201711,1453,496,957,462873.03,895558.68,1358431.71
500510,201711,48,37,11,34669,10293,44962
500515,201711,110,77,33,72147.53,30639,102786.53
500520,201711,353,197,156,183542.83,146154.99,329697.82
500525,201711,89,51,38,47785.76,35324.9,83110.66
500540,201711,903,371,532,347551.88,497468.15,845020.03
500560,201711,902,508,394,474270.11,368494.21,842764.32
500568,201711,989,573,416,532211.86,389501.86,921713.72
500570,201711,1218,685,533,639515.2,496802.48,1136317.68
500580,201711,340,175,165,163679.99,154576.75,318256.74
500600,201711,323,163,160,152032.78,149893.48,301926.26
500620,201711,893,630,263,584607.96,246228.23,830836.19
500625,201711,79,67,12,62084.78,11243.42,73328.20
500627,201711,21,9,12,8431.73,11243.93,19675.66
500630,201711,1578,833,745,779566.83,697582.95,1477149.78
500635,201711,514,291,223,272244.29,208805.81,481050.10
500640,201711,431,225,206,208281.96,192997.46,401279.42
500660,201711,5515,2108,3407,1972453.02,3188668.13,5161121.15
500690,201711,575,205,370,191663.14,345757.01,537420.15
500710,201711,354,171,183,159939.88,171174.76,331114.64
500720,201711,970,568,402,530797.88,376461.75,907259.63
500730,201711,192,110,82,103068.66,76547.38,179616.04
500740,201711,856,371,485,346271.38,453416.71,799688.09
500750,201711,136,43,93,40288.72,87105.18,127393.90
500755,201711,124,89,35,83110.16,32795,115905.16
500769,201711,740,415,325,388526.75,304494.39,693021.14
500770,201711,453,235,218,220179.1,204018.97,424198.07
500780,201711,169,114,55,106817.73,51535,158352.73
500790,201711,1043,516,527,482916.19,493450.9,976367.09
500793,201711,253,134,119,125555.56,111486.24,237041.80
500795,201711,177,126,51,118051.91,47773,165824.91
500797,201711,40,33,7,30920.91,6559,37479.91
500800,201711,415,181,234,169579.33,218975.61,388554.94
500830,201711,2177,1213,964,1134164.2,902281.84,2036446.04
500840,201711,144,107,37,100259,34653.73,134912.73
510010,201711,168,92,76,86192.47,71211.41,157403.88
510020,201711,483,223,260,208557.75,242921.38,451479.13
510025,201711,1664,937,727,877052.34,678291.68,1555344.02
510030,201711,617,316,301,296025.84,281259.58,577285.42
510035,201711,128,56,72,52434.63,67437.95,119872.58
510040,201711,386,171,215,160218.93,200997.3,361216.23
510050,201711,424,227,197,211926.46,183721.24,395647.70
510060,201711,110,53,57,49651.45,53395.26,103046.71
510080,201711,220,88,132,82410.76,123563.94,205974.70
510100,201711,76,34,42,31857.66,39335.26,71192.92
510120,201711,35,21,14,19676.43,13117.66,32794.09
510125,201711,407,249,158,232639.78,148011.94,380651.72
510130,201711,591,346,245,323738.27,229102.15,552840.42
510140,201711,385,129,256,120856.51,239856.62,360713.13
510160,201711,90,42,48,39353.16,44963.78,84316.94
510170,201711,856,525,331,491604.25,309466.89,801071.14
510180,201711,2869,1396,1473,1304699.49,1377894.72,2682594.21
510185,201711,12,6,6,5621.56,5622,11243.56
510190,201711,216,75,141,70272.16,132106.67,202378.83
510250,201711,2629,1532,1097,1434376.1,1026746.63,2461122.73
510260,201711,202,143,59,133729.52,55231.63,188961.15
510263,201711,449,246,203,229042.73,189461.38,418504.11
510267,201711,642,357,285,334248.56,266658.26,600906.82
510268,201711,53,29,24,27173,22487.99,49660.99
510269,201711,71,30,41,28094.4,38416.53,66510.93
510270,201711,411,211,200,197496.36,186949.9,384446.26
510279,201711,230,167,63,156436.79,58730.25,215167.04
510285,201711,170,75,95,70248.47,89014.16,159262.63
510300,201711,553,297,256,277813.35,239778.53,517591.88
510305,201711,218,99,119,92727.3,111380.12,204107.42
510310,201711,114,56,58,52470.66,54334.95,106805.61
510320,201711,860,532,328,497865.5,306828.65,804694.15
510325,201711,413,164,249,153647.85,233013.06,386660.91
510330,201711,419,236,183,221103.61,171449.84,392553.45
510335,201711,613,324,289,303519.82,270087.48,573607.30
510336,201711,50,36,14,33730.81,13118,46848.81
510337,201711,122,47,75,44026.9,70264.51,114291.41
510340,201711,17474,8422,9052,7866572.6,8468860.84,16335433.44
510343,201711,71,49,22,45902.18,20614,66516.18
510345,201711,163,107,56,100246.87,52179.51,152426.38
510350,201711,658,370,288,345452.12,269752.65,615204.77
510360,201711,206,120,86,112423.85,80454.28,192878.13
510370,201711,137,71,66,66506.32,61686.72,128193.04
510380,201711,94,64,30,59968,28094.19,88062.19
510385,201711,58,26,32,24361.07,29967.64,54328.71
510390,201711,129,52,77,48724,72102.15,120826.15
510395,201711,41,28,13,26235.22,12181,38416.22
510410,201711,705,464,241,434730.5,225784.98,660515.48
510420,201711,586,281,305,262262.79,284126.99,546389.78
510450,201711,52,32,20,29984,18739.66,48723.66
510452,201711,39,23,16,21551,14992,36543
510454,201711,66,27,39,25296.39,36533.06,61829.45
510455,201711,128,80,48,74939,44975.33,119914.33
510460,201711,181,95,86,88547.26,80537.25,169084.51
510480,201711,741,414,327,386746.02,305948.9,692694.92
510490,201711,364,185,179,172915.66,167164.47,340080.13
510500,201711,252,189,63,177081.59,59027.88,236109.47
510510,201711,784,448,336,418874.71,314812.29,733687.00
510515,201711,1152,605,547,566302.57,512487.23,1078789.80
510517,201711,248,106,142,99320.2,133025.28,232345.48
510520,201711,231,148,83,138560.72,77433.52,215994.24
510523,201711,93,63,30,59029.01,28100.09,87129.10
510525,201711,708,405,303,378667.03,283746.96,662413.99
510530,201711,17,12,5,11244,4685,15929
510550,201711,272,119,153,111036.3,143344.27,254380.57
510558,201711,277,136,141,127401.28,132079.23,259480.51
510560,201711,382,236,146,221118.95,136771.39,357890.34
510562,201711,648,448,200,418471.55,186919.36,605390.91
510590,201711,836,433,403,405672.75,377573.5,783246.25
510600,201711,255,138,117,129270.62,109579.42,238850.04
510610,201711,164,79,85,74002.78,79620.94,153623.72
510615,201711,189,75,114,70255.35,106814.85,177070.20
510617,201711,17,10,7,9369.49,6559,15928.49
510618,201711,120,58,62,54346,57623.41,111969.41
510619,201711,106,73,33,68385.46,30905.32,99290.78
510620,201711,192,107,85,100247.97,79639.96,179887.93
510621,201711,194,124,70,116160.73,65563.9,181724.63
510622,201711,447,293,154,274410.4,143958.15,418368.55
510623,201711,360,238,122,222952.99,114278.64,337231.63
510624,201711,86,38,48,35590.66,44971.9,80562.56
510625,201711,525,319,206,298609.24,192378.83,490988.07
510626,201711,106,66,40,61840.98,37479.38,99320.36
510627,201711,55,40,15,37477.32,14054.4,51531.72
510628,201711,167,100,67,93633.96,62720.78,156354.74
510629,201711,254,163,91,152729.71,84317.94,237047.65
510630,201711,451,227,224,212609.09,209534.27,422143.36
510631,201711,10,3,7,2811,6559,9370
510637,201711,341,186,155,173919.09,145029.85,318948.94
510642,201711,980,540,440,505604.78,412131.67,917736.45
510645,201711,0,0,0,0,0,0
510650,201711,1531,1006,525,942360.62,491769.3,1434129.92
510665,201711,84,43,41,40208.45,38390.8,78599.25
510670,201711,66,36,30,33732,28110,61842
510675,201711,1186,715,471,669900.29,441292.54,1111192.83
510677,201711,369,175,194,162950.04,181314.54,344264.58
510680,201711,108,63,45,59002.66,42151,101153.66
510682,201711,201,93,108,86810.28,101194.22,188004.50
510685,201711,53,38,15,35605.13,14054.23,49659.36
510700,201711,624,363,261,339960.72,244379.58,584340.30
510704,201711,1028,556,472,518253.01,440167.02,958420.03
510706,201711,128,60,68,56214.46,63668.44,119882.90
510710,201711,395,263,132,246195.59,123564.54,369760.13
510715,201711,64,47,17,44029.63,15928.3,59957.93
510718,201711,211,110,101,102957.64,94611.12,197568.76
510719,201711,32,18,14,16866,13118,29984
510720,201711,202,133,69,124604.54,64370.23,188974.77
510724,201711,88,36,52,33720.98,48683.39,82404.37
510726,201711,50,27,23,25287.83,21524,46811.83
510729,201711,78,37,41,34669,38379.52,73048.52
510730,201711,470,258,212,241710.53,198473.85,440184.38
510735,201711,111,43,68,40290.22,63711.88,104002.10
510740,201711,29,15,14,14055,13118,27173
510757,201711,19,15,4,14055,3748,17803
510760,201711,7000,3715,3285,3470105.81,3071097.86,6541203.67
510770,201711,733,344,389,322104.72,364212.71,686317.43
510774,201711,14,6,8,5621.59,7496,13117.59
510775,201711,113,85,28,79632.56,26223.88,105856.44
510776,201711,29,8,21,7496,19677,27173
510777,201711,187,84,103,78677.79,96481.1,175158.89
510779,201711,54,24,30,22472.55,28061.26,50533.81
510780,201711,297,162,135,151680.87,126370.92,278051.79
510785,201711,444,241,203,225744.88,190134.19,415879.07
510787,201711,190,95,95,88993.56,88982.42,177975.98
510788,201711,0,0,0,0,0,0
510790,201711,2388,1240,1148,1159517.68,1072944.69,2232462.37
510792,201711,1070,598,472,559784.48,441743.83,1001528.31
510794,201711,110,54,56,50596.14,52438.41,103034.55
510795,201711,2405,1397,1008,1301910.08,941531.52,2243441.60
510800,201711,178,109,69,102118.54,64635.38,166753.92
510805,201711,165,117,48,109625.47,44975.16,154600.63
510810,201711,96,39,57,36429.37,53281.94,89711.31
510820,201711,260,122,138,114054.63,128093.71,242148.34
510830,201711,68,41,27,38416.13,25285,63701.13
510835,201711,2,1,1,936.56,937,1873.56
510840,201711,9179,4599,4580,4294574.87,4282346.11,8576920.98
510850,201711,208,85,123,79633.84,114925.37,194559.21
510860,201711,393,172,221,160932.57,206291.64,367224.21
510880,201711,63,48,15,44952.2,14054.33,59006.53
510885,201711,73,45,28,42142.25,26206.05,68348.30
510890,201711,72,41,31,38416.12,29045.17,67461.29
510895,201711,186,104,82,97444.16,76513.05,173957.21
520005,201711,30,20,10,18737.79,9369.56,28107.35
520010,201711,280,125,155,117120.9,145129.56,262250.46
520013,201711,623,366,257,342886.48,240518.28,583404.76
520015,201711,49,35,14,32795,13117.53,45912.53
520017,201711,103,60,43,55937.42,40291,96228.42
520020,201711,29,15,14,14055,13118,27173
520025,201711,2012,1094,918,1023729.69,859285.99,1883015.68
520030,201711,798,403,395,376655.37,368564.04,745219.41
520050,201711,76,50,26,46850,24361.33,71211.33
520055,201711,43,29,14,27170.68,13117.29,40287.97
520060,201711,174,112,62,104941.19,58093.51,163034.70
520080,201711,588,405,183,379192.23,171462.65,550654.88
520082,201711,20,14,6,13118,5622,18740
520085,201711,97,73,24,68400.15,22487.1,90887.25
520090,201711,89,62,27,58089.99,25298.72,83388.71
520110,201711,9059,3913,5146,3660873.29,4818135.52,8479008.81
520120,201711,14,8,6,7299.23,5622,12921.23
520130,201711,753,527,226,493748.51,211737.67,705486.18
520140,201711,11815,6642,5173,6215377.18,4844020.84,11059398.02
520145,201711,44,33,11,30921,10307,41228
520150,201711,187,146,41,136799.48,38417,175216.48
520160,201711,33,23,10,21550.12,9369.64,30919.76
520170,201711,230,142,88,133001.56,82401.66,215403.22
520180,201711,109,55,54,51531.18,50597.08,102128.26
520215,201711,215,132,83,123399.04,77489.35,200888.39
520235,201711,68,52,16,48719.62,14992,63711.62
520250,201711,138,85,53,79640.64,49377.43,129018.07
520260,201711,111,70,41,65587.07,37478.64,103065.71
520280,201711,49,35,14,32127.7,13118,45245.7
520310,201711,38,25,13,23424.98,12180.26,35605.24
520320,201711,166,104,62,97426.51,58091.31,155517.82
520330,201711,780,412,368,385969.16,344768.1,730737.26
520340,201711,356,201,155,188337,145211.63,333548.63
520350,201711,523,238,285,222996.03,266982.09,489978.12
520355,201711,91,52,39,48722.73,36542.66,85265.39
520357,201711,26,18,8,16864.54,7495.66,24360.20
520360,201711,0,0,0,0,0,0
520380,201711,140,72,68,67461.11,63711.49,131172.60
520390,201711,292,121,171,112904,159961.88,272865.88
520393,201711,12,9,3,8433,2809.96,11242.96
520396,201711,98,59,39,55281.69,36542.6,91824.29
520400,201711,230,133,97,123014.39,90887.99,213902.38
520410,201711,203,102,101,95561,94623,190184
520420,201711,24,16,8,14992,7495.89,22487.89
520425,201711,297,130,167,120858.17,155996.63,276854.80
520430,201711,457,236,221,220841.33,207000.9,427842.23
520440,201711,597,392,205,367285.05,192079.43,559364.48
520450,201711,1901,865,1036,809370.95,970032.16,1779403.11
520455,201711,58,40,18,37480,16866,54346
520460,201711,30,15,15,14054.2,14054.43,28108.63
520465,201711,23,20,3,18738.56,2811,21549.56
520470,201711,418,258,160,241444.39,149918.21,391362.60
520480,201711,84,47,37,44037.87,34602.56,78640.43
520485,201711,129,45,84,42162.16,78425,120587.16
520490,201711,387,287,100,268734.64,93538.03,362272.67
520495,201711,181,107,74,100256.29,69336.62,169592.91
520500,201711,176,135,41,126491.91,38416.28,164908.19
520505,201711,173,91,82,85252.61,76831.89,162084.50
520510,201711,1746,859,887,801523.14,828473.43,1629996.57
520520,201711,39,30,9,28110,8433,36543
520530,201711,234,171,63,157877.39,58245.79,216123.18
520540,201711,523,343,180,320091.93,168654.83,488746.76
520545,201711,160,88,72,82450.1,67462.28,149912.38
520547,201711,50,28,22,26235.5,20614,46849.5
520549,201711,1059,499,560,467213.05,524141.47,991354.52
520551,201711,296,156,140,146167.31,131172.22,277339.53
520552,201711,44,27,17,25295.7,15928.89,41224.59
520570,201711,17,9,8,8432.02,7495.29,15927.31
520580,201711,283,171,112,160205.61,104938.22,265143.83
520590,201711,162,95,67,89009.63,62496.4,151506.03
520620,201711,1131,532,599,497709.52,560395.71,1058105.23
520630,201711,40,24,16,22486.5,14991.16,37477.66
520640,201711,413,236,177,221122.73,165846.89,386969.62
520650,201711,53,39,14,36540.32,13116.01,49656.33
520660,201711,34,19,15,17803,14054.52,31857.52
520670,201711,32,27,5,25297.33,4685,29982.33
520680,201711,61,40,21,37479.29,19677,57156.29
520690,201711,32,10,22,9370,20600.52,29970.52
520710,201711,36,32,4,29984,3748,33732
520725,201711,200,126,74,118059.9,69337.21,187397.11
520735,201711,56,41,15,38415.52,14051.76,52467.28
520740,201711,401,196,205,182928.23,192060.77,374989.00
520750,201711,37,27,10,25299,9369.3,34668.3
520753,201711,53,37,16,34668.43,14991.49,49659.92
520760,201711,110,73,37,68400.6,34669,103069.6
520780,201711,283,217,66,203312.33,61836.8,265149.13
520790,201711,170,81,89,75611.65,83391.22,159002.87
520800,201711,3501,1857,1644,1737704.99,1539730.39,3277435.38
520810,201711,163,114,49,106815.46,45911.87,152727.33
520815,201711,6,5,1,4685,937,5622
520830,201711,138,90,48,84329.13,44694.1,129023.23
520840,201711,343,224,119,209411,111500.1,320911.1
520850,201711,110,71,39,66513,36393.08,102906.08
520860,201711,1673,1061,612,992696.5,572280.47,1564976.97
520870,201711,30784,15180,15604,14195877.71,14605578.03,28801455.74
520880,201711,1041,584,457,547193.47,428182.52,975375.99
520890,201711,793,454,339,423775.82,317520.23,741296.05
520910,201711,1024,532,492,494937.06,460996.15,955933.21
520915,201711,96,75,21,70275,19667.63,89942.63
520920,201711,407,202,205,188706.67,192080.21,380786.88
520929,201711,22,20,2,18739.82,1874,20613.82
520940,201711,75,47,28,44035.51,26236,70271.51
520945,201711,21,13,8,12179.06,7496,19675.06
520960,201711,49,31,18,29046.61,16866,45912.61
520970,201711,327,203,124,189576.48,115902.45,305478.93
520980,201711,91,67,24,62763.71,22483.29,85247.00
520990,201711,478,320,158,299813.19,148033.46,447846.65
520993,201711,128,63,65,59030.53,60891,119921.53
520995,201711,246,137,109,127415.04,101565.44,228980.48
521000,201711,1550,895,655,836888.65,613608.13,1450496.78
521010,201711,669,305,364,285430.77,340993.78,626424.55
521015,201711,16,9,7,8433,6559,14992
521020,201711,1476,1019,457,954164.36,427833.74,1381998.10
521030,201711,43,30,13,28108.14,12180.26,40288.40
521040,201711,904,554,350,518830.47,327661.03,846491.50
521056,201711,43,29,14,27170.63,13117.22,40287.85
521060,201711,132,82,50,76833.23,46849.98,123683.21
521080,201711,469,350,119,327922.93,111498,439420.93
521090,201711,535,321,214,300762.04,200239.71,501001.75
521100,201711,291,215,76,201435.38,71210.66,272646.04
521120,201711,1035,700,335,654085.99,313596.77,967682.76
521130,201711,360,256,104,239861.55,96561.66,336423.21
521140,201711,186,106,80,99318.81,74958.45,174277.26
521150,201711,2809,1219,1590,1140222.73,1488535.61,2628758.34
521160,201711,31,17,14,15929,13118,29047
521170,201711,195,114,81,106804.45,75894.27,182698.72
521180,201711,1116,700,416,654266.26,389073.59,1043339.85
521190,201711,2562,1081,1481,1012169.12,1386792.75,2398961.87
521200,201711,45,34,11,31855.13,10307,42162.13
521205,201711,16,11,5,10307,4685,14992
521210,201711,150,85,65,79643.78,60905,140548.78
521220,201711,812,546,266,508994.76,249167.91,758162.67
521225,201711,29,18,11,16866,10307,27173
521230,201711,112,74,38,69053.81,35605.44,104659.25
521250,201711,6695,3729,2966,3487279.05,2776614.61,6263893.66
521260,201711,18,13,5,12180.7,4684.1,16864.8
521270,201711,146,112,34,104937.51,31858,136795.51
521280,201711,440,255,185,238269.86,173343.5,411613.36
521290,201711,33,13,20,12181,18739.26,30920.26
521295,201711,100,67,33,62552.28,30920.16,93472.44
521300,201711,228,115,113,107720.91,105484.65,213205.56
521305,201711,36,24,12,22488,11244,33732
521308,201711,1073,768,305,719026.34,285467.82,1004494.16
521310,201711,1350,797,553,745203.73,516971.02,1262174.75
521340,201711,22,17,5,15929,4685,20614
521350,201711,131,96,35,89951.24,32795,122746.24
521370,201711,194,120,74,111502.9,69056.9,180559.8
521375,201711,194,109,85,102132.59,79362.44,181495.03
521377,201711,50,33,17,30920.38,15929,46849.38
521380,201711,1070,695,375,646805.58,351367.86,998173.44
521385,201711,16,9,7,8432.6,6559,14991.6
521390,201711,109,89,20,83072.09,18738.99,101811.08
521400,201711,329,208,121,194603.84,113327.57,307931.41
521405,201711,150,77,73,72143.62,68400.4,140544.02
521410,201711,67,43,24,40289.81,22487.93,62777.74
521440,201711,218,153,65,142560.22,60902.84,203463.06
521450,201711,725,397,328,371973.34,307327.97,679301.31
521460,201711,1184,719,465,673392.97,435674,1109066.97
521470,201711,14,9,5,8432.11,4685,13117.11
521480,201711,52,34,18,31857.43,16782,48639.43
521483,201711,303,162,141,151505.07,132111.82,283616.89
521486,201711,288,181,107,169471.87,99591.32,269063.19
521487,201711,23,11,12,10306.6,11243.47,21550.07
521490,201711,28,16,12,14991.56,11243.85,26235.41
521500,201711,116,72,44,67462.44,41225.23,108687.67
521520,201711,40,29,11,27173,10306.5,37479.5
521523,201711,585,360,225,334364.2,210815.44,545179.64
521525,201711,46,30,16,28110,14992,43102
521530,201711,246,129,117,120870.34,109626.58,230496.92
521540,201711,31,16,15,14991.67,14055,29046.67
521550,201711,89,41,48,38108.4,44918.56,83026.96
521560,201711,795,545,250,510086.97,234101.58,744188.55
521565,201711,47,32,15,29982.56,14053.79,44036.35
521570,201711,487,326,161,305443.16,150749.87,456193.03
521580,201711,61,38,23,35605.6,21551,57156.6
521590,201711,35,19,16,17803,14992,32795
521600,201711,30,18,12,16865.56,11243.23,28108.79
521630,201711,235,118,117,110554.89,108637.76,219192.65
521640,201711,303,153,150,143354.02,140542.36,283896.38
521645,201711,29,15,14,14055,13118,27173
521680,201711,223,140,83,131176.47,77769.26,208945.73
521690,201711,1,1,0,937,0,937
521710,201711,1182,557,625,521045.02,585590.4,1106635.42
521720,201711,518,341,177,319500.14,165806.78,485306.92
521730,201711,629,307,322,287654.41,300620.49,588274.90
521740,201711,921,367,554,343831.03,517889.65,861720.68
521760,201711,1587,853,734,797676.22,687417.81,1485094.03
521770,201711,804,510,294,477844.51,275011.15,752855.66
521800,201711,2092,1292,800,1206849.99,748819.09,1955669.08
521805,201711,33,18,15,16865.33,14054.66,30919.99
521810,201711,95,58,37,53218.46,34669,87887.46
521830,201711,959,672,287,628038.26,268898.12,896936.38
521839,201711,94,62,32,58091.08,29982.16,88073.24
521850,201711,1109,596,513,557003.31,480244.69,1037248.00
521860,201711,350,216,134,202390.51,125275.68,327666.19
521870,201711,71,40,31,37478.32,29046.56,66524.88
521878,201711,43,21,22,19673.44,20608.99,40282.43
521880,201711,4405,1970,2435,1843844.68,2279099.64,4122944.32
521890,201711,581,399,182,373841.52,170232.51,544074.03
521900,201711,297,240,57,224186.07,53408.32,277594.39
521910,201711,154,109,45,102130.38,42162.47,144292.85
521920,201711,54,25,29,23425,27173,50598
521925,201711,34,21,13,19675.17,12179.87,31855.04
521930,201711,1119,641,478,600355.66,447156.78,1047512.44
521935,201711,33,25,8,23424.04,7495.68,30919.72
521940,201711,194,98,96,91825.56,89946.35,181771.91
521945,201711,15,13,2,12180.26,1874,14054.26
521950,201711,7,5,2,4685,1874,6559
521960,201711,77,58,19,54338.85,17801.71,72140.56
521970,201711,419,264,155,247076.19,145224.87,392301.06
521971,201711,97,47,50,44038.61,46846.87,90885.48
521973,201711,30,13,17,12181,15929,28110
521975,201711,1093,569,524,531998.92,489863.15,1021862.07
521980,201711,244,166,78,155371.97,73084.38,228456.35
521990,201711,72,54,18,50595.25,16864.82,67460.07
522000,201711,290,179,111,167717.79,104003.35,271721.14
522005,201711,22,14,8,13118,7496,20614
522010,201711,1123,629,494,588408.84,462294.54,1050703.38
522015,201711,55,34,21,31844,19677,51521
522020,201711,873,464,409,433589.6,382448.36,816037.96
522026,201711,29,20,9,18739.12,8432.33,27171.45
522028,201711,16,12,4,11243.56,3748,14991.56
522040,201711,745,292,453,273287.12,424374.92,697662.04
522045,201711,2034,1282,752,1200123.02,704075.81,1904198.83
522050,201711,171,81,90,75897,84329.53,160226.53
522060,201711,555,354,201,331411.19,188234.18,519645.37
522068,201711,136,89,47,83382.02,44036.86,127418.88
522070,201711,11,11,0,10307,0,10307
522100,201711,47,24,23,22220.32,21549.96,43770.28
522108,201711,40,30,10,28110,9370,37480
522119,201711,58,29,29,27170.59,27172.16,54342.75
522130,201711,79,25,54,23423.51,50545,73968.51
522140,201711,3688,1885,1803,1761480.37,1687222.3,3448702.67
522145,201711,55,33,22,30920.17,20614,51534.17
522150,201711,63,50,13,46849.01,12181,59030.01
522155,201711,59,40,19,37462.26,17802.63,55264.89
522157,201711,6,4,2,3748,1874,5622
522160,201711,1742,1022,720,956460.95,674318.43,1630779.38
522170,201711,394,264,130,247359.53,121804.71,369164.24
522180,201711,36,20,16,18739.12,14992,33731.12
522185,201711,1302,542,760,504857.26,711461.62,1216318.88
522190,201711,48,27,21,25299,19582.86,44881.86
522200,201711,299,181,118,169592.04,110559.91,280151.95
522205,201711,167,113,54,105874.77,50596.19,156470.96
522220,201711,171,121,50,113377,46849.82,160226.82
522230,201711,31,24,7,22486.62,6559,29045.62
530010,201711,55312,28304,27008,26381770.15,25252539.51,51634309.66
110001,201712,512,404,108,377581.52,100562.3,478143.82
110002,201712,2752,1643,1109,1537645.92,1038222.58,2575868.50
110003,201712,93,73,20,68401,18740,87141
110004,201712,1974,1258,716,1175875.57,669945.63,1845821.20
110005,201712,433,348,85,325795,79635.63,405430.63
110006,201712,448,344,104,322046.9,97429.26,419476.16
110007,201712,83,66,17,61842,15929,77771
110008,201712,239,137,102,127432,95574,223006
110009,201712,788,534,254,498204.1,237802,736006.1
110010,201712,1786,1109,677,1037914.06,634195.57,1672109.63
110011,201712,1889,1450,439,1357143.1,411313.52,1768456.62
110012,201712,4112,2391,1721,2233020.35,1611322.71,3844343.06
110013,201712,754,568,186,532206.63,174282,706488.63
110014,201712,364,309,55,289512.89,51530.32,341043.21
110015,201712,1428,1147,281,1072404.26,262716.06,1335120.32
110018,201712,1111,659,452,617174,423511.32,1040685.32
110020,201712,15321,8999,6322,8388065.97,5911722.05,14299788.02
110025,201712,634,464,170,432805.45,159281,592086.45
110026,201712,42,29,13,27173,12181,39354
110028,201712,1641,1191,450,1111166.43,418251.02,1529417.45
110029,201712,139,122,17,114314,15929,130243
110030,201712,2481,1667,814,1559226.3,761765.63,2320991.93
110032,201712,392,301,91,281733,85263,366996
110033,201712,657,499,158,464705.35,147761,612466.35
110034,201712,360,267,93,247908,86486,334394
110037,201712,103,84,19,78708,17803,96511
110040,201712,329,220,109,206140,102133,308273
110045,201712,929,611,318,570988,296292.7,867280.7
110050,201712,95,78,17,73086,15929,89015
110060,201712,87,45,42,42165,39354,81519
110070,201712,131,78,53,73086,49380,122466
110080,201712,396,234,162,217074.8,151745.81,368820.61
110090,201712,31,26,5,24362,4685,29047
110092,201712,111,63,48,59031,44906,103937
110094,201712,195,135,60,126495,56220,182715
110100,201712,27,22,5,20614,4685,25299
110110,201712,72,45,27,42165,25018,67183
110120,201712,72,59,13,55283,12181,67464
110130,201712,303,246,57,229033.81,53409,282442.81
110140,201712,247,160,87,149451.5,81509.63,230961.13
110143,201712,47,40,7,37480,6559,44039
110145,201712,29,20,9,18740,8433,27173
110146,201712,22,11,11,10307,10307,20614
110147,201712,39,30,9,28110,8433,36543
110148,201712,38,26,12,24310.57,11244,35554.57
110149,201712,295,209,86,195551.9,80582,276133.9
110150,201712,84,57,27,53409,25032.89,78441.89
110155,201712,8,7,1,6559,937,7496
110160,201712,72,60,12,56220,11244,67464
110170,201712,210,171,39,160227,36543,196770
110175,201712,28,22,6,20614,5622,26236
110180,201712,94,82,12,76834,11244,88078
120001,201712,132,90,42,84288,39346,123634
120005,201712,191,120,71,112397.12,66527,178924.12
120010,201712,1005,648,357,600840.4,332254.28,933094.68
120013,201712,139,94,45,87392.11,41155.98,128548.09
120017,201712,92,59,33,55174.48,30878.12,86052.60
120020,201712,3504,2787,717,2582361.81,668282.26,3250644.07
120025,201712,604,339,265,314703.67,247278.45,561982.12
120030,201712,1028,859,169,796887.76,157608.12,954495.88
120032,201712,48,40,8,37458.12,7496,44954.12
120033,201712,216,188,28,175814.94,26236,202050.94
120034,201712,154,113,41,103985.12,38373.24,142358.36
120035,201712,30,20,10,18740,9370,28110
120038,201712,385,241,144,225006.2,134884.24,359890.44
120039,201712,25,23,2,21551,1874,23425
120040,201712,14073,9726,4347,8981834.01,4031982.81,13013816.82
120042,201712,43,37,6,34669,5622,40291
120043,201712,14,3,11,2811,10307,13118
120045,201712,536,345,191,321215.29,178702.48,499917.77
120050,201712,1249,954,295,888420.59,276043.46,1164464.05
120060,201712,1401,1132,269,1045333.81,247938.06,1293271.87
120070,201712,510,366,144,336327.55,133564.83,469892.38
120080,201712,160,104,56,96206.09,51909.55,148115.64
130002,201712,149,103,46,96511,43102,139613
130006,201712,74,42,32,39354,29984,69338
130008,201712,144,77,67,71428.72,62056.96,133485.68
130010,201712,141,74,67,69338,62779,132117
130014,201712,241,176,65,164912,60905,225817
130020,201712,87,48,39,44976,36543,81519
130030,201712,882,539,343,505043,321381.63,826424.63
130040,201712,333,166,167,155542,155542.84,311084.84
130050,201712,554,307,247,287377.9,231439,518816.9
130060,201712,889,608,281,564569.3,260481.34,825050.64
130063,201712,552,289,263,270793,246409.12,517202.12
130068,201712,190,122,68,114314,63434.9,177748.9
130070,201712,1331,923,408,851353.97,377268.36,1228622.33
130080,201712,660,430,230,402535.2,215501,618036.2
130083,201712,71,38,33,35606,30921,66527
130090,201712,386,198,188,183876.88,176156,360032.88
130100,201712,1124,520,604,487240,565666.9,1052906.9
130110,201712,708,315,393,295005,368241,663246
130115,201712,171,69,102,64653,95574,160227
130120,201712,1612,1007,605,943559,566885,1510444
130130,201712,620,420,200,393540,187400,580940
130140,201712,1534,1154,380,1080646.07,355123.1,1435769.17
130150,201712,427,360,67,337320,62779,400099
130160,201712,473,262,211,245494,197707,443201
130165,201712,25,18,7,16866,6559,23425
130170,201712,949,671,278,628657.66,260486,889143.66
130180,201712,153,92,61,85735.5,57157,142892.5
130185,201712,2193,1160,1033,1085025.89,967340.26,2052366.15
130190,201712,3597,2261,1336,2114404.62,1250272.09,3364676.71
130195,201712,292,234,58,219258,54346,273604
130200,201712,179,81,98,75887.63,91826,167713.63
130210,201712,77,37,40,34669,37480,72149
130220,201712,190,130,60,121810,56220,178030
130230,201712,332,209,123,195833,115251,311084
130240,201712,1466,920,546,860724.2,510761.12,1371485.32
130250,201712,4714,3037,1677,2840213.6,1571197.19,4411410.79
130255,201712,422,209,213,195833,199299.9,395132.9
130260,201712,52871,25177,27694,23557855.81,25941687.43,49499543.24
130270,201712,1490,953,537,892492.5,503169,1395661.5
130280,201712,114,69,45,64653,42165,106818
130290,201712,2094,1516,578,1420492,541304.9,1961796.9
130300,201712,425,306,119,286440.9,111503,397943.9
130310,201712,890,475,415,445075,388855,833930
130320,201712,445,237,208,221132,194896,416028
130330,201712,701,426,275,399162,257393.9,656555.9
130340,201712,3213,1949,1264,1821715.6,1182962.6,3004678.2
130350,201712,483,302,181,282952.12,169597,452549.12
130353,201712,778,318,460,297685,431020,728705
130356,201712,756,345,411,323265,384825.9,708090.9
130360,201712,71,41,30,38417,28110,66527
130370,201712,688,500,188,468500,176156,644656
130380,201712,639,435,204,407595,191148,598743
130390,201712,491,394,97,369178,90889,460067
130395,201712,181,41,140,38417,131180,169597
130400,201712,68,46,22,43102,20614,63716
130406,201712,2091,1321,770,1234232.15,720581.06,1954813.21
130410,201712,512,216,296,202392,277333.26,479725.26
130420,201712,3191,2551,640,2386500.25,599680,2986180.25
130423,201712,163,76,87,71212,81519,152731
130426,201712,141,83,58,77771,54346,132117
130430,201712,412,271,141,253927,132117,386044
130440,201712,198,72,126,67464,118062,185526
140002,201712,36,14,22,13118,20614,33732
140005,201712,203,123,80,115016.75,74960,189976.75
140010,201712,10263,6929,3334,6460232.66,3121052.02,9581284.68
140015,201712,153,69,84,64653,78708,143361
140017,201712,109,75,34,70275,31858,102133
140020,201712,483,325,158,303588,148046,451634
140023,201712,24,15,9,13605,8433,22038
140028,201712,16,11,5,10307,4685,14992
140030,201712,363,253,110,237061,102479.69,339540.69
140040,201712,54,38,16,35606,14898.3,50504.3
140045,201712,249,118,131,109910.1,122747,232657.1
140047,201712,560,373,187,346686.63,174469.5,521156.13
140050,201712,155,102,53,94776,49661,144437
140060,201712,32,22,10,19892.51,9370,29262.51
140070,201712,31,29,2,27173,1874,29047
150010,201712,4724,2923,1801,2736180.75,1685455.66,4421636.41
150013,201712,147,100,47,93700,44039,137739
150020,201712,1101,577,524,540649,490988,1031637
150030,201712,745,301,444,282037,416028,698065
150034,201712,193,117,76,109629,71212,180841
150040,201712,1383,822,561,770214,525657,1295871
150050,201712,716,418,298,390682.9,279026,669708.9
150060,201712,4729,3068,1661,2870682.13,1555841.65,4426523.78
150070,201712,314,147,167,137739,156479,294218
150080,201712,14634,7347,7287,6874100.42,6820167.66,13694268.08
150085,201712,373,235,138,220185.63,129306,349491.63
150090,201712,764,651,113,609987,105881,715868
150095,201712,346,209,137,195076.84,127563.18,322640.02
150100,201712,53,37,16,34669,14992,49661
150110,201712,169,83,86,77771,80582,158353
150120,201712,438,324,114,303588,106818,410406
150125,201712,50,22,28,20614,26236,46850
150130,201712,1912,1012,900,948244,843295.32,1791539.32
150140,201712,54827,25476,29351,23839911.09,27488005.26,51327916.35
150145,201712,173,101,72,94637,67464,162101
150150,201712,2815,1245,1570,1166351.37,1467215.7,2633567.07
150157,201712,442,304,138,284848,129301.32,414149.32
150160,201712,122,97,25,90889,23425,114314
150170,201712,3684,2725,959,2549764.5,898301.9,3448066.4
150172,201712,312,213,99,199581,92763,292344
150175,201712,89,56,33,52472,30921,83393
150178,201712,755,501,254,468500,237998,706498
150180,201712,3033,1449,1584,1356916.8,1483903.5,2840820.3
150190,201712,336,215,121,201455,113377,314832
150195,201712,121,59,62,55283,58094,113377
150200,201712,211,99,112,92763,104944,197707
150210,201712,3160,2558,602,2395806.84,563835.75,2959642.59
150215,201712,500,330,170,309210,159290,468500
150220,201712,3960,2665,1295,2495563.9,1211335.96,3706899.86
150230,201712,1140,915,225,856785.7,210825,1067610.7
150240,201712,5756,3361,2395,3145876.57,2244102,5389978.57
150250,201712,33,16,17,14992,15929,30921
150260,201712,73,43,30,40291,28110,68401
150270,201712,2329,1514,815,1417349.14,762811.9,2180161.04
150275,201712,584,354,230,331698,215510,547208
150276,201712,102,43,59,40291,55283,95574
150277,201712,754,327,427,306380.63,400099,706479.63
150280,201712,346,211,135,197707,126495,324202
150285,201712,75,37,38,34669,35606,70275
150290,201712,967,591,376,553476.53,352031,905507.53
150293,201712,691,317,374,296607.63,350438,647045.63
150295,201712,461,202,259,189274,242533.82,431807.82
150300,201712,80,42,38,39354,35606,74960
150304,201712,137,90,47,84330,44039,128369
150307,201712,399,327,72,306399,67464,373863
150309,201712,542,388,154,363556,144298,507854
150310,201712,252,170,82,159290,76834,236124
150320,201712,1806,1237,569,1158792.59,533153,1691945.59
150330,201712,2090,1199,891,1122807.1,834867,1957674.1
150340,201712,196,129,67,120638.75,62779,183417.75
150345,201712,610,326,284,305283.97,266108,571391.97
150350,201712,422,328,94,304984.13,88078,393062.13
150360,201712,4463,2852,1611,2668721.74,1509488.26,4178210.00
150370,201712,755,537,218,502387,203975.9,706362.9
150375,201712,193,103,90,96511,84330,180841
150380,201712,1265,834,431,781458,403566,1185024
150390,201712,737,414,323,387918,302642,690560
150400,201712,99,81,18,75897,16866,92763
150405,201712,1256,828,428,774988.33,400473.8,1175462.13
150410,201712,141,91,50,85267,46850,132117
150420,201712,7391,4043,3348,3786659.44,3135893.86,6922553.30
150430,201712,488,328,160,307336,149920,457256
150440,201712,592,347,245,324390,229565,553955
150442,201712,2121,1123,998,1050427.93,934840.22,1985268.15
150445,201712,524,327,197,306399,183652,490051
150450,201712,277,130,147,121810,137739,259549
150460,201712,776,586,190,547287.66,178011.26,725298.92
150470,201712,1353,809,544,757752,509728,1267480
150475,201712,33,25,8,23425,7496,30921
150480,201712,1246,865,381,810505,356715.9,1167220.9
150490,201712,626,336,290,314832,271730,586562
150495,201712,330,226,104,211762,97448,309210
150497,201712,299,202,97,189274,90879.63,280153.63
150500,201712,432,291,141,272667,132117,404784
150503,201712,839,393,446,367960,417884,785844
150506,201712,1032,666,366,624042,342932.63,966974.63
150510,201712,1234,699,535,654682,501295,1155977
150520,201712,271,181,90,169597,84330,253927
150530,201712,1564,846,718,789610.65,671547.9,1461158.55
150540,201712,238,166,72,155542,67464,223006
150543,201712,689,383,306,358290.06,286440.9,644730.96
150548,201712,497,344,153,322328,143361,465689
150549,201712,60,40,20,37480,18740,56220
150550,201712,2914,1518,1396,1421664,1307490,2729154
150553,201712,3046,1803,1243,1687912.3,1164681.63,2852593.93
150555,201712,142,75,67,70275,62779,133054
150560,201712,55,41,14,38417,13118,51535
150563,201712,71,40,31,37480,29047,66527
150565,201712,169,101,68,94637,63716,158353
150570,201712,403,269,134,252034.26,125558,377592.26
150580,201712,1519,636,883,595276.1,827371,1422647.1
150590,201712,775,474,301,444138,282037,726175
150600,201712,454,273,181,255801,169597,425398
150610,201712,146,126,20,117229,18740,135969
150611,201712,130,90,40,84330,37480,121810
150613,201712,3162,1933,1229,1811221,1151564,2962785
150616,201712,487,301,186,281803,174282,456085
150618,201712,1137,623,514,583526.49,481618,1065144.49
150619,201712,400,303,97,283911,90889,374800
150620,201712,1285,742,543,695254,508509.9,1203763.9
150630,201712,315,213,102,199581,95574,295155
150635,201712,502,207,295,193959,276415,470374
150640,201712,62,30,32,28110,29984,58094
150650,201712,2338,1349,989,1263741.27,926407.22,2190148.49
150655,201712,250,187,63,175219,59031,234250
150658,201712,103,59,44,55283,41228,96511
150660,201712,478,333,145,312021,135865,447886
150670,201712,993,356,637,333281.9,596850.63,930132.53
150680,201712,9869,5382,4487,5036827.83,4202034.26,9238862.09
150690,201712,53,34,19,31858,17803,49661
150700,201712,548,350,198,327762.6,185526,513288.6
150710,201712,268,161,107,150857,100259,251116
150715,201712,875,529,346,494708.26,324173.89,818882.15
150720,201712,447,340,107,318580,99977.9,418557.9
150730,201712,897,479,418,448814,391384.9,840198.9
150740,201712,235,165,70,154605,65590,220195
150745,201712,776,411,365,385107,342005,727112
150746,201712,54,32,22,29984,20614,50598
150747,201712,270,208,62,194896,58094,252990
150750,201712,133,76,57,71212,53409,124621
150760,201712,1704,1099,605,1029763,566885,1596648
150770,201712,368,191,177,178967,165677.07,344644.07
150775,201712,87,40,47,37480,44039,81519
150780,201712,186,100,86,93700,80582,174282
150790,201712,902,490,412,459130,386044,845174
150795,201712,1438,837,601,784269,563137,1347406
150796,201712,409,233,176,218321,164912,383233
150797,201712,281,156,125,146172,117125,263297
150800,201712,1422,850,572,795508.31,535964,1331472.31
150803,201712,598,493,105,461941,98385,560326
150805,201712,189,117,72,109629,67450.63,177079.63
150808,201712,976,530,446,496610,417902,914512
150810,201712,3359,2311,1048,2162025.5,981414,3143439.5
150812,201712,431,225,206,210825,193022,403847
150815,201712,964,634,330,592704.04,309210,901914.04
150820,201712,1591,973,618,910482.9,579047.26,1489530.16
150830,201712,838,589,249,550956,233313,784269
150835,201712,189,112,77,104944,72149,177093
150840,201712,1304,827,477,774899,446949,1221848
160005,201712,53,31,22,29047,20614,49661
160010,201712,195,120,75,112440,70271,182711
160015,201712,119,67,52,62779,48724,111503
160020,201712,126,71,55,66527,51535,118062
160021,201712,40,21,19,19677,17803,37480
160023,201712,109,61,48,57157,44976,102133
160025,201712,33,14,19,13118,17803,30921
160027,201712,1436,818,618,762999.35,578329,1341328.35
160030,201712,15550,7954,7596,7443608.58,7112792.76,14556401.34
160040,201712,318,181,137,169597,128369,297966
160050,201712,642,332,310,311084,290188.9,601272.9
160053,201712,326,184,142,172127,133054,305181
160055,201712,21,16,5,14992,4685,19677
160060,201712,6356,3309,3047,3090352.25,2854098.1,5944450.35
160070,201712,167,101,66,94637,61842,156479
160080,201712,78,40,38,37480,35606,73086
170025,201712,23,15,8,14055,7496,21551
170030,201712,223,179,44,167529,41228,208757
170035,201712,227,111,116,103070,108692,211762
170040,201712,191,147,44,137457.9,41228,178685.9
170070,201712,325,190,135,178030,126495,304525
170100,201712,375,266,109,249242,102133,351375
170105,201712,60,49,11,45913,10307,56220
170110,201712,103,63,40,59031,37480,96511
170130,201712,73,34,39,31858,36262,68120
170190,201712,105,66,39,61842,36543,98385
170200,201712,393,263,130,245766.1,121707.78,367473.88
170210,201712,6014,3106,2908,2903026.03,2721592.33,5624618.36
170215,201712,83,42,41,39354,38417,77771
170220,201712,1432,1049,383,980551.76,358590,1339141.76
170230,201712,154,99,55,92763,51535,144298
170240,201712,556,370,186,346690,174282,520972
170255,201712,1118,893,225,836741,210543.9,1047284.9
170270,201712,37,28,9,26236,8245.6,34481.6
170290,201712,73,55,18,51535,16866,68401
170300,201712,81,53,28,48911.4,26236,75147.4
170305,201712,40,32,8,29984,7496,37480
170307,201712,61,45,16,42165,14992,57157
170310,201712,102,56,46,52472,43102,95574
170320,201712,17,13,4,12181,3748,15929
170330,201712,19,16,3,14992,2811,17803
170360,201712,25,15,10,14055,9370,23425
170370,201712,124,65,59,60905,55283,116188
170380,201712,80,57,23,53409,21551,74960
170382,201712,46,41,5,38417,4685,43102
170384,201712,127,92,35,86204,32795,118999
170386,201712,61,28,33,26236,30921,57157
170388,201712,48,17,31,15929,29047,44976
170389,201712,23,17,6,15929,5622,21551
170390,201712,50,29,21,27173,19677,46850
170410,201712,33,22,11,20614,10307,30921
170460,201712,17,12,5,11244,4685,15929
170510,201712,28,21,7,19677,6559,26236
170550,201712,1476,833,643,780521,601741.5,1382262.5
170555,201712,109,75,34,70275,31858,102133
170560,201712,99,71,28,66527,26236,92763
170600,201712,37,18,19,16866,17803,34669
170610,201712,192,100,92,93545.4,86186,179731.4
170625,201712,38,19,19,17803,17803,35606
170650,201712,86,64,22,59968,20614,80582
170700,201712,555,417,138,389745.15,129306,519051.15
170710,201712,153,95,58,89015,54337,143352
170720,201712,84,68,16,63716,14992,78708
170730,201712,58,34,24,31858,22488,54346
170740,201712,76,57,19,53409,17803,71212
170755,201712,74,39,35,35934,32795,68729
170765,201712,145,70,75,64981,70275,135256
170770,201712,228,130,98,120732.45,91826,212558.45
170820,201712,589,385,204,360745,190727,551472
170825,201712,31,20,11,18740,10307,29047
170830,201712,74,53,21,49473.6,19677,69150.6
170900,201712,201,151,50,141487,46850,188337
170930,201712,804,416,388,389474,362994,752468
170950,201712,3014,1312,1702,1227030.88,1591289.59,2818320.47
170980,201712,17,9,8,8433,7496,15929
171050,201712,131,100,31,93700,29047,122747
171070,201712,37,30,7,28110,6559,34669
171090,201712,37,27,10,25299,9370,34669
171110,201712,21,14,7,13118,6559,19677
171150,201712,39,18,21,16866,19677,36543
171180,201712,22,10,12,9370,11244,20614
171190,201712,133,78,55,73086,51535,124621
171195,201712,62,48,14,44976,13118,58094
171200,201712,45,19,26,17803,24362,42165
171215,201712,2,2,0,1874,0,1874
171240,201712,54,44,10,41228,9370,50598
171245,201712,48,44,4,41228,3748,44976
171250,201712,69,36,33,33732,30911.63,64643.63
171270,201712,17,13,4,12181,3748,15929
171280,201712,38,35,3,32655,2811,35466
171320,201712,995,562,433,526594,404784,931378
171330,201712,421,201,220,188337,206140,394477
171360,201712,85,63,22,59031,20614,79645
171370,201712,24,13,11,12181,10307,22488
171380,201712,132,108,24,101196,22262.19,123458.19
171395,201712,55,33,22,30921,20614,51535
171420,201712,311,205,106,192085,99040.9,291125.9
171430,201712,63,50,13,46850,12181,59031
171488,201712,210,112,98,104944,91826,196770
171500,201712,59,32,27,29984,25299,55283
171510,201712,67,44,23,41228,21551,62779
171515,201712,43,36,7,33732,6559,40291
171525,201712,31,26,5,24362,4685,29047
171550,201712,13,7,6,6559,5622,12181
171570,201712,60,30,30,28110,28110,56220
171575,201712,345,208,137,194756,128359.63,323115.63
171610,201712,1691,838,853,783340.83,797701.62,1581042.45
171620,201712,131,89,42,82849.54,39354,122203.54
171630,201712,53,28,25,26236,23425,49661
171650,201712,274,178,96,166786,89952,256738
171660,201712,260,137,123,128369,115247,243616
171665,201712,46,30,16,28110,14992,43102
171670,201712,431,251,180,233538.13,168097.8,401635.93
171700,201712,64,56,8,52472,7496,59968
171720,201712,23,7,16,6559,14992,21551
171750,201712,102,55,47,51535,44039,95574
171780,201712,70,57,13,53409,12181,65590
171790,201712,79,65,14,60905,13118,74023
171800,201712,36,28,8,26236,7496,33732
171820,201712,2055,1163,892,1089034.47,831279.21,1920313.68
171830,201712,34,28,6,26236,5622,31858
171840,201712,61,34,27,31858,25299,57157
171845,201712,32,20,12,18740,11244,29984
171850,201712,38,26,12,24362,11244,35606
171855,201712,74,57,17,53409,15929,69338
171865,201712,8,7,1,6559,937,7496
171870,201712,30,22,8,20614,7496,28110
171875,201712,77,52,25,48724,23425,72149
171880,201712,26,19,7,17803,6559,24362
171884,201712,45,21,24,19677,22488,42165
171886,201712,114,40,74,37480,69056.9,106536.9
171888,201712,23,17,6,15929,5622,21551
171889,201712,19,15,4,14055,3748,17803
171890,201712,57,46,11,43102,10307,53409
171900,201712,42,29,13,27173,12181,39354
172000,201712,39,33,6,30921,5622,36543
172010,201712,39,32,7,29187.55,6559,35746.55
172015,201712,26,15,11,14055,10025.9,24080.9
172020,201712,128,79,49,74023,45913,119936
172025,201712,33,21,12,19677,11244,30921
172030,201712,35,20,15,18740,14055,32795
172049,201712,74,44,30,41228,28110,69338
172065,201712,149,97,52,90889,48724,139613
172080,201712,88,64,24,58807.02,22488,81295.02
172085,201712,26,13,13,12181,12181,24362
172090,201712,403,303,100,283911,92951,376862
172093,201712,26,18,8,16866,7496,24362
172097,201712,16,8,8,7496,7215,14711
172100,201712,4650,2612,2038,2441813.88,1907650,4349463.88
172110,201712,81,54,27,50598,25299,75897
172120,201712,1730,1482,248,1382626.2,231288.14,1613914.34
172125,201712,2,2,0,1874,0,1874
172130,201712,15,13,2,12181,1874,14055
172208,201712,193,123,70,115251,65590,180841
172210,201712,455,217,238,203329,222725,426054
210005,201712,2948,1839,1109,1719973.53,1036323,2756296.53
210010,201712,198,99,99,92763,92763,185526
210015,201712,28,19,9,17803,8433,26236
210020,201712,351,178,173,166786,162101,328887
210030,201712,339,212,127,198644,118990,317634
210040,201712,158,122,36,114314,33732,148046
210043,201712,252,168,84,157416,78708,236124
210047,201712,624,312,312,291969.2,292334.63,584303.83
210050,201712,295,214,81,200518,75897,276415
210055,201712,41,31,10,29047,9370,38417
210060,201712,571,440,131,412280,122747,535027
210070,201712,414,300,114,281100,106818,387918
210080,201712,106,98,8,91826,7496,99322
210083,201712,314,132,182,123684,170534,294218
210087,201712,49,34,15,31858,14055,45913
210090,201712,495,340,155,318580,145235,463815
210095,201712,500,355,145,332625.63,135865,468490.63
210100,201712,690,521,169,487849.05,157416.35,645265.40
210110,201712,149,79,70,74023,65590,139613
210120,201712,5536,4136,1400,3869289.6,1310569.04,5179858.64
210125,201712,217,121,96,113377,89952,203329
210130,201712,560,287,273,267982,255782.26,523764.26
210135,201712,35,21,14,19677,13118,32795
210140,201712,4232,3314,918,3102079.22,859932,3962011.22
210150,201712,356,223,133,208951,124621,333572
210160,201712,3365,2811,554,2631098.68,518817,3149915.68
210170,201712,1130,870,260,815190,243620,1058810
210173,201712,118,97,21,90889,19677,110566
210177,201712,475,229,246,214573,230502,445075
210180,201712,33,19,14,17803,13118,30921
210190,201712,408,257,151,240809,141487,382296
210193,201712,0,0,0,0,0,0
210197,201712,80,54,26,50598,24362,74960
210200,201712,649,510,139,477870,130243,608113
210203,201712,269,178,91,166786,85267,252053
210207,201712,379,292,87,273604,81519,355123
210210,201712,772,700,72,655900,67464,723364
210215,201712,77,64,13,59968,12181,72149
210220,201712,395,322,73,301714,68119.9,369833.9
210230,201712,303,223,80,208951,74960,283911
210232,201712,1501,940,561,880499,525657,1406156
210235,201712,154,117,37,109442,34669,144111
210237,201712,45,25,20,23425,18740,42165
210240,201712,94,77,17,72149,15929,88078
210250,201712,179,141,38,132117,35606,167723
210255,201712,327,236,91,221132,85267,306399
210260,201712,436,260,176,243620,164912,408532
210270,201712,702,443,259,415091,242683,657774
210275,201712,41,32,9,29984,8433,38417
210280,201712,1033,654,379,610033.45,353811.25,963844.70
210290,201712,503,320,183,299840,171471,471311
210300,201712,6164,3561,2603,3332102.94,2437727,5769829.94
210310,201712,102,69,33,64653,30921,95574
210312,201712,128,79,49,74023,45913,119936
210315,201712,117,84,33,78708,30921,109629
210317,201712,122,87,35,81519,32795,114314
210320,201712,2399,1964,435,1838588.98,406658,2245246.98
210325,201712,132,89,43,82456,40010,122466
210330,201712,5685,2843,2842,2659145.65,2662944.63,5322090.28
210340,201712,1419,1006,413,941836,386910.85,1328746.85
210350,201712,607,492,115,460769.75,107755,568524.75
210355,201712,132,104,28,97448,26236,123684
210360,201712,2687,1665,1022,1557014.36,957333,2514347.36
210370,201712,1279,533,746,499421,698346.1,1197767.1
210375,201712,194,101,93,94103,87141,181244
210380,201712,737,548,189,513476,177093,690569
210390,201712,200,162,38,151794,35606,187400
210400,201712,408,339,69,317643,64653,382296
210405,201712,998,656,342,614078.87,320454,934532.87
210407,201712,56,44,12,41228,11244,52472
210408,201712,65,58,7,54346,6559,60905
210409,201712,316,261,55,244557,51535,296092
210410,201712,435,337,98,315769,91817,407586
210420,201712,194,158,36,148046,33732,181778
210430,201712,34,26,8,24362,7496,31858
210440,201712,382,226,156,211762,146172,357934
210450,201712,143,106,37,99322,34669,133991
210455,201712,210,113,97,105881,90889,196770
210460,201712,347,214,133,200518,124621,325139
210462,201712,60,50,10,46850,9370,56220
210465,201712,178,126,52,118062,48724,166786
210467,201712,526,373,153,349501,143361,492862
210470,201712,47,35,12,32795,11244,44039
210480,201712,1299,905,394,847985,369178,1217163
210490,201712,226,134,92,125558,86204,211762
210500,201712,574,294,280,275478,262360,537838
210510,201712,555,427,128,400099,119936,520035
210515,201712,454,244,210,228628,196770,425398
210520,201712,404,349,55,326731.9,51535,378266.9
210530,201712,9400,5021,4379,4692216.21,4097394.72,8789610.93
210535,201712,135,95,40,89015,37480,126495
210540,201712,1541,919,622,859979.4,581408.5,1441387.9
210542,201712,1167,594,573,556203.2,536901,1093104.2
210545,201712,13,12,1,11244,937,12181
210547,201712,135,116,19,108692,17803,126495
210550,201712,757,522,235,486825.9,220195,707020.9
210560,201712,176,145,31,135865,29047,164912
210565,201712,30,21,9,19677,8433,28110
210570,201712,1367,1064,303,996968,283911,1280879
210580,201712,108,93,15,87141,14055,101196
210590,201712,776,604,172,565198.4,161164,726362.4
210592,201712,33,29,4,27173,3748,30921
210594,201712,101,84,17,78708,15929,94637
210596,201712,82,69,13,64653,12181,76834
210598,201712,125,91,34,85267,31858,117125
210600,201712,348,291,57,272667,53409,326076
210610,201712,245,228,17,212699,15929,228628
210620,201712,47,28,19,26236,17803,44039
210630,201712,61,57,4,53409,3748,57157
210632,201712,1140,740,400,693380,374033.4,1067413.4
210635,201712,15,12,3,11244,2811,14055
210637,201712,107,75,32,70275,29984,100259
210640,201712,589,509,80,476933,74960,551893
210650,201712,406,325,81,303616.11,74960,378576.11
210660,201712,405,286,119,267327,111382,378709
210663,201712,18,11,7,10307,6559,16866
210667,201712,118,37,81,34669,75897,110566
210670,201712,269,237,32,221367,29984,251351
210675,201712,567,292,275,273604,257675,531279
210680,201712,216,134,82,125558,76834,202392
210690,201712,646,502,144,470374,134928,605302
210700,201712,193,140,53,131180,49661,180841
210710,201712,308,170,138,158821.5,129306,288127.5
210720,201712,126,105,21,98385,19677,118062
210725,201712,65,57,8,53409,7496,60905
210730,201712,22,17,5,15929,4685,20614
210735,201712,418,276,142,258612,132773,391385
210740,201712,543,459,84,430083,78708,508791
210745,201712,150,106,44,99322,41228,140550
210750,201712,2419,1082,1337,1011914,1252750.26,2264664.26
210760,201712,279,201,78,188337,73071.95,261408.95
210770,201712,400,308,92,287659,85922.9,373581.9
210780,201712,421,303,118,283911,110566,394477
210790,201712,187,142,45,133054,42165,175219
210800,201712,134,101,33,94637,30921,125558
210805,201712,41,38,3,35606,2811,38417
210810,201712,488,368,120,344160.1,112440,456600.1
210820,201712,2318,1821,497,1698165.32,465689,2163854.32
210825,201712,173,89,84,83393,78708,162101
210830,201712,811,484,327,452571,305462,758033
210840,201712,219,144,75,134928,70275,205203
210845,201712,251,152,99,142424,92763,235187
210850,201712,876,557,319,521909,298903,820812
210860,201712,4181,2119,2062,1984284.9,1931794.16,3916079.06
210870,201712,470,350,120,327950,112440,440390
210880,201712,56,38,18,35606,16866,52472
210890,201712,343,279,64,261423,59968,321391
210900,201712,562,363,199,340131,186463,526594
210905,201712,76,35,41,32795,38417,71212
210910,201712,2006,1467,539,1373812.99,505043,1878855.99
210920,201712,231,66,165,61842,154605,216447
210923,201712,79,56,23,52472,21551,74023
210927,201712,443,178,265,166786,248305,415091
210930,201712,59,46,13,43102,12181,55283
210940,201712,94,70,24,65590,22488,88078
210945,201712,199,89,110,83393,103070,186463
210950,201712,504,358,146,335446,136797.32,472243.32
210955,201712,75,49,26,45913,24362,70275
210960,201712,2471,1015,1456,949462.7,1363991,2313453.7
210970,201712,114,97,17,90889,15929,106818
210975,201712,87,78,9,73086,8433,81519
210980,201712,1269,531,738,497434.56,691225,1188659.56
210990,201712,4445,2731,1714,2557584.26,1606018,4163602.26
211000,201712,1393,1090,303,1021049,283630,1304679
211003,201712,916,625,291,585625,272658,858283
211010,201712,469,410,59,384170,55283,439453
211020,201712,1614,570,1044,534090,978012.49,1512102.49
211023,201712,26,22,4,20332.9,3748,24080.9
211027,201712,63,39,24,36543,22488,59031
211030,201712,386,254,132,237998,123684,361682
211040,201712,318,237,81,221788,75897,297685
211050,201712,1196,742,454,695254,425112.32,1120366.32
211060,201712,689,582,107,544115.9,100259,644374.9
211065,201712,24,20,4,18740,3748,22488
211070,201712,916,739,177,690860.97,165849,856709.97
211080,201712,91,86,5,80582,4685,85267
211085,201712,59,31,28,28766,26236,55002
211090,201712,94,76,18,71212,16866,88078
211100,201712,502,400,102,374800,95574,470374
211102,201712,268,174,94,163038,88078,251116
211105,201712,211,142,69,133054,64653,197707
211107,201712,135,76,59,71212,55283,126495
211110,201712,820,530,290,496048,271721,767769
211120,201712,5883,2436,3447,2277360.87,3228767.32,5506128.19
211125,201712,32,25,7,23425,6559,29984
211130,201712,46364,18937,27427,17711626.99,25686825.63,43398452.62
211140,201712,433,363,70,339015.11,65590,404605.11
211150,201712,1263,788,475,738028.05,444790,1182818.05
211153,201712,171,98,73,91826,68401,160227
211157,201712,58,42,16,39354,14992,54346
211160,201712,715,589,126,550944.25,118062,669006.25
211163,201712,0,0,0,0,0,0
211167,201712,5,3,2,2811,1874,4685
211170,201712,449,308,141,288596,132117,420713
211172,201712,123,84,39,78708,36543,115251
211174,201712,287,164,123,153668,115251,268919
211176,201712,528,373,155,349501,145235,494736
211178,201712,98,62,36,58094,33732,91826
211180,201712,209,161,48,150857,44816.71,195673.71
211190,201712,62,57,5,53409,4685,58094
211195,201712,25,16,9,14992,8433,23425
211200,201712,157,134,23,125220.68,21551,146771.68
211210,201712,555,325,230,303869.1,215510,519379.1
211220,201712,3973,2223,1750,2075269.29,1632592.42,3707861.71
211223,201712,97,90,7,84151.97,6559,90710.97
211227,201712,70,48,22,44976,20614,65590
211230,201712,784,631,153,591106.45,143342.26,734448.71
211240,201712,424,315,109,295155,102133,397288
211245,201712,213,91,122,85267,114314,199581
211250,201712,1654,1403,251,1313355.35,235187,1548542.35
211260,201712,801,630,171,590310,160227,750537
211270,201712,2106,1631,475,1528247,444138.1,1972385.1
211280,201712,1826,1084,742,1013835.08,695254,1709089.08
211285,201712,213,121,92,113377,86204,199581
211290,201712,698,462,236,432706.6,221132,653838.6
211300,201712,815,617,198,577856.7,185526,763382.7
211400,201712,1625,900,725,843300,679325,1522625
220005,201712,19,18,1,16866,937,17803
220010,201712,90,68,22,63716,20332.9,84048.9
220020,201712,583,455,128,425741.6,119936,545677.6
220025,201712,108,104,4,97448,3748,101196
220027,201712,39,32,7,29984,6559,36543
220030,201712,94,76,18,71212,16866,88078
220040,201712,1105,818,287,765229.28,268919,1034148.28
220045,201712,40,29,11,27173,10307,37480
220050,201712,647,524,123,489846.88,115232.26,605079.14
220060,201712,172,146,26,136802,24362,161164
220070,201712,94,85,9,79645,8433,88078
220080,201712,9,8,1,7496,937,8433
220090,201712,33,27,6,25018,5622,30640
220095,201712,2,1,1,937,937,1874
220100,201712,28,24,4,22488,3748,26236
220105,201712,41,38,3,35606,2811,38417
220110,201712,209,192,17,179622.9,15929,195551.9
220115,201712,45,42,3,39354,2811,42165
220117,201712,19,18,1,16866,937,17803
220120,201712,1534,1050,484,983232.51,453489.26,1436721.77
220130,201712,24,23,1,21551,937,22488
220140,201712,98,77,21,71212,19677,90889
220150,201712,448,316,132,296092,123684,419776
220155,201712,4,4,0,3748,0,3748
220157,201712,15,12,3,11244,2811,14055
220160,201712,73,64,9,59968,8433,68401
220170,201712,33,31,2,29047,1874,30921
220173,201712,8,8,0,7496,0,7496
220177,201712,5,5,0,4685,0,4685
220180,201712,65,65,0,60900.32,0,60900.32
220190,201712,1057,942,115,882654,107005.4,989659.4
220191,201712,42,37,5,34669,4685,39354
220192,201712,60,57,3,53409,2811,56220
220194,201712,28,24,4,22488,3748,26236
220196,201712,103,85,18,79505,16866,96371
220198,201712,6,4,2,3748,1874,5622
220200,201712,434,351,83,329608,77771,407379
220202,201712,39,35,4,32795,3748,36543
220205,201712,39,34,5,31858,4685,36543
220207,201712,20,19,1,17803,937,18740
220208,201712,84,43,41,40291,38417,78708
220209,201712,32,29,3,27173,2811,29984
220210,201712,15,14,1,13118,937,14055
220211,201712,37,37,0,34669,0,34669
220213,201712,42,38,4,35606,3467,39073
220217,201712,38,30,8,28110,7496,35606
220220,201712,1986,1259,727,1176142.04,679822.76,1855964.80
220225,201712,15,7,8,6559,7496,14055
220230,201712,929,741,188,693876.61,175528.21,869404.82
220240,201712,143,130,13,121810,12181,133991
220245,201712,38,34,4,30886.6,3748,34634.6
220250,201712,106,94,12,88078,11244,99322
220253,201712,45,37,8,34669,7496,42165
220255,201712,30,25,5,23425,4685,28110
220260,201712,690,501,189,469437,177093,646530
220265,201712,14,10,4,9370,3748,13118
220270,201712,657,583,74,545558.88,68869.5,614428.38
220271,201712,47,39,8,36543,7496,44039
220272,201712,26,25,1,23425,937,24362
220273,201712,15,13,2,12181,1874,14055
220275,201712,51,40,11,37480,10307,47787
220277,201712,11,9,2,8433,1874,10307
220280,201712,12,10,2,9370,1874,11244
220285,201712,44,41,3,38417,2811,41228
220290,201712,1380,1176,204,1099430,191102,1290532
220300,201712,55,53,2,49661,1874,51535
220310,201712,308,261,47,244553,44030,288583
220320,201712,430,396,34,369647.5,31858,401505.5
220323,201712,0,0,0,0,0,0
220325,201712,14,9,5,8433,4685,13118
220327,201712,12,11,1,10307,937,11244
220330,201712,201,134,67,125276.9,62779,188055.9
220335,201712,138,121,17,113377,15929,129306
220340,201712,22,12,10,11244,9370,20614
220342,201712,56,47,9,44039,8433,52472
220345,201712,81,74,7,69338,6559,75897
220350,201712,431,380,51,353484.01,47787,401271.01
220360,201712,42,31,11,29047,10307,39354
220370,201712,1090,863,227,807694,212417.9,1020111.9
220375,201712,29,27,2,25299,1874,27173
220380,201712,32,25,7,23425,6559,29984
220385,201712,28,24,4,22488,3748,26236
220390,201712,2226,1267,959,1182569.2,897225.25,2079794.45
220400,201712,27,25,2,23425,1874,25299
220410,201712,14,13,1,12181,937,13118
220415,201712,12,11,1,10307,937,11244
220420,201712,124,103,21,96511,19395.9,115906.9
220430,201712,132,119,13,109864.4,12181,122045.4
220435,201712,23,17,6,15925,5622,21547
220440,201712,287,244,43,228628,40291,268919
220450,201712,322,167,155,155334.74,145235,300569.74
220455,201712,52,50,2,46850,1874,48724
220460,201712,18,18,0,16210.1,0,16210.1
220465,201712,109,69,40,64653,37480,102133
220470,201712,239,209,30,195833,28110,223943
220480,201712,71,60,11,56220,10307,66527
220490,201712,86,75,11,69518,10307,79825
220500,201712,97,84,13,78708,12181,90889
220510,201712,380,301,79,281288,73835.6,355123.6
220515,201712,21,17,4,15929,3748,19677
220520,201712,367,329,38,306739,35588,342327
220525,201712,25,17,8,15929,7496,23425
220527,201712,37,29,8,27173,6700,33873
220530,201712,31,12,19,11244,17803,29047
220535,201712,15,14,1,13118,937,14055
220540,201712,61,48,13,44976,12181,57157
220545,201712,63,40,23,37480,21551,59031
220550,201712,630,476,154,445262.4,144298,589560.4
220551,201712,27,20,7,18740,6559,25299
220552,201712,8,8,0,7496,0,7496
220553,201712,47,43,4,40291,3748,44039
220554,201712,13,8,5,7214.9,4685,11899.9
220555,201712,22,18,4,16866,3748,20614
220556,201712,57,53,4,49661,3748,53409
220557,201712,56,50,6,46850,5622,52472
220558,201712,7,2,5,1874,4685,6559
220559,201712,6,5,1,4685,937,5622
220560,201712,54,35,19,32607.6,17803,50410.6
220570,201712,789,464,325,433304.5,304525,737829.5
220580,201712,570,522,48,489114,44302.26,533416.26
220585,201712,6,5,1,4685,937,5622
220590,201712,14,14,0,13118,0,13118
220595,201712,59,44,15,41228,14055,55283
220600,201712,18,9,9,8433,8433,16866
220605,201712,22,21,1,19677,937,20614
220610,201712,59,50,9,46850,8433,55283
220620,201712,557,435,122,407360.75,114314,521674.75
220630,201712,7,5,2,4685,1874,6559
220635,201712,37,33,4,30921,3748,34669
220640,201712,100,77,23,72149,21551,93700
220650,201712,113,107,6,100259,5622,105881
220660,201712,26,21,5,19677,4685,24362
220665,201712,4,4,0,3748,0,3748
220667,201712,11,11,0,10307,0,10307
220669,201712,22,19,3,17803,2811,20614
220670,201712,69,53,16,49473.6,14992,64465.6
220672,201712,58,39,19,36543,17803,54346
220675,201712,34,26,8,24362,7496,31858
220680,201712,34,29,5,27173,4685,31858
220690,201712,49,46,3,43102,2811,45913
220695,201712,63,30,33,28110,30921,59031
220700,201712,1503,1150,353,1075741.59,330761,1406502.59
220710,201712,3,1,2,937,1874,2811
220720,201712,116,94,22,87843.75,20473.45,108317.20
220730,201712,19,18,1,16866,937,17803
220735,201712,3,1,2,937,1874,2811
220740,201712,41,38,3,35606,2811,38417
220750,201712,99,80,19,74960,17803,92763
220755,201712,14,14,0,13118,0,13118
220760,201712,51,48,3,44976,2811,47787
220770,201712,5735,2855,2880,2670018.52,2692813.13,5362831.65
220775,201712,31,16,15,14992,14055,29047
220777,201712,15,14,1,13118,937,14055
220779,201712,18,14,4,13118,3748,16866
220780,201712,875,745,130,697409.1,121529,818938.1
220785,201712,10,6,4,5622,3748,9370
220790,201712,1004,796,208,743494,194896,938390
220793,201712,14,14,0,13118,0,13118
220795,201712,23,22,1,20614,937,21551
220800,201712,3859,2936,923,2749418.1,863892.06,3613310.16
220810,201712,55,50,5,46850,4685,51535
220820,201712,237,215,22,201455,20614,222069
220830,201712,1148,973,175,911696.32,163957,1075653.32
220840,201712,2411,1589,822,1476482.1,768153,2244635.1
220850,201712,52,41,11,38417,10307,48724
220855,201712,14,9,5,8433,4685,13118
220860,201712,8,7,1,6559,937,7496
220865,201712,21,19,2,17803,1874,19677
220870,201712,57,54,3,50598,2811,53409
220880,201712,329,250,79,233594.1,73742,307336.1
220885,201712,44,38,6,35606,5622,41228
220887,201712,19,18,1,16866,937,17803
220890,201712,103,91,12,85267,11244,96511
220900,201712,46,26,20,24362,18740,43102
220910,201712,54,45,9,42165,8433,50598
220915,201712,10,9,1,8433,937,9370
220920,201712,37,33,4,30921,3748,34669
220930,201712,43,42,1,39354,937,40291
220935,201712,19,18,1,16866,937,17803
220937,201712,45,42,3,39354,2811,42165
220940,201712,48,44,4,41228,3748,44976
220945,201712,0,0,0,0,0,0
220950,201712,46,42,4,39354,3748,43102
220955,201712,34,31,3,29047,2811,31858
220960,201712,1,1,0,937,0,937
220965,201712,28,24,4,22488,3748,26236
220970,201712,47,39,8,36543,7496,44039
220975,201712,9,8,1,7496,937,8433
220980,201712,34,32,2,29984,1874,31858
220985,201712,63,56,7,52472,6559,59031
220987,201712,30,29,1,27173,937,28110
220990,201712,12,11,1,10307,937,11244
220995,201712,42,35,7,32795,6559,39354
220997,201712,38,31,7,29047,6559,35606
221000,201712,1101,992,109,925508.77,101851.9,1027360.67
221005,201712,68,62,6,58094,5622,63716
221010,201712,14,12,2,11244,1874,13118
221020,201712,48,46,2,43102,1874,44976
221030,201712,32,26,6,24362,5622,29984
221035,201712,20,19,1,17803,937,18740
221037,201712,12,6,6,5622,5622,11244
221038,201712,23,21,2,19677,1874,21551
221039,201712,23,23,0,21551,0,21551
221040,201712,251,215,36,201455,33732,235187
221050,201712,233,196,37,183652,34669,218321
221060,201712,1683,1476,207,1381523.76,193959,1575482.76
221062,201712,29,28,1,26236,937,27173
221063,201712,13,9,4,8433,3748,12181
221065,201712,47,40,7,37480,6559,44039
221070,201712,145,125,20,117125,18740,135865
221080,201712,374,329,45,308273,41883.9,350156.9
221090,201712,38,37,1,34669,937,35606
221093,201712,63,43,20,40291,18740,59031
221095,201712,11,10,1,9370,937,10307
221097,201712,23,20,3,18740,2811,21551
221100,201712,24357,13948,10409,13048237.7,9748321.31,22796559.01
221110,201712,1018,743,275,695910,257675,953585
221120,201712,517,385,132,360464,123684,484148
221130,201712,918,747,171,698721.9,159572,858293.9
221135,201712,35,32,3,29984,2811,32795
221140,201712,38,30,8,28110,7496,35606
221150,201712,15,12,3,11244,2811,14055
221160,201712,10,10,0,9370,0,9370
221170,201712,13,13,0,12181,0,12181
230010,201712,158,147,11,137739,10307,148046
230015,201712,116,95,21,89015,19677,108692
230020,201712,1511,1291,220,1207138,205266.73,1412404.73
230030,201712,1601,1148,453,1070206.62,424461,1494667.62
230040,201712,197,173,24,161164,22488,183652
230050,201712,205,150,55,140550,51535,192085
230060,201712,146,120,26,111690.4,24362,136052.4
230070,201712,285,253,32,237061,29984,267045
230075,201712,792,693,99,647375,92481.9,739856.9
230080,201712,175,152,23,142424,21551,163975
230090,201712,89,60,29,55470.4,27173,82643.4
230100,201712,1933,1155,778,1079989,728986,1808975
230110,201712,2632,1681,951,1571518.6,890524.9,2462043.5
230120,201712,930,736,194,687289.91,181760,869049.91
230125,201712,137,111,26,104007,24362,128369
230130,201712,455,407,48,381359,44976,426335
230140,201712,205,177,28,165849,26236,192085
230150,201712,153,120,33,112440,30921,143361
230160,201712,901,785,116,734842.5,108692,843534.5
230170,201712,578,531,47,494457.75,44039,538496.75
230180,201712,79,74,5,69338,4685,74023
230185,201712,398,342,56,319113.16,52472,371585.16
230190,201712,2163,1742,421,1628064.9,394165,2022229.9
230195,201712,484,422,62,395414,58094,453508
230200,201712,363,316,47,295145.63,44039,339184.63
230205,201712,346,217,129,201590.86,120873,322463.86
230210,201712,1247,995,252,931011.76,235374.4,1166386.16
230220,201712,1370,959,411,897833.4,385107,1282940.4
230230,201712,895,788,107,736732.85,100259,836991.85
230240,201712,1620,1392,228,1302650.85,213636,1516286.85
230250,201712,1741,1429,312,1335033.86,292063,1627096.86
230260,201712,2899,1726,1173,1612162.56,1098146.01,2710308.57
230270,201712,1330,1074,256,1003785.73,238701.25,1242486.98
230280,201712,2671,1985,686,1854606.97,641975.43,2496582.40
230290,201712,398,359,39,329419.09,36543,365962.09
230300,201712,506,374,132,349201.16,123684,472885.16
230310,201712,421,313,108,293135.77,100915,394050.77
230320,201712,896,770,126,716922.47,118062,834984.47
230330,201712,297,239,58,223193.4,54159,277352.4
230340,201712,448,359,89,335447,83393,418840
230350,201712,3009,1892,1117,1772785.26,1043819.24,2816604.50
230360,201712,249,217,32,202435,29984,232419
230365,201712,136,108,28,100494,26236,126730
230370,201712,9589,4672,4917,4369426.45,4603411.91,8972838.36
230380,201712,457,394,63,368897,58094.8,426991.8
230390,201712,499,274,225,254967.07,210825,465792.07
230393,201712,269,224,45,209048.4,42165,251213.4
230395,201712,329,268,61,250873,57157,308030
230400,201712,599,475,124,443201,115700.76,558901.76
230410,201712,2578,1604,974,1497420.37,912357,2409777.37
230420,201712,5838,3795,2043,3537775.29,1909791.9,5447567.19
230423,201712,304,263,41,246431,38417,284848
230425,201712,337,281,56,263297,52472,315769
230426,201712,106,96,10,89239.88,9088.9,98328.78
230427,201712,78,75,3,70275,2811,73086
230428,201712,1339,693,646,649116.12,605302,1254418.12
230430,201712,436,351,85,328696,79645,408341
230435,201712,778,543,235,507275.85,218977.17,726253.02
230440,201712,82768,36418,46350,34038691.18,43388903.25,77427594.43
230445,201712,263,179,84,167535.6,78708,246243.6
230450,201712,539,436,103,408532,96511,505043
230460,201712,57,47,10,44039,9370,53409
230465,201712,292,236,56,221132,52472,273604
230470,201712,1817,1410,407,1321170,380271.59,1701441.59
230480,201712,145,140,5,130898.9,4685,135583.9
230490,201712,280,227,53,212699,49661,262360
230495,201712,432,326,106,304625,99322,403947
230500,201712,936,707,229,660585,214564,875149
230510,201712,44,36,8,33732,7496,41228
230520,201712,386,304,82,284848,76834,361682
230523,201712,1951,1233,718,1153864.4,672326,1826190.4
230526,201712,291,242,49,226754,45136,271890
230530,201712,659,496,163,461793.38,151794.6,613587.98
230533,201712,179,172,7,161164,6559,167723
230535,201712,340,255,85,238935,79645,318580
230540,201712,1826,1598,228,1494727.7,212933.9,1707661.6
230550,201712,3610,2311,1299,2157324.43,1215570.1,3372894.53
230560,201712,575,439,136,409282.4,126495,535777.4
230565,201712,187,136,51,127432,47787,175219
230570,201712,302,268,34,251116,31858,282974
230580,201712,1093,805,288,752851.39,268637.9,1021489.29
230590,201712,938,728,210,677968.05,196301.5,874269.55
230600,201712,250,228,22,212905.32,20614,233519.32
230610,201712,328,264,64,247181,59968,307149
230620,201712,163,134,29,124621,27173,151794
230625,201712,708,513,195,479604.25,181582.04,661186.29
230630,201712,1223,968,255,907016,238560.2,1145576.2
230640,201712,3410,2945,465,2752360.31,434960.09,3187320.40
230650,201712,391,342,49,319637.49,45913,365550.49
230655,201712,619,537,82,502232.4,76754.85,578987.25
230660,201712,332,276,56,258612,52190.9,310802.9
230670,201712,418,374,44,350438,41228,391666
230680,201712,199,183,16,171471,14992,186463
230690,201712,850,740,110,693380,103070,796450
230700,201712,695,590,105,552811.26,97822.8,650634.06
230710,201712,731,689,42,645406,39354,684760
230720,201712,142,120,22,112055.83,20614,132669.83
230725,201712,225,178,47,166786,44030,210816
230730,201712,11577,6272,5305,5861601.5,4962849.53,10824451.03
230740,201712,653,521,132,487896,123005.63,610901.63
230750,201712,796,679,117,635052.15,109629,744681.15
230760,201712,1286,1114,172,1039844.59,161164,1201008.59
230763,201712,323,266,57,247321.99,53409,300730.99
230765,201712,6740,3146,3594,2941724.25,3365611.1,6307335.35
230770,201712,4962,2544,2418,2374053.76,2263005.14,4637058.90
230780,201712,674,592,82,551620.47,76819.95,628440.42
230790,201712,187,151,36,141487,32945.66,174432.66
230800,201712,1102,806,296,755198.58,277352,1032550.58
230810,201712,1263,1124,139,1052204.15,130055.6,1182259.75
230820,201712,322,232,90,216448,84330,300778
230830,201712,931,806,125,751771.02,117125,868896.02
230835,201712,276,237,39,221132,35841,256973
230837,201712,163,137,26,128369,24362,152731
230840,201712,885,706,179,660304.5,166505,826809.5
230850,201712,1466,1280,186,1199078.9,174001,1373079.9
230860,201712,305,227,78,212699,72149.25,284848.25
230870,201712,1786,1515,271,1418337,252615.4,1670952.4
230880,201712,30,22,8,20614,7496,28110
230890,201712,565,519,46,486182.98,43088,529270.98
230900,201712,268,204,64,191148,59775,250923
230910,201712,195,159,36,148233.4,33732,181965.4
230920,201712,396,313,83,293281,77771,371052
230930,201712,913,644,269,600617.92,252053,852670.92
230940,201712,823,660,163,618420,152544,770964
230945,201712,453,380,73,355873,68401,424274
230950,201712,380,323,57,302651,53409,356060
230960,201712,2465,1669,796,1557244.51,745571,2302815.51
230970,201712,1720,978,742,915490.45,694391.96,1609882.41
230980,201712,210,179,31,167723,29047,196770
230990,201712,140,112,28,104944,25492.95,130436.95
231000,201712,205,186,19,172408,17803,190211
231010,201712,132,104,28,96885.8,26236,123121.8
231020,201712,1251,872,379,815471.5,355123,1170594.5
231025,201712,935,700,235,653773.6,218677.9,872451.5
231030,201712,1139,958,181,897642,169316,1066958
231040,201712,136,93,43,86410.14,39573,125983.14
231050,201712,986,877,109,820016.45,102133,922149.45
231060,201712,139,122,17,114314,15929,130243
231070,201712,1402,993,409,929317.15,383233,1312550.15
231080,201712,262,245,17,228768.55,15929,244697.55
231085,201712,535,335,200,312959,187400,500359
231090,201712,234,195,39,182715,36543,219258
231095,201712,164,130,34,121810,31858,153668
231100,201712,122,102,20,95574,17521.9,113095.9
231110,201712,338,293,45,273845,42165,316010
231120,201712,299,257,42,239867.88,39167,279034.88
231123,201712,133,127,6,118999,5622,124621
231126,201712,274,237,37,222069,34669,256738
231130,201712,4537,3530,1007,3299099.34,942519.03,4241618.37
231135,201712,200,174,26,163038,23120.2,186158.2
231140,201712,3023,2229,794,2084970.31,743003.52,2827973.83
231150,201712,349,334,15,312958,14055,327013
231160,201712,1202,939,263,876845.35,246206.12,1123051.47
231170,201712,536,349,187,327013,175219,502232
231180,201712,1582,1336,246,1251082.4,230502,1481584.4
231190,201712,200,178,22,166786,20614,187400
231195,201712,209,180,29,167948.91,27173,195121.91
231200,201712,824,679,145,636223,134627,770850
231210,201712,601,500,101,467563.9,94637,562200.9
231220,201712,1015,736,279,688677.26,261423,950100.26
231230,201712,1372,1101,271,1030457.7,253177.4,1283635.1
231240,201712,1347,974,373,912356.9,348283.1,1260640.0
231250,201712,109,102,7,95574,6559,102133
231260,201712,292,189,103,177093,96230,273323
231270,201712,985,825,160,767889.04,149920,917809.04
231280,201712,52,40,12,37480,11244,48724
231290,201712,7147,3954,3193,3696149.48,2989256.41,6685405.89
231300,201712,623,575,48,538775,44976,583751
231310,201712,697,646,51,604107,47787,651894
231320,201712,556,432,124,404317,116188,520505
231325,201712,85,75,10,70275,9370,79645
231330,201712,1990,1545,445,1441667.19,414062.3,1855729.49
231335,201712,246,219,27,205203,25299,230502
231340,201712,1574,1152,422,1077738.24,395414,1473152.24
231350,201712,1129,923,206,864851,192460,1057311
231355,201712,389,337,52,315769,48724,364493
231360,201712,463,369,94,343091.1,88078,431169.1
231370,201712,89,72,17,67464,15929,83393
231375,201712,284,206,78,193022,73086,266108
231380,201712,437,355,82,331068.36,76646.6,407714.96
231390,201712,194,159,35,148983,32795,181778
231395,201712,719,438,281,409131.68,263015.9,672147.58
231400,201712,1039,860,179,803293.55,167385.9,970679.45
231410,201712,1282,1032,250,962441.7,233314,1195755.7
240010,201712,388,181,207,168465.54,193950,362415.54
240020,201712,2173,1685,488,1577006.07,457252,2034258.07
240030,201712,144,123,21,115251,19677,134928
240040,201712,33,33,0,30921,0,30921
240050,201712,498,427,71,399260.66,66527,465787.66
240060,201712,67,63,4,59031,3748,62779
240070,201712,170,130,40,121810,37480,159290
240080,201712,417,274,143,256734,133991,390725
240090,201712,103,91,12,84967.16,11244,96211.16
240100,201712,1429,1346,83,1258282.18,77583.6,1335865.78
240110,201712,964,607,357,567101.28,334509,901610.28
240120,201712,142,119,23,111503,21551,133054
240130,201712,285,267,18,250174.32,16866,267040.32
240140,201712,80,63,17,59031,15929,74960
240145,201712,671,590,81,552314.65,75690.86,628005.51
240150,201712,20,15,5,14055,4670.95,18725.95
240160,201712,45,38,7,35606,6559,42165
240165,201712,32,26,6,24128,5622,29750
240170,201712,91,71,20,66527,18740,85267
240180,201712,77,63,14,59031,13118,72149
240185,201712,44,40,4,37470.63,3748,41218.63
240190,201712,14,12,2,11244,1874,13118
240200,201712,2969,1672,1297,1560603.45,1214072,2774675.45
240210,201712,162,128,34,119936,31858,151794
240220,201712,1112,795,317,744568,297019.63,1041587.63
240230,201712,815,754,61,703714.68,56520,760234.68
240240,201712,118,86,32,80582,29984,110566
240250,201712,91,80,11,74960,10307,85267
240260,201712,1785,1325,460,1240850.36,430054.89,1670905.25
240270,201712,191,169,22,157978.2,20614,178592.2
240280,201712,43,33,10,30921,9370,40291
240290,201712,51,49,2,45913,1874,47787
240300,201712,179,99,80,92763,74960,167723
240310,201712,1967,1075,892,998567.26,832627.06,1831194.32
240320,201712,209,198,11,185526,10307,195833
240325,201712,4281,2617,1664,2445241.53,1557037.41,4002278.94
240330,201712,64,61,3,57157,2811,59968
240340,201712,101,73,28,68401,26236,94637
240350,201712,92,81,11,75897,10307,86204
240360,201712,371,267,104,249901,97448,347349
240370,201712,36,34,2,31858,1874,33732
240375,201712,74,44,30,41228,28110,69338
240380,201712,238,193,45,179944,42072,222016
240390,201712,16,13,3,12181,2811,14992
240400,201712,77,74,3,69338,2811,72149
240410,201712,10,6,4,5622,3748,9370
240420,201712,874,677,197,632223.88,184326.64,816550.52
240430,201712,262,247,15,229690,14055,243745
240440,201712,69,36,33,33732,30921,64653
240450,201712,203,135,68,125713.9,63716,189429.9
240460,201712,59,46,13,43102,12181,55283
240470,201712,234,203,31,189663.79,29047,218710.79
240480,201712,14,14,0,13024.3,0,13024.3
240485,201712,71,61,10,56876,9370,66246
240490,201712,45,45,0,41958.86,0,41958.86
240500,201712,83,66,17,61842,15929,77771
240510,201712,50,35,15,32795,14055,46850
240520,201712,125,119,6,111503,5622,117125
240530,201712,50,45,5,42165,4685,46850
240540,201712,78,67,11,62779,10307,73086
240550,201712,15,13,2,12181,1874,14055
240560,201712,367,271,96,253311.4,89952,343263.4
240570,201712,460,285,175,265920.6,163975,429895.6
240580,201712,1259,1017,242,947542.95,225616.6,1173159.55
240590,201712,31,28,3,26236,2811,29047
240600,201712,112,112,0,104944,0,104944
240610,201712,517,431,86,403496.95,79833,483329.95
240615,201712,29,28,1,26236,937,27173
240620,201712,95,91,4,84330,3748,88078
240630,201712,33,32,1,29984,937,30921
240640,201712,27,23,4,21551,3748,25299
240650,201712,231,195,36,181872.45,33732,215604.45
240660,201712,96,84,12,78708,11244,89952
240670,201712,285,168,117,155355.15,109629,264984.15
240680,201712,48,37,11,34669,10307,44976
240690,201712,50,47,3,44039,2811,46850
240700,201712,191,158,33,148046,30921,178967
240710,201712,1894,1205,689,1128664.3,644759.07,1773423.37
240720,201712,1027,752,275,703678.23,257675,961353.23
240725,201712,67,64,3,59968,2811,62779
240730,201712,131,116,15,108692,14055,122747
240740,201712,240,203,37,188871.09,33451.81,222322.90
240750,201712,34,21,13,19677,12181,31858
240760,201712,31,27,4,25299,3748,29047
240770,201712,147,112,35,104944,32795,137739
240780,201712,698,581,117,542701.03,109629,652330.03
240790,201712,38,36,2,33732,1874,35606
240800,201712,8489,5744,2745,5344519.91,2564983.6,7909503.51
240810,201712,19886,10902,8984,10174284.48,8407731.08,18582015.56
240820,201712,192,124,68,115526.22,63716,179242.22
240830,201712,1588,1304,284,1215439.48,265172,1480611.48
240840,201712,79,69,10,64653,9370,74023
240850,201712,85,74,11,69338,10307,79645
240860,201712,113,110,3,103070,2811,105881
240870,201712,55,48,7,44976,6559,51535
240880,201712,28,26,2,24352.63,1874,26226.63
240890,201712,1143,673,470,626762.29,440386,1067148.29
240895,201712,42,32,10,29984,9370,39354
240910,201712,151,136,15,127432,14055,141487
240920,201712,15,11,4,10307,3748,14055
240930,201712,372,336,36,313895,33732,347627
240933,201712,27,19,8,17803,7496,25299
240940,201712,2413,2132,281,1985476.48,260467.26,2245943.74
240950,201712,49,47,2,44039,1874,45913
240960,201712,33,25,8,23425,7496,30921
240970,201712,133,96,37,89952,33932,123884
240980,201712,189,150,39,140550,36543,177093
240990,201712,122,82,40,76834,37480,114314
241000,201712,78,70,8,65590,7496,73086
241010,201712,56,45,11,42165,10307,52472
241020,201712,112,105,7,98385,6559,104944
241025,201712,9,3,6,2811,5622,8433
241030,201712,120,98,22,91826,20614,112440
241040,201712,31,27,4,25299,3748,29047
241050,201712,92,78,14,73086,13118,86204
241060,201712,29,26,3,24362,2811,27173
241070,201712,16,16,0,14992,0,14992
241080,201712,65,57,8,53127.9,7496,60623.9
241090,201712,48,40,8,37480,7481.95,44961.95
241100,201712,75,66,9,61842,8433,70275
241105,201712,7,3,4,2811,3748,6559
241110,201712,49,47,2,44039,1874,45913
241120,201712,1418,1096,322,1024020.4,300851.96,1324872.36
241140,201712,225,183,42,170535,39354,209889
241142,201712,42,41,1,38417,937,39354
241150,201712,1208,1060,148,990550.5,138676,1129226.5
241160,201712,24,23,1,21551,937,22488
241170,201712,42,39,3,36543,2811,39354
241180,201712,52,42,10,39182.53,9370,48552.53
241190,201712,40,39,1,36543,937,37480
241200,201712,3808,2095,1713,1958336.61,1603194.74,3561531.35
241210,201712,72,60,12,56220,10401,66621
241220,201712,1364,905,459,847468.7,430050.26,1277518.96
241230,201712,240,203,37,190023.6,34669,224692.6
241240,201712,52,40,12,37480,11244,48724
241250,201712,1071,996,75,932971,69994,1002965
241255,201712,46,37,9,34669,8433,43102
241260,201712,628,493,135,461936.32,126495,588431.32
241270,201712,45,31,14,29047,13118,42165
241280,201712,98,86,12,80582,11244,91826
241290,201712,108,80,28,74960,26236,101196
241300,201712,78,55,23,51535,21551,73086
241310,201712,52,39,13,36403,12181,48584
241320,201712,26,14,12,13118,11244,24362
241330,201712,60,54,6,50598,5622,56220
241335,201712,61,54,7,50035.8,6559,56594.8
241340,201712,186,141,45,132117,42165,174282
241350,201712,57,52,5,48724,4685,53409
241355,201712,42,39,3,36543,2811,39354
241360,201712,46,46,0,43102,0,43102
241370,201712,45,37,8,34547.19,7496,42043.19
241380,201712,41,39,2,36543,1874,38417
241390,201712,77,62,15,57906.6,14055,71961.6
241400,201712,191,158,33,147390.1,30921,178311.1
241410,201712,179,163,16,152731,14899,167630
241415,201712,91,72,19,67464,17803,85267
241420,201712,94,73,21,68401,19677,88078
241430,201712,28,27,1,25299,937,26236
241440,201712,452,385,67,360731,62779,423510
241445,201712,35,33,2,30921,1874,32795
241450,201712,275,225,50,210701,46850,257551
241460,201712,136,124,12,115954,11244,127198
241470,201712,45,37,8,34669,7496,42165
241475,201712,64,60,4,56220,3748,59968
241480,201712,95,68,27,63716,25299,89015
241490,201712,9,8,1,7496,937,8433
241500,201712,47,35,12,32795,11244,44039
250010,201712,102,89,13,83144.26,12181,95325.26
250020,201712,24,21,3,19677,2811,22488
250030,201712,807,594,213,555257.1,198551.3,753808.4
250040,201712,320,268,52,251116,48724,299840
250050,201712,227,188,39,175589.8,36543,212132.8
250053,201712,53,41,12,38417,11244,49661
250057,201712,0,0,0,0,0,0
250060,201712,447,342,105,320454,98103.9,418557.9
250070,201712,685,581,104,542417,97448,639865
250073,201712,7,7,0,6559,0,6559
250077,201712,205,152,53,142039.83,49661,191700.83
250080,201712,420,328,92,305744.1,86204,391948.1
250090,201712,205,135,70,125559,64734.26,190293.26
250100,201712,465,380,85,356060,79271,435331
250110,201712,484,368,116,343063.81,108692,451755.81
250115,201712,27,8,19,7496,17803,25299
250120,201712,108,82,26,76834,24362,101196
250130,201712,587,463,124,433831,116001,549832
250135,201712,14,8,6,7496,5622,13118
250140,201712,75,64,11,59968,10307,70275
250150,201712,557,413,144,384854,134618.79,519472.79
250153,201712,11,10,1,9370,937,10307
250157,201712,28,23,5,21551,4685,26236
250160,201712,210,165,45,154605,42165,196770
250170,201712,67,48,19,44976,17803,62779
250180,201712,3981,2683,1298,2500251.02,1211218.5,3711469.52
250190,201712,909,596,313,556812.25,292578.25,849390.50
250200,201712,50,42,8,39354,7496,46850
250205,201712,19,17,2,15929,1874,17803
250210,201712,90,78,12,73086,11244,84330
250215,201712,61,53,8,49661,7496,57157
250220,201712,27,21,6,19677,5622,25299
250230,201712,73,67,6,62775,5622,68397
250240,201712,240,199,41,185666.55,38417,224083.55
250250,201712,385,330,55,309210,51535,360745
250260,201712,32,27,5,25299,4685,29984
250270,201712,59,46,13,43102,12181,55283
250280,201712,385,323,62,302651,58094,360745
250290,201712,94,89,5,83111.9,4685,87796.9
250300,201712,556,382,174,357298.24,163025,520323.24
250310,201712,48,41,7,38417,6559,44976
250320,201712,1901,1299,602,1210864.84,562530,1773394.84
250330,201712,83,72,11,67464,10307,77771
250340,201712,25,21,4,19677,3748,23425
250350,201712,139,88,51,82174.9,47224.8,129399.7
250355,201712,28,23,5,21551,4685,26236
250360,201712,198,161,37,150857,34435,185292
250370,201712,2362,1600,762,1493393.59,712464.71,2205858.30
250375,201712,21,17,4,15929,3748,19677
250380,201712,51,35,16,32795,14992,47787
250390,201712,42,35,7,32795,6559,39354
250400,201712,15550,7874,7676,7353904.89,7185510.19,14539415.08
250403,201712,424,344,80,322318.64,74960,397278.64
250407,201712,54,46,8,43102,7496,50598
250410,201712,28,23,5,21551,4685,26236
250415,201712,42,28,14,26236,13099.26,39335.26
250420,201712,48,39,9,36543,8433,44976
250430,201712,1662,1400,262,1309646,245494,1555140
250435,201712,17,14,3,13118,2811,15929
250440,201712,689,594,95,553765.7,89015,642780.7
250450,201712,86,72,14,67464,12462.1,79926.1
250460,201712,415,280,135,262360,126485.63,388845.63
250470,201712,88,65,23,60905,21551,82456
250480,201712,318,251,67,235187,62779,297966
250485,201712,2,1,1,937,937,1874
250490,201712,202,164,38,153668,35606,189274
250500,201712,75,54,21,50598,19677,70275
250510,201712,730,573,157,535589.8,146118.41,681708.21
250520,201712,173,121,52,113358.28,48719.32,162077.60
250523,201712,109,91,18,85267,16866,102133
250527,201712,104,80,24,74955.32,22488,97443.32
250530,201712,7,5,2,4685,1874,6559
250535,201712,25,21,4,19677,3748,23425
250540,201712,125,95,30,88312.25,28110,116422.25
250550,201712,69,66,3,61842,2811,64653
250560,201712,35,29,6,27173,5622,32795
250570,201712,151,120,31,112440,29047,141487
250580,201712,135,105,30,98103.9,28110,126213.9
250590,201712,20,16,4,14992,3748,18740
250600,201712,1320,894,426,834869.04,399069,1233938.04
250610,201712,152,131,21,122747,19677,142424
250620,201712,20,16,4,14992,3748,18740
250625,201712,61,46,15,43102,14055,57157
250630,201712,3003,1922,1081,1793010.37,1011786.66,2804797.03
250640,201712,201,168,33,157416,30921,188337
250650,201712,31,21,10,19677,9370,29047
250660,201712,42,32,10,29984,9370,39354
250670,201712,57,37,20,34669,18740,53409
250680,201712,386,315,71,295155,66527,361682
250690,201712,1802,1241,561,1159439.03,525282.9,1684721.93
250700,201712,951,834,117,777076.3,109422.86,886499.16
250710,201712,443,342,101,320454,94637,415091
250720,201712,102,80,22,74960,20614,95574
250730,201712,373,313,60,292113.22,56220,348333.22
250740,201712,51,47,4,44039,3748,47787
250750,201712,20089,12007,8082,11194652.14,7564123.59,18758775.73
250760,201712,67,50,17,46850,15929,62779
250770,201712,345,230,115,213355.67,106607.27,319962.94
250780,201712,58,45,13,42165,12181,54346
250790,201712,486,314,172,291407.76,160461.25,451869.01
250800,201712,151,140,11,130477.25,10307,140784.25
250810,201712,79,59,20,55283,18740,74023
250820,201712,157,126,31,118062,29047,147109
250830,201712,429,289,140,269809.25,131180,400989.25
250840,201712,54,51,3,47787,2811,50598
250850,201712,51,39,12,35868.36,11244,47112.36
250855,201712,13,11,2,10307,1874,12181
250860,201712,206,146,60,136802,55938.9,192740.9
250870,201712,32,29,3,27173,2811,29984
250880,201712,78,59,19,55226.78,17803,73029.78
250890,201712,2355,1737,618,1626257.2,578218.57,2204475.77
250900,201712,103,87,16,81519,14992,96511
250905,201712,133,104,29,97448,27173,124621
250910,201712,1167,832,335,778441.56,313613.9,1092055.46
250915,201712,111,76,35,71212,32795,104007
250920,201712,138,105,33,98385,30921,129306
250930,201712,159,99,60,92763,56220,148983
250933,201712,0,0,0,0,0,0
250937,201712,7,6,1,5622,937,6559
250939,201712,28,21,7,19677,6559,26236
250940,201712,108,82,26,76834,24362,101196
250950,201712,70,45,25,42165,23425,65590
250960,201712,91,50,41,46850,38417,85267
250970,201712,1203,857,346,801417,323920.9,1125337.9
250980,201712,93,65,28,60905,26236,87141
250990,201712,165,128,37,119500.35,34626.85,154127.20
251000,201712,73,67,6,62591.6,5622,68213.6
251010,201712,93,73,20,68397,17975.4,86372.4
251020,201712,81,70,11,64793.55,10307,75100.55
251030,201712,42,32,10,29984,9370,39354
251040,201712,54,39,15,36543,14055,50598
251050,201712,25,23,2,21551,1874,23425
251060,201712,49,39,10,35606,9370,44976
251065,201712,3,3,0,2811,0,2811
251070,201712,25,20,5,18731,4685,23416
251080,201712,4700,2272,2428,2116710.04,2268599.41,4385309.45
251090,201712,196,168,28,157416,26236,183652
251100,201712,19,18,1,16866,937,17803
251110,201712,47,37,10,34669,9370,44039
251120,201712,1762,1049,713,978091.1,668081,1646172.1
251130,201712,351,284,67,266108,62779,328887
251140,201712,503,325,178,303402,166620.34,470022.34
251150,201712,288,250,38,233492,35606,269098
251160,201712,90,75,15,70271,14055,84326
251170,201712,99,80,19,74931.92,17798.32,92730.24
251180,201712,288,181,107,169588.32,100250.32,269838.64
251190,201712,192,131,61,122424.68,57157,179581.68
251200,201712,253,204,49,191148,45913,237061
251203,201712,34,32,2,29984,1874,31858
251207,201712,93,77,16,72149,14992,87141
251210,201712,1239,883,356,825844.89,332916.1,1158760.99
251220,201712,45,34,11,31858,10307,42165
251230,201712,479,401,78,375737,73086,448823
251240,201712,103,73,30,67464,28110,95574
251250,201712,1326,951,375,887967.24,351235,1239202.24
251260,201712,13,8,5,7496,4685,12181
251270,201712,341,250,91,234250,85127,319377
251272,201712,67,61,6,57157,5622,62779
251274,201712,28,23,5,21551,4685,26236
251275,201712,22,15,7,14055,6559,20614
251276,201712,18,15,3,14055,2811,16866
251278,201712,9,7,2,6559,1874,8433
251280,201712,96,92,4,86204,3748,89952
251290,201712,693,524,169,490988,158353,649341
251300,201712,16,14,2,13118,1874,14992
251310,201712,358,258,100,241742,93700,335442
251315,201712,18,17,1,15929,937,16866
251320,201712,59,48,11,44976,10307,55283
251330,201712,79,70,9,65590,8433,74023
251335,201712,10,6,4,5622,3748,9370
251340,201712,686,407,279,381359,260416.63,641775.63
251350,201712,34,32,2,29984,1874,31858
251360,201712,66,57,9,53206.61,8433,61639.61
251365,201712,14,14,0,13118,0,13118
251370,201712,5259,3568,1691,3338721.29,1583156.5,4921877.79
251380,201712,49,38,11,35606,10307,45913
251385,201712,2,2,0,1874,0,1874
251390,201712,652,520,132,486116.6,122466,608582.6
251392,201712,31,21,10,19677,9370,29047
251394,201712,9,9,0,8433,0,8433
251396,201712,20,15,5,14055,4685,18740
251398,201712,17,15,2,14055,1874,15929
251400,201712,37,30,7,28110,6559,34669
251410,201712,34,29,5,27173,4685,31858
251420,201712,108,81,27,75897,25299,101196
251430,201712,37,35,2,32795,1874,34669
251440,201712,36,22,14,20614,13118,33732
251445,201712,51,46,5,43102,4685,47787
251450,201712,414,365,49,340379.4,45913,386292.4
251455,201712,2,1,1,937,937,1874
251460,201712,16,12,4,11244,3748,14992
251465,201712,5,2,3,1874,2811,4685
251470,201712,44,36,8,33732,7496,41228
251480,201712,24,22,2,20614,1874,22488
251490,201712,129,91,38,84799,34670,119469
251500,201712,116,94,22,88078,19865,107943
251510,201712,33,25,8,23425,7496,30921
251520,201712,25,25,0,23425,0,23425
251530,201712,4530,3175,1355,2968876.49,1269344.53,4238221.02
251540,201712,74,66,8,61842,7496,69338
251550,201712,417,321,96,299840.6,89718,389558.6
251560,201712,21,16,5,14992,4685,19677
251570,201712,18,18,0,16866,0,16866
251580,201712,119,97,22,90889,20614,111503
251590,201712,128,94,34,88078,31858,119936
251593,201712,17,9,8,8433,7496,15929
251597,201712,61,50,11,46850,10307,57157
251600,201712,1101,783,318,732209.94,296287.26,1028497.20
251610,201712,209,157,52,146453.1,48069,194522.1
251615,201712,2,2,0,1874,0,1874
251620,201712,4242,2845,1397,2655819.42,1306554.34,3962373.76
251630,201712,441,324,117,303588,109338.9,412926.9
251640,201712,149,106,43,99322,40291,139613
251650,201712,263,191,72,177168.55,67464,244632.55
251660,201712,218,199,19,185526.55,17615.6,203142.15
251670,201712,356,281,75,261733.07,70275,332008.07
251675,201712,3,3,0,2811,0,2811
251680,201712,86,78,8,73086,7496,80582
251690,201712,340,285,55,265932.79,51191.13,317123.92
251700,201712,281,234,47,218681.75,44024.95,262706.70
251710,201712,19,12,7,11244,6559,17803
251720,201712,33,22,11,20614,10026,30640
251740,201712,9,7,2,6559,1874,8433
260005,201712,3092,1759,1333,1637941.06,1247876.55,2885817.61
260010,201712,1397,1003,394,936812.74,367210.96,1304023.70
260020,201712,432,379,53,355123,49661,404784
260030,201712,569,411,158,384353.65,148046,532399.65
260040,201712,862,523,339,488186.37,317493.08,805679.45
260050,201712,1123,799,324,748429,303026,1051455
260060,201712,413,373,40,348751.4,37480,386231.4
260070,201712,1439,901,538,840206,502126.58,1342332.58
260080,201712,729,573,156,535964.55,146172,682136.55
260090,201712,564,351,213,328662.86,199581,528243.86
260100,201712,226,156,70,145188.6,65590,210778.6
260105,201712,238,133,105,124621,98385,223006
260110,201712,2716,2024,692,1896469.63,647608,2544077.63
260120,201712,2886,1459,1427,1357078.34,1334852.55,2691930.89
260130,201712,147,100,47,93700,44039,137739
260140,201712,2079,1360,719,1265978.88,672186.63,1938165.51
260150,201712,229,149,80,139613,74960,214573
260160,201712,294,254,40,237998,37480,275478
260170,201712,3342,2042,1300,1905441.71,1217022.45,3122464.16
260180,201712,136,116,20,108692,18740,127432
260190,201712,2263,1617,646,1512035.03,605302,2117337.03
260200,201712,883,734,149,686996.24,139332,826328.24
260210,201712,1404,986,418,923733.96,390439.96,1314173.92
260220,201712,715,654,61,612026,57157,669183
260230,201712,1194,905,289,845833.15,270793,1116626.15
260240,201712,216,163,53,151578.49,49661,201239.49
260250,201712,72,57,15,53409,14055,67464
260260,201712,981,704,277,659648,259549,919197
260270,201712,434,352,82,328399.1,76552.9,404952.0
260280,201712,1238,865,373,809755.4,349220,1158975.4
260290,201712,6319,3344,2975,3114858.82,2780967.06,5895825.88
260300,201712,831,732,99,683833.8,92482,776315.8
260310,201712,494,393,101,366887.03,94637,461524.03
260320,201712,878,662,216,620010.6,202392,822402.6
260330,201712,29,23,6,21551,5622,27173
260340,201712,66,48,18,44976,16866,61842
260345,201712,5594,3147,2447,2942390.92,2291576.74,5233967.66
260350,201712,464,338,126,314993.16,117126,432119.16
260360,201712,281,143,138,133991,129306,263297
260370,201712,643,418,225,389102.7,210688,599790.7
260380,201712,599,430,169,402910,157229.14,560139.14
260390,201712,292,249,43,232254.19,39354,271608.19
260392,201712,93,81,12,75897,11244,87141
260400,201712,4097,2340,1757,2182519.93,1645953.41,3828473.34
260410,201712,14117,7666,6451,7168736.87,6041904.5,13210641.37
260415,201712,123,111,12,104007,11244,115251
260420,201712,1769,1049,720,977780.95,672749.89,1650530.84
260430,201712,190,174,16,161847.14,14992,176839.14
260440,201712,230,166,64,154831,59968,214799
260450,201712,478,345,133,322003,124621,446624
260460,201712,863,461,402,429335.4,376669.32,806004.72
260470,201712,372,225,147,210075.4,136568.55,346643.95
260480,201712,199,122,77,114314,72149,186463
260490,201712,206,166,40,155542,37480,193022
260500,201712,1119,746,373,696754.6,348423.9,1045178.5
260510,201712,728,574,154,537838,143361,681199
260515,201712,255,227,28,212699,25768,238467
260520,201712,3278,1938,1340,1807363.31,1253697.21,3061060.52
260530,201712,762,618,144,576296.92,134928,711224.92
260540,201712,574,429,145,401973,134928.66,536901.66
260545,201712,14,10,4,9370,3748,13118
260550,201712,337,209,128,195833,119936,315769
260560,201712,515,389,126,363913,117780.9,481693.9
260570,201712,1004,827,177,771948.9,165567.9,937516.8
260580,201712,273,244,29,228628,27173,255801
260590,201712,654,372,282,347177.24,264234,611411.24
260600,201712,8200,4132,4068,3847699.86,3808526.02,7656225.88
260610,201712,496,329,167,308273,156197.9,464470.9
260620,201712,3587,1875,1712,1745394.49,1599241.18,3344635.67
260630,201712,70,67,3,62779,2811,65590
260640,201712,3621,1986,1635,1857623.49,1531630.31,3389253.80
260650,201712,339,233,106,218321,99279.85,317600.85
260660,201712,494,335,159,313520.2,148373.95,461894.15
260670,201712,102,76,26,71212,24362,95574
260680,201712,3673,2044,1629,1897708.16,1525362.78,3423070.94
260690,201712,126,96,30,89952,28110,118062
260700,201712,328,199,129,185713.4,120056,305769.4
260710,201712,35,33,2,30921,1874,32795
260720,201712,2193,1319,874,1230120.23,817879.19,2047999.42
260730,201712,587,442,145,414154,133709.9,547863.9
260740,201712,62,58,4,54346,3748,58094
260750,201712,648,450,198,421217.04,185526,606743.04
260760,201712,625,345,280,323265,262048,585313
260765,201712,989,518,471,482476.9,441092.75,923569.65
260770,201712,225,169,56,158353,52472,210825
260775,201712,812,481,331,449339.9,310138,759477.9
260780,201712,266,169,97,158353,90757.82,249110.82
260790,201712,12459,6820,5639,6362737.14,5276589.27,11639326.41
260795,201712,157,107,50,99865.46,46850,146715.46
260800,201712,309,253,56,236593,52472,289065
260805,201712,176,113,63,105165.13,59031,164196.13
260810,201712,742,646,96,604074.53,89952,694026.53
260820,201712,314,210,104,195464,97448,292912
260825,201712,205,140,65,130809.71,60905,191714.71
260830,201712,262,168,94,157275.45,88078,245353.45
260840,201712,229,166,63,154887,58750,213637
260845,201712,211,150,61,140268.9,57157,197425.9
260850,201712,510,372,138,346929.64,129306,476235.64
260860,201712,253,189,64,176898.86,59968,236866.86
260870,201712,366,258,108,241746,101196,342942
260875,201712,689,477,212,445855.53,198644,644499.53
260880,201712,1532,941,591,879793.21,553579.6,1433372.81
260890,201712,2442,1709,733,1593884.55,685885,2279769.55
260900,201712,1030,703,327,657432,306399,963831
260910,201712,276,216,60,202392,56220,258612
260915,201712,307,204,103,191148,96391,287539
260920,201712,171,98,73,91826,68401,160227
260930,201712,395,338,57,316706,53310.7,370016.7
260940,201712,2744,1508,1236,1408594.55,1157364.26,2565958.81
260950,201712,1955,1135,820,1056319.71,768340,1824659.71
260960,201712,14215,7380,6835,6879181.09,6397200.21,13276381.30
260970,201712,432,372,60,348564,56220,404784
260980,201712,200,175,25,163694,23425,187119
260990,201712,2544,2097,447,1964393.01,418183.1,2382576.11
261000,201712,4303,2538,1765,2365906.64,1652221.87,4018128.51
261010,201712,186,134,52,125558,47920.8,173478.8
261020,201712,611,452,159,423384,148186.55,571570.55
261030,201712,218,159,59,148983,55081.55,204064.55
261040,201712,363,326,37,305462,34106.9,339568.9
261050,201712,464,410,54,384170,50598,434768
261060,201712,1322,869,453,812145.88,424461,1236606.88
261070,201712,8986,4616,4370,4300973.71,4085904.57,8386878.28
261080,201712,385,296,89,276594,83393,359987
261090,201712,2200,1688,512,1573625.92,478986,2052611.92
261100,201712,1087,771,316,720132.3,294255.48,1014387.78
261110,201712,8039,4921,3118,4605717.04,2919324.14,7525041.18
261120,201712,277,229,48,214493.91,44971.32,259465.23
261130,201712,573,329,244,307945.45,228628,536573.45
261140,201712,188,120,68,112440,63716,176156
261150,201712,661,387,274,362619,256082.1,618701.1
261153,201712,74,71,3,65590.12,2811,68401.12
261160,201712,76572,38853,37719,36284815.12,35318540.8,71603355.92
261170,201712,449,335,114,312995.58,106818,419813.58
261180,201712,1769,1077,692,1003705.33,648404,1652109.33
261190,201712,617,426,191,398759.89,178958,577717.89
261200,201712,210,185,25,172640.09,23425,196065.09
261210,201712,35,31,4,29047,3748,32795
261220,201712,2495,1758,737,1641720.11,689444.9,2331165.01
261230,201712,315,235,80,220195,74945.95,295140.95
261240,201712,442,383,59,354929.47,55283,410212.47
261245,201712,221,185,36,173345,33732,207077
261247,201712,151,113,38,105881,35606,141487
261250,201712,2830,1415,1415,1325292.9,1324764.61,2650057.51
261255,201712,254,232,22,217384,20614,237998
261260,201712,850,728,122,682136,114314,796450
261270,201712,174,134,40,125558,37480,163038
261280,201712,152,123,29,115251,27173,142424
261290,201712,129,90,39,84095.75,36543,120638.75
261300,201712,1226,868,358,813316,335446,1148762
261310,201712,754,505,249,473185,232703.95,705888.95
261320,201712,538,363,175,340131,163975,504106
261330,201712,807,638,169,594862.25,157522.53,752384.78
261340,201712,312,173,139,162101,130243,292344
261350,201712,782,559,223,522846.1,208951,731797.1
261360,201712,1195,766,429,717347.53,401973,1119320.53
261370,201712,4936,3033,1903,2826806.58,1779948.38,4606754.96
261380,201712,571,420,151,391675.92,141206,532881.92
261390,201712,3412,2284,1128,2135414,1053143.15,3188557.15
261400,201712,278,253,25,236492.28,23425,259917.28
261410,201712,1044,689,355,645593,332630.32,978223.32
261420,201712,874,542,332,505953.63,311065.63,817019.26
261430,201712,330,300,30,280269,27828.9,308097.9
261440,201712,103,92,11,86204,10307,96511
261450,201712,2493,2071,422,1938102.13,394422.12,2332524.25
261460,201712,709,562,147,525657.81,137739,663396.81
261470,201712,244,187,57,174423,53409,227832
261480,201712,340,281,59,262080,55279,317359
261485,201712,339,207,132,193303.1,123684,316987.1
261500,201712,629,421,208,394477,194896,589373
261510,201712,39,28,11,26236,10307,36543
261520,201712,153,138,15,129306,14055,143361
261530,201712,4175,2643,1532,2467678.06,1434252.95,3901931.01
261540,201712,1070,656,414,614216.62,387918,1002134.62
261550,201712,286,141,145,130759,135846.26,266605.26
261560,201712,786,522,264,485930.1,245953.8,731883.9
261570,201712,366,285,81,267045,75897,342942
261580,201712,373,291,82,271920,76834,348754
261590,201712,193,156,37,146172,34669,180841
261600,201712,287,231,56,215698,52004,267702
261610,201712,104,90,14,83982,13118,97100
261618,201712,65,51,14,47787,13118,60905
261620,201712,208,126,82,118062,76834,194896
261630,201712,592,452,140,421207.8,131180,552387.8
261640,201712,6270,3332,2938,3113919.15,2750105.26,5864024.41
261650,201712,474,295,179,275749.73,167723,443472.73
270010,201712,519,454,65,425117,60156,485273
270020,201712,304,239,65,223939,60905,284844
270030,201712,9095,5791,3304,5412839.18,3093434.39,8506273.57
270040,201712,1925,1179,746,1104151.44,698720.9,1802872.34
270050,201712,175,129,46,120873,43102,163975
270060,201712,117,64,53,59968,49661,109629
270070,201712,905,654,251,610817.26,234878.16,845695.42
270080,201712,40,34,6,31858,5622,37480
270090,201712,20,16,4,14992,3748,18740
270100,201712,1269,830,439,773948.98,409235.35,1183184.33
270110,201712,160,118,42,110566,39354,149920
270120,201712,224,183,41,170634.72,38135.9,208770.62
270130,201712,260,180,80,168378.9,74678.9,243057.8
270135,201712,98,59,39,55283,36543,91826
270140,201712,1266,760,506,711930.48,472614.4,1184544.88
270150,201712,267,215,52,201455,48724,250179
270160,201712,517,381,136,356997,126776.1,483773.1
270170,201712,697,442,255,413029.6,238138.55,651168.15
270180,201712,72,55,17,51222.7,15722.86,66945.56
270190,201712,105,92,13,86204,12181,98385
270200,201712,107,96,11,89764.6,10307,100071.6
270210,201712,487,251,236,235187,220850.9,456037.9
270220,201712,191,153,38,143361,35606,178967
270230,201712,2091,1240,851,1156543.24,794582.2,1951125.44
270235,201712,736,550,186,515049.92,173923.48,688973.40
270240,201712,3090,2381,709,2220720.07,661027.8,2881747.87
270250,201712,175,122,53,113564.4,49661,163225.4
270255,201712,221,192,29,179904,26798.2,206702.2
270260,201712,323,257,66,240809,61842,302651
270270,201712,116,48,68,44967,63716,108683
270280,201712,216,136,80,127432,74960,202392
270290,201712,1155,863,292,807572.59,272733.26,1080305.85
270300,201712,267,169,98,158353,91544.9,249897.9
270310,201712,928,741,187,692115.18,174507.62,866622.80
270320,201712,887,755,132,706383.4,123571.57,829954.97
270330,201712,266,221,45,206140,42165,248305
270340,201712,61,48,13,44976,12181,57157
270350,201712,94,48,46,44976,43102,88078
270360,201712,73,39,34,36543,31858,68401
270370,201712,51,38,13,35606,12181,47787
270375,201712,62,33,29,30921,27169,58090
270380,201712,1080,606,474,566885,444138,1011023
270390,201712,196,105,91,98385,85267,183652
270400,201712,702,508,194,474802.43,181769,656571.43
270410,201712,697,494,203,462878,190201.63,653079.63
270420,201712,396,255,141,237268,132034.89,369302.89
270430,201712,32002,22763,9239,21274848.05,8648316.36,29923164.41
270440,201712,494,384,110,358824.55,102788.9,461613.45
270450,201712,766,396,370,370817.75,345472.73,716290.48
270460,201712,199,150,49,140550,45913,186463
270470,201712,1343,886,457,829833.95,428209,1258042.95
270480,201712,522,418,104,388077.94,96745.25,484823.19
270490,201712,25,20,5,18740,4685,23425
270500,201712,510,417,93,390729,87141,477870
270510,201712,735,450,285,421650,267045,688695
270520,201712,393,237,156,221722.45,146172,367894.45
270530,201712,63,55,8,51535,7496,59031
270540,201712,124,95,29,89015,27173,116188
270550,201712,1728,1305,423,1221531.37,396346.32,1617877.69
270560,201712,319,144,175,134928,163975,298903
270570,201712,445,290,155,270914.73,145235,416149.73
270580,201712,77,55,22,51535,20614,72149
270590,201712,83,69,14,64653,13118,77771
270600,201712,180,148,32,138676,29984,168660
270610,201712,173,137,36,128360,33732,162092
270620,201712,30,29,1,27173,937,28110
270630,201712,3820,2894,926,2701013.96,865545.38,3566559.34
270640,201712,910,664,246,620500.3,230193.9,850694.2
270642,201712,205,172,33,161164,30921,192085
270644,201712,286,193,93,180653.97,87136.32,267790.29
270650,201712,236,136,100,127432,93700,221132
270660,201712,255,205,50,192085,46850,238935
270670,201712,3181,2411,770,2248763.31,719555.95,2968319.26
270680,201712,460,266,194,249233,181773.32,431006.32
270690,201712,1114,694,420,648576.24,393530.63,1042106.87
270700,201712,36,27,9,25299,8433,33732
270710,201712,870,649,221,606526.86,207077,813603.86
270720,201712,249,188,61,176156,56875.9,233031.9
270730,201712,1865,1078,787,1007885.2,735350.6,1743235.8
270740,201712,47,29,18,27173,16866,44039
270750,201712,632,463,169,433644,157698,591342
270760,201712,309,225,84,210825,78708,289533
270770,201712,2696,1688,1008,1574511.84,943559,2518070.84
270780,201712,92,57,35,53404.32,32777.64,86181.96
270790,201712,274,181,93,169597,87141,256738
270800,201712,1982,1572,410,1471203.12,383439.14,1854642.26
270810,201712,319,249,70,233298.95,65581.32,298880.27
270820,201712,155,99,56,92763,52379,145142
270830,201712,964,692,272,646906,254583,901489
270840,201712,1407,1019,388,954311.2,361918,1316229.2
270850,201712,1714,1042,672,971620.18,629645.63,1601265.81
270860,201712,2463,1594,869,1490968.2,811387.9,2302356.1
270870,201712,122,67,55,62779,51535,114314
270880,201712,905,651,254,608193.67,237102.75,845296.42
270890,201712,364,265,99,247864.61,92758.32,340622.93
270895,201712,73,63,10,59031,9370,68401
270900,201712,109,85,24,79645,22488,102133
270910,201712,328,260,68,242495.6,63716,306211.6
270915,201712,1806,1073,733,1000579.45,686132.06,1686711.51
270920,201712,480,396,84,371052,78708,449760
270930,201712,6225,4467,1758,4179967.23,1644508.04,5824475.27
270940,201712,2381,1794,587,1679778.64,549064,2228842.64
280010,201712,43,38,5,35606,4685,40291
280020,201712,700,599,101,559358.31,93700,653058.31
280030,201712,19007,12161,6846,11318551.46,6387095.74,17705647.20
280040,201712,343,217,126,203329,116656.5,319985.5
280050,201712,377,291,86,272385.9,80582,352967.9
280060,201712,322,212,110,197656.02,103070,300726.02
280067,201712,975,682,293,636241.93,273604.12,909846.05
280070,201712,127,105,22,98385,20614,118999
280100,201712,609,480,129,446970.98,120686,567656.98
280110,201712,73,69,4,64653,3748,68401
280120,201712,628,504,124,472248,116188,588436
280130,201712,1325,822,503,768808.9,471170.45,1239979.35
280140,201712,464,372,92,347720.7,86204,433924.7
280150,201712,315,232,83,216716.21,76834,293550.21
280160,201712,98,83,15,77771,14055,91826
280170,201712,583,390,193,363973.68,180044.55,544018.23
280190,201712,28,26,2,24362,1874,26236
280200,201712,23,15,8,14055,7496,21551
280210,201712,2755,1940,815,1800332.12,758012.89,2558345.01
280220,201712,39,31,8,29047,7496,36543
280230,201712,310,255,55,238115.95,51535,289650.95
280240,201712,111,105,6,98244.45,5622,103866.45
280250,201712,22,13,9,12181,8433,20614
280260,201712,76,68,8,63716,7496,71212
280270,201712,161,123,38,115251,35606,150857
280280,201712,195,123,72,115251,67464,182715
280290,201712,3035,2200,835,2048483.42,781107.63,2829591.05
280300,201712,1084,821,263,767641.93,245681.4,1013323.33
280310,201712,105,100,5,93093.7,4685,97778.7
280320,201712,656,445,211,416956,197707,614663
280330,201712,354,254,100,237998,93578.19,331576.19
280340,201712,409,327,82,304954.05,76085,381039.05
280350,201712,3394,2621,773,2446894.36,721610.41,3168504.77
280360,201712,466,298,168,279226,156479,435705
280370,201712,97,86,11,80582,10307,90889
280380,201712,56,41,15,38417,14055,52472
280390,201712,184,153,31,143361,29047,172408
280400,201712,344,232,112,216541.4,104944,321485.4
280410,201712,292,234,58,218116,54336.63,272452.63
280420,201712,174,146,28,136802,26236,163038
280430,201712,107,78,29,73086,27066.56,100152.56
280440,201712,667,510,157,474029.95,146912.23,620942.18
280445,201712,114,106,8,99322,7496,106818
280450,201712,1059,905,154,844705.5,144298,989003.5
280460,201712,728,523,205,483313.26,192085,675398.26
280470,201712,191,174,17,163038,14993,178031
280480,201712,2238,1596,642,1481059.21,597678.2,2078737.41
280490,201712,365,334,31,311872,29047,340919
280500,201712,44,39,5,36543,4685,41228
280510,201712,150,117,33,109331.6,30640,139971.6
280520,201712,55,41,14,38417,13118,51535
280530,201712,78,55,23,51535,21551,73086
280540,201712,501,400,101,374800,94355.9,469155.9
280550,201712,705,650,55,606480.3,51535,658015.3
280560,201712,471,406,65,378266.9,60905,439171.9
280570,201712,1767,1339,428,1250897.59,400196.44,1651094.03
280580,201712,595,452,143,421886.3,133898,555784.3
280590,201712,163,100,63,93425.46,59031,152456.46
280600,201712,353,295,58,275684.14,54346,330030.14
280610,201712,144,107,37,100057,34669,134726
280620,201712,547,444,103,414596.71,95574.45,510171.16
280630,201712,165,137,28,128369,26236,154605
280640,201712,211,168,43,156602,40291,196893
280650,201712,80,52,28,48724,26236,74960
280660,201712,127,91,36,85267,33497.75,118764.75
280670,201712,1583,985,598,917894.53,556648.98,1474543.51
280680,201712,180,153,27,141609.81,25299,166908.81
280690,201712,46,39,7,36543,6559,43102
280700,201712,16,16,0,14992,0,14992
280710,201712,1414,1061,353,986552.39,330105.1,1316657.49
280720,201712,107,73,34,65886.7,31858,97744.7
280730,201712,23,19,4,17803,3748,21551
280740,201712,2369,1734,635,1620090.15,592972.07,2213062.22
280750,201712,295,253,42,237061,39354,276415
280760,201712,863,587,276,548894.6,258471.45,807366.05
290010,201712,194,128,66,119936,61842,181778
290020,201712,175,162,13,151794,12181,163975
290030,201712,589,380,209,355404.1,195833,551237.1
290035,201712,140,113,27,102733.8,25299,128032.8
290040,201712,268,169,99,158353,92763,251116
290050,201712,69,51,18,47787,16866,64653
290060,201712,261,113,148,105599.9,138676,244275.9
290070,201712,5519,2706,2813,2528216.07,2632085.85,5160301.92
290080,201712,503,229,274,214273.16,256720,470993.16
290090,201712,382,166,216,155542,202392,357934
290100,201712,1575,1036,539,967547.65,504480.9,1472028.55
290110,201712,761,446,315,416305.1,294920.75,711225.85
290115,201712,213,197,16,183652,14992,198644
290120,201712,782,508,274,475340.1,256738,732078.1
290130,201712,418,245,173,229274.53,162101,391375.53
290135,201712,295,224,71,209222.73,66527,275749.73
290140,201712,293,242,51,226754,47599.6,274353.6
290150,201712,128,96,32,89952,29984,119936
290160,201712,245,192,53,178685.95,49661,228346.95
290170,201712,87,61,26,57157,24362,81519
290180,201712,152,119,33,111503,30921,142424
290190,201712,450,364,86,340787,80300.9,421087.9
290195,201712,300,174,126,163038,118062,281100
290200,201712,288,244,44,228628,41228,269856
290205,201712,138,85,53,79645,49661,129306
290210,201712,1110,808,302,755972.6,282974,1038946.6
290220,201712,213,116,97,108223.5,90889,199112.5
290225,201712,282,104,178,97448,166786,264234
290230,201712,64,41,23,38417,21551,59968
290240,201712,312,124,188,115906.9,176156,292062.9
290250,201712,270,244,26,227944,24362,252306
290260,201712,271,223,48,208202,44976,253178
290265,201712,184,150,34,139747,31858,171605
290270,201712,1380,1133,247,1059433.63,230592,1290025.63
290280,201712,467,345,122,323265,114314,437579
290290,201712,1201,695,506,646776.61,474122,1120898.61
290300,201712,450,382,68,357414.07,63716,421130.07
290310,201712,319,140,179,131180,167723,298903
290320,201712,3916,2435,1481,2278941.46,1384886.5,3663827.96
290323,201712,183,159,24,148702,22488,171190
290327,201712,148,116,32,108424.96,29984,138408.96
290330,201712,69,35,34,32795,31858,64653
290340,201712,912,363,549,339176,513850.9,853026.9
290350,201712,582,344,238,321576,223006,544582
290360,201712,364,274,90,254865.14,84330,339195.14
290370,201712,935,356,579,333572,542523,876095
290380,201712,299,182,117,170534,109629,280163
290390,201712,2461,1527,934,1427879.47,873284,2301163.47
290395,201712,243,135,108,125979.9,101196,227175.9
290400,201712,280,208,72,194334,67464,261798
290405,201712,259,221,38,207077,35606,242683
290410,201712,555,474,81,441187.9,75897,517084.9
290420,201712,228,176,52,164912,48724,213636
290430,201712,511,319,192,298903,179904,478807
290440,201712,72,63,9,59031,7808.3,66839.3
290450,201712,235,179,56,167723,52472,220195
290460,201712,1869,1106,763,1034203.8,714463.56,1748667.36
290470,201712,1439,604,835,564536.17,782083.08,1346619.25
290475,201712,589,552,37,516522,34669,551191
290480,201712,289,161,128,150857,119936,270793
290485,201712,218,205,13,192085,12181,204266
290490,201712,1135,808,327,756346.4,305462.6,1061809.0
290500,201712,660,331,329,309210,308273,617483
290510,201712,218,166,52,154606,48724,203330
290515,201712,134,77,57,72149,53409,125558
290520,201712,1369,875,494,818282.61,459694.01,1277976.62
290530,201712,310,282,28,264234,26236,290470
290540,201712,92,55,37,51535,34669,86204
290550,201712,152,129,23,120873,21204.31,142077.31
290560,201712,3383,1367,2016,1279885.78,1888801.4,3168687.18
290570,201712,5766,2987,2779,2794196.32,2601157.99,5395354.31
290580,201712,1245,714,531,667799.9,496844.25,1164644.15
290590,201712,530,439,91,410594,85267,495861
290600,201712,1709,1186,523,1106410.88,490022.89,1596433.77
290610,201712,218,196,22,183203,20614,203817
290620,201712,320,282,38,264234,35043.8,299277.8
290630,201712,2118,891,1227,831120,1144177.52,1975297.52
290640,201712,149,121,28,113377,26236,139613
290650,201712,1686,792,894,741158.42,837678,1578836.42
290660,201712,280,227,53,212699,49661,262360
290670,201712,977,514,463,481056,433490.9,914546.9
290680,201712,1167,940,227,879843,211762,1091605
290682,201712,287,210,77,195801.15,72130.63,267931.78
290685,201712,227,144,83,133991,77771,211762
290687,201712,929,616,313,573865.8,291285.29,865151.09
290689,201712,125,74,51,69324,47772.95,117096.95
290690,201712,650,269,381,252025.26,356125.03,608150.29
290700,201712,243,115,128,107755,119936,227691
290710,201712,682,449,233,420713,218321,639034
290720,201712,1017,831,186,778647,173813.5,952460.5
290730,201712,1112,633,479,591293.85,447886,1039179.85
290740,201712,16,12,4,11244,3748,14992
290750,201712,1336,605,731,565575.83,682872.55,1248448.38
290755,201712,69,61,8,57157,7496,64653
290760,201712,300,261,39,244557,36543,281100
290770,201712,187,174,13,163028.63,12181,175209.63
290780,201712,964,772,192,721455.23,178123.7,899578.93
290790,201712,378,261,117,243988,109629,353617
290800,201712,2622,1042,1580,973286.07,1479363.71,2452649.78
290810,201712,437,303,134,283630,125558,409188
290820,201712,378,232,146,216433,136802,353235
290830,201712,391,261,130,244557,121810,366367
290840,201712,1652,1010,642,943981.4,599511.44,1543492.84
290850,201712,755,417,338,390541.6,315769,706310.6
290860,201712,653,292,361,273604,337976,611580
290870,201712,658,480,178,448841.9,166786,615627.9
290880,201712,126,69,57,64653,53409,118062
290890,201712,322,228,94,213636,88078,301714
290900,201712,168,128,40,119936,37480,157416
290910,201712,357,269,88,252053,82456,334509
290920,201712,228,192,36,179904,33732,213636
290930,201712,810,615,195,576255,182715,758970
290940,201712,250,204,46,190398.4,43102,233500.4
290950,201712,170,98,72,91826,67464,159290
290960,201712,436,291,145,271449.72,135583.9,407033.62
290970,201712,249,218,31,204078.6,28626,232704.6
290980,201712,1468,1040,428,970405.02,400006.1,1370411.12
290990,201712,362,306,56,286704,52416.89,339120.89
291000,201712,858,238,620,223006,580377.8,803383.8
291005,201712,2046,868,1178,811573.28,1103022.72,1914596.00
291010,201712,158,143,15,133991,14055,148046
291020,201712,104,81,23,75897,21551,97448
291030,201712,89,66,23,61842,21551,83393
291040,201712,586,291,295,272667,276415,549082
291050,201712,1330,751,579,702072.32,542241.9,1244314.22
291060,201712,1481,811,670,759251.1,627790,1387041.1
291070,201712,1887,1393,494,1299011.6,460890.13,1759901.73
291072,201712,7277,2681,4596,2508808.91,4304008.14,6812817.05
291075,201712,197,160,37,149920,34669,184589
291077,201712,50,34,16,31858,14992,46850
291080,201712,19264,8363,10901,7813505.74,10201459.12,18014964.86
291085,201712,287,229,58,214573,54341.32,268914.32
291090,201712,306,113,193,105600,180831.63,286431.63
291100,201712,694,202,492,189274,461004,650278
291110,201712,397,304,93,284848,87141,371989
291120,201712,2518,1172,1346,1098024,1259258.76,2357282.76
291125,201712,59,31,28,29047,26236,55283
291130,201712,212,185,27,173345,25299,198644
291140,201712,119,89,30,83393,27829,111222
291150,201712,382,150,232,140550,217384,357934
291160,201712,349,293,56,273604.25,52472,326076.25
291165,201712,22,18,4,16866,3748,20614
291170,201712,2858,1444,1414,1349327.95,1322200.9,2671528.85
291180,201712,1318,505,813,473047,761727,1234774
291185,201712,73,71,2,66527,1874,68401
291190,201712,1240,525,715,490419.5,669421.9,1159841.4
291200,201712,163,117,46,109629,43102,152731
291210,201712,2200,850,1350,793367.27,1263170.17,2056537.44
291220,201712,258,195,63,181778.43,59031,240809.43
291230,201712,1018,342,676,319611,633412,953023
291240,201712,444,420,24,392322,22488,414810
291250,201712,429,349,80,327013,74960,401973
291260,201712,40,30,10,28110,9370,37480
291270,201712,1210,489,721,458193,675061.9,1133254.9
291280,201712,375,170,205,159102.6,191794.53,350897.13
291290,201712,1734,871,863,815002.6,807601,1622603.6
291300,201712,224,177,47,165193.1,44039,209232.1
291310,201712,231,205,26,191804,24362,216166
291320,201712,1385,992,393,925880.93,367211.8,1293092.73
291330,201712,125,106,19,98478.7,17803,116281.7
291340,201712,140,79,61,74023,57157,131180
291345,201712,126,83,43,77771,40291,118062
291350,201712,1559,493,1066,461472.5,998655.15,1460127.65
291360,201712,8521,4174,4347,3901366.83,4069913.28,7971280.11
291370,201712,1079,589,490,551612,459130,1010742
291380,201712,253,200,53,187400,49661,237061
291390,201712,3873,1671,2202,1561353.5,2061775,3623128.5
291400,201712,2072,1474,598,1376079.79,558439.51,1934519.30
291410,201712,153,135,18,125558,16866,142424
291420,201712,107,77,30,72149,28110,100259
291430,201712,173,97,76,90194,70275.96,160469.96
291440,201712,487,388,99,361161.25,92763,453924.25
291450,201712,882,547,335,510385.54,312958,823343.54
291460,201712,1718,1398,320,1307489.8,299840,1607329.8
291465,201712,2217,1033,1184,967628.93,1109153.41,2076782.34
291470,201712,2760,1405,1355,1312766.95,1268851,2581617.95
291480,201712,11814,5223,6591,4882894.64,6166349.9,11049244.54
291490,201712,545,221,324,207077,303588,510665
291500,201712,368,199,169,186463,158353,344816
291510,201712,1247,464,783,433627.68,733389.9,1167017.58
291520,201712,955,431,524,403847,490978.63,894825.63
291530,201712,1015,271,744,253927,696828.26,950755.26
291535,201712,114,96,18,89952,16866,106818
291540,201712,364,109,255,102133,237998.8,340131.8
291550,201712,1178,549,629,512540.19,588792.9,1101333.09
291560,201712,5553,2848,2705,2655962.96,2522387.36,5178350.32
291570,201712,202,102,100,95574,93700,189274
291580,201712,1197,725,472,678572.63,442250.32,1120822.95
291590,201712,75,30,45,27969.45,42165,70134.45
291600,201712,1372,619,753,579066,705262,1284328
291610,201712,1371,621,750,580616.74,702695,1283311.74
291620,201712,575,266,309,249242,289158.2,538400.2
291630,201712,499,162,337,151794,315769,467563
291640,201712,3902,1945,1957,1816367.71,1832364.19,3648731.90
291650,201712,413,271,142,252812.97,132081.98,384894.95
291660,201712,447,177,270,165169.3,251912.45,417081.75
291670,201712,222,140,82,130618,76834,207452
291680,201712,706,401,305,375737,285692,661429
291685,201712,561,298,263,278992,246243.6,525235.6
291690,201712,554,279,275,261423,256738,518161
291700,201712,910,718,192,672049.19,178967,851016.19
291710,201712,1710,785,925,734861.34,865863.93,1600725.27
291720,201712,398,267,131,250174.32,122747,372921.32
291730,201712,929,533,396,497922.4,371042.63,868965.03
291733,201712,257,179,78,167441.9,73086,240527.9
291735,201712,67,51,16,47787,14992,62779
291740,201712,338,256,82,239872,76834,316706
291750,201712,1930,1283,647,1195952.08,604616.81,1800568.89
291760,201712,3073,1645,1428,1534843.81,1335693.5,2870537.31
291770,201712,804,541,263,504854.03,246431,751285.03
291780,201712,46,26,20,24362,18740,43102
291790,201712,167,77,90,72149,84330,156479
291800,201712,9909,3914,5995,3656258.37,5612850.2,9269108.57
291810,201712,1146,818,328,765899.22,307336,1073235.22
291820,201712,265,191,74,178967,69338,248305
291830,201712,1060,395,665,368916,622159,991075
291835,201712,622,565,57,528936.5,53409,582345.5
291840,201712,4623,2367,2256,2213171.62,2113039.18,4326210.80
291845,201712,308,106,202,99322,189245.89,288567.89
291850,201712,322,280,42,262125.75,39354,301479.75
291855,201712,266,107,159,100259,148983,249242
291860,201712,181,108,73,100259,68401,168660
291870,201712,83,34,49,31858,45913,77771
291875,201712,184,168,16,157416,14992,172408
291880,201712,485,379,106,354327,99322,453649
291890,201712,245,79,166,74013.63,153855.5,227869.13
291900,201712,56,31,25,29047,23425,52472
291905,201712,140,96,44,89671,41228,130899
291910,201712,179,145,34,135865,31858,167723
291915,201712,387,344,43,320690,40291,360981
291920,201712,4887,2528,2359,2366094.71,2208457.34,4574552.05
291930,201712,182,106,76,98385.7,71212,169597.7
291940,201712,310,169,141,157669.49,131180,288849.49
291950,201712,1124,919,205,860354,192085,1052439
291955,201712,991,586,405,549082,379064,928146
291960,201712,174,118,56,110566,52472,163038
291970,201712,784,593,191,555641,178967,734608
291980,201712,1499,1323,176,1236300.31,163975.7,1400276.01
291990,201712,122,113,9,105881,8433,114314
291992,201712,162,82,80,76084.4,74960,151044.4
291995,201712,148,104,44,97448,41228,138676
292000,201712,384,290,94,270512,88078,358590
292010,201712,280,202,78,188619,72149,260768
292020,201712,269,198,71,185526,66527,252053
292030,201712,139,109,30,102133,28110,130243
292040,201712,625,317,308,297029,288596,585625
292045,201712,90,81,9,75897,8433,84330
292050,201712,882,599,283,560272.26,265171,825443.26
292060,201712,933,769,164,718680.59,153668,872348.59
292070,201712,51,22,29,20614,27173,47787
292080,201712,111,76,35,71212,32795,104007
292090,201712,495,174,321,162850.6,300777,463627.6
292100,201712,1392,596,796,556906.35,745824.26,1302730.61
292105,201712,200,168,32,157416,29984,187400
292110,201712,2104,773,1331,723982.42,1245156.78,1969139.20
292120,201712,633,506,127,473009.96,118999,592008.96
292130,201712,444,261,183,244557,171471,416028
292140,201712,199,156,43,146172,40161.61,186333.61
292145,201712,156,83,73,77771,68372.9,146143.9
292150,201712,1392,1116,276,1045692,257602.47,1303294.47
292160,201712,181,148,33,138394.9,30921,169315.9
292170,201712,1214,1067,147,998116.73,137682.78,1135799.51
292180,201712,196,139,57,130243,53409,183652
292190,201712,155,95,60,89015,56220,145235
292200,201712,1274,463,811,432507.24,759270.68,1191777.92
292205,201712,115,104,11,97166.9,10307,107473.9
292210,201712,362,249,113,231955,105178.25,337133.25
292220,201712,22,16,6,14992,5622,20614
292225,201712,40,36,4,33732,3748,37480
292230,201712,904,732,172,683234.72,161164,844398.72
292240,201712,612,436,176,407455,164912,572367
292250,201712,1672,1054,618,987598,579066,1566664
292260,201712,435,241,194,225817,181028.4,406845.4
292265,201712,271,189,82,176811.9,76834,253645.9
292270,201712,771,333,438,311365.1,409469.4,720834.5
292273,201712,196,111,85,103243.34,79645,182888.34
292275,201712,160,76,84,71212,78426.9,149638.9
292280,201712,131,91,40,85267,37480,122747
292285,201712,59,50,9,46194.1,8433,54627.1
292290,201712,541,358,183,333001.01,171190,504191.01
292300,201712,1608,608,1000,569133.9,936180.99,1505314.89
292303,201712,96,66,30,61842,28110,89952
292305,201712,110,78,32,73086,29984,103070
292310,201712,789,484,305,453153,284420.15,737573.15
292320,201712,649,491,158,459785.9,148046,607831.9
292330,201712,190,97,93,90889,87141,178030
292335,201712,276,210,66,196770,61842,258612
292340,201712,561,387,174,361892.93,163038,524930.93
292350,201712,265,141,124,131320.55,115906.9,247227.45
292360,201712,698,530,168,494923.5,157416,652339.5
292370,201712,778,591,187,553767,175219,728986
292380,201712,648,497,151,463816.11,141487,605303.11
292390,201712,506,187,319,175219,297169.75,472388.75
292400,201712,3344,2057,1287,1909417.29,1202389,3111806.29
292405,201712,262,174,88,162569.5,82174.9,244744.4
292410,201712,153,90,63,84330,59031,143361
292420,201712,303,260,43,243338.9,40291,283629.9
292430,201712,515,401,114,375737,106349.5,482086.5
292440,201712,575,491,84,458868,78426.9,537294.9
292450,201712,242,188,54,176156,50598,226754
292460,201712,579,426,153,398599.9,142658.25,541258.15
292465,201712,189,158,31,148046,28322.24,176368.24
292467,201712,99,57,42,53409,39354,92763
292470,201712,250,169,81,158353,75897,234250
292480,201712,311,211,100,196770.75,93419,290189.75
292490,201712,222,145,77,135865,72149,208014
292500,201712,1178,509,669,476519,626403.35,1102922.35
292510,201712,3293,1479,1814,1384886.36,1697039.35,3081925.71
292520,201712,1042,497,545,464513.75,510656,975169.75
292525,201712,386,274,112,256733.32,104944,361677.32
292530,201712,4208,1724,2484,1612493.52,2325506.96,3938000.48
292540,201712,484,260,224,243620,209888,453508
292550,201712,1057,567,490,530549.6,458660.64,989210.24
292560,201712,318,299,19,280163,17803,297966
292570,201712,296,226,70,211439,65590,277029
292575,201712,458,289,169,270512,158353,428865
292580,201712,895,564,331,527062.5,309866,836928.5
292590,201712,504,434,70,406360.98,65590,471950.98
292593,201712,144,113,31,105881,29047,134928
292595,201712,176,133,43,124621,40291,164912
292600,201712,1239,923,316,864539,295436.1,1159975.1
292610,201712,125,95,30,89015,27857.01,116872.01
292620,201712,520,431,89,403557,83393,486950
292630,201712,1353,784,569,733048.5,531560.5,1264609.0
292640,201712,762,533,229,498983.55,214573,713556.55
292650,201712,176,150,26,140119,24362,164481
292660,201712,1982,1420,562,1324820.52,521623.96,1846444.48
292665,201712,138,99,39,92763,36543,129306
292670,201712,388,318,70,297962,65590,363552
292680,201712,247,190,57,178030,52941,230971
292690,201712,180,136,44,127432,41228,168660
292700,201712,910,596,314,557515.9,294218,851733.9
292710,201712,96,84,12,78708,10963,89671
292720,201712,828,466,362,435854.92,339007,774861.92
292730,201712,201,95,106,88078.75,99322,187400.75
292740,201712,65640,32464,33176,30345650.24,31056562.35,61402212.59
292750,201712,369,262,107,244557.07,99463.01,344020.08
292760,201712,316,255,61,237942.25,57157,295099.25
292770,201712,783,333,450,311700,421650,733350
292780,201712,424,161,263,150633.53,246431,397064.53
292790,201712,733,357,376,334509,352077.75,686586.75
292800,201712,1130,692,438,647467,410406,1057873
292805,201712,424,122,302,113798.65,282974,396772.65
292810,201712,1463,851,612,796543.9,573153.63,1369697.53
292820,201712,741,595,146,555642.3,136511.9,692154.2
292830,201712,103,82,21,76834,19677,96511
292840,201712,647,532,115,498016,107740.95,605756.95
292850,201712,136,92,44,86200,41228,127428
292860,201712,2100,1229,871,1147575.07,816127,1963702.07
292870,201712,3348,2237,1111,2094828.9,1040997.63,3135826.53
292880,201712,1428,939,489,875441.33,458193,1333634.33
292890,201712,470,403,67,377583,62779,440362
292895,201712,139,90,49,82995.71,45913,128908.71
292900,201712,388,288,100,269856,93700,363556
292905,201712,443,225,218,210825,204079,414904
292910,201712,389,300,89,280773,83393,364166
292920,201712,532,235,297,220195,278289,498484
292925,201712,508,472,36,441598.73,33479.75,475078.48
292930,201712,548,337,211,315769,197707,513476
292935,201712,297,127,170,118999,159290,278289
292937,201712,239,162,77,151794,72149,223943
292940,201712,188,143,45,133991,42165,176156
292950,201712,1099,566,533,528281.6,498485,1026766.6
292960,201712,535,358,177,335446,165849,501295
292970,201712,274,190,84,177375,78708,256083
292975,201712,156,88,68,82456,63529,145985
292980,201712,257,174,83,161286.42,77771,239057.42
292990,201712,1296,953,343,885757.28,321207.26,1206964.54
293000,201712,101,74,27,69338,25289.63,94627.63
293010,201712,2640,1621,1019,1512311.12,950837.48,2463148.60
293015,201712,645,506,139,473908.37,129616,603524.37
293020,201712,339,277,62,259549,58094,317643
293030,201712,619,539,80,503544.82,74960,578504.82
293040,201712,337,265,72,248305,67464,315769
293050,201712,2694,1572,1122,1463626.48,1047257.39,2510883.87
293060,201712,253,202,51,188010,46850.4,234860.4
293070,201712,3358,1693,1665,1577518.79,1558906.26,3136425.05
293075,201712,91,58,33,54346,30921,85267
293076,201712,72,46,26,43102,24362,67464
293077,201712,431,263,168,241997.04,157416,399413.04
293080,201712,447,396,51,371052,47787,418839
293090,201712,130,112,18,104038.23,16553.7,120591.93
293100,201712,513,361,152,338257,142424,480681
293105,201712,339,229,110,214292,103024.95,317316.95
293110,201712,166,117,49,109629,45913,155542
293120,201712,318,211,107,197707,100071.6,297778.6
293130,201712,248,164,84,153668,78708,232376
293135,201712,7887,3120,4767,2917429.45,4458294.97,7375724.42
293140,201712,179,115,64,107755,59219,166974
293150,201712,329,278,51,259081.1,47787,306868.1
293160,201712,432,242,190,226754,178030,404784
293170,201712,190,133,57,124339.9,52566,176905.9
293180,201712,459,311,148,291126,138676,429802
293190,201712,1263,874,389,814373.98,364493,1178866.98
293200,201712,525,463,62,432770,58094,490864
293210,201712,336,244,92,228479,85501.25,313980.25
293220,201712,2681,1075,1606,1005374.08,1502667.95,2508042.03
293230,201712,1771,634,1137,592653.9,1065088,1657741.9
293240,201712,220,201,19,188337,17803,206140
293245,201712,110,93,17,87141,15929,103070
293250,201712,741,277,464,258445.24,433782.29,692227.53
293260,201712,311,260,51,242683.89,47787,290470.89
293270,201712,1170,553,617,516288.48,578129,1094417.48
293280,201712,237,131,106,122747,99322,222069
293290,201712,3069,1991,1078,1863454.57,1009792,2873246.57
293300,201712,692,489,203,455902.29,189414.55,645316.84
293305,201712,148,126,22,118062,20614,138676
293310,201712,137,103,34,96511,31858,128369
293315,201712,155,119,36,111503,33732,145235
293317,201712,96,67,29,62779,27173,89952
293320,201712,953,537,416,502232.25,389792,892024.25
293325,201712,183,66,117,61842,109591.52,171433.52
293330,201712,12794,5956,6838,5570049.89,6399530.78,11969580.67
293340,201712,251,183,68,171471,62779,234250
293345,201712,245,194,51,181778,47787,229565
293350,201712,624,318,306,297966,285269.65,583235.65
293360,201712,1570,1116,454,1044474,424180.35,1468654.35
310010,201712,152,74,78,69338,72805,142143
310020,201712,1044,573,471,534407.6,439172.26,973579.86
310030,201712,322,260,62,242515.14,57812.9,300328.04
310040,201712,52,33,19,30921,17803,48724
310050,201712,180,116,64,107755.2,59968,167723.2
310060,201712,239,167,72,156011,67464,223475
310070,201712,17,8,9,7496,8433,15929
310080,201712,50,28,22,26236,20614,46850
310090,201712,957,500,457,463348.04,427084.8,890432.84
310100,201712,292,218,74,204266,69338,273604
310110,201712,727,389,338,363477.09,315769,679246.09
310120,201712,384,214,170,199862.1,158922.61,358784.71
310130,201712,34,21,13,19677,12181,31858
310140,201712,28,16,12,14992,11244,26236
310150,201712,1280,877,403,817627.81,377048.9,1194676.71
310160,201712,2106,1067,1039,991716.05,971200.6,1962916.65
310163,201712,91,49,42,45913,39354,85267
310170,201712,2530,1028,1502,963115,1404844.3,2367959.3
310180,201712,125,46,79,43102,73648.2,116750.2
310190,201712,483,322,161,301714,150294.8,452008.8
310200,201712,504,317,187,297029,175219,472248
310205,201712,59,45,14,42165,13118,55283
310210,201712,280,227,53,212699,49661,262360
310220,201712,51,31,20,29047,18740,47787
310230,201712,261,183,78,171283.6,72861.89,244145.49
310240,201712,104,91,13,85032.75,12181,97213.75
310250,201712,97,78,19,73086,17803,90889
310260,201712,802,429,373,398200.09,348779.51,746979.60
310270,201712,267,180,87,168117,81519,249636
310280,201712,364,272,92,254209,86204,340413
310285,201712,221,157,64,146806.35,59968,206774.35
310290,201712,256,147,109,137739,102133,239872
310300,201712,157,129,28,120873,26236,147109
310310,201712,6,4,2,3748,1874,5622
310320,201712,22,14,8,13118,7496,20614
310330,201712,31,23,8,21551,7496,29047
310340,201712,1700,1094,606,1017473.75,566323.25,1583797.00
310350,201712,2805,1514,1291,1413881.48,1209095.9,2622977.38
310360,201712,41,33,8,30921,7496,38417
310370,201712,122,100,22,93700,20333,114033
310375,201712,103,37,66,34669,61824,96493
310380,201712,52,30,22,28110,20614,48724
310390,201712,100,70,30,65590,28110,93700
310400,201712,2294,1486,808,1388541.5,756796.9,2145338.4
310410,201712,127,68,59,63716,55283,118999
310420,201712,670,360,310,335072.4,289524.43,624596.83
310430,201712,333,220,113,205858.9,105881,311739.9
310440,201712,66,39,27,36543,25299,61842
310445,201712,84,67,17,62779,15929,78708
310450,201712,858,539,319,504387.1,298903,803290.1
310460,201712,267,192,75,179904,70275,250179
310470,201712,492,309,183,289533,171471,461004
310480,201712,75,53,22,49661,20614,70275
310490,201712,483,226,257,210825.1,240809,451634.1
310500,201712,127,56,71,52472,66527,118999
310510,201712,606,395,211,368897.8,197688.63,566586.43
310520,201712,130,87,43,81519,40291,121810
310530,201712,88,40,48,37480,44694.9,82174.9
310540,201712,454,281,173,260956.3,162101,423057.3
310550,201712,85,55,30,51535,28110,79645
310560,201712,2903,2002,901,1866225.5,842686.27,2708911.77
310570,201712,137,92,45,86204,42165,128369
310590,201712,338,223,115,208530,107740.95,316270.95
310600,201712,158,91,67,83533.85,62779,146312.85
310610,201712,59,21,38,19677,35606,55283
310620,201712,45356,21670,23686,20230817.46,22154649.18,42385466.64
310630,201712,588,377,211,350579.3,196239.71,546819.01
310640,201712,135,113,22,105693.6,20614,126307.6
310650,201712,159,139,20,129306,18740,148046
310660,201712,90,56,34,52472,31858,84330
310665,201712,55,40,15,37480,14055,51535
310670,201712,6265,2924,3341,2731104.06,3125816.15,5856920.21
310680,201712,53,35,18,32795,16866,49661
310690,201712,590,427,163,395969.73,152731,548700.73
310700,201712,63,40,23,37480,21410.45,58890.45
310710,201712,1242,827,415,773667.32,388292.9,1161960.22
310720,201712,85,28,57,26236,53409,79645
310730,201712,1368,945,423,885184,396351,1281535
310740,201712,1017,566,451,526967.2,422343.63,949310.83
310750,201712,245,143,102,133054.29,95574,228628.29
310760,201712,68,52,16,48724,14992,63716
310770,201712,93,45,48,42165,44976,87141
310780,201712,402,328,74,307327,69338,376665
310790,201712,99,80,19,74960,17803,92763
310800,201712,459,223,236,208482.5,220850.9,429333.4
310810,201712,165,116,49,107371.1,44976,152347.1
310820,201712,362,285,77,267045,71867.9,338912.9
310825,201712,191,157,34,147109,31858,178967
310830,201712,459,219,240,204554.61,224411.17,428965.78
310840,201712,387,220,167,205956,156479,362435
310850,201712,110,89,21,83393,19677,103070
310855,201712,375,295,80,276415,74960,351375
310860,201712,1386,1037,349,966298.05,325308.95,1291607.00
310870,201712,55,43,12,40291,11244,51535
310880,201712,81,63,18,58749.9,16866,75615.9
310890,201712,311,183,128,171471,119936,291407
310900,201712,637,293,344,271669.3,322028.9,593698.2
310910,201712,251,170,81,157979.1,75897,233876.1
310920,201712,485,290,195,267983.1,181778.7,449761.8
310925,201712,34,27,7,25299,6278,31577
310930,201712,1094,654,440,612401.42,412185.88,1024587.30
310940,201712,679,348,331,325485.9,310147,635632.9
310945,201712,117,72,45,67464,42165,109629
310950,201712,252,196,56,183652,52472,236124
310960,201712,87,32,55,29984,51531,81515
310970,201712,166,103,63,96511,58125.2,154636.2
310980,201712,44,24,20,22488,18740,41228
310990,201712,151,84,67,78427,62779,141206
311000,201712,828,421,407,391012.9,381350,772362.9
311010,201712,39,32,7,29984,6559,36543
311020,201712,41,26,15,24362,14055,38417
311030,201712,392,229,163,212700,152731,365431
311040,201712,38,33,5,30921,4685,35606
311050,201712,467,196,271,183090,253364.8,436454.8
311060,201712,752,433,319,404316.2,298622,702938.2
311070,201712,332,147,185,137739,173345,311084
311080,201712,107,59,48,55283,44976,100259
311090,201712,397,186,211,173345,197707,371052
311100,201712,617,367,250,343597.9,233968.9,577566.8
311110,201712,679,468,211,438234.9,197698,635932.9
311115,201712,66,48,18,44976,16866,61842
311120,201712,1018,532,486,497497.4,454772.95,952270.35
311130,201712,406,237,169,221881.6,158353,380234.6
311140,201712,160,76,84,71212,77911.55,149123.55
311150,201712,355,232,123,217384,115016.75,332400.75
311160,201712,739,535,204,498953.2,190680,689633.2
311170,201712,80,58,22,54346,20332.9,74678.9
311180,201712,336,223,113,208669.9,105600,314269.9
311190,201712,33,17,16,15929,14992,30921
311200,201712,337,233,104,216728.3,97448,314176.3
311205,201712,29,19,10,17568.75,8995.2,26563.95
311210,201712,49,41,8,38136,7496,45632
311220,201712,15,13,2,12181,1874,14055
311230,201712,1630,1057,573,987338.65,536901,1524239.65
311240,201712,166,105,61,98184.96,57157,155341.96
311250,201712,75,32,43,29984,40291,70275
311260,201712,556,348,208,326076,194896,520972
311265,201712,111,76,35,71212,32795,104007
311270,201712,283,201,82,188337,76834,265171
311280,201712,214,99,115,92763,107192.8,199955.8
311290,201712,109,88,21,82351,19115,101466
311300,201712,546,343,203,320454.88,189793,510247.88
311310,201712,24,19,5,17803,4685,22488
311320,201712,672,504,168,471311,157416,628727
311330,201712,1026,759,267,710855.75,249242.7,960098.45
311340,201712,2611,1859,752,1735242.82,704221.83,2439464.65
311350,201712,271,210,61,196770,57157,253927
311360,201712,177,107,70,100259,65590,165849
311370,201712,1196,482,714,449679.25,668455.8,1118135.05
311380,201712,7,6,1,5622,937,6559
311390,201712,278,148,130,138676,121341.6,260017.6
311400,201712,149,97,52,90889,48715,139604
311410,201712,94,54,40,50598,37480,88078
311420,201712,292,160,132,148983.05,123684,272667.05
311430,201712,856,556,300,519943,281100,801043
311440,201712,484,338,146,316706,136520.9,453226.9
311450,201712,315,195,120,182715,112440,295155
311455,201712,306,204,102,190857.9,95292.9,286150.8
311460,201712,127,51,76,47787,70139.83,117926.83
311470,201712,20,10,10,9370,9370,18740
311480,201712,23,9,14,8433,13118,21551
311490,201712,16,9,7,8433,6559,14992
311500,201712,20,10,10,9370,9370,18740
311510,201712,625,438,187,408498.85,174937.9,583436.75
311520,201712,45,33,12,30265.1,11244,41509.1
311530,201712,1818,1348,470,1254768.56,440390,1695158.56
311535,201712,65,51,14,47787,13118,60905
311540,201712,33,29,4,27173,3748,30921
311545,201712,184,137,47,128369,44039,172408
311547,201712,30,21,9,19677,8433,28110
311550,201712,615,281,334,263297,312939.63,576236.63
311560,201712,42,28,14,26236,13118,39354
311570,201712,301,198,103,184963.8,96511,281474.8
311580,201712,303,175,128,163693.9,119936,283629.9
311590,201712,32,28,4,26236,3748,29984
311600,201712,89,70,19,65590,17803,83393
311610,201712,260,227,33,211449.95,30921,242370.95
311615,201712,96,80,16,74332.21,14992,89324.21
311620,201712,18,11,7,10307,6559,16866
311630,201712,84,71,13,66527,12181,78708
311640,201712,118,66,52,61842,48724,110566
311650,201712,128,95,33,88312.25,30921,119233.25
311660,201712,404,192,212,179904,198644,378548
311670,201712,164,105,59,98145,55283,153428
311680,201712,223,162,61,150908.97,56407.4,207316.37
311690,201712,17,10,7,9370,6559,15929
311700,201712,197,136,61,127150.9,57157,184307.9
311710,201712,216,138,78,129306,73086,202392
311720,201712,38,28,10,26236,9370,35606
311730,201712,547,359,188,335821,176156,511977
311740,201712,35,24,11,22488,10307,32795
311750,201712,707,482,225,449760.4,210825,660585.4
311760,201712,64,36,28,33732,26236,59968
311770,201712,402,194,208,179904.61,194896,374800.61
311780,201712,168,96,72,89952,67152,157104
311783,201712,77,68,9,63716,8433,72149
311787,201712,37,17,20,15929,18740,34669
311790,201712,269,129,140,120873,131180,252053
311800,201712,636,437,199,406144.15,186463,592607.15
311810,201712,44,36,8,33732,7496,41228
311820,201712,106,88,18,82456,16866,99322
311830,201712,1862,1194,668,1113270.25,622637.4,1735907.65
311840,201712,1007,560,447,520504.95,417115.77,937620.72
311850,201712,8,5,3,4685,2811,7496
311860,201712,9395,4295,5100,4008654.55,4770345.33,8778999.88
311870,201712,154,85,69,79645,64653,144298
311880,201712,947,707,240,661231.9,224880,886111.9
311890,201712,221,113,108,105881,101196,207077
311900,201712,89,36,53,33732,49661,83393
311910,201712,1371,851,520,794530.05,485038.15,1279568.20
311920,201712,225,147,78,137505,73086,210591
311930,201712,906,522,384,488833,359292.9,848125.9
311940,201712,2411,1232,1179,1152089.35,1101958.95,2254048.30
311950,201712,30,21,9,19677,8433,28110
311960,201712,68,48,20,44976,18740,63716
311970,201712,24,14,10,13118,9370,22488
311980,201712,43,32,11,29984,10307,40291
311990,201712,58,43,15,40291,14055,54346
311995,201712,62,43,19,40291,17803,58094
312000,201712,33,22,11,20332.9,10307,30639.9
312010,201712,85,62,23,58094,21551,79645
312015,201712,97,71,26,66246,24362,90608
312020,201712,137,84,53,78708,49661,128369
312030,201712,41,34,7,30922,6559,37481
312040,201712,79,51,28,47787,26236,74023
312050,201712,226,117,109,109629,102133,211762
312060,201712,65,40,25,37480,22769.1,60249.1
312070,201712,76,44,32,41228,29984,71212
312080,201712,527,227,300,212699,281100,493799
312083,201712,48,35,13,32795,12181,44976
312087,201712,108,86,22,80582,20614,101196
312090,201712,2811,1591,1220,1476247.61,1138594.88,2614842.49
312100,201712,161,113,48,105881,44208,150089
312110,201712,117,74,43,69338,40291,109629
312120,201712,144,105,39,98385,36543,134928
312125,201712,93,53,40,49473.6,37480,86953.6
312130,201712,123,82,41,76834,38417,115251
312140,201712,133,105,28,98385,26236,124621
312150,201712,43,35,8,32795,7496,40291
312160,201712,1523,1014,509,946746.84,475546.44,1422293.28
312170,201712,11,9,2,8433,1874,10307
312180,201712,106,65,41,60203,38136,98339
312190,201712,33,29,4,27173,3748,30921
312200,201712,727,627,100,585578.35,93700,679278.35
312210,201712,99,63,36,59031,33732,92763
312220,201712,120,90,30,84096,28110,112206
312230,201712,3436,1689,1747,1578874.79,1635358.86,3214233.65
312235,201712,139,92,47,86204,44039,130243
312240,201712,110,71,39,66527,36543,103070
312245,201712,159,106,53,99318,49661,148979
312247,201712,55,39,16,35794,14992,50786
312250,201712,184,87,97,81051,90889,171940
312260,201712,101,68,33,62873.6,30921,93794.6
312270,201712,137,86,51,80582,47787,128369
312280,201712,25,15,10,14055,9370,23425
312290,201712,160,110,50,102788.9,45914,148702.9
312300,201712,201,134,67,125558,62779,188337
312310,201712,58,53,5,49661,4685,54346
312320,201712,422,264,158,245494,146781.25,392275.25
312330,201712,86,75,11,69526,10025.9,79551.9
312340,201712,36,16,20,14992,18740,33732
312350,201712,16,10,6,9370,5622,14992
312352,201712,96,65,31,60905,29047,89952
312360,201712,562,254,308,237061,288596,525657
312370,201712,294,175,119,163693.9,111503,275196.9
312380,201712,138,88,50,82456,46850,129306
312385,201712,182,147,35,137739,32795,170534
312390,201712,297,188,109,176156,101478,277634
312400,201712,379,286,93,267982,86673,354655
312410,201712,855,272,583,254395.5,545705,800100.5
312420,201712,603,484,119,452852.1,111503,564355.1
312430,201712,858,632,226,589609.94,210825.1,800435.04
312440,201712,45,33,12,30921,11244,42165
312450,201712,211,131,80,122747,74960,197707
312460,201712,57,28,29,26236,27173,53409
312470,201712,56,35,21,32795,19677,52472
312480,201712,211,129,82,120873,76834,197707
312490,201712,251,172,79,161164,74023,235187
312500,201712,32,18,14,16866,13118,29984
312510,201712,418,156,262,146172,244889.36,391061.36
312520,201712,40,14,26,13118,24362,37480
312530,201712,48,36,12,33732,11244,44976
312540,201712,100,87,13,81519,12181,93700
312550,201712,40,31,9,29047,8433,37480
312560,201712,197,141,56,131836,52190.9,184026.9
312570,201712,440,264,176,246712.1,164233.23,410945.33
312580,201712,84,44,40,41228,37480,78708
312590,201712,273,216,57,202018,53409,255427
312595,201712,146,131,15,122747,14055,136802
312600,201712,75,46,29,42681,27173,69854
312610,201712,1621,844,777,785583.29,726550.3,1512133.59
312620,201712,188,130,58,121810,54341.32,176151.32
312630,201712,65,54,11,50598,10307,60905
312640,201712,46,13,33,12181,30921,43102
312650,201712,146,118,28,110285,25955,136240
312660,201712,69,52,17,48443,15929,64372
312670,201712,864,566,298,528796.95,279016.15,807813.10
312675,201712,42,31,11,29047,10307,39354
312680,201712,86,60,26,55845.2,24362,80207.2
312690,201712,242,129,113,120863.63,105599.9,226463.53
312695,201712,31,24,7,22488,6559,29047
312700,201712,206,120,86,112440,80582,193022
312705,201712,71,60,11,56220,10307,66527
312707,201712,95,70,25,64896.72,23425,88321.72
312710,201712,1850,987,863,923130,808423,1731553
312720,201712,65,33,32,30921,29984,60905
312730,201712,288,170,118,158353,110284.9,268637.9
312733,201712,50,43,7,40291,6559,46850
312735,201712,22,16,6,14992,5622,20614
312737,201712,69,37,32,34669,29984,64653
312738,201712,53,37,16,34669,14992,49661
312740,201712,69,48,21,44976,19677,64653
312750,201712,72,52,20,48724,18740,67464
312760,201712,272,198,74,185526,69338,254864
312770,201712,7662,3535,4127,3290048.99,3858489.07,7148538.06
312780,201712,433,335,98,313613.9,91826,405439.9
312790,201712,20,15,5,14055,4685,18740
312800,201712,1585,1113,472,1034081.78,441103.11,1475184.89
312810,201712,372,239,133,223662,124621,348283
312820,201712,193,146,47,136802,44039,180841
312825,201712,27,19,8,17803,7496,25299
312830,201712,284,162,122,150577,113687,264264
312840,201712,149,110,39,103070,36543,139613
312850,201712,24,22,2,20614,1874,22488
312860,201712,172,108,64,100915,59968,160883
312870,201712,978,514,464,478869.85,434768,913637.85
312880,201712,150,104,46,97307.45,43008.3,140315.75
312890,201712,163,111,52,104007,48724,152731
312900,201712,212,157,55,146453.1,51535,197988.1
312910,201712,183,91,92,84117.66,86204,170321.66
312920,201712,156,87,69,81519,64653,146172
312930,201712,341,247,94,231439,88078,319517
312940,201712,103,70,33,65590,30921,96511
312950,201712,694,455,239,425023.3,223943,648966.3
312960,201712,176,133,43,124621,40291,164912
312965,201712,49,44,5,41228,4685,45913
312970,201712,279,224,55,208951.1,51535,260486.1
312980,201712,2305,1233,1072,1150442.1,1003897.8,2154339.9
312990,201712,50,29,21,27173,19677,46850
313000,201712,39,25,14,23425,13118,36543
313005,201712,164,125,39,116150.75,36262,152412.75
313010,201712,930,387,543,361400.9,508500.9,869901.8
313020,201712,189,99,90,92294.5,84330,176624.5
313030,201712,207,133,74,122748,69338,192086
313040,201712,59,22,37,20614,34669,55283
313050,201712,296,206,90,192085.1,84330,276415.1
313055,201712,46,33,13,30921,12181,43102
313060,201712,126,83,43,77771,40009.9,117780.9
313065,201712,60,39,21,36543,19677,56220
313070,201712,155,84,71,78708,66527,145235
313080,201712,39,17,22,15929,20614,36543
313090,201712,703,483,220,450603.4,206140,656743.4
313100,201712,165,64,101,59968,94629,154597
313110,201712,123,72,51,67464,47787,115251
313115,201712,157,85,72,79448.23,66527,145975.23
313120,201712,750,406,344,380141,320829,700970
313130,201712,5130,2760,2370,2561355.23,2211454.42,4772809.65
313140,201712,163,86,77,80582,72149,152731
313150,201712,315,252,63,236124,58749.9,294873.9
313160,201712,192,137,55,128369,51535,179904
313170,201712,1330,939,391,867710.94,365983.2,1233694.14
313180,201712,327,192,135,179266.84,126495,305761.84
313190,201712,720,423,297,393633.7,277540,671173.7
313200,201712,23,22,1,20614,937,21551
313210,201712,1038,872,166,814114.48,155537.32,969651.80
313220,201712,234,161,73,149920,67698.25,217618.25
313230,201712,273,199,74,185527,69338,254865
313240,201712,1911,1025,886,958637.07,826710.52,1785347.59
313250,201712,1239,906,333,844064.61,309212.4,1153277.01
313260,201712,91,53,38,49661,35606,85267
313270,201712,952,556,396,516989.77,371052,888041.77
313280,201712,60,52,8,48255.51,7496,55751.51
313290,201712,224,181,43,169316,39354.9,208670.9
313300,201712,371,185,186,171416.01,174282,345698.01
313310,201712,222,115,107,107755,100259,208014
313320,201712,368,285,83,265124.55,77771,342895.55
313330,201712,1349,804,545,751943.6,509494.75,1261438.35
313340,201712,334,228,106,213636,99322,312958
313350,201712,525,351,174,327013.05,163038,490051.05
313360,201712,113,67,46,62779,42821,105600
313370,201712,194,75,119,70275,111503,181778
313375,201712,268,158,110,148046,103070,251116
313380,201712,1259,635,624,593139.74,584121.9,1177261.64
313390,201712,47,39,8,35606.4,7496,43102.4
313400,201712,420,271,149,253927,139332,393259
313410,201712,21,12,9,11244,8433,19677
313420,201712,4659,2400,2259,2239967.29,2109834.81,4349802.10
313430,201712,134,62,72,58094,67464,125558
313440,201712,1454,977,477,913997.65,446106,1360103.65
313450,201712,63,27,36,25299,33450.9,58749.9
313460,201712,373,173,200,160683,187400,348083
313470,201712,527,237,290,222069,271074.1,493143.1
313480,201712,161,110,51,102134,47787,149921
313490,201712,508,246,262,230497.32,245448,475945.32
313500,201712,20,12,8,11244,7496,18740
313505,201712,951,738,213,690350.9,199581,889931.9
313507,201712,89,52,37,48724,34669,83393
313510,201712,2759,1778,981,1660324.34,918260,2578584.34
313520,201712,3589,2803,786,2614521.19,736478,3350999.19
313530,201712,41,28,13,26236,12181,38417
313535,201712,105,84,21,78053,19677,97730
313540,201712,71,54,17,50598,15929,66527
313545,201712,107,87,20,81519,18740,100259
313550,201712,234,190,44,178030,40947,218977
313560,201712,329,173,156,162101,146172,308273
313570,201712,58,31,27,29047,25299,54346
313580,201712,1289,696,593,649622.1,553954.7,1203576.8
313590,201712,82,49,33,45913,30921,76834
313600,201712,688,410,278,384170,259643,643813
313610,201712,55,43,12,39682.9,11244,50926.9
313620,201712,1332,708,624,653681.26,581277.5,1234958.76
313630,201712,1629,1252,377,1171326,352968,1524294
313640,201712,125,71,54,66527,50598,117125
313650,201712,235,108,127,101196,118999,220195
313652,201712,15,14,1,13118,937,14055
313655,201712,52,31,21,29047,19677,48724
313657,201712,45,41,4,38417,3748,42165
313660,201712,128,91,37,85267,34669,119936
313665,201712,626,311,315,291407,294920.75,586327.75
313670,201712,10168,7056,3112,6587545.23,2915100.9,9502646.13
313680,201712,40,29,11,27173,10307,37480
313690,201712,160,122,38,114314,35606,149920
313695,201712,63,48,15,44976,14055,59031
313700,201712,290,232,58,217103,54346,271449
313710,201712,150,101,49,94637,45913,140550
313720,201712,1033,492,541,458286.8,505596.83,963883.63
313730,201712,59,41,18,38417,16866,55283
313740,201712,164,129,35,120873,32795,153668
313750,201712,441,320,121,299558.9,113377,412935.9
313753,201712,242,170,72,158634.1,67464,226098.1
313760,201712,1212,433,779,405721,727235.56,1132956.56
313770,201712,354,251,103,235187,96511,331698
313780,201712,752,384,368,359808,344534.9,704342.9
313790,201712,27,26,1,24362,937,25299
313800,201712,144,88,56,82456,52472,134928
313810,201712,61,37,24,34669,22488,57157
313820,201712,1277,635,642,594058.1,600594.1,1194652.2
313830,201712,66,50,16,46850,14992,61842
313835,201712,51,46,5,43102,4685,47787
313840,201712,1663,1021,642,950839.79,600336,1551175.79
313850,201712,179,61,118,57157,109996.39,167153.39
313860,201712,484,378,106,350767.65,98385.55,449153.20
313862,201712,174,114,60,106818,56220,163038
313865,201712,82,64,18,59968,16866,76834
313867,201712,49,37,12,34669,11244,45913
313868,201712,25,16,9,14243,8433,22676
313870,201712,123,65,58,60905,54346,115251
313880,201712,338,216,122,201829.9,113751.9,315581.8
313890,201712,316,169,147,157603.9,137176.8,294780.7
313900,201712,917,496,421,463160.25,394431,857591.25
313910,201712,136,95,41,89015,37480.1,126495.1
313920,201712,607,431,176,403659.6,164912,568571.6
313925,201712,34,29,5,27173,4685,31858
313930,201712,789,605,184,566885,172385,739270
313940,201712,1756,1102,654,1028170.2,612142.2,1640312.4
313950,201712,936,600,336,560420.8,314550.9,874971.7
313960,201712,1388,796,592,741664.65,553486,1295150.65
313970,201712,121,85,36,79645,33732,113377
313980,201712,210,137,73,128135,68401,196536
313990,201712,360,217,143,202766.8,133913.22,336680.02
314000,201712,913,619,294,576584.45,275473.32,852057.77
314010,201712,77,50,27,46850,25299,72149
314015,201712,51,15,36,14055,33732,47787
314020,201712,49,33,16,30921,14898.3,45819.3
314030,201712,90,42,48,38913.61,44976,83889.61
314040,201712,42,30,12,28110,11244,39354
314050,201712,313,183,130,171190,120357.65,291547.65
314053,201712,101,66,35,60905.2,32795,93700.2
314055,201712,298,173,125,162101,117125,279226
314060,201712,146,123,23,114314,21551,135865
314070,201712,951,469,482,435434.67,450744,886178.67
314080,201712,216,142,74,131601.9,68308.14,199910.04
314085,201712,123,82,41,76834,38417,115251
314090,201712,342,248,94,232376,88073.32,320449.32
314100,201712,471,386,85,357935,79083,437018
314110,201712,687,372,315,346699.37,294452.8,641152.17
314120,201712,99,54,45,50598,42165,92763
314130,201712,26,12,14,11244,13118,24362
314140,201712,1095,654,441,610436.86,411343.23,1021780.09
314150,201712,168,105,63,98385,59031,157416
314160,201712,358,261,97,241520.24,90702,332222.24
314170,201712,70,52,18,47974.4,16866,64840.4
314180,201712,721,628,93,588155,86204.25,674359.25
314190,201712,101,60,41,56220,38417,94637
314200,201712,588,405,183,377955.7,170534,548489.7
314210,201712,276,206,70,192085,65309,257394
314220,201712,312,236,76,219259,70931,290190
314225,201712,64,44,20,41228,18740,59968
314230,201712,102,46,56,43102,52472,95574
314240,201712,140,106,34,99322,31858,131180
314250,201712,60,36,24,33732,22488,56220
314260,201712,187,96,91,89952,85267,175219
314270,201712,332,258,74,240997,69057,310054
314280,201712,686,384,302,359799,282974,642773
314290,201712,554,443,111,413873.25,103725.9,517599.15
314300,201712,414,295,119,273531.5,111457,384988.5
314310,201712,1429,954,475,891744.36,444774.33,1336518.69
314315,201712,33,26,7,24362,6559,30921
314320,201712,597,379,218,354560.9,203357.11,557918.01
314330,201712,10674,5373,5301,5022564.27,4962640.69,9985204.96
314340,201712,569,262,307,244931.9,287097,532028.9
314345,201712,27,21,6,19677,5622,25299
314350,201712,188,116,72,108692,67464,176156
314360,201712,77,46,31,43102,29047,72149
314370,201712,58,48,10,44976,9370,54346
314380,201712,91,65,26,60905,24362,85267
314390,201712,3166,1996,1170,1866015.13,1093385.7,2959400.83
314400,201712,685,492,193,458185.1,180841,639026.1
314410,201712,420,268,152,251116,142424,393540
314420,201712,19,8,11,7496,10307,17803
314430,201712,2505,896,1609,835587.15,1504995.79,2340582.94
314435,201712,270,155,115,144953.9,106818,251771.9
314437,201712,26,20,6,18740,5622,24362
314440,201712,98,70,28,65590,26236,91826
314450,201712,151,116,35,108692,32795,141487
314460,201712,662,304,358,284848,335446,620294
314465,201712,81,56,25,52472,23425,75897
314467,201712,66,56,10,52463,9370,61833
314470,201712,378,193,185,177451.06,172408.75,349859.81
314480,201712,1040,506,534,474122,500170.6,974292.6
314490,201712,87,66,21,61842,19677,81519
314500,201712,318,208,110,194896,103070,297966
314505,201712,131,83,48,77771,44976,122747
314510,201712,226,181,45,169316,42165,211481
314520,201712,1220,632,588,585066.85,549035.45,1134102.30
314530,201712,693,547,146,511735,136802,648537
314535,201712,208,130,78,120779.3,72839.48,193618.78
314537,201712,61,36,25,33732,23425,57157
314540,201712,13,9,4,8433,3748,12181
314545,201712,51,34,17,31858,15929,47787
314550,201712,78,42,36,39354,33732,73086
314560,201712,802,431,371,401692,347627,749319
314570,201712,22,17,5,15929,4685,20614
314580,201712,18,9,9,8433,8433,16866
314585,201712,20,14,6,13118,5622,18740
314587,201712,84,72,12,67464,11244,78708
314590,201712,547,403,144,377611,134928,512539
314600,201712,998,646,352,600704.29,327575.4,928279.69
314610,201712,933,517,416,481899.45,388667.6,870567.05
314620,201712,146,108,38,99415.8,35606,135021.8
314625,201712,96,72,24,66902,22488,89390
314630,201712,1236,636,600,594479.65,561918.9,1156398.55
314640,201712,90,60,30,56220,28110,84330
314650,201712,206,121,85,112346.8,79176.5,191523.3
314655,201712,65,51,14,47787,13118,60905
314660,201712,18,14,4,13118,3748,16866
314670,201712,185,147,38,137458,35606,173064
314675,201712,213,119,94,111503,88078,199581
314690,201712,536,297,239,278007.9,223943,501950.9
314700,201712,2426,1322,1104,1233374.6,1033557.95,2266932.55
314710,201712,1632,954,678,888851.95,634676.95,1523528.90
314720,201712,410,242,168,225376.61,157416,382792.61
314730,201712,503,273,230,254396,215501,469897
314740,201712,683,335,348,312255.25,326076,638331.25
314750,201712,22,19,3,17803,2811,20614
314760,201712,306,151,155,141487,145225.63,286712.63
314770,201712,119,83,36,77771,33732,111503
314780,201712,21,6,15,5622,14055,19677
314790,201712,2329,1453,876,1354894.85,820146.73,2175041.58
314795,201712,51,44,7,40994,6559,47553
314800,201712,2899,1693,1206,1581148.46,1128420.1,2709568.56
314810,201712,1499,829,670,774478.25,625510.36,1399988.61
314820,201712,90,50,40,46850,37480,84330
314830,201712,210,164,46,152965.75,42821,195786.75
314840,201712,85,50,35,46850,32795,79645
314850,201712,348,170,178,159290,166786,326076
314860,201712,709,534,175,498390.79,162476.35,660867.14
314870,201712,1436,732,704,684947.5,659648,1344595.5
314875,201712,59,51,8,47787,7496,55283
314880,201712,45,32,13,29984,12181,42165
314890,201712,52,31,21,29047,19677,48724
314900,201712,30,25,5,23425,4685,28110
314910,201712,257,172,85,160882.9,79645,240527.9
314915,201712,152,134,18,125324,16866,142190
314920,201712,121,75,46,70275,42820.9,113095.9
314930,201712,1019,518,501,483541,469155.9,952696.9
314940,201712,53,41,12,38417,11244,49661
314950,201712,38,28,10,25533.25,9370,34903.25
314960,201712,60,44,16,41228,14992,56220
314970,201712,135,67,68,62217,63716,125933
314980,201712,307,201,106,186135.05,98385,284520.05
314990,201712,468,257,211,240809,196817.75,437626.75
314995,201712,198,65,133,60905,124611.63,185516.63
315000,201712,84,68,16,63716,14992,78708
315010,201712,47,31,16,29047,14992,44039
315015,201712,172,139,33,129530.88,30921,160451.88
315020,201712,63,54,9,50598,8433,59031
315030,201712,119,91,28,84331,26236,110567
315040,201712,66,49,17,45913,15929,61842
315050,201712,198,117,81,109629,75897,185526
315053,201712,40,35,5,32795,4685,37480
315057,201712,97,80,17,74397.47,15929,90326.47
315060,201712,69,63,6,57157.98,5622,62779.98
315070,201712,104,58,46,54346,43102,97448
315080,201712,372,306,66,286722,61842,348564
315090,201712,106,64,42,59968,39354,99322
315100,201712,72,38,34,35606,31858,67464
315110,201712,289,160,129,149077,120873,269950
315120,201712,1631,824,807,768200.1,754988,1523188.1
315130,201712,324,236,88,221132,82456,303588
315140,201712,533,311,222,289814.1,208014,497828.1
315150,201712,979,461,518,431021,485085,916106
315160,201712,207,105,102,98385,95574,193959
315170,201712,343,222,121,207078,113095.9,320173.9
315180,201712,3220,1367,1853,1277366.15,1733123.6,3010489.75
315190,201712,315,182,133,170160,124621,294781
315200,201712,1180,669,511,625073.1,477963.7,1103036.8
315210,201712,1542,874,668,814629.35,623540.6,1438169.95
315213,201712,42,26,16,24362,14992,39354
315217,201712,194,153,41,143361,38417,181778
315220,201712,1490,1137,353,1064760.3,330667.3,1395427.6
315230,201712,172,125,47,116844,44039,160883
315240,201712,422,272,150,254864,139370.25,394234.25
315250,201712,2523,1249,1274,1169469.8,1193448.23,2362918.03
315260,201712,148,90,58,83018.2,54346,137364.2
315270,201712,128,86,42,80019.8,38641.88,118661.68
315280,201712,685,446,239,417528,223933.63,641461.63
315290,201712,193,114,79,106818,73086.34,179904.34
315300,201712,72,46,26,43102,24362,67464
315310,201712,65,58,7,54346,6559,60905
315320,201712,158,86,72,80582,67464,148046
315330,201712,55,47,8,44039,7496,51535
315340,201712,420,297,123,276846.7,115251,392097.7
315350,201712,142,86,56,80582,52472,133054
315360,201712,96,51,45,47787,42165,89952
315370,201712,56,33,23,30921,21410.45,52331.45
315380,201712,12,7,5,6559,4685,11244
315390,201712,55,13,42,12181,39354,51535
315400,201712,819,615,204,570915.25,190492.1,761407.35
315410,201712,349,209,140,195552,130900,326452
315415,201712,58,44,14,41228,13118,54346
315420,201712,203,151,52,140737.5,48724,189461.5
315430,201712,677,401,276,374800.1,258143.9,632944.0
315440,201712,81,58,23,54346,21551,75897
315445,201712,256,205,51,191775.79,47787,239562.79
315450,201712,193,148,45,138676,42165,180841
315460,201712,3345,1700,1645,1588351.9,1538967.05,3127318.95
315470,201712,46,23,23,21270,21551,42821
315480,201712,61,23,38,21551,35606,57157
315490,201712,612,379,233,353108.45,218321,571429.45
315500,201712,20,12,8,11244,7496,18740
315510,201712,153,100,53,93700,49661,143361
315520,201712,71,62,9,58094,8433,66527
315530,201712,52,29,23,27173,21551,48724
315540,201712,242,157,85,147109,79645,226754
315550,201712,179,143,36,133991,33732,167723
315560,201712,747,593,154,554324.9,144298,698622.9
315570,201712,309,167,142,153734.52,133054,286788.52
315580,201712,652,426,226,399162,211762,610924
315590,201712,210,108,102,101196,95574,196770
315600,201712,297,216,81,201455,75710,277165
315610,201712,98,49,49,45913,45913,91826
315620,201712,32,25,7,23425,6559,29984
315630,201712,139,91,48,85267,44976,130243
315640,201712,57,33,24,30921,22488,53409
315645,201712,64,45,19,42165,17335,59500
315650,201712,167,121,46,113096,43102,156198
315660,201712,477,201,276,188337,258612,446949
315670,201712,2310,1179,1131,1101987.96,1058595.73,2160583.69
315680,201712,847,569,278,529650.81,259773.88,789424.69
315690,201712,694,474,220,443083.63,206140,649223.63
315700,201712,1903,1006,897,938818.39,840489,1779307.39
315710,201712,323,81,242,75897,226754,302651
315720,201712,431,276,155,258612,145235,403847
315725,201712,202,162,40,151794,37480,189274
315727,201712,41,22,19,20614,17803,38417
315730,201712,42,40,2,37480,1874,39354
315733,201712,87,56,31,52472,29047,81519
315737,201712,51,37,14,34669,13118,47787
315740,201712,43,38,5,35606,4685,40291
315750,201712,159,126,33,118062,30921,148983
315760,201712,46,31,15,29047,14055,43102
315765,201712,116,75,41,70275,38417,108692
315770,201712,229,136,93,127432,86860,214292
315780,201712,3266,1704,1562,1589971.75,1461252.41,3051224.16
315790,201712,207,160,47,149920,43476.8,193396.8
315800,201712,284,206,78,193022,73086,266108
315810,201712,94,54,40,50598,37199,87797
315820,201712,789,568,221,529968.77,207077,737045.77
315830,201712,146,82,64,76834,59968,136802
315840,201712,88,60,28,56220,26236,82456
315850,201712,260,190,70,178030,65590,243620
315860,201712,12,4,8,3748,7496,11244
315870,201712,34,27,7,25299,6559,31858
315880,201712,105,69,36,64653,33732,98385
315890,201712,75,57,18,53409,16866,70275
315895,201712,426,279,147,260206,137177,397383
315900,201712,70,33,37,30921,34669,65590
315910,201712,38,24,14,22253.75,13118,35371.75
315920,201712,184,120,64,112440,59031.95,171471.95
315930,201712,39,14,25,13118,23425,36543
315935,201712,148,116,32,108692,29975,138667
315940,201712,89,68,21,63716,19677,83393
315950,201712,67,48,19,44976,17803,62779
315960,201712,557,259,298,242045.94,278663.9,520709.84
315970,201712,38,30,8,28110,7496,35606
315980,201712,697,320,377,298582.1,353239.63,651821.73
315990,201712,247,150,97,140550,90608,231158
316000,201712,50,31,19,29047,17803,46850
316010,201712,74,62,12,58094,11244,69338
316020,201712,107,88,19,82456,17803,100259
316030,201712,404,208,196,194896,183137,378033
316040,201712,494,218,276,203985,258331,462316
316045,201712,60,53,7,49661,6559,56220
316050,201712,16,14,2,13118,1874,14992
316060,201712,94,61,33,56875.9,30921,87796.9
316070,201712,1030,661,369,613083.25,345004,958087.25
316080,201712,104,62,42,58094,39354,97448
316090,201712,41,25,16,22769.1,14992,37761.1
316095,201712,69,57,12,53138,11244,64382
316100,201712,301,174,127,162241.65,118999,281240.65
316105,201712,35,24,11,22488,10307,32795
316110,201712,1915,1537,378,1432064.27,353530.1,1785594.37
316120,201712,79,59,20,55283,18458.9,73741.9
316130,201712,138,106,32,98667,29984,128651
316140,201712,28,21,7,19677,6559,26236
316150,201712,200,140,60,130477.25,56220,186697.25
316160,201712,88,52,36,48724,33732,82456
316165,201712,64,46,18,42915,16163.25,59078.25
316170,201712,203,136,67,126495,62779,189274
316180,201712,195,91,104,84939.05,97448,182387.05
316190,201712,137,96,41,89015,38417,127432
316200,201712,697,391,306,366367,286159.9,652526.9
316210,201712,752,501,251,469097.43,235187,704284.43
316220,201712,118,80,38,74960,35606,110566
316225,201712,22,14,8,13118,7496,20614
316230,201712,33,19,14,17803,13118,30921
316240,201712,614,499,115,466626.1,107755,574381.1
316245,201712,99,82,17,76834,15929,92763
316250,201712,1501,1046,455,970951.5,424892.26,1395843.76
316255,201712,114,90,24,83955.2,22488,106443.2
316257,201712,178,94,84,88078,78426.9,166504.9
316260,201712,242,160,82,148645.93,76741,225386.93
316265,201712,25,16,9,14992,8433,23425
316270,201712,679,471,208,438609.8,194896,633505.8
316280,201712,549,341,208,319205,194240.3,513445.3
316290,201712,677,454,223,422587.69,208951,631538.69
316292,201712,490,193,297,180841,278055,458896
316294,201712,104,62,42,58094,39354,97448
316295,201712,278,122,156,112892.5,146172,259064.5
316300,201712,106,74,32,69338,29984,99322
316310,201712,34,18,16,16866,14992,31858
316320,201712,41,25,16,23425,14992,38417
316330,201712,129,82,47,75897.25,43757.9,119655.15
316340,201712,144,95,49,89015,45913,134928
316350,201712,190,137,53,128206,49661,177867
316360,201712,23,18,5,16866,4685,21551
316370,201712,1055,565,490,525676.75,458839.53,984516.28
316380,201712,123,93,30,87141,28110,115251
316390,201712,119,86,33,80582,30921,111503
316400,201712,138,105,33,98385,30921,129306
316410,201712,307,225,82,209466.35,76834,286300.35
316420,201712,195,139,56,129540.25,52472,182012.25
316430,201712,155,76,79,71212,74023,145235
316440,201712,99,47,52,44039,48724,92763
316443,201712,36,34,2,31858,1874,33732
316447,201712,63,49,14,45913,13118,59031
316450,201712,225,170,55,159290,51535,210825
316460,201712,66,28,38,26236,35606,61842
316470,201712,1580,1141,439,1060706.44,409842.87,1470549.31
316480,201712,13,10,3,9370,2811,12181
316490,201712,17,6,11,5622,10307,15929
316500,201712,149,99,50,92481.9,46850,139331.9
316510,201712,170,124,46,115204.15,43102,158306.15
316520,201712,192,117,75,109066.8,70275,179341.8
316530,201712,151,110,41,103070,38417,141487
316540,201712,142,79,63,73086,59031,132117
316550,201712,142,100,42,93700,39354,133054
316553,201712,232,110,122,102570.4,114314,216884.4
316555,201712,31,22,9,20614,8433,29047
316556,201712,11,7,4,6559,3748,10307
316557,201712,16,14,2,13118,1874,14992
316560,201712,57,45,12,42165,11244,53409
316570,201712,245,223,22,208473.31,20614,229087.31
316580,201712,21,15,6,14055,5622,19677
316590,201712,115,99,16,92763,14992,107755
316600,201712,182,148,34,138395,31858,170253
316610,201712,69,47,22,43757.9,20614,64371.9
316620,201712,131,101,30,94637,28110,122747
316630,201712,37,27,10,25299,9370,34669
316640,201712,16,10,6,9370,5622,14992
316650,201712,65,51,14,47787,13118,60905
316660,201712,6,4,2,3748,1874,5622
316670,201712,439,154,285,144280,266482.9,410762.9
316680,201712,158,109,49,102133,45726,147859
316690,201712,188,118,70,110566,65590,176156
316695,201712,59,52,7,48724,6559,55283
316700,201712,13,7,6,6559,5622,12181
316710,201712,711,518,193,484850.9,180841,665691.9
316720,201712,4857,2475,2382,2304840.19,2228341.92,4533182.11
316730,201712,14,13,1,12181,937,13118
316740,201712,133,82,51,76834,47787,124621
316750,201712,19,13,6,12181,5622,17803
316760,201712,324,263,61,246431,57157,303588
316770,201712,139,80,59,74960,55283,130243
316780,201712,67,40,27,37180.16,25299,62479.16
316790,201712,56,43,13,40291,12181,52472
316800,201712,1802,1104,698,1032199.4,652340.1,1684539.5
316805,201712,18,9,9,8433,8433,16866
316810,201712,65,42,23,39354,21270,60624
316820,201712,37,18,19,16866,17803,34669
316830,201712,92,40,52,37480,47507,84987
316840,201712,498,301,197,281287.5,182715,464002.5
316850,201712,346,227,119,211340.35,111503,322843.35
316860,201712,5954,2635,3319,2454528.95,3106755.63,5561284.58
316870,201712,1444,929,515,862165.05,477872,1340037.05
316880,201712,106,59,47,55001.9,44039,99040.9
316890,201712,250,165,85,154605,79645,234250
316900,201712,415,285,130,264544.84,121810,386354.84
316905,201712,17,10,7,9370,6559,15929
316910,201712,50,26,24,24362,22488,46850
316920,201712,136,106,30,98620,28110,126730
316930,201712,1919,964,955,897601.15,892676.17,1790277.32
316935,201712,856,515,341,480681.66,318580,799261.66
316940,201712,1097,631,466,590310.7,436070.53,1026381.23
316950,201712,191,100,91,93700,85267,178967
316960,201712,1093,606,487,566510.9,456028.63,1022539.53
316970,201712,636,495,141,463815,132117,595932
316980,201712,112,67,45,62779,42155.63,104934.63
316990,201712,2162,1416,746,1319502.67,697353.88,2016856.55
317000,201712,325,251,74,234906,69338,304244
317005,201712,246,174,72,163038,67464,230502
317010,201712,6241,3423,2818,3187100.1,2638582.83,5825682.93
317020,201712,16018,7077,8941,6598929.37,8359385.85,14958315.22
317030,201712,83,32,51,29984,47574.12,77558.12
317040,201712,3114,1927,1187,1802826.64,1108996.7,2911823.34
317043,201712,70,49,21,45913,19677,65590
317047,201712,34,16,18,14992,16862,31854
317050,201712,185,138,47,129306,44039,173345
317052,201712,120,94,26,88078,24362,112440
317057,201712,198,149,49,139613,45351,184964
317060,201712,55,35,20,32795,18458.9,51253.9
317065,201712,59,48,11,44976,10307,55283
317070,201712,1952,921,1031,858292.85,963985.8,1822278.65
317075,201712,109,57,52,53409,48724,102133
317080,201712,819,434,385,405299.35,360558,765857.35
317090,201712,626,503,123,469015.75,115251,584266.75
317100,201712,409,306,103,284848.6,96511,381359.6
317103,201712,106,91,15,85267,14055,99322
317107,201712,36,32,4,29984,3748,33732
317110,201712,94,41,53,38417,49661,88078
317115,201712,39,33,6,30921,5622,36543
317120,201712,1781,897,884,832727.61,827859,1660586.61
317130,201712,1898,1214,684,1134574.1,640253,1774827.1
317140,201712,6,5,1,4685,937,5622
317150,201712,270,161,109,150857,101383.4,252240.4
317160,201712,315,230,85,215198,79645,294843
317170,201712,202,140,62,131180,58094,189274
317180,201712,430,307,123,286956.25,115251,402207.25
317190,201712,257,173,84,162101,78145.8,240246.8
317200,201712,787,560,227,512487,212465,724952
317210,201712,150,85,65,78708.6,60905,139613.6
317220,201712,21,14,7,13118,6559,19677
320010,201712,618,460,158,427741.25,148046,575787.25
320013,201712,131,96,35,89952,32795,122747
320016,201712,284,178,106,166786,99322,266108
320020,201712,709,425,284,395721.38,263513.97,659235.35
320030,201712,148,110,38,103070,35278.05,138348.05
320035,201712,134,99,35,92763,32795,125558
320040,201712,496,258,238,240621.8,223006,463627.8
320050,201712,111,85,26,79645,24362,104007
320060,201712,1505,694,811,650232,759242.3,1409474.3
320070,201712,100,70,30,65590,28110,93700
320080,201712,759,435,324,404813.5,303588,708401.5
320090,201712,1193,831,362,775352.08,338350.8,1113702.88
320100,201712,313,178,135,166786,126495,293281
320110,201712,141,89,52,81707.1,48724,130431.1
320115,201712,111,91,20,85267,18740,104007
320120,201712,3261,1827,1434,1700939.6,1342011.96,3042951.56
320130,201712,7228,3457,3771,3219127.88,3525953.92,6745081.80
320140,201712,417,267,150,248867.6,140310,389177.6
320150,201712,1861,1092,769,1016676.85,720543.63,1737220.48
320160,201712,697,310,387,288493.62,361571.36,650064.98
320170,201712,115,89,26,82644,24362,107006
320180,201712,51,29,22,27173,20614,47787
320190,201712,235,159,76,148224.03,70931,219155.03
320200,201712,56,42,14,39354,13118,52472
320210,201712,841,474,367,442639.8,342925,785564.8
320220,201712,302,113,189,104944.86,176812,281756.86
320225,201712,72,59,13,55283,12181,67464
320230,201712,533,343,190,320079.2,177234,497313.2
320240,201712,3100,1565,1535,1463969.9,1435676.05,2899645.95
320245,201712,442,306,136,285597.7,127432,413029.7
320250,201712,221,116,105,107755,98385,206140
320255,201712,147,117,30,108345.31,27970,136315.31
320260,201712,176,124,52,116188,48677.15,164865.15
320265,201712,160,128,32,119140,29984,149124
320270,201712,153,125,28,117125,26236,143361
320280,201712,940,567,373,525095.8,348404.81,873500.61
320290,201712,65,55,10,51535,9370,60905
320300,201712,535,382,153,356501.65,142116.55,498618.20
320305,201712,654,351,303,328887,283724,612611
320310,201712,210,119,91,110004.84,84525,194529.84
320313,201712,297,150,147,140550,137458,278008
320316,201712,110,91,19,85267,17803,103070
320320,201712,3295,1498,1797,1397761.9,1680853.5,3078615.4
320330,201712,259,191,68,178317.9,61842.81,240160.71
320332,201712,879,536,343,500128.3,320361.15,820489.45
320334,201712,238,144,94,134647,88078,222725
320335,201712,145,104,41,96276.95,38417,134693.95
320340,201712,592,410,182,383046,169879,552925
320350,201712,962,414,548,385482.14,512960.44,898442.58
320360,201712,166,92,74,85923,69026,154949
320370,201712,245,188,57,174494,52394,226888
320380,201712,283,192,91,178499.4,85267,263766.4
320390,201712,1105,677,428,633750,399211.66,1032961.66
320400,201712,322,233,89,217385,83393,300778
320405,201712,884,374,510,350434,477563.26,827997.26
320410,201712,960,488,472,455597.7,441899.34,897497.04
320420,201712,481,247,234,230971.2,219258,450229.2
320425,201712,197,105,92,98385,86204,184589
320430,201712,392,221,171,205484.35,160227,365711.35
320435,201712,164,110,54,102264.18,50598,152862.18
320440,201712,197,121,76,113095.9,71212,184307.9
320450,201712,129,75,54,70275,50598,120873
320455,201712,244,197,47,183653,44039,227692
320460,201712,238,151,87,141487,81519,223006
320465,201712,114,77,37,71792.94,34669,106461.94
320470,201712,630,403,227,377312.54,212695,590007.54
320480,201712,172,114,58,106818,54346,161164
320490,201712,2998,1492,1506,1393694.98,1408276.98,2801971.96
320495,201712,88,55,33,51517,30921,82438
320500,201712,9303,4728,4575,4405412.22,4274899.71,8680311.93
320501,201712,537,271,266,253927,249242,503169
320503,201712,271,195,76,181778.6,71212,252990.6
320506,201712,249,191,58,178967,54346,233313
320510,201712,924,443,481,411368.65,449198.05,860566.70
320515,201712,78,65,13,59968.45,12181,72149.45
320517,201712,206,145,61,135865,57157,193022
320520,201712,6696,2990,3706,2788366.56,3464336.98,6252703.54
320530,201712,5180,2610,2570,2437218.31,2404907.83,4842126.14
330010,201712,2974,1550,1424,1444825.68,1331543.91,2776369.59
330015,201712,156,60,96,55283.14,89952,145235.14
330020,201712,3522,1540,1982,1439796.52,1856572,3296368.52
330022,201712,210,118,92,109864,85267.9,195131.9
330023,201712,520,184,336,171237.4,314832,486069.4
330025,201712,531,121,410,113377,383607.9,496984.9
330030,201712,1906,1210,696,1125668.83,648942.04,1774610.87
330040,201712,2283,1158,1125,1082938.55,1052861,2135799.55
330045,201712,8259,2602,5657,2429445.61,5294399.99,7723845.60
330050,201712,794,503,291,471311,272667,743978
330060,201712,865,541,324,503171.45,302950.84,806122.29
330070,201712,3388,1307,2081,1219301.63,1948895.18,3168196.81
330080,201712,1470,703,767,653542.15,717742.3,1371284.45
330090,201712,351,214,137,200518,128369,328887
330093,201712,287,131,156,122747,146138,268885
330095,201712,102,52,50,48724,46850,95574
330100,201712,9445,4879,4566,4563303.14,4274829.3,8838132.44
330110,201712,467,207,260,193256.25,243620,436876.25
330115,201712,523,310,213,290470,199581,490051
330120,201712,371,192,179,178779.6,166973.4,345753.0
330130,201712,1488,425,1063,397512.88,995980,1393492.88
330140,201712,591,310,281,290453,262361,552814
330150,201712,445,267,178,248305,165849,414154
330160,201712,206,128,78,119936,73086,193022
330170,201712,26583,9374,17209,8762761.05,16112571.1,24875332.15
330180,201712,231,143,88,130553.75,81753.25,212307.00
330185,201712,766,323,443,301142.9,414136,715278.9
330187,201712,274,87,187,81519,175219,256738
330190,201712,5566,2227,3339,2076988.15,3125408.53,5202396.68
330200,201712,4344,1528,2816,1426864.89,2633964.24,4060829.13
330205,201712,390,242,148,226332.35,138395,364727.35
330210,201712,985,598,387,555644.8,361072.95,916717.75
330220,201712,2487,1492,995,1394678.75,931378.1,2326056.85
330225,201712,544,305,239,285158,223287.1,508445.1
330227,201712,2450,792,1658,739002.63,1553197.32,2292199.95
330230,201712,200,123,77,114596,72149,186745
330240,201712,3593,1886,1707,1761795.54,1596685.81,3358481.35
330245,201712,150,63,87,59031,80769.4,139800.4
330250,201712,6415,3342,3073,3121154.15,2870420.06,5991574.21
330260,201712,564,171,393,160227,368241,528468
330270,201712,3288,1215,2073,1137612.5,1941840.6,3079453.1
330280,201712,438,287,151,266034.34,141478,407512.34
330285,201712,6996,2337,4659,2185124.32,4363171.2,6548295.52
330290,201712,575,223,352,207986,329824,537810
330300,201712,741,503,238,467563.85,222989,690552.85
330310,201712,411,238,173,221132.35,162101,383233.35
330320,201712,8008,3002,5006,2805006.4,4684750.92,7489757.32
330330,201712,9264,3610,5654,3376155.71,5293461.03,8669616.74
330340,201712,2622,1576,1046,1474548.43,980083.26,2454631.69
330350,201712,17686,7000,10686,6532155.3,9993876.49,16526031.79
330360,201712,2588,1269,1319,1187910.7,1235894,2423804.7
330370,201712,971,534,437,499608.4,407502.3,907110.7
330380,201712,838,364,474,340355.88,443529.9,783885.78
330385,201712,606,319,287,297967,268919,566886
330390,201712,5114,2854,2260,2660563.2,2115109.52,4775672.72
330395,201712,242,153,89,141675.05,80910.5,222585.55
330400,201712,643,331,312,305837.3,289687.29,595524.59
330410,201712,501,356,145,331934,135102.86,467036.86
330411,201712,234,136,98,127254,91779.15,219033.15
330412,201712,253,107,146,99978,136802,236780
330414,201712,6218,2516,3702,2353690.4,3465899.75,5819590.15
330415,201712,557,262,295,245494,275478.4,520972.4
330420,201712,2276,1206,1070,1127089.8,1000048,2127137.8
330430,201712,1799,818,981,765436,916667.7,1682103.7
330440,201712,258,118,140,110566,131180,241746
330450,201712,120,48,72,44976,67464,112440
330452,201712,1672,774,898,723676.5,841127.2,1564803.7
330455,201712,110171,39251,70920,36704965.54,66391340.13,103096305.67
330460,201712,264,106,158,99322,148046,247368
330470,201712,1234,677,557,628167.19,521899.63,1150066.82
330475,201712,1374,377,997,351319.98,933626.8,1284946.78
330480,201712,743,399,344,373207.1,321391.4,694598.5
330490,201712,13385,4729,8656,4424529.22,8104170.07,12528699.29
330500,201712,1334,613,721,574381,675203,1249584
330510,201712,11228,3726,7502,3483397.84,7022801.27,10506199.11
330513,201712,105,53,52,49661,48724,98385
330515,201712,857,353,504,326996.9,471874,798870.9
330520,201712,2427,909,1518,851518,1422225.45,2273743.45
330530,201712,228,119,109,111503,101946,213449
330540,201712,347,174,173,163038,161633,324671
330550,201712,3127,1100,2027,1029248,1897284.65,2926532.65
330555,201712,735,270,465,252972,434581.4,687553.4
330560,201712,552,211,341,197707,319500,517207
330570,201712,249,170,79,159290,74023,233313
330575,201712,798,333,465,311787,433685.75,745472.75
330580,201712,3340,1880,1460,1754783.8,1366287.1,3121070.9
330590,201712,309,157,152,147109,142424,289533
330600,201712,1084,702,382,655675.72,356276.45,1011952.17
330610,201712,1516,837,679,777225.51,632150.45,1409375.96
330615,201712,187,140,47,131180,44039,175219
330620,201712,933,449,484,418371.7,452005.9,870377.6
330630,201712,3719,2355,1364,2190388.01,1271929.57,3462317.58
350010,201712,589,386,203,360419.02,190211,550630.02
350020,201712,40,21,19,19677,17803,37480
350030,201712,517,334,183,311834,170302.66,482136.66
350040,201712,127,47,80,43701.68,74960,118661.68
350050,201712,290,161,129,150857,120620.63,271477.63
350055,201712,85,47,38,44039,35606,79645
350060,201712,73,28,45,26236,42165,68401
350070,201712,796,466,330,432360.67,307545.56,739906.23
350075,201712,67,43,24,40291,22488,62779
350080,201712,50,30,20,27485.3,17803,45288.3
350090,201712,101,58,43,54346,40286.32,94632.32
350100,201712,299,187,112,174516.25,104944,279460.25
350110,201712,59,37,22,34669,20614,55283
350115,201712,154,94,60,87422.1,56220,143642.1
350120,201712,111,74,37,69338,34669,104007
350130,201712,358,172,186,160602,174282,334884
350140,201712,33,19,14,17054,13118,30172
350150,201712,71,56,15,52472,14055,66527
350160,201712,2455,951,1504,888071.99,1407930.12,2296002.11
350170,201712,403,246,157,228347,146828,375175
350180,201712,186,97,89,90889,83393,174282
350190,201712,972,498,474,464658.84,443842.85,908501.69
350200,201712,72,26,46,24362,42841.8,67203.8
350210,201712,1358,762,596,706435.55,557943.23,1264378.78
350220,201712,676,580,96,539402.75,89952,629354.75
350230,201712,76,54,22,50598,20614,71212
350240,201712,64,49,15,45913,14055,59968
350250,201712,1221,612,609,568105.1,569921.93,1138027.03
350260,201712,92,66,26,61842,24362,86204
350270,201712,827,542,285,507480,265621.76,773101.76
350275,201712,298,116,182,108318,170534,278852
350280,201712,4681,2387,2294,2225889.44,2145769.4,4371658.84
350290,201712,397,189,208,176787.32,194333.9,371121.22
350300,201712,46,26,20,24362,18740,43102
350310,201712,96,69,27,64372,25299,89671
350315,201712,37,22,15,20614,14055,34669
350320,201712,3253,1606,1647,1500373.35,1542715.15,3043088.50
350330,201712,1674,888,786,828028.3,735200.7,1563229.0
350335,201712,21,14,7,13118,6559,19677
350340,201712,129,63,66,59031,61842,120873
350350,201712,96,48,48,44976,44976,89952
350360,201712,129,88,41,82452,38136,120588
350370,201712,96,56,40,51847.3,37470.63,89317.93
350380,201712,727,305,422,285129.1,394664.9,679794.0
350390,201712,1391,572,819,535180.25,766278.7,1301458.95
350395,201712,25,18,7,16866,6559,23425
350400,201712,1697,910,787,843890.87,733930.58,1577821.45
350410,201712,2226,993,1233,927407.88,1155007.22,2082415.10
350420,201712,235,145,90,135272,84330,219602
350430,201712,75,44,31,40666,29047,69713
350440,201712,150,110,40,102086.25,37480,139566.25
350450,201712,1594,1007,587,936466.9,549926,1486392.9
350460,201712,336,120,216,112440,202110.9,314550.9
350470,201712,13,10,3,9370,2811,12181
350480,201712,158,88,70,82456,65590,148046
350490,201712,241,116,125,107755.9,117125,224880.9
350500,201712,38,18,20,16866,18740,35606
350510,201712,168,113,55,105881,51535,157416
350520,201712,444,205,239,189587,223318.3,412905.3
350530,201712,457,216,241,202392,225817,428209
350535,201712,61,48,13,44976,12181,57157
350540,201712,378,190,188,177230.55,175875,353105.55
350550,201712,2741,1609,1132,1500329.4,1059683.51,2560012.91
350560,201712,624,435,189,407590.32,176741.65,584331.97
350570,201712,4217,1739,2478,1624070.11,2319423.1,3943493.21
350580,201712,366,173,193,161165,180827.63,341992.63
350590,201712,902,488,414,457256,386981,844237
350600,201712,6145,3072,3073,2863577.16,2876011.75,5739588.91
350610,201712,1546,778,768,723492.3,719607,1443099.3
350620,201712,39,27,12,25299,11244,36543
350630,201712,239,138,101,128369.3,93701,222070.3
350635,201712,841,330,511,308929,478171.54,787100.54
350640,201712,121,89,32,83393,29984,113377
350650,201712,1880,1239,641,1157289.6,599010.7,1756300.3
350660,201712,751,343,408,320763.21,381355,702118.21
350670,201712,314,162,152,151560,142424,293984
350680,201712,175,98,77,91826,72149,163975
350690,201712,198,96,102,89952,95574,185526
350700,201712,687,341,346,316242.99,324202,640444.99
350710,201712,322,131,191,122184.8,178967,301151.8
350715,201712,49,43,6,40291,5622,45913
350720,201712,18,13,5,12181,4685,16866
350730,201712,41,26,15,24362,14055,38417
350740,201712,207,116,91,108401.53,85267,193668.53
350745,201712,22,12,10,11220,9370,20590
350750,201712,2120,1373,747,1278360.05,699314.3,1977674.35
350760,201712,3722,1606,2116,1503229.5,1980527.63,3483757.13
350770,201712,58,39,19,36543,17803,54346
350775,201712,48,35,13,32795,12172,44967
350780,201712,419,205,214,192085,200518,392603
350790,201712,370,160,210,149920,196770,346690
350800,201712,430,242,188,226754,176156,402910
350810,201712,514,411,103,384171,96511,480682
350820,201712,85,52,33,48724,30921,79645
350830,201712,80,46,34,43102,31858,74960
350840,201712,707,322,385,301714,359527,661241
350850,201712,1751,1013,738,943281.81,691240.63,1634522.44
350860,201712,570,335,235,312004.16,220195,532199.16
350870,201712,439,299,140,280163,130898.9,411061.9
350880,201712,286,153,133,140552.55,123965.1,264517.65
350890,201712,43,26,17,24362,15929,40291
350900,201712,1455,467,988,435629.19,925006.4,1360635.59
350910,201712,27,17,10,15929,9370,25299
350920,201712,594,332,262,310771.7,245494,556265.7
350925,201712,1163,627,536,584510.69,500826.7,1085337.39
350930,201712,96,59,37,55283,34669,89952
350940,201712,701,395,306,368615.8,284913.8,653529.6
350945,201712,106,79,27,73499,25299,98798
350950,201712,15082,7275,7807,6790699.04,7305070.59,14095769.63
350960,201712,1280,593,687,551044.8,643715,1194759.8
350970,201712,1122,606,516,565595.3,483201.63,1048796.93
350980,201712,97,65,32,60905,29984,90889
350990,201712,363,129,234,119608.06,218976.9,338584.96
350995,201712,34,17,17,15929,15929,31858
351000,201712,642,459,183,427898.26,171471,599369.26
351010,201712,51,29,22,27173,20614,47787
351015,201712,58,42,16,39354,14992,54346
351020,201712,1658,957,701,895033.64,654776.2,1549809.84
351030,201712,334,233,101,215791.1,94637,310428.1
351040,201712,846,458,388,428209,362619.15,790828.15
351050,201712,3230,1559,1671,1453872.3,1563889.64,3017761.94
351060,201712,4909,2029,2880,1890834.26,2695579.57,4586413.83
351070,201712,420,269,151,249870.59,141487,391357.59
351080,201712,812,580,232,543460,216447,759907
351090,201712,63,27,36,25299,33732,59031
351100,201712,458,263,195,244248.35,182701.32,426949.67
351110,201712,2105,1023,1082,953396.66,1011241.81,1964638.47
351120,201712,75,40,35,37396.6,32795,70191.6
351130,201712,171,57,114,53409,106818,160227
351140,201712,334,233,101,216541.5,94637,311178.5
351150,201712,393,199,194,185900.9,181778,367678.9
351160,201712,243,159,84,148983,78708,227691
351170,201712,180,93,87,87141,80770,167911
351190,201712,91,62,29,58094,27173,85267
351200,201712,379,248,131,231782.7,122747,354529.7
351210,201712,132,61,71,56906.92,66527,123433.92
351220,201712,520,313,207,289970.81,193959,483929.81
351230,201712,280,204,76,190523.3,71193.26,261716.56
351240,201712,229,98,131,91638.6,122747,214385.6
351250,201712,69,48,21,44976,19490,64466
351260,201712,152,110,42,103070,39073,142143
351270,201712,49,21,28,19677,26236,45913
351280,201712,1099,503,596,467565.35,557937.39,1025502.74
351290,201712,225,101,124,94637,115907,210544
351300,201712,3733,1751,1982,1633944.13,1856537,3490481.13
351310,201712,753,391,362,364727.25,339194,703921.25
351320,201712,106,65,41,60905,38417,99322
351330,201712,40,28,12,26236,11244,37480
351340,201712,1208,759,449,703573.57,419746.32,1123319.89
351350,201712,2408,1316,1092,1231546.85,1022918.22,2254465.07
351360,201712,778,389,389,362619,363379.19,725998.19
351370,201712,365,193,172,180836.32,160539.3,341375.62
351380,201712,8884,4065,4819,3794478,4505674.76,8300152.76
351385,201712,29,20,9,18740,8433,27173
351390,201712,292,215,77,200725.26,72149,272874.26
351400,201712,64,39,25,36543,23379.63,59922.63
351410,201712,419,264,155,246431.4,144673,391104.4
351420,201712,62,50,12,46850,11244,58094
351430,201712,77,40,37,37480,34669,72149
351440,201712,784,545,239,508507.2,223939,732446.2
351450,201712,248,125,123,117125,115251,232376
351460,201712,121,55,66,50833,61842,112675
351470,201712,141,73,68,68392,63716,132108
351480,201712,519,288,231,268638.3,216329.88,484968.18
351490,201712,298,105,193,98385,180841,279226
351492,201712,32,23,9,21551,8433,29984
351495,201712,28,18,10,16866,9370,26236
351500,201712,3548,1531,2017,1428859.37,1885105.1,3313964.47
351510,201712,1771,740,1031,693098.9,963882.54,1656981.44
351512,201712,22,18,4,16866,3748,20614
351515,201712,192,108,84,101196,78708,179904
351518,201712,723,440,283,411339,264889.9,676228.9
351519,201712,74,47,27,44039,25299,69338
351520,201712,141,87,54,80894.3,50598,131492.3
351530,201712,19,13,6,12181,5622,17803
351535,201712,137,74,63,69338,59031,128369
351540,201712,461,331,130,307806.5,121810,429616.5
351550,201712,1311,798,513,743344.8,480671.63,1224016.43
351560,201712,71,35,36,32795,33732,66527
351565,201712,11,6,5,5622,4685,10307
351570,201712,2567,1330,1237,1244635.03,1158418.26,2403053.29
351580,201712,39,35,4,32795,3748,36543
351590,201712,69,46,23,43102,21551,64653
351600,201712,189,142,47,133054,44039,177093
351610,201712,60,29,31,27173,29047,56220
351620,201712,5961,3432,2529,3205928.26,2367493.46,5573421.72
351630,201712,2517,1294,1223,1206321.59,1144072.32,2350393.91
351640,201712,1651,805,846,751778.96,791203.4,1542982.36
351650,201712,30,25,5,23425,4685,28110
351660,201712,159,101,58,93419.5,54346,147765.5
351670,201712,750,470,280,438095,262360,700455
351680,201712,76,62,14,58094,13118,71212
351685,201712,44,29,15,27173,14055,41228
351690,201712,308,220,88,204308.17,82456,286764.17
351700,201712,163,115,48,107755,44976,152731
351710,201712,74,53,21,49661,19677,69338
351720,201712,136,62,74,58094,69338,127432
351730,201712,98,71,27,65309.3,25294.32,90603.62
351740,201712,710,475,235,443835.3,220190.32,664025.62
351750,201712,366,155,211,144298.7,197707,342005.7
351760,201712,799,626,173,586797,161965,748762
351770,201712,289,248,41,232376,38417,270793
351780,201712,168,93,75,87132,70275,157407
351790,201712,242,128,114,119936,106818,226754
351800,201712,54,35,19,32795,17803,50598
351810,201712,123,81,42,75897,39354,115251
351820,201712,883,640,243,595653.6,227405.32,823058.92
351830,201712,505,184,321,171658.4,300777,472435.4
351840,201712,1849,945,904,875602.95,845293.11,1720896.06
351850,201712,226,168,58,156807.9,54346,211153.9
351860,201712,751,495,256,457914.92,239867.32,697782.24
351870,201712,5610,2652,2958,2475398.42,2765467.1,5240865.52
351880,201712,18921,8337,10584,7788852.52,9902495.65,17691348.17
351885,201712,89,60,29,55518,27173,82691
351890,201712,74,62,12,58094,11244,69338
351900,201712,224,135,89,125840,83393,209233
351905,201712,75,33,42,30921,39354,70275
351907,201712,3111,1358,1753,1269003.23,1640800.9,2909804.13
351910,201712,176,72,104,67464,97448,164912
351920,201712,136,79,57,74023,53386.96,127409.96
351925,201712,84,58,26,54346,24362,78708
351930,201712,380,262,118,245400.3,110566,355966.3
351940,201712,232,107,125,100259,117125,217384
351950,201712,146,85,61,79645,57157,136802
351960,201712,836,389,447,364317.75,417002.58,781320.33
351970,201712,1901,1006,895,940514.04,838325,1778839.04
351980,201712,145,74,71,67464,66527,133991
351990,201712,281,189,92,176156,85416.92,261572.92
352000,201712,353,212,141,198269.2,132117,330386.2
352010,201712,352,211,141,197707,132117,329824
352020,201712,194,71,123,66527,115251,181778
352030,201712,997,515,482,481852.25,450072.3,931924.55
352040,201712,566,248,318,232376,297966,530342
352042,201712,276,97,179,90889,167161,258050
352044,201712,391,236,155,220195.1,145235,365430.1
352050,201712,3130,1276,1854,1189016.8,1736119.53,2925136.33
352060,201712,104,66,38,61842,35606,97448
352070,201712,101,71,30,65591,28110,93701
352080,201712,63,38,25,34669,23425,58094
352090,201712,171,117,54,109629,50598,160227
352100,201712,252,125,127,117121,117867,234988
352110,201712,113,34,79,31858,74023,105881
352115,201712,72,27,45,25299,42165,67464
352120,201712,94,62,32,58094,29984,88078
352130,201712,221,185,36,173157.6,33732,206889.6
352140,201712,179,74,105,68870,98385,167255
352150,201712,118,66,52,60905.7,48724,109629.7
352160,201712,131,88,43,82456,40291,122747
352170,201712,373,253,120,236124.7,112440,348564.7
352180,201712,613,412,201,385107.75,188333,573440.75
352190,201712,261,102,159,95564.63,148945.52,244510.15
352200,201712,33,18,15,16866,14055,30921
352210,201712,3739,1557,2182,1450805.47,2039470.72,3490276.19
352215,201712,52,29,23,27173,21101.24,48274.24
352220,201712,6908,2725,4183,2548484.24,3917041.46,6465525.70
352230,201712,3165,2016,1149,1876410.57,1071658.22,2948068.79
352240,201712,2203,1303,900,1218476.29,841301.35,2059777.64
352250,201712,2575,1349,1226,1260000.85,1145754.67,2405755.52
352260,201712,1111,622,489,581025.32,457912,1038937.32
352265,201712,61,27,34,25299,31858,57157
352270,201712,403,230,173,214573.84,162046,376619.84
352280,201712,392,243,149,226442,139608.32,366050.32
352290,201712,174,111,63,103445,59031,162476
352300,201712,101,76,25,71212,23425,94637
352310,201712,5736,2804,2932,2615088.98,2741087.77,5356176.75
352320,201712,943,498,445,464034.99,414950.55,878985.54
352330,201712,528,230,298,215182.05,278945,494127.05
352340,201712,1394,686,708,640178.5,662599.75,1302778.25
352350,201712,332,209,123,195833,114970,310803
352360,201712,231,94,137,87187.85,125537.9,212725.75
352370,201712,105,70,35,65590,32795,98385
352380,201712,120,75,45,70275,42165,112440
352390,201712,2436,1110,1326,1035695.75,1240308.04,2276003.79
352400,201712,469,204,265,190211,248023.9,438234.9
352410,201712,748,535,213,496866.9,199113,695979.9
352420,201712,101,64,37,59968,34669,94637
352430,201712,1746,776,970,720929.75,906023.6,1626953.35
352440,201712,3066,1585,1481,1476763.59,1384566.05,2861329.64
352450,201712,188,159,29,148983,27173,176156
352460,201712,569,293,276,273993.54,257910.1,531903.64
352470,201712,586,196,390,183652,365421,549073
352480,201712,1362,761,601,711619.3,562574.9,1274194.2
352490,201712,83,31,52,29047,48724,77771
352500,201712,1213,544,669,508511,625439,1133950
352510,201712,734,397,337,371052.3,315769,686821.3
352520,201712,531,236,295,221132,276274.45,497406.45
352530,201712,1719,907,812,849203.1,760469.3,1609672.4
352540,201712,75,50,25,46850,23425,70275
352550,201712,182,104,78,97448,72430.1,169878.1
352560,201712,48,39,9,36543,8433,44976
352570,201712,658,345,313,322672,293281,615953
352580,201712,56,38,18,34669.33,16866,51535.33
352585,201712,17,5,12,4685,11244,15929
352590,201712,4288,2164,2124,2022202.3,1989303.11,4011505.41
352600,201712,355,247,108,230502.3,101187,331689.3
352610,201712,926,435,491,404928.62,460067,864995.62
352620,201712,961,387,574,361682.1,537838,899520.1
352630,201712,220,84,136,78708,127000.98,205708.98
352640,201712,556,395,161,367742.75,150857,518599.75
352650,201712,89,60,29,56220,27173,83393
352660,201712,82,49,33,45913,30921,76834
352670,201712,1645,898,747,837995.88,698869.08,1536864.96
352680,201712,878,567,311,527167.68,289971.2,817138.88
352690,201712,4319,1996,2323,1862006.5,2172572.77,4034579.27
352700,201712,109,62,47,57813,44039,101852
352710,201712,1341,709,632,662459,590774.5,1253233.5
352720,201712,1280,635,645,592497.1,604079.32,1196576.42
352725,201712,26,24,2,22488,1874,24362
352730,201712,362,180,182,167502.81,170534,338036.81
352740,201712,412,258,154,239826.04,144298,384124.04
352750,201712,23,15,8,13773.9,7496,21269.9
352760,201712,193,139,54,130243,50598,180841
352770,201712,80,63,17,59031,15929,74960
352780,201712,81,45,36,42165,33732,75897
352790,201712,27,22,5,20614,4685,25299
352800,201712,247,165,82,154605,76552.9,231157.9
352810,201712,164,107,57,97792.92,53409,151201.92
352820,201712,64,51,13,47787,12181,59968
352830,201712,89,62,27,58094,25299,83393
352840,201712,588,305,283,284521.1,265171,549692.1
352850,201712,1348,484,864,452852.1,809568,1262420.1
352860,201712,129,83,46,77771,43102,120873
352870,201712,41,25,16,23425,14992,38417
352880,201712,188,128,60,119917.26,56220,176137.26
352885,201712,29,20,9,18740,8433,27173
352890,201712,56,39,17,36543,15648,52191
352900,201712,4905,2378,2527,2211134.18,2360411.95,4571546.13
352910,201712,38,30,8,28110,7496,35606
352920,201712,718,443,275,414154,257675,671829
352930,201712,1255,606,649,566422.58,605207.77,1171630.35
352940,201712,6301,2734,3567,2550065.6,3339168.12,5889233.72
352950,201712,90,35,55,32795,51535,84330
352960,201712,69,45,24,42165,22488,64653
352965,201712,20,8,12,7496,11244,18740
352970,201712,462,350,112,323863.14,104008,427871.14
352980,201712,175,91,84,85267,78708,163975
352990,201712,924,426,498,397239.78,465356.99,862596.77
353000,201712,66,30,36,28110,33732,61842
353010,201712,551,344,207,322328,193940.27,516268.27
353020,201712,283,208,75,194896,70275,265171
353030,201712,1166,530,636,496291.63,595257.73,1091549.36
353040,201712,85,52,33,48724,30921,79645
353050,201712,1295,815,480,755944.27,449666.3,1205610.57
353060,201712,7726,3580,4146,3340066.52,3878671.24,7218737.76
353070,201712,1643,1029,614,957735.63,574051.04,1531786.67
353080,201712,1301,685,616,640485.72,577183.32,1217669.04
353090,201712,56,34,22,31858,20614,52472
353100,201712,61,49,12,45913,11244,57157
353110,201712,1951,610,1341,569869.63,1254630.54,1824500.17
353120,201712,76,40,36,37480,33732,71212
353130,201712,868,433,435,404765.63,407548.89,812314.52
353140,201712,577,226,351,211703,328887,540590
353150,201712,355,196,159,182715,148973.63,331688.63
353160,201712,101,83,18,77771,16866,94637
353170,201712,195,64,131,59968,122719.63,182687.63
353180,201712,951,429,522,399719.95,488599,888318.95
353190,201712,471,334,137,311637.95,128088,439725.95
353200,201712,181,91,90,85267,84330,169597
353205,201712,26,18,8,16866,7496,24362
353210,201712,82,51,31,47787,29047,76834
353215,201712,56,32,24,29984,22488,52472
353220,201712,84,48,36,44976,32795.93,77771.93
353230,201712,160,61,99,57157,92763,149920
353240,201712,284,158,126,148046,118062,266108
353250,201712,202,106,96,99322,89952,189274
353260,201712,440,314,126,293103.25,118052.63,411155.88
353270,201712,69,50,19,46850,17147.1,63997.1
353280,201712,96,47,49,43571,45913,89484
353282,201712,120,89,31,83393,29047,112440
353284,201712,24,19,5,17803,4685,22488
353286,201712,1,1,0,937,0,937
353290,201712,81,48,33,44976,30912,75888
353300,201712,398,222,176,206499.55,164912,371411.55
353310,201712,54,48,6,44976,5622,50598
353320,201712,61,39,22,36543,20614,57157
353325,201712,54,35,19,32795,17504,50299
353330,201712,67,51,16,47647,14992,62639
353340,201712,623,193,430,180841,402338.54,583179.54
353350,201712,918,425,493,397419.92,460424.9,857844.82
353360,201712,112,89,23,83080.7,21270,104350.7
353370,201712,122,70,52,64653.55,48724,113377.55
353380,201712,29,21,8,19673,7496,27169
353390,201712,1043,500,543,468500,508791,977291
353400,201712,52,31,21,29047,19677,48724
353410,201712,121,76,45,71212,42119,113331
353420,201712,57,24,33,22488,30921,53409
353430,201712,546,363,183,336475.96,171189.9,507665.86
353440,201712,10181,4445,5736,4153062.63,5368390.21,9521452.84
353450,201712,57,30,27,28110,25299,53409
353460,201712,603,329,274,305161.99,256026.25,561188.24
353470,201712,2138,1167,971,1088660.36,907445.91,1996106.27
353475,201712,243,163,80,150092.3,74960,225052.3
353480,201712,190,151,39,141487,36543,178030
353490,201712,236,143,93,133991,87141,221132
353500,201712,185,110,75,101852.3,70275,172127.3
353510,201712,102,73,29,68382.63,27163.63,95546.26
353520,201712,211,144,67,134928,62779,197707
353530,201712,466,257,209,240809,195833,436642
353540,201712,351,232,119,217067.02,111503,328570.02
353550,201712,742,501,241,465322.74,225817,691139.74
353560,201712,637,270,367,251452.99,343579.9,595032.89
353570,201712,57,30,27,28110,25299,53409
353580,201712,354,270,84,252522,78708,331230
353590,201712,83,56,27,52159.7,25299,77458.7
353600,201712,266,147,119,137427,110878.3,248305.3
353610,201712,115,60,55,56220,51535,107755
353620,201712,562,305,257,283196.09,240527.9,523723.99
353625,201712,51,29,22,27173,20614,47787
353630,201712,236,170,66,155036.37,61842,216878.37
353640,201712,123,85,38,79645,35606,115251
353650,201712,842,329,513,306211.6,480681,786892.6
353657,201712,22,16,6,14992,5622,20614
353660,201712,254,141,113,132117,105599.9,237716.9
353670,201712,747,446,301,416965.1,282037,699002.1
353680,201712,98,70,28,65590,26236,91826
353690,201712,46,36,10,33732,9370,43102
353700,201712,284,199,85,186463,79645,266108
353710,201712,414,197,217,183652.4,203329,386981.4
353715,201712,47,35,12,32513.9,11244,43757.9
353720,201712,354,164,190,153650,178030,331680
353730,201712,1135,699,436,652106.45,408250.9,1060357.35
353740,201712,650,362,288,338912.9,269856,608768.9
353750,201712,96,59,37,54760.62,34669,89429.62
353760,201712,2714,1018,1696,951841.06,1585613.37,2537454.43
353770,201712,100,81,19,75428.5,17803,93231.5
353780,201712,1094,552,542,514601.3,505980,1020581.3
353790,201712,503,285,218,265012.55,203207.96,468220.51
353800,201712,3238,1654,1584,1541911.46,1481870.62,3023782.08
353810,201712,236,132,104,122845.75,97421,220266.75
353820,201712,183,90,93,84330,86527.54,170857.54
353830,201712,48,41,7,38417,6559,44976
353850,201712,168,87,81,81519,75897,157416
353860,201712,458,205,253,191382.25,236779.9,428162.15
353870,201712,4960,2485,2475,2312507.32,2307948.55,4620455.87
353880,201712,667,475,192,443763.7,178967.36,622731.06
353890,201712,587,330,257,308648,240519,549167
353900,201712,136,66,70,61842,65590,127432
353910,201712,176,87,89,81519,83393,164912
353920,201712,455,250,205,233079.7,191649.99,424729.69
353930,201712,985,594,391,554447.44,365155.9,919603.34
353940,201712,187,103,84,95761.4,77865,173626.4
353950,201712,512,316,196,295810.9,183652,479462.9
353960,201712,72,58,14,54346,13118,67464
353970,201712,72,47,25,44039,23425,67464
353980,201712,1507,750,757,700138.91,708190.08,1408328.99
353990,201712,78,43,35,40291,32795,73086
354000,201712,373,174,199,162383,186271.6,348654.6
354010,201712,95,51,44,47787,40760,88547
354020,201712,541,341,200,318580,187400,505980
354025,201712,53,42,11,39354,10307,49661
354030,201712,65,35,30,32795,28110,60905
354040,201712,93,67,26,62404.2,24362,86766.2
354050,201712,191,108,83,100915,77771,178686
354060,201712,768,368,400,344816,372599.7,717415.7
354070,201712,883,511,372,476679.52,348564,825243.52
354075,201712,207,116,91,108599,84330.9,192929.9
354080,201712,291,128,163,119654.9,152731,272385.9
354085,201712,19,12,7,11244,6559,17803
354090,201712,314,175,139,163896,130243,294139
354100,201712,5431,2252,3179,2100242.82,2973272.55,5073515.37
354105,201712,78,39,39,36543,36543,73086
354110,201712,47,21,26,19677,24362,44039
354120,201712,149,103,46,96374.29,43102,139476.29
354130,201712,693,470,223,440156,208666,648822
354140,201712,3149,1474,1675,1377801.42,1568239.22,2946040.64
354150,201712,644,399,245,372645.7,228159.5,600805.2
354160,201712,694,436,258,407360.75,241465,648825.75
354165,201712,19,12,7,11244,6559,17803
354170,201712,172,117,55,108973.1,51535,160508.1
354180,201712,63,39,24,36223,22488,58711
354190,201712,214,99,115,91170.1,107755,198925.1
354200,201712,129,70,59,65122,55283,120405
354210,201712,72,35,37,32795,34669,67464
354220,201712,645,399,246,373207.1,229003.08,602210.18
354230,201712,157,64,93,59968,86204.8,146172.8
354240,201712,313,205,108,191148.79,100571.3,291720.09
354250,201712,92,55,37,51535,34669,86204
354260,201712,1892,876,1016,811601.92,950674,1762275.92
354270,201712,98,73,25,68401,23425,91826
354280,201712,34,18,16,16866,14992,31858
354290,201712,147,101,46,93841.05,43102,136943.05
354300,201712,418,285,133,266733,124465,391198
354310,201712,103,75,28,69338.1,26236,95574.1
354320,201712,180,95,85,89015,79645,168660
354323,201712,17,15,2,14055,1874,15929
354325,201712,109,62,47,57302,44039,101341
354330,201712,2520,854,1666,795646.54,1558918.69,2354565.23
354340,201712,10581,5166,5415,4826108.86,5068329.7,9894438.56
354350,201712,131,88,43,82456,40150.45,122606.45
354360,201712,86,48,38,44976,35606,80582
354370,201712,268,142,126,133054,118062,251116
354380,201712,211,127,84,118225,78708,196933
354390,201712,2750,992,1758,928571.5,1645880.73,2574452.23
354400,201712,320,171,149,159290.9,139050.9,298341.8
354410,201712,602,295,307,274818.42,286722.1,561540.52
354420,201712,269,170,99,159290,92763,252053
354425,201712,318,181,137,169597,128369,297966
354430,201712,187,119,68,109956.95,62966.4,172923.35
354440,201712,40,28,12,26236,11244,37480
354450,201712,50,36,14,33732,13118,46850
354460,201712,101,59,42,55283,39354,94637
354470,201712,40,28,12,26236,11244,37480
354480,201712,118,62,56,58085,52462.63,110547.63
354490,201712,147,92,55,86047.81,51535,137582.81
354500,201712,397,196,201,183652,188337,371989
354510,201712,102,70,32,65590,29984,95574
354515,201712,37,13,24,12181,22488,34669
354520,201712,1608,718,890,669634.6,833499.68,1503134.28
354530,201712,638,332,306,309393.4,285879.1,595272.5
354540,201712,274,156,118,146172,110561.32,256733.32
354550,201712,42,23,19,21551,17803,39354
354560,201712,161,95,66,88734,61832.63,150566.63
354570,201712,141,93,48,87141,44976,132117
354580,201712,1959,933,1026,871409,961067.54,1832476.54
354600,201712,280,150,130,138339.36,121795.95,260135.31
354610,201712,71,64,7,59968,6559,66527
354620,201712,63,19,44,17803,41228,59031
354625,201712,17,11,6,10307,5618,15925
354630,201712,322,211,111,197207.21,104007,301214.21
354640,201712,784,503,281,467455.5,263297,730752.5
354650,201712,72,39,33,36534,30893.26,67427.26
354660,201712,820,607,213,564809.05,199581,764390.05
354670,201712,283,101,182,93701,169598,263299
354680,201712,1244,469,775,439453,725707,1165160
354690,201712,93,63,30,58095,28110,86205
354700,201712,76,56,20,52472,18740,71212
354710,201712,58,40,18,36855.3,16866,53721.3
354720,201712,20,19,1,17803,937,18740
354730,201712,1910,802,1108,748509.6,1038008.6,1786518.2
354740,201712,59,43,16,40291,14992,55283
354750,201712,445,265,180,248296,168660,416956
354760,201712,513,317,196,294693,183089.9,477782.9
354765,201712,11,5,6,4685,5622,10307
354770,201712,331,228,103,212545.71,95761.4,308307.11
354780,201712,8110,3300,4810,3078884.18,4501228.98,7580113.16
354790,201712,114,68,46,63716,43102,106818
354800,201712,416,232,184,217384,172108.26,389492.26
354805,201712,103,52,51,48100,47787,95887
354810,201712,137,81,56,75615.9,52472,128087.9
354820,201712,186,81,105,75691,98385,174076
354830,201712,39,22,17,20614,15929,36543
354840,201712,56,37,19,34669,17803,52472
354850,201712,4555,2020,2535,1885091.7,2371095.24,4256186.94
354860,201712,332,161,171,150857,157875.48,308732.48
354870,201712,11725,5283,6442,4923688.88,6027203.16,10950892.04
354880,201712,3007,1134,1873,1060602.55,1753152.96,2813755.51
354890,201712,2815,1555,1260,1452083.28,1179467.9,2631551.18
354900,201712,59,39,20,36543,18740,55283
354910,201712,1214,641,573,597769.22,536901,1134670.22
354920,201712,52,44,8,41228,7496,48724
354925,201712,12,7,5,6559,4685,11244
354930,201712,30,27,3,25033,2811,27844
354940,201712,794,583,211,544353.09,197707,742060.09
354950,201712,220,145,75,135263,70275,205538
354960,201712,172,64,108,59968,100915,160883
354970,201712,843,551,292,511513.39,272976.31,784489.70
354980,201712,8358,3130,5228,2924148.71,4896251.62,7820400.33
354990,201712,9159,4302,4857,4019003.82,4545021.86,8564025.68
354995,201712,511,180,331,168660,309556.69,478216.69
355000,201712,451,149,302,139608.32,281913,421521.32
355010,201712,624,395,229,370115,212400.36,582515.36
355020,201712,710,446,264,416960.9,247360,664320.9
355030,201712,202664,78403,124261,73244521.04,116334381.2,189578902.24
355040,201712,713,336,377,313333.65,353061.6,666395.25
355050,201712,152,101,51,93388.77,47787,141175.77
355060,201712,1445,734,711,682997.97,665036.15,1348034.12
355070,201712,1472,727,745,677157.44,697089,1374246.44
355080,201712,203,117,86,109421.74,79710.9,189132.64
355090,201712,291,193,98,178781,91826,270607
355100,201712,4769,2363,2406,2195621.02,2252296.39,4447917.41
355110,201712,271,173,98,161161,91826,252987
355120,201712,81,57,24,53409,22488,75897
355130,201712,52,27,25,25299,23425,48724
355140,201712,181,121,60,113377,56220,169597
355150,201712,664,403,261,376389.1,244088.5,620477.6
355160,201712,449,214,235,198175.8,219914,418089.8
355170,201712,2034,1053,981,985303.87,919178.28,1904482.15
355180,201712,622,266,356,248305,332752.12,581057.12
355190,201712,220,148,72,138676,67464,206140
355200,201712,119,68,51,63716,47787,111503
355210,201712,715,420,295,393540,276396.63,669936.63
355220,201712,6555,3536,3019,3303550.78,2819389.88,6122940.66
355230,201712,109,65,44,60905,41223.32,102128.32
355240,201712,4167,1837,2330,1708644.76,2179207.38,3887852.14
355250,201712,5316,2600,2716,2428973.66,2541463.6,4970437.26
355255,201712,50,29,21,27173,19677,46850
355260,201712,187,113,74,104925.36,69310.63,174235.99
355270,201712,166,98,68,91826,63014,154840
355280,201712,6231,2631,3600,2460426.05,3368862.64,5829288.69
355290,201712,80,61,19,57157,17803,74960
355300,201712,179,117,62,108411.8,58094,166505.8
355310,201712,101,55,46,51535,43102,94637
355320,201712,92,47,45,44039,41234.3,85273.3
355330,201712,268,148,120,138676,112440,251116
355340,201712,1429,544,885,507167.76,828516.2,1335683.96
355350,201712,140,72,68,67464,63716,131180
355360,201712,181,115,66,107548.86,61842,169390.86
355365,201712,26,21,5,19677,4685,24362
355370,201712,1029,583,446,540498.22,416664.67,957162.89
355380,201712,775,518,257,483948.06,240528,724476.06
355385,201712,58,40,18,37480,16866,54346
355390,201712,103,60,43,56220,40291,96511
355395,201712,187,113,74,105080.32,69338,174418.32
355400,201712,1525,950,575,885941.98,538212.9,1424154.88
355410,201712,4840,2253,2587,2093297.58,2414078.23,4507375.81
355420,201712,47,35,12,32795,11244,44039
355430,201712,346,212,134,197988.1,125558,323546.1
355440,201712,78,44,34,41228,31858,73086
355450,201712,423,200,223,184449.97,207920.4,392370.37
355460,201712,70,54,16,49661.51,14992,64653.51
355465,201712,50,31,19,29047,17803,46850
355470,201712,186,73,113,67464.55,105881,173345.55
355475,201712,12,8,4,7496,3748,11244
355480,201712,454,198,256,183933.5,238457.13,422390.63
355490,201712,114,82,32,76834,29984,106818
355495,201712,52,25,27,23425,25299,48724
355500,201712,1703,976,727,909726.14,681160.64,1590886.78
355510,201712,267,195,72,179318.5,67464,246782.5
355520,201712,36,28,8,25955,7496,33451
355530,201712,23,16,7,14992,6559,21551
355535,201712,77,37,40,34669,37480,72149
355540,201712,2338,937,1401,876536.42,1310563.93,2187100.35
355550,201712,63,38,25,35606,23425,59031
355560,201712,238,118,120,110566,111816,222382
355570,201712,31,20,11,18740,10307,29047
355580,201712,268,187,81,175219,75892.32,251111.32
355590,201712,23,14,9,13118,8433,21551
355600,201712,267,139,128,130243,119650.32,249893.32
355610,201712,208,137,71,128369,66527,194896
355620,201712,1253,578,675,540789.9,631412.19,1172202.09
355630,201712,406,291,115,271731,107755,379486
355635,201712,128,61,67,57157,62766,119923
355640,201712,566,331,235,309210.98,220195,529405.98
355645,201712,829,358,471,333784.64,439481.21,773265.85
355650,201712,2093,896,1197,836059.4,1121570.63,1957630.03
355660,201712,263,140,123,131180,115246.32,246426.32
355670,201712,478,182,296,170534,277352,447886
355680,201712,209,121,88,112193.95,82175,194368.95
355690,201712,87,40,47,37480,43701,81181
355695,201712,14,12,2,11244,1874,13118
355700,201712,1135,582,553,540355.3,517599,1057954.3
355710,201712,2189,1203,986,1123605.38,923291.9,2046897.28
355715,201712,20,18,2,16866,1874,18740
355720,201712,206,122,84,112752.66,78704,191456.66
355730,201712,91,53,38,48521.53,35606,84127.53
410010,201712,132,110,22,103070,20614,123684
410020,201712,105,94,11,88078,10307,98385
410030,201712,160,101,59,93981.2,55283,149264.2
410040,201712,966,525,441,491690.75,413030,904720.75
410045,201712,26,21,5,19677,4685,24362
410050,201712,464,260,204,243620,190679.5,434299.5
410060,201712,273,211,62,197707,58094,255801
410070,201712,312,258,54,241746,50598,292344
410080,201712,165,107,58,100259,54346,154605
410090,201712,77,68,9,63510,8433,71943
410100,201712,294,208,86,194586.79,79879.25,274466.04
410105,201712,43,25,18,23425,16866,40291
410110,201712,311,190,121,178030,113377,291407
410115,201712,27,19,8,17803,7496,25299
410120,201712,453,232,221,217087.9,207077,424164.9
410130,201712,41,26,15,24362,14055,38417
410140,201712,3071,1510,1561,1410033.32,1459650.43,2869683.75
410150,201712,2686,1076,1610,1007359.75,1507796.5,2515156.25
410160,201712,503,322,181,301432.9,169597,471029.9
410165,201712,67,45,22,42165,20614,62779
410170,201712,167,125,42,114929.83,39354,154283.83
410180,201712,2146,1242,904,1159837.69,845148.08,2004985.77
410185,201712,35,31,4,29047,3748,32795
410190,201712,438,274,164,256738,153668,410406
410200,201712,975,730,245,682239.51,229283.9,911523.41
410210,201712,554,286,268,267982,250554,518536
410220,201712,40,22,18,20614,16866,37480
410230,201712,126,70,56,65590,52472,118062
410240,201712,725,482,243,451071.9,227691,678762.9
410250,201712,378,278,100,259892.6,93700,353592.6
410260,201712,279,167,112,156479,104944,261423
410270,201712,28,17,11,15929,10307,26236
410275,201712,69,52,17,48724,15929,64653
410280,201712,321,178,143,166531.14,133991,300522.14
410290,201712,232,147,85,137739,79645,217384
410300,201712,82,66,16,61842,14992,76834
410302,201712,24,16,8,14992,7496,22488
410304,201712,45,31,14,29047,13118,42165
410305,201712,205,112,93,104152,87141,191293
410310,201712,262,168,94,157416,88059.26,245475.26
410315,201712,56,40,16,37456,14992,52448
410320,201712,139,98,41,91826,38417,130243
410322,201712,34,24,10,22488,9370,31858
410330,201712,165,116,49,108692,45726,154418
410335,201712,96,58,38,54346,35606,89952
410337,201712,39,34,5,31858,4685,36543
410340,201712,32,30,2,28110,1874,29984
410345,201712,211,134,77,125558,72149,197707
410347,201712,52,39,13,36543,12181,48724
410350,201712,230,140,90,130899,84330,215229
410360,201712,455,275,180,255177.2,168098,423275.2
410370,201712,2363,996,1367,930657.46,1277863.11,2208520.57
410380,201712,218,143,75,133991,70275,204266
410390,201712,370,279,91,261419,85267,346686
410395,201712,34,22,12,20614,10870,31484
410400,201712,835,423,412,395044.7,385515,780559.7
410405,201712,88,64,24,59968,22488,82456
410410,201712,41,32,9,29984,8433,38417
410420,201712,1655,816,839,762819.6,784582.3,1547401.9
410425,201712,182,88,94,82269,88078,170347
410430,201712,2199,1290,909,1205638,850589.96,2056227.96
410440,201712,394,284,110,265172,103070,368242
410442,201712,361,241,120,224881,112440,337321
410445,201712,426,293,133,274541,124621,399162
410450,201712,411,199,212,186463,198644,385107
410460,201712,404,214,190,200236.9,178030,378266.9
410465,201712,196,128,68,118716.26,63645.98,182362.24
410470,201712,220,140,80,131180,74960,206140
410480,201712,5682,2815,2867,2619747.87,2680127.45,5299875.32
410490,201712,1380,911,469,851857,437580,1289437
410500,201712,265,153,112,143361,104944,248305
410510,201712,175,129,46,120873,42468.3,163341.3
410520,201712,264,196,68,183652,63716,247368
410530,201712,236,88,148,82456,138672,221128
410540,201712,317,228,89,213065.8,83388.32,296454.12
410550,201712,1601,699,902,654588.9,844892.9,1499481.8
410560,201712,149,113,36,105881,33732,139613
410570,201712,439,312,127,290293.05,118999,409292.05
410580,201712,3183,1430,1753,1338324.9,1641156,2979480.9
410590,201712,399,285,114,267045,106818,373863
410600,201712,182,158,24,148046,22488,170534
410610,201712,54,44,10,41228,9370,50598
410620,201712,241,175,66,163975,61842,225817
410630,201712,453,267,186,250179,173143,423322
410640,201712,965,588,377,548031.52,351670.85,899702.37
410645,201712,97,73,24,68027,22488,90515
410650,201712,363,250,113,233313,105881,339194
410655,201712,79,60,19,56220,17803,74023
410657,201712,43,20,23,18740,21551,40291
410660,201712,583,416,167,388571,156479,545050
410670,201712,76,62,14,58094,13118,71212
410680,201712,191,158,33,148046,30921,178967
410685,201712,17,11,6,10307,5622,15929
410690,201712,28510,12370,16140,11573691.39,15110198.5,26683889.89
410700,201712,323,238,85,222444,79645,302089
410710,201712,126,101,25,94637,23425,118062
410712,201712,23,14,9,13118,8433,21551
410715,201712,82,62,20,58094,18740,76834
410720,201712,586,352,234,329824,218686.8,548510.8
410725,201712,180,130,50,121810,46850,168660
410730,201712,87,54,33,50598,30921,81519
410740,201712,115,83,32,77771,29984,107755
410750,201712,220,164,56,153664,52467.32,206131.32
410752,201712,24,15,9,14055,8433,22488
410753,201712,54,23,31,20890.41,29047,49937.41
410754,201712,34,21,13,19677,12181,31858
410755,201712,81,55,26,51253.9,24362,75615.9
410760,201712,707,403,304,377611,284380,661991
410765,201712,1662,797,865,740695.94,809652.63,1550348.57
410770,201712,108,92,16,86204,14992,101196
410773,201712,45,34,11,31858,10307,42165
410775,201712,176,131,45,122091.1,42165,164256.1
410780,201712,81,43,38,40291,35606,75897
410785,201712,60,48,12,44976,11244,56220
410790,201712,69,33,36,30921,33732,64653
410800,201712,292,183,109,170535,102133,272668
410810,201712,26,22,4,20614,3467,24081
410820,201712,179,132,47,123544,44039,167583
410830,201712,8512,3879,4633,3626304.1,4337795.12,7964099.22
410832,201712,105,72,33,67182.9,30921,98103.9
410840,201712,1396,774,622,723013.99,582412.67,1305426.66
410845,201712,64,40,24,37480,22488,59968
410850,201712,193,133,60,124340,56220,180560
410855,201712,47,40,7,37480,6559,44039
410860,201712,668,393,275,367469.75,257675,625144.75
410865,201712,108,83,25,77771,23425,101196
410870,201712,151,132,19,123684,17516,141200
410880,201712,1098,550,548,514847.65,513431,1028278.65
410890,201712,75,52,23,48724,21551,70275
410895,201712,75,56,19,52472,17803,70275
410900,201712,19,13,6,12181,5622,17803
410910,201712,18,15,3,14055,2811,16866
410920,201712,33,22,11,20614,10307,30921
410930,201712,503,327,176,306191.74,164912,471103.74
410940,201712,4319,2570,1749,2399681.16,1635603.7,4035284.86
410950,201712,125,90,35,84330,32795,117125
410960,201712,759,335,424,313614,397101,710715
410965,201712,63,48,15,44694.9,14055,58749.9
410970,201712,626,446,180,417446.1,168660,586106.1
410975,201712,106,64,42,59467,39354,98821
410980,201712,1549,702,847,655273.21,792412.22,1447685.43
410990,201712,266,180,86,168494.25,80300.9,248795.15
411000,201712,62,40,22,37480,20614,58094
411005,201712,23,18,5,16866,4685,21551
411007,201712,238,138,100,129306,93700,223006
411010,201712,572,399,173,373863,162101,535964
411020,201712,286,197,89,184589,83393,267982
411030,201712,21,12,9,11244,8433,19677
411040,201712,49,34,15,31858,14055,45913
411050,201712,217,173,44,161423.72,41101.12,202524.84
411060,201712,523,355,168,332626,157416,490042
411065,201712,60,52,8,48724,7496,56220
411070,201712,1192,803,389,748289,363396.12,1111685.12
411080,201712,242,170,72,159373,67464,226837
411090,201712,113,85,28,79645,26236,105881
411095,201712,264,108,156,100728,146162,246890
411100,201712,111,93,18,87141,16866,104007
411110,201712,123,85,38,79645,35606,115251
411120,201712,183,137,46,128369,43102,171471
411125,201712,181,79,102,73385.84,95574,168959.84
411130,201712,125,108,17,100570,15929,116499
411140,201712,175,122,53,114011.02,49145.65,163156.67
411150,201712,1198,798,400,747716.63,374800,1122516.63
411155,201712,116,81,35,75897,32795,108692
411160,201712,21,10,11,9370,10307,19677
411170,201712,60,54,6,50316.9,5622,55938.9
411180,201712,917,602,315,562856,295150.32,858006.32
411190,201712,336,190,146,177374.1,136802,314176.1
411200,201712,665,444,221,414779.09,206186.95,620966.04
411210,201712,675,361,314,336734.83,294218,630952.83
411220,201712,147,110,37,103070,34669,137739
411230,201712,40,37,3,34669,2811,37480
411240,201712,123,84,39,78708,36543,115251
411250,201712,421,307,114,287659,106818,394477
411260,201712,23,16,7,14992,6559,21551
411270,201712,289,156,133,146172,124621,270793
411275,201712,201,177,24,165146.8,22488,187634.8
411280,201712,229,163,66,151482.36,61842,213324.36
411290,201712,55,40,15,37480,14055,51535
411295,201712,140,111,29,104007,27173,131180
411300,201712,74,38,36,35606,33732,69338
411310,201712,93,71,22,66527,20614,87141
411320,201712,754,549,205,512914.7,190510.84,703425.54
411325,201712,48,30,18,28110,16866,44976
411330,201712,905,578,327,540087.26,305680.8,845768.06
411340,201712,26,18,8,16866,7187,24053
411342,201712,78,57,21,53409,19677,73086
411345,201712,122,59,63,55283,59031,114314
411350,201712,481,386,95,360417.82,88069.1,448486.92
411360,201712,55,35,20,32795,18740,51535
411370,201712,14055,5763,8292,5383861.34,7755241.37,13139102.71
411373,201712,191,141,50,132117,46850,178967
411375,201712,81,67,14,62779,13118,75897
411380,201712,95,71,24,66527,22488,89015
411390,201712,140,93,47,87141,44039,131180
411400,201712,353,264,89,247359,83393,330752
411410,201712,450,230,220,214854.1,205859,420713.1
411420,201712,1034,471,563,439078.2,526500.5,965578.7
411430,201712,400,260,140,242964.1,131171,374135.1
411435,201712,36,25,11,23425,10307,33732
411440,201712,469,374,95,348814.37,89015,437829.37
411450,201712,431,359,72,336383,67464,403847
411460,201712,733,293,440,273596.2,410978.96,684575.16
411470,201712,92,68,24,63716,22488,86204
411480,201712,619,347,272,323640.8,254301.8,577942.6
411490,201712,291,182,109,170534,102133,272667
411500,201712,111,94,17,88078,15555,103633
411510,201712,217,173,44,161366.39,41228,202594.39
411520,201712,5904,2311,3593,2161091.2,3358745.17,5519836.37
411530,201712,108,72,36,67464,33732,101196
411535,201712,45,18,27,16866,25299,42165
411540,201712,343,235,108,219188.2,101196,320384.2
411545,201712,62,45,17,42165,15929,58094
411550,201712,72,56,16,52472,14992,67464
411560,201712,381,177,204,165196.77,191148,356344.77
411570,201712,785,298,487,278936,456132,735068
411573,201712,38,22,16,20614,14992,35606
411575,201712,262,160,102,149920,95574,245494
411580,201712,1217,481,736,449413.31,688660,1138073.31
411585,201712,76,38,38,35606,35606,71212
411590,201712,25,17,8,15929,7496,23425
411600,201712,24,10,14,9370,13118,22488
411605,201712,238,107,131,100119,122747,222866
411610,201712,236,158,78,148046,73086,221132
411620,201712,356,197,159,184401.6,148355.21,332756.81
411630,201712,57,39,18,36543,16866,53409
411640,201712,36,30,6,28110,5622,33732
411650,201712,14,10,4,9370,3748,13118
411660,201712,32,27,5,25299,4685,29984
411670,201712,244,186,58,174282,54346,228628
411680,201712,155,132,23,123684,21551,145235
411690,201712,599,320,279,299242.32,261081.72,560324.04
411695,201712,62,47,15,44039,14055,58094
411700,201712,169,145,24,135865,22488,158353
411705,201712,102,66,36,61842,33732,95574
411710,201712,294,199,95,185496.86,89015,274511.86
411720,201712,133,85,48,79645,44976,124621
411721,201712,57,47,10,44039,9370,53409
411722,201712,99,42,57,39354,53409,92763
411725,201712,143,111,32,103726,29984,133710
411727,201712,77,61,16,57157,14710.9,71867.9
411729,201712,35,28,7,26236,6559,32795
411730,201712,543,354,189,330136.3,177093,507229.3
411740,201712,29,20,9,18740,8433,27173
411745,201712,68,46,22,42325,20614,62939
411750,201712,855,410,445,383093.45,416004.58,799098.03
411760,201712,1172,888,284,830829.14,266099,1096928.14
411770,201712,435,292,143,273585.26,133991,407576.26
411780,201712,367,237,130,222069,121810,343879
411790,201712,529,297,232,276440.54,217272.67,493713.21
411800,201712,168,131,37,122747,34669,157416
411810,201712,164,128,36,119936,33732,153668
411820,201712,2106,1029,1077,961905.56,1008251.8,1970157.36
411830,201712,12,12,0,11244,0,11244
411840,201712,1950,1208,742,1130713.51,694484.9,1825198.41
411845,201712,49,18,31,16866,29047,45913
411850,201712,1245,712,533,664698.74,497502.81,1162201.55
411860,201712,44,28,16,25955,14992,40947
411870,201712,45,32,13,29984,12181,42165
411880,201712,426,274,152,256484,141693.14,398177.14
411885,201712,102,69,33,64653,30921,95574
411890,201712,325,206,119,190867.49,111493.63,302361.12
411900,201712,70,51,19,47787,17803,65590
411910,201712,166,137,29,128359.63,26348.44,154708.07
411915,201712,2070,887,1183,829987.11,1107420.03,1937407.14
411920,201712,123,101,22,94637,20614,115251
411925,201712,16,11,5,10307,4685,14992
411930,201712,796,591,205,551895,192085,743980
411940,201712,589,420,169,393071.5,158328.56,551400.06
411950,201712,898,474,424,444138,396319.8,840457.8
411960,201712,958,682,276,636703,258612,895315
411965,201712,23,16,7,14992,6559,21551
411970,201712,69,62,7,58094,6559,64653
411980,201712,195,129,66,120873,61842,182715
411990,201712,4851,2850,2001,2654718.18,1873195.4,4527913.58
411995,201712,463,174,289,163038,270793,433831
412000,201712,288,169,119,157651.56,111493.63,269145.19
412010,201712,45,27,18,25299,16866,42165
412015,201712,44,32,12,29984,11244,41228
412020,201712,29,26,3,24080.9,2811,26891.9
412030,201712,63,53,10,49661,9370,59031
412033,201712,55,35,20,32771,18740,51511
412035,201712,67,42,25,39354,23425,62779
412040,201712,34,24,10,22207,9370,31577
412050,201712,200,149,51,139613,47787,187400
412060,201712,746,585,161,545334.88,149888.9,695223.78
412065,201712,48,33,15,30921,14055,44976
412070,201712,153,104,49,96792.1,45913,142705.1
412080,201712,275,144,131,134928,122747,257675
412085,201712,31,15,16,14055,14992,29047
412090,201712,735,461,274,430037.1,256738,686775.1
412100,201712,243,203,40,189275,37292.6,226567.6
412110,201712,72,58,14,54346,13118,67464
412120,201712,311,203,108,189648.8,101196,290844.8
412125,201712,78,46,32,42820.9,29984,72804.9
412130,201712,49,35,14,32795,13118,45913
412135,201712,28,15,13,14055,12181,26236
412140,201712,301,213,88,198953.21,82456,281409.21
412150,201712,257,172,85,160227.62,79645,239872.62
412160,201712,81,48,33,44976,30921,75897
412170,201712,631,453,178,424461,166786,591247
412175,201712,42,30,12,28110,11244,39354
412180,201712,198,157,41,146520.29,37807.95,184328.24
412190,201712,330,266,64,248581.41,59968,308549.41
412200,201712,189,122,67,114314,62779,177093
412210,201712,77,59,18,55283,16866,72149
412215,201712,242,164,78,153387,73086,226473
412217,201712,70,54,16,50598,14992,65590
412220,201712,815,608,207,569696,193959,763655
412230,201712,333,205,128,190131.22,119756.97,309888.19
412240,201712,1312,644,668,599550.35,623837.14,1223387.49
412250,201712,380,244,136,228628,127432,356060
412260,201712,126,92,34,86204,31858,118062
412265,201712,165,131,34,122747,31858,154605
412270,201712,86,54,32,50598,29984,80582
412280,201712,89,70,19,65590,17803,83393
412290,201712,95,65,30,60905,28110,89015
412300,201712,220,142,78,133054,73086,206140
412310,201712,44,37,7,34669,6559,41228
412320,201712,96,81,15,75897,14055,89952
412330,201712,168,149,19,139613,17803,157416
412340,201712,146,100,46,93700,42821,136521
412350,201712,595,292,303,272620.15,283911,556531.15
412360,201712,27,24,3,22488,2811,25299
412370,201712,164,140,24,130243,22488,152731
412380,201712,253,189,64,176811.9,59561.89,236373.79
412382,201712,50,27,23,25299,21551,46850
412385,201712,137,98,39,91826,36543,128369
412390,201712,280,209,71,195833,66527,262360
412395,201712,63,49,14,45913,13118,59031
412400,201712,71,52,19,48724,17803,66527
412402,201712,237,109,128,102128.32,119654.9,221783.22
412405,201712,810,321,489,299346.01,457528.24,756874.25
412410,201712,946,594,352,555079,329824,884903
412420,201712,15,11,4,10307,3748,14055
412430,201712,22,15,7,14055,6559,20614
412440,201712,598,320,278,297510.43,258602.52,556112.95
412450,201712,82,68,14,63716,13118,76834
412460,201712,79,63,16,59031,14992,74023
412470,201712,257,204,53,191148,49661,240809
412480,201712,174,134,40,124621.95,37480,162101.95
412490,201712,164,138,26,129306,24362,153668
412500,201712,478,387,91,361353.77,85267,446620.77
412510,201712,189,155,34,144321,31858,176179
412520,201712,127,69,58,64653,54346,118999
412530,201712,106,57,49,53409,45631.9,99040.9
412535,201712,107,82,25,76816,23425,100241
412540,201712,63,30,33,28110,30921,59031
412545,201712,101,74,27,69338,25299,94637
412550,201712,3475,1572,1903,1469584.57,1781987.55,3251572.12
412555,201712,16,11,5,10307,4685,14992
412560,201712,583,438,145,407585.1,135865,543450.1
412570,201712,731,408,323,381696.32,302370,684066.32
412575,201712,85,58,27,54346,25299,79645
412580,201712,163,111,52,104007,48724,152731
412590,201712,32,30,2,28110,1874,29984
412600,201712,173,132,41,123684,38417,162101
412610,201712,33,21,12,19677,10438.18,30115.18
412620,201712,147,130,17,121810,15929,137739
412625,201712,2177,1170,1007,1093256.91,941714.4,2034971.31
412627,201712,69,56,13,52472,12181,64653
412630,201712,430,286,144,266572.1,134647,401219.1
412635,201712,63,20,43,18740,40291,59031
412640,201712,117,78,39,73086,36543,109629
412650,201712,336,210,126,196488.9,118057.32,314546.22
412660,201712,485,290,195,271028,182715,453743
412665,201712,50,44,6,41228,5622,46850
412667,201712,302,204,98,190567.6,91510.92,282078.52
412670,201712,61,51,10,47787,9370,57157
412680,201712,285,227,58,212699,54346,267045
412690,201712,114,75,39,70275,36262,106537
412700,201712,166,112,54,104944,50317,155261
412710,201712,1401,869,532,808913.8,496048.97,1304962.77
412720,201712,228,154,74,144298,69338,213636
412730,201712,207,164,43,153668,39354,193022
412740,201712,413,224,189,209747.45,177093,386840.45
412750,201712,463,266,197,248305,184589,432894
412760,201712,248,129,119,120873,111503,232376
412770,201712,2065,1173,892,1094795.49,835505,1930300.49
412780,201712,149,117,32,109629,29984,139613
412785,201712,265,135,130,126026.5,121810,247836.5
412788,201712,36,21,15,19677,14055,33732
412790,201712,139,114,25,106162.1,23425,129587.1
412795,201712,157,117,40,109629,37480,147109
412796,201712,301,207,94,192815.83,87946.82,280762.65
412800,201712,555,362,193,338644.36,180832,519476.36
412810,201712,2989,1671,1318,1560273.69,1233743.22,2794016.91
412820,201712,937,615,322,566375.5,299318.29,865693.79
412830,201712,16,13,3,12181,2811,14992
412840,201712,217,156,61,145235.1,57157,202392.1
412850,201712,777,528,249,492862,233313,726175
412853,201712,176,94,82,88078,76834,164912
412855,201712,223,122,101,113221.21,94637,207858.21
412860,201712,91,68,23,63716,21551,85267
412862,201712,59,44,15,40946.9,14055,55001.9
412863,201712,7,6,1,5622,937,6559
412865,201712,42,32,10,29984,9370,39354
412870,201712,110,72,38,67464,35606,103070
412880,201712,105,79,26,74023,24362,98385
420005,201712,35,32,3,29984,2249,32233
420010,201712,366,242,124,225608.67,116188,341796.67
420020,201712,75,64,11,59968,10307,70275
420030,201712,28,25,3,23425,2811,26236
420040,201712,106,79,27,74023,25299,99322
420050,201712,56,33,23,30559.9,21390.34,51950.24
420055,201712,20,19,1,17803,937,18740
420060,201712,30,22,8,20614,7496,28110
420070,201712,102,88,14,82456,13108.63,95564.63
420075,201712,13,11,2,10307,1874,12181
420080,201712,46,40,6,36589.85,5622,42211.85
420090,201712,35,33,2,30157.34,1874,32031.34
420100,201712,157,132,25,122747.1,23425,146172.1
420110,201712,17,17,0,15929,0,15929
420120,201712,43,32,11,29984,10307,40291
420125,201712,81,65,16,60905,14992,75897
420127,201712,33,30,3,28110,2811,30921
420130,201712,380,244,136,228337.63,127188.38,355526.01
420140,201712,1263,737,526,688986.89,492798,1181784.89
420150,201712,48,41,7,38417,6559,44976
420160,201712,40,38,2,35606,1874,37480
420165,201712,18,14,4,13118,3748,16866
420170,201712,63,42,21,39354,19677,59031
420180,201712,23,22,1,20614,937,21551
420190,201712,31,28,3,26236,2811,29047
420195,201712,128,61,67,57157,62498,119655
420200,201712,1266,562,704,522192.05,658109.7,1180301.75
420205,201712,66,32,34,29984,31858,61842
420207,201712,103,58,45,54346,42155.63,96501.63
420208,201712,23,18,5,16866,3841.7,20707.7
420209,201712,20,16,4,14992,3748,18740
420210,201712,463,218,245,203984.9,229471.67,433456.57
420213,201712,48,38,10,35606,9370,44976
420215,201712,26,22,4,20614,3748,24362
420220,201712,70,45,25,42165,23425,65590
420230,201712,738,424,314,396539,293927.63,690466.63
420240,201712,2263,1535,728,1430863.96,681486.7,2112350.66
420243,201712,36,29,7,27173,6559,33732
420245,201712,97,57,40,53409,37480,90889
420250,201712,55,31,24,29047,22488,51535
420253,201712,37,31,6,29047,5622,34669
420257,201712,10,8,2,7496,1874,9370
420260,201712,97,86,11,80582,10307,90889
420270,201712,37,30,7,28106,6559,34665
420280,201712,279,205,74,190365.86,68095.35,258461.21
420285,201712,20,12,8,11244,7496,18740
420287,201712,49,31,18,29047,16866,45913
420290,201712,976,690,286,645566.5,267915.2,913481.7
420300,201712,1382,1088,294,1015242.2,274260.77,1289502.97
420310,201712,56,43,13,40291,12181,52472
420315,201712,34,30,4,28110,3748,31858
420320,201712,851,427,424,399138.58,397284,796422.58
420325,201712,0,0,0,0,0,0
420330,201712,118,80,38,74960,35493.56,110453.56
420340,201712,158,108,50,100251,46821.89,147072.89
420350,201712,241,174,67,161727.1,62779,224506.1
420360,201712,744,568,176,530325.23,163320.09,693645.32
420370,201712,105,69,36,64466,33451,97917
420380,201712,1125,801,324,745844.76,302559.62,1048404.38
420390,201712,252,163,89,151495.06,82690.25,234185.31
420395,201712,182,131,51,122747,47777.63,170524.63
420400,201712,245,181,64,169035,59968,229003
420410,201712,58,45,13,42165,12181,54346
420415,201712,34,31,3,29047,2811,31858
420417,201712,47,35,12,32795,11234.63,44029.63
420419,201712,11,11,0,10307,0,10307
420420,201712,2781,1705,1076,1586764.03,1005683.51,2592447.54
420425,201712,68,58,10,54337,9061.53,63398.53
420430,201712,1283,893,390,833803.16,363715.29,1197518.45
420435,201712,15,13,2,12181,1874,14055
420440,201712,109,74,35,68698.96,32622.6,101321.56
420445,201712,23,21,2,19677,1874,21551
420450,201712,76,36,40,33723,37480,71203
420455,201712,249,193,56,180813.26,52399.26,233212.52
420460,201712,2321,1547,774,1444937.18,725016.45,2169953.63
420470,201712,124,89,35,83393,32795,116188
420475,201712,6,6,0,5622,0,5622
420480,201712,844,625,219,580221.39,204266.1,784487.49
420490,201712,112,87,25,81519,23425,104944
420500,201712,675,284,391,264454.1,366367,630821.1
420510,201712,20,17,3,15929,2811,18740
420515,201712,25,20,5,18740,4685,23425
420517,201712,9,9,0,8433,0,8433
420519,201712,0,0,0,0,0,0
420520,201712,67,50,17,46850,15929,62779
420530,201712,159,108,51,100259.95,47787,148046.95
420535,201712,20,17,3,15929,2811,18740
420540,201712,4653,2757,1896,2573085.8,1772008.69,4345094.49
420543,201712,21,21,0,19677,0,19677
420545,201712,188,132,56,122747,52453.26,175200.26
420550,201712,841,671,170,627472.36,159143.12,786615.48
420555,201712,42,30,12,28110,11244,39354
420560,201712,60,47,13,43664.2,12181,55845.2
420570,201712,137,78,59,73086,55273.63,128359.63
420580,201712,302,133,169,124621,158072,282693
420590,201712,509,363,146,339849.9,136802,476651.9
420600,201712,95,49,46,45913,43102,89015
420610,201712,38,36,2,33451,1874,35325
420620,201712,71,58,13,54346,12181,66527
420630,201712,151,107,44,100255,41224,141479
420640,201712,95,85,10,79176.5,9370,88546.5
420650,201712,237,126,111,117406.1,103399.26,220805.36
420660,201712,56,42,14,38604.9,13118,51722.9
420665,201712,38,29,9,27173,8433,35606
420670,201712,316,236,80,220419.88,74660.53,295080.41
420675,201712,15,14,1,13118,937,14055
420680,201712,36,26,10,24362,9370,33732
420690,201712,173,144,29,134928,27173,162101
420700,201712,617,431,186,403764.15,174060.82,577824.97
420710,201712,146,86,60,80582,55938.9,136520.9
420720,201712,105,85,20,79645,18740,98385
420730,201712,512,328,184,306316.99,171126.49,477443.48
420740,201712,45,44,1,41228,937,42165
420750,201712,491,326,165,305180.9,154605,459785.9
420757,201712,17,14,3,12321.55,2811,15132.55
420760,201712,38,30,8,28110,7496,35606
420765,201712,71,59,12,55283,11244,66527
420768,201712,67,59,8,55283,7496,62779
420770,201712,83,70,13,65590,12181,77771
420775,201712,47,44,3,40291,2811,43102
420780,201712,239,186,53,174272.63,49661,223933.63
420785,201712,13,9,4,8433,3748,12181
420790,201712,174,145,29,135529.9,26208.63,161738.53
420800,201712,77,58,19,53596.4,17803,71399.4
420810,201712,247,212,35,198635,31998.55,230633.55
420820,201712,2319,1391,928,1297127.57,868027.93,2165155.50
420830,201712,545,309,236,287292.09,220185.63,507477.72
420840,201712,141,107,34,100259,31858,132117
420845,201712,449,198,251,184866.93,233969,418835.93
420850,201712,224,181,43,169597,40291,209888
420860,201712,61,52,9,48724,8433,57157
420870,201712,117,84,33,78708,30921,109629
420880,201712,168,115,53,107089.73,49661,156750.73
420890,201712,858,424,434,394255.34,406649,800904.34
420895,201712,10,10,0,9370,0,9370
420900,201712,408,321,87,298754.12,81491.26,380245.38
420910,201712,5783,3227,2556,3015411.28,2390537.29,5405948.57
420915,201712,80,73,7,68401,6559,74960
420917,201712,18,13,5,12181,4685,16866
420920,201712,23,15,8,14055,7496,21551
420930,201712,2588,1570,1018,1464201.51,947087.09,2411288.60
420940,201712,595,433,162,404400.3,150170.24,554570.54
420945,201712,8,6,2,5622,1874,7496
420950,201712,55,49,6,45913,5622,51535
420960,201712,115,89,26,83356.26,24353,107709.26
420970,201712,307,247,60,229792.45,56192.63,285985.08
420980,201712,26,25,1,23425,937,24362
420985,201712,62,54,8,50598,7496,58094
420990,201712,66,50,16,46850,14992,61842
421000,201712,32,21,11,19677,10307,29984
421003,201712,67,43,24,40291,22479,62770
421005,201712,8,5,3,4685,2811,7496
421010,201712,766,542,224,507544,207874.5,715418.5
421020,201712,29,24,5,22488,4685,27173
421030,201712,128,106,22,98995,20614,119609
421040,201712,67,57,10,53409,9370,62779
421050,201712,304,218,86,202205.1,80582,282787.1
421055,201712,26,22,4,20614,3748,24362
421060,201712,84,57,27,53409,25299,78708
421070,201712,50,46,4,43102,3748,46850
421080,201712,34,31,3,29047,2811,31858
421085,201712,24,19,5,17803,4685,22488
421090,201712,42,32,10,29984,9370,39354
421100,201712,123,90,33,84330,30921,115251
421105,201712,218,177,41,165709,38393.95,204102.95
421110,201712,111,91,20,84657.95,18740,103397.95
421120,201712,154,121,33,112890.13,30902.26,143792.39
421125,201712,14,10,4,9370,3748,13118
421130,201712,804,514,290,480508.02,270708.87,751216.89
421140,201712,29,21,8,18974.25,7496,26470.25
421145,201712,39,31,8,29047,7496,36543
421150,201712,108,77,31,72149,29047,101196
421160,201712,61,41,20,38407.63,18740,57147.63
421165,201712,18,16,2,14992,1874,16866
421170,201712,190,165,25,153595.52,23416,177011.52
421175,201712,147,96,51,89952,47750.26,137702.26
421180,201712,58,36,22,33376,20614,53990
421185,201712,16,13,3,12181,2811,14992
421187,201712,0,0,0,0,0,0
421189,201712,38,30,8,28110,7486.63,35596.63
421190,201712,1447,892,555,835055,519069.99,1354124.99
421200,201712,87,65,22,59969,20614,80583
421205,201712,24,16,8,14992,7486.63,22478.63
421210,201712,182,122,60,114314,56220,170534
421220,201712,270,214,56,199667.95,52472,252139.95
421223,201712,56,46,10,43102,9370,52472
421225,201712,60,41,19,38417,17803,56220
421227,201712,93,70,23,65590,21551,87141
421230,201712,48,35,13,32795,12181,44976
421240,201712,20,20,0,18740,0,18740
421250,201712,358,219,139,205110,129465.29,334575.29
421260,201712,29,23,6,21551,5622,27173
421265,201712,0,0,0,0,0,0
421270,201712,52,46,6,43102,5622,48724
421280,201712,328,190,138,178030,127619.4,305649.4
421290,201712,311,208,103,194662,95124.56,289786.56
421300,201712,26,21,5,19677,4685,24362
421310,201712,55,42,13,38698.1,12181,50879.1
421315,201712,28,20,8,18740,7496,26236
421320,201712,129,94,35,88078,32795,120873
421330,201712,107,83,24,76627.86,22479,99106.86
421335,201712,41,27,14,25299,13118,38417
421340,201712,290,195,95,180700.5,89015,269715.5
421350,201712,164,97,67,90454,62779,153233
421360,201712,691,511,180,472580.7,168454.63,641035.33
421370,201712,185,142,43,133054,39963.05,173017.05
421380,201712,128,102,26,95569.32,24362,119931.32
421390,201712,18,14,4,13118,3748,16866
421400,201712,113,95,18,89015,16866,105881
421410,201712,23,18,5,16866,4685,21551
421415,201712,18,17,1,15929,937,16866
421420,201712,152,125,27,116562.8,25017.9,141580.7
421430,201712,14,11,3,10307,2811,13118
421440,201712,61,47,14,44039,13118,57157
421450,201712,99,86,13,80582,12181,92763
421460,201712,60,52,8,47934.1,7496,55430.1
421470,201712,70,46,24,43102,22488,65590
421480,201712,634,471,163,440858.5,152722,593580.5
421490,201712,23,21,2,19013,1874,20887
421500,201712,513,328,185,306267.29,173069.82,479337.11
421505,201712,25,18,7,16866,6559,23425
421507,201712,31,25,6,23425,5622,29047
421510,201712,73,47,26,44039,23987.2,68026.2
421520,201712,66,58,8,53597,7496,61093
421530,201712,53,47,6,43383.1,5622,49005.1
421535,201712,29,28,1,25974,937,26911
421540,201712,58,52,6,48724,5622,54346
421545,201712,97,75,22,69798,20614,90412
421550,201712,280,202,78,188619,73086,261705
421555,201712,25,20,5,18740,4592,23332
421560,201712,8,8,0,7496,0,7496
421565,201712,122,91,31,85267,29047,114314
421567,201712,28,23,5,21551,4685,26236
421568,201712,33,31,2,29047,1874,30921
421569,201712,8,8,0,7496,0,7496
421570,201712,139,93,46,87141,43102,130243
421575,201712,27,22,5,20356.33,4685,25041.33
421580,201712,716,430,286,401972.1,267045.27,669017.37
421590,201712,21,20,1,18740,937,19677
421600,201712,110,74,36,69318,32515,101833
421605,201712,101,72,29,67137,27173,94310
421610,201712,187,146,41,136802,38417,175219
421620,201712,1109,663,446,618776.76,417883.26,1036660.02
421625,201712,21,18,3,16866,2811,19677
421630,201712,276,176,100,164866,92857,257723
421635,201712,17,8,9,7496,8433,15929
421640,201712,100,86,14,80582,13118,93700
421650,201712,271,159,112,148964.26,104925.26,253889.52
421660,201712,2074,1237,837,1156184.86,783014.16,1939199.02
421670,201712,167,124,43,116188,40291,156479
421680,201712,166,151,15,141487,14046,155533
421690,201712,343,239,104,223634.9,96501.99,320136.89
421700,201712,54,33,21,30921,18834,49755
421710,201712,25,25,0,23425,0,23425
421715,201712,10,9,1,8433,937,9370
421720,201712,573,412,161,383456.7,149161.4,532618.1
421725,201712,13,6,7,5622,6559,12181
421730,201712,43,30,13,27392.48,12181,39573.48
421740,201712,84,40,44,37480,41228,78708
421750,201712,217,160,57,147858.7,53409,201267.7
421755,201712,25,24,1,22488,937,23425
421760,201712,103,73,30,68391.63,28110,96501.63
421770,201712,560,381,179,354827.89,167658.15,522486.04
421775,201712,25,16,9,14992,8433,23425
421780,201712,189,148,41,138394.9,38417,176811.9
421790,201712,155,130,25,121294.65,23425,144719.65
421795,201712,16,13,3,12181,2811,14992
421800,201712,454,290,164,270947.51,153668,424615.51
421810,201712,69,55,14,51535,13118,64653
421820,201712,297,204,93,190183.1,87141,277324.1
421825,201712,128,106,22,99322,20614,119936
421830,201712,128,98,30,91826,28110,119936
421835,201712,3,3,0,2811,0,2811
421840,201712,61,51,10,47778,9370,57148
421850,201712,81,72,9,67464,8429,75893
421860,201712,42,32,10,29702.9,9370,39072.9
421870,201712,971,732,239,677093.34,223086.96,900180.30
421875,201712,50,44,6,41228,5622,46850
421880,201712,163,118,45,110566,41884,152450
421885,201712,27,23,4,21551,3748,25299
421890,201712,112,78,34,73086,31858,104944
421895,201712,38,35,3,32795,2811,35606
421900,201712,151,122,29,114240.15,27128,141368.15
421910,201712,65,43,22,40291,20614,60905
421915,201712,31,25,6,23425,5622,29047
421917,201712,38,27,11,25299,10307,35606
421920,201712,32,29,3,27173,2811,29984
421930,201712,756,584,172,545512.03,161127.63,706639.66
421935,201712,57,50,7,46850,6559,53409
421940,201712,39,37,2,34669,1874,36543
421950,201712,831,548,283,507518.93,262678.66,770197.59
421960,201712,39,35,4,32514,3748,36262
421970,201712,369,233,136,217831.12,127401.12,345232.24
421985,201712,29,19,10,17803,9370,27173
422000,201712,0,0,0,0,0,0
430003,201712,206,48,158,44273.25,148046,192319.25
430005,201712,36,28,8,26236,7496,33732
430010,201712,278,195,83,182246.5,77771,260017.5
430020,201712,152,99,53,92482,48724,141206
430030,201712,126,98,28,91544.9,26236,117780.9
430040,201712,2990,1739,1251,1621803.32,1170594.94,2792398.26
430045,201712,69,59,10,55002,9370,64372
430047,201712,6,5,1,4685,937,5622
430050,201712,80,67,13,62779,12181,74960
430055,201712,17,14,3,13118,2811,15929
430057,201712,4,2,2,1874,1874,3748
430060,201712,3697,2191,1506,2045539.82,1407385.24,3452925.06
430063,201712,56,50,6,46850,5622,52472
430064,201712,145,123,22,115251,20614,135865
430066,201712,10,7,3,6559,2811,9370
430070,201712,45,33,12,30921,11244,42165
430080,201712,69,48,21,44288.8,19677,63965.8
430085,201712,37,11,26,10307,24362,34669
430087,201712,36,27,9,25159,8433,33592
430090,201712,71,64,7,59686.9,6559,66245.9
430100,201712,115,76,39,70275,36543,106818
430105,201712,148,74,74,69338,69038.16,138376.16
430107,201712,22,16,6,14992,5622,20614
430110,201712,411,238,173,222209.55,162044.78,384254.33
430120,201712,137,125,12,116188.95,11244,127432.95
430130,201712,785,493,292,461331.95,273322.9,734654.85
430140,201712,123,113,10,105881,9370,115251
430150,201712,112,73,39,67652,35606,103258
430155,201712,33,30,3,28110,2811,30921
430160,201712,3801,2236,1565,2076019.5,1462404.11,3538423.61
430163,201712,327,144,183,133804.57,171414.78,305219.35
430165,201712,22,16,6,14992,5622,20614
430170,201712,81,73,8,68401,7496,75897
430175,201712,82,63,19,59031,17147.1,76178.1
430180,201712,91,72,19,67464,17193.95,84657.95
430185,201712,31,23,8,21551,7496,29047
430187,201712,103,43,60,40291,55920.9,96211.9
430190,201712,220,126,94,118015.15,87412.73,205427.88
430192,201712,14,14,0,13118,0,13118
430195,201712,13,8,5,7496,4685,12181
430200,201712,162,143,19,133335.1,17803,151138.1
430205,201712,20,19,1,17803,937,18740
430210,201712,618,479,139,445168.7,128978.15,574146.85
430215,201712,17,14,3,13118,2811,15929
430220,201712,61,43,18,40291,16866,57157
430222,201712,14,7,7,6559,6559,13118
430223,201712,15,8,7,7496,6559,14055
430225,201712,4,3,1,2811,937,3748
430230,201712,296,183,113,170534,105881,276415
430235,201712,52,38,14,35606,13108.63,48714.63
430237,201712,29,22,7,20614,6559,27173
430240,201712,130,81,49,75428.5,45903.63,121332.13
430245,201712,71,60,11,56220,10307,66527
430250,201712,191,110,81,103060.63,75887.63,178948.26
430258,201712,14,12,2,11244,1874,13118
430260,201712,34,30,4,28110,3738.63,31848.63
430265,201712,36,29,7,27154.26,6559,33713.26
430270,201712,564,413,151,383373.37,139707.81,523081.18
430280,201712,1016,627,389,583835.93,362038.8,945874.73
430290,201712,380,220,160,204266.4,149920,354186.4
430300,201712,2107,1156,951,1077486.86,888081.3,1965568.16
430310,201712,1981,1039,942,966623.1,879595.32,1846218.42
430320,201712,48,40,8,37465.95,7496,44961.95
430330,201712,97,88,9,81987.5,8433,90420.5
430340,201712,66,58,8,54346,7496,61842
430350,201712,1656,1152,504,1067215.99,470534.03,1537750.02
430355,201712,25,22,3,20614,2811,23425
430360,201712,82,39,43,36543,39073,75616
430367,201712,28,19,9,17803,8433,26236
430370,201712,55,48,7,44976,6559,51535
430380,201712,129,97,32,90326.8,29984,120310.8
430390,201712,614,381,233,356715.9,218021.63,574737.53
430400,201712,136,106,30,97635.4,28091.26,125726.66
430410,201712,56,45,11,42165,10307,52472
430420,201712,494,326,168,303026.9,154915.48,457942.38
430430,201712,54,52,2,48099.95,1874,49973.95
430435,201712,157,118,39,109629,35840.25,145469.25
430440,201712,511,341,170,319517,159102.6,478619.6
430450,201712,1188,981,207,911796.27,193949.63,1105745.90
430460,201712,5110,2781,2329,2590210.88,2176767.23,4766978.11
430461,201712,17,15,2,14055,1874,15929
430462,201712,11,7,4,6559,3748,10307
430463,201712,1019,536,483,499778.39,452225.05,952003.44
430465,201712,28,16,12,14992,11244,26236
430466,201712,652,471,181,439453.1,169409.6,608862.7
430467,201712,100,59,41,54065.4,38407.63,92473.03
430468,201712,110,68,42,63716,39107.39,102823.39
430469,201712,23,17,6,15929,5622,21551
430470,201712,1174,650,524,601183.37,489067.15,1090250.52
430471,201712,48,36,12,33713.26,11244,44957.26
430480,201712,96,60,36,55376.7,33722.63,89099.33
430485,201712,5,5,0,4404,0,4404
430490,201712,94,75,19,69479.35,17803,87282.35
430495,201712,35,28,7,26236,6559,32795
430500,201712,194,132,62,122981.25,57724.63,180705.88
430510,201712,3050,2033,1017,1898672.35,952057.96,2850730.31
430511,201712,18,18,0,16866,0,16866
430512,201712,135,92,43,86204,40291,126495
430513,201712,52,46,6,42633.5,5622,48255.5
430515,201712,31,29,2,27173,1874,29047
430517,201712,169,149,20,138676.25,18721.26,157397.51
430520,201712,367,252,115,235469,107726.89,343195.89
430530,201712,90,53,37,49661,34669,84330
430535,201712,475,313,162,293084.92,151770.58,444855.50
430537,201712,10,10,0,9370,0,9370
430540,201712,73,47,26,44039,24362,68401
430543,201712,371,115,256,107755,239872,347627
430544,201712,43,39,4,36543,3748,40291
430545,201712,342,159,183,148965,170983.76,319948.76
430550,201712,43,35,8,32795,7496,40291
430558,201712,6,4,2,3748,1874,5622
430560,201712,46,20,26,18740,24362,43102
430570,201712,106,46,60,43102,56163.78,99265.78
430580,201712,124,97,27,90889,25252.15,116141.15
430583,201712,14,14,0,13118,0,13118
430585,201712,9,4,5,3748,4685,8433
430587,201712,14,8,6,7496,5622,13118
430590,201712,152,127,25,117780.9,23425,141205.9
430593,201712,4,4,0,3748,0,3748
430595,201712,15,10,5,9370,4685,14055
430597,201712,51,26,25,24362,23425,47787
430600,201712,214,148,66,138666.63,61560.9,200227.53
430605,201712,159,99,60,92763,56210.63,148973.63
430607,201712,26,21,5,19677,4685,24362
430610,201712,1641,765,876,713901.15,815621.49,1529522.64
430613,201712,2,2,0,1874,0,1874
430620,201712,112,80,32,74820,29974.63,104794.63
430630,201712,45,40,5,37480,4685,42165
430632,201712,31,26,5,24362,4685,29047
430635,201712,41,37,4,34669,3748,38417
430637,201712,55,31,24,29047,22488,51535
430640,201712,213,118,95,109722.7,89015,198737.7
430642,201712,28,26,2,24362,1874,26236
430645,201712,32,28,4,26236,3748,29984
430650,201712,252,201,51,188056,47740.15,235796.15
430655,201712,4,4,0,3748,0,3748
430660,201712,955,464,491,433221.95,458567.9,891789.85
430670,201712,71,51,20,47787,18740,66527
430673,201712,72,40,32,37480,29984,67464
430675,201712,13,10,3,9370,2811,12181
430676,201712,483,296,187,276640.62,175148.84,451789.46
430680,201712,250,177,73,163694,68401,232095
430690,201712,525,312,213,291454.96,197954.01,489408.97
430692,201712,7,5,2,4685,1874,6559
430693,201712,136,90,46,84330,42483.58,126813.58
430695,201712,73,66,7,60923.74,6559,67482.74
430697,201712,60,36,24,33732,22488,56220
430700,201712,1591,1114,477,1032423.59,446949,1479372.59
430705,201712,19,18,1,16866,937,17803
430710,201712,259,167,92,156479,86204,242683
430720,201712,108,92,16,86016.6,14992,101008.6
430730,201712,119,102,17,94637,15929,110566
430740,201712,64,43,21,40291,19677,59968
430745,201712,37,30,7,27829,6559,34388
430750,201712,336,229,107,213650.72,99322,312972.72
430755,201712,81,45,36,42165,33732,75897
430760,201712,368,221,147,204454.16,137711.26,342165.42
430770,201712,1470,755,715,705354.96,665577.93,1370932.89
430780,201712,318,204,114,190184.16,106752.78,296936.94
430781,201712,28,23,5,21551,4685,26236
430783,201712,49,39,10,36230.8,9370,45600.8
430786,201712,6,3,3,2811,2811,5622
430790,201712,484,312,172,289797.4,160873.63,450671.03
430800,201712,150,126,24,118062,22488,140550
430805,201712,42,38,4,35606,3748,39354
430807,201712,34,21,13,19677,12181,31858
430810,201712,71,45,26,42165,24362,66527
430820,201712,130,80,50,74960,46194.1,121154.1
430825,201712,12,10,2,9370,1874,11244
430830,201712,232,217,15,203029.26,14055,217084.26
430840,201712,123,83,40,77771,36824.1,114595.1
430843,201712,5,3,2,2811,1874,4685
430845,201712,70,39,31,36543,29047,65590
430850,201712,566,390,176,364277.49,164783.04,529060.53
430860,201712,153,97,56,90233.1,51806.73,142039.83
430865,201712,62,30,32,27454.1,29674.79,57128.89
430870,201712,78,63,15,59031,14055,73086
430880,201712,158,118,40,110547.26,37480,148027.26
430885,201712,7,6,1,5622,937,6559
430890,201712,334,203,131,188580.62,122747,311327.62
430900,201712,541,372,169,344441.7,157875.13,502316.83
430905,201712,83,33,50,30921,46850,77771
430910,201712,268,150,118,140550,109902,250452
430912,201712,4,4,0,3748,0,3748
430915,201712,35,27,8,25299,7214.9,32513.9
430920,201712,4151,2322,1829,2169083.42,1711996.41,3881079.83
430925,201712,5,4,1,3504.38,937,4441.38
430930,201712,2075,1232,843,1146741.42,788666.07,1935407.49
430940,201712,235,146,89,136136.73,83374.26,219510.99
430950,201712,159,130,29,121810,27173,148983
430955,201712,20,12,8,11244,7496,18740
430957,201712,18,17,1,15929,937,16866
430960,201712,239,157,82,145375.55,76834,222209.55
430965,201712,104,65,39,60905,36543,97448
430970,201712,77,65,12,60905,10307,71212
430975,201712,34,32,2,29984,1874,31858
430980,201712,43,26,17,24362,15929,40291
430990,201712,111,86,25,80582,23425,104007
430995,201712,115,111,4,102788.9,3748,106536.9
431000,201712,296,136,160,125319.1,149920,275239.1
431010,201712,338,205,133,191119.89,124621,315740.89
431020,201712,1930,1116,814,1037937.95,758576.28,1796514.23
431030,201712,42,34,8,31858,7496,39354
431033,201712,381,187,194,174422.6,181778,356200.6
431036,201712,15,9,6,8433,5622,14055
431040,201712,129,77,52,71212,48616.25,119828.25
431041,201712,37,25,12,23425,11244,34669
431043,201712,44,25,19,23425,17803,41228
431046,201712,12,7,5,6559,4685,11244
431050,201712,208,132,76,122204.91,70187.93,192392.84
431053,201712,74,44,30,40478.4,28110,68588.4
431055,201712,63,42,21,39354,19658.26,59012.26
431057,201712,17,17,0,15929,0,15929
431060,201712,1690,1060,630,986119.19,588479.95,1574599.14
431065,201712,17,10,7,9370,6559,15929
431070,201712,72,67,5,62779,4685,67464
431075,201712,8,8,0,7496,0,7496
431080,201712,136,87,49,81237.9,45913,127150.9
431085,201712,30,27,3,25299,2811,28110
431087,201712,15,13,2,12181,1874,14055
431090,201712,57,45,12,42165,11244,53409
431100,201712,1232,735,497,681199.91,465689,1146888.91
431110,201712,242,151,91,141487,85257.63,226744.63
431112,201712,30,18,12,16866,11244,28110
431113,201712,30,19,11,17803,10307,28110
431115,201712,154,104,50,96823.2,46840.63,143663.83
431120,201712,620,368,252,342905.42,236050.52,578955.94
431123,201712,3,2,1,1874,937,2811
431125,201712,90,80,10,74960,9370,84330
431127,201712,7,3,4,2811,3748,6559
431130,201712,618,401,217,374518.9,203029.16,577548.06
431140,201712,726,492,234,456740.8,219183.04,675923.84
431142,201712,32,25,7,22235,6559,28794
431150,201712,205,151,54,141487,50588.63,192075.63
431160,201712,56,50,6,46850,5622,52472
431162,201712,20,14,6,13118,5622,18740
431164,201712,4,4,0,3748,0,3748
431170,201712,102,84,18,78708,16866,95574
431171,201712,49,27,22,25299,20604.63,45903.63
431173,201712,1,1,0,937,0,937
431175,201712,204,99,105,91545,98375.63,189920.63
431177,201712,72,54,18,50598,16192.26,66790.26
431179,201712,13,11,2,10307,1874,12181
431180,201712,435,263,172,246431,161145.63,407576.63
431190,201712,88,67,21,62779,19677,82456
431198,201712,69,45,24,42165,22488,64653
431200,201712,18,16,2,14992,1874,16866
431205,201712,23,23,0,21551,0,21551
431210,201712,87,53,34,49334,31858,81192
431213,201712,25,20,5,18740,4685,23425
431215,201712,26,23,3,21551,2811,24362
431217,201712,7,6,1,5622,937,6559
431220,201712,67,58,9,54346,8433,62779
431225,201712,151,101,50,94628,46840.63,141468.63
431230,201712,102,88,14,81800.1,13118,94918.1
431235,201712,7,7,0,6559,0,6559
431237,201712,25,16,9,14992,8433,23425
431238,201712,15,11,4,10026,3748,13774
431240,201712,984,635,349,593365.42,326507.02,919872.44
431242,201712,34,34,0,31858,0,31858
431244,201712,11,8,3,7496,2811,10307
431245,201712,61,47,14,43384,13118,56502
431247,201712,13,10,3,9370,2811,12181
431250,201712,268,137,131,128303.41,122073.26,250376.67
431260,201712,60,43,17,40291,15929,56220
431261,201712,22,15,7,14055,6559,20614
431262,201712,16,16,0,14992,0,14992
431265,201712,166,87,79,81519,74023,155542
431267,201712,15,14,1,13118,937,14055
431270,201712,313,261,52,244557,48724,293281
431275,201712,41,39,2,36543,1874,38417
431280,201712,21,17,4,15109.12,3748,18857.12
431290,201712,20,17,3,15929,2811,18740
431295,201712,5,5,0,4685,0,4685
431300,201712,22,19,3,17803,2811,20614
431301,201712,7,7,0,6559,0,6559
431303,201712,51,34,17,31736.19,15647.9,47384.09
431306,201712,222,116,106,108244.11,99322,207566.11
431308,201712,6,5,1,4685,937,5622
431310,201712,63,53,10,49661,9370,59031
431320,201712,123,73,50,68401,46278.43,114679.43
431330,201712,177,117,60,109629,56220,165849
431333,201712,33,27,6,25299,5622,30921
431335,201712,10,5,5,4685,4685,9370
431337,201712,320,150,170,139736.1,158278.14,298014.24
431339,201712,19,16,3,14992,2811,17803
431340,201712,3062,1763,1299,1647342.76,1215310.07,2862652.83
431342,201712,46,29,17,27173,15929,43102
431344,201712,18,17,1,15929,937,16866
431346,201712,3,3,0,2811,0,2811
431349,201712,36,33,3,30921,2811,33732
431350,201712,900,533,367,494953.73,342904.52,837858.25
431360,201712,45,39,6,36543,5622,42165
431365,201712,316,150,166,140531.26,154314.53,294845.79
431370,201712,1319,789,530,735442.99,496425.19,1231868.18
431380,201712,98,83,15,77771,14055,91826
431390,201712,504,282,222,263268.99,207106.01,470375.00
431395,201712,275,117,158,109629,148028,257657
431400,201712,38,30,8,28110,7496,35606
431402,201712,94,65,29,60905,27173,88078
431403,201712,14,9,5,8433,4685,13118
431405,201712,648,348,300,324979.81,281073,606052.81
431406,201712,31,27,4,25299,3748,29047
431407,201712,49,41,8,38417,7496,45913
431410,201712,3207,1908,1299,1775510.75,1215242.15,2990752.90
431413,201712,15,13,2,12181,1874,14055
431415,201712,72,52,20,48724,18740,67464
431417,201712,23,12,11,11244,10307,21551
431420,201712,298,209,89,195189.56,83383.63,278573.19
431430,201712,42,17,25,15929,23425,39354
431440,201712,8933,6365,2568,5895510.8,2396787.25,8292298.05
431442,201712,27,14,13,13118,12181,25299
431445,201712,26,20,6,18740,5622,24362
431446,201712,7,6,1,5622,937,6559
431447,201712,84,59,25,55283,23425,78708
431449,201712,48,44,4,41228,3748,44976
431450,201712,411,286,125,266248.55,116422.25,382670.80
431454,201712,0,0,0,0,0,0
431455,201712,49,38,11,35606,10307,45913
431460,201712,522,360,162,333759.4,151372.9,485132.3
431470,201712,117,91,26,84587.86,24362,108949.86
431475,201712,11,10,1,9370,937,10307
431477,201712,36,26,10,24362,9370,33732
431478,201712,8,7,1,6559,937,7496
431480,201712,492,308,184,287013.41,172361.15,459374.56
431490,201712,28151,15954,12197,14877518.27,11394950.4,26272468.67
431500,201712,79,54,25,50598,23425,74023
431505,201712,46,20,26,18740,24362,43102
431507,201712,11,9,2,8433,1874,10307
431510,201712,279,181,98,168894.9,90870.26,259765.16
431513,201712,23,18,5,16866,4685,21551
431514,201712,8,7,1,6559,937,7496
431515,201712,80,67,13,62779,12181,74960
431517,201712,3,1,2,937,1874,2811
431520,201712,36,32,4,29984,3748,33732
431530,201712,1609,713,896,667052.52,839097.67,1506150.19
431531,201712,22,20,2,18740,1874,20614
431532,201712,24,17,7,15929,6559,22488
431535,201712,25,16,9,14992,8433,23425
431540,201712,142,127,15,117434.21,14055,131489.21
431545,201712,19,17,2,15929,1874,17803
431550,201712,346,203,143,190211,133897.3,324108.3
431555,201712,12,11,1,10307,937,11244
431560,201712,4401,3118,1283,2893349.49,1199951.13,4093300.62
431570,201712,766,407,359,378267.1,333563.63,711830.73
431575,201712,35,24,11,22488,10307,32795
431580,201712,96,67,29,61842,27173,89015
431590,201712,136,114,22,105881,20614,126495
431595,201712,12,11,1,10307,937,11244
431600,201712,216,125,91,117125,85267,202392
431610,201712,127,92,35,85548.1,32795,118343.1
431620,201712,42,34,8,31858,7496,39354
431630,201712,131,112,19,104944,17803,122747
431640,201712,1322,827,495,770495.1,462260.32,1232755.42
431642,201712,41,37,4,34200.5,3748,37948.5
431643,201712,44,20,24,18740,22488,41228
431645,201712,303,172,131,159945.9,121810,281755.9
431647,201712,11,11,0,10307,0,10307
431650,201712,33,24,9,22488,8433,30921
431660,201712,279,182,97,168378.9,90889,259267.9
431670,201712,216,103,113,93934.25,105852.89,199787.14
431673,201712,3,3,0,2811,0,2811
431675,201712,28,24,4,22206.9,3748,25954.9
431680,201712,1086,777,309,724301,288503.04,1012804.04
431690,201712,4747,2900,1847,2699074.74,1725843.91,4424918.65
431695,201712,26,20,6,18740,5622,24362
431697,201712,0,0,0,0,0,0
431700,201712,168,127,41,118999,38417,157416
431710,201712,3979,1715,2264,1604238.02,2119949.56,3724187.58
431720,201712,1400,828,572,768377.36,535013.63,1303390.99
431725,201712,1,1,0,937,0,937
431730,201712,1194,809,385,751176.95,360745,1111921.95
431740,201712,1372,684,688,636373.66,644123.86,1280497.52
431750,201712,1878,1213,665,1125549.02,621203.26,1746752.28
431755,201712,5,4,1,3748,937,4685
431760,201712,1088,694,394,649903.2,368953.49,1018856.69
431770,201712,392,287,105,268909.63,98366.26,367275.89
431775,201712,27,21,6,19677,5622,25299
431780,201712,556,344,212,321231.71,198634.63,519866.34
431790,201712,150,112,38,104007,35559.15,139566.15
431795,201712,13,11,2,10307,1874,12181
431800,201712,3391,1779,1612,1655506.51,1503602.96,3159109.47
431805,201712,15,14,1,13118,937,14055
431810,201712,617,416,201,387205.88,188206.19,575412.07
431820,201712,316,177,139,165849,129259.15,295108.15
431830,201712,2320,1412,908,1319689.05,849547.96,2169237.01
431840,201712,512,337,175,312209.7,162757,474966.7
431842,201712,34,28,6,26236,5622,31858
431843,201712,11,7,4,6559,3748,10307
431844,201712,14,12,2,11244,1874,13118
431845,201712,30,27,3,25299,2811,28110
431846,201712,29,25,4,23425,3748,27173
431848,201712,13,11,2,10307,1874,12181
431849,201712,8,6,2,5622,1874,7496
431850,201712,805,668,137,624421.96,128134.75,752556.71
431860,201712,102,75,27,70275,24362,94637
431861,201712,4,2,2,1874,1874,3748
431862,201712,48,33,15,30921,14055,44976
431870,201712,3472,2046,1426,1908786.38,1334872.01,3243658.39
431880,201712,933,684,249,636195,232376,868571
431890,201712,1308,808,500,751868.37,466922,1218790.37
431900,201712,184,127,57,118999,52631.29,171630.29
431910,201712,56,41,15,38417,14055,52472
431912,201712,35,19,16,17803,14992,32795
431915,201712,125,100,25,93700,23425,117125
431920,201712,144,107,37,99977.9,34669,134646.9
431930,201712,86,70,16,65590,14992,80582
431935,201712,4,3,1,2811,937,3748
431936,201712,12,11,1,10307,937,11244
431937,201712,17,12,5,11244,4685,15929
431940,201712,444,295,149,273697.7,139603.63,413301.33
431950,201712,462,301,161,280819.64,150726.56,431546.20
431960,201712,709,420,289,389428.31,270634.45,660062.76
431970,201712,73,65,8,60905,7496,68401
431971,201712,3,3,0,2811,0,2811
431973,201712,19,16,3,14992,2811,17803
431975,201712,6,5,1,4685,937,5622
431980,201712,200,126,74,116562.8,69338,185900.8
431990,201712,1234,654,580,611162.09,543423,1154585.09
432000,201712,1673,899,774,835162.57,721739.12,1556901.69
432010,201712,275,184,91,171315.3,85267,256582.3
432020,201712,172,136,36,127432,33722.63,161154.63
432023,201712,21,16,5,14992,4685,19677
432026,201712,67,60,7,56220,6559,62779
432030,201712,60,29,31,27173,29047,56220
432032,201712,23,20,3,18740,2811,21551
432035,201712,46,36,10,33732,9370,43102
432040,201712,99,68,31,63716,29047,92763
432045,201712,8,7,1,6277.9,937,7214.9
432050,201712,70,42,28,39354,26236,65590
432055,201712,99,75,24,70256.26,22488,92744.26
432057,201712,1,0,1,0,937,937
432060,201712,39,36,3,33029.25,2811,35840.25
432065,201712,32,29,3,27173,2811,29984
432067,201712,94,82,12,76815.26,11244,88059.26
432070,201712,402,302,100,281401.29,93672.26,375073.55
432080,201712,812,564,248,526800.14,232311.15,759111.29
432085,201712,15,11,4,10307,3748,14055
432090,201712,260,165,95,154605,89015,243620
432100,201712,175,116,59,108410.9,55283,163693.9
432110,201712,599,411,188,378689.02,175219,553908.02
432120,201712,971,577,394,539993.1,369140.52,909133.62
432130,201712,500,360,140,336008.2,131039.45,467047.65
432132,201712,26,23,3,21551,2811,24362
432135,201712,78,65,13,60905,12181,73086
432140,201712,263,208,55,194605.53,51535,246140.53
432143,201712,186,117,69,109629,64653,174282
432145,201712,268,185,83,171320.12,77489.9,248810.02
432146,201712,15,14,1,13118,937,14055
432147,201712,140,62,78,58094,73062.58,131156.58
432149,201712,17,12,5,11244,4685,15929
432150,201712,821,520,301,486068.75,279054.15,765122.90
432160,201712,1393,723,670,675194.2,626919.56,1302113.76
432162,201712,4,3,1,2811,937,3748
432163,201712,18,14,4,13118,3748,16866
432166,201712,120,91,29,85502,27173,112675
432170,201712,228,124,104,115252,97448,212700
432180,201712,522,316,206,293000.89,192741,485741.89
432183,201712,8,6,2,5622,1874,7496
432185,201712,83,71,12,66433.3,11244,77677.3
432190,201712,475,259,216,241540.63,202261.56,443802.19
432195,201712,83,72,11,66761.25,10307,77068.25
432200,201712,407,261,146,244557,136755.52,381312.52
432210,201712,117,76,41,69197.45,38417,107614.45
432215,201712,62,59,3,55283,2811,58094
432218,201712,19,18,1,16866,937,17803
432220,201712,671,337,334,314768.05,312458.97,627227.02
432225,201712,16,10,6,8901.5,5622,14523.5
432230,201712,150,87,63,81284.75,59031,140315.75
432232,201712,15,13,2,12181,1874,14055
432234,201712,4,3,1,2811,937,3748
432235,201712,1,1,0,937,0,937
432237,201712,30,17,13,15929,12181,28110
432240,201712,4188,2332,1856,2175454.02,1731520.65,3906974.67
432250,201712,1016,645,371,601789.38,347467.71,949257.09
432252,201712,40,31,9,28316.14,8433,36749.14
432253,201712,60,49,11,45913,10307,56220
432254,201712,21,9,12,8433,11244,19677
432255,201712,14,13,1,12181,937,13118
432260,201712,840,661,179,618317.03,166786.75,785103.78
432270,201712,216,159,57,148983,53409,202392
432280,201712,119,85,34,79176.9,31858,111034.9
432285,201712,2,1,1,937,937,1874
432290,201712,69,62,7,56501.1,6559,63060.1
432300,201712,4654,2652,2002,2469193.2,1871687.24,4340880.44
432310,201712,115,91,24,85246.89,22488,107734.89
432320,201712,19,14,5,13118,4685,17803
432330,201712,15,10,5,9370,4685,14055
432335,201712,8,7,1,6559,937,7496
432340,201712,40,36,4,33732,3748,37480
432345,201712,86,62,24,58094,22488,80582
432350,201712,22,21,1,19677,937,20614
432360,201712,7,5,2,4685,1874,6559
432370,201712,25,25,0,23425,0,23425
432375,201712,42,36,6,33732,5622,39354
432377,201712,7,7,0,6559,0,6559
432380,201712,168,73,95,67745.1,88968.15,156713.25
500020,201712,247,135,112,126495,104353.69,230848.69
500025,201712,118,58,60,53409,56220,109629
500060,201712,1380,843,537,789328.8,502574.21,1291903.01
500070,201712,746,352,394,329479,369159.63,698638.63
500080,201712,135,103,32,96511,29984,126495
500085,201712,143,116,27,108411,24479.13,132890.13
500090,201712,332,159,173,148983,162101,311084
500100,201712,698,371,327,345471.9,305837,651308.9
500110,201712,2247,1000,1247,936687.63,1167450.3,2104137.93
500124,201712,310,179,131,167723,122465.9,290188.9
500150,201712,331,131,200,122738,187046,309784
500190,201712,523,357,166,333834.36,155061,488895.36
500200,201712,203,171,32,159890,29984,189874
500210,201712,1455,521,934,486926.48,874096.47,1361022.95
500215,201712,240,138,102,128365.21,95574,223939.21
500220,201712,787,514,273,481377.52,255057.63,736435.15
500230,201712,259,180,79,167957.25,73554.5,241511.75
500240,201712,711,495,216,463065.4,201923.9,664989.3
500260,201712,569,209,360,195833,337320,533153
500270,201712,28332,12008,16324,11222632.02,15279860.29,26502492.31
500280,201712,192,73,119,68401,111503,179904
500290,201712,1189,693,496,648405,464743,1113148
500295,201712,400,242,158,226754,148036.63,374790.63
500310,201712,64,20,44,18740,41228,59968
500315,201712,702,416,286,389782.63,267691.53,657474.16
500320,201712,3662,1822,1840,1704830.39,1722471.11,3427301.50
500325,201712,938,515,423,482087,395393.32,877480.32
500330,201712,1499,686,813,640599.86,761168.43,1401768.29
500345,201712,322,235,87,219249.1,81519,300768.1
500348,201712,242,140,102,131180,95555.63,226735.63
500350,201712,144,71,73,66527,68401,134928
500370,201712,5442,2428,3014,2267403.14,2821386.16,5088789.30
500375,201712,344,249,95,233303.63,89015,322318.63
500380,201712,579,330,249,309055.4,233303.63,542359.03
500390,201712,72,36,36,33732,33732,67464
500400,201712,218,147,71,137720.26,66518,204238.26
500410,201712,576,223,353,208905.58,330615.42,539521.00
500430,201712,541,374,167,350438,156479,506917
500440,201712,204,106,98,98561.42,91826,190387.42
500450,201712,414,176,238,164223.8,222624.46,386848.26
500460,201712,316,157,159,147099.63,148983,296082.63
500470,201712,438,344,94,321135.05,87132,408267.05
500480,201712,111,67,44,62779,41228,104007
500490,201712,106,41,65,38412.32,60905,99317.32
500500,201712,1456,500,956,466701.8,894894.53,1361596.33
500510,201712,47,36,11,33732,10298,44030
500515,201712,111,77,34,72149,31577,103726
500520,201712,354,199,155,185433,144950,330383
500525,201712,87,49,38,45913,35324.9,81237.9
500540,201712,897,370,527,346624.78,492807.03,839431.81
500560,201712,894,504,390,470530.66,364761.51,835292.17
500568,201712,993,575,418,534090.1,391380.32,925470.42
500570,201712,1213,683,530,637300.59,494319.86,1131620.45
500580,201712,337,172,165,160873.53,154592,315465.53
500600,201712,318,159,159,148284.93,148965,297249.93
500620,201712,898,632,266,586510.61,249045.23,835555.84
500625,201712,79,67,12,62084.78,11244,73328.78
500627,201712,23,10,13,9370,12181,21551
500630,201712,1579,832,747,778638.53,699466.22,1478104.75
500635,201712,518,295,223,276002.72,208810.45,484813.17
500640,201712,429,225,204,208296.5,191129.63,399426.13
500660,201712,5500,2108,3392,1971261.7,3174631.36,5145893.06
500690,201712,578,203,375,189868.39,349471.4,539339.79
500710,201712,355,171,184,159946,172117.9,332063.9
500720,201712,964,562,402,525184.32,376468.26,901652.58
500730,201712,194,112,82,104944,76548.22,181492.22
500740,201712,852,369,483,344475.82,451827,796302.82
500750,201712,135,43,92,40291,85895.26,126186.26
500755,201712,123,89,34,83112,31858,114970
500769,201712,742,416,326,389475.7,305449,694924.7
500770,201712,447,234,213,219248.63,199337.38,418586.01
500780,201712,173,116,57,108692,53409,162101
500790,201712,1038,514,524,481051.32,490666.63,971717.95
500793,201712,255,134,121,125558,113368,238926
500795,201712,176,125,51,117115.63,47778,164893.63
500797,201712,39,31,8,29047,7496,36543
500800,201712,416,179,237,167714,221787.9,389501.9
500830,201712,2179,1221,958,1141707.76,896671.89,2038379.65
500840,201712,143,106,37,99322,34660,133982
510010,201712,168,92,76,86194.63,71212,157406.63
510020,201712,485,225,260,210533.3,243088.75,453622.05
510025,201712,1656,928,728,868700.14,679342.97,1548043.11
510030,201712,626,322,304,301668.26,284097.32,585765.58
510035,201712,127,57,70,53381.63,65571.63,118953.26
510040,201712,383,168,215,157416,201015.53,358431.53
510050,201712,431,231,200,215719.1,186580.89,402299.99
510060,201712,115,57,58,53399.63,54336.63,107736.26
510080,201712,218,87,131,81486.95,122635.3,204122.25
510100,201712,77,34,43,31858,40272.26,72130.26
510120,201712,35,20,15,18740,14055,32795
510125,201712,401,247,154,230769.05,144275.26,375044.31
510130,201712,590,345,245,322845.07,229146.68,551991.75
510140,201712,387,128,259,119927,242678.32,362605.32
510160,201712,91,42,49,39354,45909,85263
510170,201712,864,531,333,497274.66,311397.65,808672.31
510180,201712,2867,1390,1477,1299463.9,1382004.87,2681468.77
510185,201712,12,6,6,5622,5622,11244
510190,201712,214,74,140,69338,131175.32,200513.32
510250,201712,2617,1525,1092,1427902.22,1022100.29,2450002.51
510260,201712,203,144,59,134746.52,55246.63,189993.15
510263,201712,454,249,205,231871.04,191342.89,423213.93
510267,201712,645,358,287,335272.78,268650.73,603923.51
510268,201712,53,28,25,26236,23425,49661
510269,201712,71,30,41,28101,38417,66518
510270,201712,412,211,201,197531.19,187926.94,385458.13
510279,201712,232,171,61,160190.26,56857.26,217047.52
510285,201712,167,74,93,69319.63,87141,156460.63
510300,201712,555,299,256,279719.48,239798.53,519518.01
510305,201712,217,99,118,92740.63,110473.41,203214.04
510310,201712,116,58,58,54346,54336.63,108682.63
510320,201712,858,530,328,496041.42,306905.89,802947.31
510325,201712,414,164,250,153658.63,233959.53,387618.16
510330,201712,417,235,182,220182,170515.26,390697.26
510335,201712,607,322,285,301667.89,266382.32,568050.21
510336,201712,49,36,13,33732,12181,45913
510337,201712,120,47,73,44029.63,68391.63,112421.26
510340,201712,17484,8411,9073,7858745.97,8490556.66,16349302.63
510343,201712,69,47,22,44029.63,20614,64643.63
510345,201712,162,106,56,99312.63,52172.26,151484.89
510350,201712,660,369,291,344624.6,272493.89,617118.49
510360,201712,206,121,85,113368,79563.26,192931.26
510370,201712,136,70,66,65571.26,61712.3,127283.56
510380,201712,94,64,30,59968,28101,88069
510385,201712,58,26,32,24362,29975,54337
510390,201712,125,51,74,47787,69300.52,117087.52
510395,201712,41,28,13,26236,12181,38417
510410,201712,705,465,240,435681,224856.95,660537.95
510420,201712,591,284,307,265178.03,286207.05,551385.08
510450,201712,51,31,20,29047,18740,47787
510452,201712,39,23,16,21551,14992,36543
510454,201712,67,28,39,26236,36533.63,62769.63
510455,201712,128,80,48,74941.26,44976,119917.26
510460,201712,180,94,86,87629.53,80544.89,168174.42
510480,201712,744,416,328,388686.05,306988.08,695674.13
510490,201712,364,185,179,172964.9,167191.13,340156.03
510500,201712,254,189,65,177083.63,60905,237988.63
510510,201712,777,446,331,417031.43,310137.63,727169.06
510515,201712,1147,607,540,567936.48,505942.89,1073879.37
510517,201712,247,105,142,98385,133030.95,231415.95
510520,201712,231,148,83,138584.15,77466.52,216050.67
510523,201712,93,63,30,59031,28100.63,87131.63
510525,201712,712,407,305,380599.15,285580.99,666180.14
510530,201712,17,12,5,11244,4685,15929
510550,201712,274,121,153,112916.46,143352,256268.46
510558,201712,276,135,141,126462.58,132089.26,258551.84
510560,201712,386,239,147,223943,137721,361664
510562,201712,642,447,195,417541.25,182237.13,599778.38
510590,201712,833,432,401,404746.89,375718.96,780465.85
510600,201712,253,137,116,128346.26,108655.26,237001.52
510610,201712,170,81,89,75878.26,83374.63,159252.89
510615,201712,189,75,114,70256.26,106818,177074.26
510617,201712,17,10,7,9370,6559,15929
510618,201712,117,56,61,52472,56688.5,109160.5
510619,201712,106,73,33,68392,30912,99304
510620,201712,191,107,84,100249.63,78708,178957.63
510621,201712,194,123,71,115232.63,66499.63,181732.26
510622,201712,451,291,160,272575.52,149592.89,422168.41
510623,201712,360,238,122,222959.89,114285.89,337245.78
510624,201712,85,38,47,35597,44039,79636
510625,201712,531,325,206,304316.15,192435.19,496751.34
510626,201712,107,67,40,62779,37480,100259
510627,201712,57,42,15,39354,14055,53409
510628,201712,169,101,68,94591.26,63659.78,158251.04
510629,201712,252,163,89,152731,82446.63,235177.63
510630,201712,457,233,224,218246.78,209556.85,427803.63
510631,201712,10,3,7,2811,6559,9370
510637,201712,346,192,154,179563.79,144152.52,323716.31
510642,201712,981,544,437,509382.79,409328.82,918711.61
510645,201712,0,0,0,0,0,0
510650,201712,1526,1002,524,938711.89,490878.41,1429590.30
510665,201712,87,44,43,41174,40291,81465
510670,201712,66,36,30,33732,28110,61842
510675,201712,1178,711,467,666176,437556.32,1103732.32
510677,201712,368,173,195,161113.52,182286.67,343400.19
510680,201712,108,63,45,59013,42156,101169
510682,201712,203,95,108,88699,101196,189895
510685,201712,52,37,15,34669,14055,48724
510700,201712,624,362,262,339076.26,245361.78,584438.04
510704,201712,1033,559,474,521530.09,442583.69,964113.78
510706,201712,130,61,69,57152.32,64616.26,121768.58
510710,201712,393,264,129,247174.93,120762.04,367936.97
510715,201712,64,47,17,44029.63,15929,59958.63
510718,201712,209,110,99,102977.78,92744.63,195722.41
510719,201712,33,19,14,17803,13118,30921
510720,201712,199,132,67,123675,62497.9,186172.9
510724,201712,88,37,51,34659.63,47754.89,82414.52
510726,201712,51,27,24,25289.63,22470,47759.63
510729,201712,78,37,41,34669,38379.52,73048.52
510730,201712,474,257,217,240791,203181.63,443972.63
510735,201712,111,43,68,40291,63716,104007
510740,201712,29,15,14,14055,13118,27173
510757,201712,19,15,4,14055,3748,17803
510760,201712,7020,3734,3286,3487002.08,3073324.13,6560326.21
510770,201712,732,344,388,322143.15,363365.15,685508.30
510774,201712,14,6,8,5622,7496,13118
510775,201712,113,85,28,79635.63,26226.63,105862.26
510776,201712,29,8,21,7496,19677,27173
510777,201712,187,84,103,78679.89,96482.89,175162.78
510779,201712,55,25,30,23416,28073.26,51489.26
510780,201712,296,161,135,150794.63,126414,277208.63
510785,201712,445,242,203,226688.78,190136.04,416824.82
510787,201712,188,95,93,89001.32,87123.32,176124.64
510788,201712,0,0,0,0,0,0
510790,201712,2391,1242,1149,1161682.07,1074441.64,2236123.71
510792,201712,1077,600,477,561721.15,446529.64,1008250.79
510794,201712,111,54,57,50598,53381.26,103979.26
510795,201712,2400,1399,1001,1303658.17,935071.43,2238729.60
510800,201712,177,108,69,101186.63,64644,165830.63
510805,201712,165,117,48,109629,44976,154605
510810,201712,96,39,57,36460.89,53287.56,89748.45
510820,201712,262,122,140,114081.63,130197.71,244279.34
510830,201712,66,40,26,37480,24353,61833
510835,201712,6,4,2,3748,1874,5622
510840,201712,9254,4605,4649,4300564.02,4348332.67,8648896.69
510850,201712,206,85,121,79635.63,113058.79,192694.42
510860,201712,389,170,219,159105.56,204505.16,363610.72
510880,201712,64,49,15,45894.63,14055,59949.63
510885,201712,72,44,28,41209.63,26207.89,67417.52
510890,201712,73,42,31,39354,29047,68401
510895,201712,187,106,81,99322,75593.63,174915.63
520005,201712,33,22,11,20614,10307,30921
520010,201712,283,126,157,118062,147016,265078
520013,201712,622,370,252,346663,235842.9,582505.9
520015,201712,49,35,14,32795,13118,45913
520017,201712,102,60,42,55939,39354,95293
520020,201712,29,15,14,14055,13118,27173
520025,201712,2005,1086,919,1016270.3,860250.7,1876521.0
520030,201712,795,402,393,375728,366694.95,742422.95
520050,201712,78,52,26,48724,24362,73086
520055,201712,43,29,14,27173,13118,40291
520060,201712,176,113,63,105881,59031,164912
520080,201712,587,404,183,378266.9,171471,549737.9
520082,201712,20,14,6,13118,5622,18740
520085,201712,98,73,25,68401,23425,91826
520090,201712,91,62,29,58094,27173,85267
520110,201712,9031,3896,5135,3645530.11,4807684.56,8453214.67
520120,201712,13,8,5,7299.23,4685,11984.23
520130,201712,749,527,222,493790,208005,701795
520140,201712,11784,6621,5163,6196367.43,4834856.19,11031223.62
520145,201712,44,33,11,30921,10307,41228
520150,201712,187,146,41,136802,38417,175219
520160,201712,32,22,10,20614,9370,29984
520170,201712,232,142,90,133023,84294,217317
520180,201712,111,57,54,53409,50598,104007
520215,201712,209,130,79,121528.9,73741.9,195270.8
520235,201712,69,53,16,49661,14992,64653
520250,201712,136,83,53,77771,49379.9,127150.9
520260,201712,111,70,41,65590,37480,103070
520280,201712,48,36,12,33077,11244,44321
520310,201712,38,25,13,23425,12181,35606
520320,201712,166,106,60,99312.63,56220,155532.63
520330,201712,776,410,366,384124.63,342915,727039.63
520340,201712,352,200,152,187400,142405.63,329805.63
520350,201712,522,236,286,221132,267936,489068
520355,201712,88,49,39,45913,36543,82456
520357,201712,26,19,7,17803,6559,24362
520360,201712,0,0,0,0,0,0
520380,201712,139,72,67,67464,62779,130243
520390,201712,292,121,171,112909,159964.67,272873.67
520393,201712,12,9,3,8433,2811,11244
520396,201712,99,58,41,54346,38417,92763
520400,201712,228,132,96,122092.1,89952,212044.1
520410,201712,203,103,100,96502,93691,190193
520420,201712,24,16,8,14992,7496,22488
520425,201712,298,129,169,119937,157885.6,277822.6
520430,201712,453,233,220,218039.9,206085,424124.9
520440,201712,600,397,203,371942.15,190211,562153.15
520450,201712,1898,860,1038,804724.63,971961.32,1776685.95
520455,201712,56,39,17,36543,15929,52472
520460,201712,30,15,15,14055,14055,28110
520465,201712,24,20,4,18740,3748,22488
520470,201712,418,258,160,241446.07,149920,391366.07
520480,201712,83,47,36,44039,33687,77726
520485,201712,128,44,84,41228,78427,119655
520490,201712,392,290,102,271549.26,95412.84,366962.10
520495,201712,178,107,71,100259,66527,166786
520500,201712,177,134,43,125558,40291,165849
520505,201712,173,91,82,85262.32,76834,162096.32
520510,201712,1743,856,887,798830.97,829020.47,1627851.44
520520,201712,39,30,9,28110,8433,36543
520530,201712,232,169,63,156003.89,58245.79,214249.68
520540,201712,532,352,180,328540.81,168660,497200.81
520545,201712,160,88,72,82456,67464,149920
520547,201712,50,28,22,26236,20614,46850
520549,201712,1066,502,564,470056,528071,998127
520551,201712,294,154,140,144298,131180,275478
520552,201712,45,27,18,25299,16866,42165
520570,201712,16,9,7,8433,6559,14992
520580,201712,282,170,112,159281,104944,264225
520590,201712,161,95,66,89015,61560.9,150575.9
520620,201712,1132,532,600,497735.14,561526.53,1059261.67
520630,201712,40,24,16,22488,14992,37480
520640,201712,414,236,178,221132,166786,387918
520650,201712,54,39,15,36543,14055,50598
520660,201712,34,19,15,17803,14055,31858
520670,201712,32,27,5,25299,4685,29984
520680,201712,60,39,21,36543,19677,56220
520690,201712,32,10,22,9370,20605,29975
520710,201712,36,32,4,29984,3748,33732
520725,201712,198,125,73,117125,68401,185526
520735,201712,56,41,15,38417,14055,52472
520740,201712,404,198,206,184824.2,193013,377837.2
520750,201712,37,27,10,25299,9370,34669
520753,201712,52,37,15,34669,14055,48724
520760,201712,110,74,36,69338,33732,103070
520780,201712,284,217,67,203329,62779,266108
520790,201712,168,80,88,74678.9,82456,157134.9
520800,201712,3481,1847,1634,1727301.68,1530393.45,3257695.13
520810,201712,163,114,49,106818,45913,152731
520815,201712,6,5,1,4685,937,5622
520830,201712,137,89,48,83393,44694.9,128087.9
520840,201712,341,224,117,209419.5,109629,319048.5
520850,201712,109,70,39,65581,36393.08,101974.08
520860,201712,1683,1068,615,999320.87,575131.6,1574452.47
520870,201712,30809,15185,15624,14200160.31,14624889.77,28825050.08
520880,201712,1051,587,464,550019,434749.26,984768.26
520890,201712,792,456,336,425670.2,314729.63,740399.83
520910,201712,1024,534,490,496846.31,459130,955976.31
520915,201712,97,75,22,70275,20604.63,90879.63
520920,201712,402,197,205,184026.8,192085,376111.8
520929,201712,22,20,2,18740,1874,20614
520940,201712,76,48,28,44976,26236,71212
520945,201712,21,13,8,12181,7496,19677
520960,201712,48,31,17,29047,15929,44976
520970,201712,327,203,124,189593,115906.9,305499.9
520980,201712,88,64,24,59968,22488,82456
520990,201712,473,316,157,296092,147109,443201
520993,201712,129,62,67,58094,62770,120864
520995,201712,240,133,107,123685,99697,223382
521000,201712,1547,896,651,837585.3,609894,1447479.3
521010,201712,668,305,363,285458.53,340066.15,625524.68
521015,201712,17,10,7,9370,6559,15929
521020,201712,1471,1018,453,953247.95,424105.41,1377353.36
521030,201712,43,29,14,27173,13118,40291
521040,201712,911,558,353,522612.6,330480,853092.6
521056,201712,45,30,15,28110,14055,42165
521060,201712,133,82,51,76834,47787,124621
521080,201712,468,349,119,327004,111503,438507
521090,201712,532,320,212,299840,198372.27,498212.27
521100,201712,289,212,77,198635,72149,270784
521120,201712,1031,701,330,655056.8,308929,963985.8
521130,201712,362,258,104,241736.63,96577.8,338314.43
521140,201712,184,105,79,98385,74023,172408
521150,201712,2816,1219,1597,1140274.14,1495138.85,2635412.99
521160,201712,32,17,15,15929,14055,29984
521170,201712,196,115,81,107745.63,75897,183642.63
521180,201712,1120,704,416,658046.53,389090.1,1047136.63
521190,201712,2568,1087,1481,1018500.26,1386826.16,2405326.42
521200,201712,45,34,11,31858,10307,42165
521205,201712,16,12,4,11244,3748,14992
521210,201712,147,83,64,77771,59968,137739
521220,201712,811,545,266,508079.78,249187,757266.78
521225,201712,28,17,11,15929,10307,26236
521230,201712,113,74,39,69056.9,36543,105599.9
521250,201712,6716,3718,2998,3477179.71,2806860.03,6284039.74
521260,201712,20,14,6,13118,5622,18740
521270,201712,146,112,34,104944,31858,136802
521280,201712,436,255,181,238279.1,169597,407876.1
521290,201712,31,13,18,12181,16866,29047
521295,201712,100,67,33,62554.12,30921,93475.12
521300,201712,231,119,112,111485,104589.89,216074.89
521305,201712,36,24,12,22488,11244,33732
521308,201712,1089,788,301,737864.04,281747,1019611.04
521310,201712,1346,799,547,747267.77,511369.26,1258637.03
521340,201712,21,17,4,15929,3748,19677
521350,201712,131,96,35,89952,32795,122747
521370,201712,193,119,74,110566,69056.9,179622.9
521375,201712,196,111,85,104007,79363.9,183370.9
521377,201712,50,33,17,30921,15929,46850
521380,201712,1064,692,372,644229.26,348564,992793.26
521385,201712,15,8,7,7496,6559,14055
521390,201712,107,87,20,81206.7,18740,99946.7
521400,201712,328,207,121,193677.9,113330.15,307008.05
521405,201712,147,75,72,70275,67464,137739
521410,201712,67,44,23,41228,21551,62779
521440,201712,213,149,64,138816.55,59968,198784.55
521450,201712,722,397,325,371989,304525,676514
521460,201712,1189,721,468,675295.9,438497.26,1113793.16
521470,201712,13,8,5,7496,4685,12181
521480,201712,50,33,17,30921,15865,46786
521483,201712,304,162,142,151513,133054,284567
521486,201712,287,180,107,168538.19,99604,268142.19
521487,201712,23,11,12,10307,11244,21551
521490,201712,28,16,12,14992,11244,26236
521500,201712,116,73,43,68401,40291,108692
521520,201712,41,30,11,28110,10307,38417
521523,201712,584,360,224,334386.45,209888,544274.45
521525,201712,46,30,16,28110,14992,43102
521530,201712,247,129,118,120873,110566,231439
521540,201712,31,16,15,14992,14055,29047
521550,201712,89,41,48,38117.63,44930.26,83047.89
521560,201712,794,544,250,509165.9,234110,743275.9
521565,201712,46,31,15,29047,14055,43102
521570,201712,487,324,163,303578.63,152638.15,456216.78
521580,201712,61,38,23,35606,21551,57157
521590,201712,35,19,16,17803,14992,32795
521600,201712,30,18,12,16866,11244,28110
521630,201712,236,118,118,110556.63,109592.88,220149.51
521640,201712,302,152,150,142424,140550,282974
521645,201712,30,16,14,14992,13118,28110
521680,201712,221,140,81,131180,75897,207077
521690,201712,2,2,0,1874,0,1874
521710,201712,1181,553,628,517317.9,588427,1105744.9
521720,201712,525,347,178,325129.63,166748.63,491878.26
521730,201712,626,306,320,286722,298753.18,585475.18
521740,201712,920,371,549,347599.26,513233.96,860833.22
521760,201712,1584,855,729,799585.52,682765,1482350.52
521770,201712,805,511,294,478807,275018.87,753825.87
521800,201712,2091,1293,798,1208061.1,747027.79,1955088.89
521805,201712,33,18,15,16866,14055,30921
521810,201712,94,58,36,53221.9,33732,86953.9
521830,201712,956,670,286,626198.08,267973,894171.08
521839,201712,94,62,32,58094,29984,88078
521850,201712,1108,597,511,557996.26,478486.04,1036482.30
521860,201712,347,214,133,200518,124340,324858
521870,201712,74,43,31,40291,29047,69338
521878,201712,42,21,21,19677,19677,39354
521880,201712,4436,1986,2450,1858632.58,2292967.85,4151600.43
521890,201712,580,399,181,373863,169306.9,543169.9
521900,201712,293,235,58,219570.3,54346,273916.3
521910,201712,155,109,46,102133,43102,145235
521920,201712,54,25,29,23425,27173,50598
521925,201712,35,21,14,19677,13118,32795
521930,201712,1117,641,476,600423.19,445354.9,1045778.09
521935,201712,33,25,8,23425,7496,30921
521940,201712,194,98,96,91826,89947.32,181773.32
521945,201712,14,12,2,11244,1874,13118
521950,201712,8,5,3,4685,2811,7496
521960,201712,76,57,19,53409,17803,71212
521970,201712,425,268,157,250834.9,147109,397943.9
521971,201712,97,47,50,44039,46850,90889
521973,201712,29,13,16,12181,14992,27173
521975,201712,1099,571,528,533903.6,493650.73,1027554.33
521980,201712,244,166,78,155542,73086,228628
521990,201712,71,53,18,49661,16866,66527
522000,201712,294,181,113,169597,105881,275478
522005,201712,22,14,8,13118,7496,20614
522010,201712,1122,630,492,589364,460432.43,1049796.43
522015,201712,55,34,21,31849,19677,51526
522020,201712,870,462,408,431957.1,381528.36,813485.46
522026,201712,28,20,8,18740,7496,26236
522028,201712,16,12,4,11244,3748,14992
522040,201712,740,291,449,272368,420658.63,693026.63
522045,201712,2046,1288,758,1205838.43,709721.9,1915560.33
522050,201712,170,81,89,75897,83393,159290
522060,201712,559,353,206,330479.9,192928.3,523408.2
522068,201712,134,88,46,82456,43102,125558
522070,201712,10,10,0,9370,0,9370
522100,201712,46,24,22,22225.64,20614,42839.64
522108,201712,40,30,10,28110,9370,37480
522119,201712,58,29,29,27173,27173,54346
522130,201712,77,25,52,23425,48688,72113
522140,201712,3691,1878,1813,1754998.37,1696654.95,3451653.32
522145,201712,53,31,22,29047,20614,49661
522150,201712,63,49,14,45913,13118,59031
522155,201712,58,40,18,37471,16866,54337
522157,201712,6,4,2,3748,1874,5622
522160,201712,1734,1015,719,949930.6,673412.9,1623343.5
522170,201712,395,265,130,248305,121810,370115
522180,201712,36,20,16,18740,14992,33732
522185,201712,1295,541,754,503949.95,705868.38,1209818.33
522190,201712,48,27,21,25299,19583.3,44882.3
522200,201712,299,181,118,169597,110566,280163
522205,201712,167,112,55,104944,51535,156479
522220,201712,170,120,50,112440,46850,159290
522230,201712,31,24,7,22488,6559,29047
530010,201712,55487,28376,27111,26454160.89,25349898.64,51804059.53
