ibge,anomes,bpc_ben,bpc_pcd_ben,bpc_idoso_ben,bpc_pcd_val,bpc_idoso_val,bpc_val
110001,202301,534,437,97,568980.01,127596,696576.01
110002,202301,2990,1896,1094,2471252.69,1428306.29,3899558.98
110003,202301,79,60,19,78121.92,24738,102859.92
110004,202301,2185,1484,701,1934806.12,912707.28,2847513.40
110005,202301,454,353,101,459609.92,131502.2,591112.12
110006,202301,446,331,115,430966.03,149730,580696.03
110007,202301,78,63,15,82026.6,19530,101556.6
110008,202301,272,156,116,203112.79,151032.2,354144.99
110009,202301,976,749,227,975205.84,295554.91,1270760.75
110010,202301,1734,982,752,1279888.49,983013.38,2262901.87
110011,202301,1754,1348,406,1755135.15,529921.32,2285056.47
110012,202301,4267,2448,1819,3187345.24,2370958.01,5558303.25
110013,202301,739,587,152,765596.85,200511.76,966108.61
110014,202301,362,322,40,419247.86,52080,471327.86
110015,202301,1402,1066,336,1387950.98,437476.99,1825427.97
110018,202301,1053,651,402,847621.09,523405.88,1371026.97
110020,202301,17085,9449,7636,12309633.64,9944811.56,22254445.20
110025,202301,665,489,176,636682.09,229152.4,865834.49
110026,202301,38,25,13,32551.81,16926,49477.81
110028,202301,1663,1174,489,1529886.7,636688.88,2166575.58
110029,202301,130,117,13,152337.03,16926,169263.03
110030,202301,2484,1609,875,2094745.65,1139256.92,3234002.57
110032,202301,333,255,78,332020.6,101559.59,433580.19
110033,202301,684,489,195,636698.98,253896.32,890595.30
110034,202301,331,248,83,322897.33,108067.07,430964.40
110037,202301,93,81,12,105462.6,15624,121086.6
110040,202301,408,284,124,371070.6,161448,532518.6
110045,202301,990,714,276,929649.66,359355.1,1289004.76
110050,202301,91,81,10,105464.12,13020.33,118484.45
110060,202301,58,38,20,49476.93,26040,75516.93
110070,202301,112,74,38,96349.36,49476.2,145825.56
110080,202301,558,320,238,416646.78,309876.7,726523.48
110090,202301,26,21,5,27342,6510,33852
110092,202301,121,58,63,75517.62,82026,157543.62
110094,202301,213,146,67,190095.64,87234,277329.64
110100,202301,54,39,15,50778.41,19530.06,70308.47
110110,202301,118,68,50,89839.86,65100,154939.86
110120,202301,66,57,9,74215.36,11718,85933.36
110130,202301,266,215,51,281238.46,66402.4,347640.86
110140,202301,263,188,75,244777.47,97650.1,342427.57
110143,202301,54,44,10,57288,13020,70308
110145,202301,44,32,12,41664.39,15624,57288.39
110146,202301,28,12,16,15624.2,20832,36456.2
110147,202301,41,26,15,33852,19530.58,53382.58
110148,202301,32,26,6,33852.33,7812,41664.33
110149,202301,302,208,94,272118.4,122388,394506.4
110150,202301,141,108,33,140616.2,42966,183582.2
110155,202301,10,9,1,11718,1302,13020
110160,202301,66,50,16,65101.21,20832,85933.21
110170,202301,224,168,56,218737.21,72912,291649.21
110175,202301,68,53,15,69006.8,19530,88536.8
110180,202301,83,64,19,83329.58,24738,108067.58
120001,202301,225,163,62,212233.44,80724.3,292957.74
120005,202301,228,133,95,173168.12,123690.1,296858.22
120010,202301,1203,732,471,953072.69,613244.24,1566316.93
120013,202301,172,116,56,151033.38,72912.3,223945.68
120017,202301,137,83,54,108067,70308,178375
120020,202301,3520,2836,684,3693862.69,890580.13,4584442.82
120025,202301,599,325,274,423187.71,356761.44,779949.15
120030,202301,1210,1045,165,1360652.62,214839.44,1575492.06
120032,202301,44,39,5,50778.55,6510,57288.55
120033,202301,227,197,30,256502.51,39060.55,295563.06
120034,202301,183,136,47,177074.37,61194,238268.37
120035,202301,56,49,7,63798.1,9114,72912.1
120038,202301,416,268,148,348947.07,192698.27,541645.34
120039,202301,34,31,3,40363.1,3906,44269.1
120040,202301,15143,10130,5013,13190730.01,6528566.02,19719296.03
120042,202301,48,44,4,57290.6,5208,62498.6
120043,202301,17,5,12,6510,15624,22134
120045,202301,556,352,204,458323.14,265611.29,723934.43
120050,202301,1321,1012,309,1317688.96,402331.34,1720020.30
120060,202301,1525,1272,253,1656336.22,329412.64,1985748.86
120070,202301,423,305,118,397120.48,153636.69,550757.17
120080,202301,205,133,72,173168.42,93744.55,266912.97
130002,202301,164,117,47,152334.95,61194,213528.95
130006,202301,110,74,36,96348,46872,143220
130008,202301,131,77,54,100254.1,70308,170562.1
130010,202301,174,110,64,143220.55,83328.24,226548.79
130014,202301,310,217,93,282860.87,121086.4,403947.27
130020,202301,147,101,46,131503.4,59892,191395.4
130030,202301,1020,574,446,747354.52,580692.96,1328047.48
130040,202301,407,206,201,268213,261702,529915
130050,202301,573,304,269,395815.14,351548.21,747363.35
130060,202301,900,609,291,794222.55,378882.7,1173105.25
130063,202301,618,381,237,496062.1,308574,804636.1
130068,202301,233,148,85,192697.38,110671.32,303368.70
130070,202301,1386,916,470,1192654.7,611946.18,1804600.88
130080,202301,737,510,227,664025.96,296858.52,960884.48
130083,202301,91,60,31,78120.6,40362,118482.6
130090,202301,317,180,137,234360.52,179676,414036.52
130100,202301,1339,674,665,878864.94,867140.41,1746005.35
130110,202301,837,366,471,477837.03,614545.18,1092382.21
130115,202301,149,74,75,96348,97650,193998
130120,202301,1732,1076,656,1400966.61,855415.95,2256382.56
130130,202301,653,440,213,574182.5,277326,851508.5
130140,202301,1574,1208,366,1572825.44,476532.86,2049358.30
130150,202301,434,386,48,502573,62496,565069
130160,202301,473,298,175,387997.3,229152,617149.3
130165,202301,142,126,16,164054.27,20832,184886.27
130170,202301,1150,792,358,1031132.33,466125.4,1497257.73
130180,202301,278,211,67,274723.67,87234.2,361957.87
130185,202301,2359,1153,1206,1501237.14,1570233.17,3071470.31
130190,202301,3409,2121,1288,2761608.21,1679597.93,4441206.14
130195,202301,296,237,59,308574,76818,385392
130200,202301,221,128,93,166658.37,121086,287744.37
130210,202301,96,46,50,59892,65100,124992
130220,202301,215,157,58,204415.9,75516,279931.9
130230,202301,368,249,119,324198,154938,479136
130240,202301,1374,889,485,1157483.94,632773.68,1790257.62
130250,202301,4981,3223,1758,4199027.42,2288944.3,6487971.72
130255,202301,442,225,217,292950.72,282534.8,575485.52
130260,202301,66678,30805,35873,40130290.86,46742981.99,86873272.85
130270,202301,1567,1072,495,1395868.09,644492.3,2040360.39
130280,202301,147,85,62,110670,80724,191394
130290,202301,2091,1341,750,1747316.76,976508.27,2723825.03
130300,202301,432,296,136,385393.65,178377.28,563770.93
130310,202301,976,538,438,700479.15,571578.9,1272058.05
130320,202301,564,307,257,399715.2,335916,735631.2
130330,202301,819,545,274,709595.22,356749.1,1066344.32
130340,202301,3659,1987,1672,2588447.55,2176965.54,4765413.09
130350,202301,471,325,146,423150,190092,613242
130353,202301,989,458,531,596329.25,691369.31,1287698.56
130356,202301,855,394,461,512995.83,600226.61,1113222.44
130360,202301,107,85,22,110670.39,28644.1,139314.49
130370,202301,705,557,148,725216.15,192696,917912.15
130380,202301,680,534,146,695271.99,190092.8,885364.79
130390,202301,502,410,92,533820.2,119784,653604.2
130395,202301,177,67,110,87234.31,143220,230454.31
130400,202301,103,79,24,102860.34,31248,134108.34
130406,202301,2283,1331,952,1732972.75,1242110.42,2975083.17
130410,202301,443,234,209,304668,272118,576786
130420,202301,2871,2326,545,3028534.91,709592.66,3738127.57
130423,202301,232,155,77,201814.34,100254,302068.34
130426,202301,194,107,87,139314.2,113274,252588.2
130430,202301,449,265,184,345030.8,240870,585900.8
130440,202301,204,72,132,93746.86,171865.82,265612.68
140002,202301,56,17,39,22134.2,50779.09,72913.29
140005,202301,234,136,98,177075.15,127598.73,304673.88
140010,202301,12858,7467,5391,9725050.69,7020549.47,16745600.16
140015,202301,192,75,117,97653.11,152334.92,249988.03
140017,202301,157,86,71,111981.56,92444.64,204426.20
140020,202301,461,304,157,395819.77,205720.02,601539.79
140023,202301,73,43,30,55986,39060.24,95046.24
140028,202301,27,16,11,20832.55,14323.32,35155.87
140030,202301,428,272,156,354150.88,203113.45,557264.33
140040,202301,81,53,28,69006.35,36456,105462.35
140045,202301,359,108,251,140617.06,326804.92,467421.98
140047,202301,595,376,219,489558.99,286442.11,776001.10
140050,202301,150,93,57,121089.24,74216.03,195305.27
140060,202301,90,62,28,80725.68,36456.2,117181.88
140070,202301,24,21,3,27342.2,3906,31248.2
150010,202301,5356,3223,2133,4197743.51,2778497.9,6976241.41
150013,202301,174,117,57,152334.71,74214.99,226549.70
150020,202301,1197,672,525,874957.62,683551.74,1558509.36
150030,202301,724,320,404,416650.17,526011,942661.17
150034,202301,217,126,91,164053.76,118482.5,282536.26
150040,202301,1743,990,753,1289026.93,980431.37,2269458.30
150050,202301,777,456,321,593718.12,417943.16,1011661.28
150060,202301,5221,3247,1974,4228884.99,2572025.33,6800910.32
150070,202301,509,274,235,356752.47,305971.95,662724.42
150080,202301,18901,8789,10112,11447584.36,13172906.35,24620490.71
150085,202301,482,294,188,382798.12,246081.25,628879.37
150090,202301,768,614,154,799446.86,200509.72,999956.58
150095,202301,81,56,25,72914.25,32551.64,105465.89
150100,202301,78,47,31,61194,40363.12,101557.12
150110,202301,219,127,92,165355.51,119784.1,285139.61
150120,202301,412,293,119,381494,154939.61,536433.61
150125,202301,49,19,30,24738,39060,63798
150130,202301,2493,1216,1277,1583280.91,1665504.26,3248785.17
150140,202301,64335,27541,36794,35886279.04,47932948.33,83819227.37
150145,202301,273,148,125,192697.78,162750.1,355447.88
150150,202301,3841,1680,2161,2188731.03,2816276.56,5005007.59
150157,202301,381,271,110,352854.19,143220.56,496074.75
150160,202301,158,117,41,152334.61,53382,205716.61
150170,202301,4331,3128,1203,4072736.01,1566324.28,5639060.29
150172,202301,393,272,121,354147.11,158845.7,512992.81
150175,202301,95,55,40,71610.3,52080,123690.3
150178,202301,817,553,264,720027.3,343733.41,1063760.71
150180,202301,3481,1745,1736,2272047.62,2262888.58,4534936.20
150190,202301,410,275,135,358058.95,175770.51,533829.46
150195,202301,140,76,64,98953,83328.58,182281.58
150200,202301,196,94,102,122388,132804.3,255192.3
150210,202301,3405,2625,780,3417850.79,1018178.7,4436029.49
150215,202301,721,427,294,555969.86,382796.82,938766.68
150220,202301,3692,2436,1256,3171744.76,1635339.71,4807084.47
150230,202301,1462,1170,292,1524672.78,380189.22,1904862.00
150240,202301,7793,4268,3525,5561039.12,4590957.07,10151996.19
150250,202301,83,46,37,59892.6,48174,108066.6
150260,202301,129,87,42,113278.1,54684.8,167962.9
150270,202301,2236,1451,785,1889236.7,1022079.52,2911316.22
150275,202301,571,369,202,480446.99,263004.99,743451.98
150276,202301,117,38,79,49476.2,102859.47,152335.67
150277,202301,906,404,502,526020.61,653617.82,1179638.43
150280,202301,345,237,108,308577.57,140616,449193.57
150285,202301,157,78,79,101557.71,102649.68,204207.39
150290,202301,1369,776,593,1010371.94,772095.3,1782467.24
150293,202301,877,416,461,542952.55,600230.23,1143182.78
150295,202301,613,291,322,378896.39,420548.84,799445.23
150300,202301,101,47,54,61194.1,70308.6,131502.7
150304,202301,204,119,85,156241.92,111973.45,268215.37
150307,202301,466,383,83,498675.64,108066.5,606742.14
150309,202301,627,440,187,572902.98,243478.74,816381.72
150310,202301,294,196,98,255194.02,127596,382790.02
150320,202301,2012,1394,618,1815013.56,805949.16,2620962.72
150330,202301,2240,1275,965,1660066.67,1257736.91,2917803.58
150340,202301,205,132,73,171864.2,95046.42,266910.62
150345,202301,687,378,309,492163.59,402318.8,894482.39
150350,202301,433,344,89,447911.53,115880.46,563791.99
150360,202301,5248,3047,2201,3968603.75,2865737.18,6834340.93
150370,202301,874,584,290,760393.31,377586.53,1137979.84
150375,202301,200,83,117,108066.19,152334.18,260400.37
150380,202301,1587,1055,532,1373640.55,695273.35,2068913.90
150390,202301,950,546,404,710921.5,526013.88,1236935.38
150400,202301,123,103,20,134106.4,26040,160146.4
150405,202301,1728,1095,633,1425711.76,826774.47,2252486.23
150410,202301,107,67,40,87234.77,52080.2,139314.97
150420,202301,8315,4403,3912,5733152.64,5094854.73,10828007.37
150430,202301,696,429,267,558600.44,347640.24,906240.68
150440,202301,482,293,189,381499.99,246080.67,627580.66
150442,202301,2601,1377,1224,1792912.75,1596279.12,3389191.87
150445,202301,571,378,193,492161.58,251286.2,743447.78
150450,202301,245,142,103,184884.49,134106.1,318990.59
150460,202301,735,556,179,723931.95,233060.13,956992.08
150470,202301,1338,801,537,1042934.86,699179.07,1742113.93
150475,202301,247,188,59,244783.4,76819.19,321602.59
150480,202301,1542,1089,453,1417928.48,591116.72,2009045.20
150490,202301,611,368,243,479139.94,316386,795525.94
150495,202301,367,274,93,356748.98,121086,477834.98
150497,202301,294,190,104,247381.99,135408.3,382790.29
150500,202301,283,165,118,214831.12,153636.1,368467.22
150503,202301,1443,716,727,932260.57,946567.28,1878827.85
150506,202301,948,651,297,847614.19,386695.32,1234309.51
150510,202301,1402,764,638,994752.06,831985,1826737.06
150520,202301,343,233,110,303368.45,143220.8,446589.25
150530,202301,2123,1204,919,1567710.03,1196599.64,2764309.67
150540,202301,240,177,63,231758.76,82026.56,313785.32
150543,202301,936,484,452,630186.61,588513.59,1218700.20
150548,202301,464,335,129,436174.84,167959.7,604134.54
150549,202301,82,53,29,69006.99,37758,106764.99
150550,202301,3391,1714,1677,2231676.77,2184775.98,4416452.75
150553,202301,3980,2217,1763,2887939.85,2296776.77,5184716.62
150555,202301,146,80,66,104160.2,85933.17,190093.37
150560,202301,77,37,40,48175.11,52080,100255.11
150563,202301,128,66,62,85936.59,80724.68,166661.27
150565,202301,226,134,92,174469.16,119784.15,294253.31
150570,202301,435,286,149,372373.08,193998.9,566371.98
150580,202301,1828,902,926,1175718.46,1205653.76,2381372.22
150590,202301,893,595,298,774709.14,387997.66,1162706.80
150600,202301,528,330,198,429673.16,257801.85,687475.01
150610,202301,188,147,41,191396.12,53382,244778.12
150611,202301,154,105,49,136710,63798,200508
150613,202301,3660,2023,1637,2635337.07,2131481.91,4766818.98
150616,202301,622,333,289,433572.48,376280.76,809853.24
150618,202301,1465,755,710,983016.65,925723.48,1908740.13
150619,202301,418,317,101,412737.43,131505.62,544243.05
150620,202301,1345,762,583,992150.24,759070.24,1751220.48
150630,202301,179,116,63,151042.04,82027.11,233069.15
150635,202301,493,222,271,289053.83,352843.47,641897.30
150640,202301,48,22,26,28645.24,33852,62497.24
150650,202301,2615,1493,1122,1943954.11,1460876.15,3404830.26
150655,202301,285,204,81,265608.6,105462,371070.6
150658,202301,73,40,33,52080,42966,95046
150660,202301,645,400,245,522110.63,318993.67,841104.30
150670,202301,1207,434,773,565075.62,1006455.71,1571531.33
150680,202301,11917,6235,5682,8120859.47,7401867.44,15522726.91
150690,202301,44,20,24,26040.9,31248,57288.9
150700,202301,584,390,194,509102,252592.47,761694.47
150710,202301,304,173,131,225251.14,170562.55,395813.69
150715,202301,860,543,317,707005.53,414039.28,1121044.81
150720,202301,449,339,110,442688.36,143220.73,585909.09
150730,202301,1217,566,651,736944.54,847610.26,1584554.80
150740,202301,267,170,97,221340.6,126294,347634.6
150745,202301,855,477,378,621070.84,492159.45,1113230.29
150746,202301,72,35,37,45570,48174.2,93744.2
150747,202301,275,186,89,242176.94,115878.67,358055.61
150750,202301,147,79,68,102861.81,88539.7,191401.51
150760,202301,1974,1300,674,1692625.55,877556.22,2570181.77
150770,202301,420,246,174,320293.72,226548.2,546841.92
150775,202301,106,54,52,70308.48,67704.7,138013.18
150780,202301,216,126,90,164054.38,117180,281234.38
150790,202301,728,420,308,546851.03,402322.1,949173.13
150795,202301,1821,1111,710,1446545.63,924428.43,2370974.06
150796,202301,331,191,140,248682.46,182280.71,430963.17
150797,202301,423,194,229,252595.12,298158.54,550753.66
150800,202301,1762,972,790,1266861.41,1028582.37,2295443.78
150803,202301,370,271,99,352854.5,128900.86,481755.36
150805,202301,217,129,88,167959.71,114576.7,282536.41
150808,202301,1173,580,593,755164.47,772089.81,1527254.28
150810,202301,3327,2235,1092,2910040.55,1421791.46,4331832.01
150812,202301,561,291,270,378886.72,351541.47,730428.19
150815,202301,1313,811,502,1057233.96,653607.29,1710841.25
150820,202301,1781,1066,715,1389284.04,932252.67,2321536.71
150830,202301,597,448,149,583310.79,193999.99,777310.78
150835,202301,255,157,98,204416.45,127596,332012.45
150840,202301,1547,885,662,1156199.82,861937.09,2018136.91
160005,202301,71,48,23,62497.19,29946.12,92443.31
160010,202301,215,134,81,174472.23,105463.37,279935.60
160015,202301,186,123,63,160156.05,82026.59,242182.64
160020,202301,152,75,77,97651.44,100254.92,197906.36
160021,202301,67,30,37,39061.6,49476.45,88538.05
160023,202301,78,48,30,62498.14,39060.44,101558.58
160025,202301,27,14,13,18228.72,16926.12,35154.84
160027,202301,1561,861,700,1122376.15,911409.42,2033785.57
160030,202301,18287,9380,8907,12217151.34,11627073.18,23844224.52
160040,202301,354,216,138,281239.27,180979.15,462218.42
160050,202301,805,367,438,477851.34,570287.17,1048138.51
160053,202301,308,182,126,236972.85,164054.62,401027.47
160055,202301,26,18,8,23437.51,10417.85,33855.36
160060,202301,7200,3907,3293,5087126.18,4288870.51,9375996.69
160070,202301,195,114,81,148430.74,105464.39,253895.13
160080,202301,148,75,73,97650.52,95046.74,192697.26
170025,202301,26,14,12,18228,15624.62,33852.62
170030,202301,171,137,34,178379.55,44268,222647.55
170035,202301,206,102,104,134110.87,135409.86,269520.73
170040,202301,185,137,48,178374,62496,240870
170070,202301,334,211,123,274728.64,160147.27,434875.91
170100,202301,363,263,100,342436.97,130200.8,472637.77
170105,202301,39,34,5,44268.51,6510,50778.51
170110,202301,114,70,44,91140.99,57288.1,148429.09
170130,202301,82,40,42,52080,54684,106764
170190,202301,102,59,43,76818.58,55986,132804.58
170200,202301,350,236,114,307275.22,148428.2,455703.42
170210,202301,7043,3854,3189,5020326.71,4153426.16,9173752.87
170215,202301,168,97,71,126297.86,92443.55,218741.41
170220,202301,1356,966,390,1259055.01,507786.17,1766841.18
170230,202301,150,100,50,130202.85,65100.3,195303.15
170240,202301,501,347,154,451814.56,201812.22,653626.78
170255,202301,1026,804,222,1046824.94,289046.97,1335871.91
170270,202301,45,32,13,41664,16926,58590
170290,202301,143,89,54,117181.16,70308,187489.16
170300,202301,118,78,40,101556.2,52080.71,153636.91
170305,202301,55,43,12,55986,15624,71610
170307,202301,58,41,17,53384.06,22134.9,75518.96
170310,202301,127,77,50,100256.22,65100,165356.22
170320,202301,40,25,15,32550.2,19530,52080.2
170330,202301,33,23,10,29946.65,13020.1,42966.75
170360,202301,33,19,14,24738.2,18229.7,42967.9
170370,202301,77,43,34,55988.61,44268,100256.61
170380,202301,85,64,21,83328.3,27342,110670.3
170382,202301,39,31,8,40362,10416,50778
170384,202301,146,112,34,145825.41,44268.2,190093.61
170386,202301,69,29,40,37758.22,52080,89838.22
170388,202301,46,21,25,28644,33852,62496
170389,202301,24,19,5,24738.4,6510,31248.4
170390,202301,85,51,34,66402.49,44268,110670.49
170410,202301,24,22,2,28645.36,2604,31249.36
170460,202301,14,8,6,10416.87,7812,18228.87
170510,202301,32,24,8,31248.76,10416,41664.76
170550,202301,1628,936,692,1220002.82,902295.7,2122298.52
170555,202301,111,82,29,106769.03,37758,144527.03
170560,202301,102,75,27,97651.41,35154,132805.41
170600,202301,41,15,26,19531.03,33852,53383.03
170610,202301,187,102,85,132807.01,110670.2,243477.21
170625,202301,32,19,13,24738.99,16926,41664.99
170650,202301,99,69,30,89838,39060.2,128898.2
170700,202301,588,436,152,567677.73,197904,765581.73
170710,202301,140,84,56,109371.29,72915,182286.29
170720,202301,110,84,26,110670.81,33852,144522.81
170730,202301,113,66,47,85933.16,61194,147127.16
170740,202301,85,61,24,79422.77,31248,110670.77
170755,202301,51,28,23,36457.86,29946.2,66404.06
170765,202301,137,80,57,104163.71,74214.2,178377.91
170770,202301,194,125,69,162752.98,91140.73,253893.71
170820,202301,604,398,206,518205.06,269515.03,787720.09
170825,202301,48,29,19,37758.6,24738,62496.6
170830,202301,93,70,23,91140.81,29946,121086.81
170900,202301,168,128,40,166657.36,52080.6,218737.96
170930,202301,1020,560,460,729140.65,598927.45,1328068.10
170950,202301,3377,1599,1778,2083245.98,2316279.05,4399525.03
170980,202301,15,9,6,11718.11,7812,19530.11
171050,202301,151,116,35,151032,45570.2,196602.2
171070,202301,64,51,13,66402.77,16926.38,83329.15
171090,202301,49,37,12,48174.2,15624,63798.2
171110,202301,24,18,6,23437.05,7812,31249.05
171150,202301,45,30,15,39060,19530,58590
171180,202301,24,11,13,14322,16926.22,31248.22
171190,202301,187,105,82,136711.42,106764,243475.42
171195,202301,59,48,11,62496.83,14322,76818.83
171200,202301,31,15,16,19530,20832,40362
171215,202301,10,8,2,10416,2604,13020
171240,202301,65,50,15,65100,19530.8,84630.8
171245,202301,56,47,9,61196.83,11718,72914.83
171250,202301,81,45,36,58590.2,46872,105462.2
171270,202301,12,8,4,10416.6,5208.22,15624.82
171280,202301,46,37,9,48175.76,11718.1,59893.86
171320,202301,1077,629,448,818969.35,583298.27,1402267.62
171330,202301,443,228,215,296858.64,279930.1,576788.74
171360,202301,106,75,31,97650,40362,138012
171370,202301,36,19,17,24738,22134.25,46872.25
171380,202301,138,116,22,151034.11,28644,179678.11
171395,202301,42,26,16,33852,20832,54684
171420,202301,262,173,89,225247.62,115878.2,341125.82
171430,202301,73,58,15,76818.2,19530.39,96348.59
171488,202301,217,122,95,158844.58,123690,282534.58
171500,202301,67,37,30,48174.2,39060,87234.2
171510,202301,76,50,26,65100,33852.52,98952.52
171515,202301,41,34,7,44269.77,9114,53383.77
171525,202301,25,22,3,28645.28,3906,32551.28
171550,202301,17,11,6,14322.4,7812,22134.4
171570,202301,56,27,29,35154,37758.1,72912.1
171575,202301,269,184,85,239569.88,110670,350239.88
171610,202301,1993,1024,969,1334574.95,1262959.78,2597534.73
171620,202301,156,112,44,145825.4,58590,204415.4
171630,202301,50,28,22,36456,28644,65100
171650,202301,356,245,111,320302.01,144522.99,464825.00
171660,202301,267,151,116,197911,151033.3,348944.3
171665,202301,91,56,35,72913.08,45570.33,118483.41
171670,202301,456,284,172,369774.51,223945.74,593720.25
171700,202301,61,53,8,69007.05,10416,79423.05
171720,202301,28,9,19,11718.2,24738.2,36456.4
171750,202301,100,49,51,63798,66402.2,130200.2
171780,202301,77,60,17,78120.4,22134,100254.4
171790,202301,99,78,21,101556,27342,128898
171800,202301,33,26,7,33852,9114,42966
171820,202301,2186,1264,922,1647062.83,1200450.06,2847512.89
171830,202301,33,26,7,33852.2,9114,42966.2
171840,202301,56,36,20,46872.76,26040,72912.76
171845,202301,33,22,11,28644.27,14322,42966.27
171850,202301,46,37,9,48175.64,11719.02,59894.66
171855,202301,73,52,21,67704.1,27342,95046.1
171865,202301,6,4,2,5208,2604,7812
171870,202301,37,25,12,32550.2,15624.45,48174.65
171875,202301,90,64,26,83328,33852,117180
171880,202301,46,29,17,37758,22134.72,59892.72
171884,202301,57,30,27,39060.93,35154,74214.93
171886,202301,136,60,76,78120.4,98952,177072.4
171888,202301,28,21,7,27342.16,9114.1,36456.26
171889,202301,15,7,8,9114,10416,19530
171890,202301,60,49,11,63799.18,14322,78121.18
171900,202301,29,20,9,26040.91,11718,37758.91
172000,202301,36,31,5,40362.2,6510.2,46872.4
172010,202301,54,41,13,53382,16926.94,70308.94
172015,202301,19,14,5,18229,6510,24739
172020,202301,124,77,47,100255.02,61194,161449.02
172025,202301,41,27,14,35154.46,18228,53382.46
172030,202301,53,33,20,42967.74,26040,69007.74
172049,202301,81,52,29,67704.54,37758.2,105462.74
172065,202301,114,74,40,96351.36,52080.46,148431.82
172080,202301,125,76,49,98953.5,63798.67,162752.17
172085,202301,30,16,14,20832,18228,39060
172090,202301,465,336,129,437478.93,167958.24,605437.17
172093,202301,17,15,2,19530,2604,22134
172097,202301,17,9,8,11718,10416,22134
172100,202301,6263,3609,2654,4700344.22,3456865.1,8157209.32
172110,202301,83,55,28,71611.01,36456,108067.01
172120,202301,1774,1473,301,1917910.57,393208.66,2311119.23
172125,202301,15,11,4,14322,5208,19530
172130,202301,31,20,11,26040.59,14322.3,40362.89
172208,202301,202,130,72,169260,93744.88,263004.88
172210,202301,351,179,172,233061.56,223945.36,457006.92
210005,202301,3152,1983,1169,2583269.88,1522066.87,4105336.75
210010,202301,149,101,48,131503.27,62496,193999.27
210015,202301,43,31,12,40362.39,15624,55986.39
210020,202301,384,227,157,295556.29,205717.68,501273.97
210030,202301,323,221,102,287762.07,132807.49,420569.56
210040,202301,123,101,22,131502.1,28644,160146.1
210043,202301,273,225,48,294256.36,62496,356752.36
210047,202301,494,314,180,408829.84,234360,643189.84
210050,202301,275,194,81,252588,105462.2,358050.2
210055,202301,57,47,10,61194.79,13020,74214.79
210060,202301,547,441,106,574206.91,138014.56,712221.47
210070,202301,463,360,103,468720,134106.8,602826.8
210080,202301,150,139,11,180979.71,14322,195301.71
210083,202301,301,155,146,203112.99,190092.19,393205.18
210087,202301,9,6,3,7812,3906,11718
210090,202301,485,354,131,460925.88,170564.95,631490.83
210095,202301,429,343,86,446590.99,111973.31,558564.30
210100,202301,706,569,137,740847.49,178374.2,919221.69
210110,202301,115,81,34,105463.58,44268,149731.58
210120,202301,4890,3934,956,5122282.2,1244728.34,6367010.54
210125,202301,172,109,63,141919,82027.08,223946.08
210130,202301,458,281,177,365870.58,230455.13,596325.71
210135,202301,29,24,5,31249.48,6510,37759.48
210140,202301,4596,3507,1089,4566242.46,1420500.26,5986742.72
210150,202301,375,239,136,311189.46,177075.95,488265.41
210160,202301,3267,2786,481,3628759.63,627571.39,4256331.02
210170,202301,1277,1038,239,1351524.11,311180.28,1662704.39
210173,202301,130,118,12,153638.44,15624,169262.44
210177,202301,294,170,124,221341.46,161448,382789.46
210180,202301,30,16,14,20832.2,18228,39060.2
210190,202301,454,312,142,406224.87,184884.7,591109.57
210193,202301,6,4,2,5208.09,2604,7812.09
210197,202301,66,49,17,63798.46,22134.2,85932.66
210200,202301,620,531,89,691381.49,115878.1,807259.59
210203,202301,229,165,64,214832.8,83329.12,298161.92
210207,202301,321,276,45,359357.65,58590,417947.65
210210,202301,709,661,48,860631.82,62496.6,923128.42
210215,202301,77,69,8,89841.52,10416,100257.52
210220,202301,354,304,50,395821.6,65101.59,460923.19
210230,202301,324,265,59,345033.66,76818,421851.66
210232,202301,1235,895,340,1165310.03,442681.45,1607991.48
210235,202301,185,140,45,182283.71,58590.4,240874.11
210237,202301,49,26,23,33853.88,29946,63799.88
210240,202301,77,66,11,85932.21,14322.21,100254.42
210250,202301,182,159,23,207019.14,29946.2,236965.34
210255,202301,397,296,101,385402.89,132805.96,518208.85
210260,202301,392,280,112,364563.68,145824,510387.68
210270,202301,631,447,184,582005.94,239568.77,821574.71
210275,202301,104,82,22,106764.18,28644,135408.18
210280,202301,1094,725,369,943962.29,480438.98,1424401.27
210290,202301,541,365,176,475238.8,230455.6,705694.4
210300,202301,4932,3209,1723,4178194.22,2243351.92,6421546.14
210310,202301,126,80,46,104160.2,59892.11,164052.31
210312,202301,116,84,32,109369.26,41664.8,151034.06
210315,202301,127,110,17,143220.89,22134,165354.89
210317,202301,146,113,33,147126.03,42966,190092.03
210320,202301,2450,2107,343,2743393.04,446587.46,3189980.50
210325,202301,157,94,63,122390.19,82026.68,204416.87
210330,202301,4220,2506,1714,3264172.39,2234238,5498410.39
210340,202301,1218,943,275,1227824.57,358052.99,1585877.56
210350,202301,686,576,110,749963.66,143220,893183.66
210355,202301,147,125,22,164053.16,28644,192697.16
210360,202301,2043,1489,554,1938723.34,721312.37,2660035.71
210370,202301,1255,663,592,863236.3,770787.68,1634023.98
210375,202301,191,95,96,123698.3,126295.29,249993.59
210380,202301,738,580,158,755168.11,205718.18,960886.29
210390,202301,193,163,30,212228.36,39060,251288.36
210400,202301,416,365,51,475241.13,66402,541643.13
210405,202301,1120,797,323,1037712.38,421850.25,1459562.63
210407,202301,73,61,12,79422.2,15624,95046.2
210408,202301,48,43,5,55987.64,6510,62497.64
210409,202301,343,299,44,389301.58,57288.4,446589.98
210410,202301,441,351,90,457003.75,117180,574183.75
210420,202301,204,164,40,213529.36,52080.9,265610.26
210430,202301,58,42,16,54684.5,20832,75516.5
210440,202301,374,256,118,333321.96,153636,486957.96
210450,202301,111,98,13,127599.89,16926,144525.89
210455,202301,243,130,113,169265.05,147127.87,316392.92
210460,202301,315,216,99,281237.11,128898.25,410135.36
210462,202301,76,64,12,83328.94,15624.9,98953.84
210465,202301,127,102,25,132804.25,32550,165354.25
210467,202301,558,422,136,549457.21,177073.12,726530.33
210470,202301,42,36,6,46872,7812,54684
210480,202301,1354,985,369,1282499.79,480442.27,1762942.06
210490,202301,182,133,49,173168.54,63798.2,236966.74
210500,202301,503,328,175,427069.3,227852.46,654921.76
210510,202301,529,436,93,567674.7,121087.92,688762.62
210515,202301,340,224,116,291649.66,151032.2,442681.86
210520,202301,403,366,37,476536.67,48174,524710.67
210530,202301,9933,5062,4871,6590995.83,6343514.02,12934509.85
210535,202301,122,93,29,121086.97,37758,158844.97
210540,202301,1557,1064,493,1385369.59,641890.16,2027259.75
210542,202301,1096,560,536,729141.91,697886.03,1427027.94
210545,202301,22,20,2,26040.51,2604,28644.51
210547,202301,126,111,15,144523.93,19530.31,164054.24
210550,202301,591,419,172,545557.61,223946.01,769503.62
210560,202301,162,141,21,183583.55,27342.2,210925.75
210565,202301,25,18,7,23437.41,9114.95,32552.36
210570,202301,1316,1113,203,1449151.4,264307.34,1713458.74
210580,202301,129,112,17,145824.58,22134.16,167958.74
210590,202301,682,571,111,743444.9,144522,887966.9
210592,202301,47,43,4,55986,5208,61194
210594,202301,113,99,14,128898.8,18228,147126.8
210596,202301,116,102,14,132805.1,18228,151033.1
210598,202301,138,106,32,138012.2,41664.58,179676.78
210600,202301,301,260,41,338528.56,53382.06,391910.62
210610,202301,246,226,20,294258.01,26041.11,320299.12
210620,202301,43,30,13,39060.22,16926,55986.22
210630,202301,92,82,10,106764.2,13020.2,119784.4
210632,202301,981,707,274,920517.4,356748.2,1277265.6
210635,202301,25,22,3,28644.2,3906.2,32550.4
210637,202301,120,88,32,114576.2,41664,156240.2
210640,202301,566,506,60,658814.24,78120,736934.24
210650,202301,411,347,64,451802.25,83328,535130.25
210660,202301,376,300,76,391919.84,100255.18,492175.02
210663,202301,71,57,14,74214.2,18228,92442.2
210667,202301,83,41,42,53383.71,54684.57,108068.28
210670,202301,259,232,27,302067.29,35154.6,337221.89
210675,202301,481,285,196,371079.11,255193.41,626272.52
210680,202301,233,153,80,199209.08,104160,303369.08
210690,202301,96,88,8,114577.13,10416,124993.13
210700,202301,154,117,37,152335.69,48174.2,200509.89
210710,202301,253,163,90,212227.69,117180.6,329408.29
210720,202301,128,116,12,151032.58,15624,166656.58
210725,202301,61,52,9,67707.83,11718,79425.83
210730,202301,21,15,6,19530,7812,27342
210735,202301,288,210,78,273420.97,101556,374976.97
210740,202301,518,450,68,585924.08,88536,674460.08
210745,202301,153,119,34,154938.7,44268,199206.7
210750,202301,2740,1488,1252,1937424.65,1631422.79,3568847.44
210760,202301,256,203,53,264307.36,69006.19,333313.55
210770,202301,246,203,43,264322.09,55988.24,320310.33
210780,202301,418,318,100,414049.26,130201.2,544250.46
210790,202301,190,162,28,210927.26,36456,247383.26
210800,202301,185,136,49,177082.32,63799,240881.32
210805,202301,66,59,7,76818,9114,85932
210810,202301,439,362,77,471337.87,100254,571591.87
210820,202301,1978,1669,309,2173103.26,402321.65,2575424.91
210825,202301,152,95,57,123691,74214.2,197905.2
210830,202301,694,495,199,644494.85,259099.44,903594.29
210840,202301,204,150,54,196603.05,70308,266911.05
210845,202301,226,174,52,226550.02,67704,294254.02
210850,202301,724,517,207,673156.33,269517.68,942674.01
210860,202301,3446,2094,1352,2726441.25,1761611.98,4488053.23
210870,202301,390,313,77,407542.36,100254.2,507796.56
210880,202301,84,68,16,88538.93,20832.2,109371.13
210890,202301,318,279,39,363267.52,50778,414045.52
210900,202301,704,455,249,592426.12,324201.53,916627.65
210905,202301,73,41,32,53382.2,41664.2,95046.4
210910,202301,2110,1590,520,2070218.9,677047.06,2747265.96
210920,202301,142,63,79,82027.82,102858,184885.82
210923,202301,79,65,14,84630.93,18228,102858.93
210927,202301,417,220,197,286443,256494.2,542937.2
210930,202301,75,64,11,83328.4,14322,97650.4
210940,202301,76,60,16,78121.55,20832,98953.55
210945,202301,198,119,79,154941.28,102858,257799.28
210950,202301,517,384,133,501272.52,173166.65,674439.17
210955,202301,94,55,39,71611.4,50778.2,122389.6
210960,202301,2433,1267,1166,1649649.45,1518134.39,3167783.84
210970,202301,108,92,16,119785.46,20832.9,140618.36
210975,202301,78,74,4,96348.66,5208.95,101557.61
210980,202301,1047,536,511,697887.83,665325.9,1363213.73
210990,202301,4420,3141,1279,4090976.61,1666578.96,5757555.57
211000,202301,1303,1075,228,1399686.04,296859.03,1696545.07
211003,202301,969,720,249,937456.57,324198.56,1261655.13
211010,202301,487,443,44,576792.47,57288.92,634081.39
211020,202301,1368,631,737,821579.81,960890.62,1782470.43
211023,202301,45,39,6,50778.4,7812,58590.4
211027,202301,80,62,18,80724.4,23436,104160.4
211030,202301,367,264,103,343730.51,134106,477836.51
211040,202301,294,250,44,325501.66,57288,382789.66
211050,202301,1136,788,348,1026004.26,453098.33,1479102.59
211060,202301,628,556,72,723938.52,93744.4,817682.92
211065,202301,25,19,6,24739.6,7812.88,32552.48
211070,202301,844,707,137,921853.22,178374.8,1100228.02
211080,202301,89,86,3,111973.84,3906,115879.84
211085,202301,63,34,29,44268,37758,82026
211090,202301,84,73,11,95048.82,14322,109370.82
211100,202301,467,400,67,520813.37,87234.4,608047.77
211102,202301,223,164,59,213528.6,76818,290346.6
211105,202301,223,160,63,208321.08,82026.65,290347.73
211107,202301,128,81,47,105462.2,61194,166656.2
211110,202301,986,675,311,880170.28,404928.69,1285098.97
211120,202301,5236,2839,2397,3697867.11,3123540.2,6821407.31
211125,202301,21,15,6,19530.01,7812,27342.01
211130,202301,42051,20560,21491,26775380.1,28002484.98,54777865.08
211140,202301,355,317,38,412748.54,49476.47,462225.01
211150,202301,1234,890,344,1161416.92,447890.82,1609307.74
211153,202301,168,98,70,127596,92442,220038
211157,202301,67,55,12,71610,15624,87234
211160,202301,688,581,107,756473.49,139315.27,895788.76
211163,202301,3,2,1,2604,1302,3906
211167,202301,10,10,0,13020,,13020.0
211170,202301,417,312,105,406225.78,136711.35,542937.13
211172,202301,108,79,29,102858.76,37758,140616.76
211174,202301,25,18,7,23436.91,9114.31,32551.22
211176,202301,463,338,125,440082.69,164053.51,604136.20
211178,202301,93,66,27,85932.83,35154,121086.83
211180,202301,213,173,40,225246.6,52080.74,277327.34
211190,202301,72,64,8,83328.2,10416,93744.2
211195,202301,41,28,13,36458.84,16926,53384.84
211200,202301,149,126,23,164053.78,29946.6,194000.38
211210,202301,396,305,91,397116.64,118483.11,515599.75
211220,202301,4433,2668,1765,3473889.33,2299386.43,5773275.76
211223,202301,132,122,10,158847.44,13020,171867.44
211227,202301,59,48,11,62496.2,14322,76818.2
211230,202301,710,590,120,768207.8,156241.15,924448.95
211240,202301,377,316,61,411435.61,79422,490857.61
211245,202301,183,100,83,130201.36,108066.72,238268.08
211250,202301,1477,1271,206,1654911.88,268215.33,1923127.21
211260,202301,799,686,113,893179.27,147126,1040305.27
211270,202301,1850,1541,309,2006421.58,402318.74,2408740.32
211280,202301,1795,1243,552,1618416.42,718704.75,2337121.17
211285,202301,227,150,77,195301.45,100254.6,295556.05
211290,202301,795,566,229,736935.33,299462.84,1036398.17
211300,202301,779,629,150,818974.89,195301.04,1014275.93
211400,202301,1573,1035,538,1347600.59,701779.74,2049380.33
220005,202301,18,17,1,22134,1302,23436
220010,202301,76,64,12,83328.07,15624,98952.07
220020,202301,745,611,134,796832.2,174469.48,971301.68
220025,202301,105,101,4,131503.36,5208,136711.36
220027,202301,60,49,11,63798.2,14322,78120.2
220030,202301,123,102,21,132805.59,27342.46,160148.05
220040,202301,1300,1003,297,1305930.04,386697.52,1692627.56
220045,202301,30,21,9,27343.49,11719.15,39062.64
220050,202301,693,579,114,753792.7,148429.55,902222.25
220060,202301,186,164,22,213533.42,28644.35,242177.77
220070,202301,113,98,15,127599.76,19530.2,147129.96
220080,202301,13,11,2,14322.22,2604,16926.22
220090,202301,41,29,12,37758.06,15624,53382.06
220095,202301,3,2,1,2604,1302,3906
220100,202301,23,19,4,24738.71,5208,29946.71
220105,202301,31,28,3,36457.05,3906,40363.05
220110,202301,249,229,20,298158.8,26040,324198.8
220115,202301,46,39,7,50778,9114,59892
220117,202301,24,22,2,28644,2604,31248
220120,202301,1534,1187,347,1545497.97,451794.2,1997292.17
220130,202301,23,23,0,29946,,29946.0
220140,202301,85,71,14,92442.4,18228.64,110671.04
220150,202301,496,375,121,488267.71,157544.94,645812.65
220155,202301,23,22,1,28644,1302,29946
220157,202301,22,19,3,24738.4,3906,28644.4
220160,202301,106,92,14,119785.2,18228,138013.2
220170,202301,40,33,7,42966,9114,52080
220173,202301,19,16,3,20832,3906,24738
220177,202301,17,17,0,22134.4,,22134.4
220180,202301,65,63,2,82027.19,2604,84631.19
220190,202301,1180,1012,168,1318942.95,218740.07,1537683.02
220191,202301,38,32,6,41665.61,7812,49477.61
220192,202301,94,87,7,113274.16,9114,122388.16
220194,202301,60,52,8,67704.48,10416,78120.48
220196,202301,78,65,13,84634.73,16926.4,101561.13
220198,202301,2,2,0,2604,,2604.0
220200,202301,404,344,60,447906.51,78122.01,526028.52
220202,202301,35,31,4,40362.88,5208,45570.88
220205,202301,66,57,9,74214.2,11718,85932.2
220207,202301,15,15,0,19530.13,,19530.13
220208,202301,70,44,26,57288.77,33852.2,91140.97
220209,202301,33,28,5,36456,6510,42966
220210,202301,27,23,4,29946,5208,35154
220211,202301,34,33,1,42968.8,1302,44270.8
220213,202301,35,32,3,41665.04,3906,45571.04
220217,202301,41,33,8,42966.3,10416,53382.3
220220,202301,2401,1609,792,2094943.56,1032495.85,3127439.41
220225,202301,7,2,5,2604.4,6510,9114.4
220230,202301,999,750,249,976516.27,324203.93,1300720.20
220240,202301,166,147,19,191395.14,24738.32,216133.46
220245,202301,44,41,3,53384.74,3906,57290.74
220250,202301,144,120,24,156242.95,31248,187490.95
220253,202301,48,43,5,55986.25,6510,62496.25
220255,202301,48,41,7,53382.2,9114,62496.2
220260,202301,715,548,167,713506.21,217434.58,930940.79
220265,202301,11,9,2,11718,2604,14322
220270,202301,867,781,86,1016872.23,111972.83,1128845.06
220271,202301,38,29,9,37759.06,11718,49477.06
220272,202301,17,17,0,22134,,22134.0
220273,202301,16,15,1,19530.4,1302,20832.4
220275,202301,66,56,10,72912,13020,85932
220277,202301,31,22,9,28644.33,11719.06,40363.39
220280,202301,19,13,6,16926,7812,24738
220285,202301,44,40,4,52080.35,5208,57288.35
220290,202301,1573,1345,228,1751225.65,296860.37,2048086.02
220300,202301,41,41,0,53383.94,,53383.94
220310,202301,342,289,53,376292.48,69008.93,445301.41
220320,202301,462,424,38,552069.28,49477.68,601546.96
220323,202301,2,1,1,1302.8,1302,2604.8
220325,202301,9,8,1,10416,1302,11718
220327,202301,16,16,0,20832.19,,20832.19
220330,202301,221,158,63,205717.06,82026.7,287743.76
220335,202301,134,114,20,148429.76,26040,174469.76
220340,202301,48,38,10,49476,13020,62496
220342,202301,55,47,8,61196.52,10416,71612.52
220345,202301,89,77,12,100254,15624.3,115878.3
220350,202301,462,403,59,524710.06,76818,601528.06
220360,202301,50,33,17,42966,22134,65100
220370,202301,1370,1146,224,1492123.23,292951.36,1785074.59
220375,202301,20,19,1,24739.87,1302,26041.87
220380,202301,24,18,6,23436.9,7812.55,31249.45
220385,202301,15,13,2,16926,2604.66,19530.66
220390,202301,2476,1373,1103,1787691.89,1436126.83,3223818.72
220400,202301,37,31,6,40362,7812,48174
220410,202301,22,21,1,27342.8,1302,28644.8
220415,202301,14,13,1,16927.08,1302,18229.08
220420,202301,127,107,20,139315.3,26040,165355.3
220430,202301,145,127,18,165357.09,23436.2,188793.29
220435,202301,27,21,6,27342.5,7812,35154.5
220440,202301,281,241,40,313793.91,52080,365873.91
220450,202301,365,181,184,235667.85,239574.59,475242.44
220455,202301,53,52,1,67704.46,1302,69006.46
220460,202301,18,17,1,22135.31,1302.19,23437.50
220465,202301,65,44,21,57289.09,27342.41,84631.50
220470,202301,236,208,28,270821.63,36456.86,307278.49
220480,202301,68,63,5,82026.68,6510,88536.68
220490,202301,85,72,13,93744,16926,110670
220500,202301,127,106,21,138012.36,27342,165354.36
220510,202301,362,283,79,368475.48,102858.88,471334.36
220515,202301,26,24,2,31248.54,2604,33852.54
220520,202301,380,337,43,438782.8,55986.45,494769.25
220525,202301,10,6,4,7812.93,5208.06,13020.99
220527,202301,12,12,0,15624.65,,15624.65
220530,202301,48,23,25,29946,32550.87,62496.87
220535,202301,6,5,1,6510.42,1302,7812.42
220540,202301,107,93,14,121086.8,18228.2,139315.0
220545,202301,24,16,8,20832.39,10416.2,31248.59
220550,202301,758,599,159,781222.43,207020,988242.43
220551,202301,12,10,2,13020,2604,15624
220552,202301,13,13,0,16926,,16926.0
220553,202301,57,53,4,70308.55,5208,75516.55
220554,202301,6,4,2,5208.4,2604,7812.4
220555,202301,45,36,9,46872.88,11718,58590.88
220556,202301,42,39,3,50779.24,3906,54685.24
220557,202301,59,53,6,69007.99,7812.74,76820.73
220558,202301,12,6,6,7812,7812,15624
220559,202301,5,5,0,6510,,6510.0
220560,202301,80,52,28,67704.69,36456,104160.69
220570,202301,731,452,279,588510.47,364562.93,953073.40
220580,202301,554,509,45,662746.81,58592.03,721338.84
220585,202301,15,12,3,15624.2,3906.02,19530.22
220590,202301,15,14,1,18228.4,1302,19530.4
220595,202301,75,58,17,75516.5,22134,97650.5
220600,202301,22,16,6,20832,7812,28644
220605,202301,30,27,3,35154.2,3906,39060.2
220610,202301,99,82,17,106764,22134,128898
220620,202301,565,484,81,630179.87,105464.03,735643.90
220630,202301,3,2,1,2604,1302,3906
220635,202301,33,30,3,39060.83,3906,42966.83
220640,202301,113,94,19,122388,26040,148428
220650,202301,116,110,6,143220.2,7812,151032.2
220660,202301,82,64,18,83330.56,23436.8,106767.36
220665,202301,12,12,0,15624,,15624.0
220667,202301,24,22,2,28644.63,2604,31248.63
220669,202301,37,32,5,41664.2,6510,48174.2
220670,202301,71,55,16,71610.28,20832,92442.28
220672,202301,75,55,20,72914.33,26041.21,98955.54
220675,202301,29,21,8,27343.2,10416,37759.2
220680,202301,59,51,8,66402,10416,76818
220690,202301,46,44,2,57288.22,2604,59892.22
220695,202301,27,15,12,19530.74,15624,35154.74
220700,202301,1911,1480,431,1926986.01,561165.66,2488151.67
220710,202301,9,7,2,9114.2,2604.81,11719.01
220720,202301,115,98,17,127596,22134,149730
220730,202301,28,27,1,35154.01,1302,36456.01
220735,202301,7,4,3,5208,3906,9114
220740,202301,59,50,9,65100.38,11718.91,76819.29
220750,202301,130,110,20,143222.86,26040.21,169263.07
220755,202301,19,19,0,24738.4,,24738.4
220760,202301,71,63,8,82026.99,10416,92442.99
220770,202301,6153,3546,2607,4617067.72,3396991.66,8014059.38
220775,202301,11,8,3,10416.1,3906.13,14322.23
220777,202301,22,21,1,27342,1302,28644
220779,202301,5,1,4,1302,5208,6510
220780,202301,950,805,145,1048119.16,188790.88,1236910.04
220785,202301,7,4,3,5208,3906.2,9114.2
220790,202301,1244,995,249,1296819.32,324206.47,1621025.79
220793,202301,7,5,2,6510,2604,9114
220795,202301,22,21,1,27342,1302,28644
220800,202301,4147,3179,968,4139367.04,1261651.93,5401018.97
220810,202301,78,67,11,87234.69,14322,101556.69
220820,202301,250,229,21,298165.13,27343.8,325508.93
220830,202301,1331,1174,157,1528566.01,204414.97,1732980.98
220840,202301,2622,1854,768,2413963.35,1001257.68,3415221.03
220850,202301,80,69,11,89838,15624,105462
220855,202301,8,4,4,5208,5208,10416
220860,202301,15,13,2,16927.9,2604,19531.9
220865,202301,31,28,3,36456.1,3906,40362.1
220870,202301,91,83,8,108067.16,10416,118483.16
220880,202301,335,278,57,361967.37,74215.6,436182.97
220885,202301,29,28,1,36458.73,1302,37760.73
220887,202301,6,5,1,6510.2,1302,7812.2
220890,202301,89,75,14,97651.4,18228,115879.4
220900,202301,25,13,12,16926,15624,32550
220910,202301,47,37,10,48176.03,13020,61196.03
220915,202301,9,8,1,10416.19,1302,11718.19
220920,202301,52,46,6,59892.82,7812,67704.82
220930,202301,55,53,2,69006.26,2604,71610.26
220935,202301,14,14,0,18228.27,,18228.27
220937,202301,34,29,5,37758.29,6510,44268.29
220940,202301,60,52,8,67704,10416,78120
220945,202301,4,4,0,5208,,5208.0
220950,202301,34,27,7,35154.2,9114,44268.2
220955,202301,21,20,1,26040.72,1302,27342.72
220960,202301,39,34,5,44268,6510,50778
220965,202301,52,47,5,61194,6510,67704
220970,202301,66,55,11,71610,14322,85932
220975,202301,11,10,1,13020.4,1302,14322.4
220980,202301,28,26,2,33852.26,2604,36456.26
220985,202301,55,47,8,61194,10416,71610
220987,202301,31,30,1,39062.77,1302.63,40365.40
220990,202301,24,24,0,31248,,31248.0
220995,202301,13,11,2,14322,2604,16926
220997,202301,68,60,8,78121.88,10416,88537.88
221000,202301,1320,1172,148,1525974.88,192696.86,1718671.74
221005,202301,43,40,3,52080,3906.93,55986.93
221010,202301,26,18,8,23436,10416,33852
221020,202301,41,36,5,46872.98,6510,53382.98
221030,202301,43,36,7,46769.85,9114,55883.85
221035,202301,22,20,2,26042.25,2604,28646.25
221037,202301,14,10,4,13020,5208,18228
221038,202301,26,23,3,29946,3906,33852
221039,202301,24,23,1,29946.39,1302.2,31248.59
221040,202301,262,222,40,289051.02,52080.9,341131.92
221050,202301,232,194,38,252594.5,49476.2,302070.7
221060,202301,2046,1757,289,2287655.81,377585.01,2665240.82
221062,202301,28,28,0,36457.02,,36457.02
221063,202301,17,13,4,16926,5208,22134
221065,202301,75,60,15,78122.39,19530.82,97653.21
221070,202301,159,138,21,179680.17,27342,207022.17
221080,202301,412,352,60,458313.61,78120,536433.61
221090,202301,24,19,5,24739.05,6510,31249.05
221093,202301,47,31,16,40362.4,20832.88,61195.28
221095,202301,4,4,0,5208,,5208.0
221097,202301,11,9,2,11718,2604,14322
221100,202301,27987,16749,11238,21811908.48,14637345.29,36449253.77
221110,202301,1189,917,272,1193962.81,354148.78,1548111.59
221120,202301,586,427,159,555964.77,207018,762982.77
221130,202301,1028,834,194,1085882.73,252591.64,1338474.37
221135,202301,33,30,3,39060.4,3906,42966.4
221140,202301,50,42,8,54684.2,10416,65100.2
221150,202301,13,9,4,11718.18,5208,16926.18
221160,202301,17,17,0,22135.39,,22135.39
221170,202301,20,19,1,24738,1302,26040
230010,202301,166,143,23,186188.01,29946,216134.01
230015,202301,167,141,26,183582.15,33852,217434.15
230020,202301,1892,1514,378,1971269.27,492169.44,2463438.71
230030,202301,1718,1247,471,1623637.59,613247.81,2236885.40
230040,202301,240,191,49,248683.28,63798,312481.28
230050,202301,246,172,74,223944.2,96348.2,320292.4
230060,202301,176,141,35,183582.79,45571.54,229154.33
230070,202301,323,274,49,356749.99,63798,420547.99
230075,202301,955,792,163,1031205.76,212229.08,1243434.84
230080,202301,237,193,44,251287.01,57288,308575.01
230090,202301,183,128,55,166657.79,71610,238267.79
230100,202301,2820,1581,1239,2061137.06,1613197.81,3674334.87
230110,202301,3177,1993,1184,2596246.16,1541585.58,4137831.74
230120,202301,1241,945,296,1230412.99,386696.49,1617109.48
230125,202301,183,142,41,184884.33,53382,238266.33
230130,202301,523,455,68,592420.64,89838.22,682258.86
230140,202301,228,184,44,239570.29,57288,296858.29
230150,202301,156,119,37,154939.99,48174.4,203114.39
230160,202301,1020,830,190,1081966.92,247380.68,1329347.60
230170,202301,675,587,88,765594.94,114579.83,880174.77
230180,202301,68,62,6,80724.39,7812,88536.39
230185,202301,432,366,66,476541.32,85933.14,562474.46
230190,202301,2659,2007,652,2613178.19,848913.57,3462091.76
230195,202301,546,463,83,602840.72,108066,710906.72
230200,202301,470,363,107,472631.64,139314.2,611945.84
230205,202301,422,276,146,359353.37,190092.2,549445.57
230210,202301,1482,1122,360,1462168.3,468721.08,1930889.38
230220,202301,1721,1138,583,1481711.29,759075.82,2240787.11
230230,202301,1060,857,203,1115832.52,264308.63,1380141.15
230240,202301,2122,1841,281,2399951.6,365865.51,2765817.11
230250,202301,1918,1553,365,2022058.8,476541.78,2498600.58
230260,202301,3494,2146,1348,2794121.03,1755099.34,4549220.37
230270,202301,1438,1114,324,1450445.1,421852.16,1872297.26
230280,202301,2978,2276,702,2963418.49,915312.49,3878730.98
230290,202301,364,315,49,410139.88,63799.02,473938.90
230300,202301,527,384,143,499970.71,186186.29,686157.00
230310,202301,450,347,103,451794.56,134106.57,585901.13
230320,202301,993,830,163,1080686.1,212227.74,1292913.84
230330,202301,337,273,64,355448.74,83328.4,438777.14
230340,202301,466,375,91,488256.46,118482.4,606738.86
230350,202301,3595,2193,1402,2855354.8,1825420.89,4680775.69
230360,202301,283,230,53,299462.64,69006.41,368469.05
230365,202301,138,110,28,143220.53,36456,179676.53
230370,202301,12311,6163,6148,8025852,8008799.81,16034651.81
230380,202301,531,453,78,589817.42,101557.98,691375.40
230390,202301,559,320,239,416644.22,311178.6,727822.82
230393,202301,235,189,46,246079.29,59892.5,305971.79
230395,202301,380,300,80,390617.87,104163.58,494781.45
230400,202301,679,537,142,699181.56,184884.4,884065.96
230410,202301,2981,1870,1111,2436098.01,1447845.03,3883943.04
230420,202301,6905,4534,2371,5904795.71,3089727.88,8994523.59
230423,202301,353,306,47,398415.65,61194.1,459609.75
230425,202301,531,425,106,553358.35,138013.34,691371.69
230426,202301,131,100,31,130200.7,40362,170562.7
230427,202301,78,69,9,89838.4,11718,101556.4
230428,202301,1859,899,960,1170525.19,1251231.72,2421756.91
230430,202301,487,390,97,507787.53,126295.9,634083.43
230435,202301,997,712,285,927039.72,371072.57,1298112.29
230440,202301,104670,48004,56666,62520333.13,73829970.45,136350303.58
230445,202301,347,234,113,304674.01,147126.2,451800.21
230450,202301,613,480,133,624962.24,173166.2,798128.44
230460,202301,110,78,32,101558.06,41664,143222.06
230465,202301,336,273,63,355449.53,82026,437475.53
230470,202301,2144,1671,473,2175662.5,615847.72,2791510.22
230480,202301,158,143,15,186186.5,19530.56,205717.06
230490,202301,353,277,76,360656.41,100254.07,460910.48
230495,202301,515,362,153,471336.95,199208.72,670545.67
230500,202301,1198,884,314,1150978.49,408829.41,1559807.90
230510,202301,79,53,26,69006.48,33852,102858.48
230520,202301,437,330,107,429663.03,139314.62,568977.65
230523,202301,2764,1680,1084,2188722.46,1412687.73,3601410.19
230526,202301,262,218,44,283837.2,57288.76,341125.96
230530,202301,719,520,199,678352.54,261706.31,940058.85
230533,202301,224,205,19,266913.07,24738.26,291651.33
230535,202301,436,326,110,424462.03,143220.57,567682.60
230540,202301,1876,1671,205,2176991.81,266912.85,2443904.66
230550,202301,4425,2794,1631,3639246.05,2124906.38,5764152.43
230560,202301,616,465,151,605440.7,196602.57,802043.27
230565,202301,232,172,60,223944,78120.2,302064.2
230570,202301,326,273,53,355448.29,69006.6,424454.89
230580,202301,1290,890,400,1158791.77,520806.45,1679598.22
230590,202301,1124,858,266,1117025.25,346333.24,1463358.49
230600,202301,293,262,31,341130.71,40362,381492.71
230610,202301,497,366,131,476538.07,170562.2,647100.27
230620,202301,184,152,32,197907.1,41664,239571.1
230625,202301,923,616,307,802046.02,399714.4,1201760.42
230630,202301,1562,1165,397,1519464.33,516897.3,2036361.63
230640,202301,4255,3461,794,4507655.38,1033816.35,5541471.73
230650,202301,517,442,75,575487.18,97651.17,673138.35
230655,202301,778,617,161,803358.83,209623.06,1012981.89
230660,202301,380,312,68,406228.42,88536.2,494764.62
230670,202301,503,400,103,520817.75,134106.79,654924.54
230680,202301,229,198,31,257800.37,40362,298162.37
230690,202301,1021,854,167,1114533.98,217436.07,1331970.05
230700,202301,1078,888,190,1160097.86,247380.97,1407478.83
230710,202301,709,649,60,845017.36,78120.56,923137.92
230720,202301,153,130,23,169260,29946.2,199206.2
230725,202301,304,229,75,298161.25,97651.35,395812.60
230730,202301,13824,7294,6530,9497328.87,8512615.92,18009944.79
230740,202301,739,589,150,766899.01,195301.95,962200.96
230750,202301,870,717,153,933546.01,199207.75,1132753.76
230760,202301,1725,1455,270,1894465.65,351543.17,2246008.82
230763,202301,385,317,68,412739.11,88536.8,501275.91
230765,202301,9275,4385,4890,5713469,6370891.58,12084360.58
230770,202301,5515,2800,2715,3645712.19,3534968.07,7180680.26
230780,202301,848,733,115,954372.65,149730.1,1104102.75
230790,202301,335,274,61,356748,79422.2,436170.2
230800,202301,1279,902,377,1174419.01,492157.61,1666576.62
230810,202301,1510,1300,210,1693958.48,273423.95,1967382.43
230820,202301,400,263,137,342428.77,178375.77,520804.54
230830,202301,1032,859,173,1118436.41,225246.9,1343683.31
230835,202301,297,239,58,311181.46,75516.83,386698.29
230837,202301,203,163,40,212227.51,52080.71,264308.22
230840,202301,999,756,243,984320.65,316388.91,1300709.56
230850,202301,1476,1239,237,1613219.52,308578.24,1921797.76
230860,202301,354,278,76,361958,98958.7,460916.7
230870,202301,1953,1656,297,2156144.23,386694.47,2542838.70
230880,202301,83,65,18,84630,23436,108066
230890,202301,594,522,72,679652.42,93745.1,773397.52
230900,202301,324,239,85,311180.1,110670.51,421850.61
230910,202301,239,186,53,242174.41,69006,311180.41
230920,202301,529,409,120,532523.55,156240,688763.55
230930,202301,1183,819,364,1066359.23,473931.83,1540291.06
230940,202301,894,688,206,895791.07,268213.35,1164004.42
230945,202301,601,478,123,622371.19,160151.42,782522.61
230950,202301,463,399,64,519515.5,84630.37,604145.87
230960,202301,3026,2006,1020,2613226.78,1328072.29,3941299.07
230970,202301,1942,1052,890,1371044.19,1158794.63,2529838.82
230980,202301,236,176,60,229154.83,78120,307274.83
230990,202301,149,116,33,151032.25,42966,193998.25
231000,202301,217,198,19,257797.41,24738,282535.41
231010,202301,190,129,61,167960.21,79422.1,247382.31
231020,202301,1575,1041,534,1355427.49,695283.01,2050710.50
231025,202301,1211,827,384,1076794.37,499980.32,1576774.69
231030,202301,1113,898,215,1169209.49,281234.68,1450444.17
231040,202301,189,127,62,165356.76,80724,246080.76
231050,202301,1002,857,145,1115835.87,188797.28,1304633.15
231060,202301,169,137,32,178379.37,41665.2,220044.57
231070,202301,1610,1101,509,1433528.24,662722.7,2096250.94
231080,202301,280,246,34,320298.77,44268,364566.77
231085,202301,751,458,293,596331.16,381486.46,977817.62
231090,202301,284,226,58,294256.52,75517.64,369774.16
231095,202301,168,126,42,164052,54684.99,218736.99
231100,202301,196,158,38,205716.24,49476,255192.24
231110,202301,390,323,67,420552,87236.52,507788.52
231120,202301,267,222,45,289047.05,58590.97,347638.02
231123,202301,153,145,8,188791.35,10416,199207.35
231126,202301,353,274,79,356748.66,102858,459606.66
231130,202301,5260,4065,1195,5292804.58,1555918.13,6848722.71
231135,202301,228,198,30,257798.46,39061.41,296859.87
231140,202301,3268,2335,933,3041546.92,1214781.1,4256328.02
231150,202301,414,381,33,496070.45,42966.1,539036.55
231160,202301,1331,1082,249,1408785.52,324198.66,1732984.18
231170,202301,558,385,173,501273.22,225246,726519.22
231180,202301,2044,1769,275,2304598.8,358056.44,2662655.24
231190,202301,236,189,47,247380.1,61194,308574.1
231195,202301,248,202,46,263005.16,59892.55,322897.71
231200,202301,901,721,180,938766,234363.59,1173129.59
231210,202301,543,455,88,593720.08,114577.39,708297.47
231220,202301,1133,795,338,1035113.89,440079.25,1475193.14
231230,202301,1677,1231,446,1605388.92,580693.76,2186082.68
231240,202301,1740,1172,568,1525974.29,739542.12,2265516.41
231250,202301,97,91,6,118484,7812,126296
231260,202301,273,180,93,234361.9,121087.6,355449.5
231270,202301,1060,814,246,1059853.34,320293.46,1380146.80
231280,202301,82,62,20,80724.75,26040,106764.75
231290,202301,8640,4795,3845,6245915.98,5007579.82,11253495.80
231300,202301,618,560,58,729127.99,75516,804643.99
231310,202301,885,808,77,1052029.1,100254.89,1152283.99
231320,202301,638,474,164,617155.21,214831.62,831986.83
231325,202301,107,90,17,117180,22134.54,139314.54
231330,202301,2083,1569,514,2044188.31,669237.51,2713425.82
231335,202301,265,232,33,302068.4,42966,345034.4
231340,202301,2058,1400,658,1824141.22,858026.76,2682167.98
231350,202301,1530,1194,336,1554636.82,437484.14,1992120.96
231355,202301,445,361,84,470028.3,109368.64,579396.94
231360,202301,610,409,201,532529.87,261703.94,794233.81
231370,202301,100,84,16,109368,20832.12,130200.12
231375,202301,313,233,80,303371.16,104161.03,407532.19
231380,202301,561,445,116,579393.91,151032.9,730426.81
231390,202301,202,154,48,200509.19,62496,263005.19
231395,202301,832,491,341,639284.63,443982.3,1083266.93
231400,202301,1289,1063,226,1384044.71,294256.45,1678301.16
231410,202301,1479,1197,282,1558522.64,367166.98,1925689.62
240010,202301,403,181,222,235669.47,289051.58,524721.05
240020,202301,2426,1982,444,2580656.18,578097.03,3158753.21
240030,202301,120,96,24,124994.15,31248,156242.15
240040,202301,34,33,1,42966,1302,44268
240050,202301,546,468,78,609365.67,101556.1,710921.77
240060,202301,88,80,8,104161.36,10416,114577.36
240070,202301,297,224,73,291650.37,95046.32,386696.69
240080,202301,620,416,204,541650.77,265615.33,807266.10
240090,202301,104,91,13,119784.7,16926,136710.7
240100,202301,1624,1523,101,1982996.81,131505.08,2114501.89
240110,202301,1113,747,366,973953.49,477854.44,1451807.93
240120,202301,154,115,39,149732.56,50778.11,200510.67
240130,202301,280,256,24,333327.5,31248.7,364576.2
240140,202301,94,63,31,82027.89,40362.64,122390.53
240145,202301,771,678,93,882788.32,121086.26,1003874.58
240150,202301,28,21,7,27342,9114,36456
240160,202301,40,30,10,39060,13020,52080
240165,202301,44,35,9,45573.66,11718.2,57291.86
240170,202301,152,105,47,136711.69,61194,197905.69
240180,202301,124,92,32,119786.67,41664,161450.67
240185,202301,52,45,7,58591.09,9114.2,67705.29
240190,202301,16,14,2,18228.43,2604,20832.43
240200,202301,3289,1766,1523,2299389.78,1984270.02,4283659.80
240210,202301,165,125,40,162750.73,52080,214830.73
240220,202301,1209,820,389,1067682.08,506481.39,1574163.47
240230,202301,879,784,95,1022103.09,123691.38,1145794.47
240240,202301,84,55,29,71610.2,37758.5,109368.7
240250,202301,104,89,15,115878.51,19530,135408.51
240260,202301,2018,1409,609,1834565.77,792926.85,2627492.62
240270,202301,179,152,27,197904.73,35154,233058.73
240280,202301,72,57,15,74214.2,19530,93744.2
240290,202301,42,40,2,52080,2604,54684
240300,202301,176,94,82,122389.32,106764,229153.32
240310,202301,2684,1438,1246,1872328.21,1622314.73,3494642.94
240320,202301,185,171,14,222642.07,18228,240870.07
240325,202301,5283,2939,2344,3826759.68,3053276.31,6880035.99
240330,202301,86,80,6,104160,7812,111972
240340,202301,110,77,33,100254,42966,143220
240350,202301,100,81,19,105462.2,24738,130200.2
240360,202301,779,498,281,648420.94,365869.47,1014290.41
240370,202301,66,56,10,72913.34,13020.62,85933.96
240375,202301,52,33,19,42967.05,24738.6,67705.65
240380,202301,222,182,40,236973.61,52080.7,289054.31
240390,202301,16,14,2,18228,2604,20832
240400,202301,85,76,9,98952.85,11718,110670.85
240410,202301,12,9,3,11718,3906,15624
240420,202301,1190,843,347,1097617.72,451802.52,1549420.24
240430,202301,273,246,27,320303.36,35154.54,355457.90
240440,202301,156,83,73,108070.4,95046.07,203116.47
240450,202301,261,158,103,205725.06,134108.62,339833.68
240460,202301,95,74,21,96348.32,27342,123690.32
240470,202301,228,205,23,266922.35,29946.02,296868.37
240480,202301,15,13,2,16926,2604,19530
240485,202301,89,70,19,91141.39,24738,115879.39
240490,202301,66,59,7,76818.2,9114,85932.2
240500,202301,108,82,26,106764,33852,140616
240510,202301,39,29,10,37758.6,13020,50778.6
240520,202301,99,94,5,122390.5,6510.04,128900.54
240530,202301,64,51,13,66402.7,16926,83328.7
240540,202301,103,89,14,115878.1,18228.45,134106.55
240550,202301,13,11,2,14322,2604,16926
240560,202301,419,282,137,367173.52,178374.99,545548.51
240570,202301,454,279,175,363264.43,227850.34,591114.77
240580,202301,1428,1055,373,1374949.2,485646.69,1860595.89
240590,202301,30,29,1,37758.48,1302,39060.48
240600,202301,105,98,7,127596.81,9114,136710.81
240610,202301,515,423,92,550765.74,119788.25,670553.99
240615,202301,13,13,0,16926.8,,16926.8
240620,202301,90,85,5,111973.26,6510,118483.26
240630,202301,43,36,7,46872.97,9114.8,55987.77
240640,202301,37,25,12,32550,15624,48174
240650,202301,248,194,54,252589.68,70308.26,322897.94
240660,202301,115,98,17,127596.45,22134,149730.45
240670,202301,314,174,140,226561.79,182289.61,408851.40
240680,202301,59,45,14,58590.67,18228.1,76818.77
240690,202301,49,47,2,61196.04,2604,63800.04
240700,202301,177,147,30,191394.1,39061.02,230455.12
240710,202301,2422,1452,970,1891857.96,1265561.7,3157419.66
240720,202301,1122,785,337,1022102.74,438780.55,1460883.29
240725,202301,77,69,8,89838.6,10416.88,100255.48
240730,202301,150,124,26,161448.21,33852,195300.21
240740,202301,242,199,43,259107.08,55986.62,315093.70
240750,202301,55,33,22,42966,28644,71610
240760,202301,57,45,12,58590,15624,74214
240770,202301,151,117,34,152335.29,44268.8,196604.09
240780,202301,783,641,142,834606.9,184885.43,1019492.33
240790,202301,40,38,2,49477.91,2604,52081.91
240800,202301,10290,6919,3371,9013004.53,4393121.36,13406125.89
240810,202301,23133,12173,10960,15857834.93,14280673.76,30138508.69
240820,202301,274,163,111,213535.12,144524.45,358059.57
240830,202301,1659,1369,290,1782489.98,377586.54,2160076.52
240840,202301,77,66,11,85933.55,14322,100255.55
240850,202301,90,79,11,102858,14322,117180
240860,202301,112,108,4,140618.09,5208.85,145826.94
240870,202301,58,47,11,61197.29,14322,75519.29
240880,202301,32,28,4,36456,5208,41664
240890,202301,1253,701,552,912732.91,718714.12,1631447.03
240895,202301,65,50,15,65100.28,19530.59,84630.87
240910,202301,182,151,31,196603.19,40362.2,236965.39
240920,202301,13,12,1,15625.62,1302,16927.62
240930,202301,439,389,50,506503.65,65101.82,571605.47
240933,202301,61,38,23,49476.95,29946,79422.95
240940,202301,2403,2097,306,2731656.65,398417.08,3130073.73
240950,202301,42,37,5,48174,6510,54684
240960,202301,25,20,5,26040.2,6510.3,32550.5
240970,202301,111,77,34,100254,44268,144522
240980,202301,210,164,46,213529.47,59893.8,273423.27
240990,202301,149,96,53,124992.85,69006,193998.85
241000,202301,61,55,6,71610.51,7812,79422.51
241010,202301,90,74,16,96349.27,20832,117181.27
241020,202301,112,103,9,134107.31,11718.47,145825.78
241025,202301,19,11,8,14323.85,10416.5,24740.35
241030,202301,119,92,27,119784,35154,154938
241040,202301,46,37,9,48174.1,11718,59892.1
241050,202301,75,69,6,89838.8,7812,97650.8
241060,202301,28,24,4,31248,5208,36456
241070,202301,24,24,0,31251.18,,31251.18
241080,202301,61,54,7,70308.2,9114,79422.2
241090,202301,57,45,12,58594.02,15624,74218.02
241100,202301,72,61,11,79422.2,14322.47,93744.67
241105,202301,29,18,11,23439.1,14322.61,37761.71
241110,202301,54,43,11,55986.15,14322,70308.15
241120,202301,1778,1341,437,1746016.41,568978.64,2314995.05
241140,202301,212,172,40,223947.05,52080,276027.05
241142,202301,51,39,12,50778.96,15624,66402.96
241150,202301,1215,1047,168,1363234.52,218738.4,1581972.92
241160,202301,24,18,6,23436,7812,31248
241170,202301,52,44,8,57288,10416,67704
241180,202301,45,32,13,41664,16926,58590
241190,202301,40,36,4,46873.86,5208,52081.86
241200,202301,5075,2652,2423,3453069.44,3156148.88,6609218.32
241210,202301,72,61,11,79422.2,14322,93744.2
241220,202301,1649,1042,607,1356740.85,790329.73,2147070.58
241230,202301,260,208,52,270818.83,67704,338522.83
241240,202301,51,38,13,49476.67,16926,66402.67
241250,202301,1181,1076,105,1400985.81,136712.74,1537698.55
241255,202301,68,53,15,69007.28,19530,88537.28
241260,202301,766,582,184,757778.1,239569.67,997347.77
241270,202301,67,47,20,61194.1,26040,87234.1
241280,202301,98,86,12,111975.17,15624,127599.17
241290,202301,141,104,37,135410.32,48174.72,183585.04
241300,202301,84,58,26,75516,33852.98,109368.98
241310,202301,55,39,16,50778.1,20832.1,71610.2
241320,202301,35,18,17,23437.92,22134,45571.92
241330,202301,66,56,10,72913.11,13020,85933.11
241335,202301,107,96,11,124995.75,14322,139317.75
241340,202301,186,134,52,174468,67704,242172
241350,202301,66,54,12,70308.41,15624,85932.41
241355,202301,55,45,10,58591.32,13020,71611.32
241360,202301,56,53,3,69006.16,3906,72912.16
241370,202301,66,54,12,70308,15624,85932
241380,202301,36,32,4,41664.6,5208,46872.6
241390,202301,88,68,20,88536,26040,114576
241400,202301,226,168,58,219680.59,75516.45,295197.04
241410,202301,184,164,20,213528.67,26040.09,239568.76
241415,202301,111,88,23,114576.1,29946.8,144522.9
241420,202301,139,95,44,123690.85,57288,180978.85
241430,202301,20,17,3,22134,3906,26040
241440,202301,556,467,89,608057.25,115880.46,723937.71
241445,202301,44,38,6,49476.2,7812.72,57288.92
241450,202301,268,225,43,292958.59,55986.44,348945.03
241460,202301,177,162,15,210927.01,19530.9,230457.91
241470,202301,33,27,6,35154.8,7812.2,42967.0
241475,202301,48,44,4,57288,5208,62496
241480,202301,141,101,40,131502.86,52080.4,183583.26
241490,202301,14,11,3,14323.34,3906.59,18229.93
241500,202301,51,40,11,52082.41,14322.02,66404.43
250010,202301,103,84,19,109368.19,24738,134106.19
250020,202301,33,28,5,36456,6510,42966
250030,202301,920,679,241,884080.98,313787.05,1197868.03
250040,202301,412,334,78,434880.48,101556.69,536437.17
250050,202301,292,240,52,312481.48,67704,380185.48
250053,202301,67,55,12,71610.5,15624,87234.5
250057,202301,4,3,1,3906.2,1302,5208.2
250060,202301,649,465,184,605441.9,239570.2,845012.1
250070,202301,701,555,146,722626.85,190092.64,912719.49
250073,202301,9,8,1,10416.58,1302.01,11718.59
250077,202301,186,135,51,175772.07,66402.28,242174.35
250080,202301,424,333,91,433574.34,118483.2,552057.54
250090,202301,228,147,81,191394.82,105462,296856.82
250100,202301,612,489,123,636683.49,160147.8,796831.29
250110,202301,720,522,198,679654.09,257797.03,937451.12
250115,202301,14,4,10,5208,13020.26,18228.26
250120,202301,125,89,36,115878.36,46873.58,162751.94
250130,202301,585,479,106,623672.18,138013.99,761686.17
250135,202301,33,15,18,19530.09,23436,42966.09
250140,202301,87,74,13,96348.54,16926,113274.54
250150,202301,656,452,204,588512.4,265609.14,854121.54
250153,202301,17,15,2,19530.48,2604,22134.48
250157,202301,36,29,7,37758,9114,46872
250160,202301,253,191,62,248685.22,80724,329409.22
250170,202301,91,61,30,79422.2,39060,118482.2
250180,202301,5165,3572,1593,4652277.57,2076751.91,6729029.48
250190,202301,823,555,268,722618.33,348939.39,1071557.72
250200,202301,73,58,15,75516.78,19530,95046.78
250205,202301,22,17,5,22134.61,6510,28644.61
250210,202301,90,76,14,98952.8,18228,117180.8
250215,202301,88,59,29,76818.5,37758.35,114576.85
250220,202301,30,20,10,26040.44,13020,39060.44
250230,202301,80,70,10,91140.61,13020.2,104160.81
250240,202301,253,191,62,248686.8,80724.2,329411.0
250250,202301,417,357,60,464826.73,78120,542946.73
250260,202301,51,41,10,53382.1,13020,66402.1
250270,202301,83,58,25,75516.9,32550,108066.9
250280,202301,407,336,71,437476.01,92442.2,529918.21
250290,202301,114,101,13,131502,16926.98,148428.98
250300,202301,529,357,172,464826.36,223944.72,688771.08
250310,202301,56,51,5,66402.68,6510,72912.68
250320,202301,2154,1424,730,1854127.88,950484.54,2804612.42
250330,202301,121,105,16,136711.84,20832.1,157543.94
250340,202301,33,27,6,35154.64,7812,42966.64
250350,202301,211,139,72,180981.28,93744,274725.28
250355,202301,42,33,9,42966,11718.24,54684.24
250360,202301,194,159,35,207022.86,45571.29,252594.15
250370,202301,2488,1588,900,2067643.08,1173125.79,3240768.87
250375,202301,18,11,7,14322.36,9114.61,23436.97
250380,202301,57,50,7,65100.84,9114.2,74215.04
250390,202301,50,41,9,53383.52,11718,65101.52
250400,202301,18314,9363,8951,12197585.14,11662254.82,23859839.96
250403,202301,307,235,72,305972.7,93744,399716.7
250407,202301,69,55,14,71610.1,18228.85,89838.95
250410,202301,32,27,5,35154.31,6510.8,41665.11
250415,202301,47,29,18,37758.97,23436,61194.97
250420,202301,41,35,6,45570.3,7812,53382.3
250430,202301,1541,1335,206,1739829.88,269515.38,2009345.26
250435,202301,38,29,9,37758.85,11718,49476.85
250440,202301,694,567,127,738240.34,165355,903595.34
250450,202301,89,68,21,88538.03,27342,115880.03
250460,202301,500,329,171,428362.84,222643.09,651005.93
250470,202301,105,72,33,93744,42966.6,136710.6
250480,202301,346,273,73,355455.57,95046.98,450502.55
250485,202301,7,6,1,7812,1302,9114
250490,202301,254,205,49,266914.68,63798.96,330713.64
250500,202301,102,80,22,104161.37,28644,132805.37
250510,202301,870,690,180,899688.4,234360.63,1134049.03
250520,202301,170,116,54,151032.1,70308.12,221340.22
250523,202301,129,105,24,136710,31248.12,167958.12
250527,202301,122,91,31,118482.53,40362,158844.53
250530,202301,11,6,5,7812,6510,14322
250535,202301,33,26,7,33852,9114,42966
250540,202301,143,113,30,147126.28,39060,186186.28
250550,202301,73,71,2,92442.39,2604,95046.39
250560,202301,68,42,26,54684.2,33852,88536.2
250570,202301,169,138,31,179677.12,40362.2,220039.32
250580,202301,98,77,21,100338.2,27342,127680.2
250590,202301,24,15,9,19530,11718.54,31248.54
250600,202301,1675,1100,575,1432230.13,748653.76,2180883.89
250610,202301,161,128,33,166666.16,42966.45,209632.61
250620,202301,23,19,4,24738.81,5208,29946.81
250625,202301,70,55,15,71613.09,19530.59,91143.68
250630,202301,3232,2018,1214,2627752.37,1580654.74,4208407.11
250640,202301,200,158,42,205720.41,54684.2,260404.61
250650,202301,34,22,12,28644.2,15624.78,44268.98
250660,202301,64,47,17,61194,22134,83328
250670,202301,81,64,17,83328.27,22134.94,105463.21
250680,202301,436,350,86,455710.2,111972.52,567682.72
250690,202301,2290,1542,748,2009030.24,973912.95,2982943.19
250700,202301,968,825,143,1074162.42,186186.2,1260348.62
250710,202301,502,388,114,505201.85,148432.54,653634.39
250720,202301,122,89,33,115878.7,44268,160146.7
250730,202301,421,347,74,451798.69,96350.31,548149.00
250740,202301,73,65,8,84631.61,10416.43,95048.04
250750,202301,25874,15169,10705,19759839.7,13948687.96,33708527.66
250760,202301,124,96,28,124992.5,36456.76,161449.26
250770,202301,379,250,129,325505.35,167958.7,493464.05
250780,202301,75,51,24,66402.1,31248,97650.1
250790,202301,471,286,185,372380.55,240872.2,613252.75
250800,202301,152,137,15,178374,19530,197904
250810,202301,73,59,14,76818,18228,95046
250820,202301,164,135,29,175772.05,37758,213530.05
250830,202301,499,323,176,420556.2,229153.68,649709.88
250840,202301,60,50,10,65101.05,13020.2,78121.25
250850,202301,70,59,11,76818,14322,91140
250855,202301,15,13,2,16926.2,2604,19530.2
250860,202301,250,162,88,210924.72,114576,325500.72
250870,202301,31,28,3,36456,3906,40362
250880,202301,93,71,22,92442.41,28644,121086.41
250890,202301,3331,2454,877,3195189.62,1143170.32,4338359.94
250900,202301,69,58,11,75517.08,14322,89839.08
250905,202301,127,92,35,119784.9,46872,166656.9
250910,202301,1013,735,278,956990,363262.47,1320252.47
250915,202301,116,78,38,101556.9,49477.33,151034.23
250920,202301,155,117,38,152334,49476.96,201810.96
250930,202301,206,120,86,156240.18,111972.2,268212.38
250933,202301,13,9,4,11718,5208,16926
250937,202301,18,17,1,22134,1302,23436
250939,202301,42,32,10,41664.2,13020,54684.2
250940,202301,139,99,40,128899.2,52080.6,180979.8
250950,202301,85,61,24,79423.92,31248,110671.92
250960,202301,89,51,38,66404.44,49476.3,115880.74
250970,202301,1341,948,393,1234316.32,511690.3,1746006.62
250980,202301,98,65,33,84630.99,42966,127596.99
250990,202301,173,133,40,173166,52080,225246
251000,202301,88,74,14,96348,18228,114576
251010,202301,140,97,43,126294,55986,182280
251020,202301,91,75,16,97650.65,20832,118482.65
251030,202301,49,34,15,44268,19530,63798
251040,202301,68,47,21,61194,27342,88536
251050,202301,31,25,6,32550,7812,40362
251060,202301,53,42,11,54684.95,14322.64,69007.59
251065,202301,6,3,3,3906,3906,7812
251070,202301,20,17,3,22134.4,3906,26040.4
251080,202301,5758,2687,3071,3499916.38,3999828.95,7499745.33
251090,202301,199,165,34,214831.94,44268.68,259100.62
251100,202301,22,21,1,27343.18,1302,28645.18
251110,202301,65,42,23,54684,29946,84630
251120,202301,2033,1254,779,1634083.83,1014277.15,2648360.98
251130,202301,458,375,83,488253.54,108066.05,596319.59
251140,202301,644,421,223,548147.56,290347.45,838495.01
251150,202301,350,291,59,378887.22,76819.34,455706.56
251160,202301,98,79,19,102858.44,24738,127596.44
251170,202301,86,71,15,92442.28,19530,111972.28
251180,202301,304,175,129,227853.25,167960.45,395813.70
251190,202301,207,133,74,173169.2,96349.09,269518.29
251200,202301,322,248,74,322905.37,96348.44,419253.81
251203,202301,33,30,3,39060.3,3906,42966.3
251207,202301,88,73,15,95046.22,19530,114576.22
251210,202301,1627,1176,451,1531175.96,587208.89,2118384.85
251220,202301,49,38,11,49476.53,14322,63798.53
251230,202301,605,507,98,660122.98,127597,787719.98
251240,202301,124,87,37,113274,48174,161448
251250,202301,1645,1183,462,1540194.68,601530.81,2141725.49
251260,202301,14,10,4,13020,5208.81,18228.81
251270,202301,321,254,67,330714.66,87234.69,417949.35
251272,202301,62,53,9,69006.2,11718.1,80724.3
251274,202301,27,19,8,24738.1,10416.63,35154.73
251275,202301,35,19,16,24738.51,20832,45570.51
251276,202301,28,22,6,28644.55,7812,36456.55
251278,202301,14,11,3,14322.62,3906,18228.62
251280,202301,117,112,5,145824.2,6510,152334.2
251290,202301,1164,820,344,1067694.73,447905.13,1515599.86
251300,202301,18,13,5,16926,6510,23436
251310,202301,323,232,91,302066.98,118482.54,420549.52
251315,202301,44,39,5,50778,6510.1,57288.1
251320,202301,74,60,14,78120.2,18228.1,96348.3
251330,202301,84,74,10,97650,13020,110670
251335,202301,22,14,8,18228,10416,28644
251340,202301,859,480,379,624974.56,493461.95,1118436.51
251350,202301,35,34,1,44268,1302,45570
251360,202301,94,79,15,102858.2,19530,122388.2
251365,202301,8,8,0,10417.8,,10417.8
251370,202301,6236,4221,2015,5495911.7,2624867.12,8120778.82
251380,202301,45,35,10,45570.75,13020,58590.75
251385,202301,3,3,0,3906,,3906.0
251390,202301,1042,761,281,990844.62,365870.25,1356714.87
251392,202301,38,27,11,35154,14322.39,49476.39
251394,202301,16,12,4,15624.1,5208,20832.1
251396,202301,11,7,4,9114,5208.2,14322.2
251398,202301,21,17,4,22134.2,5208,27342.2
251400,202301,55,43,12,55986,15624,71610
251410,202301,47,40,7,52080.29,9114,61194.29
251420,202301,113,81,32,105463.07,41664.11,147127.18
251430,202301,48,41,7,53382.7,9114,62496.7
251440,202301,54,28,26,36456,33852,70308
251445,202301,69,58,11,75518.19,14322,89840.19
251450,202301,402,342,60,445293.51,78120.2,523413.71
251455,202301,5,4,1,5208,1302,6510
251460,202301,25,20,5,26040,6510.02,32550.02
251465,202301,10,6,4,7812,5208,13020
251470,202301,52,38,14,49476,18228,67704
251480,202301,26,22,4,28644.62,5208.38,33853.00
251490,202301,114,68,46,88537.59,59893.59,148431.18
251500,202301,112,91,21,118483.29,27342,145825.29
251510,202301,99,63,36,82026.94,46872,128898.94
251520,202301,41,33,8,42966,10416,53382
251530,202301,4473,3125,1348,4070118.35,1757710.12,5827828.47
251540,202301,96,76,20,98952.59,26040.61,124993.20
251550,202301,443,333,110,433579.97,143223.44,576803.41
251560,202301,24,19,5,24738.1,6510,31248.1
251570,202301,16,15,1,19530,1302,20832
251580,202301,134,104,30,135408.36,39060,174468.36
251590,202301,106,74,32,96348.2,41664.6,138012.8
251593,202301,31,17,14,22134.27,18228,40362.27
251597,202301,124,96,28,124994.52,36456.18,161450.70
251600,202301,1122,770,352,1002557.74,458307.12,1460864.86
251610,202301,270,193,77,251290.05,100254.2,351544.25
251615,202301,20,17,3,22134,3906,26040
251620,202301,4289,2721,1568,3545421.88,2041567.32,5586989.20
251630,202301,504,369,135,480453.67,175773.54,656227.21
251640,202301,111,79,32,102862.16,41664.2,144526.36
251650,202301,309,225,84,292953.23,109368.2,402321.43
251660,202301,206,181,25,235664.71,32550.8,268215.51
251670,202301,421,318,103,414043.59,134106.53,548150.12
251675,202301,15,10,5,13020,6510,19530
251680,202301,109,95,14,123690.3,18228,141918.3
251690,202301,326,271,55,353174.97,71610.2,424785.17
251700,202301,284,242,42,315087.18,54684.07,369771.25
251710,202301,23,15,8,19530.19,10416,29946.19
251720,202301,33,25,8,32550,10416,42966
251740,202301,13,10,3,13020.8,3906,16926.8
260005,202301,3879,2018,1861,2626980.93,2424361.58,5051342.51
260010,202301,1812,1354,458,1762935.42,596321.53,2359256.95
260020,202301,430,370,60,481745.48,78120.2,559865.68
260030,202301,645,432,213,562473.55,277327.05,839800.60
260040,202301,815,509,306,662733.19,398414.9,1061148.09
260050,202301,1178,850,328,1108023.21,429664.23,1537687.44
260060,202301,377,346,31,450502.23,40362,490864.23
260070,202301,1380,843,537,1097634.06,700498.27,1798132.33
260080,202301,766,575,191,748663.88,248682,997345.88
260090,202301,490,308,182,401017.9,236964.1,637982.0
260100,202301,223,150,73,195302.07,95046,290348.07
260105,202301,281,162,119,210925.47,154938.6,365864.07
260110,202301,3129,2257,872,2939961.19,1136655.73,4076616.92
260120,202301,2893,1536,1357,2001565.96,1766832.42,3768398.38
260130,202301,223,157,66,204415.73,85932,290347.73
260140,202301,2363,1516,847,1973881.82,1102806.44,3076688.26
260150,202301,195,128,67,166658.22,88537.4,255195.62
260160,202301,363,283,80,368476.43,104161.02,472637.45
260170,202301,3575,2116,1459,2759001.96,1900950.7,4659952.66
260180,202301,191,162,29,210925.47,37758.5,248683.97
260190,202301,2572,1674,898,2179586.83,1169204.8,3348791.63
260200,202301,1036,803,233,1045521.74,303366.8,1348888.54
260210,202301,1424,1017,407,1324161.59,531222.3,1855383.89
260220,202301,650,578,72,752571.38,93745.67,846317.05
260230,202301,1359,998,361,1299423.95,471330.3,1770754.25
260240,202301,216,163,53,212231.18,69007.63,281238.81
260250,202301,106,80,26,104160.05,33852,138012.05
260260,202301,1135,786,349,1023383.49,454400.65,1477784.14
260270,202301,264,189,75,246084.74,97650,343734.74
260280,202301,1193,946,247,1231713.5,321597.32,1553310.82
260290,202301,7456,3979,3477,5182098.12,4530997.84,9713095.96
260300,202301,1099,929,170,1209604.5,222643.42,1432247.92
260310,202301,548,432,116,562472.92,151032.6,713505.52
260320,202301,828,590,238,768183.15,309876.99,1078060.14
260330,202301,89,67,22,87234.3,29946.8,117181.1
260340,202301,88,63,25,82026.85,32550,114576.85
260345,202301,6200,3154,3046,4109235.84,3965947.6,8075183.44
260350,202301,497,353,144,459616.82,187488.6,647105.42
260360,202301,257,147,110,191394.6,143221.1,334615.7
260370,202301,737,471,266,613250.46,348937.85,962188.31
260380,202301,561,400,161,520808.39,209624.19,730432.58
260390,202301,294,252,42,328108.91,54684,382792.91
260392,202301,122,106,16,138013.77,20832.67,158846.44
260400,202301,4717,2689,2028,3503729.69,2640475.25,6144204.94
260410,202301,16183,8327,7856,10844620.73,10233803.74,21078424.47
260415,202301,159,132,27,171865.24,35154,207019.24
260420,202301,1866,1174,692,1529875.7,900987.04,2430862.74
260430,202301,175,156,19,203120.02,24738.8,227858.82
260440,202301,212,142,70,184889.74,91141.37,276031.11
260450,202301,437,328,109,427066.65,143220.73,570287.38
260460,202301,890,460,430,602842.89,561166.41,1164009.30
260470,202301,339,206,133,268217.65,173167.16,441384.81
260480,202301,259,163,96,212226,124992,337218
260490,202301,243,183,60,238267.36,78120,316387.36
260500,202301,1200,795,405,1035110.06,527316.88,1562426.94
260510,202301,871,694,177,903601.54,230455.07,1134056.61
260515,202301,246,227,19,295555.97,24738.91,320294.88
260520,202301,3344,2037,1307,2652160.07,1701737.29,4353897.36
260530,202301,879,699,180,910126.35,234360.1,1144486.45
260540,202301,564,440,124,572888.65,161449.36,734338.01
260545,202301,24,13,11,16926.43,14322.62,31249.05
260550,202301,358,233,125,303367.86,162750.19,466118.05
260560,202301,519,396,123,515602.06,160147.84,675749.90
260570,202301,1074,858,216,1117146.24,281234.12,1398380.36
260580,202301,357,288,69,374978.75,89838,464816.75
260590,202301,645,376,269,489554.9,350238.4,839793.3
260600,202301,8253,4790,3463,6238011.74,4512767.02,10750778.76
260610,202301,515,350,165,455708.48,214834.1,670542.58
260620,202301,4040,2101,1939,2735586.56,2529966.2,5265552.76
260630,202301,84,74,10,96348.2,13020,109368.2
260640,202301,3546,2137,1409,2782415.33,1834528.29,4616943.62
260650,202301,334,240,94,312486.74,122388.8,434875.54
260660,202301,622,407,215,529930.52,279933.84,809864.36
260670,202301,113,78,35,101556,45570.12,147126.12
260680,202301,4318,2315,2003,3014248.54,2607951.8,5622200.34
260690,202301,136,102,34,132804.74,44268,177072.74
260700,202301,329,226,103,294255.44,134106.2,428361.64
260710,202301,52,43,9,55986,11718,67704
260720,202301,2851,1656,1195,2157439.23,1557197.76,3714636.99
260730,202301,795,588,207,765585.85,269515.37,1035101.22
260740,202301,79,65,14,84630.76,18228,102858.76
260750,202301,575,428,147,558569.14,191395.12,749964.26
260760,202301,789,388,401,505200.54,522113.85,1027314.39
260765,202301,1074,557,517,725227.79,673143.07,1398370.86
260770,202301,228,163,65,212206.92,84632.44,296839.36
260775,202301,899,465,434,608050.38,565076.9,1173127.28
260780,202301,240,149,91,194000.25,118482,312482.25
260790,202301,16891,8177,8714,10658509,11370465.74,22028974.74
260795,202301,161,104,57,135408.62,75516,210924.62
260800,202301,315,259,56,337221.03,72912.46,410133.49
260805,202301,38,25,13,32551.2,16926.7,49477.9
260810,202301,883,704,179,916616.15,233058.67,1149674.82
260820,202301,323,214,109,278631.84,141918.32,420550.16
260825,202301,218,147,71,191394.92,92442,283836.92
260830,202301,308,199,109,259098,141918,401016
260840,202301,280,201,79,261704.62,102858.9,364563.52
260845,202301,204,122,82,161449,106765.83,268214.83
260850,202301,437,327,110,425759.57,143220,568979.57
260860,202301,242,182,60,236966.09,78120,315086.09
260870,202301,348,271,77,354147.51,100254,454401.51
260875,202301,773,558,215,727846.66,281233.15,1009079.81
260880,202301,1681,1110,571,1445241.03,743443.09,2188684.12
260890,202301,2636,1793,843,2334529.95,1097594.02,3432123.97
260900,202301,1056,777,279,1011670.22,363258.8,1374929.02
260910,202301,257,204,53,265613.15,69006.6,334619.75
260915,202301,286,214,72,278628,93744,372372
260920,202301,231,126,105,164052.2,136710,300762.2
260930,202301,367,312,55,406233.91,71610.86,477844.77
260940,202301,2709,1445,1264,1881452.19,1648352.63,3529804.82
260950,202301,2087,1173,914,1528589.34,1190050.16,2718639.50
260960,202301,14871,7114,7757,9269382.06,10108922.29,19378304.35
260970,202301,448,360,88,468723.15,114576,583299.15
260980,202301,215,197,18,256497.55,23436.1,279933.65
260990,202301,2808,2225,583,2898330.64,759072.92,3657403.56
261000,202301,4411,2716,1695,3537587.38,2209513.56,5747100.94
261010,202301,136,101,35,131503.26,45570,177073.26
261020,202301,619,448,171,584607.5,222642.1,807249.6
261030,202301,259,190,69,247381.23,89838,337219.23
261040,202301,382,320,62,416650,80724,497374
261050,202301,545,448,97,583304.55,126296.13,709600.68
261060,202301,1667,1040,627,1355395.02,816358.19,2171753.21
261070,202301,10517,4939,5578,6432179.82,7267968.01,13700147.83
261080,202301,371,288,83,374983.13,108066,483049.13
261090,202301,2176,1665,511,2167903.51,665326.36,2833229.87
261100,202301,1287,887,400,1154899.29,520807.78,1675707.07
261110,202301,9975,6228,3747,8110473.46,4878677.69,12989151.15
261120,202301,234,199,35,259099.59,45570,304669.59
261130,202301,587,347,240,451810.15,312487.88,764298.03
261140,202301,225,139,86,180978.75,111972.37,292951.12
261150,202301,686,444,242,578091.76,315084.1,893175.86
261153,202301,76,71,5,92442.2,6510,98952.2
261160,202301,81382,39566,41816,51564369,54488377.67,106052746.67
261170,202301,512,382,130,497364.88,169260.68,666625.56
261180,202301,1868,1165,703,1518464.99,917919.18,2436384.17
261190,202301,612,413,199,537734.15,260401.75,798135.90
261200,202301,225,177,48,230457.49,62496,292953.49
261210,202301,44,33,11,42966.1,14322,57288.1
261220,202301,2980,2077,903,2706925.55,1175720.07,3882645.62
261230,202301,381,280,101,364566.76,131502.97,496069.73
261240,202301,439,376,63,490865.76,82026,572891.76
261245,202301,257,221,36,289044.86,46872,335916.86
261247,202301,177,134,43,174470.43,55986,230456.43
261250,202301,4047,1932,2115,2516802.37,2753745.8,5270548.17
261255,202301,256,225,31,292950.52,40362,333312.52
261260,202301,875,751,124,977848.24,161452.59,1139300.83
261270,202301,208,147,61,191394.13,79422,270816.13
261280,202301,204,164,40,213530.32,52080.66,265610.98
261290,202301,102,73,29,95046.24,37758.2,132804.44
261300,202301,1474,1098,376,1429627.82,490859.02,1920486.84
261310,202301,857,567,290,738249.08,377582.21,1115831.29
261320,202301,529,364,165,473939.85,214831.99,688771.84
261330,202301,923,724,199,942689.01,259106.54,1201795.55
261340,202301,343,193,150,251289.82,195300.94,446590.76
261350,202301,963,663,300,863253.88,390607.06,1253860.94
261360,202301,1451,911,540,1186129.45,703083.96,1889213.41
261370,202301,5261,3067,2194,3993329.85,2860536.57,6853866.42
261380,202301,587,458,129,596321.95,167958,764279.95
261390,202301,3983,2697,1286,3511612.77,1674408.17,5186020.94
261400,202301,291,258,33,335921.43,42967.4,378888.83
261410,202301,1190,779,411,1014280.93,535124.21,1549405.14
261420,202301,1010,616,394,802046.26,514293.78,1316340.04
261430,202301,326,293,33,381491.32,42966,424457.32
261440,202301,104,99,5,128898.24,6510,135408.24
261450,202301,2692,2084,608,2713405.95,791621.14,3505027.09
261460,202301,816,623,193,811164.45,251288.63,1062453.08
261470,202301,239,191,48,248684,62496.5,311180.5
261480,202301,497,371,126,483052.44,163994.58,647047.02
261485,202301,411,246,165,320300.14,214830.83,535130.97
261500,202301,655,422,233,549453.9,305971.3,855425.2
261510,202301,54,36,18,46872.98,23436.1,70309.08
261520,202301,103,87,16,113276.59,20832.2,134108.79
261530,202301,4458,2867,1591,3734203.8,2071500.57,5805704.37
261540,202301,1598,921,677,1199161.1,881462.67,2080623.77
261550,202301,268,127,141,165355.14,184884,350239.14
261560,202301,1005,663,342,864549.74,445288.45,1309838.19
261570,202301,398,318,80,414041.02,104160.95,518201.97
261580,202301,409,328,81,427063.26,105462.61,532525.87
261590,202301,201,161,40,209627.68,52080.8,261708.48
261600,202301,329,255,74,333321.4,96348.84,429670.24
261610,202301,93,77,16,100254.52,20832.76,121087.28
261618,202301,84,61,23,79422.59,29946,109368.59
261620,202301,210,134,76,174468.27,98952.98,273421.25
261630,202301,707,550,157,716103.98,204416.26,920520.24
261640,202301,7107,3751,3356,4883925.19,4373485.6,9257410.79
261650,202301,465,297,168,386694.85,218736.3,605431.15
270010,202301,520,460,60,598932.79,78120.5,677053.29
270020,202301,261,214,47,278632.48,61195.17,339827.65
270030,202301,9544,6114,3430,7963914.87,4467154.14,12431069.01
270040,202301,2144,1414,730,1841059.84,950467.77,2791527.61
270050,202301,243,190,53,247382.86,69006.13,316388.99
270060,202301,70,47,23,61198.27,29947.16,91145.43
270070,202301,802,593,209,772095.49,272119.4,1044214.89
270080,202301,54,42,12,54684.1,15624,70308.1
270090,202301,20,16,4,20832,5208,26040
270100,202301,1354,923,431,1201769.84,561165.87,1762935.71
270110,202301,66,54,12,70308,15624,85932
270120,202301,260,213,47,277335.43,61194.4,338529.83
270130,202301,337,255,82,332015.33,106764,438779.33
270135,202301,121,85,36,110670.8,46872,157542.8
270140,202301,1445,957,488,1246045.05,635385.94,1881430.99
270150,202301,256,189,67,246081.39,87235.27,333316.66
270160,202301,487,383,104,498678.1,135408.06,634086.16
270170,202301,820,546,274,710899.39,356749.96,1067649.35
270180,202301,54,43,11,55986,14322.76,70308.76
270190,202301,115,99,16,128900.94,20832,149732.94
270200,202301,116,103,13,134106.16,16926,151032.16
270210,202301,556,345,211,449193.38,276024.6,725217.98
270220,202301,202,139,63,180978.99,82026.93,263005.92
270230,202301,2249,1432,817,1864496.59,1063739.1,2928235.69
270235,202301,496,388,108,506498.39,140616.1,647114.49
270240,202301,3398,2690,708,3502426.49,921819.63,4424246.12
270250,202301,125,95,30,123691.79,39060,162751.79
270255,202301,214,177,37,230455.87,48174.44,278630.31
270260,202301,420,332,88,432276.78,114576.2,546852.98
270270,202301,97,52,45,67704.5,58590,126294.5
270280,202301,198,125,73,162750.2,95046,257796.2
270290,202301,1159,908,251,1182232.99,326806.71,1509039.70
270300,202301,379,277,102,360655.78,132804.2,493459.98
270310,202301,823,687,136,895793.83,177074.17,1072868.00
270320,202301,766,661,105,860635.25,136710,997345.25
270330,202301,331,286,45,372372.12,58590,430962.12
270340,202301,65,54,11,70308,14322,84630
270350,202301,84,49,35,63801.98,45570.06,109372.04
270360,202301,76,41,35,53382,46872,100254
270370,202301,67,53,14,69006,18228,87234
270375,202301,87,56,31,72912.1,40362,113274.1
270380,202301,1067,735,332,958272.3,432264,1390536.3
270390,202301,134,80,54,104160.2,70308.1,174468.3
270400,202301,773,598,175,779910.1,227850.92,1007761.02
270410,202301,221,165,56,214836.41,72912.01,287748.42
270420,202301,413,290,123,377583.21,160146.7,537729.91
270430,202301,36108,25673,10435,33450033.54,13598408.11,47048441.65
270440,202301,470,371,99,483051.06,128899.04,611950.10
270450,202301,894,540,354,703085.21,460910.11,1163995.32
270460,202301,182,145,37,188794.34,48174,236968.34
270470,202301,1710,1196,514,1558046.88,669229.3,2227276.18
270480,202301,572,463,109,602837.41,141918.76,744756.17
270490,202301,25,20,5,26040,6510,32550
270500,202301,480,397,83,516899.45,108066,624965.45
270510,202301,910,606,304,791566.03,395810.7,1187376.73
270520,202301,268,180,88,234360.97,114576,348936.97
270530,202301,64,54,10,70308.2,13020,83328.2
270540,202301,84,60,24,78120,31248,109368
270550,202301,1661,1273,388,1660076,505178.85,2165254.85
270560,202301,250,152,98,197906.3,127596.5,325502.8
270570,202301,605,430,175,559866.75,227850,787716.75
270580,202301,19,14,5,18228,6510,24738
270590,202301,56,44,12,57288.3,15624,72912.3
270600,202301,158,135,23,175777.07,29946.1,205723.17
270610,202301,251,204,47,265610.94,61194.1,326805.04
270620,202301,18,18,0,23436,,23436.0
270630,202301,3685,2756,929,3591010.64,1210870.91,4801881.55
270640,202301,896,664,232,864541.8,302066.26,1166608.06
270642,202301,213,175,38,227851.25,49476,277327.25
270644,202301,272,170,102,221343.32,132806.44,354149.76
270650,202301,355,220,135,286443.93,175771.75,462215.68
270660,202301,200,175,25,227859.98,32550.75,260410.73
270670,202301,3014,2299,715,2994436.6,930931.94,3925368.54
270680,202301,398,261,137,339827.5,178374,518201.5
270690,202301,1255,851,404,1108027.61,527315.04,1635342.65
270700,202301,23,19,4,24738,5208,29946
270710,202301,562,438,124,570283.95,161448,731731.95
270720,202301,229,185,44,240874.18,57288.5,298162.68
270730,202301,1946,1222,724,1593667.42,943955.62,2537623.04
270740,202301,34,24,10,31248.56,13020,44268.56
270750,202301,622,480,142,626269.13,186186.72,812455.85
270760,202301,298,218,80,283844.15,104160.76,388004.91
270770,202301,2939,2021,918,2632722.06,1195244.19,3827966.25
270780,202301,65,39,26,50778,33852.71,84630.71
270790,202301,201,125,76,162752.46,98952,261704.46
270800,202301,2071,1666,405,2169169.71,528612.2,2697781.91
270810,202301,210,170,40,221342.04,52080,273422.04
270820,202301,119,82,37,106766.8,48174,154940.8
270830,202301,856,658,198,856747.21,260401.05,1117148.26
270840,202301,1334,1040,294,1354093.74,382789.36,1736883.10
270850,202301,1570,1025,545,1335343.78,710895.62,2046239.40
270860,202301,2663,1808,855,2355141.86,1113222.98,3468364.84
270870,202301,129,78,51,101556.44,66402.2,167958.64
270880,202301,856,680,176,885379.9,229154.25,1114534.15
270890,202301,260,200,60,260401.12,79422.9,339824.02
270895,202301,74,70,4,91140,5208,96348
270900,202301,67,56,11,72912.85,14322,87234.85
270910,202301,311,259,52,337227.41,67705.54,404932.95
270915,202301,1982,1330,652,1734295.4,848906.09,2583201.49
270920,202301,394,330,64,429664.84,83328,512992.84
270930,202301,5631,4338,1293,5649487.39,1684797.22,7334284.61
270940,202301,2230,1782,448,2320201.38,583297.71,2903499.09
280010,202301,34,28,6,36456.2,7812,44268.2
280020,202301,515,434,81,565077.82,105462.97,670540.79
280030,202301,22859,14736,8123,19191097.28,10584246.08,29775343.36
280040,202301,343,211,132,274723.24,171864.72,446587.96
280050,202301,449,349,100,454403.62,131502,585905.62
280060,202301,418,266,152,346340.21,199207.08,545547.29
280067,202301,1174,844,330,1100206.68,429660.36,1529867.04
280070,202301,124,105,19,136711.02,24738,161449.02
280100,202301,698,537,161,700483.56,209622.81,910106.37
280110,202301,90,78,12,101557.05,15624,117181.05
280120,202301,703,583,120,759076.17,156241.48,915317.65
280130,202301,1847,1215,632,1583246.62,822865.8,2406112.42
280140,202301,529,441,88,574189.93,114576.2,688766.13
280150,202301,436,310,126,403630,165354,568984
280160,202301,152,113,39,147126.99,50778,197904.99
280170,202301,433,305,128,397122.18,167959.51,565081.69
280190,202301,34,26,8,33852,10416,44268
280200,202301,53,42,11,54689.01,14322.3,69011.31
280210,202301,3119,2239,880,2917758.35,1145767.84,4063526.19
280220,202301,66,53,13,69008.06,16926,85934.06
280230,202301,341,274,67,356759.84,87236.42,443996.26
280240,202301,135,125,10,162752.74,13020,175772.74
280250,202301,20,11,9,14322.3,11719.87,26042.17
280260,202301,79,71,8,92444.69,10416,102860.69
280270,202301,142,109,33,141918.58,42966.79,184885.37
280280,202301,193,130,63,169261.62,82026,251287.62
280290,202301,3953,2881,1072,3752419.63,1395757.66,5148177.29
280300,202301,1724,1382,342,1799392.65,447891.77,2247284.42
280310,202301,104,98,6,127598.61,7812,135410.61
280320,202301,702,483,219,628881.87,285141.82,914023.69
280330,202301,326,242,84,315090.79,111972.2,427062.99
280340,202301,441,367,74,477843.19,96349.37,574192.56
280350,202301,3911,2989,922,3891841.54,1203066.69,5094908.23
280360,202301,496,340,156,442693.18,203113.45,645806.63
280370,202301,95,80,15,104160.96,19530,123690.96
280380,202301,51,40,11,52080,14322,66402
280390,202301,178,151,27,196604.85,35154,231758.85
280400,202301,422,276,146,359361.94,190095.05,549456.99
280410,202301,302,254,48,332015.19,62496,394511.19
280420,202301,145,125,20,162758.83,26040.95,188799.78
280430,202301,103,83,20,108067.06,26040,134107.06
280440,202301,735,604,131,786425.81,170565.03,956990.84
280445,202301,123,115,8,149732.51,10416,160148.51
280450,202301,1366,1166,200,1518154.23,260404.67,1778558.90
280460,202301,698,514,184,670542.85,240870.72,911413.57
280470,202301,99,90,9,117182.55,11718,128900.55
280480,202301,3338,2244,1094,2924479.03,1425728,4350207.03
280490,202301,207,196,11,255202.65,14322,269524.65
280500,202301,39,35,4,45570.54,5208.77,50779.31
280510,202301,134,107,27,139314.89,36456.9,175771.79
280520,202301,51,36,15,46872.27,19530,66402.27
280530,202301,74,49,25,63801.58,32550.38,96351.96
280540,202301,576,498,78,648404.55,101556,749960.55
280550,202301,764,704,60,916624.99,78120,994744.99
280560,202301,497,449,48,584606.65,62496.74,647103.39
280570,202301,2476,1963,513,2557169.06,667928.36,3225097.42
280580,202301,604,477,127,622362.01,165354.96,787716.97
280590,202301,228,147,81,191402.7,106769.6,298172.3
280600,202301,424,345,79,449256.66,102858.2,552114.86
280610,202301,116,81,35,105466.16,45572.11,151038.27
280620,202301,570,463,107,602833.57,139314.08,742147.65
280630,202301,156,127,29,165356.63,37758.2,203114.83
280640,202301,178,144,34,187488.3,45570,233058.3
280650,202301,86,52,34,67705.51,44268.52,111974.03
280660,202301,126,94,32,122394.95,41664.31,164059.26
280670,202301,2126,1359,767,1769535.08,998660.11,2768195.19
280680,202301,245,207,38,270818.88,49476,320294.88
280690,202301,76,66,10,85932,13020,98952
280700,202301,22,22,0,28644,,28644.0
280710,202301,1590,1227,363,1597578.99,473931.62,2071510.61
280720,202301,136,95,41,123694.38,53382,177076.38
280730,202301,32,28,4,36457.04,5208.05,41665.09
280740,202301,2664,2008,656,2617047.19,855418.49,3472465.68
280750,202301,236,207,29,269523.87,37759.14,307283.01
280760,202301,983,663,320,863253.04,416642.63,1279895.67
290010,202301,204,145,59,188790.66,76818,265608.66
290020,202301,193,171,22,222644.36,28644.9,251289.26
290030,202301,637,411,226,535127.94,294252.88,829380.82
290035,202301,138,111,27,144523.59,35154.93,179678.52
290040,202301,258,181,77,235666.98,100254,335920.98
290050,202301,93,75,18,97650,23436,121086
290060,202301,256,112,144,145824.95,187489.19,333314.14
290070,202301,6286,2972,3314,3872240.32,4316180.83,8188421.15
290080,202301,492,217,275,282536.62,358050.09,640586.71
290090,202301,334,155,179,201810.3,233060.23,434870.53
290100,202301,1786,1124,662,1463476.8,861928.74,2325405.54
290110,202301,919,512,407,667949.55,529922.89,1197872.44
290115,202301,181,165,16,214833.03,20832,235665.03
290120,202301,840,564,276,734337.69,359352.3,1093689.99
290130,202301,488,298,190,387998.69,247380.18,635378.87
290135,202301,299,224,75,291651.35,97650.1,389301.45
290140,202301,332,279,53,363264.11,69006.2,432270.31
290150,202301,150,101,49,131502,63798.01,195300.01
290160,202301,251,191,60,248689.54,78120.69,326810.23
290170,202301,108,78,30,101557.24,39060,140617.24
290180,202301,199,143,56,186188.09,72912.2,259100.29
290190,202301,368,286,82,372382.69,106765.63,479148.32
290195,202301,311,207,104,269516.24,135408.1,404924.34
290200,202301,265,213,52,277326.51,67704.1,345030.61
290205,202301,159,97,62,126294.4,80724,207018.4
290210,202301,1294,951,343,1238232.54,446590.59,1684823.13
290220,202301,171,104,67,135413.93,87235.1,222649.03
290225,202301,293,113,180,147128.59,234360.56,381489.15
290230,202301,93,55,38,71611.5,49476.6,121088.1
290240,202301,375,130,245,169262.25,318990.8,488253.05
290250,202301,242,224,18,291654.71,23436,315090.71
290260,202301,356,279,77,363270.01,100256.98,463526.99
290265,202301,195,170,25,221342.97,32550.49,253893.46
290270,202301,1414,1167,247,1519479.03,321595.9,1841074.93
290280,202301,504,352,152,458308.79,197904.4,656213.19
290290,202301,1482,896,586,1166612.29,762974.09,1929586.38
290300,202301,393,333,60,433574.36,78120.55,511694.91
290310,202301,291,138,153,179676.4,199206,378882.4
290320,202301,4463,2662,1801,3468640.9,2344923.65,5813564.55
290323,202301,213,185,28,240874.49,36456.2,277330.69
290327,202301,169,130,39,169263.7,50778.13,220041.83
290330,202301,125,57,68,74214.13,88536,162750.13
290340,202301,797,336,461,437488.35,600226.6,1037714.95
290350,202301,690,412,278,536427.42,361958.76,898386.18
290360,202301,334,261,73,339827.28,95046.39,434873.67
290370,202301,909,415,494,540333.02,643188.91,1183521.93
290380,202301,349,222,127,289046,165355.79,454401.79
290390,202301,2506,1560,946,2032462.68,1231701.67,3264164.35
290395,202301,238,140,98,182280.7,127596,309876.7
290400,202301,298,217,81,282535.25,105462,387997.25
290405,202301,243,208,35,272118.8,45570,317688.8
290410,202301,666,556,110,723915.87,144522,868437.87
290420,202301,284,230,54,299461.7,70308,369769.7
290430,202301,511,328,183,427057.91,238266,665323.91
290440,202301,91,75,16,97650.22,20832,118482.22
290450,202301,198,146,52,190092.17,67704,257796.17
290460,202301,2054,1228,826,1598885.76,1078058.02,2676943.78
290470,202301,1407,623,784,811168.1,1020779.51,1831947.61
290475,202301,577,540,37,704395.52,48174,752569.52
290480,202301,202,112,90,145825.46,117180.93,263006.39
290485,202301,242,217,25,282535.53,32550,315085.53
290490,202301,1340,941,399,1227799.94,519500.83,1747300.77
290500,202301,836,450,386,585906.74,502574.8,1088481.54
290510,202301,189,152,37,197913.78,48174.35,246088.13
290515,202301,185,116,69,151033.49,89838,240871.49
290520,202301,1453,953,500,1240812.4,651001.47,1891813.87
290530,202301,278,250,28,325510.31,36456.2,361966.51
290540,202301,130,61,69,79422,89838,169260
290550,202301,175,144,31,187490.11,40362.2,227852.31
290560,202301,3290,1483,1807,1932213.48,2352728.52,4284942.00
290570,202301,7245,3422,3823,4459519.26,4981546.81,9441066.07
290580,202301,1330,805,525,1048122.25,684853.49,1732975.74
290590,202301,593,473,120,615874.15,156244.88,772119.03
290600,202301,1843,1247,596,1623648.2,778605.1,2402253.3
290610,202301,187,170,17,221349.63,22134,243483.63
290620,202301,400,352,48,458308.69,62496.4,520805.09
290630,202301,2070,881,1189,1147086.73,1548085.68,2695172.41
290640,202301,136,107,29,139319.51,37758.05,177077.56
290650,202301,2103,982,1121,1278603.19,1460853.2,2739456.39
290660,202301,276,225,51,292950.34,66402,359352.34
290670,202301,1095,550,545,717415.14,709596.67,1427011.81
290680,202301,1305,1047,258,1363213.82,335920.07,1699133.89
290682,202301,350,255,95,332012.26,123690.58,455702.84
290685,202301,267,160,107,208323.28,139314.2,347637.48
290687,202301,1244,819,425,1066571.65,553351.19,1619922.84
290689,202301,148,75,73,97650,96348.31,193998.31
290690,202301,578,264,314,343733.33,408830.27,752563.60
290700,202301,263,133,130,173171.51,169261.79,342433.30
290710,202301,811,564,247,734338.9,321599.59,1055938.49
290720,202301,1110,889,221,1157517.4,287744.21,1445261.61
290730,202301,1288,764,524,997353.85,682254.02,1679607.87
290740,202301,28,24,4,31248,5208,36456
290750,202301,1548,674,874,877569.03,1137964.63,2015533.66
290755,202301,81,69,12,89838,15624,105462
290760,202301,269,231,38,300773.76,49476.52,350250.28
290770,202301,191,182,9,236966.73,11718,248684.73
290780,202301,1163,932,231,1213486.32,300766.67,1514252.99
290790,202301,411,278,133,361961.38,174472.3,536433.68
290800,202301,2496,1013,1483,1318948.52,1930873.77,3249822.29
290810,202301,505,348,157,453101.24,204414.99,657516.23
290820,202301,430,250,180,325510.34,234363.81,559874.15
290830,202301,498,351,147,458309.24,191394.18,649703.42
290840,202301,1936,1218,718,1585871.59,934842.14,2520713.73
290850,202301,1080,551,529,717411.95,690066.67,1407478.62
290860,202301,715,345,370,449197,481742.22,930939.22
290870,202301,643,441,202,574191.78,263004.25,837196.03
290880,202301,124,65,59,85932.4,76818,162750.4
290890,202301,511,304,207,395814.32,269515.94,665330.26
290900,202301,162,125,37,162750.94,48174,210924.94
290910,202301,414,316,98,411432.66,127596,539028.66
290920,202301,210,188,22,244779.8,28644,273423.8
290930,202301,548,416,132,541640.22,171866.1,713506.32
290940,202301,224,191,33,248682.3,42966,291648.3
290950,202301,160,91,69,118482,89838,208320
290960,202301,514,366,148,476535.94,192697.86,669233.80
290970,202301,237,208,29,270817.82,37758.2,308576.02
290980,202301,2022,1409,613,1834554.57,798133.76,2632688.33
290990,202301,429,366,63,476548.73,82028.07,558576.80
291000,202301,953,309,644,402318.96,838488,1240806.96
291005,202301,2761,1182,1579,1541625.72,2057192.22,3598817.94
291010,202301,120,105,15,136710,19530,156240
291020,202301,89,71,18,92442,23436,115878
291030,202301,106,79,27,102858.47,35154,138012.47
291040,202301,661,393,268,511687.78,350238.95,861926.73
291050,202301,1598,829,769,1079376.9,1002548.94,2081925.84
291060,202301,1748,962,786,1252546.75,1023379.34,2275926.09
291070,202301,2022,1514,508,1971268.54,661422.31,2632690.85
291072,202301,7635,2920,4715,3803268.46,6142871.9,9946140.36
291075,202301,256,212,44,276024.6,57288.2,333312.8
291077,202301,60,41,19,53382,24738,78120
291080,202301,22478,9616,12862,12523016.37,16756989.06,29280005.43
291085,202301,286,230,56,299464.97,72912.75,372377.72
291090,202301,256,104,152,135410.6,197904,333314.6
291100,202301,981,342,639,445284.81,831978,1277262.81
291110,202301,454,344,110,447893.63,143220.4,591114.03
291120,202301,2485,1328,1157,1729076.21,1506420.38,3235496.59
291125,202301,70,35,35,45570.1,45570,91140.1
291130,202301,180,155,25,201814.89,32550,234364.89
291140,202301,134,104,30,135409.31,39060.7,174470.01
291150,202301,361,132,229,171864.38,298158,470022.38
291160,202301,409,314,95,410145.07,123691.29,533836.36
291165,202301,52,39,13,50778,16926.62,67704.62
291170,202301,3538,1752,1786,2283750.14,2326680.46,4610430.60
291180,202301,1275,540,735,703090.96,959575.01,1662665.97
291185,202301,117,107,10,139315.4,13020,152335.4
291190,202301,1425,691,734,899700.61,955677.69,1855378.30
291200,202301,176,132,44,171864.41,57288.68,229153.09
291210,202301,2532,1035,1497,1347591.85,1950406.39,3297998.24
291220,202301,331,253,78,329406.99,101556.2,430963.19
291230,202301,965,347,618,451800.86,808545.26,1260346.12
291240,202301,409,378,31,492159.99,40362,532521.99
291250,202301,411,335,76,436170.19,98952,535122.19
291260,202301,66,56,10,72912.1,13020,85932.1
291270,202301,1044,465,579,606761.61,753877.09,1360638.70
291280,202301,369,174,195,226550.31,253890.8,480441.11
291290,202301,1683,895,788,1165330.66,1025992.2,2191322.86
291300,202301,248,186,62,242174.29,80724,322898.29
291310,202301,234,202,32,263009.16,41664,304673.16
291320,202301,1331,929,402,1209589.89,523406.65,1732996.54
291330,202301,141,117,24,152336.17,31248.2,183584.37
291340,202301,240,148,92,192699.15,119785.24,312484.39
291345,202301,121,87,34,113274.4,44268,157542.4
291350,202301,1847,707,1140,921820.34,1484280.83,2406101.17
291360,202301,8995,4294,4701,5593599.96,6127317.94,11720917.90
291370,202301,1188,716,472,932263.71,614551.43,1546815.14
291380,202301,272,210,62,273421.39,80724,354145.39
291390,202301,4238,1880,2358,2449110.81,3071434.92,5520545.73
291400,202301,2161,1503,658,1958256.48,856729.17,2814985.65
291410,202301,230,193,37,251288.07,48174,299462.07
291420,202301,123,94,29,122388.2,37758,160146.2
291430,202301,186,115,71,149730.2,92442,242172.2
291440,202301,549,445,104,579404.05,135408.2,714812.25
291450,202301,1033,683,350,889281.57,457006.94,1346288.51
291460,202301,2103,1639,464,2135342.64,605440.74,2740783.38
291465,202301,2390,1150,1240,1497327.1,1614487.43,3111814.53
291470,202301,3014,1515,1499,1972575.5,1954317.74,3926893.24
291480,202301,12639,5480,7159,7136449.72,9328889.12,16465338.84
291490,202301,717,288,429,376281.7,558558.4,934840.1
291500,202301,376,225,151,293963.23,196602.47,490565.70
291510,202301,1189,472,717,614547.08,934837.19,1549384.27
291520,202301,947,426,521,554661.76,678343.55,1233005.31
291530,202301,948,286,662,372373.75,861924.6,1234298.35
291535,202301,135,111,24,144522.19,31248.2,175770.39
291540,202301,347,123,224,160148.98,291649.05,451798.03
291550,202301,1302,618,684,804648.09,891871.97,1696520.06
291560,202301,5283,2678,2605,3489402.16,3394323.44,6883725.60
291570,202301,239,126,113,164052.79,147127.45,311180.24
291580,202301,1232,778,454,1012970.14,591111.68,1604081.82
291590,202301,116,54,62,70308.72,80724,151032.72
291600,202301,1169,593,576,772098.45,749956.62,1522055.07
291610,202301,1517,737,780,959627.52,1015587.47,1975214.99
291620,202301,570,269,301,350247.06,391904.29,742151.35
291630,202301,487,154,333,200509.65,433566.2,634075.85
291640,202301,4259,2075,2184,2703011.29,2846194.67,5549205.96
291650,202301,468,326,142,424465.94,184886.8,609352.74
291660,202301,370,151,219,196603.59,285139.57,481743.16
291670,202301,169,105,64,136713.98,83328.1,220042.08
291680,202301,630,386,244,502598.52,317691.85,820290.37
291685,202301,627,366,261,476539.11,339825.92,816365.03
291690,202301,507,326,181,424454.16,236966.3,661420.46
291700,202301,1077,831,246,1081982.97,321597.19,1403580.16
291710,202301,1647,796,851,1036411.81,1108007.7,2144419.51
291720,202301,461,314,147,410130.62,191394.9,601525.52
291730,202301,972,562,410,731740.46,533823.75,1265564.21
291733,202301,322,221,101,287743.42,131502.19,419245.61
291735,202301,90,68,22,88536.2,28644,117180.2
291740,202301,349,263,86,342427.95,111972,454399.95
291750,202301,2515,1585,930,2063750.9,1210886.42,3274637.32
291760,202301,3192,1770,1422,2304552.08,1851445.36,4155997.44
291770,202301,774,516,258,671859.5,335925.34,1007784.84
291780,202301,102,64,38,83328.3,49476.8,132805.1
291790,202301,163,87,76,113274,98953.47,212227.47
291800,202301,10951,4758,6193,6196381.99,8067271.73,14263653.72
291810,202301,1085,809,276,1053337.73,359355.66,1412693.39
291820,202301,297,212,85,276025.17,110670,386695.17
291830,202301,1039,437,602,568990.74,785111.74,1354102.48
291835,202301,579,537,42,699183.96,54684.36,753868.32
291840,202301,5638,2845,2793,3704361.32,3639157,7343518.32
291845,202301,293,98,195,127596,253890,381486
291850,202301,313,274,39,356758.75,50779.12,407537.87
291855,202301,269,113,156,147126.41,203112.78,350239.19
291860,202301,156,102,54,132804.52,70309.48,203114.00
291870,202301,80,36,44,46872,57288,104160
291875,202301,168,155,13,201814.6,16926.84,218741.44
291880,202301,446,368,78,479146.47,101559.87,580706.34
291890,202301,259,93,166,121086.3,216132.6,337218.9
291900,202301,60,36,24,46872,31248,78120
291905,202301,128,98,30,127597.11,39060.22,166657.33
291910,202301,156,124,32,161448.26,41664.1,203112.36
291915,202301,456,396,60,515607.57,78121.07,593728.64
291920,202301,6366,3050,3316,3975182.72,4318822.35,8294005.07
291930,202301,171,104,67,135410.69,87234.25,222644.94
291940,202301,413,244,169,317690.03,220038,537728.03
291950,202301,1236,964,272,1256438.1,354145.48,1610583.58
291955,202301,1523,913,610,1188754.11,794225.52,1982979.63
291960,202301,204,151,53,196603.08,69006,265609.08
291970,202301,787,577,210,751274.56,273421.47,1024696.03
291980,202301,1448,1255,193,1634035.15,252591.71,1886626.86
291990,202301,146,135,11,175771.56,14322,190093.56
291992,202301,209,101,108,131508.2,140620.2,272128.4
291995,202301,190,121,69,157543.56,89838.2,247381.76
292000,202301,439,316,123,411439.29,160146.24,571585.53
292010,202301,364,245,119,318991.11,156240.6,475231.71
292020,202301,309,228,81,296857.25,105462,402319.25
292030,202301,164,125,39,162752.5,50778,213530.5
292040,202301,611,330,281,429660,367164,796824
292045,202301,126,110,16,143220,20832.43,164052.43
292050,202301,974,703,271,915314.44,352844.28,1268158.72
292060,202301,963,785,178,1022100.7,231760.57,1253861.27
292070,202301,69,27,42,35154.2,54684,89838.2
292080,202301,171,119,52,154938.41,67704,222642.41
292090,202301,581,213,368,277327.32,479136.95,756464.27
292100,202301,1682,730,952,950502.05,1239531.99,2190034.04
292105,202301,181,163,18,212226.8,23436,235662.8
292110,202301,2384,896,1488,1167912.53,1937382.88,3105295.41
292120,202301,731,557,174,725240.23,226549.29,951789.52
292130,202301,501,274,227,356753.08,295554.2,652307.28
292140,202301,216,176,40,229157.75,52081.94,281239.69
292145,202301,172,95,77,123690,100254,223944
292150,202301,1555,1294,261,1684809.82,339824.19,2024634.01
292160,202301,180,141,39,183582,50778.24,234360.24
292170,202301,1203,1019,184,1328082.56,239571.37,1567653.93
292180,202301,248,174,74,226548,96348.64,322896.64
292190,202301,157,100,57,130200,74214.96,204414.96
292200,202301,1484,549,935,714810.66,1217376.28,1932186.94
292205,202301,120,99,21,128898.46,27342,156240.46
292210,202301,407,270,137,351546.39,179676.2,531222.59
292220,202301,32,22,10,28644.11,13020,41664.11
292225,202301,59,47,12,61196.25,15624.6,76820.85
292230,202301,1043,801,242,1042928.48,315085.39,1358013.87
292240,202301,662,480,182,624975.45,236964.5,861939.95
292250,202301,1691,1083,608,1410108.17,794225.83,2204334.00
292260,202301,433,255,178,332013.51,231757.63,563771.14
292265,202301,256,191,65,248687.07,84630.76,333317.83
292270,202301,741,373,368,485651.41,479136,964787.41
292273,202301,220,128,92,166656.2,119784.6,286440.8
292275,202301,187,96,91,124992,118482,243474
292280,202301,160,108,52,140616,67704,208320
292285,202301,98,76,22,98952,28644,127596
292290,202301,658,442,216,576794.22,281233.37,858027.59
292300,202301,1966,776,1190,1011669.71,1550699.45,2562369.16
292303,202301,141,98,43,127597.61,57288.44,184886.05
292305,202301,122,88,34,114576.69,44268,158844.69
292310,202301,1025,678,347,882775.62,451798.26,1334573.88
292320,202301,615,459,156,597623.34,203113.62,800736.96
292330,202301,174,110,64,143220.59,83328,226548.59
292335,202301,323,256,67,333314.66,87234,420548.66
292340,202301,568,394,174,512991.26,227850.86,740842.12
292350,202301,291,151,140,196604.4,182280,378884.4
292360,202301,763,568,195,739541.29,253891.51,993432.80
292370,202301,736,562,174,731732.37,226548.5,958280.87
292380,202301,631,521,110,678352.2,143220.49,821572.69
292390,202301,401,161,240,209623.93,312481.97,522105.90
292400,202301,3954,2397,1557,3120984.6,2027225.8,5148210.4
292405,202301,280,185,95,240870.8,123690,364560.8
292410,202301,112,70,42,91140,54684,145824
292420,202301,279,241,38,313782.84,49476,363258.84
292430,202301,548,394,154,512990.72,200509.31,713500.03
292440,202301,663,551,112,717412.98,145825.31,863238.29
292450,202301,241,182,59,236966.57,76818.8,313785.37
292460,202301,528,402,126,523409.23,164052.25,687461.48
292465,202301,211,180,31,234360.59,40362.1,274722.69
292467,202301,183,121,62,157542.27,80724,238266.27
292470,202301,323,219,104,285139.17,135408,420547.17
292480,202301,420,282,138,367175.06,179678.78,546853.84
292490,202301,249,186,63,242173.75,82027.76,324201.51
292500,202301,979,477,502,621072.83,653612.67,1274685.50
292510,202301,3780,1845,1935,2403527.52,2520684.77,4924212.29
292520,202301,1241,592,649,770801.63,846310.6,1617112.23
292525,202301,468,344,124,447898.33,161451.42,609349.75
292530,202301,5260,2154,3106,2804568.91,4045350.41,6849919.32
292540,202301,495,286,209,372373.81,272118.9,644492.71
292550,202301,1176,654,522,851523.3,679648.75,1531172.05
292560,202301,342,309,33,402328.93,42966.16,445295.09
292570,202301,348,270,78,351541,101556,453097
292575,202301,592,427,165,557278.95,214832.96,772111.91
292580,202301,1073,721,352,938747.55,458306.8,1397054.35
292590,202301,584,517,67,673141.25,87234.8,760376.05
292593,202301,148,118,30,153636.58,39060,192696.58
292595,202301,218,173,45,225248.06,58590,283838.06
292600,202301,1334,948,386,1234334.27,502580.52,1736914.79
292610,202301,118,97,21,126299.79,27343.34,153643.13
292620,202301,538,448,90,583323.62,117181.13,700504.75
292630,202301,1637,896,741,1166614.41,964787.07,2131401.48
292640,202301,913,629,284,818969.78,369772.1,1188741.88
292650,202301,190,144,46,187496.98,59892,247388.98
292660,202301,2053,1452,601,1890554.67,783818.17,2674372.84
292665,202301,139,97,42,126294.4,54684,180978.4
292670,202301,399,304,95,395810.18,123690.47,519500.65
292680,202301,263,198,65,257796.96,84630,342426.96
292690,202301,212,146,66,190093.97,85932,276025.97
292700,202301,1056,687,369,894493.57,480445.94,1374939.51
292710,202301,118,101,17,131502,22134.31,153636.31
292720,202301,1055,606,449,789020.98,585900.78,1374921.76
292730,202301,219,102,117,132805.86,152334.4,285140.26
292740,202301,80754,38457,42297,50090003.63,55099063.15,105189066.78
292750,202301,409,297,112,386700.82,145827.18,532528.00
292760,202301,344,290,54,377584.3,70308.7,447893.0
292770,202301,919,385,534,501278.17,695275.27,1196553.44
292780,202301,38,15,23,19530.27,29946.59,49476.86
292790,202301,809,432,377,562467.49,490854.2,1053321.69
292800,202301,1327,792,535,1031198.59,696576.17,1727774.76
292805,202301,411,153,258,199207.15,337219.07,536426.22
292810,202301,1896,1123,773,1463472.14,1006449.58,2469921.72
292820,202301,709,601,108,782527.77,140618.52,923146.29
292830,202301,143,110,33,143223.47,42967.41,186190.88
292840,202301,729,587,142,765595.8,186187.63,951783.43
292850,202301,147,102,45,132806.45,58591.54,191397.99
292860,202301,2215,1263,952,1644483.45,1240824.5,2885307.95
292870,202301,3885,2524,1361,3286319.62,1773334.69,5059654.31
292880,202301,1499,989,510,1287698.87,664026.29,1951725.16
292890,202301,566,470,96,611949.63,124994.98,736944.61
292895,202301,145,101,44,131502.2,57288,188790.2
292900,202301,339,242,97,316397.34,126296.9,442694.24
292905,202301,518,253,265,329412.52,345032.49,674445.01
292910,202301,542,405,137,527317.09,178374.47,705691.56
292920,202301,597,266,331,347641.46,430967.82,778609.28
292925,202301,487,446,41,580694.33,53383.22,634077.55
292930,202301,755,456,299,593721.24,389301,983022.24
292935,202301,283,123,160,160146.05,208321.1,368467.15
292937,202301,217,149,68,194000.5,89838,283838.5
292940,202301,198,152,46,197904.51,59892,257796.51
292950,202301,1415,674,741,878878.54,966095.86,1844974.40
292960,202301,521,371,150,483058.66,195302.25,678360.91
292970,202301,257,188,69,244779.01,89840.33,334619.34
292975,202301,94,50,44,65103.98,57290.18,122394.16
292980,202301,356,248,108,322899.5,140617.88,463517.38
292990,202301,1368,1024,344,1333257.88,449191.32,1782449.20
293000,202301,121,85,36,110670.99,46872.1,157543.09
293010,202301,3184,1877,1307,2443977.3,1703045.51,4147022.81
293015,202301,641,528,113,687465.62,147126,834591.62
293020,202301,355,278,77,361967.52,100255.55,462223.07
293030,202301,588,522,66,679651.92,85932,765583.92
293040,202301,396,314,82,408830.01,106764,515594.01
293050,202301,3196,1873,1323,2438700.96,1725170.29,4163871.25
293060,202301,241,191,50,248691.55,65100.5,313792.05
293070,202301,4007,2013,1994,2621011.86,2598824.57,5219836.43
293075,202301,100,71,29,92442.98,37758,130200.98
293076,202301,82,61,21,79424.2,27342,106766.2
293077,202301,621,353,268,459622.14,348941.64,808563.78
293080,202301,440,390,50,507785.9,65100.66,572886.56
293090,202301,138,122,16,158844,20832,179676
293100,202301,548,371,177,483049.1,230454.47,713503.57
293105,202301,358,261,97,339823.18,126294,466117.18
293110,202301,130,85,45,110675.32,58594.15,169269.47
293120,202301,306,216,90,281240.02,117182.98,398423.00
293130,202301,258,175,83,227857.08,108066,335923.08
293135,202301,8802,3559,5243,4635222.54,6830318.25,11465540.79
293140,202301,203,123,80,160148.22,104160.39,264308.61
293150,202301,326,282,44,367173.81,57288.4,424462.21
293160,202301,433,271,162,352844.75,210924.47,563769.22
293170,202301,261,162,99,210929.9,128899.39,339829.29
293180,202301,623,421,202,548144.6,263004,811148.6
293190,202301,1443,996,447,1296828.32,583305.87,1880134.19
293200,202301,601,527,74,686164.55,96348,782512.55
293210,202301,430,326,104,424459.14,135408,559867.14
293220,202301,2431,1083,1348,1410084.18,1759010.29,3169094.47
293230,202301,1861,691,1170,899700.5,1523343.24,2423043.74
293240,202301,241,215,26,279935.94,33852.99,313788.93
293245,202301,131,108,23,140618.5,29946,170564.5
293250,202301,846,359,487,467431.95,635388.86,1102820.81
293260,202301,332,262,70,341126.8,91140,432266.8
293270,202301,1234,553,681,721312.26,886662.1,1607974.36
293280,202301,321,216,105,281233.48,136710.93,417944.41
293290,202301,3166,2027,1139,2639206.6,1484291.24,4123497.84
293300,202301,916,635,281,826779.28,365862.74,1192642.02
293305,202301,199,152,47,197904.2,61194.65,259098.85
293310,202301,176,132,44,171865.9,57288.2,229154.1
293315,202301,174,132,42,171866.94,54685.19,226552.13
293317,202301,95,69,26,89838.4,33852,123690.4
293320,202301,1277,661,616,860673.8,802051.68,1662725.48
293325,202301,217,89,128,115878,166656,282534
293330,202301,15463,7125,8338,9283482.5,10861383.94,20144866.44
293340,202301,298,208,90,270816,117180,387996
293345,202301,264,219,45,285142.29,58590,343732.29
293350,202301,606,381,225,496076.11,292951.29,789027.40
293360,202301,1545,1085,460,1412696.25,598927.2,2011623.45
310010,202301,146,76,70,98952.77,93744,192696.77
310020,202301,1012,552,460,718715.73,600227.8,1318943.53
310030,202301,316,253,63,329411.16,82028.32,411439.48
310040,202301,47,33,14,42966,18228,61194
310050,202301,166,105,61,136710.21,79422,216132.21
310060,202301,280,198,82,257802.99,106764.81,364567.80
310070,202301,19,11,8,14322.47,10416.2,24738.67
310080,202301,53,36,17,46872,22134.83,69006.83
310090,202301,1147,643,504,837203.78,656216.17,1493419.95
310100,202301,386,269,117,350245.61,152336.2,502581.81
310110,202301,722,387,335,503878.52,437475.32,941353.84
310120,202301,391,226,165,294252.86,216133.23,510386.09
310130,202301,34,18,16,23436.2,20832,44268.2
310140,202301,27,11,16,15624,20833.2,36457.2
310150,202301,1236,814,422,1061158.7,550755.87,1611914.57
310160,202301,2222,1106,1116,1440043.52,1455644.49,2895688.01
310163,202301,107,61,46,79422,59892,139314
310170,202301,2708,1286,1422,1674406.15,1852759.66,3527165.81
310180,202301,199,93,106,121087.44,138012,259099.44
310190,202301,504,338,166,440079.82,216134.56,656214.38
310200,202301,442,280,162,364564.64,210924.2,575488.84
310205,202301,80,55,25,71610,32550,104160
310210,202301,278,228,50,296857.49,65100,361957.49
310220,202301,61,38,23,49476.82,29946,79422.82
310230,202301,290,207,83,269516.2,108066,377582.2
310240,202301,128,103,25,134106,32550,166656
310250,202301,94,77,17,100256.11,22134,122390.11
310260,202301,794,427,367,555971.53,477838.91,1033810.44
310270,202301,287,180,107,234363.52,139314.14,373677.66
310280,202301,408,290,118,377583.8,154938.44,532522.24
310285,202301,208,159,49,207019.97,63798.03,270818.00
310290,202301,240,130,110,169261.2,143220,312481.2
310300,202301,182,146,36,190092.63,46872,236964.63
310310,202301,13,11,2,14322,2604,16926
310320,202301,33,11,22,14322.18,28644,42966.18
310330,202301,46,33,13,42966.19,16926.66,59892.85
310340,202301,1949,1392,557,1813715.36,725217.12,2538932.48
310350,202301,2898,1500,1398,1955668.19,1821508.98,3777177.17
310360,202301,51,39,12,50778.88,15624.12,66403.00
310370,202301,136,113,23,147126,29946,177072
310375,202301,112,44,68,57289.25,88537.41,145826.66
310380,202301,54,34,20,44268,26040,70308
310390,202301,109,64,45,83328.55,58590,141918.55
310400,202301,2674,1760,914,2291610.43,1193941.79,3485552.22
310410,202301,117,68,49,88538.09,63798,152336.09
310420,202301,712,367,345,479144.77,449196.54,928341.31
310430,202301,295,191,104,248683.96,135408,384091.96
310440,202301,78,49,29,63798,37758,101556
310445,202301,82,69,13,89839.29,16926,106765.29
310450,202301,690,456,234,593727.35,304669.64,898396.99
310460,202301,260,176,84,229154.28,109368.05,338522.33
310470,202301,555,359,196,467425.37,255194.52,722619.89
310480,202301,100,64,36,83328,46872,130200
310490,202301,592,285,307,371074.72,401017.97,772092.69
310500,202301,132,55,77,71611.98,100254.8,171866.78
310510,202301,633,448,185,584610.06,240870.89,825480.95
310520,202301,150,105,45,136711.35,58590,195301.35
310530,202301,123,54,69,70308.73,89838,160146.73
310540,202301,508,286,222,372380.91,289045.88,661426.79
310550,202301,76,50,26,65102.36,33852,98954.36
310560,202301,3347,2280,1067,2968632.53,1389238,4357870.53
310570,202301,112,71,41,93744.6,53382,147126.6
310590,202301,410,241,169,313788.39,220038.62,533827.01
310600,202301,141,67,74,87234.89,96348,183582.89
310610,202301,46,17,29,22134.91,37758,59892.91
310620,202301,53032,25117,27915,32726513.02,36376801.89,69103314.91
310630,202301,798,477,321,621065.77,419245.29,1040311.06
310640,202301,156,106,50,138012.2,65100.2,203112.4
310650,202301,174,155,19,201810.7,24738,226548.7
310660,202301,116,78,38,101556.2,49476,151032.2
310665,202301,72,49,23,63798,29946,93744
310670,202301,7778,3373,4405,4396992.53,5743153.44,10140145.97
310680,202301,66,42,24,54684,31248,85932
310690,202301,627,444,183,578098.62,238268.58,816367.20
310700,202301,62,37,25,48174.2,32550.97,80725.17
310710,202301,1337,902,435,1174794.19,567678.18,1742472.37
310720,202301,162,46,116,59892,151032,210924
310730,202301,1627,1099,528,1430946.42,687473.73,2118420.15
310740,202301,1053,575,478,748671.49,623663.37,1372334.86
310750,202301,257,161,96,209624.48,124992.37,334616.85
310760,202301,71,55,16,71612.46,20832,92444.46
310770,202301,87,42,45,54684.1,58590,113274.1
310780,202301,372,300,72,390604.69,93744.6,484349.29
310790,202301,118,94,24,122388.4,31248.59,153636.99
310800,202301,498,234,264,304670.96,343728,648398.96
310810,202301,184,121,63,157542.37,82026.59,239568.96
310820,202301,319,255,64,332017.96,83328.04,415346.00
310825,202301,217,179,38,234362.39,49476,283838.39
310830,202301,477,217,260,282535.33,339823.82,622359.15
310840,202301,375,230,145,299462.76,188790.91,488253.67
310850,202301,77,61,16,79422.95,20832,100254.95
310855,202301,444,350,94,455709.49,122388,578097.49
310860,202301,1685,1244,441,1621033.47,574190.77,2195224.24
310870,202301,61,52,9,67705.64,11718,79423.64
310880,202301,93,74,19,96348,24738,121086
310890,202301,298,174,124,226549.33,161448,387997.33
310900,202301,644,299,345,389301.88,450497.04,839798.92
310910,202301,250,166,84,216134,109368,325502
310920,202301,443,256,187,333324.27,243479.93,576804.20
310925,202301,36,28,8,36456.2,10416,46872.2
310930,202301,1413,948,465,1236917.11,605434.46,1842351.57
310940,202301,721,351,370,457012.64,484349.78,941362.42
310945,202301,146,94,52,122388.1,67704,190092.1
310950,202301,218,171,47,222644.3,61194,283838.3
310960,202301,76,27,49,35156.08,63798.03,98954.11
310970,202301,182,106,76,138012.22,98952.6,236964.82
310980,202301,55,37,18,48177.8,23436,71613.8
310990,202301,166,86,80,111972.11,104161.11,216133.22
311000,202301,901,456,445,595025.48,579396.6,1174422.08
311010,202301,52,40,12,52081.44,15624,67705.44
311020,202301,40,26,14,33852.1,18228,52080.1
311030,202301,411,233,178,303367.19,233058.78,536425.97
311040,202301,40,31,9,40362,11718,52080
311050,202301,531,201,330,263006.35,429660.76,692667.11
311060,202301,858,468,390,609344.47,509084.01,1118428.48
311070,202301,347,156,191,203113.28,248682,451795.28
311080,202301,125,71,54,92443.86,70309.61,162753.47
311090,202301,349,171,178,222647.45,231757.53,454404.98
311100,202301,586,357,229,464817.61,298158.25,762975.86
311110,202301,725,516,209,671847.71,272121.21,943968.92
311115,202301,82,56,26,72912.82,33852,106764.82
311120,202301,1157,638,519,830701.85,675742.65,1506444.50
311130,202301,295,170,125,221344.42,164052,385396.42
311140,202301,176,98,78,127599.04,101557.87,229156.91
311150,202301,342,217,125,282538.09,162750.1,445288.19
311160,202301,795,564,231,734339.59,300764.05,1035103.64
311170,202301,95,78,17,101556.06,22134,123690.06
311180,202301,326,220,106,286449.76,138012.68,424462.44
311190,202301,37,18,19,23436,24738,48174
311200,202301,351,236,115,307273.86,149730.9,457004.76
311205,202301,36,28,8,36456,10416,46872
311210,202301,39,35,4,45570.6,5208,50778.6
311220,202301,30,26,4,33852,5208,39060
311230,202301,1738,1155,583,1503853.21,759072.83,2262926.04
311240,202301,82,53,29,69008.2,37758.85,106767.05
311250,202301,65,26,39,33852,50778,84630
311260,202301,555,341,214,443987.51,278628.14,722615.65
311265,202301,138,90,48,117180.1,62496,179676.1
311270,202301,295,198,97,257799.06,126296.92,384095.98
311280,202301,209,92,117,119784.86,152334,272118.86
311290,202301,109,93,16,121086.45,20832.2,141918.65
311300,202301,614,393,221,512995.06,287743.12,800738.18
311310,202301,18,15,3,19530,3906,23436
311320,202301,668,500,168,651008.52,218737.03,869745.55
311330,202301,1258,921,337,1199160.96,438780.09,1637941.05
311340,202301,2790,1962,828,2555876.36,1079362.63,3635238.99
311350,202301,272,207,65,269516.9,84630,354146.9
311360,202301,171,104,67,135411.4,87234,222645.4
311370,202301,1283,546,737,712222,959584.09,1671806.09
311380,202301,7,6,1,7812,1302,9114
311390,202301,248,145,103,188791.39,134106.2,322897.59
311400,202301,141,89,52,115878.2,67704,183582.2
311410,202301,124,59,65,76818.68,84630,161448.68
311420,202301,331,168,163,218741.66,212228.49,430970.15
311430,202301,874,575,299,749960.02,389299,1139259.02
311440,202301,472,320,152,416652.64,197906.34,614558.98
311450,202301,314,184,130,239569.8,169260.92,408830.72
311455,202301,281,191,90,248688.56,117182.08,365870.64
311460,202301,134,60,74,78120.26,97650.65,175770.91
311470,202301,32,14,18,18228,23436,41664
311480,202301,56,31,25,40362,32550,72912
311490,202301,11,6,5,7812,6510,14322
311500,202301,31,15,16,19530.27,20832,40362.27
311510,202301,826,561,265,730438.31,345031.65,1075469.96
311520,202301,42,35,7,45570,9114,54684
311530,202301,1909,1371,538,1785097.96,700480.09,2485578.05
311535,202301,66,43,23,55986.98,29946.52,85933.50
311540,202301,37,33,4,42966.2,5208,48174.2
311545,202301,175,126,49,164053.43,63798,227851.43
311547,202301,61,46,15,59892.2,19530.2,79422.4
311550,202301,712,325,387,423158.93,503875.37,927034.30
311560,202301,45,28,17,36456.83,22134,58590.83
311570,202301,297,197,100,256496.23,130202.15,386698.38
311580,202301,442,282,160,367166.74,208320.39,575487.13
311590,202301,28,24,4,31248.83,5208,36456.83
311600,202301,97,78,19,101558.17,24739.67,126297.84
311610,202301,263,226,37,294253.1,48174.73,342427.83
311615,202301,171,144,27,187488.49,35154.52,222643.01
311620,202301,33,23,10,29946.2,13020,42966.2
311630,202301,110,94,16,122388,20832,143220
311640,202301,130,62,68,80725.86,88539.44,169265.30
311650,202301,132,91,41,118482,54684.2,173166.2
311660,202301,456,208,248,270816.33,322897.27,593713.60
311670,202301,160,108,52,140431.38,67704.43,208135.81
311680,202301,227,172,55,223946.53,71610.56,295557.09
311690,202301,13,13,0,16926.5,,16926.5
311700,202301,203,152,51,197907.11,66403.32,264310.43
311710,202301,183,123,60,160147.03,78120,238267.03
311720,202301,43,32,11,41665.2,14322,55987.2
311730,202301,600,423,177,550761.19,230454.75,781215.94
311740,202301,30,21,9,27342.2,11718,39060.2
311750,202301,755,516,239,674441.47,311178.68,985620.15
311760,202301,84,37,47,48175.24,61194.2,109369.44
311770,202301,381,187,194,244779.38,253890,498669.38
311780,202301,213,109,104,141919.09,135408.2,277327.29
311783,202301,94,84,10,109369.27,13020,122389.27
311787,202301,48,19,29,24738,37758.71,62496.71
311790,202301,278,121,157,157544.28,204416.42,361960.70
311800,202301,785,479,306,623668.68,399717.02,1023385.70
311810,202301,55,40,15,52080.7,19530,71610.7
311820,202301,132,101,31,131504.33,40363.53,171867.86
311830,202301,2063,1213,850,1579359.32,1109305.4,2688664.72
311840,202301,1153,655,498,852819.49,648399.89,1501219.38
311850,202301,18,12,6,15624,7812.2,23436.2
311860,202301,10957,4687,6270,6106550.87,8172727.6,14279278.47
311870,202301,116,66,50,85935.14,65100.31,151035.45
311880,202301,998,715,283,930954.55,369778.22,1300732.77
311890,202301,205,95,110,123584.73,143221.21,266805.94
311900,202301,74,30,44,39060,57288.15,96348.15
311910,202301,1475,923,552,1201767.11,718708.42,1920475.53
311920,202301,247,160,87,208322.27,113274.2,321596.47
311930,202301,952,533,419,693975.19,545541.9,1239517.09
311940,202301,2829,1551,1278,2019451.98,1666562.74,3686014.72
311950,202301,167,98,69,127598.84,89839.55,217438.39
311960,202301,68,48,20,62496.62,26040,88536.62
311970,202301,25,14,11,18228,14322,32550
311980,202301,39,30,9,39060,11718,50778
311990,202301,39,27,12,35154.08,15624.64,50778.72
311995,202301,55,32,23,41664,29946.42,71610.42
312000,202301,24,18,6,23436,7812,31248
312010,202301,75,58,17,75516.65,22134.1,97650.75
312015,202301,86,63,23,82026.69,29946,111972.69
312020,202301,138,99,39,128898.25,50778,179676.25
312030,202301,77,57,20,74214,26040,100254
312040,202301,89,52,37,67704,48174,115878
312050,202301,204,117,87,152334.4,113274,265608.4
312060,202301,20,13,7,16926,9114,26040
312070,202301,83,54,29,70308.29,37758.2,108066.49
312080,202301,583,274,309,356749.38,402318.4,759067.78
312083,202301,80,54,26,70308.2,33852,104160.2
312087,202301,105,78,27,101557.26,35154,136711.26
312090,202301,3618,2218,1400,2890535.06,1825421.88,4715956.94
312100,202301,150,108,42,140317.72,54684.63,195002.35
312110,202301,133,81,52,105463.74,67704.07,173167.81
312120,202301,130,94,36,122389.47,46872,169261.47
312125,202301,87,56,31,72912.58,40362.01,113274.59
312130,202301,133,88,45,114577.58,58590,173167.58
312140,202301,150,117,33,152336.06,42966.4,195302.46
312150,202301,38,30,8,39060,10416,49476
312160,202301,1531,1017,514,1324272.76,669233.72,1993506.48
312170,202301,13,10,3,13020,3906,16926
312180,202301,90,66,24,85932,31248,117180
312190,202301,49,42,7,54684.46,9114,63798.46
312200,202301,771,655,116,854130.19,151033.53,1005163.72
312210,202301,130,67,63,87235.11,82026.58,169261.69
312220,202301,150,110,40,143222.13,52080,195302.13
312230,202301,4082,1813,2269,2360595.15,2955551.88,5316147.03
312235,202301,177,119,58,154938,75516.2,230454.2
312240,202301,86,64,22,83330.61,28644,111974.61
312245,202301,237,172,65,223947.24,84630.44,308577.68
312247,202301,88,64,24,83328.37,31248.38,114576.75
312250,202301,182,94,88,122389.92,114576,236965.92
312260,202301,111,72,39,93744,50778,144522
312270,202301,144,84,60,109370.14,78120,187490.14
312280,202301,31,17,14,22134,18228,40362
312290,202301,148,100,48,130201.27,62497.22,192698.49
312300,202301,212,137,75,178376.89,97650.64,276027.53
312310,202301,63,56,7,72912,9114,82026
312320,202301,434,264,170,343729.84,221340,565069.84
312330,202301,103,88,15,114576,19530.86,134106.86
312340,202301,34,18,16,23436,20832,44268
312350,202301,14,8,6,10416.1,7812,18228.1
312352,202301,97,68,29,88536.61,37758,126294.61
312360,202301,606,260,346,338524.48,450492.2,789016.68
312370,202301,393,215,178,282535.16,231757.49,514292.65
312380,202301,144,96,48,124996.23,62497.07,187493.30
312385,202301,171,140,31,182281.82,40362.79,222644.61
312390,202301,303,192,111,249985.75,144522,394507.75
312400,202301,393,296,97,385393.8,126294.67,511688.47
312410,202301,1298,479,819,623676.16,1067657.21,1691333.37
312420,202301,707,537,170,699180.48,221340.45,920520.93
312430,202301,899,647,252,842401.32,328105.35,1170506.67
312440,202301,50,37,13,48174,16926,65100
312450,202301,225,133,92,173166,119784,292950
312460,202301,36,16,20,20832,26040,46872
312470,202301,47,33,14,42966,18228,61194
312480,202301,173,107,66,139317.18,85933.19,225250.37
312490,202301,332,226,106,294258.69,138013.11,432271.80
312500,202301,33,23,10,29947.11,13020,42967.11
312510,202301,709,278,431,361963.54,561170.86,923134.40
312520,202301,28,8,20,10416,26040.2,36456.2
312530,202301,41,29,12,37759.58,15624.1,53383.68
312540,202301,88,76,12,98952.7,15624,114576.7
312550,202301,33,26,7,33852,9114,42966
312560,202301,213,167,46,217437.59,59892,277329.59
312570,202301,497,297,200,386703.1,260402.01,647105.11
312580,202301,90,54,36,70308,46872,117180
312590,202301,222,176,46,229155.06,59892,289047.06
312595,202301,161,131,30,170562.25,39060,209622.25
312600,202301,79,36,43,46872.9,55986,102858.9
312610,202301,1648,851,797,1108023.14,1038997.49,2147020.63
312620,202301,237,174,63,226549.93,82026,308575.93
312630,202301,72,57,15,74214.38,19530,93744.38
312640,202301,44,11,33,14322,42966,57288
312650,202301,161,138,23,180116.08,29946.1,210062.18
312660,202301,114,84,30,109374.59,39060.59,148435.18
312670,202301,965,615,350,800750.66,455704.61,1256455.27
312675,202301,49,38,11,49476,14322,63798
312680,202301,78,51,27,66402,35154,101556
312690,202301,274,140,134,182281.91,174468.45,356750.36
312695,202301,32,25,7,32550,9114,41664
312700,202301,259,152,107,197906.11,140616.64,338522.75
312705,202301,83,67,16,87234.61,20832,108066.61
312707,202301,132,93,39,121086.83,50778,171864.83
312710,202301,1985,1108,877,1443961.29,1141862.18,2585823.47
312720,202301,45,23,22,29946.56,28644.69,58591.25
312730,202301,288,169,119,220043.54,154940.72,374984.26
312733,202301,51,41,10,53382.2,13020,66402.2
312735,202301,21,16,5,20832.71,6510.8,27343.51
312737,202301,82,48,34,62496.06,44268,106764.06
312738,202301,70,44,26,57288.64,33852,91140.64
312740,202301,76,49,27,63799.09,35154,98953.09
312750,202301,115,75,40,97650.6,52080,149730.6
312760,202301,283,193,90,251289.99,117180.41,368470.40
312770,202301,9424,4502,4922,5866952.71,6414974.51,12281927.22
312780,202301,463,352,111,458311.01,144523.92,602834.93
312790,202301,22,14,8,18228,10416.4,28644.4
312800,202301,1730,1194,536,1554604.22,699178.28,2253782.50
312810,202301,357,244,113,317689.19,149730,467419.19
312820,202301,197,152,45,197904.67,58590,256494.67
312825,202301,48,36,12,46874.57,15624,62498.57
312830,202301,194,104,90,135409.08,117180.81,252589.89
312840,202301,199,140,59,182281,76818,259099
312850,202301,37,32,5,41664.9,6510,48174.9
312860,202301,148,99,49,128898.98,63798,192696.98
312870,202301,1235,639,596,831995.88,775992,1607987.88
312880,202301,123,92,31,119788.26,40362,160150.26
312890,202301,178,129,49,167962.74,63798,231760.74
312900,202301,165,124,41,162752.7,53382,216134.7
312910,202301,178,101,77,131508.77,100256.29,231765.06
312920,202301,111,64,47,83328.4,61194,144522.4
312930,202301,342,231,111,302069.07,144523.39,446592.46
312940,202301,153,104,49,135408,63798,199206
312950,202301,770,539,231,701795.45,302066.93,1003862.38
312960,202301,150,107,43,139320.95,55987.44,195308.39
312965,202301,119,95,24,123690.1,31248,154938.1
312970,202301,302,240,62,312487.21,80725.28,393212.49
312980,202301,2807,1455,1352,1895761.46,1762915.03,3658676.49
312990,202301,44,17,27,22134.39,35154,57288.39
313000,202301,56,31,25,40362,32550,72912
313005,202301,186,143,43,186187.09,55986.5,242173.59
313010,202301,1029,445,584,579401.12,761675.69,1341076.81
313020,202301,198,106,92,138012,119784,257796
313030,202301,214,139,75,180978.42,97650,278628.42
313040,202301,93,28,65,36456.72,84630,121086.72
313050,202301,215,155,60,201810.24,78120,279930.24
313055,202301,40,28,12,36456,15624,52080
313060,202301,152,105,47,136711.05,62496,199207.05
313065,202301,57,42,15,54684,19530.6,74214.6
313070,202301,131,69,62,89839.14,80724,170563.14
313080,202301,43,24,19,31248.6,24738,55986.6
313090,202301,703,458,245,596326.13,320292.18,916618.31
313100,202301,222,82,140,106764.45,182280,289044.45
313110,202301,161,89,72,115878.3,93745.55,209623.85
313115,202301,256,134,122,174470.95,158844.86,333315.81
313120,202301,879,502,377,654916.48,490857.34,1145773.82
313130,202301,6396,3556,2840,4632629.91,3700309.17,8332939.08
313140,202301,136,77,59,100255.85,76818.66,177074.51
313150,202301,308,241,67,313785.88,87234,401019.88
313160,202301,190,142,48,184888.81,62496,247384.81
313170,202301,1481,934,547,1216098.99,713497.08,1929596.07
313180,202301,347,220,127,289047.85,165355.84,454403.69
313190,202301,801,461,340,600232.1,442684.6,1042916.7
313200,202301,38,28,10,36456.78,13020.2,49476.98
313210,202301,1050,898,152,1169237.69,199209.14,1368446.83
313220,202301,325,195,130,255192.85,169260,424452.85
313230,202301,300,232,68,302065.69,88536,390601.69
313240,202301,2410,1204,1206,1568941.71,1571514.63,3140456.34
313250,202301,1281,962,319,1252555.22,415342.53,1667897.75
313260,202301,101,48,53,62496.28,69006,131502.28
313270,202301,1092,646,446,842403.74,580698.33,1423102.07
313280,202301,48,37,11,48174,14322,62496
313290,202301,242,192,50,249988.92,65100,315088.92
313300,202301,334,163,171,212229.61,222642.58,434872.19
313310,202301,261,114,147,148429.47,191394.8,339824.27
313320,202301,403,295,108,384094.33,140616.07,524710.40
313330,202301,1513,930,583,1210883.88,760373.81,1971257.69
313340,202301,348,250,98,325505.32,127597.5,453102.82
313350,202301,463,284,179,369770.47,233058.24,602828.71
313360,202301,204,96,108,124992.52,140616,265608.52
313370,202301,241,86,155,113274.34,203112,316386.34
313375,202301,340,212,128,277331.67,166656.3,443987.97
313380,202301,1364,717,647,937467.52,843697.87,1781165.39
313390,202301,57,51,6,66402.6,7812,74214.6
313400,202301,419,289,130,376295.16,169262.44,545557.60
313410,202301,96,62,34,80725.2,44268.81,124994.01
313420,202301,4866,2738,2128,3564986.59,2774577.1,6339563.69
313430,202301,123,60,63,78120.31,82026.33,160146.64
313440,202301,1437,1017,420,1324180.18,548150.03,1872330.21
313450,202301,68,30,38,40362,49476,89838
313460,202301,415,185,230,240874.22,299460.98,540335.20
313470,202301,527,253,274,329415.79,356754.81,686170.60
313480,202301,165,123,42,160147.48,54684,214831.48
313490,202301,576,259,317,337232.75,412743.27,749976.02
313500,202301,31,17,14,22134,18228,40362
313505,202301,1144,877,267,1141882.18,347637.6,1489519.78
313507,202301,110,75,35,97651.83,45570,143221.83
313510,202301,3053,1880,1173,2451858.76,1528566.55,3980425.31
313520,202301,3558,2750,808,3580616.53,1054629.96,4635246.49
313530,202301,41,25,16,32550.6,20832,53382.6
313535,202301,91,74,17,96350.42,22134,118484.42
313540,202301,68,48,20,62496,26040,88536
313545,202301,124,105,19,136711.37,24738,161449.37
313550,202301,219,187,32,243476.77,41665.85,285142.62
313560,202301,369,173,196,226553.21,255196.84,481750.05
313570,202301,81,29,52,37758,67704,105462
313580,202301,1426,837,589,1089789.09,768184.01,1857973.10
313590,202301,70,43,27,55986.59,35154.54,91141.13
313600,202301,706,428,278,558564.92,361957.81,920522.73
313610,202301,58,45,13,58591.41,16926.35,75517.76
313620,202301,1581,768,813,999960.49,1058528.15,2058488.64
313630,202301,1745,1315,430,1712166.6,559862.51,2272029.11
313640,202301,121,73,48,95047.08,63798,158845.08
313650,202301,244,128,116,167958.92,151032.88,318991.80
313652,202301,33,31,2,40362,2604,42966
313655,202301,92,62,30,80725.46,39060.4,119785.86
313657,202301,52,48,4,62497.88,5208,67705.88
313660,202301,144,97,47,126295.26,61194.59,187489.85
313665,202301,749,346,403,450503.26,524714.02,975217.28
313670,202301,11443,7832,3611,10204196.69,4709376.52,14913573.21
313680,202301,45,35,10,45570.73,13020,58590.73
313690,202301,140,100,40,130200.47,52080,182280.47
313695,202301,88,67,21,87235.18,27342,114577.18
313700,202301,359,274,85,356753.07,110670.5,467423.57
313710,202301,131,93,38,121089.3,49476,170565.3
313720,202301,1236,575,661,749972.97,861934.26,1611907.23
313730,202301,76,44,32,57289.75,41664,98953.75
313740,202301,160,119,41,154939.25,53382,208321.25
313750,202301,414,288,126,374979.06,164052.79,539031.85
313753,202301,242,183,59,238269.5,76818.1,315087.6
313760,202301,1451,572,879,746063.95,1144466.97,1890530.92
313770,202301,433,292,141,380194.19,183586.27,563780.46
313780,202301,906,496,410,645798.04,533823.24,1179621.28
313790,202301,38,38,0,49476,,49476.0
313800,202301,172,108,64,140618.38,83329.4,223947.78
313810,202301,96,55,41,71610.21,53382.3,124992.51
313820,202301,1468,710,758,924438.97,989522.01,1913960.98
313830,202301,56,37,19,48174.4,24738,72912.4
313835,202301,69,60,9,78120.2,11718,89838.2
313840,202301,1814,1089,725,1419221.36,945258.5,2364479.86
313850,202301,234,102,132,132806.27,171864,304670.27
313860,202301,506,384,122,501281.15,158844.64,660125.79
313862,202301,180,125,55,162754.76,71610.2,234364.96
313865,202301,192,131,61,170563.34,79422.3,249985.64
313867,202301,66,55,11,71610,14322.1,85932.1
313868,202301,52,32,20,41664,26040,67704
313870,202301,80,43,37,58590.2,48174,106764.2
313880,202301,395,245,150,318992.95,195300.35,514293.30
313890,202301,351,191,160,248686.93,209622,458308.93
313900,202301,871,476,395,621067.83,515598.69,1136666.52
313910,202301,153,105,48,136710.06,62496,199206.06
313920,202301,678,461,217,600225.28,282535.24,882760.52
313925,202301,35,30,5,39060,6510,45570
313930,202301,940,717,223,933558.45,290350.69,1223909.14
313940,202301,2063,1227,836,1597582.88,1088478.76,2686061.64
313950,202301,895,540,355,703092.84,464814.59,1167907.43
313960,202301,1548,885,663,1152286.2,864535.52,2016821.72
313970,202301,194,111,83,144522.1,108066.2,252588.3
313980,202301,253,160,93,208331.47,121087.62,329419.09
313990,202301,278,169,109,221340.01,141918,363258.01
314000,202301,923,603,320,785115.37,416645.64,1201761.01
314010,202301,105,67,38,87234.15,49476,136710.15
314015,202301,98,28,70,36457.35,91140.9,127598.25
314020,202301,56,37,19,49476.86,24738,74214.86
314030,202301,75,38,37,49477.42,49476,98953.42
314040,202301,46,24,22,31248,28644,59892
314050,202301,297,165,132,214835.3,171864,386699.3
314053,202301,99,62,37,80724.7,48174,128898.7
314055,202301,311,197,114,256499.09,148429.64,404928.73
314060,202301,126,105,21,136710.48,27342,164052.48
314070,202301,1135,573,562,746070.08,731734.91,1477804.99
314080,202301,224,137,87,179679.15,113274.64,292953.79
314085,202301,189,132,57,171864.16,74214,246078.16
314090,202301,423,301,122,391908.62,158844,550752.62
314100,202301,543,428,115,557269.98,149733.28,707003.26
314110,202301,806,358,448,466133.84,583300.6,1049434.44
314120,202301,71,43,28,55986,36456,92442
314130,202301,26,19,7,24738,9114,33852
314140,202301,1241,785,456,1022092.21,593715.62,1615807.83
314150,202301,196,126,70,164055.14,91140.66,255195.80
314160,202301,320,239,81,311181.1,105462.56,416643.66
314170,202301,86,64,22,83328.79,28644,111972.79
314180,202301,801,712,89,927050.44,115879.77,1042930.21
314190,202301,87,54,33,70308.6,42966,113274.6
314200,202301,543,374,169,486962.69,221347.03,708309.72
314210,202301,253,194,59,252590.84,76818.6,329409.44
314220,202301,321,229,92,299465.54,119784.93,419250.47
314225,202301,50,32,18,41666.09,23436,65102.09
314230,202301,126,57,69,74215.05,89838,164053.05
314240,202301,180,129,51,167960.11,66402.47,234362.58
314250,202301,61,37,24,48176.02,31248.28,79424.30
314260,202301,220,107,113,139314.94,147126,286440.94
314270,202301,436,342,94,445299.88,122388.7,567688.58
314280,202301,758,411,347,535071.37,451797.17,986868.54
314290,202301,563,438,125,570282.27,162750.72,733032.99
314300,202301,347,257,90,334620.02,117180,451800.02
314310,202301,1371,952,419,1241160.82,549444,1790604.82
314315,202301,47,35,12,45570.2,15624,61194.2
314320,202301,600,414,186,540340.41,242173.78,782514.19
314330,202301,12429,6023,6406,7843496.19,8345872.78,16189368.97
314340,202301,684,308,376,401024.1,489557.43,890581.53
314345,202301,62,46,16,59892,20832,80724
314350,202301,190,116,74,151033.28,96348.66,247381.94
314360,202301,54,28,26,36458.16,33852.64,70310.80
314370,202301,71,50,21,65100,27342,92442
314380,202301,139,75,64,97651.41,83328,180979.41
314390,202301,3676,2378,1298,3098852.99,1690001.48,4788854.47
314400,202301,720,501,219,652312.41,285140.7,937453.11
314410,202301,560,370,190,483050.41,247382.26,730432.67
314420,202301,27,17,10,22134,13020,35154
314430,202301,2558,971,1587,1265573.77,2067605.84,3333179.61
314435,202301,146,88,58,114578.52,75516,190094.52
314437,202301,57,43,14,55986,18228,74214
314440,202301,93,60,33,78120.63,42966.1,121086.73
314450,202301,170,118,52,154938.73,67704.25,222642.98
314460,202301,660,328,332,427063.46,432267.4,859330.86
314465,202301,132,86,46,111973.38,59892,171865.38
314467,202301,75,61,14,79422.04,18228,97650.04
314470,202301,429,215,214,279932.19,278630.25,558562.44
314480,202301,1127,507,620,660125.55,809848.92,1469974.47
314490,202301,35,19,16,24738,20832,45570
314500,202301,284,194,90,252590.27,118482.45,371072.72
314505,202301,124,80,44,104162.19,57288,161450.19
314510,202301,265,215,50,279931.32,65100,345031.32
314520,202301,1518,787,731,1024702.34,951775.25,1976477.59
314530,202301,797,633,164,824196.32,213532.42,1037728.74
314535,202301,180,112,68,145824,89838,235662
314537,202301,71,42,29,54684.13,37758.98,92443.11
314540,202301,20,12,8,15624,10416,26040
314545,202301,67,44,23,57288,29946,87234
314550,202301,79,43,36,55987.65,46873.72,102861.37
314560,202301,910,485,425,631481.24,554656.66,1186137.90
314570,202301,16,14,2,18229.09,2604,20833.09
314580,202301,12,6,6,7812,7812,15624
314585,202301,33,24,9,31248,11718.66,42966.66
314587,202301,83,72,11,93744,14322,108066
314590,202301,625,426,199,554662.25,259100.45,813762.70
314600,202301,1017,663,354,863250.56,462219.69,1325470.25
314610,202301,1028,522,506,680951.22,660117.11,1341068.33
314620,202301,155,116,39,151032.83,50778,201810.83
314625,202301,99,76,23,98952.78,29946,128898.78
314630,202301,1171,652,519,848927.15,675744.63,1524671.78
314640,202301,93,58,35,75517.2,45570.6,121087.8
314650,202301,161,93,68,121087.21,88537.53,209624.74
314655,202301,65,48,17,62496.2,22134,84630.2
314660,202301,20,15,5,19530,6510,26040
314670,202301,233,183,50,238277.65,65102.67,303380.32
314675,202301,219,131,88,170563.84,114576.23,285140.07
314690,202301,588,313,275,407530.11,358052.56,765582.67
314700,202301,2261,1202,1059,1566356.65,1378824.32,2945180.97
314710,202301,1939,1079,860,1404876.15,1119721.14,2524597.29
314720,202301,417,229,188,298160.08,244777.82,542937.90
314730,202301,536,292,244,380188.05,317689.65,697877.70
314740,202301,842,375,467,488255.98,608037.06,1096293.04
314750,202301,27,20,7,26040,9114,35154
314760,202301,375,151,224,196603.28,291648.88,488252.16
314770,202301,107,68,39,88536.19,50778,139314.19
314780,202301,18,7,11,9114,14322,23436
314790,202301,2676,1708,968,2226475.02,1261638.57,3488113.59
314795,202301,73,63,10,82026,13020,95046
314800,202301,3099,1816,1283,2365774.41,1671772.36,4037546.77
314810,202301,1558,885,673,1153591.55,877550.26,2031141.81
314820,202301,121,71,50,92442.69,65100.1,157542.79
314830,202301,228,190,38,247385.66,49476,296861.66
314840,202301,88,52,36,67704,46872,114576
314850,202301,462,220,242,287875.32,315084,602959.32
314860,202301,660,498,162,648402.19,210924.08,859326.27
314870,202301,1715,918,797,1196562.62,1039010.91,2235573.53
314875,202301,69,62,7,80724,9114,89838
314880,202301,41,29,12,37758,15624,53382
314890,202301,58,32,26,41664,33852,75516
314900,202301,28,21,7,27342.72,9114.92,36457.64
314910,202301,243,161,82,209623.7,106764,316387.7
314915,202301,145,125,20,162752.25,26040.18,188792.43
314920,202301,80,53,27,69006.85,35154,104160.85
314930,202301,1075,491,584,639297,760370.24,1399667.24
314940,202301,37,28,9,36456,11718.1,48174.1
314950,202301,22,19,3,24738.27,3906,28644.27
314960,202301,28,20,8,26040,10416.19,36456.19
314970,202301,180,82,98,106765.47,127597.35,234362.82
314980,202301,321,204,117,265612.21,152334.75,417946.96
314990,202301,475,255,220,332014.91,286441.58,618456.49
314995,202301,155,67,88,87234.6,114576,201810.6
315000,202301,98,76,22,98952.49,28644.1,127596.59
315010,202301,32,19,13,24738,16926,41664
315015,202301,166,131,35,170562.4,45570,216132.4
315020,202301,69,59,10,76818,13020,89838
315030,202301,111,84,27,109368,35154,144522
315040,202301,92,55,37,71610,48174,119784
315050,202301,215,131,84,170562.37,109368.68,279931.05
315053,202301,69,49,20,63798.8,26040,89838.8
315057,202301,129,99,30,128898.05,39060,167958.05
315060,202301,65,53,12,69007.56,15624,84631.56
315070,202301,119,72,47,93745.21,61194,154939.21
315080,202301,404,320,84,416644.28,110671.47,527315.75
315090,202301,103,60,43,79422.89,55986,135408.89
315100,202301,96,46,50,59892.37,65100.38,124992.75
315110,202301,291,146,145,190094.38,188790,378884.38
315120,202301,1943,924,1019,1203088.46,1326769.82,2529858.28
315130,202301,369,263,106,342429.7,138012.88,480442.58
315140,202301,574,310,264,403625.39,343733.06,747358.45
315150,202301,1020,492,528,640601.05,690066.31,1330667.36
315160,202301,198,107,91,139320.88,118485.25,257806.13
315170,202301,305,200,105,260402.66,136710.8,397113.46
315180,202301,3408,1445,1963,1884037.81,2557139.44,4441177.25
315190,202301,301,186,115,242175.18,149730.75,391905.93
315200,202301,1266,755,511,983028.92,665324.78,1648353.70
315210,202301,1876,1122,754,1460870.28,981709.71,2442579.99
315213,202301,26,15,11,19530.79,14322,33852.79
315217,202301,220,172,48,223945.98,62496,286441.98
315220,202301,1676,1236,440,1609308.46,572889.16,2182197.62
315230,202301,184,141,43,183583.97,55986,239569.97
315240,202301,372,245,127,319000.47,165357.93,484358.40
315250,202301,2856,1359,1497,1769462.38,1949098.6,3718560.98
315260,202301,141,81,60,105462,78120.1,183582.1
315270,202301,152,107,45,139314,58590,197904
315280,202301,626,407,219,529930.68,286451.36,816382.04
315290,202301,202,125,77,162752.02,100254.56,263006.58
315300,202301,100,76,24,98952.8,31248,130200.8
315310,202301,84,76,8,98952,10416,109368
315320,202301,143,92,51,119787.73,66402,186189.73
315330,202301,64,50,14,65100,18228,83328
315340,202301,392,283,109,368469.91,141919.56,510389.47
315350,202301,168,106,62,138012.88,80724.34,218737.22
315360,202301,105,50,55,65100.15,71610,136710.15
315370,202301,56,36,20,46874.14,26040,72914.14
315380,202301,6,5,1,6510,1302,7812
315390,202301,74,30,44,39060.87,57289.88,96350.75
315400,202301,854,644,210,838505.25,273420.77,1111926.02
315410,202301,323,194,129,252599.95,167963.47,420563.42
315415,202301,58,44,14,57288.27,18228,75516.27
315420,202301,211,150,61,195302.49,79422,274724.49
315430,202301,652,364,288,473931.28,374977.17,848908.45
315440,202301,97,65,32,84630,41664,126294
315445,202301,234,194,40,252595.38,52080.37,304675.75
315450,202301,181,131,50,170562,65100,235662
315460,202301,5092,2347,2745,3059810.1,3574032.49,6633842.59
315470,202301,48,20,28,26040.1,36456,62496.1
315480,202301,77,23,54,29946.89,70309.06,100255.95
315490,202301,769,495,274,644497.36,356748.48,1001245.84
315500,202301,19,15,4,19530,5208,24738
315510,202301,156,112,44,145824.38,57288,203112.38
315520,202301,79,67,12,87234.68,15624,102858.68
315530,202301,47,27,20,35154,26040.2,61194.2
315540,202301,277,190,87,247384.4,113275.52,360659.92
315550,202301,197,157,40,204414.41,52080,256494.41
315560,202301,745,583,162,759080.7,210926.94,970007.64
315570,202301,314,155,159,201816.62,207019.62,408836.24
315580,202301,789,535,254,696575.66,330709.4,1027285.06
315590,202301,194,99,95,128899.92,123690.63,252590.55
315600,202301,360,279,81,363262.06,105462.78,468724.84
315610,202301,102,48,54,62496,70308,132804
315620,202301,36,27,9,35155.31,11718,46873.31
315630,202301,134,99,35,128899,45570,174469
315640,202301,63,38,25,49476.98,32550,82026.98
315645,202301,53,35,18,45570,23436,69006
315650,202301,171,127,44,165354.49,57288,222642.49
315660,202301,445,205,240,266920.88,312484.99,579405.87
315670,202301,2547,1150,1397,1499946.14,1820218.37,3320164.51
315680,202301,788,563,225,733034.28,292950.5,1025984.78
315690,202301,712,472,240,614558.09,312483.42,927041.51
315700,202301,2120,1107,1013,1441354.44,1318959.02,2760313.46
315710,202301,380,127,253,165355.31,329406.12,494761.43
315720,202301,541,327,214,425763.96,278628.54,704392.50
315725,202301,212,165,47,214830.87,61194.6,276025.47
315727,202301,84,50,34,65104.03,44268.33,109372.36
315730,202301,56,49,7,63798,9114,72912
315733,202301,90,52,38,67704.2,49476,117180.2
315737,202301,50,38,12,49477.58,15624,65101.58
315740,202301,30,23,7,29946,9114,39060
315750,202301,177,126,51,164052.17,66402.56,230454.73
315760,202301,46,34,12,44268,15624,59892
315765,202301,143,81,62,105464.11,80726.33,186190.44
315770,202301,242,163,79,212228.25,102858.64,315086.89
315780,202301,4197,2072,2125,2697822.26,2769360.53,5467182.79
315790,202301,249,192,57,249989.38,74215.13,324204.51
315800,202301,325,213,112,277328.85,145824,423152.85
315810,202301,63,38,25,49476.97,32550,82026.97
315820,202301,795,591,204,769508.83,265613.12,1035121.95
315830,202301,124,81,43,105462.8,55987.11,161449.91
315840,202301,84,57,27,74214,35154,109368
315850,202301,278,187,91,243479.32,118484.16,361963.48
315860,202301,21,9,12,11718,15624,27342
315870,202301,41,32,9,41664.12,11718,53382.12
315880,202301,102,67,35,87234,45570,132804
315890,202301,107,75,32,97651.24,41664.54,139315.78
315895,202301,415,274,141,356761.97,183583.79,540345.76
315900,202301,88,38,50,49476,65100.08,114576.08
315910,202301,51,32,19,41664,24738,66402
315920,202301,162,111,51,144523.88,66402,210925.88
315930,202301,54,18,36,23437.89,46873.45,70311.34
315935,202301,130,102,28,132808.16,36456,169264.16
315940,202301,104,74,30,96348.82,39060,135408.82
315950,202301,39,30,9,39060,11718.65,50778.65
315960,202301,611,287,324,373680.13,423156.63,796836.76
315970,202301,31,26,5,33852.64,6510,40362.64
315980,202301,699,356,343,463521.71,446588.11,910109.82
315990,202301,267,153,114,199209.03,148428.58,347637.61
316000,202301,54,33,21,42966.8,27342,70308.8
316010,202301,96,81,15,105463.15,19530,124993.15
316020,202301,102,91,11,118482.49,14322,132804.49
316030,202301,389,227,162,295560.26,210925.45,506485.71
316040,202301,577,240,337,312482.96,438774.2,751257.16
316045,202301,53,47,6,61194,7812,69006
316050,202301,25,18,7,23436,9114,32550
316060,202301,108,76,32,98953.07,41664,140617.07
316070,202301,1268,853,415,1110626.77,542939.38,1653566.15
316080,202301,95,65,30,84744.72,39060,123804.72
316090,202301,36,17,19,22134,24738.38,46872.38
316095,202301,86,74,12,96349.78,15624.89,111974.67
316100,202301,358,194,164,252593.94,213528.85,466122.79
316105,202301,54,32,22,41664.96,28644,70308.96
316110,202301,1935,1494,441,1945227.17,574190.97,2519418.14
316120,202301,80,54,26,70308,33852,104160
316130,202301,121,92,29,119786.46,37758,157544.46
316140,202301,34,23,11,29946,14322,44268
316150,202301,232,162,70,210927.11,91140.33,302067.44
316160,202301,87,55,32,71610.76,41664.28,113275.04
316165,202301,80,54,26,70308.45,33852,104160.45
316170,202301,189,121,68,158844.56,88536,247380.56
316180,202301,220,85,135,110672.77,175772.14,286444.91
316190,202301,150,107,43,139314.58,55986,195300.58
316200,202301,699,389,310,506489.71,403621.14,910110.85
316210,202301,787,539,248,702020.19,325502.49,1027522.68
316220,202301,131,84,47,109369.23,61194,170563.23
316225,202301,41,26,15,33853.88,19530.87,53384.75
316230,202301,49,28,21,36456.2,27342,63798.2
316240,202301,690,542,148,705698.1,192699.76,898397.86
316245,202301,175,153,22,199209.36,28644,227853.36
316250,202301,1751,1169,582,1523371.13,759069.64,2282440.77
316255,202301,138,106,32,138012,41664.1,179676.1
316257,202301,183,93,90,121086.87,117181.19,238268.06
316260,202301,203,139,64,180979.04,83328.2,264307.24
316265,202301,38,26,12,33853.4,15624.21,49477.61
316270,202301,709,501,208,652311.12,270818.3,923129.42
316280,202301,589,370,219,481750.25,285140.72,766890.97
316290,202301,895,617,278,803352.02,363262.83,1166614.85
316292,202301,657,271,386,352848.43,502575.18,855423.61
316294,202301,109,68,41,89840.16,54684.5,144524.66
316295,202301,405,194,211,252592.78,274729.09,527321.87
316300,202301,25,18,7,23436,9114,32550
316310,202301,28,16,12,20832,15624,36456
316320,202301,73,33,40,42966.85,52080,95046.85
316330,202301,181,127,54,165355.3,70308.91,235664.21
316340,202301,144,93,51,121086,66402,187488
316350,202301,200,137,63,178375.48,82026.2,260401.68
316360,202301,26,16,10,20832,13020,33852
316370,202301,1345,662,683,861940.06,891874.9,1753814.96
316380,202301,118,89,29,115878.56,37758,153636.56
316390,202301,106,80,26,104160,33852,138012
316400,202301,168,129,39,167959.5,50778.9,218738.4
316410,202301,313,225,88,292950.74,114576.2,407526.94
316420,202301,229,151,78,196608.93,101557.92,298166.85
316430,202301,165,91,74,118482.46,96348,214830.46
316440,202301,76,42,34,54685.02,44268.08,98953.10
316443,202301,49,41,8,53382,10416,63798
316447,202301,45,37,8,48175.85,10416,58591.85
316450,202301,251,185,66,240870.58,85932,326802.58
316460,202301,47,14,33,18228.7,42966.54,61195.24
316470,202301,1844,1345,499,1752528.31,649699.03,2402227.34
316480,202301,9,7,2,9114,2604,11718
316490,202301,20,6,14,7812,18228,26040
316500,202301,168,108,60,140616.77,79422.85,220039.62
316510,202301,140,112,28,145824.64,36456,182280.64
316520,202301,188,102,86,132805.14,111974.1,244779.24
316530,202301,180,113,67,147126.81,87234.83,234361.64
316540,202301,164,86,78,111974.08,102858.73,214832.81
316550,202301,168,104,64,135409.3,83328,218737.3
316553,202301,470,235,235,305975.44,305971.03,611946.47
316555,202301,66,57,9,74215.6,11718,85933.6
316556,202301,17,11,6,14322.41,7812,22134.41
316557,202301,35,29,6,37758.59,7812,45570.59
316560,202301,76,53,23,69006.2,29946,98952.2
316570,202301,222,203,19,264307.09,24738,289045.09
316580,202301,24,16,8,20832,10416,31248
316590,202301,91,76,15,98953.32,19530.37,118483.69
316600,202301,183,153,30,199208.19,39060,238268.19
316610,202301,73,52,21,67705.33,27342,95047.33
316620,202301,150,104,46,135408,59892,195300
316630,202301,60,46,14,59892.6,18228,78120.6
316640,202301,22,14,8,18228,10416,28644
316650,202301,109,87,22,113274,28644,141918
316660,202301,6,2,4,2604,5208,7812
316670,202301,435,148,287,192699.65,373675,566374.65
316680,202301,171,131,40,170563.5,52080.4,222643.9
316690,202301,155,94,61,122388,79422,201810
316695,202301,57,49,8,63798.09,10416,74214.09
316700,202301,28,19,9,24738,11718,36456
316710,202301,847,644,203,838501.07,264308.27,1102809.34
316720,202301,5452,2528,2924,3294143.27,3810962.25,7105105.52
316730,202301,15,14,1,18228,1302,19530
316740,202301,163,101,62,131502,80724,212226
316750,202301,22,13,9,16926.76,11718.9,28645.66
316760,202301,341,272,69,354148.8,89838.49,443987.29
316770,202301,187,97,90,126294.5,117180,243474.5
316780,202301,71,41,30,53382.6,39060,92442.6
316790,202301,69,47,22,61194.67,28644.1,89838.77
316800,202301,1863,1132,731,1475198.83,951781.84,2426980.67
316805,202301,33,22,11,28644.08,14322,42966.08
316810,202301,61,36,25,46872.2,32550.7,79422.9
316820,202301,38,22,16,28644,20832,49476
316830,202301,103,49,54,63798.76,70308.2,134106.96
316840,202301,522,315,207,410133.95,269515.4,679649.35
316850,202301,317,221,96,287744.54,124992.4,412736.94
316860,202301,6657,2998,3659,3906079.12,4766642.07,8672721.19
316870,202301,1806,1169,637,1522103.04,829380.75,2351483.79
316880,202301,166,84,82,109370.71,106766.06,216136.77
316890,202301,236,159,77,207020.23,100254.69,307274.92
316900,202301,436,305,131,398419.55,170562,568981.55
316905,202301,26,11,15,14322,19530,33852
316910,202301,83,34,49,44268,63798,108066
316920,202301,156,119,37,154940.69,48174,203114.69
316930,202301,2087,1068,1019,1391861.86,1326740.75,2718602.61
316935,202301,1007,595,412,774704.15,536432.66,1311136.81
316940,202301,1157,678,479,882771.7,623660.54,1506432.24
316950,202301,202,95,107,124992.98,139314,264306.98
316960,202301,1134,629,505,818985.03,660123.4,1479108.43
316970,202301,677,541,136,704393.46,177075.23,881468.69
316980,202301,87,46,41,59892,53382,113274
316990,202301,2384,1614,770,2101471.14,1002544.14,3104015.28
317000,202301,357,275,82,358058.49,106766.19,464824.68
317005,202301,225,153,72,199211.18,93745.6,292956.78
317010,202301,7207,4115,3092,5359253.03,4027135.63,9386388.66
317020,202301,16439,7168,9271,9339576.38,12086555.83,21426132.21
317030,202301,93,43,50,55986,65100,121086
317040,202301,3250,2127,1123,2770717.51,1466062.61,4236780.12
317043,202301,79,62,17,80732.29,22135.27,102867.56
317047,202301,39,24,15,31248,19530.81,50778.81
317050,202301,162,130,32,169261.69,41664,210925.69
317052,202301,160,131,29,170563.74,37758,208321.74
317057,202301,191,141,50,184886.12,65100,249986.12
317060,202301,66,40,26,52080,33852.8,85932.8
317065,202301,52,39,13,50778,16926,67704
317070,202301,2059,958,1101,1248653.14,1436107.71,2684760.85
317075,202301,98,54,44,70308.75,57288,127596.75
317080,202301,1013,511,502,665352.19,656209.55,1321561.74
317090,202301,739,575,164,748664.82,214834.32,963499.14
317100,202301,457,343,114,446592.49,148428.95,595021.44
317103,202301,137,110,27,143220.75,35154,178374.75
317107,202301,52,40,12,52080,15624,67704
317110,202301,80,41,39,53382.2,50779.62,104161.82
317115,202301,44,40,4,52141.19,5208,57349.19
317120,202301,2258,1126,1132,1466103.87,1475182.12,2941285.99
317130,202301,2208,1488,720,1938695.52,937442.33,2876137.85
317140,202301,12,9,3,11718,3906,15624
317150,202301,300,182,118,236965.79,153636.89,390602.68
317160,202301,364,270,94,351544.49,122388.98,473933.47
317170,202301,245,160,85,208320.66,110670.6,318991.26
317180,202301,430,291,139,378886.18,183584.46,562470.64
317190,202301,267,190,77,247381.61,100254,347635.61
317200,202301,890,625,265,813779.48,346338.52,1160118.00
317210,202301,186,96,90,124997.94,117180.21,242178.15
317220,202301,23,11,12,14322,15624,29946
320010,202301,583,413,170,537736.9,221345.83,759082.73
320013,202301,145,96,49,124994.9,63800.21,188795.11
320016,202301,256,155,101,201815.82,132804,334619.82
320020,202301,785,463,322,602846.18,419251.78,1022097.96
320030,202301,174,121,53,157543.49,69007.78,226551.27
320035,202301,142,96,46,124992.2,59892.56,184884.76
320040,202301,514,253,261,330717.41,339829.89,670547.30
320050,202301,128,90,38,117186.32,50778.5,167964.82
320060,202301,2005,936,1069,1218705.94,1394460.76,2613166.70
320070,202301,102,65,37,84630.87,48174,132804.87
320080,202301,861,482,379,627590.93,493461.71,1121052.64
320090,202301,1372,883,489,1149696.03,636694.39,1786390.42
320100,202301,369,210,159,273427.53,207020.68,480448.21
320110,202301,133,81,52,105469.93,67704.6,173174.53
320115,202301,121,101,20,131502.38,26040,157542.38
320120,202301,3985,2075,1910,2703033.16,2488167.16,5191200.32
320130,202301,8687,3727,4960,4859230.05,6464552,11323782.05
320140,202301,535,343,192,446604.54,249991.71,696596.25
320150,202301,2307,1262,1045,1643179.78,1360605,3003784.78
320160,202301,681,290,391,377586.84,509084.6,886671.44
320170,202301,117,93,24,121086.4,31248.02,152334.42
320180,202301,62,34,28,44269.51,36456.12,80725.63
320190,202301,260,153,107,199213,139314.1,338527.1
320200,202301,65,54,11,70310.52,14322,84632.52
320210,202301,954,515,439,671853.04,571587.38,1243440.42
320220,202301,309,106,203,138012.8,264306.2,402319.0
320225,202301,84,69,15,89838.39,19530.21,109368.60
320230,202301,755,480,275,624988.48,358057.43,983045.91
320240,202301,3807,1712,2095,2230385.46,2727724.37,4958109.83
320245,202301,548,376,172,489560.95,223950.36,713511.31
320250,202301,260,120,140,156245.37,182282.1,338527.47
320255,202301,123,91,32,118485.01,41664.22,160149.23
320260,202301,301,158,143,205717.64,186187.67,391905.31
320265,202301,150,117,33,152335.46,42966.64,195302.10
320270,202301,163,124,39,161451.89,52081.15,213533.04
320280,202301,1429,790,639,1029913.43,831995.58,1861909.01
320290,202301,69,53,16,69006.4,20832,89838.4
320300,202301,654,444,210,578104.33,273423.5,851527.83
320305,202301,801,435,366,567694.58,476546.06,1044240.64
320310,202301,212,126,86,164055.83,111972.2,276028.03
320313,202301,372,168,204,218747.06,265608.94,484356.00
320316,202301,115,82,33,106765.77,42966.2,149731.97
320320,202301,3693,1627,2066,2118418.27,2691273.21,4809691.48
320330,202301,300,217,83,282534.75,108066.48,390601.23
320332,202301,811,482,329,627604.39,429675.36,1057279.75
320334,202301,299,166,133,217435.46,173167.3,390602.76
320335,202301,150,98,52,127602.38,67706.03,195308.41
320340,202301,622,443,179,576806.93,233064.59,809871.52
320350,202301,1172,474,698,617169.36,910111.35,1527280.71
320360,202301,181,85,96,110670.5,124992,235662.5
320370,202301,242,177,65,230459.45,84631.29,315090.74
320380,202301,339,240,99,312487,128898.89,441385.89
320390,202301,1209,702,507,914028.5,660119.47,1574147.97
320400,202301,338,239,99,311190.09,128898.26,440088.35
320405,202301,1035,419,616,545563.71,802051.5,1347615.21
320410,202301,1003,496,507,647106.87,660120.68,1307227.55
320420,202301,615,274,341,356761.58,443994.07,800755.65
320425,202301,225,116,109,151034.03,141918.8,292952.83
320430,202301,421,219,202,285148.29,263009.76,548158.05
320435,202301,186,126,60,164054.05,78121.99,242176.04
320440,202301,219,121,98,157545.02,127601,285146.02
320450,202301,142,73,69,95047.18,89839.06,184886.24
320455,202301,236,183,53,238271.16,69006.66,307277.82
320460,202301,336,201,135,261705.63,175770.21,437475.84
320465,202301,121,83,38,108070.41,49476.65,157547.06
320470,202301,783,464,319,604146.89,416653.46,1020800.35
320480,202301,237,157,80,205720.95,104160.82,309881.77
320490,202301,3530,1671,1859,2175713.66,2421775.25,4597488.91
320495,202301,134,77,57,100254.4,74214.6,174469.0
320500,202301,11010,5313,5697,6924304.44,7425429.54,14349733.98
320501,202301,591,302,289,393221.72,377589.89,770811.61
320503,202301,336,237,99,309883.91,128898.43,438782.34
320506,202301,289,195,94,253893.05,122388.38,376281.43
320510,202301,1354,584,770,760386.3,1006467.48,1766853.78
320515,202301,87,67,20,87235.61,26040,113275.61
320517,202301,239,172,67,223949.19,88536,312485.19
320520,202301,8611,3561,5050,4641779.41,6584328.98,11226108.39
320530,202301,7650,3627,4023,4728975.14,5245835.55,9974810.69
330010,202301,3829,1882,1947,2451748.27,2536329.99,4988078.26
330015,202301,223,97,126,126295.16,164052.56,290347.72
330020,202301,4389,1670,2719,2175704.56,3550590.58,5726295.14
330022,202301,277,141,136,183587.7,178374.95,361962.65
330023,202301,917,261,656,339827.61,855424.2,1195251.81
330025,202301,999,166,833,216133.93,1084574.83,1300708.76
330030,202301,2024,1246,778,1623664.95,1012971.46,2636636.41
330040,202301,2885,1466,1419,1911395.67,1850173.13,3761568.80
330045,202301,11319,3560,7759,4637858.03,10116684.05,14754542.08
330050,202301,939,573,366,746063.78,476535.92,1222599.70
330060,202301,1302,761,541,990865.22,704392.04,1695257.26
330070,202301,4763,1603,3160,2088482.06,4118283.12,6206765.18
330080,202301,1755,765,990,996063.68,1288999.87,2285063.55
330090,202301,415,227,188,295643.91,244777.32,540421.23
330093,202301,236,98,138,127597.56,179676.99,307274.55
330095,202301,74,39,35,50779.16,45570,96349.16
330100,202301,12058,5961,6097,7764101.89,7942327,15706428.89
330110,202301,506,228,278,296860.75,361961.92,658822.67
330115,202301,549,267,282,347643.02,367167.31,714810.33
330120,202301,433,223,210,291651.91,273421.74,565073.65
330130,202301,1745,462,1283,602845.91,1673103.7,2275949.61
330140,202301,739,373,366,485652.64,477834.7,963487.34
330150,202301,572,342,230,446594.67,299462.1,746056.77
330160,202301,216,126,90,164055.01,117181.7,281236.71
330170,202301,29624,10451,19173,13612918.13,24985836.01,38598754.14
330180,202301,273,151,122,196603.76,158847.15,355450.91
330185,202301,1311,506,805,661432.7,1049429.49,1710862.19
330187,202301,630,195,435,253899.04,567678.6,821577.64
330190,202301,6918,2591,4327,3377483.45,5640324.03,9017807.48
330200,202301,5058,1688,3370,2197848.26,4394331.66,6592179.92
330205,202301,520,288,232,374985.64,302066.74,677052.38
330210,202301,984,589,395,766901.12,514294.06,1281195.18
330220,202301,3035,1768,1267,2303318.61,1650966.12,3954284.73
330225,202301,641,339,302,441385.87,393205.11,834590.98
330227,202301,2684,864,1820,1124957.58,2373582.41,3498539.99
330230,202301,262,139,123,180979.04,160146.58,341125.62
330240,202301,4833,2213,2620,2882723.51,3413905.98,6296629.49
330245,202301,178,85,93,110671.66,121086.85,231758.51
330250,202301,7386,3507,3879,4566273.32,5057047.73,9623321.05
330260,202301,849,236,613,307278.37,800735.59,1108013.96
330270,202301,4392,1425,2967,1855407.43,3868306.8,5723714.23
330280,202301,500,301,199,391923.11,259101.79,651024.90
330285,202301,7012,2247,4765,2928327.91,6211973.51,9140301.42
330290,202301,823,283,540,369777.88,703085.34,1072863.22
330300,202301,794,485,309,632290.42,403629.34,1035919.76
330310,202301,509,293,216,381495.06,282536.56,664031.62
330320,202301,8512,2898,5614,3775966.47,7322564.72,11098531.19
330330,202301,10426,3809,6617,4964655.36,8625878.15,13590533.51
330340,202301,2993,1646,1347,2143129.95,1753812.36,3896942.31
330350,202301,21966,8022,13944,10452876.91,18173669.27,28626546.18
330360,202301,2113,977,1136,1273410.34,1483013.47,2756423.81
330370,202301,1074,567,507,738257.79,661427.95,1399685.74
330380,202301,1097,446,651,580698.96,848912.67,1429611.63
330385,202301,718,350,368,457011.43,479139.11,936150.54
330390,202301,6826,3511,3315,4575359.93,4320099.73,8895459.66
330395,202301,431,280,151,364570.39,196607.45,561177.84
330400,202301,774,394,380,513006.41,494763.56,1007769.97
330410,202301,557,399,158,519510.55,205719.63,725230.18
330411,202301,405,220,185,286442.35,240870.2,527312.55
330412,202301,235,109,126,141921.4,164052.1,305973.5
330414,202301,5959,2336,3623,3041589.86,4722406.38,7763996.24
330415,202301,676,287,389,373689.38,506484.07,880173.45
330420,202301,2701,1410,1291,1838465.35,1683498.97,3521964.32
330430,202301,1949,822,1127,1070266.22,1469974.37,2540240.59
330440,202301,414,200,214,260405.76,278630.61,539036.37
330450,202301,129,56,73,72913.54,95046.85,167960.39
330452,202301,2655,1075,1580,1400997.38,2057187.48,3458184.86
330455,202301,137975,48169,89806,62748321.64,117040295.76,179788617.40
330460,202301,284,131,153,170564.59,199206.4,369770.99
330470,202301,1354,718,636,934858.45,829388.23,1764246.68
330475,202301,2015,608,1407,791631,1831927.21,2623558.21
330480,202301,849,471,378,613253.89,494766.57,1108020.46
330490,202301,18216,5584,12632,7275912.73,16464022.63,23739935.36
330500,202301,1705,725,980,943967.75,1275972.06,2219939.81
330510,202301,12182,4264,7918,5558439.31,10321100.71,15879540.02
330513,202301,107,55,52,71610,67704,139314
330515,202301,749,321,428,417948.33,557267.39,975215.72
330520,202301,2744,933,1811,1216106.46,2359258.64,3575365.10
330530,202301,186,106,80,138014.62,104160.1,242174.72
330540,202301,377,199,178,259100.2,231758.93,490859.13
330550,202301,3087,1018,2069,1325459.12,2695170.62,4020629.74
330555,202301,1154,425,729,553360.69,949165.01,1502525.70
330560,202301,852,300,552,390610.28,718711.91,1109322.19
330570,202301,347,240,107,312481.64,139314.43,451796.07
330575,202301,955,359,596,468733.55,776005.36,1244738.91
330580,202301,3745,1960,1785,2551987.78,2326701.1,4878688.88
330590,202301,275,144,131,187490.57,170563.73,358054.30
330600,202301,1542,905,637,1178344.19,830688.03,2009032.22
330610,202301,1761,887,874,1154896.77,1137954.97,2292851.74
330615,202301,236,187,49,244779.31,63801.26,308580.57
330620,202301,1051,443,608,576803.83,855427.65,1432231.48
330630,202301,5063,2993,2070,3897006.29,2695179.68,6592185.97
350010,202301,629,417,212,542954.27,279933.32,822887.59
350020,202301,55,18,37,23436.94,48174,71610.94
350030,202301,601,352,249,458330.07,324206.4,782536.47
350040,202301,115,49,66,63802.5,85933.19,149735.69
350050,202301,384,183,201,238271.76,261706.25,499978.01
350055,202301,132,57,75,74215.9,97650.2,171866.1
350060,202301,83,33,50,42968.61,66402.2,109370.81
350070,202301,824,458,366,596345.73,476544.56,1072890.29
350075,202301,84,52,32,67707.19,41664,109371.19
350080,202301,61,28,33,36457.07,42966.27,79423.34
350090,202301,83,45,38,58593.67,49476,108069.67
350100,202301,309,191,118,248684.97,153636.98,402321.95
350110,202301,48,30,18,39061.3,23436,62497.3
350115,202301,187,90,97,117182.3,127596.26,244778.56
350120,202301,109,69,40,89841.3,53382.97,143224.27
350130,202301,435,185,250,240885.2,326810.39,567695.59
350140,202301,37,23,14,29946.64,18228,48174.64
350150,202301,75,52,23,67705.24,29946.16,97651.40
350160,202301,2545,997,1548,1299427.45,2015505.97,3314933.42
350170,202301,433,250,183,325512.61,238270.66,563783.27
350180,202301,169,92,77,119789.6,100255.01,220044.61
350190,202301,1039,555,484,722640.74,631473.15,1354113.89
350200,202301,60,26,34,33853.1,45570,79423.1
350210,202301,1383,736,647,958313.23,842420.27,1800733.50
350220,202301,651,522,129,679662.55,169262.47,848925.02
350230,202301,70,42,28,54684.84,36456.1,91140.94
350240,202301,61,38,23,49476.65,29947.28,79423.93
350250,202301,1163,521,642,680968.13,835895.34,1516863.47
350260,202301,110,81,29,105464.99,37758.87,143223.86
350270,202301,1016,671,345,874950.54,449193.75,1324144.29
350275,202301,348,128,220,166658.36,286444.06,453102.42
350280,202301,4633,2202,2431,2868421.74,3166479.76,6034901.50
350290,202301,499,212,287,276031.84,374979.73,651011.57
350300,202301,49,25,24,32553.8,31248.9,63802.7
350310,202301,80,45,35,58591.33,45570.59,104161.92
350315,202301,76,31,45,40362,58590,98952
350320,202301,3576,1649,1927,2148394.47,2511582.83,4659977.30
350330,202301,1738,858,880,1118449.53,1145764.67,2264214.20
350335,202301,21,13,8,16926,10416,27342
350340,202301,130,52,78,67704.8,101560.78,169265.58
350350,202301,96,45,51,58590.49,66402,124992.49
350360,202301,107,68,39,88538.22,50778.24,139316.46
350370,202301,86,47,39,61198.36,50778.48,111976.84
350380,202301,890,380,510,496072.75,664027.73,1160100.48
350390,202301,1911,706,1205,919233.14,1568927.8,2488160.94
350395,202301,18,14,4,18228,5208,23436
350400,202301,1841,868,973,1130162.52,1269451.08,2399613.60
350410,202301,3292,1322,1970,1721285.89,2571470.15,4292756.04
350420,202301,289,172,117,223949.58,152334.83,376284.41
350430,202301,104,53,51,69011.33,66404.16,135415.49
350440,202301,147,103,44,134114.05,57288.35,191402.40
350450,202301,1833,998,835,1299445.1,1087170.8,2386615.9
350460,202301,428,145,283,188795.21,368475.45,557270.66
350470,202301,20,12,8,15624,10416,26040
350480,202301,203,104,99,135415.22,128898.54,264313.76
350490,202301,262,117,145,152336.28,188791.79,341128.07
350500,202301,58,20,38,26040,49476,75516
350510,202301,154,88,66,114579.02,85932.38,200511.40
350520,202301,460,247,213,321609.33,277333.32,598942.65
350530,202301,459,219,240,285151.04,312490.37,597641.41
350535,202301,93,62,31,80724.79,40362.96,121087.75
350540,202301,369,192,177,249987.36,231760.48,481747.84
350550,202301,2932,1632,1300,2126259.98,1693910.11,3820170.09
350560,202301,622,423,199,550762.48,259100.79,809863.27
350570,202301,4991,2037,2954,2653545.69,3850046.98,6503592.67
350580,202301,400,187,213,243482.6,277329.65,520812.25
350590,202301,1049,565,484,735650.53,630311.47,1365962.00
350600,202301,6787,3086,3701,4020745.88,4818740.66,8839486.54
350610,202301,1615,832,783,1083292.68,1019471.57,2102764.25
350620,202301,26,15,11,19530,14322,33852
350630,202301,271,131,140,170566.91,182282.06,352848.97
350635,202301,1354,568,786,740858.7,1024694.92,1765553.62
350640,202301,129,91,38,118484.14,49476.2,167960.34
350650,202301,2003,1314,689,1710891.55,897080.51,2607972.06
350660,202301,848,331,517,432271.22,673140.47,1105411.69
350670,202301,306,150,156,195301.81,203112.7,398414.51
350680,202301,163,82,81,106767.84,105463.5,212231.34
350690,202301,210,93,117,121087.49,152334,273421.49
350700,202301,1003,478,525,623680.2,683560.35,1307240.55
350710,202301,435,159,276,207022.74,359356.57,566379.31
350715,202301,56,46,10,59893.77,13020,72913.77
350720,202301,16,11,5,14322.32,6510,20832.32
350730,202301,43,26,17,33852.58,22134.61,55987.19
350740,202301,263,144,119,187492.37,154938.76,342431.13
350745,202301,32,14,18,18229.39,23436.23,41665.62
350750,202301,2644,1531,1113,1993431.82,1450442.31,3443874.13
350760,202301,4259,1788,2471,2330646.96,3217265.83,5547912.79
350770,202301,59,36,23,46872.75,29946,76818.75
350775,202301,56,41,15,53386.83,19531.36,72918.19
350780,202301,483,239,244,311191.48,317690.13,628881.61
350790,202301,374,155,219,201813.27,285141.79,486955.06
350800,202301,551,330,221,432270.48,287742.32,720012.80
350810,202301,532,404,128,528638.87,166656.2,695295.07
350820,202301,100,55,45,71610.41,58590,130200.41
350830,202301,83,42,41,54684.17,53382,108066.17
350840,202301,864,345,519,450504.97,675864.56,1126369.53
350850,202301,1980,1016,964,1324167.03,1257738.58,2581905.61
350860,202301,724,373,351,485661.3,457014.48,942675.78
350870,202301,475,317,158,412743.45,205716.35,618459.80
350880,202301,289,154,135,200511.64,175773.83,376285.47
350890,202301,39,24,15,31248,19530.33,50778.33
350900,202301,1749,557,1192,725235.36,1552017.05,2277252.41
350910,202301,24,12,12,15624,15624.42,31248.42
350920,202301,838,427,411,555963.61,535122.66,1091086.27
350925,202301,1243,615,628,800764.02,817671.76,1618435.78
350930,202301,126,72,54,93746.72,70308,164054.72
350940,202301,774,397,377,518218.57,492172.04,1010390.61
350945,202301,122,83,39,108068.72,50778.96,158847.68
350950,202301,19050,8754,10296,11411055.15,13418511.73,24829566.88
350960,202301,1838,727,1111,949372.94,1446537.92,2395910.86
350970,202301,1166,562,604,732913.65,787726.28,1520639.93
350980,202301,99,65,34,84631.53,44268.64,128900.17
350990,202301,431,157,274,204415.3,356750.88,561166.18
350995,202301,43,18,25,23437.39,32551.16,55988.55
351000,202301,637,400,237,520817.35,308584.1,829401.45
351010,202301,54,35,19,45571.18,24738,70309.18
351015,202301,48,29,19,37759.21,24738,62497.21
351020,202301,1566,928,638,1210889,833288.37,2044177.37
351030,202301,362,209,153,272120.1,199206.36,471326.46
351040,202301,1084,587,497,764295.22,648400.39,1412695.61
351050,202301,3940,1778,2162,2315046.24,2816250.38,5131296.62
351060,202301,6583,2366,4217,3081929.62,5494474.73,8576404.35
351070,202301,434,267,167,347645.83,217441.09,565086.92
351080,202301,794,582,212,759088.18,277329.77,1036417.95
351090,202301,48,25,23,32551.3,29946.41,62497.71
351100,202301,439,231,208,300776.95,272129.01,572905.96
351110,202301,2230,1015,1215,1321566.19,1581932.77,2903498.96
351120,202301,65,31,34,40362.83,45570,85932.83
351130,202301,198,64,134,83330.83,174471.31,257802.14
351140,202301,338,199,139,259104.85,182283.55,441388.40
351150,202301,528,266,262,346341.24,341126.63,687467.87
351160,202301,334,193,141,251293.46,183582.72,434876.18
351170,202301,244,139,105,180980.46,136710.55,317691.01
351190,202301,100,60,40,78120.82,52080.52,130201.34
351200,202301,360,231,129,300770.16,167959.77,468729.93
351210,202301,134,66,68,85933.76,88536.78,174470.54
351220,202301,624,349,275,454412.95,358051.07,812464.02
351230,202301,319,203,116,264312.56,151032.3,415344.86
351240,202301,252,125,127,162753.27,165356.91,328110.18
351250,202301,87,60,27,78125.18,35154.1,113279.28
351260,202301,148,102,46,132804.29,59892,192696.29
351270,202301,45,21,24,27342.85,31248,58590.85
351280,202301,1088,524,564,682265.72,734336.48,1416602.20
351290,202301,259,123,136,160148.08,178374,338522.08
351300,202301,4317,1795,2522,2338462.58,3288897.39,5627359.97
351310,202301,768,370,398,481763.64,518209.17,999972.81
351320,202301,122,66,56,85933.75,72912,158845.75
351330,202301,42,25,17,32550,22134,54684
351340,202301,1531,820,711,1067672.42,925726.54,1993398.96
351350,202301,2578,1503,1075,1956978.53,1402261.05,3359239.58
351360,202301,852,393,459,511693.6,598925.18,1110618.78
351370,202301,473,233,240,303372.29,312480.2,615852.49
351380,202301,9383,4056,5327,5281044.78,6939697.29,12220742.07
351385,202301,25,17,8,22134.39,10416,32550.39
351390,202301,289,209,80,272121.38,104160.5,376281.88
351400,202301,62,40,22,52080.25,28644,80724.25
351410,202301,493,285,208,371080.7,270818.7,641899.4
351420,202301,75,54,21,70308.04,27342,97650.04
351430,202301,71,36,35,46873.28,45570.2,92443.48
351440,202301,862,559,303,727853.08,395813.52,1123666.60
351450,202301,298,146,152,190096.4,197909.41,388005.81
351460,202301,147,60,87,78122.36,113276.16,191398.52
351470,202301,147,78,69,101558.34,89838.89,191397.23
351480,202301,484,282,202,367169.18,263004.2,630173.38
351490,202301,323,132,191,171865.82,248682.55,420548.37
351492,202301,28,17,11,22134.63,14322,36456.63
351495,202301,26,17,9,22134,11718,33852
351500,202301,3660,1450,2210,1889238.48,2881345.54,4770584.02
351510,202301,2275,817,1458,1063764.7,1899640.57,2963405.27
351512,202301,14,10,4,13020,5208,18228
351515,202301,223,132,91,171870.34,118482,290352.34
351518,202301,708,417,291,544267.45,378903.69,923171.14
351519,202301,90,55,35,71612.26,45570,117182.26
351520,202301,176,108,68,140620.22,88560.45,229180.67
351530,202301,26,12,14,15624,18228,33852
351535,202301,137,82,55,106767.64,71610.96,178378.60
351540,202301,496,316,180,411445.24,234363.23,645808.47
351550,202301,1674,982,692,1278599.04,904895.11,2183494.15
351560,202301,87,48,39,62497.46,50778,113275.46
351565,202301,15,7,8,9114.32,10416,19530.32
351570,202301,2986,1344,1642,1751255.17,2137900.72,3889155.89
351580,202301,35,32,3,41664,3906,45570
351590,202301,69,41,28,53385.37,36456.22,89841.59
351600,202301,185,136,49,177078.27,63798.24,240876.51
351610,202301,53,24,29,31248.97,37758,69006.97
351620,202301,6287,3300,2987,4296762.17,3898224.71,8194986.88
351630,202301,3587,1681,1906,2191328.34,2485541.67,4676870.01
351640,202301,2671,1159,1512,1512967.77,1968637.85,3481605.62
351650,202301,34,28,6,36456.51,7812,44268.51
351660,202301,148,95,53,123690.93,69006,192696.93
351670,202301,790,451,339,587223.46,441383.94,1028607.40
351680,202301,86,63,23,82026.9,29946,111972.9
351685,202301,14,10,4,13020,5208,18228
351690,202301,314,199,115,259105.85,149731.62,408837.47
351700,202301,198,133,65,173449.8,84630.2,258080.0
351710,202301,69,44,25,57289.32,32550.91,89840.23
351720,202301,125,70,55,91142.4,71610,162752.4
351730,202301,121,81,40,105462.44,52080,157542.44
351740,202301,835,524,311,683581.37,406228.64,1089810.01
351750,202301,392,157,235,204419.07,305971.6,510390.67
351760,202301,722,559,163,727723.88,212226,939949.88
351770,202301,300,241,59,313797.48,76818.56,390616.04
351780,202301,146,89,57,115879.46,74214,190093.46
351790,202301,281,141,140,183587.83,182282.4,365870.23
351800,202301,47,31,16,40362.18,20832,61194.18
351810,202301,121,76,45,98956.66,58592.46,157549.12
351820,202301,777,548,229,713542.07,299466.64,1013008.71
351830,202301,682,218,464,286448.69,604133.95,890582.64
351840,202301,2421,1078,1343,1404896.24,1748593.51,3153489.75
351850,202301,280,190,90,247386.19,117180.1,364566.29
351860,202301,618,410,208,533843.1,270817.43,804660.53
351870,202301,6222,2773,3449,3611865.27,4493297.25,8105162.52
351880,202301,23687,9024,14663,11757347.62,19113383.74,30870731.36
351885,202301,107,60,47,78123.23,61195.5,139318.73
351890,202301,75,52,23,67705.4,29946,97651.4
351900,202301,254,131,123,170565.35,160146.39,330711.74
351905,202301,100,48,52,62497.72,67704,130201.72
351907,202301,3999,1614,2385,2101492.25,3107904.65,5209396.90
351910,202301,160,66,94,85935.75,122388.87,208324.62
351920,202301,118,65,53,84630,69006,153636
351925,202301,93,56,37,74217.24,48174.91,122392.15
351930,202301,476,298,178,388016.81,231762.83,619779.64
351940,202301,248,102,146,132806.88,190093.54,322900.42
351950,202301,149,80,69,104161.42,89840.81,194002.23
351960,202301,1014,487,527,634098.57,686171.17,1320269.74
351970,202301,2265,1059,1206,1381444.73,1571534.2,2952978.93
351980,202301,159,65,94,84632.79,122389.48,207022.27
351990,202301,257,160,97,208322.45,126295.07,334617.52
352000,202301,328,208,120,270827.14,156244.29,427071.43
352010,202301,454,291,163,380288.78,213538.47,593827.25
352020,202301,208,67,141,87234,183582,270816
352030,202301,1243,582,661,757783.71,863243.12,1621026.83
352040,202301,725,281,444,365866.79,579393.76,945260.55
352042,202301,353,80,273,104162.76,355448.07,459610.83
352044,202301,381,214,167,279944.48,218741.01,498685.49
352050,202301,3448,1257,2191,1636651.87,2853997.44,4490649.31
352060,202301,103,62,41,80724.18,53382.99,134107.17
352070,202301,102,69,33,89843.47,42966,132809.47
352080,202301,67,41,26,53385.57,33852.48,87238.05
352090,202301,197,120,77,156245.1,100254.45,256499.55
352100,202301,336,163,173,212230.28,225248.33,437478.61
352110,202301,111,27,84,35154.93,109368,144522.93
352115,202301,67,25,42,32550,54684.58,87234.58
352120,202301,71,47,24,61194,31248,92442
352130,202301,218,162,56,210933.05,72912.57,283845.62
352140,202301,199,94,105,123691.62,138012.41,261704.03
352150,202301,132,70,62,91143.07,80725.77,171868.84
352160,202301,148,95,53,123693.47,69006.04,192699.51
352170,202301,440,291,149,378887.43,193998.08,572885.51
352180,202301,730,438,292,570295.18,381494.06,951789.24
352190,202301,254,106,148,138015.09,192697.99,330713.08
352200,202301,30,13,17,16926,22134.1,39060.1
352210,202301,4813,1890,2923,2462190.87,3814891.16,6277082.03
352215,202301,78,42,36,54684.2,46872,101556.2
352220,202301,6476,2384,4092,3106660.5,5330447.61,8437108.11
352230,202301,3832,2394,1438,3119703.22,1873585.91,4993289.13
352240,202301,2928,1630,1298,2122319.9,1691314.15,3813634.05
352250,202301,3895,1727,2168,2251212.43,2826650.79,5077863.22
352260,202301,1092,570,522,742158.75,679657.9,1421816.65
352265,202301,68,40,28,52080,36456,88536
352270,202301,415,224,191,291665.81,248690.06,540355.87
352280,202301,530,310,220,406232.97,286440,692672.97
352290,202301,186,101,85,131508.22,113277.38,244785.60
352300,202301,104,64,40,83331.99,52080.64,135412.63
352310,202301,8003,3444,4559,4484241.21,5939736.63,10423977.84
352320,202301,1230,633,597,824182.83,778602.95,1602785.78
352330,202301,555,286,269,372376.71,351540.96,723917.67
352340,202301,1441,654,787,851534.25,1024683.4,1876217.65
352350,202301,391,209,182,273427.47,236967.05,510394.52
352360,202301,225,98,127,127597.68,165354.2,292951.88
352370,202301,125,77,48,100259.39,62496.42,162755.81
352380,202301,119,84,35,109371.64,45571.13,154942.77
352390,202301,2755,1169,1586,1524683.46,2067584.96,3592268.42
352400,202301,580,247,333,321596.57,433567.8,755164.37
352410,202301,955,620,335,807274.85,436190.24,1243465.09
352420,202301,91,66,25,85933.04,32550,118483.04
352430,202301,1845,802,1043,1044248.93,1358013.43,2402262.36
352440,202301,3684,1655,2029,2154867.27,2641771.25,4796638.52
352450,202301,203,156,47,203113.09,61195.2,264308.29
352460,202301,668,325,343,423156.34,446590.85,869747.19
352470,202301,712,272,440,354156.81,574186.07,928342.88
352480,202301,1730,970,760,1262971.15,990835.39,2253806.54
352490,202301,54,22,32,28644.6,41664.3,70308.9
352500,202301,1374,545,829,709601.95,1079365.05,1788967.00
352510,202301,759,397,362,518223.15,472630.67,990853.82
352520,202301,906,403,503,524715.84,654921.35,1179637.19
352530,202301,1979,982,997,1279914.15,1298101.4,2578015.55
352540,202301,72,49,23,63799.8,29946,93745.8
352550,202301,222,126,96,164053.93,124992.4,289046.33
352560,202301,53,38,15,49478.24,19530.96,69009.20
352570,202301,795,380,415,494782.47,540345.07,1035127.54
352580,202301,58,43,15,55988.84,19530,75518.84
352585,202301,18,7,11,9114.2,14322.95,23437.15
352590,202301,4792,2338,2454,3044181.68,3196436.88,6240618.56
352600,202301,391,263,128,342437.35,166662.59,509099.94
352610,202301,964,420,544,546852.13,709596.12,1256448.25
352620,202301,1188,446,742,582005.02,968698.05,1550703.07
352630,202301,192,71,121,92443.61,157542.08,249985.69
352640,202301,541,344,197,447907.47,256499.94,704407.41
352650,202301,92,63,29,83330.42,37758,121088.42
352660,202301,69,37,32,48175.01,41664,89839.01
352670,202301,1821,950,871,1236952.92,1135345.6,2372298.52
352680,202301,1011,592,419,773412.19,545556.47,1318968.66
352690,202301,4949,2142,2807,2791575.47,3656042.63,6447618.10
352700,202301,92,50,42,65101.45,54685.56,119787.01
352710,202301,1585,804,781,1048154.77,1018167.84,2066322.61
352720,202301,1663,680,983,885393.36,1279892.12,2165285.48
352725,202301,28,21,7,27343.1,9114,36457.1
352730,202301,420,202,218,263008.49,283838.7,546847.19
352740,202301,413,260,153,338534.95,199209.67,537744.62
352750,202301,22,14,8,18229.06,10416.14,28645.20
352760,202301,243,156,87,203114.25,113275.11,316389.36
352770,202301,79,57,22,74216.89,28644.18,102861.07
352780,202301,75,39,36,50778,46872.78,97650.78
352790,202301,25,17,8,22136.22,10416.18,32552.40
352800,202301,253,190,63,247388.13,83329.41,330717.54
352810,202301,160,100,60,130202.28,79424.98,209627.26
352820,202301,48,36,12,46872.7,15624,62496.7
352830,202301,75,50,25,65101.58,32550.01,97651.59
352840,202301,749,332,417,432279.54,545544.42,977823.96
352850,202301,1944,572,1372,744756.07,1786354.1,2531110.17
352860,202301,123,76,47,98954.76,61194.56,160149.32
352870,202301,53,33,20,42970.86,26040.5,69011.36
352880,202301,191,108,83,140622.08,108068.16,248690.24
352885,202301,34,22,12,28644.42,15624,44268.42
352890,202301,59,35,24,45571.25,31248.6,76819.85
352900,202301,4832,2246,2586,2925694.31,3370892.91,6296587.22
352910,202301,39,32,7,41664.88,9114,50778.88
352920,202301,660,373,287,486969.61,373682.59,860652.20
352930,202301,1243,574,669,747369.61,871043.15,1618412.76
352940,202301,6620,2479,4141,3229030.53,5392950.91,8621981.44
352950,202301,126,57,69,74216.32,89839.94,164056.26
352960,202301,63,40,23,52080.93,29946,82026.93
352965,202301,16,10,6,13020.63,7812,20832.63
352970,202301,549,394,155,513008.03,201814.76,714822.79
352980,202301,162,93,69,121092.78,89839.78,210932.56
352990,202301,1004,472,532,614563.66,692675.57,1307239.23
353000,202301,62,28,34,36456.44,44268.51,80724.95
353010,202301,534,324,210,421864.81,273423.92,695288.73
353020,202301,349,226,123,294261.58,160149.32,454410.90
353030,202301,1464,647,817,842425.06,1065054.92,1907479.98
353040,202301,89,46,43,59894.71,55987.13,115881.84
353050,202301,1399,907,492,1180966.49,640586.2,1821552.69
353060,202301,9744,4176,5568,5442553.13,7258710.13,12701263.26
353070,202301,2076,1200,876,1565062.58,1141624.11,2706686.69
353080,202301,1381,734,647,955702.33,843699.46,1799401.79
353090,202301,67,36,31,46873.34,40362,87235.34
353100,202301,46,34,12,44270.62,15624.57,59895.19
353110,202301,2371,782,1589,1019514.1,2070247.65,3089761.75
353120,202301,144,81,63,105462.2,82026,187488.2
353130,202301,887,419,468,545559.12,609342.71,1154901.83
353140,202301,604,282,322,367179.47,420552.73,787732.20
353150,202301,324,163,161,212231.31,209626.5,421857.81
353160,202301,110,82,28,106768.07,36456,143224.07
353170,202301,209,74,135,96350.3,177072.01,273422.31
353180,202301,1306,598,708,778614.66,923129.87,1701744.53
353190,202301,517,364,153,473952.78,199208.98,673161.76
353200,202301,278,134,144,174470.48,187488.45,361958.93
353205,202301,21,14,7,18228,9114,27342
353210,202301,75,44,31,57288.8,41664.56,98953.36
353215,202301,44,24,20,31248.2,26040,57288.2
353220,202301,83,44,39,57289.46,50778.6,108068.06
353230,202301,161,70,91,91143.37,118482,209625.37
353240,202301,421,180,241,234362.55,313782.2,548144.75
353250,202301,188,94,94,122391.61,122390.26,244781.87
353260,202301,488,311,177,404934.07,230460.66,635394.73
353270,202301,72,55,17,71612.33,22134,93746.33
353280,202301,124,58,66,75517.55,85936.14,161453.69
353282,202301,132,88,44,114577.49,57288.6,171866.09
353284,202301,34,24,10,31249.46,13020,44269.46
353286,202301,10,5,5,6510.2,6510.3,13020.5
353290,202301,88,51,37,66403.09,48174,114577.09
353300,202301,464,231,233,300774.93,304676.34,605451.27
353310,202301,39,31,8,40363.57,10417.5,50781.07
353320,202301,44,25,19,32551.8,24738.39,57290.19
353325,202301,47,25,22,32551.85,28644,61195.85
353330,202301,63,41,22,53382.4,28644.2,82026.6
353340,202301,739,267,472,347641.29,614551.98,962193.27
353350,202301,965,472,493,615865.5,641900.2,1257765.7
353360,202301,110,86,24,111974.44,31248.64,143223.08
353370,202301,113,61,52,79424.67,67704.38,147129.05
353380,202301,27,13,14,16926.2,19530,36456.2
353390,202301,1182,548,634,716122.75,825482.27,1541605.02
353400,202301,57,30,27,39061.69,35156.16,74217.85
353410,202301,118,63,55,82029.24,71611.78,153641.02
353420,202301,61,27,34,35154,44268,79422
353430,202301,598,387,211,503896.73,274732.77,778629.50
353440,202301,13942,6174,7768,8043916.12,10117891.75,18161807.87
353450,202301,51,25,26,32550.8,33852.2,66403.0
353460,202301,685,348,337,453119.29,438784.67,891903.96
353470,202301,2393,1139,1254,1484342.83,1634020.56,3118363.39
353475,202301,298,188,110,244782,143221.77,388003.77
353480,202301,188,148,40,192701.02,52080,244781.02
353490,202301,229,132,97,171869.91,127596.92,299466.83
353500,202301,219,121,98,157544.79,127596.81,285141.60
353510,202301,82,55,27,71610.72,35154.3,106765.02
353520,202301,254,185,69,240873.45,89838.6,330712.05
353530,202301,509,245,264,320303.27,343735.23,664038.50
353540,202301,431,268,163,348947.85,214834.63,563782.48
353550,202301,789,493,296,643222.32,385405.48,1028627.80
353560,202301,572,232,340,302064.92,445285.02,747349.94
353570,202301,71,49,22,63800.36,28644,92444.36
353580,202301,366,225,141,294256.8,183582,477838.8
353590,202301,92,68,24,88537.81,31248,119785.81
353600,202301,294,166,128,217441.2,166656.46,384097.66
353610,202301,144,81,63,105464.94,82026,187490.94
353620,202301,710,353,357,459618.18,466124.64,925742.82
353625,202301,61,32,29,41665.85,37758.21,79424.06
353630,202301,226,159,67,207027.97,87235.49,294263.46
353640,202301,132,84,48,109372.05,62496.9,171868.95
353650,202301,1110,433,677,563776.87,881461.31,1445238.18
353657,202301,24,19,5,24738,6510,31248
353660,202301,308,157,151,204417.87,196604.4,401022.27
353670,202301,751,420,331,546861.57,430971.2,977832.77
353680,202301,147,92,55,119784.93,71610,191394.93
353690,202301,44,30,14,39060,18229.09,57289.09
353700,202301,301,201,100,261707.99,130201.28,391909.27
353710,202301,567,276,291,360666.07,378882.94,739549.01
353715,202301,40,23,17,29946,22134,52080
353720,202301,333,149,184,194004.63,239570.4,433575.03
353730,202301,1229,723,506,942684.17,658814.42,1601498.59
353740,202301,627,343,284,446604.63,369774.47,816379.10
353750,202301,89,46,43,59893.82,55986,115879.82
353760,202301,3507,1347,2160,1755169.43,2814970.06,4570139.49
353770,202301,79,63,16,82028.23,20832.2,102860.43
353780,202301,1465,657,808,855430.83,1053328.5,1908759.33
353790,202301,521,307,214,399731.96,278635.79,678367.75
353800,202301,3983,1834,2149,2389276.6,2800609.06,5189885.66
353810,202301,252,125,127,164058.49,165355.32,329413.81
353820,202301,277,112,165,145824.85,214831.02,360655.87
353830,202301,69,58,11,75518.12,14322.9,89841.02
353850,202301,222,98,124,127598.28,161450.68,289048.96
353860,202301,560,253,307,329412.35,399718.17,729130.52
353870,202301,6161,3112,3049,4054540.19,3976338.06,8030878.25
353880,202301,757,481,276,626282.48,360660.36,986942.84
353890,202301,586,329,257,428369.79,334622.48,762992.27
353900,202301,146,77,69,100256.7,89840.14,190096.84
353910,202301,216,83,133,108067.59,173167.25,281234.84
353920,202301,489,249,240,324207.2,312483.49,636690.69
353930,202301,1091,638,453,832005.74,592412.63,1424418.37
353940,202301,223,104,119,135409.98,154941.35,290351.33
353950,202301,535,346,189,450512.22,246081.22,696593.44
353960,202301,83,66,17,85934.88,22134,108068.88
353970,202301,41,25,16,32551.11,20833.29,53384.40
353980,202301,2094,914,1180,1192665.44,1537682.15,2730347.59
353990,202301,83,48,35,62497.22,45570.61,108067.83
354000,202301,402,183,219,238272.82,285140.42,523413.24
354010,202301,93,53,40,69008.55,52080.69,121089.24
354020,202301,551,341,210,443997.72,273425.14,717422.86
354025,202301,39,33,6,42966.63,7812,50778.63
354030,202301,50,27,23,35155.63,29946.15,65101.78
354040,202301,101,75,26,97654.11,33852,131506.11
354050,202301,166,86,80,111973.47,104161.28,216134.75
354060,202301,862,399,463,519509.89,602827.31,1122337.20
354070,202301,962,535,427,697893.31,555962.34,1253855.65
354075,202301,192,92,100,119786.55,130201.84,249988.39
354080,202301,316,144,172,187493.49,223945.89,411439.38
354085,202301,25,15,10,19531.35,13020,32551.35
354090,202301,293,170,123,221234.92,160147.94,381382.86
354100,202301,6579,2656,3923,3458240.49,5110432.97,8568673.46
354105,202301,104,54,50,70308.79,65100,135408.79
354110,202301,44,22,22,28644,28644.19,57288.19
354120,202301,164,102,62,132807.12,80724.36,213531.48
354130,202301,817,494,323,643212.84,421852.06,1065064.90
354140,202301,3535,1573,1962,2049426.71,2557144.6,4606571.31
354150,202301,674,382,292,497387.47,380192.71,877580.18
354160,202301,700,435,265,566403.41,346339.67,912743.08
354165,202301,11,7,4,9114.49,5208,14322.49
354170,202301,188,123,65,160152.13,85932.3,246084.43
354180,202301,54,32,22,41664.2,28644.7,70308.9
354190,202301,219,83,136,108068.79,177073.94,285142.73
354200,202301,118,57,61,74215.46,79424.4,153639.86
354210,202301,77,32,45,41664,58590,100254
354220,202301,630,381,249,497386.96,324204.28,821591.24
354230,202301,175,76,99,98953.66,128898.53,227852.19
354240,202301,336,202,134,263017.51,174469.29,437486.80
354250,202301,78,45,33,58590.18,42966,101556.18
354260,202301,2264,1034,1230,1347610.88,1601490.44,2949101.32
354270,202301,89,64,25,83329.69,32550,115879.69
354280,202301,58,32,26,41664,33852.6,75516.6
354290,202301,151,102,49,132808.05,63799.25,196607.30
354300,202301,341,240,101,312486.65,131503.31,443989.96
354310,202301,96,67,29,87238.71,37758,124996.71
354320,202301,239,112,127,145826.75,165354.64,311181.39
354323,202301,8,6,2,7812,2604,10416
354325,202301,131,69,62,89839.47,80724.27,170563.74
354330,202301,2588,867,1721,1128860.06,2242052.13,3370912.19
354340,202301,11396,5137,6259,6688326.39,8163604.86,14851931.25
354350,202301,151,101,50,131502.49,65100,196602.49
354360,202301,78,45,33,58592.81,42967.1,101559.91
354370,202301,250,128,122,167960.03,158845.72,326805.75
354380,202301,182,104,78,135410.51,101556,236966.51
354390,202301,2914,1034,1880,1348907.07,2450387.57,3799294.64
354400,202301,361,185,176,242177.05,229152.79,471329.84
354410,202301,734,317,417,414053.89,544246.47,958300.36
354420,202301,297,200,97,260408.06,126295.24,386703.30
354425,202301,354,199,155,259164.48,201812.95,460977.43
354430,202301,180,94,86,122392.25,111972.54,234364.79
354440,202301,27,22,5,28646,6510,35156
354450,202301,59,38,21,49476.26,27342,76818.26
354460,202301,104,59,45,76825.4,58591.84,135417.24
354470,202301,25,13,12,16927.23,15624.76,32551.99
354480,202301,119,65,54,84631.3,70308.75,154940.05
354490,202301,135,76,59,98954.79,76821.59,175776.38
354500,202301,418,178,240,231758.18,312481.27,544239.45
354510,202301,89,61,28,79423.91,36456.65,115880.56
354515,202301,51,18,33,23437.19,42966.1,66403.29
354520,202301,1727,722,1005,941182.98,1312417.78,2253600.76
354530,202301,906,445,461,579402.94,601529.14,1180932.08
354540,202301,273,137,136,178379.18,177073.79,355452.97
354550,202301,46,25,21,32550.86,27342,59892.86
354560,202301,167,93,74,121087.01,96348,217435.01
354570,202301,134,92,42,119784.87,54684,174468.87
354580,202301,1983,926,1057,1206992.86,1376223.05,2583215.91
354600,202301,298,136,162,177077.11,210924.5,388001.61
354610,202301,66,54,12,70308.99,15624.82,85933.81
354620,202301,78,22,56,28644.5,72913.08,101557.58
354625,202301,13,9,4,11720,5208.72,16928.72
354630,202301,365,239,126,311189.9,164057.38,475247.28
354640,202301,880,515,365,670788.59,475236.41,1146025.00
354650,202301,70,41,29,53383.99,37758,91141.99
354660,202301,872,632,240,824205.81,312483.32,1136689.13
354670,202301,232,90,142,117180.8,184884.2,302065.0
354680,202301,1435,508,927,661431.14,1208265.76,1869696.90
354690,202301,80,48,32,62499.58,41664.19,104163.77
354700,202301,78,54,24,70308.78,31248,101556.78
354710,202301,46,33,13,42966.3,16926,59892.3
354720,202301,23,20,3,26040.2,3906,29946.2
354730,202301,1953,797,1156,1037718.5,1510339.35,2548057.85
354740,202301,76,54,22,70309.31,28644,98953.31
354750,202301,419,231,188,300769.18,244778.12,545547.30
354760,202301,555,344,211,447919.05,274728.95,722648.00
354765,202301,7,3,4,3906,5208,9114
354770,202301,369,236,133,307281.3,174472.36,481753.66
354780,202301,9132,3312,5820,4316221.18,7581588.83,11897810.01
354790,202301,89,51,38,66402.44,49476.11,115878.55
354800,202301,453,239,214,311135.69,278633.47,589769.16
354805,202301,76,38,38,49476.89,49476.27,98953.16
354810,202301,100,54,46,70309.93,59892,130201.93
354820,202301,227,91,136,118484.13,177076.24,295560.37
354830,202301,43,23,20,29946,26040,55986
354840,202301,59,38,21,49477.57,27342,76819.57
354850,202301,5039,2222,2817,2893152.43,3679493.19,6572645.62
354860,202301,359,159,200,207018.42,260401.5,467419.92
354870,202301,13118,5662,7456,7376010.17,9715590.82,17091600.99
354880,202301,2847,1027,1820,1337190.24,2371028.55,3708218.79
354890,202301,3236,1692,1544,2204373.67,2010301.81,4214675.48
354900,202301,66,47,19,61195.27,24738.19,85933.46
354910,202301,1386,698,688,908824.38,895777.37,1804601.75
354920,202301,40,33,7,42966.1,9114,52080.1
354925,202301,24,13,11,16926,14322,31248
354930,202301,35,28,7,36458.31,9114,45572.31
354940,202301,799,546,253,712220.45,329412.96,1041633.41
354950,202301,213,130,83,169264.97,108068.8,277333.77
354960,202301,132,47,85,61195.06,110671.42,171866.48
354970,202301,1240,861,379,1122364.44,493459.13,1615823.57
354980,202301,10197,3670,6527,4781100.31,8503426.6,13284526.91
354990,202301,11282,4951,6331,6451569.88,8248216.38,14699786.26
354995,202301,634,211,423,274725.84,553359.66,828085.50
355000,202301,468,161,307,209624.61,399714.7,609339.31
355010,202301,705,439,266,571616.52,347642.43,919258.95
355020,202301,857,521,336,678359.43,438782.28,1117141.71
355030,202301,231238,85393,145845,111237139.83,190013590.11,301250729.94
355040,202301,1067,508,559,661439.84,727827.85,1389267.69
355050,202301,189,102,87,132805.85,113274,246079.85
355060,202301,1955,903,1052,1175756.63,1371015.34,2546771.97
355070,202301,1755,759,996,988237.87,1296809.41,2285047.28
355080,202301,212,128,84,166658.22,109369.08,276027.30
355090,202301,329,206,123,268224.58,160149.03,428373.61
355100,202301,5957,2740,3217,3568797.09,4191175.53,7759972.62
355110,202301,222,144,78,188790.92,101556.97,290347.89
355120,202301,53,33,20,42967.45,26040,69007.45
355130,202301,54,29,25,37759.22,32550,70309.22
355140,202301,215,122,93,158848.21,122388.43,281236.64
355150,202301,759,450,309,585922.57,403623.87,989546.44
355160,202301,522,248,274,322910.85,359359.58,682270.43
355170,202301,2208,1120,1088,1459601.57,1416589.9,2876191.47
355180,202301,731,285,446,371078.21,580699.87,951778.08
355190,202301,231,154,77,200518.45,101558.12,302076.57
355200,202301,116,56,60,74215.58,78120.6,152336.18
355210,202301,746,385,361,501277.33,470149.48,971426.81
355220,202301,8427,3959,4468,5158684.18,5825200.21,10983884.39
355230,202301,96,51,45,66403.5,58591.87,124995.37
355240,202301,4948,1944,3004,2532409.62,3916437.35,6448846.97
355250,202301,7638,3342,4296,4354052.08,5597319.34,9951371.42
355255,202301,50,31,19,40362,24738,65100
355260,202301,201,110,91,143224.94,118484.26,261709.20
355270,202301,165,107,58,139318.94,75516.98,214835.92
355280,202301,7717,2863,4854,3727730.25,6321298.06,10049028.31
355290,202301,67,51,16,66402.2,20832,87234.2
355300,202301,235,132,103,171867.39,134106.97,305974.36
355310,202301,113,62,51,80724.6,66402,147126.6
355320,202301,107,53,54,69006.6,70308.96,139315.56
355330,202301,341,197,144,256502.7,187491.4,443994.1
355340,202301,1399,509,890,662754.07,1158825.63,1821579.70
355350,202301,171,80,91,104160,118482.3,222642.3
355360,202301,191,126,65,164060.62,84631.39,248692.01
355365,202301,18,13,5,16926,6510,23436
355370,202301,1087,626,461,815087.04,600227.11,1415314.15
355380,202301,862,517,345,673165.96,449199.65,1122365.61
355385,202301,98,62,36,80724.2,46872,127596.2
355390,202301,107,56,51,72912.96,66402.8,139315.76
355395,202301,204,101,103,131506.8,134110.09,265616.89
355400,202301,1913,1068,845,1390467.71,1101494.87,2491962.58
355410,202301,5560,2471,3089,3218642.91,4023197.23,7241840.14
355420,202301,45,31,14,40362.8,18228,58590.8
355430,202301,462,270,192,351556.94,249991.76,601548.70
355440,202301,92,51,41,67704.65,53383.43,121088.08
355450,202301,477,246,231,320303.6,300764.23,621067.83
355460,202301,57,42,15,54684.4,19530.8,74215.2
355465,202301,51,28,23,36456.09,29946,66402.09
355470,202301,195,75,120,97652.73,156241.78,253894.51
355475,202301,8,5,3,6510.21,3906,10416.21
355480,202301,679,272,407,354158.26,529920.08,884078.34
355490,202301,109,78,31,101563.16,40364.07,141927.23
355495,202301,107,40,67,52080.1,87234.91,139315.01
355500,202301,1663,893,770,1162718.16,1002546.44,2165264.60
355510,202301,283,197,86,256509.08,111974.25,368483.33
355520,202301,28,19,9,24738.18,11718,36456.18
355530,202301,25,13,12,16926,15624,32550
355535,202301,83,40,43,52082.19,55986,108068.19
355540,202301,3042,1196,1846,1558542.8,2406147.23,3964690.03
355550,202301,70,39,31,50778,40362,91140
355560,202301,274,122,152,158847.75,197906.71,356754.46
355570,202301,16,12,4,15624.32,5208,20832.32
355580,202301,241,160,81,209627.66,105464.76,315092.42
355590,202301,17,11,6,14322.2,7812,22134.2
355600,202301,288,137,151,179681.57,196604.93,376286.50
355610,202301,252,150,102,195304.93,132808.68,328113.61
355620,202301,1370,574,796,748666.59,1036394.22,1785060.81
355630,202301,433,308,125,402333.13,164053.11,566386.24
355635,202301,135,54,81,70308.19,105462,175770.19
355640,202301,623,334,289,434875.03,376283.69,811158.72
355645,202301,934,336,598,437484.73,779907.63,1217392.36
355650,202301,1960,845,1115,1100227.07,1451732.12,2551959.19
355660,202301,228,115,113,151034.14,147127.61,298161.75
355670,202301,707,299,408,389301.21,532520.49,921821.70
355680,202301,217,117,100,152341.33,130204.91,282546.24
355690,202301,98,47,51,61194.86,66402,127596.86
355695,202301,25,15,10,19530,13020,32550
355700,202301,1307,633,674,825493.94,881460.97,1706954.91
355710,202301,2412,1323,1089,1722617.89,1419184.5,3141802.39
355715,202301,16,13,3,16926,3906.1,20832.1
355720,202301,272,164,108,214834.04,140617.39,355451.43
355730,202301,109,62,47,80724.03,61194.15,141918.18
410010,202301,107,85,22,110672.92,28644,139316.92
410020,202301,123,86,37,111973.49,48174.2,160147.69
410030,202301,188,105,83,136713.81,108069.41,244783.22
410040,202301,1471,700,771,911417.04,1003858.01,1915275.05
410045,202301,45,33,12,42966.55,15624,58590.55
410050,202301,544,316,228,411436.05,298159.44,709595.49
410060,202301,220,159,61,207023.07,79422.5,286445.57
410070,202301,304,250,54,325508.64,70309.05,395817.69
410080,202301,189,117,72,152335.66,95046,247381.66
410090,202301,54,46,8,59895.28,10416,70311.28
410100,202301,265,168,97,218738.06,127596.1,346334.16
410105,202301,45,27,18,35154,23436,58590
410110,202301,370,224,146,291661.31,190098.38,481759.69
410115,202301,49,28,21,36456,27342.2,63798.2
410120,202301,493,225,268,292958.45,348939.26,641897.71
410130,202301,67,37,30,48174,39060.39,87234.39
410140,202301,3405,1531,1874,1993402.79,2441274.39,4434677.18
410150,202301,2782,1109,1673,1443947.17,2178265.09,3622212.26
410160,202301,507,291,216,380190.19,282537.38,662727.57
410165,202301,58,37,21,48174.41,27342,75516.41
410170,202301,223,126,97,164053.57,126294.31,290347.88
410180,202301,2516,1311,1205,1709577.71,1568938.42,3278516.13
410185,202301,37,31,6,40362,7812,48174
410190,202301,510,327,183,425761.73,238266.9,664028.63
410200,202301,1102,776,326,1011669.7,424456.09,1436125.79
410210,202301,675,348,327,453106.69,425755.55,878862.24
410220,202301,49,20,29,26040.7,37758,63798.7
410230,202301,205,88,117,114576.77,152337.26,266914.03
410240,202301,746,480,266,624981.54,347637.41,972618.95
410250,202301,396,268,128,348940.25,166658.22,515598.47
410260,202301,313,173,140,225252.56,182282.98,407535.54
410270,202301,29,20,9,26040.63,11718,37758.63
410275,202301,63,44,19,57288.87,24738,82026.87
410280,202301,337,199,138,260409.65,179676.2,440085.85
410290,202301,274,152,122,199210.31,158845.31,358055.62
410300,202301,91,56,35,72912,45570,118482
410302,202301,27,14,13,18228.6,16926,35154.6
410304,202301,45,31,14,40364.02,18228,58592.02
410305,202301,218,131,87,170565.29,113274.98,283840.27
410310,202301,190,111,79,144524.23,102860.81,247385.04
410315,202301,38,30,8,39060.2,10416,49476.2
410320,202301,146,100,46,130201.47,59892,190093.47
410322,202301,37,22,15,29946.15,19530,49476.15
410330,202301,179,114,65,148430.75,84630,233060.75
410335,202301,107,58,49,75516,63798,139314
410337,202301,47,37,10,48174.5,13020,61194.5
410340,202301,37,30,7,39060.74,9114,48174.74
410345,202301,207,127,80,165354.98,104161.01,269515.99
410347,202301,43,31,12,40363.29,15624.5,55987.79
410350,202301,255,147,108,191399.6,140616,332015.6
410360,202301,458,282,176,367177.32,230456.3,597633.62
410370,202301,2441,1047,1394,1363226.51,1820213.59,3183440.10
410380,202301,207,115,92,149732.85,119784.52,269517.37
410390,202301,425,267,158,347638.28,205716.78,553355.06
410395,202301,32,20,12,26041,15624.46,41665.46
410400,202301,972,397,575,518210.64,748657.42,1266868.06
410405,202301,81,59,22,76821.03,28645.68,105466.71
410410,202301,26,17,9,22135.36,11718,33853.36
410420,202301,1912,843,1069,1097492.19,1393158.44,2490650.63
410425,202301,209,84,125,109370.42,162750.2,272120.62
410430,202301,2550,1307,1243,1703046.57,1618404.77,3321451.34
410440,202301,365,254,111,330709.45,144524.19,475233.64
410442,202301,364,231,133,300768.52,174469.6,475238.12
410445,202301,359,244,115,317696.06,151032.64,468728.70
410450,202301,407,191,216,249988.14,281232.07,531220.21
410460,202301,589,314,275,408831.76,358052.01,766883.77
410465,202301,282,153,129,199208.25,167958.89,367167.14
410470,202301,249,141,108,183585.62,140618.03,324203.65
410480,202301,7038,3374,3664,4394363.73,4775794.75,9170158.48
410490,202301,1491,811,680,1058375.67,887974.85,1946350.52
410500,202301,279,163,116,212228.8,151032.5,363261.3
410510,202301,205,152,53,197909.76,69007.84,266917.60
410520,202301,282,199,83,259098.69,108066,367164.69
410530,202301,282,85,197,110670,257796,368466
410540,202301,381,275,106,358054.63,138013.21,496067.84
410550,202301,1770,740,1030,963494.93,1346279.72,2309774.65
410560,202301,189,122,67,158848.08,87234.83,246082.91
410570,202301,454,298,156,388001.04,203114.18,591115.22
410580,202301,4052,1676,2376,2183113.39,3101418.44,5284531.83
410590,202301,446,285,161,371059.88,209622.2,580682.08
410600,202301,101,86,15,111972.65,19530,131502.65
410610,202301,62,49,13,63799.05,16926,80725.05
410620,202301,290,182,108,236969.89,140617.25,377587.14
410630,202301,480,264,216,343730.38,281233.29,624963.67
410640,202301,1195,736,459,958282.65,597621.74,1555904.39
410645,202301,116,86,30,111975.94,39060.2,151036.14
410650,202301,389,238,151,309879.83,196605.07,506484.90
410655,202301,89,66,23,85932.35,29946.08,115878.43
410657,202301,35,14,21,18228,27342,45570
410660,202301,692,471,221,614558.83,289048.24,903607.07
410670,202301,78,63,15,82026.49,19530.13,101556.62
410680,202301,195,154,41,200510.47,53382,253892.47
410685,202301,35,24,11,31248,14322,45570
410690,202301,30912,12566,18346,16369099.52,23905013.47,40274112.99
410700,202301,339,244,95,317971.44,124992.97,442964.41
410710,202301,127,106,21,138013.32,27342.2,165355.52
410712,202301,41,28,13,36456.2,16926,53382.2
410715,202301,107,77,30,100256.22,39060,139316.22
410720,202301,677,375,302,488257.41,395808.85,884066.26
410725,202301,202,136,66,177073.99,85932,263005.99
410730,202301,109,43,66,57288.79,85932,143220.79
410740,202301,78,58,20,75517.4,26040,101557.4
410750,202301,302,194,108,252590.44,141918,394508.44
410752,202301,22,16,6,20832.14,7812,28644.14
410753,202301,62,20,42,26040,54684,80724
410754,202301,57,28,29,36458.24,37758,74216.24
410755,202301,84,42,42,54684.2,54684,109368.2
410760,202301,802,431,371,561166.56,483045.25,1044211.81
410765,202301,2085,932,1153,1213502.41,1501233.36,2714735.77
410770,202301,122,82,40,106765.21,52082.91,158848.12
410773,202301,70,46,24,59893.05,31248,91141.05
410775,202301,206,146,60,190096.23,78120,268216.23
410780,202301,84,46,38,59892.81,49476,109368.81
410785,202301,57,48,9,62496.72,11718,74214.72
410790,202301,82,34,48,44268.2,62496,106764.2
410800,202301,296,183,113,238276.47,147127.44,385403.91
410810,202301,28,17,11,22134.69,14322.9,36457.59
410820,202301,152,108,44,140618.54,57288.9,197907.44
410830,202301,9978,4020,5958,5240689.83,7761313.59,13002003.42
410832,202301,113,71,42,92443.11,54684.8,147127.91
410840,202301,1496,801,695,1044226.01,906196.28,1950422.29
410845,202301,60,30,30,39060.47,39060.89,78121.36
410850,202301,153,109,44,141923.16,57288,199211.16
410855,202301,80,73,7,95047.04,9114,104161.04
410860,202301,906,443,463,578094.93,602830.18,1180925.11
410865,202301,94,66,28,85934.24,36456,122390.24
410870,202301,146,120,26,156242.76,33852.07,190094.83
410880,202301,1239,596,643,776008.22,839797.66,1615805.88
410890,202301,117,72,45,93744.8,58590,152334.8
410895,202301,80,61,19,79423.23,24738.95,104162.18
410900,202301,30,25,5,32550.67,6510,39060.67
410910,202301,12,7,5,9114.95,6510,15624.95
410920,202301,47,29,18,37758,23436,61194
410930,202301,578,345,233,449192.02,304669.19,753861.21
410940,202301,4716,2378,2338,3098863.69,3045424.74,6144288.43
410950,202301,100,75,25,97652.08,32550,130202.08
410960,202301,1023,384,639,499981.43,831991.58,1331973.01
410965,202301,66,45,21,58590.2,27342,85932.2
410970,202301,629,412,217,539034.77,282535.67,821570.44
410975,202301,124,75,49,97652.69,63798,161450.69
410980,202301,1681,758,923,986941.94,1201758.3,2188700.24
410990,202301,286,203,83,264307.56,108066.98,372374.54
411000,202301,62,34,28,44268.73,36458.23,80726.96
411005,202301,38,31,7,40362,9114,49476
411007,202301,261,151,110,196602.47,143220,339822.47
411010,202301,633,397,236,516906.37,307274.53,824180.90
411020,202301,290,180,110,234364.24,143221.51,377585.75
411030,202301,25,13,12,16926,15624,32550
411040,202301,64,41,23,53382,29946,83328
411050,202301,221,150,71,196603.59,92442.03,289045.62
411060,202301,562,382,180,497370.31,234362.78,731733.09
411065,202301,40,36,4,46872.84,5208,52080.84
411070,202301,1324,743,581,967400.83,757769.88,1725170.71
411080,202301,260,171,89,222642.93,115878.2,338521.13
411090,202301,88,63,25,82026.9,32550.96,114577.86
411095,202301,368,119,249,154938.87,324198.37,479137.24
411100,202301,112,87,25,113275.66,32550,145825.66
411110,202301,159,83,76,108066.56,98952.2,207018.76
411120,202301,218,139,79,182283.96,102858,285141.96
411125,202301,370,178,192,231763.1,251291.13,483054.23
411130,202301,125,105,20,136713.5,26040,162753.5
411140,202301,213,143,70,187488.19,91140,278628.19
411150,202301,1293,821,472,1068959.73,614548.65,1683508.38
411155,202301,121,82,39,106764,50778,157542
411160,202301,35,15,20,19530,26040,45570
411170,202301,57,48,9,62496,13020,75516
411180,202301,1071,695,376,904914.25,492163.92,1397078.17
411190,202301,364,207,157,270819.31,204414,475233.31
411200,202301,702,377,325,490866.78,423152.58,914019.36
411210,202301,700,352,348,458308.61,454399.27,912707.88
411220,202301,164,114,50,148431.05,65101.25,213532.30
411230,202301,36,29,7,37758.04,9114.1,46872.14
411240,202301,113,72,41,93746.27,53382,147128.27
411250,202301,436,309,127,403622.65,165354,568976.65
411260,202301,12,9,3,11718.8,3906,15624.8
411270,202301,275,145,130,188795.38,169262.3,358057.68
411275,202301,197,162,35,210926.24,45570,256496.24
411280,202301,285,190,95,247383.82,124992,372375.82
411290,202301,70,52,18,67704,23436,91140
411295,202301,131,97,34,127597.59,44268.46,171866.05
411300,202301,85,39,46,50778.05,59892,110670.05
411310,202301,96,67,29,87234.2,37758,124992.2
411320,202301,871,528,343,687465.16,446588.19,1134053.35
411325,202301,63,43,20,55986.1,26040,82026.1
411330,202301,991,629,362,820282.78,471326.93,1291609.71
411340,202301,35,22,13,28644,16926.09,45570.09
411342,202301,63,48,15,62496,19530,82026
411345,202301,103,51,52,66404.66,67704.95,134109.61
411350,202301,542,402,140,523413.03,182282.42,705695.45
411360,202301,60,39,21,50779.85,27344,78123.85
411370,202301,14275,5804,8471,7562217.75,11038468.05,18600685.80
411373,202301,187,125,62,164052,80724.17,244776.17
411375,202301,84,68,16,88537.72,20832,109369.72
411380,202301,78,52,26,67705.65,33852,101557.65
411390,202301,163,85,78,110670.39,101556,212226.39
411400,202301,371,235,136,305977.03,177072,483049.03
411410,202301,557,263,294,342431.33,382790.23,725221.56
411420,202301,1008,419,589,545547.72,768184.89,1313732.61
411430,202301,571,298,273,389314.82,355454.67,744769.49
411435,202301,27,20,7,26040.63,9114,35154.63
411440,202301,503,396,107,516899.72,139314,656213.72
411450,202301,405,327,78,425761.84,101556.09,527317.93
411460,202301,858,320,538,416649.14,700481.11,1117130.25
411470,202301,114,80,34,104164.43,44268,148432.43
411480,202301,755,375,380,489565.36,496064.18,985629.54
411490,202301,292,180,112,234362.86,145824.2,380187.06
411500,202301,111,87,24,113274.97,31248,144522.97
411510,202301,235,179,56,233063.26,72913.19,305976.45
411520,202301,6682,2213,4469,2882681.62,5823886.8,8706568.42
411530,202301,127,83,44,108066.66,57288,165354.66
411535,202301,49,14,35,18228.1,45570,63798.1
411540,202301,397,259,138,337223.15,179678.83,516901.98
411545,202301,58,41,17,53382.39,22134,75516.39
411550,202301,88,68,20,88536.81,26040,114576.81
411560,202301,407,170,237,221342.84,308574.15,529916.99
411570,202301,1092,354,738,460916.58,963490.92,1424407.50
411573,202301,26,15,11,19530.2,14322,33852.2
411575,202301,327,202,125,263008.07,162750,425758.07
411580,202301,1323,456,867,593719.32,1130143,1723862.32
411585,202301,74,35,39,45570,50778,96348
411590,202301,13,7,6,9114,7812,16926
411600,202301,16,8,8,10416.2,10416.7,20832.9
411605,202301,177,69,108,89839.68,140616,230455.68
411610,202301,245,148,97,192699.11,126294.2,318993.31
411620,202301,393,189,204,246085.33,266916.59,513001.92
411630,202301,52,34,18,44268.15,23436.99,67705.14
411640,202301,32,22,10,28644.68,13020,41664.68
411650,202301,6,4,2,5208,2604,7812
411660,202301,47,35,12,45570,15624,61194
411670,202301,242,164,78,213530.69,101556.2,315086.89
411680,202301,163,126,37,165355.33,48174,213529.33
411690,202301,731,380,351,494764.35,457004.73,951769.08
411695,202301,66,44,22,57288.2,28644,85932.2
411700,202301,145,114,31,148430.63,40362,188792.63
411705,202301,101,68,33,88536.86,42966.3,131503.16
411710,202301,296,199,97,259101.62,126295.07,385396.69
411720,202301,156,101,55,132804.96,71610.2,204415.16
411721,202301,95,70,25,91140.2,32550.2,123690.4
411722,202301,104,50,54,65100.2,70308,135408.2
411725,202301,168,117,51,153636.2,66402,220038.2
411727,202301,106,83,23,108068.81,29946.55,138015.36
411729,202301,53,40,13,52080.4,16926,69006.4
411730,202301,584,364,220,475233.98,286442.55,761676.53
411740,202301,25,14,11,18228.53,14322.12,32550.65
411745,202301,74,54,20,70308,26040,96348
411750,202301,884,359,525,467426.96,686159.07,1153586.03
411760,202301,1331,952,379,1240845.22,493466.98,1734312.20
411770,202301,437,279,158,364563.14,205718.52,570281.66
411780,202301,382,247,135,321595.4,175770.21,497365.61
411790,202301,619,342,277,445292.28,360654,805946.28
411800,202301,169,119,50,154941.73,66402.38,221344.11
411810,202301,189,145,44,188792.73,57288.79,246081.52
411820,202301,2744,1084,1660,1411429.23,2162671.55,3574100.78
411830,202301,21,14,7,18228,9114.6,27342.6
411840,202301,2324,1342,982,1747318.67,1281188.02,3028506.69
411845,202301,67,22,45,28644.9,58590,87234.9
411850,202301,1330,705,625,917930.87,815061.16,1732992.03
411860,202301,63,38,25,49476.54,32550,82026.54
411870,202301,77,48,29,62496,37758,100254
411880,202301,432,256,176,333320.13,229152.74,562472.87
411885,202301,112,71,41,92443.37,53383.56,145826.93
411890,202301,351,247,104,321598.39,135409.68,457008.07
411900,202301,111,81,30,105463.11,39060,144523.11
411910,202301,223,145,78,188794.87,101558.04,290352.91
411915,202301,2589,995,1594,1295525.66,2080630.93,3376156.59
411920,202301,116,85,31,111973.23,40362.98,152336.21
411925,202301,19,12,7,15624.59,9114,24738.59
411930,202301,826,552,274,721411.72,356752.7,1078164.42
411940,202301,607,380,227,494770.03,295556.57,790326.60
411950,202301,1313,580,733,755186.12,954385.37,1709571.49
411960,202301,1203,734,469,955678.28,611941.45,1567619.73
411965,202301,23,14,9,18228.97,11718,29946.97
411970,202301,93,79,14,102859.37,18228,121087.37
411980,202301,239,123,116,160146,151032,311178
411990,202301,5618,2950,2668,3846185.36,3480404.21,7326589.57
411995,202301,664,197,467,256499.89,608049.96,864549.85
412000,202301,347,233,114,303376.19,148431.68,451807.87
412010,202301,67,34,33,44268.9,42966.71,87235.61
412015,202301,36,26,10,33852,13020,46872
412020,202301,24,19,5,24740.57,6510,31250.57
412030,202301,39,34,5,44268.72,6510,50778.72
412033,202301,44,23,21,29946.79,27342,57288.79
412035,202301,69,44,25,57288,32550,89838
412040,202301,32,15,17,19530.6,22134,41664.6
412050,202301,220,160,60,208326.42,78120.56,286446.98
412060,202301,827,589,238,768201.04,309879.77,1078080.81
412065,202301,58,29,29,37758.81,37758.15,75516.96
412070,202301,146,101,45,131503.4,58591.1,190094.5
412080,202301,360,176,184,229157.16,239571.38,468728.54
412085,202301,39,14,25,18228.2,32550,50778.2
412090,202301,895,540,355,703097.87,462212.01,1165309.88
412100,202301,268,221,47,289055.72,61194,350249.72
412110,202301,75,55,20,71611,26040,97651
412120,202301,376,198,178,257801.1,231760.11,489561.21
412125,202301,71,40,31,52080.2,40362,92442.2
412130,202301,49,30,19,39061.17,24738,63799.17
412135,202301,28,17,11,22134.2,14322,36456.2
412140,202301,471,303,168,394510.52,218737.83,613248.35
412150,202301,258,156,102,203113.43,132804,335917.43
412160,202301,74,48,26,62497.23,33852,96349.23
412170,202301,733,471,262,613246.86,341126.18,954373.04
412175,202301,37,24,13,31248.2,16926.08,48174.28
412180,202301,162,119,43,154940.89,55986.2,210927.09
412190,202301,337,263,74,342430.77,96348,438778.77
412200,202301,193,114,79,148429.9,102858,251287.9
412210,202301,98,72,26,95046,33853.64,128899.64
412215,202301,243,163,80,212228.58,104161.16,316389.74
412217,202301,63,48,15,62497.15,19530,82027.15
412220,202301,895,573,322,746071.24,419250.96,1165322.20
412230,202301,289,170,119,221345.61,154942.49,376288.10
412240,202301,1436,706,730,919238.64,951771.78,1871010.42
412250,202301,432,261,171,339825.17,223944,563769.17
412260,202301,131,85,46,110671.61,59892.2,170563.81
412265,202301,168,128,40,166656.83,52080,218736.83
412270,202301,99,60,39,78121.95,50778,128899.95
412280,202301,84,64,20,83328.2,26040,109368.2
412290,202301,92,58,34,75517.24,44268,119785.24
412300,202301,213,151,62,196603.42,82026,278629.42
412310,202301,58,45,13,58590.57,16926,75516.57
412320,202301,93,68,25,88540.12,32550,121090.12
412330,202301,207,156,51,203113.29,66402,269515.29
412340,202301,182,117,65,152335.65,84630,236965.65
412350,202301,710,316,394,412737.64,512990.15,925727.79
412360,202301,23,18,5,23436,6510,29946
412370,202301,146,120,26,156242.85,33852,190094.85
412380,202301,191,142,49,184886.26,63798.3,248684.56
412382,202301,58,32,26,41664,33852,75516
412385,202301,162,115,47,149733.28,61194,210927.28
412390,202301,334,251,83,326809.47,108067.81,434877.28
412395,202301,67,55,12,71610.22,15624,87234.22
412400,202301,102,67,35,87235.75,45570,132805.75
412402,202301,244,134,110,174470.35,143220,317690.35
412405,202301,1000,329,671,428360.1,873644.14,1302004.24
412410,202301,1039,612,427,796858.24,555960.6,1352818.84
412420,202301,17,16,1,20832,1302,22134
412430,202301,27,25,2,32551.44,2604.2,35155.64
412440,202301,708,358,350,466122.97,455701.51,921824.48
412450,202301,66,58,8,75517.66,10416,85933.66
412460,202301,79,55,24,71611.49,32550.19,104161.68
412470,202301,235,184,51,239570.45,66402.24,305972.69
412480,202301,160,117,43,152335.6,57288.2,209623.8
412490,202301,177,147,30,191396.37,39060,230456.37
412500,202301,411,318,93,414046.79,121086.86,535133.65
412510,202301,171,141,30,183583.77,39060,222643.77
412520,202301,90,59,31,76818,40362,117180
412530,202301,112,51,61,66402.5,79422,145824.5
412535,202301,68,53,15,69007.92,19530,88537.92
412540,202301,51,29,22,37758.96,28644.82,66403.78
412545,202301,86,59,27,76819.34,35154,111973.34
412550,202301,4438,1775,2663,2313731.77,3471197.48,5784929.25
412555,202301,12,7,5,9114,6510,15624
412560,202301,725,465,260,605438.87,338521.97,943960.84
412570,202301,878,388,490,505185.68,640587.09,1145772.77
412575,202301,102,72,30,94874.25,39060,133934.25
412580,202301,182,120,62,156247.82,80726.07,236973.89
412590,202301,32,28,4,36456.9,5208,41664.9
412600,202301,216,153,63,199211.31,82026.83,281238.14
412610,202301,43,20,23,26040.2,29946,55986.2
412620,202301,130,106,24,138014.76,31248.46,169263.22
412625,202301,2235,1059,1176,1380147.39,1535068.26,2915215.65
412627,202301,65,48,17,62496.42,22134,84630.42
412630,202301,381,257,124,334623.69,161448.48,496072.17
412635,202301,79,24,55,31248,71610,102858
412640,202301,112,79,33,102858.2,42966,145824.2
412650,202301,323,211,112,274727.5,145824.89,420552.39
412660,202301,590,313,277,407528.99,360654.55,768183.54
412665,202301,41,37,4,48174.18,5208,53382.18
412667,202301,270,168,102,218739.34,132804,351543.34
412670,202301,82,62,20,80724.04,26040,106764.04
412680,202301,340,256,84,333321.78,110670.08,443991.86
412690,202301,133,85,48,110672.69,63798,174470.69
412700,202301,191,120,71,156240.13,92442.23,248682.36
412710,202301,1422,780,642,1015577.07,837196.1,1852773.17
412720,202301,246,135,111,175771.53,144522.69,320294.22
412730,202301,218,186,32,242176.27,41664.99,283841.26
412740,202301,416,201,215,261707.09,279930.41,541637.50
412750,202301,420,234,186,304674.35,242172.56,546846.91
412760,202301,381,191,190,248688.1,247384.37,496072.47
412770,202301,2225,1185,1040,1542897.21,1354086.77,2896983.98
412780,202301,148,101,47,131504.59,61194,192698.59
412785,202301,333,172,161,223946.14,209622.02,433568.16
412788,202301,53,29,24,37759.27,31248,69007.27
412790,202301,128,103,25,134109.49,32550,166659.49
412795,202301,147,99,48,128900.22,62496,191396.22
412796,202301,313,198,115,257798.33,149730,407528.33
412800,202301,743,414,329,539031.63,428358,967389.63
412810,202301,3244,1762,1482,2294191.61,1930891.03,4225082.64
412820,202301,1070,614,456,800752.23,593726.08,1394478.31
412830,202301,14,13,1,16926.2,1302,18228.2
412840,202301,289,193,96,252589.81,124992.2,377582.01
412850,202301,591,389,202,506484.21,263004.68,769488.89
412853,202301,174,78,96,101556.26,124992,226548.26
412855,202301,209,113,96,147128.91,124992.73,272121.64
412860,202301,99,67,32,87235.98,41665.33,128901.31
412862,202301,82,51,31,66402,40362,106764
412863,202301,8,5,3,6510,3906,10416
412865,202301,47,37,10,48174,13020,61194
412870,202301,118,74,44,96350.97,57288.61,153639.58
412880,202301,97,65,32,84632.56,41664,126296.56
420005,202301,43,36,7,46872.7,9114,55986.7
420010,202301,375,243,132,316392.14,171864.39,488256.53
420020,202301,102,77,25,100254.79,32550,132804.79
420030,202301,29,23,6,29946.2,7812,37758.2
420040,202301,95,73,22,95048.74,28644.2,123692.94
420050,202301,53,33,20,42966.91,26040,69006.91
420055,202301,18,16,2,20832.29,2604,23436.29
420060,202301,27,19,8,24738.2,10416.2,35154.4
420070,202301,105,90,15,117180.38,19530,136710.38
420075,202301,10,10,0,13020,,13020.0
420080,202301,40,34,6,44269.06,7812,52081.06
420090,202301,40,31,9,40362.66,11718.29,52080.95
420100,202301,167,142,25,184887.4,32550,217437.4
420110,202301,25,24,1,31248,1302,32550
420120,202301,62,45,17,58590.31,22134,80724.31
420125,202301,83,62,21,80724.6,27342,108066.6
420127,202301,38,32,6,41664,7812,49476
420130,202301,513,309,204,402329.43,266916.77,669246.20
420140,202301,1435,800,635,1041629.18,828091.78,1869720.96
420150,202301,51,37,14,48174,18228,66402
420160,202301,33,29,4,37758.82,5208,42966.82
420165,202301,19,14,5,18228.87,6510,24738.87
420170,202301,71,41,30,53382.78,39060,92442.78
420180,202301,24,20,4,26040,5208,31248
420190,202301,27,23,4,29946.18,5208,35154.18
420195,202301,136,62,74,80728.46,96351.28,177079.74
420200,202301,1448,601,847,782525.75,1105417.11,1887942.86
420205,202301,126,75,51,97653.41,66402.4,164055.81
420207,202301,154,87,67,113277.27,87235.38,200512.65
420208,202301,19,15,4,19530.21,5208,24738.21
420209,202301,12,10,2,13020,2604,15624
420210,202301,625,294,331,382800.23,432268.01,815068.24
420213,202301,55,38,17,49476.69,22134,71610.69
420215,202301,28,23,5,29946.45,6510,36456.45
420220,202301,61,38,23,49476.6,29946,79422.6
420230,202301,1063,634,429,825500.87,558565.14,1384066.01
420240,202301,2423,1588,835,2067608,1087176.99,3154784.99
420243,202301,46,37,9,48174.69,11718,59892.69
420245,202301,230,110,120,143225.73,156243.66,299469.39
420250,202301,61,43,18,55987.12,23436,79423.12
420253,202301,23,17,6,22135.72,7812,29947.72
420257,202301,16,10,6,13020,7812,20832
420260,202301,126,101,25,131504.19,32550.14,164054.33
420270,202301,35,25,10,32550.19,13020,45570.19
420280,202301,301,223,78,291664.93,101556.98,393221.91
420285,202301,25,20,5,26040,6510,32550
420287,202301,46,29,17,37759.72,22134,59893.72
420290,202301,983,662,321,861934.74,419245.02,1281179.76
420300,202301,1674,1332,342,1734327.95,445290.4,2179618.35
420310,202301,44,32,12,41664.2,15624,57288.2
420315,202301,26,21,5,27342.78,6510.74,33853.52
420320,202301,1090,516,574,671851.8,747359.84,1419211.64
420325,202301,6,4,2,5208,2604.8,7812.8
420330,202301,119,79,40,102858.54,52080.62,154939.16
420340,202301,197,133,64,173168.49,83328,256496.49
420350,202301,265,188,77,244783.47,100255.19,345038.66
420360,202301,707,540,167,703103.22,217437.63,920540.85
420370,202301,143,77,66,100256.3,85932.43,186188.73
420380,202301,1281,859,422,1118452.24,549449.92,1667902.16
420390,202301,230,163,67,212229.21,87234.4,299463.61
420395,202301,196,142,54,184895.62,71612.59,256508.21
420400,202301,229,175,54,227853.65,70308.2,298161.85
420410,202301,55,41,14,53383.63,18228,71611.63
420415,202301,32,26,6,33853.76,7812,41665.76
420417,202301,63,50,13,65100.01,16926,82026.01
420419,202301,11,10,1,13020,1302,14322
420420,202301,3039,1872,1167,2438707.23,1520750.28,3959457.51
420425,202301,73,52,21,67706.99,27342,95048.99
420430,202301,1055,757,298,988228.33,387997.92,1376226.25
420435,202301,14,11,3,14322,3906,18228
420440,202301,90,65,25,84632.26,32550,117182.26
420445,202301,31,28,3,36456.9,3906,40362.9
420450,202301,81,46,35,59894.09,45570,105464.09
420455,202301,178,135,43,177076.3,57288,234364.3
420460,202301,2482,1539,943,2005153.29,1231701.92,3236855.21
420470,202301,85,54,31,70308.2,40362.69,110670.89
420475,202301,10,9,1,11718,1302,13020
420480,202301,909,691,218,899719.65,285139.34,1184858.99
420490,202301,101,75,26,97653.14,33852,131505.14
420500,202301,402,239,163,311186.61,212227.06,523413.67
420510,202301,26,22,4,28644.84,5208,33852.84
420515,202301,26,14,12,18228.02,15624,33852.02
420517,202301,12,9,3,11718.91,3906,15624.91
420519,202301,2,2,0,2604,,2604.0
420520,202301,62,46,16,59893.84,20832.2,80726.04
420530,202301,144,92,52,119785.48,67704.2,187489.68
420535,202301,16,13,3,16926.91,3906,20832.91
420540,202301,6897,4273,2624,5571754.13,3416487.94,8988242.07
420543,202301,30,29,1,37760.09,1302,39062.09
420545,202301,220,151,69,196607.61,89838,286445.61
420550,202301,807,676,131,880180.92,171866.99,1052047.91
420555,202301,33,24,9,31248.5,11718,42966.5
420560,202301,66,51,15,66403.34,19530,85933.34
420570,202301,230,108,122,140620.36,158847.36,299467.72
420580,202301,327,162,165,210928.25,214831.53,425759.78
420590,202301,503,316,187,411437.83,243474.82,654912.65
420600,202301,157,86,71,111973.07,93744,205717.07
420610,202301,37,34,3,44268.8,3906,48174.8
420620,202301,77,56,21,72913.59,27342.41,100256.00
420630,202301,161,108,53,140619.04,69006,209625.04
420640,202301,73,62,11,80724,14322,95046
420650,202301,328,167,161,217438,209624,427062
420660,202301,39,29,10,37758.45,13020,50778.45
420665,202301,46,30,16,39060.2,20832,59892.2
420670,202301,238,183,55,238273.66,72912,311185.66
420675,202301,15,12,3,15624,3906,19530
420680,202301,34,29,5,37758.12,6510,44268.12
420690,202301,198,149,49,193999.41,63798.34,257797.75
420700,202301,741,481,260,626279.33,339827.28,966106.61
420710,202301,148,79,69,102860.28,89839.53,192699.81
420720,202301,94,77,17,100257.01,22134.97,122391.98
420730,202301,745,440,305,572894.89,397117.57,970012.46
420740,202301,58,57,1,74215.06,1302,75517.06
420750,202301,505,329,176,428360.15,229153.56,657513.71
420757,202301,19,16,3,20832,3906,24738
420760,202301,40,28,12,36456.36,15624,52080.36
420765,202301,76,53,23,69006.7,29946,98952.7
420768,202301,60,47,13,61196.11,16926,78122.11
420770,202301,70,60,10,78122.53,13020,91142.53
420775,202301,35,31,4,40363.45,5208,45571.45
420780,202301,198,154,44,200511.16,57288,257799.16
420785,202301,26,17,9,22134,11718,33852
420790,202301,137,112,25,145824.86,32550.09,178374.95
420800,202301,63,48,15,62496.98,19530,82026.98
420810,202301,290,222,68,289054.73,88536,377590.73
420820,202301,2743,1507,1236,1963466.53,1609293.02,3572759.55
420830,202301,736,390,346,507801.28,453109.79,960911.07
420840,202301,133,91,42,118482.45,54684.2,173166.65
420845,202301,459,198,261,257801.41,339825.73,597627.14
420850,202301,275,213,62,277329.59,80724.3,358053.89
420860,202301,59,50,9,65101.71,11718,76819.71
420870,202301,130,91,39,118482.3,50778,169260.3
420880,202301,194,123,71,160148.53,93744.6,253893.13
420890,202301,1037,504,533,656221.18,695270.01,1351491.19
420895,202301,8,8,0,10416,,10416.0
420900,202301,422,338,84,440084.64,109368.78,549453.42
420910,202301,6213,3368,2845,4386572.99,3704239.53,8090812.52
420915,202301,60,54,6,70308.2,7812,78120.2
420917,202301,21,16,5,20832.23,6510,27342.23
420920,202301,21,15,6,19530,7812,27342
420930,202301,3608,2412,1196,3141769.38,1558528.79,4700298.17
420940,202301,588,408,180,532541.07,234367.98,766909.05
420945,202301,10,8,2,10416,2604,13020
420950,202301,45,32,13,41664.56,16926,58590.56
420960,202301,115,94,21,122392.54,27342.1,149734.64
420970,202301,283,227,56,295563.03,72913.09,368476.12
420980,202301,23,22,1,28644,1302,29946
420985,202301,52,44,8,57289.99,10416,67705.99
420990,202301,91,68,23,88537.55,29947.1,118484.65
421000,202301,63,33,30,42966,39060,82026
421003,202301,33,23,10,29946.02,13020,42966.02
421005,202301,8,6,2,7812.8,2604,10416.8
421010,202301,902,579,323,753890.19,421854.28,1175744.47
421020,202301,20,17,3,22134.68,3906,26040.68
421030,202301,118,97,21,126295.85,27342.2,153638.05
421040,202301,68,47,21,61196.47,27343.6,88540.07
421050,202301,331,230,101,299461.88,131502,430963.88
421055,202301,15,12,3,15624.2,3906,19530.2
421060,202301,107,61,46,79422.73,59892,139314.73
421070,202301,38,34,4,44269.98,5208,49477.98
421080,202301,44,37,7,48174.18,9114,57288.18
421085,202301,18,14,4,18228,5208,23436
421090,202301,39,30,9,39060.31,11718.6,50778.91
421100,202301,114,88,26,114577.79,33852.95,148430.74
421105,202301,199,158,41,205722.15,53382.2,259104.35
421110,202301,130,92,38,119788.93,49476,169264.93
421120,202301,193,137,56,178378.44,72912,251290.44
421125,202301,17,10,7,13020,9114.71,22134.71
421130,202301,883,540,343,703098.08,446591.55,1149689.63
421140,202301,34,25,9,32550.61,11718,44268.61
421145,202301,41,36,5,46872.76,6510,53382.76
421150,202301,83,65,18,84631.51,23436,108067.51
421160,202301,60,38,22,49476,28644.3,78120.3
421165,202301,14,12,2,15624,2604,18228
421170,202301,166,139,27,181141.56,35154.7,216296.26
421175,202301,194,138,56,179679.02,72914.35,252593.37
421180,202301,39,27,12,35154.96,15624,50778.96
421185,202301,15,12,3,15624.18,3906,19530.18
421187,202301,3,2,1,2604.2,1302,3906.2
421189,202301,45,32,13,41664.9,16926,58590.9
421190,202301,2117,1332,785,1734325.02,1023392.65,2757717.67
421200,202301,94,65,29,84632.4,37758,122390.4
421205,202301,25,18,7,23437.03,9114,32551.03
421210,202301,175,128,47,166657.52,61194,227851.52
421220,202301,254,196,58,255194.1,75517.45,330711.55
421223,202301,49,38,11,49477.17,14322,63799.17
421225,202301,75,50,25,65101.81,32551.73,97653.54
421227,202301,62,53,9,69007.19,11718,80725.19
421230,202301,73,48,25,62497.51,32550.18,95047.69
421240,202301,16,14,2,18229.54,2604,20833.54
421250,202301,426,233,193,303372.59,251291.95,554664.54
421260,202301,22,17,5,22134.59,6510,28644.59
421265,202301,11,7,4,9114.63,5208.1,14322.73
421270,202301,54,49,5,63798,6510,70308
421280,202301,406,205,201,266915.71,261703.22,528618.93
421290,202301,321,211,110,274724.42,143220.85,417945.27
421300,202301,21,19,2,24738,2604,27342
421310,202301,47,33,14,42966,18228,61194
421315,202301,33,20,13,26040.01,16926.08,42966.09
421320,202301,140,94,46,122389.11,59892,182281.11
421330,202301,113,85,28,110671.34,36456,147127.34
421335,202301,42,30,12,39061.85,15624,54685.85
421340,202301,244,163,81,212229.69,105462,317691.69
421350,202301,190,112,78,145828.06,101556.25,247384.31
421360,202301,767,530,237,691374.7,308579.03,999953.73
421370,202301,201,151,50,196603.42,65100.53,261703.95
421380,202301,152,115,37,149732.83,48174,197906.83
421390,202301,15,10,5,13020,6510,19530
421400,202301,118,95,23,123690.15,29946.63,153636.78
421410,202301,20,17,3,22134,3906,26040
421415,202301,20,18,2,23436,2604,26040
421420,202301,102,87,15,113275.12,19530,132805.12
421430,202301,21,13,8,16926,10416,27342
421440,202301,62,53,9,69007.04,11718.98,80726.02
421450,202301,79,66,13,85932.55,16926,102858.55
421460,202301,54,43,11,55986,14322,70308
421470,202301,77,41,36,53382.77,46872,100254.77
421480,202301,805,598,207,779908.71,269514.99,1049423.70
421490,202301,23,22,1,28644.18,1302,29946.18
421500,202301,489,284,205,369781.83,266911.63,636693.46
421505,202301,39,32,7,41664.1,9114.2,50778.3
421507,202301,31,24,7,31248.1,9114,40362.1
421510,202301,69,42,27,54685.85,35154.61,89840.46
421520,202301,49,41,8,53382.4,10416,63798.4
421530,202301,50,42,8,54685.28,10416,65101.28
421535,202301,24,22,2,28644.99,2604,31248.99
421540,202301,49,40,9,52080.2,11718,63798.2
421545,202301,81,54,27,70313.59,35154.82,105468.41
421550,202301,295,212,83,277339.62,108066.97,385406.59
421555,202301,15,13,2,16926.41,2604,19530.41
421560,202301,8,7,1,9114,1302,10416
421565,202301,134,86,48,113276.58,62496.15,175772.73
421567,202301,37,27,10,35154,13020,48174
421568,202301,40,38,2,49476,2604,52080
421569,202301,10,10,0,13020.91,,13020.91
421570,202301,266,173,93,225248.03,121086.82,346334.85
421575,202301,27,24,3,31248.95,3906,35154.95
421580,202301,759,446,313,580787.19,407528.33,988315.52
421590,202301,22,19,3,24738.2,3906,28644.2
421600,202301,187,133,54,173167.47,70308,243475.47
421605,202301,104,69,35,89839.32,45570.2,135409.52
421610,202301,174,127,47,165354.89,61194,226548.89
421620,202301,1112,637,475,829406.36,619764.57,1449170.93
421625,202301,24,21,3,27342.71,3906,31248.71
421630,202301,375,226,149,294258.48,194003.52,488262.00
421635,202301,26,13,13,16926,16926,33852
421640,202301,104,82,22,106767.75,28644,135411.75
421650,202301,334,192,142,249990.87,184886.43,434877.30
421660,202301,2755,1667,1088,2171802.3,1421805.43,3593607.73
421670,202301,161,116,45,151034.07,58590,209624.07
421680,202301,199,180,19,234362.26,24738,259100.26
421690,202301,351,235,116,307277.82,151033.66,458311.48
421700,202301,61,41,20,53382.2,26040.2,79422.4
421710,202301,20,20,0,26040.28,,26040.28
421715,202301,5,4,1,5208.36,1302,6510.36
421720,202301,662,442,220,575497.31,286442.81,861940.12
421725,202301,31,13,18,16926,23436.8,40362.8
421730,202301,23,17,6,22134,7812,29946
421740,202301,116,46,70,59892.35,91140,151032.35
421750,202301,193,141,52,184884.34,67704,252588.34
421755,202301,18,16,2,20832,2604,23436
421760,202301,98,66,32,85933.31,41664.19,127597.50
421770,202301,727,460,267,598936.21,348939.93,947876.14
421775,202301,30,19,11,24738.97,14322,39060.97
421780,202301,193,150,43,195300.4,55986,251286.4
421790,202301,151,127,24,165355.09,31248.66,196603.75
421795,202301,16,13,3,16926.33,3906,20832.33
421800,202301,592,355,237,462231.08,308577.94,770809.02
421810,202301,69,57,12,74215.58,15624,89839.58
421820,202301,314,192,122,249988.94,158844,408832.94
421825,202301,162,136,26,177077.89,33852,210929.89
421830,202301,158,97,61,127602.38,79422.56,207024.94
421835,202301,7,3,4,3906.73,5208,9114.73
421840,202301,41,34,7,44270.2,9114,53384.2
421850,202301,77,64,13,83328.5,16926,100254.5
421860,202301,36,26,10,33852.93,13020,46872.93
421870,202301,1193,851,342,1108038.98,445297.38,1553336.36
421875,202301,48,38,10,49476,13020,62496
421880,202301,196,138,58,179678.28,75516.7,255194.98
421885,202301,20,15,5,19530,6510.84,26040.84
421890,202301,168,123,45,160150.3,58590.85,218741.15
421895,202301,48,41,7,53383.6,9114,62497.6
421900,202301,128,98,30,127602.31,39060,166662.31
421910,202301,65,41,24,53383.08,31248,84631.08
421915,202301,29,23,6,29946,7812,37758
421917,202301,50,39,11,50780.15,14322,65102.15
421920,202301,35,31,4,40362,5208,45570
421930,202301,641,513,128,667942.06,166657.71,834599.77
421935,202301,44,38,6,49476,7812,57288
421940,202301,53,45,8,58590.4,10416,69006.4
421950,202301,946,625,321,813762,417945.85,1231707.85
421960,202301,41,34,7,44268.22,9114,53382.22
421970,202301,329,204,125,265612.99,165355.39,430968.38
421985,202301,19,11,8,14322.2,10416,24738.2
422000,202301,8,3,5,3906.7,6510.26,10416.96
430003,202301,190,57,133,74214,173166,247380
430005,202301,32,24,8,31248.47,10416,41664.47
430010,202301,256,187,69,243475.84,89838,333313.84
430020,202301,137,96,41,124993.29,53382.24,178375.53
430030,202301,127,101,26,131502.26,33852,165354.26
430040,202301,3028,1786,1242,2325407.86,1619691.21,3945099.07
430045,202301,72,63,9,82026,11718,93744
430047,202301,8,6,2,7812,2604,10416
430050,202301,88,75,13,97650.68,16926,114576.68
430055,202301,14,12,2,15624,2604,18228
430057,202301,5,3,2,3906,2604,6510
430060,202301,4327,2485,1842,3240786.96,2402210.33,5642997.29
430063,202301,55,44,11,57288,14322,71610
430064,202301,175,138,37,179676,48174,227850
430066,202301,7,4,3,5208,3906,9114
430070,202301,42,32,10,41664.48,14322,55986.48
430080,202301,86,56,30,72913.15,39060.2,111973.35
430085,202301,26,12,14,15624,18228,33852
430087,202301,30,24,6,31248.88,7812,39060.88
430090,202301,68,57,11,74214.76,14322,88536.76
430100,202301,151,103,48,134107.26,63798,197905.26
430105,202301,175,98,77,127599.35,100254.3,227853.65
430107,202301,19,14,5,18228.13,6510,24738.13
430110,202301,496,265,231,345030.9,300762,645792.9
430120,202301,165,152,13,197904.1,16926,214830.1
430130,202301,827,492,335,640589.9,437474.4,1078064.3
430140,202301,137,127,10,165354.6,13020,178374.6
430150,202301,114,71,43,92443.82,55986,148429.82
430155,202301,31,25,6,32550,7812,40362
430160,202301,3883,2179,1704,2837112.15,2222526.6,5059638.75
430163,202301,442,211,231,274729.13,300767.13,575496.26
430165,202301,30,19,11,24738.59,14322,39060.59
430170,202301,83,69,14,89838,18228,108066
430175,202301,85,65,20,84630,26040.6,110670.6
430180,202301,109,84,25,109368.4,32550,141918.4
430185,202301,25,17,8,22134,10416,32550
430187,202301,85,34,51,44270.35,66402,110672.35
430190,202301,235,118,117,153639.47,152335.59,305975.06
430192,202301,14,10,4,13020.06,5208,18228.06
430195,202301,17,13,4,16926.95,5208,22134.95
430200,202301,156,130,26,169262.04,33852,203114.04
430205,202301,19,19,0,24738,,24738.0
430210,202301,775,571,204,743455.28,265608.64,1009063.92
430215,202301,11,10,1,13020,1302,14322
430220,202301,78,53,25,69006.5,32550,101556.5
430222,202301,15,5,10,6510,13020,19530
430223,202301,16,11,5,14322,6510,20832
430225,202301,5,3,2,3906,2604,6510
430230,202301,360,221,139,287743.68,180978,468721.68
430235,202301,53,33,20,44268,26040,70308
430237,202301,21,16,5,20832.47,6510,27342.47
430240,202301,120,80,40,104160.61,52080,156240.61
430245,202301,67,53,14,69006,18228,87234
430250,202301,193,113,80,147126.51,104160.84,251287.35
430258,202301,13,9,4,11718.28,5208.8,16927.08
430260,202301,37,32,5,41664.1,6510,48174.1
430265,202301,37,33,4,42966,5208,48174
430270,202301,537,377,160,492169.77,208320,700489.77
430280,202301,1103,638,465,833284.81,606732.3,1440017.11
430290,202301,461,239,222,311182.87,289044,600226.87
430300,202301,2242,1219,1023,1588474.69,1333263.16,2921737.85
430310,202301,2278,1113,1165,1451779.68,1519460.77,2971240.45
430320,202301,60,48,12,62496,15624,78120
430330,202301,86,73,13,95046.16,16926,111972.16
430340,202301,73,57,16,74214,20832.07,95046.07
430350,202301,1741,1097,644,1428307.26,839791.25,2268098.51
430355,202301,19,17,2,22134,2604,24738
430360,202301,100,48,52,62496,67704,130200
430367,202301,52,38,14,49476,18228,67704
430370,202301,62,55,7,71610,9114,80724
430380,202301,109,79,30,102859.16,39060,141919.16
430390,202301,727,435,292,568904.46,381489.84,950394.30
430400,202301,260,177,83,230455.57,108066,338521.57
430410,202301,53,44,9,57288.2,11718,69006.2
430420,202301,544,348,196,454406.76,255192.89,709599.65
430430,202301,48,46,2,59024.86,2604,61628.86
430435,202301,152,113,39,147126.06,50778,197904.06
430440,202301,615,373,242,485653.51,315084.83,800738.34
430450,202301,1271,1027,244,1338470.72,318991.74,1657462.46
430460,202301,6281,3190,3091,4156093.08,4025835.05,8181928.13
430461,202301,17,15,2,19530,2604,22134
430462,202301,4,2,2,2604.1,2604,5208.1
430463,202301,1271,687,584,894495.11,760373.81,1654868.92
430465,202301,27,16,11,20832,14322,35154
430466,202301,761,528,233,687480.26,303373.41,990853.67
430467,202301,129,73,56,95047.06,72912,167959.06
430468,202301,158,90,68,117180.42,88536.61,205717.03
430469,202301,20,14,6,18228,7812,26040
430470,202301,1222,653,569,850603.82,740840.4,1591444.22
430471,202301,75,51,24,66402.45,31248.57,97651.02
430480,202301,143,99,44,128898.95,57288,186186.95
430485,202301,8,8,0,10416.6,,10416.6
430490,202301,72,57,15,74214.64,19530,93744.64
430495,202301,32,23,9,29946.2,11718,41664.2
430500,202301,200,134,66,174469,85932,260401
430510,202301,4066,2612,1454,3403475.59,1893117.55,5296593.14
430511,202301,14,14,0,18228,,18228.0
430512,202301,178,121,57,157543.9,74215.1,231759.0
430513,202301,53,40,13,52080,16926,69006
430515,202301,24,22,2,28644,2604,31248
430517,202301,182,152,30,197904,39060,236964
430520,202301,346,241,105,313787.54,136710.18,450497.72
430530,202301,78,42,36,54684.2,46872,101556.2
430535,202301,476,306,170,398416.09,221342.79,619758.88
430537,202301,8,8,0,10416,,10416.0
430540,202301,82,54,28,70308,36456,106764
430543,202301,438,142,296,184885.07,385392.01,570277.08
430544,202301,54,50,4,65100.87,5208,70308.87
430545,202301,445,217,228,282550.35,296862.96,579413.31
430550,202301,46,38,8,49476.1,10416,59892.1
430558,202301,1,1,0,1302,,1302.0
430560,202301,53,29,24,37758,31248,69006
430570,202301,121,49,72,63799.24,93744,157543.24
430580,202301,125,99,26,128898.94,33852,162750.94
430583,202301,13,13,0,16926,,16926.0
430585,202301,15,11,4,14322,5208,19530
430587,202301,16,10,6,13020,7812.08,20832.08
430590,202301,191,154,37,200509.88,49476,249985.88
430593,202301,1,1,0,1302,,1302.0
430595,202301,17,14,3,18228,3906,22134
430597,202301,41,24,17,31248.64,22134,53382.64
430600,202301,225,166,59,216132,76818,292950
430605,202301,181,107,74,139314,96348,235662
430607,202301,30,24,6,31248,7812,39060
430610,202301,1840,876,964,1141867.23,1255132.86,2397000.09
430613,202301,5,5,0,6510,,6510.0
430620,202301,96,68,28,88536.71,36456,124992.71
430630,202301,48,41,7,53383.23,9114,62497.23
430632,202301,31,27,4,35154,5208,40362
430635,202301,35,29,6,37758,7812,45570
430637,202301,66,30,36,39060,46872,85932
430640,202301,179,97,82,126294.96,106764.74,233059.70
430642,202301,18,16,2,20832,2604,23436
430645,202301,34,27,7,35154,9114,44268
430650,202301,249,197,52,256496.02,67704.2,324200.22
430655,202301,8,7,1,9114,1302,10416
430660,202301,1039,511,528,665334,688767.03,1354101.03
430670,202301,69,46,23,59892,29946,89838
430673,202301,80,55,25,71610,32550,104160
430675,202301,8,6,2,7812,2604,10416
430676,202301,669,409,260,532528.83,338522.48,871051.31
430680,202301,261,173,88,225248.98,115878,341126.98
430690,202301,566,345,221,449196.85,287743.07,736939.92
430692,202301,8,6,2,7812,2604,10416
430693,202301,141,91,50,118482.64,65100.2,183582.84
430695,202301,67,54,13,70308,16926,87234
430697,202301,68,43,25,55986,32550,88536
430700,202301,1413,955,458,1243425.37,596316.64,1839742.01
430705,202301,30,26,4,33852.05,5208,39060.05
430710,202301,279,175,104,229152,135408,364560
430720,202301,101,84,17,109368,22134,131502
430730,202301,149,127,22,165354,28644,193998
430740,202301,84,51,33,66402.2,42966,109368.2
430745,202301,27,17,10,22134,13020,35154
430750,202301,331,212,119,276025.71,154939.15,430964.86
430755,202301,83,46,37,59892.76,48174,108066.76
430760,202301,445,241,204,313786.64,266913.1,580699.74
430770,202301,1740,939,801,1225207.27,1042909.77,2268117.04
430780,202301,359,221,138,287742.56,180978,468720.56
430781,202301,24,24,0,31248,,31248.0
430783,202301,63,47,16,61194,20832,82026
430786,202301,7,5,2,6510,2604,9114
430790,202301,555,347,208,451796.75,272120.59,723917.34
430800,202301,169,126,43,164052.1,55986,220038.1
430805,202301,38,31,7,40362,9114.48,49476.48
430807,202301,74,40,34,52080,44268,96348
430810,202301,83,55,28,71611.33,36456,108067.33
430820,202301,154,98,56,127596.71,74214,201810.71
430825,202301,11,9,2,11718,2604,14322
430830,202301,269,249,20,324200.08,26040,350240.08
430840,202301,141,92,49,119784,63798,183582
430843,202301,7,4,3,5208,3906,9114
430845,202301,86,50,36,65100,46872,111972
430850,202301,605,427,178,555955.89,231756,787711.89
430860,202301,173,116,57,151034.01,74214.88,225248.89
430865,202301,77,42,35,54684,45570,100254
430870,202301,71,58,13,75516.27,16926,92442.27
430880,202301,182,125,57,162752.15,74214.2,236966.35
430885,202301,10,9,1,11718,1302,13020
430890,202301,343,208,135,270816.56,177072,447888.56
430900,202301,553,377,176,490860.04,229152.46,720012.50
430905,202301,140,59,81,76818.97,105463.35,182282.32
430910,202301,304,163,141,212226.5,183582.8,395809.3
430912,202301,4,4,0,5208.49,,5208.49
430915,202301,44,41,3,53382,3906,57288
430920,202301,5054,2633,2421,3428277.4,3154799.46,6583076.86
430925,202301,7,6,1,7812,1302,9114
430930,202301,2248,1250,998,1627530.82,1300704.5,2928235.32
430940,202301,273,174,99,226549.54,128898.6,355448.14
430950,202301,157,125,32,162751.09,41664,204415.09
430955,202301,26,15,11,19530,14322,33852
430957,202301,23,20,3,26040.11,3906,29946.11
430960,202301,269,173,96,225247.45,127596.38,352843.83
430965,202301,105,68,37,88536,48174,136710
430970,202301,93,73,20,95046,26040,121086
430975,202301,53,46,7,59892,9114,69006
430980,202301,54,32,22,41664.68,28644,70308.68
430990,202301,99,77,22,100254,28644,128898
430995,202301,112,104,8,135408,10416.7,145824.7
431000,202301,298,146,152,190093.2,197904,387997.2
431010,202301,371,219,152,285147.11,199209.11,484356.22
431020,202301,1986,1138,848,1481696.78,1108004.31,2589701.09
431030,202301,39,30,9,39060,11718,50778
431033,202301,506,226,280,294266.69,364573.85,658840.54
431036,202301,12,8,4,10416,5208,15624
431040,202301,150,101,49,131503.16,63798,195301.16
431041,202301,46,27,19,35154.37,24738,59892.37
431043,202301,40,22,18,28644.42,23436,52080.42
431046,202301,13,10,3,13020,3906,16926
431050,202301,210,129,81,167959.51,105462,273421.51
431053,202301,76,42,34,54684.07,44269.09,98953.16
431055,202301,66,44,22,57288,28644,85932
431057,202301,18,18,0,23436,,23436.0
431060,202301,1635,1038,597,1352791.25,777296.08,2130087.33
431065,202301,16,7,9,9114,11718,20832
431070,202301,66,57,9,74214.62,11718,85932.62
431075,202301,8,8,0,10416,,10416.0
431080,202301,131,72,59,93745.19,76818,170563.19
431085,202301,36,32,4,41664.34,5208,46872.34
431087,202301,17,13,4,16926,5208,22134
431090,202301,50,39,11,50778.8,15624,66402.8
431100,202301,1324,789,535,1027296.21,696574.33,1723870.54
431110,202301,230,138,92,179678.96,119784,299462.96
431112,202301,27,21,6,27342.33,7812,35154.33
431113,202301,29,20,9,26040,11718,37758
431115,202301,158,111,47,144522.16,61194,205716.16
431120,202301,611,357,254,464822.07,330708,795530.07
431123,202301,6,6,0,7812,,7812.0
431125,202301,97,84,13,109368,16926,126294
431127,202301,5,3,2,3906,2604,6510
431130,202301,742,474,268,618457.38,348938.36,967395.74
431140,202301,847,594,253,773396.37,332010.8,1105407.17
431142,202301,19,17,2,22134.5,2604,24738.5
431150,202301,207,148,59,194000.53,76818,270818.53
431160,202301,42,38,4,49476,5208,54684
431162,202301,6,6,0,7812.83,,7812.83
431164,202301,5,4,1,5208,1302,6510
431170,202301,118,84,34,109368.2,44268,153636.2
431171,202301,78,44,34,57288,44268,101556
431173,202301,6,5,1,6510,1302.8,7812.8
431175,202301,208,109,99,141919.51,128898.15,270817.66
431177,202301,108,75,33,97650.83,42966.31,140617.14
431179,202301,15,10,5,13020,6510,19530
431180,202301,415,256,159,334616.57,207018.77,541635.34
431190,202301,71,51,20,66402,26040.7,92442.7
431198,202301,74,50,24,64964.85,31248,96212.85
431200,202301,22,18,4,23436,5208,28644
431205,202301,22,20,2,26040,2604,28644
431210,202301,106,63,43,82026.2,55986,138012.2
431213,202301,33,26,7,33852,9114.56,42966.56
431215,202301,23,22,1,28644,1302,29946
431217,202301,6,5,1,6510,1302,7812
431220,202301,68,57,11,74214.43,14322,88536.43
431225,202301,170,103,67,134107.27,87234,221341.27
431230,202301,101,83,18,108069.02,23436,131505.02
431235,202301,5,4,1,5208,1302,6510
431237,202301,17,12,5,15624.46,6510,22134.46
431238,202301,16,11,5,14322,6510.2,20832.2
431240,202301,1010,623,387,812470.6,503876.6,1316347.2
431242,202301,42,41,1,53382,1302,54684
431244,202301,37,29,8,37758.26,10416,48174.26
431245,202301,50,36,14,46872,18228,65100
431247,202301,13,10,3,13020,3906,16926
431250,202301,309,149,160,193999.6,208320,402319.6
431260,202301,54,46,8,59892,10416,70308
431261,202301,24,17,7,22134.28,9114,31248.28
431262,202301,13,11,2,14322,2604,16926
431265,202301,153,85,68,111972.77,88536,200508.77
431267,202301,18,15,3,19530,3906,23436
431270,202301,340,264,76,343731.74,98952.48,442684.22
431275,202301,39,35,4,45570,5208,50778
431280,202301,20,15,5,19530,6510,26040
431290,202301,25,22,3,28644.83,3906,32550.83
431295,202301,3,1,2,1302,2604,3906
431300,202301,24,21,3,27342,3906,31248
431301,202301,7,7,0,9114,,9114.0
431303,202301,57,36,21,46872,27342,74214
431306,202301,249,127,122,165354.99,158844,324198.99
431308,202301,9,8,1,10416,1302,11718
431310,202301,64,49,15,63798,19530,83328
431320,202301,220,133,87,173167.6,113274,286441.6
431330,202301,221,146,75,190092.6,97650,287742.6
431333,202301,25,21,4,27342,5208,32550
431335,202301,8,6,2,7812,2604,10416
431337,202301,450,220,230,286452.15,300764.26,587216.41
431339,202301,24,18,6,23436,7812,31248
431340,202301,3274,1742,1532,2269330.26,1994676.06,4264006.32
431342,202301,35,24,11,31248,14322,45570
431344,202301,21,21,0,27342,,27342.0
431346,202301,5,4,1,5208,1302,6510
431349,202301,28,26,2,33852,2604,36456
431350,202301,962,532,430,692686.79,561167.15,1253853.94
431360,202301,58,42,16,54684,20832,75516
431365,202301,392,162,230,210928.04,299461.44,510389.48
431370,202301,1253,690,563,899695.04,733027.75,1632722.79
431380,202301,101,88,13,114576.63,16926,131502.63
431390,202301,508,277,231,360654.85,300762.8,661417.65
431395,202301,340,148,192,192697.5,249984,442681.5
431400,202301,37,23,14,29946,18228,48174
431402,202301,100,73,27,95046.3,35154.8,130201.1
431403,202301,28,19,9,24738,11718,36456
431405,202301,760,440,320,572892.22,419246.44,992138.66
431406,202301,37,28,9,36456.86,11718,48174.86
431407,202301,48,36,12,46872,15624,62496
431410,202301,3682,2246,1436,2924348.59,1870988.04,4795336.63
431413,202301,16,13,3,16926,3906,20832
431415,202301,75,53,22,69007.41,28644,97651.41
431417,202301,22,11,11,14322,14322,28644
431420,202301,383,252,131,328108.39,170562.6,498670.99
431430,202301,69,33,36,42967.87,46872,89839.87
431440,202301,9682,6505,3177,8476283.77,4140461.37,12616745.14
431442,202301,28,15,13,19530,16926,36456
431445,202301,28,27,1,35154,1302,36456
431446,202301,5,5,0,6510.2,,6510.2
431447,202301,86,64,22,83328,28644,111972
431449,202301,62,49,13,63798.3,16926,80724.3
431450,202301,434,285,149,371071.43,193998,565069.43
431454,202301,11,6,5,7812,6510,14322
431455,202301,48,39,9,50778.03,11718,62496.03
431460,202301,520,351,169,457008.44,220038,677046.44
431470,202301,141,104,37,135408.25,48174,183582.25
431475,202301,10,8,2,10416,2604,13020
431477,202301,41,23,18,29946,23436,53382
431478,202301,7,7,0,9114,,9114.0
431480,202301,780,471,309,613255.16,403620.14,1016875.30
431490,202301,31955,17882,14073,23293247.91,18342786.62,41636034.53
431500,202301,77,59,18,76818,23436,100254
431505,202301,29,21,8,27342.35,10416,37758.35
431507,202301,9,8,1,10416,2604,13020
431510,202301,237,166,71,216134.32,92442,308576.32
431513,202301,20,19,1,24738,1302,26040
431514,202301,7,4,3,5208,3906,9114
431515,202301,83,70,13,91140.04,16926.1,108066.14
431517,202301,7,4,3,5208,3906,9114
431520,202301,40,33,7,42966.2,9114,52080.2
431530,202301,1439,622,817,811151.59,1063734.43,1874886.02
431531,202301,23,22,1,28644.2,1302,29946.2
431532,202301,36,27,9,35154,11718,46872
431535,202301,30,17,13,22134,16926,39060
431540,202301,142,112,30,145825.52,39060.6,184886.12
431545,202301,14,11,3,14322,3906,18228
431550,202301,360,188,172,244781.64,223945.19,468726.83
431555,202301,14,13,1,16926.36,1302,18228.36
431560,202301,5136,3384,1752,4411329.56,2283756.12,6695085.68
431570,202301,894,472,422,617157.72,549448.78,1166606.50
431575,202301,57,35,22,45570.6,28644.18,74214.78
431580,202301,82,57,25,75516,32550,108066
431590,202301,145,122,23,158844,29946,188790
431595,202301,18,16,2,20832,2604,23436
431600,202301,258,149,109,194003.28,141919.08,335922.36
431610,202301,121,90,31,117183,41664.8,158847.8
431620,202301,39,32,7,41664,9114,50778
431630,202301,123,99,24,128898.13,31248,160146.13
431640,202301,1335,825,510,1074163.88,666625.41,1740789.29
431642,202301,32,30,2,39060,2604,41664
431643,202301,43,17,26,22134,33852,55986
431645,202301,339,197,142,256494.64,184884,441378.64
431647,202301,12,11,1,14322,1302,15624
431650,202301,35,19,16,24738,20832,45570
431660,202301,270,171,99,222642.73,128898,351540.73
431670,202301,231,101,130,131502.39,170562.11,302064.50
431673,202301,14,11,3,14322,3906,18228
431675,202301,28,21,7,27342,9114,36456
431680,202301,1221,878,343,1144485.53,447895.28,1592380.81
431690,202301,5246,3075,2171,4007667.15,2827989.71,6835656.86
431695,202301,20,12,8,15624,10416,26040
431697,202301,4,2,2,2604,2604,5208
431700,202301,196,146,50,190092.55,65100,255192.55
431710,202301,4316,1839,2477,2394412.24,3227670.18,5622082.42
431720,202301,1309,808,501,1053978.86,652303.28,1706282.14
431725,202301,3,1,2,1302,2604,3906
431730,202301,1243,824,419,1074197.8,545547.31,1619745.11
431740,202301,1380,670,710,872351.85,924424.17,1796776.02
431750,202301,1884,1228,656,1600176.46,854117.1,2454293.56
431755,202301,5,4,1,5208,1302,6510
431760,202301,1026,646,380,842413.46,496067.93,1338481.39
431770,202301,423,284,139,369768.89,180978,550746.89
431775,202301,26,19,7,24738,9114,33852
431780,202301,588,357,231,464815.6,300762,765577.6
431790,202301,147,110,37,143220.8,48174.1,191394.9
431795,202301,13,11,2,14322,2604,16926
431800,202301,3212,1674,1538,2183487.67,2002483.71,4185971.38
431805,202301,19,15,4,19530,5208,24738
431810,202301,589,382,207,497368.1,269514.4,766882.5
431820,202301,360,205,155,266911.57,201810,468721.57
431830,202301,2433,1463,970,1906084.38,1262942.64,3169027.02
431840,202301,523,330,193,429669.39,251286.98,680956.37
431842,202301,34,28,6,36456,7812,44268
431843,202301,9,6,3,7812.5,3906.2,11718.7
431844,202301,16,12,4,15624,5208,20832
431845,202301,25,23,2,29946,2604,32550
431846,202301,28,24,4,31248.72,5208,36456.72
431848,202301,14,10,4,13020.6,5208.6,18229.2
431849,202301,6,5,1,6510,1302,7812
431850,202301,837,656,181,856732.02,236965.8,1093697.82
431860,202301,121,77,44,100254.31,57288,157542.31
431861,202301,3,0,3,,3906,3906.0
431862,202301,67,49,18,63798.15,23436,87234.15
431870,202301,4038,2318,1720,3018124.43,2240768.52,5258892.95
431880,202301,1021,711,310,927031.99,403621.53,1330653.52
431890,202301,1264,726,538,945262.86,700477.08,1645739.94
431900,202301,198,129,69,167958.86,89838,257796.86
431910,202301,45,35,10,45570,13020,58590
431912,202301,51,33,18,42966.97,23436,66402.97
431915,202301,155,117,38,152335.29,49476,201811.29
431920,202301,158,112,46,145824.45,59892,205716.45
431930,202301,74,59,15,76818,19530,96348
431935,202301,4,3,1,3906.73,1302,5208.73
431936,202301,2,2,0,2604,,2604.0
431937,202301,21,16,5,20832.63,6510,27342.63
431940,202301,478,327,151,425760,196603.06,622363.06
431950,202301,503,317,186,412744.37,242173,654917.37
431960,202301,767,413,354,539035.8,460908.47,999944.27
431970,202301,63,57,6,74214,7812,82026
431971,202301,3,3,0,3906,,3906.0
431973,202301,21,18,3,23436.83,3906,27342.83
431975,202301,10,10,0,13020,,13020.0
431980,202301,211,118,93,153638.82,121086,274724.82
431990,202301,1012,543,469,708306.17,611950.85,1320257.02
432000,202301,2041,1079,962,1404911.22,1252543.75,2657454.97
432010,202301,266,171,95,222642.4,123690.2,346332.6
432020,202301,195,166,29,216134.26,37758.87,253893.13
432023,202301,15,13,2,16926,2604,19530
432026,202301,61,53,8,69006,10416,79422
432030,202301,54,23,31,29946.61,40362,70308.61
432032,202301,15,11,4,14322,5208,19530
432035,202301,73,53,20,69006,26040,95046
432040,202301,86,61,25,79423.28,32550,111973.28
432045,202301,3,3,0,3906,,3906.0
432050,202301,85,53,32,69006.71,41664,110670.71
432055,202301,135,92,43,119785.42,55986,175771.42
432057,202301,6,4,2,5209.3,2604,7813.3
432060,202301,32,27,5,35154,6510,41664
432065,202301,31,27,4,35154,5208,40362
432067,202301,85,78,7,101556.6,9114,110670.6
432070,202301,394,310,84,403623.82,109368,512991.82
432080,202301,864,611,253,795547.72,329409.22,1124956.94
432085,202301,23,19,4,24738,5208,29946
432090,202301,286,185,101,240870.2,131502.33,372372.53
432100,202301,175,109,66,141918.31,85932,227850.31
432110,202301,577,381,196,497370.55,257796.32,755166.87
432120,202301,1092,610,482,795536.26,628870.67,1424406.93
432130,202301,535,379,156,493459.36,203112,696571.36
432132,202301,21,19,2,26040,2604,28644
432135,202301,85,66,19,85932,24738,110670
432140,202301,270,203,67,264308.14,87234,351542.14
432143,202301,235,144,91,187489.65,118482.1,305971.75
432145,202301,305,216,89,281235.26,117180,398415.26
432146,202301,16,14,2,18228,2604,20832
432147,202301,100,61,39,79422,50778,130200
432149,202301,15,11,4,14322,5208,19530
432150,202301,1133,712,421,929647.75,548146.72,1477794.47
432160,202301,2130,1085,1045,1413997.76,1361908.48,2775906.24
432162,202301,5,2,3,2604,3906,6510
432163,202301,15,10,5,13020,6510,19530
432166,202301,133,91,42,118809.51,54685.55,173495.06
432170,202301,246,133,113,173170.48,147126.3,320296.78
432180,202301,588,376,212,489552.69,277326,766878.69
432183,202301,14,13,1,16926.3,1302,18228.3
432185,202301,81,66,15,85932.75,19530.63,105463.38
432190,202301,545,321,224,417942.57,291648.8,709591.37
432195,202301,91,72,19,93744.2,24738,118482.2
432200,202301,451,270,181,352843.99,235663.64,588507.63
432210,202301,125,74,51,96348,66402,162750
432215,202301,31,29,2,37758,2604,40362
432218,202301,20,20,0,26040,,26040.0
432220,202301,670,330,340,429665.93,442682.58,872348.51
432225,202301,20,14,6,18228.2,7812,26040.2
432230,202301,129,82,47,106764,61195.31,167959.31
432232,202301,30,27,3,35154,3906,39060
432234,202301,4,2,2,2604,2604,5208
432235,202301,1,1,0,1302,,1302.0
432237,202301,23,16,7,20832,9114,29946
432240,202301,4757,2643,2114,3442576.11,2753762.43,6196338.54
432250,202301,1193,799,394,1040303.82,512989.27,1553293.09
432252,202301,51,48,3,62496,3906,66402
432253,202301,71,55,16,71612.99,20832,92444.99
432254,202301,31,15,16,19530,20832,40362
432255,202301,11,10,1,13020,1302,14322
432260,202301,906,726,180,945263.56,235662.1,1180925.66
432270,202301,224,165,59,214842.35,76818.33,291660.68
432280,202301,167,124,43,161451.31,55986,217437.31
432285,202301,1,1,0,1302,,1302.0
432290,202301,59,49,10,63798,13020,76818
432300,202301,5403,2884,2519,3754968,3283669.9,7038637.9
432310,202301,131,111,20,144522.65,26040,170562.65
432320,202301,19,14,5,19530,6510,26040
432330,202301,19,13,6,16926,7812,24738
432335,202301,10,8,2,10416,2604,13020
432340,202301,36,28,8,36456,10416,46872
432345,202301,124,81,43,105464.15,57288,162752.15
432350,202301,25,24,1,31248,1302,32550
432360,202301,5,4,1,5208,1302,6510
432370,202301,26,26,0,33852.26,,33852.26
432375,202301,26,24,2,31248,2604,33852
432377,202301,7,7,0,9114.48,,9114.48
432380,202301,222,102,120,132805.72,158846.85,291652.57
500020,202301,301,156,145,203114.27,188790.39,391904.66
500025,202301,149,71,78,92443.75,101557.12,194000.87
500060,202301,1555,987,568,1286408.48,739547.14,2025955.62
500070,202301,784,380,404,494774.89,526016.9,1020791.79
500080,202301,147,115,32,149733.49,41664,191397.49
500085,202301,139,103,36,134108.29,46872,180980.29
500090,202301,409,189,220,246082.63,287743.42,533826.05
500100,202301,717,369,348,480450.99,455703.97,936154.96
500110,202301,2407,1158,1249,1507759.26,1627527.64,3135286.90
500124,202301,270,145,125,188790.26,162751.39,351541.65
500150,202301,330,138,192,179680.21,251287.14,430967.35
500190,202301,599,399,200,519512.36,260401.66,779914.02
500200,202301,213,173,40,225251.14,52080,277331.14
500210,202301,1793,568,1225,739549.17,1597571.8,2337120.97
500215,202301,206,117,89,152338.5,115878.2,268216.7
500220,202301,737,463,274,605451.3,356751.87,962203.17
500230,202301,254,145,109,188793.75,141918.47,330712.22
500240,202301,679,428,251,557268.46,326805.88,884074.34
500260,202301,627,253,374,329410.94,486949.1,816360.04
500270,202301,32646,14185,18461,18483080.02,24061349.22,42544429.24
500280,202301,207,71,136,92442.24,177072.66,269514.90
500290,202301,1234,767,467,998660.4,608037.47,1606697.87
500295,202301,506,332,174,432272.49,226549.09,658821.58
500310,202301,116,39,77,50778.1,100254.87,151032.97
500315,202301,884,480,404,626263.67,526009.64,1152273.31
500320,202301,3899,1818,2081,2367117.81,2710781.58,5077899.39
500325,202301,995,559,436,727845.47,568980.6,1296826.07
500330,202301,1596,781,815,1016822.34,1061145.37,2077967.71
500345,202301,321,225,96,294255.69,124992.21,419247.90
500348,202301,254,155,99,201812.68,128898,330710.68
500350,202301,106,51,55,66403.07,71610.45,138013.52
500370,202301,6111,2766,3345,3604050.28,4363039.47,7967089.75
500375,202301,385,253,132,329409.45,171865.53,501274.98
500380,202301,681,383,298,499982.11,387998.63,887980.74
500390,202301,75,32,43,41664.1,55986.8,97650.9
500400,202301,233,143,90,186189.19,117180.97,303370.16
500410,202301,477,209,268,272126.24,348940.13,621066.37
500430,202301,616,388,228,505188.53,296857.31,802045.84
500440,202301,213,121,92,157542.14,119784.2,277326.34
500450,202301,448,192,256,249987.5,333312.8,583300.3
500460,202301,282,153,129,199210.66,167958.96,367169.62
500470,202301,447,321,126,419249.04,164053.06,583302.10
500480,202301,104,57,47,74214.59,61195.19,135409.78
500490,202301,95,40,55,52080.88,71612.05,123692.93
500500,202301,1535,563,972,734343.76,1269456.9,2003800.66
500510,202301,38,32,6,41664.51,7812,49476.51
500515,202301,123,81,42,105464.84,54684.78,160149.62
500520,202301,293,149,144,194003.9,187488.16,381492.06
500525,202301,100,52,48,67704.14,62496,130200.14
500540,202301,951,407,544,529931.31,708296.45,1238227.76
500560,202301,912,509,403,662728.58,524711.35,1187439.93
500568,202301,1140,543,597,707001.84,777301.98,1484303.82
500570,202301,1257,718,539,934855.61,701785.27,1636640.88
500580,202301,317,174,143,226554.75,187489.87,414044.62
500600,202301,408,196,212,255197.38,276025.67,531223.05
500620,202301,1039,711,328,925742.37,427061.26,1352803.63
500625,202301,88,66,22,85932.4,28644,114576.4
500627,202301,38,17,21,22134.15,27342,49476.15
500630,202301,1640,933,707,1216855.74,920522.59,2137378.33
500635,202301,526,307,219,399715.21,285138,684853.21
500640,202301,373,208,165,270827.42,216134.3,486961.72
500660,202301,6292,2235,4057,2911336.69,5286156.63,8197493.32
500690,202301,661,238,423,309880.3,550746.24,860626.54
500710,202301,430,209,221,274729.43,289047.63,563777.06
500720,202301,997,539,458,701795.8,596320.1,1298115.9
500730,202301,149,90,59,117188.11,76818,194006.11
500740,202301,1027,439,588,571589.74,766885.6,1338475.34
500750,202301,203,76,127,98953.72,165356.55,264310.27
500755,202301,110,83,27,108069.03,35154.93,143223.96
500769,202301,782,427,355,558569.06,462214.08,1020783.14
500770,202301,444,233,211,303366.74,274722,578088.74
500780,202301,136,94,42,122393.46,54684.63,177078.09
500790,202301,1140,550,590,716122.27,768183.18,1484305.45
500793,202301,312,158,154,205718.32,200511.26,406229.58
500795,202301,198,128,70,166658.44,91140.79,257799.23
500797,202301,48,33,15,42967.12,19530,62497.12
500800,202301,446,199,247,260404.86,321596.02,582000.88
500830,202301,2489,1302,1187,1695261.98,1546784.66,3242046.64
500840,202301,117,83,34,108071.22,44268.9,152340.12
510010,202301,172,93,79,121086,102858,223944
510020,202301,573,271,302,352853.03,393207.97,746061.00
510025,202301,1826,1029,797,1339794.36,1037703.6,2377497.96
510030,202301,676,356,320,463528.64,416645.84,880174.48
510035,202301,137,69,68,89838.26,88536,178374.26
510040,202301,423,198,225,257798.32,292951.68,550750.00
510050,202301,381,203,178,264312.71,231759.12,496071.83
510060,202301,133,58,75,75517.05,97650,173167.05
510080,202301,264,111,153,144523.89,199206,343729.89
510100,202301,66,27,39,35154.55,50778.03,85932.58
510120,202301,31,19,12,24738.99,15624.85,40363.84
510125,202301,407,260,147,338521.53,192696,531217.53
510130,202301,555,327,228,425763.04,296857.3,722620.34
510140,202301,463,154,309,201810.64,403621.38,605432.02
510160,202301,111,43,68,55988.43,88537.61,144526.04
510170,202301,804,470,334,611951.34,434873.18,1046824.52
510180,202301,3115,1404,1711,1828050.77,2230353.26,4058404.03
510185,202301,35,16,19,20832,24738,45570
510190,202301,261,90,171,117181.03,222643.59,339824.62
510250,202301,2826,1709,1117,2225155.76,1458247.87,3683403.63
510260,202301,171,121,50,157544.21,65101.15,222645.36
510263,202301,504,284,220,369774.24,286443.31,656217.55
510267,202301,629,353,276,459620.17,359356.23,818976.40
510268,202301,75,36,39,46872.95,50778,97650.95
510269,202301,82,37,45,48174,58590.4,106764.4
510270,202301,395,190,205,247381.64,266910.2,514291.84
510279,202301,208,154,54,200508.82,70308,270816.82
510285,202301,190,76,114,98953.36,148428,247381.36
510300,202301,547,282,265,367168.21,345030.56,712198.77
510305,202301,195,88,107,114576.2,139314,253890.2
510310,202301,108,55,53,71610.92,69006.1,140617.02
510320,202301,834,519,315,675749.21,410131.12,1085880.33
510325,202301,472,198,274,257797.87,356750.05,614547.92
510330,202301,474,262,212,341130.11,277327.5,618457.61
510335,202301,700,411,289,535136.56,376280.35,911416.91
510336,202301,52,35,17,45571.17,22134.7,67705.87
510337,202301,101,42,59,54684,76818,131502
510340,202301,19467,8294,11173,10805988.89,14559219.48,25365208.37
510343,202301,58,45,13,58590,16926,75516
510345,202301,151,91,60,118483.63,78121.28,196604.91
510350,202301,677,355,322,462219.8,420551.25,882771.05
510360,202301,226,142,84,184886.87,109368.8,294255.67
510370,202301,177,75,102,97650,132804,230454
510380,202301,81,59,22,79422,28644,108066
510385,202301,61,31,30,40362.2,39060,79422.2
510390,202301,103,49,54,63798.57,70308.1,134106.67
510395,202301,59,42,17,54684,22134,76818
510410,202301,827,519,308,677063.3,401019.82,1078083.12
510420,202301,577,278,299,361959.48,390600,752559.48
510450,202301,52,28,24,36456,31248,67704
510452,202301,61,29,32,37758,41664,79422
510454,202301,55,25,30,32550,39060.03,71610.03
510455,202301,123,70,53,91140,69006.97,160146.97
510460,202301,199,83,116,108068.86,151032,259100.86
510480,202301,779,456,323,593725.9,421854.37,1015580.27
510490,202301,343,165,178,214833.17,233058.5,447891.67
510500,202301,245,183,62,238267.74,80724,318991.74
510510,202301,893,523,370,680960.78,481745.26,1162706.04
510515,202301,1341,682,659,887977.19,858026.74,1746003.93
510517,202301,288,127,161,165357.27,210924.9,376282.17
510520,202301,233,144,89,187491.66,115878.5,303370.16
510523,202301,117,92,25,121086,32550,153636
510525,202301,922,564,358,734342.61,466120.29,1200462.90
510530,202301,26,15,11,19530,14322,33852
510550,202301,252,116,136,151034.52,177073.83,328108.35
510558,202301,330,165,165,215078.93,216132,431210.93
510560,202301,409,237,172,308579.55,223946.95,532526.50
510562,202301,690,488,202,635391.66,263005.35,898397.01
510590,202301,740,359,381,467428.28,496064.57,963492.85
510600,202301,224,117,107,152337.72,139314.21,291651.93
510610,202301,228,100,128,130202.27,166657.09,296859.36
510615,202301,233,111,122,144523.21,158844.56,303367.77
510617,202301,26,11,15,14322,19530,33852
510618,202301,131,65,66,84630.78,85934.16,170564.94
510619,202301,82,58,24,75516.29,31248,106764.29
510620,202301,167,88,79,114576,102858,217434
510621,202301,184,117,67,152334.6,88536.23,240870.83
510622,202301,522,278,244,361970.88,318994.26,680965.14
510623,202301,291,198,93,257799.8,121086.2,378886.0
510624,202301,93,45,48,58590.7,62496.53,121087.23
510625,202301,549,344,205,447900.77,266913.48,714814.25
510626,202301,114,65,49,84632.39,63798,148430.39
510627,202301,96,64,32,83329.89,41664.2,124994.09
510628,202301,175,105,70,136711.95,91140,227851.95
510629,202301,302,183,119,238267.37,154961.43,393228.80
510630,202301,468,240,228,312488,298158.71,610646.71
510631,202301,22,9,13,11718.13,16926,28644.13
510637,202301,367,217,150,282536.54,195300,477836.54
510642,202301,1218,654,564,851529.77,734336.52,1585866.29
510645,202301,11,2,9,2604,13020,15624
510650,202301,1307,845,462,1102835.49,602830.63,1705666.12
510665,202301,101,48,53,62496.55,69006.08,131502.63
510670,202301,59,34,25,44268.46,32550,76818.46
510675,202301,1138,725,413,943975.28,537730.69,1481705.97
510677,202301,350,183,167,238269.22,217435.56,455704.78
510680,202301,89,55,34,71612.35,44268,115880.35
510682,202301,194,92,102,119784.52,132804,252588.52
510685,202301,57,41,16,53382.73,20832,74214.73
510700,202301,610,342,268,445295.57,348937.21,794232.78
510704,202301,1318,660,658,860655.18,859332.71,1719987.89
510706,202301,161,82,79,106767.21,102859.74,209626.95
510710,202301,445,314,131,408834.74,170562.6,579397.34
510715,202301,57,39,18,50778,23436.18,74214.18
510718,202301,253,112,141,145826,183586.19,329412.19
510719,202301,50,21,29,27342,37758,65100
510720,202301,187,130,57,169260.79,74214,243474.79
510724,202301,82,30,52,39060,67704,106764
510726,202301,67,32,35,41664.7,45570.62,87235.32
510729,202301,16,7,9,9114,11718.1,20832.1
510730,202301,470,256,214,333314.46,278628,611942.46
510735,202301,119,46,73,59892.92,95046,154938.92
510740,202301,25,14,11,18229.78,14322.13,32551.91
510757,202301,29,24,5,31249.3,6510.16,37759.46
510760,202301,8052,4046,4006,5269319.45,5223670.04,10492989.49
510770,202301,752,341,411,443990.01,536426.1,980416.11
510774,202301,17,7,10,9114.19,13020,22134.19
510775,202301,122,93,29,121086,37758,158844
510776,202301,35,12,23,15624,29946.2,45570.2
510777,202301,188,84,104,109368,135408,244776
510779,202301,42,24,18,32550,23436,55986
510780,202301,275,141,134,183590.79,174468.2,358058.99
510785,202301,351,190,161,247384.28,209622.12,457006.40
510787,202301,212,104,108,135411.7,140617.01,276028.71
510788,202301,8,4,4,5208.4,5208,10416.4
510790,202301,2796,1444,1352,1882792.89,1761613.4,3644406.29
510792,202301,1172,649,523,845025.02,680959.41,1525984.43
510794,202301,117,64,53,83329.06,69006.92,152335.98
510795,202301,2416,1370,1046,1787681.86,1363203.67,3150885.53
510800,202301,197,111,86,144523.33,111972.14,256495.47
510805,202301,215,141,74,183582.4,96348,279930.4
510810,202301,108,42,66,55988.72,85932.42,141921.14
510820,202301,265,135,130,175773.45,169262.14,345035.59
510830,202301,82,40,42,52080,54684,106764
510835,202301,24,17,7,22134.2,9114,31248.2
510840,202301,9883,4451,5432,5796711.67,7076452.84,12873164.51
510850,202301,217,85,132,110672.27,173166.26,283838.53
510860,202301,422,209,213,272120.22,277326.42,549446.64
510880,202301,80,56,24,72912.2,31248,104160.2
510885,202301,73,42,31,54685.06,40362.6,95047.66
510890,202301,78,38,40,49476.86,52080.45,101557.31
510895,202301,183,108,75,140617.58,97650,238267.58
520005,202301,158,62,96,80726.88,124994.46,205721.34
520010,202301,322,139,183,180980.17,239573.24,420553.41
520013,202301,763,516,247,671845.65,322900.25,994745.90
520015,202301,39,26,13,33852,16926,50778
520017,202301,86,53,33,69006.15,42966,111972.15
520020,202301,11,5,6,6510,7812,14322
520025,202301,3078,1638,1440,2134072.91,1876242.79,4010315.70
520030,202301,902,464,438,604139.42,571581.68,1175721.10
520050,202301,64,48,16,62496.2,22134.16,84630.36
520055,202301,79,52,27,67704,35154.2,102858.2
520060,202301,177,117,60,152340.07,78121.65,230461.72
520080,202301,578,417,161,542936.4,209622,752558.4
520082,202301,16,12,4,15624,5208,20832
520085,202301,109,83,26,108067.38,33852.2,141919.58
520090,202301,83,59,24,78120.75,31248,109368.75
520110,202301,9809,4156,5653,5411248.55,7365482.66,12776731.21
520120,202301,13,7,6,9114,7812,16926
520130,202301,878,605,273,787721.21,355447.77,1143168.98
520140,202301,12784,6922,5862,9014033.94,7636316.81,16650350.75
520145,202301,60,34,26,44268.2,33852,78120.2
520150,202301,139,109,30,141922.27,39060,180982.27
520160,202301,42,25,17,32550,22134,54684
520170,202301,223,128,95,166663.36,123693.61,290356.97
520180,202301,206,93,113,121087.36,147126.63,268213.99
520215,202301,194,135,59,175770.46,76818.2,252588.66
520235,202301,86,65,21,84630.8,27342,111972.8
520250,202301,155,82,73,106764.99,95046,201810.99
520260,202301,116,71,45,92444.27,59892.99,152337.26
520280,202301,46,34,12,44268,15624,59892
520310,202301,26,14,12,18228.9,15624.8,33853.7
520320,202301,186,111,75,144524.26,98952.97,243477.23
520330,202301,884,488,396,635390.66,515597.2,1150987.86
520340,202301,306,179,127,233067.13,165356.07,398423.20
520350,202301,499,253,246,329410.49,320293.31,649703.80
520355,202301,105,62,43,80725.83,55986,136711.83
520357,202301,35,28,7,36456,9114,45570
520360,202301,19,5,14,6510.2,18228.28,24738.48
520380,202301,146,80,66,104160,85932,190092
520390,202301,241,107,134,139318.29,174468,313786.29
520393,202301,17,13,4,16926.1,5208,22134.1
520396,202301,77,56,21,72912,27342,100254
520400,202301,213,130,83,169265.07,108069.42,277334.49
520410,202301,195,97,98,126297.64,127596.2,253893.84
520420,202301,20,15,5,19530.11,6510,26040.11
520425,202301,253,125,128,162752.27,166656.48,329408.75
520430,202301,552,261,291,339823.68,378882.5,718706.18
520440,202301,674,478,196,622371.36,255192.93,877564.29
520450,202301,2299,969,1330,1261671.73,1734278.95,2995950.68
520455,202301,64,38,26,49478.75,33852.51,83331.26
520460,202301,46,28,18,36456.19,23436.75,59892.94
520465,202301,38,31,7,40362,9114,49476
520470,202301,465,289,176,376280.39,229152.2,605432.59
520480,202301,77,47,30,61194.95,39060,100254.95
520485,202301,113,41,72,53382.72,93744.1,147126.82
520490,202301,516,371,145,483051.02,188792.62,671843.64
520495,202301,166,98,68,127596.1,88536,216132.1
520500,202301,190,150,40,195301.95,52080,247381.95
520505,202301,193,113,80,147126,104160,251286
520510,202301,2103,987,1116,1287702.53,1455648.45,2743350.98
520520,202301,64,41,23,53382.69,29946,83328.69
520530,202301,212,168,44,218741.45,57288,276029.45
520540,202301,770,522,248,684860.85,325502.28,1010363.13
520545,202301,153,86,67,111974.83,87234,199208.83
520547,202301,75,41,34,53384.76,44268.51,97653.27
520549,202301,1578,752,826,980440.42,1076770.71,2057211.13
520551,202301,346,180,166,234365.43,218736.6,453102.03
520552,202301,43,30,13,39061.2,16926,55987.2
520570,202301,16,11,5,14322,6510,20832
520580,202301,282,173,109,225250,141918.16,367168.16
520590,202301,150,84,66,109369.78,85932,195301.78
520620,202301,1277,594,683,774700.89,890574.71,1665275.60
520630,202301,48,27,21,35154,27342,62496
520640,202301,397,230,167,299464.87,218736.39,518201.26
520650,202301,67,33,34,42966,44268,87234
520660,202301,43,23,20,29947.19,26040.38,55987.57
520670,202301,48,36,12,46872.74,15624,62496.74
520680,202301,26,16,10,20832,13020,33852
520690,202301,40,11,29,14322,37758,52080
520710,202301,38,30,8,39060,10416,49476
520725,202301,194,143,51,186189.3,66402,252591.3
520735,202301,58,37,21,48174.22,27342.2,75516.42
520740,202301,489,239,250,311182.74,325500.24,636682.98
520750,202301,39,24,15,31248,19530,50778
520753,202301,79,58,21,75516.2,27342,102858.2
520760,202301,105,71,34,92442.6,44268.98,136711.58
520780,202301,270,213,57,277329.52,74214.32,351543.84
520790,202301,151,92,59,119784.3,76818,196602.3
520800,202301,3565,1990,1575,2592358.13,2051978.26,4644336.39
520810,202301,139,107,32,139316.6,41664.89,180981.49
520815,202301,6,4,2,5208.96,2604,7812.96
520830,202301,135,92,43,119787.16,55986.05,175773.21
520840,202301,412,267,145,347636.13,188790,536426.13
520850,202301,114,64,50,83329.69,65100,148429.69
520860,202301,1904,1194,710,1555928.03,924426.08,2480354.11
520870,202301,35115,15809,19306,20590491.61,25154923.35,45745414.96
520880,202301,1330,700,630,911437.85,821580.25,1733018.10
520890,202301,864,543,321,707005.69,417942.72,1124948.41
520910,202301,1018,533,485,693987.15,631472.44,1325459.59
520915,202301,95,67,28,87236.13,36456,123692.13
520920,202301,513,239,274,311188.09,358057.72,669245.81
520929,202301,16,13,3,16926.34,3906,20832.34
520940,202301,64,46,18,59893.84,23436.1,83329.94
520945,202301,18,10,8,13020,10416,23436
520960,202301,47,28,19,36456,24738,61194
520970,202301,430,247,183,321599.11,240872.12,562471.23
520980,202301,90,65,25,84630,32550,117180
520990,202301,440,311,129,404924.2,169260.39,574184.59
520993,202301,124,62,62,80727.62,82026.3,162753.92
520995,202301,270,147,123,191396.14,160146,351542.14
521000,202301,1673,916,757,1192653.04,985624.17,2178277.21
521010,202301,659,352,307,458311.98,399716.18,858028.16
521015,202301,12,7,5,9114,6510,15624
521020,202301,1468,1032,436,1343691.38,568983.27,1912674.65
521030,202301,74,50,24,65100.53,31248,96348.53
521040,202301,1023,677,346,881476.4,450493.48,1331969.88
521056,202301,59,39,20,50778,26040,76818
521060,202301,126,81,45,105462.4,58590.76,164053.16
521080,202301,331,260,71,338536.02,92442.5,430978.52
521090,202301,601,403,198,524711,257796.89,782507.89
521100,202301,270,190,80,247383.55,104160.4,351543.95
521120,202301,1110,783,327,1019754.5,425756.73,1445511.23
521130,202301,329,234,95,304674.8,123690.6,428365.4
521140,202301,193,107,86,139318.61,113274.69,252593.30
521150,202301,2676,1144,1532,1489542.94,1994693.67,3484236.61
521160,202301,25,10,15,13020,19530,32550
521170,202301,237,126,111,164053.13,145824.2,309877.33
521180,202301,1242,784,458,1020792.01,596323.61,1617115.62
521190,202301,2690,1109,1581,1445258.72,2058480.91,3503739.63
521200,202301,61,42,19,54684.2,24738,79422.2
521205,202301,14,11,3,14322.2,3906,18228.2
521210,202301,132,79,53,102859.88,69006,171865.88
521220,202301,769,528,241,687463.63,315086.39,1002550.02
521225,202301,22,15,7,19532.16,9114.93,28647.09
521230,202301,106,69,37,89839.02,50779.39,140618.41
521250,202301,6716,3663,3053,4769398.56,3975067.13,8744465.69
521260,202301,42,19,23,24738,29946,54684
521270,202301,126,95,31,123690.26,40362,164052.26
521280,202301,429,269,160,350240.94,208320,558560.94
521290,202301,29,17,12,22134.78,15624,37758.78
521295,202301,106,72,34,93745.38,44268,138013.38
521300,202301,241,134,107,174469.39,140617.03,315086.42
521305,202301,45,31,14,40362.79,18228,58590.79
521308,202301,1036,790,246,1028609.08,320295.76,1348904.84
521310,202301,1449,804,645,1046839.98,841107.05,1887947.03
521340,202301,20,16,4,20832,5208,26040
521350,202301,112,83,29,109368.93,37758,147126.93
521370,202301,172,113,59,147126.2,76818,223944.2
521375,202301,203,98,105,127598.97,136710.88,264309.85
521377,202301,49,37,12,48174.13,15624.1,63798.23
521380,202301,1131,671,460,873674.29,600227.54,1473901.83
521385,202301,12,7,5,9114,6510,15624
521390,202301,107,84,23,109369.54,29946.49,139316.03
521400,202301,403,287,116,373685.11,151033.92,524719.03
521405,202301,160,97,63,126296.67,82026.66,208323.33
521410,202301,82,60,22,78120.87,28644,106764.87
521440,202301,220,150,70,195306.13,92442.8,287748.93
521450,202301,812,444,368,578096.69,479138.43,1057235.12
521460,202301,1127,773,354,1006483.31,464818.58,1471301.89
521470,202301,13,9,4,11718,5208,16926
521480,202301,41,28,13,36456.68,16926.1,53382.78
521483,202301,335,216,119,281235.29,154938.56,436173.85
521486,202301,306,201,105,261703.43,136710.84,398414.27
521487,202301,23,11,12,14322,15624,29946
521490,202301,26,16,10,20832,13020,33852
521500,202301,148,65,83,84630.2,109368.29,193998.49
521520,202301,44,33,11,42966,14322,57288
521523,202301,1151,626,525,815067.29,684854.98,1499922.27
521525,202301,60,42,18,54684,23436,78120
521530,202301,249,141,108,183582.39,140616.49,324198.88
521540,202301,46,23,23,29946,29946,59892
521550,202301,118,55,63,71610.33,82027.89,153638.22
521560,202301,941,621,320,808564.22,416643.59,1225207.81
521565,202301,73,51,22,66403.16,28644,95047.16
521570,202301,588,373,215,485654.05,281233.07,766887.12
521580,202301,49,28,21,36456,27342,63798
521590,202301,41,21,20,27342,26040,53382
521600,202301,26,12,14,15624,18228,33852
521630,202301,226,115,111,149735.99,145831.11,295567.10
521640,202301,324,171,153,222644.49,199207.11,421851.60
521645,202301,41,22,19,28644,24738,53382
521680,202301,261,159,102,207019.54,132804.4,339823.94
521690,202301,16,14,2,18228,2604,20832
521710,202301,1156,546,610,710902.91,795527.14,1506430.05
521720,202301,629,411,218,535128.08,287743.47,822871.55
521730,202301,729,339,390,441386.36,507783.06,949169.42
521740,202301,935,428,507,557260.31,660118.68,1217378.99
521760,202301,2487,1276,1211,1661506.53,1579364.16,3240870.69
521770,202301,863,522,341,679652.66,443984.26,1123636.92
521800,202301,2057,1383,674,1800696.96,878852.12,2679549.08
521805,202301,36,22,14,28644,18228,46872
521810,202301,95,53,42,69006.8,54684.19,123690.99
521830,202301,1039,754,285,981735.4,371076.69,1352812.09
521839,202301,72,41,31,53382,40362,93744
521850,202301,1208,600,608,781221.47,792928.62,1574150.09
521860,202301,338,210,128,273425.48,166656,440081.48
521870,202301,87,55,32,71610,41664,113274
521878,202301,35,14,21,18228,27342.98,45570.98
521880,202301,5269,2284,2985,2973859.3,3887810.12,6861669.42
521890,202301,650,443,207,578097.19,269515.99,847613.18
521900,202301,280,218,62,283837.3,80724.2,364561.5
521910,202301,183,128,55,166664.35,71610.98,238275.33
521920,202301,38,22,16,28644,20832,49476
521925,202301,54,30,24,39060,31248,70308
521930,202301,1288,711,577,925749.07,752563.95,1678313.02
521935,202301,34,24,10,31249.47,13020,44269.47
521940,202301,245,110,135,143221.21,175771.25,318992.46
521945,202301,22,14,8,18228,10416,28644
521950,202301,22,15,7,19530,9114,28644
521960,202301,70,55,15,71610,19530,91140
521970,202301,417,270,147,351542.55,191394.89,542937.44
521971,202301,112,58,54,75516.72,70308,145824.72
521973,202301,40,16,24,20832.6,31248,52080.6
521975,202301,1696,882,814,1148399.49,1059846.26,2208245.75
521980,202301,241,164,77,213529.87,100254,313783.87
521990,202301,85,58,27,75517.17,35154,110671.17
522000,202301,295,196,99,254745.75,128898.79,383644.54
522005,202301,20,11,9,14322,11718,26040
522010,202301,1196,667,529,868464.77,688765.85,1557230.62
522015,202301,56,34,22,44268,28644,72912
522020,202301,916,547,369,713505.45,481745.87,1195251.32
522026,202301,27,18,9,23436,11718,35154
522028,202301,22,19,3,24738,3906,28644
522040,202301,859,374,485,486964.61,632778.75,1119743.36
522045,202301,2900,1694,1206,2205663.27,1572834.22,3778497.49
522050,202301,163,72,91,93748.67,118482.72,212231.39
522060,202301,557,347,210,451802.58,273421.01,725223.59
522068,202301,113,81,32,105462.39,41664,147126.39
522070,202301,19,16,3,20832,3906,24738
522100,202301,40,25,15,32550,19530,52080
522108,202301,44,35,9,45571.27,11718,57289.27
522119,202301,63,36,27,46872.82,35154,82026.82
522130,202301,80,29,51,37759.09,66402.97,104162.06
522140,202301,4471,2334,2137,3038960.21,2786302.95,5825263.16
522145,202301,50,35,15,45570,19530,65100
522150,202301,109,73,36,95047.04,46872.84,141919.88
522155,202301,55,36,19,46872.52,24738,71610.52
522157,202301,15,8,7,10416,9114,19530
522160,202301,1725,1024,701,1334581.84,912710.12,2247291.96
522170,202301,427,297,130,386697.54,170563.34,557260.88
522180,202301,30,12,18,15624,23436,39060
522185,202301,2679,1158,1521,1507773.2,1984292.36,3492065.56
522190,202301,76,44,32,57288.67,41664,98952.67
522200,202301,337,196,141,255193.68,183582.24,438775.92
522205,202301,146,100,46,130202.68,59892.1,190094.78
522220,202301,145,112,33,145824.2,42966,188790.2
522230,202301,30,27,3,35154.41,3906,39060.41
530010,202301,59355,30058,29297,39158903.77,38180637.21,77339540.98
110001,202302,533,436,97,567680.07,126294,693974.07
110002,202302,3012,1914,1098,2492087.84,1429609.35,3921697.19
110003,202302,79,61,18,79424.58,23436,102860.58
110004,202302,2199,1499,700,1951733.8,911407.73,2863141.53
110005,202302,453,353,100,459610.44,130200.2,589810.64
110006,202302,447,332,115,432269.47,149730,581999.47
110007,202302,78,63,15,82026.6,19530,101556.6
110008,202302,272,156,116,203113.89,151032.2,354146.09
110009,202302,979,750,229,976509.72,298158.91,1274668.63
110010,202302,1727,979,748,1275984.49,977803.83,2253788.32
110011,202302,1751,1350,401,1757745.92,522109.98,2279855.90
110012,202302,4272,2451,1821,3192560.99,2370960.48,5563521.47
110013,202302,745,593,152,772111.1,197907.09,970018.19
110014,202302,359,319,40,415343.82,52080,467423.82
110015,202302,1397,1061,336,1381443.3,437477.04,1818920.34
110018,202302,1056,658,398,856737.21,518197.68,1374934.89
110020,202302,17146,9495,7651,12377397.53,9965656.9,22343054.43
110025,202302,663,484,179,632776.24,233058.4,865834.64
110026,202302,34,22,12,28645.54,15624,44269.54
110028,202302,1671,1180,491,1536398.6,639291.97,2175690.57
110029,202302,132,119,13,154940.89,16926,171866.89
110030,202302,2497,1614,883,2101263.17,1149672.04,3250935.21
110032,202302,339,261,78,339830.4,101558.81,441389.21
110033,202302,691,493,198,643214.36,257802.62,901016.98
110034,202302,334,251,83,326804.54,108066.9,434871.44
110037,202302,95,82,13,106765.1,16926,123691.1
110040,202302,407,283,124,368467.5,161448,529915.5
110045,202302,1006,728,278,947882.23,363260.54,1311142.77
110050,202302,92,82,10,106766.74,13020.13,119786.87
110060,202302,57,37,20,48174.92,26040,74214.92
110070,202302,108,71,37,92443.36,48174,140617.36
110080,202302,563,325,238,423157.03,309876.81,733033.84
110090,202302,26,21,5,27342,6510,33852
110092,202302,121,58,63,75517.62,82026,157543.62
110094,202302,214,148,66,192698.69,87234,279932.69
110100,202302,55,40,15,52081.33,19530.06,71611.39
110110,202302,118,69,49,89840.83,63798.1,153638.93
110120,202302,67,58,9,75517.36,11718,87235.36
110130,202302,266,216,50,281240.62,65100.9,346341.52
110140,202302,266,189,77,246081.7,100254.1,346335.8
110143,202302,53,43,10,55986,13020,69006
110145,202302,45,33,12,42966.39,15624,58590.39
110146,202302,28,12,16,15624.2,20832,36456.2
110147,202302,42,26,16,33852,20832.58,54684.58
110148,202302,32,25,7,32550.14,9114,41664.14
110149,202302,307,212,95,276025.5,123690,399715.5
110150,202302,139,108,31,140616.5,40362,180978.5
110155,202302,11,10,1,13020,1302,14322
110160,202302,66,50,16,65101.21,20832,85933.21
110170,202302,226,170,56,221343.46,72912,294255.46
110175,202302,68,53,15,69006.8,19530,88536.8
110180,202302,82,64,18,83329.58,23436,106765.58
120001,202302,229,163,66,212233.09,85932.65,298165.74
120005,202302,228,131,97,170564.64,126294.1,296858.74
120010,202302,1206,735,471,956982.9,614546.74,1571529.64
120013,202302,172,118,54,153637.88,70308.1,223945.98
120017,202302,140,85,55,110671,71610,182281
120020,202302,3521,2837,684,3693868.65,891882.63,4585751.28
120025,202302,599,325,274,423193.1,358066.57,781259.67
120030,202302,1212,1048,164,1365861.01,213536.45,1579397.46
120032,202302,43,39,4,50779.1,5208,55987.1
120033,202302,226,197,29,256502.02,39060.55,295562.57
120034,202302,182,136,46,177075.25,59892,236967.25
120035,202302,56,49,7,63798.1,9114,72912.1
120038,202302,416,271,145,354159.85,188792.07,542951.92
120039,202302,34,31,3,40363.1,3906,44269.1
120040,202302,15202,10169,5033,13249353.32,6557212.23,19806565.55
120042,202302,47,44,3,57290.6,3906,61196.6
120043,202302,17,4,13,5208,16926,22134
120045,202302,557,351,206,457020.57,268214.99,725235.56
120050,202302,1324,1015,309,1321596.45,402332.18,1723928.63
120060,202302,1524,1270,254,1653605.69,330715.34,1984321.03
120070,202302,425,306,119,398426.05,154938.92,553364.97
120080,202302,204,135,69,175775.32,89838.55,265613.87
130002,202302,164,117,47,152334.95,61194,213528.95
130006,202302,109,73,36,96348,46872,143220
130008,202302,131,77,54,100254.62,70308,170562.62
130010,202302,175,111,64,144522.2,83328.3,227850.5
130014,202302,311,218,93,284163.7,121087.65,405251.35
130020,202302,149,103,46,134107.72,59892,193999.72
130030,202302,1019,573,446,746052.05,580692.44,1326744.49
130040,202302,410,206,204,268214.2,265608,533822.2
130050,202302,572,303,269,394515.69,350247.62,744763.31
130060,202302,902,612,290,796827.48,377580.7,1174408.18
130063,202302,618,381,237,496062.1,308574,804636.1
130068,202302,234,147,87,191395.09,113275.59,304670.68
130070,202302,1388,919,469,1196564.71,610643.26,1807207.97
130080,202302,739,511,228,665329.66,296858.98,962188.64
130083,202302,90,59,31,76818.9,40362,117180.9
130090,202302,317,180,137,234360.58,178374,412734.58
130100,202302,1346,678,668,882769.77,869747.05,1752516.82
130110,202302,844,367,477,477839.03,621055.3,1098894.33
130115,202302,150,75,75,97650,97650,195300
130120,202302,1729,1076,653,1400965,850208,2251173
130130,202302,654,441,213,574183,277326,851509
130140,202302,1574,1208,366,1572825.91,476533.32,2049359.23
130150,202302,432,385,47,501271,61194,562465
130160,202302,472,298,174,387998,226548,614546
130165,202302,143,126,17,164054.61,22134,186188.61
130170,202302,1166,804,362,1046753.54,471333.85,1518087.39
130180,202302,278,212,66,276027.47,85932.2,361959.67
130185,202302,2364,1155,1209,1505157.31,1576744.02,3081901.33
130190,202302,3429,2135,1294,2779851.11,1690016.09,4469867.20
130195,202302,295,236,59,307272,76818,384090
130200,202302,225,132,93,171866.51,121086,292952.51
130210,202302,95,45,50,58590,65100,123690
130220,202302,213,156,57,203113.9,74214,277327.9
130230,202302,370,249,121,324198,157542,481740
130240,202302,1377,894,483,1165297.14,628867.14,1794164.28
130250,202302,5010,3245,1765,4228992.11,2298060.85,6527052.96
130255,202302,447,227,220,295554.52,286440.85,581995.37
130260,202302,67099,31039,36060,40443020.77,46985252.56,87428273.33
130270,202302,1569,1076,493,1401079.76,641888.59,2042968.35
130280,202302,145,85,60,110670.1,79422,190092.1
130290,202302,2089,1343,746,1751229.7,971300.1,2722529.8
130300,202302,431,295,136,384092.69,177074.29,561166.98
130310,202302,972,537,435,699177.11,566370.9,1265548.01
130320,202302,565,308,257,401017.26,335916,736933.26
130330,202302,812,542,270,705689.04,351541.68,1057230.72
130340,202302,3662,1995,1667,2597581.08,2170464.3,4768045.38
130350,202302,471,327,144,425754,187488,613242
130353,202302,1002,465,537,605448.08,699182.32,1304630.40
130356,202302,858,396,462,515599.03,601527.81,1117126.84
130360,202302,105,83,22,108066.2,28644.1,136710.3
130370,202302,706,558,148,726519.07,192696,919215.07
130380,202302,679,531,148,691365.99,192696.8,884062.79
130390,202302,502,410,92,533820.2,119784,653604.2
130395,202302,173,66,107,85932.31,139314,225246.31
130400,202302,103,79,24,102861.35,31248,134109.35
130406,202302,2280,1335,945,1738183.52,1230395,2968578.52
130410,202302,444,234,210,304668,273420,578088
130420,202302,2872,2331,541,3036358.18,705687.71,3742045.89
130423,202302,230,154,76,200512.54,98952,299464.54
130426,202302,194,107,87,139314,113274,252588
130430,202302,451,265,186,345030.8,242172.1,587202.9
130440,202302,204,72,132,93748.44,171867.87,265616.31
140002,202302,55,17,38,22134.2,49476.64,71610.84
140005,202302,231,135,96,175773.63,124994.53,300768.16
140010,202302,12923,7480,5443,9745966.08,7093469.95,16839436.03
140015,202302,218,76,142,98955.29,184885,283840.29
140017,202302,153,84,69,109380.26,91142.87,200523.13
140020,202302,460,308,152,401028.5,197908.67,598937.17
140023,202302,75,45,30,58590,39060.24,97650.24
140028,202302,27,15,12,19531.05,15624.94,35155.99
140030,202302,426,273,153,355456.86,199208.39,554665.25
140040,202302,81,53,28,69006.82,36456,105462.82
140045,202302,366,109,257,141918.39,334617.41,476535.80
140047,202302,602,382,220,498676.05,286442.63,785118.68
140050,202302,148,94,54,122391.24,71611.59,194002.83
140060,202302,88,61,27,79423.68,35154.2,114577.88
140070,202302,24,21,3,27342.2,3906,31248.2
150010,202302,5374,3231,2143,4206873.16,2790217.82,6997090.98
150013,202302,176,119,57,154939.34,74214.99,229154.33
150020,202302,1201,675,526,878866.3,686156.17,1565022.47
150030,202302,724,322,402,419253.63,523407.34,942660.97
150034,202302,220,127,93,165355.03,121086.7,286441.73
150040,202302,1743,994,749,1294248.53,975223.43,2269471.96
150050,202302,785,464,321,604136.54,417943.16,1022079.70
150060,202302,5224,3246,1978,4230211.8,2575939.52,6806151.32
150070,202302,513,278,235,361961.4,305971.75,667933.15
150080,202302,18973,8805,10168,11468590.56,13252103.69,24720694.25
150085,202302,488,296,192,385405.01,249989.59,635394.60
150090,202302,767,613,154,798149.97,200508.91,998658.88
150095,202302,81,56,25,72913.81,32551.82,105465.63
150100,202302,75,45,30,59892,39061.15,98953.15
150110,202302,215,126,89,164053.15,115878.1,279931.25
150120,202302,413,295,118,384098.94,153637.57,537736.51
150125,202302,47,19,28,24738,36456,61194
150130,202302,2533,1234,1299,1606727.61,1691542.64,3298270.25
150140,202302,64555,27610,36945,35960258.8,48132104.88,84092363.68
150145,202302,274,147,127,191395.85,165354.1,356749.95
150150,202302,3891,1698,2193,2210871.74,2859244.62,5070116.36
150157,202302,379,267,112,347646.06,145825.2,493471.26
150160,202302,159,119,40,154938.67,52080,207018.67
150170,202302,4341,3137,1204,4084477.72,1571534.38,5656012.10
150172,202302,394,273,121,355451.25,157543.7,512994.95
150175,202302,92,53,39,69007,50778,119785
150178,202302,821,556,265,723939.21,346337.64,1070276.85
150180,202302,3491,1748,1743,2275954.59,2272004.39,4547958.98
150190,202302,412,278,134,361964.81,174470.18,536434.99
150195,202302,139,77,62,100254.8,80724.64,180979.44
150200,202302,194,93,101,121086,132804.3,253890.3
150210,202302,3401,2622,779,3413972.77,1014316.6,4428289.37
150215,202302,733,430,303,559881.91,394517.36,954399.27
150220,202302,3699,2435,1264,3173065.19,1647063.92,4820129.11
150230,202302,1472,1176,296,1531191.44,385400.77,1916592.21
150240,202302,7845,4303,3542,5602741,4617009.11,10219750.11
150250,202302,85,48,37,62497.5,48174,110671.5
150260,202302,130,89,41,115882.4,53382.8,169265.2
150270,202302,2238,1452,786,1890544.07,1023381.79,2913925.86
150275,202302,572,369,203,480449.26,264306.84,744756.10
150276,202302,116,39,77,50778.2,100255.19,151033.39
150277,202302,911,405,506,527325.49,661431.7,1188757.19
150280,202302,345,237,108,308577.87,140616,449193.87
150285,202302,158,78,80,101558.83,103951.68,205510.51
150290,202302,1385,783,602,1019490.19,783814,1803304.19
150293,202302,892,424,468,552068.84,609346.46,1161415.30
150295,202302,614,291,323,378897.6,420549.1,799446.7
150300,202302,101,47,54,61194.1,70308.6,131502.7
150304,202302,204,119,85,154940.79,110673.15,265613.94
150307,202302,463,379,84,493469.8,109368.5,602838.3
150309,202302,623,439,184,571607.53,239571.31,811178.84
150310,202302,297,198,99,257799.05,128898,386697.05
150320,202302,2016,1394,622,1815017.58,809854.5,2624872.08
150330,202302,2253,1287,966,1676994.64,1257737.94,2934732.58
150340,202302,206,133,73,173168.4,95046.42,268214.82
150345,202302,695,381,314,496070.42,408828,904898.42
150350,202302,431,343,88,446613.64,114579.05,561192.69
150360,202302,5278,3059,2219,3982934.51,2889171.15,6872105.66
150370,202302,875,587,288,764306.04,374980.82,1139286.86
150375,202302,202,83,119,108067.11,154938.18,263005.29
150380,202302,1592,1060,532,1380150.93,693972.47,2074123.40
150390,202302,955,550,405,716133.56,527317.21,1243450.77
150400,202302,125,106,19,138013,24738,162751
150405,202302,1733,1095,638,1425717.69,830679.87,2256397.56
150410,202302,106,66,40,85932.77,52080.2,138012.97
150420,202302,8325,4414,3911,5750110.76,5097471.23,10847581.99
150430,202302,696,429,267,559903.49,347644.49,907547.98
150440,202302,482,295,187,384103.63,244779.92,628883.55
150442,202302,2624,1393,1231,1815061.12,1602792.9,3417854.02
150445,202302,574,380,194,494766.29,252588.4,747354.69
150450,202302,249,145,104,188790.22,135408.22,324198.44
150460,202302,737,556,181,723934.36,235663.28,959597.64
150470,202302,1340,800,540,1041634.62,703084.99,1744719.61
150475,202302,248,188,60,244785.75,78122.26,322908.01
150480,202302,1545,1094,451,1424450.75,588513.1,2012963.85
150490,202302,607,365,242,476536.51,315084,791620.51
150495,202302,369,275,94,358050.98,122388,480438.98
150497,202302,296,190,106,247382.06,138012.3,385394.36
150500,202302,283,164,119,213529.53,154938.1,368467.63
150503,202302,1459,729,730,949191.23,951776.61,1900967.84
150506,202302,951,653,298,851521.76,387997.32,1239519.08
150510,202302,1402,765,637,996061.85,829380.45,1825442.30
150520,202302,344,235,109,305972.45,141919,447891.45
150530,202302,2136,1215,921,1582057.16,1199210.42,2781267.58
150540,202302,238,175,63,227852.86,82026.81,309879.67
150543,202302,938,488,450,635393.21,585908.89,1221302.10
150548,202302,461,334,127,434873.87,165355.03,600228.90
150549,202302,81,53,28,69008.5,36456,105464.5
150550,202302,3403,1719,1684,2240585.84,2195192.65,4435778.49
150553,202302,4020,2235,1785,2910102.25,2325422.51,5235524.76
150555,202302,140,77,63,100254.2,83329.17,183583.37
150560,202302,78,38,40,49477.11,52080,101557.11
150563,202302,132,67,65,87237.82,84631.94,171869.76
150565,202302,228,134,94,174469.66,122388.38,296858.04
150570,202302,434,286,148,372373.9,192696.8,565070.7
150580,202302,1839,912,927,1187436.24,1206956.28,2394392.52
150590,202302,894,597,297,777320.34,386696.02,1164016.36
150600,202302,532,336,196,437485.52,255196.35,692681.87
150610,202302,188,147,41,191395.49,53382,244777.49
150611,202302,152,104,48,136710,62496,199206
150613,202302,3669,2028,1641,2640554.09,2138002.19,4778556.28
150616,202302,633,339,294,441384.44,382790.35,824174.79
150618,202302,1470,761,709,990830,923120.51,1913950.51
150619,202302,421,321,100,417946.37,130204.54,548150.91
150620,202302,1354,766,588,997359.14,765580.8,1762939.94
150630,202302,180,116,64,151043.69,83329.99,234373.68
150635,202302,488,220,268,287752.88,348940.1,636692.98
150640,202302,48,22,26,28645.3,33852,62497.3
150650,202302,2614,1492,1122,1943965.8,1462180.79,3406146.59
150655,202302,284,203,81,264306.69,105462,369768.69
150658,202302,69,40,29,52080,37758,89838
150660,202302,651,404,247,526019.72,321597.45,847617.17
150670,202302,1212,441,771,574191.25,1005152.41,1579343.66
150680,202302,12007,6272,5735,8166507.63,7472362.26,15638869.89
150690,202302,44,20,24,26040.95,31248,57288.95
150700,202302,586,391,195,509104.48,253894.76,762999.24
150710,202302,309,173,136,226554.82,177073.3,403628.12
150715,202302,862,547,315,712214.9,411435.84,1123650.74
150720,202302,453,341,112,443990.99,145824.73,589815.72
150730,202302,1221,572,649,744764.03,845007.45,1589771.48
150740,202302,268,172,96,223944.85,124992,348936.85
150745,202302,860,484,376,630189.48,489560.14,1119749.62
150746,202302,71,35,36,45570.89,46872,92442.89
150747,202302,272,184,88,239574.32,114576.67,354150.99
150750,202302,146,79,67,102862.73,87237.56,190100.29
150760,202302,1979,1306,673,1700444.79,876254.86,2576699.65
150770,202302,423,248,175,322897.28,227850.2,550747.48
150775,202302,105,54,51,70308.48,66402.56,136711.04
150780,202302,219,127,92,165355.92,119784,285139.92
150790,202302,728,419,309,545550.81,402321.33,947872.14
150795,202302,1828,1116,712,1454364.84,927034.33,2381399.17
150796,202302,331,192,139,249985.6,180978.2,430963.8
150797,202302,428,196,232,255200.56,303368,558568.56
150800,202302,1766,973,793,1266864.45,1032488.18,2299352.63
150803,202302,366,268,98,348948.46,127599.48,476547.94
150805,202302,217,130,87,169261.22,113274.7,282535.92
150808,202302,1179,583,596,760377.13,775996.23,1536373.36
150810,202302,3338,2250,1088,2932190.49,1421791.38,4353981.87
150812,202302,561,290,271,378888.29,352844.2,731732.49
150815,202302,1318,817,501,1063748.23,653607.39,1717355.62
150820,202302,1786,1067,719,1389292.16,938762.01,2328054.17
150830,202302,597,449,148,584614.92,192697.62,777312.54
150835,202302,254,156,98,203115.59,127596,330711.59
150840,202302,1553,886,667,1153604.07,869747.78,2023351.85
160005,202302,72,49,23,63799.25,29946.12,93745.37
160010,202302,211,130,81,169264.54,106765.45,276029.99
160015,202302,183,122,61,158853.99,79424.01,238278.00
160020,202302,151,75,76,97651.44,98952.54,196603.98
160021,202302,65,31,34,40364.16,45570.72,85934.88
160023,202302,78,48,30,62498.44,39060.44,101558.88
160025,202302,28,15,13,19531.22,16926.12,36457.34
160027,202302,1560,857,703,1115867.92,915314.79,2031182.71
160030,202302,18376,9435,8941,12290158.7,11650537.69,23940696.39
160040,202302,361,220,141,286450.91,183583.91,470034.82
160050,202302,811,369,442,480458.8,575494.88,1055953.68
160053,202302,311,186,125,242183.69,162752.84,404936.53
160055,202302,25,18,7,23437.5,9116.22,32553.72
160060,202302,7228,3937,3291,5126233.29,4288883.73,9415117.02
160070,202302,195,114,81,148432.07,105463.82,253895.89
160080,202302,149,75,74,97650.52,96348,193998.52
170025,202302,26,14,12,18228,15624.71,33852.71
170030,202302,169,136,33,177078.4,42966,220044.4
170035,202302,207,101,106,131508.77,138013.86,269522.63
170040,202302,184,137,47,178374,61194,239568
170070,202302,335,213,122,277332.56,158844.92,436177.48
170100,202302,362,262,100,341135.93,130200.8,471336.73
170105,202302,38,33,5,42966.83,6510,49476.83
170110,202302,114,70,44,91140.99,58590.1,149731.09
170130,202302,82,40,42,52080,54684,106764
170190,202302,105,61,44,79422.58,57288,136710.58
170200,202302,350,236,114,307274.77,148428.2,455702.97
170210,202302,7075,3869,3206,5038575.45,4179475.93,9218051.38
170215,202302,155,90,65,117183.64,84631.37,201815.01
170220,202302,1359,969,390,1261665.52,507785.95,1769451.47
170230,202302,149,100,49,130204.14,63798.5,194002.64
170240,202302,500,345,155,449211.9,201812.72,651024.62
170255,202302,1026,804,222,1046829.71,289046.7,1335876.41
170270,202302,45,32,13,41664,16926,58590
170290,202302,144,88,56,114578.49,72912,187490.49
170300,202302,119,79,40,102858.2,52080,154938.2
170305,202302,57,43,14,55986.8,18228,74214.8
170307,202302,57,41,16,53384.06,20832.9,74216.96
170310,202302,126,78,48,101558.48,62496,164054.48
170320,202302,39,25,14,32550.2,18228,50778.2
170330,202302,34,24,10,31249.27,13020.1,44269.37
170360,202302,33,19,14,24738.2,18229.53,42967.73
170370,202302,79,45,34,58591.81,44268.2,102860.01
170380,202302,85,63,22,82026.5,28644,110670.5
170382,202302,39,31,8,40362,10416,50778
170384,202302,145,111,34,145825.66,44268.44,190094.10
170386,202302,69,30,39,39060.61,50778,89838.61
170388,202302,46,21,25,27342.32,32550,59892.32
170389,202302,25,19,6,24738.96,7812,32550.96
170390,202302,83,49,34,63798.67,44268.04,108066.71
170410,202302,24,22,2,28645.36,2604,31249.36
170460,202302,15,9,6,11718.87,7812,19530.87
170510,202302,33,24,9,31248.81,11718,42966.81
170550,202302,1625,937,688,1220006.76,902296.06,2122302.82
170555,202302,113,84,29,109373.22,37758,147131.22
170560,202302,102,75,27,97650.58,35154.27,132804.85
170600,202302,41,15,26,19530.71,33852,53382.71
170610,202302,187,102,85,132807.4,110670.2,243477.6
170625,202302,31,18,13,24738.99,16926,41664.99
170650,202302,101,69,32,89838.64,41664.2,131502.84
170700,202302,587,434,153,565073.98,199206,764279.98
170710,202302,143,86,57,111976.95,74217.05,186194.00
170720,202302,110,85,25,110670.81,32550,143220.81
170730,202302,114,67,47,87235.76,61194,148429.76
170740,202302,85,61,24,79422,31248,110670
170755,202302,53,27,26,35156.32,33852.2,69008.52
170765,202302,138,81,57,105465.15,74215.86,179681.01
170770,202302,194,125,69,162751.98,89838.73,252590.71
170820,202302,603,399,204,519508.35,266911.03,786419.38
170825,202302,48,29,19,37758.3,24738,62496.3
170830,202302,91,69,22,89838.99,28644.33,118483.32
170900,202302,170,129,41,167959.36,53383.1,221342.46
170930,202302,1021,561,460,731750.33,600230.05,1331980.38
170950,202302,3384,1603,1781,2087156.56,2318883.36,4406039.92
170980,202302,16,10,6,13021.82,7812,20833.82
171050,202302,152,117,35,152334,45570.2,197904.2
171070,202302,64,51,13,66402.31,16926.38,83328.69
171090,202302,49,37,12,48174.2,15624,63798.2
171110,202302,24,18,6,23436.71,7812,31248.71
171150,202302,45,29,16,37758,20832,58590
171180,202302,24,11,13,14322,16926.27,31248.27
171190,202302,187,106,81,138012.95,105462,243474.95
171195,202302,58,47,11,61195.61,14322,75517.61
171200,202302,31,15,16,19530,20832,40362
171215,202302,10,8,2,10416,2604,13020
171240,202302,63,50,13,65100,16926,82026
171245,202302,56,47,9,61196.43,11718,72914.43
171250,202302,80,45,35,58590.2,45570,104160.2
171270,202302,11,7,4,9114.6,5208.22,14322.82
171280,202302,46,37,9,48176.26,11718.1,59894.36
171320,202302,1084,632,452,822876.18,588506.27,1411382.45
171330,202302,448,231,217,300763.8,282534.21,583298.01
171360,202302,107,76,31,98952.7,40362,139314.7
171370,202302,33,19,14,24738,18228.38,42966.38
171380,202302,137,115,22,149732.67,28644,178376.67
171395,202302,42,26,16,33852,20832,54684
171420,202302,265,174,91,226549.71,118482.2,345031.91
171430,202302,73,58,15,75516.2,19530.57,95046.77
171488,202302,218,123,95,160146.58,123690,283836.58
171500,202302,66,37,29,48174.2,37758,85932.2
171510,202302,77,50,27,65100,35154.52,100254.52
171515,202302,40,33,7,42968.11,9114,52082.11
171525,202302,25,22,3,28645.96,3906,32551.96
171550,202302,17,11,6,14322.9,7812,22134.9
171570,202302,58,29,29,37758,37758.1,75516.1
171575,202302,269,184,85,239569.55,110670,350239.55
171610,202302,2013,1034,979,1347600.77,1274680.31,2622281.08
171620,202302,157,113,44,147127.4,57288.28,204415.68
171630,202302,50,28,22,36456,28644.74,65100.74
171650,202302,359,247,112,321605.48,145826.45,467431.93
171660,202302,270,153,117,199212.81,152335.73,351548.54
171665,202302,92,56,36,72913.08,46873.15,119786.23
171670,202302,458,287,171,373681.13,222644.42,596325.55
171700,202302,62,53,9,69007.04,11718,80725.04
171720,202302,27,9,18,11718.7,23436.2,35154.9
171750,202302,100,49,51,63798,66402.2,130200.2
171780,202302,76,59,17,76818.9,22134,98952.9
171790,202302,99,78,21,101556,27342,128898
171800,202302,34,27,7,35154,9114,44268
171820,202302,2192,1265,927,1647070.07,1206959.02,2854029.09
171830,202302,33,26,7,33852.2,9114,42966.2
171840,202302,54,35,19,45570.26,24738,70308.26
171845,202302,33,22,11,28644.3,14322,42966.3
171850,202302,45,36,9,46873.37,11719.02,58592.39
171855,202302,74,53,21,69006.1,27342,96348.1
171865,202302,6,4,2,5208,2604,7812
171870,202302,35,23,12,29946.2,15624.45,45570.65
171875,202302,90,65,25,84630,32550,117180
171880,202302,46,29,17,37758,22134.72,59892.72
171884,202302,56,29,27,37758.41,35154,72912.41
171886,202302,135,61,74,79422.9,96348,175770.9
171888,202302,28,21,7,27343.39,9114.1,36457.49
171889,202302,14,7,7,9114,9114,18228
171890,202302,59,48,11,62497.24,14322,76819.24
171900,202302,28,19,9,24739.41,11718,36457.41
172000,202302,36,32,4,41664.2,5208.2,46872.4
172010,202302,56,42,14,54684,18228.17,72912.17
172015,202302,19,14,5,18229.84,6510,24739.84
172020,202302,124,77,47,100255.34,61194,161449.34
172025,202302,41,27,14,35154.46,18228,53382.46
172030,202302,55,34,21,44269.74,27342,71611.74
172049,202302,82,54,28,70309.16,36456.2,106765.36
172065,202302,114,74,40,96349.19,52080.46,148429.65
172080,202302,123,76,47,98953.4,61195.48,160148.88
172085,202302,29,15,14,19530,18228,37758
172090,202302,468,339,129,441384.56,167958.24,609342.80
172093,202302,16,14,2,18228,2604,20832
172097,202302,17,9,8,11718,10416,22134
172100,202302,6308,3636,2672,4735004.89,3480310.41,8215315.30
172110,202302,85,57,28,74215.01,36456,110671.01
172120,202302,1768,1467,301,1911409.59,391907.2,2303316.79
172125,202302,15,11,4,14322,5208,19530
172130,202302,31,20,11,26040.59,14322.8,40363.39
172208,202302,201,131,70,170562,92442.88,263004.88
172210,202302,351,180,171,234365.1,223946.3,458311.4
210005,202302,3178,1996,1182,2598908.69,1538994.73,4137903.42
210010,202302,149,101,48,131503.75,62496,193999.75
210015,202302,44,32,12,41664.39,15624,57288.39
210020,202302,390,231,159,300766.9,207020.35,507787.25
210030,202302,322,220,102,286461.24,132808.63,419269.87
210040,202302,123,101,22,131502.1,28644,160146.1
210043,202302,270,222,48,289048.02,62496.48,351544.50
210047,202302,500,318,182,414037.45,236964,651001.45
210050,202302,274,193,81,251286.72,105462.2,356748.92
210055,202302,58,48,10,62496.79,13020,75516.79
210060,202302,547,441,106,575509.47,138014.67,713524.14
210070,202302,468,361,107,470022,139315.5,609337.5
210080,202302,151,140,11,182281.71,14322,196603.71
210083,202302,299,155,144,201811.13,187488.19,389299.32
210087,202302,9,6,3,7812,3906,11718
210090,202302,494,361,133,470042.77,173168.47,643211.24
210095,202302,429,343,86,446591.89,111973.31,558565.20
210100,202302,710,570,140,743453.38,182280.2,925733.58
210110,202302,117,81,36,105463.59,46872.7,152336.29
210120,202302,4896,3943,953,5137931.52,1244729.51,6382661.03
210125,202302,178,115,63,149732.15,82027.6,231759.75
210130,202302,459,282,177,367172.83,230455.13,597627.96
210135,202302,30,24,6,31248.98,7812,39060.98
210140,202302,4627,3526,1101,4590990.7,1433521.07,6024511.77
210150,202302,380,243,137,316399.15,178378.82,494777.97
210160,202302,3287,2806,481,3653510.24,626269.48,4279779.72
210170,202302,1283,1043,240,1358039.55,312481.8,1670521.35
210173,202302,130,118,12,153638.3,15624,169262.3
210177,202302,294,171,123,222644.57,160146,382790.57
210180,202302,31,16,15,20832.2,19530,40362.2
210190,202302,460,317,143,412735.37,186186.7,598922.07
210193,202302,7,5,2,6510.59,2604,9114.59
210197,202302,68,51,17,66402.46,22134.2,88536.66
210200,202302,624,535,89,696594.82,115878.1,812472.92
210203,202302,230,165,65,214834.06,84631.12,299465.18
210207,202302,321,276,45,359358.46,58590,417948.46
210210,202302,714,666,48,867141.53,62496.6,929638.13
210215,202302,81,73,8,95049.02,10416,105465.02
210220,202302,356,306,50,398429.42,65101.59,463531.01
210230,202302,328,268,60,348942.46,78120,427062.46
210232,202302,1239,899,340,1170526.61,442680.95,1613207.56
210235,202302,188,142,46,184888.53,59892.4,244780.93
210237,202302,50,27,23,35155.43,29946,65101.43
210240,202302,76,65,11,84630.21,14322.21,98952.42
210250,202302,183,160,23,208320.82,29946.2,238267.02
210255,202302,394,296,98,385403.62,127597.95,513001.57
210260,202302,394,282,112,367167.68,145824,512991.68
210270,202302,634,451,183,587217.86,239569.08,826786.94
210275,202302,107,85,22,110670.24,28644,139314.24
210280,202302,1099,728,371,947871.02,483043.98,1430915.00
210290,202302,543,367,176,479144.52,229153.99,708298.51
210300,202302,4945,3221,1724,4196435.17,2245956.51,6442391.68
210310,202302,127,79,48,102858.2,62496.11,165354.31
210312,202302,118,86,32,111973.26,41664.8,153638.06
210315,202302,128,110,18,143220.89,23436,166656.89
210317,202302,149,114,35,148428.23,45570,193998.23
210320,202302,2463,2122,341,2762934.93,445285.46,3208220.39
210325,202302,161,97,64,126296.19,83328.68,209624.87
210330,202302,4230,2516,1714,3277197.73,2234236.51,5511434.24
210340,202302,1221,948,273,1234341.75,355450.05,1589791.80
210350,202302,691,580,111,755176.43,144522,899698.43
210355,202302,147,125,22,162750.2,28644,191394.2
210360,202302,2048,1496,552,1947843.27,718708.21,2666551.48
210370,202302,1262,667,595,868450.06,774694.86,1643144.92
210375,202302,192,95,97,123700.45,126295.29,249995.74
210380,202302,743,585,158,761680.33,205718.71,967399.04
210390,202302,193,163,30,212228.41,39060,251288.41
210400,202302,422,371,51,483054.64,66402,549456.64
210405,202302,1119,795,324,1035111,421850.25,1456961.25
210407,202302,73,61,12,79422.2,15624,95046.2
210408,202302,46,42,4,55988.1,5208,61196.1
210409,202302,346,302,44,393207.78,57288.56,450496.34
210410,202302,443,353,90,459608.49,117180,576788.49
210420,202302,206,166,40,216133.86,52080.58,268214.44
210430,202302,58,42,16,54684.5,20832,75516.5
210440,202302,378,259,119,337229.83,154938,492167.83
210450,202302,111,98,13,127600.09,16926,144526.09
210455,202302,241,130,111,169266.6,144523.87,313790.47
210460,202302,316,216,100,281238.33,130200.25,411438.58
210462,202302,79,65,14,84631.64,18228.5,102860.14
210465,202302,128,103,25,134107,32550,166657
210467,202302,561,428,133,557269.26,173167.12,730436.38
210470,202302,44,38,6,49476,7812,57288
210480,202302,1366,995,371,1295528.73,484348.59,1779877.32
210490,202302,179,130,49,169261.99,63798.2,233060.19
210500,202302,505,329,176,428375.91,229154.54,657530.45
210510,202302,530,439,91,571581.78,118483.92,690065.70
210515,202302,338,225,113,292954.16,147126.2,440080.36
210520,202302,403,366,37,476537.64,48174,524711.64
210530,202302,10000,5089,4911,6627490.87,6402119.52,13029610.39
210535,202302,121,93,28,121087.85,36456,157543.85
210540,202302,1562,1071,491,1394496.9,639286.11,2033783.01
210542,202302,1093,557,536,725239.12,700489.59,1425728.71
210545,202302,22,20,2,26040.71,2604,28644.71
210547,202302,128,111,17,144523.93,22134.31,166658.24
210550,202302,597,421,176,548168.79,229154.31,777323.10
210560,202302,163,142,21,184886.05,27342.95,212229.00
210565,202302,24,17,7,22135.57,9114.43,31250.00
210570,202302,1320,1118,202,1455670.64,263005.34,1718675.98
210580,202302,128,111,17,144522.78,22134.16,166656.94
210590,202302,684,574,110,747352.68,143220,890572.68
210592,202302,49,44,5,57288,6510,63798
210594,202302,113,99,14,128899.3,18228,147127.3
210596,202302,116,102,14,132805.6,18228,151033.6
210598,202302,139,107,32,139314.2,41665.08,180979.28
210600,202302,302,262,40,341133.01,52080,393213.01
210610,202302,251,231,20,300769.58,26040.61,326810.19
210620,202302,43,30,13,39060.22,16926,55986.22
210630,202302,93,81,12,105463.4,15624.2,121087.6
210632,202302,981,708,273,921819.12,355446,1277265.12
210635,202302,25,22,3,28644.9,3906.2,32551.1
210637,202302,122,89,33,115878.2,42966,158844.2
210640,202302,571,511,60,665325.78,78120,743445.78
210650,202302,415,351,64,457010.86,83328.7,540339.56
210660,202302,374,300,74,390621.92,96349.99,486971.91
210663,202302,79,65,14,84631.24,18228,102859.24
210667,202302,86,44,42,57289.61,54685.17,111974.78
210670,202302,264,236,28,307278.41,36456.6,343735.01
210675,202302,482,287,195,373684.62,253891.91,627576.53
210680,202302,233,154,79,200511.2,102858,303369.2
210690,202302,100,91,9,119785.75,11718,131503.75
210700,202302,154,116,38,151034.09,49476.2,200510.29
210710,202302,258,162,96,210927,124992.6,335919.6
210720,202302,128,116,12,151032.08,15624,166656.08
210725,202302,60,51,9,66406.33,11718,78124.33
210730,202302,20,14,6,18228,7812,26040
210735,202302,293,213,80,277327.72,104160,381487.72
210740,202302,519,451,68,587230.89,88536,675766.89
210745,202302,156,122,34,158845.04,44268,203113.04
210750,202302,2770,1509,1261,1964768.09,1643141.07,3607909.16
210760,202302,260,207,53,269516.36,69006.19,338522.55
210770,202302,247,204,43,265626.66,55988.24,321614.90
210780,202302,420,319,101,415353.83,131503.2,546857.03
210790,202302,194,165,29,214833.46,37758,252591.46
210800,202302,185,137,48,178386.25,62497,240883.25
210805,202302,70,63,7,82026,9114,91140
210810,202302,439,362,77,471339.08,100254,571593.08
210820,202302,1972,1669,303,2173112.11,394507.97,2567620.08
210825,202302,155,97,58,126295.5,75516.2,201811.7
210830,202302,700,499,201,649704.71,261703.44,911408.15
210840,202302,206,152,54,197905.05,70308,268213.05
210845,202302,227,176,51,229154.84,66402,295556.84
210850,202302,725,521,204,679669.28,265611.41,945280.69
210860,202302,3458,2110,1348,2748577.42,1757706.88,4506284.30
210870,202302,392,314,78,408845.24,101556.2,510401.44
210880,202302,86,70,16,91141.93,20832.2,111974.13
210890,202302,318,279,39,363270.39,50778,414048.39
210900,202302,710,456,254,593731.86,330711.1,924442.96
210905,202302,76,41,35,53382.2,45570.2,98952.4
210910,202302,2116,1595,521,2079346.96,678349.99,2757696.95
210920,202302,142,64,78,83329.82,101556,184885.82
210923,202302,77,64,13,83328.93,16926,100254.93
210927,202302,418,222,196,289046.5,256494.2,545540.7
210930,202302,77,66,11,85932.4,14322,100254.4
210940,202302,76,60,16,78123.27,22134,100257.27
210945,202302,205,122,83,158846.73,108066,266912.73
210950,202302,516,385,131,501274.19,170562.65,671836.84
210955,202302,93,55,38,71611.15,49476.2,121087.35
210960,202302,2456,1284,1172,1671783.98,1525946.58,3197730.56
210970,202302,109,93,16,121087.66,20832.9,141920.56
210975,202302,78,74,4,96348.66,5208.95,101557.61
210980,202302,1048,539,509,701794.53,664023.27,1365817.80
210990,202302,4446,3152,1294,4104026.1,1684807.92,5788834.02
211000,202302,1315,1084,231,1412712.01,300766.15,1713478.16
211003,202302,972,726,246,945271.07,320292.76,1265563.83
211010,202302,494,449,45,584606.13,58590.85,643196.98
211020,202302,1370,637,733,829394.49,954383.13,1783777.62
211023,202302,43,37,6,48174.9,7812,55986.9
211027,202302,82,64,18,83328.4,23436,106764.4
211030,202302,367,264,103,343730.31,134106,477836.31
211040,202302,289,248,41,322897.66,54684,377581.66
211050,202302,1144,795,349,1035126.5,454400.49,1489526.99
211060,202302,634,562,72,731756.42,93744.4,825500.82
211065,202302,25,20,5,26041.8,6510.38,32552.18
211070,202302,839,706,133,919254.75,173167,1092421.75
211080,202302,89,86,3,111973.39,3906,115879.39
211085,202302,62,34,28,44268,37758,82026
211090,202302,86,74,12,96352.92,15624,111976.92
211100,202302,467,400,67,520813.49,87234.4,608047.89
211102,202302,223,164,59,213528.4,76818,290346.4
211105,202302,226,163,63,212226.88,82026.65,294253.53
211107,202302,128,81,47,105462.2,61194,166656.2
211110,202302,989,677,312,882778.97,406229.46,1289008.43
211120,202302,5274,2865,2409,3733052.66,3145677.46,6878730.12
211125,202302,20,15,5,19530,6510,26040
211130,202302,42297,20712,21585,26976053.85,28145738.04,55121791.89
211140,202302,356,318,38,414051.1,49476.47,463527.57
211150,202302,1233,887,346,1154913.75,450495.52,1605409.27
211153,202302,166,99,67,128898,88536,217434
211157,202302,67,55,12,71610,15624,87234
211160,202302,688,582,106,757775.56,138013,895788.56
211163,202302,3,2,1,2604,1302,3906
211167,202302,10,10,0,13020,,13020.0
211170,202302,421,315,106,410132.86,138013.35,548146.21
211172,202302,108,80,28,104161.42,36456,140617.42
211174,202302,25,17,8,22134,10416.81,32550.81
211176,202302,463,338,125,440082.36,162751.54,602833.90
211178,202302,94,67,27,87235.82,35154,122389.82
211180,202302,213,172,41,223945.52,53382.24,277327.76
211190,202302,73,65,8,84630.2,10416,95046.2
211195,202302,41,29,12,37761.21,15624,53385.21
211200,202302,147,125,22,162752.46,28644.6,191397.06
211210,202302,396,304,92,395815.52,119785.11,515600.63
211220,202302,4447,2681,1766,3492143.99,2303299.33,5795443.32
211223,202302,137,126,11,164055.87,14322,178377.87
211227,202302,60,48,12,62496.2,15624,78120.2
211230,202302,711,592,119,770817.45,154939.85,925757.30
211240,202302,378,317,61,412738.12,79422,492160.12
211245,202302,183,100,83,130201.96,108066.2,238268.16
211250,202302,1483,1278,205,1664032.78,268215.24,1932248.02
211260,202302,808,695,113,904900.49,147126,1052026.49
211270,202302,1853,1545,308,2011629.5,401017.23,2412646.73
211280,202302,1801,1252,549,1630139.41,714798.75,2344938.16
211285,202302,228,150,78,195300.68,101556,296856.68
211290,202302,794,567,227,738239.12,295556,1033795.12
211300,202302,780,629,151,818979.13,196603.16,1015582.29
211400,202302,1580,1041,539,1355417.15,701780.34,2057197.49
220005,202302,17,16,1,20832,1302,22134
220010,202302,74,63,11,82026.57,14322,96348.57
220020,202302,753,614,139,799438.82,180979.29,980418.11
220025,202302,105,101,4,132805.86,5208,138013.86
220027,202302,58,48,10,62496.2,13020,75516.2
220030,202302,126,104,22,135409.68,28644,164053.68
220040,202302,1306,1006,300,1309837.4,390603.38,1700440.78
220045,202302,29,21,8,27344.07,10416.4,37760.47
220050,202302,688,575,113,748590.56,147127.7,895718.26
220060,202302,190,165,25,214835.8,32550.35,247386.15
220070,202302,110,96,14,124994.82,18228.7,143223.52
220080,202302,13,11,2,14322.22,2604,16926.22
220090,202302,44,31,13,40362.52,16926,57288.52
220095,202302,3,2,1,2604,1302,3906
220100,202302,23,19,4,24738.71,5208,29946.71
220105,202302,32,29,3,37759.55,3906,41665.55
220110,202302,248,228,20,296856.8,26040,322896.8
220115,202302,47,39,8,50778,10416,61194
220117,202302,24,22,2,28644,2604,31248
220120,202302,1544,1195,349,1555918.13,454398.2,2010316.33
220130,202302,24,24,0,31248,,31248.0
220140,202302,85,71,14,92443.1,18228.64,110671.74
220150,202302,495,373,122,485668.37,158847.89,644516.26
220155,202302,24,23,1,29946.18,1302,31248.18
220157,202302,22,19,3,24739.39,3906,28645.39
220160,202302,106,92,14,119784.79,18228,138012.79
220170,202302,40,33,7,42966,9114,52080
220173,202302,18,15,3,19530.44,3906,23436.44
220177,202302,18,18,0,23436.4,,23436.4
220180,202302,64,62,2,80725.29,2604,83329.29
220190,202302,1191,1021,170,1329364.48,221344.38,1550708.86
220191,202302,37,31,6,40363.11,7812,48175.11
220192,202302,93,86,7,111973.13,9114,121087.13
220194,202302,59,52,7,67704.48,9114,76818.48
220196,202302,78,65,13,84634.23,16926.4,101560.63
220198,202302,2,2,0,2604,,2604.0
220200,202302,404,343,61,446605.78,79423.51,526029.29
220202,202302,34,30,4,39061.17,5208,44269.17
220205,202302,66,57,9,74214.2,11718,85932.2
220207,202302,15,15,0,19530.12,,19530.12
220208,202302,73,46,27,59892.77,35154.2,95046.97
220209,202302,34,29,5,37758,6510,44268
220210,202302,27,22,5,28644,6510,35154
220211,202302,34,33,1,42968.86,1302,44270.86
220213,202302,35,32,3,41665.2,3906,45571.2
220217,202302,42,34,8,44268.3,10416,54684.3
220220,202302,2416,1618,798,2106671.16,1039005.26,3145676.42
220225,202302,6,2,4,2604.4,5208,7812.4
220230,202302,1005,752,253,979122.1,329412.7,1308534.8
220240,202302,167,148,19,192697.14,24738.32,217435.46
220245,202302,43,41,2,53384.14,2604,55988.14
220250,202302,144,120,24,156241.74,31248,187489.74
220253,202302,49,44,5,57288.25,6510,63798.25
220255,202302,48,41,7,53382.2,9114,62496.2
220260,202302,719,550,169,716112.43,220039.51,936151.94
220265,202302,13,11,2,14322.25,2604,16926.25
220270,202302,870,783,87,1019477.97,113274,1132751.97
220271,202302,38,29,9,37759.06,11718,49477.06
220272,202302,17,17,0,22134,,22134.0
220273,202302,16,15,1,19530.4,1302,20832.4
220275,202302,68,58,10,75516,13020,88536
220277,202302,30,22,8,28644.58,10416.8,39061.38
220280,202302,20,14,6,18228,7812,26040
220285,202302,44,40,4,52080.35,5208,57288.35
220290,202302,1584,1356,228,1765555.43,296860.19,2062415.62
220300,202302,41,41,0,53384.53,,53384.53
220310,202302,341,289,52,376295.03,67706.45,444001.48
220320,202302,465,428,37,557279.34,48175.68,605455.02
220323,202302,2,1,1,1302.8,1302,2604.8
220325,202302,8,7,1,9114,1302,10416
220327,202302,15,15,0,19530.19,,19530.19
220330,202302,218,155,63,201810.56,82026.7,283837.26
220335,202302,136,116,20,151033.32,26040,177073.32
220340,202302,49,39,10,50778,13020,63798
220342,202302,55,47,8,61197.22,10416,71613.22
220345,202302,91,79,12,102858,15624.3,118482.3
220350,202302,467,407,60,529918.23,78120.05,608038.28
220360,202302,50,33,17,42966,22134,65100
220370,202302,1380,1157,223,1506447.05,291649.36,1798096.41
220375,202302,21,20,1,26040.71,1302,27342.71
220380,202302,24,18,6,23436.9,7812.55,31249.45
220385,202302,16,14,2,18228,2604.66,20832.66
220390,202302,2498,1383,1115,1802029.29,1451754.17,3253783.46
220400,202302,38,31,7,40362,9114,49476
220410,202302,23,22,1,28644.2,1302,29946.2
220415,202302,14,13,1,16926.79,1302,18228.79
220420,202302,129,109,20,141919.3,26040,167959.3
220430,202302,147,129,18,167963.25,23436.2,191399.45
220435,202302,26,20,6,26040.5,7812,33852.5
220440,202302,284,243,41,316403.06,53382,369785.06
220450,202302,369,186,183,242180.79,238273.25,480454.04
220455,202302,53,52,1,67704.59,1302,69006.59
220460,202302,19,18,1,23437.2,1302.19,24739.39
220465,202302,65,44,21,57289.09,27342.41,84631.50
220470,202302,237,208,29,270822.4,37758.86,308581.26
220480,202302,68,63,5,82026.18,6510,88536.18
220490,202302,85,72,13,93744,16926,110670
220500,202302,127,106,21,138012.36,27342,165354.36
220510,202302,364,285,79,371080.65,102858.88,473939.53
220515,202302,28,26,2,33852.67,2604,36456.67
220520,202302,385,340,45,442691.46,58590.47,501281.93
220525,202302,9,5,4,6510.93,5208.06,11718.99
220527,202302,12,12,0,15624.65,,15624.65
220530,202302,50,23,27,29946.9,35154.87,65101.77
220535,202302,5,4,1,5208.61,1302,6510.61
220540,202302,106,92,14,119785.24,18228.2,138013.44
220545,202302,24,16,8,20833.15,10416.37,31249.52
220550,202302,764,605,159,787741.24,207020.53,994761.77
220551,202302,12,10,2,13020,2604,15624
220552,202302,13,12,1,15624,1302,16926
220553,202302,60,55,5,71611.05,6510,78121.05
220554,202302,5,3,2,3906.52,2604,6510.52
220555,202302,44,35,9,45571.6,11718,57289.6
220556,202302,42,39,3,50779.24,3906,54685.24
220557,202302,60,55,5,71611.49,6510.74,78122.23
220558,202302,13,6,7,7812,9114,16926
220559,202302,4,4,0,5208.07,,5208.07
220560,202302,81,53,28,69007.19,36456,105463.19
220570,202302,731,456,275,593720.63,358053.4,951774.03
220580,202302,558,512,46,666659.01,59893.53,726552.54
220585,202302,15,12,3,15624.2,3906.52,19530.72
220590,202302,15,14,1,18228.9,1302,19530.9
220595,202302,74,58,16,75516.5,20832,96348.5
220600,202302,21,15,6,19530,7812,27342
220605,202302,31,28,3,36456.2,3906,40362.2
220610,202302,98,82,16,106764,20832,127596
220620,202302,566,485,81,631482.79,105464.53,736947.32
220630,202302,3,2,1,2604,1302,3906
220635,202302,33,30,3,39061.33,3906,42967.33
220640,202302,116,96,20,124992,26040,151032
220650,202302,116,110,6,143221.66,7812,151033.66
220660,202302,82,64,18,83328.91,23436.8,106765.71
220665,202302,11,11,0,14322,,14322.0
220667,202302,24,21,3,27342.13,3906,31248.13
220669,202302,39,34,5,44268.2,6510,50778.2
220670,202302,72,57,15,74215.05,19530,93745.05
220672,202302,75,55,20,71614.3,26041.21,97655.51
220675,202302,29,22,7,28646.31,9114,37760.31
220680,202302,60,51,9,66402.2,11718,78120.2
220690,202302,47,45,2,58590.29,2604,61194.29
220695,202302,28,15,13,19530.87,16926,36456.87
220700,202302,1907,1483,424,1932195.97,555958.52,2488154.49
220710,202302,7,5,2,6510.2,2604.81,9115.01
220720,202302,115,99,16,128898,20832,149730
220730,202302,31,30,1,39060.01,1302,40362.01
220735,202302,8,5,3,6510,3906,10416
220740,202302,60,52,8,67704.38,10416.91,78121.29
220750,202302,130,110,20,143221.65,26040.21,169261.86
220755,202302,20,19,1,24739.67,1302,26041.67
220760,202302,70,63,7,82028.29,9114,91142.29
220770,202302,6171,3556,2615,4631435.11,3406106.57,8037541.68
220775,202302,10,8,2,10416.7,2604.63,13021.33
220777,202302,21,20,1,26040,1302,27342
220779,202302,5,1,4,1302,5208,6510
220780,202302,956,810,146,1054630.56,190092.78,1244723.34
220785,202302,7,4,3,5208,3906.2,9114.2
220790,202302,1250,1001,249,1305938.51,326810.63,1632749.14
220793,202302,8,6,2,7812,2604,10416
220795,202302,22,21,1,27342,1302,28644
220800,202302,4169,3192,977,4156304.98,1273368.85,5429673.83
220810,202302,80,67,13,87235.85,16926,104161.85
220820,202302,250,229,21,298167.23,27343.8,325511.03
220830,202302,1337,1179,158,1535080.37,205716.97,1740797.34
220840,202302,2635,1863,772,2425692.05,1005165.69,3430857.74
220850,202302,79,67,12,87234,15624,102858
220855,202302,8,4,4,5208,5208,10416
220860,202302,18,15,3,19531.7,3906,23437.7
220865,202302,31,28,3,36456.1,3906,40362.1
220870,202302,92,84,8,109369.16,10416,119785.16
220880,202302,337,280,57,364573.23,74215.6,438788.83
220885,202302,28,27,1,35156.37,1302,36458.37
220887,202302,6,5,1,6510.2,1302,7812.2
220890,202302,88,74,14,97652.45,18228,115880.45
220900,202302,26,13,13,16926,16926,33852
220910,202302,47,37,10,48176.03,13020,61196.03
220915,202302,9,8,1,10416.19,1302,11718.19
220920,202302,49,43,6,55986.82,7812,63798.82
220930,202302,56,53,3,69006.54,3906,72912.54
220935,202302,15,15,0,19530.97,,19530.97
220937,202302,35,30,5,39060.99,6510,45570.99
220940,202302,60,53,7,69006,9114,78120
220945,202302,4,4,0,5208,,5208.0
220950,202302,35,27,8,35154.2,10416,45570.2
220955,202302,22,21,1,27342.72,1302,28644.72
220960,202302,39,34,5,44268,6510,50778
220965,202302,53,48,5,62496,6510,69006
220970,202302,64,54,10,70308,13020,83328
220975,202302,11,10,1,13020.4,1302,14322.4
220980,202302,27,25,2,32550.76,2604,35154.76
220985,202302,53,45,8,58590,10416,69006
220987,202302,30,29,1,37759.84,1302.63,39062.47
220990,202302,25,24,1,31248,1302,32550
220995,202302,13,11,2,14322,2604,16926
220997,202302,68,60,8,78122.02,10416,88538.02
221000,202302,1333,1179,154,1536395.98,200508.86,1736904.84
221005,202302,44,41,3,53382,3906.98,57288.98
221010,202302,27,19,8,24738,10416,35154
221020,202302,40,35,5,45571.48,6510,52081.48
221030,202302,43,36,7,46769.85,9114,55883.85
221035,202302,22,20,2,26042.37,2604,28646.37
221037,202302,14,10,4,13020,5208,18228
221038,202302,26,23,3,29946,3906,33852
221039,202302,25,24,1,31248.06,1302.2,32550.26
221040,202302,262,222,40,289049.33,52081.2,341130.53
221050,202302,235,195,40,253900.43,52080.4,305980.83
221060,202302,2064,1773,291,2308490.51,378887.93,2687378.44
221062,202302,27,27,0,35155.55,,35155.55
221063,202302,18,14,4,18228,5208,23436
221065,202302,77,62,15,80726.89,19530.82,100257.71
221070,202302,160,138,22,179679.41,28644,208323.41
221080,202302,414,353,61,459616.61,79422,539038.61
221090,202302,25,20,5,26042.25,6510,32552.25
221093,202302,49,33,16,42966.44,20832.88,63799.32
221095,202302,4,4,0,5208,,5208.0
221097,202302,11,9,2,11718,2604,14322
221100,202302,28146,16817,11329,21901897.45,14763680.36,36665577.81
221110,202302,1192,918,274,1196575.54,356754.08,1553329.62
221120,202302,590,428,162,557268.14,210924,768192.14
221130,202302,1044,842,202,1096299.89,263008.14,1359308.03
221135,202302,33,30,3,39061.09,3906,42967.09
221140,202302,48,41,7,53382.2,9114,62496.2
221150,202302,13,9,4,11718.18,5208,16926.18
221160,202302,17,17,0,22135.39,,22135.39
221170,202302,20,19,1,24738,1302,26040
230010,202302,167,144,23,187489.6,29946,217435.6
230015,202302,167,141,26,183582.15,33852,217434.15
230020,202302,1909,1518,391,1977788.86,509097.85,2486886.71
230030,202302,1727,1254,473,1634063.52,615853.07,2249916.59
230040,202302,241,193,48,251287.55,62496,313783.55
230050,202302,251,174,77,226548.2,100254.44,326802.64
230060,202302,178,142,36,184884.39,46873.54,231757.93
230070,202302,325,276,49,359356.58,63798,423154.58
230075,202302,960,797,163,1037717.31,212230.73,1249948.04
230080,202302,238,194,44,252591.87,57288,309879.87
230090,202302,185,131,54,170564.03,70308,240872.03
230100,202302,2860,1609,1251,2095004.46,1628822.04,3723826.50
230110,202302,3209,2018,1191,2627505.06,1552001.02,4179506.08
230120,202302,1256,959,297,1248646.4,387999.46,1636645.86
230125,202302,185,144,41,187488.83,53382,240870.83
230130,202302,526,458,68,596325.71,88536.28,684861.99
230140,202302,228,184,44,239569.67,57288,296857.67
230150,202302,156,120,36,156242.69,46872.4,203115.09
230160,202302,1019,828,191,1078061.09,248682.72,1326743.81
230170,202302,678,589,89,766898.65,115881.23,882779.88
230180,202302,69,62,7,80724.39,9114,89838.39
230185,202302,434,368,66,479145.41,85933.75,565079.16
230190,202302,2669,2012,657,2621000.16,855425.3,3476425.46
230195,202302,548,465,83,605448,108066,713514
230200,202302,473,365,108,475238.39,140616.2,615854.59
230205,202302,424,277,147,360655.17,191394.2,552049.37
230210,202302,1491,1129,362,1469981.77,471325.08,1941306.85
230220,202302,1726,1142,584,1486925.38,760378.14,2247303.52
230230,202302,1069,861,208,1121045.15,270817.72,1391862.87
230240,202302,2164,1881,283,2449433.9,368471.05,2817904.95
230250,202302,1932,1565,367,2037697.43,477844.35,2515541.78
230260,202302,3513,2160,1353,2813653.16,1762911.73,4576564.89
230270,202302,1449,1120,329,1458257.83,428360.91,1886618.74
230280,202302,3003,2296,707,2989473.79,920523.73,3909997.52
230290,202302,364,315,49,410144.99,63798.46,473943.45
230300,202302,527,385,142,501272.98,184884.29,686157.27
230310,202302,449,346,103,450492.62,134106.87,584599.49
230320,202302,995,832,163,1084592.05,212227.24,1296819.29
230330,202302,336,272,64,354147.92,83328.4,437476.32
230340,202302,463,373,90,486956.08,117180.4,604136.48
230350,202302,3633,2214,1419,2885314.93,1848857.59,4734172.52
230360,202302,283,230,53,299463.08,69006.46,368469.54
230365,202302,136,108,28,140616.53,36456,177072.53
230370,202302,12406,6222,6184,8104045.46,8055696.67,16159742.13
230380,202302,537,457,80,595026.93,104163.14,699190.07
230390,202302,564,320,244,416643.61,317688.6,734332.21
230393,202302,238,192,46,249985.91,59892.5,309878.41
230395,202302,383,302,81,393226.6,105466.14,498692.74
230400,202302,691,548,143,713505.2,186186.4,899691.6
230410,202302,3007,1883,1124,2451733.34,1463470.73,3915204.07
230420,202302,6964,4578,2386,5962137,3111869.1,9074006.1
230423,202302,357,310,47,403623.14,61194.1,464817.24
230425,202302,539,429,110,558565.83,143221.39,701787.22
230426,202302,133,100,33,130200.7,42966,173166.7
230427,202302,81,69,12,89838.79,15624,105462.79
230428,202302,1882,904,978,1177039.19,1273369.6,2450408.79
230430,202302,488,390,98,507789.4,127597.9,635387.3
230435,202302,1003,715,288,930951.04,374979.24,1305930.28
230440,202302,105382,48358,57024,63001252.45,74291031.83,137292284.28
230445,202302,349,234,115,304677,149730.7,454407.7
230450,202302,613,480,133,624962.15,173166.2,798128.35
230460,202302,109,77,32,100255.04,41664,141919.04
230465,202302,333,270,63,352846.13,82026,434872.13
230470,202302,2148,1676,472,2182176.03,614546.98,2796723.01
230480,202302,157,142,15,186186.5,19531.1,205717.6
230490,202302,352,275,77,358052.63,100254.82,458307.45
230495,202302,518,364,154,475244.28,200511.56,675755.84
230500,202302,1205,890,315,1160093.02,410131.76,1570224.78
230510,202302,82,56,26,72912.54,33852,106764.54
230520,202302,437,331,106,432267.69,138012.62,570280.31
230523,202302,2800,1700,1100,2213475.65,1432220.2,3645695.85
230526,202302,265,217,48,282535.7,62496,345031.7
230530,202302,724,524,200,682260.51,260403.44,942663.95
230533,202302,227,208,19,270818.5,24738.2,295556.7
230535,202302,439,326,113,424466.8,147127.17,571593.97
230540,202302,1890,1682,208,2190018.44,270819.36,2460837.80
230550,202302,4461,2811,1650,3662708.54,2149651.99,5812360.53
230560,202302,617,466,151,606742.87,196602.57,803345.44
230565,202302,234,173,61,225246.7,79422.51,304669.21
230570,202302,326,274,52,356751.25,67704.45,424455.70
230580,202302,1303,897,406,1167906.02,529921.19,1697827.21
230590,202302,1128,858,270,1117026.61,351541.9,1468568.51
230600,202302,297,265,32,345036.99,42966,388002.99
230610,202302,499,368,131,480448.08,170562.2,651010.28
230620,202302,184,151,33,196605.05,42966,239571.05
230625,202302,938,624,314,812467.08,410131.29,1222598.37
230630,202302,1575,1173,402,1528585.01,524709.87,2053294.88
230640,202302,4277,3470,807,4519404.68,1050746.7,5570151.38
230650,202302,523,444,79,578092.08,102859.14,680951.22
230655,202302,784,619,165,805966.76,214832.86,1020799.62
230660,202302,389,317,72,412737.93,93744.2,506482.13
230670,202302,504,401,103,522122.49,134106.19,656228.68
230680,202302,229,197,32,256499.87,41664,298163.87
230690,202302,1026,857,169,1117143.81,220040.38,1337184.19
230700,202302,1085,894,191,1164007.97,248683.68,1412691.65
230710,202302,712,652,60,848926.02,78120.56,927046.58
230720,202302,154,130,24,169260,31248.7,200508.7
230725,202302,311,234,77,304670.76,100254.92,404925.68
230730,202302,13928,7334,6594,9550778.59,8588154.29,18138932.88
230740,202302,746,595,151,774712.72,196603.95,971316.67
230750,202302,882,725,157,943966.9,204415.25,1148382.15
230760,202302,1736,1466,270,1908797.43,351543.99,2260341.42
230763,202302,389,322,67,419249.49,87234.89,506484.38
230765,202302,9354,4413,4941,5746096.82,6434718.17,12180814.99
230770,202302,5558,2826,2732,3682189.6,3562313.04,7244502.64
230780,202302,851,735,116,956979.41,151032.1,1108011.51
230790,202302,337,275,62,358050.7,80724.6,438775.3
230800,202302,1284,908,376,1182233.45,489553.9,1671787.35
230810,202302,1509,1301,208,1693969.99,272121.82,1966091.81
230820,202302,401,263,138,342430.52,179678.44,522108.96
230830,202302,1037,862,175,1122345.13,227850.9,1350196.03
230835,202302,300,242,58,315087.68,75517.14,390604.82
230837,202302,203,162,41,210925.01,53382.01,264307.02
230840,202302,1008,760,248,992133.81,322898.81,1315032.62
230850,202302,1478,1241,237,1615826.68,308578.08,1924404.76
230860,202302,353,277,76,360657.49,98958.7,459616.19
230870,202302,1962,1660,302,2161357.34,393204.47,2554561.81
230880,202302,85,66,19,85932,24738,110670
230890,202302,601,527,74,686162.92,96349.37,782512.29
230900,202302,329,243,86,316387.92,111972.51,428360.43
230910,202302,241,187,54,243476.85,70308,313784.85
230920,202302,534,414,120,539033.53,156240,695273.53
230930,202302,1194,827,367,1076778.61,477837.52,1554616.13
230940,202302,899,690,209,898398.54,272120.12,1170518.66
230945,202302,605,482,123,627586.99,160150.95,787737.94
230950,202302,462,399,63,519517.44,82026.87,601544.31
230960,202302,3038,2015,1023,2623662.1,1335889.47,3959551.57
230970,202302,1967,1063,904,1384076.74,1178325.92,2562402.66
230980,202302,235,174,61,226550.34,79422,305972.34
230990,202302,151,118,33,153636.75,42966,196602.75
231000,202302,216,198,18,257798.47,23436,281234.47
231010,202302,191,129,62,167960.76,80724.46,248685.22
231020,202302,1590,1051,539,1368455.94,701793.45,2070249.39
231025,202302,1222,832,390,1083310.65,507791.97,1591102.62
231030,202302,1115,900,215,1171813.88,279932.47,1451746.35
231040,202302,188,128,60,166658.26,78120,244778.26
231050,202302,1007,861,146,1121043.04,191401.33,1312444.37
231060,202302,172,139,33,180981.92,42966.23,223948.15
231070,202302,1615,1099,516,1430928.99,671837.74,2102766.73
231080,202302,283,247,36,321602.48,46872,368474.48
231085,202302,763,467,296,608054.91,386694.26,994749.17
231090,202302,283,225,58,292954.48,75517.64,368472.12
231095,202302,168,127,41,165354,53382.37,218736.37
231100,202302,198,161,37,209623.14,48174,257797.14
231110,202302,390,323,67,420555.01,88537.93,509092.94
231120,202302,270,225,45,294256.33,58590.19,352846.52
231123,202302,154,146,8,190094.87,10416,200510.87
231126,202302,353,275,78,358051.66,101556,459607.66
231130,202302,5281,4075,1206,5307165.62,1570242.36,6877407.98
231135,202302,230,197,33,256496.15,42968.11,299464.26
231140,202302,3287,2352,935,3063694.09,1217383.16,4281077.25
231150,202302,416,383,33,498677.32,42967.87,541645.19
231160,202302,1337,1087,250,1415296.7,325500.46,1740797.16
231170,202302,563,389,174,506481.18,226548,733029.18
231180,202302,2069,1788,281,2328045.42,365868.6,2693914.02
231190,202302,236,190,46,247380.54,59892,307272.54
231195,202302,246,201,45,261704.3,59892.55,321596.85
231200,202302,917,731,186,951786.9,242175.59,1193962.49
231210,202302,547,457,90,595023.23,117181.39,712204.62
231220,202302,1137,796,341,1036418.04,443985.96,1480404.00
231230,202302,1681,1235,446,1607995.12,580693.09,2188688.21
231240,202302,1753,1175,578,1532491.55,752565.61,2285057.16
231250,202302,97,91,6,118484,7812,126296
231260,202302,277,183,94,238267.9,122390.3,360658.2
231270,202302,1059,813,246,1058553.94,320293.44,1378847.38
231280,202302,82,62,20,80725.75,26040.36,106766.11
231290,202302,8706,4837,3869,6300641.19,5044047,11344688.19
231300,202302,624,564,60,734337.55,78120,812457.55
231310,202302,884,805,79,1048125.34,102859.79,1150985.13
231320,202302,642,479,163,623664.42,212227.62,835892.04
231325,202302,108,90,18,117180.18,23436.54,140616.72
231330,202302,2089,1570,519,2045502.63,678352.29,2723854.92
231335,202302,268,236,32,307277.43,41664,348941.43
231340,202302,2084,1412,672,1838464.5,876257.23,2714721.73
231350,202302,1543,1200,343,1562456.94,446600.96,2009057.90
231355,202302,443,361,82,470028.34,106764.64,576792.98
231360,202302,616,412,204,536437.28,265609.94,802047.22
231370,202302,98,83,15,108066,19530.12,127596.12
231375,202302,312,232,80,302068.63,104160.25,406228.88
231380,202302,567,451,116,587205.58,151032.19,738237.77
231390,202302,210,162,48,210925.43,62496,273421.43
231395,202302,840,492,348,640588.23,453097.55,1093685.78
231400,202302,1296,1068,228,1390563.4,296861.41,1687424.81
231410,202302,1491,1204,287,1567641.7,373675.63,1941317.33
240010,202302,408,185,223,240879.05,290354.08,531233.13
240020,202302,2445,1993,452,2598903.83,588515.06,3187418.89
240030,202302,121,96,25,124994.49,32550,157544.49
240040,202302,35,34,1,44268,1302,45570
240050,202302,551,471,80,613273.8,104160.1,717433.9
240060,202302,87,79,8,102859.01,10416,113275.01
240070,202302,301,228,73,296857.88,95046.32,391904.20
240080,202302,622,417,205,542959.03,266917.44,809876.47
240090,202302,104,91,13,118482.42,16926,135408.42
240100,202302,1635,1530,105,1992121.44,136712.03,2128833.47
240110,202302,1118,753,365,980473.45,475253.97,1455727.42
240120,202302,155,114,41,148430.88,53382.95,201813.83
240130,202302,278,254,24,330722.98,31248.7,361971.68
240140,202302,93,60,33,78121.89,42966.64,121088.53
240145,202302,775,683,92,889304.18,119784.32,1009088.50
240150,202302,28,21,7,27342,9114,36456
240160,202302,38,30,8,39060,10416,49476
240165,202302,42,34,8,44271.68,11718.8,55990.48
240170,202302,155,105,50,136712.29,65100,201812.29
240180,202302,125,93,32,121089.31,41664,162753.31
240185,202302,52,45,7,58591.09,9114.7,67705.79
240190,202302,16,14,2,18228.43,2604,20832.43
240200,202302,3301,1770,1531,2304601.1,1995992.18,4300593.28
240210,202302,164,124,40,161448.73,52080,213528.73
240220,202302,1219,826,393,1075499.69,511690.31,1587190.00
240230,202302,880,784,96,1022109.95,124993.38,1147103.33
240240,202302,84,55,29,71610.2,37758.5,109368.7
240250,202302,103,88,15,114576.51,19530,134106.51
240260,202302,2033,1420,613,1848903.26,798137.28,2647040.54
240270,202302,178,151,27,196603.37,35154,231757.37
240280,202302,72,57,15,74214.2,19530,93744.2
240290,202302,44,42,2,54684,2604,57288
240300,202302,179,95,84,123691.89,109368,233059.89
240310,202302,2701,1447,1254,1886659.43,1632733.06,3519392.49
240320,202302,185,171,14,222642.07,18228,240870.07
240325,202302,5322,2955,2367,3847628.55,3083227.43,6930855.98
240330,202302,86,80,6,104160,7812,111972
240340,202302,112,78,34,101556,44268,145824
240350,202302,99,79,20,102858.2,26040,128898.2
240360,202302,789,499,290,651029.85,377589.68,1028619.53
240370,202302,64,55,9,71611.01,11719.26,83330.27
240375,202302,52,34,18,44269.21,23437.57,67706.78
240380,202302,220,180,40,234369.56,52080.5,286450.06
240390,202302,16,14,2,18228,2604,20832
240400,202302,86,77,9,100254.95,11718,111972.95
240410,202302,13,10,3,13020,3906,16926
240420,202302,1195,846,349,1101527.07,454406.92,1555933.99
240430,202302,273,246,27,320302.65,35154.54,355457.19
240440,202302,156,84,72,109373.13,93744.12,203117.25
240450,202302,265,159,106,207027.39,138014.89,345042.28
240460,202302,91,71,20,92442.42,27342,119784.42
240470,202302,228,205,23,266927.15,29946.67,296873.82
240480,202302,17,15,2,19530,2604,22134
240485,202302,88,69,19,89839.83,24738,114577.83
240490,202302,63,57,6,74215.17,7812,82027.17
240500,202302,113,86,27,111972,35154,147126
240510,202302,39,29,10,37758.17,13020,50778.17
240520,202302,100,95,5,123693.14,6510.8,130203.94
240530,202302,65,51,14,66403.27,18228,84631.27
240540,202302,103,89,14,115878.1,18228.45,134106.55
240550,202302,12,10,2,13020,2604,15624
240560,202302,423,283,140,368478.43,182280.2,550758.63
240570,202302,459,278,181,361963.14,235663.27,597626.41
240580,202302,1441,1057,384,1376258.91,501271.14,1877530.05
240590,202302,30,29,1,37758.98,1302,39060.98
240600,202302,104,97,7,126295.3,9114,135409.3
240610,202302,517,423,94,550767.05,122394.63,673161.68
240615,202302,12,12,0,15624.8,,15624.8
240620,202302,89,85,4,110671.81,5208,115879.81
240630,202302,43,35,8,45570.97,10416.48,55987.45
240640,202302,38,26,12,33852,15624,49476
240650,202302,248,195,53,253892.14,69006.76,322898.90
240660,202302,117,99,18,128898.97,23436,152334.97
240670,202302,318,176,142,229169.73,184892.5,414062.23
240680,202302,59,45,14,58590.67,18228.1,76818.77
240690,202302,49,47,2,61196.54,2604,63800.54
240700,202302,178,148,30,192696.6,39061.02,231757.62
240710,202302,2444,1463,981,1907490.99,1277278.26,3184769.25
240720,202302,1128,785,343,1022101.61,446595.66,1468697.27
240725,202302,78,70,8,91141.1,10416.88,101557.98
240730,202302,151,124,27,161448.26,35154,196602.26
240740,202302,243,198,45,259109.94,58590.62,317700.56
240750,202302,56,34,22,44268,28644,72912
240760,202302,58,46,12,59892,15624,75516
240770,202302,155,119,36,154940.92,46873.05,201813.97
240780,202302,791,646,145,841115.76,188791.43,1029907.19
240790,202302,39,37,2,48176.47,2604,50780.47
240800,202302,10351,6939,3412,9039118.15,4446513.61,13485631.76
240810,202302,23283,12209,11074,15900903.96,14429132.02,30330035.98
240820,202302,272,161,111,209629.2,144524.49,354153.69
240830,202302,1669,1377,292,1792907.29,380190.87,2173098.16
240840,202302,80,68,12,88537.05,15624,104161.05
240850,202302,90,79,11,102858,14322,117180
240860,202302,113,109,4,141920.09,5208.85,147128.94
240870,202302,60,49,11,63800.79,14322,78122.79
240880,202302,33,29,4,37758,5208,42966
240890,202302,1267,709,558,923150.07,726525.6,1649675.67
240895,202302,62,47,15,61194.2,19530.59,80724.79
240910,202302,186,154,32,200509.72,41664.2,242173.92
240920,202302,13,12,1,15624.62,1302,16926.62
240930,202302,439,389,50,506502.61,65101.86,571604.47
240933,202302,64,41,23,53382.95,29946,83328.95
240940,202302,2413,2104,309,2740787.73,402323.2,3143110.93
240950,202302,42,37,5,48174,6510,54684
240960,202302,25,20,5,26040.2,6510.3,32550.5
240970,202302,108,76,32,98952.96,41664,140616.96
240980,202302,207,162,45,210925.49,58592.51,269518.00
240990,202302,147,95,52,123691.23,67704,191395.23
241000,202302,62,56,6,72912.51,7812,80724.51
241010,202302,90,73,17,95046.89,22134,117180.89
241020,202302,112,103,9,135409.51,11718.47,147127.98
241025,202302,19,11,8,14323.27,10416.5,24739.77
241030,202302,118,90,28,117180,36456.3,153636.3
241040,202302,45,37,8,48174.1,10416,58590.1
241050,202302,75,69,6,89839.5,7812,97651.5
241060,202302,29,24,5,31248,6510,37758
241070,202302,24,24,0,31250.37,,31250.37
241080,202302,60,53,7,69006.2,9114,78120.2
241090,202302,56,45,11,58593.09,14322,72915.09
241100,202302,71,61,10,79422.5,13020.46,92442.96
241105,202302,29,18,11,23439.73,14322.8,37762.53
241110,202302,52,42,10,54684.15,13020,67704.15
241120,202302,1788,1350,438,1757739.28,570279.94,2328019.22
241140,202302,212,171,41,222645.24,53382,276027.24
241142,202302,50,39,11,50778.88,14322,65100.88
241150,202302,1221,1050,171,1367147.93,222644.83,1589792.76
241160,202302,24,18,6,23436,7812,31248
241170,202302,53,45,8,58590,10416,69006
241180,202302,45,32,13,41664,16926,58590
241190,202302,39,35,4,45571.2,5208,50779.2
241200,202302,5142,2688,2454,3501269.27,3199128.42,6700397.69
241210,202302,73,62,11,80724.75,14322,95046.75
241220,202302,1661,1043,618,1358047.11,805953.52,2164000.63
241230,202302,263,211,52,274727.02,67704.91,342431.93
241240,202302,52,39,13,50779.58,16926,67705.58
241250,202302,1180,1075,105,1399692.49,136712.58,1536405.07
241255,202302,70,55,15,71610.78,19530,91140.78
241260,202302,771,583,188,759084.43,244778.9,1003863.33
241270,202302,71,50,21,65100.6,27342,92442.6
241280,202302,98,85,13,110673.91,16926,127599.91
241290,202302,145,106,39,138014.66,50778.7,188793.36
241300,202302,84,58,26,75516,33852.98,109368.98
241310,202302,54,38,16,49476.8,20832.1,70308.9
241320,202302,35,17,18,22135.4,23436,45571.4
241330,202302,66,56,10,72913.7,13020,85933.7
241335,202302,110,99,11,128902.94,14322,143224.94
241340,202302,187,134,53,174468.81,69006,243474.81
241350,202302,67,55,12,71610.81,15624,87234.81
241355,202302,54,44,10,58591.03,13020,71611.03
241360,202302,55,52,3,67704.16,3906,71610.16
241370,202302,66,54,12,70308,15624,85932
241380,202302,37,33,4,42966.6,5208,48174.6
241390,202302,90,70,20,91140,26040,117180
241400,202302,228,169,59,220983.15,76819.97,297803.12
241410,202302,186,166,20,216133.01,26040.09,242173.10
241415,202302,110,88,22,114576.1,28644.8,143220.9
241420,202302,144,97,47,126296.05,61194.6,187490.65
241430,202302,20,17,3,22134.88,3906,26040.88
241440,202302,558,467,91,608061.62,118485,726546.62
241445,202302,44,38,6,49476.2,7812.72,57288.92
241450,202302,266,225,41,292959.47,53382.44,346341.91
241460,202302,180,165,15,214835.62,19531,234366.62
241470,202302,33,27,6,35154.82,7812.2,42967.02
241475,202302,48,44,4,57288,5208,62496
241480,202302,146,103,43,134109.12,55986.83,190095.95
241490,202302,13,11,2,14323.57,2604.1,16927.67
241500,202302,52,39,13,50780.98,16926.02,67707.00
250010,202302,103,84,19,109368.75,24738.04,134106.79
250020,202302,33,28,5,36456,6510,42966
250030,202302,922,683,239,889297.32,311183.31,1200480.63
250040,202302,411,334,77,434880.76,100255.12,535135.88
250050,202302,294,241,53,313783.92,69006.5,382790.42
250053,202302,68,56,12,72912.6,15624,88536.6
250057,202302,4,3,1,3906.2,1302,5208.2
250060,202302,651,469,182,610651.9,236966.44,847618.34
250070,202302,702,559,143,727837.54,186186.64,914024.18
250073,202302,9,8,1,10416.77,1302.01,11718.78
250077,202302,188,136,52,177074.12,67704.67,244778.79
250080,202302,423,332,91,432274.01,118483.42,550757.43
250090,202302,230,147,83,191395.09,108066,299461.09
250100,202302,615,490,125,637986.8,162751.8,800738.6
250110,202302,722,521,201,678355.27,261703.53,940058.80
250115,202302,14,4,10,5208.18,13020.26,18228.44
250120,202302,126,90,36,117180.86,46873.58,164054.44
250130,202302,588,481,107,626282.36,139315.96,765598.32
250135,202302,34,15,19,19530.59,24738,44268.59
250140,202302,87,74,13,96349.88,16926,113275.88
250150,202302,671,463,208,602837.54,270817.7,873655.24
250153,202302,17,15,2,19530.48,2604,22134.48
250157,202302,38,31,7,40362.42,9114,49476.42
250160,202302,254,192,62,249988.52,80724,330712.52
250170,202302,92,60,32,78120.2,41664,119784.2
250180,202302,5206,3598,1608,4684853.72,2093683.49,6778537.21
250190,202302,820,555,265,722618.95,345033.73,1067652.68
250200,202302,73,58,15,75517.18,19530.7,95047.88
250205,202302,22,17,5,22134.61,6510,28644.61
250210,202302,90,76,14,98952.92,18228,117180.92
250215,202302,91,61,30,79422.5,39060.07,118482.57
250220,202302,32,20,12,26040.88,15624,41664.88
250230,202302,79,70,9,91141.11,11718.2,102859.31
250240,202302,257,193,64,251290.73,83328.2,334618.93
250250,202302,421,360,61,468733.45,79422,548155.45
250260,202302,51,41,10,53382.1,13020,66402.1
250270,202302,81,57,24,74215.4,31248,105463.4
250280,202302,410,338,72,440081.57,93744,533825.57
250290,202302,114,101,13,131502,16926.04,148428.04
250300,202302,526,357,169,464824.92,221340.96,686165.88
250310,202302,56,51,5,66403.28,6510,72913.28
250320,202302,2174,1438,736,1872367.7,958296.41,2830664.11
250330,202302,122,105,17,136712.84,22134.1,158846.94
250340,202302,33,27,6,35154.71,7812,42966.71
250350,202302,212,139,73,180981.12,95046,276027.12
250355,202302,43,34,9,44268,11718.24,55986.24
250360,202302,194,161,33,209626.32,42967.06,252593.38
250370,202302,2509,1596,913,2078066.16,1188750.71,3266816.87
250375,202302,16,10,6,13020.36,7812.68,20833.04
250380,202302,56,49,7,63799.33,9114.96,72914.29
250390,202302,50,41,9,53382.96,11718,65100.96
250400,202302,18453,9457,8996,12318785.75,11719567.22,24038352.97
250403,202302,304,234,70,304670.03,91140,395810.03
250407,202302,70,56,14,72912.1,18228.85,91140.95
250410,202302,32,27,5,35154.31,6510.8,41665.11
250415,202302,50,31,19,40362,24738,65100
250420,202302,41,35,6,45570.3,7812,53382.3
250430,202302,1549,1344,205,1750253.96,266910.69,2017164.65
250435,202302,38,29,9,37760.16,11718,49478.16
250440,202302,695,566,129,738242.16,167959,906201.16
250450,202302,91,69,22,89841,28644,118485
250460,202302,502,329,173,428364.51,225248.04,653612.55
250470,202302,104,71,33,92443.5,42966.6,135410.1
250480,202302,347,273,74,355455.91,96348.98,451804.89
250485,202302,7,6,1,7812,1302,9114
250490,202302,258,206,52,268216.8,67704.96,335921.76
250500,202302,101,78,23,102859.37,29946,132805.37
250510,202302,872,692,180,900993.67,234360.31,1135353.98
250520,202302,171,116,55,151032.1,71610.12,222642.22
250523,202302,131,107,24,139314.25,31248.12,170562.37
250527,202302,122,91,31,118482.13,40362,158844.13
250530,202302,10,6,4,7812,5208,13020
250535,202302,31,24,7,32550,9114,41664
250540,202302,146,115,31,149730.6,40362,190092.6
250550,202302,73,71,2,92442.59,2604,95046.59
250560,202302,68,41,27,53382.2,35154,88536.2
250570,202302,167,137,30,178375.12,39060.7,217435.82
250580,202302,98,77,21,100338.2,27342,127680.2
250590,202302,22,13,9,16926,11718.24,28644.24
250600,202302,1688,1113,575,1449155.67,751258.85,2200414.52
250610,202302,159,125,34,162759.78,44268.91,207028.69
250620,202302,23,19,4,24738.81,5208,29946.81
250625,202302,71,55,16,71612.39,20832.59,92444.98
250630,202302,3255,2028,1227,2640782.9,1598881.46,4239664.36
250640,202302,199,157,42,204419.24,54684.15,259103.39
250650,202302,34,22,12,28644.2,15624.48,44268.68
250660,202302,64,47,17,61194,22134,83328
250670,202302,82,64,18,83328.27,23436.94,106765.21
250680,202302,435,350,85,455711.49,110670.52,566382.01
250690,202302,2298,1548,750,2015544.7,976515.26,2992059.96
250700,202302,971,825,146,1074163.02,190092.2,1264255.22
250710,202302,504,390,114,509112.32,148433.07,657545.39
250720,202302,122,89,33,115878.76,42966,158844.76
250730,202302,420,347,73,451799.7,95046.86,546846.56
250740,202302,70,62,8,80725.54,10416.43,91141.97
250750,202302,26047,15232,10815,19840711.64,14091941.85,33932653.49
250760,202302,125,97,28,126294.5,36456.76,162751.26
250770,202302,386,254,132,330714.24,171864.7,502578.94
250780,202302,76,50,26,65100.64,33852,98952.64
250790,202302,471,287,184,373681,239570.67,613251.67
250800,202302,153,138,15,180978,19530,200508
250810,202302,73,59,14,76818,18228,95046
250820,202302,164,134,30,174470.05,39060,213530.05
250830,202302,506,327,179,425767.1,233059.68,658826.78
250840,202302,61,50,11,65101.05,14322.2,79423.25
250850,202302,71,59,12,76818,15624,92442
250855,202302,15,13,2,16926.2,2604,19530.2
250860,202302,251,163,88,212227.29,114576,326803.29
250870,202302,32,29,3,37758,3906,41664
250880,202302,94,72,22,93744.91,28644,122388.91
250890,202302,3349,2468,881,3213426.86,1148377.87,4361804.73
250900,202302,68,57,11,74214.8,14322,88536.8
250905,202302,127,92,35,119784.9,45570,165354.9
250910,202302,1005,731,274,951785.44,356751.74,1308537.18
250915,202302,118,80,38,104160.86,49477.39,153638.25
250920,202302,153,114,39,148428,50778.96,199206.96
250930,202302,206,119,87,154938.37,113275.1,268213.47
250933,202302,12,8,4,10416,5208.2,15624.2
250937,202302,19,18,1,23436,1302,24738
250939,202302,41,31,10,40362.2,13020,53382.2
250940,202302,140,100,40,130202.62,52080.2,182282.82
250950,202302,86,62,24,80726.33,31248,111974.33
250960,202302,90,52,38,67706.98,49476.3,117183.28
250970,202302,1350,956,394,1244740,512994.48,1757734.48
250980,202302,96,63,33,82027.05,42966,124993.05
250990,202302,171,131,40,170562,52080,222642
251000,202302,89,75,14,97650,18228,115878
251010,202302,139,96,43,124992,55986,180978
251020,202302,93,77,16,100254,20832,121086
251030,202302,51,36,15,46872.6,19530,66402.6
251040,202302,69,48,21,62496,27342,89838
251050,202302,31,24,7,31248,9114,40362
251060,202302,53,42,11,54685.1,14322.64,69007.74
251065,202302,6,3,3,3906,3906,7812
251070,202302,21,18,3,23436.85,3906,27342.85
251080,202302,5772,2687,3085,3499942.47,4018066.59,7518009.06
251090,202302,199,165,34,214830.84,44268.68,259099.52
251100,202302,24,22,2,28645.2,2604,31249.2
251110,202302,67,44,23,57288,29946,87234
251120,202302,2041,1260,781,1640599.53,1016880.33,2657479.86
251130,202302,459,376,83,489556.29,108066.05,597622.34
251140,202302,642,419,223,545543.1,291649.53,837192.63
251150,202302,354,295,59,384097.43,76819.66,460917.09
251160,202302,100,81,19,105462.44,24738,130200.44
251170,202302,86,71,15,92442.26,19530,111972.26
251180,202302,306,175,131,227854.74,170564.45,398419.19
251190,202302,206,131,75,170565.28,97651.16,268216.44
251200,202302,325,253,72,329416.2,93744.44,423160.64
251203,202302,34,31,3,40362.3,3906,44268.3
251207,202302,85,70,15,91140.23,19530,110670.23
251210,202302,1636,1186,450,1544201.16,585907.65,2130108.81
251220,202302,50,38,12,49477.04,15624,65101.04
251230,202302,606,509,97,662729.63,126295.81,789025.44
251240,202302,123,86,37,111972.5,48174,160146.5
251250,202302,1661,1197,464,1559730.27,605438.2,2165168.47
251260,202302,14,10,4,13020,5208.4,18228.4
251270,202302,325,257,68,334620.5,88536.69,423157.19
251272,202302,65,56,9,72912.2,11718,84630.2
251274,202302,27,20,7,26040.5,9114,35154.5
251275,202302,36,20,16,26040.58,20832,46872.58
251276,202302,28,22,6,28644.6,7812,36456.6
251278,202302,15,12,3,15625.56,3906,19531.56
251280,202302,119,114,5,148428.2,6510,154938.2
251290,202302,1178,828,350,1078127.08,455721.21,1533848.29
251300,202302,18,13,5,16926,6510,23436
251310,202302,325,234,91,304670.74,118483.16,423153.90
251315,202302,44,39,5,50778,6510.1,57288.1
251320,202302,76,62,14,80724.2,18228,98952.2
251330,202302,83,73,10,95046,13020,108066
251335,202302,21,14,7,18228,9114,27342
251340,202302,865,482,383,627580.42,498669.95,1126250.37
251350,202302,37,36,1,46872,1302,48174
251360,202302,93,78,15,101556.2,19530,121086.2
251365,202302,8,8,0,10417.79,,10417.79
251370,202302,6285,4248,2037,5532390.08,2652211.09,8184601.17
251380,202302,46,35,11,45570.54,14322,59892.54
251385,202302,3,3,0,3906,,3906.0
251390,202302,1061,772,289,1005172.18,376287.47,1381459.65
251392,202302,39,26,13,33852.5,16926.39,50778.89
251394,202302,16,12,4,15624.6,5208,20832.6
251396,202302,12,8,4,10416,5208.2,15624.2
251398,202302,21,17,4,22134.02,5208,27342.02
251400,202302,55,43,12,55986,15624,71610
251410,202302,47,39,8,50778.35,10416,61194.35
251420,202302,115,82,33,106765.9,44268.67,151034.57
251430,202302,49,43,6,55986.3,7812,63798.3
251440,202302,56,29,27,37758,35154,72912
251445,202302,69,58,11,75520.18,14322.2,89842.38
251450,202302,405,343,62,446595.79,80724.9,527320.69
251455,202302,5,4,1,5208,1302,6510
251460,202302,24,19,5,24738,6510.02,31248.02
251465,202302,11,7,4,9114,5208,14322
251470,202302,51,37,14,48174,18228,66402
251480,202302,25,21,4,27342.62,5208.38,32551.00
251490,202302,114,67,47,87236.65,61195.01,148431.66
251500,202302,110,89,21,115879.08,27342,143221.08
251510,202302,98,62,36,80724.45,46872.6,127597.05
251520,202302,43,34,9,44268,11718,55986
251530,202302,4471,3130,1341,4076640.47,1745991.92,5822632.39
251540,202302,93,75,18,97650.49,23436.66,121087.15
251550,202302,443,335,108,436187.16,140621.11,576808.27
251560,202302,24,19,5,24738.1,6510,31248.1
251570,202302,16,15,1,19530,1302,20832
251580,202302,135,104,31,135409.1,40362,175771.1
251590,202302,107,75,32,97650.2,41664.6,139314.8
251593,202302,31,17,14,22134.27,18228,40362.27
251597,202302,129,100,29,130201.68,37758.23,167959.91
251600,202302,1128,777,351,1011672.91,457005.12,1468678.03
251610,202302,272,193,79,251292.75,102858.2,354150.95
251615,202302,22,19,3,24738,3906,28644
251620,202302,4291,2720,1571,3544128.43,2051981.22,5596109.65
251630,202302,502,367,135,477853.83,175773.63,653627.46
251640,202302,109,79,30,102863.88,39060,141923.88
251650,202302,313,228,85,296860.63,110670.2,407530.83
251660,202302,206,182,24,236967.57,31248.8,268216.37
251670,202302,427,323,104,420554.8,135408.75,555963.55
251675,202302,15,10,5,13020,6510,19530
251680,202302,110,96,14,124992.84,18228,143220.84
251690,202302,329,272,57,354480.56,74214.2,428694.76
251700,202302,284,241,43,313785.18,55986,369771.18
251710,202302,23,15,8,19530.75,10416,29946.75
251720,202302,34,25,9,32550,11718,44268
251740,202302,13,10,3,13020.8,3906,16926.8
260005,202302,3930,2031,1899,2643921.11,2472539.58,5116460.69
260010,202302,1834,1372,462,1786378.17,602831.46,2389209.63
260020,202302,431,372,59,484350.22,76818.2,561168.42
260030,202302,655,438,217,570288.56,282536.38,852824.94
260040,202302,814,512,302,666644.43,394509.2,1061153.63
260050,202302,1185,855,330,1113233.99,432267.5,1545501.49
260060,202302,375,344,31,447899.05,40362,488261.05
260070,202302,1386,844,542,1098941.9,705707.4,1804649.3
260080,202302,771,577,194,751270.61,252588,1003858.61
260090,202302,480,309,171,402320.03,225246.6,627566.63
260100,202302,225,151,74,196604.53,96348,292952.53
260105,202302,279,160,119,209623.47,154938.1,364561.57
260110,202302,3153,2273,880,2959502.62,1147073.05,4106575.67
260120,202302,2896,1541,1355,2006780.09,1765532.48,3772312.57
260130,202302,221,157,64,204416.67,83328,287744.67
260140,202302,2378,1524,854,1984299.46,1113222.48,3097521.94
260150,202302,197,129,68,167959.27,88537.4,256496.67
260160,202302,364,284,80,369781.82,104160.75,473942.57
260170,202302,3601,2129,1472,2774634.26,1916572.77,4691207.03
260180,202302,186,158,28,205719.07,36456.66,242175.73
260190,202302,2593,1678,915,2186101.09,1191337.71,3377438.80
260200,202302,1040,808,232,1052037.31,302065.8,1354103.11
260210,202302,1429,1023,406,1331976.14,528618.4,1860594.54
260220,202302,644,574,70,747363.63,91141.67,838505.30
260230,202302,1365,1001,364,1303341.21,473935.36,1777276.57
260240,202302,215,162,53,210930.17,69008.62,279938.79
260250,202302,106,80,26,104160.23,33852,138012.23
260260,202302,1141,792,349,1032500.48,454400.28,1486900.76
260270,202302,265,188,77,244781.27,100254,345035.27
260280,202302,1200,951,249,1239526.64,324203.53,1563730.17
260290,202302,7518,4016,3502,5230285.28,4563548.36,9793833.64
260300,202302,1111,935,176,1217420.46,229155.01,1446575.47
260310,202302,549,433,116,563775.33,151032.6,714807.93
260320,202302,834,595,239,774692.46,311178.99,1085871.45
260330,202302,93,69,24,89838.3,31248.8,121087.1
260340,202302,89,65,24,84630.65,31248,115878.65
260345,202302,6258,3191,3067,4154830.76,3993300.1,8148130.86
260350,202302,502,357,145,464827.09,188790.91,653618.00
260360,202302,260,150,110,195301.34,143220.85,338522.19
260370,202302,741,476,265,619764.98,345031.85,964796.83
260380,202302,564,406,158,528621.1,205718.19,734339.29
260390,202302,296,252,44,328109.97,57288.6,385398.57
260392,202302,125,107,18,139316.29,23437.2,162753.49
260400,202302,4740,2696,2044,3510254.06,2663914.21,6174168.27
260410,202302,16295,8364,7931,10892835.16,10334065.49,21226900.65
260415,202302,159,132,27,171865.39,35154,207019.39
260420,202302,1870,1178,692,1533786.66,900987.84,2434774.50
260430,202302,175,156,19,203119.7,24738.8,227858.5
260440,202302,213,142,71,184890.23,92444.14,277334.37
260450,202302,443,331,112,430973.52,145825.38,576798.90
260460,202302,893,467,426,608052.72,555960.33,1164013.05
260470,202302,338,207,131,269520.34,170563.16,440083.50
260480,202302,265,166,99,216132,128898,345030
260490,202302,243,182,61,236965.11,79422,316387.11
260500,202302,1203,796,407,1036414.91,529920.93,1566335.84
260510,202302,874,697,177,907508.17,230455.07,1137963.24
260515,202302,248,229,19,298160.36,24738.91,322899.27
260520,202302,3366,2051,1315,2673006.44,1712154.43,4385160.87
260530,202302,883,701,182,912736.17,236964.7,1149700.87
260540,202302,568,445,123,579400.36,160147.36,739547.72
260545,202302,26,13,13,16926.2,16926.71,33852.91
260550,202302,363,235,128,305972.34,166656.67,472629.01
260560,202302,517,394,123,513002.03,160147.63,673149.66
260570,202302,1077,859,218,1119755,283838.3,1403593.3
260580,202302,356,286,70,372374.81,92442,464816.81
260590,202302,646,376,270,489555,352842.4,842397.4
260600,202302,8302,4825,3477,6286202.21,4533603.57,10819805.78
260610,202302,518,351,167,457015.42,217438.64,674454.06
260620,202302,4047,2109,1938,2746021.75,2523479.09,5269500.84
260630,202302,84,74,10,96348.2,13020,109368.2
260640,202302,3562,2154,1408,2804577.81,1834539.56,4639117.37
260650,202302,332,240,92,312486.11,119784.8,432270.91
260660,202302,628,413,215,537745.11,279933.94,817679.05
260670,202302,115,81,34,105462,44268.12,149730.12
260680,202302,4346,2327,2019,3029889.24,2631393.35,5661282.59
260690,202302,137,104,33,135408.74,42966,178374.74
260700,202302,333,229,104,298164.71,135408.69,433573.40
260710,202302,51,42,9,54684,11718,66402
260720,202302,2859,1663,1196,2166565.62,1558499.65,3725065.27
260730,202302,802,591,211,770795.92,274723.37,1045519.29
260740,202302,77,64,13,83328.76,16926,100254.76
260750,202302,570,425,145,554665.59,190092.82,744758.41
260760,202302,801,394,407,513012.88,531229.73,1044242.61
260765,202302,1069,559,510,727831.49,664030.97,1391862.46
260770,202302,230,164,66,213510.28,85933.79,299444.07
260775,202302,913,470,443,611960.57,578098.08,1190058.65
260780,202302,243,149,94,193999.68,122388.6,316388.28
260790,202302,17062,8224,8838,10710650.59,11513709.56,22224360.15
260795,202302,160,104,56,135408.62,72912,208320.62
260800,202302,317,262,55,341127.6,71610.46,412738.06
260805,202302,37,26,11,33854.41,14322.35,48176.76
260810,202302,893,710,183,924430.07,238266.17,1162696.24
260820,202302,326,214,112,278632.34,145824.32,424456.66
260825,202302,217,148,69,192696.08,89838,282534.08
260830,202302,310,199,111,259098,144522,403620
260840,202302,283,204,79,265611.57,102858.99,368470.56
260845,202302,207,124,83,161449.14,108067.83,269516.97
260850,202302,434,324,110,423155.76,143220,566375.76
260860,202302,240,181,59,235664.59,76818,312482.59
260870,202302,348,271,77,352846.47,100254,453100.47
260875,202302,779,562,217,731758.99,282535.2,1014294.19
260880,202302,1691,1113,578,1449150.43,752557.29,2201707.72
260890,202302,2666,1817,849,2367089.11,1106708.5,3473797.61
260900,202302,1072,792,280,1032499.6,364560.8,1397060.4
260910,202302,256,204,52,265615.11,67704.6,333319.71
260915,202302,289,217,72,283836.9,93744,377580.9
260920,202302,233,127,106,165354.2,138012,303366.2
260930,202302,366,311,55,404934.53,71610.86,476545.39
260940,202302,2725,1447,1278,1884061.59,1665281.61,3549343.20
260950,202302,2095,1180,915,1536410.5,1191351.24,2727761.74
260960,202302,14985,7150,7835,9312397,10203994.98,19516391.98
260970,202302,452,363,89,473933.76,115878,589811.76
260980,202302,221,202,19,263007.61,24738.1,287745.71
260990,202302,2821,2230,591,2903540.27,769488.38,3673028.65
261000,202302,4416,2729,1687,3554519.53,2200401.62,5754921.15
261010,202302,134,100,34,130201.44,45570,175771.44
261020,202302,621,449,172,584611.97,223944.1,808556.07
261030,202302,261,192,69,249985.78,89838,339823.78
261040,202302,388,323,65,420557.05,84630,505187.05
261050,202302,552,451,101,587211.47,131504.13,718715.60
261060,202302,1683,1050,633,1367116.24,825472.98,2192589.22
261070,202302,10587,4956,5631,6455682.65,7340902.23,13796584.88
261080,202302,374,291,83,378890.88,108066,486956.88
261090,202302,2181,1673,508,2178335.2,661421.82,2839757.02
261100,202302,1289,888,401,1156206.5,522110.12,1678316.62
261110,202302,10017,6253,3764,8143083.15,4909936.84,13053019.99
261120,202302,234,199,35,259099.09,45570,304669.09
261130,202302,585,344,241,447902.74,313791.54,761694.28
261140,202302,224,140,84,182280.75,109368.37,291649.12
261150,202302,686,444,242,578092.33,315084.86,893177.19
261153,202302,75,70,5,91140.2,6510,97650.2
261160,202302,81804,39661,42143,51662317.09,54896041.19,106558358.28
261170,202302,512,383,129,498666.68,167958.78,666625.46
261180,202302,1875,1169,706,1523670.69,921825.68,2445496.37
261190,202302,614,415,199,540337.57,259099.81,799437.38
261200,202302,224,178,46,231760.55,59892.36,291652.91
261210,202302,47,35,12,45570.1,15624,61194.1
261220,202302,3000,2084,916,2714747.95,1192650.43,3907398.38
261230,202302,380,279,101,363265.32,131502.97,494768.29
261240,202302,440,377,63,490868.83,82027.57,572896.40
261245,202302,262,224,38,291648.09,49476,341124.09
261247,202302,179,136,43,177074.49,55986,233060.49
261250,202302,4093,1951,2142,2542852.27,2788902.72,5331754.99
261255,202302,260,230,30,299460.52,39060,338520.52
261260,202302,873,746,127,971344.01,165358.79,1136702.80
261270,202302,210,149,61,193998.13,79422,273420.13
261280,202302,205,164,41,213530.01,53382.66,266912.67
261290,202302,104,73,31,95046.24,40362.2,135408.44
261300,202302,1481,1105,376,1438743.35,489557.3,1928300.65
261310,202302,862,569,293,740851.93,381488.35,1122340.28
261320,202302,528,365,163,475241.17,212228.48,687469.65
261330,202302,923,725,198,943990.96,257806.36,1201797.32
261340,202302,345,192,153,249988.41,199208.22,449196.63
261350,202302,970,670,300,872374.88,390610.04,1262984.92
261360,202302,1461,917,544,1193943.59,709596.17,1903539.76
261370,202302,5305,3095,2210,4029794.5,2877461.04,6907255.54
261380,202302,592,463,129,602832.71,167958,770790.71
261390,202302,4003,2715,1288,3536375.46,1677014.24,5213389.70
261400,202302,291,257,34,334620.92,44268.74,378889.66
261410,202302,1194,781,413,1016892.34,539032.53,1555924.87
261420,202302,1012,615,397,800745.7,516897.9,1317643.6
261430,202302,327,293,34,381491.88,44268,425759.88
261440,202302,104,99,5,128898.74,6510,135408.74
261450,202302,2705,2087,618,2717318.92,804642.23,3521961.15
261460,202302,817,625,192,813770.41,251288.53,1065058.94
261470,202302,239,191,48,248683.7,62496,311179.7
261480,202302,497,371,126,483055.32,163994.58,647049.90
261485,202302,411,243,168,316393.76,220038.88,536432.64
261500,202302,663,426,237,554662.77,308575.9,863238.67
261510,202302,54,36,18,46872.98,23436.1,70309.08
261520,202302,104,88,16,114579.73,20832.2,135411.93
261530,202302,4508,2903,1605,3781082.65,2091029.91,5872112.56
261540,202302,1608,924,684,1203073.25,890578.76,2093652.01
261550,202302,272,128,144,166657.19,187488,354145.19
261560,202302,1014,665,349,865853.65,454404.38,1320258.03
261570,202302,401,320,81,416647.14,105462.95,522110.09
261580,202302,408,328,80,427062.78,104160.61,531223.39
261590,202302,204,162,42,210932.23,54685.5,265617.73
261600,202302,332,257,75,335925.13,97650.65,433575.78
261610,202302,96,78,18,101556.92,23436.61,124993.53
261618,202302,83,60,23,78120.61,29946,108066.61
261620,202302,209,135,74,175772.23,96348.88,272121.11
261630,202302,705,550,155,717408.76,201811.66,919220.42
261640,202302,7171,3786,3385,4930822.78,4408647.3,9339470.08
261650,202302,463,297,166,386695.05,216132.3,602827.35
270010,202302,522,461,61,601536.81,79423.22,680960.03
270020,202302,262,214,48,278632.63,62496.67,341129.30
270030,202302,9597,6139,3458,7998403.32,4503616.25,12502019.57
270040,202302,2142,1417,725,1844973.19,945259.78,2790232.97
270050,202302,247,192,55,249988.56,71610.52,321599.08
270060,202302,69,48,21,62501.27,27342.33,89843.60
270070,202302,800,589,211,766891.49,274723.4,1041614.89
270080,202302,53,40,13,52080.1,16926,69006.1
270090,202302,20,16,4,20832,5208,26040
270100,202302,1367,932,435,1213489.99,566373.69,1779863.68
270110,202302,64,52,12,67704,15624,83328
270120,202302,263,214,49,278636.64,63798.45,342435.09
270130,202302,336,253,83,330712.31,109368,440080.31
270135,202302,126,90,36,117181.4,46872,164053.4
270140,202302,1464,971,493,1264276.91,641896.98,1906173.89
270150,202302,269,191,78,248686.73,101557.67,350244.40
270160,202302,492,388,104,505187.47,135408.06,640595.53
270170,202302,831,551,280,717409.46,364561.67,1081971.13
270180,202302,55,43,12,55986,15624.1,71610.1
270190,202302,114,98,16,127600.65,20832,148432.65
270200,202302,117,104,13,135408.16,16926,152334.16
270210,202302,562,351,211,457005.38,276024.6,733029.98
270220,202302,201,142,59,184884.59,76818.97,261703.56
270230,202302,2265,1444,821,1880128.22,1070250.6,2950378.82
270235,202302,494,388,106,506498.13,138012.1,644510.23
270240,202302,3407,2695,712,3508943.25,929632.52,4438575.77
270250,202302,125,95,30,123693.61,39060,162753.61
270255,202302,209,175,34,227851.67,44268.44,272120.11
270260,202302,422,335,87,436183.88,113274.7,549458.58
270270,202302,98,53,45,69006,58590,127596
270280,202302,198,125,73,162750,95046,257796
270290,202302,1158,908,250,1182237.6,326805.91,1509043.51
270300,202302,381,278,103,361957.4,134106.2,496063.6
270310,202302,827,692,135,902309.31,177073.82,1079383.13
270320,202302,763,660,103,859334.18,134106,993440.18
270330,202302,328,283,45,369768.12,58590,428358.12
270340,202302,64,53,11,69006,14322,83328
270350,202302,82,48,34,62499.53,44268.21,106767.74
270360,202302,80,45,35,58590,45570,104160
270370,202302,67,52,15,67704,19530,87234
270375,202302,85,54,31,70309.47,40362,110671.47
270380,202302,1068,739,329,963482.18,429660,1393142.18
270390,202302,134,80,54,104160.2,70308.5,174468.7
270400,202302,779,603,176,785120.52,229152.92,1014273.44
270410,202302,220,164,56,213534.58,72912,286446.58
270420,202302,418,294,124,382792.77,161448.7,544241.47
270430,202302,36227,25721,10506,33520586.01,13693477.62,47214063.63
270440,202302,470,371,99,483052.38,128899.54,611951.92
270450,202302,895,537,358,699179.84,466117.33,1165297.17
270460,202302,182,145,37,188793.9,48174,236967.9
270470,202302,1719,1198,521,1559827.69,678344.08,2238171.77
270480,202302,573,464,109,604966.37,141918.76,746885.13
270490,202302,24,19,5,24738,6510,31248
270500,202302,479,396,83,515597.67,108066,623663.67
270510,202302,915,610,305,794172.24,398414.7,1192586.94
270520,202302,268,180,88,234360.99,114576,348936.99
270530,202302,63,53,10,69006.2,13020,82026.2
270540,202302,84,59,25,76818,32550,109368
270550,202302,1667,1279,388,1665291.98,505177.56,2170469.54
270560,202302,255,156,99,203116.26,128898.5,332014.76
270570,202302,607,434,173,565074.76,225246,790320.76
270580,202302,19,14,5,18228,6510,24738
270590,202302,57,46,11,59892.3,14322,74214.3
270600,202302,161,137,24,178380.29,31248.1,209628.39
270610,202302,251,204,47,265610.72,61194.1,326804.82
270620,202302,20,19,1,24738,1302,26040
270630,202302,3698,2758,940,3593633.73,1223891.29,4817525.02
270640,202302,902,668,234,869754.25,304670.4,1174424.65
270642,202302,213,176,37,229153.75,48174,277327.75
270644,202302,267,172,95,223946.17,124994.44,348940.61
270650,202302,354,221,133,289047.5,173167.75,462215.25
270660,202302,201,177,24,230464.87,31248.15,261713.02
270670,202302,3020,2308,712,3005081.1,927026.61,3932107.71
270680,202302,399,263,136,342432.29,178374,520806.29
270690,202302,1259,850,409,1106732.94,532522.72,1639255.66
270700,202302,24,19,5,24738.19,6510,31248.19
270710,202302,561,436,125,567681.53,162750,730431.53
270720,202302,228,185,43,240874.04,55987,296861.04
270730,202302,1957,1229,728,1601485.07,947860.41,2549345.48
270740,202302,33,24,9,31248.56,11718,42966.56
270750,202302,622,480,142,626272.79,184885.42,811158.21
270760,202302,295,216,79,282541.07,102858.76,385399.83
270770,202302,2954,2032,922,2645746.13,1200453.92,3846200.05
270780,202302,67,41,26,53382,33852.78,87234.78
270790,202302,202,125,77,162752.88,100254.88,263007.76
270800,202302,2074,1666,408,2170474.73,531216,2701690.73
270810,202302,211,171,40,222644.04,52080,274724.04
270820,202302,119,82,37,106768.39,48174,154942.39
270830,202302,862,663,199,864559.14,259099.12,1123658.26
270840,202302,1335,1040,295,1354095.71,384091.36,1738187.07
270850,202302,1582,1038,544,1351489.74,708291.36,2059781.10
270860,202302,2670,1817,853,2365779.47,1110618.01,3476397.48
270870,202302,130,77,53,100255.07,69006.2,169261.27
270880,202302,860,682,178,888985.57,231759.63,1120745.20
270890,202302,261,201,60,261704.11,78121.4,339825.51
270895,202302,74,71,3,92442,3906,96348
270900,202302,66,55,11,71611.65,14322,85933.65
270910,202302,314,263,51,342436.25,67705.54,410141.79
270915,202302,1991,1338,653,1742114.13,850207.83,2592321.96
270920,202302,396,331,65,430967.5,84630,515597.5
270930,202302,5626,4347,1279,5665124.07,1666568.5,7331692.57
270940,202302,2233,1786,447,2326719.58,581996.42,2908716.00
280010,202302,33,27,6,35154.2,7812,42966.2
280020,202302,519,438,81,571593.11,105462.97,677056.08
280030,202302,22992,14801,8191,19282371.57,10668907.47,29951279.04
280040,202302,343,211,132,274724.66,171864.6,446589.26
280050,202302,453,353,100,459613,130200,589813
280060,202302,420,265,155,345037.88,201811.62,546849.50
280067,202302,1173,844,329,1101512.72,429660.36,1531173.08
280070,202302,125,106,19,138013.85,24738,162751.85
280100,202302,703,541,162,704391.57,210924.95,915316.52
280110,202302,91,79,12,102860.15,15624,118484.15
280120,202302,707,586,121,762983.04,157543.03,920526.07
280130,202302,1852,1217,635,1584554.13,826772.51,2411326.64
280140,202302,528,440,88,572887.95,114576.2,687464.15
280150,202302,433,311,122,404934.03,160146,565080.03
280160,202302,152,114,38,148428.89,49476,197904.89
280170,202302,438,309,129,402332.55,167959.51,570292.06
280190,202302,33,24,9,31248,11718,42966
280200,202302,51,40,11,52086.29,14322.3,66408.59
280210,202302,3134,2241,893,2917762.93,1162694.62,4080457.55
280220,202302,64,53,11,69008.21,14322,83330.21
280230,202302,339,273,66,355460.15,85934.55,441394.70
280240,202302,136,126,10,164055.85,13020,177075.85
280250,202302,21,11,10,14322.8,13021.87,27344.67
280260,202302,79,71,8,92444.79,10416,102860.79
280270,202302,143,110,33,143220.58,42967.32,186187.90
280280,202302,192,129,63,167961.77,82026.09,249987.86
280290,202302,3986,2890,1096,3762847.32,1427011.5,5189858.82
280300,202302,1734,1390,344,1809812.62,449193.12,2259005.74
280310,202302,104,98,6,127597.61,7812,135409.61
280320,202302,706,484,222,630186.86,289045.98,919232.84
280330,202302,326,241,85,315090.9,110670.2,425761.1
280340,202302,441,367,74,477843.48,96349.5,574192.98
280350,202302,3929,2999,930,3906181.53,1210877.62,5117059.15
280360,202302,497,340,157,442693.51,204414.95,647108.46
280370,202302,94,79,15,102858.53,19530,122388.53
280380,202302,51,40,11,52080,14322,66402
280390,202302,178,150,28,195303.48,36456,231759.48
280400,202302,426,279,147,363274.04,191397.01,554671.05
280410,202302,303,255,48,332017.37,62496,394513.37
280420,202302,145,125,20,162759.84,26040.95,188800.79
280430,202302,106,85,21,110671.32,27342,138013.32
280440,202302,738,606,132,789035.74,171867.81,960903.55
280445,202302,122,113,9,147129.29,11718,158847.29
280450,202302,1378,1174,204,1528579.42,265612.94,1794192.36
280460,202302,704,520,184,677054.17,239569.72,916623.89
280470,202302,99,91,8,118484.09,10416,128900.09
280480,202302,3359,2248,1111,2927104.83,1446565.14,4373669.97
280490,202302,207,196,11,255204.45,14322,269526.45
280500,202302,39,35,4,45571.04,5209.09,50780.13
280510,202302,135,108,27,140617.21,35154.98,175772.19
280520,202302,51,36,15,46873.45,19530,66403.45
280530,202302,74,49,25,63800.64,33852.38,97653.02
280540,202302,577,499,78,649706.79,101556,751262.79
280550,202302,767,706,61,920532.74,79422,999954.74
280560,202302,495,448,47,584608.33,61195.74,645804.07
280570,202302,2478,1964,514,2558478.07,669232.1,3227710.17
280580,202302,610,479,131,623665.14,170562.96,794228.10
280590,202302,227,147,80,191406.33,104167.45,295573.78
280600,202302,423,344,79,447955.25,102858.2,550813.45
280610,202302,117,84,33,109374.48,42968.61,152343.09
280620,202302,568,460,108,598927.74,140616.08,739543.82
280630,202302,155,126,29,164055.38,37758.4,201813.78
280640,202302,178,144,34,187488.4,44268,231756.4
280650,202302,86,53,33,69009.01,42966.59,111975.60
280660,202302,123,92,31,119791.39,40362.31,160153.70
280670,202302,2139,1363,776,1774756.21,1010383.41,2785139.62
280680,202302,246,208,38,270819.03,49476,320295.03
280690,202302,77,67,10,87234,13020,100254
280700,202302,22,22,0,28644,,28644.0
280710,202302,1592,1232,360,1605398.94,472628.75,2078027.69
280720,202302,136,95,41,123693.99,53382,177075.99
280730,202302,32,28,4,36457.54,5208.05,41665.59
280740,202302,2672,2016,656,2624865.35,855416.01,3480281.36
280750,202302,236,207,29,269522.85,37759.5,307282.35
280760,202302,983,659,324,858048.05,421851.37,1279899.42
290010,202302,203,145,58,188791.16,75516,264307.16
290020,202302,194,172,22,223947.03,28644.9,252591.93
290030,202302,640,412,228,536430.84,296856.88,833287.72
290035,202302,136,110,26,143264.19,35154.93,178419.12
290040,202302,260,181,79,235667.66,102858,338525.66
290050,202302,93,75,18,97650,23436,121086
290060,202302,256,111,145,144523.3,188791.19,333314.49
290070,202302,6326,2991,3335,3898311.13,4344835.63,8243146.76
290080,202302,488,219,269,285141.06,350238.09,635379.15
290090,202302,334,155,179,201810.2,233059.36,434869.56
290100,202302,1784,1127,657,1467387.88,855418.39,2322806.27
290110,202302,924,516,408,671860.56,531227.1,1203087.66
290115,202302,181,165,16,214834.84,20832,235666.84
290120,202302,846,573,273,746058.83,355446.3,1101505.13
290130,202302,490,297,193,386697.22,251286.84,637984.06
290135,202302,298,224,74,291653.05,96348.1,388001.15
290140,202302,334,279,55,363266.06,71610.2,434876.26
290150,202302,150,101,49,131502,63798.01,195300.01
290160,202302,250,191,59,248690.04,78121.25,326811.29
290170,202302,110,80,30,104161.24,39060,143221.24
290180,202302,200,144,56,188792.63,72913,261705.63
290190,202302,366,285,81,371081.47,105463.5,476544.97
290195,202302,311,208,103,270818.39,134106.31,404924.70
290200,202302,265,213,52,277326.51,67704.1,345030.61
290205,202302,161,98,63,127596.4,82026,209622.4
290210,202302,1298,953,345,1240839.5,449195.98,1690035.48
290220,202302,172,106,66,138017.99,85933.1,223951.09
290225,202302,292,112,180,145826.64,234361.26,380187.90
290230,202302,92,54,38,70310.81,49476,119786.81
290240,202302,375,128,247,166658.69,321594.8,488253.49
290250,202302,243,224,19,291654.38,24738,316392.38
290260,202302,359,280,79,364576.64,102861.44,467438.08
290265,202302,195,170,25,221343.22,32550.69,253893.91
290270,202302,1418,1170,248,1526001.21,322898.7,1848899.91
290280,202302,504,352,152,458309.94,197904.4,656214.34
290290,202302,1492,904,588,1177032.09,765578.33,1942610.42
290300,202302,393,333,60,433575.95,78121.05,511697.00
290310,202302,290,137,153,178374.4,199206,377580.4
290320,202302,4490,2668,1822,3475167.03,2372269.3,5847436.33
290323,202302,213,185,28,240875.69,36456.2,277331.89
290327,202302,168,130,38,169264.95,49476.13,218741.08
290330,202302,127,57,70,74214,91140,165354
290340,202302,798,336,462,437487.43,601527.41,1039014.84
290350,202302,691,413,278,537730.59,361958.42,899689.01
290360,202302,331,259,72,337225.29,93744.39,430969.68
290370,202302,904,410,494,533821.81,643188.91,1177010.72
290380,202302,348,223,125,291651.17,162751.79,454402.96
290390,202302,2517,1566,951,2038980.45,1239516.07,3278496.52
290395,202302,235,138,97,179677.17,126294,305971.17
290400,202302,298,217,81,282535.95,105462,387997.95
290405,202302,244,209,35,272120.93,45570,317690.93
290410,202302,669,556,113,723916.99,147126,871042.99
290420,202302,285,231,54,300764.3,70308,371072.3
290430,202302,514,330,184,429662.51,239568,669230.51
290440,202302,91,74,17,96348.22,22134,118482.22
290450,202302,198,145,53,188790.77,69006,257796.77
290460,202302,2062,1227,835,1598886.92,1088473.82,2687360.74
290470,202302,1407,623,784,811168.31,1020777.63,1831945.94
290475,202302,580,543,37,707000.44,48174,755174.44
290480,202302,200,112,88,145826.02,114576.93,260402.95
290485,202302,241,217,24,282536.9,31248,313784.9
290490,202302,1348,945,403,1230408.69,524709.76,1755118.45
290500,202302,840,454,386,591115.28,502575.37,1093690.65
290510,202302,191,154,37,200520.02,48174.35,248694.37
290515,202302,185,115,70,149731.23,91140,240871.23
290520,202302,1455,958,497,1247325.71,647095.23,1894420.94
290530,202302,277,248,29,322908.31,37758.2,360666.51
290540,202302,132,62,70,80724,92442,173166
290550,202302,178,147,31,191396.17,40362,231758.17
290560,202302,3295,1486,1809,1936123.06,2355332.89,4291455.95
290570,202302,7302,3430,3872,4467360.33,5044049.09,9511409.42
290580,202302,1338,804,534,1046822.46,695269.1,1742091.56
290590,202302,595,475,120,618481.1,156243.08,774724.18
290600,202302,1846,1257,589,1636679.89,768189.92,2404869.81
290610,202302,186,170,16,221350.85,22134,243484.85
290620,202302,398,350,48,457010.14,62496.6,519506.74
290630,202302,2075,884,1191,1150992.63,1550691.39,2701684.02
290640,202302,136,106,30,138016.51,39060.05,177076.56
290650,202302,2139,997,1142,1299442.17,1486893.32,2786335.49
290660,202302,276,227,49,295554.34,63798,359352.34
290670,202302,1111,555,556,722623.74,723920.54,1446544.28
290680,202302,1308,1048,260,1364517.13,338523.13,1703040.26
290682,202302,353,258,95,337222.34,123690.91,460913.25
290685,202302,266,160,106,209626.26,139314.2,348940.46
290687,202302,1255,829,426,1079595.98,554653.25,1634249.23
290689,202302,148,75,73,97650,95046.31,192696.31
290690,202302,574,262,312,341130.86,406226.53,747357.39
290700,202302,267,135,132,175776.43,171867.21,347643.64
290710,202302,824,573,251,746060.45,326808.25,1072868.70
290720,202302,1116,896,220,1166631.91,287744,1454375.91
290730,202302,1293,768,525,999959.23,683556.71,1683515.94
290740,202302,29,25,4,32550,5208,37758
290750,202302,1552,674,878,877572.52,1143175.46,2020747.98
290755,202302,82,70,12,91140.5,15624,106764.5
290760,202302,269,231,38,300775.51,49477.27,350252.78
290770,202302,193,184,9,239570.79,11718,251288.79
290780,202302,1168,937,231,1219997.49,302068.72,1522066.21
290790,202302,416,281,135,367169.29,175774.68,542943.97
290800,202302,2499,1011,1488,1317649.9,1937385.96,3255035.86
290810,202302,503,344,159,449196.02,207019.77,656215.79
290820,202302,429,247,182,322906.29,236969.3,559875.59
290830,202302,497,349,148,454405.32,193998.18,648403.50
290840,202302,1942,1221,721,1591085.76,938749.84,2529835.60
290850,202302,1089,557,532,725226.63,692669.95,1417896.58
290860,202302,720,349,371,454406.4,485648.22,940054.62
290870,202302,645,443,202,576795.59,263004.87,839800.46
290880,202302,123,65,58,84630.44,75516,160146.44
290890,202302,514,308,206,401022.16,268213.41,669235.57
290900,202302,163,126,37,164052.94,48174,212226.94
290910,202302,415,317,98,412734.92,127596,540330.92
290920,202302,212,190,22,247383.9,28644,276027.9
290930,202302,551,419,132,545552.25,171866.1,717418.35
290940,202302,222,189,33,246078.9,42966,289044.9
290950,202302,161,91,70,118482,91140,209622
290960,202302,520,373,147,485651.23,192697.48,678348.71
290970,202302,237,207,30,269516.32,39060.2,308576.52
290980,202302,2038,1420,618,1850185.45,804645.44,2654830.89
290990,202302,431,366,65,476552.71,84631.57,561184.28
291000,202302,955,310,645,403622.39,841092,1244714.39
291005,202302,2786,1187,1599,1548145.03,2081931.6,3630076.63
291010,202302,122,107,15,139314.23,19530,158844.23
291020,202302,89,71,18,92442,23436,115878
291030,202302,109,80,29,104161.74,37758,141919.74
291040,202302,665,395,270,514292.06,351541.55,865833.61
291050,202302,1605,836,769,1088493.14,1002550.39,2091043.53
291060,202302,1754,969,785,1261665.45,1022077.64,2283743.09
291070,202302,2040,1526,514,1986895.53,670538.93,2657434.46
291072,202302,7661,2932,4729,3818915.17,6159804.95,9978720.12
291075,202302,258,213,45,277326.6,58590,335916.6
291077,202302,59,41,18,53382,23436,76818
291080,202302,22641,9678,12963,12605121.34,16889804.25,29494925.59
291085,202302,286,232,54,302069.61,71610.75,373680.36
291090,202302,255,103,152,134108.6,197904,332012.6
291100,202302,985,345,640,449190.5,833280,1282470.5
291110,202302,454,344,110,447895.49,143220.6,591116.09
291120,202302,2490,1331,1159,1732989.43,1510326.37,3243315.80
291125,202302,70,35,35,45570,45570,91140
291130,202302,179,154,25,200512.74,32550,233062.74
291140,202302,133,105,28,136710.81,36456.7,173167.51
291150,202302,367,133,234,173166.32,304668,477834.32
291160,202302,416,318,98,414053.1,127597.59,541650.69
291165,202302,50,37,13,48174,16926.62,65100.62
291170,202302,3551,1760,1791,2292871.17,2333191.14,4626062.31
291180,202302,1274,539,735,703092.2,958273.07,1661365.27
291185,202302,115,106,9,138013.45,11718,149731.45
291190,202302,1424,694,730,903607.85,953074.86,1856682.71
291200,202302,176,130,46,169261.1,59892,229153.1
291210,202302,2535,1037,1498,1351501.46,1954312.58,3305814.04
291220,202302,334,256,78,333314.7,101556.2,434870.9
291230,202302,964,346,618,450501.01,804638.75,1255139.76
291240,202302,406,375,31,488255.05,40362,528617.05
291250,202302,411,335,76,436170.19,98952,535122.19
291260,202302,66,56,10,72912.1,13020,85932.1
291270,202302,1037,461,576,600261.34,751273.56,1351534.90
291280,202302,369,174,195,226551.04,253890.8,480441.84
291290,202302,1692,897,795,1167941.69,1035106.23,2203047.92
291300,202302,251,187,64,243476.35,83328,326804.35
291310,202302,233,201,32,261708.21,41664,303372.21
291320,202302,1335,928,407,1208297.33,529917.14,1738214.47
291330,202302,142,118,24,153638.17,31248.2,184886.37
291340,202302,240,148,92,192701.87,119785.99,312487.86
291345,202302,123,89,34,115878.4,44268,160146.4
291350,202302,1862,716,1146,934839.84,1497300.83,2432140.67
291360,202302,9063,4317,4746,5626191.04,6184628.18,11810819.22
291370,202302,1198,720,478,937477.75,622364.9,1559842.65
291380,202302,272,209,63,272119.65,82026,354145.65
291390,202302,4248,1889,2359,2462135.17,3076646.67,5538781.84
291400,202302,2167,1505,662,1959563.41,863242.13,2822805.54
291410,202302,234,195,39,253892.27,50778,304670.27
291420,202302,124,93,31,121086.2,40362,161448.2
291430,202302,189,117,72,152334.2,93744,246078.2
291440,202302,550,446,104,580706.26,136710.2,717416.46
291450,202302,1034,685,349,891891.38,454402.97,1346294.35
291460,202302,2141,1665,476,2167902.45,619767.97,2787670.42
291465,202302,2401,1162,1239,1514255.97,1614487.87,3128743.84
291470,202302,3036,1525,1511,1985602.37,1967339.21,3952941.58
291480,202302,12698,5504,7194,7166442.36,9378370.39,16544812.75
291490,202302,730,294,436,382792.31,567672.4,950464.71
291500,202302,375,226,149,295264.82,193998.47,489263.29
291510,202302,1191,474,717,617150.93,933535.19,1550686.12
291520,202302,948,430,518,559871.81,674437.35,1234309.16
291530,202302,945,288,657,374977.75,855414.6,1230392.35
291535,202302,137,112,25,145824.19,32550.2,178374.39
291540,202302,344,120,224,156243.5,291649.28,447892.78
291550,202302,1301,619,682,805948.03,887965.97,1693914.00
291560,202302,5290,2684,2606,3495918.83,3394326,6890244.83
291570,202302,245,130,115,169261.39,149731.61,318993.00
291580,202302,1243,785,458,1022087.5,596319.47,1618406.97
291590,202302,114,54,60,70308.18,78120,148428.18
291600,202302,1174,596,578,776006.68,752559.8,1528566.48
291610,202302,1516,732,784,953125.66,1020794.65,1973920.31
291620,202302,576,271,305,352852.95,397112.81,749965.76
291630,202302,488,153,335,199207.15,436170.2,635377.35
291640,202302,4268,2068,2200,2695209.94,2865726.94,5560936.88
291650,202302,471,328,143,427073.64,186189.31,613262.95
291660,202302,364,149,215,194000.44,279931.57,473932.01
291670,202302,168,105,63,136714.03,82026.36,218740.39
291680,202302,634,387,247,505208.17,321597.85,826806.02
291685,202302,633,369,264,480450.23,343731.92,824182.15
291690,202302,508,329,179,428361.99,233059.42,661421.41
291700,202302,1081,831,250,1081987.32,325502.94,1407490.26
291710,202302,1648,796,852,1036412.04,1109310.65,2145722.69
291720,202302,467,317,150,412736.02,195300.9,608036.92
291730,202302,977,566,411,736952.16,536427.68,1273379.84
291733,202302,323,221,102,289046.75,132804.19,421850.94
291735,202302,91,68,23,88536.2,29946,118482.2
291740,202302,352,265,87,345031.58,113274,458305.58
291750,202302,2514,1583,931,2062463.54,1214794.92,3277258.46
291760,202302,3195,1771,1424,2305855.3,1855351.46,4161206.76
291770,202302,779,519,260,675765.24,338529.24,1014294.48
291780,202302,105,65,40,84630.3,52080.8,136711.1
291790,202302,163,86,77,111972,100255.47,212227.47
291800,202302,10998,4785,6213,6231570.99,8092022.35,14323593.34
291810,202302,1091,814,277,1059850.34,360658.23,1420508.57
291820,202302,300,214,86,278629.05,111972,390601.05
291830,202302,1043,441,602,574201.02,783810.24,1358011.26
291835,202302,581,539,42,701787.67,54684.36,756472.03
291840,202302,5707,2875,2832,3744758.4,3688644.98,7433403.38
291845,202302,292,97,195,126294,253890,380184
291850,202302,316,276,40,359362.45,52081.59,411444.04
291855,202302,268,112,156,145824.41,203112.08,348936.49
291860,202302,156,102,54,132804.52,70308.7,203113.22
291870,202302,81,36,45,46872,58590,105462
291875,202302,169,156,13,203116.39,16926.84,220043.23
291880,202302,445,368,77,479146.46,100257.27,579403.73
291890,202302,258,91,167,118482.3,217434.6,335916.9
291900,202302,61,37,24,48174,31248,79422
291905,202302,128,98,30,127597.56,39060.92,166658.48
291910,202302,154,124,30,161448.96,39060.1,200509.06
291915,202302,457,398,59,518214.68,76818.9,595033.58
291920,202302,6443,3087,3356,4022086,4373509.25,8395595.25
291930,202302,173,105,68,136712.85,88536.25,225249.10
291940,202302,414,245,169,318992.83,220038,539030.83
291950,202302,1243,969,274,1261647.08,356749.48,1618396.56
291955,202302,1526,914,612,1190060.6,796832.83,1986893.43
291960,202302,205,152,53,197905.08,69006,266911.08
291970,202302,790,578,212,752574.6,276025.47,1028600.07
291980,202302,1451,1253,198,1631440.37,257799.18,1889239.55
291990,202302,148,137,11,178376.74,14322,192698.74
291992,202302,214,104,110,135416.2,143223,278639.2
291995,202302,190,122,68,158845.86,88536.2,247382.06
292000,202302,437,314,123,408835.23,160146.24,568981.47
292010,202302,370,253,117,329406.41,152334.6,481741.01
292020,202302,310,229,81,298160.43,105462,403622.43
292030,202302,165,127,38,165356.2,50778,216134.2
292040,202302,614,334,280,434868,365862,800730
292045,202302,127,111,16,144522.7,20832.54,165355.24
292050,202302,976,706,270,919222.96,355449.24,1274672.20
292060,202302,967,789,178,1027318.27,231759.56,1259077.83
292070,202302,71,28,43,36456.2,55986,92442.2
292080,202302,175,122,53,158844.41,69006,227850.41
292090,202302,582,212,370,276024.87,481740.2,757765.07
292100,202302,1701,741,960,964828.19,1249949.75,2214777.94
292105,202302,180,162,18,210924.8,23436,234360.8
292110,202302,2405,900,1505,1171823.96,1959518.26,3131342.22
292120,202302,739,561,178,730451.44,231757.79,962209.23
292130,202302,506,274,232,358055.76,303366.45,661422.21
292140,202302,216,176,40,229158.99,52081.08,281240.07
292145,202302,174,97,77,126294,100254,226548
292150,202302,1560,1299,261,1691327.97,339823.63,2031151.60
292160,202302,179,139,40,180978,53382.29,234360.29
292170,202302,1209,1020,189,1328092.86,246081.38,1574174.24
292180,202302,251,174,77,226548,100254.7,326802.7
292190,202302,158,101,57,131502,74214.96,205716.96
292200,202302,1494,551,943,717415.41,1227794.62,1945210.03
292205,202302,121,100,21,130200.73,27342,157542.73
292210,202302,406,267,139,347639.75,180978.86,528618.61
292220,202302,33,22,11,28644.11,14322,42966.11
292225,202302,60,48,12,62498.09,15624.6,78122.69
292230,202302,1040,799,241,1041629.36,315085.39,1356714.75
292240,202302,666,480,186,624979.43,242172.5,867151.93
292250,202302,1686,1080,606,1406201.9,789019.02,2195220.92
292260,202302,431,255,176,332014.67,229153.12,561167.79
292265,202302,252,191,61,248687.11,79422.86,328109.97
292270,202302,743,375,368,488255.91,479136,967391.91
292273,202302,220,129,91,167958.9,118482.6,286441.5
292275,202302,187,97,90,126294,117180,243474
292280,202302,157,108,49,140616,63798,204414
292285,202302,98,76,22,98952,28644,127596
292290,202302,660,441,219,574193.31,285139.77,859333.08
292300,202302,1965,782,1183,1018184.49,1544190.25,2562374.74
292303,202302,142,98,44,127598.4,57288.89,184887.29
292305,202302,125,90,35,117181.05,45570,162751.05
292310,202302,1032,683,349,889286.42,454404.56,1343690.98
292320,202302,615,459,156,597623.56,203113.22,800736.78
292330,202302,176,111,65,144522.16,84630,229152.16
292335,202302,323,257,66,334617.35,85932,420549.35
292340,202302,575,397,178,516899.01,231756.86,748655.87
292350,202302,292,152,140,197906.68,182280,380186.68
292360,202302,768,572,196,744748.67,255193.85,999942.52
292370,202302,736,563,173,733034.11,225247.15,958281.26
292380,202302,630,523,107,680962.75,140616.49,821579.24
292390,202302,399,162,237,210926.12,309878.03,520804.15
292400,202302,3984,2404,1580,3130108.76,2057171.43,5187280.19
292405,202302,282,185,97,240870.8,126294,367164.8
292410,202302,111,70,41,91140.7,53382,144522.7
292420,202302,278,240,38,312480.85,49476,361956.85
292430,202302,549,396,153,515595.25,199207.31,714802.56
292440,202302,667,554,113,721318.72,147128.23,868446.95
292450,202302,244,185,59,240872.13,76818.8,317690.93
292460,202302,528,401,127,522107.03,165355.34,687462.37
292465,202302,211,179,32,234361.34,41664.1,276025.44
292467,202302,182,121,61,157542.27,79422,236964.27
292470,202302,327,220,107,286441.19,139314,425755.19
292480,202302,422,283,139,368476.26,180980.78,549457.04
292490,202302,254,190,64,247382.32,83329.36,330711.68
292500,202302,987,483,504,628887.55,657518.6,1286406.15
292510,202302,3799,1852,1947,2411346.81,2535008.97,4946355.78
292520,202302,1254,595,659,777319.26,858027.52,1635346.78
292525,202302,473,349,124,455711.11,161451.51,617162.62
292530,202302,5290,2164,3126,2818899.24,4072695.07,6891594.31
292540,202302,491,283,208,368467.94,270816.52,639284.46
292550,202302,1181,655,526,854128.17,684856.55,1538984.72
292560,202302,341,308,33,402329.91,42966.16,445296.07
292570,202302,351,274,77,356749.02,100254,457003.02
292575,202302,593,429,164,559880.54,213530.96,773411.50
292580,202302,1073,722,351,940052.3,458307.3,1398359.6
292590,202302,584,519,65,675745.21,84631.1,760376.31
292593,202302,145,115,30,149730.58,39060,188790.58
292595,202302,220,174,46,227852.52,59892,287744.52
292600,202302,1340,949,391,1236939.15,509089.77,1746028.92
292610,202302,119,96,23,124997.97,29947.34,154945.31
292620,202302,538,447,91,582031.01,118483.13,700514.14
292630,202302,1651,900,751,1173126.31,977807.85,2150934.16
292640,202302,921,634,287,825481.52,373679.1,1199160.62
292650,202302,189,142,47,184892.1,61194,246086.1
292660,202302,2070,1462,608,1904883.85,792933.93,2697817.78
292665,202302,140,97,43,126294.9,55986,182280.9
292670,202302,400,303,97,394508.18,126295.07,520803.25
292680,202302,269,204,65,265609.81,84630,350239.81
292690,202302,212,146,66,190092.88,85932,276024.88
292700,202302,1067,692,375,901009.55,488257.75,1389267.30
292710,202302,118,101,17,131502.78,22134.31,153637.09
292720,202302,1055,607,448,790322.63,584598.78,1374921.41
292730,202302,221,104,117,135409.78,152334.4,287744.18
292740,202302,81317,38637,42680,50352004.86,55601733.86,105953738.72
292750,202302,416,303,113,394515.54,147129.18,541644.72
292760,202302,345,292,53,380188,69006.17,449194.17
292770,202302,926,388,538,505183.72,700484.23,1205667.95
292780,202302,39,15,24,19531.52,31248.59,50780.11
292790,202302,813,433,380,563769.15,494760.2,1058529.35
292800,202302,1334,794,540,1033804.62,703086.47,1736891.09
292805,202302,412,153,259,199207.15,337219.29,536426.44
292810,202302,1902,1121,781,1460876.83,1018168.37,2479045.20
292820,202302,710,600,110,781227.24,143222.62,924449.86
292830,202302,144,112,32,145828.25,41664.8,187493.05
292840,202302,732,589,143,766898.58,186188.79,953087.37
292850,202302,144,99,45,128901.1,58592.54,187493.64
292860,202302,2225,1265,960,1647087.2,1249938.35,2897025.55
292870,202302,3923,2550,1373,3320177.52,1788958.77,5109136.29
292880,202302,1505,995,510,1295517.6,664026.96,1959544.56
292890,202302,569,472,97,614558.12,127598.33,742156.45
292895,202302,143,99,44,128898.75,57288,186186.75
292900,202302,339,242,97,315099.4,126296.85,441396.25
292905,202302,525,257,268,334621.46,350241.19,684862.65
292910,202302,547,409,138,532526.33,179676.47,712202.80
292920,202302,606,270,336,351550.77,437479.75,789030.52
292925,202302,489,447,42,581997.08,54685.22,636682.30
292930,202302,763,460,303,600235.29,395811.67,996046.96
292935,202302,279,122,157,158844.55,204415.1,363259.65
292937,202302,217,148,69,192698.5,89838,282536.5
292940,202302,198,152,46,197904.83,59892,257796.83
292950,202302,1439,687,752,895805.96,980417.75,1876223.71
292960,202302,521,373,148,486965.94,193999.77,680965.71
292970,202302,260,190,70,247383.95,91141.82,338525.77
292975,202302,94,50,44,65104.92,57290.52,122395.44
292980,202302,366,253,113,329411.11,147127.88,476538.99
292990,202302,1363,1018,345,1325446.96,449191.82,1774638.78
293000,202302,120,84,36,109369.6,46872.1,156241.7
293010,202302,3205,1889,1316,2460920.28,1716067.35,4176987.63
293015,202302,644,531,113,691374.93,148428,839802.93
293020,202302,361,283,78,368479.97,101558.98,470038.95
293030,202302,588,523,65,682255.71,85932,768187.71
293040,202302,396,314,82,408829.98,106764,515593.98
293050,202302,3214,1875,1339,2441317.41,1743399.37,4184716.78
293060,202302,243,193,50,251297.94,65100.5,316398.44
293070,202302,4061,2043,2018,2660092.08,2628776.84,5288868.92
293075,202302,100,71,29,92442.98,37758,130200.98
293076,202302,83,61,22,79424.29,28644,108068.29
293077,202302,629,356,273,463531.82,355452.99,818984.81
293080,202302,439,390,49,507786.99,63798.66,571585.65
293090,202302,139,123,16,160146,20832,180978
293100,202302,552,373,179,485653.84,233058.97,718712.81
293105,202302,360,263,97,342427.48,126294,468721.48
293110,202302,131,85,46,110676.94,59895.39,170572.33
293120,202302,306,216,90,281237.87,117182.98,398420.85
293130,202302,257,173,84,225252.62,109368,334620.62
293135,202302,8854,3585,5269,4667789.36,6866774.62,11534563.98
293140,202302,204,122,82,158847.24,106764.92,265612.16
293150,202302,326,282,44,367173.47,57288.4,424461.87
293160,202302,436,274,162,356751.03,212226.47,568977.50
293170,202302,265,165,100,214835.84,130202.09,345037.93
293180,202302,629,423,206,550748.6,268212,818960.6
293190,202302,1448,1000,448,1302034.99,584608.43,1886643.42
293200,202302,605,527,78,687471.86,101556,789027.86
293210,202302,433,328,105,427065.49,136710,563775.49
293220,202302,2438,1091,1347,1420501.99,1755103.86,3175605.85
293230,202302,1860,694,1166,903610.88,1522041.92,2425652.80
293240,202302,238,213,25,277333.46,32550.4,309883.86
293245,202302,129,106,23,138014.02,29946,167960.02
293250,202302,848,363,485,473941.84,631483.49,1105425.33
293260,202302,335,262,73,341125.65,95046,436171.65
293270,202302,1235,552,683,718710.83,889266.1,1607976.93
293280,202302,322,217,105,282536.8,136710.93,419247.73
293290,202302,3175,2032,1143,2645722.91,1490800.53,4136523.44
293300,202302,930,642,288,835892.87,374976.84,1210869.71
293305,202302,198,151,47,196603.2,61194.65,257797.85
293310,202302,175,131,44,170564.05,57288.7,227852.75
293315,202302,176,133,43,173169.1,55986.69,229155.79
293317,202302,94,69,25,89838.4,32550,122388.4
293320,202302,1308,676,632,880217.08,822885.21,1703102.29
293325,202302,219,91,128,118482,166656,285138
293330,202302,15548,7155,8393,9319980.05,10935617.24,20255597.29
293340,202302,298,207,91,269514.7,118482,387996.7
293345,202302,264,219,45,285142.64,58590,343732.64
293350,202302,605,381,224,496077.65,291649.39,787727.04
293360,202302,1554,1091,463,1423116.94,602832.73,2025949.67
310010,202302,147,76,71,98952.77,92442.04,191394.81
310020,202302,1013,553,460,720022.52,598926.18,1318948.70
310030,202302,318,254,64,330714.36,83330.32,414044.68
310040,202302,47,33,14,42966,18228,61194
310050,202302,166,104,62,135408.21,80724,216132.21
310060,202302,284,202,82,263013.42,106764.86,369778.28
310070,202302,19,11,8,14322.81,10416.2,24739.01
310080,202302,53,36,17,46872,22134.83,69006.83
310090,202302,1155,646,509,842414.45,664029.48,1506443.93
310100,202302,389,272,117,354153.34,152335.26,506488.60
310110,202302,727,389,338,506486.42,440078.82,946565.24
310120,202302,393,228,165,296856.36,214831.23,511687.59
310130,202302,35,19,16,24738.2,20832,45570.2
310140,202302,26,10,16,13020,20832.76,33852.76
310150,202302,1240,814,426,1059865.35,554661.67,1614527.02
310160,202302,2236,1110,1126,1450466.83,1471271.19,2921738.02
310163,202302,105,61,44,79422,57288,136710
310170,202302,2718,1299,1419,1692641.44,1847554.68,3540196.12
310180,202302,200,93,107,121087.94,139314,260401.94
310190,202302,502,337,165,438778.92,214832.15,653611.07
310200,202302,441,280,161,364565.55,209622.2,574187.75
310205,202302,80,55,25,71610,32550,104160
310210,202302,278,227,51,295555.99,66402,361957.99
310220,202302,62,38,24,49476.47,31248,80724.47
310230,202302,290,207,83,269516.23,108066,377582.23
310240,202302,128,103,25,134106,32550,166656
310250,202302,94,77,17,100256.51,22134,122390.51
310260,202302,791,426,365,554673.34,475234.62,1029907.96
310270,202302,289,183,106,238270.96,138012.14,376283.10
310280,202302,409,288,121,374979.17,157542.44,532521.61
310285,202302,212,162,50,210926.67,65100.99,276027.66
310290,202302,241,130,111,169261.7,144522,313783.7
310300,202302,181,145,36,188792.43,46872,235664.43
310310,202302,12,10,2,13020,2604,15624
310320,202302,31,11,20,14322.18,26040.17,40362.35
310330,202302,47,35,12,45570.19,15624.66,61194.85
310340,202302,1953,1397,556,1820226.62,723916.27,2544142.89
310350,202302,2905,1505,1400,1959575.73,1825415.55,3784991.28
310360,202302,53,41,12,53382.39,15624.12,69006.51
310370,202302,137,114,23,148428,29946,178374
310375,202302,112,44,68,57289.28,88537.28,145826.56
310380,202302,52,33,19,42966,24738,67704
310390,202302,113,66,47,85932.3,61194,147126.3
310400,202302,2677,1766,911,2300732.35,1186132.92,3486865.27
310410,202302,119,70,49,91141.49,63798,154939.49
310420,202302,713,368,345,479145.71,449195.64,928341.35
310430,202302,293,190,103,248684.1,134106,382790.1
310440,202302,80,50,30,65100,39060,104160
310445,202302,85,72,13,93745.29,16926,110671.29
310450,202302,689,456,233,593728.7,304669.13,898397.83
310460,202302,265,180,85,234363.79,110670.31,345034.10
310470,202302,562,368,194,479146.52,253892.73,733039.25
310480,202302,102,64,38,83328,49476,132804
310490,202302,589,281,308,365870.19,401017.3,766887.49
310500,202302,132,55,77,71612.13,100254.8,171866.93
310510,202302,637,452,185,588520.55,240871.73,829392.28
310520,202302,150,105,45,136712,58590,195302
310530,202302,124,54,70,70308.43,91140,161448.43
310540,202302,508,286,222,372381.46,289047.41,661428.87
310550,202302,77,51,26,66405.74,33852,100257.74
310560,202302,3361,2298,1063,2992075.25,1386634.19,4378709.44
310570,202302,110,69,41,89838.6,53382,143220.6
310590,202302,410,240,170,313790.16,222642.81,536432.97
310600,202302,144,68,76,88537.59,98952,187489.59
310610,202302,46,17,29,22134.91,37758,59892.91
310620,202302,53216,25216,28000,32849095.79,36486198.24,69335294.03
310630,202302,799,478,321,622369.34,417943.33,1040312.67
310640,202302,158,105,53,136710.2,69006.2,205716.4
310650,202302,177,158,19,205716.2,24738,230454.2
310660,202302,117,78,39,101556.2,50778,152334.2
310665,202302,71,48,23,62496,29946,92442
310670,202302,7809,3391,4418,4420455.79,5754870.97,10175326.76
310680,202302,65,42,23,54684,29946,84630
310690,202302,626,448,178,583310,233061.24,816371.24
310700,202302,63,38,25,49476.2,32550.97,82027.17
310710,202302,1329,898,431,1169583.78,562470.19,1732053.97
310720,202302,163,46,117,59892,152334,212226
310730,202302,1633,1103,530,1438762.43,690077.8,2128840.23
310740,202302,1052,574,478,747375.31,622360.75,1369736.06
310750,202302,259,163,96,212228.02,124992.37,337220.39
310760,202302,74,57,17,74217.34,22134,96351.34
310770,202302,88,41,47,53382.1,61194,114576.1
310780,202302,372,301,71,391909.38,92442.6,484351.98
310790,202302,117,93,24,122389.15,31248.59,153637.74
310800,202302,498,234,264,304671.16,343728,648399.16
310810,202302,184,122,62,158844.37,80724.59,239568.96
310820,202302,319,255,64,332017.61,83328.04,415345.65
310825,202302,217,180,37,234361.89,48174,282535.89
310830,202302,478,217,261,282536.23,341126.1,623662.33
310840,202302,383,234,149,305972.84,193998.4,499971.24
310850,202302,78,63,15,82026.95,19530,101556.95
310855,202302,447,351,96,457011.68,124992,582003.68
310860,202302,1694,1251,443,1628851.38,578097.01,2206948.39
310870,202302,66,56,10,72913.32,13020,85933.32
310880,202302,95,75,20,97650,26040,123690
310890,202302,297,174,123,226550.43,161448,387998.43
310900,202302,649,303,346,394512.31,450498.75,845011.06
310910,202302,252,168,84,218738.3,110670,329408.3
310920,202302,443,255,188,332023.08,246083.24,578106.32
310925,202302,38,30,8,39060.85,10416,49476.85
310930,202302,1409,946,463,1234314.62,602830.46,1837145.08
310940,202302,715,350,365,455711.52,476537.69,932249.21
310945,202302,147,95,52,123690.1,67704,191394.1
310950,202302,219,172,47,223946.85,61194,285140.85
310960,202302,76,27,49,35156.51,65100.03,100256.54
310970,202302,181,105,76,138013.71,98952.6,236966.31
310980,202302,55,37,18,48178.8,23436,71614.8
310990,202302,163,85,78,110670.48,101556.8,212227.28
311000,202302,897,454,443,591122.5,576791.01,1167913.51
311010,202302,54,41,13,53383.44,16926,70309.44
311020,202302,40,26,14,33852.55,18228,52080.55
311030,202302,410,232,178,302065.5,231756.78,533822.28
311040,202302,40,31,9,40362,11718,52080
311050,202302,537,203,334,264307.49,434869.8,699177.29
311060,202302,858,469,389,610649.25,506482.19,1117131.44
311070,202302,350,159,191,208321.93,248682,457003.93
311080,202302,128,74,54,96350.96,70309.61,166660.57
311090,202302,354,174,180,226554.02,235662.86,462216.88
311100,202302,587,358,229,466120.92,298158.25,764279.17
311110,202302,726,519,207,675759.78,270820.5,946580.28
311115,202302,83,56,27,72912,35154,108066
311120,202302,1171,649,522,845025.82,679651.27,1524677.09
311130,202302,297,172,125,223949.79,162750,386699.79
311140,202302,178,100,78,130203.29,101558.18,231761.47
311150,202302,340,215,125,279935.02,162750,442685.02
311160,202302,796,566,230,736944.02,299461.26,1036405.28
311170,202302,95,77,18,100254.69,23436,123690.69
311180,202302,325,220,105,286451.01,136710.68,423161.69
311190,202302,37,18,19,23436,24738,48174
311200,202302,356,239,117,311180.38,152334.9,463515.28
311205,202302,34,27,7,35154,9114,44268
311210,202302,38,34,4,44268.6,5208,49476.6
311220,202302,33,29,4,37758,5208,42966
311230,202302,1741,1159,582,1509069.66,757772.52,2266842.18
311240,202302,83,53,30,69009.39,39060.85,108070.24
311250,202302,64,26,38,33852,49476,83328
311260,202302,559,343,216,446592.89,281232.14,727825.03
311265,202302,136,88,48,114577.11,62496,177073.11
311270,202302,291,198,93,257800.15,121089.15,378889.30
311280,202302,207,91,116,118483.36,151032,269515.36
311290,202302,108,93,15,121087.38,19530.2,140617.58
311300,202302,611,391,220,509090.07,286441.89,795531.96
311310,202302,18,15,3,19530,3906,23436
311320,202302,668,499,169,649707.86,220039.53,869747.39
311330,202302,1266,928,338,1208282.77,440086.67,1648369.44
311340,202302,2803,1968,835,2565000.94,1087174.91,3652175.85
311350,202302,271,207,64,269517.65,83328,352845.65
311360,202302,171,104,67,135410.07,87234,222644.07
311370,202302,1284,549,735,714824.92,958283.76,1673108.68
311380,202302,7,6,1,7812,1302,9114
311390,202302,254,148,106,192697.39,138012.2,330709.59
311400,202302,142,89,53,115878.2,69006,184884.2
311410,202302,127,61,66,79422.68,85932,165354.68
311420,202302,329,166,163,216136.37,213530.49,429666.86
311430,202302,875,577,298,751263.08,387997,1139260.08
311440,202302,474,323,151,420561.16,196604.6,617165.76
311450,202302,315,185,130,240872.01,169260.92,410132.93
311455,202302,282,190,92,247385.85,119785.63,367171.48
311460,202302,134,60,74,78120.6,96348.65,174469.25
311470,202302,32,14,18,18228,23436,41664
311480,202302,57,31,26,40362,33852,74214
311490,202302,11,6,5,7812,6510,14322
311500,202302,31,15,16,19530.03,20832,40362.03
311510,202302,830,563,267,733043.98,347636.52,1080680.50
311520,202302,42,35,7,45570,9114,54684
311530,202302,1921,1380,541,1798132.48,704383.58,2502516.06
311535,202302,66,44,22,57288.8,28644.52,85933.32
311540,202302,35,31,4,41664.75,5208,46872.75
311545,202302,175,127,48,165355.48,62496,227851.48
311547,202302,61,46,15,59892.85,19530.12,79422.97
311550,202302,716,327,389,427065.9,506480.63,933546.53
311560,202302,45,28,17,36456.83,22134,58590.83
311570,202302,299,197,102,256497.04,132807.02,389304.06
311580,202302,441,282,159,368470.56,208320.33,576790.89
311590,202302,29,24,5,31249.65,6510,37759.65
311600,202302,96,77,19,100255.8,24739.82,124995.62
311610,202302,263,226,37,294254.3,48174.73,342429.03
311615,202302,172,144,28,187488.69,36456.52,223945.21
311620,202302,33,23,10,29946.9,13020,42966.9
311630,202302,111,96,15,124992,20832,145824
311640,202302,133,64,69,83329.04,91143.14,174472.18
311650,202302,130,90,40,117180,52080.2,169260.2
311660,202302,455,207,248,269517.17,322897.27,592414.44
311670,202302,161,109,52,141734.56,67704.43,209438.99
311680,202302,228,173,55,225247.97,71610.18,296858.15
311690,202302,12,12,0,15624.5,,15624.5
311700,202302,204,153,51,199209.53,66402.96,265612.49
311710,202302,183,123,60,161449.51,78120,239569.51
311720,202302,42,31,11,40363.2,14322,54685.2
311730,202302,602,425,177,553367.82,230455.15,783822.97
311740,202302,30,21,9,27342,11718,39060
311750,202302,756,514,242,669236.19,316386.75,985622.94
311760,202302,83,37,46,48176.12,59892.11,108068.23
311770,202302,380,186,194,242174.27,252588.61,494762.88
311780,202302,218,114,104,148429.59,135408.27,283837.86
311783,202302,96,84,12,109370.16,15624,124994.16
311787,202302,51,19,32,24738,41664.04,66402.04
311790,202302,276,121,155,157544.66,201812.17,359356.83
311800,202302,786,476,310,619763.76,403623.61,1023387.37
311810,202302,56,40,16,52081.41,20832,72913.41
311820,202302,134,103,31,134109.22,40362.78,174472.00
311830,202302,2058,1206,852,1570250.64,1110607.41,2680858.05
311840,202302,1157,659,498,860633.32,649702.02,1510335.34
311850,202302,18,12,6,15624,7812.2,23436.2
311860,202302,10991,4707,6284,6132630.21,8187064.78,14319694.99
311870,202302,117,67,50,87236.4,65100.31,152336.71
311880,202302,998,715,283,930954.94,368475.47,1299430.41
311890,202302,207,95,112,123585.37,145826.07,269411.44
311900,202302,72,28,44,37758,57288.15,95046.15
311910,202302,1480,928,552,1208284.34,718709.85,1926994.19
311920,202302,251,163,88,212227.94,114576.2,326804.14
311930,202302,955,537,418,699186.4,546843.7,1246030.1
311940,202302,2832,1552,1280,2020770.09,1667865.42,3688635.51
311950,202302,170,100,70,130202.56,91141.55,221344.11
311960,202302,68,48,20,62496.79,26040,88536.79
311970,202302,26,14,12,18228,15624,33852
311980,202302,40,30,10,39060,13020,52080
311990,202302,39,27,12,35154.08,15624.64,50778.72
311995,202302,55,32,23,41664.7,29946.42,71611.12
312000,202302,22,16,6,20832,7812,28644
312010,202302,76,59,17,76819.65,22134.1,98953.75
312015,202302,86,62,24,80724.69,31248,111972.69
312020,202302,141,101,40,131502.25,52080,183582.25
312030,202302,77,57,20,74214,26040,100254
312040,202302,89,53,36,69006,46872,115878
312050,202302,203,117,86,152335.58,111972,264307.58
312060,202302,19,12,7,15624,9114,24738
312070,202302,86,55,31,71610.88,40362.2,111973.08
312080,202302,589,279,310,363260.78,404923.16,768183.94
312083,202302,80,53,27,69006.97,35154,104160.97
312087,202302,106,78,28,101557.26,36456,138013.26
312090,202302,3645,2239,1406,2917894.28,1833231.77,4751126.05
312100,202302,151,109,42,141622.07,54684.7,196306.77
312110,202302,132,80,52,104161.57,67704.02,171865.59
312120,202302,132,95,37,123691.47,48174,171865.47
312125,202302,88,57,31,74214.98,40362.64,114577.62
312130,202302,133,88,45,114577.06,59892,174469.06
312140,202302,151,117,34,152336.14,44268,196604.14
312150,202302,39,30,9,39060,11718,50778
312160,202302,1529,1016,513,1324274.42,669233.72,1993508.14
312170,202302,13,10,3,13020,3906,16926
312180,202302,88,65,23,84630,29946,114576
312190,202302,50,43,7,55986.46,9114,65100.46
312200,202302,774,658,116,856738.33,151033.76,1007772.09
312210,202302,132,69,63,89839.13,82026.58,171865.71
312220,202302,150,110,40,143222.88,52080,195302.88
312230,202302,4090,1817,2273,2368418.05,2965966.89,5334384.94
312235,202302,176,118,58,153636,75516,229152
312240,202302,88,64,24,83330.66,31248,114578.66
312245,202302,237,172,65,223948.53,84630.5,308579.03
312247,202302,86,63,23,82026.37,31248.38,113274.75
312250,202302,183,94,89,122390.13,115878,238268.13
312260,202302,110,71,39,92442,50778,143220
312270,202302,142,84,58,109370.18,75516,184886.18
312280,202302,31,17,14,22134,18228,40362
312290,202302,148,100,48,130201.27,62497.24,192698.51
312300,202302,213,137,76,178377.05,98953.45,277330.50
312310,202302,63,56,7,72912,9114,82026
312320,202302,435,265,170,345031.48,221340,566371.48
312330,202302,102,87,15,113274,19530.92,132804.92
312340,202302,33,17,16,22134,20832,42966
312350,202302,14,8,6,10416.32,7812,18228.32
312352,202302,96,68,28,88536.61,36456,124992.61
312360,202302,606,261,345,339828.96,450492.2,790321.16
312370,202302,393,215,178,279931.26,231757.49,511688.75
312380,202302,145,97,48,126301.35,62497.39,188798.74
312385,202302,169,139,30,180981.05,39060.82,220041.87
312390,202302,305,195,110,253891.62,144522,398413.62
312400,202302,396,298,98,387997.3,127596.67,515593.97
312410,202302,1310,482,828,627584.33,1078075.87,1705660.20
312420,202302,707,534,173,695277.02,225247.05,920524.07
312430,202302,902,649,253,845008.43,329407.49,1174415.92
312440,202302,51,38,13,49476,16926,66402
312450,202302,227,134,93,174468,122388,296856
312460,202302,37,17,20,22134.59,26040,48174.59
312470,202302,47,33,14,42966,18228,61194
312480,202302,173,107,66,139317.06,85933.19,225250.25
312490,202302,333,226,107,294261.32,139315.7,433577.02
312500,202302,34,23,11,29947.21,15624,45571.21
312510,202302,710,280,430,364568.2,561169.73,925737.93
312520,202302,27,8,19,10416,24738,35154
312530,202302,40,28,12,36457.46,15624.1,52081.56
312540,202302,89,76,13,98952.2,16926,115878.2
312550,202302,33,26,7,33852,9114,42966
312560,202302,215,169,46,220040.46,59892,279932.46
312570,202302,498,297,201,386704.13,263005.44,649709.57
312580,202302,90,54,36,71610,46872,118482
312590,202302,222,176,46,229154.71,59892,289046.71
312595,202302,163,133,30,173166.25,39060,212226.25
312600,202302,77,36,41,46872.9,54684,101556.9
312610,202302,1651,855,796,1114538.16,1037695.48,2152233.64
312620,202302,236,173,63,226550.12,82026,308576.12
312630,202302,71,57,14,74214.88,19530,93744.88
312640,202302,45,12,33,15624,42966,58590
312650,202302,163,140,23,182720.07,29946.1,212666.17
312660,202302,115,83,32,108071.79,41664.59,149736.38
312670,202302,968,614,354,799452.07,460914,1260366.07
312675,202302,50,39,11,50778,14322,65100
312680,202302,77,50,27,65100,35154,100254
312690,202302,276,142,134,184887.38,174468.45,359355.83
312695,202302,32,25,7,32550,9114,41664
312700,202302,259,153,106,200511.74,138012.64,338524.38
312705,202302,84,67,17,87234,22134,109368
312707,202302,131,92,39,119784.39,50778,170562.39
312710,202302,1995,1118,877,1455684.72,1143162.78,2598847.50
312720,202302,44,23,21,29946.56,27342,57288.56
312730,202302,289,170,119,221345.59,154940.72,376286.31
312733,202302,50,40,10,52080.7,13020,65100.7
312735,202302,22,16,6,20832.71,7812.8,28645.51
312737,202302,80,46,34,59892.11,44268,104160.11
312738,202302,72,45,27,58590.23,35154,93744.23
312740,202302,76,49,27,63799.69,35154,98953.69
312750,202302,114,76,38,98952.6,49476,148428.6
312760,202302,284,192,92,251290.52,119784.97,371075.49
312770,202302,9460,4518,4942,5887797.43,6438409.24,12326206.67
312780,202302,466,353,113,459614.12,147128.81,606742.93
312790,202302,21,14,7,18228,9114.9,27342.9
312800,202302,1736,1195,541,1557210.28,704385.69,2261595.97
312810,202302,356,245,111,318990.45,144522,463512.45
312820,202302,196,151,45,197906.49,58590,256496.49
312825,202302,47,35,12,46874.69,15624,62498.69
312830,202302,194,105,89,138013.98,115878.85,253892.83
312840,202302,202,143,59,186187.5,76818,263005.5
312850,202302,37,32,5,41664.9,6510,48174.9
312860,202302,149,100,49,130201.08,63798.2,193999.28
312870,202302,1253,652,601,848926.43,783804.62,1632731.05
312880,202302,124,93,31,121089.62,40362,161451.62
312890,202302,179,129,50,167962.55,65100,233062.55
312900,202302,164,123,41,160148,53382,213530
312910,202302,180,101,79,131508.41,102859.69,234368.10
312920,202302,115,66,49,85932.46,63798,149730.46
312930,202302,342,230,112,299464.98,145826,445290.98
312940,202302,155,105,50,136710.7,65100,201810.7
312950,202302,777,545,232,709608.71,302067.11,1011675.82
312960,202302,148,106,42,138018.47,54685.9,192704.37
312965,202302,121,96,25,124992.1,32550,157542.1
312970,202302,305,243,62,316393.93,80724.89,397118.82
312980,202302,2817,1456,1361,1895778.13,1773332.32,3669110.45
312990,202302,46,18,28,23436.89,36456,59892.89
313000,202302,57,32,25,41664,32550,74214
313005,202302,186,143,43,186186.59,55986.5,242173.09
313010,202302,1034,450,584,585915.9,761675.61,1347591.51
313020,202302,199,106,93,138012,121086,259098
313030,202302,216,140,76,182281.02,98952,281233.02
313040,202302,93,28,65,36456.31,84630,121086.31
313050,202302,221,161,60,209622.61,78120,287742.61
313055,202302,40,28,12,36456,15624,52080
313060,202302,151,104,47,135409.65,61194,196603.65
313065,202302,57,42,15,54684,19530.6,74214.6
313070,202302,131,68,63,89840.14,82026,171866.14
313080,202302,43,24,19,31248.54,24738,55986.54
313090,202302,705,458,247,596326.11,321594.18,917920.29
313100,202302,222,82,140,106764.2,182280,289044.2
313110,202302,160,88,72,114576.3,93745.14,208321.44
313115,202302,257,136,121,177076.91,157543.57,334620.48
313120,202302,881,505,376,657525.78,489557.04,1147082.82
313130,202302,6418,3568,2850,4645676.65,3714635.29,8360311.94
313140,202302,137,78,59,101558.61,76819.35,178377.96
313150,202302,309,241,68,313785.01,88536,402321.01
313160,202302,188,141,47,183588.68,62496,246084.68
313170,202302,1494,937,557,1220011,725215.84,1945226.84
313180,202302,343,218,125,283840.87,162752.85,446593.72
313190,202302,806,464,342,604142.7,445289.12,1049431.82
313200,202302,36,28,8,36456.78,10416.2,46872.98
313210,202302,1058,905,153,1178365.34,199209.57,1377574.91
313220,202302,330,199,131,259098,170562,429660
313230,202302,301,234,67,304670.89,87234,391904.89
313240,202302,2422,1211,1211,1576766,1578024.63,3154790.63
313250,202302,1289,963,326,1253859.87,424456.07,1678315.94
313260,202302,101,48,53,62496.78,69006,131502.78
313270,202302,1096,648,448,843707.34,584604.41,1428311.75
313280,202302,47,37,10,48174,13020,61194
313290,202302,246,196,50,255198.08,65100,320298.08
313300,202302,335,161,174,209626.97,226548.58,436175.55
313310,202302,262,116,146,151033.47,190092.8,341126.27
313320,202302,402,294,108,382791.96,140616.07,523408.03
313330,202302,1510,931,579,1213492.12,756468.41,1969960.53
313340,202302,347,249,98,324202.95,127596.92,451799.87
313350,202302,468,285,183,371072.54,239568.24,610640.78
313360,202302,203,95,108,123690.3,140616,264306.3
313370,202302,244,89,155,115878.41,201810,317688.41
313375,202302,342,213,129,277331.73,167958.4,445290.13
313380,202302,1378,722,656,940069.88,854115.15,1794185.03
313390,202302,57,51,6,66402.6,7812,74214.6
313400,202302,423,293,130,381504.09,170565.52,552069.61
313410,202302,95,61,34,79422.5,44268.81,123691.31
313420,202302,4895,2769,2126,3607971,2769370.16,6377341.16
313430,202302,125,60,65,78120.31,84630.33,162750.64
313440,202302,1440,1021,419,1329406.02,545547.59,1874953.61
313450,202302,69,31,38,40362,49476,89838
313460,202302,417,184,233,239574.24,303366.86,542941.10
313470,202302,531,256,275,333324.79,358056.21,691381.00
313480,202302,165,124,41,161449.44,53382,214831.44
313490,202302,579,261,318,341135.45,415346.96,756482.41
313500,202302,31,17,14,22134,18228,40362
313505,202302,1141,875,266,1140584.41,347639.06,1488223.47
313507,202302,110,75,35,97651.33,45570,143221.33
313510,202302,3067,1889,1178,2460985.15,1536384.77,3997369.92
313520,202302,3565,2754,811,3585841.59,1055933.66,4641775.25
313530,202302,40,24,16,31248,20832.94,52080.94
313535,202302,87,72,15,93746.3,20832,114578.3
313540,202302,68,48,20,62496,26040,88536
313545,202302,125,106,19,138012.51,24738,162750.51
313550,202302,221,188,33,244779.57,42967.35,287746.92
313560,202302,368,174,194,226552.89,252594.89,479147.78
313570,202302,81,28,53,36456,69006,105462
313580,202302,1425,838,587,1091095.94,765581.33,1856677.27
313590,202302,72,45,27,58590.59,35154.8,93745.39
313600,202302,710,429,281,558566.71,365863.31,924430.02
313610,202302,58,45,13,58591.62,16926.35,75517.97
313620,202302,1596,771,825,1003872.9,1076758.6,2080631.5
313630,202302,1746,1319,427,1719983.49,555957.11,2275940.60
313640,202302,120,72,48,93745.08,62496,156241.08
313650,202302,249,131,118,170563.42,153637.03,324200.45
313652,202302,34,32,2,41664,2604,44268
313655,202302,94,63,31,82027.46,40362.36,122389.82
313657,202302,53,49,4,63800.03,5208,69008.03
313660,202302,146,98,48,127597.19,62497.11,190094.30
313665,202302,754,348,406,453110.16,528623.27,981733.43
313670,202302,11513,7881,3632,10265472.2,4731516.12,14996988.32
313680,202302,44,35,9,45570.73,11718,57288.73
313690,202302,139,100,39,130200.47,50778,180978.47
313695,202302,87,66,21,85932.41,27342,113274.41
313700,202302,359,275,84,358055.41,109369.48,467424.89
313710,202302,132,94,38,122391.15,49476,171867.15
313720,202302,1242,578,664,752584.18,864538.43,1617122.61
313730,202302,75,44,31,57288.93,40362,97650.93
313740,202302,162,120,42,156241.57,54684,210925.57
313750,202302,416,291,125,378887.02,162750.79,541637.81
313753,202302,242,183,59,238270.47,76818.1,315088.57
313760,202302,1458,575,883,748669.89,1149678.3,1898348.19
313770,202302,434,293,141,381497.38,183585.86,565083.24
313780,202302,908,497,411,647100.58,537729.28,1184829.86
313790,202302,37,37,0,48174,,48174.0
313800,202302,175,110,65,143224.46,84631.07,227855.53
313810,202302,96,54,42,70308.81,54685.02,124993.83
313820,202302,1473,714,759,929652.59,988220.48,1917873.07
313830,202302,56,37,19,48174.89,24738,72912.89
313835,202302,68,59,9,76818.2,11718,88536.2
313840,202302,1822,1101,721,1433547.96,940049.21,2373597.17
313850,202302,235,105,130,136712.98,169260.5,305973.48
313860,202302,506,382,124,497373.8,161448.64,658822.44
313862,202302,182,127,55,165359.81,71610.2,236970.01
313865,202302,190,130,60,169261.64,78120.1,247381.74
313867,202302,66,55,11,71610,14322.1,85932.1
313868,202302,52,32,20,41664,27342,69006
313870,202302,82,45,37,58590.2,48174,106764.2
313880,202302,397,247,150,321597.29,195300.69,516897.98
313890,202302,354,194,160,252592.75,209622.15,462214.90
313900,202302,865,472,393,614559.19,511693.11,1126252.30
313910,202302,151,103,48,134106,62496,196602
313920,202302,683,464,219,604132.93,286441.24,890574.17
313925,202302,36,30,6,39060,7812,46872
313930,202302,944,720,224,937473.1,291653.19,1229126.29
313940,202302,2072,1231,841,1602798.15,1094991.47,2697789.62
313950,202302,897,544,353,708302.04,462211.02,1170513.06
313960,202302,1553,888,665,1156194.82,865838.25,2022033.07
313970,202302,194,111,83,144522.1,108066.2,252588.3
313980,202302,258,164,94,213537.75,122390.04,335927.79
313990,202302,280,171,109,222643.53,141918.15,364561.68
314000,202302,925,606,319,789025.07,415342.41,1204367.48
314010,202302,105,66,39,85932.15,50778,136710.15
314015,202302,98,28,70,36456.97,91140.9,127597.87
314020,202302,58,38,20,49476.42,26040,75516.42
314030,202302,76,38,38,49476.42,49476,98952.42
314040,202302,48,26,22,33852,28644,62496
314050,202302,301,166,135,216137.35,175770,391907.35
314053,202302,100,63,37,82027.01,48174,130201.01
314055,202302,310,198,112,257800.11,145826.14,403626.25
314060,202302,122,103,19,135408.48,24738,160146.48
314070,202302,1139,576,563,749979.19,733036.29,1483015.48
314080,202302,225,136,89,177075.25,115878.64,292953.89
314085,202302,191,134,57,174468.34,74214,248682.34
314090,202302,422,300,122,390609.01,158844,549453.01
314100,202302,548,430,118,559875.3,153639,713514.3
314110,202302,806,353,453,459620.96,589811.15,1049432.11
314120,202302,72,43,29,55986,37758.5,93744.5
314130,202302,26,19,7,24738,9114,33852
314140,202302,1246,792,454,1031204.63,591111.48,1622316.11
314150,202302,197,127,70,165357.93,91140.66,256498.59
314160,202302,318,239,79,311180.6,104160.56,415341.16
314170,202302,86,63,23,82027.39,29946,111973.39
314180,202302,799,709,90,924452.78,117181.77,1041634.55
314190,202302,87,54,33,70308.6,42966,113274.6
314200,202302,542,373,169,485661.67,220045.76,705707.43
314210,202302,254,195,59,253893.46,76818.6,330712.06
314220,202302,322,229,93,298164.54,121087.33,419251.87
314225,202302,51,33,18,42968.19,23436,66404.19
314230,202302,128,59,69,76818.55,89838,166656.55
314240,202302,182,131,51,170563.21,66402.47,236965.68
314250,202302,61,37,24,48176.43,31248.28,79424.71
314260,202302,219,107,112,139315.13,145824,285139.13
314270,202302,439,344,95,447900.84,123690.7,571591.54
314280,202302,761,412,349,536374,454400.57,990774.57
314290,202302,565,440,125,572888.03,162750.72,735638.75
314300,202302,350,259,91,337227.73,118482,455709.73
314310,202302,1376,954,422,1243770.87,549444,1793214.87
314315,202302,47,35,12,45570.52,15624,61194.52
314320,202302,602,417,185,542946.52,240872.48,783819.00
314330,202302,12466,6031,6435,7856562.76,8381029.48,16237592.24
314340,202302,686,309,377,403630.71,490858.29,894489.00
314345,202302,62,46,16,59892,20832,80724
314350,202302,188,116,72,151032.88,93744.66,244777.54
314360,202302,54,29,25,37760.66,32550.64,70311.30
314370,202302,71,50,21,65100,27342,92442
314380,202302,138,75,63,97650.2,82026,179676.2
314390,202302,3701,2398,1303,3123596.19,1696510.55,4820106.74
314400,202302,720,499,221,649710.98,287745.51,937456.49
314410,202302,563,374,189,486959.94,246080.55,733040.49
314420,202302,25,15,10,19530,13020,32550
314430,202302,2568,978,1590,1273392.77,2071516.17,3344908.94
314435,202302,148,88,60,114577.81,78120,192697.81
314437,202302,57,43,14,55986,18228,74214
314440,202302,95,62,33,80724.12,42966.1,123690.22
314450,202302,172,119,53,154938.72,70309.56,225248.28
314460,202302,658,327,331,425763.15,432267.51,858030.66
314465,202302,132,87,45,113276.02,58590,171866.02
314467,202302,74,60,14,78120,18228,96348
314470,202302,429,214,215,278631.13,279933.15,558564.28
314480,202302,1137,513,624,669242.27,812454.97,1481697.24
314490,202302,36,20,16,26040,20832,46872
314500,202302,284,195,89,253894.01,115878.45,369772.46
314505,202302,123,78,45,101559.1,58590,160149.1
314510,202302,264,212,52,276027.87,67704,343731.87
314520,202302,1520,786,734,1023408.82,956984.25,1980393.07
314530,202302,801,635,166,826805.17,216135.76,1042940.93
314535,202302,179,111,68,145824.49,89838,235662.49
314537,202302,70,41,29,53382.38,37758.98,91141.36
314540,202302,20,12,8,15624,10416,26040
314545,202302,66,43,23,55986,29946,85932
314550,202302,80,44,36,57289.47,46873.78,104163.25
314560,202302,907,486,421,632787.37,549448.32,1182235.69
314570,202302,16,14,2,18229.09,2604,20833.09
314580,202302,11,6,5,7812,6510,14322
314585,202302,33,24,9,31248,11718.66,42966.66
314587,202302,84,73,11,95046,14322,109368
314590,202302,627,426,201,555969.31,261704.33,817673.64
314600,202302,1018,665,353,865866.38,460918.07,1326784.45
314610,202302,1023,520,503,678349.52,656211.32,1334560.84
314620,202302,156,116,40,151033.05,52080,203113.05
314625,202302,100,77,23,100254.98,29946,130200.98
314630,202302,1173,655,518,852834.77,675745.74,1528580.51
314640,202302,94,58,36,75517.54,46872.6,122390.14
314650,202302,163,95,68,123691.99,88537.53,212229.52
314655,202302,64,47,17,61194,22134,83328
314660,202302,19,14,5,18228,6510,24738
314670,202302,231,181,50,235672.15,65102.92,300775.07
314675,202302,219,132,87,171865.83,113274.23,285140.06
314690,202302,589,314,275,408834.45,359355.32,768189.77
314700,202302,2266,1210,1056,1576782.16,1377522.29,2954304.45
314710,202302,1946,1083,863,1411392.33,1124928.89,2536321.22
314720,202302,422,233,189,303370.83,246079.22,549450.05
314730,202302,534,290,244,378886.05,317689.85,696575.90
314740,202302,845,377,468,490863.53,609339.03,1100202.56
314750,202302,27,20,7,26040,9114,35154
314760,202302,376,150,226,195301.84,294252.88,489554.72
314770,202302,105,68,37,88536.69,48174,136710.69
314780,202302,18,7,11,9114,14322,23436
314790,202302,2688,1721,967,2240813.62,1260336.57,3501150.19
314795,202302,76,65,11,84630,14322,98952
314800,202302,3100,1818,1282,2369697.11,1671772.05,4041469.16
314810,202302,1563,890,673,1158804.06,880153.59,2038957.65
314820,202302,121,72,49,93745.79,63798.1,157543.89
314830,202302,229,191,38,249990.27,49476,299466.27
314840,202302,88,52,36,67704,46872,114576
314850,202302,465,220,245,286573.72,318990,605563.72
314860,202302,658,499,159,649705.74,208320.08,858025.82
314870,202302,1724,929,795,1209587.92,1035104.69,2244692.61
314875,202302,69,62,7,80724,9114,89838
314880,202302,42,30,12,39060,15624,54684
314890,202302,59,32,27,41664,35154,76818
314900,202302,28,21,7,27342.22,9114.92,36457.14
314910,202302,244,161,83,209625.02,108066,317691.02
314915,202302,145,125,20,162752.77,26040.68,188793.45
314920,202302,83,54,29,70308.85,37758,108066.85
314930,202302,1081,494,587,643208.38,764275.2,1407483.58
314940,202302,36,28,8,36456,10416,46872
314950,202302,23,19,4,24738.77,5208,29946.77
314960,202302,28,20,8,26040,10416.18,36456.18
314970,202302,182,83,99,108067.58,128899.13,236966.71
314980,202302,325,208,117,270820.51,152335.45,423155.96
314990,202302,477,255,222,332017.26,289045.61,621062.87
314995,202302,156,68,88,88537.1,114576,203113.1
315000,202302,101,78,23,101556.49,29946.1,131502.59
315010,202302,32,20,12,26040,15624,41664
315015,202302,164,129,35,167958.9,45570,213528.9
315020,202302,69,59,10,76818,13020,89838
315030,202302,113,86,27,111972,35154,147126
315040,202302,90,54,36,70308.22,48174,118482.22
315050,202302,214,132,82,171865.31,108066.68,279931.99
315053,202302,68,48,20,62496.8,26040,88536.8
315057,202302,129,100,29,130200.05,39060,169260.05
315060,202302,65,53,12,69007.56,15624,84631.56
315070,202302,117,70,47,91142.41,61194,152336.41
315080,202302,402,319,83,416645.49,108067.61,524713.10
315090,202302,104,60,44,78120.89,57288,135408.89
315100,202302,96,46,50,59893.09,65100.38,124993.47
315110,202302,292,146,146,190095.13,190092.6,380187.73
315120,202302,1959,931,1028,1213513.51,1338490.04,2552003.55
315130,202302,371,263,108,342429.27,140616.88,483046.15
315140,202302,576,310,266,403626.6,346338.88,749965.48
315150,202302,1020,493,527,644512.05,687463.66,1331975.71
315160,202302,198,108,90,140624.39,117183.73,257808.12
315170,202302,305,199,106,259101.01,138012.3,397113.31
315180,202302,3418,1447,1971,1885348.19,2574070.18,4459418.37
315190,202302,300,186,114,242175.97,148428.75,390604.72
315200,202302,1270,761,509,990849.55,662721.77,1653571.32
315210,202302,1887,1129,758,1469989.43,988221.18,2458210.61
315213,202302,27,16,11,20833.3,14322,35155.3
315217,202302,221,174,47,226549.68,61194.71,287744.39
315220,202302,1678,1236,442,1609312.61,575494.12,2184806.73
315230,202302,185,142,43,184886.47,55986,240872.47
315240,202302,372,244,128,317697.08,166659.39,484356.47
315250,202302,2861,1363,1498,1775986.93,1953005.73,3728992.66
315260,202302,139,80,59,104160,76818.1,180978.1
315270,202302,155,110,45,143220.8,58590,201810.8
315280,202302,634,415,219,541658.49,285149.12,826807.61
315290,202302,204,126,78,164053.19,101556.52,265609.71
315300,202302,102,76,26,98952.61,33852,132804.61
315310,202302,88,80,8,104160,10416,114576
315320,202302,142,91,51,118486.46,66402,184888.46
315330,202302,64,50,14,65100,18228,83328
315340,202302,391,283,108,368471.31,140617.26,509088.57
315350,202302,167,106,61,138012.88,79422.34,217435.22
315360,202302,107,51,56,66402.15,72912,139314.15
315370,202302,57,37,20,48175.63,26040,74215.63
315380,202302,6,5,1,6510,1302,7812
315390,202302,74,30,44,39060.49,57289.76,96350.25
315400,202302,859,649,210,846318.04,273420.42,1119738.46
315410,202302,325,195,130,253902.67,169265.08,423167.75
315415,202302,57,44,13,57288.27,16926,74214.27
315420,202302,214,153,61,199207.04,79422,278629.04
315430,202302,653,364,289,475234,376279.17,851513.17
315440,202302,98,66,32,85932,41664,127596
315445,202302,238,196,42,255201.17,54684.37,309885.54
315450,202302,180,130,50,169260,65100,234360
315460,202302,5141,2373,2768,3093687.87,3606586.48,6700274.35
315470,202302,48,20,28,26040.9,36456,62496.9
315480,202302,78,24,54,31250.12,70310.23,101560.35
315490,202302,770,498,272,648404.38,354144.48,1002548.86
315500,202302,19,15,4,19530,5208,24738
315510,202302,157,113,44,147126.79,57288,204414.79
315520,202302,79,67,12,87234.67,15624,102858.67
315530,202302,46,26,20,33852,26040.2,59892.2
315540,202302,280,192,88,249988.15,114576.9,364565.05
315550,202302,195,157,38,204415.01,49476,253891.01
315560,202302,740,580,160,756478.51,208323.43,964801.94
315570,202302,316,156,160,203118.7,208321.62,411440.32
315580,202302,794,537,257,699183.06,334615.4,1033798.46
315590,202302,193,99,94,128900.52,122388.63,251289.15
315600,202302,362,279,83,363262.36,108066.78,471329.14
315610,202302,104,48,56,62496,72912,135408
315620,202302,36,27,9,35155.81,11718,46873.81
315630,202302,132,98,34,127596,44268,171864
315640,202302,63,39,24,50778.98,31248,82026.98
315645,202302,52,35,17,45570,22134,67704
315650,202302,171,127,44,165354.94,57288,222642.94
315660,202302,447,205,242,266919.55,315090.44,582009.99
315670,202302,2547,1148,1399,1494754.69,1824125.01,3318879.70
315680,202302,785,563,222,734337.18,290346.5,1024683.68
315690,202302,712,474,238,617165.92,309880.41,927046.33
315700,202302,2128,1110,1018,1446568.09,1328068.91,2774637.00
315710,202302,382,128,254,166657.88,330708.23,497366.11
315720,202302,541,324,217,421858.28,282534.54,704392.82
315725,202302,212,164,48,213528.87,62496.6,276025.47
315727,202302,83,50,33,65103.23,42966.13,108069.36
315730,202302,57,50,7,65100,9114,74214
315733,202302,88,51,37,67704.2,48174,115878.2
315737,202302,51,39,12,50779.58,15624,66403.58
315740,202302,31,24,7,31248,9114,40362
315750,202302,175,124,51,161448.17,66402.56,227850.73
315760,202302,47,34,13,44268,16926,61194
315765,202302,141,80,61,104163.84,79423.83,183587.67
315770,202302,243,164,79,214832.23,102858.64,317690.87
315780,202302,4236,2100,2136,2736893.47,2782383.21,5519276.68
315790,202302,253,194,59,252592.85,76818.97,329411.82
315800,202302,327,214,113,278631.04,147126,425757.04
315810,202302,63,38,25,49476.36,32550,82026.36
315820,202302,789,588,201,765604.87,261706.54,1027311.41
315830,202302,124,80,44,104160.36,57289.33,161449.69
315840,202302,84,57,27,74214,35154,109368
315850,202302,282,190,92,247385.12,119785.71,367170.83
315860,202302,21,9,12,11718,15624,27342
315870,202302,41,32,9,41664.77,11718,53382.77
315880,202302,102,67,35,87234,45570,132804
315890,202302,107,75,32,97652.21,41664.54,139316.75
315895,202302,416,275,141,358066.12,183583.79,541649.91
315900,202302,86,38,48,49476,63798.08,113274.08
315910,202302,53,33,20,42966,26040,69006
315920,202302,162,109,53,141920.38,69006,210926.38
315930,202302,54,18,36,23439.89,46873.11,70313.00
315935,202302,131,103,28,134109.28,36456,170565.28
315940,202302,103,74,29,96348.44,37758,134106.44
315950,202302,39,31,8,40362,10416.65,50778.65
315960,202302,609,285,324,371076.97,421854.96,792931.93
315970,202302,32,27,5,35154.7,6510,41664.7
315980,202302,698,358,340,466129.66,443984.01,910113.67
315990,202302,270,154,116,200510.39,151032.52,351542.91
316000,202302,53,33,20,42966.8,26040,69006.8
316010,202302,97,82,15,106765.76,19530,126295.76
316020,202302,99,89,10,115878.49,13020,128898.49
316030,202302,388,227,161,295560.85,209624.55,505185.40
316040,202302,579,242,337,315088.61,438774.61,753863.22
316045,202302,53,47,6,61194,7812,69006
316050,202302,25,18,7,23436,9114,32550
316060,202302,109,77,32,100255.17,41664,141919.17
316070,202302,1275,858,417,1117149.08,545544.33,1662693.41
316080,202302,93,63,30,83443.17,39060,122503.17
316090,202302,38,17,21,22134,27342.42,49476.42
316095,202302,88,76,12,98953.47,15624.89,114578.36
316100,202302,361,197,164,256498.92,213528.85,470027.77
316105,202302,55,32,23,41665.18,29946,71611.18
316110,202302,1939,1497,442,1949139.4,575493.34,2524632.74
316120,202302,80,54,26,70308,33852,104160
316130,202302,122,91,31,118485.2,40362,158847.2
316140,202302,35,23,12,29946,15624,45570
316150,202302,235,164,71,213530.1,92442.33,305972.43
316160,202302,86,54,32,70308.82,41664.28,111973.10
316165,202302,78,53,25,69007.77,32550,101557.77
316170,202302,190,123,67,160146.56,87234,247380.56
316180,202302,221,85,136,110673.85,177074.14,287747.99
316190,202302,149,107,42,139316.26,54684,194000.26
316200,202302,704,391,313,509095.92,410132.17,919228.09
316210,202302,781,536,245,698118.96,318992.09,1017111.05
316220,202302,128,82,46,108067.98,61194,169261.98
316225,202302,41,26,15,33853.78,19530,53383.78
316230,202302,49,28,21,36456.99,27342,63798.99
316240,202302,692,542,150,707000.45,196605.86,903606.31
316245,202302,173,152,21,197907.11,27342.99,225250.10
316250,202302,1761,1174,587,1528590.48,766881.87,2295472.35
316255,202302,135,106,29,138012,37758.1,175770.1
316257,202302,183,93,90,121086.87,118483.19,239570.06
316260,202302,203,139,64,180980.83,83328.2,264309.03
316265,202302,39,27,12,35156.03,15624.21,50780.24
316270,202302,712,503,209,654918.68,272119.81,927038.49
316280,202302,590,370,220,481751.59,286442.22,768193.81
316290,202302,897,618,279,805957.01,363262.56,1169219.57
316292,202302,664,275,389,359362.6,506481.16,865843.76
316294,202302,109,67,42,87236.97,54684.5,141921.47
316295,202302,411,193,218,251292.44,283842.52,535134.96
316300,202302,25,18,7,23436,9114,32550
316310,202302,28,16,12,20832,15624,36456
316320,202302,73,34,39,44268.85,50778,95046.85
316330,202302,181,126,55,164053.38,71610.61,235663.99
316340,202302,144,93,51,121086,66402,187488
316350,202302,199,135,64,175771.29,83328.2,259099.49
316360,202302,26,16,10,20832,13020,33852
316370,202302,1349,665,684,867154.68,891876.76,1759031.44
316380,202302,118,89,29,115878.56,37758,153636.56
316390,202302,105,79,26,102858,33852,136710
316400,202302,169,130,39,169263.56,50778.36,220041.92
316410,202302,311,227,84,295554.34,109368.2,404922.54
316420,202302,229,151,78,196608.19,101557.78,298165.97
316430,202302,166,92,74,119784.46,96348,216132.46
316440,202302,75,41,34,53382.58,44268.08,97650.66
316443,202302,49,41,8,53382.11,10416,63798.11
316447,202302,46,38,8,49478,10416,59894
316450,202302,252,186,66,242172.65,85932,328104.65
316460,202302,47,14,33,18228.2,42966.54,61194.74
316470,202302,1854,1356,498,1766866.97,649699.03,2416566.00
316480,202302,9,7,2,9114,2604,11718
316490,202302,20,6,14,7812,18228,26040
316500,202302,168,108,60,140616.77,78120.85,218737.62
316510,202302,141,113,28,147126.23,36456,183582.23
316520,202302,188,103,85,134107.14,110672.18,244779.32
316530,202302,181,113,68,147127.79,88536.83,235664.62
316540,202302,161,84,77,109370.04,100254.65,209624.69
316550,202302,171,106,65,139317.4,84630,223947.4
316553,202302,476,237,239,308580.33,311178.68,619759.01
316555,202302,69,59,10,76819.76,13020.8,89840.56
316556,202302,18,12,6,15624.41,7812,23436.41
316557,202302,39,29,10,37758.27,13020.2,50778.47
316560,202302,75,53,22,69006.2,28644,97650.2
316570,202302,223,204,19,265610.72,24738,290348.72
316580,202302,25,17,8,22134,10416,32550
316590,202302,91,76,15,98953.32,19530.18,118483.50
316600,202302,184,154,30,200510.03,39060,239570.03
316610,202302,72,51,21,66402.63,27342,93744.63
316620,202302,148,102,46,132804,59892.05,192696.05
316630,202302,61,46,15,59892,19530,79422
316640,202302,23,14,9,18228,11718,29946
316650,202302,110,88,22,114576,28644,143220
316660,202302,6,2,4,2604,5208,7812
316670,202302,433,147,286,191396.1,373676.2,565072.3
316680,202302,172,133,39,173168.85,50778.4,223947.25
316690,202302,155,93,62,121086,80724,201810
316695,202302,57,49,8,63798.15,10416,74214.15
316700,202302,30,21,9,27342,11718,39060
316710,202302,843,641,202,834596.7,264309.6,1098906.3
316720,202302,5461,2534,2927,3300677.8,3813567.36,7114245.16
316730,202302,14,13,1,16926,1302,18228
316740,202302,164,102,62,132804.1,80724,213528.1
316750,202302,21,12,9,15624.76,11718.28,27343.04
316760,202302,345,274,71,356754.91,92442.87,449197.78
316770,202302,182,95,87,123692.09,113274,236966.09
316780,202302,69,40,29,52080.6,39060,91140.6
316790,202302,70,48,22,62496.01,28644.5,91140.51
316800,202302,1868,1134,734,1476501.78,955688.23,2432190.01
316805,202302,33,22,11,28644.08,14322,42966.08
316810,202302,59,35,24,45570.7,31248.7,76819.4
316820,202302,39,22,17,28644,22134,50778
316830,202302,104,49,55,63798.9,71610.2,135409.1
316840,202302,522,316,206,411437.23,268212.76,679649.99
316850,202302,315,220,95,286442.76,123690,410132.76
316860,202302,6679,3007,3672,3916859.32,4784870.41,8701729.73
316870,202302,1821,1172,649,1526018.01,846307.57,2372325.58
316880,202302,165,84,81,109372.37,105463.44,214835.81
316890,202302,233,156,77,203113.48,100254.69,303368.17
316900,202302,439,306,133,398419.47,173166,571585.47
316905,202302,27,11,16,14322,20832,35154
316910,202302,83,34,49,44268,63798,108066
316920,202302,158,120,38,156243.25,49476,205719.25
316930,202302,2102,1077,1025,1402282.56,1335855.52,2738138.08
316935,202302,1009,598,411,778613.28,536433.27,1315046.55
316940,202302,1155,677,478,881477.03,622358.46,1503835.49
316950,202302,202,96,106,124995.72,138012,263007.72
316960,202302,1137,632,505,822893.07,657521.58,1480414.65
316970,202302,684,544,140,708306.12,182283.23,890589.35
316980,202302,89,48,41,62496,53382,115878
316990,202302,2389,1623,766,2117106.86,999941.58,3117048.44
317000,202302,356,274,82,356760.23,106766.4,463526.63
317005,202302,224,152,72,197910.04,93745.6,291655.64
317010,202302,7232,4134,3098,5387938.76,4040165.09,9428103.85
317020,202302,16477,7203,9274,9385200.81,12091771.74,21476972.55
317030,202302,93,43,50,55986,65100,121086
317040,202302,3253,2128,1125,2773337.7,1466062.02,4239399.72
317043,202302,79,62,17,80731.8,22135.27,102867.07
317047,202302,41,25,16,32550,20832.81,53382.81
317050,202302,162,130,32,169261.23,41664,210925.23
317052,202302,161,132,29,171865.14,37758,209623.14
317057,202302,190,141,49,183584.86,63798,247382.86
317060,202302,65,39,26,50778.45,33852.3,84630.75
317065,202302,52,39,13,50778,16926,67704
317070,202302,2062,955,1107,1244758.89,1442618.15,2687377.04
317075,202302,98,54,44,70308.75,57288,127596.75
317080,202302,1011,513,498,667957.17,649700.73,1317657.90
317090,202302,740,574,166,747364.41,216137.26,963501.67
317100,202302,461,344,117,447894.67,152334.95,600229.62
317103,202302,135,108,27,140617.22,35154,175771.22
317107,202302,52,41,11,53382,14322,67704
317110,202302,80,41,39,53382.2,50779.68,104161.88
317115,202302,44,40,4,52141.19,5208,57349.19
317120,202302,2271,1134,1137,1477834.69,1481692.47,2959527.16
317130,202302,2230,1504,726,1958228.13,945256.59,2903484.72
317140,202302,13,10,3,13020.5,3906,16926.5
317150,202302,298,181,117,235666.53,152334.49,388001.02
317160,202302,366,270,96,351545.34,124993.58,476538.92
317170,202302,247,160,87,209622.88,113274.6,322897.48
317180,202302,431,293,138,381490.38,179678.46,561168.84
317190,202302,267,190,77,247381.4,100254,347635.4
317200,202302,898,632,266,822895.72,346340.97,1169236.69
317210,202302,186,97,89,126298.94,115878.21,242177.15
317220,202302,23,11,12,14322,15624,29946
320010,202302,583,415,168,540344.19,218742.63,759086.82
320013,202302,147,97,50,126296.67,65102.21,191398.88
320016,202302,258,157,101,204420.44,131502,335922.44
320020,202302,781,458,323,596340.68,420555.43,1016896.11
320030,202302,175,122,53,158845.9,69008.11,227854.01
320035,202302,139,97,42,126294.2,55986.59,182280.79
320040,202302,521,253,268,329418.7,348946.61,678365.31
320050,202302,127,89,38,115885.35,49477,165362.35
320060,202302,2008,936,1072,1221322.3,1395764.81,2617087.11
320070,202302,101,65,36,84630.87,46872,131502.87
320080,202302,859,481,378,626285.03,492161.58,1118446.61
320090,202302,1389,894,495,1165326.73,644506.05,1809832.78
320100,202302,368,211,157,274732.71,207020.63,481753.34
320110,202302,138,84,54,109379.47,70308.6,179688.07
320115,202302,122,102,20,132805.08,26040,158845.08
320120,202302,4004,2084,1920,2716079.57,2501196.37,5217275.94
320130,202302,8716,3734,4982,4868368.98,6486697.54,11355066.52
320140,202302,538,345,193,449208.69,252596.61,701805.30
320150,202302,2328,1278,1050,1665325.04,1368420.52,3033745.56
320160,202302,677,286,391,372380.53,510387.45,882767.98
320170,202302,117,93,24,121087.22,31248.02,152335.24
320180,202302,62,34,28,44269.14,36456.12,80725.26
320190,202302,262,153,109,199210.83,141918.1,341128.93
320200,202302,64,53,11,69008.22,14322,83330.22
320210,202302,964,522,442,679666.25,576794.92,1256461.17
320220,202302,313,109,204,141919,265608.2,407527.2
320225,202302,85,70,15,91140.39,19530.9,110671.29
320230,202302,760,484,276,631507.27,359360.23,990867.50
320240,202302,3828,1724,2104,2247327.42,2742058.57,4989385.99
320245,202302,553,379,174,493469.34,226554.96,720024.30
320250,202302,255,117,138,152338.54,180980.74,333319.28
320255,202302,123,90,33,117181.91,42966.98,160148.89
320260,202302,307,163,144,212227.11,187489.67,399716.78
320265,202302,154,120,34,156240.94,44268.64,200509.58
320270,202302,162,123,39,160149.45,50779.15,210928.60
320280,202302,1442,797,645,1037731.99,841109.31,1878841.30
320290,202302,71,55,16,71610.4,20832,92442.4
320300,202302,654,446,208,580711.11,272121.74,852832.85
320305,202302,800,434,366,566397.54,477849.06,1044246.60
320310,202302,216,128,88,166659.82,114576.2,281236.02
320313,202302,372,166,206,216140.83,268213.14,484353.97
320316,202302,117,84,33,109370.04,42966.15,152336.19
320320,202302,3702,1632,2070,2124936.95,2695182.98,4820119.93
320330,202302,299,215,84,279930.75,109368.48,389299.23
320332,202302,814,483,331,630213.6,430980.89,1061194.49
320334,202302,303,165,138,216134.3,179677.3,395811.6
320335,202302,153,99,54,128903.17,70311.45,199214.62
320340,202302,624,442,182,575509,236970.9,812479.9
320350,202302,1184,481,703,626676.06,916622.58,1543298.64
320360,202302,182,86,96,113275,124992,238267
320370,202302,244,179,65,233064.91,84632.11,317697.02
320380,202302,342,244,98,317697.92,127596.89,445294.81
320390,202302,1210,702,508,914035.32,661424.24,1575459.56
320400,202302,342,239,103,311191.88,134106.26,445298.14
320405,202302,1041,420,621,546866.47,808561.83,1355428.30
320410,202302,1000,491,509,639302.31,662725.09,1302027.40
320420,202302,612,274,338,356763.78,442693.28,799457.06
320425,202302,224,115,109,149732.73,141918.8,291651.53
320430,202302,417,215,202,281245.49,263010.71,544256.20
320435,202302,189,128,61,166658.55,79424.08,246082.63
320440,202302,218,119,99,154942.76,128903,283845.76
320450,202302,142,73,69,96349.9,89839.08,186188.98
320455,202302,237,184,53,239572.37,69006.66,308579.03
320460,202302,339,203,136,264311.76,177072.21,441383.97
320465,202302,123,84,39,109374.22,50778.65,160152.87
320470,202302,789,467,322,608059.63,419256.44,1027316.07
320480,202302,239,158,81,205725.08,105462.22,311187.30
320490,202302,3537,1668,1869,2171823.82,2433503.54,4605327.36
320495,202302,136,79,57,102858.4,74214.6,177073.0
320500,202302,11060,5347,5713,6967321.93,7443668.59,14410990.52
320501,202302,587,299,288,390616.1,374987.06,765603.16
320503,202302,342,241,101,313788.81,131503.25,445292.06
320506,202302,290,196,94,255193.94,122388.38,377582.32
320510,202302,1345,578,767,752578.64,1001262.86,1753841.50
320515,202302,88,68,20,88537.95,26040,114577.95
320517,202302,241,174,67,226554.03,88536,315090.03
320520,202302,8642,3588,5054,4676953.87,6584344.74,11261298.61
320530,202302,7698,3644,4054,4745933.24,5280991.48,10026924.72
330010,202302,3838,1879,1959,2447864.12,2551957.97,4999822.09
330015,202302,226,100,126,130203.08,164052.56,294255.64
330020,202302,4372,1656,2716,2157487.62,3537578.72,5695066.34
330022,202302,280,142,138,184889.27,179677.37,364566.64
330023,202302,929,265,664,345035.26,865840.68,1210875.94
330025,202302,1133,170,963,221343.88,1256440.89,1477784.77
330030,202302,2027,1242,785,1617160.4,1022088.46,2639248.86
330040,202302,2901,1475,1426,1920517.24,1859287.4,3779804.64
330045,202302,11358,3589,7769,4673050.65,10123226.19,14796276.84
330050,202302,942,575,367,748670.62,477839.32,1226509.94
330060,202302,1316,769,547,1001289.37,712206.47,1713495.84
330070,202302,4785,1615,3170,2109320.49,4132611.83,6241932.32
330080,202302,1771,770,1001,1002576.7,1303325.19,2305901.89
330090,202302,415,227,188,295564.74,246079.97,541644.71
330093,202302,235,99,136,128900.41,177073.48,305973.89
330095,202302,75,39,36,50778.71,46872,97650.71
330100,202302,12105,5973,6132,7782392.69,7991818.03,15774210.72
330110,202302,507,229,278,298161.74,361962.1,660123.84
330115,202302,552,269,283,350247.86,368468.22,718716.08
330120,202302,431,222,209,289049.08,272120.84,561169.92
330130,202302,1748,464,1284,604157.16,1671804.02,2275961.18
330140,202302,736,373,363,485654.23,472627.57,958281.80
330150,202302,571,343,228,446596.28,298160.4,744756.68
330160,202302,218,127,91,165357.66,118484.15,283841.81
330170,202302,29654,10477,19177,13652060.03,24996288.33,38648348.36
330180,202302,278,153,125,199209.07,162753.19,361962.26
330185,202302,1319,508,811,661438.67,1057243.55,1718682.22
330187,202302,631,195,436,253900.26,568982.99,822883.25
330190,202302,6941,2610,4331,3402252.4,5644240.67,9046493.07
330200,202302,5068,1695,3373,2209578.59,4398245.86,6607824.45
330205,202302,522,292,230,380194.98,302067.55,682262.53
330210,202302,980,584,396,761696.3,515597.98,1277294.28
330220,202302,3037,1775,1262,2312451.97,1645759.77,3958211.74
330225,202302,682,341,341,443990.85,445286.09,889276.94
330227,202302,2708,866,1842,1127571.01,2399622.32,3527193.33
330230,202302,262,138,124,179679.55,161450.08,341129.63
330240,202302,4851,2225,2626,2903583.66,3424328.24,6327911.90
330245,202302,180,85,95,110672.14,123690,234362.14
330250,202302,7383,3513,3870,4575428.94,5044039.83,9619468.77
330260,202302,851,236,615,307277.35,800736.12,1108013.47
330270,202302,4401,1433,2968,1865838.44,3868313.28,5734151.72
330280,202302,503,300,203,390619.62,264312.58,654932.20
330285,202302,6995,2244,4751,2924450.57,6193758.17,9118208.74
330290,202302,835,286,549,372387.59,714802.56,1087190.15
330300,202302,798,485,313,632294.73,407534.97,1039829.70
330310,202302,510,295,215,384100.65,279931.59,664032.24
330320,202302,8504,2899,5605,3777300.03,7310865.25,11088165.28
330330,202302,10450,3811,6639,4965995.75,8650625.94,13616621.69
330340,202302,3013,1653,1360,2154865.59,1770740.89,3925606.48
330350,202302,22039,8067,13972,10512832.77,18216676.99,28729509.76
330360,202302,2111,981,1130,1277320.32,1472600.47,2749920.79
330370,202302,1073,567,506,738260.79,658827.61,1397088.40
330380,202302,1114,453,661,589819.69,860630.44,1450450.13
330385,202302,722,352,370,459614.6,481744.63,941359.23
330390,202302,6858,3529,3329,4596229.07,4337025.47,8933254.54
330395,202302,430,280,150,364572.92,195306.03,559878.95
330400,202302,779,398,381,518219.01,497367.49,1015586.50
330410,202302,560,400,160,520819.51,208324.3,729143.81
330411,202302,407,221,186,287745.79,242172.2,529917.99
330412,202302,239,111,128,144525.73,166656.1,311181.83
330414,202302,5975,2344,3631,3054631.95,4732830.28,7787462.23
330415,202302,679,287,392,374990.92,510390.36,885381.28
330420,202302,2699,1410,1289,1838481.7,1684804.5,3523286.2
330430,202302,1955,826,1129,1075483.77,1469977.16,2545460.93
330440,202302,418,202,216,263009.57,281234.08,544243.65
330450,202302,131,57,74,74215.24,96349.42,170564.66
330452,202302,2684,1092,1592,1423145.19,2072813.87,3495959.06
330455,202302,138748,48460,90288,63151138.88,117708428.27,180859567.15
330460,202302,285,131,154,170564,201810.4,372374.4
330470,202302,1351,715,636,930953.87,829385.48,1760339.35
330475,202302,2026,611,1415,795535.75,1843648.17,2639183.92
330480,202302,840,465,375,606749.37,488259.54,1095008.91
330490,202302,18286,5609,12677,7307193.71,16516119.3,23823313.01
330500,202302,1710,729,981,949181.38,1277276.79,2226458.17
330510,202302,12225,4289,7936,5589716.09,10340651.64,15930367.73
330513,202302,105,54,51,70308,66402,136710
330515,202302,741,319,422,416648.44,550755.41,967403.85
330520,202302,2746,934,1812,1216115.62,2360568.67,3576684.29
330530,202302,186,106,80,138015.65,104160.96,242176.61
330540,202302,377,199,178,259101.69,233063.84,492165.53
330550,202302,3098,1020,2078,1329372.2,2706892.07,4036264.27
330555,202302,1186,428,758,558568.93,986925.3,1545494.23
330560,202302,853,302,551,393214.49,717410.65,1110625.14
330570,202302,350,242,108,315088.67,140616.43,455705.10
330575,202302,965,363,602,472641.53,783821.14,1256462.67
330580,202302,3763,1968,1795,2562412.05,2339731.01,4902143.06
330590,202302,274,145,129,188793.65,170563.54,359357.19
330600,202302,1553,913,640,1188765.28,834599.37,2023364.65
330610,202302,1764,889,875,1157505.32,1140559.48,2298064.80
330615,202302,235,188,47,244781.17,61197.73,305978.90
330620,202302,1054,445,609,579418.35,792934.9,1372353.25
330630,202302,5088,3009,2079,3919168.31,2709504.73,6628673.04
350010,202302,629,415,214,540352.86,278630.82,818983.68
350020,202302,56,18,38,23437.77,49476,72913.77
350030,202302,609,355,254,462237.5,332018.8,794256.3
350040,202302,116,51,65,66406.07,84631.19,151037.26
350050,202302,383,182,201,236972.05,261706.53,498678.58
350055,202302,134,58,76,76819.97,100254.2,177074.17
350060,202302,84,34,50,44269.79,65100.2,109369.99
350070,202302,830,459,371,597657.56,483054.3,1080711.86
350075,202302,84,52,32,67706.45,41664,109370.45
350080,202302,61,28,33,36456.45,42966.27,79422.72
350090,202302,83,45,38,59895,49476,109371
350100,202302,313,194,119,252593.27,156240,408833.27
350110,202302,48,30,18,39060.99,23436,62496.99
350115,202302,187,90,97,117183.16,126294.46,243477.62
350120,202302,112,72,40,93747.53,52080.47,145828.00
350130,202302,439,187,252,243492.3,328111.95,571604.25
350140,202302,38,23,15,29946.64,19530,49476.64
350150,202302,77,53,24,69008.09,31248.25,100256.34
350160,202302,2553,1006,1547,1309846.37,2015509.54,3325355.91
350170,202302,432,251,181,326816.13,235666.74,562482.87
350180,202302,171,93,78,121092.35,101557.01,222649.36
350190,202302,1044,559,485,729156.37,635378.48,1364534.85
350200,202302,61,27,34,35156.3,44268,79424.3
350210,202302,1388,737,651,959619.88,847628.27,1807248.15
350220,202302,648,516,132,673150.5,171866.47,845016.97
350230,202302,71,43,28,55986.84,36456.9,92443.74
350240,202302,60,37,23,48174.65,29946.44,78121.09
350250,202302,1160,519,641,677064.81,834596.47,1511661.28
350260,202302,111,82,29,106767.05,37758.87,144525.92
350270,202302,1021,674,347,877556.19,451797.37,1329353.56
350275,202302,351,131,220,171866.03,286444.3,458310.33
350280,202302,4649,2200,2449,2868433.02,3191220.33,6059653.35
350290,202302,505,214,291,278635.16,381489.26,660124.42
350300,202302,51,27,24,35158.41,31248.9,66407.31
350310,202302,80,45,35,58591.01,45570.59,104161.60
350315,202302,74,30,44,39060,57288,96348
350320,202302,3606,1659,1947,2160123.53,2538927.88,4699051.41
350330,202302,1750,857,893,1117153.03,1163992.11,2281145.14
350335,202302,21,13,8,16926,10416,27342
350340,202302,129,51,78,66403.85,101560.78,167964.63
350350,202302,97,46,51,59892.49,66402,126294.49
350360,202302,107,69,38,89841.02,49476.37,139317.39
350370,202302,88,49,39,63802.32,50778.48,114580.80
350380,202302,903,389,514,506492.58,669235.99,1175728.57
350390,202302,1915,710,1205,927048.26,1570229.43,2497277.69
350395,202302,19,14,5,18228,6510,24738
350400,202302,1860,878,982,1144494.73,1282472.01,2426966.74
350410,202302,3319,1322,1997,1723898.57,2600114.81,4324013.38
350420,202302,292,174,118,226553.04,153637.28,380190.32
350430,202302,103,51,52,66405.47,67707.3,134112.77
350440,202302,147,103,44,134116.28,57288.35,191404.63
350450,202302,1857,1011,846,1316381.62,1101493.83,2417875.45
350460,202302,437,149,288,194003.77,374987.92,568991.69
350470,202302,21,12,9,15624,11718,27342
350480,202302,204,105,99,136714.89,130200.94,266915.83
350490,202302,263,118,145,153637.67,188790.8,342428.47
350500,202302,59,21,38,27342,49476,76818
350510,202302,154,87,67,113277.09,87234.38,200511.47
350520,202302,468,251,217,326818.39,282542.37,609360.76
350530,202302,461,222,239,289061.51,311189.36,600250.87
350535,202302,96,64,32,83328.79,41664.96,124993.75
350540,202302,369,192,177,249989.69,230459.13,480448.82
350550,202302,2947,1636,1311,2132778.98,1708234.22,3841013.20
350560,202302,625,425,200,553370.73,260404.16,813774.89
350570,202302,5055,2062,2993,2686114.88,3899524.06,6585638.94
350580,202302,404,192,212,249993.17,276027.67,526020.84
350590,202302,1064,563,501,733048.62,652447.13,1385495.75
350600,202302,6851,3108,3743,4052023.03,4878641.52,8930664.55
350610,202302,1624,845,779,1100223.8,1014264.31,2114488.11
350620,202302,26,15,11,19530,14322,33852
350630,202302,272,133,139,173169.9,180980.2,354150.1
350635,202302,1370,577,793,751279.36,1033807.15,1785086.51
350640,202302,131,91,40,118483.88,52080.7,170564.58
350650,202302,2027,1328,699,1730435,911402.52,2641837.52
350660,202302,856,335,521,437480.47,679651.27,1117131.74
350670,202302,304,149,155,195302.79,201810.7,397113.49
350680,202302,164,84,80,109371.47,105463.55,214835.02
350690,202302,210,94,116,122389.69,152334,274723.69
350700,202302,1021,485,536,631493.39,697883.32,1329376.71
350710,202302,438,162,276,210931.4,359356.56,570287.96
350715,202302,56,46,10,59893.47,13020,72913.47
350720,202302,18,12,6,15624.9,7812,23436.9
350730,202302,44,26,18,33853.58,23436.61,57290.19
350740,202302,261,144,117,187492.63,152335.28,339827.91
350745,202302,33,14,19,18229.29,24738.23,42967.52
350750,202302,2680,1545,1135,2011679.56,1477786.19,3489465.75
350760,202302,4301,1796,2505,2339771.51,3262840.48,5602611.99
350770,202302,58,36,22,46872.75,28644,75516.75
350775,202302,59,43,16,55991.06,20833.36,76824.42
350780,202302,486,242,244,315099.98,317690.13,632790.11
350790,202302,374,156,218,204420.07,283839.9,488259.97
350800,202302,559,336,223,438780.41,290346.32,729126.73
350810,202302,533,405,128,527340.79,166656.2,693996.99
350820,202302,98,53,45,69007.3,58590,127597.3
350830,202302,82,41,41,53382.17,53382,106764.17
350840,202302,870,348,522,453111.73,681073.47,1134185.20
350850,202302,1998,1026,972,1335898.16,1269456.8,2605354.96
350860,202302,739,379,360,493479.01,468733.61,962212.62
350870,202302,478,320,158,416649.18,207018.35,623667.53
350880,202302,295,156,139,203117.82,182284.94,385402.76
350890,202302,40,24,16,31248,20832.83,52080.83
350900,202302,1764,573,1191,746074.02,1552017.41,2298091.43
350910,202302,26,13,13,16926,16926.42,33852.42
350920,202302,847,433,414,563775.51,539028.72,1102804.23
350925,202302,1246,617,629,803372.97,818976.68,1622349.65
350930,202302,127,72,55,93746.84,71610.28,165357.12
350940,202302,780,402,378,523432.23,492172.5,1015604.73
350945,202302,122,83,39,108068.92,50778.68,158847.60
350950,202302,19216,8830,10386,11502225.45,13535707.31,25037932.76
350960,202302,1852,735,1117,957191.32,1456957.55,2414148.87
350970,202302,1177,563,614,735520.69,799442.33,1534963.02
350980,202302,102,67,35,87236.74,45571.03,132807.77
350990,202302,431,157,274,205716.88,356750.96,562467.84
350995,202302,44,18,26,23436.87,33852.94,57289.81
351000,202302,641,403,238,524723.4,309887.08,834610.48
351010,202302,54,36,18,46874.74,23436,70310.74
351015,202302,47,28,19,36456.71,24738,61194.71
351020,202302,1570,929,641,1210896.13,834591.67,2045487.80
351030,202302,362,210,152,273423.67,197904.32,471327.99
351040,202302,1098,600,498,782531.57,648400.17,1430931.74
351050,202302,3971,1789,2182,2329384.24,2844895.12,5174279.36
351060,202302,6653,2398,4255,3123608.96,5542654.37,8666263.33
351070,202302,432,266,166,346343.66,216139.04,562482.70
351080,202302,807,590,217,768207.12,282537.57,1050744.69
351090,202302,47,24,23,31249.74,29946.41,61196.15
351100,202302,444,233,211,303389.99,274732.45,578122.44
351110,202302,2236,1012,1224,1318974.62,1593652.06,2912626.68
351120,202302,66,31,35,40363.46,45570,85933.46
351130,202302,195,63,132,82029.68,171867.97,253897.65
351140,202302,338,199,139,259107.55,180982.19,440089.74
351150,202302,537,272,265,354151.22,345032.76,699183.98
351160,202302,338,195,143,253896.81,187488.72,441385.53
351170,202302,248,143,105,186188.66,136710.55,322899.21
351190,202302,99,59,40,76819.21,52080.37,128899.58
351200,202302,363,233,130,303376.44,169261.99,472638.43
351210,202302,134,64,70,83330.55,91140.78,174471.33
351220,202302,625,350,275,455717.66,358051,813768.66
351230,202302,322,205,117,266914.89,152334.7,419249.59
351240,202302,251,125,126,162753.6,164054.45,326808.05
351250,202302,86,60,26,78125.65,33852.1,111977.75
351260,202302,147,100,47,130201.35,61194,191395.35
351270,202302,49,23,26,29947.75,33852,63799.75
351280,202302,1093,529,564,688780.32,734336.07,1423116.39
351290,202302,260,123,137,160148.64,179676,339824.64
351300,202302,4378,1817,2561,2365806.57,3335774.94,5701581.51
351310,202302,771,368,403,479162.81,524720.34,1003883.15
351320,202302,122,67,55,87235.66,71610.6,158846.26
351330,202302,41,23,18,29946,23436,53382
351340,202302,1557,833,724,1085903.18,942652.08,2028555.26
351350,202302,2598,1517,1081,1975228.6,1408770.76,3383999.36
351360,202302,848,395,453,514298.73,591112.33,1105411.06
351370,202302,472,232,240,303372.1,313782.68,617154.78
351380,202302,9447,4079,5368,5313627.73,7000891.11,12314518.84
351385,202302,24,17,7,22135.44,9114,31249.44
351390,202302,288,208,80,272122.94,104160.39,376283.33
351400,202302,62,40,22,52080.34,28644,80724.34
351410,202302,500,288,212,374991.38,276026.89,651018.27
351420,202302,75,54,21,70308.36,27342,97650.36
351430,202302,72,37,35,48174.65,45570.2,93744.85
351440,202302,872,562,310,731757.9,403625.49,1135383.39
351450,202302,306,152,154,197907.8,200512.02,398419.82
351460,202302,146,62,84,80729.89,109369.86,190099.75
351470,202302,150,79,71,102860.88,93744.89,196605.77
351480,202302,486,284,202,369773.74,263004.2,632777.94
351490,202302,328,134,194,174470.62,252588.55,427059.17
351492,202302,28,17,11,22134.63,14322,36456.63
351495,202302,26,17,9,22134,11718,33852
351500,202302,3669,1452,2217,1890545.25,2887861.73,4778406.98
351510,202302,2296,825,1471,1074184.89,1917868.24,2992053.13
351512,202302,14,10,4,13020,5208,18228
351515,202302,224,132,92,171872.26,119784,291656.26
351518,202302,709,418,291,544268.95,378906.03,923174.98
351519,202302,89,55,34,71611.87,44268,115879.87
351520,202302,176,109,67,141920.93,87258.45,229179.38
351530,202302,26,12,14,15624,18228,33852
351535,202302,137,81,56,105466.11,72912.96,178379.07
351540,202302,499,318,181,415352.87,236968.61,652321.48
351550,202302,1694,992,702,1292931.5,914013.41,2206944.91
351560,202302,88,48,40,62498.54,52080,114578.54
351565,202302,15,7,8,9114.32,10416,19530.32
351570,202302,3018,1355,1663,1765585.58,2169151.09,3934736.67
351580,202302,35,32,3,41664,3906,45570
351590,202302,69,41,28,53385.87,36456.22,89842.09
351600,202302,187,136,51,177080.01,66402.76,243482.77
351610,202302,52,24,28,31249.02,36456,67705.02
351620,202302,6315,3298,3017,4296794.5,3934681.52,8231476.02
351630,202302,3624,1688,1936,2199153.18,2523303.26,4722456.44
351640,202302,2739,1180,1559,1539012.64,2031134.88,3570147.52
351650,202302,38,30,8,39061.42,10416,49477.42
351660,202302,148,94,54,122388.8,70308,192696.8
351670,202302,798,451,347,588530.66,451804.82,1040335.48
351680,202302,89,63,26,82026.9,33852,115878.9
351685,202302,14,10,4,13020,5208,18228
351690,202302,314,198,116,257803.18,151033.62,408836.80
351700,202302,201,135,66,176055.21,85932.2,261987.41
351710,202302,69,44,25,57290.25,32550.91,89841.16
351720,202302,126,70,56,91141.97,72912,164053.97
351730,202302,124,83,41,108066.44,53382,161448.44
351740,202302,839,521,318,680979.21,415344.85,1096324.06
351750,202302,394,157,237,204420.1,308575.6,512995.7
351760,202302,723,561,162,730330.22,210924,941254.22
351770,202302,307,246,61,320306.6,79422.56,399729.16
351780,202302,145,88,57,115880.13,74214,190094.13
351790,202302,281,140,141,184890.67,183585.24,368475.91
351800,202302,47,31,16,40362.18,20832,61194.18
351810,202302,123,77,46,100258.29,59894.93,160153.22
351820,202302,778,549,229,714847.83,298165.89,1013013.72
351830,202302,688,221,467,287747.97,608039.95,895787.92
351840,202302,2451,1091,1360,1420522.17,1775938.26,3196460.43
351850,202302,278,188,90,244784.22,117180.1,361964.32
351860,202302,622,412,210,537757.5,273421.89,811179.39
351870,202302,6285,2786,3499,3630109.72,4561005,8191114.72
351880,202302,24024,9140,14884,11905828.82,19392025.84,31297854.66
351885,202302,109,61,48,79424.25,62496.8,141921.05
351890,202302,76,52,24,67704.62,31248,98952.62
351900,202302,255,132,123,171869.38,160146.39,332015.77
351905,202302,102,49,53,63799.73,69006.24,132805.97
351907,202302,4053,1639,2414,2135360.22,3145662.47,5281022.69
351910,202302,163,67,96,87237.26,124992.98,212230.24
351920,202302,118,64,54,83328,70308,153636
351925,202302,95,57,38,74218.37,50779.51,124997.88
351930,202302,480,299,181,389321.04,235669.79,624990.83
351940,202302,250,107,143,139316.29,186187.07,325503.36
351950,202302,150,81,69,105463.63,89841.41,195305.04
351960,202302,1028,494,534,643216.28,696589.69,1339805.97
351970,202302,2284,1073,1211,1398377.19,1578046.55,2976423.74
351980,202302,161,66,95,85935.12,123690.98,209626.10
351990,202302,261,162,99,210927.62,128899.07,339826.69
352000,202302,330,211,119,274735.41,156244.85,430980.26
352010,202302,456,294,162,382895.72,210935.38,593831.10
352020,202302,211,68,143,88536,186186,274722
352030,202302,1255,586,669,764296.18,872356.48,1636652.66
352040,202302,740,286,454,372375.84,591112.13,963487.97
352042,202302,366,83,283,108069.76,368468.34,476538.10
352044,202302,383,213,170,277344.22,221346.16,498690.38
352050,202302,3482,1267,2215,1649684.16,2883945.14,4533629.30
352060,202302,103,61,42,79422.18,54684.99,134107.17
352070,202302,105,72,33,93750.53,42966,136716.53
352080,202302,67,41,26,53384.71,33852.48,87237.19
352090,202302,197,121,76,157545.9,98952.72,256498.62
352100,202302,341,164,177,213534.6,230457.32,443991.92
352110,202302,109,27,82,35155.01,108066,143221.01
352115,202302,70,26,44,33852.7,57289.03,91141.73
352120,202302,71,47,24,61194,31248,92442
352130,202302,222,164,58,213536.42,75516.57,289052.99
352140,202302,202,97,105,126295.85,136712.8,263008.65
352150,202302,133,70,63,91142.28,82028.56,173170.84
352160,202302,146,94,52,122391.84,69006.54,191398.38
352170,202302,446,295,151,384096.14,196602.08,580698.22
352180,202302,733,439,294,572900.45,382795.55,955696.00
352190,202302,255,106,149,138016.75,194000.56,332017.31
352200,202302,30,13,17,16926,22134.1,39060.1
352210,202302,4858,1901,2957,2477820.9,3851351.24,6329172.14
352215,202302,79,42,37,54684.2,48174,102858.2
352220,202302,6508,2395,4113,3119704.23,5357795.3,8477499.53
352230,202302,3884,2431,1453,3167899.72,1895719.91,5063619.63
352240,202302,2957,1642,1315,2139252.06,1713450.32,3852702.38
352250,202302,3951,1744,2207,2272052.47,2876127.99,5148180.46
352260,202302,1104,573,531,746070.29,692677.92,1438748.21
352265,202302,71,42,29,54684,37758,92442
352270,202302,418,224,194,291670.15,253896.8,545566.95
352280,202302,534,310,224,404933.88,291648,696581.88
352290,202302,186,101,85,131509.31,110673.47,242182.78
352300,202302,105,64,41,83332.38,53383.16,136715.54
352310,202302,8110,3502,4608,4562394.04,6003536.93,10565930.97
352320,202302,1234,637,597,829396.36,777302.54,1606698.90
352330,202302,559,288,271,374980.37,352844.47,727824.84
352340,202302,1458,662,796,861951.78,1037703.52,1899655.30
352350,202302,389,209,180,272127.29,234363.96,506491.25
352360,202302,227,99,128,128899.64,166656.7,295556.34
352370,202302,126,78,48,101560.88,62497.66,164058.54
352380,202302,119,84,35,109373.11,45571.13,154944.24
352390,202302,2781,1175,1606,1531203.96,2092323.49,3623527.45
352400,202302,588,254,334,330715.67,434873.5,765589.17
352410,202302,961,625,336,815093.25,437492.71,1252585.96
352420,202302,92,67,25,87235.93,32550,119785.93
352430,202302,1851,803,1048,1046858.17,1364524.21,2411382.38
352440,202302,3713,1659,2054,2165305.13,2676923.1,4842228.23
352450,202302,202,155,47,201813.33,61196.06,263009.39
352460,202302,677,333,344,433574.56,447892.25,881466.81
352470,202302,710,269,441,350254.84,575489.07,925743.91
352480,202302,1740,971,769,1265592.56,1001254.89,2266847.45
352490,202302,58,22,36,28644.6,46872.36,75516.96
352500,202302,1382,550,832,716116.79,1084575.26,1800692.05
352510,202302,769,400,369,520829.53,481744.88,1002574.41
352520,202302,914,409,505,532529.81,657525.5,1190055.31
352530,202302,1997,981,1016,1278626.01,1322839.19,2601465.20
352540,202302,72,49,23,63799.79,29946,93745.79
352550,202302,224,128,96,166658.48,124992.4,291650.88
352560,202302,53,38,15,49476.84,19530.84,69007.68
352570,202302,801,382,419,498693.84,549458.5,1048152.34
352580,202302,59,44,15,57290.94,19530,76820.94
352585,202302,18,6,12,7812.98,15624.95,23437.93
352590,202302,4810,2350,2460,3065026.39,3206856.84,6271883.23
352600,202302,388,262,126,341134.24,164059.08,505193.32
352610,202302,965,420,545,546851.26,710899.09,1257750.35
352620,202302,1201,448,753,583310.06,983021.02,1566331.08
352630,202302,197,73,124,95047.67,161448.08,256495.75
352640,202302,541,342,199,446608.58,259102.73,705711.31
352650,202302,95,65,30,84632.74,39060,123692.74
352660,202302,70,37,33,48175.2,42966,91141.2
352670,202302,1839,961,878,1253896.05,1143158.15,2397054.20
352680,202302,1015,590,425,768208.27,555974.59,1324182.86
352690,202302,4990,2163,2827,2817634.09,3687293.18,6504927.27
352700,202302,94,50,44,65103.49,57289,122392.49
352710,202302,1592,810,782,1057272.55,1020769.91,2078042.46
352720,202302,1689,687,1002,894514.49,1305935.75,2200450.24
352725,202302,28,21,7,27342.78,9114,36456.78
352730,202302,426,205,221,268220.69,287745.26,555965.95
352740,202302,408,258,150,335932.91,195303.67,531236.58
352750,202302,24,14,10,18229.1,13020.14,31249.24
352760,202302,245,158,87,205720.16,113275.17,318995.33
352770,202302,79,57,22,74216.94,28644.18,102861.12
352780,202302,76,40,36,52080,46872.78,98952.78
352790,202302,26,17,9,22135.44,11718.18,33853.62
352800,202302,258,194,64,252593.24,83330.07,335923.31
352810,202302,161,101,60,131504.03,78122.87,209626.90
352820,202302,49,36,13,46872.57,16926,63798.57
352830,202302,74,49,25,63800.3,32550.01,96350.31
352840,202302,760,334,426,434891.79,554671.37,989563.16
352850,202302,1973,575,1398,748663.52,1821509.41,2570172.93
352860,202302,124,78,46,101560.23,59892.56,161452.79
352870,202302,54,33,21,42971.47,27343.51,70314.98
352880,202302,195,110,85,143228.74,110671.23,253899.97
352885,202302,34,22,12,28644.48,15624,44268.48
352890,202302,61,36,25,46874.15,32550.6,79424.75
352900,202302,4865,2261,2604,2946539.51,3391726.3,6338265.81
352910,202302,40,32,8,41664.88,10416,52080.88
352920,202302,663,374,289,486973.45,376286.19,863259.64
352930,202302,1249,576,673,749984.45,876251.1,1626235.55
352940,202302,6650,2488,4162,3242056.56,5425500.54,8667557.10
352950,202302,128,59,69,76820.21,89840.18,166660.39
352960,202302,66,43,23,55986.93,29946,85932.93
352965,202302,15,9,6,11718,7812,19530
352970,202302,560,399,161,519517.82,209628.61,729146.43
352980,202302,160,92,68,119790.97,88537.56,208328.53
352990,202302,1007,473,534,615871.82,696582.06,1312453.88
353000,202302,62,28,34,36456.44,44268.08,80724.52
353010,202302,542,328,214,428373.77,278631.99,707005.76
353020,202302,345,223,122,290356.98,158847.63,449204.61
353030,202302,1480,656,824,854145.09,1074172.63,1928317.72
353040,202302,94,48,46,62498.65,59893.75,122392.40
353050,202302,1413,914,499,1190087.03,649700.34,1839787.37
353060,202302,9794,4197,5597,5468620.18,7299082.03,12767702.21
353070,202302,2103,1210,893,1575484,1163757.3,2739241.3
353080,202302,1391,740,651,964821.12,847606.42,1812427.54
353090,202302,68,36,32,46873.83,41664,88537.83
353100,202302,46,34,12,44269.2,15625.54,59894.74
353110,202302,2390,786,1604,1023422.31,2088485.9,3111908.21
353120,202302,148,84,64,109368.7,83328,192696.7
353130,202302,896,421,475,548166.51,619759.18,1167925.69
353140,202302,614,282,332,367183.71,432270.74,799454.45
353150,202302,325,163,162,212232.56,210929.69,423162.25
353160,202302,109,81,28,105468.35,36456,141924.35
353170,202302,210,74,136,96350.01,177072.01,273422.02
353180,202302,1332,609,723,792940.9,941359.32,1734300.22
353190,202302,523,369,154,480465.06,200511.79,680976.85
353200,202302,283,137,146,178378.23,190093.45,368471.68
353205,202302,21,14,7,18228,9114,27342
353210,202302,77,46,31,59893.3,40362.09,100255.39
353215,202302,44,24,20,31248.2,26040,57288.2
353220,202302,85,45,40,58591.46,52080.59,110672.05
353230,202302,159,70,89,91142.36,115878,207020.36
353240,202302,419,178,241,231758.55,313782.89,545541.44
353250,202302,187,93,94,121090.13,122390.92,243481.05
353260,202302,491,312,179,406238.98,233064.17,639303.15
353270,202302,73,56,17,72915.33,22134,95049.33
353280,202302,125,57,68,74216.64,88539.76,162756.40
353282,202302,133,89,44,115878.49,57288.6,173167.09
353284,202302,32,24,8,31249.46,10416,41665.46
353286,202302,9,4,5,5208.2,6510.3,11718.5
353290,202302,88,51,37,66403.09,48174,114577.09
353300,202302,466,231,235,300776.85,305979.03,606755.88
353310,202302,38,30,8,40363.07,10417.05,50780.12
353320,202302,44,25,19,32551.3,24738.89,57290.19
353325,202302,47,25,22,32552.12,28644,61196.12
353330,202302,61,41,20,53382.4,26040.7,79423.1
353340,202302,744,269,475,350246.34,618460.21,968706.55
353350,202302,974,477,497,622377.25,648412.57,1270789.82
353360,202302,109,85,24,111975.14,31248.22,143223.36
353370,202302,113,62,51,80727.62,66402.38,147130.00
353380,202302,27,13,14,16926.2,18228,35154.2
353390,202302,1193,555,638,722639.54,830691.61,1553331.15
353400,202302,56,30,26,40364,33853.27,74217.27
353410,202302,118,63,55,82031.26,71612.01,153643.27
353420,202302,64,30,34,39060,44268,83328
353430,202302,603,389,214,507802.95,278638.61,786441.56
353440,202302,14136,6244,7892,8132474.31,10281952.84,18414427.15
353450,202302,51,24,27,31248.3,35154.2,66402.5
353460,202302,688,352,336,458326.9,437484.34,895811.24
353470,202302,2410,1148,1262,1494769.64,1647039.82,3141809.46
353475,202302,298,188,110,244782.05,143221.01,388003.06
353480,202302,188,147,41,191398.36,53382,244780.36
353490,202302,232,134,98,174473.24,127596.92,302070.16
353500,202302,217,122,95,160151.28,123691.51,283842.79
353510,202302,83,56,27,72913.54,35154.3,108067.84
353520,202302,255,184,71,239571.46,92442.6,332014.06
353530,202302,519,251,268,326815.17,348942.47,675757.64
353540,202302,434,268,166,350250.11,216136.66,566386.77
353550,202302,786,489,297,638021.64,388009.3,1026030.94
353560,202302,574,234,340,304671.16,442682.22,747353.38
353570,202302,70,48,22,62499.63,28644,91143.63
353580,202302,373,229,144,298164.82,187488,485652.82
353590,202302,92,69,23,89840.34,29946,119786.34
353600,202302,294,166,128,216139.72,166656.26,382795.98
353610,202302,147,82,65,106767.43,84630,191397.43
353620,202302,712,351,361,458318.76,470032.17,928350.93
353625,202302,62,32,30,41666.37,39060.27,80726.64
353630,202302,226,159,67,207028.5,87234.78,294263.28
353640,202302,133,85,48,110674.71,62496.95,173171.66
353650,202302,1117,439,678,572891.97,884064.6,1456956.57
353657,202302,25,19,6,24738,7812,32550
353660,202302,311,158,153,205721.88,199209.07,404930.95
353670,202302,757,426,331,554680.48,432273.63,986954.11
353680,202302,146,93,53,121086.54,69006,190092.54
353690,202302,45,30,15,39060.5,19531.09,58591.59
353700,202302,304,205,99,268218.15,128899.78,397117.93
353710,202302,576,280,296,364579.24,385393.02,749972.26
353715,202302,40,23,17,29946,22134,52080
353720,202302,335,150,185,195307.21,240873.14,436180.35
353730,202302,1236,731,505,951809.53,657512.32,1609321.85
353740,202302,632,343,289,446604.48,376286.83,822891.31
353750,202302,88,45,43,58591.9,55986,114577.9
353760,202302,3524,1352,2172,1761683.22,2829293.04,4590976.26
353770,202302,79,62,17,80725.24,22134.2,102859.44
353780,202302,1481,665,816,865849.18,1062443.62,1928292.80
353790,202302,524,308,216,401032.66,282541.23,683573.89
353800,202302,4046,1855,2191,2416634.38,2853992.99,5270627.37
353810,202302,253,125,128,162759.37,166657.32,329416.69
353820,202302,279,111,168,144522.85,218737.73,363260.58
353830,202302,71,60,11,78122.1,14322.9,92445.0
353850,202302,223,99,124,128901.51,161449.48,290350.99
353860,202302,566,258,308,335922.62,401021.9,736944.52
353870,202302,6242,3145,3097,4096225.22,4033626.28,8129851.50
353880,202302,773,490,283,639308.87,368472.25,1007781.12
353890,202302,594,336,258,437486.52,338528.27,776014.79
353900,202302,147,77,70,100257.57,91142.22,191399.79
353910,202302,215,84,131,109369.48,170563.52,279933.00
353920,202302,492,249,243,324207.52,316389.96,640597.48
353930,202302,1092,635,457,830708.93,595016.23,1425725.16
353940,202302,222,107,115,139315.48,152336.87,291652.35
353950,202302,543,349,194,454422.33,253894.31,708316.64
353960,202302,82,66,16,85935.36,20832,106767.36
353970,202302,41,26,15,33853.61,19530.99,53384.60
353980,202302,2109,920,1189,1199180.79,1549404.39,2748585.18
353990,202302,85,49,36,63800.22,46872.61,110672.83
354000,202302,401,182,219,236971.05,285140.42,522111.47
354010,202302,91,52,39,69008.47,50778.69,119787.16
354020,202302,551,344,207,447904.67,269519.22,717423.89
354025,202302,39,33,6,42967.44,7812,50779.44
354030,202302,49,26,23,33853.75,29946.15,63799.90
354040,202302,99,74,25,96351.37,32550,128901.37
354050,202302,164,85,79,110671.82,104161.28,214833.10
354060,202302,869,402,467,523415.27,608036.41,1131451.68
354070,202302,971,541,430,704405.55,559868.67,1264274.22
354075,202302,195,94,101,122391.66,131504.63,253896.29
354080,202302,316,145,171,188796.73,222644.14,411440.87
354085,202302,26,16,10,20832.72,13020,33852.72
354090,202302,297,172,125,223838.31,162752.26,386590.57
354100,202302,6641,2670,3971,3476471.13,5176845.48,8653316.61
354105,202302,105,54,51,70310.32,66402,136712.32
354110,202302,44,22,22,28644,28644.8,57288.8
354120,202302,164,101,63,131504.84,82026.46,213531.30
354130,202302,823,504,319,657539.98,416643.83,1074183.81
354140,202302,3571,1589,1982,2068967.98,2581883.49,4650851.47
354150,202302,677,383,294,498692.28,382795.65,881487.93
354160,202302,703,433,270,563801,351547.65,915348.65
354165,202302,11,7,4,9114.49,5208,14322.49
354170,202302,191,125,66,162755.62,85932.65,248688.27
354180,202302,56,33,23,42966.4,29946.75,72913.15
354190,202302,221,83,138,108069.16,179677.85,287747.01
354200,202302,118,58,60,75518.56,78121.83,153640.39
354210,202302,79,33,46,42966,59892,102858
354220,202302,633,380,253,494787.05,329412.18,824199.23
354230,202302,182,82,100,106767.04,130200.72,236967.76
354240,202302,338,203,135,264320.2,175771.5,440091.7
354250,202302,78,45,33,58590.68,42966,101556.68
354260,202302,2274,1036,1238,1348919.47,1611907.27,2960826.74
354270,202302,89,64,25,83329.79,32550,115879.79
354280,202302,59,33,26,42966,33852,76818
354290,202302,153,103,50,134111.47,65100.85,199212.32
354300,202302,339,237,102,308580.24,132804.93,441385.17
354310,202302,96,67,29,87237.5,37758,124995.5
354320,202302,241,113,128,147127.76,166656.14,313783.90
354323,202302,9,6,3,7812,3906,11718
354325,202302,131,70,61,91141.47,79422.83,170564.30
354330,202302,2596,870,1726,1132779.59,2249864.81,3382644.40
354340,202302,11477,5155,6322,6719618.34,8243035.6,14962653.94
354350,202302,151,100,51,131502.62,67704,199206.62
354360,202302,79,46,33,59893.21,42966.4,102859.61
354370,202302,249,126,123,164055.56,160148.18,324203.74
354380,202302,182,104,78,135411.27,101556,236967.27
354390,202302,2948,1054,1894,1373659.11,2473825.39,3847484.50
354400,202302,372,190,182,247385.4,236964.79,484350.19
354410,202302,744,323,421,420564.75,549456.72,970021.47
354420,202302,291,196,95,255202.24,123692.91,378895.15
354425,202302,354,200,154,260466.39,200511.3,460977.69
354430,202302,182,96,86,124998.49,111972.23,236970.72
354440,202302,27,22,5,28645.31,6510,35155.31
354450,202302,60,38,22,49476.84,28644,78120.84
354460,202302,102,57,45,74221.86,58593.18,132815.04
354470,202302,25,13,12,16927.25,15624.76,32552.01
354480,202302,121,67,54,87235.3,70309.51,157544.81
354490,202302,135,76,59,98956.77,76821.91,175778.68
354500,202302,420,177,243,231758.39,316386.68,548145.07
354510,202302,89,61,28,79423.9,36456.65,115880.55
354515,202302,52,19,33,24740.08,42966.1,67706.18
354520,202302,1743,728,1015,949004.83,1325437.16,2274441.99
354530,202302,913,450,463,585914.04,604133.13,1190047.17
354540,202302,272,136,136,177076.89,177073.85,354150.74
354550,202302,45,24,21,31248.44,27342,58590.44
354560,202302,170,94,76,122389.12,98952,221341.12
354570,202302,139,94,45,122388.58,58590,180978.58
354580,202302,2005,936,1069,1218710.24,1395752.91,2614463.15
354600,202302,295,133,162,173172.15,210924.5,384096.65
354610,202302,65,54,11,70308.99,15624.82,85933.81
354620,202302,77,23,54,29946.5,70309.08,100255.58
354625,202302,13,9,4,11719.99,5208.72,16928.71
354630,202302,372,245,127,319005.04,166660.29,485665.33
354640,202302,888,521,367,678601.53,477841.93,1156443.46
354650,202302,70,41,29,53383.79,37758,91141.79
354660,202302,879,636,243,828116.56,316389.64,1144506.20
354670,202302,232,90,142,117180.8,184884.2,302065.0
354680,202302,1448,513,935,670550.56,1218681.27,1889231.83
354690,202302,82,49,33,63800.47,42966.27,106766.74
354700,202302,80,55,25,71610.38,32550,104160.38
354710,202302,47,33,14,42966.97,18228.6,61195.57
354720,202302,24,21,3,27342.2,3906,31248.2
354730,202302,1983,808,1175,1052048.6,1531172.38,2583220.98
354740,202302,76,54,22,70308.69,28644,98952.69
354750,202302,420,228,192,296865.95,249986.89,546852.84
354760,202302,555,345,210,449225.94,274729.68,723955.62
354765,202302,7,3,4,3906,5208,9114
354770,202302,370,237,133,308587.19,173171.08,481758.27
354780,202302,9211,3322,5889,4329264.22,7672733.74,12001997.96
354790,202302,89,51,38,66402,49476.11,115878.11
354800,202302,457,241,216,315044.52,281237.24,596281.76
354805,202302,77,39,38,50778.99,49476.27,100255.26
354810,202302,101,54,47,70309.93,61194,131503.93
354820,202302,229,91,138,118484.62,179679.76,298164.38
354830,202302,43,23,20,29946,26040,55986
354840,202302,59,38,21,49477.04,27342,76819.04
354850,202302,5097,2246,2851,2924411.77,3715962.23,6640374.00
354860,202302,363,160,203,208320.95,264308.3,472629.25
354870,202302,13229,5691,7538,7416416.15,9818459.12,17234875.27
354880,202302,2869,1026,1843,1337198.1,2399675.53,3736873.63
354890,202302,3260,1704,1556,2218715.48,2025926.27,4244641.75
354900,202302,66,47,19,61194.77,24738.19,85932.96
354910,202302,1400,700,700,911434.46,912703.44,1824137.90
354920,202302,40,33,7,42966.6,9114,52080.6
354925,202302,24,14,10,18228,13020,31248
354930,202302,35,28,7,36457.99,9114,45571.99
354940,202302,794,544,250,709624.11,325507.7,1035131.81
354950,202302,213,131,82,170567.32,106766,277333.32
354960,202302,132,47,85,61195.01,110670.75,171865.76
354970,202302,1254,873,381,1136695.9,497365.75,1634061.65
354980,202302,10290,3690,6600,4805872.93,8599782.84,13405655.77
354990,202302,11409,5002,6407,6516712.46,8347174.17,14863886.63
354995,202302,638,215,423,279934.22,553358.97,833293.19
355000,202302,466,158,308,205718.08,401016.7,606734.78
355010,202302,712,442,270,576827.39,352851.48,929678.87
355020,202302,864,523,341,680966.08,443990.77,1124956.85
355030,202302,233289,85942,147347,111957053.53,191996734.66,303953788.19
355040,202302,1089,525,564,683577.33,734340.39,1417917.72
355050,202302,190,103,87,134107.61,113274,247381.61
355060,202302,1979,913,1066,1188789.6,1389242.54,2578032.14
355070,202302,1777,771,1006,1006474.58,1311133.26,2317607.84
355080,202302,210,126,84,164055.72,109370.4,273426.12
355090,202302,331,208,123,270830.76,160148.93,430979.69
355100,202302,6039,2777,3262,3618296.25,4249770.56,7868066.81
355110,202302,221,144,77,187489.17,100254.15,287743.32
355120,202302,52,32,20,41664.83,26040,67704.83
355130,202302,57,31,26,40362.38,33852,74214.38
355140,202302,212,120,92,156244.31,119784.43,276028.74
355150,202302,764,450,314,585926.73,408832.82,994759.55
355160,202302,529,254,275,330723.61,359359.14,690082.75
355170,202302,2223,1127,1096,1470020.31,1427006.51,2897026.82
355180,202302,728,284,444,369774.68,579400.09,949174.77
355190,202302,231,156,75,203122.61,98954.83,302077.44
355200,202302,116,55,61,71611.23,79422.6,151033.83
355210,202302,762,391,371,509089.74,483169.83,992259.57
355220,202302,8525,4000,4525,5213402.33,5898125.92,11111528.25
355230,202302,96,51,45,66403.5,58591.87,124995.37
355240,202302,4996,1970,3026,2566263.97,3942477.85,6508741.82
355250,202302,7714,3367,4347,4385328.54,5665028.62,10050357.16
355255,202302,50,30,20,39060.62,26040,65100.62
355260,202302,204,113,91,147131.34,118484.96,265616.30
355270,202302,169,109,60,141923.95,78120.98,220044.93
355280,202302,7775,2879,4896,3752491.83,6379899.44,10132391.27
355290,202302,67,51,16,66402.2,20832,87234.2
355300,202302,239,133,106,173169.95,138013.61,311183.56
355310,202302,117,64,53,83328.15,69006,152334.15
355320,202302,106,52,54,67704.6,70308.96,138013.56
355330,202302,345,200,145,260410.1,188793.73,449203.83
355340,202302,1402,512,890,667964.46,1158825.51,1826789.97
355350,202302,175,82,93,106764,121086.3,227850.3
355360,202302,194,128,66,167968.29,85932.89,253901.18
355365,202302,20,15,5,19530,7812,27342
355370,202302,1098,631,467,821604.82,608037.76,1429642.58
355380,202302,874,520,354,679677.44,460917.28,1140594.72
355385,202302,100,64,36,83328.2,46872,130200.2
355390,202302,106,55,51,71611.02,66402.8,138013.82
355395,202302,207,103,104,134111.05,135413.21,269524.26
355400,202302,1931,1073,858,1396989.67,1118420.17,2515409.84
355410,202302,5643,2508,3135,3268129.87,4084392.08,7352521.95
355420,202302,45,31,14,40362.8,18228,58590.8
355430,202302,467,273,194,355470.94,252596.11,608067.05
355440,202302,96,51,45,66403,58591.01,124994.01
355450,202302,481,249,232,324208.89,303368.07,627576.96
355460,202302,56,41,15,53382.4,19530.8,72913.2
355465,202302,51,28,23,36456.93,29946,66402.93
355470,202302,200,80,120,104162.31,156242.22,260404.53
355475,202302,8,4,4,5208.28,5208,10416.28
355480,202302,679,274,405,356766.65,528619.03,885385.68
355490,202302,107,77,30,100260.43,39061.59,139322.02
355495,202302,110,40,70,52080.1,91142.51,143222.61
355500,202302,1680,904,776,1178342.48,1011659.55,2190002.03
355510,202302,286,196,90,255206.52,117182.73,372389.25
355520,202302,28,19,9,24738.18,11718,36456.18
355530,202302,25,13,12,16926,15624,32550
355535,202302,84,40,44,52082.5,57288,109370.5
355540,202302,3075,1203,1872,1566366.48,2437397.59,4003764.07
355550,202302,72,40,32,52080,41664,93744
355560,202302,279,124,155,161453.77,201813.51,363267.28
355570,202302,16,12,4,15624.82,5208,20832.82
355580,202302,242,163,79,212235.68,102860.26,315095.94
355590,202302,16,11,5,14322.7,6510,20832.7
355600,202302,291,136,155,177078.18,201812.59,378890.77
355610,202302,255,153,102,199213.9,134111.06,333324.96
355620,202302,1380,580,800,755183.58,1045509.27,1800692.85
355630,202302,434,309,125,402336.11,162751.33,565087.44
355635,202302,134,54,80,70308.03,105462,175770.03
355640,202302,630,334,296,434876.28,385397.17,820273.45
355645,202302,944,334,610,434883.6,794229.6,1229113.2
355650,202302,1966,850,1116,1106745.15,1456940.45,2563685.60
355660,202302,231,116,115,151035.39,149732.11,300767.50
355670,202302,712,297,415,387999.59,541635.03,929634.62
355680,202302,219,117,102,152344.13,132807.93,285152.06
355690,202302,96,46,50,59893.75,65100.57,124994.32
355695,202302,26,17,9,22134,11718,33852
355700,202302,1329,633,696,824195.83,906199.73,1730395.56
355710,202302,2427,1332,1095,1735646.73,1428298.05,3163944.78
355715,202302,16,13,3,16926.7,3906.1,20832.8
355720,202302,270,163,107,213532.43,139315.64,352848.07
355730,202302,108,61,47,79422.58,61194.15,140616.73
410010,202302,107,86,21,111975.18,27342,139317.18
410020,202302,124,87,37,113277.48,48174.2,161451.68
410030,202302,192,107,85,139316.92,110673.44,249990.36
410040,202302,1488,707,781,920535.44,1018181.92,1938717.36
410045,202302,44,33,11,42966.05,14322,57288.05
410050,202302,548,318,230,414040.5,299461.71,713502.21
410060,202302,217,157,60,204421.74,78120.76,282542.50
410070,202302,301,248,53,322908.33,69007.11,391915.44
410080,202302,191,118,73,153638.88,96348,249986.88
410090,202302,54,46,8,59897.18,10416,70313.18
410100,202302,269,169,100,220041.25,130200.88,350242.13
410105,202302,46,27,19,35154,24738,59892
410110,202302,372,224,148,291661.73,192702.93,484364.66
410115,202302,49,28,21,36456,27342.2,63798.2
410120,202302,497,225,272,292959.07,354148.28,647107.35
410130,202302,68,38,30,49476.94,39060,88536.94
410140,202302,3423,1539,1884,2003822.79,2455598.67,4459421.46
410150,202302,2794,1116,1678,1453074.88,2186076.8,3639151.68
410160,202302,509,293,216,381493.32,281236.12,662729.44
410165,202302,59,38,21,49476.41,27342,76818.41
410170,202302,226,128,98,166658.4,127596.99,294255.39
410180,202302,2542,1328,1214,1729118.55,1580659.61,3309778.16
410185,202302,36,30,6,39060,7812,46872
410190,202302,510,329,181,428366.54,235663.81,664030.35
410200,202302,1122,789,333,1027294.83,433570.19,1460865.02
410210,202302,678,351,327,457013.98,425756.78,882770.76
410220,202302,48,20,28,26040.4,36456,62496.4
410230,202302,208,89,119,115878.04,154941.76,270819.80
410240,202302,745,482,263,627587.79,342428.47,970016.26
410250,202302,392,264,128,345033.62,167960.22,512993.84
410260,202302,315,173,142,225254.77,184893.44,410148.21
410270,202302,28,19,9,24738.13,11718,36456.13
410275,202302,64,45,19,58591.93,24738,83329.93
410280,202302,335,197,138,256505.94,179677.11,436183.05
410290,202302,273,152,121,197908.95,157543.31,355452.26
410300,202302,90,56,34,72912,44268,117180
410302,202302,27,14,13,18228.87,16926,35154.87
410304,202302,45,31,14,40363.73,18228,58591.73
410305,202302,217,130,87,169265.71,113275.33,282541.04
410310,202302,192,112,80,145827.58,104162.81,249990.39
410315,202302,38,31,7,40362.2,9114,49476.2
410320,202302,147,101,46,131503.47,59892,191395.47
410322,202302,39,23,16,29946.65,20832,50778.65
410330,202302,181,114,67,148430.98,87234,235664.98
410335,202302,105,57,48,74214,62496,136710
410337,202302,48,38,10,49477,13020,62497
410340,202302,38,31,7,40363.38,9114,49477.38
410345,202302,207,127,80,165355.48,104161.01,269516.49
410347,202302,43,31,12,40362.93,15624.11,55987.04
410350,202302,256,149,107,194003.36,139314,333317.36
410360,202302,464,286,178,373691.14,233060.14,606751.28
410370,202302,2458,1062,1396,1384065.51,1817609.53,3201675.04
410380,202302,210,117,93,152337.81,121086.52,273424.33
410390,202302,431,269,162,350243.82,210924.78,561168.60
410395,202302,31,20,11,26040.85,14322.04,40362.89
410400,202302,978,403,575,524723.73,751265.83,1275989.56
410405,202302,84,62,22,80727.16,28645.68,109372.84
410410,202302,28,18,10,23438.1,13020.1,36458.2
410420,202302,1927,848,1079,1104006.74,1404877.65,2508884.39
410425,202302,211,84,127,109370.41,165354.2,274724.61
410430,202302,2572,1317,1255,1714770.83,1636632.86,3351403.69
410440,202302,366,256,110,333313.27,143222.19,476535.46
410442,202302,365,232,133,302069.9,173167.9,475237.8
410445,202302,357,247,110,321605.08,143220.42,464825.50
410450,202302,405,191,214,248687.01,278628.07,527315.08
410460,202302,597,317,280,412741,364562.63,777303.63
410465,202302,281,154,127,200511.73,165354.89,365866.62
410470,202302,253,145,108,188795.99,140616.83,329412.82
410480,202302,7095,3407,3688,4438654.72,4807049.04,9245703.76
410490,202302,1501,816,685,1063765.53,891881.52,1955647.05
410500,202302,282,166,116,216135.11,151033.2,367168.31
410510,202302,210,154,56,200516.8,72913.17,273429.97
410520,202302,285,201,84,261702.69,109368,371070.69
410530,202302,280,84,196,110670.5,255192,365862.5
410540,202302,383,278,105,361963.71,136710.61,498674.32
410550,202302,1779,747,1032,972612.27,1343675.82,2316288.09
410560,202302,187,121,66,157546.6,87234.83,244781.43
410570,202302,458,300,158,390605.73,207020.14,597625.87
410580,202302,4074,1689,2385,2200449.74,3109234.28,5309684.02
410590,202302,451,290,161,377570.17,209622.11,587192.28
410600,202302,103,87,16,113275.24,20832,134107.24
410610,202302,63,51,12,66402.38,15624,82026.38
410620,202302,289,177,112,230462.36,145825.53,376287.89
410630,202302,483,264,219,343731.81,285138.38,628870.19
410640,202302,1207,746,461,972610.06,601526.78,1574136.84
410645,202302,116,86,30,111975.83,39060.2,151036.03
410650,202302,392,238,154,309879.82,200510.08,510389.90
410655,202302,89,65,24,84630.35,31248.68,115879.03
410657,202302,35,14,21,18228,27342,45570
410660,202302,688,468,220,610356.7,286444.43,896801.13
410670,202302,77,62,15,80726.47,19530.13,100256.60
410680,202302,197,156,41,203115.19,53382.2,256497.39
410685,202302,35,24,11,31248,14322,45570
410690,202302,31048,12604,18444,16419960.52,24033933.06,40453893.58
410700,202302,339,245,94,319274.9,123690.97,442965.87
410710,202302,129,107,22,139315.83,28644.2,167960.03
410712,202302,43,29,14,37758.65,18228,55986.65
410715,202302,106,76,30,98953.32,39060,138013.32
410720,202302,690,383,307,498676.34,399714.85,898391.19
410725,202302,204,137,67,178376.67,87234,265610.67
410730,202302,112,46,66,59893.16,85932.73,145825.89
410740,202302,78,58,20,75516.96,26040,101556.96
410750,202302,306,197,109,256498.45,141918.06,398416.51
410752,202302,23,16,7,20832.14,9114,29946.14
410753,202302,63,21,42,27342,54684,82026
410754,202302,59,30,29,39061.47,37758,76819.47
410755,202302,84,42,42,54684.2,54684,109368.2
410760,202302,804,431,373,562468.64,485649.32,1048117.96
410765,202302,2115,942,1173,1226532.61,1529881.4,2756414.01
410770,202302,124,84,40,109370.21,52081.61,161451.82
410773,202302,72,47,25,61195.87,32550,93745.87
410775,202302,213,150,63,195304.16,82026,277330.16
410780,202302,84,47,37,61195.35,48174,109369.35
410785,202302,57,48,9,62496.79,11718,74214.79
410790,202302,81,33,48,42966.2,62496,105462.2
410800,202302,296,183,113,238279.89,147127.44,385407.33
410810,202302,27,17,10,22134.19,13020.3,35154.49
410820,202302,153,108,45,140619.66,58590.9,199210.56
410830,202302,10061,4055,6006,5287575.7,7826419.09,13113994.79
410832,202302,112,70,42,91140.71,54684.3,145825.01
410840,202302,1505,809,696,1053346.3,906196.34,1959542.64
410845,202302,62,30,32,39060.3,41664.89,80725.19
410850,202302,154,111,43,144527.31,55986,200513.31
410855,202302,80,73,7,95046.9,9114,104160.9
410860,202302,916,450,466,585909.13,606736.5,1192645.63
410865,202302,95,66,29,85933.44,37758,123691.44
410870,202302,145,118,27,153638.81,35154.07,188792.88
410880,202302,1242,597,645,777311.38,841098.47,1618409.85
410890,202302,118,73,45,95048.73,58590,153638.73
410895,202302,80,61,19,79422.98,24738.95,104161.93
410900,202302,30,25,5,32550.67,6510,39060.67
410910,202302,13,8,5,10416.95,6510,16926.95
410920,202302,48,30,18,39060,23436,62496
410930,202302,574,344,230,447892.05,299461.89,747353.94
410940,202302,4769,2395,2374,3119708.31,3093599.54,6213307.85
410950,202302,98,74,24,96350.08,31248,127598.08
410960,202302,1034,386,648,502586.67,843709.46,1346296.13
410965,202302,65,44,21,57288.98,27342,84630.98
410970,202302,635,417,218,542941.82,285140.37,828082.19
410975,202302,125,75,50,97653.17,65100.6,162753.77
410980,202302,1690,759,931,989550.32,1213478.01,2203028.33
410990,202302,281,200,81,260401.42,105462.98,365864.40
411000,202302,62,34,28,44269.23,36457.33,80726.56
411005,202302,37,31,6,40362,7812,48174
411007,202302,261,150,111,195300.47,144522,339822.47
411010,202302,637,397,240,516908.01,312481.93,829389.94
411020,202302,288,180,108,234364.34,140618.74,374983.08
411030,202302,27,15,12,19530,15624,35154
411040,202302,68,42,26,54684,33852,88536
411050,202302,220,152,68,197906.48,88536.03,286442.51
411060,202302,569,386,183,502580.16,238268.78,740848.94
411065,202302,41,36,5,46873.34,6510,53383.34
411070,202302,1329,743,586,967406.38,764280.68,1731687.06
411080,202302,266,173,93,225246.13,121086.2,346332.33
411090,202302,88,62,26,80724.4,33852.96,114577.36
411095,202302,366,120,246,156241.52,320292.32,476533.84
411100,202302,113,88,25,114577.66,32550,147127.66
411110,202302,162,85,77,110670.86,100254.2,210925.06
411120,202302,222,142,80,184888.72,104160,289048.72
411125,202302,382,185,197,240879.61,256499.21,497378.82
411130,202302,128,106,22,138015.17,28644,166659.17
411140,202302,213,142,71,184884,92442,277326
411150,202302,1305,829,476,1079379.83,621060.08,1700439.91
411155,202302,121,82,39,106764,50778,157542
411160,202302,36,16,20,20832.55,26040,46872.55
411170,202302,58,49,9,63798,11718,75516
411180,202302,1083,703,380,915337.76,494766.35,1410104.11
411190,202302,369,209,160,272122.28,208320,480442.28
411200,202302,706,376,330,490871.55,430965.57,921837.12
411210,202302,703,354,349,460914.06,454398.77,915312.83
411220,202302,167,117,50,152338.95,65101.25,217440.20
411230,202302,36,28,8,36456.7,10416.6,46873.3
411240,202302,111,71,40,92443.31,52080,144523.31
411250,202302,437,310,127,403623.17,165354,568977.17
411260,202302,11,8,3,10416,3906,14322
411270,202302,279,145,134,188796.5,174470.3,363266.8
411275,202302,197,162,35,210927.22,45570,256497.22
411280,202302,287,190,97,248685.57,126294,374979.57
411290,202302,69,52,17,67704,22134,89838
411295,202302,133,99,34,128899.59,44268.66,173168.25
411300,202302,86,40,46,52080.99,59892,111972.99
411310,202302,94,68,26,88536.9,33852,122388.9
411320,202302,882,533,349,693975.77,455702.19,1149677.96
411325,202302,60,41,19,53382.1,24738,78120.1
411330,202302,1000,636,364,829401.12,475233.49,1304634.61
411340,202302,35,22,13,28644,16926.09,45570.09
411342,202302,63,48,15,62496,19530,82026
411345,202302,102,51,51,66405.18,66402.95,132808.13
411350,202302,548,407,141,531226.87,183585.65,714812.52
411360,202302,60,39,21,50781.09,27344.5,78125.59
411370,202302,14321,5817,8504,7575262.26,11074940.74,18650203.00
411373,202302,187,125,62,162750,80724.17,243474.17
411375,202302,84,68,16,88539.62,20832,109371.62
411380,202302,79,52,27,67707.24,35154,102861.24
411390,202302,163,85,78,110670.39,101556,212226.39
411400,202302,368,234,134,304675.23,174468,479143.23
411410,202302,553,261,292,339828.99,381488.7,721317.69
411420,202302,1010,416,594,542944.52,774695.99,1317640.51
411430,202302,587,303,284,394520.28,369777.42,764297.70
411435,202302,27,19,8,24738,10416,35154
411440,202302,508,398,110,518202.53,143220,661422.53
411450,202302,406,327,79,425764.3,102858.09,528622.39
411460,202302,854,321,533,417956.96,693970.07,1111927.03
411470,202302,113,79,34,102863.29,44268,147131.29
411480,202302,760,378,382,493474.26,498668.44,992142.70
411490,202302,292,179,113,233061.36,147126.2,380187.56
411500,202302,111,87,24,113276.78,31248,144524.78
411510,202302,236,179,57,233063.57,74215.19,307278.76
411520,202302,6742,2240,4502,2921757.86,5865555.14,8787313.00
411530,202302,127,82,45,106765.7,58590,165355.7
411535,202302,49,14,35,18228.1,45570,63798.1
411540,202302,402,264,138,343733.5,179678.42,523411.92
411545,202302,56,39,17,50778.39,22134,72912.39
411550,202302,91,69,22,89839.31,28644,118483.31
411560,202302,408,167,241,217437.13,313782.15,531219.28
411570,202302,1101,354,747,462100.08,973908.67,1436008.75
411573,202302,28,16,12,20832.2,15624,36456.2
411575,202302,328,203,125,264311.27,162750,427061.27
411580,202302,1321,452,869,588513.17,1132747.2,1721260.37
411585,202302,75,36,39,46872,50778,97650
411590,202302,15,7,8,9114,10416,19530
411600,202302,16,8,8,10416.7,10416,20832.7
411605,202302,183,70,113,91141.74,147126,238267.74
411610,202302,250,150,100,195303.01,130200.2,325503.21
411620,202302,396,190,206,247389.57,268219.09,515608.66
411630,202302,52,35,17,45570.18,22134.99,67705.17
411640,202302,31,21,10,27342.68,13020,40362.68
411650,202302,5,3,2,3906,2604,6510
411660,202302,50,37,13,48174,16926,65100
411670,202302,242,165,77,214831.93,100255.19,315087.12
411680,202302,165,127,38,165355.33,49476,214831.33
411690,202302,723,378,345,493461.75,453099.23,946560.98
411695,202302,65,44,21,57288.2,27342,84630.2
411700,202302,147,115,32,149734.12,41664,191398.12
411705,202302,102,70,32,91142,41664.4,132806.4
411710,202302,295,197,98,256500.26,128899.07,385399.33
411720,202302,160,103,57,134106.96,74214.2,208321.16
411721,202302,95,70,25,91140.2,32550.2,123690.4
411722,202302,104,50,54,65100.7,70308,135408.7
411725,202302,169,118,51,153636.7,66402,220038.7
411727,202302,105,84,21,109372.33,27342.61,136714.94
411729,202302,52,39,13,50778,16926,67704
411730,202302,588,367,221,477839.25,287746.05,765585.30
411740,202302,26,14,12,18229.24,15624.12,33853.36
411745,202302,75,54,21,70308,27342.6,97650.6
411750,202302,888,360,528,468729.04,687461.71,1156190.75
411760,202302,1336,953,383,1240855.35,498678.22,1739533.57
411770,202302,440,279,161,364565.08,209623.84,574188.92
411780,202302,385,249,136,324199.19,177072.21,501271.40
411790,202302,620,345,275,449200.15,359352.54,808552.69
411800,202302,168,118,50,153642.64,65100.38,218743.02
411810,202302,195,148,47,192699.7,61194.79,253894.49
411820,202302,2781,1083,1698,1411435.24,2212145.62,3623580.86
411830,202302,22,15,7,19530,9114,28644
411840,202302,2341,1349,992,1756442.88,1292911.87,3049354.75
411845,202302,68,23,45,29946.9,58590,88536.9
411850,202302,1334,709,625,924442.36,815063.45,1739505.81
411860,202302,64,39,25,50778.54,32550,83328.54
411870,202302,79,50,29,65100.86,37758,102858.86
411880,202302,432,257,175,334622.84,227851.89,562474.73
411885,202302,112,71,41,92443.24,54686.52,147129.76
411890,202302,358,250,108,325506.55,140617.88,466124.43
411900,202302,112,81,31,105462.35,40362,145824.35
411910,202302,226,147,79,191398.18,102859.54,294257.72
411915,202302,2606,1000,1606,1303342.14,2092356.72,3395698.86
411920,202302,116,84,32,110671.27,41664.98,152336.25
411925,202302,20,13,7,16926.59,9114,26040.59
411930,202302,832,555,277,724019.89,361961.95,1085981.84
411940,202302,606,378,228,492166.68,298160.27,790326.95
411950,202302,1323,588,735,765607.72,959599.11,1725206.83
411960,202302,1198,731,467,953076,608036.43,1561112.43
411965,202302,22,13,9,16926.97,11718,28644.97
411970,202302,93,78,15,101557.77,19530,121087.77
411980,202302,240,124,116,162750.31,151032,313782.31
411990,202302,5638,2962,2676,3857869.18,3490830.34,7348699.52
411995,202302,679,201,478,261712.37,623673.92,885386.29
412000,202302,347,234,113,305979.42,147128.78,453108.20
412010,202302,66,34,32,44268.9,42966.72,87235.62
412015,202302,35,26,9,33852,11718,45570
412020,202302,26,19,7,24740.07,9114,33854.07
412030,202302,40,35,5,45571.07,6510,52081.07
412033,202302,46,24,22,31249.42,28644,59893.42
412035,202302,67,44,23,57288.5,29946,87234.5
412040,202302,32,15,17,19530.6,22134,41664.6
412050,202302,222,162,60,210929.39,78120.56,289049.95
412060,202302,833,592,241,772114.41,313787.21,1085901.62
412065,202302,57,29,28,37758.89,36456.15,74215.04
412070,202302,143,100,43,130202.5,55986,186188.5
412080,202302,366,179,187,233066.56,243479.87,476546.43
412085,202302,39,14,25,18228.2,32550,50778.2
412090,202302,901,544,357,708303.3,464816.82,1173120.12
412100,202302,268,223,45,290355.81,58590,348945.81
412110,202302,76,56,20,72913.77,26040,98953.77
412120,202302,378,198,180,257801.74,234363.67,492165.41
412125,202302,71,40,31,52080.2,40362,92442.2
412130,202302,50,31,19,40364.62,24738,65102.62
412135,202302,29,18,11,23436.2,14322,37758.2
412140,202302,477,308,169,401019.42,220040.68,621060.10
412150,202302,261,156,105,203114.56,138013.33,341127.89
412160,202302,72,47,25,61195.69,32550.2,93745.89
412170,202302,736,469,267,610644.02,347636.37,958280.39
412175,202302,38,24,14,31248.24,18228.5,49476.74
412180,202302,160,117,43,152338.7,57288.2,209626.9
412190,202302,334,260,74,339828.76,96348,436176.76
412200,202302,193,114,79,148429.65,102858,251287.65
412210,202302,100,74,26,96348,33853.64,130201.64
412215,202302,248,166,82,216136.25,106765.16,322901.41
412217,202302,66,51,15,66403.65,19530,85933.65
412220,202302,906,576,330,749979.7,429670.47,1179650.17
412230,202302,290,170,120,221347.61,157545.77,378893.38
412240,202302,1441,708,733,923143.55,954376.45,1877520.00
412250,202302,438,265,173,345032.97,225246,570278.97
412260,202302,132,87,45,113277.2,59892.2,173169.4
412265,202302,168,128,40,166656.83,52080,218736.83
412270,202302,97,58,39,75516.25,50778,126294.25
412280,202302,84,65,19,84630.2,24738,109368.2
412290,202302,91,57,34,75517.64,44268,119785.64
412300,202302,213,151,62,196603.87,80724,277327.87
412310,202302,58,45,13,58591.57,16926,75517.57
412320,202302,93,68,25,88540.68,32550,121090.68
412330,202302,208,156,52,204415.08,67704,272119.08
412340,202302,188,120,68,156241.15,88536,244777.15
412350,202302,712,317,395,412739.41,514293.64,927033.05
412360,202302,23,18,5,23436,6510,29946
412370,202302,149,121,28,157546.4,36456,194002.4
412380,202302,190,140,50,182283.8,65100.8,247384.6
412382,202302,60,34,26,44268,33852,78120
412385,202302,164,118,46,153640.27,59892.92,213533.19
412390,202302,338,253,85,329413.61,110671.81,440085.42
412395,202302,68,56,12,72913.22,15624,88537.22
412400,202302,98,65,33,84632.25,42966,127598.25
412402,202302,245,134,111,174471,144522,318993
412405,202302,998,331,667,430964.96,869738.14,1300703.10
412410,202302,1046,619,427,805977,555960.25,1361937.25
412420,202302,16,15,1,19530,1302,20832
412430,202302,27,25,2,32552.16,2604.2,35156.36
412440,202302,716,359,357,467425.42,464816.2,932241.62
412450,202302,65,58,7,75518.11,9114,84632.11
412460,202302,79,55,24,71612.05,31248.19,102860.24
412470,202302,237,186,51,242176.85,66402.24,308579.09
412480,202302,161,118,43,153638.68,55986.2,209624.88
412490,202302,180,149,31,194000.85,40362,234362.85
412500,202302,413,318,95,414048.16,123692.47,537740.63
412510,202302,171,140,31,182284,40362,222646
412520,202302,91,60,31,78122.16,40362,118484.16
412530,202302,112,51,61,66402.5,79422,145824.5
412535,202302,67,52,15,67705.56,19530,87235.56
412540,202302,53,31,22,40362.54,28644.46,69007.00
412545,202302,88,61,27,79423.42,35154,114577.42
412550,202302,4490,1796,2694,2338473.23,3514165.47,5852638.70
412555,202302,12,7,5,9114,6510,15624
412560,202302,727,466,261,606744,339822.81,946566.81
412570,202302,885,392,493,510395.43,641889.19,1152284.62
412575,202302,97,68,29,88537.31,37758,126295.31
412580,202302,184,122,62,158854.81,80726,239580.81
412590,202302,32,28,4,36456.93,5208,41664.93
412600,202302,216,154,62,200512.92,80724.83,281237.75
412610,202302,44,20,24,26040.8,31248,57288.8
412620,202302,129,106,23,138015.31,29946.46,167961.77
412625,202302,2253,1073,1180,1397079.99,1538974.37,2936054.36
412627,202302,65,47,18,61195.02,23436,84631.02
412630,202302,384,261,123,339831.67,160146.48,499978.15
412635,202302,79,24,55,31248,71610,102858
412640,202302,115,81,34,105462.2,44268,149730.2
412650,202302,329,215,114,279936.64,148428.89,428365.53
412660,202302,594,315,279,410134.37,364560.46,774694.83
412665,202302,40,36,4,48175.14,5208,53383.14
412667,202302,273,172,101,223947.7,131502,355449.7
412670,202302,81,61,20,79422.66,26040,105462.66
412680,202302,341,257,84,334623.94,109369.07,443993.01
412690,202302,131,84,47,109370.66,62496,171866.66
412700,202302,192,119,73,154938.63,95046.23,249984.86
412710,202302,1425,778,647,1012978.28,845007.97,1857986.25
412720,202302,247,136,111,177074.75,145824.69,322899.44
412730,202302,221,188,33,244780.83,42966.99,287747.82
412740,202302,418,202,216,263009.09,281232.41,544241.50
412750,202302,419,232,187,302071.77,243474.48,545546.25
412760,202302,385,195,190,253896.35,247385.07,501281.42
412770,202302,2234,1190,1044,1550714.71,1359295.9,2910010.61
412780,202302,149,103,46,134110.2,59892.1,194002.3
412785,202302,336,173,163,225249.52,212226.02,437475.54
412788,202302,54,30,24,39060.99,31248,70308.99
412790,202302,127,102,25,132808.89,32550,165358.89
412795,202302,147,99,48,128901.34,62496,191397.34
412796,202302,313,198,115,257798.81,149730.2,407529.01
412800,202302,745,414,331,539032.63,432264.81,971297.44
412810,202302,3256,1772,1484,2308525.53,1932191.5,4240717.03
412820,202302,1079,622,457,811175.66,595028.88,1406204.54
412830,202302,14,13,1,16926.2,1302,18228.2
412840,202302,289,192,97,249987.45,126294.2,376281.65
412850,202302,594,390,204,507787.72,265608.68,773396.40
412853,202302,175,79,96,102858.26,126294,229152.26
412855,202302,212,114,98,148430.92,127596.73,276027.65
412860,202302,99,68,31,88539.8,40362.73,128902.53
412862,202302,83,52,31,67704,40362,108066
412863,202302,8,5,3,6510,3906,10416
412865,202302,46,36,10,46872,13020.6,59892.6
412870,202302,120,75,45,97654.56,58591.82,156246.38
412880,202302,99,67,32,87237.62,41664,128901.62
420005,202302,43,36,7,46872.7,9114,55986.7
420010,202302,375,246,129,320299.08,167958.39,488257.47
420020,202302,101,76,25,98953.67,32550,131503.67
420030,202302,30,24,6,31248.2,7812,39060.2
420040,202302,96,74,22,96350.7,28644.2,124994.9
420050,202302,53,33,20,42966.41,26040,69006.41
420055,202302,18,16,2,20832.29,2604,23436.29
420060,202302,29,20,9,26040.66,11718.2,37758.86
420070,202302,106,91,15,118483.38,19530,138013.38
420075,202302,11,11,0,14322,,14322.0
420080,202302,40,34,6,44268.63,7812,52080.63
420090,202302,40,32,8,41664.16,10416.21,52080.37
420100,202302,167,142,25,184886.51,32550,217436.51
420110,202302,24,23,1,29946,1302,31248
420120,202302,63,46,17,59892.31,22134,82026.31
420125,202302,82,62,20,80724.6,26040,106764.6
420127,202302,39,32,7,41664,9114,50778
420130,202302,518,312,206,406238.43,268217.6,674456.03
420140,202302,1446,803,643,1045534.15,838507.72,1884041.87
420150,202302,52,38,14,49476,18228,67704
420160,202302,34,29,5,37758.47,6510,44268.47
420165,202302,19,15,4,19530.29,5208,24738.29
420170,202302,73,41,32,53382.78,41664,95046.78
420180,202302,25,21,4,27342,5208,32550
420190,202302,28,24,4,31248.18,5208,36456.18
420195,202302,134,62,72,80728.84,93747.17,174476.01
420200,202302,1449,598,851,778621.56,1109326.94,1887948.50
420205,202302,129,77,52,100256.38,67704.4,167960.78
420207,202302,158,87,71,113278.44,93745.17,207023.61
420208,202302,19,15,4,19530.21,5208,24738.21
420209,202302,12,10,2,13020,2604,15624
420210,202302,625,295,330,384103.3,429664.21,813767.51
420213,202302,54,37,17,48174.69,22134,70308.69
420215,202302,28,24,4,31248.45,5208,36456.45
420220,202302,61,38,23,49477.1,29946,79423.1
420230,202302,1068,635,433,826810.93,565081.25,1391892.18
420240,202302,2436,1599,837,2085846.24,1089785.22,3175631.46
420243,202302,47,38,9,49477.22,11718,61195.22
420245,202302,233,113,120,147130.36,156244.88,303375.24
420250,202302,64,43,21,55987.06,27342,83329.06
420253,202302,23,17,6,22135.22,7812,29947.22
420257,202302,16,10,6,13020,7812,20832
420260,202302,128,102,26,132805.79,33852.14,166657.93
420270,202302,36,25,11,32550.19,14322,46872.19
420280,202302,299,222,77,289059.9,100254.98,389314.88
420285,202302,24,19,5,26040,6510,32550
420287,202302,47,29,18,37759.34,23436,61195.34
420290,202302,994,672,322,874960.1,420547.02,1295507.12
420300,202302,1688,1348,340,1756470.77,443988.92,2200459.69
420310,202302,44,32,12,41664.7,15624,57288.7
420315,202302,24,20,4,26040.78,5208.74,31249.52
420320,202302,1097,518,579,675762.93,755174.48,1430937.41
420325,202302,5,3,2,3906,2604.8,6510.8
420330,202302,119,78,41,101556.54,53382.45,154938.99
420340,202302,202,136,66,177075.37,85932,263007.37
420350,202302,270,192,78,249992.35,101557.19,351549.54
420360,202302,706,542,164,707014.24,214833.68,921847.92
420370,202302,143,77,66,100256.3,85932.43,186188.73
420380,202302,1290,864,426,1126272.73,554659.82,1680932.55
420390,202302,230,163,67,212231.91,87234.4,299466.31
420395,202302,197,142,55,184895.88,71612.73,256508.61
420400,202302,228,173,55,225249.56,71610.2,296859.76
420410,202302,55,41,14,53382.91,18228,71610.91
420415,202302,32,26,6,33852.86,7812,41664.86
420417,202302,63,50,13,65100.01,16926,82026.01
420419,202302,11,10,1,13020,1302,14322
420420,202302,3056,1879,1177,2446529.81,1532467.8,3978997.61
420425,202302,71,50,21,65104.47,27342,92446.47
420430,202302,1059,761,298,990834.13,389300.9,1380135.03
420435,202302,14,11,3,14322,3906,18228
420440,202302,90,64,26,83330.26,33852,117182.26
420445,202302,31,28,3,36456.9,3906,40362.9
420450,202302,83,47,36,61195.79,48174,109369.79
420455,202302,179,136,43,177076.55,55986,233062.55
420460,202302,2507,1555,952,2027294.57,1239514.01,3266808.58
420470,202302,84,54,30,70308.2,39060,109368.2
420475,202302,10,9,1,11718,1302,13020
420480,202302,920,699,221,911450.01,287743.74,1199193.75
420490,202302,100,74,26,97653.57,33852,131505.57
420500,202302,407,241,166,313792.26,216132.56,529924.82
420510,202302,25,21,4,27342.34,5208,32550.34
420515,202302,26,14,12,18228.02,15624,33852.02
420517,202302,13,10,3,13020.91,3906,16926.91
420519,202302,3,3,0,3906,,3906.0
420520,202302,63,46,17,59894.12,22134.2,82028.32
420530,202302,141,90,51,117181.98,66402.2,183584.18
420535,202302,16,13,3,16926.41,3906,20832.41
420540,202302,6959,4301,2658,5609556.13,3467271.22,9076827.35
420543,202302,30,29,1,37759.88,1302,39061.88
420545,202302,225,154,71,200513.99,92442,292955.99
420550,202302,811,680,131,885392.7,170565.86,1055958.56
420555,202302,34,24,10,31249.6,13020,44269.6
420560,202302,63,48,15,62497.34,19530,82027.34
420570,202302,234,110,124,143224.59,161450.06,304674.65
420580,202302,330,164,166,213534.28,216133.53,429667.81
420590,202302,507,316,191,411439.06,248682.82,660121.88
420600,202302,160,89,71,115879.57,92442,208321.57
420610,202302,37,34,3,44268.3,3906,48174.3
420620,202302,79,58,21,75517.19,27342.41,102859.60
420630,202302,162,108,54,140619.14,70308,210927.14
420640,202302,72,63,9,82026,11718,93744
420650,202302,336,173,163,225250.87,212227.4,437478.27
420660,202302,39,29,10,37758.45,13020,50778.45
420665,202302,46,30,16,39061.4,20832,59893.4
420670,202302,236,181,55,235670.6,71610,307280.6
420675,202302,15,12,3,15624,3906,19530
420680,202302,34,29,5,37758.12,6510,44268.12
420690,202302,198,147,51,191396.2,66402.34,257798.54
420700,202302,743,480,263,624980.9,342430.62,967411.52
420710,202302,148,81,67,105463.49,87235.03,192698.52
420720,202302,95,78,17,101558.99,22134.6,123693.59
420730,202302,746,440,306,572897.47,398420.5,971317.97
420740,202302,60,58,2,75517.18,2604,78121.18
420750,202302,508,330,178,429663.84,231757.56,661421.40
420757,202302,19,16,3,20832,3906,24738
420760,202302,40,28,12,36456.86,15624,52080.86
420765,202302,75,52,23,67704.7,29946,97650.7
420768,202302,60,47,13,61196.91,16926,78122.91
420770,202302,72,62,10,80726.53,13020,93746.53
420775,202302,35,31,4,40362.95,5208,45570.95
420780,202302,199,154,45,200511.84,58590,259101.84
420785,202302,26,17,9,22134,11718,33852
420790,202302,136,112,24,145824.86,31248.09,177072.95
420800,202302,61,47,14,61194.62,18228,79422.62
420810,202302,292,223,69,290356.65,89838,380194.65
420820,202302,2775,1530,1245,1992122.27,1621013.59,3613135.86
420830,202302,748,397,351,518220.23,457015.53,975235.76
420840,202302,133,91,42,118483.8,54684,173167.8
420845,202302,459,198,261,257801.21,339825.01,597626.22
420850,202302,281,218,63,283837.29,82026.3,365863.59
420860,202302,58,49,9,63799.71,11718,75517.71
420870,202302,131,92,39,119784.8,50778,170562.8
420880,202302,197,123,74,160149.56,96348.2,256497.76
420890,202302,1047,508,539,661427.5,701779.55,1363207.05
420895,202302,8,8,0,10416,,10416.0
420900,202302,425,341,84,443989.86,109368.78,553358.64
420910,202302,6247,3390,2857,4417836.76,3721165.13,8139001.89
420915,202302,58,54,4,70308.2,5208,75516.2
420917,202302,21,16,5,20832.23,6510,27342.23
420920,202302,21,15,6,19530,7812,27342
420930,202302,3666,2461,1205,3205591.55,1568948.56,4774540.11
420940,202302,590,409,181,533847.48,236970.03,770817.51
420945,202302,10,8,2,10416,2604,13020
420950,202302,47,34,13,44268.78,16926,61194.78
420960,202302,113,92,21,119790.88,27342.1,147132.98
420970,202302,281,225,56,292963.25,72913.09,365876.34
420980,202302,23,22,1,28644,1302,29946
420985,202302,52,45,7,58591.07,9114,67705.07
420990,202302,91,68,23,88538.4,29946.6,118485.0
421000,202302,64,34,30,44268,39060,83328
421003,202302,33,23,10,29946.32,13020,42966.32
421005,202302,8,6,2,7812.8,2604,10416.8
421010,202302,906,579,327,755189.62,425760.42,1180950.04
421020,202302,22,18,4,23438.94,5208,28646.94
421030,202302,119,99,20,128899.15,26040.7,154939.85
421040,202302,68,47,21,61196.32,27343.6,88539.92
421050,202302,330,230,100,299461.81,130200,429661.81
421055,202302,15,12,3,15624.2,3906,19530.2
421060,202302,109,61,48,79422.94,62496,141918.94
421070,202302,37,33,4,42967.98,5208,48175.98
421080,202302,45,38,7,49477,9114,58591
421085,202302,18,14,4,18228,5208,23436
421090,202302,38,29,9,37758.13,11718,49476.13
421100,202302,114,88,26,114578.71,33852.95,148431.66
421105,202302,199,158,41,205722.23,53382.2,259104.43
421110,202302,130,90,40,117185.38,52080,169265.38
421120,202302,196,139,57,180982.27,74215.01,255197.28
421125,202302,17,10,7,13020,9114.21,22134.21
421130,202302,893,543,350,708310.93,457008.05,1165318.98
421140,202302,34,25,9,32550.61,11718,44268.61
421145,202302,41,36,5,46872.76,6510,53382.76
421150,202302,83,65,18,84631.97,23436,108067.97
421160,202302,60,38,22,49476.5,28644.48,78120.98
421165,202302,14,12,2,15624,2604,18228
421170,202302,169,142,27,185048.7,35154.7,220203.4
421175,202302,196,140,56,182286.13,72913.85,255199.98
421180,202302,38,26,12,33852.46,15624,49476.46
421185,202302,15,12,3,15624.18,3906,19530.18
421187,202302,3,2,1,2604.2,1302,3906.2
421189,202302,47,34,13,44269.08,16926,61195.08
421190,202302,2144,1344,800,1751880.55,1041622.15,2793502.70
421200,202302,94,65,29,84631.86,37758,122389.86
421205,202302,23,16,7,20833.07,9114,29947.07
421210,202302,177,129,48,167959.22,62496,230455.22
421220,202302,254,198,56,257797.11,72913.45,330710.56
421223,202302,49,38,11,49477.17,14322,63799.17
421225,202302,73,50,23,65102.27,29947.73,95050.00
421227,202302,63,54,9,70309.69,11718,82027.69
421230,202302,78,51,27,66403.38,35154.18,101557.56
421240,202302,16,14,2,18229.18,2604,20833.18
421250,202302,429,233,196,303372.48,255198.41,558570.89
421260,202302,22,17,5,22134.59,6510,28644.59
421265,202302,11,7,4,9114.8,5208.1,14322.9
421270,202302,54,49,5,63798,6510,70308
421280,202302,413,207,206,269521.85,268215.45,537737.30
421290,202302,317,208,109,272119.96,143220.65,415340.61
421300,202302,22,20,2,26040,2604,28644
421310,202302,49,35,14,45570,18228,63798
421315,202302,34,21,13,27343.03,16926.08,44269.11
421320,202302,141,95,46,123691.61,61194,184885.61
421330,202302,112,84,28,109370.32,36456.5,145826.82
421335,202302,43,31,12,40363.35,15624,55987.35
421340,202302,252,171,81,222646.6,105462,328108.6
421350,202302,192,112,80,145828.28,104160.25,249988.53
421360,202302,769,531,238,691375.13,311183.89,1002559.02
421370,202302,203,152,51,197906.03,66402.85,264308.88
421380,202302,152,115,37,149731.9,48174,197905.9
421390,202302,15,10,5,13020,6510,19530
421400,202302,119,97,22,126294.65,28644,154938.65
421410,202302,20,17,3,22134,3906,26040
421415,202302,20,18,2,23436,2604,26040
421420,202302,101,86,15,111973.54,19530,131503.54
421430,202302,21,13,8,16926,10416,27342
421440,202302,61,52,9,67704.41,11718.98,79423.39
421450,202302,79,65,14,84630.95,18228,102858.95
421460,202302,55,43,12,55986,15624,71610
421470,202302,76,40,36,52080.27,46872,98952.27
421480,202302,812,604,208,786420.08,270817.72,1057237.80
421490,202302,23,22,1,28644.78,1302,29946.78
421500,202302,490,286,204,372390.28,265609.35,637999.63
421505,202302,39,32,7,41664.1,9114.2,50778.3
421507,202302,31,24,7,31248.1,9114,40362.1
421510,202302,69,43,26,55988.25,33852.61,89840.86
421520,202302,50,41,9,53382.4,11718,65100.4
421530,202302,51,43,8,55987.28,10416,66403.28
421535,202302,23,21,2,27342.99,2604,29946.99
421540,202302,49,40,9,52080.2,11718,63798.2
421545,202302,83,55,28,71614.7,36456.82,108071.52
421550,202302,300,215,85,279944.44,110671.47,390615.91
421555,202302,15,13,2,16928.06,2604,19532.06
421560,202302,8,7,1,9114,1302,10416
421565,202302,136,87,49,113276.48,63798.57,177075.05
421567,202302,37,27,10,35154,13020,48174
421568,202302,40,38,2,49476,2604,52080
421569,202302,10,10,0,13020.41,,13020.41
421570,202302,265,175,90,227853.89,117181.03,345034.92
421575,202302,28,25,3,32550.95,3906,36456.95
421580,202302,766,452,314,588603.47,408831.53,997435.00
421590,202302,21,19,2,24738.2,2604,27342.2
421600,202302,187,133,54,173167.43,70308.2,243475.63
421605,202302,107,72,35,93745.52,45570.2,139315.72
421610,202302,175,128,47,166656.99,61194,227850.99
421620,202302,1116,638,478,830710.4,622370.32,1453080.72
421625,202302,24,21,3,27342.26,3906,31248.26
421630,202302,379,229,150,298167.52,195306.34,493473.86
421635,202302,26,13,13,16926,16926,33852
421640,202302,106,83,23,108071.02,29946,138017.02
421650,202302,336,193,143,251293.27,186188.05,437481.32
421660,202302,2790,1685,1105,2195245.98,1438736.99,3633982.97
421670,202302,161,115,46,149733.73,59892,209625.73
421680,202302,200,180,20,234364.3,26040,260404.3
421690,202302,355,239,116,311185.25,151033.57,462218.82
421700,202302,61,41,20,53382.7,26040.2,79422.9
421710,202302,21,21,0,27342.28,,27342.28
421715,202302,5,4,1,5208.86,1302,6510.86
421720,202302,669,446,223,580709.05,290347.7,871056.75
421725,202302,31,13,18,16926,23436.8,40362.8
421730,202302,25,19,6,24738,7812,32550
421740,202302,115,45,70,58590.72,91140,149730.72
421750,202302,195,143,52,186186.34,69006,255192.34
421755,202302,19,17,2,22134,2604,24738
421760,202302,99,67,32,87235.89,41664.19,128900.08
421770,202302,727,460,267,598939.37,347639.03,946578.40
421775,202302,29,19,10,24738.97,13020.09,37759.06
421780,202302,190,147,43,192696.73,55986,248682.73
421790,202302,151,128,23,166657.85,29946.66,196604.51
421795,202302,16,13,3,16926.33,3906,20832.33
421800,202302,595,355,240,462236.52,312486.29,774722.81
421810,202302,68,57,11,74215.08,14322,88537.08
421820,202302,319,197,122,256499.64,158844,415343.64
421825,202302,163,137,26,178379.59,33852,212231.59
421830,202302,159,98,61,127604.86,79422.65,207027.51
421835,202302,7,3,4,3906.1,5208,9114.1
421840,202302,42,35,7,45571.8,9114,54685.8
421850,202302,78,65,13,84630.5,16926,101556.5
421860,202302,36,26,10,33852.93,13020,46872.93
421870,202302,1198,855,343,1113258.61,446599.96,1559858.57
421875,202302,48,38,10,49476,13020,62496
421880,202302,196,137,59,178377.33,76818.7,255196.03
421885,202302,20,15,5,19530,6510.84,26040.84
421890,202302,169,124,45,161453.21,58590.85,220044.06
421895,202302,50,43,7,55986.6,9114,65100.6
421900,202302,127,99,28,130208.35,36456,166664.35
421910,202302,65,41,24,53383.08,31248,84631.08
421915,202302,30,24,6,31248,7812,39060
421917,202302,52,41,11,53383.85,14322,67705.85
421920,202302,35,31,4,40362,5208,45570
421930,202302,649,515,134,671853.05,174470.35,846323.40
421935,202302,45,39,6,50778.07,7812,58590.07
421940,202302,51,44,7,57288.4,9114,66402.4
421950,202302,946,625,321,813760.92,419248.26,1233009.18
421960,202302,41,34,7,44268.22,9114,53382.22
421970,202302,331,206,125,268219.17,164053.39,432272.56
421985,202302,19,11,8,14322.2,10416,24738.2
422000,202302,10,4,6,5208.7,7812.76,13021.46
430003,202302,195,60,135,78120,175770,253890
430005,202302,31,24,7,31248.99,9114,40362.99
430010,202302,257,188,69,244777.98,89838,334615.98
430020,202302,140,99,41,128900.33,53382.24,182282.57
430030,202302,128,102,26,132804.76,33852,166656.76
430040,202302,3043,1793,1250,2334525.35,1627917.46,3962442.81
430045,202302,73,64,9,83328,11718,95046
430047,202302,8,6,2,7812,2604,10416
430050,202302,89,75,14,97650.68,18228,115878.68
430055,202302,14,12,2,15624,2604,18228
430057,202302,5,3,2,3906,2604,6510
430060,202302,4392,2518,1874,3279868.94,2442576.84,5722445.78
430063,202302,57,46,11,59892,14322,74214
430064,202302,175,139,36,180978.94,48174,229152.94
430066,202302,7,4,3,5208,3906,9114
430070,202302,42,32,10,41664.47,13020,54684.47
430080,202302,86,56,30,72914.08,39060.27,111974.35
430085,202302,26,12,14,15624,18228,33852
430087,202302,32,25,7,32550.38,9114,41664.38
430090,202302,67,57,10,74214.76,14322,88536.76
430100,202302,153,105,48,136710.86,62496,199206.86
430105,202302,176,98,78,127602.66,101556.3,229158.96
430107,202302,20,15,5,19530.53,6510,26040.53
430110,202302,498,267,231,347636.05,302064,649700.05
430120,202302,165,152,13,199206.1,16926,216132.1
430130,202302,835,493,342,641893.63,445285.9,1087179.53
430140,202302,139,129,10,167958.6,13020,180978.6
430150,202302,115,72,43,93744.96,55986,149730.96
430155,202302,31,25,6,32550,7812,40362
430160,202302,3901,2181,1720,2841034.96,2243361.28,5084396.24
430163,202302,451,214,237,278635.79,308579.05,587214.84
430165,202302,31,19,12,24738.59,15624,40362.59
430170,202302,84,70,14,91140,18228,109368
430175,202302,85,65,20,84630,26040.47,110670.47
430180,202302,109,84,25,109368.72,32550,141918.72
430185,202302,27,18,9,23436,11718,35154
430187,202302,86,33,53,42967.55,69006,111973.55
430190,202302,240,121,119,157545.47,156241.59,313787.06
430192,202302,14,10,4,13020.56,5208,18228.56
430195,202302,17,13,4,16926.89,5208,22134.89
430200,202302,157,130,27,169262.63,35154,204416.63
430205,202302,20,20,0,26040,,26040.0
430210,202302,783,574,209,747359.2,272118.9,1019478.1
430215,202302,11,10,1,13020,1302,14322
430220,202302,77,52,25,67704,32550,100254
430222,202302,15,5,10,6510,13020,19530
430223,202302,18,13,5,16926,6510,23436
430225,202302,5,3,2,3906,2604,6510
430230,202302,363,222,141,289045.48,183582,472627.48
430235,202302,54,34,20,44268.96,26040,70308.96
430237,202302,20,15,5,19530.54,6510,26040.54
430240,202302,122,82,40,106764.72,52080,158844.72
430245,202302,67,54,13,70308,16926,87234
430250,202302,190,111,79,145825.92,102858.84,248684.76
430258,202302,13,10,3,13020.19,3906.2,16926.39
430260,202302,37,32,5,41664.1,6510,48174.1
430265,202302,37,33,4,42966,5208,48174
430270,202302,545,381,164,496076.69,213528,709604.69
430280,202302,1118,646,472,841097.08,617148.3,1458245.38
430290,202302,458,239,219,311182.53,285138,596320.53
430300,202302,2268,1235,1033,1608012.56,1346285.14,2954297.70
430310,202302,2300,1124,1176,1463506.68,1532486.22,2995992.90
430320,202302,62,50,12,65100,15624,80724
430330,202302,85,72,13,93744.66,16926,110670.66
430340,202302,73,57,16,74214,20832,95046
430350,202302,1755,1102,653,1434818.87,851509.47,2286328.34
430355,202302,19,17,2,22134,2604,24738
430360,202302,101,48,53,62496,69006,131502
430367,202302,52,38,14,49476,18228,67704
430370,202302,63,55,8,71610,10416,82026
430380,202302,108,78,30,101556.79,39060,140616.79
430390,202302,722,434,288,565005.36,374979.01,939984.37
430400,202302,258,176,82,229153.57,106764,335917.57
430410,202302,53,44,9,57288.2,11718,69006.2
430420,202302,547,352,195,460919.88,253891.49,714811.37
430430,202302,49,46,3,59024.86,3906,62930.86
430435,202302,151,112,39,145824.56,50778,196602.56
430440,202302,621,376,245,489560.98,318991.53,808552.51
430450,202302,1276,1032,244,1343683.17,318992.24,1662675.41
430460,202302,6323,3202,3121,4175654.52,4066205.02,8241859.54
430461,202302,17,15,2,19530,2604,22134
430462,202302,4,2,2,2604.1,2604,5208.1
430463,202302,1296,701,595,914026.47,774697,1688723.47
430465,202302,27,16,11,20832,14322,35154
430466,202302,768,532,236,692691.24,307279.47,999970.71
430467,202302,130,73,57,95046.5,74214,169260.5
430468,202302,161,90,71,117180.8,92442.27,209623.07
430469,202302,21,14,7,18228.7,9114,27342.7
430470,202302,1229,658,571,857116.08,744747.51,1601863.59
430471,202302,79,55,24,71610.95,31248.57,102859.52
430480,202302,144,100,44,130201.79,57288,187489.79
430485,202302,8,8,0,10416.6,,10416.6
430490,202302,71,56,15,72912,19530,92442
430495,202302,32,23,9,29946.2,11718,41664.2
430500,202302,200,133,67,173167,87234,260401
430510,202302,4109,2639,1470,3436036.49,1916555.58,5352592.07
430511,202302,14,14,0,18228,,18228.0
430512,202302,178,121,57,157543.92,74215.1,231759.02
430513,202302,54,41,13,53382,16926,70308
430515,202302,24,22,2,28644,2604,31248
430517,202302,183,153,30,199206.2,39060,238266.2
430520,202302,349,243,106,316392.25,138012.69,454404.94
430530,202302,78,42,36,54684.2,46872,101556.2
430535,202302,480,308,172,401021.62,223947.92,624969.54
430537,202302,8,8,0,10416,,10416.0
430540,202302,82,54,28,70308,36456,106764
430543,202302,446,145,301,188790.96,391902.01,580692.97
430544,202302,54,50,4,65100.93,5208,70308.93
430545,202302,454,222,232,289058.3,302072.87,591131.17
430550,202302,46,37,9,48174.3,11718,59892.3
430558,202302,1,1,0,1302,,1302.0
430560,202302,55,31,24,40362,31248,71610
430570,202302,121,49,72,63800.78,93744,157544.78
430580,202302,125,99,26,128898.44,33852,162750.44
430583,202302,13,13,0,16926,,16926.0
430585,202302,14,11,3,14322,3906,18228
430587,202302,16,10,6,13020,7812.08,20832.08
430590,202302,190,154,36,200509.3,46872.39,247381.69
430593,202302,1,1,0,1302,,1302.0
430595,202302,17,14,3,18228,3906,22134
430597,202302,42,24,18,31248.64,23436,54684.64
430600,202302,226,168,58,218736,76818,295554
430605,202302,185,111,74,144522,96348,240870
430607,202302,32,25,7,32550,9114,41664
430610,202302,1854,883,971,1152286.6,1265548.21,2417834.81
430613,202302,5,5,0,6510,,6510.0
430620,202302,98,68,30,88536.56,39060,127596.56
430630,202302,48,41,7,53383.27,9114,62497.27
430632,202302,31,27,4,35154,5208,40362
430635,202302,35,28,7,37758,9114,46872
430637,202302,64,29,35,37758,45570,83328
430640,202302,178,97,81,126297.94,105462.74,231760.68
430642,202302,19,17,2,22134,2604,24738
430645,202302,33,27,6,35154,7812,42966
430650,202302,246,196,50,255194.38,65100.2,320294.58
430655,202302,8,7,1,9114,1302,10416
430660,202302,1044,513,531,667941,692674.19,1360615.19
430670,202302,69,46,23,59892,29946,89838
430673,202302,81,55,26,71610,33852,105462
430675,202302,8,6,2,7812,2604,10416
430676,202302,675,411,264,535131.84,343730.85,878862.69
430680,202302,260,171,89,222645.36,115878,338523.36
430690,202302,571,346,225,450499.78,292951.07,743450.85
430692,202302,8,6,2,7812.7,2604,10416.7
430693,202302,140,89,51,115878.47,66402.2,182280.67
430695,202302,66,53,13,69006,16926,85932
430697,202302,68,43,25,55986,32550,88536
430700,202302,1413,954,459,1242127.12,598920.31,1841047.43
430705,202302,30,26,4,33852.05,5208,39060.05
430710,202302,279,175,104,227850,135408,363258
430720,202302,102,84,18,109368,23436,132804
430730,202302,149,127,22,165354,28644,193998
430740,202302,83,51,32,66402.2,41664,108066.2
430745,202302,27,17,10,22134,13020,35154
430750,202302,328,212,116,276025.11,151033.28,427058.39
430755,202302,84,46,38,59892.26,49476,109368.26
430760,202302,452,243,209,316391.94,272120.44,588512.38
430770,202302,1758,951,807,1240845.08,1052027.37,2292872.45
430780,202302,358,218,140,283836.8,182280,466116.8
430781,202302,24,24,0,31248,,31248.0
430783,202302,64,48,16,62496,20832,83328
430786,202302,7,5,2,6510,2604,9114
430790,202302,558,348,210,454402.02,273421.96,727823.98
430800,202302,171,127,44,165354,57288,222642
430805,202302,38,31,7,40362,9114.49,49476.49
430807,202302,74,42,32,54684.6,41664,96348.6
430810,202302,82,52,30,67705.19,39060,106765.19
430820,202302,157,101,56,131504.93,72912,204416.93
430825,202302,11,9,2,11718,2604,14322
430830,202302,271,250,21,325502.54,27342,352844.54
430840,202302,144,94,50,122388.11,65100,187488.11
430843,202302,7,4,3,5208,3906,9114
430845,202302,85,50,35,65100,45570,110670
430850,202302,611,430,181,559863.87,235662,795525.87
430860,202302,173,118,55,153637.85,71610.88,225248.73
430865,202302,78,43,35,55986,45570,101556
430870,202302,72,59,13,76818.31,16926,93744.31
430880,202302,182,126,56,164055.31,74214.8,238270.11
430885,202302,11,9,2,11718,2604,14322
430890,202302,348,210,138,273420.56,179676,453096.56
430900,202302,555,378,177,493463.24,230454.96,723918.20
430905,202302,145,62,83,80724.5,108067.85,188792.35
430910,202302,305,163,142,214831.65,184884.8,399716.45
430912,202302,4,4,0,5208.99,,5208.99
430915,202302,44,41,3,53382.74,3906,57288.74
430920,202302,5089,2648,2441,3451758.18,3184755.7,6636513.88
430925,202302,7,6,1,7812,1302,9114
430930,202302,2268,1265,1003,1647064.13,1307215.44,2954279.57
430940,202302,273,173,100,225246.4,130200.6,355447.0
430950,202302,159,127,32,165355.03,41664,207019.03
430955,202302,26,15,11,19530,14322,33852
430957,202302,24,21,3,27342.11,3906,31248.11
430960,202302,273,175,98,227852.3,127596.88,355449.18
430965,202302,107,70,37,91140.18,48174,139314.18
430970,202302,93,73,20,95046,26040,121086
430975,202302,52,45,7,58590.08,9114,67704.08
430980,202302,53,31,22,40362.26,28644,69006.26
430990,202302,99,77,22,100254,28644,128898
430995,202302,111,103,8,134106,10416,144522
431000,202302,302,150,152,195301.2,199206,394507.2
431010,202302,375,221,154,287755.54,200511.51,488267.05
431020,202302,2001,1146,855,1493417.78,1113212.89,2606630.67
431030,202302,40,31,9,40362,11718,52080
431033,202302,511,229,282,298176.2,367179.2,665355.4
431036,202302,12,8,4,10416,5208,15624
431040,202302,151,101,50,131503.13,65100.6,196603.73
431041,202302,44,27,17,35154.37,22134,57288.37
431043,202302,38,22,16,28644.42,20832,49476.42
431046,202302,13,10,3,13020,3906,16926
431050,202302,214,132,82,171865.51,106764,278629.51
431053,202302,76,41,35,53382.13,45571.33,98953.46
431055,202302,65,43,22,55986,28644,84630
431057,202302,18,18,0,23436,,23436.0
431060,202302,1644,1045,599,1361905.72,781202.14,2143107.86
431065,202302,17,8,9,10416,11718,22134
431070,202302,66,57,9,74214.62,11718,85932.62
431075,202302,8,8,0,10416,,10416.0
431080,202302,133,72,61,93745.08,79422,173167.08
431085,202302,36,32,4,41664.34,5208,46872.34
431087,202302,18,13,5,16926,6510,23436
431090,202302,49,39,10,50778.3,14322,65100.3
431100,202302,1327,789,538,1027296.65,703084.28,1730380.93
431110,202302,231,140,91,182282.89,118482,300764.89
431112,202302,28,21,7,27342.33,9114,36456.33
431113,202302,31,20,11,26040.14,14322,40362.14
431115,202302,157,111,46,144522.66,59892,204414.66
431120,202302,611,355,256,462216.79,333313.49,795530.28
431123,202302,6,5,1,6510,1302,7812
431125,202302,97,84,13,110670,16926,127596
431127,202302,5,3,2,3906,2604,6510
431130,202302,742,475,267,618459.96,348937.95,967397.91
431140,202302,859,600,259,781207.52,337218.3,1118425.82
431142,202302,17,16,1,20832.3,1302,22134.3
431150,202302,206,147,59,191396.36,76818,268214.36
431160,202302,40,36,4,48174,5208,53382
431162,202302,6,6,0,7812.67,,7812.67
431164,202302,7,6,1,7812,1302,9114
431170,202302,122,85,37,110670.2,48174,158844.2
431171,202302,79,47,32,61194,41664,102858
431173,202302,7,5,2,6510,2604.8,9114.8
431175,202302,206,109,97,141919.45,126294.47,268213.92
431177,202302,108,75,33,97651.78,42966.31,140618.09
431179,202302,15,10,5,13020,6510,19530
431180,202302,418,260,158,338522.77,205716.64,544239.41
431190,202302,74,54,20,70308.65,26040.7,96349.35
431198,202302,76,51,25,66267.29,32550,98817.29
431200,202302,22,18,4,23436,5208,28644
431205,202302,22,20,2,26040,2604,28644
431210,202302,106,63,43,82026.7,55986,138012.7
431213,202302,32,26,6,33852,7812.56,41664.56
431215,202302,23,22,1,28644,1302,29946
431217,202302,5,4,1,5208,1302,6510
431220,202302,69,58,11,75516.79,14322,89838.79
431225,202302,171,103,68,134106.27,88536,222642.27
431230,202302,102,84,18,109370.87,23436,132806.87
431235,202302,5,4,1,5208,1302,6510
431237,202302,17,12,5,15624.46,6510,22134.46
431238,202302,16,11,5,14322,6510.2,20832.2
431240,202302,1020,628,392,818986.1,510386.4,1329372.5
431242,202302,42,41,1,53382,1302,54684
431244,202302,38,30,8,39061.52,10416,49477.52
431245,202302,53,38,15,50778.48,19530,70308.48
431247,202302,13,10,3,13020,3906,16926
431250,202302,310,148,162,192697.22,210924,403621.22
431260,202302,53,45,8,58590,10416,69006
431261,202302,24,17,7,22134.78,9114,31248.78
431262,202302,13,11,2,14322,2604,16926
431265,202302,153,85,68,110671.28,88536,199207.28
431267,202302,18,15,3,19530,3906,23436
431270,202302,342,262,80,341129.2,104161.23,445290.43
431275,202302,40,36,4,46872,5208,52080
431280,202302,21,15,6,19530,7812,27342
431290,202302,26,23,3,29946.33,3906,33852.33
431295,202302,4,1,3,1302,3906,5208
431300,202302,24,21,3,27342.1,3906,31248.1
431301,202302,7,7,0,9114,,9114.0
431303,202302,57,36,21,46872.2,27342,74214.2
431306,202302,251,127,124,165356.17,161448,326804.17
431308,202302,9,8,1,10416,1302,11718
431310,202302,64,50,14,65100,18228,83328
431320,202302,227,139,88,180978.53,114576,295554.53
431330,202302,221,146,75,190093.5,97650,287743.5
431333,202302,25,21,4,27342,5208,32550
431335,202302,9,6,3,7812,3906,11718
431337,202302,459,225,234,292964.69,304671.23,597635.92
431339,202302,25,18,7,23436,9114,32550
431340,202302,3301,1756,1545,2290172.06,2011601.99,4301774.05
431342,202302,36,25,11,32550,14322,46872
431344,202302,23,22,1,28644,1302,29946
431346,202302,5,4,1,5208,1302,6510
431349,202302,28,26,2,33852,2604,36456
431350,202302,974,546,428,710921.86,557261.96,1268183.82
431360,202302,58,42,16,54684,20832,75516
431365,202302,390,165,225,214833.93,292950.49,507784.42
431370,202302,1260,696,564,906208.29,734329.69,1640537.98
431380,202302,101,88,13,114576.83,16926,131502.83
431390,202302,513,280,233,364561.26,303366.8,667928.06
431395,202302,340,148,192,192697.3,249984,442681.3
431400,202302,37,23,14,29946,18228,48174
431402,202302,100,74,26,96349.16,33852.71,130201.87
431403,202302,28,19,9,24738,11718,36456
431405,202302,764,442,322,575509.02,419253.8,994762.82
431406,202302,37,28,9,36456.86,11718,48174.86
431407,202302,48,36,12,46872,15624,62496
431410,202302,3713,2270,1443,2956915.07,1882711.23,4839626.30
431413,202302,17,13,4,16926,5208,22134
431415,202302,77,55,22,71611.38,28644,100255.38
431417,202302,22,11,11,14322,14322,28644
431420,202302,388,257,131,334617.9,170562.6,505180.5
431430,202302,70,33,37,42967.02,48174,91141.02
431440,202302,9728,6525,3203,8501067.23,4175620.14,12676687.37
431442,202302,28,15,13,19530,16926,36456
431445,202302,28,27,1,35154,1302,36456
431446,202302,5,5,0,6510.7,,6510.7
431447,202302,86,65,21,84630.9,27342,111972.9
431449,202302,63,50,13,65100.7,16926,82026.7
431450,202302,433,285,148,372373.23,192696,565069.23
431454,202302,11,6,5,7812,6510,14322
431455,202302,49,39,10,50778.03,13020,63798.03
431460,202302,524,354,170,460916.35,221340,682256.35
431470,202302,141,104,37,136710.25,48174,184884.25
431475,202302,10,8,2,10416,2604,13020
431477,202302,42,24,18,31248,23436,54684
431478,202302,7,7,0,9114,,9114.0
431480,202302,780,471,309,613256.66,402319.49,1015576.15
431490,202302,32198,17990,14208,23439217.34,18513389.68,41952607.02
431500,202302,76,58,18,75516,23436,98952
431505,202302,28,20,8,26040.85,10416,36456.85
431507,202302,9,8,1,10416,1302,11718
431510,202302,239,168,71,218738.24,92442,311180.24
431513,202302,20,19,1,24738.22,1302,26040.22
431514,202302,7,5,2,6510,2604,9114
431515,202302,82,70,12,91140.04,15624,106764.04
431517,202302,6,4,2,5208,3906,9114
431520,202302,40,32,8,41664.2,10416,52080.2
431530,202302,1448,626,822,815060.33,1070245.13,1885305.46
431531,202302,24,22,2,28644.2,2604,31248.2
431532,202302,36,27,9,35154,11718,46872
431535,202302,29,16,13,20832,16926,37758
431540,202302,142,112,30,145827.12,39060.6,184887.72
431545,202302,14,11,3,14322,3906,18228
431550,202302,366,191,175,248687.89,227850.32,476538.21
431555,202302,15,13,2,16926.26,2604,19530.26
431560,202302,5162,3408,1754,4438695.12,2285060.2,6723755.32
431570,202302,905,479,426,623670.31,554656.67,1178326.98
431575,202302,59,36,23,46872,29946.58,76818.58
431580,202302,83,59,24,76818,31248,108066
431590,202302,147,124,23,161448,29946,191394
431595,202302,17,15,2,19530,2604,22134
431600,202302,261,150,111,195304.63,144522.83,339827.46
431610,202302,120,88,32,114578.47,41664.2,156242.67
431620,202302,37,30,7,39060,9114,48174
431630,202302,125,101,24,131502.79,31248,162750.79
431640,202302,1346,830,516,1080675.82,673135.51,1753811.33
431642,202302,34,30,4,39060,5208,44268
431643,202302,43,17,26,22134,33852,55986
431645,202302,345,201,144,261703.95,187488,449191.95
431647,202302,12,11,1,14322,1302,15624
431650,202302,36,20,16,26040,20832,46872
431660,202302,269,170,99,221340.73,128898,350238.73
431670,202302,230,101,129,131503.09,169260.11,300763.20
431673,202302,15,12,3,15624,3906,19530
431675,202302,29,21,8,27342,10416,37758
431680,202302,1229,883,346,1151010.15,450499.9,1601510.05
431690,202302,5297,3092,2205,4027206.72,2870960.53,6898167.25
431695,202302,21,13,8,16926,10416,27342
431697,202302,4,2,2,2604,2604,5208
431700,202302,196,146,50,190092.55,65100,255192.55
431710,202302,4334,1840,2494,2395713.55,3251108.48,5646822.03
431720,202302,1311,808,503,1051376.46,656208.97,1707585.43
431725,202302,3,1,2,1302,2604,3906
431730,202302,1246,822,424,1071603.4,553360.07,1624963.47
431740,202302,1378,671,707,873655.65,920518.99,1794174.64
431750,202302,1881,1224,657,1594970.19,856722.46,2451692.65
431755,202302,5,4,1,5208,1302,6510
431760,202302,1034,654,380,851534.49,496069.97,1347604.46
431770,202302,421,283,138,368466.89,179676,548142.89
431775,202302,26,19,7,24738,9114,33852
431780,202302,596,360,236,468722.54,307272,775994.54
431790,202302,148,112,36,145824.8,46872.6,192697.4
431795,202302,13,11,2,14322,2604,16926
431800,202302,3221,1685,1536,2195214.01,1999881.73,4195095.74
431805,202302,19,15,4,19530,5208,24738
431810,202302,589,382,207,497370.93,270816.64,768187.57
431820,202302,361,204,157,265609.28,205716,471325.28
431830,202302,2439,1467,972,1912599.11,1265546.79,3178145.90
431840,202302,521,329,192,428368.58,251286.84,679655.42
431842,202302,34,28,6,36456,7812,44268
431843,202302,9,6,3,7812.1,3906.36,11718.46
431844,202302,16,12,4,15624,5208,20832
431845,202302,25,23,2,29946,2604,32550
431846,202302,27,23,4,29946.72,5208,35154.72
431848,202302,14,10,4,13020.6,5208.6,18229.2
431849,202302,6,5,1,6510,1302,7812
431850,202302,841,659,182,858037.15,238268,1096305.15
431860,202302,118,75,43,98952.57,57288,156240.57
431861,202302,3,0,3,,3906,3906.0
431862,202302,69,51,18,66402.65,23436,89838.65
431870,202302,4075,2338,1737,3048100.8,2262909.21,5311010.01
431880,202302,1031,718,313,937450.92,408829.29,1346280.21
431890,202302,1277,733,544,954378.18,708289.08,1662667.26
431900,202302,198,130,68,169260.36,88536,257796.36
431910,202302,46,36,10,46872.1,13020,59892.1
431912,202302,50,33,17,42967.41,23436,66403.41
431915,202302,156,117,39,152335.27,50778,203113.27
431920,202302,157,111,46,145824.95,59892,205716.95
431930,202302,74,60,14,78120,18228,96348
431935,202302,4,3,1,3906,1302,5208
431936,202302,2,2,0,2604,,2604.0
431937,202302,22,17,5,22134.2,6510,28644.2
431940,202302,480,329,151,429666.28,196603.66,626269.94
431950,202302,507,322,185,419257.11,240871,660128.11
431960,202302,770,417,353,544246.06,459606.77,1003852.83
431970,202302,64,57,7,74214,9114,83328
431971,202302,4,3,1,3906,1302,5208
431973,202302,19,16,3,20832.83,3906,24738.83
431975,202302,10,10,0,13020.2,,13020.2
431980,202302,214,120,94,156242.42,122388.6,278631.02
431990,202302,1017,544,473,708310.82,617158.16,1325468.98
432000,202302,2063,1091,972,1420544.71,1266866.52,2687411.23
432010,202302,265,172,93,223945.23,121086.2,345031.43
432020,202302,198,169,29,220041.66,37758.4,257800.06
432023,202302,15,13,2,16926,2604,19530
432026,202302,60,52,8,67704.1,10416,78120.1
432030,202302,55,23,32,29946.17,41664,71610.17
432032,202302,14,11,3,14322,3906,18228
432035,202302,74,54,20,70308.3,26040,96348.3
432040,202302,85,59,26,76818.96,33852,110670.96
432045,202302,3,3,0,3906,,3906.0
432050,202302,84,53,31,69006.19,40362,109368.19
432055,202302,135,92,43,119785.86,55986,175771.86
432057,202302,6,4,2,5209.3,2604,7813.3
432060,202302,32,27,5,35154,6510,41664
432065,202302,32,28,4,36456,5208,41664
432067,202302,85,78,7,101557.1,9114,110671.1
432070,202302,395,311,84,404927.42,109368,514295.42
432080,202302,871,617,254,803367.85,330710.81,1134078.66
432085,202302,24,20,4,26040,5208,31248
432090,202302,289,188,101,244776.46,131502.33,376278.79
432100,202302,176,109,67,141918.21,87234,229152.21
432110,202302,579,385,194,501276.87,252588.32,753865.19
432120,202302,1095,614,481,799444.71,627568.83,1427013.54
432130,202302,541,381,160,496065.25,208320.46,704385.71
432132,202302,21,19,2,24738,2604,27342
432135,202302,84,65,19,84630.95,24738,109368.95
432140,202302,271,207,64,269516.37,83328,352844.37
432143,202302,236,145,91,190094.63,118482.1,308576.73
432145,202302,306,216,90,281234.87,117180,398414.87
432146,202302,16,14,2,18228,2604,20832
432147,202302,100,61,39,80724,50778,131502
432149,202302,15,11,4,14322,5208,19530
432150,202302,1139,715,424,932254.21,553355.06,1485609.27
432160,202302,2134,1087,1047,1416611.54,1364510.66,2781122.20
432162,202302,6,3,3,3906,3906,7812
432163,202302,15,10,5,13020,6510,19530
432166,202302,134,92,42,120112.41,54685.05,174797.46
432170,202302,252,135,117,175776.15,152334.3,328110.45
432180,202302,589,379,210,493458.69,273420,766878.69
432183,202302,13,12,1,15624.43,1302,16926.43
432185,202302,81,66,15,85932.75,19530.13,105462.88
432190,202302,548,322,226,419244.37,294252.8,713497.17
432195,202302,91,72,19,93744.2,24738,118482.2
432200,202302,454,271,183,352847.36,238267.9,591115.26
432210,202302,124,73,51,95046.1,66402,161448.1
432215,202302,31,28,3,36456,3906,40362
432218,202302,20,20,0,26040,,26040.0
432220,202302,674,333,341,433573.49,443985.03,877558.52
432225,202302,19,14,5,18228.2,6510,24738.2
432230,202302,131,84,47,109368,61195.01,170563.01
432232,202302,29,26,3,33852,3906,37758
432234,202302,4,2,2,2604,2604,5208
432235,202302,1,1,0,1302,,1302.0
432237,202302,23,16,7,20832,9114,29946
432240,202302,4783,2659,2124,3466021.21,2768085.75,6234106.96
432250,202302,1201,804,397,1046819.1,516895.78,1563714.88
432252,202302,52,48,4,62496,5208,67704
432253,202302,73,55,18,71611.67,23436,95047.67
432254,202302,31,15,16,19530,20832,40362
432255,202302,11,10,1,13020,1302,14322
432260,202302,913,733,180,955685.43,234360.1,1190045.53
432270,202302,228,168,60,218748.75,78120.97,296869.72
432280,202302,169,126,43,164056.25,55986,220042.25
432285,202302,1,1,0,1302,,1302.0
432290,202302,60,49,11,63798,14322,78120
432300,202302,5442,2910,2532,3792745.86,3301896.25,7094642.11
432310,202302,129,109,20,142005.45,26040,168045.45
432320,202302,19,14,5,18228,6510,24738
432330,202302,19,13,6,16926,7812,24738
432335,202302,10,8,2,10416,2604,13020
432340,202302,36,28,8,36456,10416,46872
432345,202302,128,83,45,108067.83,58590,166657.83
432350,202302,26,25,1,32550,1302,33852
432360,202302,5,4,1,5208.7,1302,6510.7
432370,202302,27,27,0,35154.83,,35154.83
432375,202302,27,25,2,32550,2604,35154
432377,202302,8,8,0,10416.98,,10416.98
432380,202302,226,104,122,135410.12,158847.45,294257.57
500020,202302,305,158,147,205718.49,191394.7,397113.19
500025,202302,146,69,77,89839.98,100255.12,190095.10
500060,202302,1558,990,568,1290320.08,740848.82,2031168.90
500070,202302,793,383,410,498681.82,533830.46,1032512.28
500080,202302,147,116,31,151035.47,40362,191397.47
500085,202302,141,103,38,134109.7,49476,183585.7
500090,202302,408,189,219,246082.76,286441.47,532524.23
500100,202302,713,368,345,479151.15,449193.83,928344.98
500110,202302,2424,1167,1257,1519484.59,1636642.86,3156127.45
500124,202302,270,144,126,187488.81,164053.39,351542.20
500150,202302,337,140,197,182284.6,256495.14,438779.74
500190,202302,597,397,200,516911.69,260402.16,777313.85
500200,202302,214,173,41,225249.94,53382,278631.94
500210,202302,1801,567,1234,738250.43,1606684.43,2344934.86
500215,202302,209,120,89,156246.36,115878.2,272124.56
500220,202302,741,463,278,602845.94,361958.44,964804.38
500230,202302,256,146,110,190095.64,143220.58,333316.22
500240,202302,681,427,254,555969.59,330712.68,886682.27
500260,202302,623,252,371,328109.55,483042.76,811152.31
500270,202302,32738,14240,18498,18551019.36,24093923.22,42644942.58
500280,202302,209,71,138,92442.24,179676.66,272118.90
500290,202302,1236,767,469,998663.35,610642.44,1609305.79
500295,202302,511,334,177,434875.83,230455.09,665330.92
500310,202302,118,38,80,49476.1,104160.87,153636.97
500315,202302,889,484,405,630168.87,527311.76,1157480.63
500320,202302,3907,1832,2075,2385367.7,2701669.6,5087037.3
500325,202302,995,562,433,733055.71,563773.79,1296829.50
500330,202302,1602,782,820,1018126.69,1067658.17,2085784.86
500345,202302,324,225,99,292955.27,130200.21,423155.48
500348,202302,257,157,100,204416.81,130200,334616.81
500350,202302,103,49,54,65102.37,71610.45,136712.82
500370,202302,6129,2771,3358,3609287.5,4376063.47,7985350.97
500375,202302,380,250,130,325505.15,169260.73,494765.88
500380,202302,679,380,299,496080.63,389299.89,885380.52
500390,202302,78,33,45,42966.1,58591.2,101557.3
500400,202302,232,143,89,186190.94,115878.97,302069.91
500410,202302,475,207,268,269525.03,348940.18,618465.21
500430,202302,623,388,235,505189.89,305971.39,811161.28
500440,202302,213,121,92,157542.14,119784.2,277326.34
500450,202302,452,193,259,251289.86,337218.8,588508.66
500460,202302,285,153,132,199210.27,171864.96,371075.23
500470,202302,448,321,127,417950.88,165355.71,583306.59
500480,202302,103,56,47,72912.65,61195.68,134108.33
500490,202302,94,40,54,52080.88,70310.08,122390.96
500500,202302,1539,567,972,738254.86,1265550.05,2003804.91
500510,202302,38,32,6,41664.51,7812,49476.51
500515,202302,124,81,43,105464.3,55986.62,161450.92
500520,202302,297,150,147,195305.57,191394.16,386699.73
500525,202302,101,53,48,69006.14,62496,131502.14
500540,202302,958,408,550,531236.8,716109.36,1247346.16
500560,202302,909,511,398,665336.95,518200.59,1183537.54
500568,202302,1151,547,604,712208.76,786415.95,1498624.71
500570,202302,1263,720,543,937464.1,706991.89,1644455.99
500580,202302,315,173,142,225254.12,184885.87,410139.99
500600,202302,411,198,213,257802.58,277327.23,535129.81
500620,202302,1054,726,328,946582.57,427061.3,1373643.87
500625,202302,87,66,21,85932.9,27342.7,113275.6
500627,202302,40,17,23,22134.15,29946,52080.15
500630,202302,1647,937,710,1220768.27,925730.28,2146498.55
500635,202302,527,307,220,399715.08,286440,686155.08
500640,202302,367,202,165,264316.64,214832.58,479149.22
500660,202302,6333,2255,4078,2936078.94,5310897,8246975.94
500690,202302,662,237,425,308580.05,553350.04,861930.09
500710,202302,426,207,219,269521.38,285142.87,554664.25
500720,202302,1003,542,461,705705.34,601528.96,1307234.30
500730,202302,147,88,59,114584.76,76818,191402.76
500740,202302,1029,442,587,575500.38,764282.24,1339782.62
500750,202302,201,74,127,96350.97,165356.31,261707.28
500755,202302,112,84,28,109372.44,36456.93,145829.37
500769,202302,792,434,358,565080.54,466121.52,1031202.06
500770,202302,444,233,211,303367.47,274722,578089.47
500780,202302,140,95,45,123695.35,58591.33,182286.68
500790,202302,1139,546,593,710919.64,772089,1483008.64
500793,202302,312,160,152,208325.18,199209.26,407534.44
500795,202302,198,127,71,165355.83,92442.99,257798.82
500797,202302,48,33,15,42967.12,19530,62497.12
500800,202302,446,197,249,257803.27,324199.69,582002.96
500830,202302,2498,1301,1197,1697873,1558503.22,3256376.22
500840,202302,115,81,34,105467.6,44268.02,149735.62
510010,202302,172,92,80,119784,104160,223944
510020,202302,577,274,303,356760.01,394509.75,751269.76
510025,202302,1835,1038,797,1351516.97,1040310.57,2391827.54
510030,202302,673,358,315,466131.29,410136.69,876267.98
510035,202302,136,69,67,89838.17,87234,177072.17
510040,202302,420,196,224,255194.07,291649.08,546843.15
510050,202302,386,204,182,265615.6,236967.12,502582.72
510060,202302,135,60,75,78121.96,97650,175771.96
510080,202302,262,111,151,144523.89,196602,341125.89
510100,202302,64,27,37,35154.05,48174.43,83328.48
510120,202302,31,19,12,24738.99,15624.74,40363.73
510125,202302,405,258,147,335917.01,191394,527311.01
510130,202302,554,329,225,428367.69,292951.13,721318.82
510140,202302,460,153,307,200509.4,399715.88,600225.28
510160,202302,110,42,68,54686,88536.64,143222.64
510170,202302,806,473,333,615861.01,433572.98,1049433.99
510180,202302,3125,1412,1713,1838474.29,2231655.99,4070130.28
510185,202302,34,17,17,22134,22134,44268
510190,202302,260,90,170,117181.3,222644.29,339825.59
510250,202302,2838,1719,1119,2239487.33,1456945.17,3696432.50
510260,202302,171,121,50,157544.6,66403.31,223947.91
510263,202302,502,283,219,368474.13,285142.62,653616.75
510267,202302,636,356,280,463526.48,364564.43,828090.91
510268,202302,76,36,40,46872.01,52080,98952.01
510269,202302,82,37,45,48174,58591.4,106765.4
510270,202302,398,192,206,249985.62,268212.2,518197.82
510279,202302,209,155,54,201812.65,70308,272120.65
510285,202302,190,76,114,98953.86,148428,247381.86
510300,202302,550,287,263,373678.27,342426.56,716104.83
510305,202302,197,89,108,115878.2,140616,256494.2
510310,202302,109,56,53,72912.98,69006.1,141919.08
510320,202302,836,521,315,678356.53,412737.2,1091093.73
510325,202302,470,197,273,256496.42,355448.25,611944.67
510330,202302,476,264,212,345039.4,276026.08,621065.48
510335,202302,702,413,289,537742.84,377584.37,915327.21
510336,202302,51,34,17,44269.29,22134.7,66403.99
510337,202302,101,41,60,53382,78120,131502
510340,202302,19532,8314,11218,10831553,14623043.6,25454596.6
510343,202302,57,44,13,57288,16926,74214
510345,202302,153,93,60,121087.34,78121.28,199208.62
510350,202302,676,354,322,462221.99,420551.95,882773.94
510360,202302,228,142,86,184887.71,111972,296859.71
510370,202302,177,75,102,97650,132804,230454
510380,202302,82,60,22,78120,28644,106764
510385,202302,59,30,29,39060.2,37758,76818.2
510390,202302,100,47,53,61194.59,69006.6,130201.19
510395,202302,59,42,17,54684,22134,76818
510410,202302,831,524,307,682270.51,399720.28,1081990.79
510420,202302,577,278,299,361959.82,390600,752559.82
510450,202302,52,29,23,37758,29946,67704
510452,202302,61,29,32,37758,41664,79422
510454,202302,57,26,31,33852.47,40362.03,74214.50
510455,202302,122,70,52,91140,67704.97,158844.97
510460,202302,201,85,116,110672.42,151032,261704.42
510480,202302,780,454,326,591127.31,424459.61,1015586.92
510490,202302,343,166,177,216134.87,230454.5,446589.37
510500,202302,244,182,62,236964.9,80724,317688.9
510510,202302,892,521,371,679660.22,485650.88,1165311.10
510515,202302,1348,690,658,898399.5,860630.16,1759029.66
510517,202302,287,128,159,166659.61,207018,373677.61
510520,202302,235,146,89,190096.45,115879.2,305975.65
510523,202302,117,92,25,119784,32550,152334
510525,202302,930,569,361,740856.64,470025.81,1210882.45
510530,202302,27,15,12,19530,15624,35154
510550,202302,251,115,136,149733.02,177073.83,326806.85
510558,202302,327,163,164,212473.96,213528,426001.96
510560,202302,406,238,168,309881.05,218738.95,528620.00
510562,202302,693,491,202,639301.09,263005.62,902306.71
510590,202302,737,358,379,466126.37,493460.8,959587.17
510600,202302,223,117,106,152339.27,138012.76,290352.03
510610,202302,227,101,126,131504.43,164053.59,295558.02
510615,202302,235,111,124,144522.61,161448.06,305970.67
510617,202302,26,11,15,14322,19530,33852
510618,202302,131,65,66,84630.98,85933.64,170564.62
510619,202302,82,58,24,75517.66,31248,106765.66
510620,202302,166,87,79,113274,102858,216132
510621,202302,183,117,66,152334.17,85932.23,238266.40
510622,202302,520,276,244,359366.87,318993.89,678360.76
510623,202302,291,199,92,259102.06,119784.2,378886.26
510624,202302,93,45,48,58590.97,62496.53,121087.50
510625,202302,552,345,207,449204.69,269519.89,718724.58
510626,202302,116,65,51,84632.09,66402,151034.09
510627,202302,97,65,32,84631.45,41664.2,126295.65
510628,202302,174,104,70,135409.45,91140,226549.45
510629,202302,301,182,119,236965.74,154961.43,391927.17
510630,202302,467,239,228,311190.25,296857.57,608047.82
510631,202302,22,9,13,11718.13,16926,28644.13
510637,202302,365,215,150,279932.56,195300,475232.56
510642,202302,1224,657,567,855436.49,738241.63,1593678.12
510645,202302,12,2,10,2604,13020,15624
510650,202302,1306,843,463,1097629.49,604132.41,1701761.90
510665,202302,100,46,54,59893.19,70308.08,130201.27
510670,202302,59,34,25,44268.46,32550,76818.46
510675,202302,1142,729,413,949188.35,537730.49,1486918.84
510677,202302,351,183,168,238269.04,218737.09,457006.13
510680,202302,91,54,37,70310.35,48174,118484.35
510682,202302,197,93,104,121086.52,135408,256494.52
510685,202302,57,41,16,53382.76,20832,74214.76
510700,202302,610,343,267,446602.63,347636.23,794238.86
510704,202302,1324,666,658,867172.4,858035.94,1725208.34
510706,202302,161,82,79,106766.29,102859.54,209625.83
510710,202302,445,315,130,410138.4,169260.6,579399.0
510715,202302,57,39,18,50778,23436.23,74214.23
510718,202302,258,114,144,148431.01,187492.98,335923.99
510719,202302,51,22,29,28644,37758,66402
510720,202302,185,129,56,169261.39,74214,243475.39
510724,202302,82,30,52,39060,67704,106764
510726,202302,68,32,36,41664.7,46872.62,88537.32
510729,202302,16,7,9,9114,11718.3,20832.3
510730,202302,467,252,215,328106.03,279930,608036.03
510735,202302,118,45,73,58590.99,95046,153636.99
510740,202302,25,14,11,18229.31,14322.4,32551.71
510757,202302,27,22,5,28644.74,6510.16,35154.90
510760,202302,8060,4055,4005,5283658.73,5224977.85,10508636.58
510770,202302,750,340,410,442689.09,533821.63,976510.72
510774,202302,18,7,11,9114.19,14322,23436.19
510775,202302,122,93,29,121086,37758,158844
510776,202302,35,12,23,15624,29946.2,45570.2
510777,202302,188,85,103,110670,134106,244776
510779,202302,42,24,18,31248,23436,54684
510780,202302,277,141,136,183592.56,177072.2,360664.76
510785,202302,350,188,162,244780.71,210924.52,455705.23
510787,202302,217,106,111,138017.1,144523.24,282540.34
510788,202302,8,4,4,5208.9,5208,10416.9
510790,202302,2815,1457,1358,1899730.08,1768126.92,3667857.00
510792,202302,1171,654,517,852928.63,673146.8,1526075.43
510794,202302,116,63,53,82027.48,69006,151033.48
510795,202302,2423,1378,1045,1795499.41,1360599.97,3156099.38
510800,202302,198,110,88,144524.18,114576.14,259100.32
510805,202302,215,141,74,183582.4,96348,279930.4
510810,202302,108,42,66,55988.27,85932.42,141920.69
510820,202302,265,134,131,174470.5,170565.71,345036.21
510830,202302,80,39,41,50778,53382,104160
510835,202302,24,17,7,22134.7,9114,31248.7
510840,202302,9914,4465,5449,5818890.69,7101195.34,12920086.03
510850,202302,215,85,130,110671.54,171864.26,282535.80
510860,202302,425,212,213,276025.9,277326.91,553352.81
510880,202302,80,56,24,72912.2,31248,104160.2
510885,202302,72,42,30,54685.21,39060.6,93745.81
510890,202302,79,39,40,50778.86,52080.95,102859.81
510895,202302,183,108,75,140616.96,97650,238266.96
520005,202302,156,60,96,78123.94,124994.46,203118.40
520010,202302,322,139,183,182282.59,238270.72,420553.31
520013,202302,778,531,247,691379.78,321596.85,1012976.63
520015,202302,40,27,13,35154,16926,52080
520017,202302,87,55,32,71610.84,41664,113274.84
520020,202302,11,5,6,6510,7812,14322
520025,202302,3106,1659,1447,2161431.39,1884061.88,4045493.27
520030,202302,895,462,433,601538.24,563769.78,1165308.02
520050,202302,62,46,16,59892.2,20832.21,80724.41
520055,202302,80,53,27,69006,35154.2,104160.2
520060,202302,178,118,60,153641.08,78121.25,231762.33
520080,202302,576,414,162,539030.91,210924,749954.91
520082,202302,16,12,4,15624,5208,20832
520085,202302,108,83,25,108067.38,32550,140617.38
520090,202302,84,60,24,78120.75,31248,109368.75
520110,202302,9858,4186,5672,5454238.78,7392839.05,12847077.83
520120,202302,13,7,6,9114,7812,16926
520130,202302,877,603,274,785117.67,356750.02,1141867.69
520140,202302,12811,6937,5874,9037521.34,7651956.67,16689478.01
520145,202302,58,31,27,40362.2,35154,75516.2
520150,202302,139,109,30,141923.04,39060,180983.04
520160,202302,40,24,16,31248,20832,52080
520170,202302,220,127,93,165362.89,121089.32,286452.21
520180,202302,205,95,110,123691.36,143221.94,266913.30
520215,202302,196,139,57,180978.96,74214.2,255193.16
520235,202302,88,67,21,87234.8,27342,114576.8
520250,202302,156,82,74,106765.23,96348,203113.23
520260,202302,117,71,46,92444.79,59893.42,152338.21
520280,202302,46,34,12,44268,15624,59892
520310,202302,27,15,12,19531.8,15624.3,35156.1
520320,202302,189,112,77,145825.81,100254.97,246080.78
520330,202302,885,489,396,637998.15,515597.13,1153595.28
520340,202302,303,176,127,229158.96,165357.28,394516.24
520350,202302,499,254,245,330712.47,320294.2,651006.67
520355,202302,105,62,43,80725.43,57288,138013.43
520357,202302,35,28,7,36456,9114,45570
520360,202302,20,7,13,9114.2,16926.28,26040.48
520380,202302,145,79,66,102858,87234,190092
520390,202302,240,106,134,138015.2,174468,312483.2
520393,202302,17,13,4,16926.1,5208,22134.1
520396,202302,76,56,20,72912,26040,98952
520400,202302,213,131,82,170567.89,106767.3,277335.19
520410,202302,194,97,97,126298.55,126294,252592.55
520420,202302,19,15,4,19530.61,5208,24738.61
520425,202302,259,128,131,166658.47,170562.98,337221.45
520430,202302,556,265,291,345031.68,378882.5,723914.18
520440,202302,678,485,193,631484.86,251287.33,882772.19
520450,202302,2303,970,1333,1265584.96,1736885.58,3002470.54
520455,202302,60,37,23,48176.84,29946.51,78123.35
520460,202302,46,28,18,36456.69,23437.45,59894.14
520465,202302,38,31,7,40362,9114,49476
520470,202302,466,290,176,377582.89,229152.2,606735.09
520480,202302,79,49,30,63798.97,39060,102858.97
520485,202302,113,42,71,54684.72,92442.1,147126.82
520490,202302,523,379,144,493469.53,187491.21,680960.74
520495,202302,168,99,69,128898.1,89838,218736.1
520500,202302,193,153,40,199208.37,52080,251288.37
520505,202302,190,110,80,143220,104160,247380
520510,202302,2115,994,1121,1295558.06,1459553.39,2755111.45
520520,202302,65,42,23,54684.97,29946,84630.97
520530,202302,214,170,44,221344.85,57288,278632.85
520540,202302,780,530,250,690069.12,325502.98,1015572.10
520545,202302,155,88,67,114580.61,87234.5,201815.11
520547,202302,77,42,35,54686.72,45570.61,100257.33
520549,202302,1585,755,830,983049.61,1081979.54,2065029.15
520551,202302,349,180,169,234368.7,220040.38,454409.08
520552,202302,42,29,13,37759,16926,54685
520570,202302,15,11,4,14322,5208,19530
520580,202302,284,176,108,229156.85,140616.16,369773.01
520590,202302,155,87,68,113276.96,88536,201812.96
520620,202302,1280,594,686,773399.57,894483.65,1667883.22
520630,202302,48,27,21,35154,27342.18,62496.18
520640,202302,397,227,170,295559.61,221340.9,516900.51
520650,202302,68,33,35,42966,45570,88536
520660,202302,43,23,20,29946.58,26040.38,55986.96
520670,202302,50,38,12,49476.44,15624,65100.44
520680,202302,28,16,12,20832,15624,36456
520690,202302,38,10,28,13020,36456,49476
520710,202302,37,29,8,37758,10416,48174
520725,202302,195,145,50,188793.08,65100,253893.08
520735,202302,59,38,21,49477.14,27342.2,76819.34
520740,202302,492,241,251,315089.52,326803.15,641892.67
520750,202302,42,26,16,33852,20832,54684
520753,202302,78,57,21,74214.2,27342,101556.2
520760,202302,106,72,34,93746,44268.98,138014.98
520780,202302,269,211,58,274726.15,75517.47,350243.62
520790,202302,150,91,59,118482.8,76818,195300.8
520800,202302,3585,2005,1580,2610596.8,2057192.76,4667789.56
520810,202302,140,107,33,139317.32,42966.89,182284.21
520815,202302,7,5,2,6510.96,2604,9114.96
520830,202302,135,92,43,119787.99,55986.05,175774.04
520840,202302,412,268,144,350241.24,187488,537729.24
520850,202302,115,65,50,84632.65,65100,149732.65
520860,202302,1912,1199,713,1561139.67,928332.2,2489471.87
520870,202302,35200,15840,19360,20634864.53,25231777.31,45866641.84
520880,202302,1338,704,634,917954.75,826792.04,1744746.79
520890,202302,869,549,320,716121.95,416641.28,1132763.23
520910,202302,1015,532,483,693988.67,628868.54,1322857.21
520915,202302,95,67,28,87236.58,36456.6,123693.18
520920,202302,516,242,274,315094.81,356756.44,671851.25
520929,202302,16,13,3,16926.84,3906,20832.84
520940,202302,64,46,18,59894.07,24738.1,84632.17
520945,202302,17,10,7,13020,9114,22134
520960,202302,48,29,19,37758,24738,62496
520970,202302,428,246,182,320300.85,238268.33,558569.18
520980,202302,89,64,25,83328,32550,115878
520990,202302,441,310,131,403622.11,170562.2,574184.31
520993,202302,125,63,62,82029.38,80724.9,162754.28
520995,202302,267,145,122,190094.97,158844,348938.97
521000,202302,1672,918,754,1197862.65,983020.34,2180882.99
521010,202302,658,351,307,457008.96,399716.18,856725.14
521015,202302,12,7,5,9114,6510,15624
521020,202302,1470,1036,434,1350210.78,565078.55,1915289.33
521030,202302,75,51,24,66402.93,31248,97650.93
521040,202302,1024,678,346,882781.46,451795.62,1334577.08
521056,202302,60,39,21,50778,27342,78120
521060,202302,125,79,46,102859.38,59892.76,162752.14
521080,202302,332,260,72,338539.15,93744.4,432283.55
521090,202302,605,407,198,531222.14,257796.89,789019.03
521100,202302,275,192,83,249987.74,108066.4,358054.14
521120,202302,1107,781,326,1016893.88,424454.46,1441348.34
521130,202302,330,233,97,303373.24,126294.6,429667.84
521140,202302,196,109,87,141922.74,114576.69,256499.43
521150,202302,2677,1140,1537,1485640.74,2003808.17,3489448.91
521160,202302,25,10,15,13020,19530,32550
521170,202302,236,124,112,161448.63,145824.2,307272.83
521180,202302,1245,785,460,1022096.34,600230.34,1622326.68
521190,202302,2695,1115,1580,1451770.66,2059783.65,3511554.31
521200,202302,61,42,19,54684.2,24738,79422.2
521205,202302,15,12,3,15625.13,3906,19531.13
521210,202302,136,83,53,108068.19,69006,177074.19
521220,202302,774,531,243,692675.68,316388.41,1009064.09
521225,202302,19,12,7,15625.48,9114.93,24740.41
521230,202302,106,70,36,91141.4,46873.63,138015.03
521250,202302,6728,3679,3049,4792868.11,3972463.56,8765331.67
521260,202302,43,19,24,24738,31248,55986
521270,202302,126,95,31,123690.9,40362,164052.9
521280,202302,431,271,160,352845.91,209622,562467.91
521290,202302,30,17,13,22134.85,16926,39060.85
521295,202302,106,72,34,93744.84,44268,138012.84
521300,202302,243,136,107,177074.39,139314.29,316388.68
521305,202302,43,31,12,40363.29,15624,55987.29
521308,202302,1036,791,245,1031219.07,318994.49,1350213.56
521310,202302,1456,806,650,1050748.86,846315.32,1897064.18
521340,202302,20,16,4,20832,5208,26040
521350,202302,112,83,29,108071.05,37758,145829.05
521370,202302,171,112,59,145824.8,76818,222642.8
521375,202302,205,97,108,126296.97,140617.38,266914.35
521377,202302,49,37,12,48174.16,15624.1,63798.26
521380,202302,1132,676,456,880191.17,593717.87,1473909.04
521385,202302,12,7,5,9114,6510,15624
521390,202302,105,83,22,108068.27,29946.49,138014.76
521400,202302,407,288,119,375596.6,154939.78,530536.38
521405,202302,162,99,63,128901.17,82026.66,210927.83
521410,202302,83,60,23,78121.27,29946,108067.27
521440,202302,221,152,69,197911.94,89838.8,287750.74
521450,202302,816,444,372,578100.24,484346.93,1062447.17
521460,202302,1138,783,355,1019506.55,462214.44,1481720.99
521470,202302,13,9,4,11718,5208,16926
521480,202302,41,27,14,35155.68,18228.1,53383.78
521483,202302,339,220,119,286442.89,154939.47,441382.36
521486,202302,304,200,104,261702.5,135408.84,397111.34
521487,202302,23,11,12,14322,15624,29946
521490,202302,24,14,10,18228,13020,31248
521500,202302,153,67,86,87234.14,111972.29,199206.43
521520,202302,45,33,12,42966,15624,58590
521523,202302,1176,637,539,830694.04,701783.3,1532477.34
521525,202302,61,43,18,55986,23436,79422
521530,202302,247,143,104,186186.64,135408.49,321595.13
521540,202302,44,22,22,28644,28644,57288
521550,202302,118,55,63,71610.33,82027.89,153638.22
521560,202302,940,622,318,809865.7,415341.77,1225207.47
521565,202302,73,51,22,66403.16,28644,95047.16
521570,202302,591,374,217,488259.17,282535.07,770794.24
521580,202302,46,28,18,36456,23436,59892
521590,202302,41,21,20,27342,26040,53382
521600,202302,26,12,14,15624,18228,33852
521630,202302,222,115,107,149737.15,139320.04,289057.19
521640,202302,326,172,154,223947.02,200509.19,424456.21
521645,202302,40,20,20,26040,26040,52080
521680,202302,261,159,102,207021.01,132805.27,339826.28
521690,202302,15,13,2,16926,2604,19530
521710,202302,1157,547,610,712205.89,794225.8,1506431.69
521720,202302,626,410,216,533825.66,281232.51,815058.17
521730,202302,728,342,386,445291.16,502575.24,947866.40
521740,202302,946,431,515,561169.58,670535.57,1231705.15
521760,202302,2505,1280,1225,1666724.44,1594990.63,3261715.07
521770,202302,869,525,344,683559.54,447890.7,1131450.24
521800,202302,2058,1385,673,1803311.02,877550.12,2680861.14
521805,202302,35,21,14,27342,18228,45570
521810,202302,95,53,42,69006.36,54684.19,123690.55
521830,202302,1045,760,285,989550.02,371076.91,1360626.93
521839,202302,72,41,31,53382,40362.59,93744.59
521850,202302,1216,604,612,786432.33,796836.63,1583268.96
521860,202302,340,211,129,274726.36,167958,442684.36
521870,202302,87,55,32,71610,41664,113274
521878,202302,35,14,21,18228,27342.81,45570.81
521880,202302,5281,2293,2988,2985585.73,3894319.25,6879904.98
521890,202302,652,445,207,579401.26,269516.69,848917.95
521900,202302,281,219,62,285139,80724.2,365863.2
521910,202302,182,128,54,166663.38,70309.69,236973.07
521920,202302,37,22,15,28644,19530,48174
521925,202302,56,30,26,39060,33852,72912
521930,202302,1301,720,581,937472.12,756472.87,1693944.99
521935,202302,35,25,10,32552.05,13020,45572.05
521940,202302,249,112,137,145825.77,179677.26,325503.03
521945,202302,20,13,7,16926,9114,26040
521950,202302,23,15,8,19530,10416,29946
521960,202302,70,55,15,71610,19530,91140
521970,202302,415,272,143,354146.59,186186.89,540333.48
521971,202302,113,59,54,76818.8,70308,147126.8
521973,202302,39,17,22,22134.6,28644,50778.6
521975,202302,1709,891,818,1161423.86,1065055.95,2226479.81
521980,202302,241,165,76,214832.07,98952,313784.07
521990,202302,82,55,27,71611.45,36456,108067.45
522000,202302,293,196,97,254744.9,127596.79,382341.69
522005,202302,19,11,8,14322,10416,24738
522010,202302,1202,671,531,873675.06,692672.12,1566347.18
522015,202302,56,34,22,44268,28644,72912
522020,202302,919,548,371,713505.62,483047.46,1196553.08
522026,202302,28,19,9,24738,11718,36456
522028,202302,22,19,3,24738,3906,28644
522040,202302,867,375,492,488265.62,640590.58,1128856.20
522045,202302,2915,1705,1210,2219993.34,1579343.17,3799336.51
522050,202302,165,73,92,95050.17,119785.32,214835.49
522060,202302,562,349,213,455712.18,277327.11,733039.29
522068,202302,113,80,33,104160.89,42966,147126.89
522070,202302,19,16,3,20832,3906,24738
522100,202302,40,25,15,32550,19530,52080
522108,202302,41,33,8,42967.29,10416,53383.29
522119,202302,63,36,27,46873.52,35154,82027.52
522130,202302,81,30,51,39061.09,66403.15,105464.24
522140,202302,4490,2347,2143,3055898.24,2794113.92,5850012.16
522145,202302,50,35,15,45570.2,19530,65100.2
522150,202302,108,73,35,95046.54,45570.84,140617.38
522155,202302,56,37,19,48174.9,24738,72912.9
522157,202302,15,8,7,10416,9114,19530
522160,202302,1723,1024,699,1334585.5,911407.81,2245993.31
522170,202302,428,298,130,387998.66,169260.8,557259.46
522180,202302,31,12,19,15624,24738,40362
522185,202302,2680,1156,1524,1506479.14,1986901.62,3493380.76
522190,202302,77,45,32,58590.67,41664,100254.67
522200,202302,339,197,142,256495.68,184884.24,441379.92
522205,202302,145,100,45,130204.16,58590.1,188794.26
522220,202302,142,110,32,143220.2,41664,184884.2
522230,202302,29,26,3,33852.41,3906,37758.41
530010,202302,59571,30173,29398,39312794.43,38323911.35,77636705.78
110001,202303,534,435,99,566377.35,128898.17,695275.52
110002,202303,3036,1935,1101,2519440.12,1434817.17,3954257.29
110003,202303,80,63,17,82027.96,22134,104161.96
110004,202303,2209,1511,698,1967361.67,908804.02,2876165.69
110005,202303,458,358,100,467423.84,130200.2,597624.04
110006,202303,443,330,113,429665.84,147126,576791.84
110007,202303,80,64,16,83328,20832,104160
110008,202303,275,158,117,205718.16,152334.6,358052.76
110009,202303,975,748,227,973907.18,296856.91,1270764.09
110010,202303,1733,977,756,1272082.41,985615.73,2257698.14
110011,202303,1752,1353,399,1762958.22,519507.4,2282465.62
110012,202303,4283,2456,1827,3200382.44,2382684.58,5583067.02
110013,202303,756,600,156,781225.65,203116.04,984341.69
110014,202303,360,319,41,415345.18,53382,468727.18
110015,202303,1408,1071,337,1395765.31,440081.92,1835847.23
110018,202303,1060,663,397,863247.52,516896.35,1380143.87
110020,202303,17184,9512,7672,12393056.28,9999513.81,22392570.09
110025,202303,665,487,178,634078.61,231756.4,865835.01
110026,202303,34,22,12,28644.74,15624,44268.74
110028,202303,1669,1178,491,1533796.7,639291.04,2173087.74
110029,202303,131,118,13,153637.61,16926,170563.61
110030,202303,2505,1615,890,2102563.44,1158786.56,3261350.00
110032,202303,341,263,78,342434.91,101559.56,443994.47
110033,202303,694,495,199,644521.79,259105.48,903627.27
110034,202303,333,250,83,325502.54,108066.8,433569.34
110037,202303,94,81,13,105463.1,16926,122389.1
110040,202303,415,288,127,374977.6,165354.1,540331.7
110045,202303,1007,730,277,950487.29,363262.81,1313750.10
110050,202303,94,84,10,109370.93,13020.13,122391.06
110060,202303,56,37,19,48174.92,24738,72912.92
110070,202303,108,70,38,91141.06,49476,140617.06
110080,202303,564,323,241,420552.7,313782.84,734335.54
110090,202303,25,20,5,26040,6510,32550
110092,202303,125,59,66,76819.3,85932,162751.3
110094,202303,216,149,67,194000.7,87234,281234.7
110100,202303,53,39,14,50778.68,18228.06,69006.74
110110,202303,120,70,50,91142.96,65100.1,156243.06
110120,202303,69,60,9,78122.12,11718,89840.12
110130,202303,265,218,47,283844.1,61194.27,345038.37
110140,202303,266,189,77,246081.49,100254.1,346335.59
110143,202303,53,43,10,55986,13020,69006
110145,202303,43,31,12,40362,15624,55986
110146,202303,29,12,17,15624.2,22134,37758.2
110147,202303,41,25,16,32550,20832.58,53382.58
110148,202303,32,25,7,32550.71,9114,41664.71
110149,202303,305,211,94,276025.11,122388,398413.11
110150,202303,140,110,30,143221.1,39060,182281.1
110155,202303,12,10,2,13020,2604,15624
110160,202303,66,51,15,66403.21,20832,87235.21
110170,202303,225,168,57,218739.96,74214,292953.96
110175,202303,68,54,14,70308.8,18228,88536.8
110180,202303,88,69,19,89838.88,24738,114576.88
120001,202303,228,163,65,214838.41,87234.52,302072.93
120005,202303,228,131,97,170566.03,126294.1,296860.13
120010,202303,1203,736,467,958287.55,608036.11,1566323.66
120013,202303,176,120,56,156243.08,72912.1,229155.18
120017,202303,143,88,55,114576.7,71610,186186.7
120020,202303,3521,2835,686,3693863.53,893183.47,4587047.00
120025,202303,600,324,276,421892.63,360672.45,782565.08
120030,202303,1222,1055,167,1373678.52,217442.45,1591120.97
120032,202303,46,41,5,53383.1,6510,59893.1
120033,202303,225,196,29,255200.84,37758.55,292959.39
120034,202303,185,138,47,179679.37,61194,240873.37
120035,202303,57,50,7,65100.1,9114,74214.1
120038,202303,419,272,147,354158.37,192698.43,546856.80
120039,202303,35,32,3,41665.1,3906,45571.1
120040,202303,15235,10195,5040,13279316.07,6565023.53,19844339.60
120042,202303,47,44,3,57290.05,3906,61196.05
120043,202303,17,4,13,5208,16926,22134
120045,202303,555,350,205,455718.39,266912.53,722630.92
120050,202303,1331,1018,313,1325501.39,407539.62,1733041.01
120060,202303,1521,1270,251,1653600.99,326809.34,1980410.33
120070,202303,427,309,118,402333.59,153636.92,555970.51
120080,202303,204,134,70,174473.94,91140.55,265614.49
130002,202303,163,117,46,152334.95,61194,213528.95
130006,202303,109,73,36,95046,46872,141918
130008,202303,131,77,54,100254.71,70308,170562.71
130010,202303,173,109,64,141918.2,83328.3,225246.5
130014,202303,312,217,95,282861.89,123691,406552.89
130020,202303,147,100,47,130201.5,61194,191395.5
130030,202303,1014,566,448,736937.31,583297.42,1320234.73
130040,202303,408,208,200,270817.51,260400,531217.51
130050,202303,569,303,266,394520.79,347646.01,742166.80
130060,202303,901,616,285,802036.28,371070.7,1173106.98
130063,202303,611,376,235,489552.1,305970,795522.1
130068,202303,238,151,87,196604.57,113274.31,309878.88
130070,202303,1408,926,482,1205681.53,627569.54,1833251.07
130080,202303,737,508,229,661424.77,298161.29,959586.06
130083,202303,90,59,31,76819.24,40362,117181.24
130090,202303,317,180,137,234360.61,178374,412734.61
130100,202303,1350,682,668,887979.35,869746.9,1757726.25
130110,202303,834,361,473,471327.53,618451.3,1089778.83
130115,202303,148,75,73,97650,95046,192696
130120,202303,1734,1083,651,1411385.11,848906.24,2260291.35
130130,202303,650,441,209,574182.27,272118.95,846301.22
130140,202303,1568,1212,356,1578035.08,463513.32,2041548.40
130150,202303,435,387,48,503874.48,62496,566370.48
130160,202303,470,298,172,387997.4,223944,611941.4
130165,202303,144,127,17,165355.44,22134,187489.44
130170,202303,1195,819,376,1066284.5,489561.77,1555846.27
130180,202303,280,214,66,278631.39,85932.2,364563.59
130185,202303,2363,1162,1201,1512965.99,1568934.91,3081900.90
130190,202303,3447,2151,1296,2800685.56,1688718.27,4489403.83
130195,202303,295,237,58,308574.59,75516,384090.59
130200,202303,225,133,92,173169.01,119784,292953.01
130210,202303,95,45,50,58590,65100,123690
130220,202303,212,155,57,201811.6,74214,276025.6
130230,202303,371,249,122,324198,158844,483042
130240,202303,1376,898,478,1171809.74,624961.5,1796771.24
130250,202303,5007,3243,1764,4223796.43,2296764.47,6520560.90
130255,202303,448,230,218,299460.52,283836.85,583297.37
130260,202303,67467,31217,36250,40671072.1,47250936.86,87922008.96
130270,202303,1563,1075,488,1399780.03,635379.33,2035159.36
130280,202303,144,84,60,109368.1,78120,187488.1
130290,202303,2091,1339,752,1743418.67,979112.18,2722530.85
130300,202303,431,295,136,384091.9,177074.09,561165.99
130310,202303,977,541,436,704386,568975,1273361
130320,202303,565,306,259,398413.26,337218,735631.26
130330,202303,808,540,268,703084.6,348937.18,1052021.78
130340,202303,3662,1992,1670,2594984.79,2174369.86,4769354.65
130350,202303,472,330,142,429660.2,184884,614544.2
130353,202303,1005,467,538,608051.17,701787.64,1309838.81
130356,202303,864,401,463,522109.86,602830.63,1124940.49
130360,202303,108,85,23,110670.2,29946.7,140616.9
130370,202303,703,558,145,726517.4,188790,915307.4
130380,202303,678,532,146,692668,190093.69,882761.69
130390,202303,498,408,90,531216.99,117180,648396.99
130395,202303,173,67,106,87234.89,138012,225246.89
130400,202303,103,79,24,102860.85,31248,134108.85
130406,202303,2280,1338,942,1742091.63,1227791,2969882.63
130410,202303,445,235,210,305970,273420,579390
130420,202303,2864,2328,536,3033761.15,700480.15,3734241.30
130423,202303,227,152,75,197908.1,97650,295558.1
130426,202303,193,107,86,139314,113274,252588
130430,202303,450,264,186,343728.72,242172,585900.72
130440,202303,206,73,133,95051.05,174471.6,269522.65
140002,202303,54,16,38,22134.2,49476.64,71610.84
140005,202303,229,134,95,174471.9,123692,298163.9
140010,202303,13043,7505,5538,9777263.83,7215879.07,16993142.90
140015,202303,233,72,161,93746.58,210925,304671.58
140017,202303,156,85,71,110681.29,92445.67,203126.96
140020,202303,462,311,151,404937.75,196607.35,601545.10
140023,202303,76,45,31,58590,40362.59,98952.59
140028,202303,26,14,12,18228.84,15625.07,33853.91
140030,202303,424,271,153,352854.78,199208.27,552063.05
140040,202303,81,54,27,70309.28,35154,105463.28
140045,202303,373,109,264,141919.34,345034,486953.34
140047,202303,617,394,223,513002.42,290347.89,803350.31
140050,202303,147,92,55,122392.01,71611.59,194003.60
140060,202303,89,61,28,79423.35,36456.2,115879.55
140070,202303,22,20,2,26040.2,2604,28644.2
150010,202303,5392,3244,2148,4223818.58,2798031.3,7021849.88
150013,202303,178,121,57,157543.76,74214.99,231758.75
150020,202303,1201,676,525,880171.88,683551.67,1563723.55
150030,202303,723,321,402,417956.34,523407.68,941364.02
150034,202303,220,126,94,164053.13,122388.7,286441.83
150040,202303,1750,998,752,1302060.06,980430.36,2282490.42
150050,202303,787,467,320,608043.61,416641.64,1024685.25
150060,202303,5225,3244,1981,4223718.49,2581147.91,6804866.40
150070,202303,512,278,234,361964.37,304669.75,666634.12
150080,202303,19069,8846,10223,11520722.72,13312018.42,24832741.14
150085,202303,488,298,190,388006.43,247384.12,635390.55
150090,202303,773,613,160,798148.99,208322.97,1006471.96
150095,202303,84,57,27,74214.98,35156.28,109371.26
150100,202303,79,47,32,61194,41664.55,102858.55
150110,202303,213,125,88,162751.29,114576.1,277327.39
150120,202303,415,296,119,385402.27,154938.66,540340.93
150125,202303,44,19,25,24738,32550,57288
150130,202303,2562,1251,1311,1630179.6,1713681.29,3343860.89
150140,202303,64758,27643,37115,36004671.5,48347811.31,84352482.81
150145,202303,274,148,126,192698.76,164052.55,356751.31
150150,202303,3907,1704,2203,2218689.62,2868362.34,5087051.96
150157,202303,376,270,106,352852.95,138013.26,490866.21
150160,202303,162,121,41,157542.67,53382,210924.67
150170,202303,4369,3152,1217,4106628.08,1584555.94,5691184.02
150172,202303,398,277,121,361963.65,157543.7,519507.35
150175,202303,92,53,39,69007,50778.7,119785.7
150178,202303,826,559,267,727844.79,347639.88,1075484.67
150180,202303,3506,1769,1737,2303301.39,2261588.64,4564890.03
150190,202303,411,275,136,358061.49,177074.68,535136.17
150195,202303,141,78,63,101556.8,82026.64,183583.44
150200,202303,195,95,100,123690,130200.2,253890.2
150210,202303,3402,2620,782,3411381.57,1018179.18,4429560.75
150215,202303,733,430,303,559886.36,394516.99,954403.35
150220,202303,3708,2443,1265,3180886.15,1648367.7,4829253.85
150230,202303,1491,1186,305,1544215.02,397117.14,1941332.16
150240,202303,7872,4333,3539,5641830.88,4610507.78,10252338.66
150250,202303,85,47,38,61196.31,49476.34,110672.65
150260,202303,132,90,42,117185.46,54684.8,171870.26
150270,202303,2244,1454,790,1893154.4,1028587.51,2921741.91
150275,202303,579,377,202,490863.96,263005.08,753869.04
150276,202303,118,39,79,50778.2,102858.99,153637.19
150277,202303,911,404,507,526023.19,661432.24,1187455.43
150280,202303,345,237,108,308576.81,140616,449192.81
150285,202303,161,81,80,105464.84,103951.68,209416.52
150290,202303,1391,790,601,1028611.41,782510.11,1811121.52
150293,202303,898,427,471,555974.58,614554.42,1170529.00
150295,202303,618,293,325,381504.08,423154.18,804658.26
150300,202303,100,47,53,61194.1,69006.6,130200.7
150304,202303,209,122,87,158847.05,113277.51,272124.56
150307,202303,463,378,85,492169.64,110670.5,602840.14
150309,202303,622,439,183,571610.76,238269.4,809880.16
150310,202303,295,196,99,255195.69,128898,384093.69
150320,202303,2032,1401,631,1824131.55,821572.35,2645703.90
150330,202303,2261,1294,967,1686109.59,1260342.7,2946452.29
150340,202303,207,133,74,173166.63,96348.42,269515.05
150345,202303,696,383,313,498676.03,407526,906202.03
150350,202303,436,347,89,451824.56,115881.43,567705.99
150360,202303,5320,3077,2243,4006378.49,2924327.51,6930706.00
150370,202303,875,585,290,763009.58,377588.14,1140597.72
150375,202303,204,82,122,106766.29,158844.68,265610.97
150380,202303,1605,1068,537,1390576.23,703085.92,2093662.15
150390,202303,960,551,409,717440.34,532525.47,1249965.81
150400,202303,125,107,18,139314.4,23436,162750.4
150405,202303,1737,1100,637,1432229.31,830680.11,2262909.42
150410,202303,108,68,40,88536.9,52080.2,140617.1
150420,202303,8368,4464,3904,5812637.54,5084462.05,10897099.59
150430,202303,695,430,265,559908.04,345041.86,904949.90
150440,202303,486,295,191,384105.47,248686.01,632791.48
150442,202303,2624,1400,1224,1822878.94,1593677.09,3416556.03
150445,202303,570,376,194,489559.69,252588.8,742148.49
150450,202303,254,146,108,190093.15,140616.22,330709.37
150460,202303,737,554,183,721330.23,238268.59,959598.82
150470,202303,1345,798,547,1040333.46,712200.7,1752534.16
150475,202303,251,189,62,246088.16,80726.46,326814.62
150480,202303,1545,1091,454,1420553.06,593720.43,2014273.49
150490,202303,608,364,244,475235.62,317688,792923.62
150495,202303,368,273,95,355446.23,123690,479136.23
150497,202303,294,189,105,246079.92,136710.3,382790.22
150500,202303,283,165,118,214832.42,153636.1,368468.52
150503,202303,1468,739,729,963515.3,949172.99,1912688.29
150506,202303,945,652,293,848920.76,381487.12,1230407.88
150510,202303,1404,767,637,998666.93,829381.58,1828048.51
150520,202303,344,236,108,307273.87,140617.2,447891.07
150530,202303,2137,1221,916,1589882.92,1194003,2783885.92
150540,202303,241,177,64,230457.84,83328.81,313786.65
150543,202303,955,495,460,645809.07,598928.82,1244737.89
150548,202303,459,333,126,433571.91,164053.03,597624.94
150549,202303,84,56,28,72914.5,36456.26,109370.76
150550,202303,3401,1709,1692,2225193.51,2203009.61,4428203.12
150553,202303,4048,2249,1799,2929643.48,2343649.63,5273293.11
150555,202303,143,78,65,101556.2,84632.13,186188.33
150560,202303,77,38,39,49477.11,50778,100255.11
150563,202303,132,67,65,87238.83,84631.82,171870.65
150565,202303,229,135,94,175773.15,122388.38,298161.53
150570,202303,431,285,146,372373.26,190092,562465.26
150580,202303,1840,915,925,1191344.73,1205653.68,2396998.41
150590,202303,893,596,297,776022.65,386696.8,1162719.45
150600,202303,536,340,196,442690.88,255196.65,697887.53
150610,202303,194,150,44,195304.37,57288,252592.37
150611,202303,156,106,50,138012,65100,203112
150613,202303,3670,2030,1640,2643161.37,2140612.73,4783774.10
150616,202303,634,340,294,443989.54,384092.35,828081.89
150618,202303,1474,762,712,993434.71,927025.59,1920460.30
150619,202303,422,321,101,417947.01,131507.05,549454.06
150620,202303,1353,766,587,997361.89,765582.43,1762944.32
150630,202303,191,125,66,162761.45,87235.39,249996.84
150635,202303,491,217,274,282546.95,356753.72,639300.67
150640,202303,49,23,26,29946.58,33852,63798.58
150650,202303,2618,1495,1123,1949185.48,1464788.17,3413973.65
150655,202303,289,205,84,266910.82,109368,376278.82
150658,202303,70,39,31,50778,40362,91140
150660,202303,660,408,252,531227.04,328107.29,859334.33
150670,202303,1206,441,765,574192.38,996038.29,1570230.67
150680,202303,12044,6298,5746,8208610.36,7487997.11,15696607.47
150690,202303,45,22,23,28644.95,29946,58590.95
150700,202303,594,395,199,514314.03,259102.4,773416.43
150710,202303,307,173,134,225252.54,174469.31,399721.85
150715,202303,864,548,316,713517.05,411434.92,1124951.97
150720,202303,450,341,109,443990.88,141918.73,585909.61
150730,202303,1232,573,659,746068.65,858026.39,1604095.04
150740,202303,268,170,98,221341.27,127596,348937.27
150745,202303,859,482,377,628891.82,490860.44,1119752.26
150746,202303,71,35,36,45571.68,46872,92443.68
150747,202303,272,183,89,238271.89,115878.3,354150.19
150750,202303,152,82,70,106769.87,91144.88,197914.75
150760,202303,1988,1306,682,1700447.67,887971.4,2588419.07
150770,202303,423,248,175,324199.68,227850.2,552049.88
150775,202303,101,53,48,69006.48,62496.7,131503.18
150780,202303,221,128,93,167962.19,121086.7,289048.89
150790,202303,760,450,310,585915.07,403623.53,989538.60
150795,202303,1850,1132,718,1473895.27,934848.23,2408743.50
150796,202303,327,189,138,246079.88,179676.01,425755.89
150797,202303,433,198,235,257803.81,305972.91,563776.72
150800,202303,1769,976,793,1270772.69,1032487.23,2303259.92
150803,202303,369,271,98,352853.7,127597.95,480451.65
150805,202303,217,129,88,167960.18,114576.6,282536.78
150808,202303,1181,584,597,760375.37,778598.71,1538974.08
150810,202303,3332,2240,1092,2917874.91,1423094.18,4340969.09
150812,202303,562,291,271,378889.64,352844.2,731733.84
150815,202303,1321,816,505,1062446.94,657512.69,1719959.63
150820,202303,1791,1078,713,1403615.08,929648.33,2333263.41
150830,202303,598,452,146,588520.43,190093.5,778613.93
150835,202303,256,156,100,204417.34,130200,334617.34
150840,202303,1553,883,670,1151003.7,873654.12,2024657.82
160005,202303,70,47,23,61194.95,29946.12,91141.07
160010,202303,218,136,82,177078.24,106765.45,283843.69
160015,202303,181,121,60,157554.69,78121.21,235675.90
160020,202303,148,74,74,96350.07,96348.92,192698.99
160021,202303,65,32,33,41666.16,42966.77,84632.93
160023,202303,77,48,29,62499.26,37758.44,100257.70
160025,202303,28,14,14,18229.11,18228.12,36457.23
160027,202303,1565,861,704,1121080.22,916616.91,2037697.13
160030,202303,18445,9477,8968,12346166.02,11679186.5,24025352.52
160040,202303,363,224,139,292964.15,180979.73,473943.88
160050,202303,827,372,455,484365.21,592423.3,1076788.51
160053,202303,312,188,124,244787.87,161451.33,406239.20
160055,202303,25,18,7,23438.2,9116.22,32554.42
160060,202303,7229,3943,3286,5134059.73,4279776.2,9413835.93
160070,202303,190,112,78,145828.59,101557.85,247386.44
160080,202303,150,78,72,101556.81,93744.05,195300.86
170025,202303,26,14,12,18228,15624.71,33852.71
170030,202303,169,136,33,177078.18,42966,220044.18
170035,202303,206,101,105,131505.84,138013.86,269519.70
170040,202303,187,139,48,180978,62496,243474
170070,202303,334,211,123,274730.77,160146.47,434877.24
170100,202303,366,265,101,345042.31,131502.8,476545.11
170105,202303,40,35,5,45571.21,6510,52081.21
170110,202303,116,72,44,93744.99,57288.1,151033.09
170130,202303,83,40,43,52080,55986,108066
170190,202303,106,62,44,82026.4,57288,139314.4
170200,202303,351,237,114,308576.79,148428.2,457004.99
170210,202303,7093,3880,3213,5054213.22,4189895.21,9244108.43
170215,202303,156,93,63,121091.18,82026.85,203118.03
170220,202303,1361,969,392,1261669.27,510391.57,1772060.84
170230,202303,148,99,49,128901.8,63798.3,192700.1
170240,202303,500,345,155,449215.03,201812.72,651027.75
170255,202303,1037,809,228,1053337.87,296858.87,1350196.74
170270,202303,45,32,13,41664,16926,58590
170290,202303,142,88,54,114577.32,70308,184885.32
170300,202303,120,81,39,105462.84,50778,156240.84
170305,202303,59,43,16,55986.8,20832,76818.8
170307,202303,57,41,16,53384.06,20832.9,74216.96
170310,202303,122,77,45,100256.92,58590,158846.92
170320,202303,39,25,14,32550.2,18228,50778.2
170330,202303,33,23,10,29947.72,13020.1,42967.82
170360,202303,33,19,14,24739.05,18229.46,42968.51
170370,202303,78,45,33,58592.3,42966.2,101558.5
170380,202303,86,64,22,83329.06,28644,111973.06
170382,202303,40,32,8,41664,10416,52080
170384,202303,145,111,34,144523.13,44268.26,188791.39
170386,202303,68,29,39,37758.61,50778,88536.61
170388,202303,46,21,25,27342.34,32550,59892.34
170389,202303,27,20,7,26041.09,9114,35155.09
170390,202303,85,50,35,65100.05,45570.28,110670.33
170410,202303,23,21,2,27344.04,2604,29948.04
170460,202303,15,9,6,11718.22,7812,19530.22
170510,202303,33,24,9,31249.3,11718,42967.3
170550,202303,1630,945,685,1230425.06,891879.58,2122304.64
170555,202303,115,85,30,110674.22,39060,149734.22
170560,202303,102,75,27,97650.24,35154.77,132805.01
170600,202303,40,14,26,18228.88,33852,52080.88
170610,202303,190,103,87,134111.31,113274.1,247385.41
170625,202303,31,18,13,23436.99,16926,40362.99
170650,202303,99,68,31,89838.04,40362.2,130200.24
170700,202303,592,435,157,567678.47,204414,772092.47
170710,202303,141,84,57,109371.93,74217.6,183589.53
170720,202303,111,86,25,111972.81,32550,144522.81
170730,202303,116,68,48,88537.76,62496,151033.76
170740,202303,86,63,23,82026,29946,111972
170755,202303,50,26,24,33853.78,31248.76,65102.54
170765,202303,139,82,57,106767.11,74215.01,180982.12
170770,202303,194,125,69,162751.98,89838.73,252590.71
170820,202303,612,405,207,527319.13,270816.92,798136.05
170825,202303,50,30,20,39060.7,26040,65100.7
170830,202303,93,70,23,91140.62,29946.33,121086.95
170900,202303,172,130,42,169262.55,54685.93,223948.48
170930,202303,1035,564,471,734355.91,613248.92,1347604.83
170950,202303,3405,1617,1788,2105395.95,2330605.54,4436001.49
170980,202303,15,10,5,13021.81,6510,19531.81
171050,202303,152,117,35,152334,45570.2,197904.2
171070,202303,64,51,13,66402.87,16927.05,83329.92
171090,202303,49,37,12,48174.2,15624,63798.2
171110,202303,24,18,6,23437.08,7812,31249.08
171150,202303,44,29,15,37758,19530,57288
171180,202303,24,11,13,14322,16926.27,31248.27
171190,202303,188,107,81,139316.6,105462,244778.6
171195,202303,57,48,9,62498.25,13020,75518.25
171200,202303,31,15,16,19530.51,20832,40362.51
171215,202303,10,8,2,10416,2604,13020
171240,202303,63,50,13,65100,16926,82026
171245,202303,55,47,8,61196.43,10416,71612.43
171250,202303,80,45,35,58590.2,45570,104160.2
171270,202303,11,7,4,9114.6,5208.22,14322.82
171280,202303,46,37,9,48177,11718.1,59895.1
171320,202303,1091,641,450,834596.44,587204.37,1421800.81
171330,202303,450,231,219,300764.75,285138.21,585902.96
171360,202303,107,77,30,100254.63,39060,139314.63
171370,202303,32,19,13,24738,16926.38,41664.38
171380,202303,136,114,22,148430.23,28644,177074.23
171395,202303,42,26,16,33852,20832,54684
171420,202303,269,175,94,227851.46,122388.2,350239.66
171430,202303,73,58,15,75516.2,19530.57,95046.77
171488,202303,219,123,96,160146.72,124992,285138.72
171500,202303,66,37,29,48174.2,37758,85932.2
171510,202303,78,50,28,66402,36456.52,102858.52
171515,202303,40,33,7,42969.41,9114,52083.41
171525,202303,25,22,3,28646.26,3906,32552.26
171550,202303,17,11,6,14322.9,7812,22134.9
171570,202303,59,30,29,39060,37758.1,76818.1
171575,202303,267,182,85,236965.39,110670,347635.39
171610,202303,2032,1039,993,1352812,1292912.27,2645724.27
171620,202303,158,113,45,147127.4,58590.89,205718.29
171630,202303,51,28,23,36456,29946,66402
171650,202303,359,248,111,322905.45,144524.55,467430.00
171660,202303,264,152,112,197911.66,145825.3,343736.96
171665,202303,92,57,35,74215.02,45570.33,119785.35
171670,202303,458,287,171,373681.63,222644.42,596326.05
171700,202303,62,53,9,69007.03,11718,80725.03
171720,202303,26,9,17,11718.7,22134.2,33852.9
171750,202303,103,51,52,66402,67704.7,134106.7
171780,202303,76,59,17,76818.83,22134,98952.83
171790,202303,99,78,21,101556,27342,128898
171800,202303,33,26,7,35154,9114,44268
171820,202303,2209,1273,936,1658791.53,1218678.31,2877469.84
171830,202303,34,26,8,33852.2,10416,44268.2
171840,202303,53,35,18,45570.54,23436,69006.54
171845,202303,34,23,11,29946.49,14322,44268.49
171850,202303,47,38,9,49476.89,11719,61195.89
171855,202303,74,53,21,69006.1,27342,96348.1
171865,202303,6,4,2,5208,2604,7812
171870,202303,36,24,12,31248.2,15624.45,46872.65
171875,202303,90,66,24,85932,31248,117180
171880,202303,48,30,18,39060,23436.72,62496.72
171884,202303,57,30,27,39060.17,35154,74214.17
171886,202303,136,61,75,80724.9,97650,178374.9
171888,202303,28,21,7,27343.13,9114.1,36457.23
171889,202303,14,7,7,9114,9114,18228
171890,202303,59,48,11,62497.62,14322,76819.62
171900,202303,25,17,8,22135.41,10416,32551.41
172000,202303,36,32,4,41664.2,5208.2,46872.4
172010,202303,55,41,14,53382,18228.11,71610.11
172015,202303,19,14,5,18229.16,6510,24739.16
172020,202303,125,77,48,100255.38,62496,162751.38
172025,202303,41,27,14,35154.46,18228,53382.46
172030,202303,57,36,21,46873.63,27342,74215.63
172049,202303,83,55,28,71610.6,36456.2,108066.8
172065,202303,113,74,39,96350.59,50778.46,147129.05
172080,202303,125,77,48,100256.44,62497.47,162753.91
172085,202303,28,15,13,19530,16926,36456
172090,202303,471,342,129,445290.91,167958.94,613249.85
172093,202303,16,14,2,18228,2604,20832
172097,202303,18,9,9,11718,11718,23436
172100,202303,6360,3682,2678,4796728.25,3489425.83,8286154.08
172110,202303,85,56,29,72913.01,37758.29,110671.30
172120,202303,1777,1474,303,1919227.85,394511.58,2313739.43
172125,202303,15,11,4,14322,5208,19530
172130,202303,29,18,11,24738.59,14322.78,39061.37
172208,202303,197,129,68,167958,88537.38,256495.38
172210,202303,353,179,174,233063.92,226550.07,459613.99
210005,202303,3176,2003,1173,2608032.83,1527278.07,4135310.90
210010,202303,150,102,48,132805.31,62496,195301.31
210015,202303,44,32,12,41664.39,15624,57288.39
210020,202303,385,230,155,299467.54,201813.22,501280.76
210030,202303,321,220,101,286464.46,131506.28,417970.74
210040,202303,123,101,22,131502.1,28644,160146.1
210043,202303,271,223,48,290350.34,62496.88,352847.22
210047,202303,499,318,181,414037.67,235662,649699.67
210050,202303,274,195,79,253890.02,102858.2,356748.22
210055,202303,58,48,10,62496.79,13020,75516.79
210060,202303,548,442,106,575513.38,138014.81,713528.19
210070,202303,469,362,107,471324.7,139314.8,610639.5
210080,202303,150,139,11,180980.24,14322,195302.24
210083,202303,299,155,144,201811.77,187488.19,389299.96
210087,202303,10,6,4,7812,5208,13020
210090,202303,496,362,134,471347.4,174469.7,645817.1
210095,202303,427,342,85,445293.74,110670.86,555964.60
210100,202303,710,568,142,739550.96,184884.2,924435.16
210110,202303,113,80,33,104161.31,42966.9,147128.21
210120,202303,4875,3930,945,5119716.78,1230406.79,6350123.57
210125,202303,178,112,66,145826.01,85934.35,231760.36
210130,202303,460,284,176,369777.71,229152.89,598930.60
210135,202303,31,24,7,31249.53,9114,40363.53
210140,202303,4653,3550,1103,4623554.36,1436126,6059680.36
210150,202303,382,248,134,322909.66,177076.31,499985.97
210160,202303,3290,2808,482,3656113.21,628872.94,4284986.15
210170,202303,1285,1041,244,1355442.48,317690.23,1673132.71
210173,202303,128,117,11,152335.48,14322,166657.48
210177,202303,292,171,121,222645.24,157542,380187.24
210180,202303,33,18,15,23436.2,19530,42966.2
210190,202303,460,318,142,414036.99,184884.7,598921.69
210193,202303,8,6,2,7812.59,2604,10416.59
210197,202303,66,49,17,63799.1,22134.2,85933.3
210200,202303,626,536,90,697899.38,117180.59,815079.97
210203,202303,231,167,64,217438.57,83329.82,300768.39
210207,202303,319,274,45,356753.01,58590,415343.01
210210,202303,718,671,47,873656.49,61194.6,934851.09
210215,202303,81,73,8,95049.41,10416,105465.41
210220,202303,354,305,49,397128.22,63798.01,460926.23
210230,202303,329,270,59,351545.74,76818,428363.74
210232,202303,1240,904,336,1177039.48,438775.35,1615814.83
210235,202303,186,141,45,183586.85,58590.4,242177.25
210237,202303,50,27,23,35155.97,29946,65101.97
210240,202303,76,65,11,84630.21,14322.21,98952.42
210250,202303,183,160,23,208321.33,29946.2,238267.53
210255,202303,396,297,99,386710.11,128899.95,515610.06
210260,202303,397,283,114,368469.02,148428,516897.02
210270,202303,637,455,182,592422.21,236965.28,829387.49
210275,202303,107,86,21,111972.24,27342,139314.24
210280,202303,1098,730,368,950479.18,481742.02,1432221.20
210290,202303,541,367,174,477845.94,226550.09,704396.03
210300,202303,4941,3225,1716,4199053.2,2234240.05,6433293.25
210310,202303,128,79,49,102858.2,63798,166656.2
210312,202303,120,86,34,111973.45,44268.8,156242.25
210315,202303,127,109,18,141918.18,23436,165354.18
210317,202303,149,114,35,148428.57,45570,193998.57
210320,202303,2465,2130,335,2774656.37,436172.16,3210828.53
210325,202303,159,95,64,123692.44,83328.93,207021.37
210330,202303,4213,2514,1699,3274600.27,2212103.51,5486703.78
210340,202303,1224,951,273,1238251.1,355450.74,1593701.84
210350,202303,688,578,110,752574.66,143220,895794.66
210355,202303,152,129,23,167958.2,29946,197904.2
210360,202303,2053,1497,556,1949145.91,723916.46,2673062.37
210370,202303,1259,670,589,872358.37,766882.68,1639241.05
210375,202303,192,95,97,123699.52,126295.48,249995.00
210380,202303,744,590,154,768190.1,200510.92,968701.02
210390,202303,196,165,31,214833.08,40362,255195.08
210400,202303,419,369,50,480455.02,65100,545555.02
210405,202303,1118,796,322,1036420.45,419245.24,1455665.69
210407,202303,71,59,12,76818,15624,92442
210408,202303,47,43,4,55988.68,5208,61196.68
210409,202303,347,303,44,394510.43,57288.56,451798.99
210410,202303,447,359,88,467420.5,115878,583298.5
210420,202303,206,167,39,217435.96,50778.4,268214.36
210430,202303,58,42,16,54684.5,20832,75516.5
210440,202303,374,259,115,337230.14,149730,486960.14
210450,202303,110,97,13,126299.4,16926,143225.4
210455,202303,245,131,114,170568.37,148430.65,318999.02
210460,202303,318,218,100,283843.56,130200.25,414043.81
210462,202303,77,64,13,83329.64,16926.33,100255.97
210465,202303,127,102,25,132805.1,32550,165355.1
210467,202303,562,429,133,558574.15,173167.32,731741.47
210470,202303,44,38,6,49476,7812,57288
210480,202303,1366,1001,365,1303341.93,475235.86,1778577.79
210490,202303,177,128,49,166657.89,63798.2,230456.09
210500,202303,504,329,175,428377.62,227852.54,656230.16
210510,202303,529,436,93,567675.83,121087.7,688763.53
210515,202303,336,225,111,292953.73,144522.2,437475.93
210520,202303,399,362,37,471332.89,48174.24,519507.13
210530,202303,10008,5097,4911,6636646.17,6400826.97,13037473.14
210535,202303,122,94,28,122390.19,36456,158846.19
210540,202303,1564,1074,490,1398397.91,637984.74,2036382.65
210542,202303,1096,561,535,730448.91,697883.94,1428332.85
210545,202303,22,20,2,26040.71,2604,28644.71
210547,202303,128,112,16,145826.06,20832.31,166658.37
210550,202303,595,421,174,548169.27,226549.71,774718.98
210560,202303,165,144,21,187490.05,27342.18,214832.23
210565,202303,24,17,7,22134.89,9114.43,31249.32
210570,202303,1314,1116,198,1454372.01,257797.34,1712169.35
210580,202303,129,112,17,145824.78,22134.86,167959.64
210590,202303,686,576,110,749956.58,143220,893176.58
210592,202303,49,44,5,57288,6510,63798
210594,202303,113,99,14,128899.1,18228,147127.1
210596,202303,117,103,14,134107.31,18228,152335.31
210598,202303,141,108,33,140616.9,42966.31,183583.21
210600,202303,305,265,40,345041.81,52080.7,397122.51
210610,202303,250,231,19,300768.59,24738.16,325506.75
210620,202303,43,30,13,39060.45,16926,55986.45
210630,202303,92,81,11,105463.4,14322.2,119785.6
210632,202303,985,715,270,930933.82,351540,1282473.82
210635,202303,25,22,3,28644.9,3906.2,32551.1
210637,202303,120,87,33,113274.2,42966,156240.2
210640,202303,573,512,61,666626.41,79422,746048.41
210650,202303,414,353,61,459614.87,79422.7,539037.57
210660,202303,378,302,76,393225.78,98953.5,492179.28
210663,202303,79,65,14,84630.8,18228,102858.8
210667,202303,85,43,42,55987.52,54685.17,110672.69
210670,202303,266,236,30,307279.08,39060.6,346339.68
210675,202303,479,285,194,371081.18,252589.84,623671.02
210680,202303,234,154,80,200510.86,104160,304670.86
210690,202303,100,91,9,118483.52,11718,130201.52
210700,202303,155,116,39,151033.07,50778.2,201811.27
210710,202303,255,161,94,209624.03,122388.6,332012.63
210720,202303,128,116,12,151032.08,15624,166656.08
210725,202303,60,51,9,66407.02,11718,78125.02
210730,202303,20,14,6,18228.06,7812,26040.06
210735,202303,293,213,80,277327.16,104160,381487.16
210740,202303,518,450,68,585928.21,88536,674464.21
210745,202303,155,122,33,158844.25,42966,201810.25
210750,202303,2792,1520,1272,1981701.67,1656161.17,3637862.84
210760,202303,256,203,53,264308.21,69006.19,333314.40
210770,202303,248,204,44,265627.11,57290.44,322917.55
210780,202303,418,317,101,412751.74,131503.9,544255.64
210790,202303,192,164,28,213531.71,36456,249987.71
210800,202303,183,138,45,179687.71,58591.69,238279.40
210805,202303,71,64,7,83328,9114,92442
210810,202303,436,361,75,470038.01,97650,567688.01
210820,202303,1964,1665,299,2167913.95,389301.29,2557215.24
210825,202303,152,94,58,122390.44,75516.2,197906.64
210830,202303,702,501,201,652311.48,261703.14,914014.62
210840,202303,207,152,55,197905.34,71610,269515.34
210845,202303,226,176,50,229156.27,65100,294256.27
210850,202303,725,525,200,683579.89,260402.91,943982.80
210860,202303,3446,2119,1327,2758996.31,1727761.58,4486757.89
210870,202303,400,316,84,411454.38,109368.2,520822.58
210880,202303,88,72,16,93746.69,20832,114578.69
210890,202303,315,278,37,361972.15,48174,410146.15
210900,202303,710,456,254,593734.88,330713.37,924448.25
210905,202303,76,40,36,52080.2,46872.2,98952.4
210910,202303,2111,1590,521,2070238.37,679652.27,2749890.64
210920,202303,142,64,78,83329.67,101556,184885.67
210923,202303,79,65,14,84631.43,18228,102859.43
210927,202303,415,220,195,286443.36,253890.2,540333.56
210930,202303,77,66,11,85932.4,14322,100254.4
210940,202303,75,59,16,76819.53,20832,97651.53
210945,202303,207,124,83,161449.41,108066,269515.41
210950,202303,518,386,132,502576.27,171864.65,674440.92
210955,202303,91,54,37,70309.65,48174.9,118484.55
210960,202303,2466,1287,1179,1675691.19,1535061.09,3210752.28
210970,202303,108,92,16,119784.82,20832.9,140617.72
210975,202303,74,71,3,92442.32,3906.36,96348.68
210980,202303,1053,544,509,708308.21,662721.27,1371029.48
210990,202303,4448,3163,1285,4118359.01,1673092.97,5791451.98
211000,202303,1322,1087,235,1415322.1,307276.99,1722599.09
211003,202303,961,720,241,937456.69,316386.56,1253843.25
211010,202303,494,449,45,584606.38,58590.29,643196.67
211020,202303,1358,634,724,825488.79,942667.76,1768156.55
211023,202303,41,35,6,45570.82,7812,53382.82
211027,202303,82,64,18,83328.78,23436,106764.78
211030,202303,369,266,103,346334.41,134106.5,480440.91
211040,202303,293,252,41,329408.08,53382,382790.08
211050,202303,1144,798,346,1039027.29,450494.49,1489521.78
211060,202303,633,561,72,730453.63,93744.4,824198.03
211065,202303,26,21,5,27345.34,6510.03,33855.37
211070,202303,837,705,132,917954.75,171865.77,1089820.52
211080,202303,88,85,3,110672.79,3906,114578.79
211085,202303,62,34,28,44268,36456,80724
211090,202303,86,74,12,96351.89,15624,111975.89
211100,202303,468,400,68,520813.62,88536.4,609350.02
211102,202303,224,165,59,214830.4,76818,291648.4
211105,202303,225,162,63,210924,82026.26,292950.26
211107,202303,129,82,47,106764.2,61194,167958.2
211110,202303,991,680,311,885384.43,406230.09,1291614.52
211120,202303,5280,2879,2401,3751285.69,3126148.74,6877434.43
211125,202303,21,16,5,20832,6510,27342
211130,202303,42373,20770,21603,27052961.21,28132744.19,55185705.40
211140,202303,359,322,37,419262.07,48174.88,467436.95
211150,202303,1223,884,339,1151012,443986.33,1594998.33
211153,202303,167,100,67,130200,87234,217434
211157,202303,68,55,13,71610,16926,88536
211160,202303,690,584,106,760379.88,138013.5,898393.38
211163,202303,3,2,1,2604,1302,3906
211167,202303,10,10,0,13020,,13020.0
211170,202303,423,318,105,414040.66,136711.48,550752.14
211172,202303,105,77,28,100256.49,36456,136712.49
211174,202303,24,16,8,20832,10416.29,31248.29
211176,202303,461,336,125,437478.86,162752.24,600231.10
211178,202303,93,66,27,85933.37,35154,121087.37
211180,202303,210,172,38,223946.4,49476.38,273422.78
211190,202303,74,65,9,84630.2,11718,96348.2
211195,202303,41,28,13,36460.32,16926,53386.32
211200,202303,148,125,23,162752.45,29946.6,192699.05
211210,202303,394,303,91,394515.81,118482.06,512997.87
211220,202303,4464,2704,1760,3520809.16,2294341.32,5815150.48
211223,202303,138,125,13,162754.05,16926,179680.05
211227,202303,61,49,12,63798.2,15624,79422.2
211230,202303,712,592,120,770821,156242.46,927063.46
211240,202303,376,318,58,414040.18,75516.73,489556.91
211245,202303,181,99,82,128900.82,106764.2,235665.02
211250,202303,1481,1277,204,1662744.02,265612.6,1928356.62
211260,202303,806,692,114,900993.24,148428,1049421.24
211270,202303,1845,1542,303,2007730.03,394507.23,2402237.26
211280,202303,1801,1251,550,1628839.21,716100.75,2344939.96
211285,202303,227,150,77,195301.38,100254,295555.38
211290,202303,803,572,231,744750.31,300762.24,1045512.55
211300,202303,777,630,147,820281.71,192697.16,1012978.87
211400,202303,1583,1046,537,1363230.55,700477.94,2063708.49
220005,202303,16,15,1,19530,1302,20832
220010,202303,74,63,11,82026.75,14322,96348.75
220020,202303,755,615,140,800745.2,182281.29,983026.49
220025,202303,106,101,5,131503.86,6510.6,138014.46
220027,202303,59,49,10,63798.2,13020,76818.2
220030,202303,126,104,22,135409.86,28644,164053.86
220040,202303,1311,1011,300,1316348.53,390603.52,1706952.05
220045,202303,30,22,8,28646.77,10417.21,39063.98
220050,202303,685,573,112,745986.43,145825.7,891812.13
220060,202303,190,166,24,216138.52,31248.35,247386.87
220070,202303,111,97,14,126297.91,18228.7,144526.61
220080,202303,14,12,2,15624.22,2604,18228.22
220090,202303,43,31,12,40362.95,16926,57288.95
220095,202303,3,2,1,2604,1302,3906
220100,202303,23,19,4,24738.71,5208,29946.71
220105,202303,32,29,3,37759.55,3906,41665.55
220110,202303,252,231,21,300763.92,27342,328105.92
220115,202303,48,40,8,52080.6,10416,62496.6
220117,202303,24,22,2,28644,2604,31248
220120,202303,1544,1200,344,1563732.1,449190.2,2012922.3
220130,202303,23,23,0,29946,,29946.0
220140,202303,85,71,14,92443.1,18228.9,110672.0
220150,202303,497,374,123,486969.59,161451.8,648421.39
220155,202303,24,23,1,29946.24,1302,31248.24
220157,202303,22,19,3,24739.39,3906,28645.39
220160,202303,107,92,15,119785.51,19530,139315.51
220170,202303,39,32,7,41664,9114,50778
220173,202303,19,16,3,20832,3906,24738
220177,202303,18,18,0,23436.4,,23436.4
220180,202303,63,62,1,80725.55,1302,82027.55
220190,202303,1193,1021,172,1329368.38,223948.76,1553317.14
220191,202303,36,32,4,41665.11,5208,46873.11
220192,202303,93,86,7,111974.15,9114,121088.15
220194,202303,57,51,6,66402.92,7812,74214.92
220196,202303,78,64,14,83332.78,18228.4,101561.18
220198,202303,2,2,0,2604,,2604.0
220200,202303,407,346,61,450517.47,79423.41,529940.88
220202,202303,34,30,4,39061.17,5208,44269.17
220205,202303,66,57,9,74214.2,11718,85932.2
220207,202303,14,14,0,18228.69,,18228.69
220208,202303,71,45,26,58590.77,33852.2,92442.97
220209,202303,34,29,5,37758,6510,44268
220210,202303,28,23,5,29946,6510,36456
220211,202303,34,33,1,42970.46,1302,44272.46
220213,202303,35,32,3,41665.37,3906,45571.37
220217,202303,43,35,8,45570.3,10416,55986.3
220220,202303,2427,1627,800,2119697.47,1042913.2,3162610.67
220225,202303,7,3,4,3906.9,5208,9114.9
220230,202303,999,747,252,972614.08,329412.65,1302026.73
220240,202303,165,146,19,190093.43,24738.54,214831.97
220245,202303,44,42,2,54686.14,2604,57290.14
220250,202303,145,121,24,157544.13,31248,188792.13
220253,202303,49,44,5,57288.25,6510,63798.25
220255,202303,50,43,7,55986.4,9114,65100.4
220260,202303,723,554,169,721323.38,221341,942664.38
220265,202303,12,10,2,13020,2604,15624
220270,202303,876,788,88,1027292.14,114576,1141868.14
220271,202303,37,28,9,36457.63,11718,48175.63
220272,202303,18,18,0,23436.7,,23436.7
220273,202303,16,15,1,19530.4,1302,20832.4
220275,202303,69,59,10,76818,13020,89838
220277,202303,31,22,9,28644.3,11718.8,40363.1
220280,202303,21,15,6,19530,7812,27342
220285,202303,44,40,4,52080.77,5208,57288.77
220290,202303,1587,1361,226,1772068.82,295558.88,2067627.70
220300,202303,41,41,0,53385.09,,53385.09
220310,202303,341,289,52,376296.8,67706.45,444003.25
220320,202303,466,428,38,557281.84,49477.68,606759.52
220323,202303,2,1,1,1302.8,1302,2604.8
220325,202303,9,8,1,10416,1302,11718
220327,202303,14,14,0,18228.99,,18228.99
220330,202303,219,156,63,203112.56,82026.7,285139.26
220335,202303,135,115,20,149731.32,26040,175771.32
220340,202303,49,39,10,50778,13020,63798
220342,202303,55,47,8,61197.13,10416,71613.13
220345,202303,93,81,12,105462.36,15624.8,121087.16
220350,202303,470,411,59,535126.16,76818.05,611944.21
220360,202303,49,33,16,42966,20832,63798
220370,202303,1386,1163,223,1515565.94,290346.4,1805912.34
220375,202303,21,20,1,26041.25,1302,27343.25
220380,202303,25,18,7,23436.9,9114.18,32551.08
220385,202303,17,15,2,19530,2604.66,22134.66
220390,202303,2511,1394,1117,1816352.29,1454362.16,3270714.45
220400,202303,36,29,7,37758,9114,46872
220410,202303,24,23,1,29946.2,1302,31248.2
220415,202303,14,13,1,16927.65,1302,18229.65
220420,202303,134,114,20,148429.3,26040,174469.3
220430,202303,149,131,18,170566.05,23436.2,194002.25
220435,202303,27,20,7,26040.72,9114,35154.72
220440,202303,284,242,42,315103.03,54684,369787.03
220450,202303,370,185,185,240880.48,240877.27,481757.75
220455,202303,53,52,1,67704.59,1302,69006.59
220460,202303,19,18,1,23437.08,1302.85,24739.93
220465,202303,65,45,20,58591.52,26040.41,84631.93
220470,202303,236,207,29,269521.15,37758.86,307280.01
220480,202303,66,61,5,79422.54,6510,85932.54
220490,202303,85,73,12,95046,15624,110670
220500,202303,128,107,21,139315.19,27342,166657.19
220510,202303,364,285,79,372382.8,102858.88,475241.68
220515,202303,29,27,2,35155.49,2604,37759.49
220520,202303,384,339,45,441388.98,58591.26,499980.24
220525,202303,9,5,4,6510.38,5208.43,11718.81
220527,202303,12,12,0,15624.38,,15624.38
220530,202303,50,23,27,29946,35154.87,65100.87
220535,202303,5,4,1,5208.99,1302,6510.99
220540,202303,108,94,14,122389.51,18228.2,140617.71
220545,202303,24,16,8,20833.15,10417.3,31250.45
220550,202303,768,608,160,791645.8,208322.31,999968.11
220551,202303,13,11,2,14322,2604,16926
220552,202303,12,12,0,15624,,15624.0
220553,202303,62,57,5,74215.61,6510,80725.61
220554,202303,5,3,2,3906.5,2604,6510.5
220555,202303,46,36,10,46873.86,13020.2,59894.06
220556,202303,42,39,3,50779.62,3906,54685.62
220557,202303,61,56,5,72913.79,6510.74,79424.53
220558,202303,13,6,7,7812,9114.54,16926.54
220559,202303,4,4,0,5208.07,,5208.07
220560,202303,83,53,30,69007.01,39060,108067.01
220570,202303,732,457,275,595025.75,358054.19,953079.94
220580,202303,557,511,46,667964.78,59893.81,727858.59
220585,202303,14,11,3,14322.2,3906.89,18229.09
220590,202303,15,14,1,18229.24,1302,19531.24
220595,202303,72,57,15,74214.86,19530,93744.86
220600,202303,21,15,6,19530,7812,27342
220605,202303,31,28,3,36456.2,3906,40362.2
220610,202303,98,82,16,106764,20832,127596
220620,202303,566,488,78,635390.45,101558.21,736948.66
220630,202303,3,2,1,2604,1302,3906
220635,202303,33,30,3,39062.23,3906,42968.23
220640,202303,112,93,19,121086,24738,145824
220650,202303,117,111,6,144522.76,7812,152334.76
220660,202303,80,62,18,80725.82,23436.2,104162.02
220665,202303,12,12,0,15624,,15624.0
220667,202303,25,23,2,29946.75,2604,32550.75
220669,202303,41,35,6,45570.2,7812,53382.2
220670,202303,69,54,15,71610.9,19530,91140.9
220672,202303,76,56,20,72917.5,26041.21,98958.71
220675,202303,29,22,7,28645.77,9114,37759.77
220680,202303,61,52,9,67704.2,11718,79422.2
220690,202303,47,45,2,58590.97,2604,61194.97
220695,202303,30,17,13,22135.19,16926,39061.19
220700,202303,1913,1487,426,1936104.58,554656.7,2490761.28
220710,202303,7,5,2,6510.2,2604.78,9114.98
220720,202303,113,98,15,127596,20832,148428
220730,202303,31,30,1,39060.01,1302,40362.01
220735,202303,7,5,2,6510,2604,9114
220740,202303,61,52,9,67704.2,11718.91,79423.11
220750,202303,130,111,19,144524.8,24738.18,169262.98
220755,202303,20,19,1,24739.29,1302,26041.29
220760,202303,70,63,7,82028.78,9114,91142.78
220770,202303,6195,3574,2621,4654900.97,3415231.26,8070132.23
220775,202303,10,8,2,10416.7,2604.63,13021.33
220777,202303,22,21,1,27342,1302,28644
220779,202303,5,1,4,1302,5208,6510
220780,202303,959,813,146,1058536.64,190092.78,1248629.42
220785,202303,7,4,3,5208,3906.2,9114.2
220790,202303,1260,1010,250,1315056.72,325508.76,1640565.48
220793,202303,8,6,2,7812,2604,10416
220795,202303,23,22,1,28644.27,1302,29946.27
220800,202303,4156,3185,971,4148501.66,1266862.62,5415364.28
220810,202303,80,68,12,88538.79,15624,104162.79
220820,202303,254,231,23,300770.44,29947.8,330718.24
220830,202303,1337,1179,158,1535084.75,205717.34,1740802.09
220840,202303,2647,1873,774,2441329.32,1009071.5,3450400.82
220850,202303,80,68,12,88536,15624,104160
220855,202303,8,4,4,5208,5208,10416
220860,202303,16,12,4,16928.31,5208,22136.31
220865,202303,32,29,3,37758.1,3906,41664.1
220870,202303,92,82,10,106764.61,13020,119784.61
220880,202303,339,281,58,365875.85,75517.92,441393.77
220885,202303,29,27,2,35157.49,2604,37761.49
220887,202303,6,5,1,6510.2,1302,7812.2
220890,202303,87,73,14,95047.72,18228,113275.72
220900,202303,27,14,13,18228,16926,35154
220910,202303,48,37,11,48176.13,14322,62498.13
220915,202303,9,8,1,10416.19,1302,11718.19
220920,202303,51,45,6,58590.88,7812,66402.88
220930,202303,56,53,3,69006.75,3906,72912.75
220935,202303,15,15,0,19530.97,,19530.97
220937,202303,36,30,6,39060.31,7812,46872.31
220940,202303,62,54,8,70308,10416,80724
220945,202303,4,4,0,5208.7,,5208.7
220950,202303,36,28,8,36456.2,10416,46872.2
220955,202303,23,22,1,28644.77,1302,29946.77
220960,202303,39,34,5,44268,6510,50778
220965,202303,54,49,5,63798,6510,70308
220970,202303,64,53,11,69006,14322,83328
220975,202303,11,10,1,13020.9,1302,14322.9
220980,202303,27,25,2,32550.76,2604,35154.76
220985,202303,52,44,8,57288,10416,67704
220987,202303,31,30,1,39062.09,1302.63,40364.72
220990,202303,25,24,1,31248,1302,32550
220995,202303,13,11,2,14322,2604,16926
220997,202303,73,65,8,84631.98,10416,95047.98
221000,202303,1341,1188,153,1546819.01,199206.86,1746025.87
221005,202303,44,41,3,53382,3906.98,57288.98
221010,202303,27,19,8,24738,10416,35154
221020,202303,40,35,5,45570.84,6510,52080.84
221030,202303,43,36,7,46769.85,9114,55883.85
221035,202303,23,21,2,27344.52,2604,29948.52
221037,202303,14,10,4,13020,5208,18228
221038,202303,26,23,3,29946,3906,33852
221039,202303,25,24,1,31248.06,1302.2,32550.26
221040,202303,263,223,40,290351.04,52081.4,342432.44
221050,202303,237,196,41,255202.98,53382.2,308585.18
221060,202303,2070,1779,291,2317610.74,378887.38,2696498.12
221062,202303,27,27,0,35155.4,,35155.4
221063,202303,18,14,4,18228,5208,23436
221065,202303,74,61,13,79424.59,16926,96350.59
221070,202303,161,139,22,180982.4,28644,209626.4
221080,202303,416,354,62,460921.05,80724,541645.05
221090,202303,27,21,6,27344.42,7812,35156.42
221093,202303,50,34,16,44269.1,20832.88,65101.98
221095,202303,4,4,0,5208,,5208.0
221097,202303,12,10,2,13020,2604,15624
221100,202303,28186,16847,11339,21943665.43,14772815.68,36716481.11
221110,202303,1204,925,279,1204396.98,364566.95,1568963.93
221120,202303,595,432,163,562476.24,212226.7,774702.94
221130,202303,1048,845,203,1100207.17,264310.14,1364517.31
221135,202303,33,30,3,39061.09,3906,42967.09
221140,202303,47,40,7,52080.2,9114,61194.2
221150,202303,13,9,4,11718.18,5208,16926.18
221160,202303,19,17,2,22135.39,2604,24739.39
221170,202303,20,19,1,24738,1302,26040
230010,202303,171,148,23,192697.78,29946,222643.78
230015,202303,166,139,27,180978.7,35154,216132.7
230020,202303,1922,1525,397,1986907.28,516909.84,2503817.12
230030,202303,1723,1256,467,1635369.34,609344.45,2244713.79
230040,202303,241,193,48,251289.01,62496,313785.01
230050,202303,249,173,76,225246.41,98952.78,324199.19
230060,202303,179,143,36,186186.39,46873.54,233059.93
230070,202303,331,279,52,363262.21,67704,430966.21
230075,202303,963,800,163,1041628.56,213532.17,1255160.73
230080,202303,239,196,43,255196.41,55986,311182.41
230090,202303,191,133,58,173166.93,75516,248682.93
230100,202303,2874,1617,1257,2105429.72,1637938.45,3743368.17
230110,202303,3222,2037,1185,2652252.66,1544190.62,4196443.28
230120,202303,1261,961,300,1251253.03,390603.28,1641856.31
230125,202303,186,145,41,188790.83,53382,242172.83
230130,202303,527,459,68,597626.73,88536.76,686163.49
230140,202303,227,184,43,239568.51,57288,296856.51
230150,202303,155,120,35,156242.18,46872.75,203114.93
230160,202303,1015,824,191,1072854.15,248683.8,1321537.95
230170,202303,681,589,92,766899,119788.64,886687.64
230180,202303,71,64,7,83328.39,9114,92442.39
230185,202303,439,374,65,486957.98,84631.75,571589.73
230190,202303,2681,2024,657,2635332.67,855426.35,3490759.02
230195,202303,547,465,82,605449.9,106764,712213.9
230200,202303,479,368,111,479144.54,144522.2,623666.74
230205,202303,429,281,148,365863.17,192696.2,558559.37
230210,202303,1489,1125,364,1464777.3,473929.66,1938706.96
230220,202303,1740,1153,587,1501245.97,765586.5,2266832.47
230230,202303,1066,857,209,1115840.63,272120.42,1387961.05
230240,202303,2195,1910,285,2486873.66,371076.04,2857949.70
230250,202303,1942,1576,366,2053326.24,476542.43,2529868.67
230260,202303,3509,2164,1345,2817561.1,1753799.52,4571360.62
230270,202303,1462,1128,334,1468674.7,436174.2,1904848.9
230280,202303,3023,2314,709,3012915.86,923128.64,3936044.50
230290,202303,365,315,50,410145.28,65100.95,475246.23
230300,202303,532,389,143,506481.3,186186.29,692667.59
230310,202303,450,346,104,450492.62,135408.87,585901.49
230320,202303,995,832,163,1083290.02,212227.85,1295517.87
230330,202303,336,273,63,355450.09,82026.4,437476.49
230340,202303,464,374,90,488259.01,117180.4,605439.41
230350,202303,3652,2223,1429,2895742.46,1860574.48,4756316.94
230360,202303,282,231,51,300766.85,66402.46,367169.31
230365,202303,142,113,29,147128.49,37758,184886.49
230370,202303,12449,6254,6195,8148354.78,8073942.37,16222297.15
230380,202303,543,462,81,601536.98,105464.8,707001.78
230390,202303,564,322,242,419248.12,315084.6,734332.72
230393,202303,241,194,47,252590.07,61194.5,313784.57
230395,202303,389,308,81,401040.29,105464.57,506504.86
230400,202303,687,545,142,712202.01,184884.2,897086.21
230410,202303,3024,1897,1127,2471271.96,1468679.19,3939951.15
230420,202303,6989,4597,2392,5986943.41,3117090.49,9104033.90
230423,202303,357,308,49,402321.46,63798.1,466119.56
230425,202303,547,437,110,568981.94,143221.4,712203.34
230426,202303,130,101,29,131502.7,37758,169260.7
230427,202303,81,70,11,91140.99,14322,105462.99
230428,202303,1890,904,986,1177042.12,1283787.5,2460829.62
230430,202303,492,394,98,512997.59,127597.7,640595.29
230435,202303,1003,716,287,932257.08,373677.17,1305934.25
230440,202303,105854,48661,57193,63388191.42,74526776.3,137914967.72
230445,202303,353,236,117,307283.44,152334.9,459618.34
230450,202303,617,483,134,628868.17,174468.7,803336.87
230460,202303,110,78,32,101557.34,41664,143221.34
230465,202303,330,268,62,348940.93,80724,429664.93
230470,202303,2160,1688,472,2197803.39,614546.94,2812350.33
230480,202303,156,141,15,183582.5,19531.1,203113.6
230490,202303,352,274,78,356751.18,101556.9,458308.08
230495,202303,517,362,155,471337.85,203115.46,674453.31
230500,202303,1210,896,314,1166603.24,408830.94,1575434.18
230510,202303,82,56,26,72912,33852,106764
230520,202303,440,334,106,434872.73,138012.62,572885.35
230523,202303,2821,1721,1100,2240822.77,1434825.55,3675648.32
230526,202303,264,216,48,281234.15,62496,343730.15
230530,202303,732,529,203,688770.31,264310.23,953080.54
230533,202303,228,210,18,273422.89,23436.2,296859.09
230535,202303,438,326,112,424466.83,145825,570291.83
230540,202303,1899,1686,213,2195235.28,277329.42,2472564.70
230550,202303,4486,2825,1661,3678353.98,2165281.23,5843635.21
230560,202303,617,466,151,606743.69,196602.57,803346.26
230565,202303,234,173,61,225246.7,79423.14,304669.84
230570,202303,326,275,51,358052.55,66402.45,424455.00
230580,202303,1307,898,409,1169211.08,532523.82,1701734.90
230590,202303,1139,866,273,1127445.41,356749.81,1484195.22
230600,202303,305,274,31,356756.84,40362,397118.84
230610,202303,500,367,133,477843.18,173166.2,651009.38
230620,202303,183,152,31,197907.87,40362,238269.87
230625,202303,941,629,312,818976.93,406225.39,1225202.32
230630,202303,1582,1181,401,1539001.32,523409.41,2062410.73
230640,202303,4279,3476,803,4525938.37,1046840.31,5572778.68
230650,202303,527,447,80,582000.45,104161.14,686161.59
230655,202303,791,625,166,813780.62,216135.81,1029916.43
230660,202303,396,323,73,420550.15,95046.2,515596.35
230670,202303,509,404,105,526028.77,136710.76,662739.53
230680,202303,233,199,34,259103.57,44268,303371.57
230690,202303,1031,862,169,1122349.95,220039.76,1342389.71
230700,202303,1104,911,193,1186149.38,251287.68,1437437.06
230710,202303,712,651,61,848931.35,79422.56,928353.91
230720,202303,154,132,22,171864,29946.7,201810.7
230725,202303,308,233,75,303368.82,97651.17,401019.99
230730,202303,13990,7370,6620,9598979.77,8628529.58,18227509.35
230740,202303,747,597,150,777316.28,195301.1,972617.38
230750,202303,890,732,158,953081.56,205717.44,1158799.00
230760,202303,1743,1472,271,1917914.87,352846.21,2270761.08
230763,202303,391,326,65,425758.65,84630,510388.65
230765,202303,9453,4458,4995,5809933.7,6508945.36,12318879.06
230770,202303,5578,2842,2736,3708261.27,3571426.19,7279687.46
230780,202303,852,735,117,956982.22,152334.1,1109316.32
230790,202303,339,275,64,358050.7,83328.52,441379.22
230800,202303,1294,915,379,1191348.83,493461.1,1684809.93
230810,202303,1523,1310,213,1706995.95,277329.62,1984325.57
230820,202303,401,262,139,341128.86,182281.91,523410.77
230830,202303,1032,862,170,1122346.41,221340.9,1343687.31
230835,202303,299,242,57,315088.68,74214.68,389303.36
230837,202303,201,161,40,209624.85,52080.91,261705.76
230840,202303,1014,761,253,992135.05,329409.13,1321544.18
230850,202303,1482,1242,240,1617127.95,312483.49,1929611.44
230860,202303,358,280,78,364563.18,101562.51,466125.69
230870,202303,1973,1665,308,2169172.25,401016.47,2570188.72
230880,202303,86,67,19,87234,24738,111972
230890,202303,603,530,73,690071.26,95047.91,785119.17
230900,202303,331,243,88,316388.04,114576.51,430964.55
230910,202303,242,187,55,243476.47,71610,315086.47
230920,202303,538,416,122,541639.09,158844,700483.09
230930,202303,1201,834,367,1085891.13,477836.35,1563727.48
230940,202303,900,690,210,898399.01,273420.73,1171819.74
230945,202303,606,483,123,630191.62,160151.5,790343.12
230950,202303,460,397,63,516917.35,82026.87,598944.22
230960,202303,3039,2022,1017,2632775.56,1325473.45,3958249.01
230970,202303,1979,1072,907,1395798.05,1182236.92,2578034.97
230980,202303,236,173,63,225248.35,82026,307274.35
230990,202303,150,118,32,154939.09,41664,196603.09
231000,202303,218,200,18,260403.24,23436,283839.24
231010,202303,191,130,61,169262.92,80724.46,249987.38
231020,202303,1592,1049,543,1367160.58,707002.55,2074163.13
231025,202303,1229,841,388,1095027.77,505189.31,1600217.08
231030,202303,1122,906,216,1179625.07,281234.47,1460859.54
231040,202303,192,132,60,171867.18,78120,249987.18
231050,202303,1011,863,148,1123648.07,192703.47,1316351.54
231060,202303,173,140,33,182284.07,42966.23,225250.30
231070,202303,1623,1102,521,1434836.66,680953.37,2115790.03
231080,202303,285,248,37,322904.1,48174,371078.1
231085,202303,764,467,297,608057.76,386694.26,994752.02
231090,202303,285,227,58,296861.54,75517.64,372379.18
231095,202303,171,127,44,165354,57288.39,222642.39
231100,202303,199,161,38,209624.13,49476,259100.13
231110,202303,393,326,67,424459.52,87237.48,511697.00
231120,202303,274,225,49,292953.73,63798.71,356752.44
231123,202303,156,148,8,192699.65,10416,203115.65
231126,202303,357,277,80,360655.09,104160,464815.09
231130,202303,5331,4116,1215,5359262.54,1583262.77,6942525.31
231135,202303,229,199,30,259100.07,39060.44,298160.51
231140,202303,3299,2360,939,3072816.3,1222593.11,4295409.41
231150,202303,423,389,34,506489.59,44269.41,550759.00
231160,202303,1346,1094,252,1424413.67,328104.46,1752518.13
231170,202303,566,391,175,509086.32,227850,736936.32
231180,202303,2091,1805,286,2351483.72,372378.64,2723862.36
231190,202303,241,192,49,249984.54,63798,313782.54
231195,202303,247,201,46,261704.68,59892.65,321597.33
231200,202303,918,732,186,953091.99,242174.8,1195266.79
231210,202303,545,455,90,592420.37,117181.39,709601.76
231220,202303,1142,801,341,1042928.3,443984.69,1486912.99
231230,202303,1697,1239,458,1614511.38,596317.8,2210829.18
231240,202303,1780,1190,590,1549420.82,769490.99,2318911.81
231250,202303,97,91,6,118483.53,7812,126295.53
231260,202303,274,181,93,235664.04,121088.71,356752.75
231270,202303,1059,809,250,1053346.72,325500.94,1378847.66
231280,202303,87,64,23,83329.22,29946.82,113276.04
231290,202303,8721,4850,3871,6314976.14,5042750.48,11357726.62
231300,202303,634,572,62,744753.31,80724,825477.31
231310,202303,887,807,80,1050727.07,104161.51,1154888.58
231320,202303,651,484,167,630172.88,217435.62,847608.50
231325,202303,107,90,17,117180.18,22134.54,139314.72
231330,202303,2097,1576,521,2053318.99,680955.67,2734274.66
231335,202303,267,235,32,305976.01,41664,347640.01
231340,202303,2103,1420,683,1848890.91,889277.57,2738168.48
231350,202303,1555,1206,349,1570277.09,454413.93,2024691.02
231355,202303,443,359,84,467423.21,109369.24,576792.45
231360,202303,618,415,203,540345.37,264307.94,804653.31
231370,202303,98,82,16,106764,20832.94,127596.94
231375,202303,309,229,80,298163.92,104160.1,402324.02
231380,202303,567,450,117,585905.67,152334,738239.67
231390,202303,207,160,47,208321.99,61194,269515.99
231395,202303,843,493,350,641890.96,455701.86,1097592.82
231400,202303,1309,1080,229,1406190.19,298163.32,1704353.51
231410,202303,1496,1205,291,1568943.02,378884.83,1947827.85
240010,202303,414,188,226,244786.64,294262.1,539048.74
240020,202303,2459,2005,454,2610629.07,591118.59,3201747.66
240030,202303,123,97,26,126295.83,33852,160147.83
240040,202303,36,35,1,45570,1302,46872
240050,202303,555,474,81,617181.05,105462.1,722643.15
240060,202303,88,78,10,101557.63,13020,114577.63
240070,202303,308,233,75,303369.38,97650.2,401019.58
240080,202303,632,419,213,545560.97,277334.88,822895.85
240090,202303,105,92,13,119784.57,16926,136710.57
240100,202303,1644,1538,106,2003844.68,138014.85,2141859.53
240110,202303,1124,759,365,988297.12,475254.28,1463551.40
240120,202303,157,117,40,152335.58,52080.16,204415.74
240130,202303,276,253,23,329422.68,29946.7,359369.38
240140,202303,92,60,32,78121.2,41664.64,119785.84
240145,202303,777,686,91,893207.05,118482.82,1011689.87
240150,202303,29,22,7,28644,9114,37758
240160,202303,38,31,7,40362,9114,49476
240165,202303,44,36,8,46875.24,10416.8,57292.04
240170,202303,159,107,52,139316.18,67704,207020.18
240180,202303,125,93,32,121089.1,41664,162753.1
240185,202303,52,46,6,59892.39,7812,67704.39
240190,202303,16,14,2,18228.43,2604,20832.43
240200,202303,3315,1778,1537,2317631.79,2003801.88,4321433.67
240210,202303,164,124,40,161448.73,52080,213528.73
240220,202303,1226,832,394,1083312.52,512994.47,1596306.99
240230,202303,874,779,95,1015607.29,123691.38,1139298.67
240240,202303,85,55,30,71610.2,39060.22,110670.42
240250,202303,104,89,15,115879.35,19530,135409.35
240260,202303,2051,1433,618,1867136.63,804648.09,2671784.72
240270,202303,177,151,26,196603.37,33852,230455.37
240280,202303,71,57,14,74214.2,18228.1,92442.3
240290,202303,42,40,2,52080,2604,54684
240300,202303,178,95,83,123690.93,108066,231756.93
240310,202303,2717,1463,1254,1904896.76,1632732.44,3537629.20
240320,202303,185,172,13,223944.07,16926,240870.07
240325,202303,5348,2968,2380,3865860.36,3100160.66,6966021.02
240330,202303,86,80,6,104160,7812,111972
240340,202303,113,81,32,105462,41664,147126
240350,202303,99,79,20,102858.2,26040,128898.2
240360,202303,800,505,295,657541.74,384098.62,1041640.36
240370,202303,65,56,9,72913.22,11719.26,84632.48
240375,202303,52,34,18,44269.55,23437.07,67706.62
240380,202303,220,182,38,236974.02,49476.5,286450.52
240390,202303,16,14,2,18228,2604,20832
240400,202303,86,77,9,100254.94,11718,111972.94
240410,202303,12,9,3,11718,3906,15624
240420,202303,1198,848,350,1104129.11,457010.62,1561139.73
240430,202303,275,248,27,322909.68,35154.54,358064.22
240440,202303,155,84,71,109373.89,92442.12,201816.01
240450,202303,267,158,109,205726.77,143223.55,348950.32
240460,202303,95,73,22,95047.12,28644.6,123691.72
240470,202303,230,207,23,269531.56,29946.93,299478.49
240480,202303,15,13,2,16926,2604,19530
240485,202303,89,70,19,91141.68,24738,115879.68
240490,202303,65,59,6,76818.75,7812,84630.75
240500,202303,110,84,26,109368,35154,144522
240510,202303,39,29,10,37758.13,13020,50778.13
240520,202303,100,95,5,123692.32,6510.8,130203.12
240530,202303,67,51,16,66402.72,20832,87234.72
240540,202303,104,90,14,117180.1,18228,135408.1
240550,202303,12,10,2,13020,2604,15624
240560,202303,426,286,140,372382.64,182280.7,554663.34
240570,202303,457,278,179,361963.88,233059.13,595023.01
240580,202303,1448,1058,390,1377560.25,510386.1,1887946.35
240590,202303,30,29,1,37758.94,1302,39060.94
240600,202303,104,97,7,126295.67,9114,135409.67
240610,202303,515,423,92,550773.3,119789.8,670563.1
240615,202303,11,11,0,14322.8,,14322.8
240620,202303,88,84,4,109369.68,5208,114577.68
240630,202303,43,35,8,45570.97,10416.48,55987.45
240640,202303,36,24,12,31248,15624,46872
240650,202303,249,196,53,255194.3,69006.28,324200.58
240660,202303,116,98,18,128898.77,23436,152334.77
240670,202303,325,180,145,234376.66,188800.53,423177.19
240680,202303,58,44,14,57288.67,18228.1,75516.77
240690,202303,48,46,2,59894.21,2604,62498.21
240700,202303,182,152,30,197904.6,39061.02,236965.62
240710,202303,2458,1471,987,1915315.61,1285091.1,3200406.71
240720,202303,1131,787,344,1024713.24,447898.06,1472611.30
240725,202303,78,70,8,91141.9,10416.88,101558.78
240730,202303,152,124,28,161448.26,36456.7,197904.96
240740,202303,244,198,46,257807.83,59892.62,317700.45
240750,202303,56,34,22,44268,28644,72912
240760,202303,61,48,13,62496,16926,79422
240770,202303,156,121,35,157545.13,46872.57,204417.70
240780,202303,793,652,141,848929.97,183582.87,1032512.84
240790,202303,39,37,2,48175.46,2604,50779.46
240800,202303,10398,6974,3424,9080800.6,4460847.43,13541648.03
240810,202303,23345,12261,11084,15967368.7,14443456.93,30410825.63
240820,202303,272,160,112,208326.42,145826.66,354153.08
240830,202303,1678,1383,295,1800723.71,384096.91,2184820.62
240840,202303,79,68,11,88536.79,14322,102858.79
240850,202303,89,78,11,101556,14322,115878
240860,202303,116,111,5,144524.09,6510.85,151034.94
240870,202303,58,47,11,61196.6,14322,75518.6
240880,202303,33,29,4,37758,5208,42966
240890,202303,1272,712,560,927057.18,729130.36,1656187.54
240895,202303,64,49,15,63798.2,19530.69,83328.89
240910,202303,186,154,32,200509.83,41664.2,242174.03
240920,202303,12,11,1,14322.97,1302,15624.97
240930,202303,442,392,50,511712.52,65102.46,576814.98
240933,202303,62,40,22,52080.95,28644,80724.95
240940,202303,2420,2113,307,2752504.95,399718.52,3152223.47
240950,202303,42,37,5,48174,6510,54684
240960,202303,25,20,5,26040.2,6510.3,32550.5
240970,202303,110,78,32,101556.96,41664,143220.96
240980,202303,212,165,47,214830.89,61196.42,276027.31
240990,202303,147,94,53,122389.15,69006,191395.15
241000,202303,62,56,6,72913.15,7812,80725.15
241010,202303,92,75,17,97651.1,22134,119785.1
241020,202303,115,106,9,138013.93,11718.5,149732.43
241025,202303,21,13,8,16927.57,10416.5,27344.07
241030,202303,119,91,28,118482,37759.43,156241.43
241040,202303,47,38,9,49476.1,11718,61194.1
241050,202303,75,69,6,89838.98,7812,97650.98
241060,202303,29,24,5,31248.78,6510,37758.78
241070,202303,24,23,1,29948.26,1302,31250.26
241080,202303,61,53,8,69006.2,10416,79422.2
241090,202303,55,44,11,57290.69,14322,71612.69
241100,202303,70,61,9,79422.78,11718.46,91141.24
241105,202303,28,16,12,20835.47,15624.73,36460.20
241110,202303,54,44,10,57288.15,13020,70308.15
241120,202303,1799,1360,439,1770760.62,572884.16,2343644.78
241140,202303,214,174,40,226552.65,52080,278632.65
241142,202303,50,39,11,50778.81,14322,65100.81
241150,202303,1227,1057,170,1377001.21,221343.19,1598344.40
241160,202303,26,19,7,24738,9114,33852
241170,202303,53,45,8,58590,10416,69006
241180,202303,47,34,13,44268,16926,61194
241190,202303,39,35,4,45570.36,5208,50778.36
241200,202303,5170,2706,2464,3526036.2,3209555.76,6735591.96
241210,202303,73,62,11,80724.75,14322,95046.75
241220,202303,1679,1051,628,1369765.15,818971,2188736.15
241230,202303,263,211,52,274726.55,67704.91,342431.46
241240,202303,52,39,13,50779.36,16926,67705.36
241250,202303,1183,1079,104,1404899.09,136712.73,1541611.82
241255,202303,69,55,14,71610.78,18228,89838.78
241260,202303,778,589,189,766895.59,246080.4,1012975.99
241270,202303,72,50,22,65101.05,28644.6,93745.65
241280,202303,98,85,13,110673.46,16926,127599.46
241290,202303,145,106,39,138015.28,50778.7,188793.98
241300,202303,85,58,27,75516.7,35154.98,110671.68
241310,202303,54,38,16,49478.22,20832.1,70310.32
241320,202303,35,19,16,24740.07,20832,45572.07
241330,202303,66,56,10,72913.33,13020,85933.33
241335,202303,108,96,12,126297.97,15624,141921.97
241340,202303,190,136,54,177072.81,70308,247380.81
241350,202303,68,56,12,72912.44,15624,88536.44
241355,202303,54,44,10,57290.57,13020,70310.57
241360,202303,57,54,3,70308.49,3906,74214.49
241370,202303,69,56,13,72912,16926,89838
241380,202303,37,33,4,42967.5,5208,48175.5
241390,202303,91,71,20,92442,26040,118482
241400,202303,230,171,59,223586.37,76820,300406.37
241410,202303,186,166,20,216133.34,26040.8,242174.14
241415,202303,111,88,23,114576.1,29946.8,144522.9
241420,202303,147,96,51,124994.14,66402.6,191396.74
241430,202303,20,17,3,22134.88,3906,26040.88
241440,202303,563,471,92,613273.59,119786.94,733060.53
241445,202303,44,38,6,49476.2,7812.72,57288.92
241450,202303,265,224,41,291658.62,53382.44,345041.06
241460,202303,178,163,15,212231.68,19531,231762.68
241470,202303,33,27,6,35154.8,7812.43,42967.23
241475,202303,49,45,4,58590,5208,63798
241480,202303,144,103,41,134109.26,53383.08,187492.34
241490,202303,12,10,2,13020.91,2604.1,15625.01
241500,202303,53,39,14,50780.88,18228.02,69008.90
250010,202303,102,84,18,109368.75,23436.48,132805.23
250020,202303,34,29,5,37758,6510,44268
250030,202303,931,689,242,897111.64,315089.65,1212201.29
250040,202303,410,333,77,433585.37,100255.12,533840.49
250050,202303,295,242,53,315085.92,69006.5,384092.42
250053,202303,69,56,13,72912.6,16926,89838.6
250057,202303,4,3,1,3906.2,1302,5208.2
250060,202303,652,472,180,614561.78,234361.63,848923.41
250070,202303,699,557,142,725234.46,184884.64,910119.10
250073,202303,10,8,2,10416.45,2604.01,13020.46
250077,202303,189,136,53,177073.75,69006.99,246080.74
250080,202303,420,332,88,432274.46,114576.68,546851.14
250090,202303,227,143,84,186187.79,109368,295555.79
250100,202303,618,492,126,640594.12,164053.8,804647.92
250110,202303,725,521,204,678356.16,265609.7,943965.86
250115,202303,14,4,10,5208.18,13020.26,18228.44
250120,202303,127,92,35,119784.86,45572.1,165356.96
250130,202303,593,485,108,631491.34,140617.96,772109.30
250135,202303,34,15,19,19530.59,24738,44268.59
250140,202303,87,74,13,96350.75,16926,113276.75
250150,202303,681,474,207,617159.91,270817.77,887977.68
250153,202303,18,15,3,19530.48,3906,23436.48
250157,202303,38,31,7,40362.42,9114,49476.42
250160,202303,252,191,61,248686.45,79422,328108.45
250170,202303,91,59,32,76818.2,41664,118482.2
250180,202303,5229,3616,1613,4709619.56,2102799.3,6812418.86
250190,202303,820,555,265,722617.59,345033.73,1067651.32
250200,202303,73,58,15,75516.9,19530.7,95047.6
250205,202303,23,18,5,23436.61,6510,29946.61
250210,202303,91,77,14,100256.06,18228,118484.06
250215,202303,92,60,32,78120.74,41664.07,119784.81
250220,202303,32,20,12,26041.24,15624,41665.24
250230,202303,80,70,10,91141.51,13020.2,104161.71
250240,202303,259,192,67,249987.55,87234.2,337221.75
250250,202303,425,363,62,472642.2,80724,553366.2
250260,202303,53,43,10,55986.1,13020,69006.1
250270,202303,83,58,25,75517.4,32550,108067.4
250280,202303,410,336,74,437477.57,96348,533825.57
250290,202303,115,102,13,132804,16926.04,149730.04
250300,202303,529,359,170,467428.36,221340.34,688768.70
250310,202303,57,51,6,66403.07,7812,74215.07
250320,202303,2176,1443,733,1880197.75,955694.09,2835891.84
250330,202303,123,106,17,138014.84,22134.1,160148.94
250340,202303,33,27,6,35154.71,7812,42966.71
250350,202303,214,141,73,183585.69,95046,278631.69
250355,202303,43,34,9,44268,11718.51,55986.51
250360,202303,195,161,34,209625.54,44269.06,253894.60
250370,202303,2515,1601,914,2084584.54,1190057.29,3274641.83
250375,202303,17,11,6,14322.36,7812.68,22135.04
250380,202303,56,49,7,63798.66,9114.96,72913.62
250390,202303,51,41,10,53383.52,13020,66403.52
250400,202303,18529,9511,9018,12387839.43,11745632.22,24133471.65
250403,202303,308,237,71,308577.61,92442,401019.61
250407,202303,69,55,14,71610.1,18228.85,89838.95
250410,202303,32,27,5,35154.31,6510.8,41665.11
250415,202303,51,32,19,41664,24738,66402
250420,202303,40,34,6,44268.3,7812,52080.3
250430,202303,1558,1353,205,1761982.35,266911.53,2028893.88
250435,202303,39,29,10,37759.92,13020,50779.92
250440,202303,695,569,126,740848.41,164053,904901.41
250450,202303,90,68,22,88538.15,28644,117182.15
250460,202303,514,337,177,438780.01,230456.04,669236.05
250470,202303,109,76,33,98953.65,42966.6,141920.25
250480,202303,350,276,74,359363.81,96348.98,455712.79
250485,202303,6,5,1,6510,1302,7812
250490,202303,256,206,50,268216.88,65101.66,333318.54
250500,202303,101,78,23,101557.37,29946,131503.37
250510,202303,881,701,180,912714.46,234361.09,1147075.55
250520,202303,172,117,55,152334,71610,223944
250523,202303,131,107,24,139314.97,31248.12,170563.09
250527,202303,121,90,31,117180,40362,157542
250530,202303,11,6,5,7812,6510,14322
250535,202303,30,23,7,29946,9114,39060
250540,202303,147,115,32,149730.74,41664,191394.74
250550,202303,75,73,2,95047.19,2604,97651.19
250560,202303,69,40,29,52080.84,37758.07,89838.91
250570,202303,168,138,30,179677.44,39060.7,218738.14
250580,202303,98,77,21,100338.2,27342,127680.2
250590,202303,22,15,7,19530,9114,28644
250600,202303,1693,1116,577,1453063.67,752559.96,2205623.63
250610,202303,159,124,35,161457.31,45570.71,207028.02
250620,202303,23,19,4,24738.81,5208,29946.81
250625,202303,70,54,16,70310.49,20832.13,91142.62
250630,202303,3251,2022,1229,2634276.11,1600182.05,4234458.16
250640,202303,199,157,42,204418.37,54685.45,259103.82
250650,202303,34,22,12,28644.5,15624.94,44269.44
250660,202303,65,47,18,61194,23436,84630
250670,202303,82,65,17,84630.68,22134.94,106765.62
250680,202303,439,352,87,458318.09,113274.59,571592.68
250690,202303,2311,1561,750,2033777.72,976515.47,3010293.19
250700,202303,980,831,149,1081978.76,193998.2,1275976.96
250710,202303,512,395,117,514319.54,152339.76,666659.30
250720,202303,124,91,33,118483.75,42966,161449.75
250730,202303,426,352,74,458312.87,96349.62,554662.49
250740,202303,71,64,7,83329.51,9114,92443.51
250750,202303,26213,15349,10864,19997012.27,14153152.27,34150164.54
250760,202303,126,98,28,127596.5,36456.75,164053.25
250770,202303,387,254,133,330716.11,173166.7,503882.81
250780,202303,77,50,27,65100.98,35154,100254.98
250790,202303,469,290,179,377586.7,233060.01,610646.71
250800,202303,153,137,16,178374,20832,199206
250810,202303,74,60,14,78120,18228,96348
250820,202303,162,132,30,173168.42,39060,212228.42
250830,202303,510,327,183,425768.66,238268.73,664037.39
250840,202303,62,52,10,67705.05,13020.2,80725.25
250850,202303,71,59,12,76818,15624,92442
250855,202303,16,13,3,16926.2,3906,20832.2
250860,202303,249,161,88,210925.17,114576,325501.17
250870,202303,31,28,3,36456,3906,40362
250880,202303,97,74,23,96348.91,29946,126294.91
250890,202303,3377,2483,894,3234263.7,1165303.95,4399567.65
250900,202303,68,57,11,74214.7,14322,88536.7
250905,202303,129,94,35,122388.9,45570,167958.9
250910,202303,1005,732,273,953090.7,355449.74,1308540.44
250915,202303,120,81,39,105463.35,50779.39,156242.74
250920,202303,153,114,39,148428,50778.7,199206.7
250930,202303,207,118,89,153636.86,115880.04,269516.90
250933,202303,12,8,4,10416,5208.29,15624.29
250937,202303,21,20,1,26040,1302,27342
250939,202303,41,31,10,40362.8,13020,53382.8
250940,202303,137,100,37,130202.38,48175.13,178377.51
250950,202303,86,62,24,80727.07,31248,111975.07
250960,202303,89,52,37,67707.63,48174.3,115881.93
250970,202303,1354,961,393,1251250.2,511692.39,1762942.59
250980,202303,98,65,33,84631.62,42966,127597.62
250990,202303,174,134,40,174468.36,52080,226548.36
251000,202303,90,75,15,97650,19530.6,117180.6
251010,202303,141,97,44,126294.1,57288,183582.1
251020,202303,93,77,16,100254,20832,121086
251030,202303,50,35,15,45570.43,19530,65100.43
251040,202303,70,49,21,63798,27342,91140
251050,202303,30,24,6,31248,7812,39060
251060,202303,52,41,11,54685.1,14322.64,69007.74
251065,202303,6,3,3,3906,3906,7812
251070,202303,19,17,2,22135.53,2604,24739.53
251080,202303,5809,2703,3106,3522086.63,4046712.25,7568798.88
251090,202303,197,164,33,213529.57,42966.68,256496.25
251100,202303,24,22,2,28644.88,2604,31248.88
251110,202303,67,44,23,57288,29946,87234
251120,202303,2057,1269,788,1652331.82,1025996.95,2678328.77
251130,202303,460,377,83,490858.94,108066.05,598924.99
251140,202303,651,427,224,555959.22,292951.9,848911.12
251150,202303,353,295,58,384095.2,75516.94,459612.14
251160,202303,101,83,18,108066,23436,131502
251170,202303,85,70,15,91140.26,19530,110670.26
251180,202303,306,176,130,229155.86,169262.45,398418.31
251190,202303,204,130,74,169263.39,96349.44,265612.83
251200,202303,322,250,72,326812.79,93744.44,420557.23
251203,202303,34,31,3,40362.69,3906,44268.69
251207,202303,87,70,17,91140.09,22134,113274.09
251210,202303,1653,1200,453,1563729.08,589813.56,2153542.64
251220,202303,49,37,12,48175.43,15624,63799.43
251230,202303,608,510,98,664029.99,127596.76,791626.75
251240,202303,125,88,37,114577.06,48174,162751.06
251250,202303,1669,1199,470,1561039.16,613249.75,2174288.91
251260,202303,13,9,4,11718.29,5208.4,16926.69
251270,202303,329,260,69,338527.25,89838.69,428365.94
251272,202303,64,55,9,71610.2,11718,83328.2
251274,202303,24,18,6,23436.87,7812,31248.87
251275,202303,36,20,16,27342.58,20832,48174.58
251276,202303,30,24,6,31249.01,7812,39061.01
251278,202303,14,11,3,14323.75,3906,18229.75
251280,202303,120,115,5,149730.2,6510,156240.2
251290,202303,1194,841,353,1095066.58,459629.36,1554695.94
251300,202303,18,13,5,16926,6510,23436
251310,202303,329,235,94,305979.17,122390.1,428369.27
251315,202303,42,39,3,50778,5208,55986
251320,202303,77,63,14,82026.84,18228,100254.84
251330,202303,85,75,10,97650,13020,110670
251335,202303,21,14,7,18228,9114,27342
251340,202303,872,487,385,634090.7,501273.51,1135364.21
251350,202303,37,36,1,46872,1302,48174
251360,202303,93,78,15,101556.2,19530,121086.2
251365,202303,8,8,0,10418.21,,10418.21
251370,202303,6319,4283,2036,5577971.5,2652211.84,8230183.34
251380,202303,48,37,11,48174.54,14322,62496.54
251385,202303,3,3,0,3906,,3906.0
251390,202303,1066,778,288,1012984.04,377588.86,1390572.90
251392,202303,39,27,12,35154.5,15624,50778.5
251394,202303,16,12,4,15624.6,5208,20832.6
251396,202303,11,7,4,9114,5208.2,14322.2
251398,202303,21,17,4,22134.4,5208,27342.4
251400,202303,55,43,12,55986,15624,71610
251410,202303,46,38,8,49476.35,10416,59892.35
251420,202303,115,82,33,106766.08,42966.67,149732.75
251430,202303,50,44,6,57288.96,7812,65100.96
251440,202303,55,29,26,37758,33852,71610
251445,202303,68,57,11,74218.26,14322.2,88540.46
251450,202303,408,346,62,450504.73,80724.9,531229.63
251455,202303,5,4,1,5208,1302,6510
251460,202303,24,19,5,24738,6510.02,31248.02
251465,202303,11,7,4,9114,5208,14322
251470,202303,52,38,14,49476,18228,67704
251480,202303,26,22,4,28644.62,5208.94,33853.56
251490,202303,115,66,49,85934.43,63799.01,149733.44
251500,202303,109,88,21,114576.62,27342,141918.62
251510,202303,98,62,36,80724.67,46872.62,127597.29
251520,202303,44,35,9,45570.99,11718,57288.99
251530,202303,4479,3146,1333,4098774.72,1738181.49,5836956.21
251540,202303,97,79,18,102858.35,23436.66,126295.01
251550,202303,444,337,107,438792.65,139317.95,578110.60
251560,202303,26,20,6,26040.1,7812,33852.1
251570,202303,16,15,1,19530,1302,20832
251580,202303,132,102,30,132805.34,39060,171865.34
251590,202303,107,76,31,98952.2,40362.3,139314.5
251593,202303,31,17,14,22134.25,18228,40362.25
251597,202303,128,101,27,131503.68,36456.23,167959.91
251600,202303,1134,782,352,1018188.79,459609.12,1477797.91
251610,202303,274,198,76,257802.26,98952.2,356754.46
251615,202303,21,18,3,23436,3906,27342
251620,202303,4295,2725,1570,3549350.05,2045473.03,5594823.08
251630,202303,504,370,134,481760.34,174472.18,656232.52
251640,202303,110,80,30,104165.6,39060,143225.6
251650,202303,313,229,84,298162.03,109368.2,407530.23
251660,202303,207,183,24,238269.98,31248.8,269518.78
251670,202303,430,324,106,421857.09,138012.75,559869.84
251675,202303,15,10,5,13020,6510,19530
251680,202303,110,96,14,124992.84,18228,143220.84
251690,202303,330,272,58,354480.47,75516.2,429996.67
251700,202303,283,241,42,313785.93,54684,368469.93
251710,202303,22,15,7,19530.41,9114,28644.41
251720,202303,34,25,9,32550,11718,44268
251740,202303,13,10,3,13020.8,3906,16926.8
260005,202303,3964,2049,1915,2667363.72,2494680.55,5162044.27
260010,202303,1848,1379,469,1795491.41,611945,2407436.41
260020,202303,432,374,58,486956.69,75516.9,562473.59
260030,202303,653,439,214,571592.15,278630,850222.15
260040,202303,813,514,299,669249.3,389302.02,1058551.32
260050,202303,1184,858,326,1117142.85,424455.66,1541598.51
260060,202303,373,341,32,443994.03,41664,485658.03
260070,202303,1384,842,542,1096347.05,705707.99,1802055.04
260080,202303,774,577,197,751271.62,256494,1007765.62
260090,202303,476,308,168,401020.02,218736.6,619756.62
260100,202303,229,153,76,199208.27,98952,298160.27
260105,202303,285,166,119,216134.17,156240.1,372374.27
260110,202303,3163,2282,881,2971351.76,1148376.1,4119727.86
260120,202303,2888,1537,1351,2001578.42,1761632.51,3763210.93
260130,202303,218,156,62,203115.76,80724,283839.76
260140,202303,2383,1525,858,1985604.48,1117130.63,3102735.11
260150,202303,196,128,68,166657.6,88537.4,255195.0
260160,202303,363,284,79,369781.18,102859.37,472640.55
260170,202303,3609,2148,1461,2796780.51,1903555.32,4700335.83
260180,202303,185,157,28,204419.66,36457.25,240876.91
260190,202303,2604,1686,918,2196517.23,1195244.22,3391761.45
260200,202303,1044,812,232,1057247.79,302065.39,1359313.18
260210,202303,1433,1028,405,1338495.65,527315.14,1865810.79
260220,202303,638,567,71,738251.32,92443.67,830694.99
260230,202303,1377,1004,373,1307252.52,485654.22,1792906.74
260240,202303,216,163,53,212231.98,69009.22,281241.20
260250,202303,105,81,24,105462.75,31248,136710.75
260260,202303,1148,797,351,1037709.3,457004.98,1494714.28
260270,202303,264,189,75,246082.81,97650,343732.81
260280,202303,1202,954,248,1242134.82,322901.48,1565036.30
260290,202303,7516,4022,3494,5239414.08,4551835.12,9791249.20
260300,202303,1110,934,176,1217424.31,229154.77,1446579.08
260310,202303,551,434,117,565078.6,152334.6,717413.2
260320,202303,845,603,242,785109.5,315084.99,1100194.49
260330,202303,93,71,22,92442.3,28644.3,121086.6
260340,202303,92,68,24,88536.65,31248,119784.65
260345,202303,6303,3213,3090,4183499.66,4025848.23,8209347.89
260350,202303,505,359,146,467432.43,190092.91,657525.34
260360,202303,256,148,108,192697.34,140616.48,333313.82
260370,202303,742,481,261,626275.93,341125.85,967401.78
260380,202303,565,407,158,529925.22,205718.19,735643.41
260390,202303,297,252,45,329410.58,58590.6,388001.18
260392,202303,128,109,19,141920.8,24739.15,166659.95
260400,202303,4743,2697,2046,3512865.17,2663914.97,6176780.14
260410,202303,16353,8403,7950,10947558.29,10360106.38,21307664.67
260415,202303,161,132,29,171864.96,37758,209622.96
260420,202303,1879,1188,691,1546808.94,899685.49,2446494.43
260430,202303,176,157,19,204422.39,24738.8,229161.19
260440,202303,211,141,70,183588.06,91141.16,274729.22
260450,202303,447,335,112,436184.1,145824.97,582009.07
260460,202303,901,475,426,618466.01,554657.57,1173123.58
260470,202303,336,206,130,269519.36,169262.04,438781.40
260480,202303,267,169,98,220038.6,127596,347634.6
260490,202303,241,182,59,236965.3,76818,313783.3
260500,202303,1218,805,413,1048132.61,537732.76,1585865.37
260510,202303,879,701,178,912719.64,231757.07,1144476.71
260515,202303,251,230,21,299462.32,27342.91,326805.23
260520,202303,3372,2065,1307,2691240.83,1701736.04,4392976.87
260530,202303,892,708,184,921855.74,239568.5,1161424.24
260540,202303,578,451,127,587214.9,165355.36,752570.26
260545,202303,29,15,14,19530.8,18228.78,37759.58
260550,202303,364,236,128,307274.34,166656.11,473930.45
260560,202303,511,390,121,507796.58,157543.63,665340.21
260570,202303,1075,858,217,1118457.22,282536.3,1400993.52
260580,202303,365,293,72,382791.02,93744,476535.02
260590,202303,643,377,266,490856.98,346332.4,837189.38
260600,202303,8315,4849,3466,6316164.72,4515379.86,10831544.58
260610,202303,518,350,168,455713.11,220041.27,675754.38
260620,202303,4024,2096,1928,2729102.76,2513056.29,5242159.05
260630,202303,84,74,10,96348.49,13020,109368.49
260640,202303,3547,2142,1405,2791558.39,1829330.06,4620888.45
260650,202303,334,243,91,316391.63,118482.4,434874.03
260660,202303,635,418,217,544255.14,282539.09,826794.23
260670,202303,114,80,34,104160,44268.12,148428.12
260680,202303,4379,2339,2040,3048129.87,2656128.38,5704258.25
260690,202303,137,105,32,136710.74,41664,178374.74
260700,202303,334,230,104,299466.9,135408.69,434875.59
260710,202303,50,42,8,54684,10416,65100
260720,202303,2870,1669,1201,2173072.67,1566311.68,3739384.35
260730,202303,801,588,213,768189.69,277327.37,1045517.06
260740,202303,78,65,13,84630.38,16926,101556.38
260750,202303,571,426,145,555966.18,188790.82,744757.00
260760,202303,800,395,405,514316.2,527325.2,1041641.4
260765,202303,1079,561,518,730436.46,674447.18,1404883.64
260770,202303,231,165,66,214812.28,85932.82,300745.10
260775,202303,924,475,449,618471.76,584607.85,1203079.61
260780,202303,242,148,94,192698.23,122388,315086.23
260790,202303,17126,8251,8875,10752333.23,11574901.19,22327234.42
260795,202303,161,104,57,135408.62,74214,209622.62
260800,202303,316,262,54,341128.42,70308.46,411436.88
260805,202303,39,27,12,35155.81,15624.35,50780.16
260810,202303,895,712,183,927033.9,238266.09,1165299.99
260820,202303,327,215,112,279933.59,145824,425757.59
260825,202303,219,149,70,193999.02,91140,285139.02
260830,202303,313,201,112,261702,145824,407526
260840,202303,287,206,81,268215.23,105462.99,373678.22
260845,202303,209,124,85,161450.29,110671.83,272122.12
260850,202303,438,326,112,424458.75,145824,570282.75
260860,202303,244,184,60,239571.11,78120,317691.11
260870,202303,353,275,78,358056.37,101556,459612.37
260875,202303,781,565,216,735669.48,281233.97,1016903.45
260880,202303,1704,1126,578,1466080.05,753859.47,2219939.52
260890,202303,2676,1826,850,2378811.83,1106709.16,3485520.99
260900,202303,1071,795,276,1035104.84,360655.46,1395760.30
260910,202303,258,205,53,266916.69,69006.6,335923.29
260915,202303,288,217,71,282534.7,92442,374976.7
260920,202303,237,130,107,169261.09,139314,308575.09
260930,202303,369,313,56,407535.72,72912.86,480448.58
260940,202303,2720,1449,1271,1886675.42,1656168.52,3542843.94
260950,202303,2102,1186,916,1544224.77,1192652.3,2736877.07
260960,202303,14975,7149,7826,9311147.64,10198802.13,19509949.77
260970,202303,457,366,91,476538.6,118482,595020.6
260980,202303,221,203,18,264309.93,23436.1,287746.03
260990,202303,2832,2234,598,2908753.7,778603.69,3687357.39
261000,202303,4411,2730,1681,3555825.44,2192585.89,5748411.33
261010,202303,136,101,35,131503.26,45570,177073.26
261020,202303,625,451,174,587213.82,226548.1,813761.92
261030,202303,263,194,69,252589.39,89838,342427.39
261040,202303,389,325,64,423157.85,83328,506485.85
261050,202303,559,459,100,597629.35,130201.42,727830.77
261060,202303,1707,1063,644,1384044.46,838492.72,2222537.18
261070,202303,10617,4966,5651,6467446.48,7368266.12,13835712.60
261080,202303,375,291,84,378890.12,109368,488258.12
261090,202303,2186,1675,511,2180944.17,665327.86,2846272.03
261100,202303,1291,888,403,1157512.54,524713.69,1682226.23
261110,202303,10051,6287,3764,8187386.66,4904733.98,13092120.64
261120,202303,234,199,35,259099.8,45570,304669.8
261130,202303,581,342,239,445298.34,311186.17,756484.51
261140,202303,224,140,84,182281.47,109368.37,291649.84
261150,202303,686,445,241,579394.23,313782.86,893177.09
261153,202303,74,69,5,89838.7,6510,96348.7
261160,202303,82098,39789,42309,51838273.1,55136962.37,106975235.47
261170,202303,518,386,132,502573.68,171865.22,674438.90
261180,202303,1869,1165,704,1519765.59,916617.86,2436383.45
261190,202303,620,419,201,545545.51,261705.11,807250.62
261200,202303,226,178,48,231763.16,62496.36,294259.52
261210,202303,46,34,12,44268.1,15624,59892.1
261220,202303,3008,2090,918,2722565.13,1196558.33,3919123.46
261230,202303,386,285,101,371078.29,131502.97,502581.26
261240,202303,441,378,63,492169.59,82027.25,574196.84
261245,202303,264,226,38,294252,49476,343728
261247,202303,179,136,43,177074.69,55986,233060.69
261250,202303,4108,1961,2147,2557180.74,2795415.96,5352596.70
261255,202303,259,229,30,298158.52,39060,337218.52
261260,202303,877,750,127,976558.25,165357.28,1141915.53
261270,202303,212,150,62,195300.83,80724,276024.83
261280,202303,205,164,41,213530.92,53382.66,266913.58
261290,202303,105,73,32,95046.24,41664.2,136710.44
261300,202303,1491,1115,376,1451768.72,490859.32,1942628.04
261310,202303,868,571,297,743458.34,386696.35,1130154.69
261320,202303,527,364,163,473942.26,212228.48,686170.74
261330,202303,928,729,199,949204.89,259109.05,1208313.94
261340,202303,346,191,155,248684.96,201812.8,450497.76
261350,202303,975,672,303,876277.11,394517.05,1270794.16
261360,202303,1471,920,551,1197848.82,717408.72,1915257.54
261370,202303,5312,3099,2213,4037616.41,2882671.21,6920287.62
261380,202303,591,464,127,604136.97,165354,769490.97
261390,202303,4019,2732,1287,3558509.64,1677016.58,5235526.22
261400,202303,287,253,34,330715.5,44268.74,374984.24
261410,202303,1193,781,412,1016895.43,539032.73,1555928.16
261420,202303,1015,618,397,804652.12,516897.9,1321550.02
261430,202303,333,299,34,389303.25,44268,433571.25
261440,202303,108,101,7,131504.42,9114,140618.42
261450,202303,2716,2092,624,2725136.11,812454.9,3537591.01
261460,202303,824,630,194,820284.39,252590.44,1072874.83
261470,202303,236,187,49,243475.43,63798,307273.43
261480,202303,502,374,128,486960.19,166599.08,653559.27
261485,202303,415,246,169,320301.56,220038.88,540340.44
261500,202303,665,427,238,555965.19,309877.9,865843.09
261510,202303,53,35,18,45570.98,23436.1,69007.08
261520,202303,105,88,17,114577.87,22134.2,136712.07
261530,202303,4555,2942,1613,3830563.32,2100143.66,5930706.98
261540,202303,1618,932,686,1213493.16,893181.97,2106675.13
261550,202303,271,125,146,162751.19,190092,352843.19
261560,202303,1017,669,348,871063.26,453101.62,1324164.88
261570,202303,411,330,81,429667.19,105462.95,535130.14
261580,202303,412,327,85,425760.1,110670.61,536430.71
261590,202303,209,164,45,213534.78,58591.59,272126.37
261600,202303,336,259,77,337226.29,100254.45,437480.74
261610,202303,96,79,17,102859.46,22134,124993.46
261618,202303,84,60,24,78120.86,31248,109368.86
261620,202303,208,134,74,174470.7,96348.88,270819.58
261630,202303,702,546,156,712200.41,203114.67,915315.08
261640,202303,7222,3808,3414,4962088.31,4449013.51,9411101.82
261650,202303,465,296,169,385393.55,220038.3,605431.85
270010,202303,524,462,62,601543.13,80725.08,682268.21
270020,202303,258,210,48,273425.2,62496.67,335921.87
270030,202303,9605,6139,3466,8001022.24,4517941.27,12518963.51
270040,202303,2142,1424,718,1856522.34,934843.44,2791365.78
270050,202303,243,189,54,246083.7,70308.61,316392.31
270060,202303,68,48,20,62501.27,26040.33,88541.60
270070,202303,799,589,210,766887.05,274724.24,1041611.29
270080,202303,51,40,11,52080.1,14322,66402.1
270090,202303,22,16,6,20832,7812,28644
270100,202303,1372,937,435,1220001.28,566373.77,1786375.05
270110,202303,63,51,12,66402,15624,82026
270120,202303,264,215,49,279938.79,63798.95,343737.74
270130,202303,327,250,77,325505.28,100254,425759.28
270135,202303,125,89,36,117181.4,46872,164053.4
270140,202303,1462,972,490,1266886.16,640594.04,1907480.20
270150,202303,265,191,74,248687.11,96349.67,345036.78
270160,202303,489,386,103,502614.73,134109.36,636724.09
270170,202303,833,552,281,718713.11,365863.67,1084576.78
270180,202303,58,46,12,59892.7,15624.1,75516.8
270190,202303,113,97,16,126297.7,20832,147129.7
270200,202303,119,104,15,135408.02,19530,154938.02
270210,202303,564,354,210,460912.22,273421.3,734333.52
270220,202303,200,141,59,183582.52,76818.88,260401.40
270230,202303,2265,1449,816,1886635.52,1065041.83,2951677.35
270235,202303,501,393,108,511711.28,140616,652327.28
270240,202303,3411,2694,717,3507648.57,933539.1,4441187.67
270250,202303,125,95,30,123693.48,39060,162753.48
270255,202303,213,178,35,231759.18,45570.44,277329.62
270260,202303,422,334,88,436185.18,114576.7,550761.88
270270,202303,98,53,45,69006.66,58590,127596.66
270280,202303,199,127,72,165354,93744,259098
270290,202303,1159,911,248,1187446.96,324201.64,1511648.60
270300,202303,381,278,103,361957.23,134106.2,496063.43
270310,202303,826,691,135,899704.28,175771.82,1075476.10
270320,202303,769,665,104,865846.72,135408,1001254.72
270330,202303,329,283,46,368466.12,59892,428358.12
270340,202303,68,56,12,72912,15624,88536
270350,202303,83,49,34,63802.15,44268.76,108070.91
270360,202303,81,46,35,59892,45570,105462
270370,202303,69,55,14,71610,18228,89838
270375,202303,85,54,31,70308.81,40362,110670.81
270380,202303,1068,738,330,960876.44,429660.67,1390537.11
270390,202303,135,81,54,105462.2,70308.5,175770.7
270400,202303,791,613,178,798140.98,231756.92,1029897.90
270410,202303,222,167,55,217444.44,71610,289054.44
270420,202303,421,297,124,386699.94,161448.7,548148.64
270430,202303,36309,25776,10533,33588427.29,13727352.95,47315780.24
270440,202303,469,370,99,481753.06,130201.46,611954.52
270450,202303,905,545,360,710898.09,468721.41,1179619.50
270460,202303,182,144,38,187492.93,49476,236968.93
270470,202303,1733,1206,527,1571552.27,686157.42,2257709.69
270480,202303,574,464,110,604140.66,143220.76,747361.42
270490,202303,24,19,5,24738,6510,31248
270500,202303,480,397,83,516900.55,108066,624966.55
270510,202303,920,614,306,799380.02,398414.13,1197794.15
270520,202303,269,181,88,235664.28,114576,350240.28
270530,202303,64,53,11,69007.2,14322,83329.2
270540,202303,83,59,24,76818,31248,108066
270550,202303,1666,1281,385,1667900.33,501271.2,2169171.53
270560,202303,255,155,100,201814.21,130200.5,332014.71
270570,202303,610,437,173,568979.01,225246,794225.01
270580,202303,19,14,5,18228,6510,24738
270590,202303,56,45,11,58590.3,14322.08,72912.38
270600,202303,167,140,27,182286.52,35154.1,217440.62
270610,202303,251,203,48,264310.7,62496.1,326806.8
270620,202303,18,18,0,23436,,23436.0
270630,202303,3701,2765,936,3602759.49,1219985.7,4822745.19
270640,202303,907,672,235,874960.2,305973.49,1180933.69
270642,202303,213,176,37,229154.35,48174,277328.35
270644,202303,261,169,92,220040.57,119786.44,339827.01
270650,202303,354,222,132,289048.08,171866.15,460914.23
270660,202303,199,175,24,227863.92,31248.15,259112.07
270670,202303,3025,2311,714,3010288.9,929630.61,3939919.51
270680,202303,399,264,135,343734.95,175770,519504.95
270690,202303,1254,847,407,1102824.5,531220.61,1634045.11
270700,202303,24,19,5,24738.19,6510,31248.19
270710,202303,565,440,125,572888.51,162750,735638.51
270720,202303,227,184,43,239572.18,55987.35,295559.53
270730,202303,1961,1234,727,1606698.17,947862.19,2554560.36
270740,202303,32,23,9,29946.18,11718,41664.18
270750,202303,623,483,140,628878.76,182281.08,811159.84
270760,202303,293,214,79,278634.8,102858.76,381493.56
270770,202303,2950,2033,917,2648662.61,1193944.86,3842607.47
270780,202303,67,41,26,53382,33852.78,87234.78
270790,202303,199,125,74,162752.87,97650.93,260403.80
270800,202303,2077,1672,405,2176992.3,527310,2704302.3
270810,202303,210,170,40,221341.48,52080.15,273421.63
270820,202303,118,81,37,105465.93,48174,153639.93
270830,202303,868,668,200,869768.05,260401.3,1130169.35
270840,202303,1332,1037,295,1351496.12,384091.36,1735587.48
270850,202303,1581,1037,544,1351490.41,708291.36,2059781.77
270860,202303,2678,1822,856,2372289.46,1114522.49,3486811.95
270870,202303,132,78,54,101557.07,70308.2,171865.27
270880,202303,863,684,179,890599.93,233061.63,1123661.56
270890,202303,258,200,58,260401.51,75517.6,335919.11
270895,202303,75,72,3,93744,3906,97650
270900,202303,67,56,11,72913.65,14322,87235.65
270910,202303,313,262,51,341134.39,66403.54,407537.93
270915,202303,1988,1339,649,1746017.13,845001.61,2591018.74
270920,202303,392,326,66,424457.12,85932,510389.12
270930,202303,5624,4351,1273,5669038.52,1657454.44,7326492.96
270940,202303,2242,1797,445,2341044.08,579392.5,2920436.58
280010,202303,33,27,6,35154.2,7812,42966.2
280020,202303,525,439,86,571593.43,111972.97,683566.40
280030,202303,23067,14836,8231,19330619.25,10720993.97,30051613.22
280040,202303,342,210,132,273423.72,173166.6,446590.32
280050,202303,452,350,102,455707.06,132804,588511.06
280060,202303,421,272,149,354153.6,195301.51,549455.11
280067,202303,1185,856,329,1114535.1,428359.06,1542894.16
280070,202303,126,108,18,140618.68,23436,164054.68
280100,202303,705,543,162,708300.07,210924.74,919224.81
280110,202303,90,78,12,101559.05,15624,117183.05
280120,202303,714,591,123,769494.74,160146.83,929641.57
280130,202303,1851,1214,637,1581951,829375.8,2411326.8
280140,202303,529,441,88,574188.89,114576.2,688765.09
280150,202303,439,317,122,412745.14,158844,571589.14
280160,202303,150,112,38,145826.41,49476,195302.41
280170,202303,442,310,132,403637.91,171865.51,575503.42
280190,202303,32,23,9,29946,11718,41664
280200,202303,51,40,11,52086.14,14322.3,66408.44
280210,202303,3146,2253,893,2934693.35,1163996.67,4098690.02
280220,202303,64,53,11,69008.16,14322,83330.16
280230,202303,341,275,66,358064.8,85934.33,443999.13
280240,202303,136,126,10,164055.19,13020,177075.19
280250,202303,22,11,11,14323.19,14323.87,28647.06
280260,202303,79,71,8,92445.22,10416,102861.22
280270,202303,142,110,32,143220.58,41664.88,184885.46
280280,202303,190,125,65,162754,84630.09,247384.09
280290,202303,4017,2914,1103,3794103.73,1436122.58,5230226.31
280300,202303,1745,1394,351,1816322.7,457006.56,2273329.26
280310,202303,106,99,7,128899.8,9114,138013.8
280320,202303,708,484,224,630192.21,291650.86,921843.07
280330,202303,329,243,86,316394.26,111972.2,428366.46
280340,202303,444,369,75,481749.42,97651.87,579401.29
280350,202303,3944,3015,929,3925716.29,1210876.66,5136592.95
280360,202303,497,340,157,442697.09,204414.78,647111.87
280370,202303,96,80,16,104161.03,20832,124993.03
280380,202303,53,42,11,54684,14322,69006
280390,202303,182,152,30,197908.52,39060,236968.52
280400,202303,430,281,149,365878.7,194001.01,559879.71
280410,202303,305,257,48,334621.58,62496,397117.58
280420,202303,144,124,20,161458.78,26040.95,187499.73
280430,202303,105,85,20,110671.45,26040,136711.45
280440,202303,735,604,131,786431.69,170565.19,956996.88
280445,202303,121,111,10,145826.65,13020.8,158847.45
280450,202303,1385,1182,203,1538999.05,265613.16,1804612.21
280460,202303,712,527,185,686171.08,242172.98,928344.06
280470,202303,102,94,8,122391.1,10416,132807.1
280480,202303,3384,2260,1124,2944048.63,1463494.04,4407542.67
280490,202303,208,197,11,256508.5,14322,270830.5
280500,202303,41,36,5,46873.1,6511.43,53384.53
280510,202303,139,110,29,143221.59,37759.62,180981.21
280520,202303,51,36,15,46873.29,19530,66403.29
280530,202303,73,47,26,61197.61,33852.38,95049.99
280540,202303,573,496,77,645801.17,100254,746055.17
280550,202303,773,712,61,927043.56,79422,1006465.56
280560,202303,493,446,47,583306.53,61195.61,644502.14
280570,202303,2491,1972,519,2568895.69,675742.37,3244638.06
280580,202303,609,478,131,622365.29,170562.96,792928.25
280590,202303,227,148,79,192714.33,102867.16,295581.49
280600,202303,426,347,79,453163.07,102858.8,556021.87
280610,202303,119,84,35,109375.08,45571.91,154946.99
280620,202303,571,464,107,604136.46,139314,743450.46
280630,202303,153,124,29,161450.59,37758.9,199209.49
280640,202303,180,146,34,190092.4,44268,234360.4
280650,202303,85,52,33,67706.46,42966.07,110672.53
280660,202303,123,92,31,119791.97,40362.21,160154.18
280670,202303,2155,1372,783,1786479.03,1019497.52,2805976.55
280680,202303,252,212,40,276026.41,52080,328106.41
280690,202303,77,67,10,87234,13020,100254
280700,202303,22,22,0,28644,,28644.0
280710,202303,1602,1240,362,1614514.96,471327.04,2085842.00
280720,202303,138,97,41,126297.79,53382,179679.79
280730,202303,33,29,4,37759.18,5208.05,42967.23
280740,202303,2679,2017,662,2626172.98,861927.96,3488100.94
280750,202303,236,206,30,268221.68,39061.52,307283.20
280760,202303,983,660,323,859351.76,420548.85,1279900.61
290010,202303,203,143,60,187488.46,78120,265608.46
290020,202303,197,173,24,225248.73,31248.9,256497.63
290030,202303,639,410,229,533826.39,299461.58,833287.97
290035,202303,135,109,26,141919.31,33852.93,175772.24
290040,202303,259,181,78,235667.68,101556,337223.68
290050,202303,93,75,18,97650,23436,121086
290060,202303,256,110,146,143221.46,190092.2,333313.66
290070,202303,6337,2999,3338,3906135.27,4348745.11,8254880.38
290080,202303,488,220,268,287745.35,351540.09,639285.44
290090,202303,330,153,177,199206.2,230454.96,429661.16
290100,202303,1786,1131,655,1472598.21,854116.08,2326714.29
290110,202303,927,518,409,674464.77,532529.3,1206994.07
290115,202303,182,167,15,217438.57,19530,236968.57
290120,202303,845,571,274,743454.4,356749.11,1100203.51
290130,202303,491,298,193,388000.22,252588.84,640589.06
290135,202303,299,225,74,292956.24,96348.1,389304.34
290140,202303,334,279,55,363262.66,71610.56,434873.22
290150,202303,151,102,49,132804,63798.01,196602.01
290160,202303,247,190,57,247388.06,74215.25,321603.31
290170,202303,112,80,32,104160.79,41664,145824.79
290180,202303,200,144,56,187490.63,72913,260403.63
290190,202303,366,285,81,371084.1,105464.08,476548.18
290195,202303,312,211,101,274724.14,131502.1,406226.24
290200,202303,266,211,55,274722.51,71610.1,346332.61
290205,202303,160,98,62,128898.4,80724,209622.4
290210,202303,1308,958,350,1247351.87,455705.19,1703057.06
290220,202303,173,106,67,138016.36,87235.1,225251.46
290225,202303,295,115,180,149732.64,234361.06,384093.70
290230,202303,94,55,39,71612.18,50778,122390.18
290240,202303,376,129,247,167960.19,321595.22,489555.41
290250,202303,243,224,19,291655.36,24738,316393.36
290260,202303,360,282,78,367182.23,101560.22,468742.45
290265,202303,193,169,24,220042.66,31248.35,251291.01
290270,202303,1418,1172,246,1526005.67,320293.4,1846299.07
290280,202303,511,357,154,464820.38,200508.4,665328.78
290290,202303,1505,916,589,1192656.06,766880.09,1959536.15
290300,202303,391,331,60,430970.81,78121.12,509091.93
290310,202303,290,138,152,179676.62,197904,377580.62
290320,202303,4504,2677,1827,3488199.08,2378780.75,5866979.83
290323,202303,212,184,28,239575.27,36456.2,276031.47
290327,202303,171,133,38,173173.26,49476.13,222649.39
290330,202303,128,58,70,75516.48,91140,166656.48
290340,202303,796,336,460,437489.23,598923.54,1036412.77
290350,202303,693,417,276,542940.49,359354.13,902294.62
290360,202303,328,258,70,335924.69,91140.39,427065.08
290370,202303,903,411,492,535124.21,640585.61,1175709.82
290380,202303,349,223,126,290349.84,164053.39,454403.23
290390,202303,2529,1576,953,2052013.34,1240817.18,3292830.52
290395,202303,236,138,98,179677.55,127596,307273.55
290400,202303,300,218,82,283837.7,106764,390601.7
290405,202303,244,209,35,272120.56,45570,317690.56
290410,202303,672,558,114,726521.6,148428,874949.6
290420,202303,286,231,55,300764.53,71610,372374.53
290430,202303,516,329,187,428360.42,243474,671834.42
290440,202303,91,74,17,96348.4,22134,118482.4
290450,202303,198,145,53,188790.06,69006,257796.06
290460,202303,2065,1229,836,1600194.13,1089774.98,2689969.11
290470,202303,1411,629,782,818984.17,1018174.26,1837158.43
290475,202303,585,546,39,710907.45,50778,761685.45
290480,202303,197,110,87,143221.3,113274.33,256495.63
290485,202303,241,218,23,283839.45,29946,313785.45
290490,202303,1342,945,397,1230410.57,522106.99,1752517.56
290500,202303,847,461,386,600232.93,502576.2,1102809.13
290510,202303,187,152,35,197915.4,45570.35,243485.75
290515,202303,190,116,74,151034.14,96348,247382.14
290520,202303,1462,962,500,1252533.52,652303.36,1904836.88
290530,202303,280,248,32,322908.75,41664.93,364573.68
290540,202303,134,64,70,83328,91140,174468
290550,202303,177,146,31,191395.44,40362,231757.44
290560,202303,3312,1501,1811,1954354.95,2357937.83,4312292.78
290570,202303,7359,3448,3911,4492104.29,5093525.7,9585629.99
290580,202303,1339,804,535,1046825.01,697872.9,1744697.91
290590,202303,595,475,120,618486.12,156244.63,774730.75
290600,202303,1856,1263,593,1644493.51,772097.72,2416591.23
290610,202303,188,172,16,223956.16,20832,244788.16
290620,202303,394,347,47,451803.38,61194.6,512997.98
290630,202303,2068,884,1184,1150996.87,1541578.58,2692575.45
290640,202303,135,106,29,138018.86,37758.05,175776.91
290650,202303,2153,1008,1145,1312466.08,1490801.58,2803267.66
290660,202303,274,225,49,292950.34,63798.72,356749.06
290670,202303,1113,556,557,723929.39,726524.87,1450454.26
290680,202303,1316,1054,262,1372332.68,341128.88,1713461.56
290682,202303,359,263,96,342429.75,124992.38,467422.13
290685,202303,269,160,109,208324.12,141918.2,350242.32
290687,202303,1265,835,430,1087408.47,559862.64,1647271.11
290689,202303,147,74,73,96348,95046.31,191394.31
290690,202303,579,264,315,343734.73,410133.13,753867.86
290700,202303,264,134,130,174475.81,169263.04,343738.85
290710,202303,828,576,252,749967.37,328108.74,1078076.11
290720,202303,1134,904,230,1177054.97,299461.63,1476516.60
290730,202303,1297,771,526,1003865.55,684859.1,1688724.65
290740,202303,29,25,4,32550,5208,37758
290750,202303,1553,676,877,880178.37,1143175.91,2023354.28
290755,202303,81,69,12,89838,15624,105462
290760,202303,268,231,37,300774.19,48175.52,348949.71
290770,202303,193,184,9,239572.87,11718,251290.87
290780,202303,1172,936,236,1218701.8,307277.26,1525979.06
290790,202303,417,283,134,368473.14,174472.2,542945.34
290800,202303,2499,1019,1480,1328066.61,1926972.75,3255039.36
290810,202303,502,345,157,449196.91,205717.17,654914.08
290820,202303,425,245,180,318999.65,234364.29,553363.94
290830,202303,494,349,145,454404.66,188790.28,643194.94
290840,202303,1951,1224,727,1593693.88,946560.04,2540253.92
290850,202303,1096,563,533,733038.31,693972.53,1427010.84
290860,202303,719,350,369,455707.07,480440.22,936147.29
290870,202303,648,444,204,578098.12,265608.87,843706.99
290880,202303,125,65,60,84630.8,78120,162750.8
290890,202303,519,310,209,403626.48,272121.12,675747.60
290900,202303,164,127,37,165354.94,48174,213528.94
290910,202303,417,318,99,414037.39,128898,542935.39
290920,202303,212,189,23,246081.89,29946,276027.89
290930,202303,555,421,134,548160.86,174470.1,722630.96
290940,202303,221,189,32,246079,41664,287743
290950,202303,164,94,70,122388.92,91140,213528.92
290960,202303,516,370,146,483048.67,190092.8,673141.47
290970,202303,238,209,29,272120.32,37758.2,309878.52
290980,202303,2049,1436,613,1869718.92,798134.94,2667853.86
290990,202303,431,364,67,473951.54,87236.48,561188.02
291000,202303,956,314,642,408830.47,835884,1244714.47
291005,202303,2808,1194,1614,1555963.51,2104068.09,3660031.60
291010,202303,125,110,15,143220.94,19530,162750.94
291020,202303,90,72,18,93744,23436,117180
291030,202303,111,83,28,108067.57,36456,144523.57
291040,202303,662,393,269,511688.06,350238.83,861926.89
291050,202303,1608,835,773,1087196.54,1006454.57,2093651.11
291060,202303,1752,970,782,1264271.19,1022078.83,2286350.02
291070,202303,2060,1547,513,2014243.61,669238.2,2683481.81
291072,202303,7657,2935,4722,3822847.43,6153302.91,9976150.34
291075,202303,258,214,44,278628.6,57288,335916.6
291077,202303,60,42,18,54684,23436,78120
291080,202303,22714,9719,12995,12658556.19,16931486.75,29590042.94
291085,202303,287,233,54,303372.56,70308.75,373681.31
291090,202303,257,105,152,136712.8,197904,334616.8
291100,202303,977,339,638,443982.88,830676,1274658.88
291110,202303,454,344,110,447894.89,143220.6,591115.49
291120,202303,2500,1339,1161,1743406.84,1511630.47,3255037.31
291125,202303,71,35,36,45570,46872,92442
291130,202303,180,154,26,200512.58,33852,234364.58
291140,202303,134,108,26,140616.81,33852.7,174469.51
291150,202303,367,135,232,175770.6,304668,480438.6
291160,202303,401,319,82,415354.34,106765.57,522119.91
291165,202303,50,37,13,48174,16926.62,65100.62
291170,202303,3567,1773,1794,2309803.22,2335796.05,4645599.27
291180,202303,1273,544,729,708301.17,951764.42,1660065.59
291185,202303,117,108,9,140617.34,11718,152335.34
291190,202303,1429,693,736,902309.25,958282.27,1860591.52
291200,202303,180,132,48,171865.1,62496,234361.1
291210,202303,2537,1047,1490,1365826.2,1939991.77,3305817.97
291220,202303,332,255,77,332011.74,100254.2,432265.94
291230,202303,962,347,615,451802.98,800732.75,1252535.73
291240,202303,406,375,31,488254.63,40362,528616.63
291250,202303,413,336,77,437472.69,100254,537726.69
291260,202303,66,56,10,72912.1,13020,85932.1
291270,202303,1040,464,576,604168.43,749972.33,1354140.76
291280,202303,369,176,193,229155.04,251286.8,480441.84
291290,202303,1689,896,793,1166643.28,1035108.61,2201751.89
291300,202303,250,185,65,240873.04,84630,325503.04
291310,202303,231,199,32,259103.18,41664.7,300767.88
291320,202303,1329,927,402,1208297.24,523406.62,1731703.86
291330,202303,140,116,24,151034.92,31248.2,182283.12
291340,202303,242,149,93,194003.18,121087.13,315090.31
291345,202303,125,90,35,117180.4,45570,162750.4
291350,202303,1863,722,1141,940049.23,1486884.83,2426934.06
291360,202303,9079,4325,4754,5632730.54,6195047.49,11827778.03
291370,202303,1205,726,479,945297.79,623667.96,1568965.75
291380,202303,271,209,62,272119.65,80724,352843.65
291390,202303,4261,1898,2363,2473859.41,3079252.09,5553111.50
291400,202303,2170,1506,664,1960873.47,867148.1,2828021.57
291410,202303,238,196,42,255195.93,54684,309879.93
291420,202303,123,93,30,121086,39060,160146
291430,202303,188,117,71,152335.02,92442,244777.02
291440,202303,553,447,106,582008.96,138012.2,720021.16
291450,202303,1041,690,351,898404.14,458309.85,1356713.99
291460,202303,2154,1673,481,2178324.42,626276.23,2804600.65
291465,202303,2409,1166,1243,1519467.77,1620997.57,3140465.34
291470,202303,3040,1534,1506,1997318.41,1960832.33,3958150.74
291480,202303,12741,5543,7198,7222465.03,9384890.15,16607355.18
291490,202303,730,294,436,384094.79,567672.2,951766.99
291500,202303,369,223,146,291359.52,190092.47,481451.99
291510,202303,1179,468,711,609338.98,925722.49,1535061.47
291520,202303,951,432,519,562478.44,677041.35,1239519.79
291530,202303,938,284,654,369770.39,852810.6,1222580.99
291535,202303,137,114,23,148428.19,31248.91,179677.10
291540,202303,346,119,227,154941.49,295555.82,450497.31
291550,202303,1300,621,679,808554.62,885361.97,1693916.59
291560,202303,5298,2696,2602,3511553.21,3389118.58,6900671.79
291570,202303,244,128,116,166657.39,151033.33,317690.72
291580,202303,1246,787,459,1024693.41,598923.43,1623616.84
291590,202303,115,54,61,70308.62,79422,149730.62
291600,202303,1179,599,580,779915.47,755164.31,1535079.78
291610,202303,1524,743,781,967448.71,1016889.23,1984337.94
291620,202303,573,270,303,351553.81,394508.89,746062.70
291630,202303,485,149,336,193999.15,437472.2,631471.35
291640,202303,4280,2070,2210,2695212.99,2880051.36,5575264.35
291650,202303,469,328,141,427073.5,183585.01,610658.51
291660,202303,366,149,217,194000.94,282536.07,476537.01
291670,202303,167,105,62,136713.49,80724.43,217437.92
291680,202303,635,391,244,510414.29,317691.63,828105.92
291685,202303,640,371,269,483054.56,350241.08,833295.64
291690,202303,504,327,177,425757.88,230455.42,656213.30
291700,202303,1084,834,250,1085892.95,326804.94,1412697.89
291710,202303,1645,796,849,1037715.62,1108008.78,2145724.40
291720,202303,467,317,150,412736.02,195300.9,608036.92
291730,202303,974,562,412,731747.57,536427.89,1268175.46
291733,202303,326,222,104,289046.14,135408.19,424454.33
291735,202303,91,68,23,88536.2,29946,118482.2
291740,202303,351,266,85,346333.9,110670,457003.9
291750,202303,2533,1597,936,2080093.97,1218699.45,3298793.42
291760,202303,3206,1777,1429,2316273.51,1861861.67,4178135.18
291770,202303,779,521,258,678376.3,337227.13,1015603.43
291780,202303,105,66,39,85932.58,50778.8,136711.38
291790,202303,163,87,76,113274,98953.47,212227.47
291800,202303,10997,4795,6202,6244621.23,8081611.06,14326232.29
291810,202303,1093,818,275,1065063.87,358055.7,1423119.57
291820,202303,296,214,82,278628.7,106764,385392.7
291830,202303,1043,441,602,575505.82,783812,1359317.82
291835,202303,578,534,44,695278.31,57288.18,752566.49
291840,202303,5755,2898,2857,3774715.01,3726411.84,7501126.85
291845,202303,290,97,193,126294,251286,377580
291850,202303,314,276,38,359363.04,49477.59,408840.63
291855,202303,266,113,153,147127.18,199206.58,346333.76
291860,202303,156,102,54,132804.52,70308.26,203112.78
291870,202303,82,37,45,48174,58590,106764
291875,202303,167,154,13,200511.46,16926.84,217438.30
291880,202303,442,366,76,476545.69,98955.61,575501.30
291890,202303,262,91,171,118482.3,222642.6,341124.9
291900,202303,60,36,24,46872,31248,78120
291905,202303,128,98,30,127598.37,39060.65,166659.02
291910,202303,153,122,31,158844.11,40362.1,199206.21
291915,202303,457,399,58,519519.83,75517.6,595037.43
291920,202303,6489,3102,3387,4041623.79,4409977.24,8451601.03
291930,202303,173,105,68,136713,88536.25,225249.25
291940,202303,418,246,172,320294.35,223944,544238.35
291950,202303,1246,967,279,1259043.37,363259.28,1622302.65
291955,202303,1526,911,615,1187459.36,803343.92,1990803.28
291960,202303,203,151,52,196603.08,67704,264307.08
291970,202303,792,577,215,751272.67,279931.83,1031204.50
291980,202303,1456,1255,201,1634044.41,261705.55,1895749.96
291990,202303,147,136,11,177075.21,14322,191397.21
291992,202303,218,106,112,138019.6,145828.06,283847.66
291995,202303,193,123,70,160147.21,91140.2,251287.41
292000,202303,435,311,124,406230.37,161448.16,567678.53
292010,202303,376,260,116,338520.41,151032.6,489553.01
292020,202303,312,230,82,299463.49,106764,406227.49
292030,202303,164,127,37,165356.52,48174,213530.52
292040,202303,610,332,278,432264,361956,794220
292045,202303,125,109,16,141918.7,20832.54,162751.24
292050,202303,974,704,270,917922.61,351542.68,1269465.29
292060,202303,975,798,177,1039038.95,230456.66,1269495.61
292070,202303,68,26,42,33852.2,54684,88536.2
292080,202303,176,122,54,158844.41,70308,229152.41
292090,202303,583,213,370,277327.9,483042.2,760370.1
292100,202303,1711,748,963,973944.59,1253856.42,2227801.01
292105,202303,179,161,18,210924.8,23436,234360.8
292110,202303,2399,899,1500,1171826.75,1954311.08,3126137.83
292120,202303,739,559,180,727851.2,234362.29,962213.49
292130,202303,504,272,232,354149.19,303366.19,657515.38
292140,202303,219,178,41,231762.27,53382.97,285145.24
292145,202303,173,98,75,127596,98952,226548
292150,202303,1574,1312,262,1708257.33,341127.09,2049384.42
292160,202303,179,139,40,180978.7,52080.29,233058.99
292170,202303,1214,1026,188,1335904.48,244779.84,1580684.32
292180,202303,251,176,75,229152,97650.1,326802.1
292190,202303,157,100,57,130201.42,74214.97,204416.39
292200,202303,1495,548,947,716116.94,1234303.82,1950420.76
292205,202303,122,101,21,131502.78,27342,158844.78
292210,202303,410,270,140,351549.98,182281.29,533831.27
292220,202303,33,22,11,28644.9,14322,42966.9
292225,202303,63,50,13,65102.71,16926.6,82029.31
292230,202303,1031,801,230,1042936.37,299461.97,1342398.34
292240,202303,666,479,187,623676.6,243474.5,867151.1
292250,202303,1690,1086,604,1414019.13,786414.33,2200433.46
292260,202303,431,255,176,332015.36,229153.71,561169.07
292265,202303,254,193,61,251292.21,79422.57,330714.78
292270,202303,741,374,367,486954.47,477834,964788.47
292273,202303,223,131,92,170562.9,119784.08,290346.98
292275,202303,188,97,91,127596.5,118482,246078.5
292280,202303,154,107,47,139314,61194,200508
292285,202303,98,76,22,98952,28644,127596
292290,202303,665,443,222,576799.63,289045.38,865845.01
292300,202303,1971,784,1187,1020793.61,1545497.89,2566291.50
292303,202303,142,99,43,128899.16,55987.28,184886.44
292305,202303,126,90,36,118483.91,46872,165355.91
292310,202303,1037,685,352,891890.46,458310.07,1350200.53
292320,202303,616,460,156,598926.8,203113.86,802040.66
292330,202303,176,111,65,144523.68,84630,229153.68
292335,202303,321,256,65,333315.92,84630,417945.92
292340,202303,579,401,178,522107.93,231756.55,753864.48
292350,202303,294,152,142,197905.91,184884,382789.91
292360,202303,769,574,195,747351.27,253891.51,1001242.78
292370,202303,735,562,173,731733.3,225246.79,956980.09
292380,202303,631,523,108,682267.19,140616.49,822883.68
292390,202303,397,161,236,209624.72,307273.59,516898.31
292400,202303,4004,2419,1585,3149642.09,2064983.67,5214625.76
292405,202303,281,186,95,242172.8,126294,368466.8
292410,202303,112,71,41,92443.4,53382,145825.4
292420,202303,278,239,39,311179.17,50778,361957.17
292430,202303,554,397,157,516896.64,204414.51,721311.15
292440,202303,676,563,113,733039.78,148430.13,881469.91
292450,202303,245,186,59,242174.13,76818.8,318992.93
292460,202303,528,401,127,522106.86,165355.08,687461.94
292465,202303,210,178,32,231758.32,41664.1,273422.42
292467,202303,184,121,63,157542.27,82026,239568.27
292470,202303,327,219,108,285139.19,140616,425755.19
292480,202303,422,284,138,369779.64,179678.78,549458.42
292490,202303,255,189,66,246080.32,87235.49,333315.81
292500,202303,986,483,503,628888.42,656217.98,1285106.40
292510,202303,3808,1861,1947,2424372.86,2536313.17,4960686.03
292520,202303,1261,600,661,781228.76,860633.28,1641862.04
292525,202303,473,348,125,453108.79,162753.51,615862.30
292530,202303,5332,2181,3151,2842340.58,4105247.68,6947588.26
292540,202303,483,282,201,367166.53,261702.96,628869.49
292550,202303,1181,656,525,854125.9,683554.25,1537680.15
292560,202303,341,310,31,403634.32,41664.16,445298.48
292570,202303,356,273,83,355447.79,108066,463513.79
292575,202303,589,428,161,557282.15,209624.96,766907.11
292580,202303,1073,727,346,946563.99,450495.3,1397059.29
292590,202303,587,522,65,679651.31,84631.1,764282.41
292593,202303,145,114,31,148428.58,40362,188790.58
292595,202303,221,174,47,226550.88,61194,287744.88
292600,202303,1340,949,391,1236943.94,510393.74,1747337.68
292610,202303,117,95,22,123697.1,28645.34,152342.44
292620,202303,539,450,89,585932.24,115879.73,701811.97
292630,202303,1652,901,751,1174429.33,979109.32,2153538.65
292640,202303,925,638,287,831993.46,373679.1,1205672.56
292650,202303,185,138,47,179683.31,61194,240877.31
292660,202303,2084,1471,613,1915309.12,798141.73,2713450.85
292665,202303,139,97,42,126295.28,54684,180979.28
292670,202303,396,301,95,393206.18,123690.21,516896.39
292680,202303,270,204,66,265609.45,85932,351541.45
292690,202303,210,146,64,190092.9,83328,273420.9
292700,202303,1071,697,374,908823.85,489559.32,1398383.17
292710,202303,118,101,17,131503.74,22134.31,153638.05
292720,202303,1057,607,450,790323.15,585900.78,1376223.93
292730,202303,219,107,112,139316.69,147126.4,286443.09
292740,202303,81693,38768,42925,50505801.62,55927331.51,106433133.13
292750,202303,414,302,112,393215.08,145827.68,539042.76
292760,202303,349,296,53,385396.46,69006.38,454402.84
292770,202303,934,391,543,511695.28,708296.32,1219991.60
292780,202303,40,16,24,20832.92,31248.85,52081.77
292790,202303,821,438,383,570279.64,498666.2,1068945.84
292800,202303,1338,797,541,1037713.72,704388.74,1742102.46
292805,202303,414,157,257,204414.65,334615.49,539030.14
292810,202303,1907,1124,783,1463478.69,1019470.38,2482949.07
292820,202303,716,605,111,787740.09,144525.87,932265.96
292830,202303,144,111,33,144526.45,42967.08,187493.53
292840,202303,735,590,145,768204.42,188792.51,956996.93
292850,202303,144,98,46,127598.58,59893.7,187492.28
292860,202303,2219,1267,952,1649701.32,1242126.57,2891827.89
292870,202303,3931,2557,1374,3333200.46,1788959.24,5122159.70
292880,202303,1510,1003,507,1305937.56,661423.42,1967360.98
292890,202303,570,474,96,617164.52,124995.28,742159.80
292895,202303,139,99,40,128898.75,52080,180978.75
292900,202303,338,242,96,315098.1,124995.98,440094.08
292905,202303,525,258,267,335923.16,347638.03,683561.19
292910,202303,550,414,136,539037.14,177073.11,716110.25
292920,202303,609,272,337,355454.23,438782.05,794236.28
292925,202303,490,449,41,584600.1,53383.22,637983.32
292930,202303,770,468,302,609347.69,393208.42,1002556.11
292935,202303,280,124,156,161448.23,203113.1,364561.33
292937,202303,218,147,71,191396.23,92442,283838.23
292940,202303,199,153,46,199207.76,59892,259099.76
292950,202303,1446,691,755,899711.85,984322.01,1884033.86
292960,202303,517,369,148,480456.35,192698.31,673154.66
292970,202303,260,191,69,248686.93,89839.73,338526.66
292975,202303,97,51,46,66407.13,59894.15,126301.28
292980,202303,368,255,113,333316.74,147127.88,480444.62
292990,202303,1358,1015,343,1321538.23,446587.29,1768125.52
293000,202303,119,82,37,106766.53,48174.1,154940.63
293010,202303,3213,1904,1309,2479151.81,1708255.65,4187407.46
293015,202303,645,530,115,690075.35,149730,839805.35
293020,202303,359,281,78,365878.72,101558.61,467437.33
293030,202303,586,521,65,678349.71,84630,762979.71
293040,202303,395,313,82,407527.87,106764.68,514292.55
293050,202303,3235,1890,1345,2462154.96,1756422.57,4218577.53
293060,202303,237,191,46,249995.78,59892.5,309888.28
293070,202303,4082,2052,2030,2671810.25,2645702.11,5317512.36
293075,202303,101,71,30,92443.95,39060,131503.95
293076,202303,86,64,22,83329.91,28644,111973.91
293077,202303,630,358,272,466137.22,354150.66,820287.88
293080,202303,441,392,49,510389.96,63798.66,574188.62
293090,202303,139,123,16,160146,20832,180978
293100,202303,552,373,179,485655.64,234360.51,720016.15
293105,202303,359,263,96,342428.21,124992,467420.21
293110,202303,130,85,45,110675.96,58593.7,169269.66
293120,202303,306,219,87,285148.02,114580.01,399728.03
293130,202303,257,173,84,226553.2,109368,335921.2
293135,202303,8837,3591,5246,4679527.07,6835526.67,11515053.74
293140,202303,204,122,82,158847.55,106765.42,265612.97
293150,202303,328,284,44,369777.93,57288.82,427066.75
293160,202303,437,272,165,354146.83,214830.9,568977.73
293170,202303,267,164,103,213535.03,134108.51,347643.54
293180,202303,631,427,204,555957.87,265608,821565.87
293190,202303,1450,1002,448,1305942.51,583306.02,1889248.53
293200,202303,608,528,80,687473.46,104160,791633.46
293210,202303,433,329,104,429669.82,135408,565077.82
293220,202303,2444,1093,1351,1423112.09,1760314.15,3183426.24
293230,202303,1870,698,1172,910122.57,1527249.85,2437372.42
293240,202303,235,212,23,276034.8,29947.1,305981.9
293245,202303,132,108,24,140618.51,31248,171866.51
293250,202303,845,360,485,468735.26,631483.53,1100218.79
293260,202303,336,264,72,343731.12,93744,437475.12
293270,202303,1235,553,682,720014.05,887964.1,1607978.15
293280,202303,324,217,107,282537.34,139314.93,421852.27
293290,202303,3185,2037,1148,2652255.25,1496012.75,4148268.00
293300,202303,931,637,294,830687.24,382788.84,1213476.08
293305,202303,199,152,47,197905.6,61194.65,259100.25
293310,202303,177,132,45,171866.05,58590.7,230456.75
293315,202303,177,133,44,173169.81,57288.94,230458.75
293317,202303,93,68,25,88536.2,32550,121086.2
293320,202303,1307,669,638,871110.57,833302.88,1704413.45
293325,202303,221,92,129,119784,167958,287742
293330,202303,15585,7183,8402,9359076.67,10952554.62,20311631.29
293340,202303,299,210,89,273421.4,115878,389299.4
293345,202303,263,219,44,285144.1,57288,342432.1
293350,202303,604,383,221,498681.66,287743.84,786425.50
293360,202303,1556,1088,468,1416613.2,609343.57,2025956.77
310010,202303,144,76,68,98952.77,88536.04,187488.81
310020,202303,1016,556,460,723930.51,600228.18,1324158.69
310030,202303,319,255,64,332015.22,83330.5,415345.72
310040,202303,48,33,15,42966,19530,62496
310050,202303,167,105,62,136710.21,80724,217434.21
310060,202303,287,205,82,266919.09,106764.86,373683.95
310070,202303,20,12,8,15624.64,10416.2,26040.84
310080,202303,53,36,17,46872,23436.83,70308.83
310090,202303,1165,651,514,847622.08,670538.24,1518160.32
310100,202303,393,274,119,356760.35,154939.7,511700.05
310110,202303,728,389,339,506488.14,442684.43,949172.57
310120,202303,469,263,206,342427.52,269515.23,611942.75
310130,202303,36,19,17,24738.2,22134,46872.2
310140,202303,25,9,16,11718,20832.76,32550.76
310150,202303,1245,817,428,1063770.59,557267.03,1621037.62
310160,202303,2235,1105,1130,1438750.36,1472573.25,2911323.61
310163,202303,106,62,44,80724,57288,138012
310170,202303,2744,1321,1423,1719984.46,1852764.6,3572749.06
310180,202303,197,92,105,119785.94,136710,256495.94
310190,202303,502,338,164,440081.99,213530.7,653612.69
310200,202303,442,280,162,364565.47,210924.2,575489.67
310205,202303,83,56,27,74214.87,35154,109368.87
310210,202303,280,228,52,296859.32,67704,364563.32
310220,202303,66,41,25,53382.47,32550,85932.47
310230,202303,292,209,83,272121.92,108066,380187.92
310240,202303,129,103,26,134106,33852,167958
310250,202303,94,77,17,100256.42,22134,122390.42
310260,202303,799,431,368,561184.02,481744.99,1042929.01
310270,202303,294,187,107,243480.46,139314.14,382794.60
310280,202303,414,290,124,377583.33,161448,539031.33
310285,202303,213,163,50,212228.41,65100.85,277329.26
310290,202303,239,131,108,170563.94,141918,312481.94
310300,202303,183,146,37,190094.13,48174,238268.13
310310,202303,13,11,2,14322,2604,16926
310320,202303,31,11,20,14322.18,26040.17,40362.35
310330,202303,49,37,12,48174.24,15624.66,63798.90
310340,202303,1955,1402,553,1826737.27,722612.98,2549350.25
310350,202303,2917,1514,1403,1972598.2,1826719.23,3799317.43
310360,202303,52,40,12,52080.67,15624.33,67705.00
310370,202303,136,112,24,145824,31248,177072
310375,202303,111,43,68,55987.06,88537.63,144524.69
310380,202303,53,34,19,44268,24738,69006
310390,202303,114,68,46,88536.94,59892,148428.94
310400,202303,2694,1778,916,2320264.2,1192642.89,3512907.09
310410,202303,119,70,49,91141.23,63798,154939.23
310420,202303,716,370,346,481751.95,451799.82,933551.77
310430,202303,294,189,105,246079.38,136710,382789.38
310440,202303,81,51,30,66402.73,39060,105462.73
310445,202303,86,73,13,95047.2,16926,111973.2
310450,202303,694,460,234,598937.66,304669.13,903606.79
310460,202303,266,181,85,235665.26,110670.31,346335.57
310470,202303,564,367,197,479148.8,256496.99,735645.79
310480,202303,105,66,39,85932,50778,136710
310490,202303,596,289,307,376285.6,399715.11,776000.71
310500,202303,135,58,77,75518.36,100254,175772.36
310510,202303,643,453,190,589821.51,247381.13,837202.64
310520,202303,154,107,47,139316.9,61194,200510.9
310530,202303,128,54,74,70308.43,96348,166656.43
310540,202303,513,288,225,374987.39,292952.91,667940.30
310550,202303,78,52,26,67706.06,33852,101558.06
310560,202303,3362,2296,1066,2990788.17,1389237.47,4380025.64
310570,202303,111,70,41,91140,53382,144522
310590,202303,414,243,171,316395.43,222642.7,539038.13
310600,202303,141,66,75,85934.1,97650,183584.1
310610,202303,45,16,29,20832.7,37758,58590.7
310620,202303,53608,25434,28174,33129108.74,36715368.03,69844476.77
310630,202303,811,485,326,631487.82,424454.21,1055942.03
310640,202303,160,106,54,138012.2,70308.2,208320.4
310650,202303,178,159,19,207018.11,24738,231756.11
310660,202303,116,77,39,102814.8,50778,153592.8
310665,202303,71,49,22,63798,28644,92442
310670,202303,7857,3415,4442,4451716.44,5784824.52,10236540.96
310680,202303,64,41,23,53382,29946,83328
310690,202303,626,451,175,588516.56,227853.24,816369.80
310700,202303,63,38,25,49476.2,32550.97,82027.17
310710,202303,1332,899,433,1172190.54,566375.87,1738566.41
310720,202303,164,47,117,61194,152334,213528
310730,202303,1648,1116,532,1453091.93,693983.44,2147075.37
310740,202303,1052,575,477,748680.53,622362.45,1371042.98
310750,202303,260,165,95,214832.42,123690.37,338522.79
310760,202303,75,57,18,74217.48,23436,97653.48
310770,202303,87,40,47,52080.1,61194,113274.1
310780,202303,376,305,71,397115.97,92442.8,489558.77
310790,202303,118,94,24,122388.3,31248.59,153636.89
310800,202303,503,238,265,309878.56,346332,656210.56
310810,202303,185,122,63,158845.64,82026.59,240872.23
310820,202303,318,255,63,333319.27,82026.04,415345.31
310825,202303,215,178,37,231758.11,48174,279932.11
310830,202303,478,216,262,281235.02,341126.1,622361.12
310840,202303,384,234,150,304670.32,195300.39,499970.71
310850,202303,76,62,14,80724.95,18228,98952.95
310855,202303,454,357,97,464824.03,127596,592420.03
310860,202303,1698,1257,441,1636664.54,575495.59,2212160.13
310870,202303,65,55,10,71610.79,13020,84630.79
310880,202303,95,75,20,97650,26040,123690
310890,202303,303,176,127,229154.78,166656,395810.78
310900,202303,658,303,355,394512.49,462216.83,856729.32
310910,202303,258,171,87,222645.15,113274,335919.15
310920,202303,445,255,190,332022.36,247389,579411.36
310925,202303,39,31,8,40362.15,10416,50778.15
310930,202303,1412,952,460,1239524,602831.37,1842355.37
310940,202303,723,355,368,462224.5,479142.93,941367.43
310945,202303,148,97,51,126294.74,66402,192696.74
310950,202303,222,174,48,226549.07,62496,289045.07
310960,202303,75,28,47,36458.81,61195.57,97654.38
310970,202303,183,106,77,138015.2,100254.6,238269.8
310980,202303,54,35,19,45574.89,24738,70312.89
310990,202303,161,85,76,110670.68,98953.05,209623.73
311000,202303,904,462,442,601537.36,575490.38,1177027.74
311010,202303,54,41,13,53383.44,16926,70309.44
311020,202303,40,25,15,32550.55,19530,52080.55
311030,202303,415,237,178,308575.5,231756.98,540332.48
311040,202303,39,31,8,40362,10416,50778
311050,202303,534,204,330,265609.4,429661.58,695270.98
311060,202303,860,475,385,618462.91,502577.03,1121039.94
311070,202303,354,161,193,209623.18,251286,460909.18
311080,202303,128,73,55,95048.27,71611.61,166659.88
311090,202303,359,176,183,229157.71,239569.12,468726.83
311100,202303,583,355,228,462215.08,296856.25,759071.33
311110,202303,725,516,209,671855.72,273426.52,945282.24
311115,202303,83,56,27,72912.02,35154.2,108066.22
311120,202303,1176,655,521,852840.9,678348.64,1531189.54
311130,202303,295,170,125,221345.42,162750,384095.42
311140,202303,180,101,79,131505.83,102860.18,234366.01
311150,202303,338,216,122,281236.73,158844,440080.73
311160,202303,796,565,231,735643.64,302065.75,1037709.39
311170,202303,97,79,18,102858.69,23436,126294.69
311180,202303,325,221,104,287751.24,135409.44,423160.68
311190,202303,37,17,20,23436,26040,49476
311200,202303,357,240,117,312482.3,152334.9,464817.2
311205,202303,34,27,7,35154,9114,44268
311210,202303,36,32,4,41664.6,5208,46872.6
311220,202303,33,29,4,37758,5208,42966
311230,202303,1753,1170,583,1523398.53,759074.09,2282472.62
311240,202303,83,53,30,69009.39,39060.54,108069.93
311250,202303,64,27,37,35154,48174,83328
311260,202303,563,345,218,449197.5,283836.14,733033.64
311265,202303,138,90,48,117180.93,62496,179676.93
311270,202303,291,198,93,257799.75,121088.41,378888.16
311280,202303,207,91,116,118484,151032,269516
311290,202303,107,92,15,119785.51,19530.2,139315.71
311300,202303,614,390,224,507789.02,291650.49,799439.51
311310,202303,20,16,4,20832,5208,26040
311320,202303,670,503,167,654918.49,217435.53,872354.02
311330,202303,1265,926,339,1205686.35,441388.08,1647074.43
311340,202303,2806,1967,839,2562400.77,1092384.11,3654784.88
311350,202303,275,209,66,272121.75,85932,358053.75
311360,202303,169,104,65,135410.15,84630,220040.15
311370,202303,1281,549,732,717431.16,954378.56,1671809.72
311380,202303,7,6,1,7812,1302,9114
311390,202303,252,147,105,191396.41,136710.2,328106.61
311400,202303,141,88,53,114576.8,69006,183582.8
311410,202303,126,59,67,76818.53,87234,164052.53
311420,202303,332,168,164,218741.5,214831.67,433573.17
311430,202303,876,577,299,751265.24,389299,1140564.24
311440,202303,472,320,152,417955.28,197905.83,615861.11
311450,202303,320,187,133,243476.65,173166.92,416643.57
311455,202303,281,189,92,246085.37,119785.36,365870.73
311460,202303,134,60,74,78120.7,96348.65,174469.35
311470,202303,33,14,19,18228,24738,42966
311480,202303,57,31,26,40362,33852,74214
311490,202303,11,6,5,7812,6510,14322
311500,202303,32,16,16,20832.53,20832,41664.53
311510,202303,830,565,265,735648.88,346333.84,1081982.72
311520,202303,41,35,6,45570,7812,53382
311530,202303,1930,1388,542,1808576.03,706989.12,2515565.15
311535,202303,66,43,23,55987.05,29946.52,85933.57
311540,202303,35,31,4,40362.13,5208,45570.13
311545,202303,178,129,49,167960.43,63798,231758.43
311547,202303,60,47,13,61194,16926.45,78120.45
311550,202303,724,333,391,433578.09,510387.41,943965.50
311560,202303,44,27,17,35154.83,22134,57288.83
311570,202303,299,197,102,256497.76,132806.18,389303.94
311580,202303,438,281,157,365868.13,204415.14,570283.27
311590,202303,29,24,5,31249.08,6510,37759.08
311600,202303,95,76,19,98956.13,24739.14,123695.27
311610,202303,262,226,36,294254.3,48174.73,342429.03
311615,202303,175,145,30,188791.27,39060.52,227851.79
311620,202303,33,23,10,29946.9,13020,42966.9
311630,202303,112,97,15,126294.92,19530,145824.92
311640,202303,137,67,70,87235.6,91143.34,178378.94
311650,202303,132,91,41,118482,53382.2,171864.2
311660,202303,458,211,247,274725.35,322897.27,597622.62
311670,202303,160,107,53,139129.94,69006.43,208136.37
311680,202303,234,175,59,227852.18,76818.18,304670.36
311690,202303,13,12,1,15624.5,1302,16926.5
311700,202303,205,154,51,200510.26,66402.96,266913.22
311710,202303,187,125,62,162752,80724,243476
311720,202303,40,30,10,39061.09,13020,52081.09
311730,202303,607,431,176,561180.56,229153.15,790333.71
311740,202303,29,20,9,26040,11718,37758
311750,202303,762,517,245,673142.09,318991.65,992133.74
311760,202303,85,38,47,49478.12,61195.08,110673.20
311770,202303,382,190,192,247382.87,249984.61,497367.48
311780,202303,221,117,104,152335.48,135408.37,287743.85
311783,202303,98,87,11,113275.54,14322,127597.54
311787,202303,51,19,32,24738,41664.04,66402.04
311790,202303,273,121,152,157543.31,197906.91,355450.22
311800,202303,797,482,315,627579,410132.9,1037711.9
311810,202303,57,41,16,53383.41,20832,74215.41
311820,202303,137,104,33,135410.02,42967.28,178377.30
311830,202303,2058,1199,859,1561145.69,1118420.68,2679566.37
311840,202303,1155,662,493,861934.41,643191.28,1505125.69
311850,202303,19,13,6,16926.28,7812.2,24738.48
311860,202303,11058,4744,6314,6183422.13,8228733.11,14412155.24
311870,202303,119,68,51,88538.15,66402.31,154940.46
311880,202303,1000,718,282,936166.12,368475.59,1304641.71
311890,202303,206,95,111,123586,144525.62,268111.62
311900,202303,70,28,42,36456,54684.15,91140.15
311910,202303,1495,937,558,1220003.45,726522.53,1946525.98
311920,202303,254,166,88,216134.37,114576.2,330710.57
311930,202303,966,545,421,709605.51,548145.3,1257750.81
311940,202303,2849,1568,1281,2041604.64,1667865.78,3709470.42
311950,202303,170,101,69,131504.37,89839.55,221343.92
311960,202303,69,49,20,63799.59,26040,89839.59
311970,202303,27,15,12,19530,15624,35154
311980,202303,42,32,10,41664,13020,54684
311990,202303,38,26,12,33852.08,15624.64,49476.72
311995,202303,56,32,24,41664.7,31248.42,72913.12
312000,202303,22,15,7,19530,9114,28644
312010,202303,77,59,18,76819.56,23436.1,100255.66
312015,202303,89,64,25,83328.79,32550,115878.79
312020,202303,143,104,39,135408.25,50778,186186.25
312030,202303,79,59,20,76818,26040,102858
312040,202303,89,53,36,69006,46872,115878
312050,202303,206,119,87,154938.7,113274,268212.7
312060,202303,19,12,7,15624,9114,24738
312070,202303,85,54,31,70308.37,40362.7,110671.07
312080,202303,512,250,262,325502.66,341125.16,666627.82
312083,202303,82,53,29,69006.47,37758,106764.47
312087,202303,105,76,29,98952.92,37758,136710.92
312090,202303,3685,2271,1414,2959569,1843651.84,4803220.84
312100,202303,152,109,43,141921.51,55986.7,197908.21
312110,202303,133,80,53,104162.58,69007.41,173169.99
312120,202303,130,93,37,122389.78,48174,170563.78
312125,202303,87,58,29,75517.82,37758.7,113276.52
312130,202303,133,89,44,115879.81,57288,173167.81
312140,202303,152,118,34,153637.54,44268,197905.54
312150,202303,37,30,7,39060,9114,48174
312160,202303,1538,1018,520,1326885.69,678347.76,2005233.45
312170,202303,15,11,4,14322,5208,19530
312180,202303,86,63,23,82026,29946,111972
312190,202303,50,43,7,55986.96,9114,65100.96
312200,202303,774,656,118,854133.46,153637.76,1007771.22
312210,202303,134,68,66,88536.9,85932.51,174469.41
312220,202303,151,109,42,141920.88,54684,196604.88
312230,202303,4120,1826,2294,2377543.74,2990706.14,5368249.88
312235,202303,177,119,58,154938.92,76818,231756.92
312240,202303,89,65,24,84632.78,31248.93,115881.71
312245,202303,239,174,65,226554.03,84630.58,311184.61
312247,202303,85,62,23,80724.37,29946.38,110670.75
312250,202303,184,95,89,123691.95,115878,239569.95
312260,202303,110,70,40,91140,52080,143220
312270,202303,145,86,59,111974.09,76818,188792.09
312280,202303,30,15,15,19530,19530,39060
312290,202303,149,100,49,130203.66,63798.98,194002.64
312300,202303,211,135,76,177074.39,98953.38,276027.77
312310,202303,62,55,7,71610,9114,80724
312320,202303,440,269,171,351542.16,222642,574184.16
312330,202303,102,88,14,114576,18228.92,132804.92
312340,202303,33,17,16,22134,20832,42966
312350,202303,14,8,6,10416.15,7812,18228.15
312352,202303,94,67,27,87234.3,35154,122388.3
312360,202303,609,268,341,348944.7,443983.06,792927.76
312370,202303,392,213,179,277327.65,233059.49,510387.14
312380,202303,144,95,49,123697.51,63799.6,187497.11
312385,202303,171,139,32,180980.82,42967.8,223948.62
312390,202303,306,195,111,253891.5,144522,398413.5
312400,202303,397,299,98,389299.93,127596.67,516896.60
312410,202303,1308,483,825,628889.13,1074170.71,1703059.84
312420,202303,707,535,172,696579.5,223945.15,920524.65
312430,202303,903,652,251,848915.95,326805.35,1175721.30
312440,202303,53,39,14,50778,18228,69006
312450,202303,226,134,92,174468,119784,294252
312460,202303,37,17,20,22134.74,26040,48174.74
312470,202303,48,34,14,44268,18228,62496
312480,202303,174,107,67,139317.72,87235.19,226552.91
312490,202303,331,226,105,294259.24,136712.2,430971.44
312500,202303,34,23,11,29946.99,14322,44268.99
312510,202303,719,286,433,372381.32,563773.55,936154.87
312520,202303,27,8,19,10416,24738,35154
312530,202303,39,27,12,35155.78,15624.1,50779.88
312540,202303,88,75,13,97650,16926,114576
312550,202303,34,26,8,33852,10416,44268
312560,202303,218,170,48,221342.73,62496,283838.73
312570,202303,510,303,207,394517.78,269515.47,664033.25
312580,202303,92,55,37,71610,48174,119784
312590,202303,222,176,46,229156.76,59892,289048.76
312595,202303,168,137,31,178374.51,40362,218736.51
312600,202303,76,35,41,45570.9,53382,98952.9
312610,202303,1656,861,795,1122351.83,1036394.46,2158746.29
312620,202303,239,174,65,226549.97,84630,311179.97
312630,202303,71,57,14,74214.52,18228,92442.52
312640,202303,45,12,33,15624,42966,58590
312650,202303,161,138,23,180115.67,29946.1,210061.77
312660,202303,114,83,31,108072.4,40362.39,148434.79
312670,202303,976,619,357,805962.26,464819.14,1270781.40
312675,202303,50,39,11,50778,14322,65100
312680,202303,77,50,27,65100,35154,100254
312690,202303,280,144,136,187491.9,177072.3,364564.2
312695,202303,34,26,8,33852,10416,44268
312700,202303,267,157,110,204419.43,143220.64,347640.07
312705,202303,84,67,17,87234,22134,109368
312707,202303,132,93,39,121086.39,50778,171864.39
312710,202303,1997,1122,875,1463503.4,1139262.42,2602765.82
312720,202303,45,24,21,31248.56,27342,58590.56
312730,202303,294,172,122,223949.61,158846.42,382796.03
312733,202303,51,41,10,53382.7,13020,66402.7
312735,202303,23,17,6,22134.71,7812.8,29947.51
312737,202303,81,48,33,62496.11,42966,105462.11
312738,202303,75,46,29,59892.75,37758,97650.75
312740,202303,77,49,28,65101.89,36456,101557.89
312750,202303,118,79,39,104160.88,50778,154938.88
312760,202303,284,191,93,248686.62,121086.97,369773.59
312770,202303,9529,4563,4966,5947699.44,6473564.14,12421263.58
312780,202303,465,352,113,459614.44,147128.81,606743.25
312790,202303,22,15,7,19530,9114.9,28644.9
312800,202303,1746,1201,545,1563720.4,709594,2273314.4
312810,202303,353,245,108,320292.78,143220,463512.78
312820,202303,196,151,45,196604.49,58590,255194.49
312825,202303,46,34,12,44271.21,15624,59895.21
312830,202303,196,105,91,136712.28,118482.62,255194.90
312840,202303,204,145,59,188790.92,76818,265608.92
312850,202303,37,32,5,41664.9,6510,48174.9
312860,202303,150,100,50,130202.51,66402,196604.51
312870,202303,1261,657,604,858388.41,787710.62,1646099.03
312880,202303,126,95,31,123692.71,40362,164054.71
312890,202303,180,129,51,167962.53,66402,234364.53
312900,202303,162,122,40,158846.32,52080,210926.32
312910,202303,184,101,83,131507.2,108068.61,239575.81
312920,202303,117,66,51,85932.42,66402,152334.42
312930,202303,344,227,117,295557.66,152335.8,447893.46
312940,202303,157,106,51,139314.08,66402,205716.08
312950,202303,784,551,233,717424.88,303368.57,1020793.45
312960,202303,146,106,40,138017.78,52081.89,190099.67
312965,202303,120,95,25,123690.1,32550,156240.1
312970,202303,304,241,63,315092.89,82026.88,397119.77
312980,202303,2836,1474,1362,1920515,1773333.79,3693848.79
312990,202303,49,19,30,24738.29,39060,63798.29
313000,202303,57,32,25,41664.86,32550,74214.86
313005,202303,190,147,43,191394.42,55986.79,247381.21
313010,202303,1043,454,589,591123.64,766884.84,1358008.48
313020,202303,202,108,94,140616,122388,263004
313030,202303,218,142,76,184886.26,98952,283838.26
313040,202303,96,28,68,36456.71,88536,124992.71
313050,202303,224,164,60,213528.61,78120,291648.61
313055,202303,41,29,12,37758,15624,53382
313060,202303,150,103,47,134107.05,61194,195301.05
313065,202303,57,43,14,55986,18228.6,74214.6
313070,202303,129,68,61,89840.62,79422,169262.62
313080,202303,44,24,20,31248,26040,57288
313090,202303,709,460,249,598928.71,324198.49,923127.20
313100,202303,224,82,142,106764.2,186186,292950.2
313110,202303,158,87,71,113274.3,92443.62,205717.92
313115,202303,266,142,124,184889.64,161449.43,346339.07
313120,202303,882,507,375,660131.18,489557.01,1149688.19
313130,202303,6452,3586,2866,4673030.69,3736775.03,8409805.72
313140,202303,139,80,59,104162.92,76819.35,180982.27
313150,202303,310,242,68,316389.4,88536,404925.4
313160,202303,189,142,47,184890.85,61194,246084.85
313170,202303,1494,942,552,1226527.89,721311.12,1947839.01
313180,202303,345,221,124,287748.12,161451.72,449199.84
313190,202303,809,465,344,606747.9,447892.53,1054640.43
313200,202303,36,29,7,37758.78,9114.2,46872.98
313210,202303,1057,903,154,1177070.45,200512.34,1377582.79
313220,202303,331,198,133,257796,173166,430962
313230,202303,303,236,67,307274.94,87234.03,394508.97
313240,202303,2431,1220,1211,1589788.08,1576723.03,3166511.11
313250,202303,1292,965,327,1256466.07,427060.58,1683526.65
313260,202303,101,48,53,62496.46,69006,131502.46
313270,202303,1101,653,448,852562.37,583303.38,1435865.75
313280,202303,45,35,10,45570,13020,58590
313290,202303,246,196,50,255198.27,65100.6,320298.87
313300,202303,336,163,173,212232.02,225246.58,437478.60
313310,202303,264,119,145,154940.17,188790.8,343730.97
313320,202303,402,295,107,385396.08,139314.07,524710.15
313330,202303,1509,934,575,1218704.4,749958.6,1968663.0
313340,202303,347,251,96,326807.89,126295.13,453103.02
313350,202303,469,287,182,373676.66,236964.24,610640.90
313360,202303,203,94,109,122388.2,143220,265608.2
313370,202303,241,87,154,113275.59,200508,313783.59
313375,202303,340,214,126,278634.81,164052.4,442687.21
313380,202303,1382,729,653,949183.49,852813,1801996.49
313390,202303,56,50,6,65100,7812,72912
313400,202303,426,298,128,388017.09,166658.92,554676.01
313410,202303,94,59,35,76819,45570,122389
313420,202303,4911,2796,2115,3640525.36,2755049.14,6395574.50
313430,202303,124,61,63,79422.31,82026.33,161448.64
313440,202303,1444,1023,421,1332006.97,548152.63,1880159.60
313450,202303,71,32,39,41664,50778,92442
313460,202303,417,183,234,238270.9,304668.88,542939.78
313470,202303,531,256,275,333324.29,358055.93,691380.22
313480,202303,165,124,41,161449.68,53382,214831.68
313490,202303,582,263,319,342440.26,415346.37,757786.63
313500,202303,31,17,14,22134,18228,40362
313505,202303,1149,882,267,1148403.17,347641.35,1496044.52
313507,202303,117,80,37,104161.46,48174,152335.46
313510,202303,3089,1912,1177,2490941.33,1535085.83,4026027.16
313520,202303,3560,2752,808,3585858.67,1052027.65,4637886.32
313530,202303,40,24,16,31248,20832.94,52080.94
313535,202303,89,75,14,97652.5,18228.5,115881.0
313540,202303,70,48,22,62496,28644,91140
313545,202303,125,105,20,136710.98,26040,162750.98
313550,202303,225,193,32,251288.33,41666.2,292954.53
313560,202303,372,177,195,230460.15,253897.22,484357.37
313570,202303,81,28,53,36456,69006.97,105462.97
313580,202303,1426,841,585,1095004.77,762977.83,1857982.60
313590,202303,74,48,26,62496.76,33853.3,96350.06
313600,202303,707,430,277,561168.94,360655.31,921824.25
313610,202303,57,45,12,58591.62,15624.35,74215.97
313620,202303,1596,765,831,997366.81,1083267.88,2080634.69
313630,202303,1761,1333,428,1738219.26,557259.03,2295478.29
313640,202303,118,71,47,92443.08,62496.7,154939.78
313650,202303,253,134,119,174468.34,154940.4,329408.74
313652,202303,33,31,2,40362,2604,42966
313655,202303,94,63,31,82027.46,40362.49,122389.95
313657,202303,54,49,5,63799.45,6510,70309.45
313660,202303,149,100,49,130201.83,63799.15,194000.98
313665,202303,757,351,406,457017.01,529924.64,986941.65
313670,202303,11604,7952,3652,10364454,4762769.36,15127223.36
313680,202303,45,35,10,45570.73,13020,58590.73
313690,202303,140,100,40,130200.86,52080,182280.86
313695,202303,89,68,21,88536.87,27342,115878.87
313700,202303,370,285,85,371075.72,110670.88,481746.60
313710,202303,131,94,37,122391.38,48174,170565.38
313720,202303,1244,575,669,748680.25,871049.64,1619729.89
313730,202303,75,44,31,57289.63,40362,97651.63
313740,202303,165,121,44,158846.14,57288,216134.14
313750,202303,418,293,125,381492.98,162750.79,544243.77
313753,202303,245,186,59,242176.47,76818.1,318994.57
313760,202303,1472,579,893,755182.04,1162701.21,1917883.25
313770,202303,440,295,145,384100.42,188793.86,572894.28
313780,202303,913,500,413,651005.83,537730.79,1188736.62
313790,202303,37,37,0,48174,,48174.0
313800,202303,172,108,64,140620.38,83329.29,223949.67
313810,202303,98,54,44,70308.81,57289.02,127597.83
313820,202303,1475,713,762,929655.65,994730.48,1924386.13
313830,202303,54,36,18,46872.89,23436,70308.89
313835,202303,68,58,10,75516.2,13020,88536.2
313840,202303,1827,1108,719,1445272.5,937446.22,2382718.72
313850,202303,234,104,130,135411.59,169260.5,304672.09
313860,202303,507,382,125,497374.29,162750.64,660124.93
313862,202303,183,128,55,166661.73,71610.2,238271.93
313865,202303,190,129,61,167959.47,79422.1,247381.57
313867,202303,63,53,10,69006,13020.1,82026.1
313868,202303,55,33,22,42966,28644,71610
313870,202303,84,46,38,59892.2,49476,109368.2
313880,202303,403,250,153,325503.61,200508.99,526012.60
313890,202303,355,195,160,253895.09,208321.23,462216.32
313900,202303,865,470,395,613263.13,515600.48,1128863.61
313910,202303,153,104,49,135408,63798,199206
313920,202303,685,467,218,608038.09,283837.14,891875.23
313925,202303,35,30,5,39060,6510,45570
313930,202303,950,725,225,943988.79,294257.56,1238246.35
313940,202303,2084,1243,841,1618424.33,1094991.38,2713415.71
313950,202303,902,550,352,716116.33,458305.26,1174421.59
313960,202303,1561,899,662,1170520.04,863233.72,2033753.76
313970,202303,193,110,83,143220.7,108066.2,251286.9
313980,202303,254,161,93,209632.97,121088.04,330721.01
313990,202303,287,174,113,226549.53,147126,373675.53
314000,202303,926,606,320,789027.27,416645.1,1205672.37
314010,202303,108,69,39,89838.15,50778,140616.15
314015,202303,102,28,74,36457.03,96348.9,132805.93
314020,202303,59,38,21,49476.75,27342,76818.75
314030,202303,77,38,39,49477,50778,100255
314040,202303,48,26,22,33852,28644,62496
314050,202303,300,165,135,216137.91,175770,391907.91
314053,202303,100,63,37,82027.2,48174,130201.2
314055,202303,315,202,113,263008.54,147128.14,410136.68
314060,202303,122,104,18,135408.48,23436,158844.48
314070,202303,1144,576,568,749979.71,739549.79,1489529.50
314080,202303,224,135,89,175776.54,115878.64,291655.18
314085,202303,194,136,58,177072.8,75516,252588.8
314090,202303,425,302,123,393211.84,160146,553357.84
314100,202303,553,435,118,566385.8,153639,720024.8
314110,202303,811,356,455,463529.56,596321.4,1059850.96
314120,202303,72,43,29,55986,37758,93744
314130,202303,27,19,8,24738,10416,35154
314140,202303,1245,793,452,1032513.28,588509.03,1621022.31
314150,202303,196,126,70,164055.28,91140.66,255195.94
314160,202303,318,239,79,311182.02,102858.56,414040.58
314170,202303,85,62,23,80725.39,29946,110671.39
314180,202303,796,706,90,920547.07,117181.77,1037728.84
314190,202303,91,56,35,72913.18,45570,118483.18
314200,202303,544,375,169,488265.23,220046.28,708311.51
314210,202303,254,195,59,253894.02,76818.6,330712.62
314220,202303,326,232,94,302070.52,122389.25,424459.77
314225,202303,47,29,18,37759.1,23436,61195.1
314230,202303,130,59,71,78120.55,92442,170562.55
314240,202303,180,131,49,170563.3,63798,234361.3
314250,202303,61,37,24,48176.52,31248.28,79424.80
314260,202303,221,110,111,143221.34,145824,289045.34
314270,202303,438,344,94,447903.44,122388.7,570292.14
314280,202303,760,411,349,536376.33,454401.34,990777.67
314290,202303,566,440,126,574190.54,164052.72,738243.26
314300,202303,349,258,91,335924.21,118482,454406.21
314310,202303,1387,960,427,1251262.02,555954.21,1807216.23
314315,202303,48,35,13,45570.9,16926,62496.9
314320,202303,603,419,184,546854.03,239570.48,786424.51
314330,202303,12507,6065,6442,7899551.02,8397956.14,16297507.16
314340,202303,692,312,380,406234.58,496068.35,902302.93
314345,202303,62,46,16,59892,20832,80724
314350,202303,188,115,73,149730.88,95046.66,244777.54
314360,202303,54,28,26,36458.66,33852.99,70311.65
314370,202303,73,52,21,67704,27342,95046
314380,202303,140,75,65,97650.22,84630,182280.22
314390,202303,3721,2404,1317,3130129.99,1716040.95,4846170.94
314400,202303,730,504,226,656222.92,294254.75,950477.67
314410,202303,567,377,190,490866.55,247382.25,738248.80
314420,202303,27,16,11,20832,14322,35154
314430,202303,2582,990,1592,1289019.79,2074125.3,3363145.09
314435,202303,148,88,60,114577.05,78120,192697.05
314437,202303,59,46,13,59892,16926,76818
314440,202303,100,64,36,83328.66,46872.1,130200.76
314450,202303,175,122,53,158844.5,69007.84,227852.34
314460,202303,656,327,329,425761.12,430965.84,856726.96
314465,202303,131,86,45,111974.35,58590,170564.35
314467,202303,73,60,13,78120,16926,95046
314470,202303,430,216,214,281235.35,279933.15,561168.50
314480,202303,1138,514,624,669242.71,815057.79,1484300.50
314490,202303,37,20,17,26040,22134,48174
314500,202303,281,194,87,252594.36,113274.45,365868.81
314505,202303,125,79,46,102860.54,59892,162752.54
314510,202303,263,212,51,276028.25,66402,342430.25
314520,202303,1527,785,742,1022110.76,966097.45,1988208.21
314530,202303,808,641,167,834618.16,217437.99,1052056.15
314535,202303,186,118,68,153636.49,88536,242172.49
314537,202303,71,42,29,54685.37,37758.98,92444.35
314540,202303,20,12,8,15624,10416,26040
314545,202303,68,44,24,57288,31248,88536
314550,202303,80,44,36,57290.24,46873.78,104164.02
314560,202303,901,485,416,631484.73,541638,1173122.73
314570,202303,16,14,2,18229.35,2604,20833.35
314580,202303,10,5,5,6510,6510,13020
314585,202303,32,24,8,31248,10416.66,41664.66
314587,202303,84,71,13,92442.7,16926,109368.7
314590,202303,628,424,204,552065.6,265610.53,817676.13
314600,202303,1021,667,354,869771.83,460920,1330691.83
314610,202303,1024,524,500,682259.81,652308.41,1334568.22
314620,202303,156,118,38,153637.05,49476,203113.05
314625,202303,99,77,22,100254.36,28644,128898.36
314630,202303,1176,660,516,861776.23,673142.55,1534918.78
314640,202303,94,58,36,75517.9,46872.6,122390.5
314650,202303,161,94,67,122390.27,87235.53,209625.80
314655,202303,64,47,17,61194,22134,83328
314660,202303,20,15,5,19530,6510,26040
314670,202303,233,182,51,238279.51,66404.92,304684.43
314675,202303,226,137,89,178376.16,115878.23,294254.39
314690,202303,588,313,275,408836.29,358052.66,766888.95
314700,202303,2270,1211,1059,1576786.53,1380126.47,2956913.00
314710,202303,1941,1081,860,1408791.54,1122325.38,2531116.92
314720,202303,427,237,190,308581.56,247381.1,555962.66
314730,202303,533,291,242,378888.8,315087.25,693976.05
314740,202303,845,375,470,489564.94,614547.3,1104112.24
314750,202303,27,20,7,26040,9114,35154
314760,202303,377,150,227,195302.36,295554.88,490857.24
314770,202303,104,68,36,88537.39,46872,135409.39
314780,202303,18,7,11,9114,14322,23436
314790,202303,2686,1725,961,2248633.06,1252525.71,3501158.77
314795,202303,76,65,11,84630.2,14322,98952.2
314800,202303,3110,1823,1287,2373606.43,1675679.13,4049285.56
314810,202303,1567,894,673,1165312.04,877550.09,2042862.13
314820,202303,118,69,49,89840.29,63798.1,153638.39
314830,202303,229,191,38,248688.36,49476,298164.36
314840,202303,89,52,37,67704,48174,115878
314850,202303,468,224,244,291781.72,317688.05,609469.77
314860,202303,662,503,159,654912.52,207018.08,861930.60
314870,202303,1746,945,801,1231727.29,1042917.66,2274644.95
314875,202303,68,61,7,80724,9114,89838
314880,202303,42,30,12,39060,15624,54684
314890,202303,60,33,27,42966,35154,78120
314900,202303,28,21,7,27343.5,9114.92,36458.42
314910,202303,245,161,84,209623.2,109368,318991.2
314915,202303,146,125,21,162752.67,27342.68,190095.35
314920,202303,85,55,30,71610.85,39060,110670.85
314930,202303,1090,499,591,649718.68,769484.95,1419203.63
314940,202303,37,29,8,37758,10416,48174
314950,202303,23,19,4,24739.02,5208,29947.02
314960,202303,28,20,8,26040.39,10416.18,36456.57
314970,202303,180,82,98,106765.13,127596.87,234362.00
314980,202303,321,206,115,268215.4,149731.45,417946.85
314990,202303,477,256,221,333318.19,287743.73,621061.92
314995,202303,156,68,88,88537.58,114576,203113.58
315000,202303,104,80,24,104160.49,31248.1,135408.59
315010,202303,41,24,17,31248,22134,53382
315015,202303,167,131,36,170563.38,46872,217435.38
315020,202303,67,56,11,72912,14322,87234
315030,202303,114,86,28,111972,36456,148428
315040,202303,90,55,35,71610.37,45570,117180.37
315050,202303,216,133,83,173167.67,108066.68,281234.35
315053,202303,67,47,20,61194.8,26040,87234.8
315057,202303,130,100,30,130200.65,39060,169260.65
315060,202303,61,51,10,66403.56,13020,79423.56
315070,202303,120,73,47,95047.78,61194,156241.78
315080,202303,401,319,82,415345.31,106765.07,522110.38
315090,202303,103,61,42,79422.89,54684,134106.89
315100,202303,97,47,50,61195.05,65100.38,126295.43
315110,202303,293,147,146,191396.43,190092.6,381489.03
315120,202303,1967,936,1031,1221327.49,1342394.56,2563722.05
315130,202303,373,264,109,343733.81,141918.44,485652.25
315140,202303,574,310,264,403629.96,345035.89,748665.85
315150,202303,1024,499,525,649719.11,684859.09,1334578.20
315160,202303,198,106,92,138020.09,119787.77,257807.86
315170,202303,303,197,106,256497.01,138013.09,394510.10
315180,202303,3429,1459,1970,1902284.85,2564958.95,4467243.80
315190,202303,302,186,116,242177.88,151032.75,393210.63
315200,202303,1285,770,515,1003867.05,670533.61,1674400.66
315210,202303,1896,1139,757,1483012.8,985617.68,2468630.48
315213,202303,27,16,11,20833.3,14322,35155.3
315217,202303,225,176,49,229153.19,63798.95,292952.14
315220,202303,1683,1242,441,1619731.55,574191.21,2193922.76
315230,202303,187,144,43,187489.78,55986,243475.78
315240,202303,382,252,130,328112.67,169263.7,497376.37
315250,202303,2871,1366,1505,1778596.7,1960816.4,3739413.1
315260,202303,141,82,59,106764,76818.1,183582.1
315270,202303,157,111,46,144522.8,59892,204414.8
315280,202303,639,419,220,545564.62,286454.16,832018.78
315290,202303,207,129,78,167960.49,101556.29,269516.78
315300,202303,103,77,26,100254.61,33852,134106.61
315310,202303,87,79,8,102858,10416,113274
315320,202303,140,90,50,117184.46,65100,182284.46
315330,202303,63,49,14,63798,18228,82026
315340,202303,390,283,107,368471.52,139315.26,507786.78
315350,202303,170,109,61,141919.38,79422.34,221341.72
315360,202303,108,51,57,66402.15,74214.23,140616.38
315370,202303,57,38,19,49477.61,24738,74215.61
315380,202303,7,6,1,7812,1302,9114
315390,202303,75,30,45,39060.49,58591.76,97652.25
315400,202303,860,651,209,848924.85,272119.12,1121043.97
315410,202303,323,195,128,253905.11,166661.32,420566.43
315415,202303,60,46,14,59892.27,18228,78120.27
315420,202303,211,151,60,196603.4,78120,274723.4
315430,202303,655,365,290,475234.67,377580.88,852815.55
315440,202303,96,63,33,82026,42966,124992
315445,202303,242,200,42,260410.36,54684.37,315094.73
315450,202303,180,130,50,169260,65100,234360
315460,202303,5169,2380,2789,3101502.32,3632630.81,6734133.13
315470,202303,49,20,29,26040.9,37758,63798.9
315480,202303,79,25,54,32551.44,70309.81,102861.25
315490,202303,778,506,272,660124.26,354144.48,1014268.74
315500,202303,18,14,4,19530,5208,24738
315510,202303,160,114,46,148428.23,59892,208320.23
315520,202303,79,67,12,87234.38,15624,102858.38
315530,202303,46,27,19,35154,24738.2,59892.2
315540,202303,278,191,87,248686.6,113275.16,361961.76
315550,202303,192,156,36,203113.24,48174,251287.24
315560,202303,739,579,160,753875.69,208323.81,962199.50
315570,202303,313,155,158,201818.87,205716.81,407535.68
315580,202303,792,538,254,700484.28,332011.99,1032496.27
315590,202303,194,99,95,128901.1,123690.63,252591.73
315600,202303,370,287,83,373678.72,108066.78,481745.50
315610,202303,105,49,56,63798,72912,136710
315620,202303,39,30,9,39061.46,11718,50779.46
315630,202303,134,101,33,131502.14,42966,174468.14
315640,202303,64,39,25,50778.98,32550,83328.98
315645,202303,53,35,18,45570,23436,69006
315650,202303,171,127,44,165355.28,57288,222643.28
315660,202303,448,205,243,266919.63,316391.57,583311.20
315670,202303,2573,1167,1406,1519496.73,1834543.14,3354039.87
315680,202303,790,567,223,739545.72,290346.5,1029892.22
315690,202303,715,477,238,622371.59,309879.3,932250.89
315700,202303,2144,1122,1022,1460890.94,1333279.1,2794170.04
315710,202303,384,132,252,171865.22,328104.63,499969.85
315720,202303,541,324,217,424462,283837.57,708299.57
315725,202303,216,166,50,216132.87,65100,281232.87
315727,202303,80,47,33,61198.84,42966,104164.84
315730,202303,57,50,7,65100,9114,74214
315733,202303,87,50,37,65100.2,48174,113274.2
315737,202303,51,39,12,50778.86,15624,66402.86
315740,202303,33,26,7,33852,9114,42966
315750,202303,177,125,52,162750.17,67704.56,230454.73
315760,202303,48,35,13,45570.6,16926,62496.6
315765,202303,144,82,62,106768.99,80726.21,187495.20
315770,202303,245,165,80,214832.8,104160.64,318993.44
315780,202303,4269,2117,2152,2759029.34,2804519.32,5563548.66
315790,202303,254,194,60,252592.97,78120.87,330713.84
315800,202303,330,216,114,282537.62,148428,430965.62
315810,202303,61,36,25,46873.59,32550,79423.59
315820,202303,793,590,203,769508.26,264310.94,1033819.20
315830,202303,125,82,43,106764.96,55986.53,162751.49
315840,202303,85,58,27,75516,35154.66,110670.66
315850,202303,272,181,91,235669.33,118482.81,354152.14
315860,202303,21,9,12,11718,15624,27342
315870,202303,41,32,9,41664.44,11718,53382.44
315880,202303,100,66,34,85932,44268,130200
315890,202303,111,77,34,100256.18,44268.54,144524.72
315895,202303,417,273,144,355465.3,187489.79,542955.09
315900,202303,85,38,47,49476,61194.08,110670.08
315910,202303,52,32,20,41664,26040,67704
315920,202303,158,107,51,139316.57,66402,205718.57
315930,202303,53,18,35,23438.79,45571.44,69010.23
315935,202303,130,102,28,132806.89,36456,169262.89
315940,202303,103,75,28,97650.14,37758,135408.14
315950,202303,40,31,9,40362,11718.35,52080.35
315960,202303,612,288,324,374986.73,421856.27,796843.00
315970,202303,36,30,6,39060.54,7812,46872.54
315980,202303,699,358,341,466131.48,443983.97,910115.45
315990,202303,268,152,116,197906.39,151032.52,348938.91
316000,202303,53,32,21,42966.8,27342,70308.8
316010,202303,97,82,15,106765.76,19530,126295.76
316020,202303,98,88,10,114577.25,13020,127597.25
316030,202303,390,229,161,299468.12,209624.69,509092.81
316040,202303,580,244,336,317692.37,437472.61,755164.98
316045,202303,53,47,6,61194,7812,69006
316050,202303,25,18,7,23436,9114,32550
316060,202303,109,77,32,100254.88,41664,141918.88
316070,202303,1286,864,422,1124961.55,549448.55,1674410.10
316080,202303,93,63,30,83443.17,39060,122503.17
316090,202303,38,17,21,22134,27343.08,49477.08
316095,202303,89,77,12,100255.44,15624.44,115879.88
316100,202303,365,200,165,260405.14,214830.32,475235.46
316105,202303,55,33,22,42967.92,29946,72913.92
316110,202303,1947,1504,443,1958258.68,578097.84,2536356.52
316120,202303,79,54,25,70308,32550,102858
316130,202303,126,93,33,121089.33,42966.51,164055.84
316140,202303,35,23,12,29946,15624,45570
316150,202303,234,164,70,213530.66,91140.33,304670.99
316160,202303,88,55,33,71611.63,42966.28,114577.91
316165,202303,78,52,26,67705.77,33852,101557.77
316170,202303,188,121,67,157542.07,87234,244776.07
316180,202303,221,86,135,111975.02,175772.06,287747.08
316190,202303,149,107,42,139316.26,54684,194000.26
316200,202303,711,395,316,514307.19,411433.92,925741.11
316210,202303,777,531,246,694211.23,320294.59,1014505.82
316220,202303,131,85,46,110671.71,59892,170563.71
316225,202303,42,27,15,35155.55,19530,54685.55
316230,202303,49,28,21,36456.25,27342,63798.25
316240,202303,698,548,150,713513.08,195304.87,908817.95
316245,202303,171,150,21,195303.32,27342.99,222646.31
316250,202303,1764,1169,595,1523391.01,774694.02,2298085.03
316255,202303,134,105,29,136710,37758.6,174468.6
316257,202303,182,93,89,121087.57,115879.46,236967.03
316260,202303,205,140,65,182282.91,84630.2,266913.11
316265,202303,37,27,10,35155.68,14322.67,49478.35
316270,202303,715,504,211,656222.9,274723.93,930946.83
316280,202303,595,375,220,489562.62,286442.6,776005.22
316290,202303,905,628,277,817677.91,363263.23,1180941.14
316292,202303,660,271,389,352850.54,507783.12,860633.66
316294,202303,111,68,43,88537.8,55986.5,144524.3
316295,202303,419,196,223,255200.35,290352.97,545553.32
316300,202303,27,20,7,26040,9114,35154
316310,202303,27,14,13,18228,16926,35154
316320,202303,72,33,39,44268.85,50778,95046.85
316330,202303,181,126,55,164053.38,71610.43,235663.81
316340,202303,144,93,51,121086,66402,187488
316350,202303,198,134,64,174469.29,84630.2,259099.49
316360,202303,25,16,9,20832,11718,32550
316370,202303,1364,673,691,877573.57,899688.21,1777261.78
316380,202303,121,94,27,122388.56,35154,157542.56
316390,202303,105,79,26,102858,33852,136710
316400,202303,171,131,40,170565.91,52080.36,222646.27
316410,202303,310,227,83,295555.84,108066.2,403622.04
316420,202303,228,151,77,196607.74,100256.15,296863.89
316430,202303,167,93,74,121086.46,96348,217434.46
316440,202303,76,42,34,54684.58,44268.08,98952.66
316443,202303,49,41,8,53382.31,10416,63798.31
316447,202303,46,38,8,49478.58,10416,59894.58
316450,202303,256,190,66,247380.65,85932,333312.65
316460,202303,48,15,33,19530.8,42966.54,62497.34
316470,202303,1867,1367,500,1781185.61,652303.94,2433489.55
316480,202303,9,7,2,9114,2604,11718
316490,202303,20,6,14,7812,18228,26040
316500,202303,170,109,61,141918.77,79422.47,221341.24
316510,202303,142,113,29,147126.91,37758,184884.91
316520,202303,189,103,86,134107.15,111973.62,246080.77
316530,202303,181,114,67,148429.21,87234,235663.21
316540,202303,163,85,78,110671.63,101556.65,212228.28
316550,202303,174,106,68,138014.8,88536,226550.8
316553,202303,480,241,239,315091.28,311180,626271.28
316555,202303,68,58,10,75517.76,13020,88537.76
316556,202303,18,12,6,15624.41,7812,23436.41
316557,202303,40,29,11,37758.47,14322,52080.47
316560,202303,75,53,22,69006.2,28644,97650.2
316570,202303,227,208,19,270819.35,24738,295557.35
316580,202303,25,17,8,22134,10416,32550
316590,202303,91,76,15,98953.32,19530.3,118483.62
316600,202303,185,155,30,201810.78,39060,240870.78
316610,202303,73,52,21,67705.47,27342,95047.47
316620,202303,154,107,47,139314,61194.05,200508.05
316630,202303,61,47,14,61194,18228,79422
316640,202303,23,14,9,18228,11718,29946
316650,202303,114,91,23,118482,29946,148428
316660,202303,6,2,4,2604.14,5208,7812.14
316670,202303,435,150,285,196604.78,372375.17,568979.95
316680,202303,175,136,39,177075.41,50778.4,227853.81
316690,202303,152,93,59,121086,78120,199206
316695,202303,56,48,8,62496,10416,72912
316700,202303,31,22,9,28644,11718,40362
316710,202303,855,649,206,845014.6,268215.4,1113230.0
316720,202303,5511,2577,2934,3357970.95,3826591.19,7184562.14
316730,202303,14,13,1,16926,1302,18228
316740,202303,166,103,63,134106.1,82026,216132.1
316750,202303,17,10,7,13020.76,9114.6,22135.36
316760,202303,348,276,72,359357.53,93745.24,453102.77
316770,202303,179,95,84,123692.09,109368,233060.09
316780,202303,69,40,29,52080.6,37758,89838.6
316790,202303,69,47,22,61194.27,28644.5,89838.77
316800,202303,1877,1144,733,1490826.61,956990.32,2447816.93
316805,202303,34,22,12,28644.08,15624,44268.08
316810,202303,55,31,24,40362.7,31248.95,71611.65
316820,202303,40,24,16,31248,20832,52080
316830,202303,106,50,56,65100.9,72912.2,138013.1
316840,202303,528,321,207,417946.91,272120.46,690067.37
316850,202303,320,224,96,291652.22,124992,416644.22
316860,202303,6729,3038,3691,3962094.97,4810914.21,8773009.18
316870,202303,1831,1179,652,1535141.88,848912.74,2384054.62
316880,202303,170,85,85,110673.92,110671.44,221345.36
316890,202303,235,155,80,201812.18,104160.69,305972.87
316900,202303,449,313,136,407531.8,177072,584603.8
316905,202303,26,11,15,14322,19530,33852
316910,202303,83,34,49,44268,63798,108066
316920,202303,160,122,38,158849.4,49476,208325.4
316930,202303,2124,1088,1036,1416602.48,1350175.98,2766778.46
316935,202303,1019,602,417,783819.66,542943.04,1326762.70
316940,202303,1161,682,479,887987.38,624962.54,1512949.92
316950,202303,206,100,106,131504.86,139314,270818.86
316960,202303,1150,639,511,833312.15,665335.29,1498647.44
316970,202303,688,549,139,714817.26,180981.23,895798.49
316980,202303,88,47,41,61194,53382,114576
316990,202303,2393,1623,770,2115806.82,1005148.69,3120955.51
317000,202303,353,272,81,354155.62,105463.62,459619.24
317005,202303,228,156,72,203117.96,93744.9,296862.86
317010,202303,7300,4181,3119,5443946.59,4064907.03,9508853.62
317020,202303,16543,7234,9309,9433402.17,12128239.95,21561642.12
317030,202303,96,45,51,58590,66402.6,124992.6
317040,202303,3253,2126,1127,2768138.43,1468666.45,4236804.88
317043,202303,80,63,17,82034.3,22135.27,104169.57
317047,202303,44,27,17,35154,22134,57288
317050,202303,163,131,32,170564.68,41664,212228.68
317052,202303,165,136,29,177073.57,37758,214831.57
317057,202303,196,146,50,190095.18,65100,255195.18
317060,202303,66,40,26,52080.45,33852.3,85932.75
317065,202303,52,39,13,50778,16926,67704
317070,202303,2067,959,1108,1249966.84,1445222.38,2695189.22
317075,202303,97,54,43,70308.75,55986,126294.75
317080,202303,1015,515,500,673167.47,652303.9,1325471.37
317090,202303,746,579,167,753875.93,217439.16,971315.09
317100,202303,464,347,117,451802.68,152334.95,604137.63
317103,202303,135,108,27,140618.66,35154,175772.66
317107,202303,53,42,11,54684,14322,69006
317110,202303,80,42,38,54684.2,49477.66,104161.86
317115,202303,43,39,4,50839.19,5208,56047.19
317120,202303,2279,1136,1143,1481740.26,1488202.28,2969942.54
317130,202303,2230,1507,723,1963442,943953.52,2907395.52
317140,202303,14,11,3,14322.5,3906,18228.5
317150,202303,303,182,121,236967.15,157542.83,394509.98
317160,202303,365,269,96,350243.83,124993.58,475237.41
317170,202303,247,160,87,208321.35,114577.02,322898.37
317180,202303,438,298,140,388000.89,182282.1,570282.99
317190,202303,268,191,77,248683.29,100254,348937.29
317200,202303,911,639,272,832015.84,354152.85,1186168.69
317210,202303,185,97,88,126299.61,114576.21,240875.82
317220,202303,23,11,12,14322,15624,29946
320010,202303,589,418,171,544254.73,222648.93,766903.66
320013,202303,152,100,52,130204.54,67706.05,197910.59
320016,202303,256,155,101,203117.08,131502,334619.08
320020,202303,782,456,326,593737.41,425764.97,1019502.38
320030,202303,175,120,55,156242.77,71612.62,227855.39
320035,202303,140,97,43,126294.2,55986.79,182280.99
320040,202303,522,253,269,329416.23,350249.1,679665.33
320050,202303,126,89,37,115885.89,48175.21,164061.10
320060,202303,2016,944,1072,1229140.57,1397074.07,2626214.64
320070,202303,103,65,38,84630.55,49476,134106.55
320080,202303,860,482,378,627588.35,492162.34,1119750.69
320090,202303,1403,900,503,1173140.81,654922.73,1828063.54
320100,202303,376,216,160,281241.6,208322.13,489563.73
320110,202303,136,82,54,106773.86,70308.6,177082.46
320115,202303,121,102,19,132807.08,24738,157545.08
320120,202303,4046,2113,1933,2751244.73,2518120.04,5269364.77
320130,202303,8775,3756,5019,4890537.99,6545298.78,11435836.77
320140,202303,548,353,195,459628.44,253898.84,713527.28
320150,202303,2343,1287,1056,1675750.64,1374930.4,3050681.04
320160,202303,687,291,396,378891.08,515596.31,894487.39
320170,202303,115,93,22,121088.44,29946.02,151034.46
320180,202303,62,34,28,44269.72,36456.12,80725.84
320190,202303,261,154,107,200513.82,140616.1,341129.92
320200,202303,64,53,11,69008.39,14322,83330.39
320210,202303,967,524,443,682271.46,576795.86,1259067.32
320220,202303,313,108,205,140617,266910.2,407527.2
320225,202303,85,70,15,91140.39,19530.9,110671.29
320230,202303,768,490,278,638018.86,361964.62,999983.48
320240,202303,3838,1720,2118,2240831.17,2757682.07,4998513.24
320245,202303,555,381,174,496077.52,226554.36,722631.88
320250,202303,256,119,137,154943.73,178377.25,333320.98
320255,202303,124,91,33,118484.02,42966.39,161450.41
320260,202303,310,163,147,212228.01,191395.67,403623.68
320265,202303,155,119,36,154939.73,46872.55,201812.28
320270,202303,163,124,39,161451.25,50779.15,212230.40
320280,202303,1446,803,643,1045548.16,838507.02,1884055.18
320290,202303,72,55,17,71610.42,22134,93744.42
320300,202303,656,449,207,584619.37,269516.9,854136.27
320305,202303,804,436,368,567698.4,479151.81,1046850.21
320310,202303,215,126,89,164055.41,115878.2,279933.61
320313,202303,379,169,210,220048.36,273421.4,493469.76
320316,202303,117,84,33,109370.04,42966.8,152336.84
320320,202303,3726,1656,2070,2157496.5,2696486.95,4853983.45
320330,202303,301,217,84,282535.24,109368.48,391903.72
320332,202303,826,492,334,640629.58,434884.47,1075514.05
320334,202303,304,165,139,214832.95,180979.3,395812.25
320335,202303,153,99,54,128903.56,70311.14,199214.70
320340,202303,625,445,180,579419.67,235671.57,815091.24
320350,202303,1191,482,709,627589.58,924433.64,1552023.22
320360,202303,180,83,97,108067,126294,234361
320370,202303,247,182,65,236970.63,85933.29,322903.92
320380,202303,345,246,99,320300.72,128898.89,449199.61
320390,202303,1214,702,512,914038.55,667935.92,1581974.47
320400,202303,344,237,107,308588.86,139315.46,447904.32
320405,202303,1044,420,624,546869.84,812467.13,1359336.97
320410,202303,1000,493,507,641906.57,660120.3,1302026.87
320420,202303,620,279,341,363278.36,443995.83,807274.19
320425,202303,226,117,109,152336.73,141918.8,294255.53
320430,202303,420,216,204,282549.51,266919.09,549468.60
320435,202303,194,134,60,174470.11,78122.08,252592.19
320440,202303,220,119,101,154943.01,131507,286450.01
320450,202303,143,75,68,97651.32,88537.06,186188.38
320455,202303,240,186,54,242177.01,70308.66,312485.67
320460,202303,343,206,137,268217.95,179676.21,447894.16
320465,202303,124,85,39,110675.78,50778.16,161453.94
320470,202303,802,473,329,615875.49,428370.43,1044245.92
320480,202303,241,158,83,205726.1,108066.02,313792.12
320490,202303,3553,1675,1878,2182250.26,2445226.29,4627476.55
320495,202303,136,79,57,102858.75,74214.6,177073.35
320500,202303,11175,5412,5763,7049394.1,7506172.4,14555566.5
320501,202303,590,304,286,397130.3,372383.78,769514.08
320503,202303,341,240,101,312486.95,131503.25,443990.20
320506,202303,297,202,95,263006.99,123690.38,386697.37
320510,202303,1352,583,769,759090.81,1002561.28,1761652.09
320515,202303,87,68,19,88538.64,24738,113276.64
320517,202303,247,180,67,234366.62,87234.52,321601.14
320520,202303,8723,3630,5093,4729065.63,6637729.72,11366795.35
320530,202303,7771,3681,4090,4794120.8,5326571.38,10120692.18
330010,202303,3847,1881,1966,2450474.76,2561068.7,5011543.46
330015,202303,225,101,124,131505.41,161448.56,292953.97
330020,202303,4391,1663,2728,2166605.05,3554512.79,5721117.84
330022,202303,278,141,137,183587.86,178374.95,361962.81
330023,202303,933,264,669,343734.14,871049.04,1214783.18
330025,202303,1206,178,1028,231759.57,1338347.26,1570106.83
330030,202303,2036,1248,788,1626278.67,1025995.79,2652274.46
330040,202303,2925,1490,1435,1940054.95,1871005.49,3811060.44
330045,202303,11386,3620,7766,4717331.46,10128441.17,14845772.63
330050,202303,942,573,369,746071.35,480444,1226515.35
330060,202303,1330,784,546,1020820.12,712205.96,1733026.08
330070,202303,4816,1631,3185,2123645.1,4153446.29,6277091.39
330080,202303,1778,770,1008,1003886.61,1313739.52,2317626.13
330090,202303,419,229,190,298167.77,247381.87,545549.64
330093,202303,237,100,137,130201.64,178375.48,308577.12
330095,202303,75,38,37,49476.35,48174,97650.35
330100,202303,12139,5998,6141,7813687.03,7999637.44,15813324.47
330110,202303,513,233,280,303373.08,364565.49,667938.57
330115,202303,552,270,282,351550.56,367166.22,718716.78
330120,202303,432,223,209,290351.02,272120.45,562471.47
330130,202303,1761,469,1292,610669.1,1683526.6,2294195.7
330140,202303,745,378,367,492163.18,479138.17,971301.35
330150,202303,569,343,226,446597.44,294254.86,740852.30
330160,202303,216,127,89,165356.25,115880.15,281236.40
330170,202303,29721,10523,19198,13708095.55,25034078.4,38742173.95
330180,202303,280,154,126,200511.24,164055.87,364567.11
330185,202303,1321,514,807,669253.95,1052042.31,1721296.26
330187,202303,643,197,446,259110.61,582002.39,841113.00
330190,202303,6946,2623,4323,3417885.37,5632532.79,9050418.16
330200,202303,5100,1708,3392,2225217.52,4420390.25,6645607.77
330205,202303,526,292,234,380196.28,304671.84,684868.12
330210,202303,982,584,398,760392.66,518201.8,1278594.46
330220,202303,3038,1778,1260,2316366.93,1640555.92,3956922.85
330225,202303,838,340,498,442689.27,649701.02,1092390.29
330227,202303,2754,867,1887,1128870.54,2463420.88,3592291.42
330230,202303,263,138,125,179679.06,162753.18,342432.24
330240,202303,4872,2246,2626,2925727.31,3426935.39,6352662.70
330245,202303,182,86,96,111974.8,124992.86,236967.66
330250,202303,7390,3520,3870,4584558.18,5044040.55,9628598.73
330260,202303,873,238,635,309881.23,826775.35,1136656.58
330270,202303,4415,1437,2978,1871047.53,3883945.67,5754993.20
330280,202303,504,299,205,391924.6,266916.44,658841.04
330285,202303,7000,2244,4756,2924454.56,6196382.22,9120836.78
330290,202303,837,288,549,374992.01,714804.31,1089796.32
330300,202303,805,489,316,638810.93,411441.78,1050252.71
330310,202303,513,298,215,388007.81,279931.34,667939.15
330320,202303,8482,2900,5582,3778614.55,7277017.67,11055632.22
330330,202303,10502,3831,6671,4992044.23,8700107.33,13692151.56
330340,202303,3023,1658,1365,2160072,1777249.93,3937321.93
330350,202303,22103,8100,14003,10551926.11,18245351.31,28797277.42
330360,202303,2089,981,1108,1278619.58,1450466.82,2729086.40
330370,202303,1074,564,510,735658.06,665337.56,1400995.62
330380,202303,1130,461,669,600241.24,871048.6,1471289.84
330385,202303,725,352,373,458316.83,485650.2,943967.03
330390,202303,6887,3552,3335,4628904.95,4347525.71,8976430.66
330395,202303,431,280,151,364575.45,196606.49,561181.94
330400,202303,777,395,382,514314.76,497368.02,1011682.78
330410,202303,566,403,163,524726.61,212230.6,736957.21
330411,202303,406,221,185,287745.75,240870.7,528616.45
330412,202303,241,111,130,144528.17,169260.1,313788.27
330414,202303,5985,2346,3639,3054645.91,4748463,7803108.91
330415,202303,678,289,389,376293.22,506484.19,882777.41
330420,202303,2701,1410,1291,1835873.8,1684804.71,3520678.51
330430,202303,1950,828,1122,1079392.25,1463467.71,2542859.96
330440,202303,419,203,216,264310.35,281233.9,545544.25
330450,202303,133,58,75,75517.27,97650.68,173167.95
330452,202303,2719,1111,1608,1446583.23,2093645.42,3540228.65
330455,202303,139666,48796,90870,63586229.91,118459847.59,182046077.50
330460,202303,284,132,152,171865.2,199206.4,371071.6
330470,202303,1352,718,634,934860.67,825481.33,1760342.00
330475,202303,2037,617,1420,804653.81,1848855.54,2653509.35
330480,202303,848,466,382,608053.86,497371.34,1105425.20
330490,202303,18315,5624,12691,7326754.28,16542168.43,23868922.71
330500,202303,1717,732,985,954393.72,1282485.07,2236878.79
330510,202303,12255,4317,7938,5623601.8,10347174.42,15970776.22
330513,202303,105,55,50,71610,65100,136710
330515,202303,742,325,417,423163.83,544254,967417.83
330520,202303,2754,943,1811,1227838.24,2357971.06,3585809.30
330530,202303,187,107,80,139317.11,104160.1,243477.21
330540,202303,379,201,178,261706.24,231759.94,493466.18
330550,202303,3105,1032,2073,1346302.05,2702982.52,4049284.57
330555,202303,1266,435,831,566384.33,1083272.58,1649656.91
330560,202303,849,300,549,391914.46,714806.75,1106721.21
330570,202303,354,245,109,318993.62,141918.52,460912.14
330575,202303,968,361,607,472640.97,790329.56,1262970.53
330580,202303,3778,1978,1800,2578041.62,2352750.19,4930791.81
330590,202303,273,143,130,186189.86,169262.05,355451.91
330600,202303,1552,911,641,1186169.58,834600.48,2020770.06
330610,202303,1755,885,870,1152299.61,1135353.24,2287652.85
330615,202303,237,190,47,247384.98,61197.05,308582.03
330620,202303,1053,444,609,578119.08,794238.56,1372357.64
330630,202303,5123,3020,2103,3937403.84,2740761.94,6678165.78
350010,202303,630,414,216,540351.93,281235.24,821587.17
350020,202303,55,18,37,23437.82,48174,71611.82
350030,202303,611,355,256,462239.9,334622.02,796861.92
350040,202303,117,51,66,66406.11,85932.68,152338.79
350050,202303,386,182,204,236971.63,266913.94,503885.57
350055,202303,137,59,78,76820.39,101556.21,178376.60
350060,202303,83,35,48,45571.8,62496.2,108068.0
350070,202303,835,458,377,596353.86,492175,1088528.86
350075,202303,83,53,30,69008.13,39060,108068.13
350080,202303,64,29,35,37758.44,45570.97,83329.41
350090,202303,85,45,40,58593,52080,110673
350100,202303,315,194,121,252593.4,157542,410135.4
350110,202303,48,31,17,40364,22134,62498
350115,202303,188,92,96,119786.99,126294.54,246081.53
350120,202303,114,73,41,96351.21,53382.47,149733.68
350130,202303,439,186,253,243494.46,330716.99,574211.45
350140,202303,38,23,15,29946.64,19530,49476.64
350150,202303,79,55,24,71612.02,31248.15,102860.17
350160,202303,2564,1014,1550,1320271.4,2019412.1,3339683.5
350170,202303,434,253,181,329418.92,236967.78,566386.70
350180,202303,169,91,78,118487.64,101556.41,220044.05
350190,202303,1047,561,486,730463.92,632774.19,1363238.11
350200,202303,62,27,35,35155,45570,80725
350210,202303,1397,743,654,967436.2,854139.29,1821575.49
350220,202303,646,514,132,670548.33,171866.47,842414.80
350230,202303,71,43,28,55986.49,36456.9,92443.39
350240,202303,61,38,23,49476.65,29947.13,79423.78
350250,202303,1162,521,641,678370.29,835898.88,1514269.17
350260,202303,112,82,30,106767.86,39060.87,145828.73
350270,202303,1037,685,352,893180.62,458307.37,1351487.99
350275,202303,352,132,220,171866.4,287746.44,459612.84
350280,202303,4667,2204,2463,2873645.82,3208148.81,6081794.63
350290,202303,511,218,293,283842.35,382790.95,666633.30
350300,202303,50,27,23,35157.13,29946.9,65104.03
350310,202303,80,45,35,58591.15,45570.49,104161.64
350315,202303,75,31,44,40362,57288,97650
350320,202303,3616,1677,1939,2186175.72,2529814.54,4715990.26
350330,202303,1765,859,906,1119761.03,1184825.04,2304586.07
350335,202303,21,13,8,16926,10416,27342
350340,202303,128,51,77,66403.24,100258.43,166661.67
350350,202303,97,46,51,59892.34,66402,126294.34
350360,202303,108,71,37,92446.2,49476.37,141922.57
350370,202303,87,49,38,63801.39,49476.48,113277.87
350380,202303,916,396,520,515610.14,677047.81,1192657.95
350390,202303,1942,720,1222,938767.18,1592366.57,2531133.75
350395,202303,19,14,5,18228,6510,24738
350400,202303,1870,882,988,1151015.39,1286378.01,2437393.40
350410,202303,3351,1332,2019,1735624.65,2631368.61,4366993.26
350420,202303,296,174,122,226552.78,158845.28,385398.06
350430,202303,105,51,54,66405.16,70311.15,136716.31
350440,202303,147,103,44,134113.34,58590.35,192703.69
350450,202303,1866,1016,850,1325493.94,1108005.48,2433499.42
350460,202303,440,151,289,196611.09,376291.68,572902.77
350470,202303,23,13,10,16926,13020,29946
350480,202303,206,107,99,139320.85,128898.73,268219.58
350490,202303,266,119,147,154941.04,191394.8,346335.84
350500,202303,59,20,39,26040,50778,76818
350510,202303,154,86,68,111976.62,88536.38,200513.00
350520,202303,469,250,219,325520.36,285146.48,610666.84
350530,202303,464,223,241,290362.67,313793.65,604156.32
350535,202303,96,64,32,83328.37,41664.96,124993.33
350540,202303,365,192,173,249991.98,225253.68,475245.66
350550,202303,2973,1651,1322,2153623.72,1722556.69,3876180.41
350560,202303,627,429,198,559881.83,257800.3,817682.13
350570,202303,4833,1978,2855,2576751.96,3718548.2,6295300.16
350580,202303,403,192,211,249993.94,274726.64,524720.58
350590,202303,1066,564,502,734354.39,655050.95,1389405.34
350600,202303,6873,3113,3760,4055943.15,4904686.58,8960629.73
350610,202303,1619,846,773,1102835.98,1006453.23,2109289.21
350620,202303,24,14,10,18228,13020,31248
350630,202303,275,134,141,174472.81,183584.48,358057.29
350635,202303,1399,595,804,774716.79,1046828.34,1821545.13
350640,202303,128,88,40,114577.2,52080.7,166657.9
350650,202303,2041,1332,709,1734352.59,924425.32,2658777.91
350660,202303,861,338,523,440086.7,680953.56,1121040.26
350670,202303,306,149,157,194001.96,204414.7,398416.66
350680,202303,167,86,81,111975.58,105462.92,217438.50
350690,202303,211,94,117,122389.65,152334,274723.65
350700,202303,1028,489,539,638006.73,703090.69,1341097.42
350710,202303,446,162,284,210930.99,369773.99,580704.98
350715,202303,58,46,12,59893.2,15624,75517.2
350720,202303,16,12,4,15624.32,5208,20832.32
350730,202303,46,27,19,35156.25,24738.61,59894.86
350740,202303,258,143,115,186190.83,149731.78,335922.61
350745,202303,32,14,18,18229.29,23437.45,41666.74
350750,202303,2718,1573,1145,2049439.95,1490805.74,3540245.69
350760,202303,4336,1808,2528,2357999.02,3295394.15,5653393.17
350770,202303,58,36,22,46873.06,28644,75517.06
350775,202303,64,48,16,62501.68,20833.08,83334.76
350780,202303,494,245,249,319006.64,325502.53,644509.17
350790,202303,373,156,217,203117.36,282539.19,485656.55
350800,202303,565,337,228,438781.94,296856.88,735638.82
350810,202303,534,404,130,527341.86,169260.39,696602.25
350820,202303,99,54,45,70309.56,58590,128899.56
350830,202303,82,41,41,53382.17,53382,106764.17
350840,202303,875,350,525,458323.65,684980.38,1143304.03
350850,202303,2004,1027,977,1338499.61,1274666.01,2613165.62
350860,202303,747,379,368,493478.84,479149.29,972628.13
350870,202303,475,320,155,416650.16,201810.7,618460.86
350880,202303,296,154,142,200515.01,184887.43,385402.44
350890,202303,40,24,16,31248,20832.83,52080.83
350900,202303,1762,572,1190,746072.99,1553318.68,2299391.67
350910,202303,26,13,13,16926,16926.14,33852.14
350920,202303,852,435,417,566381.62,544237.3,1110618.92
350925,202303,1247,616,631,803377.42,824186.36,1627563.78
350930,202303,127,72,55,93747.64,71610.28,165357.92
350940,202303,779,401,378,523434.55,494777.48,1018212.03
350945,202303,123,84,39,109371.3,50778.68,160149.98
350950,202303,19360,8900,10460,11598597.9,13634668.1,25233266.0
350960,202303,1870,745,1125,971516.09,1468674.88,2440190.97
350970,202303,1184,563,621,732918.99,808558.15,1541477.14
350980,202303,101,66,35,85934.74,45570.4,131505.14
350990,202303,427,155,272,201811.48,354146.39,555957.87
350995,202303,46,19,27,24739.32,35154.94,59894.26
351000,202303,638,399,239,520818.29,312490.99,833309.28
351010,202303,55,36,19,46874.88,24738,71612.88
351015,202303,46,26,20,33852.63,26040,59892.63
351020,202303,1582,938,644,1221318.57,838498.15,2059816.72
351030,202303,359,207,152,269518.47,197904.32,467422.79
351040,202303,1099,599,500,779926.2,652308.4,1432234.6
351050,202303,3999,1803,2196,2351524.98,2861823.72,5213348.70
351060,202303,6721,2425,4296,3160089.97,5599944.07,8760034.04
351070,202303,433,267,166,347648.05,216137.58,563785.63
351080,202303,817,594,223,774718.42,290350.35,1065068.77
351090,202303,49,24,25,31249.01,32550.41,63799.42
351100,202303,447,235,212,305992.74,276036.02,582028.76
351110,202303,2230,1008,1222,1315074.98,1594954.76,2910029.74
351120,202303,67,32,35,41665.46,45570,87235.46
351130,202303,198,64,134,83329.92,174471.97,257801.89
351140,202303,340,199,141,259109.21,183586,442695.21
351150,202303,541,274,267,356757.4,347636.66,704394.06
351160,202303,342,195,147,253897.21,191394.72,445291.93
351170,202303,249,143,106,186189.5,138012.55,324202.05
351190,202303,104,61,43,79423.42,55986.96,135410.38
351200,202303,362,233,129,303376.03,169261.62,472637.65
351210,202303,133,64,69,83330.49,89838.78,173169.27
351220,202303,632,350,282,455715.2,368467,824182.2
351230,202303,328,207,121,269519.18,157542.8,427061.98
351240,202303,255,125,130,162753.67,169263.59,332017.26
351250,202303,91,65,26,84638.59,33852.1,118490.69
351260,202303,146,100,46,130202.1,59892.43,190094.53
351270,202303,52,23,29,29946.12,37758,67704.12
351280,202303,1100,534,566,695295.26,736940.25,1432235.51
351290,202303,259,122,137,158845.85,178374.7,337220.55
351300,202303,4402,1826,2576,2380134.2,3355307.81,5735442.01
351310,202303,774,369,405,480464.46,527323.9,1007788.36
351320,202303,121,67,54,87236.11,70308.6,157544.71
351330,202303,43,25,18,32550,23436,55986
351340,202303,1571,841,730,1096321.6,950464.95,2046786.55
351350,202303,2606,1530,1076,1992164.33,1400960.65,3393124.98
351360,202303,847,395,452,514300.86,589810.88,1104111.74
351370,202303,475,232,243,302073.61,316387.54,618461.15
351380,202303,9255,4030,5225,5252437.93,6810799.12,12063237.05
351385,202303,26,19,7,24739.67,9114,33853.67
351390,202303,292,212,80,276029.93,104160.39,380190.32
351400,202303,63,39,24,50778.8,31248,82026.8
351410,202303,498,286,212,373689.53,276025.55,649715.08
351420,202303,78,56,22,72913.32,28644,101557.32
351430,202303,76,37,39,48174.43,50778.2,98952.63
351440,202303,879,565,314,735667.96,410138.59,1145806.55
351450,202303,307,153,154,199210.76,201814.7,401025.46
351460,202303,145,61,84,79426.5,109370.01,188796.51
351470,202303,149,80,69,104164.08,89838.89,194002.97
351480,202303,487,283,204,368471.74,265608.2,634079.94
351490,202303,332,135,197,175772.64,256494.72,432267.36
351492,202303,28,17,11,22134.63,14322,36456.63
351495,202303,27,17,10,22134.65,13020,35154.65
351500,202303,3690,1462,2228,1903565.59,2902181.83,4805747.42
351510,202303,2303,824,1479,1074189.48,1926981.31,3001170.79
351512,202303,14,10,4,13020,5208,18228
351515,202303,228,129,99,167965.73,128898,296863.73
351518,202303,713,423,290,550780.13,378908.22,929688.35
351519,202303,89,54,35,70310.37,45570,115880.37
351520,202303,178,111,67,144524.95,87258.45,231783.40
351530,202303,26,12,14,15624,18228,33852
351535,202303,136,79,57,102862.38,74215.78,177078.16
351540,202303,504,319,185,415352.9,240874.65,656227.55
351550,202303,1699,996,703,1296841.84,916615.53,2213457.37
351560,202303,88,48,40,62498.66,52080,114578.66
351565,202303,16,8,8,10416.32,10416,20832.32
351570,202303,3041,1363,1678,1774702.46,2189986.83,3964689.29
351580,202303,36,33,3,42966,3906,46872
351590,202303,69,41,28,53384.3,36456.86,89841.16
351600,202303,187,136,51,177079.74,66402.76,243482.50
351610,202303,54,24,30,31248.42,39060,70308.42
351620,202303,6350,3314,3036,4316343.88,3954217.54,8270561.42
351630,202303,3616,1689,1927,2201758.78,2514190.29,4715949.07
351640,202303,2772,1198,1574,1561152.91,2051967.58,3613120.49
351650,202303,39,31,8,40362.82,10416,50778.82
351660,202303,150,94,56,122388.8,72912,195300.8
351670,202303,797,449,348,584622.95,454407.01,1039029.96
351680,202303,95,67,28,87234.9,36456,123690.9
351685,202303,13,9,4,11718.13,5208,16926.13
351690,202303,313,198,115,257806.27,149731.52,407537.79
351700,202303,201,136,65,177357.61,84630.2,261987.81
351710,202303,69,44,25,57290.28,32550.91,89841.19
351720,202303,124,68,56,88538.4,72912,161450.4
351730,202303,125,84,41,109368.73,54684,164052.73
351740,202303,843,524,319,682288.95,415344.86,1097633.81
351750,202303,397,159,238,207024.72,309877.6,516902.32
351760,202303,723,562,161,731635.33,209622,941257.33
351770,202303,310,246,64,321613.32,83328.56,404941.88
351780,202303,143,88,55,114578.32,71610,186188.32
351790,202303,278,138,140,180985.81,182283.24,363269.05
351800,202303,48,32,16,41664.18,20832,62496.18
351810,202303,122,77,45,100263.17,58593.52,158856.69
351820,202303,773,545,228,709641.49,296863.8,1006505.29
351830,202303,693,223,470,290354.81,611947.7,902302.51
351840,202303,2463,1092,1371,1421829.64,1785048.9,3206878.54
351850,202303,280,188,92,246089.58,119784,365873.58
351860,202303,629,415,214,540360.81,278631.24,818992.05
351870,202303,6304,2799,3505,3647048.09,4566217.66,8213265.75
351880,202303,24305,9247,15058,12046470.65,19630303.22,31676773.87
351885,202303,106,59,47,76819.66,61194.3,138013.96
351890,202303,77,53,24,69007.08,31248,100255.08
351900,202303,258,133,125,173172.04,162750.95,335922.99
351905,202303,105,52,53,67705.43,69006.24,136711.67
351907,202303,4077,1654,2423,2153592.34,3156076.85,5309669.19
351910,202303,164,68,96,88540.3,126294.66,214834.96
351920,202303,116,63,53,82026,69006,151032
351925,202303,96,59,37,76822.21,48175.51,124997.72
351930,202303,492,302,190,393228.89,247387.23,640616.12
351940,202303,247,102,145,132806.31,188791.07,321597.38
351950,202303,151,83,68,108067.42,89841.68,197909.10
351960,202303,1034,498,536,648426.89,699198.54,1347625.43
351970,202303,2299,1076,1223,1402284.77,1592368.98,2994653.75
351980,202303,164,70,94,91142.59,122390.74,213533.33
351990,202303,259,160,99,208324.61,128898.87,337223.48
352000,202303,327,209,118,272132.59,153640.54,425773.13
352010,202303,463,299,164,389406.4,213540.15,602946.55
352020,202303,212,67,145,89838,188790,278628
352030,202303,1270,593,677,772112.09,881471.69,1653583.78
352040,202303,740,285,455,371075.61,592415.16,963490.77
352042,202303,363,82,281,106768,365864.76,472632.76
352044,202303,382,212,170,276040.73,221344.17,497384.90
352050,202303,3506,1278,2228,1666605.23,2902179.25,4568784.48
352060,202303,105,63,42,82026.18,54685.49,136711.67
352070,202303,106,72,34,93750.38,44268,138018.38
352080,202303,66,39,27,50781.35,35154.48,85935.83
352090,202303,199,122,77,158848.43,100256.01,259104.44
352100,202303,335,160,175,208327.63,227853.42,436181.05
352110,202303,109,28,81,36457.01,106764,143221.01
352115,202303,70,26,44,33852.9,57288.59,91141.49
352120,202303,71,47,24,61194,31248,92442
352130,202303,223,164,59,213539.79,76818.57,290358.36
352140,202303,205,100,105,130202.31,136712.36,266914.67
352150,202303,134,70,64,91143.38,83330.17,174473.55
352160,202303,145,94,51,122390.98,66402.54,188793.52
352170,202303,449,294,155,382792.65,203112.08,585904.73
352180,202303,741,440,301,572904.48,391911.42,964815.90
352190,202303,253,106,147,138018.55,192698.56,330717.11
352200,202303,30,13,17,16926.48,22134.1,39060.58
352210,202303,4900,1928,2972,2512986.04,3874786.19,6387772.23
352215,202303,80,42,38,54684.2,49476,104160.2
352220,202303,6507,2394,4113,3119709.55,5356497.99,8476207.54
352230,202303,3917,2446,1471,3184836.93,1916551.91,5101388.84
352240,202303,2976,1655,1321,2154882.43,1725167.85,3880050.28
352250,202303,3984,1751,2233,2282484.94,2912585.78,5195070.72
352260,202303,1110,573,537,746072.37,700491.15,1446563.52
352265,202303,70,41,29,53382,37758,91140
352270,202303,422,227,195,295580.31,253898.49,549478.80
352280,202303,542,316,226,411443.51,294252,705695.51
352290,202303,187,103,84,134113.65,109371.68,243485.33
352300,202303,106,64,42,83332.27,54685.92,138018.19
352310,202303,8215,3546,4669,4617098.18,6081657.77,10698755.95
352320,202303,1237,637,600,829395.55,781209.36,1610604.91
352330,202303,562,288,274,374979.44,356748.89,731728.33
352340,202303,1469,665,804,867160.89,1048119.73,1915280.62
352350,202303,394,212,182,277334.51,238269.15,515603.66
352360,202303,227,98,129,127598.19,167958.7,295556.89
352370,202303,127,77,50,100256.93,65102.54,165359.47
352380,202303,121,84,37,109371.96,48175.13,157547.09
352390,202303,2783,1172,1611,1527304.74,2098833.38,3626138.12
352400,202303,586,256,330,333317.56,429664.41,762981.97
352410,202303,966,631,335,821604.3,436190.91,1257795.21
352420,202303,90,64,26,83328.96,33852,117180.96
352430,202303,1856,803,1053,1046858.6,1373641.05,2420499.65
352440,202303,3736,1661,2075,2164009.97,2704265.93,4868275.90
352450,202303,201,155,46,201814,59893.24,261707.24
352460,202303,681,333,348,433575.86,453100.75,886676.61
352470,202303,717,272,445,354160.1,579395.57,933555.67
352480,202303,1748,981,767,1277312.42,999955.81,2277268.23
352490,202303,56,22,34,28644.6,44268.26,72912.86
352500,202303,1640,647,993,843715.97,1294198.48,2137914.45
352510,202303,773,400,373,520828.02,485652.02,1006480.04
352520,202303,912,411,501,536440.35,653620.2,1190060.55
352530,202303,2008,982,1026,1281232.67,1338467.37,2619700.04
352540,202303,71,48,23,63800.4,29946,93746.4
352550,202303,231,128,103,166658.56,134106,300764.56
352560,202303,54,38,16,49477.04,20832.84,70309.88
352570,202303,811,388,423,505206.22,552061.72,1057267.94
352580,202303,59,44,15,57291.25,19530,76821.25
352585,202303,18,6,12,7812.98,15624.95,23437.93
352590,202303,4829,2360,2469,3078060.81,3219873.38,6297934.19
352600,202303,388,262,126,342439.24,164059.82,506499.06
352610,202303,970,422,548,550759.27,714805.05,1265564.32
352620,202303,1215,457,758,595029.23,986926.83,1581956.06
352630,202303,194,72,122,95046.98,158844.08,253891.06
352640,202303,543,347,196,454421.92,256499.51,710921.43
352650,202303,94,64,30,83331.1,39060,122391.1
352660,202303,72,38,34,49476.67,44268,93744.67
352670,202303,1852,966,886,1257812.35,1153574.63,2411386.98
352680,202303,1031,598,433,778629.59,563789.88,1342419.47
352690,202303,5033,2172,2861,2831970.12,3734166.17,6566136.29
352700,202303,94,50,44,65103.62,57289.38,122393.00
352710,202303,1604,818,786,1065090.07,1024676.59,2089766.66
352720,202303,1706,692,1014,901029.28,1320256.83,2221286.11
352725,202303,28,21,7,27342.76,9114,36456.76
352730,202303,430,206,224,268219.38,291651.2,559870.58
352740,202303,406,257,149,335934.57,195303.02,531237.59
352750,202303,25,14,11,18229.6,14322.14,32551.74
352760,202303,242,154,88,201813.97,114576.72,316390.69
352770,202303,79,57,22,74217.37,29946.18,104163.55
352780,202303,77,42,35,54684,45570.78,100254.78
352790,202303,27,18,9,23437.44,11718.18,35155.62
352800,202303,259,194,65,252594.44,85933.96,338528.40
352810,202303,160,100,60,130202.83,78123.73,208326.56
352820,202303,47,35,12,45570.75,15624,61194.75
352830,202303,75,49,26,63799.67,33852.01,97651.68
352840,202303,751,334,417,434892.88,544244.95,979137.83
352850,202303,1980,581,1399,757780.78,1822813.17,2580593.95
352860,202303,124,77,47,100258.93,61194.12,161453.05
352870,202303,54,33,21,42970.99,27342.43,70313.42
352880,202303,193,110,83,143227.82,108067.51,251295.33
352885,202303,33,21,12,27342.48,15624,42966.48
352890,202303,59,35,24,45571.6,31248.6,76820.2
352900,202303,4888,2284,2604,2973892.19,3396932.68,6370824.87
352910,202303,40,32,8,41664.88,10416,52080.88
352920,202303,668,379,289,493482.94,376287.36,869770.30
352930,202303,1247,575,672,749985.24,874948.91,1624934.15
352940,202303,6822,2531,4291,3296746.43,5596066.56,8892812.99
352950,202303,129,60,69,78122.54,89840.6,167963.14
352960,202303,67,44,23,57288.93,29946,87234.93
352965,202303,15,9,6,11718,7812,19530
352970,202303,564,401,163,522124.83,212231.74,734356.57
352980,202303,161,94,67,122396.47,87235.37,209631.84
352990,202303,1012,470,542,611966.63,705696.71,1317663.34
353000,202303,64,30,34,39060.73,44268.54,83329.27
353010,202303,549,332,217,432281.73,282537.27,714819.00
353020,202303,347,224,123,291657.99,160149.23,451807.22
353030,202303,1469,649,820,845031.13,1068964.66,1913995.79
353040,202303,92,48,44,62498.22,57289.75,119787.97
353050,202303,1412,914,498,1190096.44,649701.66,1839798.10
353060,202303,9851,4230,5621,5514223.94,7325117.18,12839341.12
353070,202303,2113,1217,896,1588512.75,1166363.84,2754876.59
353080,202303,1395,740,655,963521.3,855417.76,1818939.06
353090,202303,70,38,32,49478.33,41664,91142.33
353100,202303,46,34,12,44269.55,15625.54,59895.09
353110,202303,2418,792,1626,1032545.43,2118441.32,3150986.75
353120,202303,145,84,61,109368.7,79422,188790.7
353130,202303,897,422,475,549469.19,618455.07,1167924.26
353140,202303,615,283,332,368486.95,433572.68,802059.63
353150,202303,322,162,160,210929.82,209625.17,420554.99
353160,202303,110,82,28,106770.76,36456,143226.76
353170,202303,208,73,135,95049.65,175770.51,270820.16
353180,202303,1359,622,737,812469.56,959588.44,1772058.00
353190,202303,523,368,155,480462.33,201813.06,682275.39
353200,202303,288,139,149,180981.06,193998.69,374979.75
353205,202303,20,13,7,16926,9114,26040
353210,202303,77,46,31,59893.8,40362.09,100255.89
353215,202303,44,24,20,31248.2,26040,57288.2
353220,202303,85,45,40,58591.46,52081.18,110672.64
353230,202303,160,70,90,91142.08,117180,208322.08
353240,202303,425,182,243,236966.55,316386.85,553353.40
353250,202303,188,92,96,121089.65,124994.82,246084.47
353260,202303,494,314,180,408843.76,234366.67,643210.43
353270,202303,72,56,16,72915.24,20832,93747.24
353280,202303,126,58,68,75520.47,88539.87,164060.34
353282,202303,134,89,45,115879.3,58590.6,174469.9
353284,202303,31,23,8,29948.16,10416,40364.16
353286,202303,9,4,5,5208.2,6510.21,11718.41
353290,202303,87,50,37,66403.09,48174,114577.09
353300,202303,469,233,236,303381.56,307280.85,610662.41
353310,202303,38,30,8,39061.25,10417.05,49478.30
353320,202303,44,24,20,31249.3,26040.2,57289.5
353325,202303,46,24,22,31249.85,28644,59893.85
353330,202303,61,41,20,53382.4,26040.56,79422.96
353340,202303,748,271,477,352853.41,622365.76,975219.17
353350,202303,975,479,496,626283.64,647111.44,1273395.08
353360,202303,109,86,23,111974.65,29946.75,141921.40
353370,202303,116,63,53,82029.87,69006.38,151036.25
353380,202303,27,13,14,16926.2,18228,35154.2
353390,202303,1206,565,641,735663.37,835900.92,1571564.29
353400,202303,56,30,26,39062.5,33854.04,72916.54
353410,202303,117,62,55,80728.31,71612.57,152340.88
353420,202303,65,31,34,40362,44268,84630
353430,202303,596,387,209,503901.27,272128.3,776029.57
353440,202303,14261,6302,7959,8206714.88,10388721.38,18595436.26
353450,202303,50,24,26,31248.3,35154.2,66402.5
353460,202303,693,357,336,464841.08,438789.08,903630.16
353470,202303,2428,1162,1266,1514306.1,1650945.32,3165251.42
353475,202303,301,190,111,247387.28,144522.91,391910.19
353480,202303,187,146,41,190096.74,53382,243478.74
353490,202303,236,135,101,175776.54,131502.92,307279.46
353500,202303,219,123,96,160149.81,124993.23,285143.04
353510,202303,84,56,28,72913.54,36456.3,109369.84
353520,202303,260,187,73,243477.89,95046.6,338524.49
353530,202303,519,252,267,328119.06,347639.47,675758.53
353540,202303,433,265,168,347651.85,218741.67,566393.52
353550,202303,797,496,301,647141.94,393222.46,1040364.40
353560,202303,573,232,341,302066.98,445285.79,747352.77
353570,202303,70,48,22,62498.32,28644,91142.32
353580,202303,376,231,145,300769.86,188790,489559.86
353590,202303,94,70,24,91141.73,31248,122389.73
353600,202303,295,167,128,218743.47,167958.28,386701.75
353610,202303,147,81,66,105465.43,85932,191397.43
353620,202303,714,350,364,457019.07,473935.14,930954.21
353625,202303,66,33,33,42967.7,42966.27,85933.97
353630,202303,231,161,70,209633.51,91140.78,300774.29
353640,202303,135,86,49,111976.87,63798.54,175775.41
353650,202303,1125,440,685,572890.69,891878.9,1464769.59
353657,202303,25,19,6,24738,7812,32550
353660,202303,312,159,153,207023.38,199208.93,406232.31
353670,202303,756,424,332,555974.42,432273.43,988247.85
353680,202303,150,95,55,123690.58,71610,195300.58
353690,202303,46,30,16,40362.26,20833.09,61195.35
353700,202303,303,203,100,264311.82,130202.38,394514.20
353710,202303,581,281,300,365880.47,390601.45,756481.92
353715,202303,41,23,18,29946,23436,53382
353720,202303,334,148,186,192703.13,242176.05,434879.18
353730,202303,1232,724,508,946602.02,662720.82,1609322.84
353740,202303,633,345,288,449210.04,374984.06,824194.10
353750,202303,92,46,46,59893.9,59892,119785.9
353760,202303,3541,1364,2177,1776012.46,2837104.36,4613116.82
353770,202303,78,61,17,79423.24,22134.2,101557.44
353780,202303,1488,666,822,868458.43,1072859.72,1941318.15
353790,202303,528,309,219,402335.83,286448.34,688784.17
353800,202303,4088,1867,2221,2430963.86,2896960.33,5327924.19
353810,202303,255,126,129,164063.73,167958.77,332022.50
353820,202303,281,112,169,145824.85,220040.61,365865.46
353830,202303,71,60,11,78121.85,14322.9,92444.75
353850,202303,222,98,124,127600.43,161449.65,289050.08
353860,202303,568,260,308,338528.02,402323.07,740851.09
353870,202303,6282,3168,3114,4127476.55,4057066.41,8184542.96
353880,202303,776,495,281,645822.01,365866.13,1011688.14
353890,202303,599,341,258,444004.99,337225.87,781230.86
353900,202303,147,78,69,101558.14,89839.9,191398.04
353910,202303,214,86,128,111974.12,166656.82,278630.94
353920,202303,501,254,247,332019.56,321598.4,653617.96
353930,202303,1101,638,463,832016.27,604131.61,1436147.88
353940,202303,223,107,116,140617.22,151034.24,291651.46
353950,202303,542,348,194,454420.14,252591.74,707011.88
353960,202303,82,66,16,85935.31,20832,106767.31
353970,202303,44,28,16,36457.74,20833.16,57290.90
353980,202303,2133,930,1203,1210901.81,1568933.73,2779835.54
353990,202303,84,50,34,65102.39,45570.61,110673.00
354000,202303,405,182,223,236973.36,290349.02,527322.38
354010,202303,90,51,39,66406.34,50778.69,117185.03
354020,202303,549,344,205,447904.93,268218.13,716123.06
354025,202303,41,34,7,44269.56,9114,53383.56
354030,202303,49,26,23,35157.29,29946.15,65103.44
354040,202303,99,74,25,96351.3,32550,128901.3
354050,202303,165,84,81,109369.87,105463.28,214833.15
354060,202303,878,410,468,533833.37,609338.62,1143171.99
354070,202303,972,540,432,704406.33,565076.22,1269482.55
354075,202303,197,95,102,123693.45,132806.01,256499.46
354080,202303,317,144,173,188798.36,225247.89,414046.25
354085,202303,26,16,10,20833.04,13020,33853.04
354090,202303,294,169,125,219932.71,162752.35,382685.06
354100,202303,6681,2689,3992,3502526.97,5204186.97,8706713.94
354105,202303,105,55,50,71612.21,65100,136712.21
354110,202303,44,22,22,28644,28644.8,57288.8
354120,202303,164,101,63,131506.66,82026.46,213533.12
354130,202303,834,513,321,667959.78,417944.88,1085904.66
354140,202303,3581,1595,1986,2080697.02,2588394.97,4669091.99
354150,202303,678,383,295,498693.53,384098.12,882791.65
354160,202303,705,434,271,566405.98,352853.78,919259.76
354165,202303,12,7,5,9114,6510,15624
354170,202303,192,125,67,164058.19,87234.65,251292.84
354180,202303,54,32,22,41664.4,28644.75,70309.15
354190,202303,221,82,139,106766.78,180979.83,287746.61
354200,202303,119,58,61,75519.14,79423.72,154942.86
354210,202303,76,32,44,41664,58590,100254
354220,202303,635,378,257,492188,334622.43,826810.43
354230,202303,185,82,103,106766.34,134107.17,240873.51
354240,202303,342,206,136,268226.08,177072.72,445298.80
354250,202303,77,45,32,58590.72,41664,100254.72
354260,202303,2277,1044,1233,1360636.87,1605397.5,2966034.37
354270,202303,91,64,27,83330.19,35154.5,118484.69
354280,202303,58,32,26,41664.79,33852,75516.79
354290,202303,158,104,54,135416.23,70308.85,205725.08
354300,202303,339,237,102,308581.86,132805.08,441386.94
354310,202303,95,65,30,84635.16,39060.6,123695.76
354320,202303,243,112,131,145825.24,170562.51,316387.75
354323,202303,10,7,3,9114,3906,13020
354325,202303,130,71,59,92444.99,76818.83,169263.82
354330,202303,2610,874,1736,1137994.03,2260282.12,3398276.15
354340,202303,11517,5170,6347,6737870.58,8278193.43,15016064.01
354350,202303,153,101,52,131503.52,67704,199207.52
354360,202303,79,46,33,59894.62,42967.32,102861.94
354370,202303,247,125,122,162755.38,158846.18,321601.56
354380,202303,183,104,79,135411.96,102858,238269.96
354390,202303,2977,1063,1914,1385377.89,2493356.64,3878734.53
354400,202303,378,197,181,256500.78,236964.79,493465.57
354410,202303,748,327,421,425772.47,548154.9,973927.37
354420,202303,294,198,96,257806.56,124994.91,382801.47
354425,202303,356,200,156,260469.96,203114.24,463584.20
354430,202303,183,96,87,124997.97,113274.7,238272.67
354440,202303,27,22,5,28645.42,6510,35155.42
354450,202303,58,38,20,49477.34,27342,76819.34
354460,202303,103,57,46,74221.69,59895.05,134116.74
354470,202303,25,13,12,16927.25,15624.76,32552.01
354480,202303,121,67,54,87235.21,70309.51,157544.72
354490,202303,130,73,57,96352.46,74218.14,170570.60
354500,202303,426,178,248,231757.62,324198.68,555956.30
354510,202303,89,62,27,80726.86,35154.81,115881.67
354515,202303,52,18,34,23438.41,44268.1,67706.51
354520,202303,1738,728,1010,949009.27,1316324.16,2265333.43
354530,202303,916,449,467,585915.62,608038.71,1193954.33
354540,202303,268,132,136,171869.96,177074.07,348944.03
354550,202303,45,24,21,31248.79,27342,58590.79
354560,202303,171,93,78,121086.4,101556.73,222643.13
354570,202303,142,95,47,123690.98,61194.49,184885.47
354580,202303,2022,947,1075,1234334.7,1399658.86,2633993.56
354600,202303,298,136,162,177079.72,210924.5,388004.22
354610,202303,65,54,11,70308.99,14322.82,84631.81
354620,202303,76,22,54,28644.5,70309.08,98953.58
354625,202303,13,9,4,11719.64,5208.72,16928.36
354630,202303,376,250,126,325518.15,165358.15,490876.30
354640,202303,893,522,371,681210.6,484353.91,1165564.51
354650,202303,70,41,29,53384.09,37758,91142.09
354660,202303,889,640,249,834627.49,324201.45,1158828.94
354670,202303,237,92,145,119784.47,188790.2,308574.67
354680,202303,1451,514,937,670550.53,1221285.7,1891836.23
354690,202303,82,49,33,63800.65,42966.27,106766.92
354700,202303,77,54,23,70308.61,29946,100254.61
354710,202303,46,33,13,42966.97,16926,59892.97
354720,202303,22,19,3,24738.46,3906,28644.46
354730,202303,1993,811,1182,1055955.32,1541587.65,2597542.97
354740,202303,75,53,22,69006.09,28644,97650.09
354750,202303,425,230,195,299469.67,253891.95,553361.62
354760,202303,559,346,213,450529.59,278637.71,729167.30
354765,202303,7,3,4,3906,5208,9114
354770,202303,370,238,132,309891.54,171867.89,481759.43
354780,202303,9153,3312,5841,4316253.06,7620652.93,11936905.99
354790,202303,92,53,39,69006,50778.11,119784.11
354800,202303,460,243,217,316462.05,282540.59,599002.64
354805,202303,78,39,39,50778.99,50778.27,101557.26
354810,202303,100,53,47,69007.41,61194,130201.41
354820,202303,231,93,138,121089.66,179678.88,300768.54
354830,202303,43,23,20,29946,26040,55986
354840,202303,59,37,22,48175.42,28644,76819.42
354850,202303,5206,2272,2934,2960882.78,3826634.12,6787516.90
354860,202303,366,160,206,208320.63,268214.21,476534.84
354870,202303,13522,5805,7717,7563570.85,10055428.49,17618999.34
354880,202303,2883,1030,1853,1342413.24,2415300.19,3757713.43
354890,202303,3303,1723,1580,2244771.84,2058480.6,4303252.44
354900,202303,64,45,19,58590.6,24738.19,83328.79
354910,202303,1404,704,700,916641.66,911401.89,1828043.55
354920,202303,39,32,7,41664.6,9114,50778.6
354925,202303,26,16,10,20832.9,13020,33852.9
354930,202303,35,28,7,36457.99,9114,45571.99
354940,202303,798,547,251,712233.06,326809.32,1039042.38
354950,202303,211,128,83,166661.16,108068.38,274729.54
354960,202303,132,47,85,61195.24,110670.75,171865.99
354970,202303,1258,876,382,1143209.67,499971.44,1643181.11
354980,202303,10393,3723,6670,4848860.47,8693541.17,13542401.64
354990,202303,11482,5044,6438,6572714.01,8388845.26,14961559.27
354995,202303,643,215,428,279934.62,557265.95,837200.57
355000,202303,463,156,307,203115.2,399714.7,602829.9
355010,202303,720,448,272,585946.36,355456.48,941402.84
355020,202303,870,527,343,688781.16,446594.57,1135375.73
355030,202303,235104,86665,148439,112901526.14,193460348.02,306361874.16
355040,202303,1103,535,568,697904.55,739551.12,1437455.67
355050,202303,187,103,84,134107.88,110670,244777.88
355060,202303,2003,924,1079,1203118.18,1407470.8,2610588.98
355070,202303,1777,770,1007,1002568.95,1315040.21,2317609.16
355080,202303,214,128,86,166660.41,111974.18,278634.59
355090,202303,330,204,126,268225.06,164055,432280.06
355100,202303,6080,2807,3273,3656079.77,4269311.82,7925391.59
355110,202303,216,141,75,184886.44,97650.27,282536.71
355120,202303,51,32,19,41664.61,24738,66402.61
355130,202303,57,31,26,40363.2,33852,74215.2
355140,202303,213,122,91,158848.42,118482.43,277330.85
355150,202303,772,454,318,591135.83,414041.6,1005177.43
355160,202303,536,253,283,330725.85,369774.31,700500.16
355170,202303,2235,1137,1098,1481746.5,1429611.17,2911357.67
355180,202303,728,284,444,369774.09,579400.45,949174.54
355190,202303,228,154,74,200517.07,96350.71,296867.78
355200,202303,118,57,61,74215.8,79422.6,153638.4
355210,202303,772,392,380,511695.54,494886.95,1006582.49
355220,202303,8597,4019,4578,5234255.03,5967131.89,11201386.92
355230,202303,96,51,45,66403.5,58591.87,124995.37
355240,202303,5015,1975,3040,2571482,3960707.43,6532189.43
355250,202303,7741,3376,4365,4400971.75,5697586.6,10098558.35
355255,202303,51,30,21,39060.62,27342,66402.62
355260,202303,203,113,90,147129.91,117181.55,264311.46
355270,202303,170,110,60,143226.14,78120.78,221346.92
355280,202303,7810,2885,4925,3761619,6420260.66,10181879.66
355290,202303,67,50,17,65100.2,22134,87234.2
355300,202303,243,137,106,178379.77,140616.74,318996.51
355310,202303,115,63,52,82026.54,69006,151032.54
355320,202303,108,54,54,70308.6,70308.96,140617.56
355330,202303,349,201,148,261712.08,192698.81,454410.89
355340,202303,1400,512,888,666666.29,1157526.21,1824192.50
355350,202303,179,82,97,106764,126294.2,233058.2
355360,202303,204,132,72,171873.29,93745.18,265618.47
355365,202303,21,16,5,20832,6510,27342
355370,202303,1097,631,466,821604.72,606735.88,1428340.60
355380,202303,877,520,357,677072.17,466124.05,1143196.22
355385,202303,99,63,36,82026.2,46872,128898.2
355390,202303,108,57,51,74215.02,66402.71,140617.73
355395,202303,211,103,108,134111.37,140620.61,274731.98
355400,202303,1951,1078,873,1403506.9,1136648.17,2540155.07
355410,202303,5681,2533,3148,3299393.98,4102624.41,7402018.39
355420,202303,46,31,15,40362.8,19530,59892.8
355430,202303,473,275,198,358074.54,257804.57,615879.11
355440,202303,96,51,45,66403.5,58591.89,124995.39
355450,202303,484,250,234,325512.35,304670.14,630182.49
355460,202303,57,41,16,53383.1,20832.8,74215.9
355465,202303,51,28,23,36456.93,29946,66402.93
355470,202303,202,81,121,105464.3,157543.22,263007.52
355475,202303,7,4,3,5208.28,3906,9114.28
355480,202303,685,274,411,356765.97,536431.85,893197.82
355490,202303,106,76,30,98957.71,39062.42,138020.13
355495,202303,113,42,71,54684.1,92444.71,147128.81
355500,202303,1689,908,781,1184854.67,1018169.98,2203024.65
355510,202303,284,193,91,251300.19,118485.03,369785.22
355520,202303,26,19,7,24738.18,9114,33852.18
355530,202303,23,13,10,16926,13020,29946
355535,202303,85,40,45,52082.74,58590,110672.74
355540,202303,3095,1216,1879,1584602.05,2447809.78,4032411.83
355550,202303,72,40,32,52080.5,41664,93744.5
355560,202303,278,124,154,162755.47,201813.51,364568.98
355570,202303,16,12,4,15624.54,5208,20832.54
355580,202303,244,166,78,216141.41,101558.97,317700.38
355590,202303,16,11,5,14322.24,6510,20832.24
355600,202303,293,138,155,179681.76,201811.97,381493.73
355610,202303,257,152,105,197913.67,136714.86,334628.53
355620,202303,1393,582,811,757790.44,1055926.09,1813716.53
355630,202303,435,311,124,404942.18,161448.14,566390.32
355635,202303,133,54,79,70308.2,102858,173166.2
355640,202303,632,335,297,436180.97,388002.45,824183.42
355645,202303,953,338,615,440092.61,800741.4,1240834.01
355650,202303,1972,858,1114,1118468.64,1453036.62,2571505.26
355660,202303,229,115,114,149733.13,148430.11,298163.24
355670,202303,720,301,419,393210.19,545541.68,938751.87
355680,202303,222,116,106,152344.58,138015.33,290359.91
355690,202303,98,46,52,59893.75,67704.57,127598.32
355695,202303,25,16,9,20832,11718,32550
355700,202303,1338,630,708,820293.59,923125.73,1743419.32
355710,202303,2443,1344,1099,1751282.32,1430903.68,3182186.00
355715,202303,15,12,3,15626.08,3906.1,19532.18
355720,202303,272,165,107,216136.1,139315.83,355451.93
355730,202303,109,62,47,80725.28,61194.15,141919.43
410010,202303,109,88,21,114580.35,27342,141922.35
410020,202303,124,86,38,111975.24,49476.2,161451.44
410030,202303,197,108,89,140619.99,115881.88,256501.87
410040,202303,1504,712,792,927050.42,1035104.95,1962155.37
410045,202303,44,33,11,42966.31,14322,57288.31
410050,202303,550,319,231,415342.24,300762.74,716104.98
410060,202303,217,158,59,205724.17,76818.5,282542.67
410070,202303,258,208,50,270827.05,65101.71,335928.76
410080,202303,192,118,74,153638.48,96348,249986.48
410090,202303,54,46,8,59897.07,10416,70313.07
410100,202303,274,172,102,223947.73,132804.1,356751.83
410105,202303,47,27,20,35154,26040,61194
410110,202303,378,228,150,296869.87,195306.46,492176.33
410115,202303,49,28,21,36456,27342.2,63798.2
410120,202303,489,222,267,289054.36,347639.22,636693.58
410130,202303,69,38,31,49476.24,40362,89838.24
410140,202303,3446,1555,1891,2024666.09,2464715.31,4489381.40
410150,202303,2803,1122,1681,1460886.16,2189985.31,3650871.47
410160,202303,510,293,217,381493.02,282537.63,664030.65
410165,202303,60,38,22,49476.61,28644,78120.61
410170,202303,225,126,99,164055.44,128898.99,292954.43
410180,202303,2566,1334,1232,1738238.19,1605398.94,3343637.13
410185,202303,36,30,6,39060,7812,46872
410190,202303,520,336,184,437483.19,240870.9,678354.09
410200,202303,1130,787,343,1024693.16,446590.19,1471283.35
410210,202303,680,353,327,459621.09,427058.22,886679.31
410220,202303,48,22,26,28644.31,33852,62496.31
410230,202303,214,92,122,119784.52,158846.19,278630.71
410240,202303,748,480,268,624986.84,348938.04,973924.88
410250,202303,393,265,128,345035.44,166658.22,511693.66
410260,202303,317,175,142,227860.32,184893.15,412753.47
410270,202303,29,19,10,24738.19,13020,37758.19
410275,202303,65,46,19,59893.93,24738,84631.93
410280,202303,337,199,138,259110.37,179676.2,438786.57
410290,202303,278,153,125,199212,162750.5,361962.5
410300,202303,91,56,35,72912,45570,118482
410302,202303,27,14,13,18228.95,16926,35154.95
410304,202303,44,30,14,39061.73,18228,57289.73
410305,202303,217,131,86,170568.76,111973.25,282542.01
410310,202303,193,113,80,147129.84,104162.93,251292.77
410315,202303,38,31,7,40362.2,9114,49476.2
410320,202303,148,103,45,134108.17,58590,192698.17
410322,202303,40,23,17,29946.97,22134,52080.97
410330,202303,183,117,66,152336.7,85932,238268.7
410335,202303,107,58,49,75516.5,63798,139314.5
410337,202303,47,38,9,49476.5,11718,61194.5
410340,202303,37,30,7,39061.1,9114,48175.1
410345,202303,205,127,78,165356.18,101556.2,266912.38
410347,202303,42,32,10,41664.85,13020.37,54685.22
410350,202303,254,147,107,191399.42,139314,330713.42
410360,202303,475,289,186,376293.4,242174.96,618468.36
410370,202303,2456,1059,1397,1380160.97,1820214.44,3200375.41
410380,202303,207,116,91,151037.36,118483.34,269520.70
410390,202303,431,268,163,350242.96,213528.64,563771.60
410395,202303,29,20,9,26040.97,11718.31,37759.28
410400,202303,1001,415,586,540351.29,764286.63,1304637.92
410405,202303,83,61,22,79425.92,28645.39,108071.31
410410,202303,30,18,12,23439.05,15624.1,39063.15
410420,202303,1943,852,1091,1109214.62,1421805.85,2531020.47
410425,202303,215,88,127,114578.74,165354.2,279932.94
410430,202303,2589,1321,1268,1721284.8,1653561.39,3374846.19
410440,202303,367,257,110,334617.43,143222.19,477839.62
410442,202303,367,230,137,299468.14,178376.42,477844.56
410445,202303,353,245,108,318998.07,140617.28,459615.35
410450,202303,405,190,215,247385.36,279930.77,527316.13
410460,202303,599,319,280,415343.37,365864.01,781207.38
410465,202303,279,155,124,201816.1,161448.89,363264.99
410470,202303,255,147,108,191402.38,141918.32,333320.70
410480,202303,7133,3417,3716,4450391.33,4840899.26,9291290.59
410490,202303,1503,816,687,1065065.8,894484.7,1959550.5
410500,202303,285,169,116,220040.63,151033.25,371073.88
410510,202303,209,154,55,200516.12,72913,273429.12
410520,202303,287,202,85,263005.25,110670,373675.25
410530,202303,277,83,194,108066.9,252588,360654.9
410540,202303,386,279,107,363264.74,139314.61,502579.35
410550,202303,1780,751,1029,980426.36,1342373.53,2322799.89
410560,202303,186,120,66,156244.04,85932.94,242176.98
410570,202303,455,297,158,386701.44,208321.77,595023.21
410580,202303,4104,1699,2405,2213477.82,3132677.62,5346155.44
410590,202303,457,295,162,384080.42,212226.62,596307.04
410600,202303,104,89,15,115879.28,19530,135409.28
410610,202303,64,51,13,66402.84,16926,83328.84
410620,202303,290,177,113,230461.96,147127.37,377589.33
410630,202303,489,269,220,351542.92,287742.38,639285.30
410640,202303,1256,781,475,1016878.61,618453.77,1635332.38
410645,202303,116,86,30,111975.86,39060.2,151036.06
410650,202303,395,240,155,312484.96,203114.72,515599.68
410655,202303,88,66,22,85932.6,28644.08,114576.68
410657,202303,37,14,23,18228,29946,48174
410660,202303,693,470,223,611961.02,290350.32,902311.34
410670,202303,76,61,15,79424.23,19530.13,98954.36
410680,202303,198,157,41,204417.87,53382.2,257800.07
410685,202303,38,26,12,33852.49,15624,49476.49
410690,202303,31310,12688,18622,16528068.85,24272209.75,40800278.60
410700,202303,339,243,96,316671.21,124993.74,441664.95
410710,202303,130,108,22,140618.9,28644.2,169263.1
410712,202303,45,31,14,40362.65,18228,58590.65
410715,202303,109,77,32,100257.17,41664,141921.17
410720,202303,695,385,310,501280.03,403622.64,904902.67
410725,202303,202,136,66,177075.04,85932,263007.04
410730,202303,111,47,64,61195.54,84630.73,145826.27
410740,202303,79,59,20,76818.96,26040,102858.96
410750,202303,308,197,111,256499.95,144522.06,401022.01
410752,202303,22,16,6,20832.14,7812,28644.14
410753,202303,63,22,41,28644,53382,82026
410754,202303,55,28,27,36456.93,36456,72912.93
410755,202303,86,43,43,55986.2,55986,111972.2
410760,202303,810,436,374,567676.22,488252.96,1055929.18
410765,202303,2121,942,1179,1227839.16,1537700.67,2765539.83
410770,202303,125,83,42,108068.71,54685.21,162753.92
410773,202303,74,47,27,61195.91,35154,96349.91
410775,202303,218,152,66,197907.86,85932,283839.86
410780,202303,85,49,36,63798.61,46872,110670.61
410785,202303,58,50,8,65101.36,10416,75517.36
410790,202303,82,34,48,44268.2,62496,106764.2
410800,202303,296,183,113,238279.11,147127.44,385406.55
410810,202303,27,17,10,22134.82,13020.88,35155.70
410820,202303,153,107,46,140620.08,59892.9,200512.98
410830,202303,10150,4077,6073,5314923.65,7916268.05,13231191.70
410832,202303,115,73,42,95048.27,54684.05,149732.32
410840,202303,1516,816,700,1065060.3,911403.65,1976463.95
410845,202303,62,32,30,41664.3,39060,80724.3
410850,202303,155,112,43,145828.04,55986.9,201814.94
410855,202303,81,74,7,96350.74,9114,105464.74
410860,202303,924,448,476,583304.45,621059.32,1204363.77
410865,202303,95,65,30,85933.3,39060,124993.3
410870,202303,143,115,28,151034.53,36456.45,187490.98
410880,202303,1252,597,655,777313.87,855421.5,1632735.37
410890,202303,117,70,47,92444.44,61194,153638.44
410895,202303,79,61,18,79422.96,23436.95,102859.91
410900,202303,33,25,8,32550.81,10416,42966.81
410910,202303,14,9,5,11718.97,6510,18228.97
410920,202303,49,30,19,39060,24738,63798
410930,202303,575,348,227,453099.55,295555.89,748655.44
410940,202303,4792,2404,2388,3131436.96,3111828.82,6243265.78
410950,202303,98,74,24,96351.14,31248,127599.14
410960,202303,1042,384,658,501282.64,860634.87,1361917.51
410965,202303,66,45,21,58591.53,27342,85933.53
410970,202303,633,416,217,541642.73,283838.94,825481.67
410975,202303,127,76,51,98955.45,66402,165357.45
410980,202303,1693,760,933,989553.31,1216084.2,2205637.51
410990,202303,277,198,79,259099.31,102858.98,361958.29
411000,202303,66,37,29,48175.42,37759.33,85934.75
411005,202303,36,31,5,40362,6510,46872
411007,202303,284,159,125,207018.47,162750,369768.47
411010,202303,644,400,244,522114.42,317690.84,839805.26
411020,202303,288,180,108,234365.8,140618.06,374983.86
411030,202303,27,15,12,19530,15624,35154
411040,202303,71,44,27,57288.89,35154,92442.89
411050,202303,214,150,64,195301.95,83328.94,278630.89
411060,202303,573,389,184,507786.7,239569.87,747356.57
411065,202303,41,36,5,46872.54,6510,53382.54
411070,202303,1331,745,586,971312.46,762978.52,1734290.98
411080,202303,270,175,95,227850.13,123690.23,351540.36
411090,202303,87,61,26,79422.4,33852.96,113275.36
411095,202303,362,119,243,154940.26,316386.12,471326.38
411100,202303,113,87,26,113275.66,35154,148429.66
411110,202303,165,87,78,113274.88,101556.2,214831.08
411120,202303,222,144,78,187493.61,101556,289049.61
411125,202303,394,191,203,248692.03,264314.24,513006.27
411130,202303,163,138,25,179679.8,32550,212229.8
411140,202303,217,144,73,187488,95046,282534
411150,202303,1312,836,476,1088497.11,619757.79,1708254.90
411155,202303,119,80,39,105462,50778,156240
411160,202303,36,16,20,20832,26040,46872
411170,202303,60,49,11,63798,14322,78120
411180,202303,1088,709,379,923151.97,493464.58,1416616.55
411190,202303,376,210,166,273423.93,216132,489555.93
411200,202303,709,379,330,493476.35,430967.29,924443.64
411210,202303,712,362,350,471329.87,455703.29,927033.16
411220,202303,164,116,48,152337.6,62497.25,214834.85
411230,202303,35,27,8,35154.7,10416.6,45571.3
411240,202303,112,72,40,93745.53,52080,145825.53
411250,202303,439,312,127,406229.05,165354,571583.05
411260,202303,10,7,3,9114,3906,13020
411270,202303,276,142,134,187495.27,174470.46,361965.73
411275,202303,200,165,35,214833.61,45570,260403.61
411280,202303,290,192,98,249988.75,127596.7,377585.45
411290,202303,71,54,17,70308,22134,92442
411295,202303,132,98,34,127597.59,44268.88,171866.47
411300,202303,86,41,45,53382.72,58590,111972.72
411310,202303,95,69,26,89839.4,35154,124993.4
411320,202303,890,536,354,700489.74,460910.19,1161399.93
411325,202303,61,42,19,54684.1,24738,79422.1
411330,202303,1002,637,365,829402.27,475233.99,1304636.26
411340,202303,36,22,14,28644,18228.09,46872.09
411342,202303,63,48,15,62496,19530,82026
411345,202303,99,48,51,62498.15,66402.95,128901.10
411350,202303,556,413,143,537743.12,186189.38,723932.50
411360,202303,61,40,21,52083.23,27344.5,79427.73
411370,202303,14339,5842,8497,7612825.42,11081453.61,18694279.03
411373,202303,189,127,62,165354.3,80724.17,246078.47
411375,202303,88,71,17,92445.62,22134,114579.62
411380,202303,80,53,27,69010.4,35154,104164.4
411390,202303,170,91,79,118483.67,102858,221341.67
411400,202303,365,230,135,299466.72,175770,475236.72
411410,202303,567,268,299,348944.1,390602.23,739546.33
411420,202303,1009,414,595,539039.11,777299.09,1316338.20
411430,202303,598,305,293,397127.26,381494.69,778621.95
411435,202303,27,19,8,24738,10416,35154
411440,202303,515,404,111,526017.12,144522.7,670539.82
411450,202303,405,327,78,427065.99,101556.09,528622.08
411460,202303,857,323,534,420562.36,696574.94,1117137.30
411470,202303,114,80,34,104165.93,44268,148433.93
411480,202303,769,384,385,499987.29,503876.53,1003863.82
411490,202303,291,179,112,233062.84,145824.9,378887.74
411500,202303,109,86,23,111973.39,29946,141919.39
411510,202303,240,180,60,234365.15,78121.19,312486.34
411520,202303,6797,2261,4536,2947801.69,5913731.12,8861532.81
411530,202303,125,79,46,104161.05,59892,164053.05
411535,202303,49,14,35,18228.6,45570,63798.6
411540,202303,406,268,138,348941.26,179678.75,528620.01
411545,202303,56,39,17,50778.76,22134,72912.76
411550,202303,89,68,21,88537.05,27342,115879.05
411560,202303,409,168,241,218737.78,313782.15,532519.93
411570,202303,1108,357,751,464703.15,977814.83,1442517.98
411573,202303,24,15,9,19530.2,11718,31248.2
411575,202303,333,207,126,269518.16,164052,433570.16
411580,202303,1323,454,869,591118.17,1131446.28,1722564.45
411585,202303,75,36,39,46872,50778,97650
411590,202303,15,7,8,9114,10416,19530
411600,202303,16,8,8,10416.7,10416,20832.7
411605,202303,184,70,114,91141.94,148428,239569.94
411610,202303,251,152,99,197908.91,128898.2,326807.11
411620,202303,403,195,208,253901.81,270825.01,524726.82
411630,202303,51,35,16,45570.36,20832.99,66403.35
411640,202303,31,21,10,27342.5,13020,40362.5
411650,202303,6,4,2,5208.6,2604,7812.6
411660,202303,50,37,13,48174,16926,65100
411670,202303,243,166,77,216134.05,100255.69,316389.74
411680,202303,169,128,41,166657.72,53382,220039.72
411690,202303,727,378,349,493463.09,455703.23,949166.32
411695,202303,65,44,21,57288.2,27342,84630.2
411700,202303,148,114,34,148432.42,44268,192700.42
411705,202303,103,71,32,92444.21,41664.4,134108.61
411710,202303,293,194,99,252594.53,128899.07,381493.60
411720,202303,161,105,56,136710.58,72912.2,209622.78
411721,202303,97,72,25,93744.2,32550.2,126294.4
411722,202303,103,50,53,65100.7,69006,134106.7
411725,202303,169,119,50,154938.9,65100,220038.9
411727,202303,105,85,20,110674.7,26040.61,136715.31
411729,202303,55,42,13,54684,16926,71610
411730,202303,587,368,219,479144.01,285141.06,764285.07
411740,202303,25,14,11,18229.49,14322,32551.49
411745,202303,75,54,21,70308.7,27342.6,97651.3
411750,202303,894,361,533,470032.95,693970.83,1164003.78
411760,202303,1346,961,385,1251272.74,502581.43,1753854.17
411770,202303,441,279,162,363263.48,210925.96,574189.44
411780,202303,387,249,138,324199.39,179676.21,503875.60
411790,202303,625,348,277,453107.62,361956.54,815064.16
411800,202303,168,119,49,154942.9,65100.38,220043.28
411810,202303,198,150,48,195304.58,62496.79,257801.37
411820,202303,2822,1086,1736,1414829.41,2262923.28,3677752.69
411830,202303,21,14,7,18228.5,9114,27342.5
411840,202303,2357,1357,1000,1768166.49,1304631.82,3072798.31
411845,202303,71,23,48,29946.9,62496,92442.9
411850,202303,1345,717,628,933559.25,818970.83,1752530.08
411860,202303,64,39,25,50778.59,32550,83328.59
411870,202303,77,47,30,61194,39060,100254
411880,202303,432,259,173,337228.01,225248.34,562476.35
411885,202303,114,72,42,93746.18,54687.12,148433.30
411890,202303,365,253,112,329413.24,145825.88,475239.12
411900,202303,112,82,30,106764.62,39060,145824.62
411910,202303,229,151,78,196610.17,102859.54,299469.71
411915,202303,2632,1019,1613,1328082.85,2102776.95,3430859.80
411920,202303,117,82,35,106765.86,45570.98,152336.84
411925,202303,21,14,7,18228.59,9114,27342.59
411930,202303,836,558,278,726623.39,363264.34,1089887.73
411940,202303,610,378,232,492166.4,303368.6,795535.0
411950,202303,1346,600,746,782542.09,971316.78,1753858.87
411960,202303,1205,737,468,959588.66,609339.11,1568927.77
411965,202303,23,13,10,16926.27,13020,29946.27
411970,202303,93,79,14,102858.99,18228,121086.99
411980,202303,240,122,118,160146.76,153636,313782.76
411990,202303,5673,2967,2706,3865695.45,3529889.87,7395585.32
411995,202303,686,202,484,263013.26,634092.8,897106.06
412000,202303,352,237,115,308584.34,149732.78,458317.12
412010,202303,66,34,32,44268.9,41664.72,85933.62
412015,202303,35,26,9,33852,11718,45570
412020,202303,24,17,7,22135.12,9114,31249.12
412030,202303,38,33,5,42967.07,6510,49477.07
412033,202303,45,24,21,31249.42,27342,58591.42
412035,202303,66,43,23,55986.51,29946,85932.51
412040,202303,32,15,17,19530.6,22134,41664.6
412050,202303,221,162,59,210931.44,76818.56,287750.00
412060,202303,834,597,237,777321.49,308578.73,1085900.22
412065,202303,58,29,29,37760.38,37758.15,75518.53
412070,202303,143,100,43,130201.89,55986.45,186188.34
412080,202303,366,180,186,234370.17,242175.93,476546.10
412085,202303,39,14,25,18228.2,32550,50778.2
412090,202303,908,546,362,710907.44,471327.81,1182235.25
412100,202303,269,223,46,290358.72,59892,350250.72
412110,202303,75,56,19,72913.17,24738,97651.17
412120,202303,381,201,180,261705.94,234362.85,496068.79
412125,202303,71,40,31,52080.2,40362,92442.2
412130,202303,47,29,18,37760.47,23436,61196.47
412135,202303,30,19,11,24738.2,14322,39060.2
412140,202303,479,309,170,402045.73,221343.02,623388.75
412150,202303,262,155,107,203114.53,139314.73,342429.26
412160,202303,72,49,23,63799.42,29946.2,93745.62
412170,202303,718,461,257,600231.14,334617.64,934848.78
412175,202303,38,23,15,29946.69,19530.5,49477.19
412180,202303,161,117,44,152339.81,57288.48,209628.29
412190,202303,337,262,75,341130.36,97650,438780.36
412200,202303,193,114,79,148428.84,102858,251286.84
412210,202303,99,72,27,95046,35155.64,130201.64
412215,202303,246,164,82,213531.75,106765,320296.75
412217,202303,68,53,15,69007.31,19530,88537.31
412220,202303,912,581,331,756492.56,430974.81,1187467.37
412230,202303,292,172,120,223952.68,157547.36,381500.04
412240,202303,1454,715,739,931610.19,962190.24,1893800.43
412250,202303,440,267,173,347637.96,226548,574185.96
412260,202303,135,90,45,117183.58,58590.2,175773.78
412265,202303,167,129,38,167958.83,49476,217434.83
412270,202303,96,58,38,75517.5,49476,124993.5
412280,202303,84,65,19,84630.2,24738,109368.2
412290,202303,91,58,33,75516.7,42966,118482.7
412300,202303,211,150,61,195301.02,79422,274723.02
412310,202303,56,43,13,55987.48,16926,72913.48
412320,202303,93,69,24,89842.23,31248,121090.23
412330,202303,208,155,53,201811.16,69006,270817.16
412340,202303,190,119,71,154938.55,92442,247380.55
412350,202303,716,318,398,414042.43,518199.29,932241.72
412360,202303,23,18,5,23436,6510,29946
412370,202303,148,119,29,154942.56,37758,192700.56
412380,202303,190,140,50,182286.05,65100.8,247386.85
412382,202303,59,33,26,42966,33852,76818
412385,202303,164,118,46,153638.69,59892.92,213531.61
412390,202303,344,257,87,334623.48,113275.81,447899.29
412395,202303,68,55,13,71611.54,16926,88537.54
412400,202303,98,65,33,84632.46,42966,127598.46
412402,202303,247,135,112,175773.25,145824,321597.25
412405,202303,1004,336,668,437474.6,869738.25,1307212.85
412410,202303,1045,621,424,808580.13,552054.56,1360634.69
412420,202303,17,16,1,20832,1302,22134
412430,202303,26,24,2,31250.88,2604.2,33855.08
412440,202303,722,361,361,470030.17,472627.78,942657.95
412450,202303,65,58,7,75517.42,9114,84631.42
412460,202303,83,57,26,74215.01,33852.19,108067.20
412470,202303,237,186,51,242175.72,66403.33,308579.05
412480,202303,159,116,43,151035.7,55986.2,207021.9
412490,202303,179,149,30,194000.11,39060,233060.11
412500,202303,414,320,94,416651.64,122390.47,539042.11
412510,202303,174,142,32,184888.66,41664,226552.66
412520,202303,92,61,31,79424.43,40362,119786.43
412530,202303,114,52,62,67705.26,80724,148429.26
412535,202303,67,52,15,67705.56,20832,88537.56
412540,202303,53,29,24,37759.65,31248.53,69008.18
412545,202303,90,63,27,82027.7,35154,117181.7
412550,202303,4510,1816,2694,2364658.05,3511565.55,5876223.60
412555,202303,12,7,5,9114,6510,15624
412560,202303,731,467,264,608046.87,343729.68,951776.55
412570,202303,901,395,506,514310.23,658814.7,1173124.93
412575,202303,96,67,29,87235.31,37758,124993.31
412580,202303,185,123,62,160156.23,80726,240882.23
412590,202303,31,26,5,33852.73,6510,40362.73
412600,202303,215,153,62,199210.11,80724.83,279934.94
412610,202303,45,20,25,26041.57,32550,58591.57
412620,202303,128,106,22,138016.7,28644.46,166661.16
412625,202303,2271,1074,1197,1398384.73,1558507.34,2956892.07
412627,202303,65,48,17,62497.62,22134,84631.62
412630,202303,386,260,126,338532.53,164052.48,502585.01
412635,202303,79,23,56,29946,72912,102858
412640,202303,114,80,34,104160.2,44268,148428.2
412650,202303,331,215,116,279935.27,151033.83,430969.10
412660,202303,593,315,278,410135.12,363258.41,773393.53
412665,202303,40,36,4,46872.32,5208,52080.32
412667,202303,277,172,105,223948.94,136710,360658.94
412670,202303,81,61,20,79422.66,26040,105462.66
412680,202303,341,257,84,334625.09,109369.39,443994.48
412690,202303,133,85,48,110673.27,62496,173169.27
412700,202303,192,120,72,156240.74,93744.23,249984.97
412710,202303,1429,780,649,1016888.47,848916.37,1865804.84
412720,202303,252,136,116,177075.42,151032.69,328108.11
412730,202303,184,154,30,200513.46,39060.99,239574.45
412740,202303,416,202,214,263011.63,278628.41,541640.04
412750,202303,426,237,189,308581.06,246078.57,554659.63
412760,202303,386,196,190,255199,248687.05,503886.05
412770,202303,2251,1202,1049,1567638.44,1365805.79,2933444.23
412780,202303,147,102,45,132807.98,58590.42,191398.40
412785,202303,334,174,160,226550.12,208320.02,434870.14
412788,202303,55,31,24,40363.14,31248,71611.14
412790,202303,128,103,25,134111.34,32550,166661.34
412795,202303,152,102,50,132807.16,65100,197907.16
412796,202303,313,198,115,257799.43,151032.76,408832.19
412800,202303,747,416,331,541637.91,432264.81,973902.72
412810,202303,3313,1819,1494,2372322.14,1947816.34,4320138.48
412820,202303,1094,626,468,815083.8,610653.44,1425737.24
412830,202303,14,13,1,16926.2,1302,18228.2
412840,202303,254,167,87,217438.98,113274.2,330713.18
412850,202303,596,392,204,510393.94,265608.68,776002.62
412853,202303,178,80,98,104160.43,127596,231756.43
412855,202303,213,113,100,147129.02,130200.73,277329.75
412860,202303,98,67,31,87237.56,40362.73,127600.29
412862,202303,81,51,30,66402,39060,105462
412863,202303,8,5,3,6510,3906,10416
412865,202303,46,36,10,46872,13020.6,59892.6
412870,202303,120,76,44,98955.97,57289.07,156245.04
412880,202303,99,69,30,89841.31,39060,128901.31
420005,202303,45,38,7,49476.69,9114,58590.69
420010,202303,378,247,131,321601.14,171864.89,493466.03
420020,202303,101,76,25,98953.67,32550,131503.67
420030,202303,30,24,6,31248.2,7812,39060.2
420040,202303,95,74,21,96350.85,27342.2,123693.05
420050,202303,53,34,19,44268.94,24738,69006.94
420055,202303,18,16,2,20832.65,2604,23436.65
420060,202303,29,20,9,26040.26,11718.2,37758.46
420070,202303,107,92,15,119785.52,19530,139315.52
420075,202303,11,11,0,14322,,14322.0
420080,202303,40,34,6,44269.13,7812,52081.13
420090,202303,38,31,7,40362.36,9114.9,49477.26
420100,202303,168,144,24,187491.12,31248,218739.12
420110,202303,26,25,1,32550,1302,33852
420120,202303,63,45,18,58590.44,23436,82026.44
420125,202303,82,61,21,79422.6,27342,106764.6
420127,202303,39,32,7,41664,9114,50778
420130,202303,525,313,212,408847.02,277331.93,686178.95
420140,202303,1451,810,641,1057259.39,837208.74,1894468.13
420150,202303,48,34,14,44268,18228,62496
420160,202303,35,30,5,39060.93,6510,45570.93
420165,202303,19,15,4,19530.29,5208,24738.29
420170,202303,71,40,31,52080.09,40362,92442.09
420180,202303,24,21,3,27342,3906,31248
420190,202303,29,25,4,32550.18,5208,37758.18
420195,202303,135,63,72,82031.08,93747.2,175778.28
420200,202303,1461,603,858,786434.05,1117138.42,1903572.47
420205,202303,129,78,51,101559.95,66402.4,167962.35
420207,202303,162,89,73,115883.44,95047.17,210930.61
420208,202303,20,16,4,20832.21,5208,26040.21
420209,202303,13,11,2,14322,2604,16926
420210,202303,631,297,334,386707.55,434871.08,821578.63
420213,202303,54,37,17,48174.69,22134,70308.69
420215,202303,27,23,4,29946.76,5208,35154.76
420220,202303,59,38,21,49476.88,28644,78120.88
420230,202303,1074,642,432,835928.6,563777.44,1399706.04
420240,202303,2465,1616,849,2104074.91,1105407.92,3209482.83
420243,202303,45,36,9,46873.22,11718,58591.22
420245,202303,239,117,122,152339.71,158848.74,311188.45
420250,202303,65,44,21,57288.59,27342,84630.59
420253,202303,23,18,5,23437.28,6510,29947.28
420257,202303,15,10,5,13020.5,6510,19530.5
420260,202303,131,103,28,134108.92,36456.14,170565.06
420270,202303,36,26,10,33852.19,13020.48,46872.67
420280,202303,300,223,77,290361.68,100255.18,390616.86
420285,202303,24,19,5,24738,6510,31248
420287,202303,48,30,18,39060.82,23436,62496.82
420290,202303,1006,683,323,889282.16,421848.75,1311130.91
420300,202303,1695,1355,340,1765596.42,442686.7,2208283.12
420310,202303,43,31,12,40362.7,15624,55986.7
420315,202303,24,20,4,26041.46,5208.74,31250.20
420320,202303,1109,527,582,687488.08,759083.14,1446571.22
420325,202303,5,3,2,3906,2604.8,6510.8
420330,202303,121,79,42,102858.64,54684.96,157543.60
420340,202303,201,135,66,175773.56,85932,261705.56
420350,202303,271,192,79,249990.94,102858.97,352849.91
420360,202303,698,536,162,699202.2,210926.97,910129.17
420370,202303,145,79,66,102860.87,85932.43,188793.30
420380,202303,1292,864,428,1126277.74,557262.93,1683540.67
420390,202303,229,162,67,210930.45,87234.4,298164.85
420395,202303,195,141,54,183600.03,70311.04,253911.07
420400,202303,230,173,57,225249.04,74214.2,299463.24
420410,202303,57,43,14,55989.28,18228,74217.28
420415,202303,32,26,6,33853.01,7812,41665.01
420417,202303,64,51,13,66402.01,16926,83328.01
420419,202303,11,10,1,13020,1302,14322
420420,202303,3088,1905,1183,2484289.96,1542882.07,4027172.03
420425,202303,73,51,22,66406.42,28644,95050.42
420430,202303,1055,761,294,992136.63,384092.24,1376228.87
420435,202303,14,11,3,14322,3906,18228
420440,202303,89,64,25,83330.26,32550,115880.26
420445,202303,32,29,3,37758.5,3906,41664.5
420450,202303,84,49,35,63800.4,46872,110672.4
420455,202303,177,135,42,175776.85,54684,230460.85
420460,202303,2514,1551,963,2019495.52,1253840.17,3273335.69
420470,202303,86,55,31,71610.2,40362,111972.2
420475,202303,10,9,1,11718,1302,13020
420480,202303,925,703,222,915356.87,290348.51,1205705.38
420490,202303,99,73,26,95049.37,33852,128901.37
420500,202303,408,244,164,317699.24,213529.31,531228.55
420510,202303,25,21,4,27342.34,5208,32550.34
420515,202303,27,14,13,18228.58,16926,35154.58
420517,202303,11,8,3,10416.91,3906,14322.91
420519,202303,3,3,0,3906,,3906.0
420520,202303,63,46,17,59894.09,22134.2,82028.29
420530,202303,142,92,50,119786.21,65100.2,184886.41
420535,202303,16,13,3,16926.41,3906,20832.41
420540,202303,7089,4370,2719,5690297.37,3542794.93,9233092.30
420543,202303,31,29,2,37758.83,2604,40362.83
420545,202303,222,153,69,199216.39,89838.6,289054.99
420550,202303,812,684,128,890606.9,167961.66,1058568.56
420555,202303,35,26,9,33853.5,11718,45571.5
420560,202303,64,49,15,63799.34,19530,83329.34
420570,202303,237,111,126,145828.49,164054.96,309883.45
420580,202303,330,165,165,214837.14,214831.53,429668.67
420590,202303,513,318,195,414046.77,255192.62,669239.39
420600,202303,160,88,72,114577.57,93744,208321.57
420610,202303,37,34,3,44269.4,3906,48175.4
420620,202303,74,58,16,75517.92,20832.41,96350.33
420630,202303,162,109,53,141920.82,69006,210926.82
420640,202303,73,64,9,83328.6,11718,95046.6
420650,202303,343,177,166,230457.43,216133.4,446590.83
420660,202303,41,31,10,40362.45,13020,53382.45
420665,202303,46,30,16,39061.6,20832,59893.6
420670,202303,239,184,55,239578.35,71610,311188.35
420675,202303,14,12,2,15624,2604,18228
420680,202303,33,28,5,36456.12,6510,42966.12
420690,202303,200,147,53,191397.28,69006.63,260403.91
420700,202303,745,480,265,624983.98,345035,970018.98
420710,202303,148,81,67,105463.99,87235.7,192699.69
420720,202303,97,79,18,102862.14,23436.08,126298.22
420730,202303,755,445,310,579409.76,403628.11,983037.87
420740,202303,61,59,2,76820.03,2604,79424.03
420750,202303,512,332,180,432268.31,234361.76,666630.07
420757,202303,18,15,3,19530,3906,23436
420760,202303,40,28,12,36456.86,15624,52080.86
420765,202303,75,52,23,67704.61,29946,97650.61
420768,202303,60,47,13,61196.91,16926,78122.91
420770,202303,71,61,10,79424.22,13020,92444.22
420775,202303,39,33,6,42966.95,7812,50778.95
420780,202303,204,156,48,203115.49,62496,265611.49
420785,202303,28,18,10,23436,13020,36456
420790,202303,135,111,24,144524.18,31248.09,175772.27
420800,202303,62,48,14,62496.62,18228,80724.62
420810,202303,292,222,70,289058.46,91140,380198.46
420820,202303,2788,1544,1244,2011671.12,1630133.26,3641804.38
420830,202303,755,403,352,524733.28,458318.98,983052.26
420840,202303,133,90,43,117180.95,55986,173166.95
420845,202303,466,202,264,263012.55,343731.95,606744.50
420850,202303,286,220,66,286442.03,85932.3,372374.33
420860,202303,57,49,8,63799.52,10416,74215.52
420870,202303,130,91,39,118482.94,50778,169260.94
420880,202303,197,123,74,160150.12,96348.2,256498.32
420890,202303,1061,516,545,673149.43,709592,1382741.43
420895,202303,9,9,0,11718,,11718.0
420900,202303,422,338,84,440086.05,109368.78,549454.83
420910,202303,6301,3433,2868,4471229.46,3739400.29,8210629.75
420915,202303,58,54,4,70308.2,5208,75516.2
420917,202303,22,17,5,22134.54,6510,28644.54
420920,202303,22,15,7,19530,9114,28644
420930,202303,3698,2480,1218,3232954.28,1587178.73,4820133.01
420940,202303,597,412,185,536456.19,240878.31,777334.50
420945,202303,10,8,2,10416,2604,13020
420950,202303,47,34,13,44268.5,16926,61194.5
420960,202303,114,92,22,119790,28644.1,148434.1
420970,202303,283,227,56,295567.93,72913.09,368481.02
420980,202303,23,22,1,28644,1302,29946
420985,202303,51,44,7,57289.25,9114,66403.25
420990,202303,93,69,24,89838.99,31249.77,121088.76
421000,202303,63,33,30,42966,39060,82026
421003,202303,32,22,10,28644.03,13020,41664.03
421005,202303,8,6,2,7812.8,2604,10416.8
421010,202303,913,582,331,759098.89,430968.52,1190067.41
421020,202303,18,17,1,22136.25,2604,24740.25
421030,202303,119,99,20,128899.85,26041.5,154941.35
421040,202303,66,48,18,62498.14,23437.81,85935.95
421050,202303,328,228,100,298159.68,130200,428359.68
421055,202303,15,12,3,15624.2,3906,19530.2
421060,202303,109,61,48,79422.73,63798,143220.73
421070,202303,36,32,4,41666.18,5208,46874.18
421080,202303,47,39,8,50778.29,10416,61194.29
421085,202303,18,14,4,18228,5208,23436
421090,202303,38,29,9,37758.11,11718,49476.11
421100,202303,116,88,28,114579.53,36456.95,151036.48
421105,202303,199,158,41,205722.83,53382.2,259105.03
421110,202303,132,89,43,115883.55,55986.8,171870.35
421120,202303,196,139,57,180983.48,74214.32,255197.80
421125,202303,17,10,7,13020,9114.02,22134.02
421130,202303,899,542,357,705704.23,464820.18,1170524.41
421140,202303,34,25,9,32550.9,11718,44268.9
421145,202303,43,38,5,49476.01,6510,55986.01
421150,202303,84,65,19,84632.39,24738,109370.39
421160,202303,62,40,22,52080.5,28644.6,80725.1
421165,202303,14,12,2,15624,2604,18228
421170,202303,169,142,27,185049.28,35154.61,220203.89
421175,202303,196,138,58,179681.33,75516.75,255198.08
421180,202303,38,26,12,33852.42,15624,49476.42
421185,202303,15,12,3,15624.18,3906,19530.18
421187,202303,3,2,1,2604,1302,3906
421189,202303,47,33,14,42967.08,18228,61195.08
421190,202303,2168,1363,805,1776012.09,1049438.41,2825450.50
421200,202303,98,68,30,88537.99,39060,127597.99
421205,202303,24,17,7,22136.15,9114,31250.15
421210,202303,178,130,48,169262.37,62496,231758.37
421220,202303,255,198,57,257799.34,74215.6,332014.94
421223,202303,49,38,11,49477.17,14322,63799.17
421225,202303,75,51,24,66403.53,31249.64,97653.17
421227,202303,64,55,9,71611.69,11718,83329.69
421230,202303,77,51,26,66403.56,33852.18,100255.74
421240,202303,14,13,1,16927.05,1302,18229.05
421250,202303,434,232,202,302071.93,263010.1,565082.03
421260,202303,22,17,5,22134.59,6510,28644.59
421265,202303,11,7,4,9115.62,5208.1,14323.72
421270,202303,55,49,6,63798,7812,71610
421280,202303,418,212,206,276031.69,269515.82,545547.51
421290,202303,314,205,109,266912.58,141919.03,408831.61
421300,202303,24,20,4,26040,5208,31248
421310,202303,51,36,15,46872,19530,66402
421315,202303,34,21,13,27343.03,16926.08,44269.11
421320,202303,141,94,47,122390.31,61194,183584.31
421330,202303,110,83,27,108067.9,36456.37,144524.27
421335,202303,45,32,13,41665.85,16926,58591.85
421340,202303,250,168,82,218739.89,106764.41,325504.30
421350,202303,189,112,77,145828.03,100254.25,246082.28
421360,202303,769,529,240,688775.08,313787.28,1002562.36
421370,202303,205,153,52,199208.13,67705.12,266913.25
421380,202303,153,116,37,151033.47,48174,199207.47
421390,202303,15,10,5,13020,6510,19530
421400,202303,120,98,22,128898,28644,157542
421410,202303,20,17,3,22134,3906,26040
421415,202303,20,18,2,23436,2604,26040
421420,202303,100,84,16,109369.54,20832,130201.54
421430,202303,21,13,8,16926,10416,27342
421440,202303,62,52,10,67706.17,13020.98,80727.15
421450,202303,76,62,14,80724.5,18228,98952.5
421460,202303,54,43,11,55986.66,14322,70308.66
421470,202303,77,41,36,53383.03,46872,100255.03
421480,202303,821,609,212,792934.58,276027.19,1068961.77
421490,202303,23,22,1,28644.78,1302,29946.78
421500,202303,497,287,210,373695.52,273420.83,647116.35
421505,202303,43,36,7,46872.1,9114.2,55986.3
421507,202303,30,24,6,31248.6,7812,39060.6
421510,202303,68,42,26,55987.56,35154.61,91142.17
421520,202303,49,41,8,53382.98,10416,63798.98
421530,202303,51,43,8,55987.28,10416,66403.28
421535,202303,23,21,2,27343.29,2604,29947.29
421540,202303,49,40,9,52080.2,11718,63798.2
421545,202303,84,55,29,71614.73,37758.56,109373.29
421550,202303,301,216,85,281247.8,110671.86,391919.66
421555,202303,15,13,2,16928.06,2604,19532.06
421560,202303,8,7,1,9114,1302,10416
421565,202303,134,85,49,110673.02,63798.57,174471.59
421567,202303,38,28,10,36456,13020,49476
421568,202303,40,38,2,50778,2604,53382
421569,202303,10,10,0,13020.79,,13020.79
421570,202303,269,177,92,230458.95,119785.03,350243.98
421575,202303,27,24,3,31248.68,3906,35154.68
421580,202303,777,460,317,599019.48,412737.65,1011757.13
421590,202303,21,19,2,24738.2,2604,27342.2
421600,202303,186,132,54,171865.61,70308,242173.61
421605,202303,109,74,35,96350.71,45570.2,141920.91
421610,202303,172,126,46,164052.99,59892,223944.99
421620,202303,1116,639,477,833318.72,621066.77,1454385.49
421625,202303,24,21,3,27342.26,3906,31248.26
421630,202303,380,229,151,299469.37,196606.29,496075.66
421635,202303,28,14,14,18228,18228,36456
421640,202303,108,83,25,108071.49,32550,140621.49
421650,202303,338,194,144,252596.01,187491.03,440087.04
421660,202303,2816,1715,1101,2234317.58,1434835.01,3669152.59
421670,202303,162,116,46,151034.57,59892,210926.57
421680,202303,200,180,20,234366.06,26040,260406.06
421690,202303,357,241,116,313790.36,151033.71,464824.07
421700,202303,61,41,20,53382.7,26040.2,79422.9
421710,202303,21,21,0,27342.59,,27342.59
421715,202303,5,4,1,5209.09,1302,6511.09
421720,202303,671,447,224,582008.92,291652.42,873661.34
421725,202303,32,13,19,16926.91,24738.8,41665.71
421730,202303,23,18,5,23436,6510,29946
421740,202303,114,44,70,57288.76,92442,149730.76
421750,202303,193,141,52,183583.26,67704,251287.26
421755,202303,19,17,2,22134,2604,24738
421760,202303,104,71,33,92445.46,42966.19,135411.65
421770,202303,731,463,268,602848.35,350242.27,953090.62
421775,202303,29,19,10,24738.97,13020.09,37759.06
421780,202303,191,147,44,191394.4,57288,248682.4
421790,202303,154,129,25,167961.06,32550.15,200511.21
421795,202303,16,13,3,16926.33,3906,20832.33
421800,202303,605,361,244,470048.54,317695.54,787744.08
421810,202303,71,59,12,76819.18,15624,92443.18
421820,202303,316,194,122,253895.21,160146,414041.21
421825,202303,164,138,26,179682.94,33852,213534.94
421830,202303,158,98,60,127604.02,79422.54,207026.56
421835,202303,6,2,4,2604,5208,7812
421840,202303,42,34,8,44268.9,10416.71,54685.61
421850,202303,79,66,13,85933.2,16926,102859.2
421860,202303,37,27,10,35154.26,13020,48174.26
421870,202303,1224,870,354,1132785.77,460922.79,1593708.56
421875,202303,51,39,12,50778,15624,66402
421880,202303,197,139,58,180981.33,75516.7,256498.03
421885,202303,20,15,5,19530,6510.84,26040.84
421890,202303,172,125,47,162754.62,61195.64,223950.26
421895,202303,51,44,7,57289.85,9114,66403.85
421900,202303,133,103,30,134114.87,39060,173174.87
421910,202303,65,41,24,53382.74,31248,84630.74
421915,202303,32,25,7,32550,9114,41664
421917,202303,53,42,11,54686.45,14322,69008.45
421920,202303,37,33,4,42966,5208,48174
421930,202303,657,520,137,677058.69,179680.02,856738.71
421935,202303,47,40,7,52080.39,9114,61194.39
421940,202303,51,44,7,57288.4,9114,66402.4
421950,202303,953,631,322,821576.13,420549.05,1242125.18
421960,202303,42,35,7,45570.59,9114,54684.59
421970,202303,335,211,124,274727.47,161449.39,436176.86
421985,202303,19,11,8,14322.2,10416,24738.2
422000,202303,10,4,6,5208.7,7812.13,13020.83
430003,202303,194,60,134,78120.6,174468,252588.6
430005,202303,31,24,7,31248.72,9114,40362.72
430010,202303,259,190,69,247383.26,89838,337221.26
430020,202303,141,100,41,130203.19,53382.24,183585.43
430030,202303,128,102,26,132805.73,33852,166657.73
430040,202303,3055,1789,1266,2333229.45,1650052.9,3983282.35
430045,202303,73,64,9,83328,11718,95046
430047,202303,8,6,2,7812,2604,10416
430050,202303,89,75,14,97651.28,18228,115879.28
430055,202303,14,12,2,15624,2604,18228
430057,202303,5,3,2,3906,2604,6510
430060,202303,4429,2538,1891,3313733.35,2466017.69,5779751.04
430063,202303,57,46,11,59892,14322,74214
430064,202303,173,138,35,179676.24,45570,225246.24
430066,202303,7,4,3,5208,3906,9114
430070,202303,42,32,10,41664.14,13020,54684.14
430080,202303,87,57,30,74215.53,40362.18,114577.71
430085,202303,28,13,15,16926,19530,36456
430087,202303,34,26,8,33852.38,10416,44268.38
430090,202303,67,57,10,74214.76,13020,87234.76
430100,202303,154,103,51,134106.64,66402,200508.64
430105,202303,177,98,79,127603.66,102858.3,230461.96
430107,202303,21,16,5,20832.87,6510,27342.87
430110,202303,501,269,232,350240.22,302064,652304.22
430120,202303,174,158,16,205716.1,20832,226548.1
430130,202303,841,498,343,648403.77,446588.45,1094992.22
430140,202303,140,129,11,169260.6,14322,183582.6
430150,202303,114,70,44,91140.96,57288,148428.96
430155,202303,31,25,6,32550,7812,40362
430160,202303,3924,2184,1740,2843642.15,2272007.27,5115649.42
430163,202303,451,215,236,279939.78,307276.99,587216.77
430165,202303,31,19,12,24738.59,15624,40362.59
430170,202303,86,70,16,91140,20832,111972
430175,202303,84,65,19,84630,24738.47,109368.47
430180,202303,109,84,25,109369.1,32550,141919.1
430185,202303,28,19,9,24738,11718,36456
430187,202303,96,37,59,48176.8,76818,124994.8
430190,202303,239,120,119,156244.98,154940.29,311185.27
430192,202303,13,10,3,13020.56,3906,16926.56
430195,202303,17,13,4,16926.29,5208,22134.29
430200,202303,161,134,27,174472.17,35154,209626.17
430205,202303,19,19,0,24738,,24738.0
430210,202303,791,580,211,755175.38,274722.7,1029898.08
430215,202303,11,10,1,13020,1302,14322
430220,202303,78,53,25,69006,32550,101556
430222,202303,15,5,10,6510,13020,19530
430223,202303,18,12,6,15624,7812,23436
430225,202303,5,3,2,3906,2604,6510
430230,202303,368,226,142,294253.7,184884,479137.7
430235,202303,56,36,20,46872.11,26040,72912.11
430237,202303,19,14,5,18228,6510,24738
430240,202303,121,81,40,105463.11,52080,157543.11
430245,202303,67,54,13,70308,16926,87234
430250,202303,189,110,79,143221.67,102858.84,246080.51
430258,202303,13,10,3,13020.78,3906.8,16927.58
430260,202303,38,33,5,42966.1,6510,49476.1
430265,202303,37,33,4,42966,5208,48174
430270,202303,542,377,165,492172.08,214830,707002.08
430280,202303,1123,650,473,846308.4,618450.3,1464758.7
430290,202303,461,240,221,312485.73,287742,600227.73
430300,202303,2281,1238,1043,1613230.55,1360609.49,2973840.04
430310,202303,2340,1143,1197,1488256.85,1558527.54,3046784.39
430320,202303,63,51,12,66402,15624,82026
430330,202303,86,73,13,95047.15,16926,111973.15
430340,202303,74,58,16,75516,20832,96348
430350,202303,1769,1110,659,1445236.85,859321.55,2304558.40
430355,202303,19,17,2,22134,2604,24738
430360,202303,103,50,53,66402,69006,135408
430367,202303,52,37,15,48174,19530,67704
430370,202303,63,55,8,71610,10416,82026
430380,202303,110,79,31,102859.34,40362,143221.34
430390,202303,729,435,294,566305.35,384095.64,950400.99
430400,202303,259,176,83,229153.51,108066,337219.51
430410,202303,53,44,9,57288.2,11718,69006.2
430420,202303,548,350,198,457013.19,257797.49,714810.68
430430,202303,49,46,3,59024.86,3906,62930.86
430435,202303,153,112,41,145824.83,53382,199206.83
430440,202303,627,379,248,494770.98,322898.17,817669.15
430450,202303,1275,1035,240,1348892.7,312482.34,1661375.04
430460,202303,6358,3215,3143,4187384.57,4098756.72,8286141.29
430461,202303,17,15,2,19530,2604,22134
430462,202303,4,2,2,2604.1,2604,5208.1
430463,202303,1303,703,600,916635.09,781207.05,1697842.14
430465,202303,27,16,11,20832,14322,35154
430466,202303,774,543,231,707015.87,303372.32,1010388.19
430467,202303,132,74,58,96348.5,75516,171864.5
430468,202303,161,89,72,115878.9,93744.97,209623.87
430469,202303,22,14,8,18228,10416,28644
430470,202303,1225,658,567,857116.75,740841.93,1597958.68
430471,202303,80,55,25,71611.15,32550.57,104161.72
430480,202303,146,102,44,132806.62,57288,190094.62
430485,202303,8,8,0,10416.6,,10416.6
430490,202303,71,55,16,71610,20832,92442
430495,202303,32,23,9,29946.2,11718,41664.2
430500,202303,199,132,67,171865,87234,259099
430510,202303,4137,2646,1491,3447765.15,1941293.32,5389058.47
430511,202303,14,14,0,18228,,18228.0
430512,202303,179,122,57,158846.9,74214.4,233061.3
430513,202303,54,41,13,53382,16926,70308
430515,202303,23,21,2,27342,2604,29946
430517,202303,183,153,30,199206.2,39060,238266.2
430520,202303,346,239,107,311182.31,139314.88,450497.19
430530,202303,81,43,38,55986.7,49476,105462.7
430535,202303,485,312,173,406230.43,225251.25,631481.68
430537,202303,8,8,0,10416,,10416.0
430540,202303,81,53,28,69006.97,36456,105462.97
430543,202303,450,147,303,191394.24,394506.71,585900.95
430544,202303,54,50,4,65101.41,5208,70309.41
430545,202303,467,226,241,294270.33,313790.4,608060.73
430550,202303,46,37,9,48174.14,11718,59892.14
430558,202303,1,1,0,1302,,1302.0
430560,202303,53,29,24,37758,31248,69006
430570,202303,121,49,72,63800.57,95046,158846.57
430580,202303,125,99,26,128898.96,33852,162750.96
430583,202303,13,13,0,16926,,16926.0
430585,202303,14,11,3,14322,3906,18228
430587,202303,16,10,6,13020,7812.85,20832.85
430590,202303,194,156,38,204415.73,49476.49,253892.22
430593,202303,1,1,0,1302,,1302.0
430595,202303,17,13,4,16926,5208,22134
430597,202303,42,24,18,31248.38,23436,54684.38
430600,202303,228,168,60,218736,78120,296856
430605,202303,187,112,75,145824,97650,243474
430607,202303,32,25,7,32550,9114,41664
430610,202303,1867,885,982,1152291,1278569.58,2430860.58
430613,202303,5,5,0,6510,,6510.0
430620,202303,98,67,31,87234.34,40362,127596.34
430630,202303,49,42,7,54685.54,9114,63799.54
430632,202303,31,27,4,35154,5208,40362
430635,202303,35,28,7,36456,9114,45570
430637,202303,63,29,34,37758,44268,82026
430640,202303,179,98,81,127600.73,105462.54,233063.27
430642,202303,19,17,2,22134,2604,24738
430645,202303,33,27,6,35154,7812,42966
430650,202303,244,195,49,255195.09,63798.2,318993.29
430655,202303,9,8,1,10416,1302,11718
430660,202303,1050,516,534,671847.92,696578.92,1368426.84
430670,202303,70,47,23,61194,29946,91140
430673,202303,82,55,27,71610,35154,106764
430675,202303,8,6,2,7812,2604,10416
430676,202303,682,411,271,535135.6,354146.31,889281.91
430680,202303,258,170,88,221343.01,114576,335919.01
430690,202303,578,350,228,455708.72,296857.27,752565.99
430692,202303,8,6,2,7812.7,2604,10416.7
430693,202303,141,90,51,117180.8,66402.2,183583.0
430695,202303,67,53,14,69006.1,18228,87234.1
430697,202303,68,43,25,55986,32550,88536
430700,202303,1422,959,463,1248637.05,602826.31,1851463.36
430705,202303,30,26,4,33852.7,5208,39060.7
430710,202303,277,172,105,225246,136710,361956
430720,202303,102,85,17,110670.96,22134,132804.96
430730,202303,151,128,23,166656,29946,196602
430740,202303,84,50,34,65100.4,44268,109368.4
430745,202303,26,16,10,20832,13020,33852
430750,202303,326,211,115,274723.76,149730.79,424454.55
430755,202303,84,47,37,61194.58,48174,109368.58
430760,202303,454,244,210,318995.99,273422.37,592418.36
430770,202303,1773,961,812,1252566.21,1058535.32,2311101.53
430780,202303,368,223,145,290346.68,188790,479136.68
430781,202303,24,24,0,31248,,31248.0
430783,202303,64,47,17,61194,22134,83328
430786,202303,7,5,2,6510,2604,9114
430790,202303,559,347,212,451800.62,276026.52,727827.14
430800,202303,168,125,43,162750,55986,218736
430805,202303,37,31,6,40362,7812,48174
430807,202303,78,45,33,58590,42966,101556
430810,202303,81,53,28,69007.33,36456.03,105463.36
430820,202303,159,102,57,132806.23,75516,208322.23
430825,202303,11,9,2,11718,2604,14322
430830,202303,271,251,20,326804.81,26040,352844.81
430840,202303,145,96,49,124992.3,63798,188790.3
430843,202303,7,4,3,5208,3906,9114
430845,202303,85,50,35,65100,45570,110670
430850,202303,607,429,178,558561.25,233058,791619.25
430860,202303,177,120,57,156242.07,74215.37,230457.44
430865,202303,78,43,35,55986,45570,101556
430870,202303,72,59,13,76818.99,16926,93744.99
430880,202303,183,126,57,164055.38,74214.8,238270.18
430885,202303,11,9,2,11718,2604,14322
430890,202303,343,207,136,269515.88,177072,446587.88
430900,202303,559,382,177,497370.69,230454.58,727825.27
430905,202303,148,65,83,84630.77,108067.85,192698.62
430910,202303,308,165,143,214831.71,187488.8,402320.51
430912,202303,5,5,0,6510.32,,6510.32
430915,202303,44,41,3,53382,3906,57288
430920,202303,5130,2661,2469,3468687.35,3217301.37,6685988.72
430925,202303,7,6,1,7812,1302,9114
430930,202303,2282,1273,1009,1660089.39,1315029.2,2975118.59
430940,202303,275,175,100,227850.67,130201.1,358051.77
430950,202303,160,127,33,165356.89,42966,208322.89
430955,202303,27,16,11,20832.7,14322,35154.7
430957,202303,26,23,3,29946.68,3906,33852.68
430960,202303,273,177,96,230456.18,124993.06,355449.24
430965,202303,107,70,37,91140.59,48174,139314.59
430970,202303,93,73,20,95046,26040,121086
430975,202303,52,45,7,58590.2,9114,67704.2
430980,202303,53,31,22,40362.26,28644,69006.26
430990,202303,99,78,21,101556,27342,128898
430995,202303,111,103,8,134106,10416,144522
431000,202303,301,149,152,193999.2,197904,391903.2
431010,202303,376,221,155,287755.72,201813.03,489568.75
431020,202303,2012,1146,866,1493417.16,1128836.14,2622253.30
431030,202303,40,31,9,40362,11718,52080
431033,202303,517,231,286,300780.93,372386.97,673167.90
431036,202303,12,8,4,10416,5208,15624
431040,202303,150,101,49,131502.84,63798.45,195301.29
431041,202303,46,28,18,36456,23436,59892
431043,202303,38,22,16,28644.42,20832,49476.42
431046,202303,12,9,3,11718,3906,15624
431050,202303,213,132,81,171865.62,105462,277327.62
431053,202303,75,41,34,53382.83,44269.51,97652.34
431055,202303,65,43,22,55986,28644,84630
431057,202303,18,18,0,23436,,23436.0
431060,202303,1650,1051,599,1369719.44,781201.85,2150921.29
431065,202303,18,8,10,10416,13020,23436
431070,202303,65,57,8,75516.27,10416,85932.27
431075,202303,8,8,0,10416,,10416.0
431080,202303,134,72,62,93744.54,80724,174468.54
431085,202303,37,32,5,41664.02,6510,48174.02
431087,202303,17,13,4,16926,6510,23436
431090,202303,49,39,10,50778.7,13020,63798.7
431100,202303,1332,789,543,1027297,706990.27,1734287.27
431110,202303,233,141,92,183586.29,119784,303370.29
431112,202303,28,22,6,28644.33,7812,36456.33
431113,202303,31,20,11,26040.23,14322,40362.23
431115,202303,155,110,45,143220.66,58590,201810.66
431120,202303,611,357,254,464823.23,330708,795531.23
431123,202303,5,5,0,6510,,6510.0
431125,202303,98,85,13,110670,16926,127596
431127,202303,5,3,2,3906,2604,6510
431130,202303,744,473,271,615855.81,352845.03,968700.84
431140,202303,868,608,260,791625.62,338520.3,1130145.92
431142,202303,16,15,1,19530.69,1302,20832.69
431150,202303,204,146,58,190094.5,75516,265610.5
431160,202303,40,36,4,46872.7,5208,52080.7
431162,202303,7,6,1,7812.89,1302,9114.89
431164,202303,7,6,1,7812,1302,9114
431170,202303,121,85,36,110670.2,46872,157542.2
431171,202303,80,46,34,59892,44268,104160
431173,202303,6,5,1,6510,1302.8,7812.8
431175,202303,207,109,98,141919.88,127596.88,269516.76
431177,202303,108,74,34,97651.11,44268.31,141919.42
431179,202303,15,10,5,13020,6510,19530
431180,202303,421,261,160,341127.32,208321.13,549448.45
431190,202303,75,56,19,72912.6,24738.7,97651.3
431198,202303,76,52,24,67569.46,32550,100119.46
431200,202303,22,18,4,23436,5208,28644
431205,202303,23,21,2,27342.7,2604,29946.7
431210,202303,109,66,43,85932.7,55986,141918.7
431213,202303,32,26,6,33852,7812.56,41664.56
431215,202303,23,22,1,28644,1302,29946
431217,202303,5,4,1,5208,1302,6510
431220,202303,70,59,11,76818.7,14322,91140.7
431225,202303,172,105,67,136710.5,88536,225246.5
431230,202303,103,85,18,110673.42,23436,134109.42
431235,202303,5,4,1,5208,1302,6510
431237,202303,16,11,5,14322.58,6510,20832.58
431238,202303,16,11,5,14322,6510.2,20832.2
431240,202303,1032,631,401,822892.39,523406.16,1346298.55
431242,202303,42,41,1,53382,1302,54684
431244,202303,38,30,8,39061.52,10416,49477.52
431245,202303,50,38,12,49476.13,16926,66402.13
431247,202303,14,10,4,13020,5208,18228
431250,202303,314,150,164,195302.26,213528,408830.26
431260,202303,55,46,9,59892,11718,71610
431261,202303,23,16,7,20832.15,9114,29946.15
431262,202303,14,12,2,15624,2604,18228
431265,202303,154,86,68,111972.57,89838,201810.57
431267,202303,18,15,3,19530,3906,23436
431270,202303,342,261,81,339827.95,105462.5,445290.45
431275,202303,40,36,4,46872,5208,52080
431280,202303,21,16,5,20832,6510,27342
431290,202303,27,24,3,31248.65,3906,35154.65
431295,202303,4,1,3,1302,3906,5208
431300,202303,24,21,3,27342.6,3906,31248.6
431301,202303,7,7,0,9114,,9114.0
431303,202303,58,37,21,48174,27342,75516
431306,202303,250,126,124,164053.33,161448,325501.33
431308,202303,9,8,1,10416.6,1302,11718.6
431310,202303,63,49,14,63798.16,18228,82026.16
431320,202303,233,145,88,188791.12,114576,303367.12
431330,202303,227,151,76,196604.35,98952,295556.35
431333,202303,25,21,4,27342,5208,32550
431335,202303,9,6,3,7812.34,3906,11718.34
431337,202303,462,226,236,294262.66,307275.5,601538.16
431339,202303,25,18,7,23436,9114,32550
431340,202303,3337,1775,1562,2312307.27,2035036.78,4347344.05
431342,202303,37,25,12,32550,15624,48174
431344,202303,24,23,1,29946,1302,31248
431346,202303,5,4,1,5208,1302,6510
431349,202303,29,27,2,35154,2604,37758
431350,202303,988,552,436,721339.3,568980.32,1290319.62
431360,202303,58,42,16,54684,20832,75516
431365,202303,391,167,224,217437.83,292950.49,510388.32
431370,202303,1269,707,562,920536.38,733030.58,1653566.96
431380,202303,102,89,13,115880.23,16926,132806.23
431390,202303,512,281,231,365866.12,302064.8,667930.92
431395,202303,339,146,193,191395.37,251286,442681.37
431400,202303,38,24,14,31248,18228,49476
431402,202303,104,76,28,98952.9,36456.68,135409.58
431403,202303,30,20,10,26040.09,13020,39060.09
431405,202303,767,440,327,572901.11,427066.41,999967.52
431406,202303,38,29,9,37758.14,11718,49476.14
431407,202303,49,37,12,48174,15624,63798
431410,202303,3729,2279,1450,2969947.74,1890529.07,4860476.81
431413,202303,16,13,3,16926,3906,20832
431415,202303,78,57,21,74215.38,27342,101557.38
431417,202303,22,11,11,14322,14322,28644
431420,202303,390,258,132,335920.72,171864.8,507785.52
431430,202303,70,32,38,41664.87,49476,91140.87
431440,202303,9811,6585,3226,8574006.71,4201665.03,12775671.74
431442,202303,28,15,13,19530,16926,36456
431445,202303,29,28,1,36456,1302,37758
431446,202303,5,5,0,6510,,6510.0
431447,202303,86,65,21,84630.9,27342,111972.9
431449,202303,64,50,14,65100.99,18228,83328.99
431450,202303,440,291,149,378883.67,193998,572881.67
431454,202303,11,6,5,7812,6510,14322
431455,202303,49,38,11,49476.03,14322,63798.03
431460,202303,520,352,168,458311.83,220038,678349.83
431470,202303,142,105,37,136710.25,48174,184884.25
431475,202303,10,8,2,10416,2604,13020
431477,202303,41,24,17,31248,22134,53382
431478,202303,7,7,0,9114,,9114.0
431480,202303,780,472,308,614561.08,401017.89,1015578.97
431490,202303,32529,18132,14397,23628087.98,18775097.03,42403185.01
431500,202303,76,58,18,75516,23436,98952
431505,202303,29,20,9,26040.85,11718,37758.85
431507,202303,9,8,1,10416,1302,11718
431510,202303,241,171,70,222643.56,91140,313783.56
431513,202303,19,18,1,23437.5,1302,24739.5
431514,202303,7,5,2,6510,2604,9114
431515,202303,83,71,12,92442.65,15624,108066.65
431517,202303,6,4,2,5208,2604,7812
431520,202303,41,33,8,42966.2,10416,53382.2
431530,202303,1460,628,832,817667.32,1084567.13,1902234.45
431531,202303,23,21,2,27342.7,2604,29946.7
431532,202303,38,27,11,35154,14322,49476
431535,202303,29,16,13,20832,16926,37758
431540,202303,142,113,29,147128.67,37758.6,184887.27
431545,202303,14,11,3,14322,3906,18228
431550,202303,369,190,179,247383.72,233058.88,480442.60
431555,202303,16,14,2,18228.88,2604,20832.88
431560,202303,5203,3437,1766,4482974.32,2301990.95,6784965.27
431570,202303,913,484,429,630184.04,558564.13,1188748.17
431575,202303,60,35,25,45570,32550.58,78120.58
431580,202303,82,59,23,76818,29946,106764
431590,202303,148,124,24,161448,31248,192696
431595,202303,18,15,3,19530,3906,23436
431600,202303,262,149,113,194004.2,147127.33,341131.53
431610,202303,120,87,33,113275.8,42966.2,156242.0
431620,202303,36,29,7,37758,9114,46872
431630,202303,126,101,25,131502.79,32550,164052.79
431640,202303,1351,832,519,1083281.33,678343.51,1761624.84
431642,202303,33,29,4,37758,5208,42966
431643,202303,44,17,27,22134,35154,57288
431645,202303,347,203,144,264308.55,187488,451796.55
431647,202303,13,12,1,15624,1302,16926
431650,202303,37,21,16,27342,20832,48174
431660,202303,268,170,98,222642.73,127596,350238.73
431670,202303,233,101,132,131503.99,171864.11,303368.10
431673,202303,14,11,3,14322,3906,18228
431675,202303,28,21,7,27342,9114,36456
431680,202303,1241,886,355,1156222.1,463517.18,1619739.28
431690,202303,5345,3104,2241,4044140.5,2921739.94,6965880.44
431695,202303,19,12,7,15624,9114,24738
431697,202303,4,2,2,2604,2604,5208
431700,202303,199,148,51,193998.91,66402,260400.91
431710,202303,4369,1844,2525,2403534.11,3290170.85,5693704.96
431720,202303,1314,808,506,1053982,658813.07,1712795.07
431725,202303,3,1,2,1302,2604,3906
431730,202303,1262,827,435,1076809.34,566381.84,1643191.18
431740,202303,1380,675,705,878862.39,917915.88,1796778.27
431750,202303,1890,1232,658,1604094.12,858024.09,2462118.21
431755,202303,5,4,1,5208,1302,6510
431760,202303,1036,655,381,852835.01,496070.15,1348905.16
431770,202303,423,283,140,368467.22,182280,550747.22
431775,202303,26,19,7,24738,9114,33852
431780,202303,598,359,239,467420.62,311178,778598.62
431790,202303,148,113,35,147127.6,45570.1,192697.7
431795,202303,13,11,2,14322,2604,16926
431800,202303,3222,1681,1541,2190009.4,2007695.54,4197704.94
431805,202303,19,15,4,19530,5208,24738
431810,202303,591,381,210,496070.79,273420.64,769491.43
431820,202303,363,205,158,266911.79,205716,472627.79
431830,202303,2444,1474,970,1920409.13,1265548.01,3185957.14
431840,202303,522,329,193,429673.37,252589.15,682262.52
431842,202303,34,28,6,36456,7812,44268
431843,202303,8,6,2,7812.72,2604,10416.72
431844,202303,15,11,4,14322,5208,19530
431845,202303,26,24,2,31248,2604,33852
431846,202303,27,23,4,29946.72,5208,35154.72
431848,202303,13,10,3,13020.6,3906,16926.6
431849,202303,6,5,1,6510,1302,7812
431850,202303,841,658,183,856742.08,238268,1095010.08
431860,202303,116,75,41,97650.74,53382,151032.74
431861,202303,3,0,3,,3906,3906.0
431862,202303,67,48,19,62496.65,24738,87234.65
431870,202303,4104,2358,1746,3070238.28,2277229.43,5347467.71
431880,202303,1034,718,316,934850.1,411433.69,1346283.79
431890,202303,1279,732,547,953078.49,713497.08,1666575.57
431900,202303,199,130,69,169260.06,89838,259098.06
431910,202303,47,36,11,46872.1,14322,61194.1
431912,202303,52,35,17,45571.71,22134,67705.71
431915,202303,159,120,39,156240.57,50778,207018.57
431920,202303,160,113,47,147126.35,61194,208320.35
431930,202303,77,61,16,79422,20832,100254
431935,202303,5,3,2,3906,2604,6510
431936,202303,2,2,0,2604,,2604.0
431937,202303,22,17,5,22134.2,6510,28644.2
431940,202303,480,330,150,430968.88,195300.49,626269.37
431950,202303,512,322,190,419261.99,247381,666642.99
431960,202303,768,417,351,542945.63,457003.61,999949.24
431970,202303,64,58,6,75516.53,7812,83328.53
431971,202303,4,3,1,3906,1302,5208
431973,202303,19,16,3,20832.7,3906,24738.7
431975,202303,10,10,0,13020.2,,13020.2
431980,202303,215,121,94,157543.75,122388.6,279932.35
431990,202303,1019,550,469,717425.89,610650.92,1328076.81
432000,202303,2083,1106,977,1443990,1273375.61,2717365.61
432010,202303,262,171,91,222643.58,118482.2,341125.78
432020,202303,196,167,29,217436.95,37758.4,255195.35
432023,202303,16,14,2,18228,2604,20832
432026,202303,60,52,8,67704.1,10416,78120.1
432030,202303,55,23,32,29946.17,41664,71610.17
432032,202303,15,12,3,15624,3906,19530
432035,202303,75,55,20,71610.4,26040,97650.4
432040,202303,87,60,27,78121.39,35154,113275.39
432045,202303,3,3,0,3906,,3906.0
432050,202303,85,53,32,69006.19,41664,110670.19
432055,202303,135,92,43,119785.9,55986,175771.9
432057,202303,7,4,3,5209.3,3906,9115.3
432060,202303,31,26,5,33852,6510,40362
432065,202303,33,29,4,37758,5208,42966
432067,202303,85,78,7,101556.21,9114,110670.21
432070,202303,394,311,83,404928.53,108066,512994.53
432080,202303,875,621,254,808580.19,332012.25,1140592.44
432085,202303,23,19,4,24738,5208,29946
432090,202303,287,188,99,244776.2,130200.33,374976.53
432100,202303,174,108,66,140616.21,87234,227850.21
432110,202303,586,386,200,502579.86,260400.04,762979.90
432120,202303,1101,620,481,807259.69,626267.5,1433527.19
432130,202303,547,386,161,502575.41,209622,712197.41
432132,202303,21,19,2,24738,2604,27342
432135,202303,84,65,19,84631.1,24738,109369.1
432140,202303,278,211,67,274724.57,87234,361958.57
432143,202303,238,145,93,188794.19,121086.24,309880.43
432145,202303,312,219,93,285143.15,121086,406229.15
432146,202303,17,15,2,19530,2604,22134
432147,202303,102,62,40,80724,52080,132804
432149,202303,16,11,5,14322,6510,20832
432150,202303,1153,720,433,938768.51,566374.29,1505142.80
432160,202303,2136,1081,1055,1407497.69,1377533.29,2785030.98
432162,202303,6,3,3,3906,3906,7812
432163,202303,15,10,5,13020,6510,19530
432166,202303,133,92,41,120112.15,53383.73,173495.88
432170,202303,246,132,114,171870.52,148428.9,320299.42
432180,202303,588,376,212,489553.04,276024,765577.04
432183,202303,13,12,1,15624.43,1302,16926.43
432185,202303,82,67,15,87234.92,19530.86,106765.78
432190,202303,553,326,227,424453.08,295554.8,720007.88
432195,202303,92,73,19,95046.7,24738,119784.7
432200,202303,460,277,183,360660.03,238267.9,598927.93
432210,202303,122,72,50,93744.1,65100,158844.1
432215,202303,31,29,2,37758,2604,40362
432218,202303,20,20,0,26040,,26040.0
432220,202303,677,336,341,437479.91,443985.73,881465.64
432225,202303,19,14,5,18228.2,6510,24738.2
432230,202303,130,83,47,108066,61195.01,169261.01
432232,202303,29,26,3,33852,3906,37758
432234,202303,5,3,2,3906,2604,6510
432235,202303,1,1,0,1302,,1302.0
432237,202303,23,16,7,20832,9114,29946
432240,202303,4788,2662,2126,3468636.32,2772003.19,6240639.51
432250,202303,1209,805,404,1048121.76,526010.15,1574131.91
432252,202303,50,47,3,61194,3906,65100
432253,202303,73,55,18,71612.99,23436,95048.99
432254,202303,31,15,16,19530,20832,40362
432255,202303,11,10,1,13020,1302,14322
432260,202303,924,742,182,966100.75,236964.1,1203064.85
432270,202303,227,168,59,218749.45,76819.9,295569.35
432280,202303,171,128,43,166660.24,55986,222646.24
432285,202303,1,1,0,1302,,1302.0
432290,202303,60,49,11,63798,14322,78120
432300,202303,5513,2937,2576,3825302.6,3361794.06,7187096.66
432310,202303,132,110,22,143220.35,28644,171864.35
432320,202303,20,15,5,19530,6510,26040
432330,202303,20,13,7,16926,9114,26040
432335,202303,10,8,2,10416,2604,13020
432340,202303,35,27,8,35154,10416,45570
432345,202303,129,84,45,109370.71,58590.65,167961.36
432350,202303,26,25,1,32550,1302,33852
432360,202303,5,4,1,5208.7,1302,6510.7
432370,202303,27,27,0,35154.38,,35154.38
432375,202303,27,25,2,32550,2604,35154
432377,202303,7,7,0,9114.48,,9114.48
432380,202303,226,105,121,136712.12,157544.76,294256.88
500020,202303,306,160,146,208322.72,191394.8,399717.52
500025,202303,149,70,79,91142.68,102859.12,194001.80
500060,202303,1556,986,570,1285114.72,742150.2,2027264.92
500070,202303,798,390,408,507795.36,531226.56,1039021.92
500080,202303,148,116,32,151035.65,41664,192699.65
500085,202303,143,105,38,136711.87,49476,186187.87
500090,202303,404,189,215,246084.75,281234.01,527318.76
500100,202303,708,368,340,479151.69,442684.9,921836.59
500110,202303,2418,1166,1252,1518195.2,1631434.16,3149629.36
500124,202303,272,144,128,187488.7,166657.18,354145.88
500150,202303,340,141,199,183586.33,259099.79,442686.12
500190,202303,600,400,200,522122.56,260402.36,782524.92
500200,202303,217,175,42,227854.33,54684,282538.33
500210,202303,1796,561,1235,731738.23,1610589.99,2342328.22
500215,202303,208,120,88,156248.5,114576.2,270824.7
500220,202303,745,465,280,605454.48,364563.62,970018.10
500230,202303,255,146,109,190095.43,141918.58,332014.01
500240,202303,686,427,259,558574.78,337222.4,895797.18
500260,202303,622,253,369,330714.48,480438.46,811152.94
500270,202303,32842,14292,18550,18621314.35,24166853.7,42788168.05
500280,202303,207,72,135,93745.42,175770.66,269516.08
500290,202303,1234,766,468,997363.46,609340.42,1606703.88
500295,202303,518,341,177,445293.24,230455.09,675748.33
500310,202303,119,39,80,50778.1,104161.52,154939.62
500315,202303,884,478,406,622356.44,529916.16,1152272.60
500320,202303,3931,1840,2091,2397080.62,2725106.96,5122187.58
500325,202303,1003,567,436,739570.69,567679.48,1307250.17
500330,202303,1612,785,827,1022032.18,1078073.87,2100106.05
500345,202303,323,225,98,292956.9,127596.21,420553.11
500348,202303,255,155,100,203115.73,130200,333315.73
500350,202303,104,49,55,63799.99,71611.14,135411.13
500370,202303,6140,2780,3360,3619936.96,4376068.42,7996005.38
500375,202303,378,249,129,324201.4,167958.73,492160.13
500380,202303,695,386,309,502588.33,402319.89,904908.22
500390,202303,78,33,45,42966.1,58591.2,101557.3
500400,202303,231,141,90,183587.33,117180.97,300768.30
500410,202303,473,208,265,270828.17,345034.54,615862.71
500430,202303,632,390,242,507795.14,315085.39,822880.53
500440,202303,212,120,92,156240.94,119784.2,276025.14
500450,202303,455,192,263,249988.13,342427.5,592415.63
500460,202303,284,153,131,199209.79,170562.96,369772.75
500470,202303,449,321,128,419254.7,167959.91,587214.61
500480,202303,107,60,47,78120.65,61195.48,139316.13
500490,202303,92,38,54,49476.68,71612.99,121089.67
500500,202303,1558,573,985,746068.96,1285081.82,2031150.78
500510,202303,37,31,6,40362.51,7812,48174.51
500515,202303,121,80,41,105465.37,53382.72,158848.09
500520,202303,294,147,147,191400.09,192696.16,384096.25
500525,202303,98,51,47,66402.14,62496,128898.14
500540,202303,958,411,547,535142.17,713504.03,1248646.20
500560,202303,905,510,395,664035.45,514294.57,1178330.02
500568,202303,1156,543,613,707002.53,798133.47,1505136.00
500570,202303,1269,718,551,936161.83,717408.37,1653570.20
500580,202303,316,174,142,226555.68,184885.24,411440.92
500600,202303,418,200,218,260406.3,283837.76,544244.06
500620,202303,1056,726,330,946584.38,430970.58,1377554.96
500625,202303,88,67,21,87235.31,27342,114577.31
500627,202303,42,18,24,23436.15,31248,54684.15
500630,202303,1659,945,714,1229881.98,930939.06,2160821.04
500635,202303,525,305,220,397112.35,286440,683552.35
500640,202303,366,199,167,259108.79,217437.12,476545.91
500660,202303,6380,2261,4119,2945200.37,5364284.74,8309485.11
500690,202303,664,238,426,309882.82,554652.26,864535.08
500710,202303,429,209,220,272125.19,286444.44,558569.63
500720,202303,1000,541,459,704404.32,597622.43,1302026.75
500730,202303,149,88,61,114584.11,80724,195308.11
500740,202303,1028,439,589,571595.99,768187.58,1339783.57
500750,202303,205,74,131,96350.81,170564.47,266915.28
500755,202303,112,84,28,109373.28,36456.93,145830.21
500769,202303,800,444,356,580706.34,464818.8,1045525.14
500770,202303,446,236,210,307273.98,273420,580693.98
500780,202303,140,94,46,122395.01,59893.33,182288.34
500790,202303,1145,554,591,721335.18,769485.85,1490821.03
500793,202303,314,161,153,209760.18,200511.52,410271.70
500795,202303,202,129,73,167960.74,95046.99,263007.73
500797,202303,48,33,15,42967.12,19530,62497.12
500800,202303,450,199,251,259105.66,326803.8,585909.46
500830,202303,2508,1304,1204,1699177.9,1567616.45,3266794.35
500840,202303,114,79,35,102863.61,45570.02,148433.63
510010,202303,172,93,79,121086,102858,223944
510020,202303,579,277,302,360668.7,393208.93,753877.63
510025,202303,1836,1044,792,1359331.82,1035103.25,2394435.07
510030,202303,675,360,315,468737.78,410137.01,878874.79
510035,202303,137,71,66,92442.17,85932,178374.17
510040,202303,421,195,226,253892.91,294253.74,548146.65
510050,202303,389,203,186,264313.8,242175.12,506488.92
510060,202303,138,58,80,75519.09,104160,179679.09
510080,202303,261,111,150,144524.21,195300,339824.21
510100,202303,66,28,38,36456.05,49476.43,85932.48
510120,202303,32,19,13,24738.99,16926.74,41665.73
510125,202303,402,257,145,334616.2,188790.21,523406.41
510130,202303,558,332,226,432276.07,294254,726530.07
510140,202303,465,154,311,200508.78,404924.52,605433.30
510160,202303,109,44,65,57289.99,84631.19,141921.18
510170,202303,811,477,334,621071.35,436178.29,1057249.64
510180,202303,3143,1416,1727,1844989.72,2249886.31,4094876.03
510185,202303,33,17,16,22134.7,20832,42966.7
510190,202303,262,88,174,115880.42,226550.29,342430.71
510250,202303,2859,1732,1127,2256421.5,1467363.02,3723784.52
510260,202303,173,122,51,158845.91,66403.48,225249.39
510263,202303,502,284,218,369777.21,285143.49,654920.70
510267,202303,637,357,280,464834.27,364563.19,829397.46
510268,202303,77,35,42,45570.01,54684,100254.01
510269,202303,82,37,45,48174,58591.4,106765.4
510270,202303,399,189,210,246080.29,276024.7,522104.99
510279,202303,211,157,54,204416.98,70308,274724.98
510285,202303,185,74,111,96349.1,144522.3,240871.4
510300,202303,551,285,266,371074.77,346334.13,717408.90
510305,202303,202,90,112,117180.2,145824.11,263004.31
510310,202303,108,57,51,74214.98,66402.1,140617.08
510320,202303,847,529,318,688770.88,414039.38,1102810.26
510325,202303,474,202,272,263006.85,354146.17,617153.02
510330,202303,474,266,208,346341.99,272120.08,618462.07
510335,202303,700,410,290,533838.68,377583.63,911422.31
510336,202303,52,35,17,45571.67,22134.7,67706.37
510337,202303,103,42,61,54684,79422,134106
510340,202303,19653,8356,11297,10889100.75,14724617.38,25613718.13
510343,202303,59,45,14,58590,18228,76818
510345,202303,154,94,60,122390.32,79423.28,201813.60
510350,202303,669,351,318,457013.83,415344.46,872358.29
510360,202303,228,142,86,186190.2,111972,298162.2
510370,202303,174,73,101,95046,131502.7,226548.7
510380,202303,81,60,21,78120,28644,106764
510385,202303,59,31,28,40362.2,36456,76818.2
510390,202303,99,46,53,59892.84,69006.4,128899.24
510395,202303,59,42,17,54684,22134,76818
510410,202303,831,526,305,684877.05,397116.64,1081993.69
510420,202303,576,279,297,363261.48,386694.7,749956.18
510450,202303,52,29,23,37758,29946,67704
510452,202303,62,29,33,37758,42966,80724
510454,202303,59,26,33,33852,42966.03,76818.03
510455,202303,123,71,52,92442,67704.97,160146.97
510460,202303,199,85,114,110672.42,148428,259100.42
510480,202303,789,457,332,595034.89,432272.82,1027307.71
510490,202303,344,166,178,216135.1,231756.5,447891.6
510500,202303,245,183,62,238267.28,80724,318991.28
510510,202303,899,526,373,684870.13,485651.34,1170521.47
510515,202303,1349,692,657,901005.92,856722.49,1757728.41
510517,202303,291,131,160,170565.39,208320,378885.39
510520,202303,236,146,90,190097.15,117181.11,307278.26
510523,202303,117,92,25,119784,32550,152334
510525,202303,938,580,358,755179.29,466119.52,1221298.81
510530,202303,27,15,12,19530,15624,35154
510550,202303,252,116,136,151034.59,177073.56,328108.15
510558,202303,326,162,164,211173.75,213528,424701.75
510560,202303,399,233,166,304674.45,216133.76,520808.21
510562,202303,691,488,203,636092.88,264307.62,900400.50
510590,202303,728,355,373,462221.63,485649.19,947870.82
510600,202303,223,117,106,152338.75,138012.76,290351.51
510610,202303,228,102,126,132808.05,164052.95,296861.00
510615,202303,238,113,125,147127,162750.91,309877.91
510617,202303,26,11,15,14322,19530,33852
510618,202303,131,64,67,83328.14,87235.64,170563.78
510619,202303,82,58,24,75517.5,31248,106765.5
510620,202303,168,89,79,115878.7,102858,218736.7
510621,202303,183,118,65,153636.67,84630.23,238266.90
510622,202303,522,278,244,361970.4,318994.54,680964.94
510623,202303,298,203,95,264310.24,123690.2,388000.44
510624,202303,94,45,49,58590.97,63798.83,122389.80
510625,202303,550,342,208,445298.81,270821.39,716120.20
510626,202303,119,65,54,84632.67,70308,154940.67
510627,202303,99,67,32,87235.45,41664.2,128899.65
510628,202303,173,104,69,135408.92,89838,225246.92
510629,202303,301,181,120,236966.57,156263.43,393230.00
510630,202303,468,239,229,311191.36,299461.72,610653.08
510631,202303,22,9,13,11718.13,16926,28644.13
510637,202303,367,215,152,279932.24,197904,477836.24
510642,202303,1232,658,574,858038.15,747353.84,1605391.99
510645,202303,13,3,10,3906,13020,16926
510650,202303,1295,838,457,1091125.67,597622.12,1688747.79
510665,202303,99,45,54,58591.57,71610.08,130201.65
510670,202303,59,34,25,44268.83,32550,76818.83
510675,202303,1150,734,416,958305.93,541635.88,1499941.81
510677,202303,355,184,171,239571.24,222642.83,462214.07
510680,202303,89,54,35,70309.77,45570,115879.77
510682,202303,196,92,104,119784.52,135408,255192.52
510685,202303,57,41,16,53383.74,20832.8,74216.54
510700,202303,605,344,261,447904.77,339825.3,787730.07
510704,202303,1332,673,659,877591.83,861941.39,1739533.22
510706,202303,163,81,82,105465.85,106765.96,212231.81
510710,202303,445,316,129,411439.93,167958.6,579398.53
510715,202303,57,39,18,50778,23436.06,74214.06
510718,202303,262,116,146,151034.25,190096.44,341130.69
510719,202303,52,23,29,29946,37758,67704
510720,202303,187,129,58,167959.76,75516,243475.76
510724,202303,83,31,52,40362,67704,108066
510726,202303,68,33,35,42966.7,45570.62,88537.32
510729,202303,16,7,9,9114,11718.3,20832.3
510730,202303,470,252,218,329408.24,283836,613244.24
510735,202303,120,44,76,58590.21,98952,157542.21
510740,202303,25,14,11,18229.35,14322.84,32552.19
510757,202303,26,21,5,27342.73,6510.16,33852.89
510760,202303,8092,4082,4010,5317518.89,5228887.15,10546406.04
510770,202303,749,340,409,442689.91,532521.94,975211.85
510774,202303,19,7,12,9114.69,15624,24738.69
510775,202303,123,94,29,122388,37758,160146
510776,202303,35,12,23,15624,29946.2,45570.2
510777,202303,188,84,104,109368.77,135408,244776.77
510779,202303,41,24,17,31248,22134,53382
510780,202303,280,144,136,187496.97,177072.2,364569.17
510785,202303,348,187,161,243479.57,209622.52,453102.09
510787,202303,216,106,110,138016.81,143221.63,281238.44
510788,202303,8,4,4,5208.9,5208,10416.9
510790,202303,2836,1462,1374,1903640.69,1790259.78,3693900.47
510792,202303,1170,659,511,858052.16,667938.77,1525990.93
510794,202303,119,65,54,84631.06,70308,154939.06
510795,202303,2431,1377,1054,1795499.71,1372317.49,3167817.20
510800,202303,198,109,89,141919.81,115878.14,257797.95
510805,202303,221,146,75,190093.1,97650,287743.1
510810,202303,110,42,68,54685.61,88536.42,143222.03
510820,202303,262,134,128,174470.14,166659.83,341129.97
510830,202303,80,39,41,50778,53382,104160
510835,202303,24,17,7,22134.7,9114,31248.7
510840,202303,9957,4486,5471,5843644.59,7131154.73,12974799.32
510850,202303,217,86,131,111973.7,170562.26,282535.96
510860,202303,420,210,210,273423.56,274723.51,548147.07
510880,202303,79,56,23,72912.2,29946,102858.2
510885,202303,72,42,30,54685.48,39060.11,93745.59
510890,202303,79,39,40,50778.16,52080.11,102858.27
510895,202303,186,109,77,141918.44,100254,242172.44
520005,202303,158,62,96,80727.19,124993.46,205720.65
520010,202303,330,143,187,186190.12,243478.81,429668.93
520013,202303,777,533,244,693985.91,318993.43,1012979.34
520015,202303,39,26,13,33852,16926,50778
520017,202303,86,54,32,70308.84,41664,111972.84
520020,202303,11,5,6,6510,7812,14322
520025,202303,3139,1672,1467,2179668.1,1910102.57,4089770.67
520030,202303,899,465,434,605446.5,565072.79,1170519.29
520050,202303,62,46,16,59892.2,20832.87,80725.07
520055,202303,79,52,27,67704,35154.2,102858.2
520060,202303,183,122,61,158847.83,79423.25,238271.08
520080,202303,585,422,163,549446.33,212226,761672.33
520082,202303,16,12,4,15624,5208,20832
520085,202303,108,83,25,108066.94,32550.7,140617.64
520090,202303,84,60,24,78120.75,31248,109368.75
520110,202303,9899,4194,5705,5463362.18,7431899.45,12895261.63
520120,202303,13,7,6,9114,7812,16926
520130,202303,882,607,275,790325.43,358052.02,1148377.45
520140,202303,12854,6954,5900,9055787.64,7685808.9,16741596.54
520145,202303,60,32,28,41664.2,36456,78120.2
520150,202303,137,108,29,140622.47,37758,178380.47
520160,202303,41,25,16,32550,20832,53382
520170,202303,219,126,93,164060.55,121089.23,285149.78
520180,202303,200,93,107,121086.98,140617.56,261704.54
520215,202303,194,138,56,179677.14,72912.2,252589.34
520235,202303,88,67,21,87234,27342,114576
520250,202303,157,83,74,108067.87,96348,204415.87
520260,202303,116,70,46,91144.16,59893.42,151037.58
520280,202303,46,33,13,42966,16926,59892
520310,202303,29,15,14,19531.8,18228.9,37760.7
520320,202303,188,112,76,145826.71,98952.97,244779.68
520330,202303,889,490,399,639300.36,519503.6,1158803.96
520340,202303,301,173,128,225254.84,166658.46,391913.30
520350,202303,503,255,248,333317.98,322898.2,656216.18
520355,202303,106,62,44,80726.36,57288,138014.36
520357,202303,34,27,7,35154,9114,44268
520360,202303,16,5,11,6510.2,14322.28,20832.48
520380,202303,145,80,65,104160,84630,188790
520390,202303,238,105,133,136714.52,173166,309880.52
520393,202303,18,14,4,18228.1,5208,23436.1
520396,202303,76,56,20,72912,26040,98952
520400,202303,214,131,83,170569.42,108069.3,278638.72
520410,202303,197,98,99,127600.53,128898,256498.53
520420,202303,19,15,4,19530.94,5208,24738.94
520425,202303,259,127,132,166659.05,171864.98,338524.03
520430,202303,559,267,292,348937.68,380184.5,729122.18
520440,202303,677,484,193,630184.08,251287.33,881471.41
520450,202303,2315,980,1335,1276000.94,1739493.61,3015494.55
520455,202303,62,36,26,46874.63,33852.51,80727.14
520460,202303,46,28,18,36456.69,23438.15,59894.84
520465,202303,37,30,7,39060,9114,48174
520470,202303,466,287,179,373678.39,233058.2,606736.59
520480,202303,79,49,30,63798.94,40362,104160.94
520485,202303,113,42,71,54685.52,92442.1,147127.62
520490,202303,534,389,145,506489.05,188793.98,695283.03
520495,202303,167,100,67,130200.18,88536,218736.18
520500,202303,262,212,50,276025.98,65100,341125.98
520505,202303,193,112,81,145824,105462,251286
520510,202303,2133,1002,1131,1305936,1472573.77,2778509.77
520520,202303,65,42,23,54684.97,29946,84630.97
520530,202303,216,171,45,222648.44,58590,281238.44
520540,202303,788,535,253,696582.92,329409.95,1025992.87
520545,202303,153,88,65,114581.14,84630.6,199211.74
520547,202303,77,43,34,55989.72,44268.11,100257.83
520549,202303,1597,757,840,985661.63,1093699.21,2079360.84
520551,202303,316,168,148,218743.2,192697.78,411440.98
520552,202303,43,30,13,39061,16926,55987
520570,202303,15,11,4,14322,5208,19530
520580,202303,291,180,111,234498.58,144522.99,379021.57
520590,202303,156,87,69,113275.81,89838,203113.81
520620,202303,1294,597,697,777307.35,907502.99,1684810.34
520630,202303,52,29,23,37758.6,29946.18,67704.78
520640,202303,399,228,171,298163.96,223944.9,522108.86
520650,202303,68,33,35,42966,45570,88536
520660,202303,43,23,20,29946.94,26040.38,55987.32
520670,202303,47,35,12,45570.27,15624,61194.27
520680,202303,27,16,11,20832,14322,35154
520690,202303,38,10,28,13020,36456,49476
520710,202303,37,29,8,37758,10416,48174
520725,202303,197,146,51,190094.79,66402,256496.79
520735,202303,58,37,21,48175.19,27342.2,75517.39
520740,202303,493,241,252,313786.27,328105.22,641891.49
520750,202303,40,24,16,31248,20832,52080
520753,202303,80,58,22,75516.76,28644,104160.76
520760,202303,105,73,32,95047.3,41664,136711.3
520780,202303,271,213,58,277329.74,75517.97,352847.71
520790,202303,148,88,60,114576.66,78120,192696.66
520800,202303,3588,2012,1576,2621022.66,2051982.34,4673005.00
520810,202303,139,106,33,138448.69,42966.89,181415.58
520815,202303,7,5,2,6510.96,2604,9114.96
520830,202303,134,92,42,119787.63,54684.05,174471.68
520840,202303,413,268,145,348937.57,188790,537727.57
520850,202303,115,66,49,85934.19,63798,149732.19
520860,202303,1907,1198,709,1561139.06,923125.31,2484264.37
520870,202303,35374,15910,19464,20726064.65,25368516.85,46094581.50
520880,202303,1352,708,644,921865.83,839808.34,1761674.17
520890,202303,870,550,320,716906.37,416641.57,1133547.94
520910,202303,1018,536,482,697898.24,627566.54,1325464.78
520915,202303,98,67,31,87236.29,40362.6,127598.89
520920,202303,509,237,272,308585.74,355454.19,664039.93
520929,202303,17,14,3,18228.84,3906,22134.84
520940,202303,63,46,17,59893.42,22134.1,82027.52
520945,202303,17,10,7,13020,9114,22134
520960,202303,49,29,20,37758,26040,63798
520970,202303,429,245,184,318997.54,239573.16,558570.70
520980,202303,87,63,24,82026,31248,113274
520990,202303,440,310,130,403622.74,169260.13,572882.87
520993,202303,125,63,62,82030.15,82028.29,164058.44
520995,202303,269,146,123,190095.16,160146,350241.16
521000,202303,1678,916,762,1192658.39,992134.88,2184793.27
521010,202303,655,348,307,453105.09,401018.88,854123.97
521015,202303,12,7,5,9114,6510,15624
521020,202303,1483,1041,442,1356721.52,578097.61,1934819.13
521030,202303,77,52,25,67704.93,32550,100254.93
521040,202303,1021,678,343,882782.97,446587,1329369.97
521056,202303,59,39,20,50778,26040,76818
521060,202303,126,80,46,104160.74,59892.76,164053.50
521080,202303,329,258,71,335935.74,92442.4,428378.14
521090,202303,602,404,198,526015.89,257796.89,783812.78
521100,202303,278,191,87,248689.09,113274.4,361963.49
521120,202303,1116,790,326,1028655.42,424456.67,1453112.09
521130,202303,327,232,95,302072.15,123690.6,425762.75
521140,202303,192,107,85,139319.35,111972.69,251292.04
521150,202303,2676,1129,1547,1471321.38,2014224.24,3485545.62
521160,202303,27,10,17,13020.42,22134,35154.42
521170,202303,234,123,111,160147.39,144522.2,304669.59
521180,202303,1244,781,463,1016894.7,602834.86,1619729.56
521190,202303,2706,1123,1583,1464792.28,2061083.63,3525875.91
521200,202303,61,41,20,53382.2,26040,79422.2
521205,202303,14,11,3,14322.2,3906,18228.2
521210,202303,137,84,53,109370.17,69006,178376.17
521220,202303,778,531,247,691375.05,321596.41,1012971.46
521225,202303,19,12,7,15625.97,10416.21,26042.18
521230,202303,109,72,37,93746.24,48175.63,141921.87
521250,202303,6740,3682,3058,4795490.6,3986786.58,8782277.18
521260,202303,43,19,24,24738,31248,55986
521270,202303,127,95,32,123691.33,41664,165355.33
521280,202303,433,273,160,355448.47,208320,563768.47
521290,202303,32,17,15,22134.85,19530,41664.85
521295,202303,105,70,35,91140.84,45570,136710.84
521300,202303,246,137,109,178376.39,141918.84,320295.23
521305,202303,43,31,12,40363.4,15624,55987.4
521308,202303,1035,793,242,1032524.5,316391.38,1348915.88
521310,202303,1464,807,657,1050753.09,855428.16,1906181.25
521340,202303,20,16,4,20832,5208,26040
521350,202303,101,75,26,97652,33852,131504
521370,202303,172,112,60,147126.7,78120,225246.7
521375,202303,204,96,108,124995.07,140617.64,265612.71
521377,202303,50,38,12,49476.25,15624.1,65100.35
521380,202303,1133,670,463,874984.27,602832.78,1477817.05
521385,202303,12,7,5,9114,6510,15624
521390,202303,105,83,22,108068.61,28644.49,136713.10
521400,202303,401,285,116,372039.58,151033.28,523072.86
521405,202303,159,99,60,128901.38,79422.66,208324.04
521410,202303,85,62,23,80725.27,29946,110671.27
521440,202303,221,152,69,197911.61,89838.74,287750.35
521450,202303,821,448,373,583309.42,485650.53,1068959.95
521460,202303,1139,781,358,1016903.91,468726.73,1485630.64
521470,202303,13,9,4,11718,5208,16926
521480,202303,40,26,14,33853.51,18228.1,52081.61
521483,202303,339,219,120,287746.25,156241.47,443987.72
521486,202303,304,202,102,263004.5,132804.84,395809.34
521487,202303,23,11,12,14322,15624,29946
521490,202303,26,15,11,19530,14322,33852
521500,202303,153,68,85,88536.71,110670.19,199206.90
521520,202303,45,33,12,42966,15624,58590
521523,202303,1191,644,547,838508.65,712199.04,1550707.69
521525,202303,63,44,19,57288,24738,82026
521530,202303,246,142,104,186186.64,135409.16,321595.80
521540,202303,45,22,23,28644,29946,58590
521550,202303,123,56,67,72913.03,87235.89,160148.92
521560,202303,934,621,313,808564.71,407529.36,1216094.07
521565,202303,74,52,22,67705.4,28644.7,96350.1
521570,202303,592,369,223,480449,290347.07,770796.07
521580,202303,47,29,18,37758,23436,61194
521590,202303,41,21,20,27342,26040,53382
521600,202303,26,12,14,15624,18228,33852
521630,202303,222,116,106,151038.87,139320.86,290359.73
521640,202303,330,175,155,227854.15,201811.63,429665.78
521645,202303,39,20,19,26040,24738,50778
521680,202303,261,159,102,207021.41,132805.27,339826.68
521690,202303,17,15,2,19530,2604,22134
521710,202303,1157,547,610,712205.81,796831.72,1509037.53
521720,202303,622,409,213,532524.3,277326.16,809850.46
521730,202303,734,346,388,450498.11,505178.73,955676.84
521740,202303,946,433,513,563772.8,669234.32,1233007.12
521760,202303,2527,1290,1237,1681058.79,1610619.18,3291677.97
521770,202303,879,530,349,690070.48,454401.23,1144471.71
521800,202303,2066,1396,670,1817637.96,872342.12,2689980.08
521805,202303,35,21,14,27342,18228,45570
521810,202303,96,54,42,70308.94,54684.19,124993.13
521830,202303,1047,764,283,994757.88,369776.11,1364533.99
521839,202303,72,41,31,53382,40362.13,93744.13
521850,202303,1215,606,609,789037.38,794232.47,1583269.85
521860,202303,340,212,128,276029.4,166656,442685.4
521870,202303,87,55,32,71610,41664,113274
521878,202303,35,14,21,18228,27342.81,45570.81
521880,202303,5312,2308,3004,3005119.89,3912548.76,6917668.65
521890,202303,661,449,212,584610.5,276027.09,860637.59
521900,202303,285,222,63,289045.19,82026.8,371071.99
521910,202303,184,128,56,166663.48,72914.39,239577.87
521920,202303,37,22,15,28644,19530,48174
521925,202303,54,30,24,39060,31248,70308
521930,202303,1312,724,588,942688.72,766891.81,1709580.53
521935,202303,34,24,10,31249.79,13020,44269.79
521940,202303,247,109,138,141919.97,179676.76,321596.73
521945,202303,20,13,7,16926,9114,26040
521950,202303,23,14,9,18228,11718,29946
521960,202303,68,53,15,69006,19530,88536
521970,202303,412,270,142,351543.4,184884.89,536428.29
521971,202303,111,58,53,75516.2,69006,144522.2
521973,202303,39,17,22,22134.6,28644,50778.6
521975,202303,1726,907,819,1180957.45,1066357.24,2247314.69
521980,202303,240,165,75,214831.99,97650,312481.99
521990,202303,87,59,28,76819.45,36456,113275.45
522000,202303,292,195,97,254745.7,126294.79,381040.49
522005,202303,19,11,8,14322,10416,24738
522010,202303,1198,668,530,872371.59,692675.82,1565047.41
522015,202303,58,36,22,46872,28644,75516
522020,202303,912,546,366,710903.34,476538.7,1187442.04
522026,202303,28,19,9,24738,11718,36456
522028,202303,22,19,3,24738,3906,28644
522040,202303,871,381,490,496077.84,639290.59,1135368.43
522045,202303,2920,1712,1208,2230421.1,1575435.46,3805856.56
522050,202303,164,71,93,92446.17,121087.32,213533.49
522060,202303,555,345,210,449199.81,274722.81,723922.62
522068,202303,113,80,33,104160.89,42966,147126.89
522070,202303,19,16,3,20832,3906,24738
522100,202303,36,23,13,29946,16926,46872
522108,202303,41,32,9,41666.05,11718,53384.05
522119,202303,65,38,27,49477.4,35154,84631.4
522130,202303,82,30,52,39060.74,67704.65,106765.39
522140,202303,4518,2365,2153,3079340.17,2804532.94,5883873.11
522145,202303,50,35,15,45570.2,19530,65100.2
522150,202303,113,74,39,96348.31,50778.84,147127.15
522155,202303,55,36,19,46872.9,24738,71610.9
522157,202303,16,9,7,11718,9114,20832
522160,202303,1723,1023,700,1333283.05,911408.76,2244691.81
522170,202303,362,240,122,312484.54,158844.8,471329.34
522180,202303,31,12,19,15624,24738,40362
522185,202303,2705,1171,1534,1524714.41,2001225.47,3525939.88
522190,202303,76,44,32,57288.98,41664,98952.98
522200,202303,338,195,143,253892.69,186186.24,440078.93
522205,202303,141,98,43,127600.02,55986.1,183586.12
522220,202303,141,109,32,141918.2,41664,183582.2
522230,202303,29,26,3,33852.41,3906,37758.41
530010,202303,59852,30287,29565,39461151.8,38521825.4,77982977.2
110001,202304,536,437,99,568981.67,128898.47,697880.14
110002,202304,3053,1943,1110,2531153.5,1446534.19,3977687.69
110003,202304,81,63,18,82027.96,23436,105463.96
110004,202304,2221,1522,699,1984290,911407.45,2895697.45
110005,202304,463,357,106,466122.52,138012.2,604134.72
110006,202304,455,337,118,438779.3,153636.29,592415.59
110007,202304,81,64,17,83328,22134,105462
110008,202304,278,159,119,207019.61,154938.6,361958.21
110009,202304,984,757,227,985622.39,295554.91,1281177.30
110010,202304,1748,977,771,1272080.03,1003843.91,2275923.94
110011,202304,1765,1365,400,1777281,522110.8,2299391.8
110012,202304,4290,2457,1833,3202985.09,2387890.19,5590875.28
110013,202304,761,603,158,785131.41,205718.97,990850.38
110014,202304,363,322,41,419252.41,53382,472634.41
110015,202304,1412,1076,336,1400972.09,437475.79,1838447.88
110018,202304,1059,670,389,872362.27,506478.62,1378840.89
110020,202304,17324,9595,7729,12498552.31,10069815.9,22568368.21
110025,202304,667,490,177,637984.5,231756.4,869740.9
110026,202304,34,22,12,28644.74,15624,44268.74
110028,202304,1678,1179,499,1535096.21,649707.67,2184803.88
110029,202304,130,117,13,152336.73,16926,169262.73
110030,202304,2519,1630,889,2122095.94,1160089.4,3282185.34
110032,202304,345,266,79,346342.5,104163.93,450506.43
110033,202304,696,493,203,643214.1,265613.86,908827.96
110034,202304,331,251,80,326804.54,104160,430964.54
110037,202304,97,83,14,108067.7,18228,126295.7
110040,202304,418,288,130,374978.1,169260,544238.1
110045,202304,1010,733,277,954392.88,361960.11,1316352.99
110050,202304,91,82,9,106765.95,11718.03,118483.98
110060,202304,59,39,20,50778.92,26040,76818.92
110070,202304,108,72,36,93745.51,48174,141919.51
110080,202304,570,328,242,427062.82,315085.36,742148.18
110090,202304,26,21,5,27342,6510,33852
110092,202304,125,59,66,76819.11,85932,162751.11
110094,202304,223,153,70,199208.69,91140,290348.69
110100,202304,55,41,14,53382.28,18228.06,71610.34
110110,202304,121,71,50,92444.97,66402,158846.97
110120,202304,71,62,9,80726.25,11718,92444.25
110130,202304,266,217,49,282541.34,63798.74,346340.08
110140,202304,266,189,77,246080.98,100254.1,346335.08
110143,202304,55,44,11,57288,14322.6,71610.6
110145,202304,44,32,12,41664,15624,57288
110146,202304,29,12,17,15624.2,22134,37758.2
110147,202304,43,26,17,33852,22134.58,55986.58
110148,202304,32,25,7,32550.71,9114,41664.71
110149,202304,311,216,95,281233.29,123690,404923.29
110150,202304,137,110,27,143221.1,36456,179677.1
110155,202304,12,10,2,13020,2604,15624
110160,202304,67,52,15,67705.21,19530,87235.21
110170,202304,225,168,57,218739.96,74214,292953.96
110175,202304,69,55,14,71610.8,18228,89838.8
110180,202304,88,69,19,89838.88,24738,114576.88
120001,202304,234,168,66,218745.27,85932.83,304678.10
120005,202304,233,133,100,173169.15,130200.1,303369.25
120010,202304,1205,737,468,959588.98,610640.82,1570229.80
120013,202304,176,121,55,157544.99,71610.1,229155.09
120017,202304,143,88,55,114576.8,71610,186186.8
120020,202304,3535,2845,690,3704280.02,898391.55,4602671.57
120025,202304,602,324,278,421894.4,361973.89,783868.29
120030,202304,1232,1063,169,1385392.91,220046.45,1605439.36
120032,202304,45,40,5,52081.1,6510,58591.1
120033,202304,229,197,32,256503.27,41664.55,298167.82
120034,202304,189,140,49,182281.39,63798,246079.39
120035,202304,59,52,7,67704.1,9114,76818.1
120038,202304,421,276,145,359366.12,188792.68,548158.80
120039,202304,36,33,3,42967.1,3906.55,46873.65
120040,202304,15320,10259,5061,13364931.98,6597573.27,19962505.25
120042,202304,50,47,3,61196.05,3906,65102.05
120043,202304,17,4,13,5208,16926,22134
120045,202304,556,350,206,455724.18,268215,723939.18
120050,202304,1340,1025,315,1335742.72,410141.63,1745884.35
120060,202304,1536,1284,252,1671830.09,328111.34,1999941.43
120070,202304,432,314,118,408843.56,153636.17,562479.73
120080,202304,205,135,70,175775.58,91140.55,266916.13
130002,202304,164,118,46,153636.95,59892,213528.95
130006,202304,112,77,35,100254,45570,145824
130008,202304,133,78,55,101556.67,71610,173166.67
130010,202304,175,110,65,143220.2,84630.29,227850.49
130014,202304,317,222,95,289372.29,123691.55,413063.84
130020,202304,152,106,46,138013.5,59892,197905.5
130030,202304,1020,567,453,738239.87,589807.39,1328047.26
130040,202304,410,210,200,273421,260400,533821
130050,202304,581,305,276,397124.58,359365.11,756489.69
130060,202304,907,619,288,805942.73,376278.7,1182221.43
130063,202304,612,376,236,489552.1,307272,796824.1
130068,202304,239,150,89,195301.97,115879.96,311181.93
130070,202304,1424,941,483,1225209.51,630174.2,1855383.71
130080,202304,740,511,229,665329.19,298160.59,963489.78
130083,202304,92,61,31,79423.29,40362,119785.29
130090,202304,340,203,137,264306.67,179676,443982.67
130100,202304,1348,684,664,890582.11,865840.8,1756422.91
130110,202304,845,367,478,477838.08,624961.3,1102799.38
130115,202304,150,77,73,100254,95046,195300
130120,202304,1744,1089,655,1417894.33,854114.12,2272008.45
130130,202304,654,443,211,576787.5,276025.55,852813.05
130140,202304,1585,1229,356,1600170,463513.32,2063683.32
130150,202304,438,390,48,507780.08,62496,570276.08
130160,202304,474,300,174,390602,227850,618452
130165,202304,149,132,17,171864.75,22134,193998.75
130170,202304,1223,843,380,1100139.4,494769.53,1594908.93
130180,202304,306,241,65,313784.4,84630.2,398414.6
130185,202304,2362,1164,1198,1516874.31,1562424.32,3079298.63
130190,202304,3465,2163,1302,2817620.44,1701733.13,4519353.57
130195,202304,295,235,60,307272.48,78120,385392.48
130200,202304,231,140,91,182282.38,118482,300764.38
130210,202304,96,45,51,58590,66402,124992
130220,202304,211,156,55,203113,71610,274723
130230,202304,371,249,122,324198,160146,484344
130240,202304,1435,958,477,1247325.55,622357.27,1869682.82
130250,202304,5032,3255,1777,4239420.15,2314989.6,6554409.75
130255,202304,447,232,215,302064.52,279930.61,581995.13
130260,202304,68285,31613,36672,41186576.98,47789921,88976497.98
130270,202304,1563,1078,485,1404988.25,631472.55,2036460.80
130280,202304,146,86,60,111972.1,78120,190092.1
130290,202304,2098,1340,758,1744722.22,986923.03,2731645.25
130300,202304,433,294,139,382790.04,180980.79,563770.83
130310,202304,978,547,431,712198.68,561163,1273361.68
130320,202304,567,311,256,404922.8,337218,742140.8
130330,202304,810,542,268,705689.76,348937.18,1054626.94
130340,202304,3674,2004,1670,2609302.98,2178274.72,4787577.70
130350,202304,490,346,144,450492.2,187488,637980.2
130353,202304,1020,476,544,619767.73,708297.87,1328065.60
130356,202304,893,420,473,548149.72,615850.83,1164000.55
130360,202304,109,86,23,111972.2,29946.7,141918.9
130370,202304,704,559,145,727820.5,188790,916610.5
130380,202304,679,531,148,692667.14,192697.35,885364.49
130390,202304,502,411,91,535122.2,118482,653604.2
130395,202304,173,68,105,89838.5,136710,226548.5
130400,202304,102,79,23,102860.05,29946,132806.05
130406,202304,2291,1343,948,1749903.95,1234300.3,2984204.25
130410,202304,445,235,210,307272,273420,580692
130420,202304,2885,2345,540,3055890.77,703083.62,3758974.39
130423,202304,225,149,76,194001.86,98952,292953.86
130426,202304,193,107,86,139314,111972,251286
130430,202304,451,265,186,345030.74,242172,587202.74
130440,202304,205,73,132,95049.95,171867.35,266917.30
140002,202304,58,17,41,22134.2,54685.39,76819.59
140005,202304,230,135,95,175774.93,123692,299466.93
140010,202304,13310,7615,5695,9919164.09,7416382.28,17335546.37
140015,202304,264,76,188,98954.58,244777.62,343732.20
140017,202304,157,85,72,110679.9,93746.77,204426.67
140020,202304,464,312,152,406238.77,197909.55,604148.32
140023,202304,82,48,34,62496,44268.59,106764.59
140028,202304,28,15,13,19530.84,16927.1,36457.94
140030,202304,434,278,156,361970.4,203115.07,565085.47
140040,202304,84,57,27,74215.28,35154,109369.28
140045,202304,393,108,285,141920.25,371073.28,512993.53
140047,202304,627,400,227,520815.36,296858.55,817673.91
140050,202304,152,94,58,122392.53,75517.59,197910.12
140060,202304,94,67,27,87235.35,35154.2,122389.55
140070,202304,23,21,2,27342.2,2604,29946.2
150010,202304,5460,3279,2181,4269386.92,2840998.84,7110385.76
150013,202304,183,123,60,160147.11,78120.99,238268.10
150020,202304,1208,681,527,886681.95,686155.92,1572837.87
150030,202304,736,334,402,434882.63,523408.14,958290.77
150034,202304,224,130,94,169261.57,122388.5,291650.07
150040,202304,1765,1004,761,1309876.06,993449.1,2303325.16
150050,202304,793,471,322,613250.12,419244.62,1032494.74
150060,202304,5254,3264,1990,4251055.1,2594168.65,6845223.75
150070,202304,508,278,230,361962.84,300763.35,662726.19
150080,202304,19376,8988,10388,11706903.74,13526847.87,25233751.61
150085,202304,503,305,198,397121.52,257798.91,654920.43
150090,202304,788,625,163,813769.75,212228.38,1025998.13
150095,202304,89,59,30,76819.47,39061.51,115880.98
150100,202304,81,49,32,63798,41665.03,105463.03
150110,202304,215,126,89,164052.69,115878.1,279930.79
150120,202304,417,298,119,388006.96,154939.18,542946.14
150125,202304,45,20,25,26040,32550,58590
150130,202304,2634,1283,1351,1670538.11,1759247.81,3429785.92
150140,202304,65445,27948,37497,36400469.04,48856236.54,85256705.58
150145,202304,280,151,129,197907.28,167959.04,365866.32
150150,202304,3941,1720,2221,2239517,2894396.19,5133913.19
150157,202304,379,269,110,350249.78,143221.6,493471.38
150160,202304,167,124,43,161448.66,55986,217434.66
150170,202304,4410,3176,1234,4135264.26,1607987.67,5743251.93
150172,202304,406,285,121,371076.44,157543.7,528620.14
150175,202304,92,53,39,69007,50778.7,119785.7
150178,202304,831,563,268,733050.26,348943.19,1081993.45
150180,202304,3560,1804,1756,2350179.76,2287627.34,4637807.10
150190,202304,422,282,140,367173.12,182282.02,549455.14
150195,202304,141,78,63,101556.8,82026.6,183583.4
150200,202304,222,120,102,156240.08,132804.2,289044.28
150210,202304,3426,2639,787,3436121.25,1025993.6,4462114.85
150215,202304,746,434,312,565094.74,406234.92,971329.66
150220,202304,3743,2469,1274,3214734.68,1658784.67,4873519.35
150230,202304,1512,1202,310,1565565.15,403629.05,1969194.20
150240,202304,7993,4406,3587,5739467.27,4672993.64,10412460.91
150250,202304,90,49,41,63799.95,53383.28,117183.23
150260,202304,141,97,44,126298.27,57288.8,183587.07
150270,202304,2266,1459,807,1899663.85,1052024.14,2951687.99
150275,202304,595,387,208,503884.3,270817.08,774701.38
150276,202304,123,43,80,55986.2,104161.79,160147.99
150277,202304,929,410,519,533835.98,675754.9,1209590.88
150280,202304,346,238,108,309880.01,140616,450496.01
150285,202304,162,83,79,108068.64,102649.68,210718.32
150290,202304,1399,799,600,1040324.95,781209.84,1821534.79
150293,202304,914,433,481,563788.76,627574.33,1191363.09
150295,202304,625,298,327,390617.56,425756.51,816374.07
150300,202304,99,47,52,61194.1,67704.6,128898.7
150304,202304,210,125,85,162753.72,110673.15,273426.87
150307,202304,471,384,87,499978.47,113274.5,613252.97
150309,202304,628,441,187,574215.25,243478.32,817693.57
150310,202304,296,195,101,253892.66,131502,385394.66
150320,202304,2053,1418,635,1846268.03,826778.39,2673046.42
150330,202304,2272,1297,975,1690023.22,1269456.86,2959480.08
150340,202304,207,133,74,173167.3,96348.42,269515.72
150345,202304,699,388,311,505183.49,404922,910105.49
150350,202304,440,352,88,458333.54,114578.99,572912.53
150360,202304,5399,3132,2267,4081889.9,2954274.2,7036164.1
150370,202304,887,592,295,770819.84,384096.89,1154916.73
150375,202304,209,86,123,111974.05,160146.68,272120.73
150380,202304,1611,1072,539,1395778.5,701782.89,2097561.39
150390,202304,961,554,407,721346.02,529918.78,1251264.80
150400,202304,130,110,20,143220.4,26040,169260.4
150405,202304,1754,1110,644,1445245.97,838490.81,2283736.78
150410,202304,109,68,41,88537.09,53382.2,141919.29
150420,202304,8455,4516,3939,5881643.65,5130024.11,11011667.76
150430,202304,709,437,272,569018.72,355457.66,924476.38
150440,202304,493,300,193,390617.06,251290.47,641907.53
150442,202304,2659,1422,1237,1852823.98,1611904.83,3464728.81
150445,202304,572,377,195,492162.29,256494.8,748657.09
150450,202304,249,144,105,187489.11,136710.1,324199.21
150460,202304,747,560,187,729141.41,243476.29,972617.70
150470,202304,1352,807,545,1050750.16,710897,1761647.16
150475,202304,257,196,61,255201.98,79425.13,334627.11
150480,202304,1562,1102,460,1434876.74,598929.84,2033806.58
150490,202304,631,386,245,502578.39,318990,821568.39
150495,202304,371,278,93,361956.23,121086,483042.23
150497,202304,298,190,108,248683.92,140616.3,389300.22
150500,202304,288,166,122,216134.42,158844.1,374978.52
150503,202304,1495,750,745,976533.23,970001.88,1946535.11
150506,202304,952,651,301,848922.47,391903.12,1240825.59
150510,202304,1414,773,641,1006478.05,835890.21,1842368.26
150520,202304,344,235,109,305972.35,141919.2,447891.55
150530,202304,2147,1232,915,1604197.36,1191399.54,2795596.90
150540,202304,243,178,65,231759.64,84630.81,316390.45
150543,202304,962,494,468,643207.72,609343.99,1252551.71
150548,202304,459,331,128,430967.42,166656.3,597623.72
150549,202304,88,57,31,74216.28,40362.26,114578.54
150550,202304,3430,1723,1707,2247327.57,2225142.91,4472470.48
150553,202304,4106,2287,1819,2979115.42,2369688.75,5348804.17
150555,202304,144,81,63,105462.2,82027.17,187489.37
150560,202304,82,41,41,53382.34,53382,106764.34
150563,202304,134,69,65,89843.45,84631.63,174475.08
150565,202304,235,138,97,179678.49,126294.04,305972.53
150570,202304,429,284,145,369769.94,188790,558559.94
150580,202304,1854,929,925,1209571.96,1204351.68,2413923.64
150590,202304,902,599,303,781228.69,394508.49,1175737.18
150600,202304,550,350,200,455715.03,263008.19,718723.22
150610,202304,196,152,44,197907.85,57288,255195.85
150611,202304,161,110,51,143220,66402,209622
150613,202304,3708,2046,1662,2666600.51,2164048.53,4830649.04
150616,202304,645,342,303,445292.64,394508.58,839801.22
150618,202304,1484,765,719,996039.97,937442.97,1933482.94
150619,202304,431,329,102,428362.6,132809.2,561171.8
150620,202304,1370,775,595,1011685.46,774697.59,1786383.05
150630,202304,192,128,64,166667.68,83330.21,249997.89
150635,202304,501,228,273,296868.31,355450.89,652319.20
150640,202304,50,23,27,29947.86,35154,65101.86
150650,202304,2634,1508,1126,1963507.89,1468692.21,3432200.10
150655,202304,294,207,87,269514.42,114576,384090.42
150658,202304,69,41,28,53382,36456,89838
150660,202304,673,416,257,541643.65,334617.42,876261.07
150670,202304,1227,448,779,583306.4,1016871.62,1600178.02
150680,202304,12171,6386,5785,8317582.34,7537462.05,15855044.39
150690,202304,45,22,23,28645.08,29946,58591.08
150700,202304,604,402,202,523431.41,263007.93,786439.34
150710,202304,306,174,132,226553.42,171865.03,398418.45
150715,202304,872,552,320,718724.04,416642.17,1135366.21
150720,202304,455,343,112,446595.38,145824.95,592420.33
150730,202304,1241,579,662,753879.7,864536.87,1618416.57
150740,202304,273,172,101,223944.86,132804,356748.86
150745,202304,875,492,383,640609.76,498671.58,1139281.34
150746,202304,74,36,38,46873.41,49476,96349.41
150747,202304,276,187,89,243479.35,115878.3,359357.65
150750,202304,156,83,73,108070.45,95049.38,203119.83
150760,202304,2007,1320,687,1718681.79,894481.21,2613163.00
150770,202304,432,255,177,332011.81,230454.2,562466.01
150775,202304,101,53,48,69006.48,62496.7,131503.18
150780,202304,225,129,96,167960.57,124992,292952.57
150790,202304,766,451,315,587214.48,410133.53,997348.01
150795,202304,1856,1138,718,1481705.79,937450.89,2419156.68
150796,202304,334,189,145,246080.09,188790.01,434870.10
150797,202304,436,198,238,257803.82,309877.69,567681.51
150800,202304,1784,986,798,1283790.5,1040300.5,2324091.0
150803,202304,375,275,100,358064.35,130201.25,488265.60
150805,202304,221,129,92,167959.87,119785.2,287745.07
150808,202304,1195,589,606,766883.42,789014.39,1555897.81
150810,202304,3364,2256,1108,2937404.07,1442624.04,4380028.11
150812,202304,572,296,276,385399.64,359353.4,744753.04
150815,202304,1340,827,513,1076767.07,667928.11,1744695.18
150820,202304,1825,1097,728,1428356.78,947877.02,2376233.80
150830,202304,598,455,143,592425.52,187489.19,779914.71
150835,202304,258,159,99,207021.8,128898,335919.8
150840,202304,1565,894,671,1164023.69,873655.04,2037678.73
160005,202304,70,46,24,59893.1,31248.12,91141.22
160010,202304,224,137,87,178379.63,113274.83,291654.46
160015,202304,185,122,63,158856.04,82027.7,240883.74
160020,202304,148,73,75,95047.53,97650,192697.53
160021,202304,66,33,33,42968.61,42967.57,85936.18
160023,202304,80,50,30,65102.34,39061.08,104163.42
160025,202304,30,16,14,20833.88,18228.12,39062.00
160027,202304,1580,872,708,1135401.98,921825.56,2057227.54
160030,202304,18674,9612,9062,12521928.9,11804169.63,24326098.53
160040,202304,372,227,145,295568.11,188791.63,484359.74
160050,202304,846,377,469,490875.17,611953.21,1102828.38
160053,202304,322,197,125,256505.73,164055.54,420561.27
160055,202304,26,19,7,24740.18,9115.48,33855.66
160060,202304,7325,4018,3307,5231712.5,4307111.86,9538824.36
160070,202304,192,113,79,147130.84,102859.25,249990.09
160080,202304,153,80,73,104160.92,95046,199206.92
170025,202304,26,14,12,18228,15624.71,33852.71
170030,202304,171,138,33,179682.01,42966,222648.01
170035,202304,210,102,108,132807.93,140617.86,273425.79
170040,202304,188,140,48,182280,62496,244776
170070,202304,337,213,124,277334.52,161448.53,438783.05
170100,202304,366,265,101,345041.57,131502.8,476544.37
170105,202304,40,35,5,45571.29,6510,52081.29
170110,202304,116,73,43,95046.49,57288.1,152334.59
170130,202304,84,41,43,53382,55986,109368
170190,202304,107,62,45,80724.74,58590,139314.74
170200,202304,354,240,114,312483.43,148428.2,460911.63
170210,202304,7128,3912,3216,5095872.35,4191194.48,9287066.83
170215,202304,154,92,62,119788.97,82027.08,201816.05
170220,202304,1364,970,394,1262968.51,512993.5,1775962.01
170230,202304,149,102,47,132809.08,61194.3,194003.38
170240,202304,499,344,155,450515.37,201812.72,652328.09
170255,202304,1047,813,234,1059849.04,304670.15,1364519.19
170270,202304,47,32,15,41664,19530,61194
170290,202304,144,89,55,115879.75,71610,187489.75
170300,202304,121,81,40,105462.54,52080,157542.54
170305,202304,60,43,17,55986.8,22134,78120.8
170307,202304,59,43,16,55987.99,20832.9,76820.89
170310,202304,123,78,45,101558.69,58590,160148.69
170320,202304,41,25,16,32550.2,20832,53382.2
170330,202304,34,24,10,31249.5,13020.1,44269.6
170360,202304,34,20,14,26040.52,18230.21,44270.73
170370,202304,77,44,33,57289.38,42966.2,100255.58
170380,202304,85,64,21,83329.1,27342,110671.1
170382,202304,40,33,7,42966,9114,52080
170384,202304,147,112,35,145824.43,45570.89,191395.32
170386,202304,68,30,38,39060.61,49476,88536.61
170388,202304,46,21,25,27342.16,32550,59892.16
170389,202304,26,19,7,24738.4,9114,33852.4
170390,202304,86,50,36,65100.65,46872.23,111972.88
170410,202304,23,21,2,27344.04,2604,29948.04
170460,202304,16,10,6,13020.22,7812,20832.22
170510,202304,34,25,9,32551.53,11718,44269.53
170550,202304,1639,949,690,1236933.18,898388.77,2135321.95
170555,202304,115,84,31,109372.72,40362,149734.72
170560,202304,102,75,27,97650.71,35154.3,132805.01
170600,202304,40,14,26,18229.29,33852,52081.29
170610,202304,191,105,86,136714.16,111972.1,248686.26
170625,202304,34,20,14,26040.99,18228,44268.99
170650,202304,104,71,33,92442.58,42966.2,135408.78
170700,202304,595,438,157,570283.31,204414,774697.31
170710,202304,142,85,57,110673.76,74217.06,184890.82
170720,202304,113,88,25,114577.01,32550,147127.01
170730,202304,121,70,51,91141.76,66402,157543.76
170740,202304,88,65,23,84630,29946,114576
170755,202304,50,27,23,35155.93,29946.76,65102.69
170765,202304,138,82,56,106768.01,74215.61,180983.62
170770,202304,195,127,68,165356.05,88536.73,253892.78
170820,202304,616,411,205,535132.57,266910.92,802043.49
170825,202304,51,30,21,39060.3,27342,66402.3
170830,202304,92,69,23,89838.06,29946.33,119784.39
170900,202304,173,130,43,169262.89,55986.77,225249.66
170930,202304,1045,574,471,747376.9,613248.35,1360625.25
170950,202304,3451,1655,1796,2156217.26,2339715.95,4495933.21
170980,202304,16,11,5,14323,6510,20833
171050,202304,154,118,36,153636,46872.2,200508.2
171070,202304,62,49,13,63798.15,16927.16,80725.31
171090,202304,49,38,11,49476.2,14322,63798.2
171110,202304,24,18,6,23436.51,7812,31248.51
171150,202304,44,29,15,37758,19530,57288
171180,202304,24,11,13,14322,16927.06,31249.06
171190,202304,192,109,83,141920.63,108066,249986.63
171195,202304,59,49,10,63799.48,13020,76819.48
171200,202304,30,14,16,18228.51,20832,39060.51
171215,202304,11,9,2,11718,2604,14322
171240,202304,64,51,13,66402,16926,83328
171245,202304,56,48,8,62498.5,10416,72914.5
171250,202304,82,48,34,62496.2,44268,106764.2
171270,202304,12,8,4,10416.07,5208.22,15624.29
171280,202304,48,39,9,50780.2,11718.1,62498.3
171320,202304,1104,649,455,845012.32,593713.9,1438726.22
171330,202304,456,235,221,305973.27,287742.21,593715.48
171360,202304,110,79,31,102859.43,40362,143221.43
171370,202304,32,19,13,24738,16926.96,41664.96
171380,202304,135,114,21,148429.45,27342,175771.45
171395,202304,43,27,16,35154,20832,55986
171420,202304,267,174,93,226549.46,121086.2,347635.66
171430,202304,74,58,16,75516.2,20832.03,96348.23
171488,202304,221,126,95,164052.58,123690,287742.58
171500,202304,66,37,29,48174.2,37758,85932.2
171510,202304,80,53,27,69006,35154.52,104160.52
171515,202304,40,33,7,42969.07,9114,52083.07
171525,202304,25,22,3,28646.26,3906,32552.26
171550,202304,17,11,6,14322.9,7812,22134.9
171570,202304,58,30,28,39060,36456.1,75516.1
171575,202304,266,181,85,235663.21,110670,346333.21
171610,202304,2060,1062,998,1382754.82,1303325.6,2686080.42
171620,202304,163,118,45,153636.9,58590.89,212227.79
171630,202304,50,29,21,37758,27342,65100
171650,202304,359,249,110,324210.24,143222.56,467432.80
171660,202304,267,153,114,199213.75,148429.3,347643.05
171665,202304,90,55,35,71611.47,45570.33,117181.80
171670,202304,463,292,171,380191.41,222644.42,602835.83
171700,202304,62,53,9,69006.6,11718,80724.6
171720,202304,26,9,17,11718.7,22134.2,33852.9
171750,202304,102,51,51,66402,66402.7,132804.7
171780,202304,77,60,17,78120.83,22134,100254.83
171790,202304,102,81,21,105462,27342,132804
171800,202304,33,25,8,32550,10416,42966
171820,202304,2209,1277,932,1662692.37,1214772.04,2877464.41
171830,202304,34,26,8,33852.2,10416,44268.2
171840,202304,54,35,19,45570.54,24738,70308.54
171845,202304,35,24,11,31248.73,14322,45570.73
171850,202304,49,39,10,50779.5,13020.27,63799.77
171855,202304,71,51,20,66402.1,26040,92442.1
171865,202304,6,4,2,5208,2604,7812
171870,202304,37,25,12,32550.2,15624.45,48174.65
171875,202304,87,64,23,83328,29946,113274
171880,202304,46,30,16,39060,20832,59892
171884,202304,56,29,27,39060.8,35154,74214.8
171886,202304,138,62,76,82027.07,98952,180979.07
171888,202304,29,22,7,28646.25,9114.1,37760.35
171889,202304,15,8,7,10416,9114,19530
171890,202304,61,49,12,63799.07,15624,79423.07
171900,202304,25,17,8,22134.74,10416,32550.74
172000,202304,36,32,4,41664.2,5208.2,46872.4
172010,202304,56,40,16,52080,20832.07,72912.07
172015,202304,20,14,6,18229.76,7812,26041.76
172020,202304,126,78,48,101556.55,62496,164052.55
172025,202304,42,27,15,35154.46,19530,54684.46
172030,202304,60,37,23,48175.13,29946,78121.13
172049,202304,84,56,28,72913.09,36456.2,109369.29
172065,202304,114,73,41,95048.94,53382.46,148431.40
172080,202304,129,80,49,104162.78,63799.97,167962.75
172085,202304,28,15,13,19530,16926,36456
172090,202304,474,342,132,445290.6,171864.94,617155.54
172093,202304,16,14,2,18228,2604,20832
172097,202304,17,9,8,11718,10416,22134
172100,202304,6443,3733,2710,4863127.65,3533685.14,8396812.79
172110,202304,87,59,28,76819.01,36456,113275.01
172120,202304,1783,1476,307,1921823.79,399718.79,2321542.58
172125,202304,15,11,4,14322,5208,19530
172130,202304,29,18,11,23436.59,14322.28,37758.87
172208,202304,202,131,71,170562,92443.38,263005.38
172210,202304,362,181,181,235667.94,235663.87,471331.81
210005,202304,3196,2015,1181,2624960.99,1538992.2,4163953.19
210010,202304,149,102,47,132805.21,61194,193999.21
210015,202304,45,33,12,42966.39,15624,58590.39
210020,202304,390,233,157,303372.63,204417.43,507790.06
210030,202304,322,221,101,287766.91,131505.38,419272.29
210040,202304,122,101,21,131502.1,27342,158844.1
210043,202304,273,224,49,291652.81,63798.63,355451.44
210047,202304,499,319,180,415339.75,234360,649699.75
210050,202304,273,194,79,253890.59,102858.2,356748.79
210055,202304,58,48,10,62496.29,13020,75516.29
210060,202304,551,445,106,579419.48,138014.81,717434.29
210070,202304,467,361,106,470022.7,138012.67,608035.37
210080,202304,150,139,11,180979.48,14322,195301.48
210083,202304,297,153,144,199207.29,187488.19,386695.48
210087,202304,10,6,4,7812,5208,13020
210090,202304,503,366,137,476555.13,178376.62,654931.75
210095,202304,427,343,84,446595.85,109368.86,555964.71
210100,202304,713,569,144,740851.86,187488.2,928340.06
210110,202304,115,81,34,105463.21,44269.55,149732.76
210120,202304,4888,3939,949,5130131.75,1235615.03,6365746.78
210125,202304,181,115,66,149731.9,85934.35,235666.25
210130,202304,462,286,176,372381.96,229152.89,601534.85
210135,202304,32,24,8,31248.93,10416,41664.93
210140,202304,4680,3570,1110,4649594.97,1446541.62,6096136.59
210150,202304,386,251,135,326816.66,175773.15,502589.81
210160,202304,3304,2822,482,3674345.26,628872.58,4303217.84
210170,202304,1291,1048,243,1364555.72,317690.04,1682245.76
210173,202304,128,117,11,152335.48,14322,166657.48
210177,202304,291,170,121,221342.73,157542,378884.73
210180,202304,34,19,15,24738.2,19530,44268.2
210190,202304,461,317,144,412734.99,187488.7,600223.69
210193,202304,8,6,2,7812.59,2604,10416.59
210197,202304,67,48,19,62496.3,24738.2,87234.5
210200,202304,626,537,89,699200.09,115878.59,815078.68
210203,202304,237,170,67,221344.42,87236.02,308580.44
210207,202304,316,272,44,354149.09,57288,411437.09
210210,202304,724,677,47,881466.23,61194.6,942660.83
210215,202304,82,74,8,96351.36,10416,106767.36
210220,202304,356,307,49,399731.55,63798.01,463529.56
210230,202304,333,273,60,355451.74,78120,433571.74
210232,202304,1244,907,337,1180944.68,438776.01,1619720.69
210235,202304,190,143,47,186190.82,61194.4,247385.22
210237,202304,51,27,24,35155.94,31248.6,66404.54
210240,202304,78,67,11,87234.21,14322.21,101556.42
210250,202304,188,161,27,209624.19,35154.2,244778.39
210255,202304,401,299,102,389313.55,132805.83,522119.38
210260,202304,398,284,114,369771.02,148428,518199.02
210270,202304,640,459,181,597631.12,235663.43,833294.55
210275,202304,106,86,20,111972.22,26040,138012.22
210280,202304,1108,736,372,958288.52,484346.71,1442635.23
210290,202304,543,368,175,480448.9,227851.99,708300.89
210300,202304,4951,3239,1712,4219881.19,2231636.38,6451517.57
210310,202304,126,79,47,102858.2,61194,164052.2
210312,202304,119,88,31,114578.28,40362,154940.28
210315,202304,129,111,18,144522.18,23436,167958.18
210317,202304,149,114,35,148428.57,45570,193998.57
210320,202304,2484,2148,336,2796787.32,437474.16,3234261.48
210325,202304,160,96,64,124994.34,83328.78,208323.12
210330,202304,4218,2519,1699,3281108.67,2212103.03,5493211.70
210340,202304,1227,956,271,1244761.34,354148.01,1598909.35
210350,202304,697,585,112,761687.71,145824,907511.71
210355,202304,154,131,23,170562.2,29946,200508.2
210360,202304,2062,1504,558,1959560.79,726520.71,2686081.50
210370,202304,1260,669,591,872359.02,770788.94,1643147.96
210375,202304,193,95,98,123701,127597.48,251298.48
210380,202304,752,597,155,778608.05,201812.19,980420.24
210390,202304,197,166,31,216135.04,40362,256497.04
210400,202304,424,374,50,486962.68,65100,552062.68
210405,202304,1132,804,328,1046836.49,427057.76,1473894.25
210407,202304,76,64,12,83328,15624,98952
210408,202304,51,47,4,61196.24,5208,66404.24
210409,202304,353,308,45,401020.05,58590.68,459610.73
210410,202304,452,364,88,473930.46,114576,588506.46
210420,202304,206,167,39,217436.69,50778.36,268215.05
210430,202304,59,42,17,54684.5,22134,76818.5
210440,202304,375,260,115,338530.37,149730,488260.37
210450,202304,110,98,12,127599.07,15624,143223.07
210455,202304,249,132,117,171871.2,152337.15,324208.35
210460,202304,322,219,103,285145.91,134106.25,419252.16
210462,202304,77,63,14,82027.14,18228.33,100255.47
210465,202304,127,102,25,132804.85,32550,165354.85
210467,202304,577,439,138,571593.92,180979.32,752573.24
210470,202304,44,38,6,49476,7812,57288
210480,202304,1389,1017,372,1324175.23,484348.93,1808524.16
210490,202304,177,128,49,166658.66,63798.2,230456.86
210500,202304,505,332,173,432284.24,225248.97,657533.21
210510,202304,529,436,93,567674.95,121088.35,688763.30
210515,202304,335,226,109,294255.73,141918.2,436173.93
210520,202304,397,361,36,470031.26,46872.41,516903.67
210530,202304,10112,5142,4970,6696532.43,6473737.44,13170269.87
210535,202304,124,96,28,124993.8,36456,161449.8
210540,202304,1580,1085,495,1414024,644494.3,2058518.3
210542,202304,1099,563,536,733050.21,697885.4,1430935.61
210545,202304,22,20,2,26040.71,2604,28644.71
210547,202304,127,111,16,144524.56,20832.31,165356.87
210550,202304,607,429,178,558586.8,231757.71,790344.51
210560,202304,164,143,21,186188.05,27342.26,213530.31
210565,202304,24,17,7,22134.89,9114.7,31249.59
210570,202304,1314,1117,197,1454370.83,256495.34,1710866.17
210580,202304,134,117,17,152334.78,22134.16,174468.94
210590,202304,687,576,111,749956.58,144522,894478.58
210592,202304,48,44,4,57288,5208,62496
210594,202304,117,102,15,132805.1,19530,152335.1
210596,202304,120,105,15,136711.81,19530,156241.81
210598,202304,142,108,34,140616.9,44268.2,184885.1
210600,202304,306,265,41,345042.52,53382.7,398425.22
210610,202304,251,231,20,300767.19,26040.91,326808.10
210620,202304,43,30,13,39060.92,16926,55986.92
210630,202304,91,81,10,105463.4,13020.2,118483.6
210632,202304,988,713,275,929632.1,358050,1287682.1
210635,202304,26,23,3,29946.9,3906.2,33853.1
210637,202304,119,86,33,111972.2,42966,154938.2
210640,202304,574,513,61,667929.76,79422,747351.76
210650,202304,418,355,63,462218.59,82026.7,544245.29
210660,202304,384,307,77,399737.22,100256.1,499993.32
210663,202304,79,65,14,84630.44,18228,102858.44
210667,202304,85,43,42,55987.52,54685.17,110672.69
210670,202304,268,238,30,309881.59,39060.1,348941.69
210675,202304,486,286,200,372383.65,260402.67,632786.32
210680,202304,232,154,78,201811.86,101556,303367.86
210690,202304,100,91,9,118483.14,11718,130201.14
210700,202304,154,116,38,151033.27,49476.2,200509.47
210710,202304,263,162,101,210925.73,131502.6,342428.33
210720,202304,128,116,12,151032.08,15624,166656.08
210725,202304,66,56,10,72916.44,13020,85936.44
210730,202304,20,14,6,18228.56,7812,26040.56
210735,202304,295,214,81,278629.23,105462,384091.23
210740,202304,521,453,68,589833.81,88536,678369.81
210745,202304,158,124,34,161449.01,44268,205717.01
210750,202304,2810,1535,1275,1999927.67,1661368.67,3661296.34
210760,202304,258,205,53,266912.19,69006.19,335918.38
210770,202304,249,206,43,268230.83,55988.24,324219.07
210780,202304,419,316,103,411447.95,134107.3,545555.25
210790,202304,193,165,28,214834.18,36456,251290.18
210800,202304,180,137,43,179687.53,55987.32,235674.85
210805,202304,70,63,7,82026,9114,91140
210810,202304,437,362,75,471343.67,97650,568993.67
210820,202304,1969,1672,297,2177023.65,386697.9,2563721.55
210825,202304,154,96,58,124994.08,75516.2,200510.28
210830,202304,705,504,201,656217.11,261703.93,917921.04
210840,202304,206,152,54,197905.34,70308,268213.34
210845,202304,227,175,52,227853.46,67704,295557.46
210850,202304,730,526,204,684879.54,265610.91,950490.45
210860,202304,3449,2121,1328,2764201.12,1730364.82,4494565.94
210870,202304,403,318,85,414056.3,110670.2,524726.5
210880,202304,91,75,16,97651.28,20832,118483.28
210890,202304,314,277,37,360668.99,48174,408842.99
210900,202304,712,456,256,593730.94,333316.11,927047.05
210905,202304,73,40,33,52080.2,42966.2,95046.4
210910,202304,2119,1600,519,2083258.63,675746.15,2759004.78
210920,202304,143,66,77,85934.42,100254,186188.42
210923,202304,79,64,15,83329.43,19530,102859.43
210927,202304,416,222,194,289046.8,252588.2,541635.0
210930,202304,81,70,11,91140.4,14322,105462.4
210940,202304,76,60,16,78122.12,20832,98954.12
210945,202304,207,124,83,161450.01,108066,269516.01
210950,202304,521,388,133,506483.2,173166.65,679649.85
210955,202304,94,57,37,74215.25,48174.9,122390.15
210960,202304,2482,1292,1190,1682199.15,1550685.09,3232884.24
210970,202304,109,92,17,119784.82,22134.9,141919.72
210975,202304,76,72,4,93744.79,5208.36,98953.15
210980,202304,1057,545,512,709608.26,666626.87,1376235.13
210990,202304,4465,3182,1283,4143096.03,1670489.59,5813585.62
211000,202304,1340,1093,247,1423129.72,321598.51,1744728.23
211003,202304,962,721,241,938759.17,315084.56,1253843.73
211010,202304,494,450,44,585908.82,57288.29,643197.11
211020,202304,1351,633,718,824186.83,936153.32,1760340.15
211023,202304,41,35,6,45570.99,7812,53382.99
211027,202304,81,63,18,82026.78,23436,105462.78
211030,202304,369,267,102,347635.86,132804.5,480440.36
211040,202304,297,254,43,330711.04,55986,386697.04
211050,202304,1147,803,344,1045539.7,447890.53,1493430.23
211060,202304,636,564,72,734360.76,93744.4,828105.16
211065,202304,26,21,5,27345.42,6510.03,33855.45
211070,202304,838,705,133,919256.28,173167.77,1092424.05
211080,202304,86,84,2,109369.22,2604,111973.22
211085,202304,63,35,28,45570,36456,82026
211090,202304,88,76,12,98955.83,15624,114579.83
211100,202304,470,401,69,522115.99,89838.4,611954.39
211102,202304,226,166,60,216132.4,78120,294252.4
211105,202304,225,163,62,213528,80724.26,294252.26
211107,202304,129,82,47,106764.2,61194,167958.2
211110,202304,997,682,315,887989.61,410135.57,1298125.18
211120,202304,5310,2906,2404,3783826.34,3131356.55,6915182.89
211125,202304,20,15,5,19530,6510,26040
211130,202304,42591,20919,21672,27243022.07,28235587.52,55478609.59
211140,202304,360,322,38,419260.89,49476.47,468737.36
211150,202304,1227,889,338,1157518.06,441382.76,1598900.82
211153,202304,169,100,69,130200,89838,220038
211157,202304,68,55,13,71610,16926,88536
211160,202304,696,587,109,764285.97,141919.5,906205.47
211163,202304,3,2,1,2604,1302,3906
211167,202304,10,10,0,13020,,13020.0
211170,202304,423,319,104,415342.09,135409.48,550751.57
211172,202304,101,75,26,97651.58,33852,131503.58
211174,202304,29,16,13,20832,16926.73,37758.73
211176,202304,461,337,124,438781.73,161450.24,600231.97
211178,202304,94,66,28,85933.82,36456,122389.82
211180,202304,211,174,37,226550.04,48174.91,274724.95
211190,202304,73,65,8,84630.2,10416,95046.2
211195,202304,42,29,13,37762.85,16926,54688.85
211200,202304,147,123,24,160147.49,31248,191395.49
211210,202304,398,304,94,395817.47,122388.59,518206.06
211220,202304,4501,2725,1776,3549442.17,2313867.5,5863309.67
211223,202304,138,126,12,164055.82,15624,179679.82
211227,202304,64,50,14,65100.2,18228,83328.2
211230,202304,715,593,122,772124.39,158845.99,930970.38
211240,202304,382,321,61,417947.12,79422,497369.12
211245,202304,183,100,83,130202.82,108066.2,238269.02
211250,202304,1482,1276,206,1661434.12,268217,1929651.12
211260,202304,810,696,114,906202.34,148428,1054630.34
211270,202304,1855,1555,300,2024655,390601.23,2415256.23
211280,202304,1815,1264,551,1645762.19,717402.75,2363164.94
211285,202304,224,148,76,192697.38,98952,291649.38
211290,202304,810,580,230,755166.73,299460.4,1054627.13
211300,202304,782,634,148,825489.72,192697.16,1018186.88
211400,202304,1585,1047,538,1363230.08,701779.94,2065010.02
220005,202304,17,15,2,19530,2604,22134
220010,202304,76,65,11,84630.96,14322,98952.96
220020,202304,764,622,142,809857.45,184885.49,994742.94
220025,202304,106,101,5,131503.88,6510.6,138014.48
220027,202304,60,49,11,63798.2,14322,78120.2
220030,202304,129,107,22,139316.04,28644,167960.04
220040,202304,1331,1029,302,1339787.73,394509.49,1734297.22
220045,202304,30,22,8,28646.23,10416.4,39062.63
220050,202304,687,575,112,748593.42,145825.7,894419.12
220060,202304,191,167,24,217439.99,31248.35,248688.34
220070,202304,113,98,15,127599.1,19530.7,147129.8
220080,202304,15,13,2,16926.22,2604,19530.22
220090,202304,44,32,12,41664.55,15624,57288.55
220095,202304,3,2,1,2604,1302,3906
220100,202304,23,19,4,24738.71,5208,29946.71
220105,202304,33,30,3,39061.55,3906,42967.55
220110,202304,261,237,24,308576.16,31248,339824.16
220115,202304,50,41,9,53382.6,11718,65100.6
220117,202304,25,23,2,29946,2604,32550
220120,202304,1554,1207,347,1572847.66,451794.2,2024641.86
220130,202304,23,23,0,29946,,29946.0
220140,202304,86,71,15,92443.1,19530.96,111974.06
220150,202304,501,377,124,490876.69,161451.06,652327.75
220155,202304,25,24,1,31248.21,1302,32550.21
220157,202304,22,19,3,24739.39,3906,28645.39
220160,202304,109,96,13,124993.19,16926,141919.19
220170,202304,39,32,7,41664,9114,50778
220173,202304,20,17,3,22134,3906,26040
220177,202304,17,17,0,22134.4,,22134.4
220180,202304,63,62,1,80725.05,1302,82027.05
220190,202304,1201,1029,172,1339786.75,225250.63,1565037.38
220191,202304,36,32,4,41665.11,5208,46873.11
220192,202304,94,86,8,111973.64,10416,122389.64
220194,202304,57,51,6,66402.92,7812,74214.92
220196,202304,80,65,15,84634.22,19530.4,104164.62
220198,202304,2,2,0,2604,,2604.0
220200,202304,409,350,59,455725.91,76819.53,532545.44
220202,202304,35,31,4,40363.17,5208,45571.17
220205,202304,68,59,9,76818.2,11718,88536.2
220207,202304,15,15,0,19530.32,,19530.32
220208,202304,72,45,27,58590.77,35154.2,93744.97
220209,202304,34,29,5,37758,6510,44268
220210,202304,29,24,5,31248,6510,37758
220211,202304,34,33,1,42970.46,1302,44272.46
220213,202304,34,31,3,40363,3906,44269
220217,202304,42,33,9,44268.3,11718,55986.3
220220,202304,2446,1639,807,2135318.99,1052028.47,3187347.46
220225,202304,9,4,5,5208.4,6510,11718.4
220230,202304,1012,756,256,984332.65,333318.55,1317651.20
220240,202304,167,149,18,193999.43,23436.54,217435.97
220245,202304,44,42,2,54686.14,2604,57290.14
220250,202304,147,123,24,160147.83,31248,191395.83
220253,202304,52,46,6,59892.25,7812,67704.25
220255,202304,51,44,7,57288.4,9114,66402.4
220260,202304,723,554,169,722625.19,220039.29,942664.48
220265,202304,14,11,3,14322,3906,18228
220270,202304,879,791,88,1029895.61,114576,1144471.61
220271,202304,38,29,9,37759.68,11718,49477.68
220272,202304,20,20,0,26041.4,,26041.4
220273,202304,17,16,1,20832.4,1302,22134.4
220275,202304,69,59,10,76818,13020,89838
220277,202304,32,24,8,31248.9,10416.63,41665.53
220280,202304,23,16,7,20832,9114,29946
220285,202304,44,40,4,52080.77,5208,57288.77
220290,202304,1589,1362,227,1775907.85,295557.37,2071465.22
220300,202304,41,41,0,53384.39,,53384.39
220310,202304,343,291,52,378899.79,67706.45,446606.24
220320,202304,469,430,39,559884.11,50779.68,610663.79
220323,202304,2,1,1,1302.8,1302,2604.8
220325,202304,9,8,1,10416,1302,11718
220327,202304,14,14,0,18228.67,,18228.67
220330,202304,218,155,63,201810.56,82026,283836.56
220335,202304,135,115,20,149731.89,26040,175771.89
220340,202304,50,40,10,52080,13020,65100
220342,202304,55,48,7,62498.72,9114,71612.72
220345,202304,94,82,12,106764.46,15624.57,122389.03
220350,202304,474,413,61,537729.53,80724.05,618453.58
220360,202304,51,33,18,42966,23436,66402
220370,202304,1397,1169,228,1522074.73,296856.4,1818931.13
220375,202304,21,20,1,26041.19,1302,27343.19
220380,202304,25,19,6,24739.4,7812,32551.4
220385,202304,18,16,2,20832,2604.66,23436.66
220390,202304,2525,1396,1129,1818959.67,1472589.28,3291548.95
220400,202304,37,30,7,39060,9114,48174
220410,202304,24,23,1,29946.2,1302,31248.2
220415,202304,13,12,1,15624.74,1302,16926.74
220420,202304,135,115,20,149730.8,26040,175770.8
220430,202304,150,132,18,171870.29,23436.2,195306.49
220435,202304,25,19,6,24738.72,7812,32550.72
220440,202304,285,242,43,315100.6,55986,371086.6
220450,202304,374,188,186,244784.92,242178.34,486963.26
220455,202304,53,52,1,67704.54,1302,69006.54
220460,202304,20,19,1,24739.74,1302.26,26042.00
220465,202304,66,45,21,58590.87,27342.41,85933.28
220470,202304,237,208,29,270823.85,37758.86,308582.71
220480,202304,66,61,5,79422.54,6510,85932.54
220490,202304,85,72,13,93744,16926,110670
220500,202304,131,110,21,143221.57,27342,170563.57
220510,202304,367,287,80,373686.49,104160.88,477847.37
220515,202304,29,27,2,35155.45,2604,37759.45
220520,202304,389,343,46,446598.33,59893.26,506491.59
220525,202304,10,6,4,7812.38,5208.92,13021.30
220527,202304,13,13,0,16926.38,,16926.38
220530,202304,51,24,27,31248,35154.87,66402.87
220535,202304,5,4,1,5208.67,1302,6510.67
220540,202304,109,94,15,122389.06,19530.2,141919.26
220545,202304,24,16,8,20832.94,10417.3,31250.24
220550,202304,775,615,160,800758.46,208322.02,1009080.48
220551,202304,13,11,2,14322,2604,16926
220552,202304,11,11,0,14322,,14322.0
220553,202304,64,59,5,76819.69,6510,83329.69
220554,202304,5,3,2,3906.86,2604,6510.86
220555,202304,49,39,10,50780.18,13020.2,63800.38
220556,202304,41,38,3,49477.62,3906,53383.62
220557,202304,65,60,5,78121.3,6510.74,84632.04
220558,202304,13,6,7,7812,9114.54,16926.54
220559,202304,4,4,0,5208.07,,5208.07
220560,202304,86,55,31,72913,40362,113275
220570,202304,735,459,276,597629.73,360657.62,958287.35
220580,202304,566,520,46,677078.07,59893.8,736971.87
220585,202304,14,11,3,14322.2,3906.37,18228.57
220590,202304,17,16,1,20833.94,1302,22135.94
220595,202304,72,56,16,72912.33,20832,93744.33
220600,202304,21,15,6,19530,7812,27342
220605,202304,34,30,4,39060.2,5208,44268.2
220610,202304,100,84,16,109368,20832,130200
220620,202304,570,489,81,636691.28,105463.95,742155.23
220630,202304,3,2,1,2604,1302,3906
220635,202304,35,32,3,41666.23,3906,45572.23
220640,202304,114,94,20,122388,26040,148428
220650,202304,117,111,6,144522.78,7812,152334.78
220660,202304,84,63,21,82027.85,27342.2,109370.05
220665,202304,12,12,0,15624,,15624.0
220667,202304,26,24,2,31248.19,2604,33852.19
220669,202304,43,37,6,48174.2,7812,55986.2
220670,202304,69,54,15,70308.9,19530,89838.9
220672,202304,77,57,20,74220.02,26041.21,100261.23
220675,202304,28,22,6,28646.23,7812,36458.23
220680,202304,61,52,9,67704.2,11718,79422.2
220690,202304,49,46,3,59892.06,3906,63798.06
220695,202304,30,17,13,22135.19,16926,39061.19
220700,202304,1928,1494,434,1946518.99,565073,2511591.99
220710,202304,7,5,2,6510.2,2604.78,9114.98
220720,202304,113,98,15,127596,19530,147126
220730,202304,33,32,1,41664.01,1302,42966.01
220735,202304,8,6,2,7812,2604,10416
220740,202304,60,52,8,67704.2,10416.91,78121.11
220750,202304,135,114,21,148430.8,27342.18,175772.98
220755,202304,20,19,1,24739.29,1302,26041.29
220760,202304,70,62,8,80726.2,10416,91142.2
220770,202304,6242,3599,2643,4690052.69,3443874.49,8133927.18
220775,202304,11,9,2,11718.7,2604.4,14323.1
220777,202304,22,21,1,27342,1302,28644
220779,202304,5,1,4,1302,5208,6510
220780,202304,959,815,144,1061141.79,187489.24,1248631.03
220785,202304,7,4,3,5208,3906.2,9114.2
220790,202304,1268,1018,250,1325470.29,326810.26,1652280.55
220793,202304,8,6,2,7812,2604,10416
220795,202304,23,22,1,28644.27,1302,29946.27
220800,202304,4194,3209,985,4178450.21,1282485.74,5460935.95
220810,202304,80,68,12,88537.94,15624,104161.94
220820,202304,256,232,24,302072.64,31249.8,333322.44
220830,202304,1355,1194,161,1558314.98,209623.34,1767938.32
220840,202304,2666,1886,780,2455651.83,1015582.23,3471234.06
220850,202304,81,69,12,89838,15624,105462
220855,202304,8,4,4,5208,5208,10416
220860,202304,16,13,3,16928.03,3906,20834.03
220865,202304,31,28,3,36456.1,3906,40362.1
220870,202304,93,82,11,106765.08,14322,121087.08
220880,202304,340,282,58,367177.62,75517.92,442695.54
220885,202304,27,26,1,33854.84,1302,35156.84
220887,202304,6,5,1,6510.2,1302,7812.2
220890,202304,87,73,14,95047.75,18228,113275.75
220900,202304,26,14,12,18228,15624,33852
220910,202304,48,37,11,48176.13,14322,62498.13
220915,202304,10,9,1,11718.19,1302,13020.19
220920,202304,51,45,6,58591.28,7812,66403.28
220930,202304,56,54,2,70308.28,2604,72912.28
220935,202304,15,15,0,19530.97,,19530.97
220937,202304,36,30,6,39060.9,7812,46872.9
220940,202304,63,55,8,71610,10416,82026
220945,202304,4,4,0,5208.34,,5208.34
220950,202304,36,28,8,36456.2,10416,46872.2
220955,202304,23,22,1,28644.77,1302,29946.77
220960,202304,41,36,5,46872,6510,53382
220965,202304,55,50,5,65100,6510,71610
220970,202304,63,53,10,69006,13020,82026
220975,202304,11,10,1,13020.9,1302,14322.9
220980,202304,28,26,2,33852.76,2604,36456.76
220985,202304,53,45,8,58590,10416,69006
220987,202304,32,31,1,40365.11,1302.9,41668.01
220990,202304,26,24,2,31248,2951,34199
220995,202304,14,12,2,15624,2604,18228
220997,202304,75,67,8,87235.93,10416,97651.93
221000,202304,1346,1191,155,1550723.41,201810.86,1752534.27
221005,202304,44,41,3,53382,3906.75,57288.75
221010,202304,27,19,8,24738,10416,35154
221020,202304,44,38,6,49476.46,7812,57288.46
221030,202304,44,37,7,48071.85,9114,57185.85
221035,202304,24,22,2,28645.81,2604,31249.81
221037,202304,14,10,4,13020,5208,18228
221038,202304,26,23,3,29946,3906,33852
221039,202304,26,25,1,32550.03,1302.2,33852.23
221040,202304,266,225,41,292955.73,53383.4,346339.13
221050,202304,235,196,39,255202.09,50778.2,305980.29
221060,202304,2084,1789,295,2331932.53,384095.58,2716028.11
221062,202304,28,28,0,36458.11,,36458.11
221063,202304,19,14,5,18228,6510,24738
221065,202304,79,65,14,84633.09,18228,102861.09
221070,202304,161,139,22,180983.31,28644,209627.31
221080,202304,424,360,64,468733.15,83328,552061.15
221090,202304,30,24,6,31250.42,7812,39062.42
221093,202304,51,35,16,45571.2,20832.38,66403.58
221095,202304,5,5,0,6510,,6510.0
221097,202304,12,10,2,13020,2604,15624
221100,202304,28444,17001,11443,22144160.72,14904313.7,37048474.42
221110,202304,1214,936,278,1218719.88,361962.58,1580682.46
221120,202304,603,439,164,571589.6,213528.68,785118.28
221130,202304,1052,848,204,1104115.98,265612.14,1369728.12
221135,202304,33,30,3,39061.09,3906,42967.09
221140,202304,49,42,7,54684.2,9114,63798.2
221150,202304,14,10,4,13020.18,5208,18228.18
221160,202304,19,17,2,22135.39,2604,24739.39
221170,202304,21,20,1,26040,1302,27342
230010,202304,170,147,23,191395.94,29946,221341.94
230015,202304,170,142,28,184884.7,36456.6,221341.3
230020,202304,1954,1550,404,2018153.93,527323.38,2545477.31
230030,202304,1747,1278,469,1664015.01,613250.01,2277265.02
230040,202304,245,197,48,256496.69,62496,318992.69
230050,202304,251,175,76,227850.45,98952.4,326802.85
230060,202304,182,144,38,187488.39,49477.54,236965.93
230070,202304,336,284,52,369772.55,67704,437476.55
230075,202304,977,809,168,1053343.29,218740.01,1272083.30
230080,202304,243,198,45,257799.65,58590,316389.65
230090,202304,199,141,58,183583.03,75516,259099.03
230100,202304,2928,1645,1283,2141887.55,1673096.49,3814984.04
230110,202304,3267,2065,1202,2691311.88,1566326.07,4257637.95
230120,202304,1277,971,306,1264272.32,399717.91,1663990.23
230125,202304,189,148,41,192696.83,53382,246078.83
230130,202304,531,460,71,598929.17,92442.14,691371.31
230140,202304,231,188,43,244776.51,55986,300762.51
230150,202304,155,119,36,154939.58,46872.92,201812.50
230160,202304,1028,836,192,1088479.34,249985.13,1338464.47
230170,202304,687,595,92,774710.28,119787.93,894498.21
230180,202304,72,64,8,83328.39,10416,93744.39
230185,202304,444,379,65,493467.35,84631.14,578098.49
230190,202304,2711,2039,672,2654855.9,876256.44,3531112.34
230195,202304,550,466,84,606750.51,109368,716118.51
230200,202304,491,377,114,490861.46,148428.2,639289.66
230205,202304,430,280,150,364561.17,195300.2,559861.37
230210,202304,1499,1131,368,1472586.59,479137.55,1951724.14
230220,202304,1745,1158,587,1507756.65,764284.07,2272040.72
230230,202304,1079,864,215,1124953.93,279933.12,1404887.05
230240,202304,2233,1947,286,2535049.99,372375.46,2907425.45
230250,202304,1965,1594,371,2075460.74,483053.15,2558513.89
230260,202304,3542,2184,1358,2844902.92,1772028.32,4616931.24
230270,202304,1474,1132,342,1475188.97,445289.09,1920478.06
230280,202304,3062,2340,722,3046769.86,940052.53,3986822.39
230290,202304,371,321,50,419258.3,65100.99,484359.29
230300,202304,542,397,145,516897.85,188790.29,705688.14
230310,202304,452,346,106,450492.41,138012.83,588505.24
230320,202304,1000,833,167,1084588.72,217434.95,1302023.67
230330,202304,344,280,64,365864.85,83328.4,449193.25
230340,202304,469,378,91,492165.15,119784.4,611949.55
230350,202304,3696,2248,1448,2928286.69,1889219.82,4817506.51
230360,202304,284,233,51,303371.14,66402.95,369774.09
230365,202304,147,116,31,151033.66,40362.6,191396.26
230370,202304,12599,6326,6273,8242098.19,8172894.93,16414993.12
230380,202304,553,470,83,611955.32,108067.44,720022.76
230390,202304,569,325,244,423154.15,317688.6,740842.75
230393,202304,242,194,48,253892.19,62496.5,316388.69
230395,202304,391,310,81,403645.49,105464.53,509110.02
230400,202304,696,554,142,721316.24,184884.2,906200.44
230410,202304,3046,1912,1134,2489496.05,1479092.62,3968588.67
230420,202304,7048,4632,2416,6031152.7,3148336,9179488.7
230423,202304,358,307,51,399718.05,66402.1,466120.15
230425,202304,555,442,113,575492.46,147128.19,722620.65
230426,202304,128,100,28,130200.7,36456,166656.7
230427,202304,81,70,11,91140.89,14322,105462.89
230428,202304,1916,915,1001,1191365.19,1305919.88,2497285.07
230430,202304,494,396,98,515602.19,127598.01,643200.20
230435,202304,1005,719,286,936163.2,372375.18,1308538.38
230440,202304,107001,49241,57760,64148518.52,75288372.71,139436891.23
230445,202304,355,234,121,304677.54,157542.7,462220.24
230450,202304,627,489,138,636680.91,179676.7,816357.61
230460,202304,114,81,33,105462.69,42966,148428.69
230465,202304,332,270,62,351544.95,80724,432268.95
230470,202304,2173,1703,470,2217332.14,611943.64,2829275.78
230480,202304,161,145,16,188790.5,20832.89,209623.39
230490,202304,358,280,78,364562.68,101556.9,466119.58
230495,202304,526,369,157,480453.35,204417.54,684870.89
230500,202304,1229,904,325,1178321.45,423153.64,1601475.09
230510,202304,83,56,27,72912,35154,108066
230520,202304,444,337,107,438779.58,139314.62,578094.20
230523,202304,2867,1746,1121,2273372.36,1460864.38,3734236.74
230526,202304,267,219,48,285138.95,62496,347634.95
230530,202304,746,532,214,692677.25,278631.71,971308.96
230533,202304,227,209,18,272121.09,23436.2,295557.29
230535,202304,446,332,114,432280.2,148428.92,580709.12
230540,202304,1909,1699,210,2213455.6,276028.07,2489483.67
230550,202304,4554,2869,1685,3738236.44,2196527.33,5934763.77
230560,202304,625,474,151,617159.61,196602.57,813762.18
230565,202304,234,173,61,225246.7,79423.14,304669.84
230570,202304,334,284,50,369769.41,65100.45,434869.86
230580,202304,1328,905,423,1178325,550751.97,1729076.97
230590,202304,1148,874,274,1137860.83,356749.76,1494610.59
230600,202304,309,276,33,359361.54,42966,402327.54
230610,202304,509,373,136,485656.34,177072.2,662728.54
230620,202304,185,153,32,199209.79,41664,240873.79
230625,202304,949,633,316,824188,411433.27,1235621.27
230630,202304,1603,1197,406,1558533.14,528617.45,2087150.59
230640,202304,4328,3504,824,4563686.32,1072877.64,5636563.96
230650,202304,532,452,80,588509.57,104160.71,692670.28
230655,202304,807,636,171,828102.01,222645.84,1050747.85
230660,202304,404,328,76,427060.4,98952.2,526012.6
230670,202304,520,410,110,533840.01,143221.29,677061.30
230680,202304,237,202,35,263010.51,45570,308580.51
230690,202304,1048,876,172,1140581.92,223945.42,1364527.34
230700,202304,1115,919,196,1196567.5,255193.68,1451761.18
230710,202304,713,652,61,848931.31,79423.25,928354.56
230720,202304,156,134,22,174468,28644.7,203112.7
230725,202304,314,238,76,309879.32,98953.17,408832.49
230730,202304,14110,7415,6695,9658856.81,8731392.11,18390248.92
230740,202304,761,610,151,794242.1,196603.1,990845.2
230750,202304,901,739,162,962194.54,210924.95,1173119.49
230760,202304,1764,1491,273,1942653.37,355449.4,2298102.77
230763,202304,398,334,64,434871.59,83328,518199.59
230765,202304,9617,4566,5051,5947945.44,6580542.05,12528487.49
230770,202304,5655,2903,2752,3779860.6,3585745.24,7365605.84
230780,202304,860,738,122,960888.55,158844.54,1119733.09
230790,202304,340,276,64,359352.3,83328.24,442680.54
230800,202304,1315,925,390,1204368.35,507781.95,1712150.30
230810,202304,1528,1315,213,1712203.89,277330.09,1989533.98
230820,202304,410,265,145,345035.42,188791.8,533827.22
230830,202304,1030,862,168,1122346.21,218736.9,1341083.11
230835,202304,303,246,57,320297.27,74214.68,394511.95
230837,202304,201,161,40,209623.44,52080.9,261704.34
230840,202304,1029,769,260,1002548.98,338523.23,1341072.21
230850,202304,1493,1250,243,1627543.35,316390.45,1943933.80
230860,202304,365,285,80,371073.17,104166.51,475239.68
230870,202304,1981,1672,309,2176983.5,402318.47,2579301.97
230880,202304,88,68,20,88536,26040,114576
230890,202304,613,537,76,700485.25,98954.14,799439.39
230900,202304,334,246,88,320294.37,114576.51,434870.88
230910,202304,243,188,55,244779.03,71610,316389.03
230920,202304,542,420,122,546848.41,158844,705692.41
230930,202304,1211,844,367,1098913.93,477835.43,1576749.36
230940,202304,904,693,211,902305,274722.73,1177027.73
230945,202304,612,487,125,634098.24,162755.07,796853.31
230950,202304,466,401,65,522124.79,84630.5,606755.29
230960,202304,3071,2045,1026,2664023.46,1338493.26,4002516.72
230970,202304,2038,1117,921,1454386.64,1200463.05,2654849.69
230980,202304,242,176,66,229154.8,85932,315086.8
230990,202304,148,116,32,151032.5,41664,192696.5
231000,202304,222,204,18,265610.95,23436,289046.95
231010,202304,199,136,63,177074.71,82026,259100.71
231020,202304,1610,1058,552,1377573.97,718719.16,2096293.13
231025,202304,1244,851,393,1108045.61,511700.02,1619745.63
231030,202304,1136,917,219,1193948.71,286441.97,1480390.68
231040,202304,199,138,61,179678.14,79422,259100.14
231050,202304,1017,868,149,1130157.66,194005.14,1324162.80
231060,202304,174,140,34,182284.24,44269,226553.24
231070,202304,1646,1127,519,1467384.48,675745.59,2143130.07
231080,202304,289,251,38,326810.34,49476,376286.34
231085,202304,773,473,300,615863.82,391902.26,1007766.08
231090,202304,292,232,60,302068.36,78121.64,380190.00
231095,202304,171,127,44,165354,57288.4,222642.4
231100,202304,202,163,39,212227.6,50778,263005.6
231110,202304,399,330,69,429669.84,89841.19,519511.03
231120,202304,276,227,49,295557.95,63799.29,359357.24
231123,202304,157,149,8,194001.4,10416,204417.4
231126,202304,361,281,80,365863.09,105462,471325.09
231130,202304,5387,4164,1223,5423061.58,1592379.21,7015440.79
231135,202304,237,205,32,266912.07,41665.41,308577.48
231140,202304,3319,2373,946,3091045.67,1234309.63,4325355.30
231150,202304,429,394,35,513000.18,45571.02,558571.20
231160,202304,1361,1105,256,1438738.33,333312.46,1772050.79
231170,202304,570,391,179,509086.04,233058,742144.04
231180,202304,2115,1825,290,2376219.1,377587.8,2753806.9
231190,202304,245,196,49,255192.54,63798,318990.54
231195,202304,250,203,47,264307.89,61194.15,325502.04
231200,202304,924,738,186,960902.55,244778.6,1205681.15
231210,202304,554,457,97,595022.54,126295.39,721317.93
231220,202304,1155,809,346,1053344.42,450495.52,1503839.94
231230,202304,1709,1246,463,1622320.34,604128.72,2226449.06
231240,202304,1797,1197,600,1558536.13,782511.14,2341047.27
231250,202304,98,92,6,119785.53,7812,127597.53
231260,202304,276,182,94,236966,122390.15,359356.15
231270,202304,1065,815,250,1061159.05,326803.17,1387962.22
231280,202304,89,65,24,84631.94,31248.27,115880.21
231290,202304,8808,4898,3910,6378766.21,5096130.91,11474897.12
231300,202304,637,573,64,746054.89,83328,829382.89
231310,202304,900,819,81,1066351.86,106765.11,1173116.97
231320,202304,657,489,168,636684.15,218737.62,855421.77
231325,202304,109,92,17,119784.18,22134.54,141918.72
231330,202304,2109,1584,525,2065044.42,683559.8,2748604.22
231335,202304,267,235,32,305974.42,41664,347638.42
231340,202304,2126,1437,689,1871021.68,897088.67,2768110.35
231350,202304,1583,1229,354,1602824.01,462227.01,2065051.02
231355,202304,443,359,84,467423.25,109369.24,576792.49
231360,202304,629,420,209,546856.63,272119.94,818976.57
231370,202304,99,84,15,109368,19530.02,128898.02
231375,202304,308,228,80,296860.76,104160.1,401020.86
231380,202304,574,455,119,592415.26,154938,747353.26
231390,202304,213,165,48,214831.99,62496,277327.99
231395,202304,847,496,351,647098.38,458305.35,1105403.73
231400,202304,1319,1090,229,1419211.39,298162.59,1717373.98
231410,202304,1510,1217,293,1587173.98,381489.09,1968663.07
240010,202304,420,192,228,249995.75,298168.03,548163.78
240020,202304,2489,2034,455,2648389.4,592419.44,3240808.84
240030,202304,124,97,27,126295.57,35154,161449.57
240040,202304,36,35,1,45570,1302,46872
240050,202304,559,477,82,621088.79,106764.1,727852.89
240060,202304,89,78,11,101557.77,14322,115879.77
240070,202304,310,235,75,305974.19,97650.2,403624.39
240080,202304,637,425,212,553374.39,276031.45,829405.84
240090,202304,111,97,14,126294.13,18228,144522.13
240100,202304,1654,1548,106,2016862.2,138015.39,2154877.59
240110,202304,1132,761,371,992204.17,483064.59,1475268.76
240120,202304,158,118,40,153637.58,52080.72,205718.30
240130,202304,279,254,25,330723.81,32550.7,363274.51
240140,202304,94,62,32,80725.39,41664.64,122390.03
240145,202304,784,690,94,899718.42,122388.22,1022106.64
240150,202304,29,21,8,27342,10416,37758
240160,202304,39,32,7,41664,9114,50778
240165,202304,43,35,8,46875.41,10416.74,57292.15
240170,202304,163,110,53,143221.12,69006,212227.12
240180,202304,127,94,33,122391.38,42966,165357.38
240185,202304,53,45,8,58590.39,10416,69006.39
240190,202304,16,14,2,18228.43,2604,20832.43
240200,202304,3340,1790,1550,2331945.71,2020727.44,4352673.15
240210,202304,167,125,42,162750.73,54684,217434.73
240220,202304,1244,841,403,1095027.32,524711.53,1619738.85
240230,202304,894,794,100,1033833.36,130201.38,1164034.74
240240,202304,90,59,31,76818.2,40362.69,117180.89
240250,202304,109,93,16,121087.31,20832,141919.31
240260,202304,2069,1444,625,1882758.01,815062.71,2697820.72
240270,202304,179,152,27,197904.87,35154,233058.87
240280,202304,73,59,14,76818.2,18228.1,95046.3
240290,202304,41,39,2,50778,2604,53382
240300,202304,180,94,86,122389.85,111972,234361.85
240310,202304,2745,1474,1271,1920516.71,1654866.07,3575382.78
240320,202304,183,169,14,220038.07,18228,238266.07
240325,202304,5442,3017,2425,3929656.57,3158752.53,7088409.10
240330,202304,89,83,6,108066,7812,115878
240340,202304,114,82,32,106764.83,41664,148428.83
240350,202304,100,78,22,101556.2,28644,130200.2
240360,202304,825,520,305,678374.52,397118.58,1075493.10
240370,202304,67,58,9,75518.45,11719.89,87238.34
240375,202304,54,35,19,45571.28,24739.4,70310.68
240380,202304,225,184,41,239578.34,53383.2,292961.54
240390,202304,16,15,1,19530,1302,20832
240400,202304,88,79,9,102859.34,11718,114577.34
240410,202304,11,8,3,10416,3906,14322
240420,202304,1210,850,360,1108039.8,468727.79,1576767.59
240430,202304,276,249,27,324212.03,35154.44,359366.47
240440,202304,158,87,71,113278.57,92442.91,205721.48
240450,202304,273,162,111,210936.12,145826.53,356762.65
240460,202304,98,75,23,97651.12,29946.6,127597.72
240470,202304,232,209,23,272136.08,29947.01,302083.09
240480,202304,16,14,2,18228,2604,20832
240485,202304,91,72,19,93745.49,24738,118483.49
240490,202304,66,60,6,78120.11,7812,85932.11
240500,202304,110,85,25,110670,32550,143220
240510,202304,38,29,9,37758,11718,49476
240520,202304,99,94,5,122390.32,6510.56,128900.88
240530,202304,66,50,16,65100,20832,85932
240540,202304,103,89,14,115878.1,18228,134106.1
240550,202304,12,10,2,13020,2604,15624
240560,202304,432,292,140,380194.73,182280.93,562475.66
240570,202304,462,281,181,365870.12,235663.3,601533.42
240580,202304,1459,1059,400,1378861.37,520801.47,1899662.84
240590,202304,30,29,1,37758.97,1302,39060.97
240600,202304,109,102,7,132805.09,9114,141919.09
240610,202304,522,431,91,561188.26,118488.29,679676.55
240615,202304,11,10,1,13020.8,1302,14322.8
240620,202304,88,84,4,109370.5,5208,114578.5
240630,202304,44,35,9,45570.97,11718.48,57289.45
240640,202304,37,25,12,32550,15624,48174
240650,202304,257,203,54,264307.65,70308.28,334615.93
240660,202304,117,99,18,128898.77,23436,152334.77
240670,202304,328,182,146,236979.56,190101.74,427081.30
240680,202304,58,45,13,58590.67,16926.1,75516.77
240690,202304,49,47,2,61195.84,2604,63799.84
240700,202304,184,154,30,200508.6,39061.02,239569.62
240710,202304,2489,1488,1001,1938756.17,1303318.91,3242075.08
240720,202304,1138,790,348,1029918.15,453106.03,1483024.18
240725,202304,80,72,8,93745.53,10416.88,104162.41
240730,202304,152,124,28,161448.02,36456.9,197904.92
240740,202304,249,201,48,261713.39,62496.62,324210.01
240750,202304,56,34,22,44268,28644,72912
240760,202304,63,50,13,65100,16926,82026
240770,202304,158,123,35,160148.72,45571,205719.72
240780,202304,809,662,147,861949.33,191395.32,1053344.65
240790,202304,41,39,2,50780.05,2604,53384.05
240800,202304,10494,7039,3455,9170647.16,4501204.54,13671851.70
240810,202304,23588,12395,11193,16150923.1,14582766.49,30733689.59
240820,202304,281,167,114,217439.66,148431.85,365871.51
240830,202304,1692,1393,299,1815044.5,390609.61,2205654.11
240840,202304,80,69,11,89838.79,14322,104160.79
240850,202304,89,78,11,101556,14322,115878
240860,202304,115,110,5,144524.09,6510.85,151034.94
240870,202304,58,47,11,61197.2,14322,75519.2
240880,202304,33,29,4,37758,5208,42966
240890,202304,1296,720,576,937474.3,749963.3,1687437.6
240895,202304,65,50,15,66402.2,19530.38,85932.58
240910,202304,191,158,33,205718.5,42966.2,248684.7
240920,202304,13,11,2,14323.56,2604,16927.56
240930,202304,451,399,52,519522.96,67705.56,587228.52
240933,202304,63,41,22,53382.95,28644,82026.95
240940,202304,2431,2120,311,2760319.49,406228.37,3166547.86
240950,202304,43,37,6,48174,7812,55986
240960,202304,26,21,5,27342.2,6510.3,33852.5
240970,202304,114,82,32,106764.96,41664,148428.96
240980,202304,213,166,47,217435.23,61195.45,278630.68
240990,202304,150,95,55,123691.06,71610,195301.06
241000,202304,62,56,6,72912.6,9114,82026.6
241010,202304,95,77,18,100254.6,23436,123690.6
241020,202304,116,107,9,139316.39,11718.82,151035.21
241025,202304,22,14,8,18229.1,10416.5,28645.6
241030,202304,122,93,29,121086,37759.38,158845.38
241040,202304,50,40,10,52080.1,13020,65100.1
241050,202304,76,70,6,91141.03,7812,98953.03
241060,202304,29,24,5,31248.78,6510,37758.78
241070,202304,24,24,0,31251.19,,31251.19
241080,202304,61,53,8,69006.2,10416,79422.2
241090,202304,56,46,10,59895.49,13020,72915.49
241100,202304,70,61,9,79422.33,11718.23,91140.56
241105,202304,30,18,12,23440.44,15624.73,39065.17
241110,202304,54,44,10,57288.15,13020,70308.15
241120,202304,1816,1373,443,1788989.75,576790.14,2365779.89
241140,202304,213,172,41,225250.35,53382,278632.35
241142,202304,50,39,11,50779.26,14322,65101.26
241150,202304,1236,1069,167,1393190.44,217436.74,1610627.18
241160,202304,26,19,7,24738,9114,33852
241170,202304,54,46,8,59892,10416,70308
241180,202304,49,36,13,46872,16926,63798
241190,202304,41,36,5,46872.98,6510,53382.98
241200,202304,5270,2744,2526,3572910.64,3291578.35,6864488.99
241210,202304,74,62,12,80724.51,15624,96348.51
241220,202304,1693,1062,631,1384088.24,821575.51,2205663.75
241230,202304,270,215,55,279935.26,71610.91,351546.17
241240,202304,54,40,14,52081.36,18228,70309.36
241250,202304,1188,1083,105,1411411.04,136713.04,1548124.08
241255,202304,72,58,14,75517.28,18228,93745.28
241260,202304,791,598,193,778613.99,251288.43,1029902.42
241270,202304,72,53,19,69007.45,24738,93745.45
241280,202304,98,84,14,109370.31,18228,127598.31
241290,202304,147,108,39,140620.08,50778.39,191398.47
241300,202304,85,58,27,75516.7,35154.98,110671.68
241310,202304,55,38,17,49477.75,22134.1,71611.85
241320,202304,36,20,16,26041.54,20832,46873.54
241330,202304,65,55,10,71611.82,13020,84631.82
241335,202304,110,99,11,128902.03,14322,143224.03
241340,202304,194,136,58,177072.81,75516,252588.81
241350,202304,68,56,12,72912.59,15624,88536.59
241355,202304,55,44,11,57290.51,14322,71612.51
241360,202304,59,56,3,72912.78,3906,76818.78
241370,202304,68,55,13,71610,16926,88536
241380,202304,38,33,5,42967.5,6510,49477.5
241390,202304,91,72,19,93744,24738,118482
241400,202304,235,176,59,230096.76,76819.27,306916.03
241410,202304,188,169,19,220038.81,24738.8,244777.61
241415,202304,111,88,23,114576.1,29946.8,144522.9
241420,202304,148,97,51,126296.37,66402.6,192698.97
241430,202304,21,17,4,22134.88,5208,27342.88
241440,202304,566,475,91,619781.19,119787.79,739568.98
241445,202304,44,39,5,50778.2,6510.8,57289.0
241450,202304,268,226,42,294263.17,54684.54,348947.71
241460,202304,181,164,17,213533.25,22135.02,235668.27
241470,202304,32,26,6,33852.8,7812.43,41665.23
241475,202304,49,45,4,58590,5208,63798
241480,202304,147,106,41,138015.43,53382.2,191397.63
241490,202304,13,11,2,14323.07,2604.1,16927.17
241500,202304,52,39,13,50780.62,16926.02,67706.64
250010,202304,102,84,18,109368.46,23436.48,132804.94
250020,202304,34,29,5,37758,6510,44268
250030,202304,938,695,243,904920,317693.24,1222613.24
250040,202304,415,335,80,436187.75,104161.12,540348.87
250050,202304,298,245,53,318991.53,69006.5,387998.03
250053,202304,71,58,13,75516.6,16926,92442.6
250057,202304,4,3,1,3906.2,1302,5208.2
250060,202304,652,471,181,613261.85,235664,848925.85
250070,202304,702,561,141,730443.73,183582.64,914026.37
250073,202304,10,8,2,10416.64,2604.01,13020.65
250077,202304,190,137,53,178376.01,69006.2,247382.21
250080,202304,420,332,88,432272.61,114576.68,546849.29
250090,202304,229,144,85,187488.92,110670,298158.92
250100,202304,622,493,129,641893.87,167959.8,809853.67
250110,202304,733,527,206,687476.31,272119.68,959595.99
250115,202304,14,4,10,5208.18,13020.26,18228.44
250120,202304,127,92,35,119784.4,45571.63,165356.03
250130,202304,596,488,108,635396.48,140617.96,776014.44
250135,202304,34,15,19,19530.59,24738,44268.59
250140,202304,90,77,13,100256.75,16926,117182.75
250150,202304,685,476,209,619764.75,272120,891884.75
250153,202304,20,17,3,22134.48,3906,26040.48
250157,202304,39,32,7,41664.42,9114,50778.42
250160,202304,258,194,64,252591.92,83328,335919.92
250170,202304,93,61,32,79422.2,41664,121086.2
250180,202304,5307,3674,1633,4783828.79,2128833.27,6912662.06
250190,202304,823,556,267,723920.67,347637.73,1071558.40
250200,202304,73,57,16,74215.35,20832.7,95048.05
250205,202304,23,18,5,23436.61,6510,29946.61
250210,202304,93,78,15,101557.96,19530,121087.96
250215,202304,96,62,34,80724.02,44268.3,124992.32
250220,202304,31,20,11,26040.86,14322,40362.86
250230,202304,81,71,10,92442.56,13020.2,105462.76
250240,202304,260,192,68,249988.03,88536.2,338524.23
250250,202304,431,367,64,477847.68,83328,561175.68
250260,202304,55,45,10,58590.1,13020,71610.1
250270,202304,83,58,25,75517.67,32550,108067.67
250280,202304,412,335,77,437477.41,100254,537731.41
250290,202304,117,104,13,135408,16926.82,152334.82
250300,202304,529,357,172,464827.52,223945.69,688773.21
250310,202304,56,50,6,65101.83,7812,72913.83
250320,202304,2197,1456,741,1897112.82,966109.19,2863222.01
250330,202304,122,105,17,136712.84,22134.1,158846.94
250340,202304,33,27,6,35154.7,7812,42966.7
250350,202304,211,140,71,182284.3,92442,274726.3
250355,202304,43,34,9,44268,11718.25,55986.25
250360,202304,196,162,34,210929.32,44269.57,255198.89
250370,202304,2529,1610,919,2096298.67,1196564.12,3292862.79
250375,202304,17,11,6,14322.36,7812.1,22134.46
250380,202304,56,48,8,62496.26,10416.22,72912.48
250390,202304,52,42,10,54684.96,13020,67704.96
250400,202304,18719,9626,9093,12541450.8,11858892.78,24400343.58
250403,202304,305,234,71,304671.41,92442,397113.41
250407,202304,69,55,14,71610.1,18228.85,89838.95
250410,202304,32,27,5,35154.31,6510.8,41665.11
250415,202304,51,32,19,41664,24738,66402
250420,202304,41,35,6,45570.3,7812,53382.3
250430,202304,1573,1364,209,1777603.83,272119.01,2049722.84
250435,202304,39,29,10,37759.71,13020,50779.71
250440,202304,699,572,127,744753.11,165355,910108.11
250450,202304,92,70,22,91141.44,28644,119785.44
250460,202304,515,340,175,442685.46,227852.04,670537.50
250470,202304,106,74,32,96349.5,42966.6,139316.1
250480,202304,353,277,76,360665.51,98952.98,459618.49
250485,202304,6,5,1,6510,1302,7812
250490,202304,261,207,54,269518.25,70309.11,339827.36
250500,202304,105,80,25,104160.6,32550,136710.6
250510,202304,891,707,184,920525.26,239568.74,1160094.00
250520,202304,174,120,54,156240.48,71610,227850.48
250523,202304,133,107,26,139314.43,33852.12,173166.55
250527,202304,123,91,32,118482.45,41664,160146.45
250530,202304,12,8,4,10416,5208,15624
250535,202304,30,23,7,29946,9114,39060
250540,202304,148,117,31,152334.52,40362,192696.52
250550,202304,75,73,2,95047.19,2604,97651.19
250560,202304,68,40,28,52080.84,36456.07,88536.91
250570,202304,168,138,30,179677.4,39060.7,218738.1
250580,202304,98,77,21,100338.2,27342,127680.2
250590,202304,23,15,8,19530,10416,29946
250600,202304,1711,1132,579,1475200.42,753861.91,2229062.33
250610,202304,159,125,34,162760.14,44268.22,207028.36
250620,202304,24,20,4,26040.81,5208,31248.81
250625,202304,71,54,17,70310.5,22134.77,92445.27
250630,202304,3258,2019,1239,2629062.72,1613202.23,4242264.95
250640,202304,198,156,42,203117.7,54685.45,257803.15
250650,202304,33,21,12,27342.02,15624.53,42966.55
250660,202304,67,49,18,63798,23436,87234
250670,202304,83,66,17,85933.17,22134.94,108068.11
250680,202304,442,357,85,464826.49,110670.59,575497.08
250690,202304,2333,1577,756,2054610.54,984328,3038938.54
250700,202304,991,836,155,1088488.67,201810.2,1290298.87
250710,202304,518,398,120,518230.46,156245.62,674476.08
250720,202304,124,90,34,117180.95,44268,161448.95
250730,202304,428,352,76,458310.74,98953.92,557264.66
250740,202304,70,63,7,82027.5,9114,91141.5
250750,202304,26637,15586,11051,20296459.19,14413536.5,34709995.69
250760,202304,126,98,28,127596.5,36457.04,164053.54
250770,202304,390,259,131,337226.91,170562.7,507789.61
250780,202304,79,52,27,67705.57,35154,102859.57
250790,202304,472,291,181,380190.74,235664.26,615855.00
250800,202304,156,140,16,182280,20832,203112
250810,202304,74,61,13,79422,16926,96348
250820,202304,161,131,30,170564.05,39060,209624.05
250830,202304,514,331,183,430976.33,238268.73,669245.06
250840,202304,64,54,10,70309.65,13020.2,83329.85
250850,202304,75,62,13,80724.2,16926,97650.2
250855,202304,16,13,3,16926.2,3906,20832.2
250860,202304,249,162,87,210925.04,113274,324199.04
250870,202304,33,30,3,39060,3906,42966
250880,202304,97,74,23,96348.46,29946,126294.46
250890,202304,3410,2501,909,3256394.38,1183535.6,4439929.98
250900,202304,69,57,12,74214.7,15624,89838.7
250905,202304,131,96,35,124992.9,45570,170562.9
250910,202304,1020,746,274,971317.57,356753.88,1328071.45
250915,202304,122,83,39,108067.54,50779.98,158847.52
250920,202304,157,117,40,152334,52080.7,204414.7
250930,202304,206,118,88,153636.34,114577.1,268213.44
250933,202304,12,8,4,10416,5208.07,15624.07
250937,202304,20,19,1,24738,1302,26040
250939,202304,42,32,10,41664.79,13020,54684.79
250940,202304,140,103,37,134107.93,48174.23,182282.16
250950,202304,87,63,24,82029.18,31248,113277.18
250960,202304,89,52,37,67706.64,48174.3,115880.94
250970,202304,1363,967,396,1262966.45,516898.07,1779864.52
250980,202304,100,67,33,87234.82,42966,130200.82
250990,202304,177,137,40,178374.96,52080,230454.96
251000,202304,90,75,15,97650,19530,117180
251010,202304,144,100,44,130200.1,57288,187488.1
251020,202304,95,79,16,102858,20832,123690
251030,202304,52,37,15,48174.84,19530,67704.84
251040,202304,72,51,21,66402,27342,93744
251050,202304,30,25,5,32550,6510,39060
251060,202304,51,40,11,52081.1,14322.64,66403.74
251065,202304,6,3,3,3906,3906,7812
251070,202304,19,17,2,22135.53,2604,24739.53
251080,202304,5870,2721,3149,3544217.79,4102694.55,7646912.34
251090,202304,199,166,33,216133.11,42966,259099.11
251100,202304,23,22,1,28644.52,1302,29946.52
251110,202304,67,44,23,57288,29946,87234
251120,202304,2057,1275,782,1661435.18,1019486.83,2680922.01
251130,202304,463,380,83,494766.97,108066.05,602833.02
251140,202304,659,432,227,562469.04,295555.5,858024.54
251150,202304,356,297,59,386699.86,76818.94,463518.80
251160,202304,102,84,18,109368.31,23436,132804.31
251170,202304,84,70,14,91140.26,18228,109368.26
251180,202304,308,178,130,231761.3,170564.45,402325.75
251190,202304,112,85,27,110673.34,35155.42,145828.76
251200,202304,325,252,73,328114.77,95046.44,423161.21
251203,202304,33,30,3,39060.69,3906,42966.69
251207,202304,88,71,17,92442.69,22134,114576.69
251210,202304,1658,1204,454,1567636.92,592416.84,2160053.76
251220,202304,52,39,13,50778.08,16926,67704.08
251230,202304,612,513,99,669237.78,128899.64,798137.42
251240,202304,125,89,36,115879.08,48174,164053.08
251250,202304,1691,1214,477,1580568.12,621060.61,2201628.73
251260,202304,14,10,4,13020.25,5208.79,18229.04
251270,202304,331,261,70,339827.21,91140.69,430967.90
251272,202304,64,55,9,71610.2,11718,83328.2
251274,202304,25,18,7,23436.87,9114,32550.87
251275,202304,38,22,16,28644.92,20832,49476.92
251276,202304,29,23,6,31249.76,7812,39061.76
251278,202304,16,12,4,15625.24,5208,20833.24
251280,202304,122,117,5,152334.2,6510,158844.2
251290,202304,1203,849,354,1105475.83,462232.12,1567707.95
251300,202304,19,14,5,18228,6510,24738
251310,202304,329,235,94,305978.58,122389.42,428368.00
251315,202304,46,42,4,54684,5208,59892
251320,202304,77,62,15,80724.71,19530,100254.71
251330,202304,85,75,10,97650,13020,110670
251335,202304,21,14,7,18228,9114,27342
251340,202304,882,494,388,643205.55,507783.61,1150989.16
251350,202304,38,36,2,46872,2604,49476
251360,202304,92,78,14,101556.2,18228,119784.2
251365,202304,7,7,0,9115.83,,9115.83
251370,202304,6377,4326,2051,5633952.16,2673046.51,8306998.67
251380,202304,48,37,11,48174.54,14322,62496.54
251385,202304,3,3,0,3906,,3906.0
251390,202304,1072,783,289,1019493.6,376286.57,1395780.17
251392,202304,40,27,13,35154.5,16926,52080.5
251394,202304,17,12,5,15624.6,6510,22134.6
251396,202304,12,7,5,9114,6510.2,15624.2
251398,202304,21,17,4,22134.04,5208,27342.04
251400,202304,55,43,12,55986,15624,71610
251410,202304,47,38,9,49476.7,11718,61194.7
251420,202304,115,82,33,106765.84,42966.97,149732.81
251430,202304,52,45,7,58590.55,9114,67704.55
251440,202304,55,29,26,37758,33852,71610
251445,202304,68,59,9,76822.29,11718,88540.29
251450,202304,410,348,62,453108.72,80725.18,533833.90
251455,202304,7,6,1,7812,1302,9114
251460,202304,25,19,6,24738,7812.02,32550.02
251465,202304,11,7,4,9114,5208,14322
251470,202304,52,38,14,49476,18228,67704
251480,202304,26,22,4,28644.62,5208.26,33852.88
251490,202304,119,67,52,87237.08,67705.01,154942.09
251500,202304,109,88,21,114577.23,27342,141919.23
251510,202304,103,65,38,84630.67,49476.62,134107.29
251520,202304,42,34,8,44268,10416,54684
251530,202304,4497,3159,1338,4113096.52,1743389.93,5856486.45
251540,202304,100,81,19,105462.8,24739.11,130201.91
251550,202304,448,341,107,444001.44,139318.06,583319.50
251560,202304,25,19,6,24738.1,7812,32550.1
251570,202304,16,15,1,19530,1302,20832
251580,202304,131,101,30,131503.79,39060,170563.79
251590,202304,107,77,30,100254.2,39060.8,139315.0
251593,202304,31,17,14,22134.93,18228,40362.93
251597,202304,134,107,27,139314.8,35154.98,174469.78
251600,202304,1146,790,356,1028603.2,464817.12,1493420.32
251610,202304,276,200,76,260407,98952.2,359359.2
251615,202304,22,18,4,23436,5208,28644
251620,202304,4331,2742,1589,3572785.25,2068910.35,5641695.60
251630,202304,507,371,136,483064.6,177076.89,660141.49
251640,202304,111,80,31,104165.28,40362,144527.28
251650,202304,318,231,87,300766.66,113274.2,414040.86
251660,202304,209,185,24,240875.39,31248.3,272123.69
251670,202304,436,330,106,429667.74,139314.98,568982.72
251675,202304,15,10,5,13020,6510,19530
251680,202304,109,95,14,123690.99,18228,141918.99
251690,202304,333,273,60,355781.88,78120.2,433902.08
251700,202304,288,243,45,316389.93,58590,374979.93
251710,202304,22,15,7,19530.41,9114,28644.41
251720,202304,36,26,10,33852,13020,46872
251740,202304,13,10,3,13020.3,3906,16926.3
260005,202304,4002,2063,1939,2686881.21,2529841.19,5216722.40
260010,202304,1870,1394,476,1816324.91,622362.25,2438687.16
260020,202304,434,378,56,492164.03,74214.9,566378.93
260030,202304,656,443,213,576800.69,278630,855430.69
260040,202304,814,515,299,670553.43,389301.62,1059855.05
260050,202304,1189,864,325,1124953.11,423153.82,1548106.93
260060,202304,373,341,32,443996.69,41664,485660.69
260070,202304,1394,849,545,1105456.73,709614.74,1815071.47
260080,202304,784,583,201,759082.93,263004,1022086.93
260090,202304,481,314,167,408831.95,217434.6,626266.55
260100,202304,231,154,77,200510.27,100254,300764.27
260105,202304,294,174,120,226549.56,157542.1,384091.66
260110,202304,3183,2298,885,2992053.67,1153583.57,4145637.24
260120,202304,2895,1542,1353,2008088.54,1764235.01,3772323.55
260130,202304,221,157,64,204417.81,83328,287745.81
260140,202304,2396,1535,861,2001223.37,1124941.23,3126164.60
260150,202304,198,129,69,167959.03,89839.4,257798.43
260160,202304,370,288,82,374987.74,106766.96,481754.70
260170,202304,3627,2166,1461,2822820.71,1903556.29,4726377.00
260180,202304,184,156,28,203117.2,36456.78,239573.98
260190,202304,2645,1706,939,2222556.92,1222584.19,3445141.11
260200,202304,1057,822,235,1070268.45,305972.07,1376240.52
260210,202304,1448,1042,406,1358027.02,529918.37,1887945.39
260220,202304,646,574,72,748666.52,93745.67,842412.19
260230,202304,1392,1015,377,1324177.17,490864.05,1815041.22
260240,202304,222,168,54,218742.09,70310.23,289052.32
260250,202304,106,82,24,106764.15,31248,138012.15
260260,202304,1162,807,355,1052029.68,462212.98,1514242.66
260270,202304,262,186,76,242176.75,98952,341128.75
260280,202304,1212,957,255,1248645.47,332015.84,1580661.31
260290,202304,7587,4058,3529,5290190.43,4598704.24,9888894.67
260300,202304,1116,937,179,1221332.18,233061.19,1454393.37
260310,202304,557,439,118,572890.89,153636.1,726526.99
260320,202304,846,609,237,792921.01,309876.99,1102798.00
260330,202304,92,70,22,91140.3,28644.3,119784.6
260340,202304,88,65,23,84630.65,29946,114576.65
260345,202304,6376,3241,3135,4219952.16,4084433.16,8304385.32
260350,202304,509,361,148,470035.47,192697.09,662732.56
260360,202304,259,150,109,195301.34,141918.4,337219.74
260370,202304,750,486,264,632785.38,345032.38,977817.76
260380,202304,564,405,159,528622.89,207020.19,735643.08
260390,202304,297,252,45,328109.83,58590,386699.83
260392,202304,131,111,20,144524.95,26041.01,170565.96
260400,202304,4774,2718,2056,3538906.8,2678234.82,6217141.62
260410,202304,16481,8470,8011,11030878.2,10442133.34,21473011.54
260415,202304,163,133,30,173166.96,39060,212226.96
260420,202304,1894,1197,697,1558529.67,908799.01,2467328.68
260430,202304,177,158,19,205723.81,24738.7,230462.51
260440,202304,214,142,72,184889.33,93744.41,278633.74
260450,202304,451,340,111,442692.85,144523.05,587215.90
260460,202304,916,483,433,630184.53,563772.43,1193956.96
260470,202304,342,210,132,273425.66,171865.83,445291.49
260480,202304,276,173,103,225246.19,134106.6,359352.79
260490,202304,241,182,59,236965.2,76818,313783.2
260500,202304,1225,814,411,1059852.15,535127.95,1594980.10
260510,202304,884,705,179,919231.26,233059.07,1152290.33
260515,202304,254,233,21,303368.65,27342.91,330711.56
260520,202304,3392,2073,1319,2700356.05,1717361.58,4417717.63
260530,202304,905,717,188,933571.88,244776.8,1178348.68
260540,202304,582,453,129,589817.2,167959.36,757776.56
260545,202304,32,17,15,22135.3,19530.27,41665.57
260550,202304,367,237,130,308576.34,169260.11,477836.45
260560,202304,514,394,120,513002.42,158845.83,671848.25
260570,202304,1078,864,214,1124967.97,279931.9,1404899.87
260580,202304,368,291,77,378884.38,100254,479138.38
260590,202304,647,379,268,493461.09,348936.4,842397.49
260600,202304,8377,4883,3494,6357822.72,4555739.86,10913562.58
260610,202304,524,354,170,460920.2,221344.21,682264.41
260620,202304,4065,2121,1944,2761645.08,2531270.54,5292915.62
260630,202304,85,74,11,96348.49,14322,110670.49
260640,202304,3561,2145,1416,2792856.32,1846255.68,4639112.00
260650,202304,334,244,90,317694.08,117180.4,434874.48
260660,202304,636,420,216,546860.1,281236.39,828096.49
260670,202304,115,81,34,105462,44268.12,149730.12
260680,202304,4420,2357,2063,3071552.17,2689979.05,5761531.22
260690,202304,144,110,34,143220.74,44268,187488.74
260700,202304,336,231,105,300768.54,138012.69,438781.23
260710,202304,53,44,9,57288,11718,69006
260720,202304,2895,1681,1214,2188698.7,1583237.98,3771936.68
260730,202304,811,596,215,776004.85,279931.17,1055936.02
260740,202304,79,66,13,85932.82,16926,102858.82
260750,202304,573,429,144,558568.95,187488.82,746057.77
260760,202304,816,402,414,524731.51,539041.64,1063773.15
260765,202304,1088,569,519,740852.85,675747.54,1416600.39
260770,202304,233,167,66,217416.28,85933.28,303349.56
260775,202304,929,470,459,611959.96,598929.25,1210889.21
260780,202304,244,147,97,191395.56,126294,317689.56
260790,202304,17337,8317,9020,10838266.09,11746770.65,22585036.74
260795,202304,160,103,57,134106.62,75516,209622.62
260800,202304,318,261,57,339826.42,74214.46,414040.88
260805,202304,43,29,14,37760.24,18228.5,55988.74
260810,202304,903,715,188,930939.19,244776.62,1175715.81
260820,202304,329,216,113,281234.83,147126,428360.83
260825,202304,222,152,70,197905.02,91140,289045.02
260830,202304,315,201,114,261702,148428,410130
260840,202304,290,208,82,270819.67,106764.88,377584.55
260845,202304,216,127,89,165356.3,115879.83,281236.13
260850,202304,441,330,111,429666.83,144522,574188.83
260860,202304,249,186,63,242174.97,82026,324200.97
260870,202304,358,279,79,363263.51,102858,466121.51
260875,202304,792,571,221,743484.97,287742.96,1031227.93
260880,202304,1734,1145,589,1490818.8,766879.52,2257698.32
260890,202304,2702,1844,858,2400941.61,1121031.34,3521972.95
260900,202304,1089,809,280,1054635.4,364561.46,1419196.86
260910,202304,260,207,53,269519.62,69006.6,338526.22
260915,202304,290,218,72,283836.7,93744,377580.7
260920,202304,244,135,109,175770.2,141918,317688.2
260930,202304,370,315,55,410140.93,71610.86,481751.79
260940,202304,2722,1448,1274,1889279.51,1662677.13,3551956.64
260950,202304,2114,1193,921,1553332.93,1199162.64,2752495.57
260960,202304,15155,7214,7941,9398371.2,10352435.71,19750806.91
260970,202304,465,371,94,483048.54,122388,605436.54
260980,202304,225,204,21,266914.18,27342.1,294256.28
260990,202304,2852,2250,602,2933495.05,786415.15,3719910.20
261000,202304,4453,2753,1700,3584466.33,2213418.07,5797884.40
261010,202304,137,102,35,132805.26,45570,178375.26
261020,202304,637,459,178,597630.11,231756.1,829386.21
261030,202304,264,196,68,256496.19,88536,345032.19
261040,202304,397,331,66,430971.84,85932,516903.84
261050,202304,566,463,103,602836.66,134107.93,736944.59
261060,202304,1737,1078,659,1403575.43,858021.52,2261596.95
261070,202304,10738,5009,5729,6524721.62,7464600.69,13989322.31
261080,202304,380,296,84,385399.74,109368,494767.74
261090,202304,2198,1684,514,2192661.46,669233.38,2861894.84
261100,202304,1304,891,413,1161415.66,539034.33,1700449.99
261110,202304,10155,6339,3816,8253790.43,4968529.47,13222319.90
261120,202304,235,198,37,257797.3,48174,305971.3
261130,202304,588,347,241,453110.14,313790.51,766900.65
261140,202304,227,143,84,186186.75,109368.37,295555.12
261150,202304,681,444,237,578092.18,308574.8,886666.98
261153,202304,76,71,5,92442.7,6510,98952.7
261160,202304,82779,40071,42708,52204093.8,55659019.04,107863112.84
261170,202304,521,387,134,505177.28,174468.65,679645.93
261180,202304,1887,1180,707,1536693.33,921825.71,2458519.04
261190,202304,624,422,202,549453.77,263006.77,812460.54
261200,202304,227,178,49,231762.69,63798.36,295561.05
261210,202304,48,35,13,45570.1,16926,62496.1
261220,202304,3027,2095,932,2727767.35,1213481.52,3941248.87
261230,202304,392,290,102,377586.76,134106.97,511693.73
261240,202304,441,378,63,493470.47,82026.97,575497.44
261245,202304,270,231,39,300762.31,50778,351540.31
261247,202304,182,138,44,179678.37,57288,236966.37
261250,202304,4161,1989,2172,2591033.51,2827965.2,5418998.71
261255,202304,262,231,31,300762.52,40362,341124.52
261260,202304,890,760,130,989577.6,169262.99,1158840.59
261270,202304,213,149,64,193998.83,83328,277326.83
261280,202304,205,166,39,216134.77,50778.15,266912.92
261290,202304,109,76,33,98952.24,42966.2,141918.44
261300,202304,1500,1120,380,1459582.26,494765.79,1954348.05
261310,202304,879,577,302,751269.9,394508.35,1145778.25
261320,202304,532,368,164,479149.63,213530.45,692680.08
261330,202304,929,732,197,953111.74,256503.95,1209615.69
261340,202304,353,195,158,253893.05,208321.8,462214.85
261350,202304,985,680,305,886694.52,397121.15,1283815.67
261360,202304,1475,920,555,1197848.04,723917.98,1921766.02
261370,202304,5371,3123,2248,4072771.05,2934751.21,7007522.26
261380,202304,607,474,133,617156.45,173166,790322.45
261390,202304,4065,2764,1301,3598877.19,1693941.19,5292818.38
261400,202304,289,255,34,332017.62,44268.74,376286.36
261410,202304,1201,782,419,1019495.52,545542.14,1565037.66
261420,202304,1029,625,404,815068.55,526012.08,1341080.63
261430,202304,336,301,35,391907.18,45570,437477.18
261440,202304,107,100,7,130203.14,9114,139317.14
261450,202304,2731,2101,630,2738158.61,821568.69,3559727.30
261460,202304,839,643,196,837210.21,255194.44,1092404.65
261470,202304,242,192,50,249985.43,65100.42,315085.85
261480,202304,502,373,129,486961.3,167901.08,654862.38
261485,202304,421,246,175,320301.95,227851,548152.95
261500,202304,670,429,241,558568.37,313783.9,872352.27
261510,202304,52,34,18,44268.98,23436.1,67705.08
261520,202304,107,91,16,118484.34,20832.2,139316.54
261530,202304,4577,2951,1626,3844880.91,2118372.86,5963253.77
261540,202304,1630,937,693,1220002.42,902296.18,2122298.60
261550,202304,275,129,146,167959,190092,358051
261560,202304,1038,680,358,885383.08,466123.07,1351506.15
261570,202304,419,337,82,438782.3,106764.95,545547.25
261580,202304,417,329,88,428365.97,114576.61,542942.58
261590,202304,210,165,45,214837.63,58591.1,273428.73
261600,202304,341,262,79,341130.85,102858.75,443989.60
261610,202304,101,83,18,108067.46,23436,131503.46
261618,202304,87,61,26,79422.48,33852,113274.48
261620,202304,213,137,76,178376.96,98952.97,277329.93
261630,202304,710,552,158,718710.83,205718.97,924429.80
261640,202304,7295,3850,3445,5019376.42,4488069.93,9507446.35
261650,202304,465,295,170,384092.4,221340.3,605432.7
270010,202304,523,461,62,600240.38,80724.88,680965.26
270020,202304,260,212,48,276029.95,62496.67,338526.62
270030,202304,9658,6173,3485,8040081.91,4540075.3,12580157.21
270040,202304,2158,1437,721,1871020.12,938749.59,2809769.71
270050,202304,246,190,56,247384.33,72912.94,320297.27
270060,202304,69,48,21,62501.77,27342.33,89844.10
270070,202304,808,596,212,777434.78,276025.4,1053460.18
270080,202304,55,43,12,55986.1,15624,71610.1
270090,202304,21,16,5,20832,6510,27342
270100,202304,1375,938,437,1221303.98,568976.57,1790280.55
270110,202304,61,50,11,66402,14322,80724
270120,202304,271,220,51,286449.91,66402.48,352852.39
270130,202304,329,251,78,328108.25,101556,429664.25
270135,202304,123,88,35,114577.4,45570,160147.4
270140,202304,1475,988,487,1286414.72,636689.01,1923103.73
270150,202304,269,192,77,249988.75,100255.03,350243.78
270160,202304,488,387,101,503918.2,131505.36,635423.56
270170,202304,836,557,279,725222.88,363259.67,1088482.55
270180,202304,60,46,14,59892.7,18228.1,78120.8
270190,202304,115,99,16,128902.09,20832,149734.09
270200,202304,119,103,16,135408.02,20832,156240.02
270210,202304,566,358,208,466120.22,270817.3,736937.52
270220,202304,198,140,58,182280.65,75516.88,257797.53
270230,202304,2286,1466,820,1910077.72,1067645.18,2977722.90
270235,202304,505,396,109,515615.67,141918,657533.67
270240,202304,3426,2706,720,3523273.6,937444.75,4460718.35
270250,202304,125,96,29,124995.39,39060,164055.39
270255,202304,215,180,35,234362.63,45570.44,279933.07
270260,202304,423,334,89,434882.93,115878.7,550761.63
270270,202304,96,52,44,67704.12,57288,124992.12
270280,202304,198,127,71,165354,92442,257796
270290,202304,1163,913,250,1189355.22,325503.86,1514859.08
270300,202304,386,283,103,368466.78,134106.2,502572.98
270310,202304,833,695,138,904914.73,179676.86,1084591.59
270320,202304,772,667,105,868448.8,136710,1005158.8
270330,202304,329,283,46,368466.62,59892,428358.62
270340,202304,70,58,12,75516,15624,91140
270350,202304,84,50,34,65103.15,44268,109371.15
270360,202304,84,48,36,62496,46872,109368
270370,202304,68,54,14,70308,18228,88536
270375,202304,85,54,31,70309.42,40362,110671.42
270380,202304,1072,742,330,966085.03,429660.67,1395745.70
270390,202304,134,80,54,104160.2,70308.5,174468.7
270400,202304,791,616,175,802045.62,229152.92,1031198.54
270410,202304,219,165,54,216141.53,70308,286449.53
270420,202304,423,299,124,389301.81,162751.59,552053.40
270430,202304,36660,25986,10674,33862551.59,13918723.81,47781275.40
270440,202304,468,370,98,481754.23,127597.5,609351.73
270450,202304,912,548,364,713502.56,473929.41,1187431.97
270460,202304,183,144,39,187492.36,50778,238270.36
270470,202304,1752,1222,530,1593682.75,692667.57,2286350.32
270480,202304,576,466,110,606744.4,143220.76,749965.16
270490,202304,24,19,5,24738,6510,31248
270500,202304,480,395,85,514296.61,110670,624966.61
270510,202304,926,622,304,809796.72,395810.13,1205606.85
270520,202304,272,183,89,238267.52,115878,354145.52
270530,202304,65,53,12,69006.83,15624,84630.83
270540,202304,83,59,24,76818,31248,108066
270550,202304,1667,1283,384,1671805.72,499969.33,2171775.05
270560,202304,259,156,103,203115.7,134107.71,337223.41
270570,202304,613,440,173,572884.88,225246,798130.88
270580,202304,21,16,5,20832,6510,27342
270590,202304,55,43,12,55986.3,15624.08,71610.38
270600,202304,167,140,27,182287.58,35154.1,217441.68
270610,202304,255,203,52,264310.13,67704.1,332014.23
270620,202304,17,17,0,22134,,22134.0
270630,202304,3724,2780,944,3622281.28,1229099.86,4851381.14
270640,202304,913,676,237,880167.47,309878.37,1190045.84
270642,202304,214,177,37,230456.48,48174,278630.48
270644,202304,262,168,94,218739.56,123692.69,342432.25
270650,202304,353,218,135,285143.95,175772.06,460916.01
270660,202304,198,174,24,226561.45,31248.15,257809.60
270670,202304,3060,2339,721,3045445.06,941349.28,3986794.34
270680,202304,404,267,137,347642.1,178374,526016.1
270690,202304,1265,856,409,1115888.27,532521.39,1648409.66
270700,202304,25,19,6,24738.19,7812,32550.19
270710,202304,566,446,120,580700.34,157542,738242.34
270720,202304,226,183,43,239571.35,55986.72,295558.07
270730,202304,1984,1257,727,1636646.25,947863.29,2584509.54
270740,202304,32,23,9,29946.62,11718,41664.62
270750,202304,628,486,142,632781.45,184885.09,817666.54
270760,202304,293,214,79,278635.46,102858.76,381494.22
270770,202304,2962,2043,919,2662325.92,1201755.06,3864080.98
270780,202304,68,41,27,53382,35154.75,88536.75
270790,202304,196,124,72,161450.5,93745.32,255195.82
270800,202304,2076,1672,404,2178288.43,527310,2705598.43
270810,202304,211,170,41,221341.48,53382,274723.48
270820,202304,121,82,39,106768.36,50778,157546.36
270830,202304,877,675,202,880182.93,263005.3,1143188.23
270840,202304,1344,1046,298,1361912.23,387997.36,1749909.59
270850,202304,1588,1044,544,1359301.56,708291.36,2067592.92
270860,202304,2700,1837,863,2393119.29,1124939.74,3518059.03
270870,202304,133,79,54,102858.36,70308.2,173166.56
270880,202304,863,684,179,891897.15,233060.4,1124957.55
270890,202304,255,199,56,259100.04,72913.17,332013.21
270895,202304,77,73,4,95046,5208,100254
270900,202304,67,56,11,72913.83,14322,87235.83
270910,202304,311,260,51,338529.21,66403.54,404932.75
270915,202304,1995,1345,650,1753485.67,847605.87,2601091.54
270920,202304,390,325,65,423155.01,84630,507785.01
270930,202304,5612,4348,1264,5666433.41,1652245.66,7318679.07
270940,202304,2243,1800,443,2344949.26,576788.73,2921737.99
280010,202304,33,27,6,35154.2,7812,42966.2
280020,202304,528,443,85,576801.81,110670.97,687472.78
280030,202304,23229,14916,8313,19429553.09,10839464.6,30269017.69
280040,202304,348,213,135,277330.23,175770.6,453100.83
280050,202304,456,349,107,454406.89,139314,593720.89
280060,202304,419,273,146,355456.26,190093.17,545549.43
280067,202304,1188,859,329,1118437.28,428359.06,1546796.34
280070,202304,127,109,18,141920.68,23436,165356.68
280100,202304,711,545,166,709601.22,216133.02,925734.24
280110,202304,91,79,12,102860.15,15624,118484.15
280120,202304,721,599,122,779909.14,158845.56,938754.70
280130,202304,1870,1226,644,1596275.83,838490.25,2434766.08
280140,202304,534,443,91,576792.88,118482.2,695275.08
280150,202304,442,319,123,416652.28,160146,576798.28
280160,202304,151,113,38,147128.05,49476,196604.05
280170,202304,443,312,131,406236.09,170562.93,576799.02
280190,202304,33,24,9,31248,11718,42966
280200,202304,52,41,11,53387.74,14322.3,67710.04
280210,202304,3171,2270,901,2955522.55,1174413.28,4129935.83
280220,202304,64,53,11,70309.38,14322,84631.38
280230,202304,340,274,66,356763.25,85933.99,442697.24
280240,202304,140,130,10,169263.96,13020,182283.96
280250,202304,23,13,10,16927.09,13021.37,29948.46
280260,202304,80,71,9,92445.15,11718,104163.15
280270,202304,143,111,32,144522.58,41664.75,186187.33
280280,202304,190,128,62,166659.84,80724.09,247383.93
280290,202304,4059,2944,1115,3833163.39,1451746.36,5284909.75
280300,202304,1766,1407,359,1834547.7,467422.72,2301970.42
280310,202304,107,99,8,128900.67,10416,139316.67
280320,202304,720,493,227,641909.82,295556.33,937466.15
280330,202304,332,243,89,316394.07,115878.2,432272.27
280340,202304,445,371,74,483051.05,96349.1,579400.15
280350,202304,3972,3037,935,3954358.36,1217386.66,5171745.02
280360,202304,496,339,157,441392.99,204414.78,645807.77
280370,202304,93,78,15,101556.93,19530,121086.93
280380,202304,51,40,11,52080,14322,66402
280390,202304,178,150,28,195302.33,36456,231758.33
280400,202304,435,283,152,368481.13,197907.01,566388.14
280410,202304,309,260,49,338529.16,63798,402327.16
280420,202304,145,125,20,162762,26040.95,188802.95
280430,202304,107,87,20,113275.44,26040,139315.44
280440,202304,743,609,134,792941.63,174471.08,967412.71
280445,202304,123,112,11,145826.45,14322.8,160149.25
280450,202304,1391,1187,204,1546811.2,265612.98,1812424.18
280460,202304,717,531,186,693982.72,242173.49,936156.21
280470,202304,104,96,8,124995.19,10416,135411.19
280480,202304,3426,2288,1138,2980506.22,1481721.67,4462227.89
280490,202304,211,200,11,260413.31,14322,274735.31
280500,202304,41,37,4,48175.05,5208.99,53384.04
280510,202304,141,110,31,143221.21,40363.44,183584.65
280520,202304,54,39,15,50779.29,19530,70309.29
280530,202304,74,47,27,61197.51,35154.38,96351.89
280540,202304,577,499,78,649706.65,101556,751262.65
280550,202304,781,717,64,933554.51,83328,1016882.51
280560,202304,496,449,47,584608.94,61195.48,645804.42
280570,202304,2512,1986,526,2585821.38,684856.67,3270678.05
280580,202304,620,486,134,634082.68,174468.96,808551.64
280590,202304,232,151,81,196618.67,105469.33,302088.00
280600,202304,427,348,79,453163.48,102858.8,556022.28
280610,202304,118,84,34,109373.96,44269.91,153643.87
280620,202304,572,466,106,608041.35,138012,746053.35
280630,202304,155,126,29,164055.37,37758.9,201814.27
280640,202304,177,143,34,186186.4,44268,230454.4
280650,202304,87,53,34,69007.58,44268.07,113275.65
280660,202304,124,93,31,121092.11,40362.21,161454.32
280670,202304,2160,1380,780,1798194.01,1016891.09,2815085.10
280680,202304,253,214,39,278630.41,50778,329408.41
280690,202304,79,69,10,89838,13020,102858
280700,202304,22,22,0,28644,,28644.0
280710,202304,1607,1241,366,1617116.9,476534.44,2093651.34
280720,202304,138,97,41,126297.34,53382,179679.34
280730,202304,32,28,4,36457.62,5208.05,41665.67
280740,202304,2696,2031,665,2644399.11,867135.35,3511534.46
280750,202304,236,207,29,269523.55,37759.12,307282.67
280760,202304,992,665,327,865856.02,425755.86,1291611.88
290010,202304,201,141,60,183582.96,78120,261702.96
290020,202304,202,177,25,230457.05,32550.9,263007.95
290030,202304,642,413,229,537734.7,298158.95,835893.65
290035,202304,138,111,27,144523.31,35154.93,179678.24
290040,202304,271,192,79,249992.12,102858,352850.12
290050,202304,94,75,19,97650,24738,122388
290060,202304,252,109,143,141919.05,187488.2,329407.25
290070,202304,6407,3031,3376,3949109.64,4396911.8,8346021.44
290080,202304,495,219,276,285140.72,359352.09,644492.81
290090,202304,332,153,179,199206.2,233058.36,432264.56
290100,202304,1797,1138,659,1481708.41,859324.54,2341032.95
290110,202304,932,524,408,683580.45,532527.95,1216108.40
290115,202304,182,167,15,217438.11,19530,236968.11
290120,202304,854,578,276,752567.68,359354.24,1111921.92
290130,202304,489,298,191,388000.21,248682.53,636682.74
290135,202304,298,224,74,291653.46,96348.1,388001.56
290140,202304,333,279,54,363264.37,70308.36,433572.73
290150,202304,151,102,49,132804,63798.01,196602.01
290160,202304,246,190,56,247388.91,72912.8,320301.71
290170,202304,111,81,30,105463.24,39060,144523.24
290180,202304,205,147,58,191396.63,75516.4,266913.03
290190,202304,367,286,81,372385.1,105464.08,477849.18
290195,202304,313,213,100,277329.49,130200.1,407529.59
290200,202304,265,210,55,273420.49,71610.1,345030.59
290205,202304,160,98,62,127596.4,80724,208320.4
290210,202304,1324,965,359,1256465.95,467422.06,1723888.01
290220,202304,175,106,69,138017.96,89839.58,227857.54
290225,202304,297,116,181,151035.44,235663.85,386699.29
290230,202304,97,57,40,74215.98,52080,126295.98
290240,202304,382,131,251,171865.88,326803.22,498669.10
290250,202304,243,224,19,291655.11,24738,316393.11
290260,202304,359,282,77,368483.78,100258.68,468742.46
290265,202304,195,170,25,221344.54,32550.94,253895.48
290270,202304,1430,1179,251,1536419.95,326803.69,1863223.64
290280,202304,521,361,160,470029.02,208321.28,678350.30
290290,202304,1530,931,599,1212183.77,779900.09,1992083.86
290300,202304,393,333,60,433576.01,78121.67,511697.68
290310,202304,291,139,152,180978.89,197904,378882.89
290320,202304,4546,2699,1847,3518149.76,2404818.09,5922967.85
290323,202304,213,183,30,238273.27,39060.2,277333.47
290327,202304,171,133,38,173171.93,49476.13,222648.06
290330,202304,129,58,71,75516.48,92442,167958.48
290340,202304,803,338,465,440091.76,605433.54,1045525.30
290350,202304,703,419,284,546846.4,369770.67,916617.07
290360,202304,328,259,69,337226.95,89838.39,427065.34
290370,202304,898,411,487,535123.58,637981.61,1173105.19
290380,202304,355,228,127,296859.04,165355.69,462214.73
290390,202304,2555,1588,967,2067631.99,1260345.27,3327977.26
290395,202304,238,142,96,184885.17,124992,309877.17
290400,202304,305,222,83,289045.88,108066,397111.88
290405,202304,248,213,35,276070.55,45570,321640.55
290410,202304,682,567,115,738240.31,149730,887970.31
290420,202304,288,234,54,304670.53,70308,374978.53
290430,202304,519,330,189,429662.85,247380,677042.85
290440,202304,92,74,18,96348.4,23436,119784.4
290450,202304,200,144,56,187488.1,72912,260400.1
290460,202304,2090,1242,848,1617119.28,1104096.98,2721216.26
290470,202304,1408,627,781,816377.36,1022077.87,1838455.23
290475,202304,586,547,39,712208.98,50778,762986.98
290480,202304,194,112,82,145826.11,106764,252590.11
290485,202304,245,219,26,285140.47,33852,318992.47
290490,202304,1349,949,400,1235620.42,520803.9,1756424.32
290500,202304,854,464,390,604139.59,507782.81,1111922.40
290510,202304,188,153,35,199219.27,45570.35,244789.62
290515,202304,197,123,74,160148.48,96348,256496.48
290520,202304,1482,970,512,1262950.26,666625.1,1929575.36
290530,202304,281,249,32,324209.99,41664.93,365874.92
290540,202304,139,67,72,87234,93744,180978
290550,202304,179,147,32,191396.24,41664,233060.24
290560,202304,3335,1519,1816,1979091.25,2364447.3,4343538.55
290570,202304,7461,3497,3964,4554593.88,5171641.31,9726235.19
290580,202304,1349,811,538,1057241.24,701778.67,1759019.91
290590,202304,597,478,119,622391.71,154942.5,777334.21
290600,202304,1874,1277,597,1665325.17,777304.75,2442629.92
290610,202304,189,174,15,226560.55,19530,246090.55
290620,202304,395,348,47,453105.14,61194.6,514299.74
290630,202304,2084,887,1197,1154905.39,1559805.1,2714710.49
290640,202304,140,109,31,141922.45,40362.05,182284.50
290650,202304,2191,1020,1171,1328084.02,1525959.19,2854043.21
290660,202304,275,226,49,294252.34,63798.72,358051.06
290670,202304,1133,566,567,736949.11,738242.83,1475191.94
290680,202304,1330,1065,265,1386652.97,345034.1,1731687.07
290682,202304,364,268,96,348939.03,124992.38,473931.41
290685,202304,268,160,108,208324.39,140616.2,348940.59
290687,202304,1279,844,435,1100427.85,566371.67,1666799.52
290689,202304,147,74,73,97650,95046.31,192696.31
290690,202304,581,268,313,348944.16,407528.9,756473.06
290700,202304,267,134,133,174475.35,173169.04,347644.39
290710,202304,832,580,252,755174.86,328108.32,1083283.18
290720,202304,1152,913,239,1188767.92,311179.63,1499947.55
290730,202304,1298,770,528,1003865.82,687463,1691328.82
290740,202304,29,25,4,32550,5208,37758
290750,202304,1565,684,881,890596.73,1148383.29,2038980.02
290755,202304,85,71,14,92442,18228,110670
290760,202304,270,231,39,302077.16,50779.28,352856.44
290770,202304,194,185,9,240874.79,11718,252592.79
290780,202304,1176,944,232,1229114.12,302070.07,1531184.19
290790,202304,424,289,135,376284.48,175774.2,552058.68
290800,202304,2502,1020,1482,1329369.31,1929575.91,3258945.22
290810,202304,506,346,160,450499.4,208321.29,658820.69
290820,202304,428,243,185,316393.67,240874.29,557267.96
290830,202304,502,354,148,460914.01,192696.28,653610.29
290840,202304,1962,1234,728,1610622.46,950466.16,2561088.62
290850,202304,1107,572,535,746058.2,699180.51,1445238.71
290860,202304,727,356,371,463519.01,484346.22,947865.23
290870,202304,654,447,207,582004.02,269514.25,851518.27
290880,202304,125,65,60,84630.44,78120,162750.44
290890,202304,530,319,211,415343.16,274724.75,690067.91
290900,202304,164,127,37,165354.94,48174,213528.94
290910,202304,418,317,101,412735.55,131502,544237.55
290920,202304,216,193,23,251289.04,29946.6,281235.64
290930,202304,559,424,135,552063.1,175772.1,727835.2
290940,202304,225,191,34,248683,44268,292951
290950,202304,164,95,69,123691.5,91140,214831.5
290960,202304,521,374,147,486954.74,191394.95,678349.69
290970,202304,240,210,30,273421.87,39060.2,312482.07
290980,202304,2049,1442,607,1878836.07,792927.62,2671763.69
290990,202304,438,368,70,479159.77,91143.05,570302.82
291000,202304,962,315,647,410133,843696,1253829
291005,202304,2832,1198,1634,1563773.17,2128803.51,3692576.68
291010,202304,127,112,15,145824.94,19530,165354.94
291020,202304,89,71,18,92442,23436,115878
291030,202304,111,82,29,106765.88,37758,144523.88
291040,202304,661,393,268,511688.06,348936.78,860624.84
291050,202304,1622,843,779,1097611.05,1014267.91,2111878.96
291060,202304,1769,978,791,1275991.05,1031192.05,2307183.10
291070,202304,2082,1564,518,2037673.74,675746.88,2713420.62
291072,202304,7683,2952,4731,3843682.32,6166321.35,10010003.67
291075,202304,259,215,44,279930.6,57288,337218.6
291077,202304,62,43,19,55986,24738,80724
291080,202304,22912,9804,13108,12767908.95,17085107.11,29853016.06
291085,202304,291,237,54,308579.55,70308.65,378888.20
291090,202304,259,106,153,138014,199206,337220
291100,202304,978,337,641,438774.17,835884,1274658.17
291110,202304,456,346,110,450499.67,143220.6,593720.27
291120,202304,2517,1357,1160,1766842.63,1511629.76,3278472.39
291125,202304,69,34,35,44268,45570,89838
291130,202304,184,156,28,203116.58,36456,239572.58
291140,202304,136,110,26,143220.81,33852.7,177073.51
291150,202304,368,138,230,179677.1,299460,479137.1
291160,202304,406,322,84,419259.1,109369.57,528628.67
291165,202304,51,38,13,49476,16926.62,66402.62
291170,202304,3598,1786,1812,2326728.62,2361837.07,4688565.69
291180,202304,1278,549,729,714807.66,949160.19,1663967.85
291185,202304,118,109,9,141920.7,11718,153638.7
291190,202304,1441,697,744,907516.37,968698.47,1876214.84
291200,202304,180,131,49,170563.1,63798,234361.1
291210,202304,2543,1052,1491,1369733.14,1942594.11,3312327.25
291220,202304,334,257,77,334616.89,101556.2,436173.09
291230,202304,959,353,606,459615.82,791619.01,1251234.83
291240,202304,403,372,31,484348.05,40362,524710.05
291250,202304,413,337,76,438774.69,98952,537726.69
291260,202304,68,57,11,74214.1,14322,88536.1
291270,202304,1043,467,576,608076.21,751273.76,1359349.97
291280,202304,368,177,191,230457.02,248682.3,479139.32
291290,202304,1686,894,792,1164039.8,1033805.95,2197845.75
291300,202304,255,187,68,243477.05,88536,332013.05
291310,202304,231,199,32,260405.78,41664.7,302070.48
291320,202304,1324,923,401,1204390.31,522104.47,1726494.78
291330,202304,140,117,23,152336.92,29946.2,182283.12
291340,202304,246,152,94,197909.83,122389.67,320299.50
291345,202304,124,90,34,117180.4,44268,161448.4
291350,202304,1876,726,1150,946559.25,1498602.5,2445161.75
291360,202304,9146,4355,4791,5673096.37,6241923.27,11915019.64
291370,202304,1215,732,483,953108.86,631480.14,1584589.00
291380,202304,275,212,63,276025.12,82026,358051.12
291390,202304,4299,1916,2383,2495987.37,3105288.3,5601275.67
291400,202304,2183,1514,669,1972590.56,871050.71,2843641.27
291410,202304,240,198,42,257799.43,54684,312483.43
291420,202304,124,94,30,122388,39060,161448
291430,202304,188,116,72,151033.02,93744,244777.02
291440,202304,560,454,106,591122.65,138012.2,729134.85
291450,202304,1053,701,352,912729.62,458309.55,1371039.17
291460,202304,2174,1688,486,2197859.17,632787.16,2830646.33
291465,202304,2429,1173,1256,1527278.68,1635319.68,3162598.36
291470,202304,3062,1540,1522,2005131.67,1982964.71,3988096.38
291480,202304,12842,5584,7258,7274562.8,9460401.41,16734964.21
291490,202304,735,296,439,385396.02,571578.2,956974.22
291500,202304,374,225,149,293963.12,193998.47,487961.59
291510,202304,1181,469,712,610642.06,927024.49,1537666.55
291520,202304,954,436,518,567686.89,675739.35,1243426.24
291530,202304,936,283,653,368467.85,850206.6,1218674.45
291535,202304,139,114,25,148428.19,32550.91,180979.10
291540,202304,345,118,227,154941.62,295554.98,450496.60
291550,202304,1302,622,680,809857.54,885361.97,1695219.51
291560,202304,5319,2706,2613,3524572.73,3407344.91,6931917.64
291570,202304,246,130,116,169261.39,151034.64,320296.03
291580,202304,1257,794,463,1033807.49,604131.31,1637938.80
291590,202304,119,55,64,71610.46,83328,154938.46
291600,202304,1190,601,589,782522.17,766881.75,1549403.92
291610,202304,1529,746,783,972653.23,1020794.97,1993448.20
291620,202304,576,274,302,356761.79,393206.89,749968.68
291630,202304,485,149,336,193999.1,438774.2,632773.3
291640,202304,4306,2087,2219,2717345.93,2891770.16,5609116.09
291650,202304,475,334,141,434888.99,184886.09,619775.08
291660,202304,367,151,216,196604.42,281233.7,477838.12
291670,202304,168,105,63,136713.74,82026.2,218739.94
291680,202304,637,392,245,510415.52,318994.33,829409.85
291685,202304,642,372,270,484356.03,351543.53,835899.56
291690,202304,509,334,175,434872.14,227851.42,662723.56
291700,202304,1095,842,253,1096309.26,329408.74,1425718.00
291710,202304,1649,798,851,1040317.97,1108008.47,2148326.44
291720,202304,466,317,149,412736.02,196602.9,609338.92
291730,202304,974,562,412,731749.24,537730.72,1269479.96
291733,202304,328,223,105,290348.34,136710.67,427059.01
291735,202304,94,70,24,91140.2,31248,122388.2
291740,202304,351,267,84,347636.12,109368,457004.12
291750,202304,2561,1618,943,2106746.74,1229112.56,3335859.30
291760,202304,3220,1784,1436,2322782.31,1870976.29,4193758.60
291770,202304,789,529,260,688791.97,338528.66,1027320.63
291780,202304,107,66,41,85932.58,53382.8,139315.38
291790,202304,169,94,75,122388,98953.27,221341.27
291800,202304,11069,4844,6225,6309714.26,8114160.53,14423874.79
291810,202304,1098,821,277,1068970.18,360659.4,1429629.58
291820,202304,298,214,84,278628.87,109368,387996.87
291830,202304,1048,443,605,576805.87,787716.82,1364522.69
291835,202304,578,534,44,695279.08,57288.18,752567.26
291840,202304,5828,2940,2888,3830701.69,3760260.46,7590962.15
291845,202304,296,101,195,131502,253890,385392
291850,202304,319,278,41,361968.1,53383,415351.1
291855,202304,268,114,154,148429.05,200508.67,348937.72
291860,202304,156,102,54,132804.52,70308.8,203113.32
291870,202304,84,39,45,50778,58590,109368
291875,202304,167,154,13,200512,16926.84,217438.84
291880,202304,444,368,76,479149.86,98955.13,578104.99
291890,202304,264,89,175,115878.2,227850.6,343728.8
291900,202304,59,36,23,46872,29946,76818
291905,202304,128,98,30,127598.32,39060.82,166659.14
291910,202304,150,121,29,157542.66,37758.1,195300.76
291915,202304,458,400,58,520819.84,75517.11,596336.95
291920,202304,6571,3124,3447,4071565.64,4491993.76,8563559.40
291930,202304,173,104,69,135410.66,89838.25,225248.91
291940,202304,426,252,174,328106.87,226548,554654.87
291950,202304,1245,965,280,1256439.41,365863.28,1622302.69
291955,202304,1543,920,623,1197875.18,811155.55,2009030.73
291960,202304,206,150,56,195301.08,72912,268213.08
291970,202304,800,581,219,756480.32,285140.28,1041620.60
291980,202304,1462,1258,204,1637948.02,265611.32,1903559.34
291990,202304,149,138,11,179679.4,14322,194001.4
291992,202304,221,105,116,136717.72,152337.2,289054.92
291995,202304,199,127,72,165355.81,93744.2,259100.01
292000,202304,438,311,127,404928.45,165354.88,570283.33
292010,202304,383,262,121,341125.36,157542.6,498667.96
292020,202304,317,232,85,302067.36,110670,412737.36
292030,202304,164,127,37,165356.52,48174,213530.52
292040,202304,612,334,278,434868,361956,796824
292045,202304,128,112,16,145824.7,20832.36,166657.06
292050,202304,979,706,273,919222.62,355448.18,1274670.80
292060,202304,982,803,179,1045543.53,233060.05,1278603.58
292070,202304,70,26,44,33852.2,57288,91140.2
292080,202304,178,125,53,162750.41,69006,231756.41
292090,202304,590,217,373,282536.78,486948.2,769484.98
292100,202304,1713,746,967,972638.34,1259062.69,2231701.03
292105,202304,181,163,18,212226.3,23436,235662.3
292110,202304,2408,904,1504,1177036.3,1960820.9,3137857.2
292120,202304,748,563,185,733059.22,240872.29,973931.51
292130,202304,507,274,233,356752.11,303366.19,660118.30
292140,202304,226,181,45,235668.37,58592.32,294260.69
292145,202304,176,101,75,131502,97650,229152
292150,202304,1589,1325,264,1725180.45,346335.01,2071515.46
292160,202304,181,140,41,182280.7,53382.04,235662.74
292170,202304,1225,1034,191,1346317.02,249988.11,1596305.13
292180,202304,255,179,76,233058,98952.1,332010.1
292190,202304,157,101,56,131503.14,72912.97,204416.11
292200,202304,1510,552,958,718717.83,1248624.52,1967342.35
292205,202304,124,103,21,134106.88,27342,161448.88
292210,202304,411,271,140,352851.32,182281.49,535132.81
292220,202304,33,22,11,28644.8,14322,42966.8
292225,202304,64,49,15,63800.71,19530.6,83331.31
292230,202304,1030,806,224,1049447.72,295556,1345003.72
292240,202304,668,481,187,626282.95,243474.5,869757.45
292250,202304,1688,1088,600,1417925.45,781206.45,2199131.90
292260,202304,433,258,175,335921.37,227851.71,563773.08
292265,202304,257,195,62,253895.9,80725.02,334620.92
292270,202304,742,377,365,490860.86,475230,966090.86
292273,202304,223,131,92,170562.9,119784.93,290347.83
292275,202304,191,99,92,128898.5,119784,248682.5
292280,202304,154,107,47,139314,61194,200508
292285,202304,98,77,21,100254,27342,127596
292290,202304,669,442,227,575497.03,296857.21,872354.24
292300,202304,1984,789,1195,1027300.35,1555914.43,2583214.78
292303,202304,147,104,43,135410.34,55986.73,191397.07
292305,202304,125,89,36,115879.38,46872,162751.38
292310,202304,1039,691,348,899701.98,453102.7,1352804.68
292320,202304,619,463,156,602833.02,203113.9,805946.92
292330,202304,178,113,65,147127.13,84630,231757.13
292335,202304,325,258,67,335919.75,87234,423153.75
292340,202304,581,404,177,526013.35,230455.71,756469.06
292350,202304,293,151,142,196603.68,184884,381487.68
292360,202304,777,580,197,755164.27,256495.51,1011659.78
292370,202304,740,567,173,738243.1,225247.38,963490.48
292380,202304,634,526,108,684870.64,140616.49,825487.13
292390,202304,400,164,236,213530.61,308575.59,522106.20
292400,202304,4033,2440,1593,3179589.75,2075401.49,5254991.24
292405,202304,282,188,94,244777.46,122388,367165.46
292410,202304,111,70,41,91141.4,53382,144523.4
292420,202304,275,236,39,307272.9,50778,358050.9
292430,202304,560,401,159,522105.65,207018.51,729124.16
292440,202304,695,579,116,753872.38,151034.13,904906.51
292450,202304,247,187,60,243476.42,78120.8,321597.22
292460,202304,533,405,128,527314.86,166656.81,693971.67
292465,202304,212,180,32,234361.85,41664.1,276025.95
292467,202304,186,123,63,160146.27,82026,242172.27
292470,202304,329,220,109,286441.19,141918,428359.19
292480,202304,424,283,141,368476.72,184886.55,553363.27
292490,202304,259,193,66,251288.63,85934.32,337222.95
292500,202304,989,485,504,631491.07,656216.02,1287707.09
292510,202304,3835,1874,1961,2439995.95,2554544.42,4994540.37
292520,202304,1274,607,667,790343.41,868444.4,1658787.81
292525,202304,477,352,125,458315.86,162753.18,621069.04
292530,202304,5382,2206,3176,2872288.51,4144305.92,7016594.43
292540,202304,492,284,208,369770.29,270816.97,640587.26
292550,202304,1189,662,527,861936.95,687460.05,1549397.00
292560,202304,341,310,31,403633.92,40362.16,443996.08
292570,202304,358,275,83,358051.2,108066,466117.2
292575,202304,595,431,164,561190.08,213530.96,774721.04
292580,202304,1084,734,350,955678.09,455703.3,1411381.39
292590,202304,594,529,65,688765.92,84631.1,773397.02
292593,202304,148,117,31,152334.58,40362,192696.58
292595,202304,221,174,47,226551.94,61194,287745.94
292600,202304,1353,958,395,1247359.42,515600.42,1762959.84
292610,202304,116,94,22,122395.1,28645.34,151040.44
292620,202304,541,452,89,588536.99,117181.73,705718.72
292630,202304,1666,907,759,1180942.9,988223.25,2169166.15
292640,202304,929,643,286,837200.95,372377.1,1209578.05
292650,202304,187,141,46,183588.73,59892,243480.73
292660,202304,2106,1477,629,1923120.19,818973.2,2742093.39
292665,202304,139,97,42,126296.07,54684,180980.07
292670,202304,397,302,95,393206.18,123690.21,516896.39
292680,202304,267,201,66,261702.97,85932,347634.97
292690,202304,213,146,67,190092.64,87234,277326.64
292700,202304,1079,704,375,916635.24,489558.81,1406194.05
292710,202304,118,101,17,131503.69,22134.31,153638.00
292720,202304,1065,609,456,792926.37,593712.78,1386639.15
292730,202304,226,111,115,144523.49,149730.4,294253.89
292740,202304,82689,39152,43537,51008388.51,56738441.51,107746830.02
292750,202304,425,308,117,401025.87,152337.68,553363.55
292760,202304,350,297,53,386697.94,69006.38,455704.32
292770,202304,939,392,547,510392.34,712202.78,1222595.12
292780,202304,44,18,26,23437.89,33852.99,57290.88
292790,202304,827,445,382,579394.29,498666.2,1078060.49
292800,202304,1354,806,548,1049432.24,713503.24,1762935.48
292805,202304,420,157,263,204414.97,342427.49,546842.46
292810,202304,1920,1133,787,1475195.94,1028583.25,2503779.19
292820,202304,719,608,111,792948.79,144526.37,937475.16
292830,202304,147,112,35,145827.63,45571.08,191398.71
292840,202304,738,592,146,770809.74,190093.7,960903.44
292850,202304,145,99,46,128900.35,59893.85,188794.20
292860,202304,2236,1276,960,1661417.36,1251238.75,2912656.11
292870,202304,3969,2573,1396,3351430.1,1817604.16,5169034.26
292880,202304,1530,1016,514,1322856.82,669235.83,1992092.65
292890,202304,578,481,97,626278.83,126296.44,752575.27
292895,202304,146,103,43,134106.75,55986,190092.75
292900,202304,346,248,98,322910.83,127598.67,450509.50
292905,202304,534,263,271,342431.75,352846.03,695277.78
292910,202304,560,420,140,546848.95,182280.87,729129.82
292920,202304,624,276,348,359360.2,453104.42,812464.62
292925,202304,489,447,42,584599.62,54685.22,639284.84
292930,202304,779,473,306,615859.11,398415.92,1014275.03
292935,202304,280,123,157,161448.76,204415.1,365863.86
292937,202304,217,146,71,190094.23,92442,282536.23
292940,202304,203,157,46,204415.64,59892,264307.64
292950,202304,1464,702,762,914030.01,993435.03,1907465.04
292960,202304,526,376,150,489569.51,195302.12,684871.63
292970,202304,261,192,69,249989.69,89840.92,339830.61
292975,202304,99,52,47,67708.96,61196.23,128905.19
292980,202304,373,257,116,334617.87,151033.88,485651.75
292990,202304,1371,1028,343,1338465.18,446587.76,1785052.94
293000,202304,119,82,37,106766.53,48174.1,154940.63
293010,202304,3248,1924,1324,2507710.27,1725184.94,4232895.21
293015,202304,646,532,114,692679.8,148428,841107.8
293020,202304,368,289,79,377594.69,102859.87,480454.56
293030,202304,587,522,65,679654.01,85932,765586.01
293040,202304,395,313,82,407528.09,106764.68,514292.77
293050,202304,3258,1909,1349,2486890.15,1756419.34,4243309.49
293060,202304,238,192,46,249995.1,59892.5,309887.6
293070,202304,4142,2071,2071,2697856.88,2701687.27,5399544.15
293075,202304,100,70,30,91141.29,39060,130201.29
293076,202304,86,64,22,83330.35,28644,111974.35
293077,202304,642,364,278,475251.77,361962.68,837214.45
293080,202304,442,393,49,511692.13,63798.66,575490.79
293090,202304,139,123,16,160146,20832,180978
293100,202304,558,377,181,490863.24,235662.38,726525.62
293105,202304,362,265,97,345032.21,126294,471326.21
293110,202304,131,86,45,111978.67,58593.06,170571.73
293120,202304,308,221,87,287750.49,113277.95,401028.44
293130,202304,256,172,84,223949.67,109368,333317.67
293135,202304,8917,3625,5292,4726400.14,6895416.56,11621816.70
293140,202304,201,121,80,157547.61,105464.18,263011.79
293150,202304,327,284,43,369776.91,55986.2,425763.11
293160,202304,440,276,164,359354.98,213528,572882.98
293170,202304,273,169,104,220043.97,135410.51,355454.48
293180,202304,634,432,202,562467.47,263004,825471.47
293190,202304,1457,1007,450,1312450.98,588512.9,1900963.88
293200,202304,614,533,81,693984.02,105462,799446.02
293210,202304,436,333,103,433574.77,134106,567680.77
293220,202304,2462,1104,1358,1438733.69,1768125.79,3206859.48
293230,202304,1886,705,1181,920535.81,1540269.9,2460805.71
293240,202304,235,212,23,276034.38,29947.1,305981.48
293245,202304,133,109,24,141920.41,31248,173168.41
293250,202304,842,364,478,473943.26,623672.66,1097615.92
293260,202304,335,262,73,341126.58,95046,436172.58
293270,202304,1236,552,684,718712.44,890568.1,1609280.54
293280,202304,327,220,107,286442.98,139315.42,425758.40
293290,202304,3215,2054,1161,2674390.23,1511638.17,4186028.40
293300,202304,941,643,298,837196.34,387996.13,1225192.47
293305,202304,201,153,48,199207.6,62496.65,261704.25
293310,202304,178,132,46,171866.05,59892.7,231758.75
293315,202304,183,137,46,178378.41,59893.39,238271.80
293317,202304,93,69,24,89838.2,31248,121086.2
293320,202304,1327,680,647,885426.55,843719.45,1729146.00
293325,202304,220,93,127,121086,166656,287742
293330,202304,15761,7270,8491,9474949.44,11067126.47,20542075.91
293340,202304,299,211,88,274723.86,114576,389299.86
293345,202304,265,221,44,287749.04,57288,345037.04
293350,202304,613,391,222,509097.15,289045.66,798142.81
293360,202304,1563,1094,469,1424424.05,611947.46,2036371.51
310010,202304,145,77,68,100254.77,89838.04,190092.81
310020,202304,1018,558,460,726532.17,600227.37,1326759.54
310030,202304,320,254,66,330713.9,85934.5,416648.4
310040,202304,49,33,16,42966,20832,63798
310050,202304,169,107,62,139314.21,80724,220038.21
310060,202304,284,202,82,263012.23,106764.61,369776.84
310070,202304,23,14,9,18228.24,11718.2,29946.44
310080,202304,54,37,17,48174,22134.83,70308.83
310090,202304,1175,660,515,859341.41,671839.88,1531181.29
310100,202304,400,280,120,364570.7,156241.99,520812.69
310110,202304,734,392,342,510393.28,445288.43,955681.71
310120,202304,461,258,203,335916.99,264306.73,600223.72
310130,202304,35,19,16,24738.2,20832,45570.2
310140,202304,24,9,15,11718,19530.76,31248.76
310150,202304,1258,821,437,1068976.08,568985.7,1637961.78
310160,202304,2248,1106,1142,1440050.06,1486895.13,2926945.19
310163,202304,103,61,42,79422,55986,135408
310170,202304,2748,1335,1413,1738216.68,1839742.71,3577959.39
310180,202304,201,95,106,123691.44,138012,261703.44
310190,202304,507,341,166,443987.07,216134.6,660121.67
310200,202304,438,278,160,361961.59,208320.2,570281.79
310205,202304,83,56,27,72912.79,35154,108066.79
310210,202304,281,229,52,298160.66,67704,365864.66
310220,202304,65,40,25,52080.24,32550,84630.24
310230,202304,296,210,86,273424.37,111972,385396.37
310240,202304,130,105,25,136710,32550,169260
310250,202304,96,78,18,102859.95,23436,126295.95
310260,202304,799,429,370,559880.14,481745.68,1041625.82
310270,202304,294,188,106,244782.73,138012.14,382794.87
310280,202304,424,296,128,385394.43,166656,552050.43
310285,202304,216,165,51,214832.38,66402.85,281235.23
310290,202304,242,131,111,171865.94,144522,316387.94
310300,202304,185,148,37,192698.13,48174,240872.13
310310,202304,14,12,2,15624,2604,18228
310320,202304,29,11,18,14322.18,23436.53,37758.71
310330,202304,48,36,12,46872.24,15624.66,62496.90
310340,202304,1968,1417,551,1846268.21,717404.79,2563673.00
310350,202304,2922,1513,1409,1972602.48,1835830.41,3808432.89
310360,202304,54,42,12,54684.97,15624.33,70309.30
310370,202304,139,115,24,149730,31248,180978
310375,202304,110,42,68,54685.06,88537.41,143222.47
310380,202304,53,34,19,44268,24738,69006
310390,202304,110,68,42,88537.09,54684,143221.09
310400,202304,2719,1803,916,2347611.49,1193945.17,3541556.66
310410,202304,119,71,48,92443.53,62496,154939.53
310420,202304,718,372,346,485656.53,450497.32,936153.85
310430,202304,292,188,104,244777.85,135408,380185.85
310440,202304,80,51,29,66402.3,37758,104160.3
310445,202304,85,72,13,93744.71,16926,110670.71
310450,202304,698,463,235,602841.4,305971.5,908812.9
310460,202304,272,184,88,239571.63,114576.09,354147.72
310470,202304,571,371,200,483053.43,260402.33,743455.76
310480,202304,106,69,37,89838,48174,138012
310490,202304,615,299,316,389304.09,412735.11,802039.20
310500,202304,136,60,76,78121.81,98952,177073.81
310510,202304,645,452,193,589822.58,251286.91,841109.49
310520,202304,158,109,49,142527.5,63798,206325.5
310530,202304,129,54,75,70308.87,97650,167958.87
310540,202304,526,292,234,380195.15,304670.61,684865.76
310550,202304,82,56,26,72914.27,33852,106766.27
310560,202304,3391,2316,1075,3019430.47,1403561.27,4422991.74
310570,202304,113,71,42,92442.6,54684,147126.6
310590,202304,423,250,173,325508.95,225246.7,550755.65
310600,202304,142,67,75,88537.4,97650,186187.4
310610,202304,44,15,29,19530.25,37758,57288.25
310620,202304,54008,25623,28385,33390819.94,36997886.51,70388706.45
310630,202304,809,485,324,634089.79,421850.71,1055940.50
310640,202304,165,109,56,141918.2,72912.2,214830.4
310650,202304,180,161,19,209622.46,24738,234360.46
310660,202304,118,78,40,101556.2,52080,153636.2
310665,202304,72,49,23,63798,29946,93744
310670,202304,7961,3461,4500,4511610.15,5865545.01,10377155.16
310680,202304,65,43,22,55986,28644,84630
310690,202304,631,452,179,589818.78,233062.12,822880.90
310700,202304,62,38,24,49476.2,31248.97,80725.17
310710,202304,1345,907,438,1180002.71,570282.3,1750285.01
310720,202304,166,47,119,61194,154938,216132
310730,202304,1659,1122,537,1462203.02,699191.93,2161394.95
310740,202304,1064,576,488,749983.48,635381.97,1385365.45
310750,202304,263,169,94,220040.82,122388.37,342429.19
310760,202304,78,60,18,78123.29,23436,101559.29
310770,202304,88,42,46,54684.1,59892,114576.1
310780,202304,382,308,74,401023.37,96348.6,497371.97
310790,202304,121,97,24,126294.71,31248.59,157543.30
310800,202304,501,238,263,309878.98,342426,652304.98
310810,202304,186,123,63,160147.64,82026.59,242174.23
310820,202304,318,256,62,333319.07,80724.04,414043.11
310825,202304,210,176,34,229154.11,44268,273422.11
310830,202304,481,217,264,282537.48,343730,626267.48
310840,202304,386,237,149,308576.09,193998.48,502574.57
310850,202304,77,63,14,82026.95,18228,100254.95
310855,202304,460,364,96,475237.44,126294,601531.44
310860,202304,1707,1263,444,1644481.86,578098.95,2222580.81
310870,202304,64,55,9,71610.6,11718,83328.6
310880,202304,95,75,20,97650,26040,123690
310890,202304,303,177,126,230456.78,164052,394508.78
310900,202304,650,302,348,394513.18,454403.28,848916.46
310910,202304,258,171,87,222645.15,113274,335919.15
310920,202304,447,256,191,333324.77,248690.68,582015.45
310925,202304,40,32,8,41664.82,10416,52080.82
310930,202304,1424,960,464,1249942.14,604133.37,1854075.51
310940,202304,730,355,375,462225.71,489559.25,951784.96
310945,202304,148,98,50,127596.7,66402,193998.7
310950,202304,222,174,48,227852.27,62496,290348.27
310960,202304,75,28,47,36457.88,61195.57,97653.45
310970,202304,184,105,79,138015.24,102858.6,240873.84
310980,202304,57,38,19,49480.76,24738,74218.76
310990,202304,161,85,76,110670.15,98953.05,209623.20
311000,202304,911,467,444,608047.48,578092.3,1186139.78
311010,202304,54,42,12,54684.94,15624,70308.94
311020,202304,41,26,15,33852.55,19530,53382.55
311030,202304,418,238,180,309878.02,234360.48,544238.50
311040,202304,38,30,8,39060,10416,49476
311050,202304,544,209,335,272119.4,436171.58,708290.98
311060,202304,871,482,389,627576.4,506482.79,1134059.19
311070,202304,360,164,196,213529.32,255192,468721.32
311080,202304,127,72,55,93746.83,71611.61,165358.44
311090,202304,362,177,185,231761.31,242173.12,473934.43
311100,202304,588,357,231,464818.68,302064.25,766882.93
311110,202304,719,515,204,670554.11,265613.98,936168.09
311115,202304,85,58,27,76818.51,35154.2,111972.71
311120,202304,1178,657,521,855445.5,680953.09,1536398.59
311130,202304,295,170,125,223949.54,162750,386699.54
311140,202304,180,102,78,132808.18,101558.18,234366.36
311150,202304,342,220,122,286444.31,158844,445288.31
311160,202304,808,574,234,748667.19,304669.77,1053336.96
311170,202304,97,79,18,102858.82,23436,126294.82
311180,202304,330,227,103,295563.95,135409.44,430973.39
311190,202304,37,17,20,22134,26040,48174
311200,202304,354,238,116,309878.06,151032.9,460910.96
311205,202304,37,29,8,37758,10416,48174
311210,202304,35,31,4,40362,5208,45570
311220,202304,33,29,4,37758,5208,42966
311230,202304,1763,1179,584,1536417.8,760376.46,2296794.26
311240,202304,84,54,30,70312.1,39060.5,109372.6
311250,202304,64,27,37,35154,48174,83328
311260,202304,564,346,218,450499.98,283836.14,734336.12
311265,202304,141,92,49,119784.24,63798,183582.24
311270,202304,295,201,94,261750.34,122389.8,384140.14
311280,202304,206,90,116,117180.8,151032,268212.8
311290,202304,109,93,16,121087.96,20832.2,141920.16
311300,202304,624,400,224,520809.32,291651.26,812460.58
311310,202304,19,15,4,19530,5208,24738
311320,202304,676,506,170,660127.52,221341.53,881469.05
311330,202304,1269,927,342,1206983.8,445294.26,1652278.06
311340,202304,2824,1981,843,2579328.13,1098893.41,3678221.54
311350,202304,279,212,67,276026.75,87234,363260.75
311360,202304,169,104,65,135410.03,84630,220040.03
311370,202304,1294,556,738,723940.87,960887.37,1684828.24
311380,202304,7,6,1,7812,1302,9114
311390,202304,256,151,105,196604.72,136710.2,333314.92
311400,202304,143,87,56,113274.8,72912,186186.8
311410,202304,131,63,68,82026.72,88536,170562.72
311420,202304,332,166,166,217438.99,216133.22,433572.21
311430,202304,881,582,299,759076.61,390601.99,1149678.60
311440,202304,476,323,153,420556.65,199207.79,619764.44
311450,202304,324,188,136,244778.25,177072.92,421851.17
311455,202304,278,188,90,244782.69,117181.56,361964.25
311460,202304,136,60,76,78120.3,98952.65,177072.95
311470,202304,32,14,18,18228,23436,41664
311480,202304,59,33,26,42966,33852,76818
311490,202304,11,6,5,7812,6510,14322
311500,202304,33,17,16,22134.27,20832,42966.27
311510,202304,835,572,263,744763.86,343730.49,1088494.35
311520,202304,40,34,6,44268,7812,52080
311530,202304,1945,1399,546,1821597.58,713499.12,2535096.70
311535,202304,66,44,22,57288.94,29946.52,87235.46
311540,202304,35,31,4,40362.01,5208,45570.01
311545,202304,185,134,51,174470.71,66402,240872.71
311547,202304,61,47,14,61194,18228.04,79422.04
311550,202304,727,333,394,433575.64,512990.32,946565.96
311560,202304,44,27,17,35154.83,22134,57288.83
311570,202304,298,196,102,255195.67,132806.69,388002.36
311580,202304,444,286,158,372377.17,207018.96,579396.13
311590,202304,28,23,5,29946.07,6510,36456.07
311600,202304,95,76,19,100256.46,24739.3,124995.76
311610,202304,261,225,36,294254.3,46872.73,341127.03
311615,202304,178,148,30,192697.07,39060.52,231757.59
311620,202304,34,24,10,31248.9,13020,44268.9
311630,202304,113,98,15,127596.92,19530,147126.92
311640,202304,144,73,71,95047.74,93747.44,188795.18
311650,202304,140,95,45,123690,58590.2,182280.2
311660,202304,461,213,248,277329.69,322897.27,600226.96
311670,202304,159,108,51,141734.04,66402.43,208136.47
311680,202304,237,177,60,230455.66,78120.18,308575.84
311690,202304,13,12,1,15624.5,1302,16926.5
311700,202304,206,155,51,201813.21,66402.96,268216.17
311710,202304,187,125,62,162752,80724,243476
311720,202304,40,30,10,39061.09,13020,52081.09
311730,202304,612,433,179,563784.47,234361.15,798145.62
311740,202304,29,19,10,24738,13020,37758
311750,202304,764,518,246,674443.26,320293.71,994736.97
311760,202304,86,38,48,49478,62497.08,111975.08
311770,202304,387,192,195,249986.35,253890.81,503877.16
311780,202304,228,120,108,157544.3,140616.37,298160.67
311783,202304,107,93,14,121087.54,18228,139315.54
311787,202304,53,20,33,26040,42966.16,69006.16
311790,202304,273,121,152,157543.71,197906.27,355449.98
311800,202304,803,484,319,630184.93,415341,1045525.93
311810,202304,58,42,16,54685.41,20832,75517.41
311820,202304,137,105,32,136712.82,42967.28,179680.10
311830,202304,2077,1206,871,1571560.32,1134044.18,2705604.50
311840,202304,1168,672,496,874955.43,645795.02,1520750.45
311850,202304,19,13,6,16926.28,7812.2,24738.48
311860,202304,11141,4793,6348,6242008.6,8274298.05,14516306.65
311870,202304,121,69,52,89841.24,67704.31,157545.55
311880,202304,1003,721,282,938772.62,368475.56,1307248.18
311890,202304,210,99,111,128793.2,144525.51,273318.71
311900,202304,70,28,42,36456,54684.15,91140.15
311910,202304,1509,944,565,1229114.88,736938.45,1966053.33
311920,202304,251,164,87,213530.27,114576.2,328106.47
311930,202304,979,552,427,718718.82,555957.84,1274676.66
311940,202304,2867,1577,1290,2055923.34,1680885.6,3736808.94
311950,202304,175,104,71,135410.37,92443.05,227853.42
311960,202304,69,49,20,63798.5,26040,89838.5
311970,202304,27,15,12,19530,15624,35154
311980,202304,41,31,10,40362,13020,53382
311990,202304,38,26,12,33852.08,15624.64,49476.72
311995,202304,61,35,26,45570.7,33852.42,79423.12
312000,202304,21,15,6,19530,7812,27342
312010,202304,77,59,18,76819.07,23436.1,100255.17
312015,202304,86,61,25,79422.79,32550,111972.79
312020,202304,141,102,39,132804.25,50778,183582.25
312030,202304,79,59,20,76818,26040,102858
312040,202304,92,55,37,71610,48174,119784
312050,202304,208,120,88,156240.2,114576,270816.2
312060,202304,20,12,8,15624,10416,26040
312070,202304,87,56,31,72912.83,40362.7,113275.53
312080,202304,512,249,263,324200.66,343728.3,667928.96
312083,202304,81,53,28,69006.3,36456,105462.3
312087,202304,106,78,28,101557.39,36456,138013.39
312090,202304,3710,2288,1422,2981699.09,1851462.32,4833161.41
312100,202304,152,107,45,139317.17,58590.82,197907.99
312110,202304,130,80,50,104162.62,65101.41,169264.03
312120,202304,130,93,37,121087.74,48174,169261.74
312125,202304,88,58,30,75518.1,39060.73,114578.83
312130,202304,134,89,45,115879.48,58590,174469.48
312140,202304,153,119,34,156242.14,44268,200510.14
312150,202304,38,31,7,40362.87,9114,49476.87
312160,202304,1547,1018,529,1325581.72,688764.59,2014346.31
312170,202304,15,11,4,15624,5208,20832
312180,202304,87,64,23,83328,29946,113274
312190,202304,50,43,7,55986.96,9114,65100.96
312200,202304,778,660,118,859342.08,153637.76,1012979.84
312210,202304,136,71,65,92443.43,84630.53,177073.96
312220,202304,153,111,42,144524.38,54684,199208.38
312230,202304,4144,1835,2309,2391862.65,3007630.42,5399493.07
312235,202304,181,120,61,156240,79422,235662
312240,202304,89,65,24,84632.53,31248.93,115881.46
312245,202304,241,176,65,229157.53,84631.37,313788.90
312247,202304,85,62,23,80724.37,29946.38,110670.75
312250,202304,187,96,91,124993.96,118482,243475.96
312260,202304,112,72,40,93744,52080,145824
312270,202304,149,88,61,114577.96,79422,193999.96
312280,202304,30,15,15,19530,19530,39060
312290,202304,151,103,48,134109.39,63799.18,197908.57
312300,202304,212,137,75,178377.64,98953.57,277331.21
312310,202304,65,57,8,74214,10416,84630
312320,202304,440,270,170,351541.29,221340,572881.29
312330,202304,104,90,14,117180,18228.89,135408.89
312340,202304,36,17,19,22134,24738,46872
312350,202304,14,8,6,10416.78,7812,18228.78
312352,202304,95,67,28,87234.3,36456,123690.3
312360,202304,616,269,347,351546.72,451795.06,803341.78
312370,202304,396,218,178,283837.15,231756.99,515594.14
312380,202304,151,99,52,128904.72,67706.11,196610.83
312385,202304,178,143,35,186188.7,45570.81,231759.51
312390,202304,306,195,111,253891.75,144522,398413.75
312400,202304,399,301,98,391904.53,127596.67,519501.20
312410,202304,1321,487,834,635398.01,1089797.79,1725195.80
312420,202304,712,540,172,703089.08,223945.15,927034.23
312430,202304,913,657,256,855426.99,333315.82,1188742.81
312440,202304,54,40,14,52080,18228,70308
312450,202304,230,137,93,178374,121086,299460
312460,202304,41,19,22,24738.17,28644,53382.17
312470,202304,48,34,14,44268,18228,62496
312480,202304,172,107,65,139317.67,84631.19,223948.86
312490,202304,331,226,105,294260.04,136712.2,430972.24
312500,202304,32,22,10,28644.99,13020,41664.99
312510,202304,728,290,438,377588.72,571585.59,949174.31
312520,202304,27,8,19,10416,24738,35154
312530,202304,40,28,12,36457.78,15624.1,52081.88
312540,202304,88,75,13,97650.53,16926,114576.53
312550,202304,33,25,8,33852,10416,44268
312560,202304,219,169,50,220040.33,65100,285140.33
312570,202304,518,309,209,402329.31,272119.8,674449.11
312580,202304,93,55,38,71610,49476,121086
312590,202304,221,175,46,227853.69,59892,287745.69
312595,202304,170,140,30,182280.51,39060,221340.51
312600,202304,74,34,40,44268.9,52080,96348.9
312610,202304,1665,866,799,1127563.09,1040300.28,2167863.37
312620,202304,241,174,67,226549.9,87234,313783.9
312630,202304,71,57,14,74214.52,18228,92442.52
312640,202304,48,12,36,15624,46872,62496
312650,202304,162,139,23,181417.67,29946.1,211363.77
312660,202304,113,81,32,105467,41664.39,147131.39
312670,202304,980,619,361,805964.78,471329.12,1277293.90
312675,202304,50,38,12,49476,15624,65100
312680,202304,78,51,27,66402,35154,101556
312690,202304,279,142,137,186189.94,178374.8,364564.74
312695,202304,33,26,7,33852,9114,42966
312700,202304,267,155,112,201814.21,145824.64,347638.85
312705,202304,85,67,18,87234,23436,110670
312707,202304,136,94,42,122388.85,54684,177072.85
312710,202304,2014,1129,885,1470013.6,1153583.33,2623596.93
312720,202304,46,25,21,32550.56,27342,59892.56
312730,202304,296,174,122,226552.63,160148.42,386701.05
312733,202304,51,41,10,53382.7,13020,66402.7
312735,202304,22,17,5,22134.71,6510.3,28645.01
312737,202304,85,50,35,65100.87,45570,110670.87
312738,202304,78,48,30,62496.11,39060,101556.11
312740,202304,79,49,30,63799.89,39060,102859.89
312750,202304,121,82,39,106764.88,50778,157542.88
312760,202304,285,191,94,248686.28,122388.97,371075.25
312770,202304,9622,4622,5000,6024512.53,6521737.42,12546249.95
312780,202304,468,354,114,460915.09,148430.81,609345.90
312790,202304,23,16,7,20832,9114.9,29946.9
312800,202304,1757,1207,550,1571532.74,716103.9,2287636.64
312810,202304,355,247,108,321595.75,140616,462211.75
312820,202304,198,151,47,196604.49,61194,257798.49
312825,202304,47,35,12,45573.47,15624,61197.47
312830,202304,199,107,92,139316.22,119784.93,259101.15
312840,202304,206,146,60,190093.02,78120,268213.02
312850,202304,37,32,5,41664.9,6510,48174.9
312860,202304,154,103,51,134106.85,66402,200508.85
312870,202304,1273,667,606,871064.51,791616.12,1662680.63
312880,202304,126,96,30,124996.88,39060,164056.88
312890,202304,185,132,53,171868.24,69006,240874.24
312900,202304,161,122,39,158845.92,50778,209623.92
312910,202304,187,104,83,135413.76,108069.07,243482.83
312920,202304,117,66,51,85932.42,66402,152334.42
312930,202304,346,227,119,298161.7,154940.04,453101.74
312940,202304,161,108,53,140616.13,69006,209622.13
312950,202304,795,562,233,731747.44,303368.59,1035116.03
312960,202304,150,109,41,141925.55,53383.87,195309.42
312965,202304,120,96,24,124992.1,31248,156240.1
312970,202304,304,243,61,316396.29,79423.25,395819.54
312980,202304,2860,1488,1372,1938742.76,1787656.22,3726398.98
312990,202304,47,18,29,23436.4,39060,62496.4
313000,202304,55,30,25,39060.86,32550,71610.86
313005,202304,192,148,44,192696.91,57288.79,249985.70
313010,202304,1057,464,593,604145.53,772092.87,1376238.40
313020,202304,199,105,94,136710,122388,259098
313030,202304,218,143,75,186187.44,97650,283837.44
313040,202304,96,28,68,36456.78,88536,124992.78
313050,202304,224,165,59,214830.61,76818,291648.61
313055,202304,41,29,12,37758,15624,53382
313060,202304,154,107,47,139315.05,61194,200509.05
313065,202304,59,45,14,58590,18228.6,76818.6
313070,202304,129,68,61,88538.12,80724,169262.12
313080,202304,45,24,21,31248,27342,58590
313090,202304,720,471,249,614551.95,324198.49,938750.44
313100,202304,224,82,142,106764.2,184884,291648.2
313110,202304,161,88,73,115878.3,95048.42,210926.72
313115,202304,273,146,127,190095.15,165355.26,355450.41
313120,202304,894,514,380,669243.01,494763.49,1164006.50
313130,202304,6505,3624,2881,4721207.31,3758905.85,8480113.16
313140,202304,144,85,59,110672.33,76819.35,187491.68
313150,202304,310,242,68,315087,88536,403623
313160,202304,190,142,48,184889.42,62496,247385.42
313170,202304,1509,951,558,1238246.46,726519.15,1964765.61
313180,202304,348,223,125,290352.46,162753.87,453106.33
313190,202304,816,471,345,613259.2,449193.41,1062452.61
313200,202304,36,29,7,37758.78,9114.2,46872.98
313210,202304,1059,903,156,1175767.56,203116.6,1378884.16
313220,202304,333,199,134,259098,174468,433566
313230,202304,312,245,67,318992.48,87234.03,406226.51
313240,202304,2453,1230,1223,1602807.49,1594951.03,3197758.52
313250,202304,1298,972,326,1265577.01,425758.58,1691335.59
313260,202304,104,51,53,66402.95,69006,135408.95
313270,202304,1114,661,453,861937.16,589812.52,1451749.68
313280,202304,45,35,10,45570,13020,58590
313290,202304,245,196,49,256501.54,63798.6,320300.14
313300,202304,342,167,175,217439.47,227850.58,445290.05
313310,202304,264,119,145,154940.17,188790.8,343730.97
313320,202304,404,299,105,389301.8,136710.07,526011.87
313330,202304,1517,942,575,1227816.67,748656.87,1976473.54
313340,202304,347,250,97,326808.71,126295.13,453103.84
313350,202304,471,288,183,374977.74,238266.24,613243.98
313360,202304,207,96,111,124992.84,144522,269514.84
313370,202304,242,88,154,114577.33,200508,315085.33
313375,202304,339,215,124,279935.39,161448.25,441383.64
313380,202304,1384,732,652,954393.07,851509.73,1805902.80
313390,202304,55,49,6,63798,7812,71610
313400,202304,428,299,129,390618.9,167960.92,558579.82
313410,202304,97,62,35,80725.5,45570,126295.5
313420,202304,4959,2836,2123,3692605.06,2769372.87,6461977.93
313430,202304,124,61,63,79422.31,82026.33,161448.64
313440,202304,1449,1030,419,1341122.35,546850.79,1887973.14
313450,202304,72,32,40,41664,52080,93744
313460,202304,417,183,234,238270.25,304669.26,542939.51
313470,202304,536,261,275,339836.26,358056.4,697892.66
313480,202304,167,127,40,165355.51,52080,217435.51
313490,202304,591,267,324,347649,423158.96,770807.96
313500,202304,33,18,15,23436,19530,42966
313505,202304,1153,887,266,1154910.88,347640.85,1502551.73
313507,202304,117,79,38,102859.46,49476,152335.46
313510,202304,3120,1929,1191,2513067.89,1550710.43,4063778.32
313520,202304,3578,2767,811,3602781.52,1055933.87,4658715.39
313530,202304,41,24,17,31248,22134.94,53382.94
313535,202304,96,78,18,101558.51,23436.5,124995.01
313540,202304,69,47,22,61194,28644,89838
313545,202304,129,109,20,141918.78,26040,167958.78
313550,202304,226,193,33,251289.05,44269.74,295558.79
313560,202304,371,177,194,230460.68,252593.93,483054.61
313570,202304,83,29,54,37758,70308.97,108066.97
313580,202304,1428,846,582,1102814.72,757769.83,1860584.55
313590,202304,78,51,27,66402.76,35155.3,101558.06
313600,202304,716,438,278,570283.59,363259.27,933542.86
313610,202304,60,47,13,61195.62,16926.35,78121.97
313620,202304,1612,777,835,1011691.39,1087174.78,2098866.17
313630,202304,1775,1346,429,1752538.44,561165.03,2313703.47
313640,202304,118,70,48,91141.08,62496.7,153637.78
313650,202304,255,136,119,177073.33,154940.87,332014.20
313652,202304,33,31,2,40362,2604,42966
313655,202304,95,64,31,83329.46,40362.39,123691.85
313657,202304,55,50,5,65101.75,6510,71611.75
313660,202304,154,102,52,132805.6,67704.93,200510.53
313665,202304,763,357,406,464831.17,528622.72,993453.89
313670,202304,11802,8063,3739,10503757.62,4873437.99,15377195.61
313680,202304,47,38,9,49476.73,11718,61194.73
313690,202304,140,101,39,131503.29,50778,182281.29
313695,202304,91,70,21,91141.24,27342,118483.24
313700,202304,379,294,85,382794.22,110670.88,493465.10
313710,202304,129,92,37,119786.2,48174,167960.2
313720,202304,1263,585,678,763003.85,884070.01,1647073.86
313730,202304,78,44,34,57289.63,44268,101557.63
313740,202304,165,121,44,157543.74,57288,214831.74
313750,202304,419,294,125,382793.62,162750.79,545544.41
313753,202304,245,185,60,240874.12,78120.1,318994.22
313760,202304,1482,584,898,760388.25,1170512.51,1930900.76
313770,202304,445,298,147,388008.28,191397.61,579405.89
313780,202304,928,510,418,664027.55,546844.47,1210872.02
313790,202304,37,37,0,48174,,48174.0
313800,202304,171,109,62,141923.49,80725.48,222648.97
313810,202304,98,53,45,69006.81,58591.02,127597.83
313820,202304,1484,714,770,929654.96,1003844.56,1933499.52
313830,202304,54,36,18,46872.89,23436,70308.89
313835,202304,67,58,9,75516.2,13020,88536.2
313840,202304,1841,1121,720,1460901.47,938747.52,2399648.99
313850,202304,236,106,130,138015.66,169260.5,307276.16
313860,202304,510,384,126,499979.82,165354.64,665334.46
313862,202304,184,131,53,170568.31,69006,239574.31
313865,202304,193,133,60,173167.01,78120,251287.01
313867,202304,63,53,10,69006,13020.1,82026.1
313868,202304,53,34,19,44268,24738,69006
313870,202304,85,46,39,59892.2,50778,110670.2
313880,202304,408,250,158,325503.84,207018.69,532522.53
313890,202304,358,198,160,257801.42,208321.23,466122.65
313900,202304,877,479,398,623678.15,518205,1141883.15
313910,202304,152,105,47,136710.82,61194,197904.82
313920,202304,691,475,216,618454.75,283837.14,902291.89
313925,202304,35,30,5,39060,6510,45570
313930,202304,956,731,225,951803.5,292955.36,1244758.86
313940,202304,2097,1249,848,1627538.77,1104105.88,2731644.65
313950,202304,912,555,357,722627.12,464814.75,1187441.87
313960,202304,1569,904,665,1178331.43,867139.36,2045470.79
313970,202304,194,109,85,141918.36,110670,252588.36
313980,202304,260,166,94,216142.54,122389.72,338532.26
313990,202304,293,178,115,231757.3,151032.6,382789.9
314000,202304,935,611,324,796838.5,421853.05,1218691.55
314010,202304,110,70,40,91140.15,52080,143220.15
314015,202304,103,29,74,37758.63,96348.9,134107.53
314020,202304,60,38,22,49477.12,28644,78121.12
314030,202304,77,39,38,50780.77,49476,100256.77
314040,202304,48,26,22,33852,28644,62496
314050,202304,305,168,137,218741.3,178374,397115.3
314053,202304,99,62,37,80725.2,48174,128899.2
314055,202304,319,205,114,266915.21,148430.14,415345.35
314060,202304,125,107,18,139314.83,23436,162750.83
314070,202304,1153,575,578,748674.62,752571.17,1501245.79
314080,202304,223,134,89,174473.48,115878.64,290352.12
314085,202304,198,137,61,178374.8,79422,257796.8
314090,202304,429,306,123,398420.24,160146.16,558566.40
314100,202304,556,437,119,568990.5,154940.41,723930.91
314110,202304,814,357,457,464831.99,595019.54,1059851.53
314120,202304,71,43,28,55986,36456,92442
314130,202304,29,21,8,27342,10416,37758
314140,202304,1259,798,461,1039021.46,600227.3,1639248.76
314150,202304,196,126,70,164055.44,91140.36,255195.80
314160,202304,324,242,82,316389.21,106764.56,423153.77
314170,202304,88,65,23,84631.39,29946,114577.39
314180,202304,801,711,90,925755.43,117181.77,1042937.20
314190,202304,94,58,36,75517.18,46872,122389.18
314200,202304,554,384,170,499984.82,221348.57,721333.39
314210,202304,254,195,59,253893.84,76818.6,330712.44
314220,202304,330,235,95,305975.97,123691.73,429667.70
314225,202304,39,24,15,31248.48,19530,50778.48
314230,202304,132,60,72,78120.55,93744,171864.55
314240,202304,183,132,51,171865.3,66402,238267.3
314250,202304,59,37,22,48177.53,28644,76821.53
314260,202304,222,111,111,144523.48,144522,289045.48
314270,202304,438,343,95,447905.57,123690.7,571596.27
314280,202304,772,418,354,545490.45,460911.39,1006401.84
314290,202304,572,445,127,579398.07,165354.72,744752.79
314300,202304,355,265,90,345038.72,117180,462218.72
314310,202304,1395,967,428,1259076.12,558558.21,1817634.33
314315,202304,49,36,13,46872.54,16926,63798.54
314320,202304,613,429,184,558571.3,239570.48,798141.78
314330,202304,12623,6144,6479,8002419.02,8443527.9,16445946.92
314340,202304,703,317,386,412744.61,502578.43,915323.04
314345,202304,62,46,16,59892,20832,80724
314350,202304,187,115,72,149730.88,93744.66,243475.54
314360,202304,55,29,26,37760.66,33853.44,71614.10
314370,202304,76,55,21,71610,27342,98952
314380,202304,141,76,65,98952.81,84630,183582.81
314390,202304,3770,2435,1335,3171793.39,1739476.67,4911270.06
314400,202304,732,507,225,660126.98,292952.01,953078.99
314410,202304,584,386,198,503888,257798.21,761686.21
314420,202304,29,19,10,24738,13020,37758
314430,202304,2595,1000,1595,1302038.6,2078032.87,3380071.47
314435,202304,148,89,59,115879.65,76818,192697.65
314437,202304,56,44,12,57288,15624,72912
314440,202304,100,64,36,83328.74,46872.1,130200.84
314450,202304,179,124,55,161449.62,71610.96,233060.58
314460,202304,657,327,330,425760.56,429663.62,855424.18
314465,202304,131,86,45,111973.47,58590,170563.47
314467,202304,74,60,14,78120,18228,96348
314470,202304,434,217,217,282536.65,282536.63,565073.28
314480,202304,1143,516,627,674451.86,817661.55,1492113.41
314490,202304,38,20,18,26040,23436,49476
314500,202304,284,196,88,255197.14,114576.45,369773.59
314505,202304,123,76,47,98954.56,61194,160148.56
314510,202304,264,214,50,279934.49,66402,346336.49
314520,202304,1532,787,745,1026014.05,971305.84,1997319.89
314530,202304,815,647,168,842427.89,218741.06,1061168.95
314535,202304,186,118,68,153636.49,88536,242172.49
314537,202304,71,43,28,55986.68,36456.98,92443.66
314540,202304,20,12,8,15624,10416,26040
314545,202304,70,46,24,59892,31248,91140
314550,202304,83,46,37,59893.02,48175.76,108068.78
314560,202304,902,484,418,630181.37,545544.06,1175725.43
314570,202304,16,14,2,18229.35,2604,20833.35
314580,202304,10,5,5,6510,6510,13020
314585,202304,33,25,8,32550,10416.08,42966.08
314587,202304,82,69,13,89838.7,16926,106764.7
314590,202304,629,426,203,554668.96,264308.53,818977.49
314600,202304,1028,670,358,873677.76,466128.67,1339806.43
314610,202304,1034,528,506,687466.71,661421.87,1348888.58
314620,202304,156,119,37,154938.54,48174,203112.54
314625,202304,99,76,23,98952.91,29946,128898.91
314630,202304,1180,668,512,869761.06,666631.85,1536392.91
314640,202304,94,58,36,75517.97,46872.6,122390.57
314650,202304,162,94,68,122390.27,88537.53,210927.80
314655,202304,65,47,18,61194,23436,84630
314660,202304,19,15,4,19530,5208,24738
314670,202304,233,183,50,238277.39,65102.76,303380.15
314675,202304,227,138,89,179678.13,115878.23,295556.36
314690,202304,593,318,275,414043.34,358052.66,772096.00
314700,202304,2280,1213,1067,1579392.27,1390541.74,2969934.01
314710,202304,1965,1092,873,1421813.56,1136647.68,2558461.24
314720,202304,432,239,193,311185.3,251286.55,562471.85
314730,202304,537,290,247,377585.28,321596.49,699181.77
314740,202304,850,377,473,490865.9,615849.51,1106715.41
314750,202304,26,20,6,26040,7812,33852
314760,202304,379,152,227,197906.78,296856.88,494763.66
314770,202304,103,68,35,88537.39,45570,134107.39
314780,202304,18,7,11,9114,14322,23436
314790,202304,2705,1737,968,2262949.21,1260338.31,3523287.52
314795,202304,76,65,11,84630.2,14322,98952.2
314800,202304,3130,1838,1292,2394438.55,1683489.98,4077928.53
314810,202304,1589,907,682,1182238.55,887965.85,2070204.40
314820,202304,122,72,50,93744.89,65100.1,158844.99
314830,202304,233,196,37,255196.87,48174,303370.87
314840,202304,88,51,37,66402,48174,114576
314850,202304,467,225,242,294385.72,316386.05,610771.77
314860,202304,664,503,161,654912.1,209622.08,864534.18
314870,202304,1758,953,805,1243445.84,1048126.4,2291572.24
314875,202304,68,61,7,79422,9114,88536
314880,202304,42,30,12,39060,15624,54684
314890,202304,60,34,26,44268,33852,78120
314900,202304,28,21,7,27343.1,9114.92,36458.02
314910,202304,246,161,85,209623.98,110670,320293.98
314915,202304,149,125,24,162752.73,31248.68,194001.41
314920,202304,85,55,30,71610.85,39060,110670.85
314930,202304,1111,503,608,654927.85,791617.92,1446545.77
314940,202304,37,29,8,37758,10416,48174
314950,202304,24,19,5,24739.01,6510,31249.01
314960,202304,29,20,9,26040.39,11718.18,37758.57
314970,202304,182,84,98,109370.89,127596.47,236967.36
314980,202304,324,209,115,272121.5,149731.47,421852.97
314990,202304,477,256,221,333319.41,287743.73,621063.14
314995,202304,158,70,88,91142.46,114576,205718.46
315000,202304,106,83,23,108066.49,29946.1,138012.59
315010,202304,40,23,17,29946,22134,52080
315015,202304,170,136,34,177072.2,44268,221340.2
315020,202304,68,56,12,72912,15624,88536
315030,202304,119,89,30,115878,39060,154938
315040,202304,92,56,36,72912.37,46872,119784.37
315050,202304,216,134,82,174470.19,106764.68,281234.87
315053,202304,68,48,20,62496.3,26040,88536.3
315057,202304,130,100,30,130200.65,39060,169260.65
315060,202304,61,51,10,66403.56,13020,79423.56
315070,202304,120,72,48,93745.78,62496,156241.78
315080,202304,404,322,82,419250.84,106765.71,526016.55
315090,202304,106,63,43,82027.39,55986,138013.39
315100,202304,99,48,51,62498.11,66402.38,128900.49
315110,202304,295,151,144,196605.08,187488,384093.08
315120,202304,1981,941,1040,1225231.79,1355413.73,2580645.52
315130,202304,374,264,110,343733,143220.44,486953.44
315140,202304,580,311,269,404931.19,350244.81,755176.00
315150,202304,1027,498,529,652322.74,688764.26,1341087.00
315160,202304,202,108,94,140623.06,122392.42,263015.48
315170,202304,306,198,108,257799.86,140617.09,398416.95
315180,202304,3453,1472,1981,1917905.56,2579280.5,4497186.06
315190,202304,303,187,116,243479.48,151032.75,394512.23
315200,202304,1298,780,518,1015587.75,674439.26,1690027.01
315210,202304,1915,1159,756,1509052.03,986918.65,2495970.68
315213,202304,27,16,11,20833.29,14322,35155.29
315217,202304,228,181,47,235663.74,61194.84,296858.58
315220,202304,1698,1253,445,1631451.1,579399.34,2210850.44
315230,202304,191,148,43,192697.87,57288,249985.87
315240,202304,387,258,129,335924.53,169263.69,505188.22
315250,202304,2888,1378,1510,1795523.07,1967327.5,3762850.57
315260,202304,139,81,58,105462,76818.1,182280.1
315270,202304,158,111,47,144522.8,61194,205716.8
315280,202304,642,422,220,549471.16,286452.79,835923.95
315290,202304,208,131,77,170565.16,100254.04,270819.20
315300,202304,104,79,25,102858.61,32550,135408.61
315310,202304,89,80,9,104160,11718,115878
315320,202304,141,91,50,118487.18,65100,183587.18
315330,202304,63,49,14,63798,18228,82026
315340,202304,393,287,106,373678.04,138013.76,511691.80
315350,202304,169,108,61,140617.38,79422.34,220039.72
315360,202304,110,51,59,66402.15,76818.23,143220.38
315370,202304,60,38,22,49477.32,28644,78121.32
315380,202304,6,5,1,6510,1302,7812
315390,202304,73,28,45,36456,58591.96,95047.96
315400,202304,866,655,211,852829.8,274723.04,1127552.84
315410,202304,329,198,131,257809.64,170567.41,428377.05
315415,202304,59,45,14,58590.27,18228,76818.27
315420,202304,211,152,59,197906.18,78120,276026.18
315430,202304,660,367,293,477838.82,381486.38,859325.20
315440,202304,97,64,33,83328.2,42966,126294.2
315445,202304,242,200,42,260410.43,54684.37,315094.80
315450,202304,180,130,50,169260,65100,234360
315460,202304,5241,2412,2829,3143165.92,3687315.38,6830481.30
315470,202304,51,21,30,27342.9,39060,66402.9
315480,202304,81,25,56,32552.36,72914.17,105466.53
315490,202304,778,509,269,662727.64,350238.48,1012966.12
315500,202304,20,16,4,20832,5208,26040
315510,202304,159,115,44,149730.83,57288,207018.83
315520,202304,79,67,12,87234.98,15624,102858.98
315530,202304,47,28,19,36456,24738.2,61194.2
315540,202304,277,190,87,247384.05,113275.01,360659.06
315550,202304,195,157,38,204415.78,49476,253891.78
315560,202304,742,582,160,759083.16,208323.81,967406.97
315570,202304,315,155,160,201815.57,208320.24,410135.81
315580,202304,797,543,254,706993.38,330709.99,1037703.37
315590,202304,196,98,98,127598,127597.23,255195.23
315600,202304,372,289,83,376282.87,108066.78,484349.65
315610,202304,106,49,57,63798,74214,138012
315620,202304,39,30,9,39062.58,11718,50780.58
315630,202304,135,102,33,132804.91,42966,175770.91
315640,202304,63,40,23,52080.98,29946,82026.98
315645,202304,53,36,17,46872,22134,69006
315650,202304,174,128,46,166656.5,59892,226548.5
315660,202304,448,208,240,270827.5,312485.84,583313.34
315670,202304,2586,1170,1416,1526006.78,1844958.27,3370965.05
315680,202304,799,574,225,747357.92,292950.5,1040308.42
315690,202304,720,481,239,626279.74,311181.01,937460.75
315700,202304,2159,1133,1026,1475212.51,1335880.12,2811092.63
315710,202304,390,136,254,177073.38,330708.18,507781.56
315720,202304,540,324,216,421857.41,281232.92,703090.33
315725,202304,218,169,49,221340.87,63798,285138.87
315727,202304,90,52,38,67708.81,49476,117184.81
315730,202304,57,50,7,65100,9114,74214
315733,202304,85,49,36,63798.2,46872,110670.2
315737,202304,51,39,12,50778.86,15624,66402.86
315740,202304,33,26,7,33852,9114,42966
315750,202304,178,127,51,165354.17,66402.56,231756.73
315760,202304,47,34,13,44268,16926,61194
315765,202304,144,83,61,108070.79,79425,187495.79
315770,202304,247,167,80,217438.69,104160.64,321599.33
315780,202304,4322,2148,2174,2800696.04,2837069.1,5637765.14
315790,202304,256,196,60,255196.41,78120.87,333317.28
315800,202304,336,220,116,286444.31,151032,437476.31
315810,202304,64,38,26,49477.15,33852,83329.15
315820,202304,807,603,204,786433.02,265612.54,1052045.56
315830,202304,125,82,43,106764.96,55986.31,162751.27
315840,202304,86,59,27,76818,35154.66,111972.66
315850,202304,276,183,93,238272.62,121086.81,359359.43
315860,202304,21,9,12,11718,15624,27342
315870,202304,40,31,9,40363.04,11718,52081.04
315880,202304,101,66,35,85932,45570,131502
315890,202304,114,77,37,100256.29,48174.54,148430.83
315895,202304,417,275,142,358068.61,184884.81,542953.42
315900,202304,87,39,48,50778,62496.08,113274.08
315910,202304,51,31,20,40362,26040,66402
315920,202304,159,108,51,140618.57,66402,207020.57
315930,202304,53,18,35,23439,45570.9,69009.9
315935,202304,135,106,29,138014.96,37758,175772.96
315940,202304,103,75,28,97650.17,36456,134106.17
315950,202304,41,32,9,41664,11718.35,53382.35
315960,202304,611,288,323,374986.58,420553.37,795539.95
315970,202304,35,29,6,37758.24,7812,45570.24
315980,202304,704,363,341,472639.95,443983.72,916623.67
315990,202304,268,151,117,196604.39,152334.62,348939.01
316000,202304,49,30,19,40362,24738,65100
316010,202304,98,83,15,108067.48,19530,127597.48
316020,202304,98,88,10,114577.25,13020,127597.25
316030,202304,391,230,161,299467.3,209624.69,509091.99
316040,202304,585,245,340,318993.49,442680.61,761674.10
316045,202304,53,47,6,61194,7812,69006
316050,202304,28,20,8,26040,10416,36456
316060,202304,109,77,32,100255.17,41664,141919.17
316070,202304,1309,885,424,1152306.76,553354.13,1705660.89
316080,202304,97,64,33,83443.17,42966,126409.17
316090,202304,37,17,20,22134,26041.08,48175.08
316095,202304,89,76,13,98953.44,16926.44,115879.88
316100,202304,368,201,167,261707.08,218736.32,480443.40
316105,202304,58,36,22,46873.86,28644,75517.86
316110,202304,1962,1514,448,1971274.03,583306.65,2554580.68
316120,202304,78,54,24,70308,32550,102858
316130,202304,127,93,34,121089.36,44268.51,165357.87
316140,202304,33,22,11,28644,14322,42966
316150,202304,238,168,70,218739.61,91140.33,309879.94
316160,202304,88,58,30,75517.57,39060.28,114577.85
316165,202304,78,50,28,65100.78,36456,101556.78
316170,202304,188,123,65,160146.07,85932,246078.07
316180,202304,225,87,138,113277.4,180979.96,294257.36
316190,202304,148,108,40,140617.39,52080,192697.39
316200,202304,715,400,315,522116.65,410131.96,932248.61
316210,202304,784,538,246,700724.81,320294.87,1021019.68
316220,202304,132,86,46,111974.07,59892,171866.07
316225,202304,43,27,16,35154.88,20832,55986.88
316230,202304,51,29,22,37758.78,28644,66402.78
316240,202304,709,555,154,722626.58,200512.87,923139.45
316245,202304,172,151,21,196604.82,27342.99,223947.81
316250,202304,1778,1177,601,1533808.39,785109.88,2318918.27
316255,202304,134,105,29,136710,37758.63,174468.63
316257,202304,186,95,91,123691.57,118483.46,242175.03
316260,202304,209,143,66,186188.45,85932.2,272120.65
316265,202304,37,27,10,35156.28,13020.67,48176.95
316270,202304,719,507,212,660125.96,276026.07,936152.03
316280,202304,604,382,222,497375.92,289046.41,786422.33
316290,202304,910,631,279,822888.49,363262.11,1186150.60
316292,202304,669,278,391,361966.23,511688.98,873655.21
316294,202304,111,68,43,88537.9,55986.5,144524.4
316295,202304,424,199,225,260407.53,292957.17,553364.70
316300,202304,33,23,10,29946,13020,42966
316310,202304,27,13,14,16926,18228,35154
316320,202304,72,34,38,44268.85,49476.6,93745.45
316330,202304,183,129,54,167959.38,70308.87,238268.25
316340,202304,146,93,53,121086,69006,190092
316350,202304,198,134,64,174469.29,83328.2,257797.49
316360,202304,26,17,9,22134,11718,33852
316370,202304,1389,687,702,894496.34,915312.53,1809808.87
316380,202304,122,95,27,123691.57,35154,158845.57
316390,202304,105,79,26,102858,33852,136710
316400,202304,173,131,42,170565.91,54684.36,225250.27
316410,202304,317,232,85,302066.64,110670.2,412736.84
316420,202304,230,152,78,197909.66,101558.41,299468.07
316430,202304,170,94,76,122388.46,98952,221340.46
316440,202304,79,42,37,54684.58,48174.08,102858.66
316443,202304,49,41,8,53382.31,10416,63798.31
316447,202304,47,38,9,49478.51,11718,61196.51
316450,202304,254,188,66,244777.17,85932,330709.17
316460,202304,50,15,35,19530.28,45570.54,65100.82
316470,202304,1889,1388,501,1807224.4,654907.2,2462131.6
316480,202304,9,7,2,9114,2604,11718
316490,202304,20,6,14,7812,18228,26040
316500,202304,171,110,61,143220.27,79422.47,222642.74
316510,202304,141,113,28,147127.06,36456,183583.06
316520,202304,190,104,86,135408.91,111973.62,247382.53
316530,202304,185,115,70,149731.21,91140,240871.21
316540,202304,164,86,78,111973.7,101556.65,213530.35
316550,202304,177,110,67,143222.3,87234,230456.3
316553,202304,494,248,246,322903.51,320293.54,643197.05
316555,202304,68,58,10,75516.74,13020,88536.74
316556,202304,18,12,6,15624.41,7812,23436.41
316557,202304,42,30,12,39061.07,15624,54685.07
316560,202304,75,53,22,69006.2,28644,97650.2
316570,202304,234,214,20,278630.85,26040,304670.85
316580,202304,25,17,8,22134,10416,32550
316590,202304,91,76,15,98953.32,19530.32,118483.64
316600,202304,186,156,30,203114.12,39060,242174.12
316610,202304,74,53,21,69006.95,27342,96348.95
316620,202304,156,109,47,141918,61194.79,203112.79
316630,202304,62,47,15,61194,19530,80724
316640,202304,24,14,10,18228,13020,31248
316650,202304,119,94,25,122388,32550,154938
316660,202304,5,2,3,2604.19,3906,6510.19
316670,202304,438,150,288,196605.86,376281.29,572887.15
316680,202304,178,138,40,180980.77,52080.4,233061.17
316690,202304,151,93,58,121086,75516,196602
316695,202304,56,48,8,62496,10416,72912
316700,202304,31,22,9,28644,11718,40362
316710,202304,861,651,210,848920.21,273423.4,1122343.61
316720,202304,5562,2604,2958,3391826.49,3855234.09,7247060.58
316730,202304,15,14,1,18228,1302,19530
316740,202304,170,105,65,136710.1,84630,221340.1
316750,202304,18,10,8,13020.24,10416,23436.24
316760,202304,351,278,73,361962.98,95046.88,457009.86
316770,202304,182,97,85,126296.09,110670,236966.09
316780,202304,68,38,30,49476.6,39060,88536.6
316790,202304,70,47,23,61194.27,29946.5,91140.77
316800,202304,1893,1151,742,1498639.76,968707.5,2467347.26
316805,202304,33,22,11,28644.08,14322,42966.08
316810,202304,55,31,24,40362.7,31248.1,71610.8
316820,202304,41,25,16,32550,20832,53382
316830,202304,109,50,59,65101.62,76818.2,141919.82
316840,202304,529,323,206,420551.41,268214.51,688765.92
316850,202304,321,222,99,289046.84,128898,417944.84
316860,202304,6773,3074,3699,4005054.5,4825236.43,8830290.93
316870,202304,1855,1198,657,1561178.88,856725.32,2417904.20
316880,202304,171,86,85,111975.85,111973.44,223949.29
316890,202304,237,156,81,203114.26,105462.69,308576.95
316900,202304,454,317,137,412739.17,178374,591113.17
316905,202304,26,11,15,14322,19530,33852
316910,202304,87,37,50,48174,65100,113274
316920,202304,161,124,37,161455.03,48174,209629.03
316930,202304,2153,1102,1051,1436132.02,1368404.16,2804536.18
316935,202304,1037,615,422,802046.8,549453.15,1351499.95
316940,202304,1164,686,478,893194.56,624962.35,1518156.91
316950,202304,208,101,107,131504.4,139314,270818.4
316960,202304,1163,648,515,843727.66,670542.46,1514270.12
316970,202304,693,553,140,720028.5,182283.23,902311.73
316980,202304,90,48,42,62496,54684,117180
316990,202304,2415,1640,775,2139249.24,1011658.57,3150907.81
317000,202304,357,277,80,360665.19,104161.84,464827.03
317005,202304,226,157,69,204419.79,89838.9,294258.69
317010,202304,7381,4224,3157,5503833.08,4113077.93,9616911.01
317020,202304,16648,7291,9357,9497217.36,12189428.43,21686645.79
317030,202304,100,48,52,62496,69006.6,131502.6
317040,202304,3277,2150,1127,2800682.82,1467362.92,4268045.74
317043,202304,81,64,17,83335.73,22135.27,105471.00
317047,202304,44,27,17,35154,22134,57288
317050,202304,164,132,32,171866.68,41664,213530.68
317052,202304,164,135,29,175771.57,37758,213529.57
317057,202304,200,150,50,195301.69,66402,261703.69
317060,202304,67,41,26,53382.45,33852.8,87235.25
317065,202304,54,40,14,52080,18228,70308
317070,202304,2099,972,1127,1265590.09,1467356.47,2732946.56
317075,202304,96,54,42,70308.75,54684,124992.75
317080,202304,1016,520,496,677075.6,649699.92,1326775.52
317090,202304,752,584,168,760386.05,218741.7,979127.75
317100,202304,468,350,118,455708.12,153636.95,609345.07
317103,202304,140,111,29,144524.28,37758,182282.28
317107,202304,54,43,11,55986,14322,70308
317110,202304,80,42,38,54684.2,49477.3,104161.5
317115,202304,46,41,5,53443.69,6510,59953.69
317120,202304,2297,1148,1149,1494760.41,1498617.79,2993378.20
317130,202304,2245,1516,729,1973857.87,950463.72,2924321.59
317140,202304,14,11,3,14322.5,3906,18228.5
317150,202304,303,181,122,235665.77,158844.34,394510.11
317160,202304,371,275,96,358055.85,124993.78,483049.63
317170,202304,249,161,88,209623.74,115879.02,325502.76
317180,202304,438,298,140,388000.96,182282.1,570283.06
317190,202304,268,191,77,248683.79,100254,348937.79
317200,202304,914,640,274,834619.13,356757.63,1191376.76
317210,202304,187,98,89,127601.54,115878.21,243479.75
317220,202304,23,11,12,14322,15624,29946
320010,202304,588,418,170,544255.17,221347.21,765602.38
320013,202304,154,100,54,130204.2,70309.58,200513.78
320016,202304,262,159,103,207024.17,134106,341130.17
320020,202304,790,467,323,609362.63,420556.1,1029918.73
320030,202304,177,123,54,160148.56,70310.08,230458.64
320035,202304,142,98,44,127596.2,57288.86,184885.06
320040,202304,520,258,262,335928.47,341133.95,677062.42
320050,202304,128,89,39,115886.99,50779.17,166666.16
320060,202304,2034,955,1079,1243462.96,1406186.34,2649649.30
320070,202304,110,69,41,89838.55,53382,143220.55
320080,202304,865,486,379,632793.59,493464.39,1126257.98
320090,202304,1416,906,510,1179649.46,664036.6,1843686.06
320100,202304,382,218,164,283845.96,213530.43,497376.39
320110,202304,140,83,57,108073.55,74214.6,182288.15
320115,202304,123,104,19,135411.17,24738,160149.17
320120,202304,4088,2126,1962,2770773.17,2557178.82,5327951.99
320130,202304,8879,3801,5078,4955628.16,6618201.18,11573829.34
320140,202304,555,355,200,462234.35,260408,722642.35
320150,202304,2357,1295,1062,1687471.73,1385344.07,3072815.80
320160,202304,695,297,398,386703.19,519502.23,906205.42
320170,202304,117,94,23,122390.95,29946.02,152336.97
320180,202304,61,33,28,42967.26,37758.12,80725.38
320190,202304,267,156,111,203118.88,144522.1,347640.98
320200,202304,67,54,13,70310.98,16926,87236.98
320210,202304,985,538,447,700498.16,583305.17,1283803.33
320220,202304,313,108,205,141918.5,268212.2,410130.7
320225,202304,88,73,15,95046.39,19530.01,114576.40
320230,202304,776,495,281,647133.73,365871.76,1013005.49
320240,202304,3869,1735,2134,2264269.35,2782421.52,5046690.87
320245,202304,563,387,176,503889.38,230460.86,734350.24
320250,202304,263,124,139,161453.25,180981.25,342434.50
320255,202304,125,92,33,119786.17,42967.15,162753.32
320260,202304,321,167,154,217435.94,200510.27,417946.21
320265,202304,160,122,38,158845.73,49476.06,208321.79
320270,202304,163,124,39,162752.87,50779.15,213532.02
320280,202304,1471,821,650,1071594.36,847620.6,1919214.96
320290,202304,72,56,16,72912.22,22134,95046.22
320300,202304,663,452,211,589826.03,274724.85,864550.88
320305,202304,823,451,372,588531.76,485661.87,1074193.63
320310,202304,221,129,92,167962.54,119784.9,287747.44
320313,202304,387,172,215,223954.02,279931.4,503885.42
320316,202304,114,83,31,108067.54,40362.33,148429.87
320320,202304,3755,1679,2076,2186136.32,2704298.63,4890434.95
320330,202304,304,219,85,285139.32,110670.48,395809.80
320332,202304,847,502,345,654952.31,449205.96,1104158.27
320334,202304,308,167,141,217437.67,183583.3,401020.97
320335,202304,151,98,53,127601.67,70310.63,197912.30
320340,202304,631,446,185,580721.6,240879.47,821601.07
320350,202304,1202,490,712,638005.39,927039.5,1565044.89
320360,202304,182,83,99,108067,128898,236965
320370,202304,251,186,65,242176.49,84631.29,326807.78
320380,202304,354,249,105,324207.8,136710.89,460918.69
320390,202304,1221,705,516,917943.59,673144.38,1591087.97
320400,202304,349,239,110,311194.62,144523.2,455717.82
320405,202304,1060,430,630,561191.35,821584.04,1382775.39
320410,202304,1001,494,507,643205.56,660120.12,1303325.68
320420,202304,634,285,349,371088.25,454410.8,825499.05
320425,202304,228,119,109,156243.33,143220.8,299464.13
320430,202304,423,220,203,286454.78,265617.05,552071.83
320435,202304,199,137,62,178376.41,80725.49,259101.90
320440,202304,223,121,102,157545.68,134111,291656.68
320450,202304,145,76,69,98954.03,89839.06,188793.09
320455,202304,240,187,53,244780.88,70308.66,315089.54
320460,202304,353,212,141,276028.55,183582.21,459610.76
320465,202304,125,85,40,110675.33,52080.16,162755.49
320470,202304,815,482,333,627594.34,433578.77,1061173.11
320480,202304,243,160,83,208328.29,108066.02,316394.31
320490,202304,3581,1693,1888,2205680.6,2460853,4666533.6
320495,202304,139,80,59,104160.75,76818.6,180979.35
320500,202304,11310,5487,5823,7150945.42,7589495.28,14740440.70
320501,202304,591,305,286,399732.82,372384.19,772117.01
320503,202304,346,243,103,317694.69,134107.25,451801.94
320506,202304,303,206,97,268215.52,126294.38,394509.90
320510,202304,1374,592,782,773416.71,1018181.94,1791598.65
320515,202304,90,71,19,92444.91,24738,117182.91
320517,202304,250,183,67,238271.37,87234.52,325505.89
320520,202304,8840,3689,5151,4804565.34,6713239.9,11517805.24
320530,202304,7887,3746,4141,4883913.67,5399475.8,10283389.47
330010,202304,3872,1889,1983,2460895.88,2584506.86,5045402.74
330015,202304,229,101,128,132806.53,166656.56,299463.09
330020,202304,4428,1679,2749,2188737.1,3583152.57,5771889.67
330022,202304,284,144,140,187493.29,182280.95,369774.24
330023,202304,946,265,681,345036.56,887974.63,1233011.19
330025,202304,1108,182,926,236967.38,1206844.62,1443812.00
330030,202304,2042,1253,789,1634090.69,1027296.82,2661387.51
330040,202304,2951,1501,1450,1954377.29,1889235.48,3843612.77
330045,202304,11449,3663,7786,4773321.36,10155775.89,14929097.25
330050,202304,944,576,368,749976.02,480443.66,1230419.68
330060,202304,1347,793,554,1033840.53,721319.63,1755160.16
330070,202304,4867,1657,3210,2157505.91,4184689.94,6342195.85
330080,202304,1791,770,1021,1005186.57,1330665.02,2335851.59
330090,202304,425,232,193,302074.68,251288.19,553362.87
330093,202304,236,99,137,128899.35,178375.48,307274.83
330095,202304,76,38,38,49476.35,49476,98952.35
330100,202304,12231,6062,6169,7895703.79,8049113.24,15944817.03
330110,202304,517,238,279,311185.44,363262.94,674448.38
330115,202304,551,268,283,350248.48,369770.02,720018.50
330120,202304,436,227,209,295559.96,273422.27,568982.23
330130,202304,1767,474,1293,617179.7,1683527.72,2300707.42
330140,202304,750,385,365,502580.3,476534.17,979114.47
330150,202304,566,340,226,442692.4,295555.92,738248.32
330160,202304,220,128,92,166660.75,119786.15,286446.90
330170,202304,29903,10630,19273,13857817.52,25119988.68,38977806.20
330180,202304,281,154,127,200510.26,165357.27,365867.53
330185,202304,1330,521,809,678369,1053343.31,1731712.31
330187,202304,656,199,457,259110.24,596322.05,855432.29
330190,202304,7002,2652,4350,3455636.98,5665076.85,9120713.83
330200,202304,5103,1730,3373,2252556.77,4398255.16,6650811.93
330205,202304,535,298,237,388008.95,309879.14,697888.09
330210,202304,989,584,405,760393.43,528618.23,1289011.66
330220,202304,3085,1806,1279,2354124.69,1667897.99,4022022.68
330225,202304,702,343,359,446594.5,467421.02,914015.52
330227,202304,2703,875,1828,1139285.9,2381393.44,3520679.34
330230,202304,259,137,122,178378.93,158847.71,337226.64
330240,202304,4914,2262,2652,2945260.36,3455577.52,6400837.88
330245,202304,184,86,98,111975.22,127596.86,239572.08
330250,202304,7396,3531,3865,4601477.59,5041438.84,9642916.43
330260,202304,863,237,626,308582.84,816359.07,1124941.91
330270,202304,4448,1448,3000,1889275.42,3907376.72,5796652.14
330280,202304,509,303,206,395830.11,268218.97,664049.08
330285,202304,7005,2250,4755,2933570.53,6205493.92,9139064.45
330290,202304,845,292,553,380199.89,721313.35,1101513.24
330300,202304,813,494,319,644016.13,415347.78,1059363.91
330310,202304,519,302,217,393215.63,282534.61,675750.24
330320,202304,8460,2905,5555,3783817.87,7247061.67,11030879.54
330330,202304,10567,3849,6718,5012882.72,8759997.62,13772880.34
330340,202304,3054,1668,1386,2174397.39,1807198.57,3981595.96
330350,202304,22264,8158,14106,10624843.73,18382031.97,29006875.70
330360,202304,2074,981,1093,1277316.7,1425729.76,2703046.46
330370,202304,1081,568,513,739565.87,670547.57,1410113.44
330380,202304,1133,459,674,601545.87,880164.14,1481710.01
330385,202304,727,355,372,462219.76,484347.56,946567.32
330390,202304,6940,3598,3342,4690103.73,4359237.97,9049341.70
330395,202304,436,282,154,367176.36,200512.76,567689.12
330400,202304,780,396,384,516915.91,501273.28,1018189.19
330410,202304,570,406,164,528630.47,213532.02,742162.49
330411,202304,405,219,186,285141.15,242172.7,527313.85
330412,202304,242,111,131,144526.58,170562.1,315088.68
330414,202304,5995,2357,3638,3072864.63,4741943.95,7814808.58
330415,202304,683,293,390,381500.83,507784.95,889285.78
330420,202304,2706,1410,1296,1837175.7,1687409.39,3524585.09
330430,202304,1960,838,1122,1092412.14,1463464.88,2555877.02
330440,202304,424,208,216,270822.47,281234.23,552056.70
330450,202304,135,61,74,79423.8,97651.72,177075.52
330452,202304,2744,1118,1626,1456996.64,2117080.03,3574076.67
330455,202304,140642,49250,91392,64203395.77,119169341.9,183372737.67
330460,202304,286,132,154,171865.95,200508.4,372374.35
330470,202304,1360,727,633,946577.86,825481.44,1772059.30
330475,202304,2049,618,1431,804652.47,1864481.12,2669133.59
330480,202304,859,475,384,618469.28,499975.36,1118444.64
330490,202304,18427,5672,12755,7391856.29,16629388.14,24021244.43
330500,202304,1734,746,988,971316.52,1288996.7,2260313.22
330510,202304,12295,4345,7950,5662664.54,10370600.97,16033265.51
330513,202304,108,57,51,74214.02,66402,140616.02
330515,202304,740,324,416,421860.84,544254.28,966115.12
330520,202304,2777,957,1820,1246068.51,2370990.02,3617058.53
330530,202304,189,108,81,140619.22,105462.1,246081.32
330540,202304,381,201,180,261705.62,235665.4,497371.02
330550,202304,3105,1036,2069,1350205.93,2700378.31,4050584.24
330555,202304,1262,439,823,571592.88,1071555.63,1643148.51
330560,202304,855,300,555,390612.64,722618.71,1113231.35
330570,202304,358,246,112,320295.15,145824.52,466119.67
330575,202304,969,362,607,471339.98,790328.48,1261668.46
330580,202304,3828,2018,1810,2627519.05,2360561.28,4988080.33
330590,202304,271,141,130,184888.69,169261.65,354150.34
330600,202304,1568,920,648,1197887.27,843715.15,2041602.42
330610,202304,1769,892,877,1162716.13,1143164.56,2305880.69
330615,202304,240,194,46,252592.24,59895.53,312487.77
330620,202304,1058,446,612,580720.56,796839.58,1377560.14
330630,202304,5132,3018,2114,3942609.82,2757687.49,6700297.31
350010,202304,635,416,219,541652.61,285140.65,826793.26
350020,202304,59,20,39,26042.06,50778,76820.06
350030,202304,614,359,255,467443.45,332019.27,799462.72
350040,202304,117,51,66,66406.08,85932.68,152338.76
350050,202304,395,184,211,239574.77,274725.05,514299.82
350055,202304,139,61,78,79425.33,102858.21,182283.54
350060,202304,82,35,47,45571.16,62496.2,108067.36
350070,202304,847,470,377,611976.65,490871.51,1102848.16
350075,202304,83,52,31,67707.05,40362,108069.05
350080,202304,65,30,35,39060.73,45570.97,84631.70
350090,202304,87,47,40,61196.51,52080,113276.51
350100,202304,314,196,118,255197.6,154938,410135.6
350110,202304,49,32,17,41666.54,22134,63800.54
350115,202304,191,93,98,121091.07,128899.27,249990.34
350120,202304,117,76,41,98956.2,53382.47,152338.67
350130,202304,446,191,255,248701.61,332018.65,580720.26
350140,202304,38,23,15,29946.64,19530,49476.64
350150,202304,81,56,25,72914.18,32550.15,105464.33
350160,202304,2592,1023,1569,1333290.75,2044150.09,3377440.84
350170,202304,445,255,190,332022.59,247383.17,579405.76
350180,202304,166,91,75,119788.17,98952.41,218740.58
350190,202304,1062,570,492,742177.79,640585.85,1382763.64
350200,202304,64,27,37,35154.76,48174,83328.76
350210,202304,1400,742,658,966132.75,856740.77,1822873.52
350220,202304,657,521,136,678361.71,177074.47,855436.18
350230,202304,72,44,28,57288.53,36456.9,93745.43
350240,202304,59,36,23,46872.65,29946.65,76819.30
350250,202304,1172,524,648,682277.41,845013.92,1527291.33
350260,202304,114,83,31,108068.83,40362.87,148431.70
350270,202304,1047,685,362,891878.8,472628.94,1364507.74
350275,202304,358,133,225,173168.39,292955.84,466124.23
350280,202304,4696,2218,2478,2891888.96,3227681.88,6119570.84
350290,202304,522,221,301,289051.11,391906.14,680957.25
350300,202304,50,27,23,35158.8,29946.9,65105.7
350310,202304,83,47,36,61195.63,46872.59,108068.22
350315,202304,13,11,2,14322,2604,16926
350320,202304,3651,1690,1961,2203102.09,2557156.06,4760258.15
350330,202304,1795,865,930,1128876.82,1213468.39,2342345.21
350335,202304,22,14,8,18228,10416,28644
350340,202304,129,52,77,67705.24,100258.32,167963.56
350350,202304,98,47,51,61194.34,66402,127596.34
350360,202304,112,74,38,96351.35,49476.37,145827.72
350370,202304,89,50,39,65102.69,50778.48,115881.17
350380,202304,924,398,526,518212.91,686161.64,1204374.55
350390,202304,1967,732,1235,953089.35,1609289.24,2562378.59
350395,202304,20,14,6,18228,7812,26040
350400,202304,1879,882,997,1149710.66,1299397.51,2449108.17
350410,202304,3382,1345,2037,1753855.75,2657406.51,4411262.26
350420,202304,303,177,126,230458.28,164053.28,394511.56
350430,202304,108,53,55,69009.59,71614.32,140623.91
350440,202304,147,105,42,136721.5,54684.35,191405.85
350450,202304,1876,1021,855,1329397.71,1114514.64,2443912.35
350460,202304,451,154,297,200516.82,386704.48,587221.30
350470,202304,23,13,10,16926,13020,29946
350480,202304,209,107,102,139320.72,132804.4,272125.12
350490,202304,257,118,139,153638.25,180978.8,334617.05
350500,202304,61,21,40,27342,52080,79422
350510,202304,154,86,68,111976.45,88536.38,200512.83
350520,202304,471,252,219,328123.06,285147.43,613270.49
350530,202304,537,261,276,339839.06,359365.65,699204.71
350535,202304,97,64,33,83328.37,42966.08,126294.45
350540,202304,363,191,172,248688.56,223949.81,472638.37
350550,202304,3011,1666,1345,2169245.75,1753804.18,3923049.93
350560,202304,633,430,203,559879.53,264310.61,824190.14
350570,202304,4884,2000,2884,2610608.79,3761508.77,6372117.56
350580,202304,402,191,211,248692.3,274726.61,523418.91
350590,202304,1083,575,508,748674.87,662864.4,1411539.27
350600,202304,6931,3131,3800,4079389.66,4958064.28,9037453.94
350610,202304,1629,847,782,1102839.05,1019472.73,2122311.78
350620,202304,24,14,10,18228,13020,31248
350630,202304,273,133,140,173171.44,182282.48,355453.92
350635,202304,1437,616,821,802060.33,1070266.49,1872326.82
350640,202304,131,90,41,117180.5,53382.7,170563.2
350650,202304,2056,1342,714,1747370.82,929633.98,2677004.80
350660,202304,871,343,528,446595,688765.3,1135360.3
350670,202304,308,152,156,197908.17,203112.78,401020.95
350680,202304,166,86,80,111976.49,105462.92,217439.41
350690,202304,213,96,117,124994.01,152334,277328.01
350700,202304,1058,507,551,660138.88,717413.08,1377551.96
350710,202304,454,166,288,216139.54,376283.51,592423.05
350715,202304,59,47,12,61195.47,15624,76819.47
350720,202304,17,13,4,16926.58,5208,22134.58
350730,202304,46,28,18,36458.35,23436.61,59894.96
350740,202304,261,143,118,186190.42,153637.78,339828.20
350745,202304,33,15,18,19531.29,23436.75,42968.04
350750,202304,2753,1593,1160,2075480.63,1512940.61,3588421.24
350760,202304,4379,1815,2564,2368412.13,3342266.48,5710678.61
350770,202304,62,39,23,50778.5,29946,80724.5
350775,202304,68,50,18,65104.82,23437.58,88542.40
350780,202304,505,250,255,325515,332012.53,657527.53
350790,202304,377,157,220,204417.93,286444.95,490862.88
350800,202304,575,340,235,442685.85,307272.88,749958.73
350810,202304,538,407,131,529944.21,170562.39,700506.60
350820,202304,98,54,44,70309.98,57288,127597.98
350830,202304,82,41,41,54684.67,53382,108066.67
350840,202304,891,354,537,460923.6,699301.05,1160224.65
350850,202304,2013,1026,987,1335895.44,1287685.34,2623580.78
350860,202304,755,382,373,501290.78,485659.5,986950.28
350870,202304,481,326,155,424461.18,203113.26,627574.44
350880,202304,300,156,144,203117.66,187492.21,390609.87
350890,202304,40,24,16,31248,20832.7,52080.7
350900,202304,1774,580,1194,755189.88,1557227.26,2312417.14
350910,202304,26,13,13,16926,16926.01,33852.01
350920,202304,861,436,425,567684.44,553351.3,1121035.74
350925,202304,1258,622,636,809886.73,830696.52,1640583.25
350930,202304,127,71,56,92445.64,72912.28,165357.92
350940,202304,788,404,384,527339.28,501286.54,1028625.82
350945,202304,126,85,41,110672.54,53382,164054.54
350950,202304,19594,9029,10565,11765259.37,13777881.33,25543140.70
350960,202304,1906,756,1150,984536.78,1498620.58,2483157.36
350970,202304,1200,565,635,735522.93,826785.66,1562308.59
350980,202304,104,68,36,88539.14,46872.9,135412.04
350990,202304,427,157,270,204415.9,354145.22,558561.12
350995,202304,44,18,26,23436.37,33853.38,57289.75
351000,202304,644,403,241,524725.6,313791.5,838517.1
351010,202304,55,36,19,46875.05,24738,71613.05
351015,202304,46,25,21,32550.66,27342,59892.66
351020,202304,1580,938,642,1221319.91,842405.19,2063725.10
351030,202304,356,204,152,265611.94,199206.32,464818.26
351040,202304,1125,616,509,802059.69,664026.72,1466086.41
351050,202304,4058,1826,2232,2377571.01,2909997.54,5287568.55
351060,202304,6798,2460,4338,3208255.1,5654621.79,8862876.89
351070,202304,433,268,165,350250.49,214836.69,565087.18
351080,202304,831,611,220,796853.57,287745.64,1084599.21
351090,202304,50,24,26,31249.25,33852.41,65101.66
351100,202304,453,237,216,308598.77,281243.92,589842.69
351110,202304,2247,1014,1233,1325487.47,1610578.26,2936065.73
351120,202304,66,31,35,40363.46,45570,85933.46
351130,202304,201,64,137,83330.83,179679.95,263010.78
351140,202304,341,201,140,261711.02,183585.53,445296.55
351150,202304,544,276,268,359361.43,348938.39,708299.82
351160,202304,347,194,153,252593.87,199206.72,451800.59
351170,202304,259,150,109,195304.2,141918.55,337222.75
351190,202304,106,62,44,80725.69,58590,139315.69
351200,202304,365,235,130,305980.18,169261.96,475242.14
351210,202304,137,65,72,84633.17,93744.78,178377.95
351220,202304,655,354,301,460923.9,393205.13,854129.03
351230,202304,333,208,125,270821.27,162750.8,433572.07
351240,202304,256,127,129,165357.16,167960.51,333317.67
351250,202304,93,67,26,87244.56,33852.1,121096.66
351260,202304,148,101,47,131503.87,61194.99,192698.86
351270,202304,51,23,28,29946.72,36456,66402.72
351280,202304,1117,540,577,704407.93,752564.94,1456972.87
351290,202304,263,123,140,160147.94,182280.7,342428.64
351300,202304,4468,1852,2616,2413986.76,3409994.93,5823981.69
351310,202304,779,372,407,484370.74,531230.39,1015601.13
351320,202304,120,68,52,88537.44,67704.6,156242.04
351330,202304,43,25,18,32550,23436,55986
351340,202304,1598,854,744,1111947.36,969994.45,2081941.81
351350,202304,2652,1564,1088,2039042.92,1416585.24,3455628.16
351360,202304,859,399,460,519507.41,601529.18,1121036.59
351370,202304,477,235,242,305979.27,315085.18,621064.45
351380,202304,9321,4075,5246,5308422.57,6839440.1,12147862.67
351385,202304,26,19,7,24739.67,9114,33853.67
351390,202304,297,215,82,279936.35,106764.39,386700.74
351400,202304,61,38,23,49476.8,29946,79422.8
351410,202304,506,290,216,378896.14,282536.29,661432.43
351420,202304,81,59,22,76819.32,28644,105463.32
351430,202304,79,38,41,49476.53,53382.2,102858.73
351440,202304,883,569,314,740876.35,411440.66,1152317.01
351450,202304,307,153,154,199209.84,200512.96,399722.80
351460,202304,147,63,84,82030.8,109370.1,191400.9
351470,202304,147,80,67,104165.03,87234.89,191399.92
351480,202304,488,284,204,369772.61,265608.2,635380.81
351490,202304,334,135,199,175773.09,259098.72,434871.81
351492,202304,30,18,12,24738.63,15624,40362.63
351495,202304,26,17,9,22134.65,11718,33852.65
351500,202304,3711,1467,2244,1912680.62,2925620.08,4838300.70
351510,202304,2325,833,1492,1087203.36,1945207.53,3032410.89
351512,202304,15,10,5,13020,6510,19530
351515,202304,227,128,99,166662.16,128898,295560.16
351518,202304,715,424,291,553384.21,378906.45,932290.66
351519,202304,89,54,35,70310.57,45570,115880.57
351520,202304,181,114,67,148431.6,87258.45,235690.05
351530,202304,28,13,15,16926,19530,36456
351535,202304,144,84,60,109371.26,78120.95,187492.21
351540,202304,508,320,188,416655.52,244780.52,661436.04
351550,202304,1719,1002,717,1304650.58,934844.25,2239494.83
351560,202304,90,48,42,62498.08,54684,117182.08
351565,202304,16,8,8,10416.32,10416,20832.32
351570,202304,3085,1369,1716,1785119.65,2235555.02,4020674.67
351580,202304,36,33,3,42966,3906,46872
351590,202304,69,41,28,53383.67,36456.86,89840.53
351600,202304,185,135,50,175777.57,65100.76,240878.33
351610,202304,55,24,31,31249.34,40362,71611.34
351620,202304,6429,3347,3082,4360602.79,4016713.26,8377316.05
351630,202304,3666,1709,1957,2229100.76,2550646.29,4779747.05
351640,202304,2827,1215,1612,1581981.12,2101441.93,3683423.05
351650,202304,40,30,10,39062.19,13020,52082.19
351660,202304,151,94,57,122388.3,74214,196602.3
351670,202304,804,450,354,585926.02,460918.01,1046844.03
351680,202304,97,68,29,88537.19,37758,126295.19
351685,202304,14,10,4,13020.13,5208,18228.13
351690,202304,317,201,116,261712.62,151033.52,412746.14
351700,202304,199,134,65,174759.84,84630.2,259390.04
351710,202304,69,44,25,57289.89,32550.91,89840.80
351720,202304,121,69,52,89840.21,70308,160148.21
351730,202304,128,87,41,114576.73,53382,167958.73
351740,202304,847,530,317,690098.84,414043.02,1104141.86
351750,202304,403,162,241,210929.88,313783.6,524713.48
351760,202304,725,563,162,732937.77,210924.6,943862.37
351770,202304,316,251,65,328122.54,84630.56,412753.10
351780,202304,144,89,55,115880.74,71610,187490.74
351790,202304,289,143,146,186193.7,190095.24,376288.94
351800,202304,48,32,16,41664.18,20832,62496.18
351810,202304,125,79,46,104169,59894.02,164063.02
351820,202304,778,546,232,712243.77,302070.89,1014314.66
351830,202304,705,222,483,291658.98,630175.37,921834.35
351840,202304,2488,1107,1381,1441358.85,1798069.46,3239428.31
351850,202304,283,190,93,247388.95,121086,368474.95
351860,202304,637,420,217,546871.45,282537.05,829408.50
351870,202304,6378,2832,3546,3691311.26,4619593.94,8310905.20
351880,202304,24624,9335,15289,12164956.57,19933669.06,32098625.63
351885,202304,114,62,52,80726.36,67705.2,148431.56
351890,202304,78,53,25,69007.09,32550,101557.09
351900,202304,258,133,125,177079.28,164052.95,341132.23
351905,202304,106,52,54,67706.01,70308.24,138014.25
351907,202304,4126,1668,2458,2174420.17,3202948.71,5377368.88
351910,202304,166,69,97,89843.04,126295.42,216138.46
351920,202304,117,63,54,82026,70308,152334
351925,202304,97,58,39,75518.6,50779.51,126298.11
351930,202304,499,308,191,401040.04,248688.29,649728.33
351940,202304,250,104,146,135410.39,190093.07,325503.46
351950,202304,152,84,68,110671.02,88540.92,199211.94
351960,202304,1051,509,542,664051.81,705705.05,1369756.86
351970,202304,2314,1078,1236,1404890.65,1610596.11,3015486.76
351980,202304,161,70,91,91142.67,118484.78,209627.45
351990,202304,258,160,98,208325.3,127596.87,335922.17
352000,202304,263,173,90,225261.08,117184.18,342445.26
352010,202304,470,306,164,398522.14,214842.37,613364.51
352020,202304,214,68,146,88536,191394,279930
352030,202304,1276,595,681,774714.79,886675.74,1661390.53
352040,202304,748,289,459,376284.55,598926.43,975210.98
352042,202304,371,87,284,113277.21,369770.67,483047.88
352044,202304,386,213,173,277342.33,225252.18,502594.51
352050,202304,3541,1292,2249,1686135.71,2932123.34,4618259.05
352060,202304,106,63,43,82026.18,55987.59,138013.77
352070,202304,108,73,35,95052.69,45570,140622.69
352080,202304,69,41,28,53384.5,36456.48,89840.98
352090,202304,198,120,78,157546.43,101558,259104.43
352100,202304,339,164,175,213533.98,227853.42,441387.40
352110,202304,112,31,81,40362.97,105462,145824.97
352115,202304,71,27,44,35154.9,57288.2,92443.1
352120,202304,71,47,24,61194,31248,92442
352130,202304,230,170,60,221352.02,78120.57,299472.59
352140,202304,208,105,103,136712.74,134108.36,270821.10
352150,202304,135,71,64,92445.05,83329.69,175774.74
352160,202304,146,95,51,123694.08,66402.54,190096.62
352170,202304,456,298,158,388001.5,205716.08,593717.58
352180,202304,750,443,307,576810.35,403629.07,980439.42
352190,202304,248,104,144,135416.08,190093.24,325509.32
352200,202304,30,13,17,16927.03,22134.1,39061.13
352210,202304,4957,1944,3013,2531212.53,3928163.86,6459376.39
352215,202304,78,40,38,53382.2,49476,102858.2
352220,202304,6543,2415,4128,3148353.46,5379932.42,8528285.88
352230,202304,3966,2465,1501,3210878.73,1958215.52,5169094.25
352240,202304,3006,1670,1336,2177015.83,1742092.83,3919108.66
352250,202304,4067,1793,2274,2337162.88,2963363.43,5300526.31
352260,202304,1112,577,535,751276.79,696585.14,1447861.93
352265,202304,70,41,29,53382,39060,92442
352270,202304,425,228,197,296881.71,257804.47,554686.18
352280,202304,548,321,227,417952.9,295554,713506.9
352290,202304,188,105,83,136715.87,108068.77,244784.64
352300,202304,108,65,43,84634.32,55987.9,140622.22
352310,202304,8387,3626,4761,4725162.53,6211855.99,10937018.52
352320,202304,1244,645,599,841114.58,782511.45,1623626.03
352330,202304,566,291,275,378885.52,358050.12,736935.64
352340,202304,1497,675,822,880182.86,1071555.49,1951738.35
352350,202304,395,213,182,277334.26,236966.42,514300.68
352360,202304,230,100,130,130202.27,169260.7,299462.97
352370,202304,129,79,50,102862.46,65102.21,167964.67
352380,202304,122,85,37,110674.36,48175.07,158849.43
352390,202304,2795,1177,1618,1532504.8,2113155.99,3645660.79
352400,202304,593,256,337,333318.47,438779.32,772097.79
352410,202304,980,641,339,834624.34,441397.35,1276021.69
352420,202304,90,65,25,84631.56,32550,117181.56
352430,202304,1865,807,1058,1052067.56,1378848.95,2430916.51
352440,202304,3794,1672,2122,2178333.3,2766763.19,4945096.49
352450,202304,202,155,47,201814.93,61195.99,263010.92
352460,202304,688,336,352,437481.1,459611.36,897092.46
352470,202304,726,280,446,364576.51,580697.07,945273.58
352480,202304,1772,992,780,1294233.55,1016880.41,2311113.96
352490,202304,56,23,33,29946.1,42967.05,72913.15
352500,202304,1667,656,1011,854128.25,1320237.82,2174366.07
352510,202304,783,403,380,524734.32,494765.82,1019500.14
352520,202304,939,423,516,550764.14,671847.45,1222611.59
352530,202304,2108,1007,1101,1311176.35,1437418.29,2748594.64
352540,202304,70,49,21,63800.54,28644,92444.54
352550,202304,234,129,105,167959.24,136710,304669.24
352560,202304,54,38,16,49477.04,20832.84,70309.88
352570,202304,824,398,426,518226.65,554668.43,1072895.08
352580,202304,59,44,15,57290.7,19530,76820.7
352585,202304,17,5,12,6510.58,15624.95,22135.53
352590,202304,4859,2369,2490,3084568.28,3245912.57,6330480.85
352600,202304,397,267,130,347647.54,169267.41,516914.95
352610,202304,972,419,553,545552.22,722616.26,1268168.48
352620,202304,1222,460,762,598934.08,994739.22,1593673.30
352630,202304,200,75,125,97650.91,162750.08,260400.99
352640,202304,548,350,198,455726.41,259102.42,714828.83
352650,202304,96,65,31,84632.09,40362,124994.09
352660,202304,73,39,34,50778.67,44268,95046.67
352670,202304,1876,976,900,1270828.69,1173104.61,2443933.30
352680,202304,1045,605,440,787742.69,572905.03,1360647.72
352690,202304,5075,2189,2886,2854102.58,3761508.42,6615611.00
352700,202304,95,50,45,65103.03,58591.38,123694.41
352710,202304,1626,833,793,1084620.64,1033791.71,2118412.35
352720,202304,1740,706,1034,919259.67,1347597.51,2266857.18
352725,202304,28,21,7,27343.15,9114,36457.15
352730,202304,440,211,229,274730.49,298160.88,572891.37
352740,202304,405,257,148,334633.7,192698.82,527332.52
352750,202304,24,15,9,19530.96,11718.14,31249.10
352760,202304,248,157,91,204417.43,118483.11,322900.54
352770,202304,81,59,22,76820.75,28644,105464.75
352780,202304,76,41,35,53382,45570.78,98952.78
352790,202304,27,18,9,23438.48,11718.18,35156.66
352800,202304,261,199,62,259105.61,80726.22,339831.83
352810,202304,162,102,60,132806.68,78123.31,210929.99
352820,202304,45,34,11,44268.89,14322,58590.89
352830,202304,76,50,26,65102.86,33852.01,98954.87
352840,202304,761,331,430,432284.32,559870.23,992154.55
352850,202304,1992,587,1405,764290.16,1831924.59,2596214.75
352860,202304,126,79,47,102862.03,61194.12,164056.15
352870,202304,53,33,20,42970.83,26040.38,69011.21
352880,202304,195,109,86,141924.82,111973.89,253898.71
352885,202304,34,22,12,28644.26,15624,44268.26
352890,202304,59,35,24,45571.61,31248.6,76820.21
352900,202304,4926,2297,2629,2990818.88,3425578.84,6416397.72
352910,202304,40,31,9,40362.88,11718,52080.88
352920,202304,665,378,287,494784.61,373682.32,868466.93
352930,202304,1254,580,674,755191.36,877553.35,1632744.71
352940,202304,6867,2553,4314,3326701.67,5624709.03,8951410.70
352950,202304,130,61,69,79424.78,89840.6,169265.38
352960,202304,70,47,23,61194.93,29946,91140.93
352965,202304,15,9,6,11718,7812,19530
352970,202304,572,409,163,532539.76,213534,746073.76
352980,202304,162,95,67,123698.45,87235.37,210933.82
352990,202304,1022,476,546,621079.97,710905.86,1331985.83
353000,202304,65,31,34,40362.71,45570.22,85932.93
353010,202304,553,331,222,430978.38,289048.49,720026.87
353020,202304,351,226,125,294262.49,164055.75,458318.24
353030,202304,1473,652,821,848938.23,1068965.73,1917903.96
353040,202304,92,48,44,63800.27,57290.05,121090.32
353050,202304,1418,915,503,1194000,657514.02,1851514.02
353060,202304,9954,4274,5680,5566299.78,7403242.22,12969542.00
353070,202304,2154,1240,914,1614552.36,1189799.39,2804351.75
353080,202304,1405,742,663,967430.06,864530.37,1831960.43
353090,202304,71,38,33,49477.83,42966,92443.83
353100,202304,46,33,13,42967.72,16927.54,59895.26
353110,202304,2450,811,1639,1057286.56,2135356.72,3192643.28
353120,202304,150,88,62,114576.7,80724,195300.7
353130,202304,906,420,486,546864.67,632777.07,1179641.74
353140,202304,620,281,339,367185.92,441384.36,808570.28
353150,202304,328,164,164,213535.17,213531.81,427066.98
353160,202304,110,82,28,106770.99,36456,143226.99
353170,202304,214,75,139,97651.64,180978.51,278630.15
353180,202304,1385,637,748,832000.78,975212.75,1807213.53
353190,202304,525,369,156,483065.28,203116.04,686181.32
353200,202304,297,142,155,186189.94,201810.84,388000.78
353205,202304,22,14,8,18228,10416,28644
353210,202304,76,45,31,59893.8,40362.09,100255.89
353215,202304,45,25,20,32550.2,26040,58590.2
353220,202304,86,45,41,58591.46,53382.68,111974.14
353230,202304,161,73,88,95048.76,114576,209624.76
353240,202304,432,186,246,242174.55,320292.43,562466.98
353250,202304,192,95,97,123693.15,127597.83,251290.98
353260,202304,496,314,182,408844.39,236970.09,645814.48
353270,202304,71,55,16,71613.41,20832,92445.41
353280,202304,125,58,67,75521.6,87238.6,162760.2
353282,202304,136,90,46,117181.84,59892.6,177074.44
353284,202304,31,23,8,29948.16,10416,40364.16
353286,202304,9,4,5,5208.2,6510.2,11718.4
353290,202304,86,50,36,65101.09,46872,111973.09
353300,202304,474,235,239,305985.04,311187.1,617172.14
353310,202304,39,30,9,39061.69,11719.05,50780.74
353320,202304,44,24,20,31248.81,26040.2,57289.01
353325,202304,46,24,22,31250.96,28644,59894.96
353330,202304,62,41,21,53382.4,27342.53,80724.93
353340,202304,755,276,479,359363.66,623667.1,983030.76
353350,202304,994,487,507,634096.41,660131.77,1294228.18
353360,202304,109,87,22,113277.32,28644.53,141921.85
353370,202304,117,65,52,84633.07,67704.38,152337.45
353380,202304,27,13,14,16926.2,18228,35154.2
353390,202304,1207,566,641,738266.4,835901.2,1574167.6
353400,202304,56,30,26,39062.63,33853.44,72916.07
353410,202304,119,63,56,82030.65,72914.57,154945.22
353420,202304,68,33,35,42966,45570,88536
353430,202304,601,392,209,510411.31,272128.66,782539.97
353440,202304,14420,6364,8056,8290040.7,10505896.53,18795937.23
353450,202304,51,24,27,31248.8,35154.2,66403.0
353460,202304,693,360,333,468741.82,434881.21,903623.03
353470,202304,2468,1181,1287,1539037.63,1676987.14,3216024.77
353475,202304,299,191,108,248688.96,141918.91,390607.87
353480,202304,235,170,65,221343.71,84630,305973.71
353490,202304,237,136,101,177078.94,132804.92,309883.86
353500,202304,218,124,94,161451.64,122389.22,283840.86
353510,202304,85,56,29,72913.92,37758.8,110672.72
353520,202304,262,189,73,246080.84,95046.6,341127.44
353530,202304,519,253,266,329419.26,348941.47,678360.73
353540,202304,390,243,147,316403.15,194004.36,510407.51
353550,202304,807,504,303,656253.48,397127.7,1053381.18
353560,202304,571,231,340,300765.16,442682.42,743447.58
353570,202304,71,49,22,63800.51,28644,92444.51
353580,202304,379,234,145,304674.77,188790,493464.77
353590,202304,95,71,24,92443.79,31248,123691.79
353600,202304,297,169,128,220044.36,166656.28,386700.64
353610,202304,147,80,67,104162.79,87234,191396.79
353620,202304,713,348,365,453109.1,475239.75,928348.85
353625,202304,66,32,34,42967.59,44268.26,87235.85
353630,202304,231,158,73,205726,95046.78,300772.78
353640,202304,136,87,49,113279.58,63798.54,177078.12
353650,202304,1149,451,698,587213.63,910106.89,1497320.52
353657,202304,24,18,6,23436,7812,31248
353660,202304,314,162,152,210930.22,199208.9,410139.12
353670,202304,762,427,335,555973.95,437480.68,993454.63
353680,202304,155,98,57,127596.58,74214.6,201811.18
353690,202304,45,29,16,37758.66,20833.09,58591.75
353700,202304,305,203,102,264312.54,132805.88,397118.42
353710,202304,596,288,308,374996.11,401017.03,776013.14
353715,202304,43,24,19,31248,24738,55986
353720,202304,333,148,185,194004.57,240873.39,434877.96
353730,202304,1244,727,517,946603.69,673136.42,1619740.11
353740,202304,636,347,289,451814.24,377587.56,829401.80
353750,202304,93,47,46,61196.35,59892,121088.35
353760,202304,3598,1386,2212,1804654.25,2883977.98,4688632.23
353770,202304,80,63,17,82027.24,22134.2,104161.44
353780,202304,1492,674,818,877567.14,1066347.85,1943914.99
353790,202304,531,311,220,404938.56,286448.14,691386.70
353800,202304,4196,1907,2289,2484350.04,2985494.49,5469844.53
353810,202304,256,127,129,165366.99,167958.32,333325.31
353820,202304,286,116,170,151032.85,221341.72,372374.57
353830,202304,74,63,11,82027.67,14322.9,96350.57
353850,202304,223,98,125,127600.5,162751.96,290352.46
353860,202304,576,265,311,345041.4,406228.81,751270.21
353870,202304,6357,3220,3137,4197788.39,4093518.82,8291307.21
353880,202304,779,494,285,644519.43,371074.5,1015593.93
353890,202304,608,345,263,449212.5,342432.39,791644.89
353900,202304,148,80,68,104162.51,89839.98,194002.49
353910,202304,219,90,129,117182.09,167958.71,285140.80
353920,202304,506,256,250,333322.59,325504.17,658826.76
353930,202304,1117,646,471,841129.72,613244.09,1454373.81
353940,202304,226,108,118,140617.58,153638.24,294255.82
353950,202304,550,352,198,458327.88,259100.81,717428.69
353960,202304,82,66,16,85935.47,20832,106767.47
353970,202304,42,28,14,36456.79,18229.16,54685.95
353980,202304,2170,937,1233,1222618.24,1605387.03,2828005.27
353990,202304,87,53,34,69008.6,44268.61,113277.21
354000,202304,411,184,227,239577.3,295556.81,535134.11
354010,202304,92,52,40,67708.01,52080.69,119788.70
354020,202304,553,346,207,450508.85,269519.43,720028.28
354025,202304,42,35,7,45571.71,9114,54685.71
354030,202304,48,26,22,33854.77,28644.15,62498.92
354040,202304,101,76,25,98956.19,32550,131506.19
354050,202304,166,86,80,111974.06,104161.28,216135.34
354060,202304,892,419,473,545551.96,617150.91,1162702.87
354070,202304,986,544,442,708310.87,575492.97,1283803.84
354075,202304,199,95,104,123694.18,135409.7,259103.88
354080,202304,318,144,174,187493.69,226549.89,414043.58
354085,202304,29,18,11,23436.8,14322,37758.8
354090,202304,296,170,126,221236.06,164053.85,385289.91
354100,202304,6767,2722,4045,3544194.49,5271889.31,8816083.80
354105,202304,109,57,52,74216.41,67704,141920.41
354110,202304,44,22,22,28644,28644.85,57288.85
354120,202304,166,102,64,132808.4,83328.57,216136.97
354130,202304,848,524,324,682278.04,421851.28,1104129.32
354140,202304,3618,1619,1999,2108038.12,2609224.03,4717262.15
354150,202304,692,391,301,509111.11,391909.73,901020.84
354160,202304,715,433,282,565101.15,368476.58,933577.73
354165,202304,12,7,5,9114,6510,15624
354170,202304,193,126,67,164058.53,87234.54,251293.07
354180,202304,55,33,22,42966.4,28644.51,71610.91
354190,202304,299,106,193,138015.54,252589.53,390605.07
354200,202304,120,59,61,76820.49,80726.04,157546.53
354210,202304,78,34,44,44268,57288,101556
354220,202304,637,377,260,490885.94,338528.39,829414.33
354230,202304,186,82,104,106767.01,135408.67,242175.68
354240,202304,346,209,137,272130.72,179676.72,451807.44
354250,202304,77,45,32,58590.32,41664,100254.32
354260,202304,2290,1045,1245,1360636.63,1621020.99,2981657.62
354270,202304,92,65,27,84631.11,35154.5,119785.61
354280,202304,59,33,26,42966.79,33852,76818.79
354290,202304,161,105,56,136716.98,72912.85,209629.83
354300,202304,338,239,99,311185.25,128899.33,440084.58
354310,202304,95,66,29,85937.71,37758.6,123696.31
354320,202304,246,111,135,144524.8,175770.99,320295.79
354323,202304,10,7,3,9114,3906,13020
354325,202304,129,70,59,91141.43,76818.94,167960.37
354330,202304,2620,880,1740,1145807.14,2269396.69,3415203.83
354340,202304,11627,5228,6399,6812086.62,8339383.77,15151470.39
354350,202304,155,101,54,131503.61,70308,201811.61
354360,202304,81,48,33,62498.43,42966.23,105464.66
354370,202304,249,124,125,161453.87,162751.9,324205.77
354380,202304,186,104,82,135411.79,106764,242175.79
354390,202304,3011,1079,1932,1406213.07,2518094.34,3924307.41
354400,202304,388,205,183,268217.3,238266.79,506484.09
354410,202304,768,337,431,438791.96,561173,999964.96
354420,202304,296,199,97,259105.6,126296.91,385402.51
354425,202304,362,200,162,260469.63,212229.34,472698.97
354430,202304,134,80,54,104166.37,70308.43,174474.80
354440,202304,27,22,5,28645.16,6510,35155.16
354450,202304,59,40,19,52081.34,24738,76819.34
354460,202304,103,56,47,72918.67,61196.55,134115.22
354470,202304,24,13,11,16927.25,14322.76,31250.01
354480,202304,122,68,54,88536.74,70308.28,158845.02
354490,202304,129,73,56,95050.01,72915.12,167965.13
354500,202304,434,182,252,236966.92,328104.91,565071.83
354510,202304,89,62,27,80727.02,35155.33,115882.35
354515,202304,54,19,35,24740.61,45570.1,70310.71
354520,202304,1759,741,1018,965933.75,1326739.96,2292673.71
354530,202304,920,451,469,588520.56,610641.68,1199162.24
354540,202304,266,132,134,171870.97,177073.57,348944.54
354550,202304,45,24,21,31248.92,27342,58590.92
354560,202304,172,94,78,122389.23,101556.52,223945.75
354570,202304,146,97,49,126294.58,63798.49,190093.07
354580,202304,2029,950,1079,1239540.96,1406169.9,2645710.86
354600,202304,302,137,165,178381.45,214830.5,393211.95
354610,202304,65,54,11,70308.99,14322.82,84631.81
354620,202304,76,22,54,28644.5,70309.29,98953.79
354625,202304,15,10,5,13021.59,6510.72,19532.31
354630,202304,378,253,125,330725.5,164055.38,494780.88
354640,202304,908,533,375,695532.98,488257.72,1183790.70
354650,202304,69,40,29,52081.69,37758,89839.69
354660,202304,904,651,253,847649.68,329408.75,1177058.43
354670,202304,238,93,145,121086.97,188790.2,309877.17
354680,202304,1461,517,944,673150.94,1231700.33,1904851.27
354690,202304,83,49,34,63801.52,44268.27,108069.79
354700,202304,77,54,23,70308.36,29946,100254.36
354710,202304,47,33,14,42966.43,18228,61194.43
354720,202304,22,19,3,24738.2,3906,28644.2
354730,202304,2023,821,1202,1070274.6,1566326.28,2636600.88
354740,202304,74,53,21,69006.47,27342,96348.47
354750,202304,432,234,198,305978.37,257798.98,563777.35
354760,202304,562,347,215,453130.68,281241.71,734372.39
354765,202304,7,3,4,3906,5208,9114
354770,202304,375,242,133,315097.55,173170.34,488267.89
354780,202304,9273,3353,5920,4373544.33,7720906.42,12094450.75
354790,202304,92,53,39,69006.76,50778.11,119784.87
354800,202304,460,245,215,319065.19,279936.65,599001.84
354805,202304,81,39,42,50779.16,54684.27,105463.43
354810,202304,104,57,47,74215.41,61194,135409.41
354820,202304,229,93,136,121088.67,177075.48,298164.15
354830,202304,44,23,21,29946,27342,57288
354840,202304,56,35,21,45570.91,27342,72912.91
354850,202304,5394,2318,3076,3020778.95,4010213.55,7030992.50
354860,202304,375,162,213,210925.12,277328.34,488253.46
354870,202304,13706,5901,7805,7687252.21,10172608.3,17859860.51
354880,202304,2915,1043,1872,1359332.21,2440036.53,3799368.74
354890,202304,3337,1757,1580,2287737.9,2058478.63,4346216.53
354900,202304,66,46,20,59893.78,26040.19,85933.97
354910,202304,1417,711,706,927058.43,921817.67,1848876.10
354920,202304,40,33,7,42966.6,9114,52080.6
354925,202304,27,17,10,22134.9,13020,35154.9
354930,202304,37,29,8,37760.8,10416,48176.8
354940,202304,807,554,253,721345.1,329412.92,1050758.02
354950,202304,215,129,86,167962.68,111974.38,279937.06
354960,202304,134,48,86,62497.33,111972.75,174470.08
354970,202304,1286,894,392,1164044.52,511689.44,1675733.96
354980,202304,10499,3785,6714,4930886.25,8749521.03,13680407.28
354990,202304,11615,5106,6509,6650826.22,8482588.65,15133414.87
354995,202304,649,216,433,281236.52,563774.87,845011.39
355000,202304,462,156,306,203114.94,401016.7,604131.64
355010,202304,726,452,274,588546.95,356757.03,945303.98
355020,202304,881,533,348,693988.09,453102.07,1147090.16
355030,202304,237803,87651,150152,114207647.58,195711386.88,309919034.46
355040,202304,1121,548,573,713523.34,746058.76,1459582.10
355050,202304,189,102,87,132806.14,113274,246080.14
355060,202304,2017,938,1079,1221340.38,1407468.79,2628809.17
355070,202304,1802,782,1020,1018194.28,1330662.39,2348856.67
355080,202304,218,129,89,167961.98,115880.18,283842.16
355090,202304,333,208,125,270829.58,162753.44,433583.02
355100,202304,6142,2838,3304,3696445.93,4307063.01,8003508.94
355110,202304,215,141,74,183584.94,96348.29,279933.23
355120,202304,51,32,19,41664.48,24738,66402.48
355130,202304,58,32,26,41665.62,33852,75517.62
355140,202304,221,126,95,164056.54,123690.35,287746.89
355150,202304,776,456,320,593736.92,417948.16,1011685.08
355160,202304,539,255,284,332026.68,371076.97,703103.65
355170,202304,2259,1150,1109,1498673.28,1445235.23,2943908.51
355180,202304,728,283,445,368472.4,579400.24,947872.64
355190,202304,230,154,76,200516.78,98954.07,299470.85
355200,202304,118,56,62,72913.81,80724.6,153638.41
355210,202304,788,396,392,515600.39,510511.33,1026111.72
355220,202304,8689,4048,4641,5275909.49,6051755.77,11327665.26
355230,202304,99,52,47,67705.5,61195.87,128901.37
355240,202304,5076,1994,3082,2596216.23,4017994.94,6614211.17
355250,202304,7823,3415,4408,4450437.91,5750969.37,10201407.28
355255,202304,51,30,21,39060.62,27342,66402.62
355260,202304,203,114,89,148432.79,115879.73,264312.52
355270,202304,170,109,61,141924.57,79422.78,221347.35
355280,202304,7915,2945,4970,3838435.11,6476243.77,10314678.88
355290,202304,70,53,17,69007.22,22134,91141.22
355300,202304,249,140,109,182285.91,143220.74,325506.65
355310,202304,114,64,50,84630.97,66402,151032.97
355320,202304,113,56,57,72912.6,74214.96,147127.56
355330,202304,353,203,150,264315.74,195303.5,459619.24
355340,202304,1400,513,887,667967.03,1154923.14,1822890.17
355350,202304,181,83,98,108066,128898.2,236964.2
355360,202304,205,135,70,175778.54,91141.64,266920.18
355365,202304,22,17,5,22134,6510,28644
355370,202304,1108,633,475,826810.01,619756.06,1446566.07
355380,202304,885,520,365,679678.18,477841.44,1157519.62
355385,202304,101,63,38,82026.2,50778,132804.2
355390,202304,110,59,51,76819.02,66402.71,143221.73
355395,202304,215,106,109,138018.22,143224.61,281242.83
355400,202304,1972,1090,882,1419125.75,1148366.92,2567492.67
355410,202304,5748,2550,3198,3321535.1,4170325.37,7491860.47
355420,202304,46,31,15,40362.8,19530,59892.8
355430,202304,485,282,203,367189.52,264313.76,631503.28
355440,202304,99,53,46,69007.1,59892.86,128899.96
355450,202304,492,255,237,332024.23,309878.11,641902.34
355460,202304,59,42,17,54685.1,22134.8,76819.9
355465,202304,54,29,25,37758.43,32550,70308.43
355470,202304,206,80,126,104162.04,165355.84,269517.88
355475,202304,8,5,3,6510.73,3906,10416.73
355480,202304,687,275,412,358070.15,537731.23,895801.38
355490,202304,110,80,30,104165.34,39062.42,143227.76
355495,202304,119,49,70,63798.1,91141.29,154939.39
355500,202304,1692,908,784,1184857.03,1023378.45,2208235.48
355510,202304,287,196,91,255207.34,118484.95,373692.29
355520,202304,26,18,8,23436.18,10416,33852.18
355530,202304,24,13,11,16926,14322,31248
355535,202304,85,38,47,49478.23,61194,110672.23
355540,202304,3133,1225,1908,1596315.5,2485562.72,4081878.22
355550,202304,69,37,32,48174,41664,89838
355560,202304,283,125,158,162754.59,205718.86,368473.45
355570,202304,17,12,5,15625.14,6510,22135.14
355580,202304,243,166,77,217443.05,100256.35,317699.40
355590,202304,16,11,5,14322.24,6510,20832.24
355600,202304,294,136,158,177078.2,205718.27,382796.47
355610,202304,261,154,107,200516.08,139317.52,339833.60
355620,202304,1399,587,812,764298.98,1057227.23,1821526.21
355630,202304,436,309,127,402334.54,165354.25,567688.79
355635,202304,134,54,80,70308.47,104160,174468.47
355640,202304,638,336,302,437482.79,394511.94,831994.73
355645,202304,965,340,625,442698.39,815061.98,1257760.37
355650,202304,1987,864,1123,1126280.5,1463451.93,2589732.43
355660,202304,231,116,115,151035.77,149732.11,300767.88
355670,202304,717,298,419,389302.29,546843.45,936145.74
355680,202304,223,119,104,154947.53,136712.79,291660.32
355690,202304,101,46,55,59893.75,71610.57,131504.32
355695,202304,25,16,9,20832,11718,32550
355700,202304,1374,637,737,832009.9,962186.37,1794196.27
355710,202304,2466,1357,1109,1766902.23,1443923.13,3210825.36
355715,202304,15,12,3,15626.08,3906.1,19532.18
355720,202304,279,171,108,222647.72,140618.15,363265.87
355730,202304,112,64,48,83329.28,62496.15,145825.43
410010,202304,110,89,21,115880.79,27342,143222.79
410020,202304,125,87,38,113277.84,49476.2,162754.04
410030,202304,203,108,95,140619.27,124996.38,265615.65
410040,202304,1516,716,800,932259.4,1045519.15,1977778.55
410045,202304,43,32,11,41664,14322,55986
410050,202304,554,325,229,423155.07,299460.74,722615.81
410060,202304,219,159,60,208328.08,78120.5,286448.58
410070,202304,257,209,48,272128.43,63799.12,335927.55
410080,202304,195,119,76,155288.96,98952,254240.96
410090,202304,56,47,9,61198.99,11718,72916.99
410100,202304,278,176,102,229155.19,132804.1,361959.29
410105,202304,49,27,22,35154,28644,63798
410110,202304,381,231,150,300777.35,196608.96,497386.31
410115,202304,50,28,22,36456,28644.2,65100.2
410120,202304,499,226,273,294261.54,355450.14,649711.68
410130,202304,70,38,32,49476.8,41664,91140.8
410140,202304,3484,1580,1904,2058516.89,2480336.99,4538853.88
410150,202304,2822,1131,1691,1472601.22,2203007.22,3675608.44
410160,202304,513,295,218,384097.2,285141.35,669238.55
410165,202304,62,39,23,50778.41,29946,80724.41
410170,202304,223,124,99,162753.25,128898.99,291652.24
410180,202304,2598,1348,1250,1755162.31,1627526.75,3382689.06
410185,202304,36,30,6,39060,7812,46872
410190,202304,523,338,185,441390.36,242173.4,683563.76
410200,202304,1142,795,347,1036411.09,453100.19,1489511.28
410210,202304,687,358,329,466129.34,428360.62,894489.96
410220,202304,51,22,29,28645.68,37758,66403.68
410230,202304,214,92,122,119784.64,158846.19,278630.83
410240,202304,758,487,271,634099.98,354146.38,988246.36
410250,202304,392,264,128,345035.8,167960.22,512996.02
410260,202304,321,177,144,230463.8,188799.15,419262.95
410270,202304,29,19,10,24738.79,13020,37758.79
410275,202304,64,45,19,58591.89,24738,83329.89
410280,202304,337,198,139,259110.21,180978.2,440088.41
410290,202304,280,155,125,201814.79,162750.5,364565.29
410300,202304,92,56,36,72912,46872,119784
410302,202304,27,14,13,18228.05,16926,35154.05
410304,202304,44,30,14,39061.14,18228,57289.14
410305,202304,220,133,87,173173.11,114577.09,287750.20
410310,202304,195,116,79,151036.55,102860.25,253896.80
410315,202304,38,31,7,40362.2,9114,49476.2
410320,202304,150,105,45,136711.24,58590,195301.24
410322,202304,43,25,18,32550.97,23436,55986.97
410330,202304,183,118,65,153639.2,84630,238269.2
410335,202304,109,60,49,78120,63798,141918
410337,202304,47,38,9,49476.5,11718,61194.5
410340,202304,36,29,7,37759.1,9114,46873.1
410345,202304,206,130,76,169263.68,98952.2,268215.88
410347,202304,43,33,10,42966.33,13020.4,55986.73
410350,202304,258,151,107,196606.05,139314,335920.05
410360,202304,475,288,187,376289.54,244777.62,621067.16
410370,202304,2465,1066,1399,1390582.18,1824121.16,3214703.34
410380,202304,209,116,93,151037.48,121087.37,272124.85
410390,202304,437,270,167,351545.82,217434.64,568980.46
410395,202304,30,20,10,26041.37,13020.12,39061.49
410400,202304,1007,419,588,546860.59,766889.73,1313750.32
410405,202304,80,61,19,79426.46,26041.04,105467.50
410410,202304,33,19,14,24741.07,18228.1,42969.17
410420,202304,1967,855,1112,1114422.52,1449146.44,2563568.96
410425,202304,220,90,130,117182.66,169260.2,286442.86
410430,202304,2600,1325,1275,1727794.11,1663975,3391769.11
410440,202304,369,260,109,338523.23,141920.19,480443.42
410442,202304,372,232,140,302073.39,182282.05,484355.44
410445,202304,355,248,107,322903.81,139315.22,462219.03
410450,202304,410,191,219,248688.74,285138.13,533826.87
410460,202304,605,323,282,421853.23,367166.01,789019.24
410465,202304,280,156,124,203119.47,161448.89,364568.36
410470,202304,252,145,107,188797.03,140617.3,329414.33
410480,202304,7181,3434,3747,4476425.67,4885163.85,9361589.52
410490,202304,1519,820,699,1068971.64,910108.64,1979080.28
410500,202304,290,174,116,226550.58,151033.42,377584.00
410510,202304,210,155,55,201819.4,71611.3,273430.7
410520,202304,290,206,84,268213.34,110670,378883.34
410530,202304,279,86,193,111973.06,251286,363259.06
410540,202304,402,288,114,374983.87,148429.38,523413.25
410550,202304,1804,757,1047,985633.41,1364508.31,2350141.72
410560,202304,188,121,67,157547.03,87234.94,244781.97
410570,202304,458,299,159,389303.48,207019.78,596323.26
410580,202304,4152,1713,2439,2230396.04,3178241.06,5408637.10
410590,202304,462,299,163,389288.39,214830.51,604118.90
410600,202304,106,89,17,115878.78,22134,138012.78
410610,202304,62,50,12,65101.02,15624,80725.02
410620,202304,293,177,116,230462.99,151033.37,381496.36
410630,202304,493,272,221,354146.92,290346.38,644493.30
410640,202304,1274,795,479,1036410.02,624963.52,1661373.54
410645,202304,115,86,29,111976.39,37758.2,149734.59
410650,202304,394,239,155,311183.03,201812.17,512995.20
410655,202304,89,66,23,85932.6,29946.08,115878.68
410657,202304,39,15,24,19530,31248,50778
410660,202304,696,473,223,615869.04,290350.4,906219.44
410670,202304,76,61,15,79424.14,19530.13,98954.27
410680,202304,198,158,40,205721.6,52080.2,257801.8
410685,202304,39,27,12,35154.49,15624,50778.49
410690,202304,31621,12809,18812,16689511.32,24527380.78,41216892.10
410700,202304,340,245,95,319274.43,123691.74,442966.17
410710,202304,128,106,22,138014.93,28644.2,166659.13
410712,202304,46,32,14,41664.85,18228,59892.85
410715,202304,107,75,32,97653.18,41664,139317.18
410720,202304,700,389,311,506488.68,404925.09,911413.77
410725,202304,204,138,66,179679.54,85932,265611.54
410730,202304,110,47,63,61195.18,82026.73,143221.91
410740,202304,79,59,20,76819.25,26040,102859.25
410750,202304,309,197,112,256499.5,145824.06,402323.56
410752,202304,22,17,5,22134.14,6510,28644.14
410753,202304,64,22,42,28644,54684,83328
410754,202304,57,29,28,37758.85,36456,74214.85
410755,202304,89,43,46,55986.2,59892,115878.2
410760,202304,814,437,377,568978.67,492158.96,1061137.63
410765,202304,2158,965,1193,1256478.92,1555923.69,2812402.61
410770,202304,128,85,43,110672.24,55987.21,166659.45
410773,202304,73,46,27,59893.91,35154,95047.91
410775,202304,223,153,70,199208.88,91140,290348.88
410780,202304,86,49,37,63799.69,48174,111973.69
410785,202304,58,50,8,65101.35,10416,75517.35
410790,202304,86,36,50,46872.2,65100,111972.2
410800,202304,293,180,113,234375.97,147127.44,381503.41
410810,202304,29,18,11,23436.28,14322.74,37759.02
410820,202304,151,106,45,138016.07,58590.9,196606.97
410830,202304,10248,4100,6148,5340972.78,8013910.55,13354883.33
410832,202304,117,75,42,97652.27,54684.05,152336.32
410840,202304,1537,825,712,1074173.69,928331.07,2002504.76
410845,202304,64,34,30,44268.8,40362,84630.8
410850,202304,158,115,43,149734.6,55986,205720.6
410855,202304,80,73,7,95048.49,9114,104162.49
410860,202304,931,453,478,589814.35,623662.67,1213477.02
410865,202304,95,65,30,84630.84,39060,123690.84
410870,202304,146,116,30,152336.79,39060.12,191396.91
410880,202304,1264,605,659,787730.2,858024.97,1645755.17
410890,202304,118,70,48,91141.71,62496,153637.71
410895,202304,80,62,18,80725.44,23436.95,104162.39
410900,202304,36,27,9,35155.41,11718,46873.41
410910,202304,15,9,6,11719.57,7812,19531.57
410920,202304,47,28,19,36456,24738,61194
410930,202304,577,347,230,451796.92,300763.89,752560.81
410940,202304,4840,2425,2415,3158783.01,3148286.7,6307069.71
410950,202304,98,74,24,96351.55,31248,127599.55
410960,202304,1053,390,663,507795.17,865841.03,1373636.20
410965,202304,65,45,20,58591.92,26040,84631.92
410970,202304,638,419,219,545548.69,285140.57,830689.26
410975,202304,129,79,50,102861.5,65100,167961.5
410980,202304,1694,767,927,1001275.35,1209574.5,2210849.85
410990,202304,283,202,81,263004.83,105462.98,368467.81
411000,202304,69,39,30,50778.95,39061.83,89840.78
411005,202304,36,31,5,40362,6510,46872
411007,202304,286,162,124,210924.47,161448,372372.47
411010,202304,652,404,248,526021.25,322898.94,848920.19
411020,202304,290,184,106,239573.58,138014.1,377587.68
411030,202304,28,15,13,19530,16926,36456
411040,202304,72,44,28,57288.89,36456,93744.89
411050,202304,216,152,64,197905.69,83328.94,281234.63
411060,202304,576,395,181,514297.63,238268.36,752565.99
411065,202304,43,38,5,49477.07,6510,55987.07
411070,202304,1339,746,593,971311.39,773394.52,1744705.91
411080,202304,271,177,94,230454.13,122388.23,352842.36
411090,202304,87,61,26,79422.4,33852.96,113275.36
411095,202304,361,120,241,156240.36,313782.94,470023.30
411100,202304,113,87,26,113275.66,33852,147127.66
411110,202304,163,87,76,113274.52,98952.2,212226.72
411120,202304,208,138,70,179685.97,91140,270825.97
411125,202304,399,193,206,251294.93,268220.04,519514.97
411130,202304,163,138,25,179678.45,32550,212228.45
411140,202304,216,144,72,187488,93744,281232
411150,202304,1320,835,485,1087192.74,631478.08,1718670.82
411155,202304,120,79,41,102858,53382,156240
411160,202304,38,17,21,22134,27342,49476
411170,202304,61,50,11,65100,14322,79422
411180,202304,1098,714,384,930966.09,499976.35,1430942.44
411190,202304,376,213,163,277330.74,212226,489556.74
411200,202304,713,382,331,498683.33,430966.03,929649.36
411210,202304,714,364,350,473933.83,455703.11,929636.94
411220,202304,165,117,48,152337.32,62497.25,214834.57
411230,202304,33,26,7,33852.7,9114.6,42967.3
411240,202304,113,73,40,95047.53,52080,147127.53
411250,202304,436,311,125,404927.03,162750,567677.03
411260,202304,10,7,3,9114,3906,13020
411270,202304,277,142,135,184891.62,175772.46,360664.08
411275,202304,203,166,37,216135.67,48174,264309.67
411280,202304,294,196,98,255196.55,127596.7,382793.25
411290,202304,72,54,18,70308,23436,93744
411295,202304,134,98,36,127597.59,46872.8,174470.39
411300,202304,86,41,45,53382.82,58590,111972.82
411310,202304,100,71,29,92443.4,37758,130201.4
411320,202304,900,541,359,704394.49,468721.74,1173116.23
411325,202304,61,42,19,54684.1,24738,79422.1
411330,202304,998,635,363,826797.62,475233.31,1302030.93
411340,202304,37,22,15,28644,19530.09,48174.09
411342,202304,66,51,15,66402,19530,85932
411345,202304,99,48,51,62498.36,66402.95,128901.31
411350,202304,564,419,145,545553.59,188793.38,734346.97
411360,202304,60,39,21,50781.17,27344.5,78125.67
411370,202304,14420,5870,8550,7652137.39,11141344.05,18793481.44
411373,202304,192,127,65,165354.43,84630.17,249984.60
411375,202304,91,73,18,95049.61,23436,118485.61
411380,202304,80,53,27,69010.81,35154,104164.81
411390,202304,171,93,78,121087.67,101556,222643.67
411400,202304,366,231,135,302072.82,175770,477842.82
411410,202304,575,270,305,351548.1,398414.23,749962.33
411420,202304,1014,411,603,535134.33,786415.86,1321550.19
411430,202304,616,309,307,402336.08,399723.38,802059.46
411435,202304,27,19,8,24738,10416,35154
411440,202304,519,409,110,532528.57,143220.7,675749.27
411450,202304,405,327,78,425763.16,101556,527319.16
411460,202304,860,323,537,420562.1,701782.47,1122344.57
411470,202304,117,81,36,105467.43,46872,152339.43
411480,202304,777,389,388,506497.65,505179.13,1011676.78
411490,202304,293,180,113,234364.38,147126.9,381491.28
411500,202304,111,86,25,111973.69,32550,144523.69
411510,202304,241,181,60,238271.46,78121.19,316392.65
411520,202304,6858,2278,4580,2969932.66,5967109.37,8937042.03
411530,202304,128,80,48,104161.55,62496,166657.55
411535,202304,49,14,35,18228.6,45570,63798.6
411540,202304,409,269,140,350244.27,182282.31,532526.58
411545,202304,55,38,17,49476.76,22134,71610.76
411550,202304,90,69,21,89838.87,27342,117180.87
411560,202304,408,166,242,216133.04,315084.15,531217.19
411570,202304,1115,357,758,464702.34,988231.4,1452933.74
411573,202304,24,15,9,19530.2,11718,31248.2
411575,202304,335,208,127,270819.99,165354,436173.99
411580,202304,1330,459,871,597627.06,1134048.93,1731675.99
411585,202304,75,36,39,46872,50778,97650
411590,202304,14,7,7,9114,9114,18228
411600,202304,16,8,8,10416.7,10416,20832.7
411605,202304,184,69,115,89840.13,149730,239570.13
411610,202304,255,154,101,200512.85,131502.9,332015.75
411620,202304,409,196,213,255205.46,277334.08,532539.54
411630,202304,53,35,18,45570.1,23436.99,69007.09
411640,202304,31,21,10,27342.5,13020,40362.5
411650,202304,6,4,2,5208.6,2604,7812.6
411660,202304,49,36,13,46872,16926,63798
411670,202304,246,168,78,218737.85,101557.49,320295.34
411680,202304,171,130,41,169261.72,53382,222643.72
411690,202304,729,379,350,494765.96,457005.23,951771.19
411695,202304,64,44,20,57288.2,26040,83328.2
411700,202304,148,114,34,149735.05,44268,194003.05
411705,202304,103,71,32,92444.2,41664.4,134108.6
411710,202304,296,196,100,255197.81,130201.07,385398.88
411720,202304,165,107,58,139314.96,75516.2,214831.16
411721,202304,97,72,25,93744.2,33852.2,127596.4
411722,202304,105,51,54,66403.04,70308,136711.04
411725,202304,168,118,50,153636.9,65100,218736.9
411727,202304,105,86,19,111975.68,24738.4,136714.08
411729,202304,56,43,13,55986,16926,72912
411730,202304,589,370,219,481747,285140.98,766887.98
411740,202304,27,16,11,20833.08,14322,35155.08
411745,202304,74,55,19,71610.61,24738,96348.61
411750,202304,902,366,536,477845.73,697877.36,1175723.09
411760,202304,1362,973,389,1268197.45,506487.06,1774684.51
411770,202304,444,280,164,364564.25,213529.96,578094.21
411780,202304,389,249,140,324199.09,182280.21,506479.30
411790,202304,628,345,283,450502.68,368466.54,818969.22
411800,202304,168,118,50,153641.03,66402.38,220043.41
411810,202304,202,153,49,199211.3,63798.79,263010.09
411820,202304,2853,1097,1756,1428366.36,2290258.23,3718624.59
411830,202304,21,14,7,18228.47,9114,27342.47
411840,202304,2395,1377,1018,1792905.2,1326763.3,3119668.5
411845,202304,74,23,51,29946.9,66402,96348.9
411850,202304,1361,725,636,943977.97,829384.85,1773362.82
411860,202304,66,40,26,52080.59,33852,85932.59
411870,202304,77,47,30,61194,39060,100254
411880,202304,435,262,173,341132.91,225247.7,566380.61
411885,202304,116,74,42,97652.21,54686.46,152338.67
411890,202304,356,246,110,320301.16,144523.68,464824.84
411900,202304,114,83,31,108066.47,40362,148428.47
411910,202304,231,153,78,199213.64,101558.04,300771.68
411915,202304,2663,1029,1634,1341102.26,2131416.94,3472519.20
411920,202304,117,81,36,105463.85,46872.98,152336.83
411925,202304,23,16,7,20832.59,9114,29946.59
411930,202304,839,559,280,727929.07,367170.48,1095099.55
411940,202304,612,379,233,493470.35,303369.05,796839.40
411950,202304,1367,612,755,798162.11,983031.86,1781193.97
411960,202304,1211,737,474,959588.33,618452.76,1578041.09
411965,202304,22,13,9,16927.02,11718,28645.02
411970,202304,95,81,14,105463.02,18228,123691.02
411980,202304,246,124,122,161448.76,158844,320292.76
411990,202304,5748,3000,2748,3908575.41,3587170.41,7495745.82
411995,202304,694,203,491,264314.48,641904.44,906218.92
412000,202304,363,244,119,317696.6,154940.83,472637.43
412010,202304,66,35,31,45570.9,40362.72,85933.62
412015,202304,37,27,10,35154,13020,48174
412020,202304,25,18,7,23437.22,9114,32551.22
412030,202304,38,33,5,42967.07,6510,49477.07
412033,202304,43,22,21,28645.41,27342,55987.41
412035,202304,68,44,24,57288.55,31248,88536.55
412040,202304,33,17,16,22134.6,20832,42966.6
412050,202304,223,164,59,213534.94,76818.56,290353.50
412060,202304,839,600,239,782528.45,311183.07,1093711.52
412065,202304,58,29,29,37760.38,37758.15,75518.53
412070,202304,145,101,44,131504.72,57288.52,188793.24
412080,202304,364,178,186,231766.27,242176.44,473942.71
412085,202304,39,14,25,18228.83,32550,50778.83
412090,202304,908,542,366,705703.92,476536.57,1182240.49
412100,202304,275,227,48,295565.16,62496,358061.16
412110,202304,75,56,19,72913.79,24738,97651.79
412120,202304,386,202,184,263011.18,239571.28,502582.46
412125,202304,70,39,31,52080.2,40362,92442.2
412130,202304,50,33,17,42968.47,22134,65102.47
412135,202304,30,19,11,24738.2,14322,39060.2
412140,202304,485,316,169,411160.4,221342.24,632502.64
412150,202304,265,156,109,203114.53,141918.73,345033.26
412160,202304,72,50,22,65100.71,28644.2,93744.91
412170,202304,718,460,258,598927.22,335919.6,934846.82
412175,202304,38,23,15,29946.35,19530.5,49476.85
412180,202304,160,117,43,152337.87,55986.2,208324.07
412190,202304,341,266,75,346339.53,97650,443989.53
412200,202304,196,116,80,151033.17,104160,255193.17
412210,202304,102,75,27,97650,35155.64,132805.64
412215,202304,243,161,82,209626.24,106764.82,316391.06
412217,202304,70,55,15,71611.79,19530,91141.79
412220,202304,920,589,331,766905.54,430973.06,1197878.60
412230,202304,298,175,123,227858.76,160152.24,388011.00
412240,202304,1461,716,745,932263.23,971306.45,1903569.68
412250,202304,442,267,175,347637.96,227850,575487.96
412260,202304,136,91,45,118485.58,58590.2,177075.78
412265,202304,166,128,38,166656.83,49476,216132.83
412270,202304,95,57,38,74214.86,49476,123690.86
412280,202304,83,63,20,82026.2,26040,108066.2
412290,202304,89,56,33,74215.77,42966,117181.77
412300,202304,216,153,63,199207.99,82026,281233.99
412310,202304,59,46,13,59893.5,16926,76819.5
412320,202304,95,69,26,89841.9,33852,123693.9
412330,202304,207,154,53,201812.01,69006,270818.01
412340,202304,191,119,72,154939.18,95046,249985.18
412350,202304,721,319,402,415344.27,524709.29,940053.56
412360,202304,23,18,5,23436,6510,29946
412370,202304,152,123,29,160150.16,37758,197908.16
412380,202304,190,139,51,180982.81,66402.22,247385.03
412382,202304,60,34,26,44268,33852,78120
412385,202304,172,120,52,156243.55,67704.92,223948.47
412390,202304,338,252,86,328118.55,111973.81,440092.36
412395,202304,70,56,14,72913.54,18228,91141.54
412400,202304,100,67,33,87236.46,42966,130202.46
412402,202304,249,136,113,177074.26,147126.94,324201.20
412405,202304,1006,336,670,438776.55,874946.25,1313722.80
412410,202304,1053,624,429,812484.05,558564.69,1371048.74
412420,202304,16,15,1,19530,1302,20832
412430,202304,27,25,2,32552.48,2604.2,35156.68
412440,202304,738,370,368,481748.41,479137.78,960886.19
412450,202304,64,57,7,74215.42,9114,83329.42
412460,202304,87,58,29,75518.23,37758.19,113276.42
412470,202304,238,187,51,243477.87,66403.33,309881.20
412480,202304,156,116,40,151034.84,52080.2,203115.04
412490,202304,180,149,31,194000.33,40362,234362.33
412500,202304,417,326,91,424462.48,119786.67,544249.15
412510,202304,174,141,33,183586.8,42966,226552.8
412520,202304,94,64,30,83329.66,39060,122389.66
412530,202304,113,51,62,66403.7,80724,147127.7
412535,202304,64,49,15,63799.56,19530,83329.56
412540,202304,55,31,24,40363.65,31248.46,71612.11
412545,202304,91,64,27,83329.49,35154,118483.49
412550,202304,4557,1836,2721,2394598.9,3549315.76,5943914.66
412555,202304,13,7,6,9114,7812,16926
412560,202304,733,468,265,610655.43,346334.18,956989.61
412570,202304,905,395,510,515609.47,664023.27,1179632.74
412575,202304,99,68,31,88538.01,40362,128900.01
412580,202304,190,126,64,164062.08,83330,247392.08
412590,202304,31,26,5,33853.06,6510,40363.06
412600,202304,217,155,62,201815.24,80724.83,282540.07
412610,202304,46,20,26,26041.57,33852,59893.57
412620,202304,131,108,23,140619.19,29946.46,170565.65
412625,202304,2294,1090,1204,1420520.75,1571529.35,2992050.10
412627,202304,64,48,16,62497.75,20832,83329.75
412630,202304,385,259,126,337229.43,164053.45,501282.88
412635,202304,79,23,56,29946,72912,102858
412640,202304,116,81,35,105462.3,45570,151032.3
412650,202304,332,215,117,279935.82,152335.83,432271.65
412660,202304,596,316,280,412738.2,365862.73,778600.93
412665,202304,40,36,4,46872.32,5208,52080.32
412667,202304,280,173,107,225251.33,139314,364565.33
412670,202304,81,61,20,79422.56,26040,105462.56
412680,202304,345,261,84,339832.4,109369.33,449201.73
412690,202304,134,87,47,113276.25,61194,174470.25
412700,202304,195,121,74,157542.88,96348.23,253891.11
412710,202304,1440,782,658,1018188.49,856727.94,1874916.43
412720,202304,252,137,115,178377.99,149730.69,328108.68
412730,202304,186,155,31,201817.11,40362.99,242180.10
412740,202304,423,202,221,263009.76,287742.41,550752.17
412750,202304,432,238,194,309883.35,252588.44,562471.79
412760,202304,392,199,193,259106.44,251290.71,510397.15
412770,202304,2274,1209,1065,1575450.57,1387940.62,2963391.19
412780,202304,146,102,44,132807.38,57288.1,190095.48
412785,202304,333,171,162,222645.21,210924.02,433569.23
412788,202304,57,33,24,42967.14,31248,74215.14
412790,202304,128,103,25,134111.34,33852,167963.34
412795,202304,151,102,49,132807.08,63798,196605.08
412796,202304,313,197,116,257798.11,151032.2,408830.31
412800,202304,759,421,338,548148.08,440076.81,988224.89
412810,202304,3345,1839,1506,2397057.35,1962139.55,4359196.90
412820,202304,1113,633,480,824197.44,624974.6,1449172.04
412830,202304,15,14,1,18228.2,1302,19530.2
412840,202304,251,164,87,214834.54,113274.2,328108.74
412850,202304,602,393,209,511696.36,272118.68,783815.04
412853,202304,180,80,100,104160.12,130200,234360.12
412855,202304,212,113,99,148430.76,128898.73,277329.49
412860,202304,103,70,33,91144.03,42966.72,134110.75
412862,202304,79,51,28,66402,37758,104160
412863,202304,8,5,3,6510,3906,10416
412865,202304,46,36,10,46872,13020.6,59892.6
412870,202304,121,77,44,100257.17,57290.12,157547.29
412880,202304,99,69,30,89840.67,39060,128900.67
420005,202304,45,38,7,49476.69,9114,58590.69
420010,202304,378,248,130,324203.59,170562.89,494766.48
420020,202304,99,75,24,97652.17,31248,128900.17
420030,202304,30,24,6,31248.2,7812,39060.2
420040,202304,95,74,21,96349.91,27342.2,123692.11
420050,202304,53,35,18,45570.46,23436,69006.46
420055,202304,18,16,2,20832.6,2604,23436.6
420060,202304,30,20,10,26040.79,13020.2,39060.99
420070,202304,108,93,15,121086.6,19530,140616.6
420075,202304,11,11,0,14322,,14322.0
420080,202304,41,35,6,45571.13,7812,53383.13
420090,202304,39,32,7,41664.75,9114.25,50779.00
420100,202304,169,144,25,187490.25,32550,220040.25
420110,202304,26,25,1,32550,1302,33852
420120,202304,63,45,18,58590.44,23436,82026.44
420125,202304,81,61,20,79422.6,26040,105462.6
420127,202304,38,32,6,41664,7812,49476
420130,202304,539,322,217,419261.58,282539.07,701800.65
420140,202304,1461,816,645,1062465.31,841113.24,1903578.55
420150,202304,49,35,14,45570,18228,63798
420160,202304,36,31,5,40362.93,6510,46872.93
420165,202304,20,15,5,19530.79,6510,26040.79
420170,202304,72,42,30,54684.09,39060,93744.09
420180,202304,25,22,3,28644,3906,32550
420190,202304,29,25,4,32550.18,5208,37758.18
420195,202304,137,66,71,85936.9,92444.69,178381.59
420200,202304,1482,610,872,794247.05,1137970.78,1932217.83
420205,202304,130,78,52,101558.85,67704.4,169263.25
420207,202304,164,89,75,115883.13,97651.17,213534.30
420208,202304,21,17,4,22134.21,5208,27342.21
420209,202304,13,11,2,14322,2604,16926
420210,202304,634,298,336,390614.37,438777.31,829391.68
420213,202304,55,38,17,49476.69,22134,71610.69
420215,202304,27,23,4,29946.23,5208,35154.23
420220,202304,63,40,23,52080.89,29946,82026.89
420230,202304,1085,654,431,851552.78,563778.68,1415331.46
420240,202304,2485,1626,859,2118396.2,1118427.55,3236823.75
420243,202304,46,37,9,48175.22,11718,59893.22
420245,202304,247,119,128,154943.51,167962.61,322906.12
420250,202304,66,45,21,58591.2,27342,85933.2
420253,202304,23,18,5,23437.01,6510,29947.01
420257,202304,15,10,5,13020.5,6510,19530.5
420260,202304,133,104,29,136713.39,37758.14,174471.53
420270,202304,36,26,10,33852.19,13020.36,46872.55
420280,202304,305,227,78,295568.29,101557.18,397125.47
420285,202304,24,19,5,24738,6510,31248
420287,202304,48,30,18,39061.42,23436,62497.42
420290,202304,1021,695,326,904906.73,424452.75,1329359.48
420300,202304,1711,1362,349,1774708.96,454404.31,2229113.27
420310,202304,42,30,12,39060.7,15624,54684.7
420315,202304,23,19,4,24738.78,5208.74,29947.52
420320,202304,1123,530,593,690091.85,772100.4,1462192.25
420325,202304,6,3,3,3906,3906.3,7812.3
420330,202304,123,82,41,106765.17,54685.13,161450.30
420340,202304,203,136,67,177075.56,87234,264309.56
420350,202304,271,192,79,249991.63,102858.97,352850.60
420360,202304,705,539,166,703107.33,216134.74,919242.07
420370,202304,146,80,66,104162.4,85932.43,190094.83
420380,202304,1300,865,435,1127579.31,567678.56,1695257.87
420390,202304,231,163,68,212231.38,88536.4,300767.78
420395,202304,199,145,54,188805.47,70310.73,259116.20
420400,202304,231,174,57,226552.21,74214.2,300766.41
420410,202304,56,42,14,54686.5,18228,72914.5
420415,202304,33,26,7,33852.4,9114,42966.4
420417,202304,66,54,12,70308.61,15624,85932.61
420419,202304,12,10,2,13020,2604,15624
420420,202304,3120,1925,1195,2507725.43,1555903.48,4063628.91
420425,202304,76,54,22,70313.12,28644,98957.12
420430,202304,1055,758,297,988228.02,386696.85,1374924.87
420435,202304,14,11,3,14322,3906,18228
420440,202304,90,65,25,84632.26,32550,117182.26
420445,202304,32,29,3,37758.5,3906,41664.5
420450,202304,87,51,36,66404.97,46872,113276.97
420455,202304,179,135,44,175775.14,57288,233063.14
420460,202304,2536,1560,976,2031209.84,1273370.77,3304580.61
420470,202304,86,55,31,71610.2,40362,111972.2
420475,202304,9,8,1,10416.64,1302,11718.64
420480,202304,938,713,225,928377.45,292952.28,1221329.73
420490,202304,99,73,26,96351.87,33852,130203.87
420500,202304,416,249,167,324209.76,217435.77,541645.53
420510,202304,25,21,4,27342.34,5208,32550.34
420515,202304,28,14,14,18228.58,18228,36456.58
420517,202304,11,8,3,10416.91,3906,14322.91
420519,202304,4,3,1,3906,1302.5,5208.5
420520,202304,64,46,18,59894.09,23436.2,83330.29
420530,202304,143,92,51,119785.67,66402.2,186187.87
420535,202304,16,13,3,16926.41,3906,20832.41
420540,202304,7200,4436,2764,5782741.23,3601379.87,9384121.10
420543,202304,30,29,1,37759.28,1302,39061.28
420545,202304,226,156,70,203118.82,91140.6,294259.42
420550,202304,817,689,128,897116.66,166659.13,1063775.79
420555,202304,35,26,9,33853.14,11718,45571.14
420560,202304,65,50,15,65101.34,19530,84631.34
420570,202304,240,112,128,145827.54,166658.96,312486.50
420580,202304,338,170,168,221347.57,218737.53,440085.10
420590,202304,521,324,197,421859.23,256494.62,678353.85
420600,202304,162,88,74,114577.07,96348,210925.07
420610,202304,37,34,3,44269.5,3906,48175.5
420620,202304,75,59,16,76819.63,22134.41,98954.04
420630,202304,166,111,55,144524.89,71610,216134.89
420640,202304,71,64,7,83328.6,9114,92442.6
420650,202304,351,179,172,233062.19,223945.4,457007.59
420660,202304,41,31,10,40362.45,13020,53382.45
420665,202304,47,30,17,39061.6,22134,61195.6
420670,202304,241,183,58,238274.49,75516,313790.49
420675,202304,15,12,3,15624,3906,19530
420680,202304,34,28,6,36456.12,7812,44268.12
420690,202304,202,147,55,191397.32,71760.36,263157.68
420700,202304,744,483,261,628886.2,342430.35,971316.55
420710,202304,148,82,66,106766.04,85933.13,192699.17
420720,202304,97,79,18,102861.57,23436.39,126297.96
420730,202304,765,448,317,583317.23,412741.38,996058.61
420740,202304,61,59,2,76820.03,2604,79424.03
420750,202304,518,337,181,438778.2,236965.19,675743.39
420757,202304,18,15,3,19530,3906,23436
420760,202304,40,28,12,36456.86,15624,52080.86
420765,202304,77,53,24,69007.14,31248,100255.14
420768,202304,62,48,14,62498.91,18228,80726.91
420770,202304,75,65,10,84632.69,13020,97652.69
420775,202304,40,33,7,42966.45,9114,52080.45
420780,202304,208,160,48,208324.42,62496,270820.42
420785,202304,28,17,11,22134,14322,36456
420790,202304,139,114,25,148430.54,32550.09,180980.63
420800,202304,63,48,15,62496.62,19530,82026.62
420810,202304,291,219,72,285150.67,93744,378894.67
420820,202304,2822,1567,1255,2041617.4,1636642.74,3678260.14
420830,202304,763,410,353,533846.51,459617.83,993464.34
420840,202304,134,91,43,118482.95,55986,174468.95
420845,202304,473,205,268,266917.35,348939.37,615856.72
420850,202304,291,223,68,290347.94,88536.3,378884.24
420860,202304,57,49,8,63799.52,10416,74215.52
420870,202304,127,88,39,115878.98,50778,166656.98
420880,202304,201,125,76,162754.72,98952.2,261706.92
420890,202304,1060,518,542,674452.49,708290.48,1382742.97
420895,202304,10,9,1,11718,1302,13020
420900,202304,422,338,84,440085.03,109369.31,549454.34
420910,202304,6377,3482,2895,4540146.19,3771948.55,8312094.74
420915,202304,58,54,4,70308.2,5208,75516.2
420917,202304,21,16,5,20832.54,6510,27342.54
420920,202304,21,15,6,19530,9114,28644
420930,202304,3747,2521,1226,3284379.91,1596291.68,4880671.59
420940,202304,593,408,185,531246.93,240877.28,772124.21
420945,202304,10,8,2,10416,2604,13020
420950,202304,48,34,14,44268.6,18228,62496.6
420960,202304,114,92,22,119789.52,28644.1,148433.62
420970,202304,285,230,55,299473.72,71610.71,371084.43
420980,202304,23,22,1,28644,1302,29946
420985,202304,51,44,7,57289.85,9114,66403.85
420990,202304,93,69,24,89839.08,31250.76,121089.84
421000,202304,65,34,31,44268,40362,84630
421003,202304,32,22,10,28644.63,13020,41664.63
421005,202304,8,6,2,7812.3,2604,10416.3
421010,202304,917,588,329,765609.48,428365.22,1193974.70
421020,202304,18,17,1,22136.25,1302,23438.25
421030,202304,119,99,20,128899.45,26041.5,154940.95
421040,202304,67,49,18,63801.32,23437.33,87238.65
421050,202304,334,232,102,302066.33,132804,434870.33
421055,202304,16,13,3,16926.2,3906,20832.2
421060,202304,112,62,50,80725.33,65100,145825.33
421070,202304,35,31,4,40364.18,5208,45572.18
421080,202304,47,39,8,50778.58,10416,61194.58
421085,202304,17,13,4,16926,5208,22134
421090,202304,38,29,9,37758.11,11718,49476.11
421100,202304,118,88,30,114577.93,39060.95,153638.88
421105,202304,202,161,41,209629.46,53382.2,263011.66
421110,202304,135,91,44,118486.95,58590.8,177077.75
421120,202304,197,139,58,180984.62,75516.42,256501.04
421125,202304,17,10,7,13020,9114.52,22134.52
421130,202304,919,554,365,721332.34,476538.46,1197870.80
421140,202304,34,25,9,32550.39,11718,44268.39
421145,202304,44,38,6,49476.11,7812,57288.11
421150,202304,86,67,19,87235.23,24738,111973.23
421160,202304,64,42,22,54684.5,28644.38,83328.88
421165,202304,15,12,3,15624,3906.14,19530.14
421170,202304,168,142,26,186352.98,33852.61,220205.59
421175,202304,197,137,60,178378.58,78121.75,256500.33
421180,202304,40,26,14,33852.42,18228,52080.42
421185,202304,16,13,3,16926.18,3906,20832.18
421187,202304,3,2,1,2604,1302,3906
421189,202304,47,33,14,42966.58,18228,61194.58
421190,202304,2205,1388,817,1807264.24,1065061.82,2872326.06
421200,202304,97,68,29,88538.53,37758,126296.53
421205,202304,24,17,7,22136.32,9114,31250.32
421210,202304,180,130,50,169261.83,65100,234361.83
421220,202304,259,201,58,261705.3,75517.33,337222.63
421223,202304,52,39,13,50779.17,16926,67705.17
421225,202304,77,52,25,67706.53,32551.04,100257.57
421227,202304,64,55,9,71611.69,11718,83329.69
421230,202304,79,52,27,67705.56,35154.18,102859.74
421240,202304,15,13,2,16927.69,2604,19531.69
421250,202304,434,233,201,303374.34,261708.6,565082.94
421260,202304,22,17,5,22134.59,6510,28644.59
421265,202304,12,7,5,9115.62,6510.1,15625.72
421270,202304,55,49,6,63798,7812,71610
421280,202304,424,216,208,281241.62,270817.82,552059.44
421290,202304,315,206,109,268214.58,141919.03,410133.61
421300,202304,23,20,3,26040,3906,29946
421310,202304,51,36,15,46872,19530,66402
421315,202304,36,22,14,28645.03,18228.08,46873.11
421320,202304,143,96,47,124994.91,61194,186188.91
421330,202304,110,83,27,108067.51,35154.99,143222.50
421335,202304,45,32,13,41665.85,16926,58591.85
421340,202304,253,169,84,220042.93,109368.41,329411.34
421350,202304,191,113,78,147130.01,102858.25,249988.26
421360,202304,763,524,239,683567.5,312485.51,996053.01
421370,202304,206,154,52,200510.13,67704.81,268214.94
421380,202304,154,116,38,151032.95,49476,200508.95
421390,202304,14,9,5,13020,6510,19530
421400,202304,119,97,22,126294,28644,154938
421410,202304,20,17,3,22134,3906,26040
421415,202304,20,18,2,23436,2604,26040
421420,202304,101,84,17,109369.34,22134,131503.34
421430,202304,21,13,8,16926,10416,27342
421440,202304,64,54,10,70309.77,13020.98,83330.75
421450,202304,76,62,14,80724.5,18228,98952.5
421460,202304,54,43,11,55986.66,14322,70308.66
421470,202304,75,40,35,52080.51,45570,97650.51
421480,202304,831,617,214,803348.16,278630.28,1081978.44
421490,202304,23,22,1,28644.78,1302,29946.78
421500,202304,505,290,215,377602.4,279931.53,657533.93
421505,202304,42,35,7,45570.1,9114.2,54684.3
421507,202304,30,24,6,31248.6,7812,39060.6
421510,202304,67,42,25,54685.65,32550.61,87236.26
421520,202304,51,42,9,54684.98,11718,66402.98
421530,202304,52,44,8,57289.28,10416,67705.28
421535,202304,24,22,2,28645.29,2604,31249.29
421540,202304,49,40,9,52080.2,11718,63798.2
421545,202304,84,56,28,72916.49,36457.04,109373.53
421550,202304,307,222,85,289060.93,110671.86,399732.79
421555,202304,15,13,2,16927.56,2604,19531.56
421560,202304,8,7,1,9114,1302,10416
421565,202304,135,85,50,110672.62,65100.57,175773.19
421567,202304,39,29,10,37758,13020,50778
421568,202304,40,38,2,49476,2604,52080
421569,202304,10,10,0,13020.79,,13020.79
421570,202304,268,176,92,229156.97,119785.69,348942.66
421575,202304,27,24,3,31248.6,3906,35154.6
421580,202304,775,459,316,597717.45,412737.17,1010454.62
421590,202304,21,19,2,24738.2,2604,27342.2
421600,202304,185,131,54,170563.61,70308,240871.61
421605,202304,110,75,35,97652.71,45570.2,143222.91
421610,202304,173,126,47,164052.99,61194,225246.99
421620,202304,1123,637,486,829409.29,634085.06,1463494.35
421625,202304,24,21,3,27342.76,3906,31248.76
421630,202304,380,228,152,298169.78,197907.96,496077.74
421635,202304,29,15,14,19530,18228,37758
421640,202304,108,83,25,108071.18,32550,140621.18
421650,202304,344,197,147,256503.35,191397.13,447900.48
421660,202304,2877,1753,1124,2282488.92,1463479.77,3745968.69
421670,202304,160,116,44,151036.24,57288,208324.24
421680,202304,198,178,20,234365.52,26040,260405.52
421690,202304,359,240,119,312487.58,156241.29,468728.87
421700,202304,60,40,20,53382.7,26040.2,79422.9
421710,202304,21,21,0,27342.59,,27342.59
421715,202304,5,4,1,5209.53,1302,6511.53
421720,202304,672,445,227,579404.85,295557.61,874962.46
421725,202304,33,14,19,18228.6,24738.8,42967.4
421730,202304,23,18,5,23436,6510,29946
421740,202304,116,45,71,58590.71,92442,151032.71
421750,202304,193,140,53,182281.26,69006,251287.26
421755,202304,20,18,2,23436,2604,26040
421760,202304,105,71,34,92444.8,44268.19,136712.99
421770,202304,737,467,270,608058.49,351544.55,959603.04
421775,202304,29,19,10,24738.97,13020.09,37759.06
421780,202304,192,148,44,192696.4,57288,249984.4
421790,202304,155,130,25,169262,32550.15,201812.15
421795,202304,16,13,3,16926.33,3906,20832.33
421800,202304,613,363,250,472650.2,325507.73,798157.93
421810,202304,72,59,13,76819.18,16926,93745.18
421820,202304,318,194,124,253894.4,161448,415342.4
421825,202304,170,143,27,186192.48,35154,221346.48
421830,202304,163,101,62,131510.22,80725.04,212235.26
421835,202304,6,2,4,2604,5208,7812
421840,202304,43,35,8,45571.39,10416.91,55988.30
421850,202304,81,68,13,88537,16926,105463
421860,202304,38,27,11,35154.73,14322,49476.73
421870,202304,1233,877,356,1145807.58,464827.58,1610635.16
421875,202304,52,40,12,52080,15624,67704
421880,202304,196,138,58,179679.27,75516.7,255195.97
421885,202304,21,15,6,19530,7812.84,27342.84
421890,202304,174,127,47,165359.91,61195.24,226555.15
421895,202304,52,45,7,58591.92,9114,67705.92
421900,202304,136,103,33,134115.31,42966,177081.31
421910,202304,69,44,25,57289.2,32550,89839.2
421915,202304,32,25,7,32550,9114,41664
421917,202304,54,42,12,54685.88,15624,70309.88
421920,202304,37,33,4,42966,5208,48174
421930,202304,663,526,137,684872.69,178377.74,863250.43
421935,202304,48,41,7,53382.99,9114,62496.99
421940,202304,51,44,7,57288.4,9114,66402.4
421950,202304,956,630,326,821575.72,424456.51,1246032.23
421960,202304,42,35,7,45570.59,9114,54684.59
421970,202304,336,212,124,276029.09,161449.39,437478.48
421985,202304,19,12,7,15624.2,9114,24738.2
422000,202304,10,5,5,6510.2,6510.63,13020.83
430003,202304,195,60,135,78120.6,175770,253890.6
430005,202304,32,25,7,32550.82,9114,41664.82
430010,202304,264,194,70,252591.77,91140,343731.77
430020,202304,144,103,41,134108.01,53382.24,187490.25
430030,202304,130,104,26,135409.73,33852,169261.73
430040,202304,3071,1799,1272,2343643.52,1656563.72,4000207.24
430045,202304,74,65,9,84630,11718,96348
430047,202304,8,6,2,7812,2604,10416
430050,202304,92,77,15,100256.11,19530,119786.11
430055,202304,14,12,2,15624,2604,18228
430057,202304,5,3,2,3906,2604,6510
430060,202304,4494,2578,1916,3359306.5,2502473.48,5861779.98
430063,202304,59,47,12,61194,15624,76818
430064,202304,172,137,35,178374.8,45570,223944.8
430066,202304,7,4,3,5208,3906,9114
430070,202304,42,33,9,42966.16,11718,54684.16
430080,202304,86,57,29,74214.75,37758.18,111972.93
430085,202304,30,14,16,18228,20832,39060
430087,202304,34,25,9,32550.38,11718,44268.38
430090,202304,68,57,11,74214.76,14322,88536.76
430100,202304,155,104,51,135408.86,66402,201810.86
430105,202304,178,98,80,127603.39,104160.3,231763.69
430107,202304,22,17,5,22134.37,6510,28644.37
430110,202304,502,268,234,350239.42,304668,654907.42
430120,202304,182,166,16,216132.1,20832,236964.1
430130,202304,853,500,353,651009.29,459607.92,1110617.21
430140,202304,140,130,10,169260.6,13020,182280.6
430150,202304,117,72,45,93744.96,58590,152334.96
430155,202304,30,25,5,32550,6510,39060
430160,202304,3965,2208,1757,2876197.46,2294138.05,5170335.51
430163,202304,459,219,240,285147.92,312484.19,597632.11
430165,202304,31,19,12,24738.59,15624,40362.59
430170,202304,84,70,14,91140,18228,109368
430175,202304,85,66,19,85932,24738.97,110670.97
430180,202304,111,85,26,110670.74,33852,144522.74
430185,202304,26,18,8,23436,11718,35154
430187,202304,95,36,59,46873.58,76818,123691.58
430190,202304,243,122,121,158848.2,157544.29,316392.49
430192,202304,13,10,3,13020.9,3906,16926.9
430195,202304,17,13,4,16926.4,5208,22134.4
430200,202304,163,135,28,175774.66,36456,212230.66
430205,202304,19,19,0,24738,,24738.0
430210,202304,806,590,216,769498.95,281232.7,1050731.65
430215,202304,11,10,1,13020,1302,14322
430220,202304,78,53,25,69006,32550,101556
430222,202304,16,6,10,7812,13020,20832
430223,202304,17,11,6,14322,7812,22134
430225,202304,4,2,2,2604,2604,5208
430230,202304,368,229,139,298159.73,183582,481741.73
430235,202304,55,35,20,45570.11,26040,71610.11
430237,202304,20,15,5,19530,6510,26040
430240,202304,122,82,40,108067.35,52080,160147.35
430245,202304,68,55,13,71610,16926,88536
430250,202304,190,111,79,144523.67,104160.84,248684.51
430258,202304,12,9,3,11718.38,3906.2,15624.58
430260,202304,38,34,4,44268.1,5208,49476.1
430265,202304,37,33,4,42966,5208,48174
430270,202304,547,381,166,497382.11,216132,713514.11
430280,202304,1131,653,478,851516.54,623658.3,1475174.84
430290,202304,467,242,225,315090.13,292950,608040.13
430300,202304,2294,1241,1053,1617132.81,1372327.67,2989460.48
430310,202304,2345,1152,1193,1501278.3,1554621.76,3055900.06
430320,202304,61,49,12,65100,15624,80724
430330,202304,89,75,14,97650.36,18228,115878.36
430340,202304,74,58,16,75516,20832,96348
430350,202304,1785,1116,669,1454350.66,871039.55,2325390.21
430355,202304,19,17,2,22134,2604,24738
430360,202304,105,51,54,66402,70308,136710
430367,202304,52,37,15,48174,19530,67704
430370,202304,64,56,8,72912,10416,83328
430380,202304,111,78,33,101557.54,42966,144523.54
430390,202304,722,429,293,559794.57,381490.69,941285.26
430400,202304,262,179,83,233059.51,108066,341125.51
430410,202304,53,44,9,57288.2,11718,69006.2
430420,202304,565,360,205,468732.38,266911.49,735643.87
430430,202304,49,46,3,59024.86,3906,62930.86
430435,202304,154,112,42,145824.93,54684,200508.93
430440,202304,643,387,256,503886.47,334615.62,838502.09
430450,202304,1290,1049,241,1367120.32,313783.06,1680903.38
430460,202304,6429,3242,3187,4227742.27,4154739.17,8382481.44
430461,202304,17,15,2,19530,2604,22134
430462,202304,4,2,2,2604.1,2604,5208.1
430463,202304,1323,710,613,925745.95,799434.66,1725180.61
430465,202304,27,16,11,20832,14322,35154
430466,202304,787,552,235,718733.39,305977.69,1024711.08
430467,202304,132,74,58,96348.5,75516,171864.5
430468,202304,160,88,72,114577.5,93744.71,208322.21
430469,202304,21,14,7,18228.04,9114,27342.04
430470,202304,1240,668,572,871437.89,744748.44,1616186.33
430471,202304,83,57,26,74215.12,33852.57,108067.69
430480,202304,149,104,45,136711.06,58590,195301.06
430485,202304,8,8,0,10416.6,,10416.6
430490,202304,71,55,16,71610,20832,92442
430495,202304,32,23,9,29946.2,11718,41664.2
430500,202304,200,132,68,171864,88536,260400
430510,202304,4202,2683,1519,3495942.37,1977750.82,5473693.19
430511,202304,14,14,0,18228,,18228.0
430512,202304,182,123,59,160149.32,76818.4,236967.72
430513,202304,55,42,13,54684,16926,71610
430515,202304,24,22,2,28644.7,2604,31248.7
430517,202304,184,155,29,201810.2,37758,239568.2
430520,202304,343,238,105,309879.51,136710.35,446589.86
430530,202304,83,45,38,58590.7,49476,108066.7
430535,202304,490,314,176,408834.17,230458.14,639292.31
430537,202304,8,8,0,10416,,10416.0
430540,202304,82,54,28,70308.31,36456,106764.31
430543,202304,454,148,306,192696.24,398412.71,591108.95
430544,202304,54,50,4,65101.18,5208,70309.18
430545,202304,480,233,247,303384.97,322905.35,626290.32
430550,202304,48,37,11,48174.14,14322,62496.14
430558,202304,1,1,0,1302,,1302.0
430560,202304,54,31,23,40362,31248,71610
430570,202304,123,51,72,66405.16,93744,160149.16
430580,202304,127,101,26,131502.67,33852,165354.67
430583,202304,13,13,0,16926,,16926.0
430585,202304,14,11,3,14322.88,3906,18228.88
430587,202304,16,10,6,13020,7812.39,20832.39
430590,202304,196,158,38,205717.93,49476,255193.93
430593,202304,1,1,0,1302,,1302.0
430595,202304,18,14,4,18228,5208,23436
430597,202304,42,24,18,31248.66,23436,54684.66
430600,202304,228,166,62,217434,80724,298158
430605,202304,186,112,74,145824,97650,243474
430607,202304,32,25,7,32550,9114,41664
430610,202304,1891,893,998,1162703.48,1300702.68,2463406.16
430613,202304,5,5,0,6510,,6510.0
430620,202304,101,69,32,89838.56,41664,131502.56
430630,202304,49,42,7,54685.13,9114,63799.13
430632,202304,31,27,4,35154,5208,40362
430635,202304,36,28,8,36456,10416,46872
430637,202304,66,31,35,40362,45570,85932
430640,202304,177,98,79,127600.73,102858.54,230459.27
430642,202304,17,15,2,19530,2604,22134
430645,202304,34,28,6,36456,7812,44268
430650,202304,243,195,48,253893.75,63798.2,317691.95
430655,202304,13,11,2,14322,2604,16926
430660,202304,1052,516,536,673148.14,701786.66,1374934.80
430670,202304,71,48,23,62496,29946,92442
430673,202304,84,57,27,74214,35154,109368
430675,202304,9,7,2,9114,2604,11718
430676,202304,695,421,274,548155.99,358052.81,906208.80
430680,202304,259,170,89,221342.61,115878,337220.61
430690,202304,581,350,231,457009.45,300764.73,757774.18
430692,202304,8,6,2,7812.7,2604,10416.7
430693,202304,142,91,51,118483.4,66402.2,184885.6
430695,202304,69,54,15,70308,19530,89838
430697,202304,68,43,25,55986,32550,88536
430700,202304,1428,960,468,1249940.43,609336.31,1859276.74
430705,202304,31,26,5,33852.7,6510,40362.7
430710,202304,280,172,108,223944,140616,364560
430720,202304,100,83,17,108066,22134,130200
430730,202304,153,129,24,167958,31248,199206
430740,202304,86,52,34,67704.4,44268,111972.4
430745,202304,28,16,12,20832,15624,36456
430750,202304,324,209,115,272119.76,149730.79,421850.55
430755,202304,84,47,37,61195.09,48174,109369.09
430760,202304,457,246,211,320299.8,274724.55,595024.35
430770,202304,1791,971,820,1265581.91,1067649.81,2333231.72
430780,202304,377,230,147,299460.12,191394,490854.12
430781,202304,24,24,0,31248,,31248.0
430783,202304,63,46,17,59892,22134,82026
430786,202304,8,6,2,7812,2604,10416
430790,202304,562,349,213,454405.56,277329.19,731734.75
430800,202304,169,125,44,162750,57288,220038
430805,202304,38,31,7,40362,9114,49476
430807,202304,76,44,32,57288,41664,98952
430810,202304,80,52,28,67704.63,36456,104160.63
430820,202304,162,103,59,134108.54,76818,210926.54
430825,202304,11,9,2,11718,2604,14322
430830,202304,272,252,20,328106.71,26040,354146.71
430840,202304,148,98,50,128898.92,65100,193998.92
430843,202304,7,4,3,5208,3906,9114
430845,202304,85,50,35,65100,45570,110670
430850,202304,609,431,178,561165.96,231756,792921.96
430860,202304,177,119,58,154940.04,75516.82,230456.86
430865,202304,79,43,36,55986.6,46872,102858.6
430870,202304,72,59,13,76818.78,16926,93744.78
430880,202304,183,124,59,161452.05,76818.8,238270.85
430885,202304,11,9,2,11718,2604,14322
430890,202304,347,209,138,272120.1,179676,451796.1
430900,202304,561,383,178,498671.62,231756.02,730427.64
430905,202304,149,66,83,85932.57,108067.35,193999.92
430910,202304,307,162,145,210926.57,190092.8,401019.37
430912,202304,5,5,0,6510.32,,6510.32
430915,202304,43,40,3,52080,3906,55986
430920,202304,5188,2684,2504,3497323.32,3264174.71,6761498.03
430925,202304,7,6,1,7812,1302,9114
430930,202304,2304,1281,1023,1667899.03,1334555.96,3002454.99
430940,202304,283,182,101,236964.38,131503.1,368467.48
430950,202304,162,129,33,167960.23,42966,210926.23
430955,202304,27,16,11,20832.7,14322,35154.7
430957,202304,25,22,3,28644.11,3906,32550.11
430960,202304,278,180,98,234361.68,127597.07,361958.75
430965,202304,109,71,38,92442.09,49476,141918.09
430970,202304,95,74,21,96348,27342,123690
430975,202304,54,47,7,61194.86,9114,70308.86
430980,202304,52,31,21,40362.7,27342,67704.7
430990,202304,98,77,21,100254,27342,127596
430995,202304,115,106,9,138012,11718,149730
431000,202304,304,150,154,195301.2,200508,395809.2
431010,202304,378,225,153,292965.44,199209.03,492174.47
431020,202304,2035,1155,880,1503831.68,1145762.99,2649594.67
431030,202304,41,32,9,41664,11718,53382
431033,202304,517,233,284,303385.75,369782.96,673168.71
431036,202304,12,8,4,10416,5208,15624
431040,202304,151,102,49,132804.36,63798.45,196602.81
431041,202304,45,27,18,35154,23436,58590
431043,202304,40,22,18,28644.42,23436,52080.42
431046,202304,12,9,3,11718,3906,15624
431050,202304,212,132,80,171865.17,104160,276025.17
431053,202304,74,40,34,52081.12,44270.14,96351.26
431055,202304,66,43,23,55986,29946,85932
431057,202304,20,20,0,26040,,26040.0
431060,202304,1660,1055,605,1373626.95,790316.57,2163943.52
431065,202304,18,8,10,10416,13020,23436
431070,202304,65,57,8,74214.27,10416,84630.27
431075,202304,7,7,0,9114,,9114.0
431080,202304,135,73,62,95046.54,80724,175770.54
431085,202304,38,33,5,42966.51,6510,49476.51
431087,202304,17,13,4,16926,5208,22134
431090,202304,50,40,10,52080.3,13020,65100.3
431100,202304,1344,799,545,1040317.98,709593.86,1749911.84
431110,202304,234,142,92,184888.17,121086,305974.17
431112,202304,28,22,6,28644.33,7812,36456.33
431113,202304,32,20,12,26040.82,15624,41664.82
431115,202304,154,109,45,141918.66,58590,200508.66
431120,202304,619,360,259,468726.92,337218,805944.92
431123,202304,5,5,0,6510,,6510.0
431125,202304,98,85,13,110670,16926,127596
431127,202304,5,3,2,3906,2604,6510
431130,202304,740,473,267,617157.37,348939.45,966096.82
431140,202304,876,612,264,796832.96,345030.8,1141863.76
431142,202304,16,15,1,19530.69,1302,20832.69
431150,202304,208,145,63,188792.04,82026,270818.04
431160,202304,40,36,4,46872.7,5208,52080.7
431162,202304,7,5,2,6510.74,2604,9114.74
431164,202304,7,6,1,7812,1302,9114
431170,202304,120,85,35,110670.2,45570,156240.2
431171,202304,80,46,34,59892,44268,104160
431173,202304,6,5,1,6510,1302.8,7812.8
431175,202304,209,109,100,141918.88,130200.48,272119.36
431177,202304,112,75,37,97651.24,49476.31,147127.55
431179,202304,16,11,5,14322,6510,20832
431180,202304,423,260,163,339826.37,212226.97,552053.34
431190,202304,73,55,18,71610.6,23436.7,95047.3
431198,202304,78,54,24,70173.46,31248,101421.46
431200,202304,22,18,4,23436,5208,28644
431205,202304,24,22,2,28644.7,2604,31248.7
431210,202304,111,67,44,87234.7,57288,144522.7
431213,202304,32,26,6,33852,7812.56,41664.56
431215,202304,23,22,1,28644,1302,29946
431217,202304,6,5,1,6510,1302,7812
431220,202304,71,59,12,76818.99,15624,92442.99
431225,202304,180,109,71,141918.74,92442,234360.74
431230,202304,106,85,21,110673.21,27342,138015.21
431235,202304,5,4,1,5208,1302,6510
431237,202304,17,12,5,15624.02,6510,22134.02
431238,202304,17,12,5,15624,6510.2,22134.2
431240,202304,1039,634,405,828014.41,527311.96,1355326.37
431242,202304,43,41,2,54684,2604,57288
431244,202304,37,31,6,40363.52,7812,48175.52
431245,202304,54,40,14,52080.87,18228,70308.87
431247,202304,18,10,8,13020,10416,23436
431250,202304,319,153,166,199208,216132,415340
431260,202304,55,46,9,59892,11718,71610
431261,202304,24,17,7,22134.75,9114,31248.75
431262,202304,14,12,2,15624,2604,18228
431265,202304,155,87,68,113274.57,88536,201810.57
431267,202304,19,16,3,20832,3906,24738
431270,202304,346,263,83,342431.17,108067.25,450498.42
431275,202304,40,36,4,46872,5208,52080
431280,202304,21,16,5,20832,6510,27342
431290,202304,29,26,3,33852.65,3906,37758.65
431295,202304,4,1,3,1302,3906,5208
431300,202304,22,19,3,26040.6,3906,29946.6
431301,202304,7,7,0,9114,,9114.0
431303,202304,58,37,21,48174,27342,75516
431306,202304,248,124,124,161449.29,161448,322897.29
431308,202304,8,7,1,9114.6,1302,10416.6
431310,202304,64,49,15,63798.16,19530,83328.16
431320,202304,236,147,89,191395.32,115878,307273.32
431330,202304,230,153,77,199207.97,100254,299461.97
431333,202304,25,21,4,27342,5208,32550
431335,202304,10,7,3,9114.19,3906,13020.19
431337,202304,470,232,238,302076.14,309879.76,611955.90
431339,202304,26,19,7,24738,9114,33852
431340,202304,3376,1800,1576,2346161.27,2053263.47,4399424.74
431342,202304,37,25,12,32550,15624,48174
431344,202304,24,23,1,29946,1302,31248
431346,202304,5,4,1,5208,1302,6510
431349,202304,29,27,2,35154,2604,37758
431350,202304,1000,560,440,729151.03,575489.85,1304640.88
431360,202304,59,42,17,54684,22134,76818
431365,202304,397,171,226,222646.44,294252.49,516898.93
431370,202304,1269,708,561,921839.69,733030.15,1654869.84
431380,202304,103,91,12,118483.97,15624,134107.97
431390,202304,513,281,232,365865.72,302065.4,667931.12
431395,202304,338,147,191,191395.17,248682,440077.17
431400,202304,38,24,14,31248,18228,49476
431402,202304,95,70,25,91141.13,32550.21,123691.34
431403,202304,30,20,10,26040.09,13020,39060.09
431405,202304,773,446,327,580716.64,425761.28,1006477.92
431406,202304,37,29,8,37758.14,10416,48174.14
431407,202304,49,37,12,48174,15624,63798
431410,202304,3748,2294,1454,2988173.04,1898339.83,4886512.87
431413,202304,16,13,3,16926,3906,20832
431415,202304,80,59,21,76819.38,27342,104161.38
431417,202304,24,13,11,16926,14322,31248
431420,202304,391,260,131,338526.96,171864.1,510391.06
431430,202304,71,33,38,42967.34,49476,92443.34
431440,202304,9951,6670,3281,8688581.09,4274577.3,12963158.39
431442,202304,29,15,14,19530,18228,37758
431445,202304,30,28,2,36456,2604,39060
431446,202304,5,5,0,6510.04,,6510.04
431447,202304,89,68,21,88536.9,27342,115878.9
431449,202304,64,50,14,65100.52,18228,83328.52
431450,202304,442,291,151,380185.23,196602.6,576787.83
431454,202304,12,7,5,9114,6510,15624
431455,202304,49,38,11,49476.03,14322,63798.03
431460,202304,517,350,167,455709.12,218736,674445.12
431470,202304,141,104,37,135408.25,48174,183582.25
431475,202304,10,8,2,10416,2604,13020
431477,202304,40,24,16,31248,20832,52080
431478,202304,7,7,0,9114,,9114.0
431480,202304,786,473,313,615862.84,407528.09,1023390.93
431490,202304,32947,18367,14580,23931371.72,19014661.88,42946033.60
431500,202304,79,58,21,75516,27342,102858
431505,202304,29,20,9,26040.85,11718,37758.85
431507,202304,9,8,1,10416,1302,11718
431510,202304,244,174,70,226550.01,91140,317690.01
431513,202304,19,18,1,23438.06,1302,24740.06
431514,202304,5,3,2,3906,2604,6510
431515,202304,82,70,12,91140.65,15624,106764.65
431517,202304,6,4,2,5208,2604,7812
431520,202304,41,33,8,42966.2,10416,53382.2
431530,202304,1459,632,827,822875.33,1078057.13,1900932.46
431531,202304,22,20,2,26040.7,2604,28644.7
431532,202304,38,27,11,35154,14322,49476
431535,202304,29,16,13,20832,16926,37758
431540,202304,143,112,31,145827.1,40362.6,186189.7
431545,202304,14,11,3,14322,3906,18228
431550,202304,370,191,179,248687.54,233059.23,481746.77
431555,202304,18,14,4,18228.32,5208,23436.32
431560,202304,5243,3468,1775,4520732.49,2312405.39,6833137.88
431570,202304,920,488,432,636692.88,563771.8,1200464.68
431575,202304,61,36,25,46872,32550.58,79422.58
431580,202304,83,60,23,78120,29946,108066
431590,202304,150,125,25,162750.71,32550,195300.71
431595,202304,19,17,2,22134.85,2604,24738.85
431600,202304,266,153,113,199212.28,147127.63,346339.91
431610,202304,123,90,33,117182.47,42966.2,160148.67
431620,202304,35,28,7,36456,9114,45570
431630,202304,124,99,25,128898.79,32550,161448.79
431640,202304,1357,832,525,1084581.85,683551.01,1768132.86
431642,202304,33,29,4,37758,5208,42966
431643,202304,43,17,26,22134,33852,55986
431645,202304,348,205,143,266911.14,186186,453097.14
431647,202304,14,13,1,16926,1302,18228
431650,202304,36,21,15,27342,19530,46872
431660,202304,265,169,96,221340.73,127596,348936.73
431670,202304,236,100,136,131503.61,178374.11,309877.72
431673,202304,12,10,2,13020,2604,15624
431675,202304,29,21,8,27342,10416,37758
431680,202304,1243,890,353,1158828.13,462216.31,1621044.44
431690,202304,5416,3134,2282,4091020.4,2972514.34,7063534.74
431695,202304,18,11,7,14322,9114,23436
431697,202304,4,2,2,2604,2604,5208
431700,202304,203,150,53,195300.91,69006,264306.91
431710,202304,4418,1864,2554,2429574.78,3326624.85,5756199.63
431720,202304,1325,814,511,1059190.19,665322.85,1724513.04
431725,202304,3,1,2,1302,2604,3906
431730,202304,1263,825,438,1075510.13,571587.82,1647097.95
431740,202304,1385,680,705,885374.01,917915.21,1803289.22
431750,202304,1891,1233,658,1607998.53,858023.3,2466021.83
431755,202304,5,4,1,5208,1302,6510
431760,202304,1042,657,385,855436.31,501276.2,1356712.51
431770,202304,428,285,143,371071.22,186186,557257.22
431775,202304,28,20,8,26040,10416,36456
431780,202304,605,366,239,476534.7,312480,789014.7
431790,202304,150,115,35,149731.6,45570.1,195301.7
431795,202304,14,12,2,15624,2604,18228
431800,202304,3237,1676,1561,2182190.26,2032432.73,4214622.99
431805,202304,19,15,4,19530,5208,24738
431810,202304,591,380,211,494766.66,274722.64,769489.30
431820,202304,367,204,163,266911.61,213528,480439.61
431830,202304,2463,1490,973,1941241.91,1269454.31,3210696.22
431840,202304,524,332,192,432278.43,249984.59,682263.02
431842,202304,34,28,6,36456,7812,44268
431843,202304,8,6,2,7812.16,2604,10416.16
431844,202304,17,13,4,16926,5208,22134
431845,202304,26,24,2,31248,2604,33852
431846,202304,27,23,4,29946.72,5208,35154.72
431848,202304,13,10,3,13020.6,3906,16926.6
431849,202304,6,5,1,6510,1302,7812
431850,202304,853,667,186,868459.6,242174.52,1110634.12
431860,202304,116,75,41,97650.74,53382,151032.74
431861,202304,4,0,4,,5208,5208.0
431862,202304,68,49,19,63798.65,24738,88536.65
431870,202304,4139,2385,1754,3107997.26,2286344.53,5394341.79
431880,202304,1046,725,321,947870.09,417943.29,1365813.38
431890,202304,1291,737,554,959588.16,721309.08,1680897.24
431900,202304,198,129,69,167958.56,89838,257796.56
431910,202304,47,36,11,46872.1,14322,61194.1
431912,202304,53,36,17,46873.27,22134,69007.27
431915,202304,161,122,39,158845.23,50778,209623.23
431920,202304,159,112,47,145824.35,61194,207018.35
431930,202304,77,61,16,79422,20832,100254
431935,202304,4,3,1,3906,1302,5208
431936,202304,2,2,0,2604,,2604.0
431937,202304,23,18,5,23436.2,6510,29946.2
431940,202304,492,340,152,442690.13,197904.46,640594.59
431950,202304,515,324,191,423166.32,248683,671849.32
431960,202304,772,423,349,550757.9,455701.35,1006459.25
431970,202304,64,58,6,75516.85,7812,83328.85
431971,202304,4,3,1,3906,1302,5208
431973,202304,20,17,3,22134.7,3906,26040.7
431975,202304,10,10,0,13020.2,,13020.2
431980,202304,219,123,96,160147.48,124992,285139.48
431990,202304,1036,556,480,723935.96,626273.95,1350209.91
432000,202304,2110,1121,989,1459610.1,1288998.63,2748608.73
432010,202304,266,173,93,225247.18,121086.2,346333.38
432020,202304,196,167,29,217436.99,37758.4,255195.39
432023,202304,16,14,2,18228,2604,20832
432026,202304,61,53,8,69006.1,10416,79422.1
432030,202304,57,25,32,32550.11,41664,74214.11
432032,202304,15,12,3,15624,3906,19530
432035,202304,74,54,20,70308.4,26040,96348.4
432040,202304,86,59,27,76819.09,35154,111973.09
432045,202304,3,3,0,3906,,3906.0
432050,202304,83,52,31,69006.69,40362,109368.69
432055,202304,136,93,43,121087.96,55986,177073.96
432057,202304,7,4,3,5209.3,3906,9115.3
432060,202304,31,26,5,33852,6510,40362
432065,202304,35,30,5,39060,6510,45570
432067,202304,85,78,7,102858.59,9114,111972.59
432070,202304,395,311,84,404928.19,109368,514296.19
432080,202304,871,614,257,800765.39,335919.29,1136684.68
432085,202304,23,19,4,24738,5208,29946
432090,202304,286,189,97,246078.2,126294.33,372372.53
432100,202304,179,111,68,144522.21,88536,233058.21
432110,202304,590,389,201,506484.94,263004.04,769488.98
432120,202304,1119,628,491,818976.06,640589.37,1459565.43
432130,202304,550,388,162,505178.99,210924,716102.99
432132,202304,21,19,2,24738,2604,27342
432135,202304,84,65,19,84630.66,24738,109368.66
432140,202304,279,210,69,273422.29,89838,363260.29
432143,202304,237,144,93,187491.33,121086.24,308577.57
432145,202304,316,221,95,287746.65,123690,411436.65
432146,202304,17,15,2,19530,2604,22134
432147,202304,103,62,41,80724,53382,134106
432149,202304,15,12,3,15624,3906,19530
432150,202304,1164,730,434,950486.27,565072.82,1515559.09
432160,202304,2165,1097,1068,1430936.11,1390549.87,2821485.98
432162,202304,7,4,3,5208,3906,9114
432163,202304,15,10,5,13020,6510,19530
432166,202304,135,93,42,121414.51,54685.73,176100.24
432170,202304,249,128,121,166661.6,157542.9,324204.5
432180,202304,589,374,215,489552.54,279930,769482.54
432183,202304,14,13,1,16926.43,1302,18228.43
432185,202304,84,68,16,88536.36,20832.42,109368.78
432190,202304,553,325,228,423151.08,298158.2,721309.28
432195,202304,94,74,20,96348.7,26040,122388.7
432200,202304,464,279,185,364567.45,240871.9,605439.35
432210,202304,121,71,50,92442.1,65100,157542.1
432215,202304,32,30,2,39060,2604,41664
432218,202304,20,20,0,26040,,26040.0
432220,202304,687,341,346,443991.37,451797.86,895789.23
432225,202304,20,15,5,19530.2,6510,26040.2
432230,202304,128,82,46,108066,59893.01,167959.01
432232,202304,31,28,3,36456,3906,40362
432234,202304,5,3,2,3906,2604,6510
432235,202304,2,2,0,2604,,2604.0
432237,202304,24,16,8,20832,10416,31248
432240,202304,4826,2681,2145,3493368.01,2795438.25,6288806.26
432250,202304,1219,814,405,1061142.24,527311.2,1588453.44
432252,202304,53,48,5,62496,6510,69006
432253,202304,74,56,18,72913.67,23436,96349.67
432254,202304,31,15,16,19530,20832,40362
432255,202304,11,10,1,13020,1302,14322
432260,202304,928,745,183,971311.06,238266.1,1209577.16
432270,202304,231,169,62,220051.61,80726.92,300778.53
432280,202304,176,133,43,173171.16,55986,229157.16
432285,202304,1,1,0,1302,,1302.0
432290,202304,60,49,11,63798,14322,78120
432300,202304,5574,2969,2605,3868274.14,3396946.42,7265220.56
432310,202304,134,112,22,145825.43,28644,174469.43
432320,202304,19,14,5,18228,6510,24738
432330,202304,18,12,6,16926,7812,24738
432335,202304,9,7,2,9114,2604,11718
432340,202304,35,27,8,35154,10416,45570
432345,202304,129,85,44,110673.31,57288,167961.31
432350,202304,26,25,1,32550,1302,33852
432360,202304,5,4,1,5208.7,1302,6510.7
432370,202304,28,27,1,35154.88,1302,36456.88
432375,202304,29,27,2,35154,2604,37758
432377,202304,9,9,0,11718.48,,11718.48
432380,202304,230,108,122,140619.29,158847.11,299466.40
500020,202304,311,162,149,210926.19,195300.8,406226.99
500025,202304,153,72,81,93746.43,105463.12,199209.55
500060,202304,1566,992,574,1291627.34,747357.76,2038985.10
500070,202304,797,391,406,509095.62,531225.81,1040321.43
500080,202304,148,119,29,154942.76,39060,194002.76
500085,202304,149,109,40,141922.01,52080,194002.01
500090,202304,406,194,212,252593.23,278629.5,531222.73
500100,202304,713,371,342,483056.51,445287.7,928344.21
500110,202304,2426,1171,1255,1526001.53,1634037.67,3160039.20
500124,202304,281,148,133,192696.2,173167.7,365863.9
500150,202304,345,140,205,182283,268213.79,450496.79
500190,202304,609,404,205,526025.15,266913.11,792938.26
500200,202304,217,177,40,230459.12,52080,282539.12
500210,202304,1813,566,1247,740850.99,1628818.06,2369669.05
500215,202304,211,123,88,160153.92,114576.2,274730.12
500220,202304,750,466,284,606755.62,371072.65,977828.27
500230,202304,252,145,107,188793.92,140616.39,329410.31
500240,202304,687,424,263,554668.71,342431.22,897099.93
500260,202304,624,252,372,328108.14,484344.46,812452.60
500270,202304,33114,14428,18686,18798279.52,24353025.42,43151304.94
500280,202304,207,72,135,93744.79,177072.66,270817.45
500290,202304,1244,778,466,1014293.04,609340.89,1623633.93
500295,202304,523,346,177,450500.2,230455.09,680955.29
500310,202304,121,40,81,52080.1,105462.81,157542.91
500315,202304,892,483,409,628867.13,532520.16,1161387.29
500320,202304,3943,1843,2100,2403591.05,2749841.16,5153432.21
500325,202304,1012,571,441,743475.39,574188.98,1317664.37
500330,202304,1632,796,836,1037783.4,1088489.23,2126272.63
500345,202304,327,228,99,296862.18,130200.21,427062.39
500348,202304,264,159,105,207022.46,136710,343732.46
500350,202304,104,50,54,65101.43,70309.14,135410.57
500370,202304,6190,2810,3380,3659003.6,4407314.71,8066318.31
500375,202304,377,248,129,324202.3,167958.36,492160.66
500380,202304,702,386,316,503890.43,411434.39,915324.82
500390,202304,77,33,44,42966.1,59893.2,102859.3
500400,202304,233,141,92,183586.82,119784.97,303371.79
500410,202304,469,209,260,272127.62,339826.58,611954.20
500430,202304,639,392,247,510398.83,321595.89,831994.72
500440,202304,212,119,93,154938.14,121086.2,276024.34
500450,202304,460,199,261,259102.99,342426.95,601529.94
500460,202304,288,157,131,204418.06,170562.96,374981.02
500470,202304,449,320,129,416652.25,167958.59,584610.84
500480,202304,111,64,47,83328.66,61195.43,144524.09
500490,202304,92,40,52,52080.68,67707.22,119787.90
500500,202304,1570,576,994,749974.98,1294195.05,2044170.03
500510,202304,39,33,6,42966.51,7812,50778.51
500515,202304,123,83,40,108068.75,52080.89,160149.64
500520,202304,298,150,148,195307.35,192696.16,388003.51
500525,202304,98,51,47,66402.14,61194,127596.14
500540,202304,965,416,549,542955.17,714806.48,1257761.65
500560,202304,909,509,400,662730.24,520803.25,1183533.49
500568,202304,1166,547,619,712209,805944.12,1518153.12
500570,202304,1281,729,552,949181.46,720012.78,1669194.24
500580,202304,316,174,142,226555.06,184885.24,411440.30
500600,202304,424,201,223,261707.75,291650.86,553358.61
500620,202304,1078,744,334,970019.86,436179.48,1406199.34
500625,202304,92,70,22,91140.41,28644,119784.41
500627,202304,42,18,24,23436,31248,54684
500630,202304,1674,957,717,1245503.37,934843.07,2180346.44
500635,202304,529,308,221,401018.68,287742,688760.68
500640,202304,368,199,169,259109.33,220040.94,479150.27
500660,202304,6458,2291,4167,2985560.81,5430683.47,8416244.28
500690,202304,671,240,431,312486.77,561162.26,873649.03
500710,202304,428,211,217,274727.1,283839.6,558566.7
500720,202304,1009,547,462,712217.24,601527.76,1313745.00
500730,202304,151,93,58,121092.92,75516,196608.92
500740,202304,1033,445,588,579409.6,766882.98,1346292.58
500750,202304,207,75,132,97653.15,171866.9,269520.05
500755,202304,115,85,30,110674.78,39060.93,149735.71
500769,202304,806,449,357,585916.46,466119.61,1052036.07
500770,202304,451,240,211,312480.99,274722,587202.99
500780,202304,138,94,44,122396.01,57289.33,179685.34
500790,202304,1157,558,599,729147.6,781205.04,1510352.64
500793,202304,310,158,152,205720.3,197907.88,403628.18
500795,202304,204,130,74,169262.68,96348.99,265611.67
500797,202304,49,34,15,44268.62,19530,63798.62
500800,202304,453,201,252,261707.83,329407.25,591115.08
500830,202304,2531,1309,1222,1706992.39,1591053.35,3298045.74
500840,202304,112,79,33,102863.15,42966.02,145829.17
510010,202304,174,94,80,122388,104160,226548
510020,202304,574,278,296,361970.29,388000.19,749970.48
510025,202304,1854,1055,799,1373652.96,1042915.26,2416568.22
510030,202304,679,361,318,471343.08,415345.01,886688.09
510035,202304,135,70,65,91140.17,84630,175770.17
510040,202304,427,198,229,257799.44,298159.74,555959.18
510050,202304,391,203,188,264313.69,244779.12,509092.81
510060,202304,141,60,81,78122.74,105462,183584.74
510080,202304,260,112,148,145826.21,192696,338522.21
510100,202304,68,28,40,36456.55,52080.2,88536.75
510120,202304,32,19,13,24738.99,16926.62,41665.61
510125,202304,406,259,147,337219.91,191394.21,528614.12
510130,202304,560,333,227,433579.18,296858.26,730437.44
510140,202304,467,156,311,203113.28,404923.05,608036.33
510160,202304,114,45,69,58591.32,89839.29,148430.61
510170,202304,818,485,333,631486.83,433572.56,1065059.39
510180,202304,3172,1429,1743,1863214.22,2273321.07,4136535.29
510185,202304,35,18,17,23436.7,22134,45570.7
510190,202304,267,89,178,115880.6,231758.39,347638.99
510250,202304,2888,1751,1137,2281151.91,1480381.8,3761533.71
510260,202304,173,122,51,158845.69,66403.12,225248.81
510263,202304,501,283,218,368474.39,283840.91,652315.30
510267,202304,643,362,281,471342.07,365864.35,837206.42
510268,202304,79,37,42,48174.01,54684,102858.01
510269,202304,81,37,44,48174,57288.5,105462.5
510270,202304,399,192,207,249985.4,272118.98,522104.38
510279,202304,218,161,57,209624.48,74214,283838.48
510285,202304,185,74,111,96349.59,144522,240871.59
510300,202304,553,287,266,373678.78,346334.33,720013.11
510305,202304,208,92,116,119784.2,151032.11,270816.31
510310,202304,110,58,52,75516.93,67704.1,143221.03
510320,202304,844,525,319,683564.21,415340.92,1098905.13
510325,202304,475,203,272,264310.3,356750.25,621060.55
510330,202304,478,271,207,352850.39,269515.37,622365.76
510335,202304,716,420,296,546858.31,386697.13,933555.44
510336,202304,53,35,18,45571.44,23436.64,69008.08
510337,202304,106,44,62,57288,80724,138012
510340,202304,19858,8447,11411,11007562.43,14875632.29,25883194.72
510343,202304,61,47,14,61194,18228,79422
510345,202304,156,95,61,123691.31,79423.28,203114.59
510350,202304,674,353,321,459617.65,417947.08,877564.73
510360,202304,230,142,88,184888.23,114576,299464.23
510370,202304,179,76,103,98952,134106.7,233058.7
510380,202304,80,59,21,76818,27342,104160
510385,202304,59,32,27,41664.2,35154,76818.2
510390,202304,100,46,54,59892.32,70308.63,130200.95
510395,202304,60,42,18,54684,23436,78120
510410,202304,851,541,310,704406.26,404928.68,1109334.94
510420,202304,580,283,297,368470.16,386694.7,755164.86
510450,202304,50,28,22,36456,28644,65100
510452,202304,62,29,33,37758,42966,80724
510454,202304,59,26,33,33852,42966.03,76818.03
510455,202304,124,72,52,93744,67704.97,161448.97
510460,202304,201,86,115,111974.42,149730,261704.42
510480,202304,789,455,334,593732.8,434877.87,1028610.67
510490,202304,341,165,176,214832.6,230454.5,445287.1
510500,202304,248,186,62,242172.88,80724,322896.88
510510,202304,905,529,376,688775.82,492161.65,1180937.47
510515,202304,1361,701,660,912722.81,860627.81,1773350.62
510517,202304,288,130,158,169263.54,207018,376281.54
510520,202304,241,149,92,194002.69,119784.62,313787.31
510523,202304,119,92,27,119784,35154,154938
510525,202304,941,583,358,759085.23,466119.35,1225204.58
510530,202304,28,15,13,19530,16926,36456
510550,202304,259,117,142,152337.04,184886.06,337223.10
510558,202304,330,164,166,213776.7,216132,429908.7
510560,202304,405,238,167,309882.12,217435.86,527317.98
510562,202304,694,492,202,640602.81,263005.62,903608.43
510590,202304,734,358,376,466128.93,489554.43,955683.36
510600,202304,222,118,104,153641.93,135408.93,289050.86
510610,202304,231,103,128,135411.19,166657.4,302068.59
510615,202304,238,112,126,145825,164052.31,309877.31
510617,202304,27,11,16,14322,20832,35154
510618,202304,131,64,67,83328,87236.04,170564.04
510619,202304,85,60,25,78121.86,32550,110671.86
510620,202304,170,89,81,115878.7,105462,221340.7
510621,202304,183,118,65,153636.19,84630.23,238266.42
510622,202304,527,277,250,360668.63,325505.15,686173.78
510623,202304,301,204,97,265611.55,126294.2,391905.75
510624,202304,94,44,50,57289.18,65100.83,122390.01
510625,202304,557,347,210,451808.97,273425.49,725234.46
510626,202304,121,65,56,84632.67,72912,157544.67
510627,202304,97,65,32,85933.2,41664.2,127597.4
510628,202304,175,107,68,139314.45,88536,227850.45
510629,202304,302,182,120,236966.57,156263.43,393230.00
510630,202304,475,244,231,317700.58,300763.63,618464.21
510631,202304,22,9,13,11718.13,16926,28644.13
510637,202304,366,211,155,274726.51,201810,476536.51
510642,202304,1248,667,581,868456.34,757772.17,1626228.51
510645,202304,13,3,10,3906,13020,16926
510650,202304,1304,838,466,1091125.04,606736.71,1697861.75
510665,202304,100,45,55,58590.85,71610.08,130200.93
510670,202304,59,34,25,44268.32,32550,76818.32
510675,202304,1158,736,422,959606.06,550749.93,1510355.99
510677,202304,360,187,173,243478.72,226549.37,470028.09
510680,202304,90,55,35,71611.95,45570,117181.95
510682,202304,196,92,104,119784.52,135408,255192.52
510685,202304,55,40,15,52080.47,19530.8,71611.27
510700,202304,615,348,267,453110.89,347637.3,800748.19
510704,202304,1345,676,669,884097.3,871054.48,1755151.78
510706,202304,160,80,80,104162.77,104160.8,208323.57
510710,202304,450,321,129,417948.74,167958.6,585907.34
510715,202304,58,39,19,50778,24738.7,75516.7
510718,202304,267,120,147,156242.1,191399.26,347641.36
510719,202304,54,24,30,31248,39060,70308
510720,202304,187,129,58,167959.27,75516,243475.27
510724,202304,82,31,51,40362,66402,106764
510726,202304,68,33,35,42966.7,45570.62,88537.32
510729,202304,17,7,10,9114,13020.3,22134.3
510730,202304,484,258,226,335918.24,294252,630170.24
510735,202304,122,45,77,58590.69,100254,158844.69
510740,202304,25,14,11,18228.75,14323.42,32552.17
510757,202304,26,21,5,27343.29,6510.16,33853.45
510760,202304,8146,4111,4035,5355270.78,5256224.38,10611495.16
510770,202304,750,337,413,438783.68,539031.94,977815.62
510774,202304,19,7,12,9114.69,15624,24738.69
510775,202304,124,95,29,123690,37758,161448
510776,202304,35,12,23,15624,29946.2,45570.2
510777,202304,188,83,105,109368,136710,246078
510779,202304,41,24,17,31248,22134,53382
510780,202304,284,148,136,192704.61,177072,369776.61
510785,202304,351,188,163,244781.65,212226.18,457007.83
510787,202304,219,107,112,139319.77,145825.36,285145.13
510788,202304,9,4,5,5208.9,6510,11718.9
510790,202304,2850,1469,1381,1914058.73,1800677.05,3714735.78
510792,202304,1184,669,515,871074.41,671845.37,1542919.78
510794,202304,120,66,54,85933.06,71610,157543.06
510795,202304,2456,1381,1075,1798106.02,1402264.13,3200370.15
510800,202304,200,110,90,143221.81,117180.14,260401.95
510805,202304,220,147,73,191395.1,95046,286441.1
510810,202304,109,42,67,54685.51,87234.42,141919.93
510820,202304,266,136,130,177073.74,169263.19,346336.93
510830,202304,79,39,40,50778,52080,102858
510835,202304,25,18,7,23436.7,9114,32550.7
510840,202304,10033,4516,5517,5885307.38,7194946.64,13080254.02
510850,202304,219,88,131,114578.18,170562.26,285140.44
510860,202304,427,213,214,277329.02,279930.71,557259.73
510880,202304,82,59,23,76818.2,29946,106764.2
510885,202304,72,41,31,53382.94,40362,93744.94
510890,202304,78,38,40,49476.16,52080,101556.16
510895,202304,187,110,77,143220.44,100254,243474.44
520005,202304,157,63,94,82029.67,122389.46,204419.13
520010,202304,332,146,186,190095.54,242176.27,432271.81
520013,202304,782,541,241,704400.49,315087.54,1019488.03
520015,202304,39,26,13,33852,16926,50778
520017,202304,87,55,32,71610.84,41664,113274.84
520020,202304,11,5,6,6510,7812,14322
520025,202304,3186,1700,1486,2218723.07,1934843.07,4153566.14
520030,202304,917,476,441,619766.49,574185.92,1193952.41
520050,202304,62,46,16,59892.2,22134.01,82026.21
520055,202304,81,54,27,70308,35154.2,105462.2
520060,202304,189,126,63,164056.21,82027.25,246083.46
520080,202304,591,425,166,553351.63,216132,769483.63
520082,202304,16,12,4,15624,5208,20832
520085,202304,108,83,25,108066.95,32550.7,140617.65
520090,202304,84,61,23,79422.75,29946,109368.75
520110,202304,9990,4222,5768,5499810.52,7517832.08,13017642.60
520120,202304,12,7,5,9114,6510,15624
520130,202304,895,617,278,803346.06,361958.4,1165304.46
520140,202304,12998,7036,5962,9169040.25,7763926.23,16932966.48
520145,202304,60,32,28,41664.2,36456,78120.2
520150,202304,139,109,30,141922.85,39060,180982.85
520160,202304,41,25,16,32550,20832,53382
520170,202304,218,126,92,164059.23,119786.33,283845.56
520180,202304,202,93,109,121087.42,141919.56,263006.98
520215,202304,194,138,56,179676.83,72912.2,252589.03
520235,202304,91,70,21,91140,27342,118482
520250,202304,159,83,76,108067.78,98952,207019.78
520260,202304,120,70,50,91144.12,65101.36,156245.48
520280,202304,47,33,14,42966,18228,61194
520310,202304,29,18,11,23437.8,14322.16,37759.96
520320,202304,188,112,76,147127.98,98952.97,246080.95
520330,202304,892,492,400,643206.24,522108.41,1165314.65
520340,202304,301,173,128,225255.49,166657.41,391912.90
520350,202304,509,260,249,338525.57,324200.2,662725.77
520355,202304,105,62,43,80725.94,55986,136711.94
520357,202304,35,28,7,36456,9114,45570
520360,202304,17,5,12,6510.2,15624.28,22134.48
520380,202304,145,80,65,104160,85932,190092
520390,202304,237,105,132,136713.71,171864,308577.71
520393,202304,18,14,4,18228.1,5208,23436.1
520396,202304,76,56,20,72912,26040,98952
520400,202304,220,135,85,175776.19,110673.3,286449.49
520410,202304,201,102,99,132808.29,128898,261706.29
520420,202304,20,16,4,20832.94,5208,26040.94
520425,202304,262,127,135,165357.46,175770.98,341128.44
520430,202304,558,264,294,343729.68,384090.5,727820.18
520440,202304,675,484,191,630185.66,248683.33,878868.99
520450,202304,2349,997,1352,1298135.98,1760325.12,3058461.10
520455,202304,63,36,27,46874.29,35154.51,82028.80
520460,202304,47,28,19,36456.69,24740.19,61196.88
520465,202304,38,30,8,39060,10416,49476
520470,202304,470,290,180,377584.42,234360.2,611944.62
520480,202304,78,49,29,63798.72,37758,101556.72
520485,202304,112,42,70,54684.24,91140.1,145824.34
520490,202304,547,401,146,524716.81,190094.51,714811.32
520495,202304,168,101,67,131502.1,87234,218736.1
520500,202304,264,214,50,278630.3,65100,343730.3
520505,202304,194,113,81,147126,105462,252588
520510,202304,2160,1020,1140,1328066.33,1485593.94,2813660.27
520520,202304,65,42,23,54684.97,29946,84630.97
520530,202304,214,171,43,222648.44,55986,278634.44
520540,202304,789,536,253,697884.65,329409.22,1027293.87
520545,202304,154,88,66,114580.65,85933.2,200513.85
520547,202304,79,44,35,57290.49,45570.11,102860.60
520549,202304,1613,767,846,1001280.41,1101510.1,2102790.51
520551,202304,315,167,148,217435.83,192697.23,410133.06
520552,202304,45,32,13,41664.5,16926,58590.5
520570,202304,15,11,4,14322,5208,19530
520580,202304,292,181,111,235799.56,144522.29,380321.85
520590,202304,158,89,69,115879.6,89838,205717.6
520620,202304,1314,606,708,789024.4,921823.92,1710848.32
520630,202304,54,29,25,37758,32550.18,70308.18
520640,202304,399,228,171,296863.47,222642.9,519506.37
520650,202304,71,33,38,42966,49476,92442
520660,202304,46,25,21,32550.98,27342.38,59893.36
520670,202304,49,36,13,46872.22,16926,63798.22
520680,202304,24,14,10,18228,13020,31248
520690,202304,37,10,27,13020,35154,48174
520710,202304,37,29,8,37758,10416,48174
520725,202304,200,148,52,192699.83,67704,260403.83
520735,202304,58,37,21,48174.56,27342.2,75516.76
520740,202304,490,241,249,313787.51,325501.22,639288.73
520750,202304,41,24,17,31248,22134,53382
520753,202304,77,56,21,72912.76,27342,100254.76
520760,202304,108,75,33,97651.34,42966,140617.34
520780,202304,275,214,61,278631.35,79423.28,358054.63
520790,202304,146,88,58,114576.65,76818,191394.65
520800,202304,3620,2041,1579,2658775.02,2059794.29,4718569.31
520810,202304,136,104,32,135410.19,41664.89,177075.08
520815,202304,7,5,2,6510.96,2604,9114.96
520830,202304,134,92,42,119786.43,54684.05,174470.48
520840,202304,416,267,149,347635.57,193998,541633.57
520850,202304,115,67,48,87236.12,62496,149732.12
520860,202304,1934,1214,720,1581971.5,938747.73,2520719.23
520870,202304,35734,16076,19658,20946102,25618490.12,46564592.12
520880,202304,1364,713,651,928373.06,847620.56,1775993.62
520890,202304,875,556,319,723936.74,417943.57,1141880.31
520910,202304,1028,538,490,700502.86,637982.55,1338485.41
520915,202304,98,67,31,87236.29,40362.6,127598.89
520920,202304,516,241,275,313793.07,359359.57,673152.64
520929,202304,18,16,2,20832.84,2604,23436.84
520940,202304,64,47,17,61196.14,22134.1,83330.24
520945,202304,18,11,7,14322,9114,23436
520960,202304,47,29,18,37758,23436,61194
520970,202304,438,249,189,324206.24,246083.16,570289.40
520980,202304,89,65,24,84630,31248,115878
520990,202304,442,313,129,407528.2,167958.13,575486.33
520993,202304,123,63,60,82031.3,78120.94,160152.24
520995,202304,268,145,123,190095.5,161448,351543.5
521000,202304,1690,919,771,1199167.32,1005155.12,2204322.44
521010,202304,655,348,307,453104.21,401018.88,854123.09
521015,202304,13,8,5,10416,6510,16926
521020,202304,1499,1052,447,1369742.81,583304.97,1953047.78
521030,202304,78,53,25,69006.95,32550,101556.95
521040,202304,1021,678,343,884086.48,449191,1333277.48
521056,202304,58,38,20,49476,26040,75516
521060,202304,128,80,48,104161.37,62497.36,166658.73
521080,202304,326,256,70,333330.23,91140.4,424470.63
521090,202304,611,411,200,535130.46,260400.89,795531.35
521100,202304,282,192,90,249990.65,117180.4,367171.05
521120,202304,1118,790,328,1029913.07,427060.66,1456973.73
521130,202304,328,233,95,303374.58,123690.6,427065.18
521140,202304,190,107,83,139318.96,109368.69,248687.65
521150,202304,2702,1135,1567,1477828.06,2042871.02,3520699.08
521160,202304,27,10,17,13020.42,22134,35154.42
521170,202304,233,123,110,161449.03,143220.2,304669.23
521180,202304,1251,783,468,1019498.77,609346.24,1628845.01
521190,202304,2740,1137,1603,1480416.95,2087124.89,3567541.84
521200,202304,61,42,19,54684.2,24738,79422.2
521205,202304,16,12,4,15624.2,5208,20832.2
521210,202304,141,86,55,111973.69,71610,183583.69
521220,202304,787,533,254,695280.93,332012.16,1027293.09
521225,202304,18,12,6,15626.47,7812.74,23439.21
521230,202304,111,73,38,95048.06,49477.63,144525.69
521250,202304,6790,3704,3086,4824131.94,4028445.45,8852577.39
521260,202304,43,19,24,24738,31248,55986
521270,202304,128,96,32,124992.93,41664,166656.93
521280,202304,434,272,162,354146.89,210924,565070.89
521290,202304,32,17,15,22134.84,19530,41664.84
521295,202304,105,70,35,91140.85,45570,136710.85
521300,202304,249,138,111,179678.39,144522.84,324201.23
521305,202304,44,31,13,40363.51,16926,57289.51
521308,202304,1034,794,240,1033826.77,312485.07,1346311.84
521310,202304,1477,810,667,1054655.07,869749.45,1924404.52
521340,202304,20,16,4,20832,5208,26040
521350,202304,94,70,24,91141.86,31248,122389.86
521370,202304,175,114,61,148428.5,79422.6,227851.1
521375,202304,207,97,110,126296.17,143221.09,269517.26
521377,202304,52,38,14,49476.87,18228.1,67704.97
521380,202304,1139,675,464,878887.36,604135.1,1483022.46
521385,202304,11,6,5,7812,6510,14322
521390,202304,105,82,23,106766.41,29946.49,136712.90
521400,202304,403,288,115,374991.01,149731.53,524722.54
521405,202304,161,101,60,131505.34,78120.66,209626.00
521410,202304,84,61,23,79423.27,29946,109369.27
521440,202304,222,153,69,199213.18,89838.74,289051.92
521450,202304,829,455,374,592424.42,488254.53,1080678.95
521460,202304,1149,794,355,1033835.67,463519.43,1497355.10
521470,202304,14,10,4,13020,5208,18228
521480,202304,41,27,14,35155.51,18228.1,53383.61
521483,202304,344,223,121,290349.53,157543.47,447893.00
521486,202304,312,209,103,272118.5,134106.84,406225.34
521487,202304,24,12,12,15624,15624,31248
521490,202304,28,16,12,20832,15624,36456
521500,202304,155,69,86,89838.27,111972.19,201810.46
521520,202304,46,34,12,44268,15624,59892
521523,202304,1217,661,556,860858.44,723917.03,1584775.47
521525,202304,62,43,19,55986,24738,80724
521530,202304,247,142,105,184884.45,136710.49,321594.94
521540,202304,44,21,23,27342,29946,57288
521550,202304,128,61,67,79423.8,88537.89,167961.69
521560,202304,946,631,315,821584.41,410133.39,1231717.80
521565,202304,73,52,21,67705.54,27342.83,95048.37
521570,202304,606,376,230,492163.56,299461.07,791624.63
521580,202304,47,29,18,37758,23436,61194
521590,202304,41,21,20,27342,26040,53382
521600,202304,26,13,13,16926,16926,33852
521630,202304,230,119,111,154944.65,144527.69,299472.34
521640,202304,328,176,152,229154.36,197904.67,427059.03
521645,202304,40,20,20,26040,26040,52080
521680,202304,262,158,104,205720.15,135409.27,341129.42
521690,202304,16,14,2,18228,2604,20832
521710,202304,1165,553,612,722623.45,798132.65,1520756.10
521720,202304,623,408,215,531265.39,281232.92,812498.31
521730,202304,745,349,396,455705.29,515593.77,971299.06
521740,202304,950,438,512,570283.32,667931.95,1238215.27
521760,202304,2568,1309,1259,1704494.16,1643165.05,3347659.21
521770,202304,886,537,349,699186.22,455702.79,1154889.01
521800,202304,2076,1403,673,1826839.24,876248.12,2703087.36
521805,202304,37,23,14,29946,18228,48174
521810,202304,96,54,42,70309.25,54684.19,124993.44
521830,202304,1071,787,284,1024708.15,371077.49,1395785.64
521839,202304,72,41,31,53382,40362.2,93744.2
521850,202304,1236,614,622,799451.89,811159.13,1610611.02
521860,202304,343,213,130,277331.87,169260,446591.87
521870,202304,89,57,32,74214,41664,115878
521878,202304,35,14,21,18228,27342.63,45570.63
521880,202304,5349,2338,3011,3046781.2,3928169.39,6974950.59
521890,202304,663,450,213,587213.53,278630.11,865843.64
521900,202304,286,225,61,292951.24,80724.8,373676.04
521910,202304,188,130,58,169266.68,75518.39,244785.07
521920,202304,37,22,15,28644,19530,48174
521925,202304,53,29,24,37758,31248,69006
521930,202304,1319,732,587,953100.71,765589.54,1718690.25
521935,202304,33,24,9,31249.81,11718,42967.81
521940,202304,249,110,139,143221.12,180978.75,324199.87
521945,202304,23,14,9,18228,11718,29946
521950,202304,24,15,9,19530,11718,31248
521960,202304,69,55,14,71610,18228,89838
521970,202304,414,271,143,352844.8,186186.89,539031.69
521971,202304,109,57,52,74214.8,67704,141918.8
521973,202304,39,17,22,22134.6,28644,50778.6
521975,202304,1738,916,822,1193974.06,1072867.19,2266841.25
521980,202304,241,165,76,214832.49,98952,313784.49
521990,202304,89,61,28,79423.73,36456,115879.73
522000,202304,293,196,97,254745.79,126295.39,381041.18
522005,202304,19,11,8,14322,10416,24738
522010,202304,1206,670,536,873673.43,699185.68,1572859.11
522015,202304,59,37,22,48174,28644,76818
522020,202304,918,549,369,714812.57,480444.48,1195257.05
522026,202304,28,19,9,24738,13020,37758
522028,202304,24,20,4,26040,5208,31248
522040,202304,882,388,494,506493.98,644499,1150992.98
522045,202304,2937,1723,1214,2246042.99,1580641.18,3826684.17
522050,202304,166,72,94,93748.48,122389.32,216137.80
522060,202304,555,347,208,451805.66,270816.81,722622.47
522068,202304,115,81,34,105462.89,44268,149730.89
522070,202304,19,16,3,20832,3906,24738
522100,202304,36,23,13,29946,16926,46872
522108,202304,42,33,9,42967.72,11718,54685.72
522119,202304,66,37,29,48175.42,37758,85933.42
522130,202304,82,31,51,40363.28,66402.42,106765.70
522140,202304,4580,2399,2181,3123608.11,2839687.8,5963295.91
522145,202304,50,36,14,46872.2,18228,65100.2
522150,202304,110,74,36,96349.05,46872.84,143221.89
522155,202304,57,38,19,49476.9,24738,74214.9
522157,202304,15,8,7,10416,9114,19530
522160,202304,1727,1028,699,1338497.22,910106.69,2248603.91
522170,202304,363,242,121,315087.44,157542.3,472629.74
522180,202304,32,13,19,16926,24738,41664
522185,202304,2750,1202,1548,1565072.62,2020753.42,3585826.04
522190,202304,77,44,33,57288.4,42966,100254.4
522200,202304,342,197,145,256496.09,188790.24,445286.33
522205,202304,142,97,45,126297.97,58590.1,184888.07
522220,202304,141,109,32,141918.2,41664,183582.2
522230,202304,31,27,4,35154.41,5208,40362.41
530010,202304,60581,30682,29899,39971732.73,38974918.75,78946651.48
110001,202305,545,444,101,586088.72,133320.66,719409.38
110002,202305,3078,1961,1117,2590260.36,1474451.75,4064712.11
110003,202305,81,63,18,83161.96,23760,106921.96
110004,202305,2251,1542,709,2036800.09,935887.5,2972687.59
110005,202305,461,357,104,471246.38,137280.2,608526.58
110006,202305,456,337,119,444846.18,157080,601926.18
110007,202305,81,64,17,84480,22440,106920
110008,202305,283,161,122,212521.67,161040.6,373562.27
110009,202305,991,765,226,1011131.02,298320.91,1309451.93
110010,202305,1750,973,777,1288347.73,1028281.98,2316629.71
110011,202305,1770,1369,401,1807130.24,531969.41,2339099.65
110012,202305,4300,2463,1837,3252542.36,2427501.67,5680044.03
110013,202305,777,616,161,815785.52,212523.08,1028308.60
110014,202305,357,316,41,420734.99,55440,476174.99
110015,202305,1415,1081,334,1426938.87,442203.14,1869142.01
110018,202305,1066,673,393,889700.94,518760.62,1408461.56
110020,202305,17418,9643,7775,12738630.89,10277658.07,23016288.96
110025,202305,667,490,177,646805.48,233640.4,880445.88
110026,202305,34,22,12,29040.74,15840,44880.74
110028,202305,1683,1185,498,1566874.94,658687.98,2225562.92
110029,202305,130,117,13,154443.38,17160,171603.38
110030,202305,2528,1629,899,2152751.65,1188005.87,3340757.52
110032,202305,350,271,79,357731.76,104283.69,462015.45
110033,202305,703,498,205,657387.65,270605.88,927993.53
110034,202305,333,254,79,335282.54,104280,439562.54
110037,202305,98,83,15,109561.1,19800,129361.1
110040,202305,423,292,131,385442.1,172920,558362.1
110045,202305,1020,743,277,980786.58,365642.88,1346429.46
110050,202305,90,81,9,106921.95,11880.03,118801.98
110060,202305,58,40,18,52800.92,23760,76560.92
110070,202305,112,75,37,99001.58,48840,147841.58
110080,202305,569,328,241,432965.7,318120.99,751086.69
110090,202305,25,20,5,26400,6600,33000
110092,202305,127,59,68,77881.11,89760,167641.11
110094,202305,231,161,70,212523.05,92400,304923.05
110100,202305,55,41,14,54120.47,18480.06,72600.53
110110,202305,122,71,51,93723.1,67320,161043.1
110120,202305,70,61,9,80521.86,11880,92401.86
110130,202305,266,219,47,289087.21,62040.81,351128.02
110140,202305,269,192,77,253442.34,101640.1,355082.44
110143,202305,55,44,11,58080,14520,72600
110145,202305,44,33,11,43560,14520,58080
110146,202305,29,12,17,15840.2,22440,38280.2
110147,202305,43,26,17,34320,22440.58,56760.58
110148,202305,33,26,7,34320.7,9240,43560.7
110149,202305,311,218,93,287760.85,122760,410520.85
110150,202305,139,112,27,147841.1,35640,183481.1
110155,202305,11,10,1,13200,1320,14520
110160,202305,69,54,15,71281.21,19800,91081.21
110170,202305,226,168,58,221763.96,76560,298323.96
110175,202305,70,56,14,73920.8,18480,92400.8
110180,202305,88,69,19,91080.88,25080,116160.88
120001,202305,234,168,66,221768.64,87120.14,308888.78
120005,202305,235,135,100,178203.62,132000,310203.62
120010,202305,1204,736,468,972851.83,617762.53,1590614.36
120013,202305,179,122,57,161043.01,76560.1,237603.11
120017,202305,143,88,55,116160.8,72600,188760.8
120020,202305,3536,2851,685,3764728.88,909491.2,4674220.08
120025,202305,606,326,280,430363.39,369618.47,799981.86
120030,202305,1247,1076,171,1420384.53,225728.45,1646112.98
120032,202305,45,40,5,52801.1,6600,59401.1
120033,202305,231,199,32,262688.99,42240.55,304929.54
120034,202305,191,141,50,186121.44,67320,253441.44
120035,202305,59,52,7,68640.1,9240,77880.1
120038,202305,421,276,145,364332.67,191402.28,555734.95
120039,202305,36,33,3,43561.1,3960,47521.1
120040,202305,15385,10306,5079,13615983.97,6709896.39,20325880.36
120042,202305,51,47,4,62042.05,5280,67322.05
120043,202305,17,4,13,5280,17160,22440
120045,202305,562,358,204,472581.39,269283.06,741864.45
120050,202305,1337,1020,317,1346463.88,418451.07,1764914.95
120060,202305,1541,1291,250,1703428.21,330006.64,2033434.85
120070,202305,444,325,119,429015.64,157080.17,586095.81
120080,202305,208,136,72,179525.87,95040.55,274566.42
130002,202305,163,118,45,155760.95,59400,215160.95
130006,202305,113,78,35,102960,46200,149160
130008,202305,132,78,54,102960.68,72600,175560.68
130010,202305,176,110,66,145200.2,87120.34,232320.54
130014,202305,316,224,92,296012.72,121441.55,417454.27
130020,202305,154,110,44,145200.9,58080,203280.9
130030,202305,1021,568,453,749764.94,597961,1347725.94
130040,202305,413,214,199,282481.05,262680,545161.05
130050,202305,580,304,276,401295.6,364332.7,765628.3
130060,202305,906,620,286,818403.86,377520.7,1195924.56
130063,202305,625,392,233,517440.1,308880,826320.1
130068,202305,242,151,91,199323.24,120121.35,319444.59
130070,202305,1424,944,480,1246107.49,633605.08,1879712.57
130080,202305,736,509,227,671886.73,300962.58,972849.31
130083,202305,91,61,30,80521.29,39600,120121.29
130090,202305,347,211,136,279840.67,179520,459360.67
130100,202305,1351,693,658,914774.67,871210.91,1785985.58
130110,202305,845,367,478,485763.28,630961.3,1116724.58
130115,202305,151,77,74,101640,97680,199320
130120,202305,1750,1094,656,1444096.49,865921.19,2310017.68
130130,202305,658,447,211,590040.98,278520.95,868561.93
130140,202305,1611,1255,356,1656610.86,471241.32,2127852.18
130150,202305,449,401,48,529320.08,63360,592680.08
130160,202305,475,302,173,398641.4,228360,627001.4
130165,202305,150,133,17,176880.75,22440,199320.75
130170,202305,1241,856,385,1129866.54,508209.65,1638076.19
130180,202305,309,244,65,322081.55,85800.2,407881.75
130185,202305,2367,1173,1194,1548399.86,1577426.17,3125826.03
130190,202305,3480,2176,1304,2872407.59,1723940.16,4596347.75
130195,202305,305,244,61,322080.48,80520,402600.48
130200,202305,227,141,86,186121.82,113520,299641.82
130210,202305,95,43,52,56760,68640,125400
130220,202305,207,156,51,205921.08,67320,273241.08
130230,202305,369,249,120,328680,158400,487080
130240,202305,1440,966,474,1276449.75,628322.12,1904771.87
130250,202305,5037,3269,1768,4315184.28,2335111.42,6650295.70
130255,202305,449,233,216,307560.72,286440.62,594001.34
130260,202305,68926,31923,37003,42182284.99,48916535.22,91098820.21
130270,202305,1563,1083,480,1432330.26,634922.31,2067252.57
130280,202305,149,87,62,114840.1,81840,196680.1
130290,202305,2095,1338,757,1768842.55,1000566.42,2769408.97
130300,202305,433,292,141,386761.88,186122.79,572884.67
130310,202305,975,547,428,722043.57,567600.58,1289644.15
130320,202305,571,313,258,413160.9,340560,753720.9
130330,202305,809,542,267,715444.6,352441.18,1067885.78
130340,202305,3673,2009,1664,2654610.86,2199147.9,4853758.76
130350,202305,487,347,140,458040.2,186120,644160.2
130353,202305,1019,485,534,641534.3,712810.18,1354344.48
130356,202305,901,424,477,559687.14,629643.97,1189331.11
130360,202305,108,85,23,112200.2,30360.7,142560.9
130370,202305,703,559,144,737881.64,190080,927961.64
130380,202305,678,531,147,700923.14,194040.61,894963.75
130390,202305,502,413,89,545160,117480,662640
130395,202305,173,68,105,89760.18,138600,228360.18
130400,202305,100,78,22,102961.76,29040,132001.76
130406,202305,2295,1345,950,1775415.07,1254004.3,3029419.37
130410,202305,478,263,215,347160,283800,630960
130420,202305,2884,2348,536,3099457.25,707522.89,3806980.14
130423,202305,224,149,75,196683.72,99000,295683.72
130426,202305,192,107,85,142560,112200,254760
130430,202305,453,264,189,348480.74,249480,597960.74
130440,202305,204,71,133,93724.86,175563.35,269288.21
140002,202305,59,18,41,23760.2,54121.41,77881.61
140005,202305,233,136,97,179525.52,128042,307567.52
140010,202305,13555,7709,5846,10186943.23,7723502.44,17910445.67
140015,202305,307,76,231,100322.58,304921.62,405244.20
140017,202305,152,85,67,112208.52,88442.79,200651.31
140020,202305,469,315,154,415814.38,203285.73,619100.11
140023,202305,80,44,36,59400,47520.59,106920.59
140028,202305,28,15,13,19800.84,17161.14,36961.98
140030,202305,439,281,158,370933.92,209883.05,580816.97
140040,202305,87,57,30,75241.28,39600,114841.28
140045,202305,393,111,282,146522.46,374883.06,521405.52
140047,202305,639,407,232,537254.71,306242.75,843497.46
140050,202305,152,93,59,124084.59,77881.39,201965.98
140060,202305,95,67,28,88441.36,36960.2,125401.56
140070,202305,24,22,2,29040.2,2640,31680.2
150010,202305,5474,3304,2170,4361413.6,2865752.3,7227165.9
150013,202305,184,124,60,163681.29,79200.99,242882.28
150020,202305,1217,694,523,916101.2,691680.78,1607781.98
150030,202305,737,335,402,442215.02,531963.3,974178.32
150034,202305,223,130,93,171601.22,122760.5,294361.72
150040,202305,1811,1051,760,1387382.8,1003221.91,2390604.71
150050,202305,795,472,323,623047.18,427681.23,1050728.41
150060,202305,5266,3267,1999,4313776.21,2640586.12,6954362.33
150070,202305,238,185,53,244214.11,69960.64,314174.75
150080,202305,19536,9112,10424,12035030.92,13771913.56,25806944.48
150085,202305,507,309,198,407889.35,261362.87,669252.22
150090,202305,796,630,166,831621.91,219122.17,1050744.08
150095,202305,92,61,31,80520.65,40921.08,121441.73
150100,202305,81,49,32,64680,42241.11,106921.11
150110,202305,212,127,85,167640.69,112200.1,279840.79
150120,202305,417,298,119,393370.37,157081.24,550451.61
150125,202305,44,20,24,26400,31680,58080
150130,202305,2653,1299,1354,1716069.06,1790166.53,3506235.59
150140,202305,66405,28326,38079,37417126.47,50313016.45,87730142.92
150145,202305,283,151,132,199323.34,174241.04,373564.38
150150,202305,3953,1724,2229,2275754.78,2943649.27,5219404.05
150157,202305,383,273,110,360370.73,145201.6,505572.33
150160,202305,174,131,43,172920.71,56760,229680.71
150170,202305,4439,3206,1233,4232035.53,1628898.6,5860934.13
150172,202305,407,287,120,378846.38,158401.7,537248.08
150175,202305,91,52,39,68641,51480.7,120121.7
150178,202305,839,568,271,749785.13,357727.93,1107513.06
150180,202305,3582,1825,1757,2409066.36,2319252.34,4728318.70
150190,202305,422,284,138,374891.17,182162.67,557053.84
150195,202305,144,81,63,106920.8,84480.57,191401.37
150200,202305,222,119,103,157080.08,137280.2,294360.28
150210,202305,3433,2640,793,3484939.32,1046777.04,4531716.36
150215,202305,753,438,315,578185.41,415812.98,993998.39
150220,202305,3747,2483,1264,3278977.6,1669832.49,4948810.09
150230,202305,1526,1214,312,1603841,411848.18,2015689.18
150240,202305,8045,4446,3599,5870284.36,4753426.33,10623710.69
150250,202305,92,51,41,67321.56,54120.85,121442.41
150260,202305,139,96,43,126725.32,56760.41,183485.73
150270,202305,2265,1461,804,1929886.27,1061285.98,2991172.25
150275,202305,586,385,201,508211.65,265321.08,773532.73
150276,202305,127,46,81,60720.2,106922.26,167642.46
150277,202305,935,412,523,543853.69,690376.82,1234230.51
150280,202305,186,181,5,238939.02,6600,245539.02
150285,202305,175,92,83,121442.25,110668.8,232111.05
150290,202305,1398,801,597,1057346.03,788048.26,1845394.29
150293,202305,918,436,482,575539.28,636249.55,1211788.83
150295,202305,629,307,322,405257.61,425041.91,830299.52
150300,202305,99,48,51,63360.1,67320.81,130680.91
150304,202305,213,127,86,167642.9,113522.76,281165.66
150307,202305,472,386,86,509531.55,113520.5,623052.05
150309,202305,627,441,186,583473.36,245524.9,828998.26
150310,202305,300,198,102,261364.65,134640,396004.65
150320,202305,2051,1422,629,1877071.9,830288.27,2707360.17
150330,202305,2274,1298,976,1713382.11,1288326.86,3001708.97
150340,202305,211,133,78,176881.56,102960.42,279841.98
150345,202305,695,388,307,512168.45,405240,917408.45
150350,202305,440,353,87,465988.72,114842.76,580831.48
150360,202305,5499,3216,2283,4245229.28,3014911.45,7260140.73
150370,202305,892,597,295,788077.03,389408.27,1177485.30
150375,202305,204,85,119,112201.83,157080.68,269282.51
150380,202305,1611,1073,538,1416396.76,710165.45,2126562.21
150390,202305,956,552,404,728679.54,533285.17,1261964.71
150400,202305,133,112,21,147840.4,27720,175560.4
150405,202305,1754,1112,642,1467864.24,848762.87,2316627.11
150410,202305,109,69,40,91081.27,52800.2,143881.47
150420,202305,8471,4550,3921,6007826.24,5179815.48,11187641.72
150430,202305,705,437,268,576883.89,353769.3,930653.19
150440,202305,490,300,190,396016.85,250802.89,646819.74
150442,202305,2668,1430,1238,1890314.6,1635507.19,3525821.79
150445,202305,582,382,200,504246.47,264000.2,768246.67
150450,202305,77,72,5,95051.21,6600.1,101651.31
150460,202305,746,564,182,744502.34,240241.34,984743.68
150470,202305,1349,810,539,1069236.93,711485.23,1780722.16
150475,202305,259,195,64,257410.43,84483.11,341893.54
150480,202305,1561,1104,457,1459991.48,603249.61,2063241.09
150490,202305,625,384,241,508204.17,318120,826324.17
150495,202305,375,281,94,370920.23,124080,495000.23
150497,202305,303,192,111,253441.92,146520.3,399962.22
150500,202305,295,172,123,227042.42,162360.1,389402.52
150503,202305,1528,773,755,1020393.72,996612.45,2017006.17
150506,202305,956,659,297,869900.18,392041.12,1261941.30
150510,202305,1442,803,639,1059994.5,846127.27,1906121.77
150520,202305,346,235,111,310202.22,146521,456723.22
150530,202305,2158,1243,915,1640894.52,1209189.06,2850083.58
150540,202305,244,178,66,234963.5,88440.81,323404.31
150543,202305,964,499,465,660017.94,615129.84,1275147.78
150548,202305,463,335,128,443524.93,168960.28,612485.21
150549,202305,88,57,31,75242.3,40920.26,116162.56
150550,202305,3456,1748,1708,2308753.48,2258544.94,4567298.42
150553,202305,4143,2321,1822,3066501.72,2410367.49,5476869.21
150555,202305,143,80,63,105600.2,83161.17,188761.37
150560,202305,87,42,45,55440.77,59400,114840.77
150563,202305,139,72,67,95045.61,88441.63,183487.24
150565,202305,232,137,95,180842.55,125400.18,306242.73
150570,202305,426,282,144,372241.26,190080,562321.26
150580,202305,1847,926,921,1223654.32,1218361.18,2442015.50
150590,202305,904,606,298,801273.37,394682.65,1195956.02
150600,202305,548,350,198,462014.26,261364.21,723378.47
150610,202305,199,154,45,203283.57,59400,262683.57
150611,202305,164,114,50,150480,66000,216480
150613,202305,3737,2065,1672,2725906.24,2207164.94,4933071.18
150616,202305,641,343,298,452769.14,393362.03,846131.17
150618,202305,1491,769,722,1016406.18,954362.73,1970768.91
150619,202305,434,330,104,435604.71,137286.07,572890.78
150620,202305,1387,786,601,1037551.03,794647.5,1832198.53
150630,202305,192,128,64,168970.79,84482.05,253452.84
150635,202305,509,235,274,310211.06,361684.89,671895.95
150640,202305,51,23,28,30361.94,36960,67321.94
150650,202305,2636,1513,1123,2001211.14,1482398.93,3483610.07
150655,202305,296,210,86,277200.61,113520,390720.61
150658,202305,66,41,25,54120,33000,87120
150660,202305,681,421,260,555730.86,343204.07,898934.93
150670,202305,1232,455,777,600612,1025648.46,1626260.46
150680,202305,12234,6428,5806,8488015.77,7668058.62,16156074.39
150690,202305,44,22,22,29041.08,29040,58081.08
150700,202305,604,402,202,530667.14,266644.29,797311.43
150710,202305,312,179,133,236286.78,175560.72,411847.50
150715,202305,877,557,320,735260.54,422403.1,1157663.64
150720,202305,460,349,111,460687.32,146520.95,607208.27
150730,202305,1244,581,663,766941.82,875168.11,1642109.93
150740,202305,277,176,101,232321.05,133320,365641.05
150745,202305,875,491,384,649462.92,508205.43,1157668.35
150746,202305,77,38,39,50161.41,51480,101641.41
150747,202305,281,191,90,252124.65,118800.3,370924.95
150750,202305,155,82,73,108244.79,96363.2,204607.99
150760,202305,2009,1327,682,1751683.29,900246.64,2651929.93
150770,202305,431,256,175,339241.87,231000.2,570242.07
150775,202305,102,55,47,72600.48,62040.7,134641.18
150780,202305,223,130,93,171602.29,124080,295682.29
150790,202305,765,456,309,601934.59,409203.33,1011137.92
150795,202305,1871,1148,723,1516709.76,954370.09,2471079.85
150796,202305,336,192,144,253441.69,190080.94,443522.63
150797,202305,436,199,237,262687.78,312841.09,575528.87
150800,202305,1780,988,792,1305498.59,1045442.94,2350941.53
150803,202305,372,272,100,359055.45,132001.43,491056.88
150805,202305,229,138,91,182162.1,120120,302282.1
150808,202305,1197,583,614,769565.48,810482.39,1580047.87
150810,202305,3353,2256,1097,2978009.5,1448047.19,4426056.69
150812,202305,578,299,279,394688.16,368280.9,762969.06
150815,202305,1345,830,515,1096934.04,679802.11,1776736.15
150820,202305,1841,1105,736,1459983.91,971539.29,2431523.20
150830,202305,600,457,143,603256.33,188761.34,792017.67
150835,202305,258,160,98,211203.91,129360,340563.91
150840,202305,1566,895,671,1181437.46,888372.64,2069810.10
160005,202305,71,47,24,62041.2,31680.12,93721.32
160010,202305,227,137,90,180846.05,118800.92,299646.97
160015,202305,182,122,60,161052.26,79201.59,240253.85
160020,202305,149,74,75,97681.59,100320,198001.59
160021,202305,68,32,36,42242.66,47520.83,89763.49
160023,202305,80,53,27,69962.42,35640.14,105602.56
160025,202305,33,17,16,22441.88,21120.12,43562.00
160027,202305,1588,884,704,1168260.85,929288.69,2097549.54
160030,202305,18802,9738,9064,12862665.36,11971311.64,24833977.00
160040,202305,379,236,143,311531.47,188761.69,500293.16
160050,202305,853,382,471,504259.94,623051.1,1127311.04
160053,202305,321,198,123,261370.7,162362.84,423733.54
160055,202305,25,19,6,25082.23,7921.09,33003.32
160060,202305,7367,4059,3308,5358154.7,4371933.53,9730088.23
160070,202305,191,112,79,147844.92,104281.38,252126.30
160080,202305,158,82,76,108240.44,100320.28,208560.72
170025,202305,25,14,11,18480,14520.71,33000.71
170030,202305,174,140,34,184806.84,44880,229686.84
170035,202305,209,103,106,135964.49,139921.86,275886.35
170040,202305,188,140,48,184800,63360,248160
170070,202305,336,213,123,281168.7,162360.65,443529.35
170100,202305,365,263,102,348491.43,134640.8,483132.23
170105,202305,41,35,6,46201.53,7920,54121.53
170110,202305,116,72,44,95040.49,58080.1,153120.59
170130,202305,85,42,43,55440,56760,112200
170190,202305,107,63,44,83160.15,58080,141240.15
170200,202305,358,243,115,320763.43,153120.2,473883.63
170210,202305,7156,3936,3220,5200642.97,4258371.91,9459014.88
170215,202305,154,94,60,124085.12,79201.08,203286.20
170220,202305,1359,967,392,1276469.54,517445.75,1793915.29
170230,202305,151,104,47,137283.55,62040.3,199323.85
170240,202305,499,346,153,456743.6,201962.72,658706.32
170255,202305,1041,811,230,1070540.53,303602.85,1374143.38
170270,202305,49,34,15,44880,19800,64680
170290,202305,147,90,57,118801.75,75240,194041.75
170300,202305,120,80,40,105601.19,52800,158401.19
170305,202305,59,43,16,56760.8,21120,77880.8
170307,202305,60,44,16,58081.52,21120.9,79202.42
170310,202305,120,78,42,102962,55440,158402
170320,202305,39,25,14,33000.2,18480,51480.2
170330,202305,34,24,10,31682.06,13200.1,44882.16
170360,202305,34,21,13,27720.8,17161.98,44882.78
170370,202305,80,46,34,60721.43,44880.2,105601.63
170380,202305,85,64,21,84481.34,27720,112201.34
170382,202305,40,33,7,43560,9240,52800
170384,202305,147,112,35,147840.43,46200.07,194040.50
170386,202305,68,31,37,40920.61,50160,91080.61
170388,202305,44,20,24,26400.15,31680,58080.15
170389,202305,27,20,7,26400.4,9240,35640.4
170390,202305,87,50,37,66000.65,48840.41,114841.06
170410,202305,23,21,2,27722.04,2640,30362.04
170460,202305,15,10,5,13200.22,6600,19800.22
170510,202305,34,25,9,33002.31,11880,44882.31
170550,202305,1649,967,682,1276472.56,900249.71,2176722.27
170555,202305,117,85,32,112204.74,42240,154444.74
170560,202305,103,76,27,100320.77,35640.02,135960.79
170600,202305,41,15,26,19801.48,34320,54121.48
170610,202305,196,109,87,143885.42,114840.1,258725.52
170625,202305,33,20,13,26400.99,17160,43560.99
170650,202305,103,71,32,93720.58,42240.2,135960.78
170700,202305,599,443,156,584765.7,205920,790685.7
170710,202305,138,82,56,108244.04,73923.25,182167.29
170720,202305,114,90,24,118800.81,31680,150480.81
170730,202305,121,72,49,95041.78,64680,159721.78
170740,202305,88,65,23,85800,30360,116160
170755,202305,50,27,23,35641.56,30360.76,66002.32
170765,202305,139,85,54,112203.3,72600.79,184804.09
170770,202305,195,125,70,166322.11,92400.73,258722.84
170820,202305,615,411,204,542529.64,269280.32,811809.96
170825,202305,54,31,23,40920.3,30360,71280.3
170830,202305,95,72,23,96360.14,30360.33,126720.47
170900,202305,176,133,43,175563.22,56760.77,232323.99
170930,202305,1054,583,471,769588.41,621726.72,1391315.13
170950,202305,3482,1678,1804,2216339.28,2383939.9,4600279.18
170980,202305,16,11,5,14521.47,6600,21121.47
171050,202305,156,119,37,157080,48840.2,205920.2
171070,202305,62,49,13,64680.39,17160.95,81841.34
171090,202305,50,39,11,51480.2,14520,66000.2
171110,202305,25,18,7,23760.26,9240,33000.26
171150,202305,47,32,15,42240,19800,62040
171180,202305,25,12,13,15840,17161.07,33001.07
171190,202305,195,110,85,145203.03,112200,257403.03
171195,202305,59,50,9,66001.78,11880,77881.78
171200,202305,30,14,16,18480.51,21120,39600.51
171215,202305,11,9,2,11880,2640,14520
171240,202305,64,51,13,67320,17160,84480
171245,202305,56,48,8,63362.56,10560,73922.56
171250,202305,83,48,35,63360.2,46200,109560.2
171270,202305,13,9,4,11880.07,5280.22,17160.29
171280,202305,48,39,9,51481.03,11880.1,63361.13
171320,202305,1117,654,463,863293.31,612482.45,1475775.76
171330,202305,458,236,222,312842.72,293040.21,605882.93
171360,202305,109,79,30,104281.43,39600,143881.43
171370,202305,32,19,13,25080,17160.66,42240.66
171380,202305,136,115,21,151801.55,27720.81,179522.36
171395,202305,44,28,16,36960,21120,58080
171420,202305,269,175,94,231001.46,124080.2,355081.66
171430,202305,73,58,15,76560.2,19800.53,96360.73
171488,202305,223,126,97,166320.58,128040,294360.58
171500,202305,66,37,29,48840.2,38280,87120.2
171510,202305,79,54,25,71280,33000.52,104280.52
171515,202305,41,34,7,44883.18,9240,54123.18
171525,202305,25,22,3,29042.26,3960,33002.26
171550,202305,17,11,6,14520.9,7920,22440.9
171570,202305,60,31,29,40920,38280.1,79200.1
171575,202305,260,177,83,233642.02,110880,344522.02
171610,202305,2078,1073,1005,1416388.04,1327946.15,2744334.19
171620,202305,163,118,45,155760.9,59400.89,215161.79
171630,202305,50,29,21,38280,27720,66000
171650,202305,361,251,110,331331,146522.46,477853.46
171660,202305,266,153,113,203287.77,151800.7,355088.47
171665,202305,91,56,35,73921.53,46200.33,120121.86
171670,202305,464,294,170,388087.07,224402.42,612489.49
171700,202305,64,53,11,69960.29,14520,84480.29
171720,202305,26,9,17,11880.7,22440.2,34320.9
171750,202305,100,51,49,67320,66000.7,133320.7
171780,202305,77,60,17,79200.83,22440,101640.83
171790,202305,103,81,22,108240,29040,137280
171800,202305,32,24,8,31680,10560,42240
171820,202305,2226,1292,934,1705480.77,1232885.6,2938366.37
171830,202305,36,27,9,35640.2,11880.45,47520.65
171840,202305,54,35,19,46200.54,25080,71280.54
171845,202305,36,25,11,33000.8,14520,47520.8
171850,202305,52,41,11,54121.55,14521.06,68642.61
171855,202305,71,51,20,67320.1,26400,93720.1
171865,202305,6,4,2,5280,2640,7920
171870,202305,36,24,12,31680.2,15840.45,47520.65
171875,202305,87,64,23,85800,30360,116160
171880,202305,47,29,18,38280,23760,62040
171884,202305,57,29,28,38280.98,36960,75240.98
171886,202305,138,62,76,81841.3,100320,182161.3
171888,202305,28,21,7,27721.89,9240.1,36961.99
171889,202305,15,7,8,9240,10560,19800
171890,202305,60,48,12,63360.9,15840,79200.9
171900,202305,25,17,8,22440.74,10560,33000.74
172000,202305,36,32,4,42240.2,5280.2,47520.4
172010,202305,57,42,15,55440,19800.07,75240.07
172015,202305,19,14,5,18482.27,6600,25082.27
172020,202305,125,76,49,100320.7,64680,165000.7
172025,202305,43,27,16,35640.46,21120,56760.46
172030,202305,61,37,24,48841.17,31680,80521.17
172049,202305,85,57,28,75241.09,36960.2,112201.29
172065,202305,117,77,40,101643.08,54120.46,155763.54
172080,202305,131,81,50,106922.5,66001.92,172924.42
172085,202305,28,15,13,19800,17160,36960
172090,202305,477,345,132,455405.93,176880.94,632286.87
172093,202305,16,14,2,18480,2640,21120
172097,202305,17,9,8,11880,10560,22440
172100,202305,6506,3778,2728,4988435.73,3607613.8,8596049.53
172110,202305,86,58,28,76561.01,36960,113521.01
172120,202305,1791,1478,313,1951035.67,413165.98,2364201.65
172125,202305,15,11,4,14520,5280,19800
172130,202305,29,18,11,23760.59,14520.28,38280.87
172208,202305,204,132,72,174240,95041.38,269281.38
172210,202305,362,182,180,240245.84,237601.31,477847.15
210005,202305,3204,2034,1170,2685002.65,1545743.05,4230745.70
210010,202305,148,101,47,133320.96,62040,195360.96
210015,202305,45,33,12,43560.39,15840,59400.39
210020,202305,389,234,155,308887.84,205922.61,514810.45
210030,202305,324,220,104,290425.71,137283.99,427709.70
210040,202305,120,100,20,132000.1,26400,158400.1
210043,202305,276,228,48,300965.01,63360,364325.01
210047,202305,496,321,175,423721.37,231000,654721.37
210050,202305,274,193,81,254760.78,106920.2,361680.98
210055,202305,57,48,9,63360.29,11880,75240.29
210060,202305,550,448,102,591391.99,134642.81,726034.80
210070,202305,479,371,108,489720.7,142560.67,632281.37
210080,202305,148,138,10,182162.24,13200,195362.24
210083,202305,300,155,145,204601.48,191400.19,396001.67
210087,202305,10,6,4,7920,5280,13200
210090,202305,504,368,136,485783.84,179521.22,665305.06
210095,202305,424,342,82,452767.55,108240.86,561008.41
210100,202305,715,572,143,755053.78,188760.4,943814.18
210110,202305,116,81,35,106920.89,46200.9,153121.79
210120,202305,4866,3934,932,5193124.3,1234216.15,6427340.45
210125,202305,185,117,68,154442.49,89762.35,244204.84
210130,202305,461,289,172,381490.8,227040.89,608531.69
210135,202305,32,24,8,31681.04,10560,42241.04
210140,202305,4703,3588,1115,4740274.57,1473138.42,6213412.99
210150,202305,388,251,137,331332.52,180842.96,512175.48
210160,202305,3299,2815,484,3717221.2,638887.09,4356108.29
210170,202305,1297,1054,243,1391341.06,320761.35,1712102.41
210173,202305,130,120,10,158401.14,13200,171601.14
210177,202305,291,169,122,223081.49,161040,384121.49
210180,202305,34,19,15,25080.2,19800,44880.2
210190,202305,469,321,148,423721.26,195360.7,619081.96
210193,202305,8,6,2,7920.59,2640,10560.59
210197,202305,67,48,19,63360.3,25080.2,88440.5
210200,202305,629,539,90,712829.67,118800.39,831630.06
210203,202305,234,167,67,220444.42,88441.12,308885.54
210207,202305,318,273,45,360364.11,59400,419764.11
210210,202305,725,677,48,893651.43,63360.6,957012.03
210215,202305,83,75,8,99003.36,10560,109563.36
210220,202305,353,305,48,402617.23,63360.01,465977.24
210230,202305,336,274,62,361685.74,81840,443525.74
210232,202305,1228,903,325,1193311.24,429002.09,1622313.33
210235,202305,188,143,45,188764.14,60720.4,249484.54
210237,202305,51,27,24,35641.94,31680,67321.94
210240,202305,79,69,10,91080.21,13200.21,104280.42
210250,202305,188,161,27,212521.58,35640.2,248161.78
210255,202305,403,298,105,393376.99,138601.68,531978.67
210260,202305,391,284,107,374883.15,143880,518763.15
210270,202305,638,461,177,608532.41,233641.43,842173.84
210275,202305,106,86,20,113520.27,26400,139920.27
210280,202305,1116,742,374,980776.13,495002.97,1475779.10
210290,202305,543,370,173,488410.01,228361.99,716772.00
210300,202305,4936,3246,1690,4286135.45,2230806.91,6516942.36
210310,202305,126,81,45,106920.2,59400,166320.2
210312,202305,119,89,30,117481.86,39600,157081.86
210315,202305,130,112,18,147840.18,23760,171600.18
210317,202305,147,114,33,150480.57,43560,194040.57
210320,202305,2493,2156,337,2847330.33,444841.04,3292171.37
210325,202305,158,94,64,124081.48,84480.34,208561.82
210330,202305,4189,2511,1678,3314582.55,2214963.72,5529546.27
210340,202305,1225,954,271,1259329.49,359043.14,1618372.63
210350,202305,696,587,109,774857.92,143880,918737.92
210355,202305,157,133,24,175560.2,31680,207240.2
210360,202305,2055,1510,545,1995889.97,719404.08,2715294.05
210370,202305,1252,667,585,881779.43,772204.47,1653983.90
210375,202305,194,95,99,125409.95,130681.48,256091.43
210380,202305,748,592,156,781450.32,205921.59,987371.91
210390,202305,196,166,30,219123.22,39600,258723.22
210400,202305,423,376,47,496333.7,62040,558373.7
210405,202305,1142,811,331,1070548.57,438241.92,1508790.49
210407,202305,74,65,9,85800,11880,97680
210408,202305,52,48,4,63362.64,5280,68642.64
210409,202305,356,311,45,410524.79,59400.95,469925.74
210410,202305,452,365,87,483121.97,116160,599281.97
210420,202305,209,170,39,224402.34,51480.36,275882.70
210430,202305,59,43,16,56760.5,21120,77880.5
210440,202305,375,257,118,339250.5,155760,495010.5
210450,202305,110,98,12,129362.73,15840,145202.73
210455,202305,246,131,115,172926.88,153122.65,326049.53
210460,202305,324,221,103,291727.81,137280.25,429008.06
210462,202305,75,61,14,80521.64,18480.33,99001.97
210465,202305,128,103,25,135960.82,33000,168960.82
210467,202305,577,441,136,582135.78,179521.12,761656.90
210470,202305,42,37,5,48840,6600,55440
210480,202305,1394,1020,374,1346440.82,493684.45,1840125.27
210490,202305,180,130,50,171602.85,66000.2,237603.05
210500,202305,504,332,172,438259.98,227042.94,665302.92
210510,202305,527,435,92,574202.59,121442.09,695644.68
210515,202305,332,226,106,298323.73,139920.2,438243.93
210520,202305,399,364,35,480488.76,46200.21,526688.97
210530,202305,10117,5149,4968,6800991.68,6565869.1,13366860.78
210535,202305,125,98,27,129361.98,35640,165001.98
210540,202305,1586,1095,491,1445450.17,648124.31,2093574.48
210542,202305,1092,565,527,747146.4,696972.98,1444119.38
210545,202305,23,21,2,27721.01,2640,30361.01
210547,202305,126,111,15,146521.62,19800.31,166321.93
210550,202305,606,429,177,566306.91,233641.71,799948.62
210560,202305,164,144,20,190082.05,26400.28,216482.33
210565,202305,27,19,8,25080.89,10560.51,35641.40
210570,202305,1310,1118,192,1477116.28,253441.34,1730557.62
210580,202305,133,117,16,154441.59,21120.16,175561.75
210590,202305,683,575,108,759004.38,142560,901564.38
210592,202305,47,43,4,56760,5280,62040
210594,202305,117,101,16,133321.1,21120,154441.1
210596,202305,121,106,15,139921.84,19800,159721.84
210598,202305,140,108,32,142560.9,42240.2,184801.1
210600,202305,306,265,41,349811.52,54120.7,403932.22
210610,202305,253,234,19,308884.49,25080.91,333965.40
210620,202305,43,30,13,39600.01,17160,56760.01
210630,202305,91,82,9,108241.4,11880,120121.4
210632,202305,986,714,272,942484.92,359040,1301524.92
210635,202305,26,23,3,30360.9,3960.2,34321.1
210637,202305,118,86,32,113520.2,42240,155760.2
210640,202305,575,514,61,678483.47,80520,759003.47
210650,202305,415,354,61,467288.41,80520.7,547809.11
210660,202305,386,308,78,406583.9,102962.89,509546.79
210663,202305,82,66,16,87120.62,21120,108240.62
210667,202305,82,42,40,55441.52,52801.17,108242.69
210670,202305,267,238,29,314165.87,38280.68,352446.55
210675,202305,486,287,199,378851.69,264001.9,642853.59
210680,202305,234,155,79,204602.48,104280,308882.48
210690,202305,105,92,13,121441.17,17160,138601.17
210700,202305,152,116,36,153120.4,47520.2,200640.6
210710,202305,269,164,105,216482.21,139920.8,356403.01
210720,202305,130,118,12,155760.08,15840,171600.08
210725,202305,66,56,10,73924.97,13200,87124.97
210730,202305,20,14,6,18480.97,7920,26400.97
210735,202305,294,214,80,282481.23,105600,388081.23
210740,202305,520,454,66,599307.39,87120,686427.39
210745,202305,160,126,34,166320.52,44880,211200.52
210750,202305,2813,1547,1266,2042094.86,1672454.58,3714549.44
210760,202305,263,209,54,275883.18,71280.19,347163.37
210770,202305,247,205,42,270619.95,55442.24,326062.19
210780,202305,418,317,101,418453.32,133321.1,551774.42
210790,202305,195,168,27,221764.42,35640,257404.42
210800,202305,182,137,45,180852.52,59401.32,240253.84
210805,202305,68,61,7,80520,9240,89760
210810,202305,436,363,73,479177.4,96360,575537.4
210820,202305,1956,1663,293,2196563.23,388083.91,2584647.14
210825,202305,157,97,60,128041.94,79200.2,207242.14
210830,202305,698,498,200,657369.54,264001.95,921371.49
210840,202305,205,153,52,201961.34,68640,270601.34
210845,202305,231,179,52,236284.54,68640,304924.54
210850,202305,721,525,196,693028.43,258722.91,951751.34
210860,202305,3459,2133,1326,2815618.67,1750327.3,4565945.97
210870,202305,402,317,85,418459.5,112200.2,530659.7
210880,202305,92,76,16,100321.4,21120,121441.4
210890,202305,316,279,37,368293.99,48840,417133.99
210900,202305,721,459,262,605900.45,345843.62,951744.07
210905,202305,73,40,33,52800.2,43560,96360.2
210910,202305,2112,1600,512,2112059.21,677167.68,2789226.89
210920,202305,141,67,74,88441.95,99000,187441.95
210923,202305,79,64,15,84481.43,19800,104281.43
210927,202305,413,221,192,291722.43,253440.2,545162.63
210930,202305,85,74,11,97680.4,14520,112200.4
210940,202305,80,63,17,83162.17,22440,105602.17
210945,202305,208,125,83,165001.78,109560,274561.78
210950,202305,525,391,134,516125.01,176880.65,693005.66
210955,202305,95,58,37,76561.48,48840.9,125402.38
210960,202305,2476,1298,1178,1714696.81,1554963.29,3269660.10
210970,202305,110,92,18,121440.82,23760.9,145201.72
210975,202305,76,72,4,95040.85,5280.36,100321.21
210980,202305,1051,547,504,723377.74,665282.61,1388660.35
210990,202305,4471,3195,1276,4218846.69,1685663.04,5904509.73
211000,202305,1333,1094,239,1444125.84,315483.08,1759608.92
211003,202305,958,721,237,951736.85,312840.56,1264577.41
211010,202305,491,445,46,587407.53,60720.29,648127.82
211020,202305,1349,638,711,842180.89,938534.25,1780715.14
211023,202305,41,35,6,46200.88,7920,54120.88
211027,202305,82,64,18,84480.78,23760,108240.78
211030,202305,369,268,101,353761.86,133320.5,487082.36
211040,202305,298,256,42,337922.44,55440,393362.44
211050,202305,1153,806,347,1063954.02,458042.33,1521996.35
211060,202305,641,571,70,753752.54,92400.4,846152.94
211065,202305,27,21,6,27723.97,7920.03,35644.00
211070,202305,829,700,129,924041.41,170281.57,1094322.98
211080,202305,88,86,2,113521.24,2640,116161.24
211085,202305,61,33,28,43560,36960,80520
211090,202305,91,79,12,104283.29,15840,120123.29
211100,202305,473,400,73,528014.8,96360.4,624375.2
211102,202305,224,166,58,219120.4,76560,295680.4
211105,202305,226,165,61,217800,80520.26,298320.26
211107,202305,129,84,45,110880.2,59400,170280.2
211110,202305,994,682,312,901585.7,413165.68,1314751.38
211120,202305,5315,2916,2399,3849328.97,3166724.55,7016053.52
211125,202305,22,16,6,21120,7920,29040
211130,202305,42724,21033,21691,27775384.22,28656293.84,56431678.06
211140,202305,363,326,37,430338.03,48840.47,479178.50
211150,202305,1232,890,342,1174840.47,451443.84,1626284.31
211153,202305,169,102,67,134640,88440,223080
211157,202305,71,57,14,75240,18480,93720
211160,202305,691,583,108,769571.13,142560.9,912132.03
211163,202305,3,2,1,2640,1320,3960
211167,202305,10,10,0,13200,,13200.0
211170,202305,425,321,104,423723.35,137281.48,561004.83
211172,202305,101,75,26,99001.26,34320,133321.26
211174,202305,27,16,11,21120,14520.79,35640.79
211176,202305,458,335,123,442206.44,162362.24,604568.68
211178,202305,94,65,29,85801.82,38280,124081.82
211180,202305,212,175,37,231002.22,48840.98,279843.20
211190,202305,75,67,8,88440.2,10560,99000.2
211195,202305,42,29,13,38284.2,17160,55444.2
211200,202305,147,123,24,162362.22,31680,194042.22
211210,202305,397,305,92,402609.28,121440.66,524049.94
211220,202305,4512,2730,1782,3605113.94,2353775.71,5958889.65
211223,202305,139,127,12,167643.95,15840,183483.95
211227,202305,62,48,14,63360.2,18480,81840.2
211230,202305,712,593,119,782796.87,158402.06,941198.93
211240,202305,380,320,60,422404.1,79200,501604.1
211245,202305,181,99,82,130682.38,108240.2,238922.58
211250,202305,1480,1275,205,1683083.63,270604.58,1953688.21
211260,202305,808,694,114,916088.99,150480,1066568.99
211270,202305,1844,1548,296,2043400.19,392042.21,2435442.40
211280,202305,1812,1272,540,1680393.02,712800.75,2393193.77
211285,202305,225,150,75,198001.75,99000,297001.75
211290,202305,809,580,229,765605.27,302281.1,1067886.37
211300,202305,776,632,144,834262.01,191401.16,1025663.17
211400,202305,1574,1047,527,1382073.8,695641.94,2077715.74
220005,202305,18,16,2,21120,2640,23760
220010,202305,76,64,12,84480.66,15840,100320.66
220020,202305,763,623,140,822373.89,184801.29,1007175.18
220025,202305,106,101,5,133321.88,6600,139921.88
220027,202305,62,49,13,64680.2,17160,81840.2
220030,202305,133,110,23,145202.08,30360,175562.08
220040,202305,1340,1033,307,1363592.25,405242.77,1768835.02
220045,202305,31,23,8,30362.4,10561.55,40923.95
220050,202305,684,572,112,754981.35,147841.7,902823.05
220060,202305,192,168,24,221766.52,31680.35,253446.87
220070,202305,110,96,14,126723,18480.7,145203.7
220080,202305,15,13,2,17160.22,2640,19800.22
220090,202305,44,32,12,42240.78,15840,58080.78
220095,202305,3,2,1,2640,1320,3960
220100,202305,24,19,5,25080.71,6600,31680.71
220105,202305,32,29,3,38280.84,3960,42240.84
220110,202305,265,241,24,319442.26,31680,351122.26
220115,202305,48,40,8,52800,10560,63360
220117,202305,25,23,2,30360,2640,33000
220120,202305,1557,1215,342,1603832.15,454080.2,2057912.35
220130,202305,24,24,0,31680,,31680.0
220140,202305,86,72,14,95041.1,18480.84,113521.94
220150,202305,505,380,125,501623.83,165003.91,666627.74
220155,202305,26,25,1,33000.21,1320,34320.21
220157,202305,22,19,3,25081.49,3960,29041.49
220160,202305,111,98,13,129361.19,17160,146521.19
220170,202305,42,35,7,46200,9240,55440
220173,202305,20,17,3,22440,3960,26400
220177,202305,18,18,0,23760.4,,23760.4
220180,202305,66,64,2,84480.98,2640,87120.98
220190,202305,1207,1035,172,1366228.66,227044.71,1593273.37
220191,202305,36,32,4,42241.11,5280,47521.11
220192,202305,94,87,7,114841.71,9240,124081.71
220194,202305,58,52,6,68640.92,7920,76560.92
220196,202305,79,65,14,85804.29,18480.2,104284.49
220198,202305,3,3,0,3960,,3960.0
220200,202305,408,351,57,463344.3,76561.07,539905.37
220202,202305,37,33,4,43561.17,5280,48841.17
220205,202305,70,61,9,80520.2,11880,92400.2
220207,202305,15,15,0,19800.92,,19800.92
220208,202305,70,45,25,59400.57,33000.2,92400.77
220209,202305,34,29,5,38280,6600,44880
220210,202305,30,25,5,33000,6600,39600
220211,202305,34,33,1,43564.46,1320,44884.46
220213,202305,34,31,3,40921.19,3960,44881.19
220217,202305,42,33,9,43560.3,11880,55440.3
220220,202305,2453,1648,805,2178040.66,1063932.27,3241972.93
220225,202305,11,6,5,7920.4,6600,14520.4
220230,202305,1017,761,256,1004540.54,337926.55,1342467.09
220240,202305,167,149,18,196681.43,23760.54,220441.97
220245,202305,48,45,3,59401.41,3960,63361.41
220250,202305,149,124,25,163681.9,33000,196681.9
220253,202305,53,47,6,62040.25,7920,69960.25
220255,202305,51,44,7,58080.2,9240,67320.2
220260,202305,723,555,168,732615.26,223081.06,955696.32
220265,202305,14,11,3,14520,3960,18480
220270,202305,881,793,88,1046772.07,116160,1162932.07
220271,202305,37,28,9,36961.68,11880,48841.68
220272,202305,19,19,0,25080.7,,25080.7
220273,202305,17,16,1,21120.4,1320,22440.4
220275,202305,70,60,10,79200,13200,92400
220277,202305,31,23,8,30360.9,10560.29,40921.19
220280,202305,21,16,5,21120,6600,27720
220285,202305,44,40,4,52800.77,5280,58080.77
220290,202305,1596,1369,227,1807061.55,299643.69,2106705.24
220300,202305,43,43,0,56762.39,,56762.39
220310,202305,349,297,52,392057.72,68642.45,460700.17
220320,202305,471,431,40,568944.43,52801.68,621746.11
220323,202305,2,1,1,1320.8,1320,2640.8
220325,202305,10,9,1,11880,1320,13200
220327,202305,14,14,0,18480.31,,18480.31
220330,202305,219,157,62,207240.56,81840,289080.56
220335,202305,133,113,20,149161.91,26400,175561.91
220340,202305,51,40,11,52800,14520,67320
220342,202305,55,48,7,63362.7,9240,72602.7
220345,202305,93,82,11,108240.46,14520.03,122760.49
220350,202305,473,414,59,546484.41,77880.05,624364.46
220360,202305,50,33,17,43560,22440,66000
220370,202305,1404,1176,228,1552356.04,302280.4,1854636.44
220375,202305,21,20,1,26401.19,1320,27721.19
220380,202305,27,20,7,26401.4,9240,35641.4
220385,202305,18,16,2,21120,2640.66,23760.66
220390,202305,2528,1406,1122,1855981.64,1483706.14,3339687.78
220400,202305,38,31,7,40920,9240,50160
220410,202305,24,23,1,30360.2,1320,31680.2
220415,202305,13,12,1,15841.44,1320,17161.44
220420,202305,132,112,20,149160.8,26400,175560.8
220430,202305,152,133,19,175565.52,25080.2,200645.72
220435,202305,25,19,6,25080.72,7920,33000.72
220440,202305,291,248,43,327378.57,56760,384138.57
220450,202305,374,189,185,249488.22,244206.44,493694.66
220455,202305,53,51,2,67320.47,2640,69960.47
220460,202305,21,20,1,26401.74,1320.89,27722.63
220465,202305,68,47,21,62041.69,27720.41,89762.10
220470,202305,242,213,29,281167.71,39600.86,320768.57
220480,202305,65,60,5,80520.54,6600,87120.54
220490,202305,86,73,13,96360,17160,113520
220500,202305,129,108,21,143881.57,27720,171601.57
220510,202305,367,287,80,378851.44,105600.88,484452.32
220515,202305,29,27,2,35641.71,2640,38281.71
220520,202305,389,342,47,451449.5,62041.26,513490.76
220525,202305,9,5,4,6600.38,5280.98,11881.36
220527,202305,14,14,0,18480.38,,18480.38
220530,202305,51,24,27,31680,35640.87,67320.87
220535,202305,5,4,1,5280.74,1320,6600.74
220540,202305,111,97,14,128041.05,18480.2,146521.25
220545,202305,23,15,8,19800.96,10560.8,30361.76
220550,202305,775,614,161,811828.04,213841.9,1025669.94
220551,202305,14,12,2,15840,2640,18480
220552,202305,13,13,0,17160,,17160.0
220553,202305,63,58,5,76560.85,6600,83160.85
220554,202305,6,4,2,5280.86,2640,7920.86
220555,202305,49,38,11,50161.87,14520.2,64682.07
220556,202305,41,38,3,50161.62,3960,54121.62
220557,202305,67,62,5,81841.36,6600.74,88442.10
220558,202305,14,7,7,9240,9240.54,18480.54
220559,202305,6,5,1,6600.07,1320,7920.07
220560,202305,87,56,31,73921.57,40920,114841.57
220570,202305,736,461,275,608530.9,363003.57,971534.47
220580,202305,567,522,45,689075.36,59401.93,748477.29
220585,202305,14,11,3,14520.2,3960.43,18480.63
220590,202305,18,16,2,21122.04,2640,23762.04
220595,202305,73,56,17,73920.4,22440,96360.4
220600,202305,21,15,6,19800,7920,27720
220605,202305,35,32,3,42240.2,3960,46200.2
220610,202305,99,83,16,109560,22440,132000
220620,202305,574,494,80,652093.01,105601.95,757694.96
220630,202305,4,3,1,3960.53,1320,5280.53
220635,202305,34,31,3,40922.23,3960,44882.23
220640,202305,114,96,18,126720,23760,150480
220650,202305,117,111,6,146520.78,7920,154440.78
220660,202305,86,64,22,84480.92,29040.2,113521.12
220665,202305,14,14,0,18480,,18480.0
220667,202305,26,24,2,31680.26,2640,34320.26
220669,202305,46,40,6,52800.2,7920,60720.2
220670,202305,70,54,16,71280.9,21120,92400.9
220672,202305,78,57,21,75245.26,27721.21,102966.47
220675,202305,28,22,6,29042.06,7920,36962.06
220680,202305,63,54,9,71280.2,11880,83160.2
220690,202305,48,45,3,59400.81,3960,63360.81
220695,202305,30,17,13,22441.19,17160,39601.19
220700,202305,1939,1506,433,1989268.8,572885.72,2562154.52
220710,202305,7,5,2,6600.2,2640.78,9240.98
220720,202305,112,99,13,130680,17160,147840
220730,202305,31,30,1,39600.01,1320,40920.01
220735,202305,9,7,2,9240,2640,11880
220740,202305,61,53,8,69960.4,10560.91,80521.31
220750,202305,135,115,20,151802.8,26400.18,178202.98
220755,202305,20,19,1,25081.29,1320,26401.29
220760,202305,70,61,9,80521.85,11880,92401.85
220770,202305,6273,3623,2650,4782612.49,3500721.61,8283334.10
220775,202305,12,10,2,13200.7,2640.66,15841.36
220777,202305,22,21,1,27720,1320,29040
220779,202305,5,1,4,1320,5280,6600
220780,202305,968,820,148,1082409.76,195360.64,1277770.40
220785,202305,7,4,3,5280,3960.2,9240.2
220790,202305,1287,1035,252,1366234.72,332647.76,1698882.48
220793,202305,9,6,3,7920,3960,11880
220795,202305,25,24,1,31680.27,1320,33000.27
220800,202305,4209,3222,987,4253373.52,1302855.41,5556228.93
220810,202305,80,68,12,89761.61,15840,105601.61
220820,202305,257,233,24,307568.04,31681.8,339249.84
220830,202305,1362,1204,158,1590417.69,209969.33,1800387.02
220840,202305,2683,1902,781,2510716.95,1033579.55,3544296.50
220850,202305,81,69,12,91080,15840,106920
220855,202305,8,4,4,5280,5280,10560
220860,202305,17,14,3,18482.05,3960,22442.05
220865,202305,31,28,3,36960.1,3960,40920.1
220870,202305,92,82,10,108241.14,13200,121441.14
220880,202305,342,283,59,373573.92,77881.92,451455.84
220885,202305,27,26,1,34323.94,1320,35643.94
220887,202305,6,5,1,6600.2,1320,7920.2
220890,202305,86,73,13,96361.9,18480,114841.9
220900,202305,26,14,12,18480,15840,34320
220910,202305,48,37,11,48842.13,14520,63362.13
220915,202305,12,10,2,13200.19,2640,15840.19
220920,202305,51,45,6,59445.39,7920,67365.39
220930,202305,56,54,2,71280.35,2640,73920.35
220935,202305,18,18,0,23760.97,,23760.97
220937,202305,34,30,4,39601.09,5280,44881.09
220940,202305,63,55,8,72600,10560,83160
220945,202305,5,5,0,6600.34,,6600.34
220950,202305,36,28,8,36960.2,10560,47520.2
220955,202305,25,24,1,31680.77,1320,33000.77
220960,202305,43,37,6,48840,7920,56760
220965,202305,56,51,5,67320,6600,73920
220970,202305,64,54,10,71280,13200,84480
220975,202305,12,10,2,13200.9,2640,15840.9
220980,202305,28,26,2,34320.76,2640,36960.76
220985,202305,54,46,8,60720,10560,71280
220987,202305,34,33,1,43562.33,1320.19,44882.52
220990,202305,25,23,2,30360,2992,33352
220995,202305,13,11,2,14520,2640,17160
220997,202305,74,66,8,87121.93,10560,97681.93
221000,202305,1356,1199,157,1582721.73,207240.86,1789962.59
221005,202305,44,41,3,54120,3960.77,58080.77
221010,202305,28,20,8,26400,10560,36960
221020,202305,45,39,6,51480.82,7920,59400.82
221030,202305,44,37,7,48736.43,9240,57976.43
221035,202305,23,22,1,29042,1320,30362
221037,202305,14,10,4,13200,5280,18480
221038,202305,26,23,3,30360,3960,34320
221039,202305,26,25,1,33000.01,1320.2,34320.21
221040,202305,268,226,42,298324.73,55442.1,353766.83
221050,202305,240,199,41,262690.28,54120.2,316810.48
221060,202305,2097,1801,296,2378687.23,390725.96,2769413.19
221062,202305,29,28,1,36962.81,1320,38282.81
221063,202305,20,15,5,19800,6600,26400
221065,202305,78,64,14,84482.93,18480,102962.93
221070,202305,162,140,22,184804.35,29040,213844.35
221080,202305,430,364,66,480491.91,87120,567611.91
221090,202305,34,28,6,36962.42,7920,44882.42
221093,202305,52,36,16,47521.2,21120.38,68641.58
221095,202305,5,5,0,6600,,6600.0
221097,202305,12,10,2,13200,2640,15840
221100,202305,28632,17130,11502,22624519.27,15193510.85,37818030.12
221110,202305,1217,942,275,1243485.85,364326.58,1607812.43
221120,202305,609,444,165,586093.36,220440.08,806533.44
221130,202305,1061,854,207,1127300.26,273244.27,1400544.53
221135,202305,33,30,3,39601.09,3960,43561.09
221140,202305,49,43,6,56760.2,7920,64680.2
221150,202305,14,10,4,13200.18,5280,18480.18
221160,202305,19,17,2,22441.39,2640,25081.39
221170,202305,21,20,1,26400,1320,27720
230010,202305,169,146,23,192986.06,30360,223346.06
230015,202305,176,145,31,191400.7,40920,232320.7
230020,202305,1963,1555,408,2052652.51,538574.59,2591227.10
230030,202305,1760,1288,472,1700215.9,623048.72,2323264.62
230040,202305,247,198,49,262682.41,64680,327362.41
230050,202305,254,177,77,233641.01,101640.57,335281.58
230060,202305,185,145,40,191400.19,52800.94,244201.13
230070,202305,337,286,51,377525.67,67320,444845.67
230075,202305,983,812,171,1071863.13,225724.46,1297587.59
230080,202305,246,200,46,264002.75,60720,324722.75
230090,202305,201,144,57,190081.03,75240,265321.03
230100,202305,2961,1656,1305,2189977.12,1726585.35,3916562.47
230110,202305,3285,2077,1208,2743036.84,1597219.58,4340256.42
230120,202305,1290,977,313,1289669.57,414483.48,1704153.05
230125,202305,195,154,41,203280.83,54120,257400.83
230130,202305,537,466,71,615128.03,93720.77,708848.80
230140,202305,232,189,43,249480.51,56760,306240.51
230150,202305,154,118,36,155761.66,47520.41,203282.07
230160,202305,1035,842,193,1111447.88,254760.85,1366208.73
230170,202305,688,594,94,784098.99,124084.61,908183.60
230180,202305,70,62,8,81840.39,10560,92400.39
230185,202305,454,389,65,513489.25,85801.14,599290.39
230190,202305,2734,2054,680,2712672.3,898929.95,3611602.25
230195,202305,550,468,82,617777.6,108240,726017.6
230200,202305,496,382,114,504247.58,150480.2,654727.78
230205,202305,430,282,148,372241.17,195360.2,567601.37
230210,202305,1511,1145,366,1511426.48,483121.63,1994548.11
230220,202305,1764,1169,595,1543119.16,785409.57,2328528.73
230230,202305,1084,867,217,1144467.09,286442.45,1430909.54
230240,202305,2269,1982,287,2617616.15,378844.27,2996460.42
230250,202305,1983,1611,372,2126596.9,492370.06,2618966.96
230260,202305,3556,2193,1363,2894792.53,1799165.2,4693957.73
230270,202305,1484,1140,344,1504819.87,454085.09,1958904.96
230280,202305,3069,2348,721,3099452.84,951729.12,4051181.96
230290,202305,370,322,48,425054.55,63361.04,488415.59
230300,202305,547,402,145,530643.89,191400.29,722044.18
230310,202305,451,347,104,458040.46,137280.87,595321.33
230320,202305,1005,835,170,1102222.06,224401.18,1326623.24
230330,202305,350,283,67,373563.04,88440,462003.04
230340,202305,475,382,93,504249.08,122760.4,627009.48
230350,202305,3705,2250,1455,2971407.56,1923257.13,4894664.69
230360,202305,286,237,49,312845.44,64681.24,377526.68
230365,202305,148,117,31,154442.1,40920,195362.1
230370,202305,12682,6370,6312,8410151.27,8341321.34,16751472.61
230380,202305,558,476,82,628333.18,108242.78,736575.96
230390,202305,568,326,242,430323.74,319440,749763.74
230393,202305,242,195,47,257401.33,62040.5,319441.83
230395,202305,391,311,80,410546.45,105602.54,516148.99
230400,202305,712,565,147,745809.01,194040.2,939849.21
230410,202305,3094,1952,1142,2578030,1510099.64,4088129.64
230420,202305,7097,4666,2431,6162048.34,3210336.98,9372385.32
230423,202305,363,313,50,413162.98,66000.1,479163.08
230425,202305,556,442,114,583449.53,150480.99,733930.52
230426,202305,128,100,28,132000.7,36960,168960.7
230427,202305,80,69,11,91080.99,14520,105600.99
230428,202305,1926,920,1006,1214434.42,1329255.2,2543689.62
230430,202305,494,396,98,524050.45,129361.81,653412.26
230435,202305,1007,720,287,950424.48,378841.34,1329265.82
230440,202305,107833,49708,58125,65661276.38,76813595.06,142474871.44
230445,202305,355,236,119,312850.69,157080.7,469931.39
230450,202305,633,490,143,648122.77,188760.7,836883.47
230460,202305,114,82,32,108240.69,43560,151800.69
230465,202305,334,269,65,355084.18,85800,440884.18
230470,202305,2185,1714,471,2262504.65,621722.81,2884227.46
230480,202305,163,147,16,194040.5,21121.14,215161.64
230490,202305,362,283,79,373562.72,104280.9,477843.62
230495,202305,533,378,155,498975.17,204602.92,703578.09
230500,202305,1244,920,324,1214412.26,429002.54,1643414.80
230510,202305,82,55,27,72600,35640,108240
230520,202305,445,337,108,444845.58,142560.62,587406.20
230523,202305,2894,1768,1126,2336474.52,1488978.71,3825453.23
230526,202305,265,219,46,290401.62,62040,352441.62
230530,202305,749,531,218,700930.92,287763.3,988694.22
230533,202305,229,210,19,277202.24,25080.2,302282.44
230535,202305,450,335,115,442215.32,151801.86,594017.18
230540,202305,1916,1706,210,2251979.08,277203.9,2529182.98
230550,202305,4585,2891,1694,3821589.4,2236133.44,6057722.84
230560,202305,631,482,149,636251.15,196680.57,832931.72
230565,202305,234,173,61,228360.7,80521.14,308881.84
230570,202305,335,285,50,376202.22,66000.45,442202.67
230580,202305,1341,912,429,1203854.54,567605.44,1771459.98
230590,202305,1165,883,282,1165469.77,373562.1,1539031.87
230600,202305,313,281,32,370929.16,42240,413169.16
230610,202305,513,377,136,497651.74,180840.2,678491.94
230620,202305,187,155,32,204604.37,42240,246844.37
230625,202305,957,638,319,842180.59,422401.26,1264581.85
230630,202305,1614,1201,413,1585358.73,545164.94,2130523.67
230640,202305,4361,3526,835,4654498.64,1104870.75,5759369.39
230650,202305,533,453,80,597966.63,105601.01,703567.64
230655,202305,810,638,172,842187.67,228363.76,1070551.43
230660,202305,408,333,75,439564.91,99000.2,538565.11
230670,202305,518,409,109,539899.84,143880.96,683780.80
230680,202305,242,206,36,271926.53,47520,319446.53
230690,202305,1054,879,175,1160308.93,232321.26,1392630.19
230700,202305,1124,927,197,1223667.17,261361.68,1485028.85
230710,202305,720,659,61,869908.83,80521.05,950429.88
230720,202305,157,135,22,178200,29040.7,207240.7
230725,202305,316,239,77,315482.44,101641.17,417123.61
230730,202305,14189,7452,6737,9841216.87,8904888.04,18746104.91
230740,202305,762,613,149,809182.73,196681.1,1005863.83
230750,202305,909,745,164,984736.52,216481.01,1201217.53
230760,202305,1777,1502,275,1984029.62,363003.03,2347032.65
230763,202305,401,338,63,446163.62,83160,529323.62
230765,202305,9751,4653,5098,6148965.31,6733547.52,12882512.83
230770,202305,5688,2936,2752,3875679.55,3639276.41,7514955.96
230780,202305,865,740,125,976809.31,165000.54,1141809.85
230790,202305,341,278,63,366960.3,83160.24,450120.54
230800,202305,1318,928,390,1224977.86,516121.8,1741099.66
230810,202305,1535,1322,213,1746430.77,281164.12,2027594.89
230820,202305,410,266,144,351123.97,190081.26,541205.23
230830,202305,1029,858,171,1132582.2,225720.9,1358303.1
230835,202305,306,250,56,330004.6,73920.68,403925.28
230837,202305,203,161,42,213842.02,55440.9,269282.92
230840,202305,1040,775,265,1023009.69,349802.46,1372812.15
230850,202305,1495,1250,245,1650043.59,323404.62,1973448.21
230860,202305,366,287,79,378843.9,104286.6,483130.5
230870,202305,1990,1677,313,2215000.18,413160.47,2628160.65
230880,202305,88,67,21,88440,27720,116160
230890,202305,615,539,76,712808.82,100322.1,813130.92
230900,202305,338,250,88,330001.55,116160.24,446161.79
230910,202305,244,188,56,248162.22,73920,322082.22
230920,202305,544,421,123,555728.55,162360,718088.55
230930,202305,1224,852,372,1124667.96,491042.5,1615710.46
230940,202305,910,699,211,924018.8,278520.73,1202539.53
230945,202305,621,494,127,652105.97,167645.39,819751.36
230950,202305,469,404,65,533298.68,85800.5,619099.18
230960,202305,3094,2067,1027,2729888.86,1355677.48,4085566.34
230970,202305,2050,1125,925,1485052.09,1221018.06,2706070.15
230980,202305,245,177,68,233642.86,89760,323402.86
230990,202305,150,116,34,153120.5,44880,198000.5
231000,202305,221,203,18,267962.58,23760,291722.58
231010,202305,203,136,67,179522.87,88440,267962.87
231020,202305,1617,1062,555,1404538.4,733933.69,2138472.09
231025,202305,1249,857,392,1132601.74,517454.46,1650056.20
231030,202305,1147,926,221,1222334.96,291721.97,1514056.93
231040,202305,199,139,60,183483.16,79200,262683.16
231050,202305,1022,868,154,1145780.01,203287.44,1349067.45
231060,202305,176,141,35,186124.8,46200.5,232325.3
231070,202305,1661,1136,525,1500870.85,693007.8,2193878.65
231080,202305,287,251,36,331328.45,47520,378848.45
231085,202305,778,476,302,628338.73,398640.26,1026978.99
231090,202305,291,232,59,306244.48,77881.64,384126.12
231095,202305,174,129,45,170280,59400.45,229680.45
231100,202305,204,165,39,217801.6,51480,269281.6
231110,202305,399,330,69,435609.32,92403.59,528012.91
231120,202305,281,231,50,304923.98,66001.36,370925.34
231123,202305,158,150,8,198002.76,10560,208562.76
231126,202305,361,281,80,372241.09,105600,477841.09
231130,202305,5427,4201,1226,5549498.8,1618350.18,7167848.98
231135,202305,239,207,32,273242.24,42241.41,315483.65
231140,202305,3318,2375,943,3137740.48,1246093.08,4383833.56
231150,202305,430,395,35,521412.78,46201.07,567613.85
231160,202305,1360,1107,253,1463908.64,335280.46,1799189.10
231170,202305,575,396,179,522724.56,236280,759004.56
231180,202305,2128,1837,291,2424906.45,384127.15,2809033.60
231190,202305,250,201,49,265320.54,66000,331320.54
231195,202305,253,205,48,270601.93,63360.15,333962.08
231200,202305,940,748,192,987387.78,253442.2,1240829.98
231210,202305,552,456,96,603249.95,126721.39,729971.34
231220,202305,1168,818,350,1079784.65,463324.01,1543108.66
231230,202305,1721,1256,465,1657949.03,617761.36,2275710.39
231240,202305,1813,1211,602,1598559.26,794647.81,2393207.07
231250,202305,99,93,6,122761.53,7920,130681.53
231260,202305,277,185,92,244202,121442.22,365644.22
231270,202305,1063,810,253,1069230.43,333961.19,1403191.62
231280,202305,87,63,24,83162.11,31680.8,114842.91
231290,202305,8892,4950,3942,6536910.18,5210137.95,11747048.13
231300,202305,640,575,65,759007.56,87120,846127.56
231310,202305,911,829,82,1094295.25,108241.38,1202536.63
231320,202305,674,501,173,661325.71,228361.62,889687.33
231325,202305,109,92,17,121440.18,22440.54,143880.72
231330,202305,2129,1597,532,2109429.19,702249.32,2811678.51
231335,202305,270,238,32,314165.45,42240,356405.45
231340,202305,2132,1443,689,1904810.74,912131.14,2816941.88
231350,202305,1602,1241,361,1638183.02,476533.76,2114716.78
231355,202305,446,364,82,480486.34,108241.24,588727.58
231360,202305,633,425,208,561016.94,274561.94,835578.88
231370,202305,100,85,15,112200,19800,132000
231375,202305,305,226,79,298325.79,104280.1,402605.89
231380,202305,573,454,119,599285.95,158400,757685.95
231390,202305,213,163,50,216481.99,66000,282481.99
231395,202305,847,496,351,654724.5,463320.55,1118045.05
231400,202305,1339,1109,230,1465230.34,304924.38,1770154.72
231410,202305,1538,1239,299,1635510.44,396002.65,2031513.09
240010,202305,426,196,230,260051.72,303609.11,563660.83
240020,202305,2484,2038,446,2692919.78,588728.41,3281648.19
240030,202305,123,96,27,126721.74,35640,162361.74
240040,202305,37,35,2,46200,2640.31,48840.31
240050,202305,562,479,83,632313.52,109560.1,741873.62
240060,202305,90,79,11,104281.79,14520,118801.79
240070,202305,310,237,73,312844.88,96360.2,409205.08
240080,202305,641,428,213,564983.14,281168.48,846151.62
240090,202305,111,97,14,128040.32,18480,146520.32
240100,202305,1665,1557,108,2056627.13,142562.72,2199189.85
240110,202305,1141,766,375,1011198.92,495020.9,1506219.82
240120,202305,163,120,43,158401.67,56760.23,215161.90
240130,202305,279,255,24,337934.45,31680.7,369615.15
240140,202305,95,62,33,81841.39,43560.64,125402.03
240145,202305,791,695,96,917434.84,128040.71,1045475.55
240150,202305,30,22,8,29040,10560,39600
240160,202305,40,32,8,42240,10560,52800
240165,202305,42,34,8,44883.77,10560.32,55444.09
240170,202305,167,114,53,150481.59,69960,220441.59
240180,202305,130,96,34,126723.39,44880,171603.39
240185,202305,53,46,7,60720.39,9240,69960.39
240190,202305,15,13,2,17160.43,2640,19800.43
240200,202305,3371,1803,1568,2383987.45,2072423,4456410.45
240210,202305,169,126,43,166320.73,56760,223080.73
240220,202305,1253,850,403,1122047.68,533285.58,1655333.26
240230,202305,897,798,99,1053403.4,132001.46,1185404.86
240240,202305,91,60,31,79200.2,42240.76,121440.96
240250,202305,110,94,16,124081.31,21120,145201.31
240260,202305,2095,1466,629,1935185.91,830292.57,2765478.48
240270,202305,179,152,27,200641,35640,236281
240280,202305,74,60,14,80520.2,18480.1,99000.3
240290,202305,41,39,2,51480,2640,54120
240300,202305,178,95,83,125401.87,110880,236281.87
240310,202305,2772,1486,1286,1961583.33,1697545.42,3659128.75
240320,202305,181,167,14,220440.07,18480,238920.07
240325,202305,5505,3046,2459,4023577.73,3247299.98,7270877.71
240330,202305,88,83,5,109560,6600,116160
240340,202305,117,85,32,112200,42240,154440
240350,202305,102,80,22,106920.2,29040,135960.2
240360,202305,844,535,309,706233.18,407888.51,1114121.69
240370,202305,67,58,9,76562.48,11881.58,88444.06
240375,202305,51,33,18,43561.28,23761.65,67322.93
240380,202305,228,187,41,246850.79,54120.5,300971.29
240390,202305,16,15,1,19800,1320,21120
240400,202305,89,79,10,104281.34,13200,117481.34
240410,202305,11,8,3,10560,3960,14520
240420,202305,1215,850,365,1122035.61,481809.04,1603844.65
240430,202305,276,249,27,328694.15,35640.54,364334.69
240440,202305,159,89,70,117484.23,92400.93,209885.16
240450,202305,279,166,113,219131.76,149163.01,368294.77
240460,202305,103,80,23,105601.12,30360.6,135961.72
240470,202305,234,211,23,278537.69,31681.56,310219.25
240480,202305,16,14,2,18480,2640,21120
240485,202305,92,72,20,95041.49,26400,121441.49
240490,202305,69,62,7,81840.11,9240,91080.11
240500,202305,112,87,25,114840,33000,147840
240510,202305,38,29,9,38280,11880,50160
240520,202305,99,94,5,124082.32,6600.56,130682.88
240530,202305,67,50,17,66000,22440,88440
240540,202305,104,88,16,116160.1,21120,137280.1
240550,202305,12,10,2,13200,2640,15840
240560,202305,433,291,142,385450.7,187440.83,572891.53
240570,202305,466,281,185,370927.88,244201.53,615129.41
240580,202305,1476,1071,405,1413762.72,534601.73,1948364.45
240590,202305,31,30,1,39600.97,1320,40920.97
240600,202305,108,101,7,133321.83,9240,142561.83
240610,202305,518,428,90,564987.63,118806.35,683793.98
240615,202305,11,10,1,13200.8,1320,14520.8
240620,202305,88,84,4,112201.64,5280,117481.64
240630,202305,43,35,8,46200.97,10560.48,56761.45
240640,202305,38,25,13,33000,17160,50160
240650,202305,256,203,53,267961.55,69960.28,337921.83
240660,202305,116,98,18,130680.77,23760,154440.77
240670,202305,328,184,144,242895.3,191410.2,434305.5
240680,202305,58,45,13,59400.67,17160,76560.67
240690,202305,49,47,2,62041.84,2640,64681.84
240700,202305,184,154,30,203280.6,39601.02,242881.62
240710,202305,2502,1494,1008,1972149.69,1330576.99,3302726.68
240720,202305,1145,790,355,1044156.23,468607.42,1512763.65
240725,202305,79,71,8,93721.53,10560.88,104282.41
240730,202305,152,124,28,163680.04,36960.9,200640.94
240740,202305,248,200,48,264011.15,63360.62,327371.77
240750,202305,57,35,22,46200,29040,75240
240760,202305,64,51,13,67320,17160,84480
240770,202305,160,124,36,163682.72,47521.32,211204.04
240780,202305,817,670,147,884428.02,194041.32,1078469.34
240790,202305,42,39,3,51481.78,3960,55441.78
240800,202305,10562,7095,3467,9370009.94,4581913.35,13951923.29
240810,202305,23756,12500,11256,16511477.84,14870160.15,31381637.99
240820,202305,286,173,113,228366.53,149162.99,377529.52
240830,202305,1697,1399,298,1846737.75,393366.87,2240104.62
240840,202305,80,69,11,91080.79,14520,105600.79
240850,202305,91,78,13,102960,17160,120120
240860,202305,115,110,5,145202.09,6600.85,151802.94
240870,202305,59,48,11,63363.2,14520,77883.2
240880,202305,33,29,4,38280,5280,43560
240890,202305,1305,728,577,960993.85,762972.23,1723966.08
240895,202305,64,49,15,64680.2,19800.93,84481.13
240910,202305,192,158,34,208562.25,44880.2,253442.45
240920,202305,13,12,1,15841.62,1320,17161.62
240930,202305,452,401,51,529348.27,67321.06,596669.33
240933,202305,67,43,24,56760.95,31680,88440.95
240940,202305,2446,2130,316,2811675.71,417123.87,3228799.58
240950,202305,44,38,6,50160,7920,58080
240960,202305,27,22,5,29040.2,6600.3,35640.5
240970,202305,117,83,34,109560.96,44880,154440.96
240980,202305,217,169,48,223080.88,63361.45,286442.33
240990,202305,150,95,55,125401.67,73920,199321.67
241000,202305,62,56,6,73920.65,7920,81840.65
241010,202305,97,77,20,101640.3,26400,128040.3
241020,202305,115,106,9,139921.86,11880.51,151802.37
241025,202305,22,14,8,18481.17,10560.5,29041.67
241030,202305,124,95,29,125400,38280,163680
241040,202305,47,38,9,50160.1,11880,62040.1
241050,202305,76,70,6,92401.03,7920,100321.03
241060,202305,30,25,5,33000.78,6600,39600.78
241070,202305,24,24,0,31682.88,,31682.88
241080,202305,61,53,8,69960.2,10560,80520.2
241090,202305,55,44,11,58083.91,14520,72603.91
241100,202305,69,61,8,80520.52,10560.25,91080.77
241105,202305,30,18,12,23764.17,15840.73,39604.90
241110,202305,53,44,9,58080.15,11880,69960.15
241120,202305,1836,1385,451,1829561.06,595324.14,2424885.20
241140,202305,211,170,41,224404.24,54120,278524.24
241142,202305,51,40,11,52801.31,14520,67321.31
241150,202305,1243,1072,171,1415090.17,225722.74,1640812.91
241160,202305,27,19,8,25080,10560,35640
241170,202305,55,47,8,62040,10560,72600
241180,202305,50,37,13,48840,17160,66000
241190,202305,42,37,5,48842.35,6600,55442.35
241200,202305,5355,2778,2577,3671137.67,3401763.44,7072901.11
241210,202305,75,63,12,83160.53,15840,99000.53
241220,202305,1705,1069,636,1412463.45,840853.32,2253316.77
241230,202305,271,214,57,282485.49,75240.91,357726.40
241240,202305,54,40,14,52801.36,18480,71281.36
241250,202305,1191,1086,105,1433559.58,138602.12,1572161.70
241255,202305,74,60,14,79201.38,18480,97681.38
241260,202305,802,610,192,805217.03,254762.63,1059979.66
241270,202305,73,52,21,68641.17,27720,96361.17
241280,202305,98,85,13,112202.37,17160,129362.37
241290,202305,145,107,38,141243.82,50160.39,191404.21
241300,202305,86,57,29,75240.7,38280.98,113521.68
241310,202305,57,40,17,52801.92,22440.1,75242.02
241320,202305,35,19,16,25081.55,21120,46201.55
241330,202305,64,54,10,71280.08,13200,84480.08
241335,202305,111,100,11,132003.17,14520,146523.17
241340,202305,194,135,59,178200.81,77880,256080.81
241350,202305,67,56,11,73920.59,14520,88440.59
241355,202305,57,47,10,62041.8,13200,75241.8
241360,202305,60,57,3,75240.78,3960,79200.78
241370,202305,72,58,14,76560,18480,95040
241380,202305,35,31,4,40921.5,5280,46201.5
241390,202305,92,73,19,96360,25080,121440
241400,202305,240,178,62,235917.88,81841.89,317759.77
241410,202305,193,174,19,229681.02,25080.8,254761.82
241415,202305,111,88,23,116160.1,30360.8,146520.9
241420,202305,150,96,54,126722.41,71280,198002.41
241430,202305,21,18,3,23760.88,3960,27720.88
241440,202305,572,482,90,636268.57,118802.97,755071.54
241445,202305,44,39,5,51480.2,6600.8,58081.0
241450,202305,268,226,42,298331.11,55440.54,353771.65
241460,202305,183,165,18,217805.24,23760.84,241566.08
241470,202305,33,27,6,35640.8,7920.43,43561.23
241475,202305,51,47,4,62040,5280,67320
241480,202305,152,110,42,145202.32,55440.2,200642.52
241490,202305,13,11,2,14521.07,2640.1,17161.17
241500,202305,53,39,14,51482.33,18480.02,69962.35
250010,202305,101,84,17,110880.1,23760.34,134640.44
250020,202305,34,29,5,38280,6600,44880
250030,202305,945,704,241,930631.64,318124.24,1248755.88
250040,202305,420,340,80,448818.03,105601.12,554419.15
250050,202305,301,245,56,323401.95,73920.5,397322.45
250053,202305,68,55,13,72600.6,17160,89760.6
250057,202305,4,3,1,3960.2,1320,5280.2
250060,202305,657,476,181,629658.78,238921.68,868580.46
250070,202305,701,557,144,735259.83,190080.64,925340.47
250073,202305,10,8,2,10560.58,2640.01,13200.59
250077,202305,196,141,55,186122.03,72600.2,258722.23
250080,202305,421,334,87,440890.05,114840.38,555730.43
250090,202305,228,143,85,188761.54,112200,300961.54
250100,202305,619,490,129,646806.23,170281,817087.23
250110,202305,741,530,211,700941.02,278521.48,979462.50
250115,202305,14,4,10,5280.18,13200.26,18480.44
250120,202305,125,91,34,120120.37,44881.98,165002.35
250130,202305,599,493,106,650782.08,142561.58,793343.66
250135,202305,34,15,19,19800.59,25080,44880.59
250140,202305,95,80,15,105602.75,19800,125402.75
250150,202305,687,475,212,627011.64,279841.43,906853.07
250153,202305,18,15,3,19800.1,3960,23760.1
250157,202305,41,33,8,43560.42,10560,54120.42
250160,202305,261,196,65,260043.51,85800,345843.51
250170,202305,90,59,31,77880.2,42240,120120.2
250180,202305,5339,3705,1634,4890877.62,2159581.5,7050459.12
250190,202305,823,557,266,736568.69,351123.03,1087691.72
250200,202305,77,61,16,80520.41,21120.7,101641.11
250205,202305,24,19,5,25080.61,6600,31680.61
250210,202305,92,77,15,101641.97,19800,121441.97
250215,202305,101,65,36,85800.57,47520.85,133321.42
250220,202305,32,21,11,27721.66,14520,42241.66
250230,202305,80,70,10,92401.19,13200.2,105601.39
250240,202305,262,193,69,254763.97,91080.2,345844.17
250250,202305,438,374,64,493694.26,84480,578174.26
250260,202305,54,44,10,60720.1,13200,73920.1
250270,202305,81,58,23,76560.8,30360,106920.8
250280,202305,415,339,76,447484.97,100320,547804.97
250290,202305,120,107,13,141240,17160.84,158400.84
250300,202305,529,355,174,468612.1,229680.8,698292.9
250310,202305,53,48,5,63361.55,6600,69961.55
250320,202305,2215,1469,746,1940502.49,988702.09,2929204.58
250330,202305,124,107,17,141242.84,22440.1,163682.94
250340,202305,34,28,6,36960.76,7920,44880.76
250350,202305,213,141,72,186123.9,95040,281163.9
250355,202305,45,35,10,46200,13200.69,59400.69
250360,202305,196,162,34,213845.15,44881.62,258726.77
250370,202305,2539,1623,916,2143758.88,1209146.95,3352905.83
250375,202305,17,11,6,14520.36,7920.62,22440.98
250380,202305,55,47,8,62040.26,10560.24,72600.50
250390,202305,53,42,11,55441.52,14520,69961.52
250400,202305,18850,9715,9135,12832298.74,12079593.99,24911892.73
250403,202305,303,234,69,308882.81,93720,402602.81
250407,202305,69,55,14,72600.1,18480.85,91080.95
250410,202305,32,27,5,35640.31,6600.8,42241.11
250415,202305,51,32,19,42240,25080,67320
250420,202305,42,36,6,47520.3,7920,55440.3
250430,202305,1578,1372,206,1811417.08,271921.05,2083338.13
250435,202305,41,30,11,39601.92,14520,54121.92
250440,202305,697,572,125,755049.37,165001,920050.37
250450,202305,93,70,23,92401.52,30360,122761.52
250460,202305,519,344,175,454085.88,231002.04,685087.92
250470,202305,106,73,33,96360,43560,139920
250480,202305,356,280,76,369611.36,100320.98,469932.34
250485,202305,6,5,1,6600,1320,7920
250490,202305,259,207,52,273246.21,69961.31,343207.52
250500,202305,106,81,25,106920,33000,139920
250510,202305,901,716,185,945132.36,244200.8,1189333.16
250520,202305,175,120,55,158400.66,72600,231000.66
250523,202305,132,107,25,141240.83,33000.12,174240.95
250527,202305,122,90,32,118800.83,42240,161040.83
250530,202305,12,8,4,10560,5280,15840
250535,202305,30,23,7,30360,9240,39600
250540,202305,148,117,31,154440.83,40920,195360.83
250550,202305,75,73,2,96361.19,2640,99001.19
250560,202305,67,40,27,52800.84,36960.07,89760.91
250570,202305,167,138,29,182161.4,38280.7,220442.1
250580,202305,99,77,22,101725.2,29040,130765.2
250590,202305,22,15,7,19800,9240,29040
250600,202305,1728,1147,581,1514071.93,768244.13,2282316.06
250610,202305,161,127,34,167649.99,44880.22,212530.21
250620,202305,26,22,4,29041.79,5280,34321.79
250625,202305,70,52,18,68642.33,23760.01,92402.34
250630,202305,3258,2024,1234,2672010.97,1628904.8,4300915.77
250640,202305,200,159,41,209886.58,54121.45,264008.03
250650,202305,33,21,12,27720.04,15840.2,43560.24
250660,202305,65,48,17,63360,22440,85800
250670,202305,84,67,17,88441.25,22440.94,110882.19
250680,202305,442,355,87,469932.13,114840.79,584772.92
250690,202305,2351,1591,760,2100174.06,1003214.47,3103388.53
250700,202305,996,840,156,1108815.03,205920.2,1314735.23
250710,202305,520,403,117,531991.93,157086.17,689078.10
250720,202305,123,89,34,117480.93,44880,162360.93
250730,202305,435,358,77,472567.36,101641.92,574209.28
250740,202305,74,67,7,88441.74,9240,97681.74
250750,202305,26955,15779,11176,20839694.33,14764586.28,35604280.61
250760,202305,128,100,28,132000.5,36961.04,168961.54
250770,202305,387,258,129,340568.87,170280.7,510849.57
250780,202305,82,54,28,71280.77,36960,108240.77
250790,202305,477,295,182,389406.49,240242.99,629649.48
250800,202305,155,139,16,184800,21120,205920
250810,202305,74,61,13,80520,17160,97680
250820,202305,163,132,31,174242.05,40920,215162.05
250830,202305,516,333,183,440893.5,242882.73,683776.23
250840,202305,64,54,10,71281.67,13200.2,84481.87
250850,202305,76,62,14,81840.2,18480,100320.2
250855,202305,17,13,4,17160.2,5280,22440.2
250860,202305,248,159,89,211201.47,117480,328681.47
250870,202305,32,30,2,39600,2640,42240
250880,202305,100,76,24,100320.7,31680,132000.7
250890,202305,3451,2532,919,3342333.33,1215736.96,4558070.29
250900,202305,69,57,12,75240.7,15840,91080.7
250905,202305,130,95,35,125400.9,46200,171600.9
250910,202305,1018,745,273,984746.14,361685.49,1346431.63
250915,202305,122,85,37,112201.51,48841,161042.51
250920,202305,158,119,39,157080,51480.7,208560.7
250930,202305,204,118,86,155760,113521.1,269281.1
250933,202305,11,8,3,10560,3960.08,14520.08
250937,202305,21,19,2,25080,2640,27720
250939,202305,44,34,10,44880.79,13200,58080.79
250940,202305,141,103,38,135962.16,50160.72,186122.88
250950,202305,85,62,23,81842.36,30360,112202.36
250960,202305,89,52,37,68643.27,48840.3,117483.57
250970,202305,1372,973,399,1284385.12,526684.97,1811070.09
250980,202305,98,66,32,87120.51,42240,129360.51
250990,202305,176,136,40,179520.96,52800,232320.96
251000,202305,90,75,15,99000,19800,118800
251010,202305,148,104,44,137280.1,58080,195360.1
251020,202305,97,80,17,105600.37,22440,128040.37
251030,202305,52,37,15,48840.84,19800,68640.84
251040,202305,72,51,21,67320,27720,95040
251050,202305,30,25,5,33000,6600,39600
251060,202305,52,41,11,54120.92,14520.64,68641.56
251065,202305,6,3,3,3960,3960,7920
251070,202305,19,17,2,22441.53,2640,25081.53
251080,202305,5910,2740,3170,3619614.86,4187136.07,7806750.93
251090,202305,201,167,34,220442.06,44880,265322.06
251100,202305,24,22,2,29041.57,2640,31681.57
251110,202305,67,44,23,58080,30360,88440
251120,202305,2070,1289,781,1701563.11,1030940.33,2732503.44
251130,202305,467,384,83,506888.54,109560.05,616448.59
251140,202305,663,437,226,576845.06,300961.5,877806.56
251150,202305,357,299,58,394686.05,76560.94,471246.99
251160,202305,100,84,16,110880.99,22440,133320.99
251170,202305,84,70,14,92401.13,18480,110881.13
251180,202305,316,184,132,242885.57,174242.45,417128.02
251190,202305,113,84,29,110885.34,38280.47,149165.81
251200,202305,326,252,74,333970.18,97680.44,431650.62
251203,202305,34,30,4,39600.69,5280,44880.69
251207,202305,90,73,17,96360.69,22440,118800.69
251210,202305,1662,1206,456,1591948.1,603246.68,2195194.78
251220,202305,51,40,11,52800.71,14520,67320.71
251230,202305,614,514,100,678489.72,132000.92,810490.64
251240,202305,127,90,37,118800.5,48840,167640.5
251250,202305,1708,1228,480,1620897.17,633607,2254504.17
251260,202305,14,10,4,13200.25,5280.15,18480.40
251270,202305,340,266,74,351126.84,97680.69,448807.53
251272,202305,64,55,9,72600.2,11880,84480.2
251274,202305,22,16,6,21120.47,7920,29040.47
251275,202305,39,22,17,29041.07,22440,51481.07
251276,202305,29,23,6,30361.78,7920,38281.78
251278,202305,16,12,4,15841.3,5280,21121.3
251280,202305,120,115,5,151800.2,6600,158400.2
251290,202305,1224,861,363,1136596.01,479182.08,1615778.09
251300,202305,19,14,5,18480,6600,25080
251310,202305,330,236,94,311527.98,124081.48,435609.46
251315,202305,49,44,5,58080,6600,64680
251320,202305,77,63,14,83160.95,19800,102960.95
251330,202305,87,77,10,101640,13200,114840
251335,202305,23,15,8,19800,10560,30360
251340,202305,889,496,393,654737.03,521403.2,1176140.23
251350,202305,40,37,3,48840,3960,52800
251360,202305,92,78,14,102960.2,18480,121440.2
251365,202305,8,8,0,10563.18,,10563.18
251370,202305,6416,4359,2057,5756709.83,2717918.17,8474628.00
251380,202305,48,36,12,47520.25,15840,63360.25
251385,202305,4,4,0,5280,,5280.0
251390,202305,1084,792,292,1045469.27,385447.67,1430916.94
251392,202305,41,28,13,36960.5,17160,54120.5
251394,202305,18,13,5,17160.6,6600,23760.6
251396,202305,11,7,4,9240,5280.2,14520.2
251398,202305,21,17,4,22440.22,5280,27720.22
251400,202305,56,43,13,56760,17160,73920
251410,202305,48,39,9,51480.7,11880,63360.7
251420,202305,117,84,33,110882.14,43560,154442.14
251430,202305,53,45,8,59400.74,10560,69960.74
251440,202305,56,30,26,39600,34320,73920
251445,202305,67,58,9,76562.77,11880,88442.77
251450,202305,410,347,63,458052.06,83161.18,541213.24
251455,202305,6,5,1,6600,1320,7920
251460,202305,25,19,6,25080,7920.02,33000.02
251465,202305,13,8,5,10560,6600,17160
251470,202305,48,35,13,46200,17160,63360
251480,202305,26,22,4,29040.62,5280.22,34320.84
251490,202305,119,67,52,88442.94,68640.95,157083.89
251500,202305,109,89,20,117481.31,27720,145201.31
251510,202305,103,65,38,85800.67,50160.62,135961.29
251520,202305,42,34,8,44880,10560,55440
251530,202305,4507,3173,1334,4188435.1,1762211.39,5950646.49
251540,202305,101,82,19,108240.86,25081.12,133321.98
251550,202305,450,342,108,451457.07,142563.58,594020.65
251560,202305,25,19,6,25080.1,7920,33000.1
251570,202305,16,15,1,19800,1320,21120
251580,202305,131,102,29,134641.56,38280,172921.56
251590,202305,108,77,31,101640.2,40920.8,142561.0
251593,202305,31,17,14,22440.58,18480,40920.58
251597,202305,132,107,25,141240.8,33000,174240.8
251600,202305,1147,793,354,1046781.12,467282.72,1514063.84
251610,202305,276,200,76,265327.27,100320.2,365647.47
251615,202305,24,20,4,26400,5280,31680
251620,202305,4338,2748,1590,3628778.39,2100150.1,5728928.49
251630,202305,511,372,139,491061.19,183484.81,674546.00
251640,202305,108,79,29,104285.09,38280,142565.09
251650,202305,319,231,88,304924.83,116160.2,421085.03
251660,202305,211,187,24,246844.81,31680.3,278525.11
251670,202305,435,331,104,436928.33,137280.97,574209.30
251675,202305,14,10,4,13200,5280,18480
251680,202305,108,94,14,124080.99,18480,142560.99
251690,202305,331,272,59,359381.1,77880.2,437261.3
251700,202305,286,242,44,319443.93,58080,377523.93
251710,202305,22,15,7,19800.75,9240,29040.75
251720,202305,36,26,10,34320,13200,47520
251740,202305,13,10,3,13200.3,3960,17160.3
260005,202305,4025,2077,1948,2741189.34,2572734.36,5313923.70
260010,202305,1891,1410,481,1862554.05,637565.16,2500119.21
260020,202305,442,386,56,509528.29,73920.9,583449.19
260030,202305,661,447,214,590053.39,282482,872535.39
260040,202305,804,513,291,677181.17,385443.77,1062624.94
260050,202305,1194,869,325,1147105.55,430322.57,1577428.12
260060,202305,375,344,31,454093.96,40920,495013.96
260070,202305,1393,848,545,1119417.79,722065.67,1841483.46
260080,202305,788,584,204,770897.99,269280,1040177.99
260090,202305,483,317,166,418443.41,219120.6,637564.01
260100,202305,227,151,76,199322.27,100320,299642.27
260105,202305,298,176,122,232322.05,161040.1,393362.15
260110,202305,3206,2313,893,3054538.97,1178770.09,4233309.06
260120,202305,2905,1550,1355,2046411.07,1791265.1,3837676.17
260130,202305,220,157,63,207243.87,83160,290403.87
260140,202305,2402,1540,862,2032849.93,1139174.27,3172024.20
260150,202305,202,131,71,172921.23,93721.4,266642.63
260160,202305,372,293,79,386773.51,104282.63,491056.14
260170,202305,3645,2178,1467,2875044.23,1940429.53,4815473.76
260180,202305,185,157,28,207245.34,36960.85,244206.19
260190,202305,2662,1722,940,2278365.55,1243445.67,3521811.22
260200,202305,1063,827,236,1091663.53,311520.98,1403184.51
260210,202305,1452,1047,405,1382079.58,535925.13,1918004.71
260220,202305,647,575,72,760336.76,95041.67,855378.43
260230,202305,1402,1023,379,1350404.71,500289.72,1850694.43
260240,202305,225,170,55,224405.63,72602.23,297007.86
260250,202305,107,83,24,110880.75,31680,142560.75
260260,202305,1171,808,363,1066574.39,479162.98,1545737.37
260270,202305,264,188,76,248164.53,100320,348484.53
260280,202305,1218,961,257,1268546.61,339245.45,1607792.06
260290,202305,7635,4085,3550,5396321.8,4691318.84,10087640.64
260300,202305,1115,939,176,1239532.55,233643.52,1473176.07
260310,202305,554,438,116,580809,153120.1,733929.1
260320,202305,850,614,236,811803.12,311520.4,1123323.52
260330,202305,94,72,22,95040.3,29040.3,124080.6
260340,202305,88,65,23,85800.65,30360,116160.65
260345,202305,6419,3256,3163,4302044.03,4189739.34,8491783.37
260350,202305,510,363,147,479174.3,194040.58,673214.88
260360,202305,262,154,108,203280.5,142560.4,345840.9
260370,202305,752,488,264,644173.41,349802.12,993975.53
260380,202305,567,407,160,537251.1,211202.18,748453.28
260390,202305,295,250,45,330006,59400,389406
260392,202305,132,111,21,146523.36,27721.16,174244.52
260400,202305,4802,2737,2065,3612913.42,2729779.13,6342692.55
260410,202305,16543,8514,8029,11242775.22,10608928.89,21851704.11
260415,202305,165,134,31,178200.96,40920,219120.96
260420,202305,1900,1199,701,1582713.52,926643.31,2509356.83
260430,202305,176,157,19,207246.26,26400.7,233646.96
260440,202305,220,146,74,192725.86,97680.63,290406.49
260450,202305,454,343,111,452772.63,146520.4,599293.03
260460,202305,916,482,434,636256.5,574206.57,1210463.07
260470,202305,343,211,132,278525.98,174241.65,452767.63
260480,202305,275,170,105,224400.19,138600,363000.19
260490,202305,240,181,59,238921.2,77880,316801.2
260500,202305,1231,815,416,1075824.7,549125.75,1624950.45
260510,202305,883,707,176,933258.96,233641.07,1166900.03
260515,202305,258,237,21,312841.96,27720.91,340562.87
260520,202305,3404,2082,1322,2749562.39,1746382.94,4495945.33
260530,202305,914,725,189,957037.24,249480.9,1206518.14
260540,202305,580,452,128,596652.1,170281.36,766933.46
260545,202305,35,18,17,23760.63,22440.22,46200.85
260550,202305,367,236,131,311522.63,172920.95,484443.58
260560,202305,517,397,120,524054.28,158402.36,682456.64
260570,202305,1085,869,216,1147120.67,286442.12,1433562.79
260580,202305,369,291,78,384122.42,102960,487082.42
260590,202305,642,375,267,496322.46,352440.4,848762.86
260600,202305,8400,4897,3503,6469475.95,4625322.32,11094798.27
260610,202305,529,361,168,476532.6,223082.31,699614.91
260620,202305,4095,2136,1959,2820942.03,2586060.51,5407002.54
260630,202305,86,75,11,99000.49,14520,113520.49
260640,202305,3577,2166,1411,2859183.05,1862536.99,4721720.04
260650,202305,333,244,89,322086.14,117480.4,439566.54
260660,202305,646,428,218,564979.86,287764.49,852744.35
260670,202305,119,83,36,109560,47520.12,157080.12
260680,202305,4440,2371,2069,3135131.56,2735086.66,5870218.22
260690,202305,137,105,32,138600.74,42240,180840.74
260700,202305,337,234,103,308887.83,135960.69,444848.52
260710,202305,55,45,10,59400,13200,72600
260720,202305,2909,1690,1219,2230839.21,1609086.61,3839925.82
260730,202305,818,600,218,792010.3,287761.17,1079771.47
260740,202305,78,66,12,87120.9,15840,102960.9
260750,202305,577,430,147,567611.36,194040.82,761652.18
260760,202305,823,405,418,534622.5,553090.79,1087713.29
260765,202305,1094,573,521,756375.65,687729.87,1444105.52
260770,202305,239,169,70,223062.28,92401.28,315463.56
260775,202305,933,469,464,620420.8,612489.29,1232910.09
260780,202305,244,146,98,192721.71,129360.54,322082.25
260790,202305,17458,8363,9095,11047483.48,12018721.03,23066204.51
260795,202305,163,104,59,137280.62,79200,216480.62
260800,202305,318,261,57,344523.98,76560.46,421084.44
260805,202305,44,30,14,39602.46,18480.43,58082.89
260810,202305,909,720,189,950408.98,249480.68,1199889.66
260820,202305,330,219,111,289083.15,147840,436923.15
260825,202305,223,153,70,201961.02,92400,294361.02
260830,202305,313,204,109,269280,143880,413160
260840,202305,292,209,83,275883.78,109560.06,385443.84
260845,202305,218,130,88,171602.37,116161.83,287764.20
260850,202305,443,332,111,438246.11,146520,584766.11
260860,202305,250,189,61,249482.65,80520,330002.65
260870,202305,355,280,75,369605.88,99000,468605.88
260875,202305,792,571,221,753762.66,293040.98,1046803.64
260880,202305,1736,1148,588,1515387.51,776161.84,2291549.35
260890,202305,2711,1848,863,2439412.65,1139169.3,3578581.95
260900,202305,1096,815,281,1075815.52,370921.46,1446736.98
260910,202305,263,210,53,277204.85,69960.6,347165.45
260915,202305,293,219,74,289080.7,97680,386760.7
260920,202305,243,137,106,180840.2,139920,320760.2
260930,202305,369,315,54,415811.01,71280.86,487091.87
260940,202305,2733,1455,1278,1923316.94,1689621.03,3612937.97
260950,202305,2124,1201,923,1585370.46,1219700.94,2805071.40
260960,202305,15274,7268,8006,9598245.92,10578707.64,20176953.56
260970,202305,468,374,94,493686.14,124080,617766.14
260980,202305,223,204,19,269284.27,25080.1,294364.37
260990,202305,2875,2272,603,2999125.51,798606.72,3797732.23
261000,202305,4470,2768,1702,3653825.07,2246657.99,5900483.06
261010,202305,138,103,35,135961.26,46200,182161.26
261020,202305,633,460,173,607211.25,228360.1,835571.35
261030,202305,268,200,68,264003.16,89760,353763.16
261040,202305,397,331,66,436928.55,87120,524048.55
261050,202305,580,470,110,620412.09,145202,765614.09
261060,202305,1749,1092,657,1441457.12,868563.5,2310020.62
261070,202305,10794,5048,5746,6672988.8,7603425.84,14276414.64
261080,202305,378,294,84,388086.77,112200,500286.77
261090,202305,2196,1685,511,2224288.32,674525.37,2898813.69
261100,202305,1310,898,412,1185391.82,545166.64,1730558.46
261110,202305,10234,6393,3841,8443122.63,5071534.09,13514656.72
261120,202305,233,197,36,260041.33,47520,307561.33
261130,202305,591,349,242,460693.66,319447.99,780141.65
261140,202305,229,145,84,191400.75,110880,302280.75
261150,202305,683,445,238,587404.02,314160.27,901564.29
261153,202305,78,72,6,95040.7,7920,102960.7
261160,202305,83327,40330,42997,53284762.52,56813875.71,110098638.23
261170,202305,524,390,134,514802.03,176880.83,691682.86
261180,202305,1897,1193,704,1575098.82,930609.78,2505708.60
261190,202305,626,423,203,558368.7,267962.76,826331.46
261200,202305,228,178,50,234965.8,66000.36,300966.16
261210,202305,49,35,14,46200.1,18480,64680.1
261220,202305,3054,2116,938,2793200.02,1239498.94,4032698.96
261230,202305,394,290,104,382807.44,137280.97,520088.41
261240,202305,443,379,64,500292.86,84480.97,584773.83
261245,202305,272,232,40,306240.8,52800,359040.8
261247,202305,184,140,44,186123.07,58080,244203.07
261250,202305,4207,2015,2192,2662489.39,2893461.29,5555950.68
261255,202305,263,233,30,307560.52,40920,348480.52
261260,202305,897,767,130,1012499.73,171603.85,1184103.58
261270,202305,211,147,64,194040.83,84480,278520.83
261280,202305,205,166,39,219123.46,51480.15,270603.61
261290,202305,114,81,33,106920.24,43560.2,150480.44
261300,202305,1520,1136,384,1499557.03,508205.98,2007763.01
261310,202305,877,578,299,762977.35,394682.06,1157659.41
261320,202305,532,368,164,485772.52,216482.42,702254.94
261330,202305,930,736,194,971567.49,256090.76,1227658.25
261340,202305,357,197,160,260042.82,211202.78,471245.60
261350,202305,994,685,309,904231.92,407890.71,1312122.63
261360,202305,1476,922,554,1219688.76,731286.61,1950975.37
261370,202305,5397,3131,2266,4133030.26,2991164.73,7124194.99
261380,202305,612,483,129,637567.53,170280,807847.53
261390,202305,4096,2790,1306,3682939.11,1723958.24,5406897.35
261400,202305,291,257,34,339245.89,44880.74,384126.63
261410,202305,1199,780,419,1030949.16,553084.66,1584033.82
261420,202305,1032,624,408,823695.51,538563.62,1362259.13
261430,202305,338,303,35,399965.12,46200,446165.12
261440,202305,107,101,6,133322.69,7920,141242.69
261450,202305,2744,2106,638,2781290.32,843486.09,3624776.41
261460,202305,847,648,199,855385.6,262682.57,1118068.17
261470,202305,244,194,50,256081.13,66000.42,322081.55
261480,202305,505,376,129,496332.11,170222.27,666554.38
261485,202305,423,249,174,328689.78,229680.8,558370.58
261500,202305,682,437,245,576850.33,323401.9,900252.23
261510,202305,54,36,18,47520.98,23760.1,71281.08
261520,202305,108,93,15,122762.97,19800.2,142563.17
261530,202305,4612,2976,1636,3931033.97,2162177.96,6093211.93
261540,202305,1647,945,702,1247428.53,927969.23,2175397.76
261550,202305,277,129,148,170281.02,195360,365641.02
261560,202305,1039,682,357,904223.38,472565.09,1376788.47
261570,202305,422,341,81,450128.51,106920.95,557049.46
261580,202305,416,329,87,434286.58,114840.61,549127.19
261590,202305,211,164,47,217806.96,62041.27,279848.23
261600,202305,341,263,78,347167.36,104280.24,451447.60
261610,202305,101,82,19,108241.46,25080,133321.46
261618,202305,86,62,24,81840.65,31680,113520.65
261620,202305,217,139,78,183482.87,102961.28,286444.15
261630,202305,714,553,161,729967.01,213843.19,943810.20
261640,202305,7330,3860,3470,5098000.63,4581795.97,9679796.60
261650,202305,458,291,167,384122.15,220440.3,604562.45
270010,202305,526,465,61,613817.63,80520.64,694338.27
270020,202305,260,214,46,283101.27,60720.47,343821.74
270030,202305,9682,6199,3483,8188187.57,4604157.97,12792345.54
270040,202305,2157,1437,720,1898204.79,950407.08,2848611.87
270050,202305,251,193,58,254764.33,76560.6,331324.93
270060,202305,68,47,21,62045.77,27720.33,89766.10
270070,202305,805,596,209,786730.28,275881.1,1062611.38
270080,202305,58,45,13,59400.1,17160,76560.1
270090,202305,23,17,6,22440,7920,30360
270100,202305,1365,928,437,1227631.28,576842.16,1804473.44
270110,202305,60,49,11,64680,14520,79200
270120,202305,273,222,51,293049.89,67320.74,360370.63
270130,202305,335,257,78,339244.71,104280,443524.71
270135,202305,123,88,35,116161,46200,162361
270140,202305,1467,982,485,1296282.01,640211.04,1936493.05
270150,202305,266,191,75,252124.26,99000.83,351125.09
270160,202305,488,389,99,513524.57,130683.36,644207.93
270170,202305,833,557,276,735246.92,365641.67,1100888.59
270180,202305,63,49,14,64680.7,18480.1,83160.8
270190,202305,116,101,15,133324.09,19800,153124.09
270200,202305,124,107,17,141240.02,22440,163680.02
270210,202305,566,357,209,471244.22,275881.3,747125.52
270220,202305,201,142,59,187440.69,77881,265321.69
270230,202305,2297,1473,824,1944398.46,1089003.2,3033401.66
270235,202305,504,397,107,524063.78,141240,665303.78
270240,202305,3423,2705,718,3573829.97,947764.15,4521594.12
270250,202305,125,97,28,128043.33,36960,165003.33
270255,202305,216,181,35,238922.68,46200.44,285123.12
270260,202305,426,336,90,443534.03,118800.7,562334.73
270270,202305,96,51,45,67320.18,59400,126720.18
270280,202305,199,128,71,168960,93720,262680
270290,202305,1165,917,248,1210461.32,328684.51,1539145.83
270300,202305,386,284,102,374880.79,134640.2,509520.99
270310,202305,837,702,135,926663.34,178200.76,1104864.10
270320,202305,776,672,104,887054.89,137280,1024334.89
270330,202305,330,284,46,374880.62,60720,435600.62
270340,202305,70,57,13,75240,17160,92400
270350,202305,84,50,34,66003.45,44880,110883.45
270360,202305,87,49,38,64680,50160,114840
270370,202305,70,55,15,72600,19800,92400
270375,202305,87,55,32,72600.61,42240,114840.61
270380,202305,1070,741,329,979440.22,434280.67,1413720.89
270390,202305,132,79,53,104280.2,69960.5,174240.7
270400,202305,798,618,180,817094.82,238920.92,1056015.74
270410,202305,218,165,53,217807.18,69960.87,287768.05
270420,202305,424,298,126,393364.08,166320.3,559684.38
270430,202305,36834,26118,10716,34519314.02,14162619.19,48681933.21
270440,202305,465,368,97,485773.09,128041.5,613814.59
270450,202305,922,553,369,729966.17,487081.41,1217047.58
270460,202305,183,144,39,190085.45,51480,241565.45
270470,202305,1763,1233,530,1628913.1,700923.57,2329836.67
270480,202305,573,463,110,611172.22,145200,756372.22
270490,202305,24,19,5,25080,6600,31680
270500,202305,477,394,83,520086.56,109560,629646.56
270510,202305,931,629,302,834190.89,399962.13,1234153.02
270520,202305,276,186,90,245522.29,118800,364322.29
270530,202305,65,53,12,69960.83,15840,85800.83
270540,202305,84,60,24,79200,31680,110880
270550,202305,1663,1282,381,1693597.68,504241.33,2197839.01
270560,202305,257,158,99,208563.71,130680,339243.71
270570,202305,611,437,174,576844.95,229680,806524.95
270580,202305,21,16,5,21120,6600,27720
270590,202305,58,47,11,62040.3,14520.08,76560.38
270600,202305,170,142,28,188766.17,36960.1,225726.27
270610,202305,251,199,52,262684.1,68640.1,331324.2
270620,202305,17,17,0,22440,,22440.0
270630,202305,3723,2785,938,3677685.11,1239490.66,4917175.77
270640,202305,914,677,237,893655.36,312842.25,1206497.61
270642,202305,217,179,38,236282.53,50160,286442.53
270644,202305,261,167,94,220443.62,124082.69,344526.31
270650,202305,354,220,134,290405.12,176882.25,467287.37
270660,202305,197,173,24,228371.69,31680.15,260051.84
270670,202305,3072,2348,724,3100749.86,955682.06,4056431.92
270680,202305,405,269,136,355088.02,180840,535928.02
270690,202305,1278,866,412,1143153.56,543843.7,1686997.26
270700,202305,25,19,6,25080.19,7920,33000.19
270710,202305,565,448,117,591366.93,154440,745806.93
270720,202305,229,184,45,242884.12,59400.95,302285.07
270730,202305,1978,1256,722,1661910.27,953045.55,2614955.82
270740,202305,34,23,11,30360.7,14520,44880.7
270750,202305,622,481,141,634930.25,186121.09,821051.34
270760,202305,292,212,80,281169.07,105600.76,386769.83
270770,202305,2971,2058,913,2717960.27,1206490.39,3924450.66
270780,202305,69,42,27,55440,35640.8,91080.8
270790,202305,195,124,71,163682.88,93721.32,257404.20
270800,202305,2080,1678,402,2215000.31,530640,2745640.31
270810,202305,209,170,39,224401.48,51480,275881.48
270820,202305,120,82,38,108244.94,50160,158404.94
270830,202305,877,676,201,892347.41,265321.29,1157668.70
270840,202305,1337,1043,294,1376779.96,389401.7,1766181.66
270850,202305,1577,1039,538,1372814.47,710163.36,2082977.83
270860,202305,2691,1835,856,2424883.97,1129931.29,3554815.26
270870,202305,132,79,53,104280.92,69960.2,174241.12
270880,202305,862,684,178,902908.95,236282.49,1139191.44
270890,202305,256,200,56,264001.54,73921.17,337922.71
270895,202305,79,74,5,97680,6600,104280
270900,202305,67,56,11,73922.4,14520,88442.4
270910,202305,309,261,48,344529.39,63361.54,407890.93
270915,202305,2005,1357,648,1792598.57,855363.6,2647962.17
270920,202305,390,324,66,429004.12,87120,516124.12
270930,202305,5594,4338,1256,5726286.93,1660566.77,7386853.70
270940,202305,2252,1808,444,2386604.88,586082.48,2972687.36
280010,202305,33,27,6,35640.2,7920,43560.2
280020,202305,527,443,84,584774.8,110880.97,695655.77
280030,202305,23320,14947,8373,19740383.78,11057949.54,30798333.32
280040,202305,346,213,133,281162.96,175560.4,456723.36
280050,202305,457,350,107,462008.95,141240,603248.95
280060,202305,428,281,147,370931,194040.99,564971.99
280067,202305,1198,869,329,1147099.55,434281.06,1581380.61
280070,202305,127,109,18,143882.23,23760,167642.23
280100,202305,712,548,164,724691.07,217801.19,942492.26
280110,202305,90,79,11,104282.04,14520,118802.04
280120,202305,723,602,121,794652.68,159721.31,954373.99
280130,202305,1885,1231,654,1626259.92,863281.53,2489541.45
280140,202305,542,448,94,591366.39,124080.2,715446.59
280150,202305,447,323,124,427692.53,163680,591372.53
280160,202305,152,114,38,150482.62,50160,200642.62
280170,202305,441,314,127,414493.29,167640.72,582134.01
280190,202305,33,25,8,33000,10560,43560
280200,202305,52,40,12,52806.36,15840.3,68646.66
280210,202305,3186,2278,908,3008259.44,1198568.59,4206828.03
280220,202305,64,53,11,69962.1,14520,84482.1
280230,202305,343,276,67,364333.74,88442.66,452776.40
280240,202305,140,130,10,171603.99,13200,184803.99
280250,202305,21,10,11,13200.1,14521.37,27721.47
280260,202305,79,70,9,92403.44,11880,104283.44
280270,202305,142,111,31,146520.58,40920.53,187441.11
280280,202305,193,131,62,172923.19,81840.09,254763.28
280290,202305,4075,2961,1114,3912554.83,1471816.76,5384371.59
280300,202305,1771,1416,355,1869148.46,469924.19,2339072.65
280310,202305,109,99,10,130682.73,13200,143882.73
280320,202305,722,499,223,658702.08,294362.41,953064.49
280330,202305,334,244,90,322086.79,118800.2,440886.99
280340,202305,447,372,75,491048.88,99001.1,590049.98
280350,202305,3995,3051,944,4027504.03,1246095.88,5273599.91
280360,202305,492,335,157,442215.8,208560.78,650776.58
280370,202305,95,80,15,105601.09,19800,125401.09
280380,202305,51,40,11,52800,14520,67320
280390,202305,179,151,28,199322.55,36960,236282.55
280400,202305,441,288,153,380175.07,201963.01,582138.08
280410,202305,308,259,49,341888.76,64680,406568.76
280420,202305,148,127,21,167652.63,27720.96,195373.59
280430,202305,107,87,20,114841.93,26400,141241.93
280440,202305,739,608,131,805220.74,172923.11,978143.85
280445,202305,122,112,10,147842.82,13200.8,161043.62
280450,202305,1399,1195,204,1578754.4,269283.75,1848038.15
280460,202305,718,536,182,707535.79,240241.57,947777.36
280470,202305,103,97,6,128043.19,7920,135963.19
280480,202305,3424,2294,1130,3029621.55,1494284.65,4523906.20
280490,202305,212,201,11,265333.48,14520,279853.48
280500,202305,39,36,3,47521.05,5281.18,52802.23
280510,202305,143,111,32,146520.99,42240.84,188761.83
280520,202305,55,39,16,51481.29,21120,72601.29
280530,202305,75,48,27,63363.54,35640.38,99003.92
280540,202305,586,506,80,667931,105600,773531
280550,202305,779,716,63,945138.6,83160,1028298.6
280560,202305,501,453,48,597970.13,63360.78,661330.91
280570,202305,2530,2000,530,2641368.36,699606.03,3340974.39
280580,202305,620,487,133,642847.12,175560.96,818408.08
280590,202305,233,152,81,200657.49,106927.94,307585.43
280600,202305,431,350,81,462067.84,106920.2,568988.04
280610,202305,120,84,36,110886.12,47521.91,158408.03
280620,202305,571,464,107,612487.84,142560,755047.84
280630,202305,155,124,31,163683.51,40920.9,204604.41
280640,202305,176,142,34,187440.4,44880,232320.4
280650,202305,87,55,32,72601.65,42240.07,114841.72
280660,202305,123,93,30,122766.07,39600.21,162366.28
280670,202305,2152,1378,774,1823052.59,1021707.16,2844759.75
280680,202305,255,215,40,285122.41,52800,337922.41
280690,202305,79,68,11,89760,14520,104280
280700,202305,23,23,0,30360,,30360.0
280710,202305,1613,1244,369,1642113.02,487083.12,2129196.14
280720,202305,141,100,41,132001.99,54120,186121.99
280730,202305,32,28,4,36961.7,5280.05,42241.75
280740,202305,2704,2043,661,2696798.48,872523.8,3569322.28
280750,202305,234,206,28,271929.43,36960.7,308890.13
280760,202305,1004,670,334,884425.83,440882.03,1325307.86
290010,202305,201,141,60,186120.96,79200,265320.96
290020,202305,203,178,25,234962.06,33000.9,267962.96
290030,202305,641,413,228,545167.88,300961.15,846129.03
290035,202305,139,112,27,147841.31,35640.93,183482.24
290040,202305,273,193,80,254765.99,105600,360365.99
290050,202305,94,76,18,100320,23760,124080
290060,202305,249,109,140,143881.24,184800,328681.24
290070,202305,6443,3051,3392,4032732.49,4482776.2,8515508.69
290080,202305,497,221,276,291723.41,364320.09,656043.50
290090,202305,330,153,177,201960.2,233640.91,435601.11
290100,202305,1812,1152,660,1520672.75,871204.65,2391877.40
290110,202305,930,521,409,689067.28,539888.12,1228955.40
290115,202305,184,169,15,224404.22,19800,244204.22
290120,202305,863,585,278,772211.26,368281.37,1140492.63
290130,202305,492,298,194,393363.58,256080.53,649444.11
290135,202305,298,227,71,299645.55,93720.1,393365.65
290140,202305,334,280,54,369606.57,71280.36,440886.93
290150,202305,150,102,48,135960,63360.01,199320.01
290160,202305,248,192,56,253447.61,73921.08,327368.69
290170,202305,110,80,30,105602.08,39600,145202.08
290180,202305,208,148,60,195362.23,79200.47,274562.70
290190,202305,369,288,81,380172.99,106922.08,487095.07
290195,202305,311,214,97,282484.74,128040.1,410524.84
290200,202305,266,210,56,277200.37,73920.1,351120.47
290205,202305,164,101,63,133320.4,83160,216480.4
290210,202305,1329,969,360,1279114.42,475203.75,1754318.17
290220,202305,178,107,71,141247.54,93721.1,234968.64
290225,202305,298,118,180,155763.44,237601.51,393364.95
290230,202305,101,60,41,79202,54120,133322
290240,202305,386,132,254,174241.5,336601.22,510842.72
290250,202305,247,227,20,299647.3,26400,326047.3
290260,202305,360,283,77,373577.15,102964.59,476541.74
290265,202305,194,169,25,223084.63,33000.13,256084.76
290270,202305,1439,1186,253,1565579.88,333961.09,1899540.97
290280,202305,522,361,161,476525.99,212521.27,689047.26
290290,202305,1545,944,601,1246103.36,793321.49,2039424.85
290300,202305,393,334,59,440889.57,77881.02,518770.59
290310,202305,287,139,148,183480.86,195360,378840.86
290320,202305,4587,2724,1863,3595832.82,2461822.72,6057655.54
290323,202305,215,185,30,244207.27,39600.2,283807.47
290327,202305,173,135,38,178206.01,50160.13,228366.14
290330,202305,135,62,73,81840.48,96360,178200.48
290340,202305,814,343,471,452775.41,621723.77,1074499.18
290350,202305,705,423,282,559686.66,373562.96,933249.62
290360,202305,326,258,68,340568.07,89760.39,430328.46
290370,202305,897,414,483,546481.28,637561.61,1184042.89
290380,202305,356,228,128,300963.54,168960.96,469924.50
290390,202305,2571,1598,973,2109417.88,1285689.39,3395107.27
290395,202305,241,145,96,191400.86,126720,318120.86
290400,202305,306,223,83,294361.39,109560,403921.39
290405,202305,247,212,35,279842.34,46200,326042.34
290410,202305,688,570,118,752405.87,155760,908165.87
290420,202305,289,235,54,310202.53,71280,381482.53
290430,202305,524,333,191,439563.12,252120,691683.12
290440,202305,92,74,18,97680.4,23760,121440.4
290450,202305,205,146,59,192720.19,77880,270600.19
290460,202305,2090,1236,854,1634195.06,1128600.48,2762795.54
290470,202305,1409,629,780,830302.48,1029608.32,1859910.80
290475,202305,586,546,40,720733.8,52800,773533.8
290480,202305,190,111,79,146521.55,105600,252121.55
290485,202305,242,218,24,287763.21,31680,319443.21
290490,202305,1355,953,402,1259303.48,530643.78,1789947.26
290500,202305,850,460,390,607211.97,516123.72,1123335.69
290510,202305,188,153,35,201973.26,46200.35,248173.61
290515,202305,201,127,74,167641.27,97680,265321.27
290520,202305,1496,986,510,1301530.62,674521.08,1976051.70
290530,202305,279,246,33,324732.35,43560.93,368293.28
290540,202305,144,69,75,91080.66,99000,190080.66
290550,202305,178,147,31,194042.3,40920,234962.3
290560,202305,3319,1519,1800,2005129.35,2379975.62,4385104.97
290570,202305,7542,3541,4001,4679601.59,5289330.62,9968932.21
290580,202305,1351,814,537,1075817.56,708840.69,1784658.25
290590,202305,598,479,119,632316.9,157084,789400.9
290600,202305,1894,1289,605,1701545.81,798611.04,2500156.85
290610,202305,189,174,15,229693.91,19800,249493.91
290620,202305,399,351,48,463329.08,63360.6,526689.68
290630,202305,2083,883,1200,1168228.52,1586647.5,2754876.02
290640,202305,139,108,31,142563.95,40920.05,183484.00
290650,202305,2209,1032,1177,1362283.44,1554972.41,2917255.85
290660,202305,277,228,49,300961.14,64680.72,365641.86
290670,202305,1137,568,569,751096.67,751088.83,1502185.50
290680,202305,1335,1068,267,1409785.12,352444.31,1762229.43
290682,202305,367,271,96,357722.31,126720,484442.31
290685,202305,268,160,108,211204.65,142560.2,353764.85
290687,202305,1283,844,439,1114321.29,582121.46,1696442.75
290689,202305,147,73,74,96360,97680.87,194040.87
290690,202305,577,267,310,352447.33,409202.38,761649.71
290700,202305,268,137,131,180847.58,172923.04,353770.62
290710,202305,838,582,256,769575,337924.4,1107499.4
290720,202305,1166,921,245,1215764.07,324721.43,1540485.50
290730,202305,1313,779,534,1028302.71,704884.58,1733187.29
290740,202305,30,26,4,34320,5280,39600
290750,202305,1578,690,888,910828.16,1172176.95,2083005.11
290755,202305,85,71,14,93720,18480,112200
290760,202305,273,234,39,308893.77,51481,360374.77
290770,202305,195,186,9,245525.29,11880,257405.29
290780,202305,1188,955,233,1261946.53,307565.14,1569511.67
290790,202305,430,294,136,388086.45,179524.53,567610.98
290800,202305,2512,1026,1486,1354347.57,1961531.89,3315879.46
290810,202305,510,349,161,460687.42,212521.01,673208.43
290820,202305,432,246,186,324727.17,245524.33,570251.50
290830,202305,508,358,150,472565.37,198000.32,670565.69
290840,202305,1963,1236,727,1631567.92,960965.16,2592533.08
290850,202305,1118,574,544,757692.93,718085.64,1475778.57
290860,202305,730,359,371,473887.09,489722.22,963609.31
290870,202305,661,455,206,600609.71,273240.8,873850.51
290880,202305,126,66,60,87120.62,80520,167640.62
290890,202305,532,322,210,425045.27,277202.8,702248.07
290900,202305,167,128,39,168960.94,51480,220440.94
290910,202305,419,319,100,421081.27,133496,554577.27
290920,202305,218,195,23,257403.27,30360,287763.27
290930,202305,570,433,137,571575.61,180842.1,752417.71
290940,202305,221,189,32,249481,42240,291721
290950,202305,164,95,69,125400.81,91080,216480.81
290960,202305,524,377,147,497645.45,195360.25,693005.70
290970,202305,244,214,30,282481.41,39600.2,322081.61
290980,202305,2074,1459,615,1925926.89,811810.23,2737737.12
290990,202305,443,371,72,489744.28,95043.33,584787.61
291000,202305,951,317,634,418443.23,836880,1255323.23
291005,202305,2854,1213,1641,1602550.93,2167469.84,3770020.77
291010,202305,130,115,15,151801.34,19800,171601.34
291020,202305,88,71,17,93720,22440,116160
291030,202305,114,83,31,109561.28,40920,150481.28
291040,202305,662,393,269,518761.8,355080.78,873842.58
291050,202305,1626,846,780,1116743.44,1033569.46,2150312.90
291060,202305,1784,988,796,1305504.16,1050728.8,2356232.96
291070,202305,2084,1565,519,2065844.13,686408.91,2752253.04
291072,202305,7680,2965,4715,3917939.57,6242328.26,10160267.83
291075,202305,262,217,45,286440.6,59400,345840.6
291077,202305,62,43,19,56760,25080,81840
291080,202305,23034,9865,13169,13031532.49,17408407.84,30439940.33
291085,202305,294,240,54,316805.58,71280.65,388086.23
291090,202305,254,102,152,134641.4,200640,335281.4
291100,202305,970,337,633,444840.35,836880,1281720.35
291110,202305,466,355,111,468608.01,146520.6,615128.61
291120,202305,2532,1370,1162,1808428.85,1535167.71,3343596.56
291125,202305,71,36,35,47520,46200,93720
291130,202305,185,157,28,207244.58,36960,244204.58
291140,202305,137,111,26,146520.81,34320.1,180840.91
291150,202305,367,136,231,179520.91,304920,484440.91
291160,202305,412,328,84,432975.92,110881.57,543857.49
291165,202305,52,39,13,51480,17160.62,68640.62
291170,202305,3622,1805,1817,2382650.29,2403728.39,4786378.68
291180,202305,1281,556,725,733930.31,957002.21,1690932.52
291185,202305,118,110,8,145202.01,10560,155762.01
291190,202305,1434,696,738,918739.45,975490.57,1894230.02
291200,202305,182,134,48,176881.1,64680,241561.1
291210,202305,2552,1057,1495,1395268.5,1976050.48,3371318.98
291220,202305,336,258,78,340562.06,102960.2,443522.26
291230,202305,962,360,602,475208.81,794643.01,1269851.82
291240,202305,403,371,32,489723.57,42240,531963.57
291250,202305,413,338,75,446160.69,99000,545160.69
291260,202305,67,56,11,75240.1,14520,89760.1
291270,202305,1041,470,571,621760.55,753740.92,1375501.47
291280,202305,366,175,191,231003.07,252120.3,483123.37
291290,202305,1682,893,789,1178808.37,1041496.36,2220304.73
291300,202305,258,190,68,250803.11,89760,340563.11
291310,202305,231,199,32,264005.78,42240.7,306246.48
291320,202305,1325,925,400,1221040.77,529321.82,1750362.59
291330,202305,140,118,22,155761.95,29040.2,184802.15
291340,202305,249,155,94,204605.88,124081.67,328687.55
291345,202305,123,90,33,118800.4,43560,162360.4
291350,202305,1885,733,1152,967563.67,1520640.2,2488203.87
291360,202305,9205,4378,4827,5780556.11,6379689.23,12160245.34
291370,202305,1225,741,484,978164.83,638890.02,1617054.85
291380,202305,278,213,65,281160.71,85800,366960.71
291390,202305,4328,1925,2403,2543691.55,3177255.54,5720947.09
291400,202305,2196,1523,673,2011738.58,889693.67,2901432.25
291410,202305,242,198,44,261363.47,58080,319443.47
291420,202305,127,97,30,128040,39600,167640
291430,202305,190,118,72,155760.2,95040,250800.2
291440,202305,563,457,106,603256.08,139920.2,743176.28
291450,202305,1062,708,354,934586.27,467285.41,1401871.68
291460,202305,2199,1703,496,2249360.6,654734.34,2904094.94
291465,202305,2428,1176,1252,1552351.28,1652646.55,3204997.83
291470,202305,3067,1545,1522,2040766.79,2010377.47,4051144.26
291480,202305,12905,5614,7291,7418681.21,9640028.06,17058709.27
291490,202305,733,296,437,392043.49,578160.2,970203.69
291500,202305,377,227,150,300667.11,198000.47,498667.58
291510,202305,1177,472,705,623044.31,931920.49,1554964.80
291520,202305,940,436,504,575534.52,669241.35,1244775.87
291530,202305,937,284,653,374881.89,863280.7,1238162.59
291535,202305,141,115,26,151800.19,34320.91,186121.10
291540,202305,346,118,228,155763.03,300960.74,456723.77
291550,202305,1311,630,681,831611,900241.97,1731852.97
291560,202305,5321,2709,2612,3577256.67,3455770.85,7033027.52
291570,202305,248,131,117,172921.39,154442.25,327363.64
291580,202305,1269,805,464,1063941.3,612482.75,1676424.05
291590,202305,121,60,61,79200.93,80520,159720.93
291600,202305,1193,607,586,801256.24,773523.43,1574779.67
291610,202305,1527,742,785,979499.12,1038866.84,2018365.96
291620,202305,581,277,304,365652.77,401282.89,766935.66
291630,202305,478,150,328,198001.1,434280.2,632281.3
291640,202305,4315,2090,2225,2758870.52,2939666.5,5698537.02
291650,202305,477,336,141,443539.14,186122.09,629661.23
291660,202305,369,154,215,203282.44,285121.85,488404.29
291670,202305,167,105,62,138603.26,83160.75,221764.01
291680,202305,640,395,245,521432.77,323404.13,844836.90
291685,202305,649,373,276,492372.45,364322.88,856695.33
291690,202305,521,343,178,452764.08,234960.55,687724.63
291700,202305,1099,846,253,1116745.54,333962.74,1450708.28
291710,202305,1645,801,844,1057340.65,1114085.61,2171426.26
291720,202305,471,321,150,423722,198000.9,621722.9
291730,202305,973,563,410,743184.25,542524.82,1285709.07
291733,202305,326,219,107,289082.85,141240.65,430323.50
291735,202305,98,72,26,95040.2,34320.31,129360.51
291740,202305,351,269,82,355081.15,108240,463321.15
291750,202305,2579,1622,957,2142466.3,1265903.91,3408370.21
291760,202305,3221,1790,1431,2362813.88,1890241.91,4253055.79
291770,202305,790,532,258,702272.75,341887.91,1044160.66
291780,202305,108,68,40,89760.58,52800.78,142561.36
291790,202305,169,95,74,125400,97681.27,223081.27
291800,202305,11107,4863,6244,6422012.85,8250091.14,14672103.99
291810,202305,1105,828,277,1092988.66,365645.91,1458634.57
291820,202305,299,215,84,285120.75,110880,396000.75
291830,202305,1049,445,604,588739.82,797286.63,1386026.45
291835,202305,584,541,43,714131.44,58080.18,772211.62
291840,202305,5888,2971,2917,3924574.02,3855802.81,7780376.83
291845,202305,293,100,193,132000,254760,386760
291850,202305,318,278,40,366971.23,52801.66,419772.89
291855,202305,270,114,156,150481.05,205920.67,356401.72
291860,202305,156,102,54,134640.52,71280.99,205921.51
291870,202305,84,38,46,50160,60720,110880
291875,202305,170,156,14,205924.14,18480.84,224404.98
291880,202305,445,368,77,485774.2,101642.53,587416.73
291890,202305,265,90,175,118800.2,231000,349800.2
291900,202305,59,36,23,47520,30360,77880
291905,202305,129,98,31,129361.92,40920.77,170282.69
291910,202305,153,124,29,163680.66,38280.1,201960.76
291915,202305,465,405,60,534620.19,79200.36,613820.55
291920,202305,6671,3170,3501,4184600.58,4625371.83,8809972.41
291930,202305,174,106,68,139922.85,89760.25,229683.10
291940,202305,435,256,179,339243.03,236280,575523.03
291950,202305,1241,967,274,1276449.93,363000,1639449.93
291955,202305,1551,929,622,1226312.97,822368.43,2048681.40
291960,202305,211,153,58,201961.88,76560,278521.88
291970,202305,800,581,219,766937.4,289082.35,1056019.75
291980,202305,1474,1267,207,1673792.06,274562.9,1948354.96
291990,202305,153,142,11,187443.72,14520,201963.72
291992,202305,227,107,120,142567.97,158403.3,300971.27
291995,202305,201,128,73,168962.1,96360.2,265322.3
292000,202305,439,313,126,413166.16,166320.76,579486.92
292010,202305,385,263,122,347160.41,161040.6,508201.01
292020,202305,321,235,86,310203.61,113520,423723.61
292030,202305,165,127,38,167642.52,50160,217802.52
292040,202305,619,340,279,448800,368280,817080
292045,202305,127,111,16,146520.7,21120.86,167641.56
292050,202305,981,711,270,938531.85,357721.58,1296253.43
292060,202305,986,806,180,1063959.44,237602.09,1301561.53
292070,202305,72,27,45,35640.2,59400,95040.2
292080,202305,181,127,54,167640.81,71280,238920.81
292090,202305,598,223,375,294362.78,495000.2,789362.98
292100,202305,1741,760,981,1003244.54,1294948.24,2298192.78
292105,202305,180,162,18,213840.3,23760,237600.3
292110,202305,2405,907,1498,1197269.08,1977368.03,3174637.11
292120,202305,753,566,187,747151.66,246841.59,993993.25
292130,202305,509,276,233,364324.15,307560.19,671884.34
292140,202305,228,182,46,240246.37,60722.21,300968.58
292145,202305,178,102,76,134640,100320,234960
292150,202305,1587,1327,260,1751671.86,345843.28,2097515.14
292160,202305,183,141,42,186120.7,55440.06,241560.76
292170,202305,1224,1030,194,1363609.56,257404.52,1621014.08
292180,202305,254,179,75,236280,99000.1,335280.1
292190,202305,160,104,56,137281.42,73920.97,211202.39
292200,202305,1515,556,959,733933.75,1269846.4,2003780.15
292205,202305,127,105,22,138600.88,29040,167640.88
292210,202305,415,273,142,360368.76,187440.69,547809.45
292220,202305,38,27,11,35640.4,14520,50160.4
292225,202305,67,53,14,69962.71,19800.64,89763.35
292230,202305,1034,812,222,1071872.58,293042.06,1364914.64
292240,202305,670,485,185,641539.58,245520.5,887060.08
292250,202305,1683,1084,599,1432247.13,794646.92,2226894.05
292260,202305,436,261,175,344524.46,231001.71,575526.17
292265,202305,257,195,62,257404.09,81841.02,339245.11
292270,202305,736,378,358,498967.52,472560,971527.52
292273,202305,222,131,91,172920.05,120120.73,293040.78
292275,202305,190,98,92,129360.5,121440,250800.5
292280,202305,159,110,49,145200,64680,209880
292285,202305,100,77,23,101640,30360,132000
292290,202305,672,445,227,588731.73,299640.89,888372.62
292300,202305,1998,796,1202,1052064.76,1587984.77,2640049.53
292303,202305,150,105,45,138602.36,59400.78,198003.14
292305,202305,123,90,33,118801.46,43560,162361.46
292310,202305,1040,694,346,916100.32,456726.74,1372827.06
292320,202305,621,467,154,616447.88,204601.37,821049.25
292330,202305,178,114,64,150481.13,84480,234961.13
292335,202305,324,258,66,340563.75,87120,427683.75
292340,202305,581,408,173,539885.41,229680.55,769565.96
292350,202305,292,149,143,198001.18,190080,388081.18
292360,202305,775,578,197,762963.54,260041.51,1023005.05
292370,202305,744,570,174,752409.1,229680.57,982089.67
292380,202305,631,524,107,693016,141240.49,834256.49
292390,202305,402,166,236,219123.36,311521.59,530644.95
292400,202305,4070,2464,1606,3255225.95,2121250.95,5376476.90
292405,202305,281,187,94,246841.46,124080,370921.46
292410,202305,111,71,40,93721.4,54120,147841.4
292420,202305,278,240,38,316800.9,50160,366960.9
292430,202305,565,402,163,531963.75,215160.51,747124.26
292440,202305,696,579,117,765614.43,154442.13,920056.56
292450,202305,246,187,59,246842.44,77880.8,324723.24
292460,202305,534,403,131,533284.04,172921.33,706205.37
292465,202305,210,180,30,237602.4,39600.1,277202.5
292467,202305,186,125,61,165000.27,81840,246840.27
292470,202305,329,219,110,289080.59,145200,434280.59
292480,202305,426,286,140,377530.11,184801.32,562331.43
292490,202305,263,198,65,261361.82,85802.01,347163.83
292500,202305,1000,497,503,657382.15,665288.3,1322670.45
292510,202305,3855,1891,1964,2498806.58,2593819.99,5092626.57
292520,202305,1282,609,673,805229.34,891010.41,1696239.75
292525,202305,480,361,119,476532.18,158403.18,634935.36
292530,202305,5418,2221,3197,2933111.39,4224037.73,7157149.12
292540,202305,495,284,211,376202.94,279841.1,656044.04
292550,202305,1187,660,527,872531.82,696964.96,1569496.78
292560,202305,341,310,31,409214.48,40920.16,450134.64
292570,202305,361,276,85,364321.26,112200,476521.26
292575,202305,604,440,164,580828.19,216482.96,797311.15
292580,202305,1090,741,349,978130.02,460682.7,1438812.72
292590,202305,596,529,67,698287.37,88440.8,786728.17
292593,202305,151,120,31,158400.58,40920,199320.58
292595,202305,223,176,47,232324.24,62040,294364.24
292600,202305,1357,961,396,1268566.2,524047.86,1792614.06
292610,202305,118,96,22,126727.1,29041.34,155768.44
292620,202305,541,453,88,597993.98,116161.73,714155.71
292630,202305,1678,912,766,1203864.07,1011126.14,2214990.21
292640,202305,928,643,285,848775.02,376204.7,1224979.72
292650,202305,189,140,49,186127.48,64680,250807.48
292660,202305,2110,1474,636,1945745.68,839534.14,2785279.82
292665,202305,139,97,42,128042.07,55440,183482.07
292670,202305,401,305,96,402602.18,126720.21,529322.39
292680,202305,266,200,66,264000.97,87120,351120.97
292690,202305,213,145,68,191400.66,89760,281160.66
292700,202305,1086,709,377,935906.52,500286.83,1436193.35
292710,202305,118,100,18,132001.69,23760.31,155762.00
292720,202305,1074,614,460,810488.19,607200.78,1417688.97
292730,202305,228,112,116,147841.84,153120.4,300962.24
292740,202305,83548,39561,43987,52270544.6,58139230.68,110409775.28
292750,202305,429,312,117,411850.28,154443.68,566293.96
292760,202305,353,301,52,397322.31,68640.38,465962.69
292770,202305,944,392,552,517448.08,728648.81,1246096.89
292780,202305,46,19,27,25081.52,35640.74,60722.26
292790,202305,824,446,378,588723.33,498960.2,1087683.53
292800,202305,1356,809,547,1067899.88,722046.54,1789946.42
292805,202305,421,158,263,208560.3,347161.49,555721.79
292810,202305,1922,1136,786,1499548.32,1037524.1,2537072.42
292820,202305,725,614,111,811829.71,146522.97,958352.68
292830,202305,148,114,34,150484.04,44881.08,195365.12
292840,202305,742,596,146,786745.76,192721.7,979467.46
292850,202305,144,99,45,130682.39,59401.85,190084.24
292860,202305,2234,1277,957,1685702.23,1263256.24,2948958.47
292870,202305,4005,2597,1408,3429438.05,1858569.4,5288007.45
292880,202305,1529,1014,515,1338506.11,679807.51,2018313.62
292890,202305,581,484,97,638896.68,128043.04,766939.72
292895,202305,150,106,44,139920.75,58080,198000.75
292900,202305,353,257,96,339255.89,126723.27,465979.16
292905,202305,534,263,271,347165.33,357724.03,704889.36
292910,202305,563,425,138,561008.83,182160.87,743169.70
292920,202305,636,283,353,373567.55,467288.72,840856.27
292925,202305,486,445,41,587401.66,54121.22,641522.88
292930,202305,787,478,309,630971.75,407883.81,1038855.56
292935,202305,279,123,156,162360.27,205921.1,368281.37
292937,202305,216,146,70,194042.23,92400,286442.23
292940,202305,205,158,47,208562.25,62040,270602.25
292950,202305,1476,707,769,934588.78,1015090.7,1949679.48
292960,202305,528,378,150,498978.04,198002.3,696980.34
292970,202305,266,195,71,257405.69,95042.6,352448.29
292975,202305,99,53,46,69964.57,60721.59,130686.16
292980,202305,373,260,113,343205.27,149161.88,492367.15
292990,202305,1379,1036,343,1368847.15,454081.57,1822928.72
293000,202305,119,82,37,108242.48,48840.1,157082.58
293010,202305,3247,1923,1324,2541136.94,1751673.32,4292810.26
293015,202305,640,528,112,696976.25,147840,844816.25
293020,202305,368,290,78,382814.92,102961.87,485776.79
293030,202305,586,523,63,690370.98,83160,773530.98
293040,202305,395,315,80,415802.09,105600.68,521402.77
293050,202305,3282,1925,1357,2541070.15,1792580.27,4333650.42
293060,202305,237,190,47,250811.33,62040.5,312851.83
293070,202305,4175,2083,2092,2757588.01,2765436.11,5523024.12
293075,202305,99,70,29,92401.97,38280,130681.97
293076,202305,86,64,22,84481.43,29040,113521.43
293077,202305,651,370,281,488420.75,372246.16,860666.91
293080,202305,442,394,48,521405.65,63360.66,584766.31
293090,202305,142,126,16,166320,21120,187440
293100,202305,564,381,183,502930.37,241560.11,744490.48
293105,202305,364,268,96,353762.21,126720,480482.21
293110,202305,130,85,45,112205.86,59402.73,171608.59
293120,202305,309,222,87,293046.99,114844.06,407891.05
293130,202305,259,173,86,228364.8,113520,341884.8
293135,202305,8939,3639,5300,4803614.8,7002620.9,11806235.7
293140,202305,200,121,79,159724.31,104281.69,264006.00
293150,202305,331,287,44,378848.1,58080.2,436928.3
293160,202305,445,280,165,369603.12,217800,587403.12
293170,202305,275,169,106,223085.11,139922.51,363007.62
293180,202305,640,436,204,575523.51,269280,844803.51
293190,202305,1464,1010,454,1334553.73,599288.08,1933841.81
293200,202305,616,535,81,706217.44,106920,813137.44
293210,202305,441,337,104,444849.86,138600,583449.86
293220,202305,2449,1105,1344,1461262.98,1782009.96,3243272.94
293230,202305,1891,711,1180,941181.11,1561564.01,2502745.12
293240,202305,238,215,23,283811.02,30361.1,314172.12
293245,202305,137,110,27,145201.43,35640,180841.43
293250,202305,841,364,477,480492.77,632292.95,1112785.72
293260,202305,337,263,74,347163.13,97680,444843.13
293270,202305,1237,553,684,729968.17,902880.1,1632848.27
293280,202305,328,222,106,293043.16,139921.42,432964.58
293290,202305,3212,2054,1158,2714002.08,1531215.15,4245217.23
293300,202305,940,645,295,852729.61,389400.27,1242129.88
293305,202305,203,155,48,204601.6,63360.65,267962.25
293310,202305,177,132,45,174242.05,59400.7,233642.75
293315,202305,184,140,44,184804.64,58081.45,242886.09
293317,202305,97,72,25,95040.2,33000,128040.2
293320,202305,1333,683,650,902943.9,858022.7,1760966.6
293325,202305,217,92,125,121440,165000,286440
293330,202305,15885,7344,8541,9700968.65,11282161.3,20983129.95
293340,202305,299,211,88,278521.4,116160,394681.4
293345,202305,269,225,44,297007.14,58080,355087.14
293350,202305,612,392,220,517454.81,290401.09,807855.90
293360,202305,1568,1099,469,1450715.17,619086.99,2069802.16
310010,202305,147,78,69,102960.77,91080.04,194040.81
310020,202305,1014,557,457,737899.11,604565.33,1342464.44
310030,202305,321,254,67,335285.14,88442.02,423727.16
310040,202305,48,32,16,42240,21120,63360
310050,202305,168,109,59,143880.21,77880,221760.21
310060,202305,283,202,81,266648.48,106920.63,373569.11
310070,202305,22,14,8,18480.24,10560.2,29040.44
310080,202305,54,37,17,48840,23760.83,72600.83
310090,202305,1176,660,516,871524.84,681126.67,1552651.51
310100,202305,401,282,119,372251.38,157082.05,529333.43
310110,202305,735,394,341,520090.89,450124.43,970215.32
310120,202305,462,260,202,343201.05,266640.73,609841.78
310130,202305,35,19,16,25080.2,21120,46200.2
310140,202305,24,9,15,11880,19800.76,31680.76
310150,202305,1265,829,436,1095678.82,575530.03,1671208.85
310160,202305,2252,1105,1147,1458633.57,1516688.53,2975322.10
310163,202305,103,62,41,81840,54120,135960
310170,202305,2742,1332,1410,1760925,1865173.84,3626098.84
310180,202305,201,95,106,125401.44,139920,265321.44
310190,202305,512,342,170,451445.93,224402.39,675848.32
310200,202305,437,276,161,364325,212520.2,576845.2
310205,202305,86,58,28,76560.79,36960,113520.79
310210,202305,281,228,53,300962.66,69960,370922.66
310220,202305,65,41,24,54120.25,33000,87120.25
310230,202305,300,214,86,282483.49,114840,397323.49
310240,202305,132,107,25,141240.2,33000,174240.2
310250,202305,100,82,18,108242.51,23760,132002.51
310260,202305,809,435,374,575539.5,493685.36,1069224.86
310270,202305,296,191,105,252125.81,139920.14,392045.95
310280,202305,425,296,129,390723.72,170280,561003.72
310285,202305,216,165,51,217802.44,67320.5,285122.94
310290,202305,241,130,111,172922.9,147840,320762.9
310300,202305,187,149,38,196682.13,50160,246842.13
310310,202305,15,13,2,17160,2640,19800
310320,202305,29,11,18,14520.18,23760.52,38280.70
310330,202305,49,37,12,48840.24,15840.66,64680.90
310340,202305,1981,1431,550,1890269.84,731282.59,2621552.43
310350,202305,2928,1512,1416,1997230.09,1874410.07,3871640.16
310360,202305,54,42,12,55440.71,15840.33,71281.04
310370,202305,144,120,24,158400,31680,190080
310375,202305,110,42,68,55441.06,89761.4,145202.46
310380,202305,52,34,18,44880,23760,68640
310390,202305,111,70,41,92400.2,54120,146520.2
310400,202305,2735,1819,916,2403822.51,1211770.87,3615593.38
310410,202305,123,75,48,99001.86,63360,162361.86
310420,202305,723,376,347,496331.08,458043.02,954374.10
310430,202305,292,188,104,248161.97,137280,385441.97
310440,202305,80,52,28,68640.3,38280,106920.3
310445,202305,87,74,13,97680.77,17160,114840.77
310450,202305,700,464,236,613816.3,312840.95,926657.25
310460,202305,270,184,86,244202.73,113520.56,357723.29
310470,202305,571,373,198,492370.36,261362.49,753732.85
310480,202305,105,69,36,91080,47520,138600
310490,202305,620,303,317,399965.57,418441.11,818406.68
310500,202305,139,62,77,81841.64,101640,183481.64
310510,202305,650,457,193,603255.24,256080.91,859336.15
310520,202305,159,110,49,145201.94,64680,209881.94
310530,202305,129,54,75,71280.87,99000,170280.87
310540,202305,524,292,232,385449.9,306242.05,691691.95
310550,202305,83,57,26,75242.11,34320,109562.11
310560,202305,3406,2335,1071,3084930.19,1415044.47,4499974.66
310570,202305,115,73,42,96360,55440,151800
310590,202305,425,252,173,332649.16,228360.7,561009.86
310600,202305,142,68,74,89761.4,97680,187441.4
310610,202305,44,15,29,19800.95,38280,58080.95
310620,202305,54398,25826,28572,34113758.39,37766762.95,71880521.34
310630,202305,819,491,328,648135.33,434282.71,1082418.04
310640,202305,164,109,55,143880.2,72600.2,216480.4
310650,202305,183,164,19,216480.13,25080,241560.13
310660,202305,117,78,39,102960.2,51480,154440.2
310665,202305,72,50,22,66000,30360,96360
310670,202305,8034,3490,4544,4610936.58,5999431,10610367.58
310680,202305,65,44,21,58080,27720,85800
310690,202305,629,450,179,594012.35,236284.12,830296.47
310700,202305,62,38,24,50160.2,31680.97,81841.17
310710,202305,1351,911,440,1205179.23,582125.68,1787304.91
310720,202305,164,47,117,62040,154440,216480
310730,202305,1668,1130,538,1491658.88,711496.93,2203155.81
310740,202305,1066,578,488,764311.32,645485.53,1409796.85
310750,202305,265,170,95,224402.75,125400.37,349803.12
310760,202305,78,60,18,79202.2,23760,102962.2
310770,202305,88,42,46,55440.1,60720,116160.1
310780,202305,382,308,74,406566.89,97680.6,504247.49
310790,202305,122,98,24,129360.72,31680.59,161041.31
310800,202305,503,240,263,316802.4,347160,663962.4
310810,202305,184,121,63,159720.84,83160.59,242881.43
310820,202305,315,253,62,333966.59,81840.04,415806.63
310825,202305,210,177,33,233642.11,43560,277202.11
310830,202305,483,217,266,287763.2,351122.16,638885.36
310840,202305,390,239,151,315482.11,200640.75,516122.86
310850,202305,78,64,14,84480.95,18480,102960.95
310855,202305,465,369,96,487087.89,126720,613807.89
310860,202305,1722,1275,447,1683051.8,591370.67,2274422.47
310870,202305,63,54,9,71280.6,11880,83160.6
310880,202305,94,75,19,99000,25080,124080
310890,202305,301,176,125,232322.18,165000,397322.18
310900,202305,655,305,350,402606.07,462005.06,864611.13
310910,202305,257,170,87,224401.15,114840,339241.15
310920,202305,451,257,194,339251.57,256088.48,595340.05
310925,202305,44,35,9,46200.68,11880,58080.68
310930,202305,1429,965,464,1273819.42,612485.21,1886304.63
310940,202305,728,356,372,471256.63,492367.03,963623.66
310945,202305,152,102,50,134640.7,66000,200640.7
310950,202305,222,176,46,232322.5,60720,293042.5
310960,202305,75,28,47,36961.24,62041.57,99002.81
310970,202305,185,106,79,139923.56,104280,244203.56
310980,202305,57,38,19,50165.96,25080,75245.96
310990,202305,162,87,75,114840.23,99001.05,213841.28
311000,202305,917,472,445,623053.54,587403.79,1210457.33
311010,202305,52,40,12,52800.94,15840,68640.94
311020,202305,42,27,15,35640.55,19800,55440.55
311030,202305,422,239,183,315481.68,241560.52,557042.20
311040,202305,38,30,8,39600,10560,50160
311050,202305,545,209,336,275881.4,444841.58,720722.98
311060,202305,877,484,393,638892.35,520083.99,1158976.34
311070,202305,364,168,196,221761.87,258720.4,480482.27
311080,202305,128,73,55,96361.49,72601.14,168962.63
311090,202305,368,181,187,238925.77,246841.12,485766.89
311100,202305,593,359,234,473885.64,308880.25,782765.89
311110,202305,717,515,202,679822.77,266644.6,946467.37
311115,202305,85,57,28,75240.51,36960.2,112200.71
311120,202305,1182,663,519,875189,686405.83,1561594.83
311130,202305,295,170,125,224405.22,165000,389405.22
311140,202305,180,103,77,135964.47,101642.18,237606.65
311150,202305,340,219,121,289084.58,161040,450124.58
311160,202305,815,575,240,760334.3,316802.24,1077136.54
311170,202305,98,79,19,104280.98,25080,129360.98
311180,202305,332,228,104,300969.46,137280.84,438250.30
311190,202305,37,17,20,22440,26400,48840
311200,202305,352,238,114,314162.2,150480.9,464643.1
311205,202305,36,29,7,38280,10560,48840
311210,202305,36,31,5,40920,6600,47520
311220,202305,32,29,3,38280,3960,42240
311230,202305,1773,1190,583,1570857.87,769568.14,2340426.01
311240,202305,87,58,29,76564.22,38280.5,114844.72
311250,202305,62,27,35,35640,46200,81840
311260,202305,566,347,219,458048.72,289080.14,747128.86
311265,202305,142,92,50,121440.96,66000,187440.96
311270,202305,296,204,92,269284.79,121442.17,390726.96
311280,202305,205,89,116,118800.7,153120,271920.7
311290,202305,110,93,17,122762.01,22440.2,145202.21
311300,202305,622,401,221,530649.93,291721.87,822371.80
311310,202305,17,14,3,19800,3960,23760
311320,202305,673,505,168,666611.88,221761.53,888373.41
311330,202305,1274,928,346,1226310.51,458052.48,1684362.99
311340,202305,2853,2003,850,2645343.29,1124645.6,3769988.89
311350,202305,279,212,67,279842.18,88440,368282.18
311360,202305,167,103,64,135962.81,84480,220442.81
311370,202305,1296,559,737,739228.82,972851.64,1712080.46
311380,202305,7,6,1,7920,1320,9240
311390,202305,259,154,105,203282.09,138600.2,341882.29
311400,202305,145,88,57,116160.8,75240,191400.8
311410,202305,130,64,66,84480.89,87120,171600.89
311420,202305,338,169,169,223085.56,223081.76,446167.32
311430,202305,884,584,300,770890.31,396001.99,1166892.30
311440,202305,482,326,156,430331.21,205921.42,636252.63
311450,202305,325,190,135,250802.25,179520.92,430323.17
311455,202305,279,189,90,249486.28,118801.05,368287.33
311460,202305,138,62,76,81840.3,100320,182160.3
311470,202305,33,15,18,19800,23760,43560
311480,202305,60,34,26,44880,34320,79200
311490,202305,11,6,5,7920,6600,14520
311500,202305,33,17,16,22440.78,21120,43560.78
311510,202305,839,576,263,760338.15,347160.86,1107499.01
311520,202305,40,34,6,44880,9240,54120
311530,202305,1951,1403,548,1852061.86,723363.32,2575425.18
311535,202305,68,44,24,58080.94,31680.52,89761.46
311540,202305,35,30,5,39600.9,6600,46200.9
311545,202305,188,135,53,178202.79,69960,248162.79
311547,202305,60,46,14,60720,18480.23,79200.23
311550,202305,745,348,397,459370.31,524043.31,983413.62
311560,202305,44,27,17,35640.83,22440,58080.83
311570,202305,303,201,102,265323.33,134642.5,399965.83
311580,202305,448,290,158,382804.93,208560.76,591365.69
311590,202305,28,23,5,30360.07,6600,36960.07
311600,202305,97,77,20,101643.15,26401.23,128044.38
311610,202305,260,225,35,297001.8,46200.73,343202.53
311615,202305,182,152,30,200641.64,39600.52,240242.16
311620,202305,33,24,9,31680.9,11880,43560.9
311630,202305,116,101,15,133320.92,19800,153120.92
311640,202305,147,75,72,99001.6,95043.33,194044.93
311650,202305,140,95,45,125400,59400.2,184800.2
311660,202305,464,216,248,285123.16,327361.27,612484.43
311670,202305,161,110,51,145013.36,67320.43,212333.79
311680,202305,238,178,60,234961.16,79200.18,314161.34
311690,202305,13,13,0,17160.5,,17160.5
311700,202305,204,154,50,203283.14,66000.96,269284.10
311710,202305,187,126,61,166322,80520,246842
311720,202305,39,29,10,38280.89,13200,51480.89
311730,202305,604,426,178,564978.58,234961.15,799939.73
311740,202305,28,20,8,26400,10560,36960
311750,202305,766,521,245,687726.62,324721.1,1012447.72
311760,202305,87,38,49,50162.45,64681.08,114843.53
311770,202305,386,189,197,249481.84,260040.81,509522.65
311780,202305,231,123,108,162362.3,142560.37,304922.67
311783,202305,107,93,14,122761.54,18480,141241.54
311787,202305,50,19,31,25080,40920.21,66000.21
311790,202305,272,122,150,161041.78,199321.94,360363.72
311800,202305,814,492,322,649452.73,425043,1074495.73
311810,202305,57,41,16,54121.41,21120,75241.41
311820,202305,137,104,33,137282.27,43561.28,180843.55
311830,202305,2091,1214,877,1606484.39,1158962.35,2765446.74
311840,202305,1185,683,502,901571.85,663963.88,1565535.73
311850,202305,18,13,5,17160.28,6600.2,23760.48
311860,202305,11201,4831,6370,6379782.71,8417719.93,14797502.64
311870,202305,119,68,51,89762.7,67320.31,157083.01
311880,202305,1006,722,284,953069.77,374889.58,1327959.35
311890,202305,213,98,115,129254.2,151803.55,281057.75
311900,202305,70,29,41,38280,54120.15,92400.15
311910,202305,1507,944,563,1246106.61,743165.25,1989271.86
311920,202305,251,164,87,216482.41,114840.2,331322.61
311930,202305,987,559,428,737894.76,566282.57,1304177.33
311940,202305,2891,1599,1292,2110745.2,1705443.27,3816188.47
311950,202305,177,106,71,139922.37,93721.05,233643.42
311960,202305,68,48,20,63360.58,26400,89760.58
311970,202305,27,15,12,19800,15840,35640
311980,202305,43,33,10,43560,13200,56760
311990,202305,39,27,12,35640.08,15840.64,51480.72
311995,202305,63,37,26,48840.7,34320.42,83161.12
312000,202305,21,15,6,19800,7920,27720
312010,202305,75,57,18,76561.13,23760.1,100321.23
312015,202305,88,61,27,80520.74,35640,116160.74
312020,202305,141,103,38,135960.25,50160,186120.25
312030,202305,81,61,20,80520,26400,106920
312040,202305,93,55,38,72600,50160,122760
312050,202305,208,121,87,159720.68,116160,275880.68
312060,202305,22,14,8,18480,10560,29040
312070,202305,86,57,29,75240.57,39600,114840.57
312080,202305,516,252,264,332642.66,348480.3,681122.96
312083,202305,84,55,29,72600.31,38280,110880.31
312087,202305,109,80,29,105601.45,38280,143881.45
312090,202305,3735,2315,1420,3057237.08,1875737.65,4932974.73
312100,202305,153,106,47,139921.7,62040.19,201961.89
312110,202305,131,80,51,105601.98,67321.41,172923.39
312120,202305,132,94,38,125401.74,50160,175561.74
312125,202305,84,56,28,73921.65,36960.73,110882.38
312130,202305,137,92,45,121442.11,59400,180842.11
312140,202305,156,120,36,158401.54,47520,205921.54
312150,202305,39,32,7,42240,9240,51480
312160,202305,1544,1016,528,1342584.21,696966.33,2039550.54
312170,202305,15,11,4,14520,5280,19800
312180,202305,87,64,23,84480,30360,114840
312190,202305,50,43,7,56760.96,9240,66000.96
312200,202305,786,666,120,880460.29,158401.76,1038862.05
312210,202305,136,73,63,96360.99,83160.59,179521.58
312220,202305,154,113,41,149161.88,54120,203281.88
312230,202305,4140,1835,2305,2423609.04,3050528.94,5474137.98
312235,202305,180,119,61,157080,80520,237600
312240,202305,91,67,24,88442.55,31680.93,120123.48
312245,202305,243,178,65,234965.16,85800.39,320765.55
312247,202305,85,61,24,80520.37,31680.38,112200.75
312250,202305,189,97,92,128042.91,121440,249482.91
312260,202305,116,74,42,97680,55440,153120
312270,202305,149,88,61,116161.67,80520,196681.67
312280,202305,30,15,15,19800,19800,39600
312290,202305,152,105,47,138604.07,62041.03,200645.10
312300,202305,214,139,75,183484.05,99001.57,282485.62
312310,202305,67,58,9,76560,11880,88440
312320,202305,443,272,171,359041.38,225720,584761.38
312330,202305,109,95,14,125400,18480.94,143880.94
312340,202305,35,17,18,22440,23760,46200
312350,202305,14,8,6,10560.64,7920,18480.64
312352,202305,94,68,26,89760.3,34320,124080.3
312360,202305,613,269,344,355087.27,454080.2,809167.47
312370,202305,407,226,181,299641.15,238920.99,538562.14
312380,202305,151,98,53,129366.2,69962.17,199328.37
312385,202305,180,144,36,190082.72,47521.03,237603.75
312390,202305,308,195,113,257401.41,149160,406561.41
312400,202305,400,302,98,398642.07,129360.07,528002.14
312410,202305,1331,495,836,654738.85,1103542.91,1758281.76
312420,202305,719,546,173,720729.07,228361.15,949090.22
312430,202305,907,653,254,864612.69,335283.82,1199896.51
312440,202305,54,40,14,52800,18480,71280
312450,202305,232,137,95,182160,126720,308880
312460,202305,40,19,21,25080.92,27720,52800.92
312470,202305,49,35,14,46200,18480,64680
312480,202305,169,105,64,138603.14,84481.19,223084.33
312490,202305,332,225,107,297007.5,141241.6,438249.1
312500,202305,31,21,10,29040.71,13200,42240.71
312510,202305,743,295,448,389409.41,591367.1,980776.51
312520,202305,30,10,20,13200,26400,39600
312530,202305,39,27,12,35641.78,15840.1,51481.88
312540,202305,89,75,14,99000.6,18480,117480.6
312550,202305,33,25,8,33000,10560,43560
312560,202305,215,166,49,220266.35,64680,284946.35
312570,202305,522,310,212,409212.02,279841.8,689053.82
312580,202305,90,55,35,72600,47520,120120
312590,202305,220,174,46,229683.99,60720,290403.99
312595,202305,170,140,30,184800.51,39600,224400.51
312600,202305,74,34,40,44880,52800,97680
312610,202305,1666,875,791,1155026.63,1045442.27,2200468.90
312620,202305,239,175,64,231001.96,85800,316801.96
312630,202305,72,58,14,76560.52,18480,95040.52
312640,202305,48,12,36,15840,47520,63360
312650,202305,161,138,23,182605.74,30360.1,212965.84
312660,202305,111,80,31,105605.15,40920.39,146525.54
312670,202305,990,623,367,822385.42,485764.75,1308150.17
312675,202305,50,38,12,50160,15840,66000
312680,202305,80,52,28,68640,36960,105600
312690,202305,281,144,137,190082.85,180840.8,370923.65
312695,202305,35,27,8,35640,10560,46200
312700,202305,271,156,115,205924.68,151800.64,357725.32
312705,202305,87,68,19,89760,25080,114840
312707,202305,135,94,41,124080.67,55440,179520.67
312710,202305,2015,1133,882,1496932.69,1166890.61,2663823.30
312720,202305,45,24,21,31680.56,27720,59400.56
312730,202305,300,175,125,231005.03,166322.42,397327.45
312733,202305,51,41,10,54120.7,13200,67320.7
312735,202305,22,17,5,22440.71,6600.3,29041.01
312737,202305,87,52,35,68640.89,46200,114840.89
312738,202305,81,50,31,66000.7,40920,106920.7
312740,202305,79,48,31,63361.89,40920,104281.89
312750,202305,122,83,39,109560.28,51480,161040.28
312760,202305,285,192,93,253444.75,122760.97,376205.72
312770,202305,9722,4691,5031,6200199.72,6646217.34,12846417.06
312780,202305,466,356,110,471246.98,145202.81,616449.79
312790,202305,22,16,6,21120,7920.9,29040.9
312800,202305,1771,1218,553,1607776.28,731283.76,2339060.04
312810,202305,368,257,111,339241.53,146520,485761.53
312820,202305,201,154,47,203282.49,63360,266642.49
312825,202305,49,36,13,47523.57,17160,64683.57
312830,202305,198,107,91,141241.89,121440.62,262682.51
312840,202305,211,147,64,194041.27,84480,278521.27
312850,202305,38,33,5,43561.63,6600,50161.63
312860,202305,155,105,50,138600.85,66000,204600.85
312870,202305,1280,673,607,889705.38,802560.12,1692265.50
312880,202305,129,97,32,128043.5,42240,170283.5
312890,202305,181,129,52,170284.33,68640,238924.33
312900,202305,162,123,39,162361.92,51480,213841.92
312910,202305,188,104,84,137285.9,110882.01,248167.91
312920,202305,118,67,51,88440.42,67320,155760.42
312930,202305,347,226,121,298323.78,159721.44,458045.22
312940,202305,167,114,53,150480.13,69960,220440.13
312950,202305,799,565,234,745821.01,308883.54,1054704.55
312960,202305,151,109,42,143887.88,55442.16,199330.04
312965,202305,119,95,24,125400.1,31680,157080.1
312970,202305,304,245,59,323410.69,77881.56,401292.25
312980,202305,2877,1498,1379,1982701.66,1824249.89,3806951.55
312990,202305,48,20,28,26400.3,36960,63360.3
313000,202305,55,30,25,39600.86,33000,72600.86
313005,202305,192,148,44,195360.97,58080.79,253441.76
313010,202305,1064,467,597,616456.98,788047.93,1404504.91
313020,202305,199,105,94,138600,124080,262680
313030,202305,220,145,75,191402.02,99000.76,290402.78
313040,202305,98,29,69,38280.78,91080,129360.78
313050,202305,225,165,60,217800,79200,297000
313055,202305,42,29,13,38280,17160,55440
313060,202305,155,108,47,142561.05,62040,204601.05
313065,202305,59,45,14,59400,18480,77880
313070,202305,131,69,62,91082.53,81840,172922.53
313080,202305,46,25,21,33000,27720,60720
313090,202305,720,471,249,623046.42,328680.49,951726.91
313100,202305,221,82,139,108240.2,184800,293040.2
313110,202305,163,88,75,116160.3,99001.9,215162.2
313115,202305,278,151,127,199322.91,167640.67,366963.58
313120,202305,898,516,382,681134.23,505563.61,1186697.84
313130,202305,6543,3652,2891,4827393.31,3822749.86,8650143.17
313140,202305,146,85,61,112202.33,80521.35,192723.68
313150,202305,312,242,70,319443,92400,411843
313160,202305,192,144,48,191404.95,63360,254764.95
313170,202305,1525,964,561,1272524.85,740523.15,2013048.00
313180,202305,352,226,126,298325.75,166323.69,464649.44
313190,202305,818,472,346,624376.35,456724.47,1081100.82
313200,202305,35,29,6,38280.78,7920.2,46200.98
313210,202305,1057,904,153,1193336.87,201962.51,1395299.38
313220,202305,338,203,135,267960,178200,446160
313230,202305,314,246,68,324720.81,89760.03,414480.84
313240,202305,2457,1236,1221,1635520.66,1613041.72,3248562.38
313250,202305,1300,974,326,1285711.77,430324.9,1716036.67
313260,202305,107,54,53,71281.01,69960,141241.01
313270,202305,1125,670,455,887050.71,601924.31,1488975.02
313280,202305,45,35,10,46200,13200,59400
313290,202305,241,192,49,253447.41,64680.6,318128.01
313300,202305,347,170,177,224405.52,236280.58,460686.10
313310,202305,265,120,145,158402.17,191400.8,349802.97
313320,202305,406,302,104,398643.46,138600.07,537243.53
313330,202305,1517,944,573,1246111.99,756366.87,2002478.86
313340,202305,347,250,97,330006.43,128040.91,458047.34
313350,202305,473,287,186,380162.51,245520.24,625682.75
313360,202305,208,96,112,126721.02,147840,274561.02
313370,202305,245,89,156,117481.38,205920,323401.38
313375,202305,340,217,123,286445.34,162360.25,448805.59
313380,202305,1389,730,659,963625.95,871201.73,1834827.68
313390,202305,54,48,6,63360,7920,71280
313400,202305,428,300,128,397336.87,168962.92,566299.79
313410,202305,99,62,37,81841.5,48840,130681.5
313420,202305,4984,2859,2125,3780615.94,2807656.4,6588272.34
313430,202305,126,62,64,81840.31,85800.33,167640.64
313440,202305,1448,1031,417,1362302.24,550449.46,1912751.70
313450,202305,73,32,41,42240,54120,96360
313460,202305,420,185,235,244204.47,310200.28,554404.75
313470,202305,533,260,273,343213.51,360365.87,703579.38
313480,202305,170,130,40,171601.73,52800,224401.73
313490,202305,595,268,327,353773.58,432967.94,786741.52
313500,202305,33,18,15,23760,19800,43560
313505,202305,1155,889,266,1174836.25,352447.37,1527283.62
313507,202305,119,81,38,106921.46,50160,157081.46
313510,202305,3130,1932,1198,2550449.19,1581386.82,4131836.01
313520,202305,3590,2774,816,3661826.17,1081090.02,4742916.19
313530,202305,41,24,17,31680,22440.94,54120.94
313535,202305,97,78,19,102963.12,25080.5,128043.62
313540,202305,72,49,23,64680,30360,95040
313545,202305,131,111,20,146520.78,26400,172920.78
313550,202305,226,192,34,253442.3,44881.25,298323.55
313560,202305,367,177,190,233647.47,250806.08,484453.55
313570,202305,85,29,56,38280,73920.71,112200.71
313580,202305,1441,856,585,1130072.98,774844.73,1904917.71
313590,202305,79,50,29,67320.76,38281.3,105602.06
313600,202305,720,436,284,575526.44,374881.43,950407.87
313610,202305,60,47,13,62041.62,17160.35,79201.97
313620,202305,1626,784,842,1036234.93,1112764.92,2148999.85
313630,202305,1784,1350,434,1783365.55,574203.03,2357568.58
313640,202305,118,70,48,92401.08,63360.7,155761.78
313650,202305,253,135,118,178201.44,155762.15,333963.59
313652,202305,33,31,2,40920,2640,43560
313655,202305,96,66,30,87120.76,39600.91,126721.67
313657,202305,54,49,5,64682.19,6600,71282.19
313660,202305,155,103,52,135961.6,69961.7,205923.3
313665,202305,776,365,411,481815.46,542532,1024347.46
313670,202305,11892,8154,3738,10766419.99,4936847.16,15703267.15
313680,202305,48,39,9,51480.73,11880,63360.73
313690,202305,140,101,39,133320.54,51480,184800.54
313695,202305,91,70,21,92402,27720,120122
313700,202305,382,297,85,392045.67,112200.88,504246.55
313710,202305,131,94,37,124082.49,48840,172922.49
313720,202305,1276,595,681,785429.75,900250.13,1685679.88
313730,202305,79,45,34,59402.45,44880,104282.45
313740,202305,166,122,44,161041.74,58080,219121.74
313750,202305,420,295,125,389405.63,165000.79,554406.42
313753,202305,250,189,61,249483.19,80520.1,330003.29
313760,202305,1489,588,901,777502.76,1191974.48,1969477.24
313770,202305,447,301,146,397330.82,192723.21,590054.03
313780,202305,936,516,420,681125.88,554404.06,1235529.94
313790,202305,37,37,0,48840,,48840.0
313800,202305,174,110,64,145204.45,84481.69,229686.14
313810,202305,100,54,46,71280.81,60721.02,132001.83
313820,202305,1492,718,774,947781.71,1021682.03,1969463.74
313830,202305,55,36,19,47520.89,25080,72600.89
313835,202305,67,58,9,76560.2,11880,88440.2
313840,202305,1860,1135,725,1498256.88,960965.52,2459222.40
313850,202305,236,107,129,141244.42,170280.5,311524.92
313860,202305,508,383,125,505571.47,165000.64,670572.11
313862,202305,184,131,53,172925.96,69960,242885.96
313865,202305,193,134,59,176881.73,77880,254761.73
313867,202305,63,53,10,69960,13200.1,83160.1
313868,202305,54,35,19,46200.51,25080,71280.51
313870,202305,84,46,38,60720.2,50160,110880.2
313880,202305,411,253,158,333963.78,209880.69,543844.47
313890,202305,359,199,160,262685.42,211200.63,473886.05
313900,202305,889,488,401,644178.12,529328.9,1173507.02
313910,202305,149,102,47,134640.04,62040,196680.04
313920,202305,689,474,215,625682.5,283801.14,909483.64
313925,202305,36,30,6,39600,7920,47520
313930,202305,956,734,222,968921.95,293045.1,1261967.05
313940,202305,2102,1252,850,1655318.21,1124649.88,2779968.09
313950,202305,917,559,358,737895.9,475200.95,1213096.85
313960,202305,1560,901,659,1191980.41,871204.65,2063185.06
313970,202305,196,111,85,146520.1,112200,258720.1
313980,202305,263,169,94,224408.85,124081.72,348490.57
313990,202305,295,178,117,234960.82,154440,389400.82
314000,202305,942,615,327,811813.33,431643.62,1243456.95
314010,202305,111,70,41,92400.15,54120,146520.15
314015,202305,104,28,76,36960.63,100320.9,137281.53
314020,202305,61,39,22,51481.21,29040,80521.21
314030,202305,79,41,38,54122.6,50160,104282.6
314040,202305,49,26,23,34320,30360,64680
314050,202305,308,169,139,223085.8,183480,406565.8
314053,202305,98,63,35,83161.2,46200,129361.2
314055,202305,322,208,114,274565.55,150481.54,425047.09
314060,202305,125,107,18,142560.83,23760.03,166320.86
314070,202305,1151,579,572,764305.54,760334.74,1524640.28
314080,202305,227,136,91,179525.3,120121,299646.3
314085,202305,200,138,62,182160.8,81840,264000.8
314090,202305,436,313,123,413168.56,163680.16,576848.72
314100,202305,560,441,119,582136.89,157083.24,739220.13
314110,202305,815,355,460,471257.01,608523.93,1079780.94
314120,202305,70,43,27,56760,35640,92400
314130,202305,29,21,8,27720,10560,38280
314140,202305,1268,800,468,1058664.34,617765.86,1676430.20
314150,202305,200,128,72,168963.54,95040.36,264003.90
314160,202305,326,245,81,323403.67,106920.56,430324.23
314170,202305,89,66,23,87121.39,30360,117481.39
314180,202305,809,717,92,949112.34,121441.27,1070553.61
314190,202305,93,57,36,75241.18,47520,122761.18
314200,202305,557,387,170,510857.57,225727.5,736585.07
314210,202305,251,194,57,256084.41,75240,331324.41
314220,202305,330,235,95,310205.62,125401.73,435607.35
314225,202305,40,25,15,33001.15,19800,52801.15
314230,202305,132,60,72,79200.55,95040,174240.55
314240,202305,189,136,53,180841.79,69960,250801.79
314250,202305,58,36,22,47522.47,29040,76562.47
314260,202305,223,111,112,146521.48,147840,294361.48
314270,202305,437,342,95,452779.05,125400.7,578179.75
314280,202305,774,421,353,555672.62,468602.82,1024275.44
314290,202305,569,441,128,582127.87,168960.72,751088.59
314300,202305,354,265,89,349807.67,117480,467287.67
314310,202305,1402,970,432,1281761.29,570240.21,1852001.50
314315,202305,52,38,14,50160.72,18480,68640.72
314320,202305,617,434,183,572892.28,241561.88,814454.16
314330,202305,12668,6175,6493,8153956.06,8587973.62,16741929.68
314340,202305,709,320,389,422410.75,513484.81,935895.56
314345,202305,62,46,16,60720,21120,81840
314350,202305,187,115,72,151800.29,95040.66,246840.95
314360,202305,54,29,25,38282.66,33000.99,71283.65
314370,202305,74,53,21,69960,27720,97680
314380,202305,143,77,66,101640.89,87120,188760.89
314390,202305,3790,2454,1336,3240719.17,1766162.46,5006881.63
314400,202305,735,512,223,675851.61,294362.29,970213.90
314410,202305,583,386,197,509533.98,260043.03,769577.01
314420,202305,29,19,10,25080,13200,38280
314430,202305,2607,1004,1603,1326638.05,2118637.47,3445275.52
314435,202305,150,90,60,118801.05,79200,198001.05
314437,202305,58,46,12,60720,15840,76560
314440,202305,100,64,36,84480.49,47520.1,132000.59
314450,202305,179,124,55,163680.65,72600.96,236281.61
314460,202305,661,329,332,434287.92,440883.2,875171.12
314465,202305,132,86,46,114841.36,60720,175561.36
314467,202305,75,61,14,80520,18480,99000
314470,202305,438,217,221,286442.68,291722.93,578165.61
314480,202305,1157,522,635,689056.16,838205.75,1527261.91
314490,202305,38,20,18,26400,23760,50160
314500,202305,288,197,91,260045.9,120120.45,380166.35
314505,202305,122,76,46,100321.05,60720,161041.05
314510,202305,264,216,48,285124.75,63360,348484.75
314520,202305,1538,793,745,1046795.7,986050.86,2032846.56
314530,202305,816,648,168,855390.07,221764.31,1077154.38
314535,202305,187,121,66,159720,87120,246840
314537,202305,72,44,28,58081.37,36960.98,95042.35
314540,202305,22,13,9,17160,11880,29040
314545,202305,69,46,23,60720,30360,91080
314550,202305,82,46,36,60721.04,47521.8,108242.84
314560,202305,903,485,418,640213.38,551765.76,1191979.14
314570,202305,16,13,3,17160.56,3960,21120.56
314580,202305,9,4,5,6600,6600,13200
314585,202305,32,24,8,31680,10560.9,42240.9
314587,202305,81,67,14,88440.7,18480,106920.7
314590,202305,636,430,206,568937.85,271922.53,840860.38
314600,202305,1037,677,360,893676.46,475210.13,1368886.59
314610,202305,1036,530,506,699609.98,669245.96,1368855.94
314620,202305,157,120,37,158400.56,48840,207240.56
314625,202305,99,76,23,100321.09,30360,130681.09
314630,202305,1178,672,506,887064.67,670568.08,1557632.75
314640,202305,94,58,36,76561.16,47520,124081.16
314650,202305,164,95,69,125402.27,91081.53,216483.80
314655,202305,64,46,18,60720,23760,84480
314660,202305,21,17,4,22440,5280,27720
314670,202305,235,185,50,244212.01,66002.37,310214.38
314675,202305,226,139,87,183482.83,114840.23,298323.06
314690,202305,597,322,275,425046.65,364322.06,789368.71
314700,202305,2289,1222,1067,1613105.81,1409766.05,3022871.86
314710,202305,1980,1101,879,1454668.35,1162921.62,2617589.97
314720,202305,437,242,195,319445.98,257400.65,576846.63
314730,202305,538,289,249,381484.83,328681.64,710166.47
314740,202305,861,384,477,506890.48,629644.65,1136535.13
314750,202305,27,20,7,26400,9240,35640
314760,202305,380,155,225,204602.78,298320.88,502923.66
314770,202305,102,67,35,88441.39,46200,134641.39
314780,202305,20,9,11,11880,14520,26400
314790,202305,2699,1738,961,2303469.69,1273801.71,3577271.40
314795,202305,77,66,11,87120.2,14520,101640.2
314800,202305,3142,1848,1294,2442060.74,1710723.98,4152784.72
314810,202305,1602,914,688,1207823.29,909481.79,2117305.08
314820,202305,123,73,50,96360.89,67320.1,163680.99
314830,202305,234,197,37,260044.72,48840,308884.72
314840,202305,90,52,38,69960,50160,120120
314850,202305,464,228,236,301095.56,311520.05,612615.61
314860,202305,667,506,161,667926.43,212520.08,880446.51
314870,202305,1772,969,803,1279113.98,1061296.23,2340410.21
314875,202305,70,63,7,83160,9240,92400
314880,202305,42,30,12,40920,15840,56760
314890,202305,61,35,26,46200,34320,80520
314900,202305,29,21,8,27721.1,10560.92,38282.02
314910,202305,247,162,85,213840.89,112200,326040.89
314915,202305,148,124,24,163681.63,31680.68,195362.31
314920,202305,82,53,29,69960.85,39600,109560.85
314930,202305,1130,509,621,671900.89,819720.94,1491621.83
314940,202305,38,30,8,39600,10560,50160
314950,202305,24,19,5,25081.01,6600,31681.01
314960,202305,30,20,10,26400.39,13200.18,39600.57
314970,202305,183,84,99,110882.17,130680.87,241563.04
314980,202305,325,210,115,277203.64,151800.75,429004.39
314990,202305,477,256,221,337925.22,293041.73,630966.95
314995,202305,155,69,86,91080.5,113520,204600.5
315000,202305,107,83,24,109560.49,31680.1,141240.59
315010,202305,40,24,16,31680,21120,52800
315015,202305,171,137,34,180840.2,44880,225720.2
315020,202305,68,56,12,73920,15840,89760
315030,202305,119,89,30,117480,39600,157080
315040,202305,91,55,36,72600.37,47520,120120.37
315050,202305,218,135,83,178201.09,109560.68,287761.77
315053,202305,70,49,21,64680,27720,92400
315057,202305,132,102,30,134640.88,39600,174240.88
315060,202305,61,51,10,67321.64,13200,80521.64
315070,202305,120,72,48,95041.95,63360,158401.95
315080,202305,409,328,81,432966.61,106921.52,539888.13
315090,202305,106,63,43,83161.39,56760,139921.39
315100,202305,101,50,51,66001.76,67320.38,133322.14
315110,202305,298,153,145,201963.23,191400,393363.23
315120,202305,1989,948,1041,1251410.63,1376790.94,2628201.57
315130,202305,375,265,110,349806.09,145200.44,495006.53
315140,202305,582,313,269,413169.01,355086.63,768255.64
315150,202305,1026,500,526,660021.25,696966.29,1356987.54
315160,202305,203,109,94,143888.33,124084.33,267972.66
315170,202305,305,196,109,258722.82,143880.8,402603.62
315180,202305,3454,1472,1982,1945734.71,2620216.61,4565951.32
315190,202305,303,187,116,246845.46,153120.75,399966.21
315200,202305,1305,790,515,1044144.92,681123.28,1725268.20
315210,202305,1925,1167,758,1541798.11,1003202.33,2545000.44
315213,202305,27,16,11,21121.29,14520,35641.29
315217,202305,229,180,49,237601.21,64680.58,302281.79
315220,202305,1706,1255,451,1656642.17,595328.86,2251971.03
315230,202305,195,152,43,200642.11,56760,257402.11
315240,202305,390,262,128,347168.57,168962.4,516130.97
315250,202305,2889,1385,1504,1830903.02,1990564.2,3821467.22
315260,202305,137,81,56,108240,73920.1,182160.1
315270,202305,161,114,47,150480.8,62040,212520.8
315280,202305,646,425,221,561025.48,291731.88,852757.36
315290,202305,208,132,76,174243.52,100320.64,274564.16
315300,202305,107,82,25,108240.01,33000,141240.01
315310,202305,90,81,9,106920,11880,118800
315320,202305,143,93,50,122765.71,66000,188765.71
315330,202305,65,52,13,68640,17160,85800
315340,202305,396,288,108,381483.63,142561.76,524045.39
315350,202305,169,109,60,143881.38,79200.34,223081.72
315360,202305,111,53,58,69960.15,76560.23,146520.38
315370,202305,59,38,21,50161.32,27720,77881.32
315380,202305,6,5,1,6600,1320,7920
315390,202305,73,28,45,36960,59401.2,96361.2
315400,202305,879,665,214,877817.52,282480.32,1160297.84
315410,202305,328,196,132,258733.26,174244.89,432978.15
315415,202305,58,44,14,58080.27,18480,76560.27
315420,202305,212,153,59,201962.2,77880,279842.2
315430,202305,664,369,295,487084.62,389400.38,876485.00
315440,202305,97,63,34,84480.2,44880,129360.2
315445,202305,245,202,43,266649.87,56760.37,323410.24
315450,202305,183,132,51,174240,67320,241560
315460,202305,5281,2446,2835,3232812.5,3752811.85,6985624.35
315470,202305,53,21,32,27720.9,42240,69960.9
315480,202305,89,28,61,36961.97,81842.17,118804.14
315490,202305,776,510,266,673208.94,351120.48,1024329.42
315500,202305,21,17,4,22440,5280,27720
315510,202305,162,117,45,154441.06,59400,213841.06
315520,202305,79,67,12,89760.98,15840,105600.98
315530,202305,47,28,19,36960,25080.2,62040.2
315540,202305,283,195,88,257404.62,116160.83,373565.45
315550,202305,204,161,43,212521.31,56760,269281.31
315560,202305,744,586,158,773538.06,208563.81,982101.87
315570,202305,318,156,162,205924.7,213840.84,419765.54
315580,202305,799,546,253,722047.49,333960.79,1056008.28
315590,202305,196,98,98,129361.73,129360.63,258722.36
315600,202305,373,290,83,382803.78,109560.78,492364.56
315610,202305,106,50,56,66000,73920,139920
315620,202305,39,30,9,39602.66,11880,51482.66
315630,202305,136,103,33,135960.87,43560,179520.87
315640,202305,62,40,22,52800.98,29040,81840.98
315645,202305,54,36,18,47520,23760,71280
315650,202305,176,130,46,171600.52,60720,232320.52
315660,202305,445,209,236,275890.98,311526.14,587417.12
315670,202305,2601,1180,1421,1557657.22,1877062.98,3434720.20
315680,202305,804,582,222,769570,293040.5,1062610.5
315690,202305,722,483,239,637579.18,316803.09,954382.27
315700,202305,2162,1134,1028,1498241.43,1359628.52,2857869.95
315710,202305,387,134,253,176882.23,335280.18,512162.41
315720,202305,540,323,217,426367.72,287760.92,714128.64
315725,202305,216,168,48,221760.27,63360,285120.27
315727,202305,91,52,39,68645.11,51480,120125.11
315730,202305,58,51,7,67320,9240,76560
315733,202305,89,51,38,67320.2,50160,117480.2
315737,202305,52,40,12,52800.86,15840,68640.86
315740,202305,34,26,8,34320,10560,44880
315750,202305,180,127,53,167640.17,69960.56,237600.73
315760,202305,46,34,12,44880,17160,62040
315765,202305,144,84,60,110883.99,80523.02,191407.01
315770,202305,254,172,82,227044.94,108240.64,335285.58
315780,202305,4363,2168,2195,2864483.71,2900050.96,5764534.67
315790,202305,254,195,59,257405.07,79200.87,336605.94
315800,202305,339,224,115,295683.4,151800,447483.4
315810,202305,60,37,23,48841.11,30360,79201.11
315820,202305,814,609,205,803905.17,270604.54,1074509.71
315830,202305,128,85,43,112200.98,56760.31,168961.29
315840,202305,85,59,26,77880,34320.66,112200.66
315850,202305,276,182,94,240246.21,124081.03,364327.24
315860,202305,21,9,12,11880,15840,27720
315870,202305,40,31,9,40921.04,11880,52801.04
315880,202305,100,66,34,87120,44880,132000
315890,202305,112,77,35,102961.37,46200,149161.37
315895,202305,419,278,141,366976.56,186120.81,553097.37
315900,202305,93,42,51,55440,67320.08,122760.08
315910,202305,52,32,20,42240,26400,68640
315920,202305,161,109,52,143882.57,68640,212522.57
315930,202305,55,20,35,26403.6,46201.02,72604.62
315935,202305,135,107,28,141242.96,36960,178202.96
315940,202305,103,75,28,99000.08,36960,135960.08
315950,202305,42,33,9,43560,11880.35,55440.35
315960,202305,614,288,326,381490.74,431646.67,813137.41
315970,202305,35,29,6,38280.96,7920,46200.96
315980,202305,712,370,342,488414.14,452762.32,941176.46
315990,202305,269,152,117,201962.39,154440.62,356403.01
316000,202305,50,30,20,39600,26400,66000
316010,202305,99,83,16,109561.48,21120,130681.48
316020,202305,96,87,9,114841.25,11880,126721.25
316030,202305,388,228,160,302286.59,211202.19,513488.78
316040,202305,586,245,341,323403.35,450120.61,773523.96
316045,202305,55,49,6,64680,7920,72600
316050,202305,27,19,8,25080,10560,35640
316060,202305,110,78,32,102961.17,43560,146521.17
316070,202305,1320,894,426,1180116.17,562323.69,1742439.86
316080,202305,96,63,33,83276.76,43560,126836.76
316090,202305,36,17,19,22440,26401.08,48841.08
316095,202305,90,77,13,101641.79,17160.44,118802.23
316100,202305,371,204,167,269284.8,220440.32,489725.12
316105,202305,57,36,21,47521.28,27720,75241.28
316110,202305,1972,1520,452,2006443.6,596648.4,2603092.0
316120,202305,77,53,24,71280,31680,102960
316130,202305,128,93,35,122763.19,46200.52,168963.71
316140,202305,31,21,10,27720,13200,40920
316150,202305,239,169,70,223082.57,92400.33,315482.90
316160,202305,84,57,27,75241.97,35640.28,110882.25
316165,202305,75,46,29,60720.78,38280,99000.78
316170,202305,189,121,68,161040.07,89760,250800.07
316180,202305,228,89,139,117483.48,183481.85,300965.33
316190,202305,148,107,41,142561.39,54120,196681.39
316200,202305,719,405,314,534616.39,415801.78,950418.17
316210,202305,786,540,246,714369,324722.92,1039091.92
316220,202305,133,85,48,112202.22,63360,175562.22
316225,202305,44,28,16,36961.61,21120,58081.61
316230,202305,51,29,22,38280.56,29040,67320.56
316240,202305,710,556,154,735256.34,203284.87,938541.21
316245,202305,174,153,21,201962.82,27720.99,229683.81
316250,202305,1794,1185,609,1565570.08,803884.02,2369454.10
316255,202305,134,105,29,138600,39600.63,178200.63
316257,202305,186,95,91,125401.57,120121.46,245523.03
316260,202305,211,142,69,187442.13,91080,278522.13
316265,202305,38,27,11,35641.46,14520.67,50162.13
316270,202305,726,510,216,674532.78,286442.58,960975.36
316280,202305,609,387,222,510850.69,293041.97,803892.66
316290,202305,919,637,282,840862.53,373564.11,1214426.64
316292,202305,683,282,401,372249.06,529322.98,901572.04
316294,202305,111,68,43,89761.9,56760.5,146522.4
316295,202305,432,202,230,266647.49,303607.01,570254.50
316300,202305,36,23,13,30360,17160,47520
316310,202305,26,14,12,18480,15840,34320
316320,202305,73,34,39,44880.85,51480,96360.85
316330,202305,187,133,54,175560.88,71280.57,246841.45
316340,202305,145,93,52,122760,68640,191400
316350,202305,203,137,66,180840.59,87120.2,267960.79
316360,202305,27,18,9,23760,11880,35640
316370,202305,1406,693,713,914782.59,943806.92,1858589.51
316380,202305,127,100,27,132001.57,35640,167641.57
316390,202305,104,78,26,102960,34320,137280
316400,202305,175,132,43,174243.91,56760.36,231004.27
316410,202305,322,235,87,310201.84,114840.2,425042.04
316420,202305,231,153,78,201965.51,102962.26,304927.77
316430,202305,170,94,76,124080.46,100320,224400.46
316440,202305,79,43,36,56760.58,47520.08,104280.66
316443,202305,50,41,9,54120.31,11880,66000.31
316447,202305,48,39,9,51482.29,11880,63362.29
316450,202305,254,188,66,248160.77,87120,335280.77
316460,202305,48,15,33,19800.28,43560.34,63360.62
316470,202305,1889,1391,498,1836167.9,660000.43,2496168.33
316480,202305,9,7,2,9240,2640,11880
316490,202305,20,6,14,7920,18480,26400
316500,202305,174,112,62,147840.27,81840.47,229680.74
316510,202305,140,112,28,147841.03,36960,184801.03
316520,202305,190,103,87,137280.91,114841.62,252122.53
316530,202305,190,120,70,158401.21,92400,250801.21
316540,202305,164,86,78,113521.72,102960.65,216482.37
316550,202305,178,110,68,145201.9,89760,234961.9
316553,202305,505,255,250,336606.72,330000.94,666607.66
316555,202305,69,59,10,77880.76,13200,91080.76
316556,202305,20,14,6,18480.41,7920,26400.41
316557,202305,43,31,12,40921.07,15840,56761.07
316560,202305,74,52,22,68640.2,29040,97680.2
316570,202305,238,218,20,287762.89,26400,314162.89
316580,202305,26,18,8,23760,10560,34320
316590,202305,91,76,15,100320.82,19800.32,120121.14
316600,202305,186,156,30,205921.99,39600,245521.99
316610,202305,74,53,21,69960.62,27720,97680.62
316620,202305,158,110,48,145200,63360.81,208560.81
316630,202305,66,49,17,64680,22440,87120
316640,202305,25,14,11,18480,14520,33000
316650,202305,120,94,26,124080,34320,158400
316660,202305,5,2,3,2640.52,3960,6600.52
316670,202305,441,149,292,196683.93,385443.57,582127.50
316680,202305,183,143,40,188763.21,52800,241563.21
316690,202305,152,94,58,124080,76560,200640
316695,202305,55,47,8,62040,10560,72600
316700,202305,30,21,9,27720,11880,39600
316710,202305,867,653,214,861975.5,282483.4,1144458.9
316720,202305,5596,2616,2980,3455867.02,3934931.32,7390798.34
316730,202305,15,14,1,18480,1320,19800
316740,202305,170,105,65,138600.1,85800,224400.1
316750,202305,18,10,8,13200.24,10560,23760.24
316760,202305,354,278,76,366967.36,100321.06,467288.42
316770,202305,183,99,84,130681.59,112200,242881.59
316780,202305,68,38,30,50160,39600,89760
316790,202305,70,47,23,62040.27,30360.5,92400.77
316800,202305,1904,1158,746,1528598.51,984738.53,2513337.04
316805,202305,33,22,11,29040.08,14520,43560.08
316810,202305,54,31,23,40920.7,30360.1,71280.8
316820,202305,42,25,17,33000,22440,55440
316830,202305,109,50,59,66001.08,77880.2,143881.28
316840,202305,531,323,208,427684.45,274562.6,702247.05
316850,202305,320,223,97,294363.31,128040,422403.31
316860,202305,6820,3105,3715,4102396.62,4913062.29,9015458.91
316870,202305,1886,1218,668,1609155.74,881766.66,2490922.40
316880,202305,171,86,85,113524.34,113521.44,227045.78
316890,202305,239,156,83,205922.26,109560.69,315482.95
316900,202305,455,319,136,421085.01,179520,600605.01
316905,202305,27,11,16,14520,21120,35640
316910,202305,88,38,50,50160,66000,116160
316920,202305,163,126,37,166326.16,48840,215166.16
316930,202305,2179,1116,1063,1475787.24,1405802.16,2881589.40
316935,202305,1042,618,424,817096.95,561007.47,1378104.42
316940,202305,1171,692,479,913458.94,632281.15,1545740.09
316950,202305,212,104,108,137281.83,142560,279841.83
316960,202305,1165,649,516,858028.13,682453.37,1540481.50
316970,202305,698,557,141,736582.48,186123.23,922705.71
316980,202305,92,50,42,66000,55440,121440
316990,202305,2435,1654,781,2183337.8,1033564.22,3216902.02
317000,202305,357,277,80,365651.44,105601.84,471253.28
317005,202305,229,160,69,211204.92,91080.9,302285.82
317010,202305,7448,4269,3179,5639307.48,4201616.19,9840923.67
317020,202305,16743,7350,9393,9710332.16,12414703.51,22125035.67
317030,202305,100,48,52,63360,68640,132000
317040,202305,3287,2160,1127,2853921.08,1487649.28,4341570.36
317043,202305,81,64,17,84487.94,22441.27,106929.21
317047,202305,43,27,16,35640,21120,56760
317050,202305,165,132,33,174242.68,43560,217802.68
317052,202305,164,135,29,178201.57,38280,216481.57
317057,202305,200,150,50,199322.47,66000,265322.47
317060,202305,66,40,26,52800.45,34320.8,87121.25
317065,202305,53,40,13,52800,17160,69960
317070,202305,2117,983,1134,1298924.71,1498202.32,2797127.03
317075,202305,97,55,42,72600.75,55440,128040.75
317080,202305,1017,517,500,685112.45,662641.92,1347754.37
317090,202305,755,585,170,772217.76,224404.67,996622.43
317100,202305,470,350,120,463329.21,158400.95,621730.16
317103,202305,141,112,29,147842.45,38280,186122.45
317107,202305,55,43,12,56760,15840,72600
317110,202305,82,44,38,58080.2,50161.3,108241.5
317115,202305,49,43,6,56822.04,7920,64742.04
317120,202305,2313,1159,1154,1531262.54,1525933.96,3057196.50
317130,202305,2250,1518,732,2005108.35,966243.41,2971351.76
317140,202305,14,11,3,14520.5,3960,18480.5
317150,202305,303,179,124,236283.6,163680.87,399964.47
317160,202305,375,279,96,368285.21,126721.18,495006.39
317170,202305,251,162,89,213841.11,117480.6,331321.71
317180,202305,443,301,142,397324.7,187442.1,584766.8
317190,202305,268,192,76,253441.52,100320,353761.52
317200,202305,916,641,275,847478.8,363009.04,1210487.84
317210,202305,186,97,89,128045.17,117480.21,245525.38
317220,202305,24,11,13,14520,17160,31680
320010,202305,596,424,172,561019.6,227046.44,788066.04
320013,202305,153,98,55,130683.51,72601.65,203285.16
320016,202305,265,161,104,212526.45,137280,349806.45
320020,202305,794,470,324,620422.88,427689.91,1048112.79
320030,202305,179,125,54,165002.56,71282.08,236284.64
320035,202305,143,96,47,128040.2,62040.23,190080.43
320040,202305,518,257,261,340572.08,344530.47,685102.55
320050,202305,127,87,40,114847.67,52801.17,167648.84
320060,202305,2055,964,1091,1272533.75,1440143.58,2712677.33
320070,202305,112,72,40,95040.25,52800,147840.25
320080,202305,871,492,379,650781.07,500286.46,1151067.53
320090,202305,1428,910,518,1202556.96,683776.44,1886333.40
320100,202305,386,218,168,287768.49,221762.99,509531.48
320110,202305,140,85,55,112209.78,72600.6,184810.38
320115,202305,121,103,18,135963.72,23760,159723.72
320120,202305,4120,2154,1966,2847350.72,2600450.5,5447801.22
320130,202305,8930,3834,5096,5065050.1,6736086.68,11801136.78
320140,202305,556,355,201,468622.18,265327.65,733949.83
320150,202305,2371,1309,1062,1727957.37,1403175.67,3131133.04
320160,202305,704,301,403,397330.22,533284.16,930614.38
320170,202305,118,95,23,125402.32,30360.02,155762.34
320180,202305,60,33,27,43561.33,35640,79201.33
320190,202305,269,158,111,208564.89,146520.1,355084.99
320200,202305,66,54,12,71282.75,15840,87122.75
320210,202305,996,546,450,720741.76,594007.86,1314749.62
320220,202305,316,110,206,145200.5,271920.2,417120.7
320225,202305,90,75,15,99000.39,19800.09,118800.48
320230,202305,787,505,282,666638.15,373567.79,1040205.94
320240,202305,3887,1742,2145,2302166.34,2834085.93,5136252.27
320245,202305,566,388,178,512173.24,234966.86,747140.10
320250,202305,263,124,139,163685.37,183483.25,347168.62
320255,202305,126,93,33,122762.09,43560.66,166322.75
320260,202305,326,170,156,224401.94,205921.67,430323.61
320265,202305,159,120,39,158401.73,51480.13,209881.86
320270,202305,163,124,39,163683.59,51481.35,215164.94
320280,202305,1490,834,656,1100923.1,867260.58,1968183.68
320290,202305,72,56,16,73920.9,21120,95040.9
320300,202305,673,459,214,607220.58,282482.89,889703.47
320305,202305,829,457,372,603265.7,493694.16,1096959.86
320310,202305,219,127,92,168964.09,121440.9,290404.99
320313,202305,388,172,216,227050.66,285121.4,512172.06
320316,202305,112,84,28,110882.31,36960.3,147842.61
320320,202305,3779,1701,2078,2249359.64,2744320.76,4993680.40
320330,202305,308,224,84,295681.87,110880,406561.87
320332,202305,850,506,344,667962.49,454095.36,1122057.85
320334,202305,308,167,141,221763.29,186121.3,407884.59
320335,202305,153,99,54,132005.67,71281.52,203287.19
320340,202305,633,448,185,591390.96,245528.89,836919.85
320350,202305,1208,494,714,652103.03,942495,1594598.03
320360,202305,183,84,99,110881,130680,241561
320370,202305,249,184,65,242884.59,85800.69,328685.28
320380,202305,360,255,105,336608.14,138600.89,475209.03
320390,202305,1227,705,522,933272.46,689049.25,1622321.71
320400,202305,351,241,110,318135.37,145200.64,463336.01
320405,202305,1061,427,634,564989.89,836900.7,1401890.59
320410,202305,1008,500,508,661339,670565.74,1331904.74
320420,202305,648,291,357,384139.04,471253.85,855392.89
320425,202305,228,120,108,158402.73,143880.8,302283.53
320430,202305,424,222,202,293054.51,267969.01,561023.52
320435,202305,202,137,65,180842.14,85801.31,266643.45
320440,202305,222,123,99,162363.85,132005,294368.85
320450,202305,147,78,69,102960.96,91081.06,194042.02
320455,202305,246,193,53,254765.46,69960.66,324726.12
320460,202305,361,216,145,285124.5,191400.21,476524.71
320465,202305,125,85,40,112205.61,52800.7,165006.31
320470,202305,825,491,334,648149.27,440892.3,1089041.57
320480,202305,243,160,83,211209.73,109560.02,320769.75
320490,202305,3586,1699,1887,2244092.13,2494868.51,4738960.64
320495,202305,140,81,59,106920.75,77880,184800.75
320500,202305,11400,5528,5872,7307879.34,7765691.66,15073571.00
320501,202305,601,310,291,410539.47,385451.99,795991.46
320503,202305,348,244,104,322086.34,137281.25,459367.59
320506,202305,305,205,100,271925.34,132000.38,403925.72
320510,202305,1387,599,788,790705.92,1040178.56,1830884.48
320515,202305,93,73,20,96362.35,26400,122762.35
320517,202305,253,185,68,245525.79,89760.52,335286.31
320520,202305,8925,3734,5191,4931700.15,6861483.55,11793183.70
320530,202305,7964,3801,4163,5018793.65,5509758.34,10528551.99
330010,202305,3890,1893,1997,2504143.13,2640033.27,5144176.40
330015,202305,227,99,128,130681.66,168960.56,299642.22
330020,202305,4463,1685,2778,2225595.59,3674923.58,5900519.17
330022,202305,286,145,141,191405.63,186120.95,377526.58
330023,202305,967,269,698,355086.65,922691.22,1277777.87
330025,202305,1107,184,923,242883.51,1220889.12,1463772.63
330030,202305,2043,1262,781,1668561.81,1034897.59,2703459.40
330040,202305,2965,1507,1458,1993274.61,1924591.61,3917866.22
330045,202305,11473,3686,7787,4877586.67,10293526.43,15171113.10
330050,202305,952,579,373,765621.62,493686.6,1259308.22
330060,202305,1366,801,565,1057373.24,745813.1,1803186.34
330070,202305,4882,1664,3218,2197886.97,4253101.73,6450988.70
330080,202305,1802,775,1027,1027001.55,1356980.6,2383982.15
330090,202305,426,233,193,308891.22,254761.74,563652.96
330093,202305,239,102,137,134642.17,180841.48,315483.65
330095,202305,74,38,36,50160.35,47520,97680.35
330100,202305,12306,6110,6196,8073484.98,8198663.34,16272148.32
330110,202305,516,238,278,315488.67,368284.9,683773.57
330115,202305,558,274,284,361689.47,374882.11,736571.58
330120,202305,445,230,215,303605.63,283801.51,587407.14
330130,202305,1773,479,1294,632311.19,1710759.88,2343071.07
330140,202305,751,388,363,512167.96,480482.17,992650.13
330150,202305,567,344,223,455897.5,297002.78,752900.28
330160,202305,218,127,91,167644.21,120122.15,287766.36
330170,202305,29955,10669,19286,14100862.05,25496275.25,39597137.30
330180,202305,281,153,128,201961.9,171603.27,373565.17
330185,202305,1337,522,815,691706.21,1077144.82,1768851.03
330187,202305,701,202,499,266650.89,660006.2,926657.09
330190,202305,7052,2686,4366,3550928.4,5780353.83,9331282.23
330200,202305,5120,1739,3381,2298210.43,4469617.44,6767827.87
330205,202305,539,302,237,398653.51,314163.14,712816.65
330210,202305,998,589,409,777505.52,539885.53,1317391.05
330220,202305,3094,1814,1280,2397223.71,1694913.91,4092137.62
330225,202305,709,346,363,456727.94,479163.08,935891.02
330227,202305,2699,884,1815,1169553.35,2395836.07,3565389.42
330230,202305,259,137,122,182163.46,161044.22,343207.68
330240,202305,4937,2287,2650,3020289.95,3502023.9,6522313.85
330245,202305,185,87,98,114842.74,129360.86,244203.60
330250,202305,7435,3546,3889,4684890.43,5136208.56,9821098.99
330260,202305,866,240,626,316807.44,827645.26,1144452.70
330270,202305,4470,1457,3013,1924631.85,3985154.43,5909786.28
330280,202305,505,301,204,397339.43,269285.32,666624.75
330285,202305,7008,2257,4751,2980723.17,6275442.56,9256165.73
330290,202305,847,291,556,385456.17,737885.58,1123341.75
330300,202305,818,499,319,660837.37,421089.15,1081926.52
330310,202305,518,299,219,396012.14,289081.52,685093.66
330320,202305,8479,2929,5550,3869120.2,7335367.73,11204487.93
330330,202305,10640,3864,6776,5103295.72,8961615.32,14064911.04
330340,202305,3080,1683,1397,2224255.81,1845381.03,4069636.84
330350,202305,23002,8209,14793,10848270.04,19554863.66,30403133.70
330360,202305,2070,977,1093,1293656.14,1444118.16,2737774.30
330370,202305,1080,569,511,751109.38,674536.22,1425645.60
330380,202305,1136,461,675,609859.74,892332.52,1502192.26
330385,202305,731,357,374,471251.26,493683.3,964934.56
330390,202305,6982,3634,3348,4803766.87,4423462.52,9227229.39
330395,202305,436,279,157,368292.35,207244.64,575536.99
330400,202305,784,399,385,526702.36,508203.81,1034906.17
330410,202305,573,409,164,539897.75,216484.69,756382.44
330411,202305,407,221,186,291724.38,245520,537244.38
330412,202305,243,114,129,150484.77,171600.1,322084.87
330414,202305,6017,2363,3654,3120619.02,4831257.29,7951876.31
330415,202305,681,291,390,384131.82,516124.53,900256.35
330420,202305,2720,1412,1308,1866528.38,1731855.35,3598383.73
330430,202305,1965,842,1123,1112790.45,1486336.44,2599126.89
330440,202305,432,212,220,279844.92,290401.61,570246.53
330450,202305,136,61,75,80520.94,99001.37,179522.31
330452,202305,2779,1127,1652,1491660.92,2183306.18,3674967.10
330455,202305,141482,49663,91819,65630774.49,121412031.84,187042806.33
330460,202305,286,131,155,172921.95,204600.4,377522.35
330470,202305,1370,732,638,966265.14,843493.35,1809758.49
330475,202305,2062,623,1439,822377.71,1900817.08,2723194.79
330480,202305,863,478,385,630980.97,508205.75,1139186.72
330490,202305,18569,5718,12851,7558707.12,16985988.67,24544695.79
330500,202305,1750,756,994,997946.59,1314733.61,2312680.20
330510,202305,12328,4373,7955,5776586.75,10515284.77,16291871.52
330513,202305,107,57,50,75240.04,66000,141240.04
330515,202305,741,326,415,430331,547816.27,978147.27
330520,202305,2820,958,1862,1267252.06,2461846.29,3729098.35
330530,202305,191,111,80,146524.73,105600.1,252124.83
330540,202305,385,200,185,265323.36,244203.88,509527.24
330550,202305,3118,1045,2073,1380751.36,2739027.49,4119778.85
330555,202305,1267,449,818,592694.8,1079766.6,1672461.4
330560,202305,862,300,562,396012.79,743168.6,1139181.39
330570,202305,363,251,112,331323.13,147840.52,479163.65
330575,202305,974,363,611,480494.93,807853.1,1288348.03
330580,202305,3865,2041,1824,2695519.63,2411674.45,5107194.08
330590,202305,274,142,132,187444.86,174242.03,361686.89
330600,202305,1590,933,657,1231607.64,868577.03,2100184.67
330610,202305,1776,894,882,1181433.77,1165568.34,2347002.11
330615,202305,241,193,48,254763.49,63362.95,318126.44
330620,202305,1062,450,612,594027.91,809174.88,1403202.79
330630,202305,5182,3043,2139,4020871.73,2826169.23,6847040.96
350010,202305,631,413,218,545184.2,289082.39,834266.59
350020,202305,59,21,38,27721.8,50160,77881.8
350030,202305,622,363,259,479187.62,341889.47,821077.09
350040,202305,116,50,66,66002.6,87120.68,153123.28
350050,202305,395,183,212,242888.46,279843.87,522732.33
350055,202305,141,62,79,81843.06,104280.21,186123.27
350060,202305,83,36,47,47521.8,62040.2,109562.0
350070,202305,854,476,378,628359.19,498975.57,1127334.76
350075,202305,83,51,32,67322.83,42240,109562.83
350080,202305,65,29,36,38280.77,47520.97,85801.74
350090,202305,87,47,40,62042.59,52800,114842.59
350100,202305,311,196,115,258725.72,151800,410525.72
350110,202305,49,32,17,42242.68,22440,64682.68
350115,202305,195,94,101,124084.02,133321.28,257405.30
350120,202305,120,79,41,104283.37,54120.47,158403.84
350130,202305,444,191,253,252139.23,335288.29,587427.52
350140,202305,38,23,15,30360.64,19800,50160.64
350150,202305,83,56,27,73922.15,35640.22,109562.37
350160,202305,2594,1027,1567,1357003.77,2069770.27,3426774.04
350170,202305,452,261,191,344531.38,252122.69,596654.07
350180,202305,165,89,76,117483.46,100320.41,217803.87
350190,202305,1066,576,490,761681.92,650762.6,1412444.52
350200,202305,64,27,37,35641.98,48840,84481.98
350210,202305,1407,744,663,982126.8,875183.37,1857310.17
350220,202305,658,521,137,687738.9,180842.47,868581.37
350230,202305,73,44,29,58080.7,38280.9,96361.6
350240,202305,60,37,23,48840.65,30360.65,79201.30
350250,202305,1182,524,658,691709.15,871211.86,1562921.01
350260,202305,117,84,33,110882.79,43560.87,154443.66
350270,202305,1052,693,359,914767.1,475202.08,1389969.18
350275,202305,363,135,228,178201.93,300964.73,479166.66
350280,202305,4737,2229,2508,2945058.98,3314540.24,6259599.22
350290,202305,530,224,306,295687.07,403922.34,699609.41
350300,202305,51,27,24,35645.35,31680.9,67326.25
350310,202305,85,49,36,64681.63,47520.59,112202.22
350315,202305,14,11,3,14520,3960,18480
350320,202305,3692,1716,1976,2265234.22,2613628.22,4878862.44
350330,202305,1818,867,951,1145798.43,1255324.26,2401122.69
350335,202305,24,14,10,18480,13200,31680
350340,202305,132,53,79,69961.24,104284.01,174245.25
350350,202305,99,47,52,62040,69960,132000
350360,202305,116,75,41,99003.4,54120.37,153123.77
350370,202305,89,50,39,66002.73,51480.48,117483.21
350380,202305,944,406,538,537258.71,710169.24,1247427.95
350390,202305,1982,737,1245,972865.1,1646056.84,2618921.94
350395,202305,20,14,6,18480,7920,26400
350400,202305,1890,885,1005,1169565.25,1334521.51,2504086.76
350410,202305,3424,1363,2061,1800537.5,2723183.49,4523720.99
350420,202305,303,177,126,233643.73,166321.28,399965.01
350430,202305,108,53,55,69964.62,72603.5,142568.12
350440,202305,148,106,42,139929.58,55440.35,195369.93
350450,202305,1884,1020,864,1347776.15,1143122.64,2490898.79
350460,202305,451,154,297,203288.73,393370.98,596659.71
350470,202305,25,13,12,17160,15840,33000
350480,202305,213,109,104,143886.65,137281.53,281168.18
350490,202305,261,120,141,158402.64,186120.8,344523.44
350500,202305,61,20,41,26400,54120,80520
350510,202305,154,86,68,113524.01,89760.37,203284.38
350520,202305,480,255,225,336622.1,297009.15,633631.25
350530,202305,543,264,279,348496.07,368293.32,716789.39
350535,202305,99,65,34,85800.37,44880.13,130680.50
350540,202305,362,190,172,252127.83,227046.25,479174.08
350550,202305,3019,1666,1353,2203193.09,1789928.91,3993122.00
350560,202305,631,428,203,564977.35,271923.16,836900.51
350570,202305,4937,2031,2906,2683655.84,3845193.15,6528848.99
350580,202305,406,194,212,256089.11,279844.64,535933.75
350590,202305,1094,577,517,762983.98,683906.89,1446890.87
350600,202305,6993,3162,3831,4183305.68,5067530.29,9250835.97
350610,202305,1633,854,779,1127324.23,1030926.17,2158250.40
350620,202305,24,14,10,18480,13200,31680
350630,202305,276,135,141,178206.28,186122.48,364328.76
350635,202305,1456,629,827,831626.29,1094302.03,1925928.32
350640,202305,133,91,42,120120.6,55440.7,175561.3
350650,202305,2066,1351,715,1784728.57,947765.78,2732494.35
350660,202305,870,342,528,452770.02,700926.95,1153696.97
350670,202305,309,154,155,203284.15,205920.78,409204.93
350680,202305,163,85,78,112203.36,104280.92,216484.28
350690,202305,212,96,116,126722.01,153120,279842.01
350700,202305,1067,513,554,677185.72,733930.6,1411116.32
350710,202305,463,166,297,219126.91,392044.74,611171.65
350715,202305,60,47,13,62041.37,18480,80521.37
350720,202305,17,13,4,17160.92,5280,22440.92
350730,202305,48,29,19,38282.35,25080.61,63362.96
350740,202305,261,144,117,190084.62,154441.78,344526.40
350745,202305,34,15,19,19801.09,25081.44,44882.53
350750,202305,2794,1612,1182,2129242.41,1560254.76,3689497.17
350760,202305,4392,1825,2567,2410393.78,3391109.6,5801503.38
350770,202305,64,41,23,54120.44,30360,84480.44
350775,202305,70,52,18,68645.28,23761.63,92406.91
350780,202305,508,252,256,332654.56,337922.53,670577.09
350790,202305,376,157,219,207244.16,289084.71,496328.87
350800,202305,582,343,239,452765.77,315481.6,768247.37
350810,202305,541,409,132,539910.26,175560.39,715470.65
350820,202305,102,57,45,75242.11,60720,135962.11
350830,202305,87,44,43,58080.67,56760,114840.67
350840,202305,905,359,546,475214.81,720849.21,1196064.02
350850,202305,2027,1028,999,1357002.85,1321327.11,2678329.96
350860,202305,766,389,377,513500.49,497652.69,1011153.18
350870,202305,485,332,153,438250.81,201961.26,640212.07
350880,202305,304,159,145,209885.74,191405,401290.74
350890,202305,42,26,16,34320,21120.08,55440.08
350900,202305,1776,587,1189,774868.87,1576110.79,2350979.66
350910,202305,28,15,13,19800,17160.18,36960.18
350920,202305,865,437,428,576851.51,566280.9,1143132.41
350925,202305,1266,622,644,821084.45,852738.39,1673822.84
350930,202305,133,75,58,99003.64,76560.28,175563.92
350940,202305,792,405,387,535947.39,512174.21,1048121.60
350945,202305,128,87,41,114842.64,54120.18,168962.82
350950,202305,19729,9097,10632,12028217.79,14054149.22,26082367.01
350960,202305,1913,756,1157,1000783.8,1529897.65,2530681.45
350970,202305,1200,562,638,743048.9,844814.57,1587863.47
350980,202305,103,69,34,91084.13,46200,137284.13
350990,202305,431,157,274,207241.63,361681.12,568922.75
350995,202305,46,19,27,25081.15,35641.38,60722.53
351000,202305,646,404,242,534619.08,319447.97,854067.05
351010,202305,56,36,20,47523.09,26400,73923.09
351015,202305,45,25,20,33000.72,26400,59400.72
351020,202305,1589,939,650,1244799.82,859331.8,2104131.62
351030,202305,361,205,156,270603.59,207240.32,477843.91
351040,202305,1139,628,511,828988.87,677164.8,1506153.67
351050,202305,4077,1835,2242,2424958.11,2960787.9,5385746.01
351060,202305,6855,2489,4366,3286920.45,5773712.91,9060633.36
351070,202305,439,274,165,361693.97,217806.41,579500.38
351080,202305,836,618,218,815785.17,287763.95,1103549.12
351090,202305,50,25,25,33001.85,33000.41,66002.26
351100,202305,454,236,218,312863.88,289091.53,601955.41
351110,202305,2272,1032,1240,1364930.94,1640763.06,3005694.00
351120,202305,68,32,36,42241.46,48840,91081.46
351130,202305,202,67,135,88442.99,178203.99,266646.98
351140,202305,342,203,139,267969.19,183484.17,451453.36
351150,202305,544,274,270,361688.27,356404.09,718092.36
351160,202305,354,195,159,257405.22,209880.72,467285.94
351170,202305,260,150,110,198003.16,145200.05,343203.21
351190,202305,107,62,45,81841.69,59400,141241.69
351200,202305,367,235,132,310211.12,174241.11,484452.23
351210,202305,139,66,73,87122.15,96360.78,183482.93
351220,202305,641,350,291,465974.55,384121.13,850095.68
351230,202305,335,207,128,273245.43,168960.8,442206.23
351240,202305,258,128,130,168962.38,171602.57,340564.95
351250,202305,95,66,29,87128.83,38280.1,125408.93
351260,202305,151,103,48,135961.87,63360.99,199322.86
351270,202305,52,23,29,30360.91,38280,68640.91
351280,202305,1123,542,581,716787.26,766929.54,1483716.80
351290,202305,266,125,141,166322.48,186120.7,352443.18
351300,202305,4493,1859,2634,2460555.9,3482213.22,5942769.12
351310,202305,785,378,407,500306.29,539894.76,1040201.05
351320,202305,121,68,53,89761.33,71280.6,161041.93
351330,202305,41,25,16,33000,22440,55440
351340,202305,1617,861,756,1137873.61,997923.85,2135797.46
351350,202305,2674,1578,1096,2083066.18,1449368.56,3532434.74
351360,202305,860,400,460,528010.46,608525.37,1136535.83
351370,202305,475,234,241,310207.69,320760.45,630968.14
351380,202305,9359,4102,5257,5425357.35,6949834.69,12375192.04
351385,202305,26,19,7,25081.67,9240,34321.67
351390,202305,298,214,84,282486,110880.65,393366.65
351400,202305,63,40,23,52800.8,30360,83160.8
351410,202305,516,296,220,390733.94,290402.3,681136.24
351420,202305,84,61,23,80521.32,30360,110881.32
351430,202305,73,38,35,50161.03,46200.2,96361.23
351440,202305,899,578,321,765635.82,423729.3,1189365.12
351450,202305,307,152,155,200642.93,204605.11,405248.04
351460,202305,149,65,84,85804.83,110882.48,196687.31
351470,202305,147,80,67,105604.54,88440.89,194045.43
351480,202305,490,286,204,377524.03,269280.2,646804.23
351490,202305,333,133,200,176882.4,265320.72,442203.12
351492,202305,30,18,12,23760.63,15840,39600.63
351495,202305,27,19,8,25080.65,10560,35640.65
351500,202305,3708,1466,2242,1936484.14,2963423.56,4899907.70
351510,202305,2350,843,1507,1114111.91,1990579.3,3104691.21
351512,202305,16,10,6,13200,7920,21120
351515,202305,222,127,95,168966.04,125400,294366.04
351518,202305,724,428,296,564994.99,390744.72,955739.71
351519,202305,87,52,35,68642.12,46200,114842.12
351520,202305,186,117,69,154443.61,91104.78,245548.39
351530,202305,29,14,15,18480,19800,38280
351535,202305,144,85,59,112203.26,77881.78,190085.04
351540,202305,512,320,192,422414.95,253444.89,675859.84
351550,202305,1738,1008,730,1330605.25,964927.96,2295533.21
351560,202305,89,48,41,63362.1,54120,117482.1
351565,202305,16,8,8,10560.32,10560,21120.32
351570,202305,3117,1384,1733,1828271.69,2290222.97,4118494.66
351580,202305,36,33,3,43560,3960,47520
351590,202305,69,41,28,54121.76,36960.86,91082.62
351600,202305,182,133,49,175568.51,64680.76,240249.27
351610,202305,55,24,31,31680.74,40920,72600.74
351620,202305,6480,3379,3101,4465761.15,4099961.39,8565722.54
351630,202305,3697,1723,1974,2277075.26,2608348.21,4885423.47
351640,202305,2861,1239,1622,1636851.78,2146333.93,3783185.71
351650,202305,39,30,9,39601.47,11880,51481.47
351660,202305,149,92,57,121440.3,75240,196680.3
351670,202305,812,454,358,599306.58,472569.11,1071875.69
351680,202305,101,71,30,93721.19,39600,133321.19
351685,202305,14,10,4,13200.13,5280,18480.13
351690,202305,314,200,114,264011.3,151801.42,415812.72
351700,202305,200,136,64,179814.78,84480.2,264294.98
351710,202305,67,42,25,55441.89,33000.91,88442.80
351720,202305,125,70,55,92402.23,72600,165002.23
351730,202305,129,87,42,114840.73,55440,170280.73
351740,202305,850,532,318,702276.78,419766.35,1122043.13
351750,202305,407,166,241,220444.56,318121.6,538566.16
351760,202305,722,563,159,744388.77,212520.6,956909.37
351770,202305,318,251,67,331337.81,88440.56,419778.37
351780,202305,145,89,56,117481.8,73920,191401.8
351790,202305,290,142,148,187448.16,195363.24,382811.40
351800,202305,47,31,16,40920.26,21120,62040.26
351810,202305,125,78,47,102967.01,63362.24,166329.25
351820,202305,777,546,231,720768.7,306246.63,1027015.33
351830,202305,718,226,492,299648.84,649448.32,949097.16
351840,202305,2528,1124,1404,1486363.67,1855927.03,3342290.70
351850,202305,279,187,92,246850.02,121440,368290.02
351860,202305,643,426,217,562352.44,286443.09,848795.53
351870,202305,6434,2852,3582,3771378.03,4733612.86,8504990.89
351880,202305,24971,9494,15477,12541683.07,20461360,33003043.07
351885,202305,113,60,53,79202.36,69960.3,149162.66
351890,202305,79,53,26,69961,34320,104281
351900,202305,262,134,128,176886.62,168960.95,345847.57
351905,202305,108,54,54,71282.11,71280.24,142562.35
351907,202305,4157,1679,2478,2216360.35,3273626.99,5489987.34
351910,202305,167,70,97,92405.1,128040.93,220446.03
351920,202305,121,65,56,85800,73920,159720
351925,202305,98,59,39,77883.57,51481.51,129365.08
351930,202305,507,312,195,413182.19,257406.98,670589.17
351940,202305,252,106,146,139922.64,192721.89,332644.53
351950,202305,149,82,67,108241.02,88444.14,196685.16
351960,202305,1059,516,543,681154.42,716782.45,1397936.87
351970,202305,2344,1092,1252,1441470.1,1659263.83,3100733.93
351980,202305,162,71,91,93722.21,120121.97,213844.18
351990,202305,257,160,97,211202.72,129360.87,340563.59
352000,202305,264,176,88,232336.23,116164.31,348500.54
352010,202305,469,304,165,402710.89,219133.09,621843.98
352020,202305,212,66,146,87120,192720,279840
352030,202305,1286,596,690,786744.19,910814.79,1697558.98
352040,202305,757,293,464,386766.52,615125.07,1001891.59
352042,202305,377,89,288,117483.9,380161.79,497645.69
352044,202305,386,214,172,282495.02,228365.86,510860.88
352050,202305,3573,1302,2271,1718687.21,3000378.36,4719065.57
352060,202305,107,62,45,83160.18,59401.59,142561.77
352070,202305,111,74,37,99006.67,48840,147846.67
352080,202305,69,41,28,54123.52,36960.48,91084.00
352090,202305,201,122,79,161043.49,104281.1,265324.59
352100,202305,342,165,177,219126.24,233642.72,452768.96
352110,202305,115,32,83,42240.61,109560,151800.61
352115,202305,69,25,44,33000,58080.2,91080.2
352120,202305,71,47,24,62040,31680,93720
352130,202305,232,172,60,227051.36,79200.57,306251.93
352140,202305,212,107,105,141242.41,138602.36,279844.77
352150,202305,138,73,65,96361.48,85802.37,182163.85
352160,202305,147,98,49,129363.83,66000.54,195364.37
352170,202305,457,299,158,394686.23,208560.08,603246.31
352180,202305,759,446,313,588741.98,414488.62,1003230.60
352190,202305,251,106,145,139929.09,192721.95,332651.04
352200,202305,31,13,18,17161.03,23760.1,40921.13
352210,202305,4974,1940,3034,2562242.49,4008868.8,6571111.29
352215,202305,80,41,39,54120.2,51480,105600.2
352220,202305,6546,2427,4119,3205073.37,5443749.94,8648823.31
352230,202305,3985,2480,1505,3279023.82,1995847.23,5274871.05
352240,202305,3033,1684,1349,2224270.01,1785977.07,4010247.08
352250,202305,4123,1817,2306,2399833.59,3051849.95,5451683.54
352260,202305,1117,581,536,768262.78,708853.16,1477115.94
352265,202305,72,42,30,55440,39600,95040
352270,202305,425,228,197,300986.95,260049.17,561036.12
352280,202305,554,324,230,427689.68,303600,731289.68
352290,202305,190,105,85,138606.06,112201.91,250807.97
352300,202305,108,65,43,85805.03,56761.61,142566.64
352310,202305,8490,3666,4824,4844604.03,6382213.54,11226817.57
352320,202305,1249,644,605,852743.42,801248.09,1653991.51
352330,202305,567,291,276,384124.36,364320.57,748444.93
352340,202305,1515,681,834,900271.35,1102209.15,2002480.50
352350,202305,399,217,182,286447.81,240242.16,526689.97
352360,202305,231,100,131,132002.52,172920.7,304923.22
352370,202305,130,80,50,105603.66,66001.85,171605.51
352380,202305,120,85,35,112203.85,46201.07,158404.92
352390,202305,2808,1176,1632,1552373.05,2154250.17,3706623.22
352400,202305,600,260,340,344527.06,448804.36,793331.42
352410,202305,989,652,337,862000.86,444859.62,1306860.48
352420,202305,92,67,25,88441.56,33000,121441.56
352430,202305,1864,809,1055,1067927.86,1401869.49,2469797.35
352440,202305,3818,1682,2136,2221646.59,2827452.65,5049099.24
352450,202305,198,153,45,203283.06,59402.15,262685.21
352460,202305,690,335,355,443527.75,468605.05,912132.80
352470,202305,742,283,459,374896.92,607204.97,982101.89
352480,202305,1782,996,786,1317401.77,1038859.31,2356261.08
352490,202305,59,23,36,30360.1,47521.07,77881.17
352500,202305,1677,663,1014,875176.72,1339807.6,2214984.32
352510,202305,782,401,381,529347.35,505565.47,1034912.82
352520,202305,948,429,519,566298.58,686414.08,1252712.66
352530,202305,2108,1017,1091,1343824.41,1440130.39,2783954.80
352540,202305,69,49,20,64681.85,26400,91081.85
352550,202305,232,128,104,170282.14,137280,307562.14
352560,202305,56,40,16,52801.53,21120.84,73922.37
352570,202305,833,399,434,529349.94,572896.65,1102246.59
352580,202305,57,43,14,56762.91,18480,75242.91
352585,202305,17,5,12,6600.53,15840.95,22441.48
352590,202305,4888,2385,2503,3149649.4,3310585.06,6460234.46
352600,202305,398,268,130,353772.43,171607.58,525380.01
352610,202305,964,417,547,550452.56,724685.23,1275137.79
352620,202305,1227,462,765,609853.21,1013770.15,1623623.36
352630,202305,201,77,124,101640.95,163680.08,265321.03
352640,202305,552,351,201,463344.57,265324.62,728669.19
352650,202305,97,65,32,85801.64,42240,128041.64
352660,202305,73,38,35,50160.67,46200,96360.67
352670,202305,1876,975,901,1289718.93,1191962.18,2481681.11
352680,202305,1064,617,447,814472.38,592703.91,1407176.29
352690,202305,5099,2203,2896,2909401.65,3831987.81,6741389.46
352700,202305,94,49,45,64683.43,59401.38,124084.81
352710,202305,1627,831,796,1099612.68,1052042.3,2151654.98
352720,202305,1743,705,1038,931965.74,1371508.9,2303474.64
352725,202305,30,22,8,29041.67,10560,39601.67
352730,202305,438,211,227,278527.62,303602.88,582130.50
352740,202305,407,260,147,343217.49,194042.67,537260.16
352750,202305,24,16,8,21121.06,10560,31681.06
352760,202305,252,159,93,209883.86,122760.57,332644.43
352770,202305,80,58,22,76563.68,29040,105603.68
352780,202305,77,42,35,55440,46200.78,101640.78
352790,202305,26,17,9,22441.92,11880.18,34322.10
352800,202305,264,201,63,267968.4,83161.48,351129.88
352810,202305,163,103,60,137282.79,79203.31,216486.10
352820,202305,43,34,9,44880.07,11880,56760.07
352830,202305,74,48,26,63360.67,34320.01,97680.68
352840,202305,766,333,433,440899.29,571568.99,1012468.28
352850,202305,2015,593,1422,782776.87,1877051.1,2659827.97
352860,202305,128,80,48,105604.03,63360.12,168964.15
352870,202305,53,33,20,43563.92,26401.36,69965.28
352880,202305,193,108,85,142566.57,112201.89,254768.46
352885,202305,36,24,12,31680.28,15840,47520.28
352890,202305,61,37,24,48842.2,31680,80522.2
352900,202305,4934,2300,2634,3042721,3482176.55,6524897.55
352910,202305,40,31,9,40920.88,11880,52800.88
352920,202305,671,380,291,502945.2,384128.15,887073.35
352930,202305,1259,585,674,773550.92,891004.11,1664555.03
352940,202305,6915,2579,4336,3408326.08,5731504.13,9139830.21
352950,202305,134,62,72,81842.22,95042.6,176884.82
352960,202305,70,47,23,62040.93,30360,92400.93
352965,202305,16,9,7,11880,9240,21120
352970,202305,576,412,164,545182.28,216486.24,761668.52
352980,202305,160,94,66,124088.3,87121.37,211209.67
352990,202305,1032,477,555,629667.06,732613.87,1362280.93
353000,202305,64,31,33,40920.13,43560.08,84480.21
353010,202305,551,330,221,435616.93,291724.39,727341.32
353020,202305,355,230,125,303610.26,166323.35,469933.61
353030,202305,1481,656,825,865954.03,1090345.99,1956300.02
353040,202305,95,49,46,64682.45,60722.21,125404.66
353050,202305,1425,922,503,1217103.65,669242.92,1886346.57
353060,202305,10024,4329,5695,5719789.45,7533308.97,13253098.42
353070,202305,2185,1264,921,1668551.9,1215488.42,2884040.32
353080,202305,1411,746,665,984763.38,880442.37,1865205.75
353090,202305,73,38,35,50161.1,46200,96361.1
353100,202305,47,34,13,44881.34,17161.54,62042.88
353110,202305,2474,825,1649,1090379.93,2178076.99,3268456.92
353120,202305,147,85,62,112200.7,81840,194040.7
353130,202305,912,425,487,561026.31,646804.05,1207830.36
353140,202305,623,284,339,374902.99,447487.1,822390.09
353150,202305,333,167,166,220445.81,219125.02,439570.83
353160,202305,111,84,27,110886.93,35640,146526.93
353170,202305,211,74,137,99001.45,182160.51,281161.96
353180,202305,1403,645,758,851417.76,1001893.31,1853311.07
353190,202305,527,372,155,491062.68,203327.48,694390.16
353200,202305,300,145,155,191402.44,204600.64,396003.08
353205,202305,21,13,8,17160,10560,27720
353210,202305,76,45,31,59401.8,40920.09,100321.89
353215,202305,44,25,19,33000.2,25080,58080.2
353220,202305,87,47,40,62041.46,52800.68,114842.14
353230,202305,163,74,89,97681.96,117480,215161.96
353240,202305,436,187,249,246842.55,328680.99,575523.54
353250,202305,191,96,95,126723,125401.64,252124.64
353260,202305,497,316,181,417136.94,238925.69,656062.63
353270,202305,71,54,17,71283.41,22440,93723.41
353280,202305,122,55,67,73924.5,88444.63,162369.13
353282,202305,137,91,46,120121.42,60720,180841.42
353284,202305,32,23,9,30362.16,11880,42242.16
353286,202305,10,4,6,5280.2,7920.27,13200.47
353290,202305,87,50,37,66001.09,48840,114841.09
353300,202305,481,235,246,310215.25,326049.2,636264.45
353310,202305,39,30,9,39601.45,11881.05,51482.50
353320,202305,43,23,20,30360.81,26400.2,56761.01
353325,202305,49,25,24,33001.69,31680,64681.69
353330,202305,61,40,21,52800.1,27720.38,80520.48
353340,202305,756,278,478,368291.11,630967.6,999258.71
353350,202305,1001,489,512,648143.19,677177.77,1325320.96
353360,202305,113,91,22,120122.33,29040.58,149162.91
353370,202305,119,66,53,87123.07,69960.38,157083.45
353380,202305,28,13,15,17160.2,19800,36960.2
353390,202305,1208,566,642,752434.89,852736.42,1605171.31
353400,202305,58,31,27,40922,35641.47,76563.47
353410,202305,123,66,57,87125.1,75242.47,162367.57
353420,202305,69,34,35,44880,46200,91080
353430,202305,601,389,212,513505.27,279850.1,793355.37
353440,202305,14585,6436,8149,8498368.03,10779181.35,19277549.38
353450,202305,52,25,27,33000.8,35640.2,68641.0
353460,202305,699,362,337,477861.11,444851.08,922712.19
353470,202305,2480,1188,1292,1573509.61,1713369.94,3286879.55
353475,202305,301,193,108,254765.47,143880.91,398646.38
353480,202305,241,175,66,231004.04,87120,318124.04
353490,202305,238,137,101,180846.12,133320.32,314166.44
353500,202305,220,127,93,167643.09,122761.22,290404.31
353510,202305,85,54,31,71281.93,40920.74,112202.67
353520,202305,269,192,77,254763.01,101640,356403.01
353530,202305,521,257,264,339254.08,351125.47,690379.55
353540,202305,393,245,148,323416.29,195365.7,518781.99
353550,202305,813,505,308,666643.79,406573.96,1073217.75
353560,202305,578,234,344,308882.66,456722.41,765605.07
353570,202305,68,47,21,63362.92,27720,91082.92
353580,202305,381,235,146,310206.87,192720,502926.87
353590,202305,97,72,25,95041.69,33000,128041.69
353600,202305,302,171,131,225727.69,172920.28,398647.97
353610,202305,149,81,68,106922.24,89760,196682.24
353620,202305,715,347,368,458051.71,487089.53,945141.24
353625,202305,66,32,34,42241.64,44880.31,87121.95
353630,202305,233,158,75,208567.88,99000.78,307568.66
353640,202305,140,88,52,116165.28,68640.54,184805.82
353650,202305,1162,452,710,596651.57,938529.2,1535180.77
353657,202305,24,18,6,23760,7920,31680
353660,202305,315,163,152,216485.76,200642.99,417128.75
353670,202305,769,430,339,567622.12,447487.72,1015109.84
353680,202305,155,98,57,129360.58,75240,204600.58
353690,202305,45,29,16,38280.67,21121.09,59401.76
353700,202305,305,203,102,267967.81,134641.88,402609.69
353710,202305,599,291,308,385458.29,409201.69,794659.98
353715,202305,43,24,19,31680,25080,56760
353720,202305,328,147,181,194046.25,240242.98,434289.23
353730,202305,1241,725,516,958372.28,682441.61,1640813.89
353740,202305,636,346,290,456738.62,382807.96,839546.58
353750,202305,97,50,47,66002.35,62040,128042.35
353760,202305,3644,1406,2238,1857323.96,2955527.98,4812851.94
353770,202305,79,63,16,83160.7,21120.2,104280.9
353780,202305,1503,676,827,892342.82,1092969.83,1985312.65
353790,202305,532,311,221,410536.01,291726.78,702262.79
353800,202305,4240,1931,2309,2551691.65,3050528.23,5602219.88
353810,202305,256,127,129,167651.52,170280.82,337932.34
353820,202305,290,118,172,155760.85,227041.71,382802.56
353830,202305,76,64,12,84482.74,15840.9,100323.64
353850,202305,224,98,126,129364.15,166321.87,295686.02
353860,202305,578,264,314,348490.37,415804.13,764294.50
353870,202305,6402,3232,3170,4270336.74,4189708.66,8460045.40
353880,202305,783,499,284,658707,374883.57,1033590.57
353890,202305,617,349,268,463342.58,353765.37,817107.95
353900,202305,148,79,69,104281.9,91082.41,195364.31
353910,202305,220,91,129,120122.61,170280.71,290403.32
353920,202305,511,257,254,340568.43,335284.39,675852.82
353930,202305,1122,649,473,856714.39,625682.6,1482396.99
353940,202305,227,109,118,145201.48,157082.24,302283.72
353950,202305,557,357,200,471265.38,264002.89,735268.27
353960,202305,83,67,16,88443.51,21120,109563.51
353970,202305,43,29,14,38280.45,18481.16,56761.61
353980,202305,2198,948,1250,1252721.26,1651341.17,2904062.43
353990,202305,88,55,33,72602.1,43560.61,116162.71
354000,202305,412,183,229,241568.53,302282.21,543850.74
354010,202305,90,51,39,67324.01,52800.69,120124.70
354020,202305,556,347,209,458056.99,275885.24,733942.23
354025,202305,43,36,7,47522.39,9240,56762.39
354030,202305,47,26,21,34322.99,27720.15,62043.14
354040,202305,102,77,25,101644.13,33000,134644.13
354050,202305,165,85,80,112202.09,105601.28,217803.37
354060,202305,899,421,478,557051.37,632283.34,1189334.71
354070,202305,989,545,444,719422.37,591367.47,1310789.84
354075,202305,201,95,106,125403.7,139921.29,265324.99
354080,202305,319,144,175,190085.39,231001.89,421087.28
354085,202305,29,18,11,23761.45,14520,38281.45
354090,202305,299,172,127,226935.03,167640.99,394576.02
354100,202305,6828,2745,4083,3627498.6,5397567.85,9025066.45
354105,202305,108,56,52,73922.41,68640,142562.41
354110,202305,44,22,22,29040,29040.85,58080.85
354120,202305,168,101,67,134644.39,89760.57,224404.96
354130,202305,855,526,329,695670.41,435604.31,1131274.72
354140,202305,3651,1642,2009,2171503.15,2655858.15,4827361.30
354150,202305,695,395,300,521430.92,397327.85,918758.77
354160,202305,722,437,285,576873.5,376210.3,953083.8
354165,202305,13,7,6,9240,7920,17160
354170,202305,191,125,66,165006.41,87120.81,252127.22
354180,202305,55,33,22,43560.4,29040.52,72600.92
354190,202305,305,107,198,141244.22,261361.53,402605.75
354200,202305,121,60,61,79202.49,80522.06,159724.55
354210,202305,79,35,44,46200,58080,104280
354220,202305,643,383,260,505590.81,343208.39,848799.20
354230,202305,183,82,101,108242.47,134640.67,242883.14
354240,202305,355,216,139,285134.27,184800.72,469934.99
354250,202305,81,47,34,62040.32,44880,106920.32
354260,202305,2296,1045,1251,1380765.75,1655308.14,3036073.89
354270,202305,94,66,28,87121.64,36960.5,124082.14
354280,202305,59,33,26,43560.79,34320,77880.79
354290,202305,161,106,55,139926.24,72600,212526.24
354300,202305,343,240,103,316807.14,135962,452769.14
354310,202305,96,67,29,88445.11,38280.6,126725.71
354320,202305,243,109,134,145202.15,176880.3,322082.45
354323,202305,11,8,3,10560,3960,14520
354325,202305,129,70,59,92402.19,77880.6,170282.79
354330,202305,2696,886,1810,1172209.83,2391848.23,3564058.06
354340,202305,11673,5243,6430,6932654.24,8502190.18,15434844.42
354350,202305,154,101,53,133321.15,69960,203281.15
354360,202305,81,47,34,63362.5,44880.59,108243.09
354370,202305,251,123,128,162365.52,168962.71,331328.23
354380,202305,186,104,82,137284.48,108240,245524.48
354390,202305,3031,1088,1943,1438849.15,2567427.05,4006276.20
354400,202305,392,205,187,270606.03,246840.79,517446.82
354410,202305,782,342,440,452777.91,582129.79,1034907.70
354420,202305,300,202,98,266649.1,129362.91,396012.01
354425,202305,361,199,162,262748.84,213842.67,476591.51
354430,202305,134,82,52,108247.73,68640.03,176887.76
354440,202305,29,23,6,30361.14,7920,38281.14
354450,202305,60,41,19,54121.34,25080,79201.34
354460,202305,104,57,47,75247.56,62043.33,137290.89
354470,202305,23,13,10,17161.25,14520.76,31682.01
354480,202305,124,68,56,89761.22,73920.36,163681.58
354490,202305,128,72,56,95043.81,73923.16,168966.97
354500,202305,438,183,255,241563.04,337921.05,579484.09
354510,202305,89,62,27,81843.21,35641.39,117484.60
354515,202305,50,18,32,23762.12,42240.1,66002.22
354520,202305,1891,743,1148,981930.3,1519321.96,2501252.26
354530,202305,921,451,470,596659.49,621721.92,1218381.41
354540,202305,264,131,133,172925.58,175561.57,348487.15
354550,202305,46,25,21,33000.25,27720,60720.25
354560,202305,173,92,81,122761.32,106920,229681.32
354570,202305,146,97,49,128040.58,64680.49,192721.07
354580,202305,2043,950,1093,1255356.13,1442767.27,2698123.40
354600,202305,305,139,166,183487.46,220441,403928.46
354610,202305,66,54,12,71280.99,15840.82,87121.81
354620,202305,77,23,54,30360,72601.29,102961.29
354625,202305,16,11,5,14521.49,6600.72,21122.21
354630,202305,386,263,123,347178.23,162363.19,509541.42
354640,202305,914,532,382,703826.7,505567.09,1209393.79
354650,202305,71,40,31,52802.1,40920,93722.1
354660,202305,904,649,255,858047.41,336602.75,1194650.16
354670,202305,242,92,150,122760.97,198000.2,320761.17
354680,202305,1479,526,953,694339.49,1257968.83,1952308.32
354690,202305,84,51,33,67323.69,43560.27,110883.96
354700,202305,78,54,24,71280.36,31680,102960.36
354710,202305,47,33,14,43560.3,18480,62040.3
354720,202305,23,19,4,25080.4,5280,30360.4
354730,202305,2042,832,1210,1099589.14,1598540.19,2698129.33
354740,202305,74,53,21,69960.6,27720,97680.6
354750,202305,430,233,197,307568.2,261363.23,568931.43
354760,202305,566,349,217,460713.54,287769.16,748482.70
354765,202305,7,3,4,3960,5280,9240
354770,202305,379,242,137,320773.41,180843.84,501617.25
354780,202305,9353,3383,5970,4474923.71,7901565,12376488.71
354790,202305,92,53,39,69960.77,51480.11,121440.88
354800,202305,462,248,214,328754.76,282485.72,611240.48
354805,202305,80,38,42,50161.18,55440.27,105601.45
354810,202305,106,57,49,75241.41,64680,139921.41
354820,202305,230,94,136,124082.35,179523.57,303605.92
354830,202305,44,23,21,30360,27720,58080
354840,202305,56,35,21,46200.28,27720,73920.28
354850,202305,5623,2343,3280,3096855.4,4330973.83,7427829.23
354860,202305,375,162,213,213841.18,282482.01,496323.19
354870,202305,13825,5967,7858,7880633.05,10384517,18265150.05
354880,202305,2936,1061,1875,1400563.19,2480368.2,3880931.39
354890,202305,3383,1779,1604,2349724.63,2119937.01,4469661.64
354900,202305,65,46,19,60721.62,25080.19,85801.81
354910,202305,1434,720,714,951753.53,946441.68,1898195.21
354920,202305,39,33,6,43560.6,7920,51480.6
354925,202305,27,17,10,22440.9,13200,35640.9
354930,202305,38,29,9,38281.92,11880,50161.92
354940,202305,812,559,253,737916.19,333967.44,1071883.63
354950,202305,214,128,86,168964.28,114842.38,283806.66
354960,202305,135,48,87,63361.84,114840.75,178202.59
354970,202305,1296,903,393,1192014.15,518762.37,1710776.52
354980,202305,10573,3838,6735,5072966.69,8898194.24,13971160.93
354990,202305,11749,5171,6578,6827243.05,8693575.43,15520818.48
354995,202305,650,219,431,289084.13,570249.1,859333.23
355000,202305,462,159,303,209883.02,399960.7,609843.72
355010,202305,739,459,280,605921.74,369607.8,975529.54
355020,202305,875,530,345,700940.85,455406.2,1156347.05
355030,202305,239618,88446,151172,116870213.79,199854397.31,316724611.10
355040,202305,1129,554,575,731306.13,760332.68,1491638.81
355050,202305,190,103,87,135962.33,116160,252122.33
355060,202305,2031,946,1085,1248783.02,1437485.74,2686268.76
355070,202305,1823,787,1036,1038867.72,1370178.35,2409046.07
355080,202305,221,130,91,171602.69,120122.18,291724.87
355090,202305,327,201,126,265332.12,166322.31,431654.43
355100,202305,6221,2873,3348,3797697.82,4427330.11,8225027.93
355110,202305,216,141,75,186123.31,99001.12,285124.43
355120,202305,51,32,19,42241.58,25080,67321.58
355130,202305,59,32,27,42241.43,35640,77881.43
355140,202305,217,124,93,163683.72,122760.76,286444.48
355150,202305,778,459,319,607224.95,422405.09,1029630.04
355160,202305,552,260,292,343216.59,385444.69,728661.28
355170,202305,2267,1157,1110,1531271.13,1467854.85,2999125.98
355180,202305,730,285,445,376207.09,590049.79,966256.88
355190,202305,231,156,75,205927.77,100322.57,306250.34
355200,202305,118,56,62,73921.29,81840,155761.29
355210,202305,789,400,389,528009.57,516123.33,1044132.90
355220,202305,8789,4086,4703,5399003.37,6222537.52,11621540.89
355230,202305,99,52,47,69961.5,62041.87,132003.37
355240,202305,5084,1998,3086,2642669.47,4085421.79,6728091.26
355250,202305,7882,3437,4445,4544960.8,5875352.19,10420312.99
355255,202305,51,30,21,39600.62,27720,67320.62
355260,202305,201,113,88,149165.39,116162.3,265327.69
355270,202305,173,112,61,147847.2,80520.98,228368.18
355280,202305,7992,2969,5023,3929765.96,6637052.41,10566818.37
355290,202305,69,52,17,68640.51,22440,91080.51
355300,202305,252,141,111,186126.17,146520.77,332646.94
355310,202305,115,65,50,85800.37,66000,151800.37
355320,202305,111,56,55,73920.6,73920.96,147841.56
355330,202305,353,204,149,269287.51,196683.11,465970.62
355340,202305,1402,520,882,687759.24,1166927.75,1854686.99
355350,202305,181,84,97,110880,128040.2,238920.2
355360,202305,207,135,72,178210.37,95041.29,273251.66
355365,202305,22,17,5,22440.7,6600,29040.7
355370,202305,1118,639,479,844843.03,632284.21,1477127.24
355380,202305,899,527,372,695675.91,491047.62,1186723.53
355385,202305,104,63,41,83160.2,54120,137280.2
355390,202305,111,60,51,79201.41,67320.71,146522.12
355395,202305,216,106,110,139927.24,145204.61,285131.85
355400,202305,1977,1093,884,1444025.16,1168203.23,2612228.39
355410,202305,5786,2567,3219,3392530.84,4254380.57,7646911.41
355420,202305,46,31,15,40920.8,19800,60720.8
355430,202305,490,283,207,373585.51,273248.55,646834.06
355440,202305,100,54,46,71281,60720.7,132001.7
355450,202305,490,255,235,336615.42,311521.71,648137.13
355460,202305,59,42,17,55441.1,22440.8,77881.9
355465,202305,54,29,25,38280.43,33000,71280.43
355470,202305,204,80,124,105601.92,163681.11,269283.03
355475,202305,8,5,3,6600.73,3960,10560.73
355480,202305,695,278,417,366978.81,550445.16,917423.97
355490,202305,113,83,30,109565.38,39602.42,149167.80
355495,202305,122,49,73,64680.1,96361.29,161041.39
355500,202305,1699,912,787,1206515.91,1038845.58,2245361.49
355510,202305,288,198,90,261371.89,118801.25,380173.14
355520,202305,27,19,8,25080.18,10560,35640.18
355530,202305,24,13,11,17160,14520,31680
355535,202305,91,42,49,55442.37,64680,120122.37
355540,202305,3149,1231,1918,1624981.64,2533124.8,4158106.44
355550,202305,71,38,33,50160.95,43560,93720.95
355560,202305,289,127,162,167644.2,213843.01,381487.21
355570,202305,18,12,6,15841.14,7920,23761.14
355580,202305,241,165,76,217811.39,100321.84,318133.23
355590,202305,16,11,5,14520.24,6600,21120.24
355600,202305,292,136,156,180846.28,205922.18,386768.46
355610,202305,259,154,105,203288.28,138603.94,341892.22
355620,202305,1416,590,826,778825.68,1091643.52,1870469.20
355630,202305,440,311,129,410540.33,170281,580821.33
355635,202305,135,55,80,72600.02,105600,178200.02
355640,202305,640,336,304,443530.9,401286.69,844817.59
355645,202305,963,342,621,451457.77,821049.81,1272507.58
355650,202305,2002,866,1136,1144491.96,1500844.15,2645336.11
355660,202305,230,116,114,153123.05,150482.11,303605.16
355670,202305,723,300,423,397325.73,559683.23,957008.96
355680,202305,227,121,106,159729.77,139922.24,299652.01
355690,202305,102,46,56,60721.75,73920.57,134642.32
355695,202305,25,16,9,21120,11880,33000
355700,202305,1447,638,809,842188.87,1069207.08,1911395.95
355710,202305,2478,1365,1113,1801890.72,1470484.94,3272375.66
355715,202305,15,12,3,15842.08,3960.1,19802.18
355720,202305,279,170,109,224406.19,143882.18,368288.37
355730,202305,111,65,46,85801.28,60720.15,146521.43
410010,202305,111,90,21,118803.47,27720,146523.47
410020,202305,121,86,35,113524.17,46200.2,159724.37
410030,202305,204,107,97,142562.73,129364.38,271927.11
410040,202305,1547,726,821,962305.18,1086372.3,2048677.48
410045,202305,42,32,10,42240,13200,55440
410050,202305,556,324,232,427685.15,306240.74,733925.89
410060,202305,218,157,61,208570.43,80520.5,289090.93
410070,202305,258,210,48,277209.57,63361.17,340570.74
410080,202305,201,121,80,159723.74,105600,265323.74
410090,202305,56,47,9,62044.69,11880,73924.69
410100,202305,280,178,102,234964.15,134640.1,369604.25
410105,202305,45,25,20,34320,26400,60720
410110,202305,382,233,149,307573.43,198006.44,505579.87
410115,202305,51,28,23,36960,30360.2,67320.2
410120,202305,499,226,273,298330.04,360365.19,658695.23
410130,202305,71,38,33,50160.99,43560,93720.99
410140,202305,3514,1593,1921,2109419.29,2542345.68,4651764.97
410150,202305,2851,1148,1703,1515399.49,2247980.53,3763380.02
410160,202305,513,295,218,390727.54,287763.67,678491.21
410165,202305,63,40,23,52800.41,30360,83160.41
410170,202305,225,128,97,168963.21,128040.99,297004.20
410180,202305,2618,1354,1264,1787345.24,1668508.14,3455853.38
410185,202305,37,30,7,39600,9240,48840
410190,202305,520,336,184,443531.64,242880.9,686412.54
410200,202305,1153,802,351,1059979.61,463324.19,1523303.80
410210,202305,702,364,338,480493.63,446161.82,926655.45
410220,202305,52,22,30,29040.91,39600,68640.91
410230,202305,215,92,123,121440.72,162362.19,283802.91
410240,202305,766,486,280,644184.19,369602.56,1013786.75
410250,202305,395,264,131,351125.27,172922.22,524047.49
410260,202305,328,181,147,238929.86,194049.15,432979.01
410270,202305,30,20,10,26400.79,13200,39600.79
410275,202305,65,47,18,62041.94,25080,87121.94
410280,202305,339,203,136,267972.66,180840.2,448812.86
410290,202305,284,157,127,207244.8,167640.5,374885.3
410300,202305,98,58,40,76560,52800,129360
410302,202305,28,15,13,19800.05,17160,36960.05
410304,202305,46,31,15,40921.08,19800,60721.08
410305,202305,219,132,87,174246.69,114840.63,289087.32
410310,202305,194,114,80,150484.18,105602.93,256087.11
410315,202305,40,32,8,42240.2,10560,52800.2
410320,202305,150,106,44,139921.24,58080,198001.24
410322,202305,44,26,18,34320.97,23760,58080.97
410330,202305,183,117,66,154443.16,87120,241563.16
410335,202305,109,60,49,79200,64680,143880
410337,202305,47,38,9,50160.5,11880,62040.5
410340,202305,37,30,7,39601.1,9240,48841.1
410345,202305,208,132,76,174242.18,100320.2,274562.38
410347,202305,42,32,10,42240.84,13200.66,55441.50
410350,202305,264,152,112,200645.06,147840,348485.06
410360,202305,485,296,189,390732.07,249481.07,640213.14
410370,202305,2463,1065,1398,1408482.75,1850658.45,3259141.20
410380,202305,210,117,93,154446.49,122761.04,277207.53
410390,202305,435,266,169,351125.08,224400.64,575525.72
410395,202305,30,21,9,27721.37,11880.76,39602.13
410400,202305,1027,428,599,564981.3,792012.11,1356993.41
410405,202305,82,63,19,83165.27,25080.22,108245.49
410410,202305,35,18,17,23762.37,22440.24,46202.61
410420,202305,1983,864,1119,1141709.83,1477099.16,2618808.99
410425,202305,218,91,127,120122.12,167640.2,287762.32
410430,202305,2624,1333,1291,1760921.96,1708099.44,3469021.40
410440,202305,369,262,107,345843.43,141242.19,487085.62
410442,202305,372,231,141,306250.4,187442.42,493692.82
410445,202305,353,246,107,326046.23,141240.76,467286.99
410450,202305,417,196,221,258726.99,291720.13,550447.12
410460,202305,602,322,280,425043.34,373562.01,798605.35
410465,202305,278,153,125,201966.85,165000.89,366967.74
410470,202305,254,145,109,192727.03,143881.44,336608.47
410480,202305,7243,3467,3776,4584506.52,4993615.61,9578122.13
410490,202305,1525,821,704,1086390.13,934569.64,2020959.77
410500,202305,294,176,118,232322.13,155761.25,388083.38
410510,202305,210,156,54,205928.26,71282,277210.26
410520,202305,292,206,86,271920.74,113520,385440.74
410530,202305,281,86,195,113520.85,257400,370920.85
410540,202305,408,294,114,389407.41,151800.61,541208.02
410550,202305,1825,767,1058,1012460.5,1399209.53,2411670.03
410560,202305,189,121,68,159723.95,91080.94,250804.89
410570,202305,462,300,162,396005.84,213841.26,609847.10
410580,202305,4200,1734,2466,2292914.13,3263097.24,5556011.37
410590,202305,466,302,164,398628.21,216480,615108.21
410600,202305,107,90,17,118800.78,22440,141240.78
410610,202305,63,51,12,67320.93,15840,83160.93
410620,202305,297,179,118,236287.28,157081.37,393368.65
410630,202305,494,271,223,357722.92,295680.38,653403.30
410640,202305,1281,798,483,1054698.31,641523.97,1696222.28
410645,202305,115,86,29,113523.66,38280.2,151803.86
410650,202305,394,239,155,316803.36,205922.22,522725.58
410655,202305,90,65,25,85800.6,33000.08,118800.68
410657,202305,40,16,24,21120,31680,52800
410660,202305,697,471,226,624383.49,298323.24,922706.73
410670,202305,76,61,15,81842.22,19800.13,101642.35
410680,202305,197,157,40,207244.87,52800.2,260045.07
410685,202305,38,26,12,34320.49,15840,50160.49
410690,202305,31990,12929,19061,17077300.35,25208330.18,42285630.53
410700,202305,343,245,98,323687.72,129361.74,453049.46
410710,202305,128,106,22,139922.72,29040.2,168962.92
410712,202305,47,32,15,42240.65,19800,62040.65
410715,202305,107,76,31,100323.37,40920,141243.37
410720,202305,708,397,311,524050.04,411842.4,935892.44
410725,202305,205,138,67,183483.38,88440,271923.38
410730,202305,109,46,63,60721.23,83160.73,143881.96
410740,202305,79,59,20,77881.16,26400,104281.16
410750,202305,314,199,115,262685.86,151800.06,414485.92
410752,202305,22,17,5,22440.14,6600,29040.14
410753,202305,65,22,43,29040,56760,85800
410754,202305,61,30,31,39600.87,40920,80520.87
410755,202305,92,46,46,60720.2,60720,121440.2
410760,202305,816,442,374,583445.01,495002.76,1078447.77
410765,202305,2196,977,1219,1289687.17,1615710.73,2905397.90
410770,202305,129,86,43,113522.28,56761.21,170283.49
410773,202305,72,44,28,59401.91,36960,96361.91
410775,202305,226,154,72,203283.59,96360,299643.59
410780,202305,87,50,37,66001.27,48840,114841.27
410785,202305,56,48,8,64681.35,10560,75241.35
410790,202305,89,39,50,51480.2,66000,117480.2
410800,202305,293,180,113,238934.46,149160.84,388095.30
410810,202305,28,17,11,22440,14520.14,36960.14
410820,202305,151,106,45,139924.95,59400.9,199325.85
410830,202305,10365,4118,6247,5442515.76,8254050.17,13696565.93
410832,202305,118,76,42,100322.27,55440.05,155762.32
410840,202305,1558,846,712,1116743.21,942484.75,2059227.96
410845,202305,65,35,30,46200.37,40920,87120.37
410850,202305,159,116,43,153125.02,56760,209885.02
410855,202305,82,74,8,97682.63,10560,108242.63
410860,202305,942,458,484,605888.06,641524.17,1247412.23
410865,202305,95,66,29,87120.9,38280,125400.9
410870,202305,145,117,28,154441.55,38280.79,192722.34
410880,202305,1270,611,659,806538.03,869886.69,1676424.72
410890,202305,126,73,53,96362.11,69960.01,166322.12
410895,202305,80,62,18,81841.44,23760.95,105602.39
410900,202305,37,28,9,36961.41,11880.09,48841.50
410910,202305,15,9,6,11880.95,7920,19800.95
410920,202305,49,29,20,38280,26400,64680
410930,202305,580,348,232,459363.44,306241.89,765605.33
410940,202305,4879,2430,2449,3214335.46,3239328.66,6453664.12
410950,202305,98,74,24,97683.4,31680,129363.4
410960,202305,1069,394,675,520095.13,891011.36,1411106.49
410965,202305,68,48,20,63361.65,26400,89761.65
410970,202305,642,421,221,555730.22,297002.58,852732.80
410975,202305,128,78,50,102962.67,66000,168962.67
410980,202305,1704,770,934,1016435.08,1234213.99,2250649.07
410990,202305,281,202,79,266640.54,105600.98,372241.52
411000,202305,69,39,30,51481.02,39601.23,91082.25
411005,202305,36,31,5,40920,6600,47520
411007,202305,289,165,124,217800.55,163680,381480.55
411010,202305,656,403,253,533291.58,333963.3,867254.88
411020,202305,292,185,107,244206.26,142562.1,386768.36
411030,202305,28,15,13,19800,17160,36960
411040,202305,74,45,29,59400.89,38280,97680.89
411050,202305,217,153,64,201961.24,85800.94,287762.18
411060,202305,577,395,182,525367.85,240242.36,765610.21
411065,202305,43,38,5,50161.14,6600,56761.14
411070,202305,1352,751,601,991338.9,794645.38,1785984.28
411080,202305,272,176,96,232320.13,128040.23,360360.36
411090,202305,87,61,26,80520.4,34320.96,114841.36
411095,202305,363,122,241,161040.55,318120.94,479161.49
411100,202305,113,90,23,118801.66,30360,149161.66
411110,202305,169,88,81,116160.76,106920.2,223080.96
411120,202305,206,136,70,179530.38,92400,271930.38
411125,202305,397,192,205,253449.4,270609.04,524058.44
411130,202305,165,140,25,184802.02,33000,217802.02
411140,202305,220,145,75,191400,99000,290400
411150,202305,1330,843,487,1112783.35,642845.87,1755629.22
411155,202305,120,80,40,105600,52800,158400
411160,202305,37,17,20,22440,26400,48840
411170,202305,60,49,11,64680,14520,79200
411180,202305,1104,717,387,946475.57,512167.14,1458642.71
411190,202305,383,217,166,286444.51,219120,505564.51
411200,202305,718,385,333,508218.96,440884.29,949103.25
411210,202305,720,367,353,484445.21,465963.71,950408.92
411220,202305,167,117,50,154441.88,66001.25,220443.13
411230,202305,33,26,7,34320.7,9240.6,43561.3
411240,202305,114,74,40,97681.53,52800,150481.53
411250,202305,436,315,121,415805.03,159720,575525.03
411260,202305,10,7,3,9240,3960,13200
411270,202305,281,144,137,190087.3,180842.46,370929.76
411275,202305,205,169,36,223083.31,48840,271923.31
411280,202305,294,196,98,258724.42,129360.7,388085.12
411290,202305,71,53,18,69960,23760,93720
411295,202305,136,97,39,128041.72,51480.8,179522.52
411300,202305,88,41,47,54120.82,62040,116160.82
411310,202305,101,71,30,95041.05,39600,134641.05
411320,202305,897,541,356,714133.44,473881.28,1188014.72
411325,202305,59,41,18,55440.1,23760,79200.1
411330,202305,1008,639,369,846143.74,488403.4,1334547.14
411340,202305,38,23,15,30360,19800.09,50160.09
411342,202305,66,52,14,68640,18480,87120
411345,202305,99,47,52,62042.53,68640.95,130683.48
411350,202305,575,424,151,559696.78,199322.78,759019.56
411360,202305,64,41,23,54122.84,30362.5,84485.34
411370,202305,14452,5898,8554,7798220.35,11312518.26,19110738.61
411373,202305,192,129,63,170280.98,83160.17,253441.15
411375,202305,93,75,18,99002.8,23760,122762.8
411380,202305,82,55,27,72604.23,35640,108244.23
411390,202305,173,95,78,125401.67,102960,228361.67
411400,202305,372,235,137,310207.93,180840,491047.93
411410,202305,585,276,309,364326.33,407882.33,772208.66
411420,202305,1022,415,607,547813.39,801245.29,1349058.68
411430,202305,625,313,312,413179.03,411847.44,825026.47
411435,202305,27,19,8,25080,10560,35640
411440,202305,524,415,109,549129.59,145200.7,694330.29
411450,202305,408,330,78,436930.2,102960,539890.2
411460,202305,861,324,537,429014.82,710164.47,1139179.29
411470,202305,117,81,36,108245.43,47520,155765.43
411480,202305,787,394,393,520098.84,520082.73,1040181.57
411490,202305,295,182,113,240244.63,149160.9,389405.53
411500,202305,115,88,27,116161.69,35640,151801.69
411510,202305,243,182,61,240244.75,80521.19,320765.94
411520,202305,6926,2301,4625,3042669.04,6119561.02,9162230.06
411530,202305,128,80,48,105601.05,63360,168961.05
411535,202305,49,14,35,18480.6,46200,64680.6
411540,202305,411,274,137,361686.46,180842.03,542528.49
411545,202305,56,39,17,51480.76,22440,73920.76
411550,202305,88,67,21,89760.43,27720,117480.43
411560,202305,412,166,246,220440.39,324720.15,545160.54
411570,202305,1124,359,765,479046.79,1009812.52,1488859.31
411573,202305,23,15,8,19800.2,10560,30360.2
411575,202305,338,211,127,278523.58,167640,446163.58
411580,202305,1343,462,881,611168.33,1162926.48,1774094.81
411585,202305,73,35,38,47520,50160,97680
411590,202305,12,7,5,9240,6600,15840
411600,202305,16,8,8,10560.7,10560,21120.7
411605,202305,184,69,115,91081.98,151800,242881.98
411610,202305,255,155,100,204604.25,132000.2,336604.45
411620,202305,413,196,217,258733.44,286448.04,545181.48
411630,202305,55,37,18,48840.02,23760.99,72601.01
411640,202305,32,21,11,27720.5,14520,42240.5
411650,202305,6,4,2,5280,2640,7920
411660,202305,48,36,12,47520,15840,63360
411670,202305,249,169,80,223082.52,105601.49,328684.01
411680,202305,172,130,42,171601.85,55440,227041.85
411690,202305,724,377,347,498965.45,462003.23,960968.68
411695,202305,66,44,22,58080.2,30360,88440.2
411700,202305,149,115,34,151804.71,44880,196684.71
411705,202305,107,74,33,97681.98,43560.4,141242.38
411710,202305,296,196,100,260046.19,133320.87,393367.06
411720,202305,162,106,56,139920.5,73920.2,213840.7
411721,202305,96,72,24,95040.2,33000.2,128040.4
411722,202305,106,51,55,67321.04,72600,139921.04
411725,202305,168,119,49,157080.9,64680,221760.9
411727,202305,104,86,18,113524.4,23760.3,137284.7
411729,202305,58,45,13,59401.6,17160,76561.6
411730,202305,594,372,222,492366.55,293042.69,785409.24
411740,202305,27,16,11,21121.08,14520,35641.08
411745,202305,74,55,19,72600,25080,97680
411750,202305,911,373,538,492371.14,710164.82,1202535.96
411760,202305,1378,983,395,1301567.34,521407.72,1822975.06
411770,202305,447,280,167,369604.71,220441.96,590046.67
411780,202305,392,252,140,332641.22,184800.21,517441.43
411790,202305,634,352,282,464652.13,374880.54,839532.67
411800,202305,169,118,51,155765.84,67320.18,223086.02
411810,202305,202,153,49,201964.4,66000.79,267965.19
411820,202305,2894,1111,1783,1469232.62,2358880.18,3828112.80
411830,202305,21,14,7,18480.47,9240,27720.47
411840,202305,2429,1395,1034,1842769.89,1366223.19,3208993.08
411845,202305,74,23,51,30360.9,67320,97680.9
411850,202305,1372,729,643,962306.9,848769.45,1811076.35
411860,202305,68,41,27,54120.99,35640,89760.99
411870,202305,79,48,31,63360,40920,104280
411880,202305,436,262,174,345848.46,231001.53,576849.99
411885,202305,115,73,42,96362.9,55441.88,151804.78
411890,202305,360,248,112,327369.14,147841.68,475210.82
411900,202305,115,84,31,110880.47,40920,151800.47
411910,202305,238,156,82,205927.14,108242.04,314169.18
411915,202305,2698,1033,1665,1367561.49,2199161.07,3566722.56
411920,202305,120,83,37,109562.07,48840.98,158403.05
411925,202305,23,16,7,21120.59,9240,30360.59
411930,202305,847,562,285,744591.94,376205.81,1120797.75
411940,202305,614,380,234,501611.56,308882.93,810494.49
411950,202305,1392,625,767,826355.67,1016421.84,1842777.51
411960,202305,1213,738,475,974174.33,627002.38,1601176.71
411965,202305,20,12,8,15840.62,10560,26400.62
411970,202305,96,82,14,108240.69,18480,126720.69
411980,202305,249,124,125,163680.76,165000,328680.76
411990,202305,5831,3039,2792,4014343.85,3692197.58,7706541.43
411995,202305,700,208,492,274568.52,650778.56,925347.08
412000,202305,364,242,122,319449.9,162362.78,481812.68
412010,202305,67,35,32,46200.9,42240.72,88441.62
412015,202305,37,27,10,35640,13200,48840
412020,202305,24,18,6,23761.22,7920,31681.22
412030,202305,39,34,5,44880.72,6600,51480.72
412033,202305,44,23,21,30361.46,27720,58081.46
412035,202305,68,44,24,58080.55,31680,89760.55
412040,202305,34,18,16,23760.97,21120,44880.97
412050,202305,226,165,61,217807.39,80520.56,298327.95
412060,202305,851,605,246,798626.7,324725.07,1123351.77
412065,202305,58,29,29,38282.03,38280.15,76562.18
412070,202305,148,103,45,135961.9,59400.89,195362.79
412080,202305,364,173,191,228368.88,256084.23,484453.11
412085,202305,38,14,24,18480.83,31680,50160.83
412090,202305,915,547,368,722060.1,487084.37,1209144.47
412100,202305,276,228,48,300970.74,63360,364330.74
412110,202305,75,55,20,73920.5,26400,100320.5
412120,202305,390,204,186,270607.23,245523.39,516130.62
412125,202305,71,39,32,51480.2,42240,93720.2
412130,202305,50,33,17,43562.47,22440,66002.47
412135,202305,31,19,12,25080.2,15840,40920.2
412140,202305,494,323,171,426083.9,227042.45,653126.35
412150,202305,270,157,113,208562.53,149160.73,357723.26
412160,202305,76,51,25,67320.79,33000.2,100320.99
412170,202305,724,462,262,609847.93,345843.6,955691.53
412175,202305,40,25,15,33000.67,19800.5,52801.17
412180,202305,165,120,45,159723.96,59400.2,219124.16
412190,202305,342,267,75,352447.39,99000,451447.39
412200,202305,198,117,81,154441.17,106920,261361.17
412210,202305,103,76,27,100320,35640.73,135960.73
412215,202305,245,162,83,213844.92,109561.28,323406.20
412217,202305,70,55,15,72600.91,19800,92400.91
412220,202305,933,598,335,789389.95,442210.48,1231600.43
412230,202305,299,172,127,228368.63,167645.86,396014.49
412240,202305,1457,714,743,942508.08,984732.75,1927240.83
412250,202305,444,267,177,352444.16,233640,586084.16
412260,202305,137,92,45,121443.58,59400.2,180843.78
412265,202305,167,129,38,170280.83,50160,220440.83
412270,202305,99,58,41,76560.59,54120,130680.59
412280,202305,83,63,20,83160.2,26400,109560.2
412290,202305,93,57,36,75241.84,47520,122761.84
412300,202305,222,156,66,205921.99,87120,293041.99
412310,202305,58,45,13,59401.57,17160,76561.57
412320,202305,95,68,27,89763.96,35640,125403.96
412330,202305,206,153,53,201962.09,69960,271922.09
412340,202305,195,121,74,159720.73,99000,258720.73
412350,202305,731,323,408,426365.23,538563.29,964928.52
412360,202305,23,18,5,23760,6600,30360
412370,202305,151,123,28,162364.09,36960.02,199324.11
412380,202305,193,140,53,186124.59,69960.22,256084.81
412382,202305,60,34,26,44880,34320,79200
412385,202305,171,120,51,158403.72,67320.92,225724.64
412390,202305,340,252,88,332651.65,116161.81,448813.46
412395,202305,71,57,14,75241.54,18480,93721.54
412400,202305,99,66,33,88442.03,43560,132002.03
412402,202305,248,136,112,180841.66,147840.94,328682.60
412405,202305,1006,334,672,440882.55,889682.25,1330564.80
412410,202305,1055,626,429,826354.66,566286.56,1392641.22
412420,202305,16,15,1,19800,1320,21120
412430,202305,26,24,2,31681.68,2640.2,34321.88
412440,202305,750,374,376,493687.58,496321.86,990009.44
412450,202305,64,56,8,73920.85,10560,84480.85
412460,202305,87,57,30,75241.46,39600.19,114841.65
412470,202305,244,194,50,256084.45,66001.33,322085.78
412480,202305,160,118,42,155764.2,55440.2,211204.4
412490,202305,185,153,32,201962.58,42240,244202.58
412500,202305,421,329,92,434289.67,121442.67,555732.34
412510,202305,176,142,34,187444.98,44880,232324.98
412520,202305,93,64,29,84482.29,38280,122762.29
412530,202305,113,51,62,67320.91,81840,149160.91
412535,202305,62,48,14,63361.56,18480,81841.56
412540,202305,55,31,24,40921.65,31680.98,72602.63
412545,202305,95,68,27,89761.41,35640,125401.41
412550,202305,4624,1856,2768,2455422.21,3656461.68,6111883.89
412555,202305,14,7,7,9240,9240,18480
412560,202305,735,471,264,621737.28,349802.18,971539.46
412570,202305,918,398,520,525376.33,691683.58,1217059.91
412575,202305,100,68,32,89761.23,42240,132001.23
412580,202305,189,128,61,168969.75,81842,250811.75
412590,202305,30,26,4,34321.03,5280,39601.03
412600,202305,219,157,62,207244.57,81840.83,289085.40
412610,202305,50,21,29,27721.57,38280,66001.57
412620,202305,130,108,22,142563.38,29040.46,171603.84
412625,202305,2321,1098,1223,1452035.75,1617013.82,3069049.57
412627,202305,63,48,15,63362.3,19800,83162.3
412630,202305,395,264,131,348489.89,172920.52,521410.41
412635,202305,80,23,57,30360,75240,105600
412640,202305,111,79,32,104280.3,43560,147840.3
412650,202305,333,217,116,287765.11,153120.94,440886.05
412660,202305,596,315,281,415804.85,370920.41,786725.26
412665,202305,41,36,5,47520.32,6600,54120.32
412667,202305,283,175,108,231004.92,142560,373564.92
412670,202305,85,63,22,83161.56,29040,112201.56
412680,202305,346,262,84,345849.71,110880.95,456730.66
412690,202305,134,87,47,114842.77,62040,176882.77
412700,202305,194,119,75,157080.41,99000.23,256080.64
412710,202305,1458,792,666,1045463.97,879132.05,1924596.02
412720,202305,258,140,118,184803.66,155760.69,340564.35
412730,202305,184,153,31,203286.46,40920.99,244207.45
412740,202305,430,203,227,267965.82,300960.41,568926.23
412750,202305,434,238,196,315486.1,258720.93,574207.03
412760,202305,393,200,193,264007.55,254764.81,518772.36
412770,202305,2289,1215,1074,1606470.42,1417689.27,3024159.69
412780,202305,145,101,44,133322.53,58080.1,191402.63
412785,202305,327,170,157,224402.45,207240.02,431642.47
412788,202305,60,35,25,46201.95,33000,79201.95
412790,202305,129,104,25,137285.34,33000,170285.34
412795,202305,150,102,48,134643.2,63360,198003.2
412796,202305,315,198,117,261362.62,154440.76,415803.38
412800,202305,764,422,342,559685.51,451440.81,1011126.32
412810,202305,3361,1841,1520,2434156.75,2010385.99,4444542.74
412820,202305,1121,633,488,838227.14,645493.76,1483720.90
412830,202305,15,14,1,18480.2,1320,19800.2
412840,202305,253,165,88,217803.01,116160.2,333963.21
412850,202305,602,391,211,516129.99,278520.68,794650.67
412853,202305,181,81,100,106920.12,133320,240240.12
412855,202305,211,113,98,149162.66,129360.73,278523.39
412860,202305,104,71,33,93723.01,43560.77,137283.78
412862,202305,78,50,28,67320,36960,104280
412863,202305,9,6,3,7920,3960,11880
412865,202305,45,35,10,46200,13200.6,59400.6
412870,202305,123,79,44,104283.32,58081.35,162364.67
412880,202305,97,68,29,89762.21,39600,129362.21
420005,202305,44,37,7,48840.69,9240,58080.69
420010,202305,381,251,130,331325.98,171600.89,502926.87
420020,202305,100,75,25,99002.17,33000,132002.17
420030,202305,30,24,6,31680.2,7920,39600.2
420040,202305,96,74,22,97683.31,29040.2,126723.51
420050,202305,55,37,18,48840.52,23760,72600.52
420055,202305,18,16,2,21120.67,2640,23760.67
420060,202305,33,22,11,29040.79,14520.2,43560.99
420070,202305,111,96,15,126720.6,19800,146520.6
420075,202305,11,11,0,14520,,14520.0
420080,202305,42,36,6,47521.56,7920,55441.56
420090,202305,38,31,7,40920.93,9240.98,50161.91
420100,202305,168,143,25,188763.15,33000,221763.15
420110,202305,26,25,1,33000,1320,34320
420120,202305,65,47,18,62040.44,23760,85800.44
420125,202305,83,61,22,80520.6,29040,109560.6
420127,202305,41,32,9,42240,11880,54120
420130,202305,545,323,222,426376.97,294364.87,720741.84
420140,202305,1489,834,655,1100913.11,865938.76,1966851.87
420150,202305,51,37,14,48840,18480,67320
420160,202305,36,31,5,40920.93,6600,47520.93
420165,202305,19,15,4,19800.79,5280,25080.79
420170,202305,73,41,32,54120.09,42240,96360.09
420180,202305,25,22,3,29040,3960,33000
420190,202305,31,27,4,35640.18,5280,40920.18
420195,202305,137,67,70,88444.41,92402.69,180847.10
420200,202305,1488,612,876,807865.41,1157662.62,1965528.03
420205,202305,136,82,54,108243.87,71280.4,179524.27
420207,202305,164,90,74,118804.32,97681.17,216485.49
420208,202305,21,17,4,22440.21,5280,27720.21
420209,202305,13,11,2,14520,2640,17160
420210,202305,631,299,332,396012.5,438242.05,834254.55
420213,202305,56,39,17,51480.69,22440,73920.69
420215,202305,27,23,4,30361.06,5280,35641.06
420220,202305,64,40,24,52800.29,31680,84480.29
420230,202305,1102,668,434,881804.28,574213.57,1456017.85
420240,202305,2517,1645,872,2174081.23,1153690.71,3327771.94
420243,202305,45,37,8,48841.22,10560,59401.22
420245,202305,255,123,132,162365.78,174244.02,336609.80
420250,202305,69,46,23,60721.38,30360,91081.38
420253,202305,22,17,5,22440.92,6600,29040.92
420257,202305,16,10,6,13200.5,7920,21120.5
420260,202305,135,106,29,139923.31,38280.14,178203.45
420270,202305,37,26,11,34320.19,14520.48,48840.67
420280,202305,308,226,82,298334.61,109560.61,407895.22
420285,202305,25,20,5,26400,6600,33000
420287,202305,48,30,18,39601.42,23760,63361.42
420290,202305,1040,707,333,934578.64,439560.75,1374139.39
420300,202305,1726,1375,351,1815080.31,465966.16,2281046.47
420310,202305,44,32,12,42240.7,15840,58080.7
420315,202305,23,19,4,25080.78,5280.74,30361.52
420320,202305,1145,537,608,708869.3,805213.41,1514082.71
420325,202305,7,4,3,5280,3960.3,9240.3
420330,202305,121,82,39,108240.72,51481.13,159721.85
420340,202305,203,136,67,179522.06,88440,267962.06
420350,202305,273,193,80,254767.84,105600.97,360368.81
420360,202305,708,542,166,716785.8,219122.54,935908.34
420370,202305,148,81,67,106922.47,88440.43,195362.90
420380,202305,1314,877,437,1159006.56,576848.08,1735854.64
420390,202305,227,161,66,212525.51,87120.4,299645.91
420395,202305,201,145,56,191413.92,73922.63,265336.55
420400,202305,228,172,56,228363.59,73920.2,302283.79
420410,202305,56,42,14,55442.43,18480,73922.43
420415,202305,32,25,7,33000.59,9240,42240.59
420417,202305,65,53,12,69960.01,15840,85800.01
420419,202305,13,11,2,14520,2640,17160
420420,202305,3138,1939,1199,2560868.76,1587971.55,4148840.31
420425,202305,75,54,21,71285.12,29040,100325.12
420430,202305,1057,761,296,1004529.26,393362.03,1397891.29
420435,202305,14,11,3,14520,3960,18480
420440,202305,90,65,25,85801.66,33000,118801.66
420445,202305,32,29,3,38280.5,3960,42240.5
420450,202305,91,54,37,71282.05,48840,120122.05
420455,202305,177,134,43,176886.18,56760,233646.18
420460,202305,2554,1571,983,2076444.57,1298896.26,3375340.83
420470,202305,85,54,31,71280.2,40920,112200.2
420475,202305,9,8,1,10560.64,1320,11880.64
420480,202305,951,724,227,955728.53,299641.68,1255370.21
420490,202305,99,73,26,96363.87,34320,130683.87
420500,202305,419,246,173,326051.59,228360.95,554412.54
420510,202305,25,21,4,27720.66,5280,33000.66
420515,202305,28,15,13,19800.58,17160,36960.58
420517,202305,11,8,3,10560.91,3960,14520.91
420519,202305,7,5,2,6600,2640.1,9240.1
420520,202305,65,47,18,62042.09,23760.2,85802.29
420530,202305,143,91,52,120122.37,68640.2,188762.57
420535,202305,16,13,3,17160.41,3960,21120.41
420540,202305,7340,4528,2812,5978834.61,3723764.05,9702598.66
420543,202305,31,30,1,39601.66,1320,40921.66
420545,202305,231,160,71,211208.18,93720.6,304928.78
420550,202305,820,691,129,914797.16,170283.77,1085080.93
420555,202305,36,27,9,35641.14,11880,47521.14
420560,202305,64,49,15,64681.34,19800,84481.34
420570,202305,244,114,130,150483.81,171602.96,322086.77
420580,202305,342,175,167,231007.32,224400.93,455408.25
420590,202305,527,329,198,434291.02,261360.62,695651.64
420600,202305,164,89,75,117481.07,99000,216481.07
420610,202305,38,35,3,46201.5,3960,50161.5
420620,202305,76,60,16,79201.53,21120.41,100321.94
420630,202305,164,109,55,143882.11,72600,216482.11
420640,202305,72,65,7,85800.6,9240,95040.6
420650,202305,347,177,170,234963.26,224401.3,459364.56
420660,202305,42,31,11,40920.45,14520,55440.45
420665,202305,48,32,16,42241.6,21120,63361.6
420670,202305,241,184,57,242888.53,75240,318128.53
420675,202305,15,12,3,15840,3960,19800
420680,202305,35,29,6,38280.12,7920,46200.12
420690,202305,204,149,55,196683.32,74072.43,270755.75
420700,202305,756,488,268,644182.42,353764.18,997946.60
420710,202305,152,83,69,109562.08,91081.75,200643.83
420720,202305,97,79,18,104284.2,23760.12,128044.32
420730,202305,776,455,321,600618.14,423727.8,1024345.94
420740,202305,60,58,2,77882.03,2640,80522.03
420750,202305,521,337,184,447484.02,242880.89,690364.91
420757,202305,18,15,3,19800,3960,23760
420760,202305,39,27,12,36960.86,15840,52800.86
420765,202305,75,52,23,68640.21,30360,99000.21
420768,202305,63,50,13,66002.91,17160,83162.91
420770,202305,75,65,10,85802.75,13200,99002.75
420775,202305,40,33,7,43560.45,9240,52800.45
420780,202305,204,157,47,208562.77,62040,270602.77
420785,202305,29,18,11,23760,14520,38280
420790,202305,140,115,25,151802.54,33000.09,184802.63
420800,202305,63,48,15,63360.67,19800,83160.67
420810,202305,294,221,73,291730.93,97680,389410.93
420820,202305,2870,1592,1278,2101520.45,1689626.71,3791147.16
420830,202305,782,420,362,554425.07,477852.46,1032277.53
420840,202305,134,92,42,121440.61,55440,176880.61
420845,202305,471,205,266,270607.43,352443.17,623050.60
420850,202305,297,228,69,300961.08,92400.3,393361.38
420860,202305,57,49,8,64681.52,10560,75241.52
420870,202305,130,91,39,120120.99,51480,171600.99
420880,202305,200,124,76,163683.72,101640.2,265323.92
420890,202305,1066,527,539,696976.96,712801.33,1409778.29
420895,202305,11,10,1,13200,1320,14520
420900,202305,431,344,87,454088.83,114841.31,568930.14
420910,202305,6431,3518,2913,4646554.97,3855767.09,8502322.06
420915,202305,57,53,4,69960.2,5280,75240.2
420917,202305,23,17,6,22440.54,7920,30360.54
420920,202305,21,15,6,19800,7920,27720
420930,202305,3835,2596,1239,3428116.39,1638157.38,5066273.77
420940,202305,604,418,186,551791.98,245526.86,797318.84
420945,202305,11,8,3,10560,3960,14520
420950,202305,48,35,13,46200.6,18480,64680.6
420960,202305,117,94,23,124084.95,30360.1,154445.05
420970,202305,288,234,54,308895.46,72600.71,381496.17
420980,202305,24,23,1,30360,1320,31680
420985,202305,52,44,8,58081.85,10560,68641.85
420990,202305,93,70,23,92401.11,30361.82,122762.93
421000,202305,66,35,31,46200,40920,87120
421003,202305,31,22,9,29040.63,11880,40920.63
421005,202305,8,6,2,7920.3,2640,10560.3
421010,202305,917,588,329,780152,435609.18,1215761.18
421020,202305,18,17,1,22442.25,1320,23762.25
421030,202305,120,98,22,129361.45,29041.5,158402.95
421040,202305,68,51,17,67322.84,22441.4,89764.24
421050,202305,332,231,101,304922.81,133320,438242.81
421055,202305,16,13,3,17160.2,3960,21120.2
421060,202305,115,63,52,83161.33,68640,151801.33
421070,202305,36,32,4,42241.58,5280,47521.58
421080,202305,48,39,9,51480.58,11880,63360.58
421085,202305,17,13,4,17160,5280,22440
421090,202305,39,29,10,38280.11,13200,51480.11
421100,202305,118,87,31,114841.71,40920.95,155762.66
421105,202305,201,160,41,211207.77,54120.2,265327.97
421110,202305,136,92,44,121444.95,58080,179524.95
421120,202305,200,139,61,183486.78,80520.42,264007.20
421125,202305,16,9,7,11880,9240.52,21120.52
421130,202305,926,556,370,733940.79,489726.03,1223666.82
421140,202305,33,24,9,31680.33,11880,43560.33
421145,202305,44,38,6,50160.34,7920,58080.34
421150,202305,87,67,20,88441.23,26400,114841.23
421160,202305,65,43,22,56760.5,29040.38,85800.88
421165,202305,16,12,4,15840,5280.16,21120.16
421170,202305,169,142,27,188929.03,35640.61,224569.64
421175,202305,198,138,60,182164.43,79201.78,261366.21
421180,202305,40,26,14,34320.42,18480,52800.42
421185,202305,16,13,3,17160.18,3960,21120.18
421187,202305,4,3,1,3960,1320,5280
421189,202305,47,33,14,43560.58,18480,62040.58
421190,202305,2240,1413,827,1867881.27,1092986.03,2960867.30
421200,202305,97,68,29,89763.11,38280,128043.11
421205,202305,24,17,7,22441.44,9240,31681.44
421210,202305,182,130,52,171602.55,68640,240242.55
421220,202305,261,203,58,269284.07,76560.43,345844.50
421223,202305,52,39,13,51481.77,17160,68641.77
421225,202305,79,52,27,68641.92,35641.54,104283.46
421227,202305,66,56,10,73921.69,13200,87121.69
421230,202305,80,53,27,69961.56,35640.18,105601.74
421240,202305,15,13,2,17161.69,2640,19801.69
421250,202305,442,236,206,311528.6,271926.4,583455.0
421260,202305,22,17,5,22440.59,6600,29040.59
421265,202305,12,7,5,9241.62,6600.1,15841.72
421270,202305,55,49,6,64680,7920,72600
421280,202305,430,220,210,290408.41,277202.32,567610.73
421290,202305,317,207,110,273242.58,145200.43,418443.01
421300,202305,23,20,3,26400,3960,30360
421310,202305,52,36,16,47520,21120,68640
421315,202305,33,19,14,25081.03,19800.08,44881.11
421320,202305,142,95,47,125402.91,62040,187442.91
421330,202305,110,83,27,109561.7,35640.99,145202.69
421335,202305,45,32,13,42241.96,17160,59401.96
421340,202305,253,168,85,221764.13,112200.41,333964.54
421350,202305,195,115,80,151803.77,105600.25,257404.02
421360,202305,768,526,242,694336.35,319445.02,1013781.37
421370,202305,205,153,52,201962.13,68640.7,270602.83
421380,202305,155,118,37,155760.95,50160,205920.95
421390,202305,15,10,5,13200,6600,19800
421400,202305,117,96,21,126720,29040,155760
421410,202305,19,16,3,21120,3960,25080
421415,202305,21,19,2,25080,2640,27720
421420,202305,100,84,16,110881.34,21120,132001.34
421430,202305,21,13,8,17160,10560,27720
421440,202305,64,54,10,72601.77,13200.98,85802.75
421450,202305,77,63,14,83160.47,18480,101640.47
421460,202305,54,44,10,58081.38,13200,71281.38
421470,202305,79,42,37,55440.63,48840,104280.63
421480,202305,839,622,217,822375.64,287762.54,1110138.18
421490,202305,24,22,2,29040.78,2640,31680.78
421500,202305,508,290,218,382820.15,287762.25,670582.40
421505,202305,42,34,8,46200.1,10560.2,56760.3
421507,202305,30,24,6,31680.6,7920,39600.6
421510,202305,67,42,25,55441.65,33000.61,88442.26
421520,202305,52,42,10,55440.98,13200,68640.98
421530,202305,53,45,8,59401.28,10560,69961.28
421535,202305,23,21,2,27721.29,2640,30361.29
421540,202305,49,40,9,52800.2,11880,64680.2
421545,202305,85,56,29,73924.39,38280.72,112205.11
421550,202305,315,226,89,298334.94,118801.76,417136.70
421555,202305,15,13,2,17161.56,2640,19801.56
421560,202305,8,7,1,9240,1320,10560
421565,202305,137,86,51,113521.86,67320.57,180842.43
421567,202305,38,28,10,36960,13200,50160
421568,202305,38,36,2,47520,2640,50160
421569,202305,10,10,0,13200.79,,13200.79
421570,202305,272,179,93,236284.79,122761.69,359046.48
421575,202305,27,24,3,31680.6,3960,35640.6
421580,202305,778,459,319,607300.49,422402.37,1029702.86
421590,202305,21,19,2,25080.2,2640,27720.2
421600,202305,185,132,53,174241.01,69960,244201.01
421605,202305,110,75,35,99002.01,46200.2,145202.21
421610,202305,174,127,47,167640.99,62040,229680.99
421620,202305,1120,638,482,843513.5,638890.52,1482404.02
421625,202305,24,21,3,27720.76,3960,31680.76
421630,202305,380,231,149,304932.06,196684.27,501616.33
421635,202305,28,14,14,18480,18480,36960
421640,202305,113,86,27,113524.85,35640,149164.85
421650,202305,349,203,146,267969.76,192722.98,460692.74
421660,202305,2907,1776,1131,2347041.29,1498232.32,3845273.61
421670,202305,159,115,44,151804.12,59400,211204.12
421680,202305,200,179,21,236285.27,27720,264005.27
421690,202305,359,241,118,318126.93,159721.21,477848.14
421700,202305,60,41,19,54120.7,25080,79200.7
421710,202305,22,22,0,29040.59,,29040.59
421715,202305,5,4,1,5280.61,1320,6600.61
421720,202305,673,449,224,592697.54,297002.02,889699.56
421725,202305,33,13,20,17160.6,26400.8,43561.4
421730,202305,23,18,5,23760,6600,30360
421740,202305,117,45,72,59401.4,95040,154441.4
421750,202305,196,142,54,187441.26,72600,260041.26
421755,202305,20,18,2,23760,2640,26400
421760,202305,105,72,33,95043.22,43560.19,138603.41
421770,202305,740,472,268,623065.72,355084.14,978149.86
421775,202305,30,19,11,25080.97,14520.09,39601.06
421780,202305,192,148,44,195360.4,58080,253440.4
421790,202305,157,132,25,174242.14,34320.15,208562.29
421795,202305,16,13,3,17160.33,3960,21120.33
421800,202305,618,366,252,483144.45,333968.61,817113.06
421810,202305,73,60,13,79200.86,17160,96360.86
421820,202305,324,199,125,262683.92,165000,427683.92
421825,202305,172,144,28,190086.67,36960,227046.67
421830,202305,164,100,64,132006.9,84481.04,216487.94
421835,202305,6,2,4,2640,5280,7920
421840,202305,43,35,8,46202.1,10560.15,56762.25
421850,202305,81,68,13,89760.5,17160,106920.5
421860,202305,38,27,11,35640.79,14520,50160.79
421870,202305,1236,877,359,1159007.27,475212.04,1634219.31
421875,202305,52,40,12,52800,15840,68640
421880,202305,203,141,62,186122.93,81840.7,267963.63
421885,202305,20,15,5,19800,6600.84,26400.84
421890,202305,175,125,50,165005.3,66001.74,231007.04
421895,202305,52,45,7,59401.1,9240,68641.1
421900,202305,136,101,35,133328.27,46200,179528.27
421910,202305,71,45,26,59401.26,34320,93721.26
421915,202305,31,24,7,31680,9240,40920
421917,202305,54,42,12,55441.66,15840,71281.66
421920,202305,36,32,4,42240,5280,47520
421930,202305,662,524,138,691699.02,182162.37,873861.39
421935,202305,46,39,7,52800.18,9240,62040.18
421940,202305,51,44,7,58080,9240,67320
421950,202305,956,632,324,835573.9,429003.87,1264577.77
421960,202305,44,36,8,47520.59,10560,58080.59
421970,202305,339,214,125,282485.24,165001.39,447486.63
421985,202305,19,12,7,15840.2,9240,25080.2
422000,202305,12,6,6,7920.2,7920.7,15840.9
430003,202305,199,60,139,79200.6,183480,262680.6
430005,202305,32,25,7,33000.82,9240,42240.82
430010,202305,263,195,68,257403.45,89760,347163.45
430020,202305,141,101,40,133322.13,52800.24,186122.37
430030,202305,133,107,26,142561.59,34320,176881.59
430040,202305,3096,1808,1288,2389242.38,1702803.58,4092045.96
430045,202305,77,68,9,89760,11880,101640
430047,202305,8,7,1,9240,1320,10560
430050,202305,91,76,15,100321.28,19800,120121.28
430055,202305,14,12,2,15840,2640,18480
430057,202305,5,3,2,3960,2640,6600
430060,202305,4547,2614,1933,3451629.69,2556864.71,6008494.40
430063,202305,60,47,13,62040,17160,79200
430064,202305,170,136,34,179520.99,46200,225720.99
430066,202305,7,4,3,5280,3960,9240
430070,202305,44,34,10,44880.16,13200,58080.16
430080,202305,87,58,29,76560.15,38280.18,114840.33
430085,202305,30,14,16,18480,21120,39600
430087,202305,37,28,9,36960.08,11880,48840.08
430090,202305,69,58,11,76560.76,14520,91080.76
430100,202305,158,107,51,141240.64,68640,209880.64
430105,202305,181,97,84,128048.44,110880.3,238928.74
430107,202305,22,17,5,22440.37,6600,29040.37
430110,202305,507,274,233,361681.04,307560,669241.04
430120,202305,182,166,16,219120.1,21120,240240.1
430130,202305,852,501,351,661327.45,465962,1127289.45
430140,202305,141,130,11,171600,14520,186120
430150,202305,118,72,46,95040.13,60720,155760.13
430155,202305,30,25,5,33000,6600,39600
430160,202305,3998,2222,1776,2935755.76,2348295.54,5284051.30
430163,202305,468,222,246,293049.78,324723.51,617773.29
430165,202305,31,19,12,25080.59,15840,40920.59
430170,202305,86,71,15,93720,19800,113520
430175,202305,85,66,19,87120,25080,112200
430180,202305,114,85,29,112200.92,38280,150480.92
430185,202305,26,18,8,23760,10560,34320
430187,202305,97,36,61,47522.3,80520,128042.3
430190,202305,246,122,124,161044.53,163682.29,324726.82
430192,202305,13,10,3,13200.8,3960,17160.8
430195,202305,17,13,4,17160.9,5280,22440.9
430200,202305,162,134,28,176884.71,36960,213844.71
430205,202305,19,19,0,25080,,25080.0
430210,202305,810,597,213,790694.07,282480.7,1073174.77
430215,202305,10,10,0,13200,,13200.0
430220,202305,79,53,26,69960,34320,104280
430222,202305,16,6,10,7920,13200,21120
430223,202305,17,11,6,14520,7920,22440
430225,202305,4,2,2,2640,2640,5280
430230,202305,368,229,139,302281.07,183480,485761.07
430235,202305,53,33,20,43560.11,26400,69960.11
430237,202305,22,15,7,19800,9240,29040
430240,202305,122,82,40,108241.35,54120,162361.35
430245,202305,69,56,13,73920,17160,91080
430250,202305,193,112,81,147842.17,106920.84,254763.01
430258,202305,12,9,3,11880.38,3960.2,15840.58
430260,202305,38,34,4,44880.1,5280,50160.1
430265,202305,38,34,4,44880,5280,50160
430270,202305,556,387,169,510855.95,223080,733935.95
430280,202305,1151,663,488,876487.87,646800.3,1523288.17
430290,202305,466,240,226,316804.97,298320,615124.97
430300,202305,2312,1253,1059,1654007.6,1403175.83,3057183.43
430310,202305,2365,1170,1195,1544466.48,1581393.33,3125859.81
430320,202305,60,49,11,64680,14520,79200
430330,202305,89,75,14,99000.26,18480,117480.26
430340,202305,73,58,15,76560,19800,96360
430350,202305,1791,1116,675,1473135.79,893641.55,2366777.34
430355,202305,20,18,2,23760,2640,26400
430360,202305,108,54,54,71280,71280,142560
430367,202305,52,37,15,48840,19800,68640
430370,202305,64,56,8,73920,10560,84480
430380,202305,111,78,33,104281.65,43560,147841.65
430390,202305,723,429,294,568852.22,388084.77,956936.99
430400,202305,260,177,83,234960.91,110880,345840.91
430410,202305,53,44,9,58080.2,11880,69960.2
430420,202305,567,365,202,481810.72,266641.49,748452.21
430430,202305,50,46,4,59840.88,5280,65120.88
430435,202305,155,112,43,147840.99,56760,204600.99
430440,202305,656,396,260,522732,343201.67,865933.67
430450,202305,1303,1059,244,1397901.24,322081.7,1719982.94
430460,202305,6504,3275,3229,4332384.74,4270252.09,8602636.83
430461,202305,19,17,2,22440,2640,25080
430462,202305,4,2,2,2640.1,2640,5280.1
430463,202305,1339,717,622,947783.92,823688.06,1771471.98
430465,202305,27,16,11,21120,14520,35640
430466,202305,804,564,240,744507.07,318127.57,1062634.64
430467,202305,132,74,58,97680.5,76560,174240.5
430468,202305,158,88,70,116161.5,92400.73,208562.23
430469,202305,21,14,7,18480.04,9240,27720.04
430470,202305,1248,677,571,896684.65,756364.21,1653048.86
430471,202305,85,59,26,77881.12,34320.57,112201.69
430480,202305,151,105,46,139921.84,60720,200641.84
430485,202305,8,8,0,10560,,10560.0
430490,202305,71,56,15,73920,21120,95040
430495,202305,33,24,9,31680.2,11880,43560.2
430500,202305,197,130,67,171600,88440,260040
430510,202305,4245,2713,1532,3586507.11,2030171.08,5616678.19
430511,202305,14,14,0,18480,,18480.0
430512,202305,184,124,60,163683.01,79200.4,242883.41
430513,202305,55,42,13,55440,17160,72600
430515,202305,24,22,2,29040.2,2640,31680.2
430517,202305,185,156,29,205920.2,38280,244200.2
430520,202305,348,240,108,316804.55,142560.25,459364.80
430530,202305,83,44,39,58080.7,51480,109560.7
430535,202305,501,318,183,421085.18,241564.02,662649.20
430537,202305,8,8,0,10560,,10560.0
430540,202305,80,53,27,69960,35640,105600
430543,202305,458,148,310,195360.24,409200.71,604560.95
430544,202305,55,51,4,67321.2,5280,72601.2
430545,202305,488,237,251,314179.19,332649.27,646828.46
430550,202305,46,36,10,47520.37,13200,60720.37
430558,202305,1,1,0,1320,,1320.0
430560,202305,54,32,22,42240,30360,72600
430570,202305,124,52,72,68642.92,95040,163682.92
430580,202305,125,100,25,132000.67,33000,165000.67
430583,202305,13,13,0,17160,,17160.0
430585,202305,15,11,4,14520.88,5280,19800.88
430587,202305,14,9,5,11880,6600.72,18480.72
430590,202305,196,158,38,208561.69,50160,258721.69
430593,202305,1,1,0,1320,,1320.0
430595,202305,18,14,4,18480,5280,23760
430597,202305,43,25,18,33000.21,23760,56760.21
430600,202305,232,170,62,224400,81840,306240
430605,202305,189,115,74,151800,97680,249480
430607,202305,32,25,7,33000,9240,42240
430610,202305,1906,899,1007,1186700.7,1330564.05,2517264.75
430613,202305,5,5,0,6600,,6600.0
430620,202305,101,70,31,92400.34,40920,133320.34
430630,202305,49,42,7,55441.13,9240,64681.13
430632,202305,31,27,4,35640,5280,40920
430635,202305,38,30,8,39600,10560,50160
430637,202305,69,31,38,40920,50160,91080
430640,202305,176,99,77,130685.86,102960.54,233646.40
430642,202305,17,15,2,19800,2640,22440
430645,202305,34,28,6,36960,7920,44880
430650,202305,241,194,47,257403.86,63360.2,320764.06
430655,202305,14,11,3,14520,3960,18480
430660,202305,1054,518,536,686414.79,707528.01,1393942.80
430670,202305,69,47,22,62040,30360,92400
430673,202305,84,57,27,75240,35640,110880
430675,202305,9,7,2,9240,2640,11880
430676,202305,698,423,275,558374.77,363003.78,921378.55
430680,202305,261,170,91,224401.92,121440,345841.92
430690,202305,588,353,235,467286.67,310202.73,777489.40
430692,202305,8,6,2,7920.7,2640,10560.7
430693,202305,141,90,51,118800.95,67320.2,186121.15
430695,202305,69,53,16,69960,21120,91080
430697,202305,67,42,25,56760,33000,89760
430700,202305,1435,963,472,1275138.74,627000.31,1902139.05
430705,202305,32,27,5,35640.7,6600,42240.7
430710,202305,279,173,106,228360,139920,368280
430720,202305,98,81,17,106920,22440,129360
430730,202305,156,132,24,174240,31680,205920
430740,202305,87,52,35,68640.3,46200,114840.3
430745,202305,27,16,11,21120,14520,35640
430750,202305,323,207,116,274561.76,153120.84,427682.60
430755,202305,84,47,37,62040.93,48840,110880.93
430760,202305,460,252,208,332647.42,278522.55,611169.97
430770,202305,1821,994,827,1312118.5,1092969.18,2405087.68
430780,202305,388,235,153,310200.48,201960,512160.48
430781,202305,26,26,0,34320,,34320.0
430783,202305,62,45,17,59400,22440,81840
430786,202305,8,6,2,7920,2640,10560
430790,202305,571,352,219,465966.65,290403.48,756370.13
430800,202305,171,125,46,165000,60720,225720
430805,202305,38,31,7,40920,9240,50160
430807,202305,77,44,33,58080,43560,101640
430810,202305,80,52,28,68641.37,36960,105601.37
430820,202305,161,103,58,135962.81,76560,212522.81
430825,202305,11,9,2,11880,2640,14520
430830,202305,276,255,21,336601.66,27720,364321.66
430840,202305,149,99,50,130680.7,66000,196680.7
430843,202305,8,5,3,6600,3960,10560
430845,202305,84,49,35,64680,46200,110880
430850,202305,615,434,181,572883.2,238920,811803.2
430860,202305,184,123,61,163681.97,80520.85,244202.82
430865,202305,79,43,36,56760,47520,104280
430870,202305,73,60,13,79200.49,17160,96360.49
430880,202305,185,126,59,166324.08,79200.8,245524.88
430885,202305,11,9,2,11880,2640,14520
430890,202305,352,210,142,277201.26,187440,464641.26
430900,202305,565,388,177,514806.67,233640.1,748446.77
430905,202305,150,66,84,87120.57,110881.35,198001.92
430910,202305,317,170,147,224402.59,195360.8,419763.39
430912,202305,5,5,0,6600.32,,6600.32
430915,202305,43,40,3,52800,3960,56760
430920,202305,5256,2705,2551,3578671.05,3375297.75,6953968.80
430925,202305,7,6,1,7920,1320,9240
430930,202305,2325,1292,1033,1706795.13,1364886.15,3071681.28
430940,202305,287,182,105,240240.62,139921.1,380161.72
430950,202305,164,131,33,172922.19,43560,216482.19
430955,202305,27,16,11,21120.7,14520,35640.7
430957,202305,24,22,2,29040.11,2640,31680.11
430960,202305,278,181,97,238921.2,129361.07,368282.27
430965,202305,112,72,40,95040.09,52800,147840.09
430970,202305,93,73,20,96360,26400,122760
430975,202305,55,48,7,63360.86,9240,72600.86
430980,202305,55,33,22,43560.7,29040,72600.7
430990,202305,100,78,22,102960,29040,132000
430995,202305,117,107,10,141240,13200,154440
431000,202305,308,151,157,199321.2,208560,407881.2
431010,202305,380,226,154,299654.53,203283.03,502937.56
431020,202305,2043,1168,875,1543102.76,1161602.83,2704705.59
431030,202305,42,33,9,43560,11880,55440
431033,202305,521,234,287,308902.87,378855.37,687758.24
431036,202305,12,8,4,10560,5280,15840
431040,202305,154,105,49,138600.42,64680,203280.42
431041,202305,46,29,17,38280,22440,60720
431043,202305,40,23,17,30360.42,22440,52800.42
431046,202305,12,9,3,11880,3960,15840
431050,202305,212,132,80,174240.74,105600,279840.74
431053,202305,76,42,34,55441.14,44881.05,100322.19
431055,202305,65,42,23,55440,30360,85800
431057,202305,20,20,0,26400,,26400.0
431060,202305,1674,1062,612,1404495.48,807842.59,2212338.07
431065,202305,19,9,10,11880,13200,25080
431070,202305,66,57,9,75240.27,11880,87120.27
431075,202305,7,7,0,9240,,9240.0
431080,202305,134,72,62,95040.54,81840,176880.54
431085,202305,38,33,5,43560.56,6600,50160.56
431087,202305,17,13,4,17160,5280,22440
431090,202305,49,39,10,52800.3,13200,66000.3
431100,202305,1357,804,553,1063942.15,731283.59,1795225.74
431110,202305,235,144,91,190083.76,120120,310203.76
431112,202305,30,24,6,31680.33,7920,39600.33
431113,202305,31,19,12,25080.82,15840,40920.82
431115,202305,154,109,45,143880.66,59400,203280.66
431120,202305,625,365,260,483126.73,344520,827646.73
431123,202305,5,5,0,6600,,6600.0
431125,202305,99,86,13,113520,17160,130680
431127,202305,5,3,2,3960,2640,6600
431130,202305,747,479,268,632288.38,356403.72,988692.10
431140,202305,882,620,262,819727.61,347160.8,1166888.41
431142,202305,16,15,1,19800.56,1320,21120.56
431150,202305,206,144,62,190082.29,81840,271922.29
431160,202305,43,38,5,50160.7,6600,56760.7
431162,202305,6,6,0,7920.74,,7920.74
431164,202305,7,6,1,7920,1320,9240
431170,202305,122,85,37,112200.2,48840,161040.2
431171,202305,76,44,32,58080,42240,100320
431173,202305,6,5,1,6600,1320.8,7920.8
431175,202305,211,111,100,146520.88,132000.67,278521.55
431177,202305,111,75,36,99001.42,47520.31,146521.73
431179,202305,16,11,5,14520,6600,21120
431180,202305,419,259,160,343204.05,212520,555724.05
431190,202305,73,55,18,72600.6,23760.7,96361.3
431198,202305,76,52,24,69823.59,31680,101503.59
431200,202305,23,18,5,23760,6600,30360
431205,202305,24,22,2,29040.7,2640,31680.7
431210,202305,112,68,44,89760.7,58080,147840.7
431213,202305,32,26,6,34320,7920.56,42240.56
431215,202305,24,22,2,29040,2640,31680
431217,202305,6,5,1,6600,1320,7920
431220,202305,70,58,12,77881.07,15840,93721.07
431225,202305,181,110,71,145200.28,93720,238920.28
431230,202305,105,84,21,110883.48,27720,138603.48
431235,202305,5,4,1,5280,1320,6600
431237,202305,17,12,5,15840.1,6600,22440.1
431238,202305,15,10,5,14520,6600.2,21120.2
431240,202305,1051,642,409,851430.32,539881.96,1391312.28
431242,202305,42,41,1,54120,1320,55440
431244,202305,39,33,6,43561.46,7920,51481.46
431245,202305,59,45,14,59400.87,18480,77880.87
431247,202305,19,10,9,13200,11880,25080
431250,202305,321,155,166,204601.4,219120,423721.4
431260,202305,54,46,8,60720,10560,71280
431261,202305,23,16,7,21120.75,9240,30360.75
431262,202305,14,12,2,15840,2640,18480
431265,202305,152,88,64,116160.57,85800,201960.57
431267,202305,19,16,3,21120,3960,25080
431270,202305,352,268,84,353764.68,110881.4,464646.08
431275,202305,41,37,4,48840,5280,54120
431280,202305,21,16,5,21120,6600,27720
431290,202305,29,26,3,34320.65,3960,38280.65
431295,202305,4,1,3,1320,3960,5280
431300,202305,25,21,4,27720.6,5280,33000.6
431301,202305,7,7,0,9240,,9240.0
431303,202305,61,39,22,51480,29040,80520
431306,202305,248,123,125,162361.89,166320,328681.89
431308,202305,8,7,1,9240.6,1320,10560.6
431310,202305,63,48,15,63360.38,19800,83160.38
431320,202305,246,151,95,199321.32,126720,326041.32
431330,202305,232,156,76,207241.87,100320,307561.87
431333,202305,25,21,4,27720,5280,33000
431335,202305,10,7,3,9240.19,3960,13200.19
431337,202305,476,233,243,312851.95,322083.39,634935.34
431339,202305,28,20,8,26400,10560,36960
431340,202305,3416,1826,1590,2418195.51,2104089.86,4522285.37
431342,202305,37,25,12,33000,15840,48840
431344,202305,24,24,0,31680,,31680.0
431346,202305,5,4,1,5280,1320,6600
431349,202305,29,27,2,35640,2640,38280
431350,202305,1028,576,452,761667.22,596645.14,1358312.36
431360,202305,59,42,17,55440,22440,77880
431365,202305,401,175,226,231003.53,299640.49,530644.02
431370,202305,1277,710,567,937222.02,751084.09,1688306.11
431380,202305,105,92,13,121442.34,17160,138602.34
431390,202305,517,285,232,376203.72,306240.37,682444.09
431395,202305,339,148,191,195361.6,252120,447481.6
431400,202305,37,23,14,30360,18480,48840
431402,202305,96,71,25,93721.8,33000.56,126722.36
431403,202305,30,20,10,26400.09,13200,39600.09
431405,202305,774,451,323,596663.6,427684.96,1024348.56
431406,202305,37,29,8,38280.86,10560,48840.86
431407,202305,50,38,12,50160,15840,66000
431410,202305,3781,2318,1463,3069081.11,1936462.39,5005543.50
431413,202305,17,13,4,17160,5280,22440
431415,202305,82,59,23,77881.38,30360,108241.38
431417,202305,23,13,10,17160,13200,30360
431420,202305,396,262,134,345845.58,176880.1,522725.68
431430,202305,70,32,38,42241.64,50160,92401.64
431440,202305,10062,6742,3320,8910325.43,4389110.27,13299435.70
431442,202305,28,15,13,19800,18480,38280
431445,202305,32,30,2,40920,2640,43560
431446,202305,5,5,0,6600.04,,6600.04
431447,202305,91,70,21,92400.9,27720,120120.9
431449,202305,65,52,13,68640.59,17160,85800.59
431450,202305,446,293,153,386761.23,201960,588721.23
431454,202305,12,7,5,9240,6600,15840
431455,202305,48,38,10,50160.03,13200,63360.03
431460,202305,517,349,168,460688.69,221760,682448.69
431470,202305,141,103,38,135960.25,50160,186120.25
431475,202305,10,8,2,10560,2640,13200
431477,202305,41,25,16,33000,21120,54120
431478,202305,7,7,0,9240,,9240.0
431480,202305,783,472,311,624379.43,410522.05,1034901.48
431490,202305,33442,18605,14837,24592198.67,19619394.17,44211592.84
431500,202305,80,59,21,77880,27720,105600
431505,202305,32,23,9,30360.85,11880,42240.85
431507,202305,9,8,1,10560,1320,11880
431510,202305,243,172,71,227041.16,93720,320761.16
431513,202305,20,19,1,25081.25,1320,26401.25
431514,202305,5,3,2,3960,2640,6600
431515,202305,84,72,12,95040.65,15840,110880.65
431517,202305,6,4,2,5280,2640,7920
431520,202305,41,33,8,43560.2,10560,54120.2
431530,202305,1461,632,829,834250.63,1095601.13,1929851.76
431531,202305,24,22,2,29040.7,2640,31680.7
431532,202305,39,28,11,36960,14520,51480
431535,202305,29,16,13,21120,17160,38280
431540,202305,143,112,31,147843.12,40920,188763.12
431545,202305,15,12,3,15840,3960,19800
431550,202305,373,193,180,254765.44,237601.49,492366.93
431555,202305,19,15,4,19800.5,5280,25080.5
431560,202305,5303,3505,1798,4629423.68,2373412.16,7002835.84
431570,202305,927,492,435,650774.85,576845.22,1227620.07
431575,202305,60,36,24,47520,31680.58,79200.58
431580,202305,82,60,22,79200,29040,108240
431590,202305,151,125,26,166320.71,34320,200640.71
431595,202305,19,17,2,22440,2640,25080
431600,202305,270,156,114,205925.94,150481.67,356407.61
431610,202305,125,93,32,122762.47,42240.2,165002.67
431620,202305,35,28,7,36960,9240,46200
431630,202305,123,98,25,129360.79,33000,162360.79
431640,202305,1360,834,526,1100895.07,694321.01,1795216.08
431642,202305,33,29,4,38280,5280,43560
431643,202305,45,18,27,23760,35640,59400
431645,202305,347,205,142,270601.13,187440,458041.13
431647,202305,14,13,1,17160,1320,18480
431650,202305,36,21,15,27720,19800,47520
431660,202305,261,168,93,221760.73,124080,345840.73
431670,202305,240,102,138,134641.78,182160.11,316801.89
431673,202305,12,10,2,13200,2640,15840
431675,202305,27,20,7,26400,9240,35640
431680,202305,1262,903,359,1192004.07,473885.39,1665889.46
431690,202305,5486,3172,2314,4195094.32,3059808.95,7254903.27
431695,202305,18,11,7,14520,9240,23760
431697,202305,5,3,2,3960,2640,6600
431700,202305,202,149,53,198000.55,69960,267960.55
431710,202305,4474,1894,2580,2501438.62,3406934.63,5908373.25
431720,202305,1325,814,511,1076473.46,675840.53,1752313.99
431725,202305,3,1,2,1320,2640,3960
431730,202305,1272,831,441,1096979.84,583450.21,1680430.05
431740,202305,1385,679,706,896293.58,934563.44,1830857.02
431750,202305,1901,1235,666,1632870.86,880445.4,2513316.26
431755,202305,5,4,1,5280,1320,6600
431760,202305,1050,661,389,873862.02,513485.8,1387347.82
431770,202305,430,288,142,380161.22,187440,567601.22
431775,202305,26,18,8,23760,10560,34320
431780,202305,602,365,237,483122.93,314160,797282.93
431790,202305,150,116,34,153121.46,44880.1,198001.56
431795,202305,14,12,2,15840,2640,18480
431800,202305,3251,1679,1572,2218961.07,2079009.4,4297970.47
431805,202305,20,16,4,21120,5280,26400
431810,202305,596,383,213,505567.3,281160.02,786727.32
431820,202305,371,206,165,273241.01,217800,491041.01
431830,202305,2474,1496,978,1979958.53,1292283.18,3272241.71
431840,202305,532,338,194,446173.53,257400.58,703574.11
431842,202305,35,28,7,36960,9240,46200
431843,202305,9,7,2,9240.23,2640,11880.23
431844,202305,17,13,4,17160,5280,22440
431845,202305,26,24,2,31680,2640,34320
431846,202305,28,24,4,31680.72,5280,36960.72
431848,202305,13,10,3,13200.6,3960,17160.6
431849,202305,7,6,1,7920,1320,9240
431850,202305,867,678,189,896304.27,249482.31,1145786.58
431860,202305,116,74,42,97680.74,55440,153120.74
431861,202305,4,0,4,,5280,5280.0
431862,202305,69,50,19,66000.82,25080,91080.82
431870,202305,4172,2399,1773,3173398.8,2345673.68,5519072.48
431880,202305,1060,733,327,967574.04,431641.29,1399215.33
431890,202305,1295,736,559,971532.27,740521.08,1712053.35
431900,202305,197,130,67,171600.59,88440,260040.59
431910,202305,46,36,10,47520.1,13200,60720.1
431912,202305,55,38,17,50161.46,22440,72601.46
431915,202305,161,122,39,161041.77,51480,212521.77
431920,202305,161,114,47,150480.35,62040,212520.35
431930,202305,78,61,17,80520,22440,102960
431935,202305,5,4,1,5280,1320,6600
431936,202305,2,2,0,2640,,2640.0
431937,202305,23,18,5,23760.2,6600,30360.2
431940,202305,487,338,149,446171.38,196680.53,642851.91
431950,202305,520,326,194,431655.45,256081,687736.45
431960,202305,776,429,347,566290.63,458040,1024330.63
431970,202305,64,58,6,76560.54,7920,84480.54
431971,202305,5,4,1,5280,1320,6600
431973,202305,19,16,3,21120.7,3960,25080.7
431975,202305,10,10,0,13200.2,,13200.2
431980,202305,218,122,96,161041.18,128040,289081.18
431990,202305,1049,563,486,744505.02,641533.56,1386038.58
432000,202305,2148,1148,1000,1515427.6,1323976.88,2839404.48
432010,202305,265,171,94,225721.37,124080.2,349801.57
432020,202305,200,169,31,223082.68,40920.4,264003.08
432023,202305,15,13,2,17160,2640,19800
432026,202305,62,54,8,71280.1,10560,81840.1
432030,202305,56,24,32,31680.2,42240,73920.2
432032,202305,15,12,3,15840,3960,19800
432035,202305,76,56,20,73920.4,26400,100320.4
432040,202305,88,61,27,80520.99,35640,116160.99
432045,202305,3,3,0,3960,,3960.0
432050,202305,84,52,32,68640.69,42240,110880.69
432055,202305,139,96,43,126721.6,56760,183481.6
432057,202305,7,4,3,5280.7,3960,9240.7
432060,202305,31,26,5,34320,6600,40920
432065,202305,34,29,5,38280,6600,44880
432067,202305,84,77,7,101640.67,9240,110880.67
432070,202305,401,319,82,421085.42,109560,530645.42
432080,202305,880,620,260,821075.55,343202.38,1164277.93
432085,202305,21,18,3,23760,3960,27720
432090,202305,288,190,98,250800.2,129360.33,380160.53
432100,202305,180,112,68,147840.21,89760,237600.21
432110,202305,594,392,202,518767.38,266640.04,785407.42
432120,202305,1129,635,494,840859.34,652084.14,1492943.48
432130,202305,555,389,166,513483.31,220440,733923.31
432132,202305,22,20,2,26400,2640,29040
432135,202305,84,65,19,85801.22,25080,110881.22
432140,202305,282,210,72,278521.75,95040,373561.75
432143,202305,237,143,94,190082.91,124080.24,314163.15
432145,202305,324,226,98,298324.65,130680.69,429005.34
432146,202305,18,16,2,21120,2640,23760
432147,202305,101,61,40,80520,52800,133320
432149,202305,13,12,1,15840,1320,17160
432150,202305,1176,740,436,978144.31,576844.46,1554988.77
432160,202305,2180,1105,1075,1458637.96,1420333,2878970.96
432162,202305,7,4,3,5280,3960,9240
432163,202305,16,11,5,14520,6600,21120
432166,202305,136,94,42,124412.96,55441.73,179854.69
432170,202305,250,130,120,172925.6,158400.9,331326.5
432180,202305,592,376,216,496321.33,286440,782761.33
432183,202305,14,13,1,17160.7,1320,18480.7
432185,202305,83,67,16,88440.44,21120.61,109561.05
432190,202305,560,328,232,432960.85,306240.03,739200.88
432195,202305,96,75,21,99000.7,27720,126720.7
432200,202305,471,286,185,377527.26,244201.9,621729.16
432210,202305,120,70,50,93720.1,66000,159720.1
432215,202305,32,30,2,39600,2640,42240
432218,202305,21,21,0,27720,,27720.0
432220,202305,698,348,350,459368.48,462003.26,921371.74
432225,202305,20,15,5,19800.2,6600,26400.2
432230,202305,127,81,46,106920,60720.7,167640.7
432232,202305,31,28,3,36960,3960,40920
432234,202305,5,3,2,3960,2640,6600
432235,202305,2,2,0,2640,,2640.0
432237,202305,23,16,7,21120,9240,30360
432240,202305,4876,2706,2170,3573334.63,2872359.78,6445694.41
432250,202305,1240,827,413,1091655.47,546481.74,1638137.21
432252,202305,52,48,4,63360,5280,68640
432253,202305,75,57,18,75241.4,23760,99001.4
432254,202305,32,16,16,21120,21120,42240
432255,202305,11,10,1,13200,1320,14520
432260,202305,930,749,181,991339.37,241560.1,1232899.47
432270,202305,233,173,60,228372.87,80522.12,308894.99
432280,202305,182,138,44,182165.14,58080,240245.14
432285,202305,1,1,0,1320,,1320.0
432290,202305,60,49,11,64680,14520,79200
432300,202305,5626,3005,2621,3971907.21,3461071.18,7432978.39
432310,202305,134,112,22,147840.96,29040,176880.96
432320,202305,20,15,5,19800,6600,26400
432330,202305,18,12,6,15840,7920,23760
432335,202305,9,7,2,9240,2640,11880
432340,202305,34,27,7,35640,10560,46200
432345,202305,135,90,45,118804.01,59400,178204.01
432350,202305,26,24,2,31680,2640,34320
432360,202305,5,4,1,5280.7,1320,6600.7
432370,202305,28,27,1,35640.54,1320,36960.54
432375,202305,29,27,2,35640,2640,38280
432377,202305,9,9,0,11880.48,,11880.48
432380,202305,236,109,127,143882.4,167643.11,311525.51
500020,202305,316,167,149,220442.29,196680.8,417123.09
500025,202305,156,73,83,96362.43,109561.12,205923.55
500060,202305,1577,1004,573,1325326.18,757689.16,2083015.34
500070,202305,803,396,407,522732.96,537249.61,1059982.57
500080,202305,151,122,29,161044.39,38280,199324.39
500085,202305,157,115,42,151803.02,55440,207243.02
500090,202305,402,191,211,253445.68,278521.54,531967.22
500100,202305,715,374,341,493693.17,450122.85,943816.02
500110,202305,2428,1170,1258,1545776.21,1661904.86,3207681.07
500124,202305,287,151,136,199320.53,179521.76,378842.29
500150,202305,341,136,205,180843.57,270601.79,451445.36
500190,202305,612,409,203,539897.23,267962.69,807859.92
500200,202305,218,177,41,233643.61,54120,287763.61
500210,202305,1819,567,1252,749773.95,1656614.57,2406388.52
500215,202305,215,124,91,165008.59,120120.2,285128.79
500220,202305,755,469,286,619103.75,377523.21,996626.96
500230,202305,254,147,107,194043.4,142560.49,336603.89
500240,202305,692,426,266,563657.44,351123.92,914781.36
500260,202305,623,253,370,335284.16,489720.46,825004.62
500270,202305,33364,14597,18767,19298647.97,24809789.82,44108437.79
500280,202305,208,73,135,96360.9,178200.66,274561.56
500290,202305,1250,785,465,1036231.86,615124.6,1651356.46
500295,202305,525,349,176,462008.09,233641.09,695649.18
500310,202305,123,42,81,55440.1,106920.81,162360.91
500315,202305,894,481,413,636241.23,546482.16,1182723.39
500320,202305,3987,1856,2131,2453978.2,2815578.65,5269556.85
500325,202305,1015,575,440,759033.04,580806.31,1339839.35
500330,202305,1638,805,833,1062689.43,1104856.75,2167546.18
500345,202305,329,227,102,299646.8,134640.21,434287.01
500348,202305,265,160,105,211202.93,138600,349802.93
500350,202305,106,51,55,67321.51,72601.14,139922.65
500370,202305,6208,2828,3380,3735983.98,4470881.1,8206865.08
500375,202305,379,250,129,330003.71,170280.38,500284.09
500380,202305,698,384,314,508215.61,415802.39,924018.00
500390,202305,79,34,45,44880.1,59401.2,104281.3
500400,202305,234,140,94,186124.82,124080.97,310205.79
500410,202305,465,210,255,277209.76,336604.45,613814.21
500430,202305,647,398,249,525373.94,331321.87,856695.81
500440,202305,210,119,91,158400.14,121440.2,279840.34
500450,202305,461,198,263,264004.86,348480.95,612485.81
500460,202305,291,159,132,211203.48,174240.96,385444.44
500470,202305,452,322,130,425050.68,171600.93,596651.61
500480,202305,113,66,47,87120.71,62041.43,149162.14
500490,202305,96,43,53,56760.68,69962.38,126723.06
500500,202305,1580,582,998,768264.06,1317367.05,2085631.11
500510,202305,40,34,6,44880.51,7920,52800.51
500515,202305,124,83,41,109563.03,54121.41,163684.44
500520,202305,302,152,150,200646.82,198000.16,398646.98
500525,202305,99,51,48,67320.14,63360,130680.14
500540,202305,973,420,553,554422.78,732608.2,1287030.98
500560,202305,912,509,403,675853.1,531962.73,1207815.83
500568,202305,1177,549,628,726014.73,830285.45,1556300.18
500570,202305,1288,734,554,968899,731284,1700183
500580,202305,317,174,143,229686.18,188761.24,418447.42
500600,202305,421,200,221,264004.91,291722.26,555727.17
500620,202305,1088,756,332,999268.14,438248.82,1437516.96
500625,202305,89,68,21,89760.41,27720,117480.41
500627,202305,45,18,27,23760,35640,59400
500630,202305,1683,968,715,1277239.5,945127.57,2222367.07
500635,202305,528,307,221,406561.84,291720,698281.84
500640,202305,367,198,169,261370.44,223082.94,484453.38
500660,202305,6506,2324,4182,3070397.25,5522920.09,8593317.34
500690,202305,670,239,431,315486.39,568920.26,884406.65
500710,202305,430,211,219,279845.12,289084.11,568929.23
500720,202305,1013,551,462,727343.59,609844.12,1337187.71
500730,202305,151,91,60,120126.07,79200,199326.07
500740,202305,1035,452,583,596657.23,769564.89,1366222.12
500750,202305,214,78,136,104283.62,180843.09,285126.71
500755,202305,113,83,30,109564.42,39600.93,149165.35
500769,202305,806,447,359,591377.54,473884.37,1065261.91
500770,202305,457,242,215,320761.56,285120,605881.56
500780,202305,140,95,45,125407.43,59401.33,184808.76
500790,202305,1156,563,593,743186.62,784084.23,1527270.85
500793,202305,313,161,152,212525.31,200643.16,413168.47
500795,202305,206,131,75,174242.47,100320.99,274563.46
500797,202305,49,34,15,44880.62,19800,64680.62
500800,202305,463,204,259,269287.27,341881.28,611168.55
500830,202305,2546,1313,1233,1734544.95,1628890.35,3363435.30
500840,202305,113,80,33,105604.44,43560.02,149164.46
510010,202305,177,98,79,129360,104280,233640
510020,202305,573,278,295,368293.74,390724.33,759018.07
510025,202305,1870,1062,808,1403205.1,1067893.34,2471098.44
510030,202305,679,360,319,476539.82,421087.01,897626.83
510035,202305,136,70,66,92400.25,87120,179520.25
510040,202305,426,198,228,261363.85,300961.66,562325.51
510050,202305,393,203,190,267966.45,252121.84,520088.29
510060,202305,145,62,83,81842.74,109560,191402.74
510080,202305,261,112,149,147841.73,198000,345841.73
510100,202305,68,29,39,38280.55,51480.46,89761.01
510120,202305,32,19,13,25080.99,17160.62,42241.61
510125,202305,406,257,149,339242.05,196680.21,535922.26
510130,202305,557,332,225,438251.43,297002.22,735253.65
510140,202305,470,158,312,208561.28,413161.35,621722.63
510160,202305,110,45,65,59402.05,85801.31,145203.36
510170,202305,827,488,339,645498.06,447486.67,1092984.73
510180,202305,3184,1442,1742,1903488.24,2302104.53,4205592.77
510185,202305,38,20,18,26400.7,23760,50160.7
510190,202305,272,90,182,118802.21,240242.39,359044.60
510250,202305,2899,1759,1140,2323247.41,1508766.89,3832014.30
510260,202305,175,124,51,163681.71,67321.2,231002.91
510263,202305,504,287,217,380167.07,286444.44,666611.51
510267,202305,647,363,284,479179.15,374882.53,854061.68
510268,202305,81,38,43,50160.01,58080,108240.01
510269,202305,82,38,44,50160,58080.5,108240.5
510270,202305,398,194,204,256081.36,269280.22,525361.58
510279,202305,224,163,61,215161.71,80520,295681.71
510285,202305,185,74,111,97681.65,146520,244201.65
510300,202305,552,288,264,380164.84,349802.33,729967.17
510305,202305,208,91,117,120120.2,154440,274560.2
510310,202305,110,59,51,77880,67320.1,145200.1
510320,202305,846,530,316,699611.62,421083.47,1120695.09
510325,202305,472,200,272,265324.37,359042.31,624366.68
510330,202305,482,273,209,360368.49,275880.94,636249.43
510335,202305,716,425,291,561015.24,386762.4,947777.64
510336,202305,52,35,17,46201.06,22440.64,68641.70
510337,202305,107,46,61,60720.03,81840,142560.03
510340,202305,19955,8486,11469,11220440.29,15169716.41,26390156.70
510343,202305,62,49,13,64680,18480,83160
510345,202305,157,96,61,126721.97,80520.68,207242.65
510350,202305,683,359,324,473890.77,427686.43,901577.20
510360,202305,227,140,87,184804.23,114840,299644.23
510370,202305,181,77,104,101640,137280.7,238920.7
510380,202305,80,59,21,77880,27720,105600
510385,202305,58,32,26,42240.2,34320,76560.2
510390,202305,103,46,57,60720.09,75240.54,135960.63
510395,202305,61,42,19,55440,25080,80520
510410,202305,857,551,306,727342.37,403926.55,1131268.92
510420,202305,587,287,300,378844.46,396000.7,774845.16
510450,202305,52,29,23,38280,30360,68640
510452,202305,61,29,32,38280,42240,80520
510454,202305,57,26,31,34320,40920.03,75240.03
510455,202305,121,72,49,95040,64680.97,159720.97
510460,202305,206,86,120,113522.32,158400.28,271922.60
510480,202305,795,457,338,603260.07,447489.92,1050749.99
510490,202305,337,163,174,215162.26,229680.5,444842.76
510500,202305,248,186,62,245521.29,81840,327361.29
510510,202305,909,531,378,700936.85,498965.76,1199902.61
510515,202305,1362,699,663,926661.6,875167.05,1801828.65
510517,202305,287,129,158,170283.2,208560,378843.2
510520,202305,242,150,92,198004.69,121440.55,319445.24
510523,202305,120,93,27,122760,35640,158400
510525,202305,943,584,359,770897.4,473883.27,1244780.67
510530,202305,30,15,15,19800,19800,39600
510550,202305,258,116,142,153123.1,187442.1,340565.2
510558,202305,330,164,166,216732.16,219120,435852.16
510560,202305,407,239,168,315486.65,221762.2,537248.85
510562,202305,705,503,202,665302.64,266641.62,931944.26
510590,202305,734,355,379,469932.27,500283.35,970215.62
510600,202305,219,118,101,155764.93,135960.93,291725.86
510610,202305,225,102,123,135963.74,163681.46,299645.20
510615,202305,238,112,126,147841,167640.42,315481.42
510617,202305,26,11,15,14520,19800,34320
510618,202305,132,65,67,85800,88442.14,174242.14
510619,202305,84,59,25,79202.05,33000,112202.05
510620,202305,166,89,77,117480.7,102960,220440.7
510621,202305,182,118,64,155760.16,84480.23,240240.39
510622,202305,531,276,255,364332.27,337924.85,702257.12
510623,202305,299,203,96,267963.73,128040.2,396003.93
510624,202305,94,44,50,58081.55,66000.83,124082.38
510625,202305,564,351,213,463335.54,281164.58,744500.12
510626,202305,121,65,56,85802.67,75240,161042.67
510627,202305,100,68,32,89761.85,42240,132001.85
510628,202305,173,107,66,141240.52,87120,228360.52
510629,202305,296,179,117,236282.57,154463.76,390746.33
510630,202305,477,247,230,327373.69,303601.64,630975.33
510631,202305,21,9,12,11880.13,15840,27720.13
510637,202305,367,214,153,282484.04,201960,484444.04
510642,202305,1261,679,582,896301.74,769566.34,1665868.08
510645,202305,12,3,9,3960,11880,15840
510650,202305,1298,830,468,1096967.83,617765.22,1714733.05
510665,202305,100,45,55,59401.02,72600.08,132001.10
510670,202305,59,34,25,44880.38,33000,77880.38
510675,202305,1159,737,422,972871.63,557043.95,1529915.58
510677,202305,366,195,171,257403.96,227040.51,484444.47
510680,202305,90,56,34,73921.95,44880,118801.95
510682,202305,203,95,108,125400.77,142560,267960.77
510685,202305,55,40,15,52800.47,19800.8,72601.27
510700,202305,619,351,268,463336.11,353763.3,817099.41
510704,202305,1352,678,674,894999.15,889696.76,1784695.91
510706,202305,165,83,82,109563.12,108240.94,217804.06
510710,202305,452,323,129,426366.33,171600.29,597966.62
510715,202305,58,39,19,51480,25080.59,76560.59
510718,202305,265,118,147,157082.12,194044.66,351126.78
510719,202305,54,24,30,31680,39600,71280
510720,202305,188,131,57,172921.27,75240,248161.27
510724,202305,81,32,49,42240,64680,106920
510726,202305,68,33,35,43560.7,46200.62,89761.32
510729,202305,17,7,10,9240,13200.3,22440.3
510730,202305,483,256,227,337922.67,300960,638882.67
510735,202305,122,45,77,59400.08,101640,161040.08
510740,202305,25,14,11,18480.85,14520.47,33001.32
510757,202305,27,22,5,29041.31,6600.16,35641.47
510760,202305,8165,4113,4052,5431939.92,5357930.71,10789870.63
510770,202305,758,340,418,448809.28,551763.44,1000572.72
510774,202305,19,7,12,9240.69,15840,25080.69
510775,202305,126,97,29,128040,38280,166320
510776,202305,35,12,23,15840,30360.2,46200.2
510777,202305,189,84,105,110880,138600,249480
510779,202305,41,24,17,31680,22440,54120
510780,202305,285,150,135,198008.43,178200,376208.43
510785,202305,349,188,161,248165.89,212520.73,460686.62
510787,202305,222,109,113,145205.77,149161.36,294367.13
510788,202305,9,4,5,5280.9,6600,11880.9
510790,202305,2864,1473,1391,1944479.9,1836129.12,3780609.02
510792,202305,1189,672,517,887516.12,683772.48,1571288.60
510794,202305,124,67,57,88441.06,75240,163681.06
510795,202305,2456,1380,1076,1821638.14,1420328.79,3241966.93
510800,202305,199,109,90,143881.81,120120.14,264001.95
510805,202305,224,150,74,198001.1,97680,295681.1
510810,202305,107,42,65,55441.58,85800.42,141242.00
510820,202305,268,137,131,180842.44,172920.65,353763.09
510830,202305,78,39,39,51480,51480,102960
510835,202305,26,19,7,25080.7,9240,34320.7
510840,202305,10069,4545,5524,6004946.48,7301013.99,13305960.47
510850,202305,219,87,132,114842.18,174240.26,289082.44
510860,202305,431,215,216,285122.57,285120.91,570243.48
510880,202305,83,60,23,79200.2,30360,109560.2
510885,202305,72,41,31,54120.33,40920,95040.33
510890,202305,79,38,41,50160.16,54120,104280.16
510895,202305,190,112,78,147840.64,102960,250800.64
520005,202305,155,64,91,84483.67,121441.86,205925.53
520010,202305,335,150,185,198003.19,245524.35,443527.54
520013,202305,797,553,244,731297.73,322083.35,1053381.08
520015,202305,39,26,13,34320,17160,51480
520017,202305,88,56,32,73920.84,42240,116160.84
520020,202305,12,5,7,6600,9240,15840
520025,202305,3213,1717,1496,2266551.79,1977423,4243974.79
520030,202305,919,480,439,633615.39,580803.92,1214419.31
520050,202305,63,47,16,62040.2,21120.05,83160.25
520055,202305,82,55,27,72600,35640.2,108240.2
520060,202305,189,128,61,168964.77,81841.25,250806.02
520080,202305,591,422,169,558361.68,223080,781441.68
520082,202305,17,13,4,17160,5280,22440
520085,202305,107,83,24,109560.18,31680.7,141240.88
520090,202305,85,62,23,81840.75,30360,112200.75
520110,202305,10019,4246,5773,5607526.06,7632318.08,13239844.14
520120,202305,12,7,5,9240,6600,15840
520130,202305,902,626,276,826375.97,364321.42,1190697.39
520140,202305,13075,7094,5981,9367060.71,7901614.72,17268675.43
520145,202305,62,34,28,44880.2,36960,81840.2
520150,202305,139,109,30,143886.7,39600,183486.7
520160,202305,42,26,16,34320,21120,55440
520170,202305,217,124,93,165008.17,124081.82,289089.99
520180,202305,202,95,107,125401.5,141241.56,266643.06
520215,202305,198,143,55,188761.19,72600.2,261361.39
520235,202305,91,70,21,92400,27720,120120
520250,202305,163,84,79,110881.88,104280,215161.88
520260,202305,125,73,52,96363.23,68641.36,165004.59
520280,202305,45,34,11,44880,14520,59400
520310,202305,31,19,12,25081.8,15840.7,40922.5
520320,202305,188,112,76,147842.04,101640.97,249483.01
520330,202305,891,492,399,649456.87,526684.85,1176141.72
520340,202305,306,175,131,231010.89,172921.41,403932.30
520350,202305,509,261,248,344525.61,330002.2,674527.81
520355,202305,108,65,43,85802.67,56760,142562.67
520357,202305,36,28,8,36960,10560,47520
520360,202305,16,6,10,7920.2,13200.28,21120.48
520380,202305,145,79,66,104280,87120,191400
520390,202305,236,105,131,138604.63,172920,311524.63
520393,202305,18,14,4,18480.1,5280,23760.1
520396,202305,75,55,20,72600,26400,99000
520400,202305,219,134,85,176885.04,112203.3,289088.34
520410,202305,201,101,100,133323.76,132000,265323.76
520420,202305,22,18,4,23760.94,5280,29040.94
520425,202305,262,127,135,167643.17,178200.98,345844.15
520430,202305,564,266,298,351121.68,393360.9,744482.58
520440,202305,683,491,192,648140.63,253440.93,901581.56
520450,202305,2345,1002,1343,1322680.71,1778061.03,3100741.74
520455,202305,63,36,27,47521.35,35640.51,83161.86
520460,202305,48,29,19,38280.69,25082.43,63363.12
520465,202305,37,31,6,40920,7920,48840
520470,202305,475,292,183,385443.49,241560.2,627003.69
520480,202305,78,50,28,66000.69,36960,102960.69
520485,202305,111,41,70,54120.02,92400.1,146520.12
520490,202305,558,407,151,537250.75,199323.07,736573.82
520495,202305,167,101,66,133320.1,87120,220440.1
520500,202305,262,212,50,279842.3,66000,345842.3
520505,202305,192,113,79,149160,104280,253440
520510,202305,2178,1036,1142,1368867.4,1511411.15,2880278.55
520520,202305,65,42,23,55440.97,30360,85800.97
520530,202305,213,172,41,227046.44,54120,281166.44
520540,202305,799,544,255,718091.28,337923.05,1056014.33
520545,202305,162,94,68,124085.31,89760.6,213845.91
520547,202305,80,46,34,60722.18,44880.1,105602.28
520549,202305,1627,776,851,1027002.43,1125975.22,2152977.65
520551,202305,320,169,151,223082.56,199321.23,422403.79
520552,202305,47,33,14,43560.5,18480,62040.5
520570,202305,15,12,3,15840,3960,19800
520580,202305,293,181,112,239059.08,147840.73,386899.81
520590,202305,159,89,70,117482.03,92400,209882.03
520620,202305,1322,609,713,805212.51,941169.51,1746382.02
520630,202305,58,30,28,39600,36960.18,76560.18
520640,202305,400,231,169,304925.97,223080.9,528006.87
520650,202305,73,33,40,43560,52800,96360
520660,202305,47,25,22,33001.18,29040.38,62041.56
520670,202305,50,37,13,48840.27,17160,66000.27
520680,202305,24,14,10,18480,13200,31680
520690,202305,37,10,27,13200,35640,48840
520710,202305,39,30,9,39600,11880,51480
520725,202305,198,148,50,195363.1,66000,261363.1
520735,202305,60,38,22,50160.4,29040.2,79200.6
520740,202305,487,243,244,320766.49,322081.22,642847.71
520750,202305,41,24,17,31680,22440,54120
520753,202305,78,57,21,75240.48,27720,102960.48
520760,202305,111,79,32,104281.34,42240,146521.34
520780,202305,270,211,59,279845.06,77881.73,357726.79
520790,202305,144,89,55,117480.22,72600,190080.22
520800,202305,3632,2048,1584,2704771.19,2092229.2,4797000.39
520810,202305,136,104,32,137282.68,42240.89,179523.57
520815,202305,7,5,2,6600.96,2640,9240.96
520830,202305,132,92,40,121442.55,52800.05,174242.60
520840,202305,416,266,150,351120.97,198000,549120.97
520850,202305,116,67,49,88442.16,64680,153122.16
520860,202305,1946,1225,721,1618360.06,953044.9,2571404.96
520870,202305,36104,16280,19824,21498545.66,26202325.09,47700870.75
520880,202305,1387,720,667,951762.08,880458.18,1832220.26
520890,202305,885,564,321,744503.64,423721.57,1168225.21
520910,202305,1031,540,491,712825.94,648122.61,1360948.55
520915,202305,96,63,33,83162.29,43560.6,126722.89
520920,202305,518,240,278,316811.65,366967.9,683779.55
520929,202305,20,16,4,21120.37,5280,26400.37
520940,202305,66,49,17,64682.04,22440.1,87122.14
520945,202305,17,10,7,13200,9240,22440
520960,202305,47,29,18,38280,23760,62040
520970,202305,436,254,182,335289.13,240244.3,575533.43
520980,202305,90,65,25,85800,33000,118800
520990,202305,442,312,130,411841.93,171600.13,583442.06
520993,202305,123,63,60,83164.21,79200.94,162365.15
520995,202305,273,148,125,195363.58,165000,360363.58
521000,202305,1696,924,772,1221023.78,1020370.94,2241394.72
521010,202305,660,348,312,459370.01,411842.78,871212.79
521015,202305,14,9,5,11880,6600,18480
521020,202305,1531,1076,455,1421676.18,601930.25,2023606.43
521030,202305,81,55,26,72600.95,34320,106920.95
521040,202305,1027,682,345,904226.69,456721,1360947.69
521056,202305,57,37,20,48840,26400,75240
521060,202305,129,82,47,108241.55,63360.76,171602.31
521080,202305,324,257,67,339258,88440.4,427698.4
521090,202305,613,415,198,547809.68,261360.89,809170.57
521100,202305,281,192,89,253446.77,118800.4,372247.17
521120,202305,1124,794,330,1048110.96,436924.45,1485035.41
521130,202305,331,234,97,308888.59,128040,436928.59
521140,202305,193,107,86,141245.55,113520.69,254766.24
521150,202305,2707,1138,1569,1506179.16,2072430.34,3578609.50
521160,202305,28,10,18,13200.42,23760,36960.42
521170,202305,233,124,109,163681.03,143880.2,307561.23
521180,202305,1254,785,469,1037553.13,619088,1656641.13
521190,202305,2760,1149,1611,1518042,2129178.78,3647220.78
521200,202305,63,44,19,58080.2,25080,83160.2
521205,202305,16,12,4,15840.2,5280,21120.2
521210,202305,143,88,55,116161.69,72600,188761.69
521220,202305,791,534,257,704892.95,339242.22,1044135.17
521225,202305,17,12,5,15841.7,6600.81,22442.51
521230,202305,111,73,38,96362.24,50161.63,146523.87
521250,202305,6836,3732,3104,4931741.17,4101295.08,9033036.25
521260,202305,44,19,25,25080,33000,58080
521270,202305,129,97,32,128041.16,42240,170281.16
521280,202305,433,271,162,357722.98,213840,571562.98
521290,202305,33,18,15,23760.89,19800,43560.89
521295,202305,108,71,37,93720.9,48840,142560.9
521300,202305,250,139,111,183482.39,146520.84,330003.23
521305,202305,44,31,13,40921.51,17160,58081.51
521308,202305,1037,795,242,1049436.69,319443.87,1368880.56
521310,202305,1486,817,669,1078476.09,885732.99,1964209.08
521340,202305,21,17,4,22440,5280,27720
521350,202305,92,68,24,89763.19,31680,121443.19
521370,202305,174,114,60,150480.5,79200,229680.5
521375,202305,205,97,108,128042.6,143881.16,271923.76
521377,202305,48,35,13,46200.93,17160.1,63361.03
521380,202305,1142,675,467,891038.88,616447.28,1507486.16
521385,202305,11,6,5,7920,6600,14520
521390,202305,106,83,23,109563.13,30360.49,139923.62
521400,202305,408,293,115,386772.71,151801.53,538574.24
521405,202305,167,107,60,142563.56,79200.66,221764.22
521410,202305,83,61,22,80521.27,29040,109561.27
521440,202305,220,151,69,199326.56,91080.64,290407.20
521450,202305,827,455,372,600615.28,491044.53,1091659.81
521460,202305,1157,802,355,1058687.32,468607.44,1527294.76
521470,202305,15,10,5,13200,6600,19800
521480,202305,41,27,14,35641.51,18480,54121.51
521483,202305,345,225,120,297002.65,158401.47,455404.12
521486,202305,314,209,105,275880.5,138601.71,414482.21
521487,202305,24,12,12,15840,15840,31680
521490,202305,28,16,12,21120,15840,36960
521500,202305,155,70,85,92400.46,112200.19,204600.65
521520,202305,46,34,12,44880,15840,60720
521523,202305,1235,672,563,888379.19,743164.83,1631544.02
521525,202305,62,44,18,58080,23760,81840
521530,202305,246,141,105,186120.45,138600.49,324720.94
521540,202305,46,22,24,29040,31680,60720
521550,202305,131,64,67,84481.06,88440.99,172922.05
521560,202305,963,643,320,848783.49,422402.46,1271185.95
521565,202305,73,52,21,68641.09,27720.7,96361.79
521570,202305,619,383,236,506888.52,311520.97,818409.49
521580,202305,45,29,16,38280,21120,59400
521590,202305,40,21,19,27720,26400,54120
521600,202305,25,12,13,15840,17160,33000
521630,202305,235,120,115,158407.79,151805.4,310213.19
521640,202305,333,181,152,238922.57,201960.67,440883.24
521645,202305,41,20,21,26400,27720,54120
521680,202305,265,161,104,212523.92,137280.87,349804.79
521690,202305,17,15,2,19800,2640,22440
521710,202305,1165,556,609,735253.93,803887.35,1539141.28
521720,202305,635,421,214,555726.84,283800.9,839527.74
521730,202305,748,350,398,463324.99,525361.89,988686.88
521740,202305,963,446,517,588728.59,685085.77,1273814.36
521760,202305,2587,1320,1267,1743895.62,1672480.84,3416376.46
521770,202305,880,535,345,706209.82,455402.43,1161612.25
521800,202305,2084,1414,670,1867842.12,884401.92,2752244.04
521805,202305,39,24,15,31680,19800,51480
521810,202305,94,52,42,68641.34,55440.19,124081.53
521830,202305,1076,793,283,1046791.64,373566.62,1420358.26
521839,202305,72,41,31,54120,40920.2,95040.2
521850,202305,1236,619,617,817105.31,814451.1,1631556.41
521860,202305,345,216,129,285126.14,170280,455406.14
521870,202305,91,59,32,77880,42240,120120
521878,202305,34,13,21,17160,27720.66,44880.66
521880,202305,5385,2355,3030,3112440.5,4000954.87,7113395.37
521890,202305,669,455,214,600611.45,282482.11,883093.56
521900,202305,288,226,62,298321.24,81840.8,380162.04
521910,202305,192,132,60,175566.68,79202.39,254769.07
521920,202305,37,22,15,29040,19800,48840
521925,202305,54,30,24,39600,31680,71280
521930,202305,1323,734,589,968915.37,780132.55,1749047.92
521935,202305,35,26,9,34321.46,11880,46201.46
521940,202305,251,112,139,147841.85,183480.75,331322.60
521945,202305,19,12,7,15840,9240,25080
521950,202305,24,14,10,18480,13200,31680
521960,202305,69,55,14,72600,18480,91080
521970,202305,414,271,143,357723.79,188760.89,546484.68
521971,202305,108,58,50,76560.8,66000,142560.8
521973,202305,38,17,21,22440.6,27720,50160.6
521975,202305,1759,927,832,1223681.27,1099578.56,2323259.83
521980,202305,240,166,74,219122.55,97680,316802.55
521990,202305,90,63,27,83161.01,35640,118801.01
522000,202305,292,197,95,259586.82,125400.79,384987.61
522005,202305,19,11,8,14520,10560,25080
522010,202305,1215,672,543,887070.25,716771.41,1603841.66
522015,202305,59,37,22,48840,29040,77880
522020,202305,928,559,369,737893.25,487085.98,1224979.23
522026,202305,28,19,9,25080,11880,36960
522028,202305,23,20,3,26400,3960,30360
522040,202305,884,391,493,517455.39,650768.57,1168223.96
522045,202305,2965,1746,1219,2307450.56,1609092.47,3916543.03
522050,202305,168,72,96,96364.93,126720.72,223085.65
522060,202305,559,353,206,465971.97,271920.35,737892.32
522068,202305,119,85,34,112200.67,44880,157080.67
522070,202305,19,16,3,21120,3960,25080
522100,202305,37,23,14,30360,18480,48840
522108,202305,41,32,9,42241.66,11880,54121.66
522119,202305,65,37,28,48841.58,36960,85801.58
522130,202305,86,32,54,42241.28,71280.68,113521.96
522140,202305,4613,2426,2187,3202426.71,2896103.69,6098530.40
522145,202305,50,36,14,47520.2,18480,66000.2
522150,202305,112,76,36,100320.17,47520.84,147841.01
522155,202305,58,39,19,51480.9,25080,76560.9
522157,202305,15,8,7,10560,9240,19800
522160,202305,1736,1030,706,1360958.29,931929.14,2292887.43
522170,202305,366,245,121,323404.2,159720.3,483124.5
522180,202305,32,13,19,17160,25080,42240
522185,202305,2784,1222,1562,1614430.41,2061888.23,3676318.64
522190,202305,79,45,34,59400.4,44880,104280.4
522200,202305,341,198,143,261362.19,190080.24,451442.43
522205,202305,143,98,45,129364.51,59400.1,188764.61
522220,202305,140,109,31,143880.2,40920,184800.2
522230,202305,31,27,4,35640.41,5280,40920.41
530010,202305,61044,30936,30108,40858307.09,39793548.22,80651855.31
110001,202306,548,447,101,590048.84,134640.66,724689.50
110002,202306,3118,1999,1119,2641384.26,1478409.14,4119793.40
110003,202306,82,64,18,84481.96,23760,108241.96
110004,202306,2257,1544,713,2038117.75,942486.48,2980604.23
110005,202306,458,355,103,469925.99,137280.2,607206.19
110006,202306,459,340,119,448804.45,157080.44,605884.89
110007,202306,81,64,17,84480,22440,106920
110008,202306,282,162,120,213841.67,158400.6,372242.27
110009,202306,993,768,225,1013770.95,298321.15,1312092.10
110010,202306,1767,981,786,1294948.37,1037522.48,2332470.85
110011,202306,1774,1372,402,1812410.17,530648.51,2343058.68
110012,202306,4341,2491,1850,3292140.28,2444661.49,5736801.77
110013,202306,777,616,161,813145.66,212523.23,1025668.89
110014,202306,357,317,40,419282.75,52800,472082.75
110015,202306,1421,1082,339,1429576.46,448803.91,1878380.37
110018,202306,1080,681,399,900260.64,528000.43,1428261.07
110020,202306,17700,9859,7841,13019774.04,10359491.44,23379265.48
110025,202306,671,495,176,653404.87,232320.4,885725.27
110026,202306,35,23,12,30360.74,15840,46200.74
110028,202306,1689,1186,503,1565557.45,665286.7,2230844.15
110029,202306,130,118,12,155763.41,15840,171603.41
110030,202306,2558,1649,909,2176511.15,1199885.97,3376397.12
110032,202306,352,270,82,356410,108243.77,464653.77
110033,202306,710,506,204,667948.66,269286.17,937234.83
110034,202306,333,254,79,335282.54,104280.18,439562.72
110037,202306,97,82,15,108241.1,19800,128041.1
110040,202306,429,295,134,389402.1,176880,566282.1
110045,202306,1020,745,275,984746.7,363002.19,1347748.89
110050,202306,88,79,9,105601.95,11880.03,117481.98
110060,202306,58,40,18,52800.92,23760,76560.92
110070,202306,118,79,39,104281.58,51480,155761.58
110080,202306,582,339,243,447485.8,320760.06,768245.86
110090,202306,25,20,5,26400,6600,33000
110092,202306,130,62,68,81841.11,89760,171601.11
110094,202306,232,163,69,215162.7,91080,306242.7
110100,202306,55,41,14,54120.47,18480.06,72600.53
110110,202306,123,73,50,96363.1,66000,162363.1
110120,202306,69,60,9,79201.86,11880,91081.86
110130,202306,267,220,47,290407.24,62040.81,352448.05
110140,202306,271,192,79,253442.99,104280.1,357723.09
110143,202306,57,46,11,60720,14520,75240
110145,202306,44,33,11,43560,14520,58080
110146,202306,30,12,18,15840.2,23760,39600.2
110147,202306,44,27,17,35640.51,22440.58,58081.09
110148,202306,33,26,7,34320.7,9240,43560.7
110149,202306,308,215,93,283800.85,122760,406560.85
110150,202306,145,118,27,155761.1,35640,191401.1
110155,202306,13,12,1,15840,1320,17160
110160,202306,68,53,15,69961.21,19800,89761.21
110170,202306,227,169,58,223083.76,76560,299643.76
110175,202306,69,55,14,72600.8,18480,91080.8
110180,202306,88,70,18,92400.88,23760,116160.88
120001,202306,242,174,68,229689.45,89760.22,319449.67
120005,202306,240,137,103,180843.78,135960,316803.78
120010,202306,1213,739,474,976811.06,625682.17,1602493.23
120013,202306,182,124,58,163683.57,76560.1,240243.67
120017,202306,148,88,60,116161.3,80520,196681.3
120020,202306,3535,2854,681,3770010.78,900250.5,4670261.28
120025,202306,607,328,279,433004.69,368297.87,801302.56
120030,202306,1250,1082,168,1428305.86,221768.45,1650074.31
120032,202306,42,37,5,48840,6600,55440
120033,202306,233,201,32,265327.64,42240.55,307568.19
120034,202306,193,143,50,188761.34,66000,254761.34
120035,202306,61,54,7,71280.1,9240,80520.1
120038,202306,427,280,147,369611.65,194041.84,563653.49
120039,202306,36,33,3,43561.1,3960,47521.1
120040,202306,15479,10380,5099,13709697.97,6734963.95,20444661.92
120042,202306,52,47,5,62042.05,6600,68642.05
120043,202306,18,5,13,6600,17160,23760
120045,202306,574,366,208,483141.36,274563.56,757704.92
120050,202306,1349,1026,323,1354382.65,426371.07,1780753.72
120060,202306,1549,1295,254,1710028.37,335286.64,2045315.01
120070,202306,447,328,119,432975.01,157080.42,590055.43
120080,202306,212,138,74,182165.49,97680.55,279846.04
130002,202306,165,119,46,157080.95,60720,217800.95
130006,202306,112,77,35,101640,46200,147840
130008,202306,131,78,53,102960.73,69960,172920.73
130010,202306,177,111,66,146520.2,87120.85,233641.05
130014,202306,323,228,95,301292.34,125401.8,426694.14
130020,202306,158,113,45,149160.9,59400,208560.9
130030,202306,1027,573,454,756365.59,599281.07,1355646.66
130040,202306,414,213,201,281161.4,266640,547801.4
130050,202306,584,307,277,405256.44,365651.95,770908.39
130060,202306,908,618,290,815763.78,382800.7,1198564.48
130063,202306,648,416,232,549120.1,306240,855360.1
130068,202306,243,151,92,199322.48,121441.48,320763.96
130070,202306,1421,944,477,1247427.47,629645.21,1877072.68
130080,202306,737,510,227,673207.04,299642.11,972849.15
130083,202306,90,61,29,80520.44,38280,118800.44
130090,202306,350,214,136,282480.65,179520,462000.65
130100,202306,1419,754,665,996613.65,879130.39,1875744.04
130110,202306,843,365,478,481803.29,630960.83,1112764.12
130115,202306,152,78,74,102960,97680.1,200640.1
130120,202306,1761,1102,659,1454657.97,869881.23,2324539.20
130130,202306,687,474,213,625681.14,281160.95,906842.09
130140,202306,1611,1253,358,1653971.4,472560.96,2126532.36
130150,202306,449,401,48,529320.63,63360,592680.63
130160,202306,473,300,173,396001.4,228360,624361.4
130165,202306,151,134,17,176880,22440,199320
130170,202306,1272,876,396,1156263.62,522729.85,1678993.47
130180,202306,307,244,63,322082.03,83160.1,405242.13
130185,202306,2377,1185,1192,1564244.12,1574784.81,3139028.93
130190,202306,3489,2185,1304,2885604.33,1721298.34,4606902.67
130195,202306,311,247,64,326040,84480,410520
130200,202306,228,144,84,190081.91,110880,300961.91
130210,202306,95,43,52,56760,68640,125400
130220,202306,221,169,52,223081.17,68640,291721.17
130230,202306,368,250,118,330000,157080,487080
130240,202306,1447,976,471,1288328.95,623042.12,1911371.07
130250,202306,5065,3286,1779,4337621.24,2352316.95,6689938.19
130255,202306,448,233,215,307560.52,283800.67,591361.19
130260,202306,69691,32326,37365,42695729.07,49352063.31,92047792.38
130270,202306,1560,1085,475,1432328.37,627001.93,2059330.30
130280,202306,150,87,63,114840.1,83160,198000.1
130290,202306,2104,1341,763,1770160.85,1007166.23,2777327.08
130300,202306,430,291,139,384121.6,183482.29,567603.89
130310,202306,978,548,430,724683.6,567600.5,1292284.1
130320,202306,575,314,261,414481.64,344520,759001.64
130330,202306,807,540,267,712805.82,353760.84,1066566.66
130340,202306,3674,2011,1663,2654607.38,2197826.67,4852434.05
130350,202306,487,350,137,462000.2,180840,642840.2
130353,202306,1020,491,529,648135.4,698290.7,1346426.1
130356,202306,902,423,479,558367.65,633603.99,1191971.64
130360,202306,106,83,23,109560.2,30360,139920.2
130370,202306,698,558,140,736561.67,184800,921361.67
130380,202306,678,533,145,703563.9,192720.38,896284.28
130390,202306,503,414,89,546480,117480,663960
130395,202306,174,69,105,91080.61,138600,229680.61
130400,202306,100,77,23,101641.39,30360,132001.39
130406,202306,2316,1348,968,1779377.04,1277764.15,3057141.19
130410,202306,484,270,214,356400,282480,638880
130420,202306,2903,2366,537,3125855.26,708844.04,3834699.30
130423,202306,226,149,77,196683.11,101640,298323.11
130426,202306,192,107,85,141240,112200,253440
130430,202306,454,267,187,352446.41,246840,599286.41
130440,202306,202,71,131,93724.66,172921.95,266646.61
140002,202306,60,18,42,23760.2,55441.45,79201.65
140005,202306,237,140,97,184804.92,128041.5,312846.42
140010,202306,13824,7789,6035,10287256.89,7975619.83,18262876.72
140015,202306,329,76,253,100322.58,333961.82,434284.40
140017,202306,158,88,70,116167.14,92403.44,208570.58
140020,202306,469,313,156,413175.48,207244.51,620419.99
140023,202306,84,47,37,62040,48840.59,110880.59
140028,202306,27,16,11,21120.84,14521.17,35642.01
140030,202306,442,285,157,376214.69,207242.47,583457.16
140040,202306,89,59,30,77880.6,39600,117480.6
140045,202306,413,114,299,150481.22,394683.11,545164.33
140047,202306,654,416,238,549134.53,314162.33,863296.86
140050,202306,156,95,61,125404.59,80521.39,205925.98
140060,202306,98,68,30,89761.96,39600.2,129362.16
140070,202306,22,21,1,27720.2,1320,29040.2
150010,202306,5499,3323,2176,4387807.8,2872349.61,7260157.41
150013,202306,187,125,62,165000.42,81840.99,246841.41
150020,202306,1222,697,525,920059.69,693001.01,1613060.70
150030,202306,752,352,400,464654.37,528003.48,992657.85
150034,202306,222,129,93,170281.49,122760.5,293041.99
150040,202306,1834,1069,765,1411138.95,1009823.14,2420962.09
150050,202306,798,473,325,625686.6,430321.28,1056007.88
150060,202306,5289,3282,2007,4334890.82,2649826.67,6984717.49
150070,202306,234,178,56,234973.41,73921.23,308894.64
150080,202306,19677,9195,10482,12141276.94,13841852.44,25983129.38
150085,202306,517,313,204,413172.97,269283.48,682456.45
150090,202306,816,647,169,854061.7,223082.01,1077143.71
150095,202306,94,65,29,85800.75,38281.05,124081.80
150100,202306,83,51,32,67320,42241.33,109561.33
150110,202306,210,128,82,168960.69,108240.1,277200.79
150120,202306,417,298,119,393370.24,157081.24,550451.48
150125,202306,46,20,26,26400,34320,60720
150130,202306,2700,1325,1375,1750387.4,1815244.41,3565631.81
150140,202306,66979,28570,38409,37728595,50718181.73,88446776.73
150145,202306,286,154,132,204602.94,174241.01,378843.95
150150,202306,3970,1734,2236,2288949.68,2951566.19,5240515.87
150157,202306,385,276,109,364330.56,143881.05,508211.61
150160,202306,181,135,46,178200.74,60720,238920.74
150170,202306,4477,3230,1247,4263710.43,1646056.71,5909767.14
150172,202306,412,289,123,381485.25,162361.4,543846.65
150175,202306,89,50,39,66001,51480.7,117481.7
150178,202306,844,571,273,753743.75,360366.4,1114110.15
150180,202306,3607,1850,1757,2442065.48,2319250.05,4761315.53
150190,202306,427,289,138,381491.17,182162.41,563653.58
150195,202306,146,82,64,108240.99,84480.61,192721.60
150200,202306,222,121,101,159720.08,133320.2,293040.28
150210,202306,3443,2646,797,3492859.96,1052056.37,4544916.33
150215,202306,766,443,323,584784.36,426371.54,1011155.90
150220,202306,3771,2497,1274,3296136.19,1681712.63,4977848.82
150230,202306,1544,1226,318,1619680.48,419767.69,2039448.17
150240,202306,8139,4507,3632,5953435.95,4796980.71,10750416.66
150250,202306,94,53,41,69961.56,54120.92,124082.48
150260,202306,144,100,44,132005.16,58081.79,190086.95
150270,202306,2264,1466,798,1936483.02,1054684.55,2991167.57
150275,202306,593,389,204,514811.16,269281.08,784092.24
150276,202306,126,45,81,59400.2,106921.55,166321.75
150277,202306,937,413,524,545172.43,694337.11,1239509.54
150280,202306,183,179,4,236296.07,5280,241576.07
150285,202306,174,92,82,121442.25,108028.8,229471.05
150290,202306,1409,801,608,1057346.79,803888.59,1861235.38
150293,202306,924,435,489,575542.24,645488.82,1221031.06
150295,202306,640,314,326,414496.48,431642.11,846138.59
150300,202306,106,54,52,71280.1,68640,139920.1
150304,202306,224,135,89,178203.05,117482.96,295686.01
150307,202306,479,393,86,518772.16,113520.5,632292.66
150309,202306,634,448,186,591390.76,245524.08,836914.84
150310,202306,322,218,104,287765.53,137280,425045.53
150320,202306,2064,1427,637,1883673.46,840848.43,2724521.89
150330,202306,2295,1312,983,1731861.67,1297566.1,3029427.77
150340,202306,215,135,80,179521.52,105600.42,285121.94
150345,202306,696,390,306,514809.09,405240.63,920049.72
150350,202306,446,359,87,473910.28,114843.33,588753.61
150360,202306,5563,3258,2305,4300660.15,3045273.67,7345933.82
150370,202306,896,598,298,789393.05,393367.21,1182760.26
150375,202306,208,88,120,116162.43,158400.68,274563.11
150380,202306,1631,1090,541,1438834.72,715444.7,2154279.42
150390,202306,964,558,406,736596.4,535926.24,1272522.64
150400,202306,135,113,22,149160.4,29040,178200.4
150405,202306,1761,1118,643,1475782.88,850082.78,2325865.66
150410,202306,109,69,40,91080.77,52800.2,143880.97
150420,202306,8541,4601,3940,6076458.33,5204891.18,11281349.51
150430,202306,705,441,264,582166.04,348488.87,930654.91
150440,202306,499,304,195,401296.95,257402.65,658699.60
150442,202306,2683,1439,1244,1900868.68,1642107.61,3542976.29
150445,202306,586,384,202,506886.35,266640.2,773526.55
150450,202306,52,43,9,56764.53,11880.1,68644.63
150460,202306,743,562,181,741862.04,238921.49,980783.53
150470,202306,1358,819,539,1081117.89,712805.39,1793923.28
150475,202306,263,198,65,261369.64,85802.81,347172.45
150480,202306,1572,1109,463,1465269.59,611169.67,2076439.26
150490,202306,627,385,242,508202.89,319440,827642.89
150495,202306,383,288,95,380161.07,126720,506881.07
150497,202306,303,194,109,256081.92,143880.3,399962.22
150500,202306,298,176,122,232322.42,161040.1,393362.52
150503,202306,1547,788,759,1040193.89,1004532.02,2044725.91
150506,202306,958,661,297,872538.11,392041.12,1264579.23
150510,202306,1455,811,644,1070550.79,850086.99,1920637.78
150520,202306,346,235,111,310201.85,146520.5,456722.35
150530,202306,2229,1307,922,1728017.59,1219741.22,2947758.81
150540,202306,247,178,69,234963.64,91080.81,326044.45
150543,202306,970,500,470,660019.56,620406.75,1280426.31
150548,202306,466,338,128,446164.76,168960.9,615125.66
150549,202306,91,60,31,79202.35,40920.26,120122.61
150550,202306,3477,1755,1722,2316673.39,2275704.88,4592378.27
150553,202306,4180,2343,1837,3094213.52,2426203.43,5520416.95
150555,202306,148,82,66,108240.2,87121.37,195361.57
150560,202306,91,44,47,58080.75,62040,120120.75
150563,202306,141,74,67,97685.47,88441.5,186126.97
150565,202306,230,136,94,179521.7,124080.15,303601.85
150570,202306,429,285,144,376201.28,190080,566281.28
150580,202306,1850,933,917,1231571.9,1210441.29,2442013.19
150590,202306,908,610,298,805231.27,393361.74,1198593.01
150600,202306,546,352,194,464654.03,256085.14,720739.17
150610,202306,203,155,48,204603.72,63360,267963.72
150611,202306,164,114,50,150480,66000,216480
150613,202306,3752,2077,1675,2741738.05,2212445.42,4954183.47
150616,202306,640,343,297,452767.98,392041.87,844809.85
150618,202306,1496,771,725,1019048.45,957001.89,1976050.34
150619,202306,440,336,104,443525.43,137285.92,580811.35
150620,202306,1399,797,602,1052071.11,794646.77,1846717.88
150630,202306,201,133,68,175570.81,89761.71,265332.52
150635,202306,518,241,277,318131.05,365645.03,683776.08
150640,202306,52,23,29,30361.98,38280,68641.98
150650,202306,2641,1517,1124,2002530.38,1486357.04,3488887.42
150655,202306,298,207,91,273240.61,120120,393360.61
150658,202306,68,42,26,55440.2,35640,91080.2
150660,202306,685,421,264,557051.39,349803.73,906855.12
150670,202306,1244,456,788,601932.03,1040168.27,1642100.30
150680,202306,12350,6497,5853,8582644.6,7734052.5,16316697.1
150690,202306,44,21,23,27721.14,30360,58081.14
150700,202306,607,407,200,537264.86,264004.49,801269.35
150710,202306,317,182,135,240246.89,178200.61,418447.50
150715,202306,891,567,324,748461.18,427682.33,1176143.51
150720,202306,473,355,118,468608.49,155761.07,624369.56
150730,202306,1252,585,667,772222.77,881768.64,1653991.41
150740,202306,284,179,105,236281.05,138600,374881.05
150745,202306,884,501,383,661343.6,506886.63,1168230.23
150746,202306,79,39,40,51481.55,52800,104281.55
150747,202306,281,191,90,252124.57,120120.3,372244.87
150750,202306,155,86,69,113524.38,91084.08,204608.46
150760,202306,2025,1335,690,1762241.47,913447.13,2675688.60
150770,202306,434,260,174,343201.94,229680.2,572882.14
150775,202306,103,56,47,73920.48,62040.43,135960.91
150780,202306,223,129,94,170281.94,124080,294361.94
150790,202306,765,457,308,604573.17,409203.33,1013776.50
150795,202306,1890,1159,731,1531228.4,964930.94,2496159.34
150796,202306,335,191,144,252122.5,190081.72,442204.22
150797,202306,471,228,243,300969.47,320761.24,621730.71
150800,202306,1792,996,796,1314739.79,1050723.43,2365463.22
150803,202306,375,278,97,366976.19,128041.41,495017.60
150805,202306,234,142,92,187442.66,121440,308882.66
150808,202306,1205,584,621,770884.55,819722.89,1590607.44
150810,202306,3374,2272,1102,3000450.82,1457287.33,4457738.15
150812,202306,582,305,277,402607.66,365640.42,768248.08
150815,202306,1355,838,517,1106173.36,682442.35,1788615.71
150820,202306,1856,1111,745,1466578.14,983416.68,2449994.82
150830,202306,606,462,144,609856.61,190081.1,799937.71
150835,202306,265,168,97,221764.09,128040,349804.09
150840,202306,1571,895,676,1181436.05,892331.51,2073767.56
160005,202306,73,49,24,64681.26,31680.12,96361.38
160010,202306,227,137,90,180846.39,118800.47,299646.86
160015,202306,180,121,59,159733.17,77881.51,237614.68
160020,202306,157,77,80,101641.59,105600,207241.59
160021,202306,70,35,35,46202.18,46200.87,92403.05
160023,202306,81,53,28,69962.57,36960.14,106922.71
160025,202306,33,17,16,22441.25,21120.12,43561.37
160027,202306,1589,885,704,1168259.03,929286.9,2097545.93
160030,202306,18998,9876,9122,13038206.23,12046540.6,25084746.83
160040,202306,386,243,143,320770.03,188761.7,509531.73
160050,202306,863,381,482,502939.25,636251.35,1139190.60
160053,202306,325,198,127,261370.15,167643.46,429013.61
160055,202306,28,21,7,27721.37,9241.06,36962.43
160060,202306,7412,4099,3313,5412272.88,4374575.86,9786848.74
160070,202306,190,110,80,145204.13,105601.18,250805.31
160080,202306,161,83,78,109560.22,102960.28,212520.50
170025,202306,25,14,11,18480,14520.71,33000.71
170030,202306,174,140,34,184806.54,44880,229686.54
170035,202306,213,105,108,138603.62,142561.86,281165.48
170040,202306,189,141,48,186120,63360,249480
170070,202306,340,216,124,285129.2,163680.54,448809.74
170100,202306,365,263,102,347171.96,134640.3,481812.26
170105,202306,41,35,6,46201.58,7920,54121.58
170110,202306,117,73,44,96360.49,58080.1,154440.59
170130,202306,87,44,43,58080,56760,114840
170190,202306,105,62,43,81840.39,56760,138600.39
170200,202306,362,246,116,324723.43,153120.2,477843.63
170210,202306,7210,3978,3232,5254758.28,4272882.59,9527640.87
170215,202306,154,94,60,124083.97,79201.39,203285.36
170220,202306,1366,968,398,1277788.28,525366.59,1803154.87
170230,202306,151,105,46,138603.39,60720.3,199323.69
170240,202306,504,350,154,462023.25,203282.72,665305.97
170255,202306,1041,814,227,1074498.83,299642.75,1374141.58
170270,202306,51,36,15,47520,19800,67320
170290,202306,148,92,56,121441.97,73920,195361.97
170300,202306,119,81,38,106921.19,50160,157081.19
170305,202306,59,43,16,56760.8,21120,77880.8
170307,202306,58,43,15,56761.26,19800.9,76562.16
170310,202306,121,79,42,104281.71,55440,159721.71
170320,202306,41,27,14,35640.2,18480,54120.2
170330,202306,34,24,10,31681.26,13200.1,44881.36
170360,202306,35,21,14,27720.74,18481.48,46202.22
170370,202306,80,47,33,62041.7,43560.2,105601.9
170380,202306,87,66,21,87121.34,27720,114841.34
170382,202306,40,33,7,43560,9240,52800
170384,202306,151,115,36,151800.43,47520.27,199320.70
170386,202306,69,31,38,40920.61,50160,91080.61
170388,202306,45,20,25,26400.23,33000,59400.23
170389,202306,27,20,7,26400.4,9240,35640.4
170390,202306,88,50,38,66000.65,50160.29,116160.94
170410,202306,24,22,2,29042.04,2640,31682.04
170460,202306,13,8,5,10560.22,6600,17160.22
170510,202306,35,26,9,34322.36,11880,46202.36
170550,202306,1664,971,693,1281751.84,914769.15,2196520.99
170555,202306,118,87,31,114844.88,40920,155764.88
170560,202306,102,76,26,100320.77,34320.69,134641.46
170600,202306,40,14,26,18481.53,34320.7,52802.23
170610,202306,197,111,86,146524.58,113520.1,260044.68
170625,202306,33,20,13,26400.99,17160,43560.99
170650,202306,103,71,32,93720.68,42240.2,135960.88
170700,202306,609,450,159,594005.7,209880,803885.7
170710,202306,141,84,57,110884.31,75243.08,186127.39
170720,202306,114,91,23,120120.81,30360,150480.81
170730,202306,123,73,50,97682.46,66000,163682.46
170740,202306,88,66,22,87120,29040,116160
170755,202306,49,27,22,35642.36,29040.76,64683.12
170765,202306,141,87,54,114843.19,71280.04,186123.23
170770,202306,192,125,67,165002.11,88440.73,253442.84
170820,202306,627,420,207,554409.47,273240.52,827649.99
170825,202306,55,31,24,40920.3,31680,72600.3
170830,202306,95,72,23,95040.14,30360.33,125400.47
170900,202306,177,135,42,178203.24,55441.04,233644.28
170930,202306,1064,592,472,781467.86,623046.87,1404514.73
170950,202306,3518,1712,1806,2261218.85,2385259.66,4646478.51
170980,202306,15,10,5,13201.47,6600,19801.47
171050,202306,159,122,37,161040,48840.2,209880.2
171070,202306,63,49,14,64680.9,18480.95,83161.85
171090,202306,50,39,11,51480,14520,66000
171110,202306,25,18,7,23761.2,9240,33001.2
171150,202306,47,32,15,42240,19800,62040
171180,202306,26,13,13,17160,17161.12,34321.12
171190,202306,200,110,90,145203.3,118800,264003.3
171195,202306,59,50,9,66001.49,11880,77881.49
171200,202306,32,15,17,19800.51,22440,42240.51
171215,202306,12,9,3,11880,3960,15840
171240,202306,64,51,13,67320,17160,84480
171245,202306,54,46,8,60721.96,10560,71281.96
171250,202306,82,48,34,63360.2,46200,109560.2
171270,202306,13,9,4,11880.1,5280.22,17160.32
171280,202306,49,40,9,52801.25,11880.1,64681.35
171320,202306,1130,664,466,876494.69,616442.34,1492937.03
171330,202306,467,242,225,319442.3,297000.21,616442.51
171360,202306,110,79,31,104280.62,40920,145200.62
171370,202306,34,20,14,26400,18480.18,44880.18
171380,202306,135,115,20,151801.6,26400,178201.6
171395,202306,43,27,16,35640,21120,56760
171420,202306,269,176,93,232321.46,124080.2,356401.66
171430,202306,72,57,15,75240.2,19800.95,95041.15
171488,202306,223,128,95,168960.14,125400,294360.14
171500,202306,67,38,29,50160.2,38280,88440.2
171510,202306,78,53,25,71280,33000.52,104280.52
171515,202306,42,35,7,46203.13,9240,55443.13
171525,202306,25,22,3,29042.26,3960,33002.26
171550,202306,17,11,6,14520.9,7920,22440.9
171570,202306,62,31,31,40920,40920.1,81840.1
171575,202306,259,177,82,233641.19,108240,341881.19
171610,202306,2107,1093,1014,1442789.69,1338505.43,2781295.12
171620,202306,170,124,46,163680.9,60720.89,224401.79
171630,202306,52,30,22,39600,29040,68640
171650,202306,360,250,110,331331.15,145201.64,476532.79
171660,202306,269,156,113,205927.33,149160.7,355088.03
171665,202306,92,57,35,75241.53,46200.33,121441.86
171670,202306,461,293,168,386767.52,223082.42,609849.94
171700,202306,66,54,12,71280.29,15840,87120.29
171720,202306,26,9,17,11880.7,22440.2,34320.9
171750,202306,105,53,52,69960,68640.7,138600.7
171780,202306,79,61,18,80520.83,23760,104280.83
171790,202306,103,83,20,109560,26400,135960
171800,202306,32,24,8,31680,10560,42240
171820,202306,2244,1310,934,1729244.87,1232885.7,2962130.57
171830,202306,35,27,8,35640.2,10560,46200.2
171840,202306,55,35,20,46200.54,26400,72600.54
171845,202306,37,25,12,33000.88,15840,48840.88
171850,202306,52,42,10,55440.96,13200.87,68641.83
171855,202306,70,51,19,67320.1,25080,92400.1
171865,202306,5,3,2,3960,2640,6600
171870,202306,36,24,12,31680.2,15840.45,47520.65
171875,202306,89,66,23,87120,30360,117480
171880,202306,47,28,19,36960,25080.25,62040.25
171884,202306,57,30,27,39600.98,35640,75240.98
171886,202306,139,64,75,84481.07,99000,183481.07
171888,202306,28,21,7,27721.89,9240.1,36961.99
171889,202306,15,7,8,9240,10560,19800
171890,202306,63,50,13,66704.86,17160,83864.86
171900,202306,25,17,8,22440.2,10560,33000.2
172000,202306,36,32,4,42240.2,5280.2,47520.4
172010,202306,57,41,16,54120,21120.22,75240.22
172015,202306,19,14,5,18481.95,6600,25081.95
172020,202306,124,76,48,100320.7,63360,163680.7
172025,202306,43,27,16,35640.46,21120,56760.46
172030,202306,61,37,24,48841.16,31680,80521.16
172049,202306,89,59,30,77880.3,39600.71,117481.01
172065,202306,116,76,40,100323.08,52800.46,153123.54
172080,202306,130,79,51,104282.03,67321.28,171603.31
172085,202306,28,15,13,19800,17160,36960
172090,202306,485,349,136,460689,179520.94,640209.94
172093,202306,17,15,2,19800,2640,22440
172097,202306,17,9,8,11880,10560,22440
172100,202306,6614,3870,2744,5111186.69,3624770.72,8735957.41
172110,202306,87,59,28,77881.01,36960,114841.01
172120,202306,1797,1483,314,1958954.35,414485.46,2373439.81
172125,202306,16,11,5,14520,6600,21120
172130,202306,28,17,11,22440.59,14520.28,36960.87
172208,202306,204,132,72,174240,95041.38,269281.38
172210,202306,357,181,176,238926.59,232321.19,471247.78
210005,202306,3220,2061,1159,2720642.42,1531224.57,4251866.99
210010,202306,149,102,47,134641.04,62040,196681.04
210015,202306,45,33,12,43560.39,15840,59400.39
210020,202306,403,243,160,320767.88,211202.58,531970.46
210030,202306,324,220,104,290427.26,137284.36,427711.62
210040,202306,120,100,20,132000.1,26400,158400.1
210043,202306,276,230,46,303605.01,60720,364325.01
210047,202306,494,320,174,422401.51,229680,652081.51
210050,202306,279,196,83,258720.78,109560.2,368280.98
210055,202306,57,48,9,63360.29,11880,75240.29
210060,202306,552,449,103,592710.96,135962.81,728673.77
210070,202306,486,375,111,495000.7,146520.32,641521.02
210080,202306,147,137,10,180842.24,13200,194042.24
210083,202306,297,155,142,204601.63,187440.19,392041.82
210087,202306,12,6,6,7920,7920,15840
210090,202306,508,372,136,491065.01,179522.61,670587.62
210095,202306,424,343,81,452767.86,106920.42,559688.28
210100,202306,721,576,145,760333.8,191400.2,951734.0
210110,202306,117,82,35,108240.97,46200.9,154441.87
210120,202306,4875,3955,920,5220837.81,1214415.48,6435253.29
210125,202306,194,124,70,163683.09,92401.74,256084.83
210130,202306,462,291,171,385451.54,225720.89,611172.43
210135,202306,33,25,8,33001.04,10560,43561.04
210140,202306,4742,3616,1126,4773265.41,1486338.32,6259603.73
210150,202306,385,255,130,336611.99,172922.72,509534.71
210160,202306,3302,2818,484,3719854.44,638886.72,4358741.16
210170,202306,1311,1069,242,1411138.91,319441.16,1730580.07
210173,202306,129,119,10,157081.48,13200,170281.48
210177,202306,292,170,122,224401.49,161040,385441.49
210180,202306,33,18,15,23760.2,19800,43560.2
210190,202306,469,323,146,426361.06,192720.7,619081.76
210193,202306,8,6,2,7920.59,2640,10560.59
210197,202306,66,48,18,63360.3,23760.2,87120.5
210200,202306,631,541,90,714147.72,118800.39,832948.11
210203,202306,237,173,64,228362.35,84481.12,312843.47
210207,202306,318,273,45,360363.26,59400,419763.26
210210,202306,727,678,49,894971.96,64680.6,959652.56
210215,202306,80,72,8,95043.31,10560,105603.31
210220,202306,356,308,48,406576.54,63360.01,469936.55
210230,202306,336,274,62,361685.74,81840,443525.74
210232,202306,1227,899,328,1188030.89,432962.09,1620992.98
210235,202306,190,144,46,190084.42,60720.4,250804.82
210237,202306,53,27,26,35642.09,34320,69962.09
210240,202306,81,71,10,93720.7,13200.21,106920.91
210250,202306,196,170,26,224400.79,34320.2,258720.99
210255,202306,409,304,105,401295.44,138601.1,539896.54
210260,202306,393,285,108,376203.15,142560,518763.15
210270,202306,637,462,175,609852.06,231001.66,840853.72
210275,202306,111,88,23,116160.29,30360,146520.29
210280,202306,1122,747,375,986056.95,495003.01,1481059.96
210290,202306,548,373,175,492370.55,231001.49,723372.04
210300,202306,4964,3271,1693,4317814.97,2236086.93,6553901.90
210310,202306,127,81,46,106920.2,60720,167640.2
210312,202306,121,90,31,118801.86,40920,159721.86
210315,202306,131,113,18,149160.18,23760,172920.18
210317,202306,149,116,33,153120.57,43560,196680.57
210320,202306,2513,2172,341,2867127.22,450121.04,3317248.26
210325,202306,158,94,64,124081.58,84481.05,208562.63
210330,202306,4189,2521,1668,3327784.15,2203083.57,5530867.72
210340,202306,1235,962,273,1269889.12,360363.09,1630252.21
210350,202306,700,591,109,780138.31,143880,924018.31
210355,202306,157,134,23,176880.2,30360,207240.2
210360,202306,2053,1513,540,1997209.75,712804.09,2710013.84
210370,202306,1255,673,582,888379.15,768244.12,1656623.27
210375,202306,194,94,100,124089.8,132001.48,256091.28
210380,202306,749,591,158,780130.01,208560.97,988690.98
210390,202306,198,168,30,221763.02,39600,261363.02
210400,202306,427,380,47,501614.31,62040,563654.31
210405,202306,1153,819,334,1081108.17,440881.83,1521990.00
210407,202306,73,63,10,84480,13200,97680
210408,202306,51,47,4,62041.18,5280,67321.18
210409,202306,356,311,45,410523.96,59400.62,469924.58
210410,202306,455,368,87,485761.95,114840,600601.95
210420,202306,212,173,39,228362.49,51480.32,279842.81
210430,202306,59,43,16,56760.5,21120,77880.5
210440,202306,377,258,119,340570.81,157080.78,497651.59
210450,202306,111,98,13,129362.73,17160,146522.73
210455,202306,252,132,120,174246.68,158402.65,332649.33
210460,202306,321,220,101,290408.69,134640.25,425048.94
210462,202306,78,64,14,84481.64,18480.33,102961.97
210465,202306,128,103,25,135960.91,33000,168960.91
210467,202306,578,443,135,584777.21,178201.12,762978.33
210470,202306,42,37,5,48840,6600,55440
210480,202306,1395,1025,370,1353040.43,488405.05,1841445.48
210490,202306,181,130,51,171603.23,67320.2,238923.43
210500,202306,509,336,173,443538.73,228362.12,671900.85
210510,202306,533,436,97,575522.81,128042.12,703564.93
210515,202306,332,227,105,299643.73,138600.2,438243.93
210520,202306,400,365,35,481809.05,46200.36,528009.41
210530,202306,10169,5174,4995,6830020.58,6594905.84,13424926.42
210535,202306,124,98,26,129361.98,34320,163681.98
210540,202306,1604,1110,494,1465250.79,652085.06,2117335.85
210542,202306,1095,568,527,749783.53,695653.8,1445437.33
210545,202306,23,21,2,27720.71,2640,30360.71
210547,202306,127,113,14,149162.15,18480.31,167642.46
210550,202306,605,432,173,570265.2,229681.71,799946.91
210560,202306,165,145,20,191402.75,26400.33,217803.08
210565,202306,28,20,8,26400.89,10560.26,36961.15
210570,202306,1314,1121,193,1479755.35,254761.34,1734516.69
210580,202306,131,116,15,153120.78,19800.16,172920.94
210590,202306,680,575,105,759002.95,138600,897602.95
210592,202306,50,46,4,60720,5280,66000
210594,202306,118,102,16,134641.1,21120,155761.1
210596,202306,121,107,14,141241.84,18480,159721.84
210598,202306,139,106,33,139920.9,43560.2,183481.1
210600,202306,306,266,40,351131.12,52800.7,403931.82
210610,202306,254,236,18,311525.73,23760.26,335285.99
210620,202306,44,31,13,40920.01,17160,58080.01
210630,202306,92,84,8,110881.4,10560,121441.4
210632,202306,985,714,271,942484.92,357720,1300204.92
210635,202306,27,23,4,30360.9,5280.2,35641.1
210637,202306,117,85,32,112200.2,42240,154440.2
210640,202306,574,517,57,682443.15,77880,760323.15
210650,202306,414,353,61,465968.24,80520.7,546488.94
210660,202306,387,309,78,407903.18,102962.43,510865.61
210663,202306,84,67,17,88440.62,22440,110880.62
210667,202306,86,46,40,60721.52,52800.67,113522.19
210670,202306,266,237,29,312845.66,38280,351125.66
210675,202306,487,289,198,381490.08,261362.46,642852.54
210680,202306,234,156,78,205922.52,102960,308882.52
210690,202306,111,96,15,126721.17,19800,146521.17
210700,202306,153,116,37,153120.4,48840.2,201960.6
210710,202306,273,168,105,221761.93,138600.8,360362.73
210720,202306,132,119,13,157080.08,17160,174240.08
210725,202306,67,57,10,75245.4,13200,88445.4
210730,202306,19,13,6,17160,7920,25080
210735,202306,294,215,79,283801.13,104280,388081.13
210740,202306,518,454,64,599306.89,84480,683786.89
210745,202306,164,130,34,171600.52,44880,216480.52
210750,202306,2859,1577,1282,2081693.63,1692255.76,3773949.39
210760,202306,262,208,54,274563.18,71280.19,345843.37
210770,202306,246,204,42,269297.94,55442.24,324740.18
210780,202306,417,319,98,421094.58,129361.29,550455.87
210790,202306,199,170,29,224403.73,38280,262683.73
210800,202306,180,138,42,182171.41,55440.55,237611.96
210805,202306,71,64,7,84480,9240,93720
210810,202306,435,361,74,476536.91,97680,574216.91
210820,202306,1966,1676,290,2212399.53,384123.71,2596523.24
210825,202306,156,99,57,130681.71,75240.2,205921.91
210830,202306,700,500,200,660007.89,264001.95,924009.84
210840,202306,206,154,52,203281.34,68640,271921.34
210845,202306,232,180,52,237603.69,68640,306243.69
210850,202306,717,525,192,693028.87,253442.91,946471.78
210860,202306,3464,2142,1322,2827498.3,1745047.5,4572545.8
210870,202306,402,316,86,417138.29,113520.2,530658.49
210880,202306,93,77,16,101641.71,21120,122761.71
210890,202306,317,281,36,370933.51,47520,418453.51
210900,202306,724,464,260,612500.34,343203.62,955703.96
210905,202306,74,41,33,54120.2,43560,97680.2
210910,202306,2126,1607,519,2122618.22,685088.21,2807706.43
210920,202306,143,69,74,91081.82,97680,188761.82
210923,202306,78,63,15,83161.43,19800,102961.43
210927,202306,417,224,193,295681.87,254760.2,550442.07
210930,202306,87,76,11,100320.4,14520,114840.4
210940,202306,82,65,17,85802.19,22440,108242.19
210945,202306,210,127,83,167641.82,109560,277201.82
210950,202306,522,389,133,513485.08,176880.65,690365.73
210955,202306,96,58,38,76561.48,50160.9,126722.38
210960,202306,2495,1312,1183,1731856.11,1561563.09,3293419.20
210970,202306,110,92,18,121440.82,23760.9,145201.72
210975,202306,76,72,4,95040.85,5280.36,100321.21
210980,202306,1058,551,507,727337.97,669242.67,1396580.64
210990,202306,4502,3230,1272,4263727.51,1680382.01,5944109.52
211000,202306,1334,1097,237,1448085.06,312843.08,1760928.14
211003,202306,962,726,236,958337.49,311520.56,1269858.05
211010,202306,501,451,50,595327.72,66000.29,661328.01
211020,202306,1361,647,714,854061.58,942496.93,1796558.51
211023,202306,41,35,6,46201,7920,54121
211027,202306,83,64,19,84480.78,25080,109560.78
211030,202306,371,271,100,357722.01,132000.5,489722.51
211040,202306,300,258,42,340562.44,55440,396002.44
211050,202306,1161,816,345,1077152.11,455402.29,1532554.40
211060,202306,642,570,72,752432.67,95040.4,847473.07
211065,202306,27,21,6,27723.97,7920.03,35644.00
211070,202306,836,706,130,933281.2,171601.57,1104882.77
211080,202306,89,87,2,114841.28,2640,117481.28
211085,202306,63,34,29,44880,38280,83160
211090,202306,92,80,12,105603.35,15840,121443.35
211100,202306,473,402,71,530654.85,93720.4,624375.25
211102,202306,226,168,58,221760.4,76560,298320.4
211105,202306,226,165,61,217800,80520.26,298320.26
211107,202306,129,84,45,110880.2,59400,170280.2
211110,202306,999,685,314,905546.18,414485.75,1320031.93
211120,202306,5361,2964,2397,3912691.02,3164081.26,7076772.28
211125,202306,25,18,7,23760,9240,33000
211130,202306,43032,21283,21749,28097453.22,28720969.61,56818422.83
211140,202306,361,324,37,427697.51,48840.47,476537.98
211150,202306,1236,896,340,1182756.6,448803.7,1631560.3
211153,202306,170,103,67,135960,88440,224400
211157,202306,70,58,12,76560,15840,92400
211160,202306,694,586,108,773530.51,142560.9,916091.41
211163,202306,3,2,1,2640,1320,3960
211167,202306,10,10,0,13200,,13200.0
211170,202306,425,322,103,425043.17,135961.48,561004.65
211172,202306,100,75,25,99001.07,33000,132001.07
211174,202306,29,17,12,22440,15840.34,38280.34
211176,202306,467,344,123,454085.56,162361.83,616447.39
211178,202306,98,68,30,89761.82,39600,129361.82
211180,202306,214,177,37,233642.22,48840.98,282483.20
211190,202306,74,66,8,87120.2,10560,97680.2
211195,202306,42,29,13,39605,17160,56765
211200,202306,149,125,24,165002.22,31680,196682.22
211210,202306,399,305,94,402609.46,124080.66,526690.12
211220,202306,4548,2760,1788,3647352.78,2361694.66,6009047.44
211223,202306,140,127,13,167644,17160,184804
211227,202306,63,48,15,63360.2,19800,83160.2
211230,202306,719,597,122,788075.15,161042.54,949117.69
211240,202306,382,323,59,426363.75,77880,504243.75
211245,202306,185,102,83,134642.82,109560.2,244203.02
211250,202306,1483,1280,203,1689681.65,267964.58,1957646.23
211260,202306,809,697,112,920048.64,147840,1067888.64
211270,202306,1841,1546,295,2040761.94,389401.63,2430163.57
211280,202306,1811,1280,531,1689632.38,700920.75,2390553.13
211285,202306,228,153,75,201960.83,99000,300960.83
211290,202306,819,590,229,778805.36,302281.21,1081086.57
211300,202306,777,636,141,839541.54,186121.16,1025662.70
211400,202306,1583,1055,528,1392631.59,696961.94,2089593.53
220005,202306,19,17,2,22440,2640,25080
220010,202306,79,67,12,88440.66,15840,104280.66
220020,202306,764,626,138,826332.34,182161.29,1008493.63
220025,202306,109,103,6,135961.96,7920,143881.96
220027,202306,62,49,13,64680.2,17160,81840.2
220030,202306,135,110,25,145201.62,33000,178201.62
220040,202306,1344,1037,307,1371508.59,406562.77,1778071.36
220045,202306,31,23,8,30362.3,10561.55,40923.85
220050,202306,684,575,109,758942.62,143880.94,902823.56
220060,202306,193,169,24,223086.52,31680.35,254766.87
220070,202306,113,99,14,130683,18480.7,149163.7
220080,202306,14,12,2,15840.22,2640,18480.22
220090,202306,45,32,13,42240.78,17160,59400.78
220095,202306,3,2,1,2640,1320,3960
220100,202306,24,20,4,26400.71,5280,31680.71
220105,202306,31,28,3,36960.95,3960,40920.95
220110,202306,265,241,24,318122.58,31680,349802.58
220115,202306,50,42,8,55440,10560,66000
220117,202306,25,23,2,30360,2640,33000
220120,202306,1569,1227,342,1620990.06,451440.2,2072430.26
220130,202306,27,27,0,35640,,35640.0
220140,202306,86,73,13,96361.1,17160.84,113521.94
220150,202306,510,384,126,506904.58,166323.67,673228.25
220155,202306,27,26,1,34320.36,1320,35640.36
220157,202306,22,19,3,25081.49,3960,29041.49
220160,202306,109,97,12,128040.5,17160,145200.5
220170,202306,44,35,9,46200,11880,58080
220173,202306,21,18,3,23760,3960,27720
220177,202306,19,19,0,25080.4,,25080.4
220180,202306,67,65,2,85801.48,2640,88441.48
220190,202306,1217,1045,172,1379427.25,227044.76,1606472.01
220191,202306,37,33,4,43561.11,5280,48841.11
220192,202306,96,89,7,117481.71,9240,126721.71
220194,202306,59,53,6,69960.92,7920,77880.92
220196,202306,81,67,14,88444.29,18480.2,106924.49
220198,202306,2,2,0,2640,,2640.0
220200,202306,411,354,57,467304.29,75241.04,542545.33
220202,202306,37,33,4,43561.17,5280,48841.17
220205,202306,68,60,8,79200.2,11880,91080.2
220207,202306,15,15,0,19800.92,,19800.92
220208,202306,73,46,27,60720.57,35640.2,96360.77
220209,202306,34,29,5,38280,6600,44880
220210,202306,33,28,5,36960,6600,43560
220211,202306,37,36,1,47524.46,1320,48844.46
220213,202306,36,33,3,43561.19,3960,47521.19
220217,202306,43,34,9,44880.3,11880,56760.3
220220,202306,2463,1654,809,2183320.17,1069211.88,3252532.05
220225,202306,11,6,5,7920.4,6600,14520.4
220230,202306,1027,773,254,1020380.7,335286.49,1355667.19
220240,202306,168,149,19,196681.43,25080.54,221761.97
220245,202306,50,47,3,62041.41,3960,66001.41
220250,202306,151,126,25,166321.99,33000,199321.99
220253,202306,52,46,6,60720.25,7920,68640.25
220255,202306,52,45,7,59400.2,9240,68640.2
220260,202306,729,559,170,737894.83,224401.68,962296.51
220265,202306,16,13,3,17160,3960,21120
220270,202306,887,797,90,1052051.54,118800.72,1170852.26
220271,202306,40,31,9,40921.83,11880,52801.83
220272,202306,19,19,0,25080.7,,25080.7
220273,202306,19,16,3,21120.4,3960,25080.4
220275,202306,70,60,10,79200,13200,92400
220277,202306,32,24,8,31680.9,10560.1,42241.0
220280,202306,21,16,5,21120,6600,27720
220285,202306,46,42,4,55440.77,5280,60720.77
220290,202306,1605,1376,229,1816299.5,302283.73,2118583.23
220300,202306,43,43,0,56762.39,,56762.39
220310,202306,352,300,52,396015.49,68642.45,464657.94
220320,202306,481,441,40,582145.21,52801.68,634946.89
220323,202306,3,1,2,1320.8,2640,3960.8
220325,202306,9,8,1,10560,1320,11880
220327,202306,15,15,0,19800.31,,19800.31
220330,202306,219,157,62,207240.56,81840,289080.56
220335,202306,136,116,20,153121.95,26400,179521.95
220340,202306,52,40,12,52800,15840,68640
220342,202306,55,48,7,63363.26,9240,72603.26
220345,202306,94,83,11,109561.33,14520.03,124081.36
220350,202306,478,419,59,553084.41,77880.05,630964.46
220360,202306,49,33,16,43560,21120,64680
220370,202306,1411,1181,230,1558954.88,303600.4,1862555.28
220375,202306,21,20,1,26401.65,1320,27721.65
220380,202306,26,20,6,26401.4,7920,34321.4
220385,202306,18,16,2,21120,2640.66,23760.66
220390,202306,2539,1411,1128,1862584.64,1488985.57,3351570.21
220400,202306,37,31,6,40920,7920,48840
220410,202306,24,23,1,30360.2,1320,31680.2
220415,202306,14,12,2,15841.16,2640,18481.16
220420,202306,135,114,21,150480.78,27720,178200.78
220430,202306,155,136,19,179525.23,25080.2,204605.43
220435,202306,27,21,6,27720.72,7920,35640.72
220440,202306,294,251,43,331337.77,56760,388097.77
220450,202306,379,193,186,254768.1,245526.96,500295.06
220455,202306,57,54,3,71280.4,3960,75240.4
220460,202306,22,21,1,27721.9,1320.89,29042.79
220465,202306,68,48,20,63361.69,26400.41,89762.10
220470,202306,246,217,29,286447.34,38280.86,324728.20
220480,202306,66,61,5,80520.54,6600,87120.54
220490,202306,88,74,14,97680,18480,116160
220500,202306,132,111,21,146520.93,27720,174240.93
220510,202306,367,288,79,380172.06,104280.88,484452.94
220515,202306,30,27,3,35641.13,3960,39601.13
220520,202306,396,349,47,460689.94,62041.26,522731.20
220525,202306,9,5,4,6600.38,5280.98,11881.36
220527,202306,14,14,0,18480.38,,18480.38
220530,202306,50,23,27,30360,35640.87,66000.87
220535,202306,4,4,0,5280.81,,5280.81
220540,202306,117,102,15,134641.2,19800.2,154441.4
220545,202306,23,16,7,21121,9240.8,30361.8
220550,202306,780,619,161,817107.67,212522.24,1029629.91
220551,202306,14,12,2,15840,2640,18480
220552,202306,14,14,0,18480,,18480.0
220553,202306,64,59,5,77880.85,6600,84480.85
220554,202306,6,4,2,5280.95,2640,7920.95
220555,202306,49,39,10,51482.02,13200,64682.02
220556,202306,40,37,3,48841.62,3960,52801.62
220557,202306,66,61,5,80521.36,6600.74,87122.10
220558,202306,15,8,7,10560,9240.54,19800.54
220559,202306,6,5,1,6600.07,1320,7920.07
220560,202306,87,56,31,73921.57,40920,114841.57
220570,202306,745,467,278,616450.56,366963.57,983414.13
220580,202306,568,524,44,691715.99,58081.93,749797.92
220585,202306,14,11,3,14520.2,3960.43,18480.63
220590,202306,18,16,2,21121.95,2640,23761.95
220595,202306,74,57,17,75240.4,22440,97680.4
220600,202306,22,16,6,21120,7920,29040
220605,202306,33,30,3,39600.2,3960,43560.2
220610,202306,98,82,16,108240,21120,129360
220620,202306,579,499,80,658692.93,105602.09,764295.02
220630,202306,3,2,1,2640,1320,3960
220635,202306,35,32,3,42242.23,3960,46202.23
220640,202306,113,95,18,125400,23760,149160
220650,202306,118,112,6,147840.93,7920,155760.93
220660,202306,93,68,25,89760.92,33000.7,122761.62
220665,202306,14,14,0,18480,,18480.0
220667,202306,27,24,3,31680.26,3960,35640.26
220669,202306,47,41,6,54120.2,7920,62040.2
220670,202306,74,57,17,75240.9,22440,97680.9
220672,202306,79,57,22,75245.26,29041.21,104286.47
220675,202306,28,22,6,29041.76,7920,36961.76
220680,202306,63,54,9,71280.2,11880,83160.2
220690,202306,51,48,3,63360.61,3960,67320.61
220695,202306,31,17,14,22441.19,18480,40921.19
220700,202306,1954,1517,437,2002469.13,576845.72,2579314.85
220710,202306,9,7,2,9240.2,2640.78,11880.98
220720,202306,112,99,13,130680,17160,147840
220730,202306,31,30,1,39600.01,1320,40920.01
220735,202306,9,7,2,9240,2640,11880
220740,202306,64,56,8,73920.2,10560.91,84481.11
220750,202306,138,117,21,154442.8,27720.18,182162.98
220755,202306,21,20,1,26401.29,1320,27721.29
220760,202306,70,61,9,80522.58,11880,92402.58
220770,202306,6324,3661,2663,4835403.65,3517882.21,8353285.86
220775,202306,12,10,2,13200.7,2640.48,15841.18
220777,202306,24,23,1,30360,1320,31680
220779,202306,7,2,5,2640,6600,9240
220780,202306,977,829,148,1094290.43,195360.69,1289651.12
220785,202306,7,4,3,5280,3960.2,9240.2
220790,202306,1291,1039,252,1371514.12,332647.56,1704161.68
220793,202306,10,7,3,9240,3960,13200
220795,202306,25,24,1,31680.27,1320,33000.27
220800,202306,4215,3222,993,4253369.68,1313414.48,5566784.16
220810,202306,83,70,13,92401.61,17160,109561.61
220820,202306,259,234,25,308888.04,33001.8,341889.84
220830,202306,1374,1217,157,1607575.29,207241.33,1814816.62
220840,202306,2702,1915,787,2529196.16,1041499.28,3570695.44
220850,202306,82,70,12,92400,15840,108240
220855,202306,8,4,4,5280,5280,10560
220860,202306,16,13,3,17162.04,3960,21122.04
220865,202306,30,27,3,35640.1,3960,39600.1
220870,202306,91,82,9,108241.14,11880,120121.14
220880,202306,346,286,60,377533.16,79201.92,456735.08
220885,202306,29,28,1,36963.12,1320,38283.12
220887,202306,6,5,1,6600.2,1320,7920.2
220890,202306,87,74,13,97681.9,17160,114841.9
220900,202306,28,16,12,21120,15840,36960
220910,202306,49,38,11,50162.13,14520,64682.13
220915,202306,13,11,2,14520.19,2640,17160.19
220920,202306,51,45,6,59401.39,7920,67321.39
220930,202306,56,54,2,71280.35,2640,73920.35
220935,202306,18,18,0,23760.97,,23760.97
220937,202306,35,31,4,40921.39,5280,46201.39
220940,202306,67,58,9,76560,11880,88440
220945,202306,6,6,0,7920.65,,7920.65
220950,202306,39,30,9,39600.2,11880,51480.2
220955,202306,27,25,2,33000.77,2640,35640.77
220960,202306,43,38,5,50160,6600,56760
220965,202306,57,52,5,68640,6600,75240
220970,202306,64,54,10,71280,13200,84480
220975,202306,13,11,2,14520.9,2640,17160.9
220980,202306,29,27,2,35640.76,2640,38280.76
220985,202306,57,49,8,64680,10560,75240
220987,202306,33,32,1,42243.01,1320.31,43563.32
220990,202306,25,23,2,30360,2992,33352
220995,202306,14,12,2,15840,2640,18480
220997,202306,76,68,8,89762.08,10560,100322.08
221000,202306,1364,1208,156,1594601.55,205920.86,1800522.41
221005,202306,45,41,4,54120,5280.82,59400.82
221010,202306,28,20,8,26400,10560,36960
221020,202306,45,40,5,52800.82,6600,59400.82
221030,202306,47,39,8,51376.43,10560.2,61936.63
221035,202306,22,21,1,27721.96,1320,29041.96
221037,202306,14,10,4,13200,5280,18480
221038,202306,26,23,3,30360,3960,34320
221039,202306,29,27,2,35640.04,2640.2,38280.24
221040,202306,267,225,42,297005.74,55442.1,352447.84
221050,202306,241,200,41,264010.28,54120.2,318130.48
221060,202306,2105,1808,297,2389248.06,393365.96,2782614.02
221062,202306,29,29,0,38282.64,,38282.64
221063,202306,20,15,5,19800,6600,26400
221065,202306,80,65,15,85802.93,19800,105602.93
221070,202306,167,146,21,192724.16,27720,220444.16
221080,202306,441,374,67,493692.37,88440,582132.37
221090,202306,33,27,6,35642.42,7920,43562.42
221093,202306,51,35,16,46201.2,21120.45,67321.65
221095,202306,5,5,0,6600,,6600.0
221097,202306,13,10,3,13200,3960,17160
221100,202306,28881,17295,11586,22840998.61,15300426.62,38141425.23
221110,202306,1226,952,274,1256684.74,361686.59,1618371.33
221120,202306,615,446,169,588732.69,223080.39,811813.08
221130,202306,1069,863,206,1139178.7,271923.37,1411102.07
221135,202306,35,32,3,42241.09,3960,46201.09
221140,202306,49,43,6,56760.2,7920,64680.2
221150,202306,14,10,4,13200.18,5280,18480.18
221160,202306,20,18,2,23761.39,2640,26401.39
221170,202306,21,20,1,26400,1320,27720
230010,202306,171,149,22,196681.96,29040,225721.96
230015,202306,178,147,31,194040.7,40920,234960.7
230020,202306,1979,1566,413,2067174.15,545172.46,2612346.61
230030,202306,1773,1298,475,1713421,627008.32,2340429.32
230040,202306,251,201,50,265321.6,66000,331321.6
230050,202306,258,179,79,236281.01,104280.57,340561.58
230060,202306,187,147,40,194040.88,52800.94,246841.82
230070,202306,334,285,49,376204.94,66000,442204.94
230075,202306,990,818,172,1079784.04,227045.6,1306829.64
230080,202306,246,200,46,264002.76,60720,324722.76
230090,202306,201,146,55,192721.03,73920,266641.03
230100,202306,2991,1677,1314,2213732.95,1735823.5,3949556.45
230110,202306,3304,2087,1217,2754913.51,1607779.18,4362692.69
230120,202306,1302,988,314,1304188.87,414483.26,1718672.13
230125,202306,195,155,40,204600.83,52800.44,257401.27
230130,202306,546,474,72,625687.63,95040.81,720728.44
230140,202306,239,195,44,257400.51,58080,315480.51
230150,202306,156,119,37,157081.46,48840.51,205921.97
230160,202306,1035,841,194,1110127.75,256080.82,1366208.57
230170,202306,695,599,96,790700.36,126724.61,917424.97
230180,202306,70,63,7,83160.39,9240,92400.39
230185,202306,456,390,66,514808.92,87121.14,601930.06
230190,202306,2747,2062,685,2723235.53,904209.56,3627445.09
230195,202306,552,470,82,620419.11,108240,728659.11
230200,202306,499,385,114,508206.58,150480.2,658686.78
230205,202306,431,284,147,376201.17,194040.2,570241.37
230210,202306,1518,1152,366,1520664.75,483120.78,2003785.53
230220,202306,1766,1168,598,1541799.25,789366.25,2331165.50
230230,202306,1094,876,218,1156347.65,287762.96,1444110.61
230240,202306,2294,2007,287,2649294.02,378843.17,3028137.19
230250,202306,1993,1612,381,2129233.97,504248.92,2633482.89
230260,202306,3572,2212,1360,2921193.42,1797844.06,4719037.48
230270,202306,1486,1143,343,1510098.13,452764.88,1962863.01
230280,202306,3093,2369,724,3129818.48,955689.12,4085507.60
230290,202306,374,325,49,429015.24,64681.22,493696.46
230300,202306,551,403,148,531963.04,195360.29,727323.33
230310,202306,455,346,109,456720.48,143880.91,600601.39
230320,202306,1008,834,174,1100902.63,229681.18,1330583.81
230330,202306,355,287,68,378842.55,89760,468602.55
230340,202306,482,387,95,512169.11,125400.4,637569.51
230350,202306,3723,2267,1456,2993847.61,1925897.86,4919745.47
230360,202306,289,240,49,316805.44,64680.28,381485.72
230365,202306,150,119,31,157082.05,40920,198002.05
230370,202306,12763,6426,6337,8485445.65,8371670.38,16857116.03
230380,202306,565,481,84,634934.49,112202.69,747137.18
230390,202306,566,327,239,431643.46,315480,747123.46
230393,202306,251,204,47,269281.33,62040.5,331321.83
230395,202306,395,314,81,414504.24,106922.59,521426.83
230400,202306,715,565,150,747128.8,198000.2,945129.0
230410,202306,3124,1986,1138,2624229.81,1503497.9,4127727.71
230420,202306,7152,4694,2458,6200323.5,3244656.73,9444980.23
230423,202306,367,316,51,417122.98,67320.1,484443.08
230425,202306,563,449,114,592689.67,150481.24,743170.91
230426,202306,130,103,27,135960.7,36960,172920.7
230427,202306,80,69,11,91080.06,14520,105600.06
230428,202306,1961,944,1017,1246113.09,1342454.19,2588567.28
230430,202306,497,399,98,526691.28,129362,656053.28
230435,202306,1014,726,288,959662.55,380161.34,1339823.89
230440,202306,108803,50212,58591,66321221.8,77390377.24,143711599.04
230445,202306,357,239,118,315490.43,157080.7,472571.13
230450,202306,631,488,143,644162.79,188760.7,832923.49
230460,202306,116,83,33,109560.69,43560,153120.69
230465,202306,335,270,65,359044.32,85800,444844.32
230470,202306,2200,1726,474,2278344.38,625683.39,2904027.77
230480,202306,162,146,16,192720.5,21121.37,213841.87
230490,202306,362,284,78,374882.72,102960.13,477842.85
230495,202306,543,385,158,508214.78,208562.92,716777.70
230500,202306,1260,934,326,1232891.84,430322.54,1663214.38
230510,202306,83,56,27,73920,35640,109560
230520,202306,450,339,111,447484.49,146520.62,594005.11
230523,202306,2918,1780,1138,2349676.86,1503497.79,3853174.65
230526,202306,263,217,46,286441.66,60720,347161.66
230530,202306,753,532,221,704891.25,294363.34,999254.59
230533,202306,233,213,20,281162.14,26400.2,307562.34
230535,202306,452,336,116,443535.3,153121.68,596656.98
230540,202306,1922,1709,213,2257258.76,281163.9,2538422.66
230550,202306,4616,2913,1703,3845354.17,2250646.93,6096001.10
230560,202306,631,485,146,640210.82,192720.57,832931.39
230565,202306,245,181,64,238920.7,84481.14,323401.84
230570,202306,337,288,49,380161.57,64680.45,444842.02
230580,202306,1345,916,429,1209133.15,567648.18,1776781.33
230590,202306,1187,902,285,1191868.99,376201.77,1568070.76
230600,202306,317,285,32,376207.93,42240,418447.93
230610,202306,520,384,136,506891.49,179520.2,686411.69
230620,202306,185,152,33,200642.57,43560,244202.57
230625,202306,963,645,318,851420.63,419760.83,1271181.46
230630,202306,1628,1209,419,1595916.61,554404.78,2150321.39
230640,202306,4376,3531,845,4662415.42,1116744.95,5779160.37
230650,202306,541,461,80,608525.89,105601.33,714127.22
230655,202306,817,640,177,844828.72,233643.53,1078472.25
230660,202306,418,340,78,448803.34,102960.2,551763.54
230670,202306,523,412,111,543859.79,146521.1,690380.89
230680,202306,244,206,38,273246.67,50160,323406.67
230690,202306,1055,878,177,1160309.41,234961.88,1395271.29
230700,202306,1132,934,198,1232908.65,261361.68,1494270.33
230710,202306,731,667,64,880465.53,84480.8,964946.33
230720,202306,157,134,23,176880,30360.7,207240.7
230725,202306,321,242,79,319443.12,104281.17,423724.29
230730,202306,14302,7512,6790,9920405.51,8965597.16,18886002.67
230740,202306,772,622,150,822382.42,198001.1,1020383.52
230750,202306,910,748,162,987377.37,213841.01,1201218.38
230760,202306,1792,1511,281,1994589.96,370922.63,2365512.59
230763,202306,409,344,65,454083.86,85800,539883.86
230765,202306,9889,4728,5161,6245320.28,6816706.32,13062026.60
230770,202306,5745,2981,2764,3937719.99,3652474.12,7590194.11
230780,202306,875,749,126,988689.74,167640.1,1156329.84
230790,202306,342,279,63,368280.61,83160.41,451441.02
230800,202306,1330,935,395,1234216.71,521401.85,1755618.56
230810,202306,1552,1336,216,1763594.83,285125.32,2048720.15
230820,202306,415,269,146,355084.71,192721.27,547805.98
230830,202306,1032,859,173,1133901.07,228360.9,1362261.97
230835,202306,309,254,55,335284.69,72600.68,407885.37
230837,202306,205,162,43,213842.33,56760.02,270602.35
230840,202306,1047,779,268,1030929.33,353762.89,1384692.22
230850,202306,1506,1260,246,1663245.79,324724.27,1987970.06
230860,202306,368,288,80,381484.07,105606.6,487090.67
230870,202306,1998,1685,313,2224239.2,413160.47,2637399.67
230880,202306,90,69,21,91080,27720,118800
230890,202306,620,544,76,718087.78,100321.8,818409.58
230900,202306,341,253,88,333962.08,116160.24,450122.32
230910,202306,245,189,56,249482.22,73920,323402.22
230920,202306,545,422,123,558368.31,162360,720728.31
230930,202306,1242,867,375,1144466.46,495002.24,1639468.70
230940,202306,918,705,213,930617.49,281160.73,1211778.22
230945,202306,631,500,131,660026.17,172925.41,832951.58
230950,202306,475,409,66,539899.54,87120.5,627020.04
230960,202306,3125,2094,1031,2764213.55,1360953.35,4125166.90
230970,202306,2085,1147,938,1514094.06,1238177.08,2752271.14
230980,202306,249,180,69,237602.86,91080,328682.86
230990,202306,150,117,33,154440.5,43560,198000.5
231000,202306,222,204,18,269282.51,23760,293042.51
231010,202306,202,136,66,179522.71,87120,266642.71
231020,202306,1635,1076,559,1421698.17,737894.36,2159592.53
231025,202306,1250,858,392,1132601.68,517453.85,1650055.53
231030,202306,1156,930,226,1227614.63,298321.97,1525936.60
231040,202306,203,141,62,187443.47,81840,269283.47
231050,202306,1026,870,156,1148421.14,205926.44,1354347.58
231060,202306,176,141,35,186124.62,46201,232325.62
231070,202306,1678,1150,528,1518033.55,696967.73,2215001.28
231080,202306,288,251,37,331328.16,48840,380168.16
231085,202306,784,482,302,636259.36,398640.26,1034899.62
231090,202306,290,234,56,308884.53,73921.64,382806.17
231095,202306,172,129,43,170280,56760.61,227040.61
231100,202306,205,165,40,217801.6,52800,270601.6
231110,202306,400,331,69,436929.68,92403.59,529333.27
231120,202306,285,233,52,307564.2,68640.7,376204.9
231123,202306,160,152,8,200642.82,10560,211202.82
231126,202306,364,283,81,373561.09,106920,480481.09
231130,202306,5470,4244,1226,5606266.42,1620986.71,7227253.13
231135,202306,244,211,33,278522.14,43561.41,322083.55
231140,202306,3336,2390,946,3156215.78,1248733.86,4404949.64
231150,202306,430,394,36,520092.38,47521.12,567613.50
231160,202306,1372,1119,253,1477108.64,333961.37,1811070.01
231170,202306,584,402,182,530644.66,240240,770884.66
231180,202306,2143,1851,292,2444706,385446.38,2830152.38
231190,202306,256,206,50,271920.54,66000,337920.54
231195,202306,254,206,48,271922.16,63360.15,335282.31
231200,202306,954,759,195,1003228.14,257402.2,1260630.34
231210,202306,553,456,97,601929.21,128041.39,729970.60
231220,202306,1175,820,355,1082423.7,468602.83,1551026.53
231230,202306,1745,1275,470,1683025.58,620401.39,2303426.97
231240,202306,1837,1224,613,1615717.26,809168.8,2424886.06
231250,202306,99,93,6,122761.53,7920,130681.53
231260,202306,280,189,91,249482.15,120122.22,369604.37
231270,202306,1070,814,256,1074509.96,337921.12,1412431.08
231280,202306,91,68,23,89762.11,30360.8,120122.91
231290,202306,8978,5003,3975,6608185.85,5249735.76,11857921.61
231300,202306,642,577,65,761647.62,85800,847447.62
231310,202306,922,838,84,1106175.4,110880.94,1217056.34
231320,202306,687,513,174,677165.71,229681.62,906847.33
231325,202306,110,94,16,124080.18,21120.54,145200.72
231330,202306,2139,1607,532,2122623.65,702249.16,2824872.81
231335,202306,270,238,32,314165.8,43560,357725.8
231340,202306,2155,1456,699,1921967.75,924009.76,2845977.51
231350,202306,1615,1246,369,1646101.97,488414.68,2134516.65
231355,202306,452,369,83,487085.94,110881.24,597967.18
231360,202306,650,436,214,575535.65,283801.94,859337.59
231370,202306,101,86,15,113520,19800,133320
231375,202306,303,225,78,297006.57,102960.1,399966.67
231380,202306,579,459,120,605885.1,158400,764285.1
231390,202306,216,165,51,217801.37,67320,285121.37
231395,202306,851,497,354,657364.62,467280.55,1124645.17
231400,202306,1348,1118,230,1475790.96,304924.45,1780715.41
231410,202306,1560,1257,303,1660590.94,399962.28,2060553.22
240010,202306,433,202,231,266652.05,304929.88,571581.93
240020,202306,2499,2047,452,2702160.14,596649.87,3298810.01
240030,202306,124,97,27,128041.8,35640,163681.8
240040,202306,37,35,2,46200,2640,48840
240050,202306,560,480,80,633631.46,105600.1,739231.56
240060,202306,91,80,11,105601.79,14520,120121.79
240070,202306,312,239,73,315484.97,96360.2,411845.17
240080,202306,641,430,211,567622.67,278528.86,846151.53
240090,202306,116,101,15,133320.32,19800,153120.32
240100,202306,1670,1564,106,2064545.77,139922.39,2204468.16
240110,202306,1152,780,372,1029680.47,491061.99,1520742.46
240120,202306,163,120,43,158402.07,56760.25,215162.32
240130,202306,280,256,24,337933.99,31680.7,369614.69
240140,202306,95,62,33,81841.39,43560.64,125402.03
240145,202306,799,704,95,929313.04,125400.7,1054713.74
240150,202306,30,22,8,29040,10560,39600
240160,202306,40,32,8,42240,10560,52800
240165,202306,41,33,8,43563.26,10560.1,54123.36
240170,202306,172,119,53,157081.59,69960,227041.59
240180,202306,132,98,34,129363,44880,174243
240185,202306,56,47,9,62040.39,11880,73920.39
240190,202306,15,13,2,17160.43,2640,19800.43
240200,202306,3397,1814,1583,2394543.34,2090902.73,4485446.07
240210,202306,170,127,43,167640.73,56760,224400.73
240220,202306,1248,842,406,1114123.62,535925.2,1650048.82
240230,202306,902,802,100,1058686.72,133320.88,1192007.60
240240,202306,94,62,32,81840.2,42240.76,124080.96
240250,202306,109,93,16,122761.46,21120,143881.46
240260,202306,2106,1470,636,1941785.13,840851.91,2782637.04
240270,202306,180,152,28,200641,36960,237601
240280,202306,74,60,14,79200.2,18480.1,97680.3
240290,202306,43,41,2,54120,2640,56760
240300,202306,182,99,83,130681.82,109560,240241.82
240310,202306,2787,1505,1282,1986665.66,1698864.82,3685530.48
240320,202306,181,167,14,220440.07,18480,238920.07
240325,202306,5552,3068,2484,4052612.24,3281613.31,7334225.55
240330,202306,90,84,6,110880.23,7920,118800.23
240340,202306,123,90,33,118800,43560,162360
240350,202306,104,81,23,106920.2,30360,137280.2
240360,202306,858,548,310,724712.89,409207.98,1133920.87
240370,202306,69,59,10,77882.65,13201.65,91084.30
240375,202306,50,32,18,42241.59,23761.17,66002.76
240380,202306,230,187,43,246851.49,56760.5,303611.99
240390,202306,16,15,1,19800,1320,21120
240400,202306,89,78,11,102961.38,14520,117481.38
240410,202306,13,10,3,13200,3960,17160
240420,202306,1233,863,370,1139194.53,488408.54,1627603.07
240430,202306,278,249,29,328695.28,38280.54,366975.82
240440,202306,164,94,70,124084.35,92400.97,216485.32
240450,202306,280,169,111,223091.64,146522.43,369614.07
240460,202306,102,81,21,106921.91,27720,134641.91
240470,202306,235,213,22,281178.25,29041.56,310219.81
240480,202306,16,14,2,18480,2640,21120
240485,202306,92,73,19,96361.09,25080,121441.09
240490,202306,69,62,7,81840.21,9240,91080.21
240500,202306,113,88,25,116160,33000,149160
240510,202306,37,28,9,36960,11880,48840
240520,202306,98,93,5,122761.72,6600.61,129362.33
240530,202306,68,51,17,67320,22440,89760
240540,202306,105,89,16,117480.1,21120,138600.1
240550,202306,12,10,2,13200,2640,15840
240560,202306,439,294,145,388091.03,191400.6,579491.63
240570,202306,469,281,188,370927.91,248161.58,619089.49
240580,202306,1490,1077,413,1421681.9,545162.23,1966844.13
240590,202306,32,31,1,40921.12,1320,42241.12
240600,202306,106,99,7,130681.93,9240,139921.93
240610,202306,521,429,92,566309.03,121446.35,687755.38
240615,202306,10,10,0,13200.8,,13200.8
240620,202306,90,85,5,112201.19,6600,118801.19
240630,202306,45,37,8,48840.97,10560.29,59401.26
240640,202306,38,27,11,35640,14520,50160
240650,202306,260,204,56,269281.59,73920.28,343201.87
240660,202306,118,99,19,130680.77,25080,155760.77
240670,202306,328,183,145,241574.89,191408.97,432983.86
240680,202306,59,46,13,60720.67,17160,77880.67
240690,202306,49,47,2,62041.98,2640,64681.98
240700,202306,185,155,30,204600.6,39601.02,244201.62
240710,202306,2531,1513,1018,1998554.88,1345096.21,3343651.09
240720,202306,1140,787,353,1040196.12,465967.92,1506164.04
240725,202306,79,71,8,93721.53,10560.88,104282.41
240730,202306,155,127,28,167640.08,36960.9,204600.98
240740,202306,250,201,49,265331.16,66000.62,331331.78
240750,202306,57,35,22,46200,29040,75240
240760,202306,64,51,13,67320,17160,84480
240770,202306,160,124,36,163682.86,47520.79,211203.65
240780,202306,823,672,151,887066.94,199321.27,1086388.21
240790,202306,41,39,2,51481.98,2640,54121.98
240800,202306,10631,7133,3498,9416189.81,4618867.94,14035057.75
240810,202306,24006,12669,11337,16730566,14975748.39,31706314.39
240820,202306,290,176,114,232327.65,150483.62,382811.27
240830,202306,1703,1409,294,1859935.18,388086.77,2248021.95
240840,202306,81,70,11,92400,14520,106920
240850,202306,92,78,14,102960,18480,121440
240860,202306,116,111,5,146522.09,6600.85,153122.94
240870,202306,61,49,12,64683.2,15840,80523.2
240880,202306,33,29,4,38280,5280,43560
240890,202306,1323,740,583,976838.18,770890.35,1747728.53
240895,202306,64,50,14,66000.2,18480.78,84480.98
240910,202306,191,157,34,207242.25,44880.2,252122.45
240920,202306,14,12,2,15842.08,2640,18482.08
240930,202306,453,403,50,531988.39,66001.49,597989.88
240933,202306,66,43,23,56760.95,30360,87120.95
240940,202306,2439,2123,316,2802438.22,417123.76,3219561.98
240950,202306,42,37,5,48840,6600,55440
240960,202306,28,23,5,30360.2,6600.3,36960.5
240970,202306,122,86,36,113520.96,47520,161040.96
240980,202306,220,173,47,228360.9,62040.8,290401.7
240990,202306,151,96,55,126721.43,72600,199321.43
241000,202306,61,55,6,72600.65,7920,80520.65
241010,202306,96,76,20,100320.9,26400,126720.9
241020,202306,115,106,9,139921.86,11880.51,151802.37
241025,202306,23,14,9,18480.67,11880.5,30361.17
241030,202306,122,94,28,124080,36960,161040
241040,202306,46,37,9,48840.1,11880,60720.1
241050,202306,78,72,6,95041.18,7920,102961.18
241060,202306,30,25,5,33000.78,6600,39600.78
241070,202306,25,25,0,33002.79,,33002.79
241080,202306,61,53,8,69960.2,10560,80520.2
241090,202306,56,45,11,59403.92,14520,73923.92
241100,202306,69,61,8,80520.67,10560.28,91080.95
241105,202306,31,19,12,25084.17,15840.73,40924.90
241110,202306,54,44,10,58080.15,13200,71280.15
241120,202306,1844,1388,456,1834843.06,604564.08,2439407.14
241140,202306,212,172,40,227043.91,52800,279843.91
241142,202306,52,41,11,54121.31,14520,68641.31
241150,202306,1248,1076,172,1421688.56,227042.55,1648731.11
241160,202306,28,20,8,26400,10560,36960
241170,202306,55,47,8,62040,10560,72600
241180,202306,50,37,13,48840,17160,66000
241190,202306,42,37,5,48842.4,6600,55442.4
241200,202306,5407,2811,2596,3710736.15,3428156.32,7138892.47
241210,202306,75,63,12,83160.57,15840,99000.57
241220,202306,1711,1075,636,1419063.53,839532.78,2258596.31
241230,202306,270,213,57,281165.22,75240.91,356406.13
241240,202306,54,40,14,52801.58,18480,71281.58
241250,202306,1203,1095,108,1445438.43,142562.74,1588001.17
241255,202306,76,61,15,80521.28,19800,100321.28
241260,202306,805,612,193,807857.78,256082.78,1063940.56
241270,202306,76,55,21,72601.23,27720,100321.23
241280,202306,101,88,13,116162.37,17160,133322.37
241290,202306,147,110,37,145203.67,48840.59,194044.26
241300,202306,90,58,32,76560.7,42240.98,118801.68
241310,202306,56,38,18,50161.23,23760.1,73921.33
241320,202306,36,20,16,26401.74,21120,47521.74
241330,202306,64,54,10,71280.08,13200,84480.08
241335,202306,113,101,12,133324.18,15840,149164.18
241340,202306,198,135,63,178200.81,83160,261360.81
241350,202306,66,55,11,72600.59,14520,87120.59
241355,202306,59,48,11,63361.8,14520,77881.8
241360,202306,62,60,2,79200.78,2640,81840.78
241370,202306,73,58,15,76560,19800,96360
241380,202306,35,31,4,40921.5,5280,46201.5
241390,202306,93,74,19,97680,25080,122760
241400,202306,242,179,63,238558.03,84481.69,323039.72
241410,202306,197,178,19,234960.55,25080.8,260041.35
241415,202306,110,87,23,114840.1,30360.8,145200.9
241420,202306,155,97,58,128041.57,76560,204601.57
241430,202306,21,18,3,23760.88,3960,27720.88
241440,202306,576,485,91,640228.32,120122.35,760350.67
241445,202306,48,40,8,52800.2,10560.19,63360.39
241450,202306,268,226,42,298331.29,55440.44,353771.73
241460,202306,187,168,19,221765.24,25081.33,246846.57
241470,202306,32,26,6,34320.8,7920.43,42241.23
241475,202306,52,48,4,63360,5280,68640
241480,202306,153,111,42,146522.52,55440.2,201962.72
241490,202306,13,11,2,14521.32,2640.1,17161.42
241500,202306,53,39,14,51481.9,18480.02,69961.92
250010,202306,103,86,17,113520.7,22440.66,135961.36
250020,202306,34,29,5,38280,6600,44880
250030,202306,948,708,240,934591.59,316803.49,1251395.08
250040,202306,424,341,83,450137.37,109561.12,559698.49
250050,202306,303,247,56,326041.93,73920.5,399962.43
250053,202306,67,55,12,72600.6,15840,88440.6
250057,202306,4,3,1,3960.2,1320,5280.2
250060,202306,659,475,184,627019.29,242881.68,869900.97
250070,202306,706,559,147,737898.79,194040.64,931939.43
250073,202306,11,8,3,10560.59,3960.01,14520.60
250077,202306,198,143,55,188761.4,72600.2,261361.6
250080,202306,419,333,86,439570.19,113520.38,553090.57
250090,202306,229,144,85,190081.48,112200,302281.48
250100,202306,627,494,133,652087.41,175561,827648.41
250110,202306,746,531,215,702260.57,283801.48,986062.05
250115,202306,14,4,10,5280.18,13200.26,18480.44
250120,202306,123,89,34,117480.37,44881.92,162362.29
250130,202306,603,498,105,657381.11,138601.26,795982.37
250135,202306,34,15,19,19800.59,25080,44880.59
250140,202306,97,81,16,106922.75,21120,128042.75
250150,202306,685,471,214,621731.86,282481.46,904213.32
250153,202306,19,15,4,19800.1,5280,25080.1
250157,202306,45,35,10,46200.42,13200,59400.42
250160,202306,263,198,65,261362.93,85800,347162.93
250170,202306,90,59,31,77880.2,40920,118800.2
250180,202306,5384,3737,1647,4933122.57,2174098.78,7107221.35
250190,202306,819,557,262,735249.39,347162.83,1082412.22
250200,202306,79,61,18,80520.41,23760.7,104281.11
250205,202306,23,18,5,23760.61,6600,30360.61
250210,202306,92,77,15,101641.78,19800,121441.78
250215,202306,103,66,37,87120.57,48840.35,135960.92
250220,202306,33,22,11,29041.21,14520,43561.21
250230,202306,82,72,10,95041.19,13200.2,108241.39
250240,202306,263,194,69,256084.04,91080.2,347164.24
250250,202306,438,375,63,495014.6,83160,578174.6
250260,202306,58,48,10,63360.1,13200,76560.1
250270,202306,81,59,22,77880.8,29040,106920.8
250280,202306,419,341,78,454084.5,102960,557044.5
250290,202306,120,107,13,141240,17160.88,158400.88
250300,202306,532,359,173,473891.77,228360.55,702252.32
250310,202306,55,50,5,66001.55,6600,72601.55
250320,202306,2211,1468,743,1937857.45,980781.62,2918639.07
250330,202306,125,108,17,142562.84,22440.1,165002.94
250340,202306,34,28,6,36960.78,7920,44880.78
250350,202306,213,141,72,186123.5,95040,281163.5
250355,202306,47,37,10,48840,13200.69,62040.69
250360,202306,197,163,34,215165.18,44880.67,260045.85
250370,202306,2546,1630,916,2151680.08,1211786.13,3363466.21
250375,202306,16,10,6,13200.36,9240.77,22441.13
250380,202306,55,47,8,62040.26,10560.29,72600.55
250390,202306,53,42,11,55440.96,14520,69960.96
250400,202306,18952,9776,9176,12915461.61,12124465.29,25039926.90
250403,202306,306,237,69,312843.71,91080,403923.71
250407,202306,69,55,14,72600.1,18480.85,91080.95
250410,202306,32,27,5,35640.31,6600.8,42241.11
250415,202306,53,34,19,44880,25080,69960
250420,202306,44,37,7,48840.3,9240,58080.3
250430,202306,1586,1382,204,1824616.46,269281.89,2093898.35
250435,202306,42,32,10,42241.89,13200,55441.89
250440,202306,694,570,124,752409.37,165001,917410.37
250450,202306,93,69,24,91081.52,31680,122761.52
250460,202306,527,344,183,454085.95,242882.04,696967.99
250470,202306,107,75,32,99001.5,42240,141241.5
250480,202306,358,282,76,373572.49,101640.98,475213.47
250485,202306,6,5,1,6600,1320,7920
250490,202306,255,202,53,267964.13,69961.39,337925.52
250500,202306,105,80,25,105600,33000,138600
250510,202306,911,722,189,953053.13,249480.85,1202533.98
250520,202306,176,121,55,159720.66,72600.7,232321.36
250523,202306,134,108,26,142560.74,34320.12,176880.86
250527,202306,123,91,32,120120.91,42240,162360.91
250530,202306,14,9,5,11880,6600,18480
250535,202306,31,24,7,31680,9240,40920
250540,202306,148,117,31,154440.87,40920,195360.87
250550,202306,75,73,2,96361.19,2640,99001.19
250560,202306,67,40,27,52800.84,35640.07,88440.91
250570,202306,166,137,29,180841.55,38280.7,219122.25
250580,202306,95,76,19,100405.2,25080,125485.2
250590,202306,23,16,7,21120,9240,30360
250600,202306,1748,1161,587,1532552.79,774844.65,2307397.44
250610,202306,161,127,34,167650.28,44880.22,212530.50
250620,202306,26,22,4,29040.81,5280,34320.81
250625,202306,72,55,17,72602.33,22440.08,95042.41
250630,202306,3277,2032,1245,2682568.95,1644745.04,4327313.99
250640,202306,205,163,42,215166.74,55441.46,270608.20
250650,202306,32,21,11,27720.57,14520.23,42240.80
250660,202306,66,48,18,63360,23760,87120
250670,202306,85,67,18,88441.25,23760.94,112202.19
250680,202306,449,360,89,475214.34,117480.59,592694.93
250690,202306,2376,1606,770,2119969.11,1017734.93,3137704.04
250700,202306,1005,845,160,1116735.7,211200.2,1327935.9
250710,202306,526,408,118,538592.05,155765.31,694357.36
250720,202306,124,90,34,118801.15,44880,163681.15
250730,202306,434,359,75,473887.51,99001.42,572888.93
250740,202306,73,66,7,87121.86,9240,96361.86
250750,202306,27310,15980,11330,21102375.43,14969182.06,36071557.49
250760,202306,126,97,29,128040.5,38281.04,166321.54
250770,202306,388,260,128,343207.16,168960.7,512167.86
250780,202306,82,54,28,71280.77,36960,108240.77
250790,202306,478,296,182,390725.97,240243.07,630969.04
250800,202306,157,140,17,184800,22440,207240
250810,202306,74,61,13,80520,17160,97680
250820,202306,164,132,32,174242.05,42240,216482.05
250830,202306,519,337,182,444854.18,240242.73,685096.91
250840,202306,64,54,10,71281.71,13200.2,84481.91
250850,202306,78,64,14,84480.2,18480,102960.2
250855,202306,16,13,3,17160.2,3960,21120.2
250860,202306,247,156,91,205921.31,120120,326041.31
250870,202306,33,30,3,39600,3960,43560
250880,202306,102,77,25,101640.79,33000,134640.79
250890,202306,3459,2534,925,3347612.07,1222334.86,4569946.93
250900,202306,71,59,12,77880.7,15840,93720.7
250905,202306,133,99,34,130680.9,44880,175560.9
250910,202306,1023,749,274,988705.25,364325.85,1353031.10
250915,202306,122,84,38,110881.55,50161.03,161042.58
250920,202306,157,118,39,155760,51480.7,207240.7
250930,202306,202,117,85,154440,113521.1,267961.1
250933,202306,11,8,3,10560,3960.04,14520.04
250937,202306,21,19,2,25080,2640,27720
250939,202306,44,34,10,44880.94,13200,58080.94
250940,202306,141,103,38,135961.83,50160.93,186122.76
250950,202306,85,61,24,80521.43,31680,112201.43
250960,202306,89,52,37,68643.31,48840.3,117483.61
250970,202306,1381,982,399,1297584.86,526685.38,1824270.24
250980,202306,98,66,32,87121.11,42240,129361.11
250990,202306,176,135,41,178200.36,54120,232320.36
251000,202306,90,75,15,99000,19800,118800
251010,202306,154,109,45,143880,59400,203280
251020,202306,98,81,17,106920.37,22440,129360.37
251030,202306,51,37,14,48840.97,18480,67320.97
251040,202306,76,54,22,71280,29040,100320
251050,202306,30,26,4,34320,5280,39600
251060,202306,52,41,11,54120.92,14520.64,68641.56
251065,202306,6,3,3,3960,3960,7920
251070,202306,19,17,2,22441.53,2640,25081.53
251080,202306,5965,2773,3192,3660535.76,4214850.03,7875385.79
251090,202306,205,168,37,221761.66,48840,270601.66
251100,202306,24,22,2,29040.7,2640,31680.7
251110,202306,69,45,24,59400,31680,91080
251120,202306,2083,1301,782,1718721.1,1032257.99,2750979.09
251130,202306,472,388,84,512169.03,110880.05,623049.08
251140,202306,665,437,228,576844.68,300961.5,877806.18
251150,202306,354,296,58,390724.15,77880.94,468605.09
251160,202306,100,83,17,109560.99,22440,132000.99
251170,202306,84,70,14,92400.26,18480,110880.26
251180,202306,319,186,133,245524.67,175562.22,421086.89
251190,202306,116,84,32,110885.8,42240.49,153126.29
251200,202306,333,255,78,336609.86,102960.44,439570.30
251203,202306,35,30,5,39600.69,6600,46200.69
251207,202306,90,73,17,96360.69,22440,118800.69
251210,202306,1679,1219,460,1609108.38,607205.83,2216314.21
251220,202306,51,40,11,52801.28,14520,67321.28
251230,202306,619,517,102,682449.01,134640.92,817089.93
251240,202306,129,92,37,121440.5,48840,170280.5
251250,202306,1718,1235,483,1631456.83,637567.61,2269024.44
251260,202306,14,10,4,13200.4,5280.19,18480.59
251270,202306,348,271,77,357726.69,101640.69,459367.38
251272,202306,68,57,11,75240.2,14520,89760.2
251274,202306,20,15,5,19800.47,6600,26400.47
251275,202306,41,23,18,30360.66,23760,54120.66
251276,202306,29,23,6,30360.82,7920,38280.82
251278,202306,17,13,4,17161.3,5280,22441.3
251280,202306,122,117,5,154440.2,6600,161040.2
251290,202306,1222,861,361,1136592.69,476541.66,1613134.35
251300,202306,20,15,5,19800,6600,26400
251310,202306,329,234,95,308888.79,125401.22,434290.01
251315,202306,50,45,5,59400,6600,66000
251320,202306,76,62,14,81841.03,18480,100321.03
251330,202306,89,79,10,104280,13200,117480
251335,202306,24,16,8,21120,10560,31680
251340,202306,898,502,396,662655.52,522723.2,1185378.72
251350,202306,41,38,3,50160,3960,54120
251360,202306,92,78,14,102960.2,18480,121440.2
251365,202306,9,8,1,10563.18,1320,11883.18
251370,202306,6462,4402,2060,5813468.28,2727159.73,8540628.01
251380,202306,48,36,12,47520.54,15840,63360.54
251385,202306,5,4,1,5280,1320,6600
251390,202306,1098,805,293,1062627.13,386767.03,1449394.16
251392,202306,42,30,12,39600.5,15840,55440.5
251394,202306,19,14,5,18480.6,6600,25080.6
251396,202306,11,7,4,9240,5280.2,14520.2
251398,202306,21,17,4,22440.22,5280,27720.22
251400,202306,56,43,13,56760,17160,73920
251410,202306,50,40,10,52800.7,13200,66000.7
251420,202306,118,85,33,112202.19,43560,155762.19
251430,202306,52,45,7,59400.74,9240,68640.74
251440,202306,58,31,27,40920,35640,76560
251445,202306,68,59,9,77883.4,11880,89763.4
251450,202306,411,347,64,458051.22,84480.78,542532.00
251455,202306,6,5,1,6600,1320,7920
251460,202306,27,21,6,27720,7920.02,35640.02
251465,202306,14,8,6,10560,7920,18480
251470,202306,49,36,13,47520,17160,64680
251480,202306,26,22,4,29040.62,5280.22,34320.84
251490,202306,120,68,52,89762.92,68641.22,158404.14
251500,202306,110,89,21,117481.31,27720,145201.31
251510,202306,102,65,37,85800.39,48840.62,134641.01
251520,202306,42,34,8,44880,10560,55440
251530,202306,4519,3178,1341,4195038.76,1770130.71,5965169.47
251540,202306,101,82,19,108240,25081.67,133321.67
251550,202306,454,346,108,456736.97,143883.55,600620.52
251560,202306,25,19,6,25080.1,7920,33000.1
251570,202306,16,15,1,19800,1320,21120
251580,202306,131,102,29,134641.56,38280,172921.56
251590,202306,105,74,31,97680.2,40920.8,138601.0
251593,202306,31,17,14,22440.58,18480,40920.58
251597,202306,131,107,24,141240.8,31680.04,172920.84
251600,202306,1147,793,354,1046780.12,467282.72,1514062.84
251610,202306,278,200,78,264007.01,102960.2,366967.21
251615,202306,25,21,4,27720,5280,33000
251620,202306,4359,2761,1598,3644616.71,2113347.43,5757964.14
251630,202306,515,373,142,492381.22,187444.54,679825.76
251640,202306,106,77,29,101645.06,38280,139925.06
251650,202306,322,231,91,304924.78,120120.04,425044.82
251660,202306,215,190,25,250804.73,33000.3,283805.03
251670,202306,443,337,106,444848.5,139920.94,584769.44
251675,202306,16,11,5,14520,6600,21120
251680,202306,108,95,13,125401.07,17160,142561.07
251690,202306,339,278,61,367298.91,80520.2,447819.11
251700,202306,285,242,43,319443.93,56760,376203.93
251710,202306,22,15,7,19800.41,9240,29040.41
251720,202306,38,27,11,35640,14520,50160
251740,202306,13,10,3,13200.3,3960,17160.3
260005,202306,4067,2098,1969,2770224.53,2600450.53,5370675.06
260010,202306,1906,1422,484,1878392.84,640204.66,2518597.50
260020,202306,448,391,57,516128.87,75240.9,591369.77
260030,202306,665,448,217,591372.66,286442,877814.66
260040,202306,807,517,290,682461.98,382803.71,1065265.69
260050,202306,1205,876,329,1157666.41,436923.19,1594589.60
260060,202306,375,343,32,452772.91,42240,495012.91
260070,202306,1406,854,552,1127335.53,728665.19,1856000.72
260080,202306,800,588,212,776178.65,279840,1056018.65
260090,202306,488,321,167,423723.41,220440.6,644164.01
260100,202306,227,151,76,199322.27,100320,299642.27
260105,202306,299,176,123,232321.86,162360.1,394681.96
260110,202306,3225,2323,902,3069056.81,1191970.48,4261027.29
260120,202306,2910,1553,1357,2050371.38,1792582.22,3842953.60
260130,202306,225,159,66,209883.87,87120,297003.87
260140,202306,2417,1550,867,2046047.14,1144453.61,3190500.75
260150,202306,204,132,72,174240.93,95041.4,269282.33
260160,202306,370,291,79,385453.06,104282.69,489735.75
260170,202306,3660,2181,1479,2880324.49,1954947.93,4835272.42
260180,202306,163,137,26,182165.34,34320.65,216485.99
260190,202306,2686,1731,955,2286283.82,1260606.61,3546890.43
260200,202306,1076,837,239,1104863.27,315480.98,1420344.25
260210,202306,1468,1059,409,1399237.39,541204.17,1940441.56
260220,202306,650,578,72,762976.91,95041.67,858018.58
260230,202306,1406,1026,380,1355684.17,501609.47,1857293.64
260240,202306,225,171,54,225726.55,71282.23,297008.78
260250,202306,106,83,23,109560.75,30360,139920.75
260260,202306,1182,811,371,1070534.1,489722.98,1560257.08
260270,202306,263,188,75,248165.48,99000,347165.48
260280,202306,1227,966,261,1275147.28,344523.05,1619670.33
260290,202306,7663,4095,3568,5413352.62,4715077.72,10128430.34
260300,202306,1125,944,181,1246132.53,238922.86,1485055.39
260310,202306,556,438,118,578170.1,155760.1,733930.2
260320,202306,849,616,233,813122.62,307560.4,1120683.02
260330,202306,97,75,22,99000.3,29040.3,128040.6
260340,202306,88,65,23,85800.65,30360,116160.65
260345,202306,6443,3264,3179,4308638.56,4198977.79,8507616.35
260350,202306,507,360,147,475212.04,196680.61,671892.65
260360,202306,262,154,108,203280.5,142560.45,345840.95
260370,202306,749,488,261,644172.87,344522.45,988695.32
260380,202306,571,410,161,541209.87,212522.18,753732.05
260390,202306,298,252,46,332645.19,60720.2,393365.39
260392,202306,132,111,21,146523.33,27721.12,174244.45
260400,202306,4836,2761,2075,3644592.09,2745619.91,6390212.00
260410,202306,16629,8555,8074,11300850.73,10664366.88,21965217.61
260415,202306,169,138,31,182160.96,40920,223080.96
260420,202306,1899,1195,704,1577432.89,930602.75,2508035.64
260430,202306,177,158,19,208567.33,25080.2,233647.53
260440,202306,221,146,75,192725.35,99000.96,291726.31
260450,202306,460,348,112,459373.52,147841.67,607215.19
260460,202306,916,479,437,632295.98,576846.65,1209142.63
260470,202306,346,212,134,279845.65,176881.65,456727.30
260480,202306,274,170,104,224400,137280,361680
260490,202306,240,179,61,236281.2,80520,316801.2
260500,202306,1235,819,416,1081104.52,549125.87,1630230.39
260510,202306,888,709,179,935896.6,236281.07,1172177.67
260515,202306,266,244,22,322082.11,29040.91,351123.02
260520,202306,3412,2095,1317,2766722.28,1741100.41,4507822.69
260530,202306,917,729,188,962317.83,249480.9,1211798.73
260540,202306,585,456,129,601932.15,170281.36,772213.51
260545,202306,34,18,16,23761.29,21120.56,44881.85
260550,202306,371,239,132,315483.3,174240.27,489723.57
260560,202306,519,399,120,526694.55,159721.7,686416.25
260570,202306,1098,879,219,1160320.31,289081.18,1449401.49
260580,202306,379,297,82,392043.35,108240,500283.35
260590,202306,647,380,267,501601.81,352440.4,854042.21
260600,202306,8434,4925,3509,6501156.73,4637200.78,11138357.51
260610,202306,535,363,172,479172.72,227042.38,706215.10
260620,202306,4118,2151,1967,2839424.98,2597939.7,5437364.68
260630,202306,86,75,11,99000.49,14520,113520.49
260640,202306,3591,2173,1418,2869741.44,1873097.11,4742838.55
260650,202306,332,243,89,320766.08,117480.4,438246.48
260660,202306,651,435,216,574218.84,285124.67,859343.51
260670,202306,120,83,37,109560,48840.12,158400.12
260680,202306,4456,2382,2074,3145693.06,2744324.9,5890017.96
260690,202306,141,109,32,143880.99,42240,186120.99
260700,202306,337,235,102,310207.47,134640.69,444848.16
260710,202306,55,45,10,59400,13200,72600
260720,202306,2933,1700,1233,2245359.39,1627568.72,3872928.11
260730,202306,833,610,223,805210.09,294361.17,1099571.26
260740,202306,77,65,12,85800.9,15840,101640.9
260750,202306,581,432,149,570252,196680.82,766932.82
260760,202306,824,404,420,533302.19,555729.7,1089031.89
260765,202306,1099,577,522,761655.13,689049.97,1450705.10
260770,202306,240,170,70,224382.02,92400.93,316782.95
260775,202306,941,469,472,620421.27,623051.07,1243472.34
260780,202306,242,144,98,192721.71,129360.86,322082.57
260790,202306,17627,8413,9214,11110847.96,12174473.62,23285321.58
260795,202306,163,104,59,137280.62,77880,215160.62
260800,202306,318,260,58,343204,76560.46,419764.46
260805,202306,44,29,15,38282.05,19800.63,58082.68
260810,202306,916,723,193,954369.17,254760.68,1209129.85
260820,202306,333,224,109,295683.46,143880,439563.46
260825,202306,223,153,70,201961.02,92400,294361.02
260830,202306,314,207,107,273240,142560,415800
260840,202306,296,212,84,279844.28,110880.03,390724.31
260845,202306,221,133,88,175561.04,116161.83,291722.87
260850,202306,441,333,108,439565.52,142560,582125.52
260860,202306,252,191,61,252122.65,80520,332642.65
260870,202306,357,281,76,370925.91,100320,471245.91
260875,202306,790,567,223,749799.7,294361.02,1044160.72
260880,202306,1745,1157,588,1527268.56,777482.65,2304751.21
260890,202306,2733,1866,867,2464491.32,1148408.07,3612899.39
260900,202306,1108,825,283,1089014.77,374880.96,1463895.73
260910,202306,262,211,51,278525.57,67320.6,345846.17
260915,202306,294,221,73,291720.7,96360,388080.7
260920,202306,246,139,107,183480.2,142560,326040.2
260930,202306,373,318,55,419772.04,72600.17,492372.21
260940,202306,2733,1459,1274,1925950.63,1683020.89,3608971.52
260950,202306,2126,1203,923,1589331.45,1218380.76,2807712.21
260960,202306,15373,7321,8052,9670840.73,10636775,20307615.73
260970,202306,466,373,93,492366.46,122760,615126.46
260980,202306,227,208,19,274564.41,25080.1,299644.51
260990,202306,2903,2297,606,3032126.37,799925.87,3832052.24
261000,202306,4500,2795,1705,3690782.32,2253257.1,5944039.42
261010,202306,139,104,35,137281.26,46200,183481.26
261020,202306,633,461,172,608530.25,227040.1,835570.35
261030,202306,269,201,68,265323.21,89760,355083.21
261040,202306,400,335,65,442208.42,85800,528008.42
261050,202306,582,472,110,624370.86,146522,770892.86
261060,202306,1765,1100,665,1452015.7,879122.86,2331138.56
261070,202306,10865,5078,5787,6707297.37,7645656.96,14352954.33
261080,202306,379,296,83,390727.91,109560,500287.91
261090,202306,2191,1682,509,2220324.38,671885.07,2892209.45
261100,202306,1319,904,415,1193312.2,547805.81,1741118.01
261110,202306,10290,6439,3851,8507799.84,5091335.12,13599134.96
261120,202306,232,196,36,258721.33,47520,306241.33
261130,202306,592,351,241,463333.97,319448.65,782782.62
261140,202306,235,145,90,191400.67,118800,310200.67
261150,202306,678,443,235,584764.15,310200.64,894964.79
261153,202306,78,72,6,95040,7920,102960
261160,202306,83968,40633,43335,53670165.57,57250761.55,110920927.12
261170,202306,523,390,133,514801.28,175561.02,690362.30
261180,202306,1920,1209,711,1596216.83,938529.25,2534746.08
261190,202306,627,421,206,555728.66,271923.24,827651.90
261200,202306,226,176,50,233645.81,66000.36,299646.17
261210,202306,49,35,14,46200.1,18480,64680.1
261220,202306,3075,2130,945,2811673.59,1247419.32,4059092.91
261230,202306,396,291,105,384127.66,138600.97,522728.63
261240,202306,443,379,64,500293.21,84480.97,584774.18
261245,202306,278,238,40,314160.8,52800,366960.8
261247,202306,186,142,44,187442.71,58080,245522.71
261250,202306,4251,2033,2218,2683607.45,2927781.54,5611388.99
261255,202306,266,235,31,310200.52,40920,351120.52
261260,202306,907,770,137,1016458.7,180844,1197302.7
261270,202306,213,147,66,194040.83,87120,281160.83
261280,202306,204,167,37,220443.5,48840.14,269283.64
261290,202306,116,82,34,108240.24,44880.2,153120.44
261300,202306,1536,1150,386,1518035.74,509525.42,2027561.16
261310,202306,877,578,299,764297.52,394682.06,1158979.58
261320,202306,536,371,165,489734.38,217802.46,707536.84
261330,202306,931,738,193,976843.17,257409.83,1234253.00
261340,202306,356,196,160,260041.9,211202.13,471244.03
261350,202306,1004,695,309,917432.32,407890.52,1325322.84
261360,202306,1483,925,558,1221008.53,736566.19,1957574.72
261370,202306,5424,3139,2285,4143583.91,3017562.7,7161146.61
261380,202306,613,484,129,638886.54,170280,809166.54
261390,202306,4142,2830,1312,3737057.83,1731877.63,5468935.46
261400,202306,294,260,34,343205.94,44880.74,388086.68
261410,202306,1202,782,420,1032268,554403.49,1586671.49
261420,202306,1032,624,408,825015.13,538563.01,1363578.14
261430,202306,341,305,36,402605.14,47520,450125.14
261440,202306,107,101,6,133322.69,7920,141242.69
261450,202306,2768,2122,646,2802409.5,852726.41,3655135.91
261460,202306,853,650,203,858025.53,269281.8,1127307.33
261470,202306,245,195,50,257401.03,66000.5,323401.53
261480,202306,512,381,131,502931.84,172862.27,675794.11
261485,202306,426,249,177,328689.05,233640.2,562329.25
261500,202306,686,438,248,578169.93,327361.9,905531.83
261510,202306,54,36,18,47520.98,23760.1,71281.08
261520,202306,110,93,17,122762.57,22440.2,145202.77
261530,202306,4627,2989,1638,3948195.98,2163496.42,6111692.40
261540,202306,1661,952,709,1256664.12,935888.94,2192553.06
261550,202306,280,134,146,176881.75,194040,370921.75
261560,202306,1056,695,361,917422.76,476525.09,1393947.85
261570,202306,425,343,82,452766.87,108240.95,561007.82
261580,202306,415,329,86,434286.68,113520,547806.68
261590,202306,212,165,47,217807.23,62041.34,279848.57
261600,202306,340,260,80,343208.96,105600.7,448809.66
261610,202306,105,85,20,112201.24,26400,138601.24
261618,202306,87,62,25,81840.65,33000,114840.65
261620,202306,221,141,80,186122.81,105601.27,291724.08
261630,202306,722,558,164,736566.34,216483.21,953049.55
261640,202306,7358,3877,3481,5120443.07,4598957.67,9719400.74
261650,202306,455,289,166,381481.95,219120.3,600602.25
270010,202306,523,462,61,609856.33,80520.74,690377.07
270020,202306,250,207,43,273244.4,56760.47,330004.87
270030,202306,9732,6237,3495,8237016.96,4618676.34,12855693.30
270040,202306,2171,1453,718,1919368.49,949087.52,2868456.01
270050,202306,251,193,58,254764.37,76560.6,331324.97
270060,202306,57,39,18,51482.94,25080.33,76563.27
270070,202306,799,592,207,781449.94,273241.1,1054691.04
270080,202306,58,45,13,59400.1,17160,76560.1
270090,202306,21,17,4,22440,5280,27720
270100,202306,1367,929,438,1226311.4,578162.12,1804473.52
270110,202306,60,49,11,64680,14520,79200
270120,202306,277,226,51,298329.36,67320.62,365649.98
270130,202306,339,263,76,347163.96,100320,447483.96
270135,202306,124,90,34,118801,44880,163681
270140,202306,1473,991,482,1309481.6,636250.94,1945732.54
270150,202306,271,190,81,250803.9,106921.03,357724.93
270160,202306,489,390,99,514843.51,130683.36,645526.87
270170,202306,840,559,281,739206.57,372241.67,1111448.24
270180,202306,63,49,14,64680.7,18480.09,83160.79
270190,202306,116,102,14,134644.18,18480,153124.18
270200,202306,127,109,18,143880.02,23760,167640.02
270210,202306,561,353,208,465963.55,274560.62,740524.17
270220,202306,198,141,57,186120.69,75240.7,261361.39
270230,202306,2318,1490,828,1966839.9,1095604.03,3062443.93
270235,202306,511,402,109,530664.13,143880,674544.13
270240,202306,3444,2721,723,3593098.13,954363.71,4547461.84
270250,202306,122,94,28,124082.57,36960,161042.57
270255,202306,217,182,35,240242.25,46200.44,286442.69
270260,202306,430,341,89,450134.05,117480.7,567614.75
270270,202306,94,49,45,64680.18,59400,124080.18
270280,202306,199,127,72,167640,95040,262680
270290,202306,1169,917,252,1213102.63,332643.3,1545745.93
270300,202306,392,287,105,378840.85,138600.2,517441.05
270310,202306,839,704,135,930619.11,178200.54,1108819.65
270320,202306,783,677,106,893655.56,139920,1033575.56
270330,202306,330,285,45,376200.62,59400,435600.62
270340,202306,69,57,12,75240,15840,91080
270350,202306,81,47,34,62042.81,44880,106922.81
270360,202306,87,49,38,64680,50160,114840
270370,202306,73,57,16,75240,21120,96360
270375,202306,90,60,30,79200.61,39600,118800.61
270380,202306,1073,744,329,982080.56,434280,1416360.56
270390,202306,130,78,52,102960.2,68640.5,171600.7
270400,202306,801,620,181,818414.01,238920.92,1057334.93
270410,202306,218,165,53,217806.89,69960,287766.89
270420,202306,427,299,128,394683.96,168960.3,563644.26
270430,202306,37146,26361,10785,34821345.66,14249740.71,49071086.37
270440,202306,470,370,100,488413.77,132001.68,620415.45
270450,202306,929,558,371,736566.32,489721.41,1226287.73
270460,202306,184,145,39,191405.35,51480,242885.35
270470,202306,1786,1250,536,1651352.78,707523.23,2358876.01
270480,202306,581,469,112,619088.86,147840,766928.86
270490,202306,26,21,5,27720,6600,34320
270500,202306,479,397,82,524047.11,108240,632287.11
270510,202306,936,633,303,835510.5,401282.13,1236792.63
270520,202306,281,188,93,248162.27,122760,370922.27
270530,202306,65,53,12,69960.45,15840,85800.45
270540,202306,83,60,23,79200,30360,109560
270550,202306,1652,1274,378,1683038.47,500281.49,2183319.96
270560,202306,257,159,98,209883.85,129360,339243.85
270570,202306,622,447,175,590045.96,231000,821045.96
270580,202306,22,17,5,22440,6600,29040
270590,202306,57,47,10,62040.3,13200.08,75240.38
270600,202306,174,144,30,190085.13,39600.1,229685.23
270610,202306,252,200,52,264004.07,68640.1,332644.17
270620,202306,17,17,0,22440,,22440.0
270630,202306,3734,2793,941,3689517.03,1243450.72,4932967.75
270640,202306,914,674,240,889696.56,316802.25,1206498.81
270642,202306,220,182,38,240242.53,50160,290402.53
270644,202306,260,169,91,223083.62,120121.76,343205.38
270650,202306,350,221,129,291724.66,171602.25,463326.91
270660,202306,198,173,25,228371.8,33000,261371.8
270670,202306,3078,2357,721,3112625.8,954361.43,4066987.23
270680,202306,404,269,135,355087.29,178200,533287.29
270690,202306,1282,870,412,1148432.48,543843.75,1692276.23
270700,202306,24,19,5,25080.19,6600,31680.19
270710,202306,570,452,118,596647.76,155760,752407.76
270720,202306,227,184,43,242883.65,56761.66,299645.31
270730,202306,1987,1266,721,1672469.31,953045.34,2625514.65
270740,202306,34,24,10,31680.7,13200,44880.7
270750,202306,619,480,139,633609.41,183480.52,817089.93
270760,202306,290,211,79,278526.83,104280.76,382807.59
270770,202306,2991,2072,919,2737754.7,1213090.15,3950844.85
270780,202306,71,42,29,55440,38280.83,93720.83
270790,202306,194,125,69,165002.03,91081.32,256083.35
270800,202306,2088,1682,406,2220279.24,535920,2756199.24
270810,202306,208,170,38,224401.48,50160,274561.48
270820,202306,117,81,36,106924.64,47520,154444.64
270830,202306,881,681,200,898948.98,264001.14,1162950.12
270840,202306,1336,1042,294,1376779.43,388081.7,1764861.13
270850,202306,1580,1040,540,1372813.78,714123.46,2086937.24
270860,202306,2691,1831,860,2416959.34,1136531.55,3553490.89
270870,202306,132,80,52,105600.2,68640.2,174240.4
270880,202306,874,694,180,916108.1,237602.92,1153711.02
270890,202306,259,204,55,269281.59,73921.21,343202.80
270895,202306,79,75,4,99000,5280,104280
270900,202306,68,56,12,73922.32,15840,89762.32
270910,202306,311,262,49,345849.4,64681.54,410530.94
270915,202306,2010,1359,651,1796557.77,860641.88,2657199.65
270920,202306,394,325,69,429005.04,91080,520085.04
270930,202306,5583,4326,1257,5711762.92,1659246.38,7371009.30
270940,202306,2248,1808,440,2387926.31,582122.48,2970048.79
280010,202306,33,27,6,35640.2,7920,43560.2
280020,202306,530,448,82,591374.49,108240.97,699615.46
280030,202306,23497,15038,8459,19859181.39,11178063.2,31037244.59
280040,202306,346,213,133,281163.14,176880.4,458043.54
280050,202306,459,352,107,464648.6,141240,605888.6
280060,202306,435,286,149,377530.16,196680.88,574211.04
280067,202306,1200,870,330,1148419.37,435601.06,1584020.43
280070,202306,128,110,18,145202.03,23760,168962.03
280100,202306,717,552,165,728651.41,217800.49,946451.90
280110,202306,94,82,12,108242.45,15840,124082.45
280120,202306,730,609,121,803893.34,162361.39,966254.73
280130,202306,1891,1241,650,1638141.54,858001.08,2496142.62
280140,202306,545,451,94,595326.58,124080.2,719406.78
280150,202306,445,322,123,425050.62,162360,587410.62
280160,202306,154,116,38,153122.91,50160,203282.91
280170,202306,441,315,126,415814.49,166321.03,582135.52
280190,202306,32,25,7,33000,9240,42240
280200,202306,52,40,12,52806.26,15840.3,68646.56
280210,202306,3214,2296,918,3032019.35,1213088.09,4245107.44
280220,202306,66,55,11,72602.32,14520,87122.32
280230,202306,347,278,69,366974.08,91081.98,458056.06
280240,202306,141,132,9,174242.81,13200,187442.81
280250,202306,21,10,11,13200.1,14521.37,27721.47
280260,202306,80,71,9,93723.1,11880,105603.1
280270,202306,141,110,31,145200.58,40920.53,186121.11
280280,202306,193,131,62,172923.19,81840.09,254763.28
280290,202306,4099,2977,1122,3931034.64,1481054.87,5412089.51
280300,202306,1778,1420,358,1874429.47,472563.79,2346993.26
280310,202306,109,100,9,132002.45,11880,143882.45
280320,202306,726,504,222,665301.59,293042.83,958344.42
280330,202306,335,245,90,323406.89,118800.2,442207.09
280340,202306,449,372,77,491048.64,101641.1,592689.74
280350,202306,4009,3058,951,4039381.57,1255337.88,5294719.45
280360,202306,490,333,157,439575.65,207241.53,646817.18
280370,202306,95,80,15,105601.09,19800,125401.09
280380,202306,52,40,12,52800,15840,68640
280390,202306,178,150,28,198002.7,36960,234962.7
280400,202306,442,289,153,382814.92,201963.01,584777.93
280410,202306,308,259,49,341888.4,64680,406568.4
280420,202306,147,126,21,166331.76,27720.95,194052.71
280430,202306,108,87,21,114841.67,27720,142561.67
280440,202306,744,613,131,809181.68,172923.11,982104.79
280445,202306,122,112,10,147842.12,13200.8,161042.92
280450,202306,1410,1207,203,1593275.3,267962.99,1861238.29
280460,202306,717,536,181,707536.62,240241.57,947778.19
280470,202306,94,89,5,117481.56,6600,124081.56
280480,202306,3465,2328,1137,3073185.27,1504837.77,4578023.04
280490,202306,216,205,11,270614.71,14520,285134.71
280500,202306,40,37,3,48841.2,3960.22,52801.42
280510,202306,140,110,30,145200.99,39600.86,184801.85
280520,202306,56,40,16,52801.29,21120,73921.29
280530,202306,76,48,28,63364,36960.38,100324.38
280540,202306,590,508,82,670570.9,108240,778810.9
280550,202306,773,710,63,937220.03,83160,1020380.03
280560,202306,508,458,50,604571.48,66000.93,670572.41
280570,202306,2540,2010,530,2654571.24,699604.82,3354176.06
280580,202306,620,486,134,641526.54,176880.96,818407.50
280590,202306,235,154,81,203297.53,106927.19,310224.72
280600,202306,432,351,81,464707.34,106920.2,571627.54
280610,202306,123,87,36,114846.19,47521.91,162368.10
280620,202306,575,465,110,615128.42,145200,760328.42
280630,202306,151,123,28,162363.4,36960.9,199324.3
280640,202306,178,143,35,188760.4,46200,234960.4
280650,202306,86,54,32,71281.65,42240.07,113521.72
280660,202306,125,95,30,125406.29,39600.21,165006.50
280670,202306,2154,1380,774,1821729.19,1023029.32,2844758.51
280680,202306,255,215,40,285122.41,52800,337922.41
280690,202306,79,68,11,89760,14520,104280
280700,202306,22,22,0,29040,,29040.0
280710,202306,1620,1252,368,1652674.9,485763.17,2138438.07
280720,202306,146,103,43,135962.05,56760,192722.05
280730,202306,31,27,4,35641.7,5280.05,40921.75
280740,202306,2709,2045,664,2699438.56,876483.72,3575922.28
280750,202306,235,208,27,274570.15,36961.3,311531.45
280760,202306,1007,671,336,887063.47,443521.99,1330585.46
290010,202306,200,140,60,184800.96,79200,264000.96
290020,202306,209,185,24,244202.22,31680.9,275883.12
290030,202306,646,419,227,553087.15,300961.12,854048.27
290035,202306,142,114,28,150481.42,36960.93,187442.35
290040,202306,276,196,80,258725.97,105600,364325.97
290050,202306,95,77,18,101640,23760,125400
290060,202306,251,108,143,142561.24,188760,331321.24
290070,202306,6496,3084,3412,4072331.42,4506532.77,8578864.19
290080,202306,499,222,277,293043.56,365640.09,658683.65
290090,202306,330,155,175,204600.2,231000.91,435601.11
290100,202306,1829,1158,671,1528590.66,887044.65,2415635.31
290110,202306,945,525,420,694348.76,554408.17,1248756.93
290115,202306,184,171,13,225723.3,17160,242883.3
290120,202306,870,591,279,781450.26,368281.37,1149731.63
290130,202306,497,301,196,397323.73,258720.38,656044.11
290135,202306,297,225,72,297005.98,95040.1,392046.08
290140,202306,337,283,54,373566.32,71280.36,444846.68
290150,202306,151,102,49,134640,64680.01,199320.01
290160,202306,250,192,58,253447.67,76560.94,330008.61
290170,202306,114,83,31,109562.08,40920,150482.08
290180,202306,207,146,61,192722.23,80521.18,273243.41
290190,202306,335,261,74,344527.52,97680.4,442207.92
290195,202306,314,217,97,286444.74,128040.1,414484.84
290200,202306,265,211,54,279840.97,71324.1,351165.07
290205,202306,166,102,64,134640.4,84480,219120.4
290210,202306,1341,976,365,1288353.21,481803.57,1770156.78
290220,202306,166,101,65,133326.46,87121.1,220447.56
290225,202306,297,117,180,154442.99,237600.59,392043.58
290230,202306,101,60,41,79201.81,54120,133321.81
290240,202306,391,133,258,175561.4,341881.22,517442.62
290250,202306,249,229,20,302287.4,26400,328687.4
290260,202306,365,285,80,376217.7,105605.1,481822.8
290265,202306,196,171,25,225724.96,33000.32,258725.28
290270,202306,1440,1186,254,1565579.68,335280.89,1900860.57
290280,202306,524,365,159,481806.11,211200.4,693006.51
290290,202306,1558,950,608,1254022.64,803881.49,2057904.13
290300,202306,396,335,61,442208.94,80521.02,522729.96
290310,202306,287,139,148,183481.36,195360,378841.36
290320,202306,4608,2737,1871,3614312.86,2471062.34,6085375.20
290323,202306,216,186,30,245527,39600.2,285127.2
290327,202306,176,137,39,180846.01,51480,232326.01
290330,202306,135,64,71,84480.48,93720,178200.48
290340,202306,819,344,475,455414.62,627003.84,1082418.46
290350,202306,716,430,286,567604.95,377521.35,945126.30
290360,202306,320,253,67,333965.03,88440,422405.03
290370,202306,901,418,483,551761.28,637561.61,1189322.89
290380,202306,355,229,126,303603.03,166321.64,469924.67
290390,202306,2566,1593,973,2104135.76,1284370.14,3388505.90
290395,202306,243,147,96,194040.86,126720,320760.86
290400,202306,306,222,84,293041.54,110880,403921.54
290405,202306,250,215,35,283802.34,46200,330002.34
290410,202306,685,568,117,749765.5,154440,904205.5
290420,202306,292,238,54,315482.53,71280,386762.53
290430,202306,525,336,189,443522.72,249480,693002.72
290440,202306,94,74,20,97680.4,26400,124080.4
290450,202306,206,147,59,194040,77880,271920
290460,202306,2098,1238,860,1635521.46,1135203.97,2770725.43
290470,202306,1408,630,778,831623.13,1026967.1,1858590.23
290475,202306,585,546,39,722053.55,51480,773533.55
290480,202306,190,111,79,146521.75,104280,250801.75
290485,202306,245,220,25,290402.88,33000,323402.88
290490,202306,1360,956,404,1261941.88,534602.98,1796544.86
290500,202306,859,466,393,615131.69,518763.59,1133895.28
290510,202306,187,151,36,199333.73,47520.35,246854.08
290515,202306,200,126,74,166322,97680,264002
290520,202306,1517,1006,511,1327930.58,677161.08,2005091.66
290530,202306,280,247,33,326052.73,43560.93,369613.66
290540,202306,142,68,74,89760,97680,187440
290550,202306,185,151,34,199321.48,44880,244201.48
290560,202306,3314,1520,1794,2007769.97,2369415.28,4377185.25
290570,202306,7653,3605,4048,4762759.64,5348730.77,10111490.41
290580,202306,1350,814,536,1075816.65,707521.12,1783337.77
290590,202306,603,484,119,638915.51,157084.38,795999.89
290600,202306,1913,1306,607,1723986.31,801250.85,2525237.16
290610,202306,184,170,14,224409.47,18480,242889.47
290620,202306,402,354,48,467289.24,63360.6,530649.84
290630,202306,2096,891,1205,1177472.73,1590606.44,2768079.17
290640,202306,138,107,31,141243.95,40920.05,182164.00
290650,202306,2237,1044,1193,1378123.62,1577411.05,2955534.67
290660,202306,281,232,49,306241.14,64680.72,370921.86
290670,202306,1139,569,570,751096.41,752407.85,1503504.26
290680,202306,1343,1072,271,1415063.86,357721.56,1772785.42
290682,202306,370,275,95,363002.31,125400,488402.31
290685,202306,270,161,109,212524.45,143880.2,356404.65
290687,202306,1295,853,442,1126200,583441.15,1709641.15
290689,202306,148,73,75,96360,99000.2,195360.2
290690,202306,579,272,307,359047.69,405242.1,764289.79
290700,202306,267,138,129,182167.75,170283.04,352450.79
290710,202306,847,593,254,782774,335283.31,1118057.31
290720,202306,1182,930,252,1227644.15,332642.13,1560286.28
290730,202306,1313,779,534,1028302.15,704884.35,1733186.50
290740,202306,30,26,4,34320,5280,39600
290750,202306,1577,691,886,912146.49,1170857.22,2083003.71
290755,202306,87,73,14,96360,18480,114840
290760,202306,262,227,35,299652.07,46201.06,345853.13
290770,202306,197,188,9,248164.72,11880,260044.72
290780,202306,1193,961,232,1268546.83,306244.75,1574791.58
290790,202306,428,291,137,386765.61,180843.56,567609.17
290800,202306,2509,1030,1479,1360946.54,1953610.13,3314556.67
290810,202306,512,351,161,463327.08,212520.54,675847.62
290820,202306,436,249,187,330008.09,246844.33,576852.42
290830,202306,512,359,153,473885.93,201960.43,675846.36
290840,202306,1978,1245,733,1643446.81,967566.4,2611013.21
290850,202306,1135,584,551,770892.87,727325.92,1498218.79
290860,202306,730,362,368,477847.62,487082.32,964929.94
290870,202306,665,460,205,607209.49,270600.61,877810.10
290880,202306,124,65,59,85800.62,77880,163680.62
290890,202306,532,326,206,430324.3,271922.16,702246.46
290900,202306,167,128,39,168960.94,51480,220440.94
290910,202306,417,315,102,415801.1,134640,550441.1
290920,202306,220,197,23,260043.39,30360,290403.39
290930,202306,572,436,136,575537.07,182162.1,757699.17
290940,202306,222,190,32,250801,43560,294361
290950,202306,166,96,70,126720,92400,219120
290960,202306,528,380,148,501606.37,195360.13,696966.50
290970,202306,242,213,29,281161.37,38280.2,319441.57
290980,202306,2097,1477,620,1949680.8,819730.3,2769411.1
290990,202306,447,374,73,495024.01,97682.78,592706.79
291000,202306,958,323,635,426361.62,838200,1264561.62
291005,202306,2874,1230,1644,1624989.24,2171431.33,3796420.57
291010,202306,131,115,16,151800.94,21120,172920.94
291020,202306,84,68,16,89760,21120,110880
291030,202306,116,83,33,109561.88,43560,153121.88
291040,202306,662,393,269,518762.06,356400.11,875162.17
291050,202306,1644,852,792,1124664.91,1045450.14,2170115.05
291060,202306,1793,996,797,1314746.14,1052050.99,2366797.13
291070,202306,2094,1579,515,2084326.19,679809.16,2764135.35
291072,202306,7714,2994,4720,3952256.16,6238366.48,10190622.64
291075,202306,265,219,46,289080.6,60720,349800.6
291077,202306,62,44,18,58080,23760,81840
291080,202306,23146,9904,13242,13083002,17494204.61,30577206.61
291085,202306,292,238,54,314165.51,71280.65,385446.16
291090,202306,256,103,153,135961.4,201960,337921.4
291100,202306,975,341,634,450120.42,836880,1287000.42
291110,202306,472,359,113,475208.37,149160.6,624368.97
291120,202306,2544,1377,1167,1817670.42,1543087.96,3360758.38
291125,202306,69,36,33,47520,43560,91080
291130,202306,187,159,28,209884.16,36960,246844.16
291140,202306,145,118,27,155760.81,35640.1,191400.91
291150,202306,369,136,233,179520.38,307560,487080.38
291160,202306,417,329,88,435616.45,116161.57,551778.02
291165,202306,53,40,13,52800,17160.62,69960.62
291170,202306,3654,1819,1835,2401128.21,2422208.2,4823336.41
291180,202306,1284,557,727,736570.68,959642.25,1696212.93
291185,202306,121,113,8,149162.06,10560,159722.06
291190,202306,1439,703,736,929300.78,972850.75,1902151.53
291200,202306,182,134,48,176880.9,63360,240240.9
291210,202306,2565,1066,1499,1407147.85,1978689.84,3385837.69
291220,202306,339,261,78,344522.1,102960.2,447482.3
291230,202306,960,361,599,476527.67,790683.08,1267210.75
291240,202306,404,372,32,491043.84,42240,533283.84
291250,202306,415,340,75,448800.69,99000,547800.69
291260,202306,69,57,12,75240.1,15840,91080.1
291270,202306,857,401,456,529345.32,601930.83,1131276.15
291280,202306,363,173,190,228363.35,250800.3,479163.65
291290,202306,1690,900,790,1189365.69,1042814.48,2232180.17
291300,202306,258,189,69,249483.12,91080,340563.12
291310,202306,233,201,32,266645.78,42240.7,308886.48
291320,202306,1325,926,399,1222360.61,528002.4,1750363.01
291330,202306,141,118,23,155762.14,30360.2,186122.34
291340,202306,251,154,97,203285.9,128041.95,331327.85
291345,202306,125,91,34,120120.4,44880,165000.4
291350,202306,1904,747,1157,986043.83,1527240.2,2513284.03
291360,202306,9266,4403,4863,5814869.46,6421923.5,12236792.96
291370,202306,1242,753,489,995325.45,645489.12,1640814.57
291380,202306,278,213,65,281162.41,85800,366962.41
291390,202306,4330,1926,2404,2543691.9,3174616,5718307.9
291400,202306,2206,1528,678,2018339.57,894973.74,2913313.31
291410,202306,246,201,45,266643.47,59400,326043.47
291420,202306,126,96,30,126720,39600,166320
291430,202306,192,119,73,157080.2,96360,253440.2
291440,202306,567,461,106,609855.8,139920.2,749776.0
291450,202306,1067,713,354,941186.11,467285.41,1408471.52
291460,202306,2237,1732,505,2286318.48,666613.93,2952932.41
291465,202306,2433,1183,1250,1561589.9,1650006.41,3211596.31
291470,202306,3078,1551,1527,2047365.97,2016978.82,4064344.79
291480,202306,12954,5643,7311,7450364.67,9655865.28,17106229.95
291490,202306,736,296,440,390724.28,582120.2,972844.48
291500,202306,377,227,150,300667.11,198000.47,498667.58
291510,202306,1177,472,705,623044.39,930600.49,1553644.88
291520,202306,943,435,508,574214.2,670561.35,1244775.55
291530,202306,937,282,655,373561.89,864600.1,1238161.99
291535,202306,147,118,29,157080.19,38280.91,195361.10
291540,202306,349,118,231,155764.27,304920.62,460684.89
291550,202306,1315,633,682,836890.68,900241.97,1737132.65
291560,202306,5334,2725,2609,3598375.99,3446530.78,7044906.77
291570,202306,250,133,117,175561.39,154442.33,330003.72
291580,202306,1287,819,468,1081100.7,617762.29,1698862.99
291590,202306,124,61,63,80520.3,83160,163680.3
291600,202306,1193,608,585,802575.48,773524.23,1576099.71
291610,202306,1530,741,789,978179.03,1041504.62,2019683.65
291620,202306,582,275,307,364331.68,405242.89,769574.57
291630,202306,480,150,330,200641.16,436920.2,637561.36
291640,202306,4337,2101,2236,2776029.85,2952865.25,5728895.10
291650,202306,476,337,139,444858.35,184801.89,629660.24
291660,202306,369,154,215,203282.48,283801.48,487083.96
291670,202306,162,102,60,134641.92,79200.73,213842.65
291680,202306,649,401,248,529353.55,327363.36,856716.91
291685,202306,654,375,279,495012.51,368282.88,863295.39
291690,202306,520,340,180,448804.26,237601.26,686405.52
291700,202306,1102,847,255,1118065.63,336602.24,1454667.87
291710,202306,1656,802,854,1058660.29,1127285.72,2185946.01
291720,202306,471,321,150,423721.42,198000.9,621722.32
291730,202306,974,565,409,745826.2,539884.8,1285711.0
291733,202306,327,220,107,290402.53,141240.14,431642.67
291735,202306,100,75,25,99000.2,33000.31,132000.51
291740,202306,349,267,82,352441.08,108240,460681.08
291750,202306,2601,1637,964,2160947,1272502.31,3433449.31
291760,202306,3247,1806,1441,2383933.57,1902122.03,4286055.60
291770,202306,802,539,263,711513.54,347167.83,1058681.37
291780,202306,105,65,40,85800.58,52800.78,138601.36
291790,202306,170,96,74,126720,97681.27,224401.27
291800,202306,11172,4910,6262,6484047.73,8272526.54,14756574.27
291810,202306,1113,834,279,1100907.7,368285.68,1469193.38
291820,202306,303,220,83,290400.23,109560,399960.23
291830,202306,1053,447,606,590059.44,799926.62,1389986.06
291835,202306,585,543,42,716772.47,56760.18,773532.65
291840,202306,5922,2998,2924,3961531.81,3862403.03,7823934.84
291845,202306,296,102,194,134640,256080,390720
291850,202306,321,279,42,368291.56,55441.05,423732.61
291855,202306,267,113,154,149161.59,203280.48,352442.07
291860,202306,159,103,56,135960.52,73920.99,209881.51
291870,202306,87,41,46,54120,60720,114840
291875,202306,164,151,13,199322.42,17160.84,216483.26
291880,202306,445,368,77,485773.76,101643.03,587416.79
291890,202306,265,89,176,117480.2,232320,349800.2
291900,202306,60,37,23,48840,30360,79200
291905,202306,123,93,30,122761.77,39600.74,162362.51
291910,202306,148,122,26,161040.66,34320.1,195360.76
291915,202306,470,409,61,539900.5,80521.29,620421.79
291920,202306,6730,3199,3531,4224201.64,4664965.53,8889167.17
291930,202306,173,105,68,138602,89760.25,228362.25
291940,202306,440,259,181,341882.93,238920,580802.93
291950,202306,1251,974,277,1285690.1,365640.2,1651330.3
291955,202306,1564,937,627,1238194.38,827647.88,2065842.26
291960,202306,209,153,56,201961.88,73920,275881.88
291970,202306,808,594,214,784098.77,282482.35,1066581.12
291980,202306,1489,1282,207,1692272.35,273242.23,1965514.58
291990,202306,156,144,12,190083.6,15840,205923.6
291992,202306,231,111,120,146528.04,158403.3,304931.34
291995,202306,199,129,70,170281.21,92400,262681.21
292000,202306,440,313,127,413166.55,167640.62,580807.17
292010,202306,392,269,123,355080.92,162360.6,517441.52
292020,202306,325,236,89,311523.69,117480,429003.69
292030,202306,165,126,39,166322.52,51480,217802.52
292040,202306,620,338,282,446160,372240,818400
292045,202306,130,114,16,150480.7,21120.64,171601.34
292050,202306,991,719,272,949091.6,359041.58,1308133.18
292060,202306,993,811,182,1071877.88,240242.09,1312119.97
292070,202306,77,29,48,38280.2,63360,101640.2
292080,202306,180,127,53,167640.41,69960,237600.41
292090,202306,597,226,371,298321.9,491040.2,789362.1
292100,202306,1759,768,991,1013803.12,1308147.52,2321950.64
292105,202306,178,162,16,213840.3,21120,234960.3
292110,202306,2403,911,1492,1202547.3,1969447.03,3171994.33
292120,202306,762,571,191,753752.24,252121.59,1005873.83
292130,202306,516,282,234,372244.35,308880.71,681125.06
292140,202306,229,184,45,242886.37,59401.37,302287.74
292145,202306,176,101,75,133320,100320,233640
292150,202306,1594,1335,259,1763549.8,341883.43,2105433.23
292160,202306,186,145,41,191400.7,54120.09,245520.79
292170,202306,1223,1029,194,1358326.56,256083.24,1614409.80
292180,202306,259,183,76,241560,100320.1,341880.1
292190,202306,159,103,56,135961.14,73920.97,209882.11
292200,202306,1528,564,964,745813.77,1273850.44,2019664.21
292205,202306,129,107,22,141240.88,29040,170280.88
292210,202306,422,275,147,363007.93,194040.73,557048.66
292220,202306,39,28,11,36960.4,14520,51480.4
292225,202306,68,53,15,69962.91,19800.64,89763.55
292230,202306,1038,814,224,1074510.7,295681.84,1370192.54
292240,202306,674,491,183,648139.83,241560.5,889700.33
292250,202306,1696,1092,604,1441484.91,797288.89,2238773.80
292260,202306,439,263,176,347165.01,232321.71,579486.72
292265,202306,263,201,62,265324.11,83161.02,348485.13
292270,202306,743,382,361,504247.54,476520,980767.54
292273,202306,221,131,90,172920.9,118800.74,291721.64
292275,202306,189,99,90,130680.5,118800,249480.5
292280,202306,163,112,51,147840,67320,215160
292285,202306,102,79,23,104280,30360,134640
292290,202306,675,451,224,595331.92,297000.82,892332.74
292300,202306,2022,800,1222,1056023.82,1613062.79,2669086.61
292303,202306,152,106,46,139922.39,60720.77,200643.16
292305,202306,126,92,34,121441.46,44880,166321.46
292310,202306,1048,697,351,920060.62,463326.82,1383387.44
292320,202306,625,472,153,623048.5,201961.98,825010.48
292330,202306,181,118,63,155761.21,83160,238921.21
292335,202306,329,260,69,343203.52,91080,434283.52
292340,202306,589,413,176,545165.41,232320.55,777485.96
292350,202306,292,148,144,195361.18,190080,385441.18
292360,202306,778,582,196,768242.6,260041.51,1028284.11
292370,202306,746,572,174,755049.1,229680.57,984729.67
292380,202306,627,522,105,689056.84,138600.49,827657.33
292390,202306,402,166,236,220443.08,311521.59,531964.67
292400,202306,4109,2498,1611,3297466.27,2129172.99,5426639.26
292405,202306,279,185,94,244200.66,124080,368280.66
292410,202306,112,71,41,93721.4,54120,147841.4
292420,202306,276,239,37,315480.9,48840,364320.9
292430,202306,568,406,162,535922.82,213840.51,749763.33
292440,202306,700,582,118,768254.09,155762.13,924016.22
292450,202306,245,186,59,245522.48,77880.3,323402.78
292460,202306,531,402,129,530644.04,171601.11,702245.15
292465,202306,216,184,32,242882.61,42240.1,285122.71
292467,202306,186,124,62,163680.27,81840,245520.27
292470,202306,328,219,109,289080.59,145200,434280.59
292480,202306,426,284,142,374889.06,187441.32,562330.38
292490,202306,265,199,66,262681.82,87122.09,349803.91
292500,202306,999,498,501,657381.34,661327.62,1318708.96
292510,202306,3878,1911,1967,2523889.05,2599098.57,5122987.62
292520,202306,1289,616,673,813147.27,888371.01,1701518.28
292525,202306,485,364,121,480492.22,159722.72,640214.94
292530,202306,5492,2263,3229,2988551.13,4268918.21,7257469.34
292540,202306,494,284,210,374883.03,277201.1,652084.13
292550,202306,1195,665,530,877812.27,699604.9,1577417.17
292560,202306,342,311,31,410534.27,40920.16,451454.43
292570,202306,367,279,88,368281.8,116160,484441.8
292575,202306,601,438,163,578187.13,215162.96,793350.09
292580,202306,1094,746,348,984728.9,459362.7,1444091.6
292590,202306,599,530,69,699606.8,91080.8,790687.6
292593,202306,154,122,32,161040.58,42240,203280.58
292595,202306,227,178,49,234964.39,64680,299644.39
292600,202306,1362,965,397,1273845.81,524049.63,1797895.44
292610,202306,118,96,22,126727.1,29041.34,155768.44
292620,202306,546,455,91,600632.27,120121.73,720754.00
292630,202306,1681,912,769,1203864.83,1015086,2218950.83
292640,202306,932,647,285,854054.69,376204.7,1230259.39
292650,202306,190,140,50,184807.57,66000,250807.57
292660,202306,2114,1474,640,1945743.98,846134.18,2791878.16
292665,202306,142,99,43,130681.02,56760,187441.02
292670,202306,403,306,97,403922.18,128040.21,531962.39
292680,202306,268,202,66,266640.97,87120,353760.97
292690,202306,213,145,68,191400.7,89760,281160.7
292700,202306,1087,710,377,938545.64,497646.72,1436192.36
292710,202306,115,98,17,129360.84,22440.31,151801.15
292720,202306,1082,620,462,818408.16,609840.78,1428248.94
292730,202306,228,110,118,145201.84,155760.4,300962.24
292740,202306,84611,40057,44554,52910709.44,58863865.2,111774574.64
292750,202306,428,314,114,414489.73,150483.68,564973.41
292760,202306,357,305,52,402601.81,68640.38,471242.19
292770,202306,959,398,561,525367.19,741848.61,1267215.80
292780,202306,52,23,29,30361.52,38280.74,68642.26
292790,202306,827,450,377,594002.95,497640.2,1091643.15
292800,202306,1361,815,546,1075819.86,722045.94,1797865.80
292805,202306,418,157,261,207240.21,344520.95,551761.16
292810,202306,1943,1150,793,1518027.76,1046763.15,2564790.91
292820,202306,727,617,110,814470.73,145203.41,959674.14
292830,202306,146,112,34,147844.29,44881.08,192725.37
292840,202306,747,599,148,790705.09,195362.68,986067.77
292850,202306,145,99,46,130682.42,60721.85,191404.27
292860,202306,2250,1288,962,1701552.98,1271178.45,2972731.43
292870,202306,4034,2624,1410,3463757.85,1861208.98,5324966.83
292880,202306,1535,1018,517,1343784.41,683766.54,2027550.95
292890,202306,591,491,100,648136.58,132001.98,780138.56
292895,202306,153,109,44,143880.75,58080,201960.75
292900,202306,353,257,96,339255.92,128042.83,467298.75
292905,202306,538,267,271,352445.33,359044.03,711489.36
292910,202306,568,427,141,563649.1,186120.87,749769.97
292920,202306,640,286,354,378849.05,467287.8,846136.85
292925,202306,489,448,41,591361.69,54121.22,645482.91
292930,202306,789,482,307,638892.37,405244.27,1044136.64
292935,202306,281,123,158,162361.11,208561.1,370922.21
292937,202306,216,146,70,192721.65,92400,285121.65
292940,202306,207,157,50,207241.47,66000,273241.47
292950,202306,1486,715,771,945145.93,1021690.15,1966836.08
292960,202306,523,376,147,496337.78,194041.5,690379.28
292970,202306,268,196,72,258725.1,95042.84,353767.94
292975,202306,98,52,46,68644.79,60721.69,129366.48
292980,202306,375,262,113,345844.09,149161.94,495006.03
292990,202306,1374,1034,340,1366207.11,448801.3,1815008.41
293000,202306,119,82,37,108242.53,48840.1,157082.63
293010,202306,3271,1934,1337,2553016.31,1764875.82,4317892.13
293015,202306,642,529,113,698295.11,149160,847455.11
293020,202306,369,292,77,385455,101641.71,487096.71
293030,202306,584,524,60,691690.6,79200,770890.6
293040,202306,397,317,80,418442.09,105600.68,524042.77
293050,202306,3309,1937,1372,2559549.66,1811059.31,4370608.97
293060,202306,240,193,47,254770.9,62040.5,316811.4
293070,202306,4233,2111,2122,2789264.08,2807676.11,5596940.19
293075,202306,99,70,29,92401.58,38280,130681.58
293076,202306,91,68,23,89761.43,30360,120121.43
293077,202306,659,371,288,489744.51,380167.7,869912.21
293080,202306,444,395,49,522725.94,64680.66,587406.60
293090,202306,143,126,17,166320,22440,188760
293100,202306,569,383,186,505570.45,245520.8,751091.25
293105,202306,366,270,96,356402.21,126720,483122.21
293110,202306,130,85,45,112206.18,59401.88,171608.06
293120,202306,312,225,87,297007.64,114844.21,411851.85
293130,202306,260,173,87,228365.43,114840,343205.43
293135,202306,8988,3661,5327,4836619.31,7036941.01,11873560.32
293140,202306,201,122,79,161045.72,104281.49,265327.21
293150,202306,331,286,45,377528.92,59400.2,436929.12
293160,202306,444,281,163,370923.44,215160,586083.44
293170,202306,277,171,106,225725.83,141242.51,366968.34
293180,202306,650,446,204,588722.29,269280,858002.29
293190,202306,1474,1013,461,1337194.3,609848.57,1947042.87
293200,202306,619,537,82,708857.39,108240,817097.39
293210,202306,449,343,106,452768.61,139920,592688.61
293220,202306,2517,1136,1381,1499544.05,1825569.59,3325113.64
293230,202306,1974,742,1232,979462.12,1626243.95,2605706.07
293240,202306,238,215,23,283811.39,30361.1,314172.49
293245,202306,134,108,26,142561.36,34320,176881.36
293250,202306,841,363,478,479173.56,630973.48,1110147.04
293260,202306,337,264,73,348483.16,96360,444843.16
293270,202306,1239,554,685,731288.85,906840.1,1638128.95
293280,202306,325,223,102,294363.16,137281.42,431644.58
293290,202306,3243,2077,1166,2741722,1541774.44,4283496.44
293300,202306,948,649,299,856689.79,394680.24,1251370.03
293305,202306,204,156,48,205921.6,63360.65,269282.25
293310,202306,176,131,45,172922.2,59400.7,232322.9
293315,202306,184,141,43,186124.16,56761.45,242885.61
293317,202306,98,72,26,95040.2,34320,129360.2
293320,202306,1349,687,662,906902.44,873860.91,1780763.35
293325,202306,218,92,126,121440,166320,287760
293330,202306,16009,7428,8581,9807885.71,11338918.77,21146804.48
293340,202306,297,210,87,277201.4,114840,392041.4
293345,202306,273,228,45,300966.17,59400,360366.17
293350,202306,608,394,214,520091.97,282481.09,802573.06
293360,202306,1573,1103,470,1455995.79,620408.25,2076404.04
310010,202306,145,78,67,102960.77,88440.04,191400.81
310020,202306,1008,552,456,732617.24,603245.37,1335862.61
310030,202306,321,254,67,335285.61,88442.5,423728.11
310040,202306,47,32,15,42240,19800,62040
310050,202306,168,108,60,142560.21,79200,221760.21
310060,202306,286,205,81,270608.48,106920.67,377529.15
310070,202306,23,16,7,21120.24,9240.2,30360.44
310080,202306,54,37,17,48840,22440.83,71280.83
310090,202306,1187,670,517,884416.32,682445.75,1566862.07
310100,202306,404,283,121,374891.34,159722.1,534613.44
310110,202306,736,394,342,520091.04,452764.64,972855.68
310120,202306,459,260,199,343201.05,262680.73,605881.78
310130,202306,34,19,15,25080.2,19800,44880.2
310140,202306,26,10,16,13200,21120.76,34320.76
310150,202306,1262,827,435,1092994.27,574210.5,1667204.77
310160,202306,2258,1109,1149,1463914.96,1519328.13,2983243.09
310163,202306,104,62,42,81840,55440,137280
310170,202306,2737,1330,1407,1756963.86,1865174.81,3622138.67
310180,202306,203,97,106,128041.44,142560,270601.44
310190,202306,518,343,175,454086.41,231001.59,685088.00
310200,202306,438,276,162,364324.08,213840.2,578164.28
310205,202306,87,60,27,79200.93,35640,114840.93
310210,202306,280,225,55,297001.81,72600,369601.81
310220,202306,66,41,25,54120.3,33000,87120.3
310230,202306,301,214,87,282483.49,114840,397323.49
310240,202306,133,108,25,142560.2,33000,175560.2
310250,202306,102,82,20,108242.51,26400,134642.51
310260,202306,807,436,371,575539.77,489724.66,1065264.43
310270,202306,301,197,104,260046.52,137280.14,397326.66
310280,202306,432,299,133,394683.25,175560,570243.25
310285,202306,216,165,51,217802.44,67320.16,285122.60
310290,202306,241,129,112,170282.9,147840,318122.9
310300,202306,188,151,37,199322.13,50160,249482.13
310310,202306,17,14,3,18480,3960,22440
310320,202306,29,11,18,14520.18,23760.19,38280.37
310330,202306,48,36,12,47520.24,15840.66,63360.90
310340,202306,2013,1453,560,1919311.67,739202.59,2658514.26
310350,202306,2952,1518,1434,2006470.32,1894209.42,3900679.74
310360,202306,54,42,12,55440.71,15840.33,71281.04
310370,202306,147,123,24,162360,31680,194040
310375,202306,111,42,69,55441.06,91081.36,146522.42
310380,202306,52,34,18,44880,23760,68640
310390,202306,112,71,41,93720.95,54120,147840.95
310400,202306,2734,1823,911,2409099.61,1203849.19,3612948.80
310410,202306,126,76,50,100321.67,66000,166321.67
310420,202306,725,378,347,500290.35,458043.02,958333.37
310430,202306,299,192,107,253442.04,141240,394682.04
310440,202306,82,53,29,69960.52,38280,108240.52
310445,202306,87,74,13,97680.77,17160,114840.77
310450,202306,703,469,234,619095.31,308881.3,927976.61
310460,202306,271,183,88,242881.99,116160.56,359042.55
310470,202306,571,373,198,493689.64,261362.61,755052.25
310480,202306,105,69,36,91080,47520,138600
310490,202306,624,305,319,402606.42,421081.11,823687.53
310500,202306,140,62,78,81841.64,102960,184801.64
310510,202306,640,454,186,600617.42,248160.91,848778.33
310520,202306,159,109,50,143881.94,66000,209881.94
310530,202306,130,54,76,71280.9,100320,171600.9
310540,202306,526,293,233,388090.13,307562.05,695652.18
310550,202306,84,57,27,75241.07,35640,110881.07
310560,202306,3433,2357,1076,3112655.88,1420324.47,4532980.35
310570,202306,119,77,42,101640,55440,157080
310590,202306,433,256,177,339160.54,233640.7,572801.24
310600,202306,143,68,75,89761.4,99000,188761.4
310610,202306,41,14,27,18480.95,35640,54120.95
310620,202306,54914,26091,28823,34474106.46,38082242.66,72556349.12
310630,202306,822,502,320,662655.24,423721.91,1086377.15
310640,202306,167,111,56,146520.2,73920.2,220440.4
310650,202306,181,163,18,215160.13,23760,238920.13
310660,202306,117,79,38,104280.2,50160,154440.2
310665,202306,73,51,22,67320,29040,96360
310670,202306,8103,3516,4587,4643932.84,6058831,10702763.84
310680,202306,62,41,21,54120,27720,81840
310690,202306,625,446,179,588731.04,236283.38,825014.42
310700,202306,62,38,24,50160.2,31680.97,81841.17
310710,202306,1357,915,442,1207818.5,584765.64,1792584.14
310720,202306,166,47,119,62040,157080,219120
310730,202306,1680,1140,540,1504860.63,712814.73,2217675.36
310740,202306,1071,582,489,768271.69,648125.95,1416397.64
310750,202306,266,172,94,228362.68,124080.37,352443.05
310760,202306,80,62,18,81841.79,23760,105601.79
310770,202306,89,43,46,56760.1,60720,117480.1
310780,202306,383,309,74,407884.87,97680.6,505565.47
310790,202306,123,99,24,130680.78,31680.59,162361.37
310800,202306,504,239,265,316802.04,349800,666602.04
310810,202306,183,121,62,159720.84,81840.59,241561.43
310820,202306,316,253,63,333966.39,83160.04,417126.43
310825,202306,208,176,32,232322.11,42240,274562.11
310830,202306,484,219,265,290402.93,352442.02,642844.95
310840,202306,390,243,147,320762.15,198000.83,518762.98
310850,202306,77,63,14,83160.95,18480,101640.95
310855,202306,465,372,93,491047.19,122760,613807.19
310860,202306,1722,1275,447,1684373.86,591369.64,2275743.50
310870,202306,64,55,9,72600.6,11880,84480.6
310880,202306,94,75,19,99000,25080,124080
310890,202306,305,179,126,236282.18,166320,402602.18
310900,202306,656,303,353,399966.74,465965.7,865932.44
310910,202306,253,167,86,220441.15,113520,333961.15
310920,202306,455,260,195,343209.52,257409.22,600618.74
310925,202306,43,34,9,44880.68,11880,56760.68
310930,202306,1443,978,465,1290980.93,613805.77,1904786.70
310940,202306,735,359,376,473896.51,496325.84,970222.35
310945,202306,154,103,51,135960.85,67320,203280.85
310950,202306,220,175,45,231002.5,60720,291722.5
310960,202306,75,28,47,36961.31,62041.57,99002.88
310970,202306,183,104,79,137284.14,104280,241564.14
310980,202306,56,39,17,51485.24,22440,73925.24
310990,202306,163,88,75,116160.23,99001.05,215161.28
311000,202306,924,479,445,632293.52,588723.75,1221017.27
311010,202306,54,41,13,54120.94,17160,71280.94
311020,202306,44,29,15,38280.55,19800,58080.55
311030,202306,422,238,184,314162.02,242881.51,557043.53
311040,202306,38,30,8,39600,10560,50160
311050,202306,546,208,338,274560.84,447481.58,722042.42
311060,202306,878,483,395,637571.18,522724.58,1160295.76
311070,202306,367,169,198,223081.87,261360.4,484442.27
311080,202306,127,72,55,95041.49,72600.4,167641.89
311090,202306,365,181,184,240244.78,244201.12,484445.90
311100,202306,598,363,235,479165.29,310200.25,789365.54
311110,202306,723,517,206,682460.74,273245.77,955706.51
311115,202306,88,59,29,77880.58,38280.2,116160.78
311120,202306,1189,667,522,880466.92,690366.44,1570833.36
311130,202306,292,168,124,221764.76,163680,385444.76
311140,202306,179,101,78,134644.47,102962.18,237606.65
311150,202306,341,218,123,287764.91,162360,450124.91
311160,202306,821,578,243,764293.85,322081.07,1086374.92
311170,202306,100,81,19,106920.94,25080,132000.94
311180,202306,330,229,101,302288.3,133320.84,435609.14
311190,202306,37,17,20,22440,26400,48840
311200,202306,350,239,111,315482.07,146520.9,462002.97
311205,202306,39,32,7,42240,9240,51480
311210,202306,38,33,5,43560,6600,50160
311220,202306,32,29,3,38280,3960,42240
311230,202306,1778,1195,583,1577453.78,769568.21,2347021.99
311240,202306,91,62,29,81844.22,38280.5,120124.72
311250,202306,60,25,35,33000,46200,79200
311260,202306,568,348,220,459368.72,290400.14,749768.86
311265,202306,142,93,49,122760.96,64680,187440.96
311270,202306,294,202,92,266644.51,121441.8,388086.31
311280,202306,207,91,116,120121.3,153120,273241.3
311290,202306,114,97,17,128042.01,22440,150482.01
311300,202306,624,403,221,531969.37,291721.88,823691.25
311310,202306,18,15,3,19800,3960,23760
311320,202306,681,507,174,670571.97,229681.53,900253.50
311330,202306,1287,935,352,1235550.03,464652.06,1700202.09
311340,202306,2869,2017,852,2662502.21,1128605.04,3791107.25
311350,202306,281,214,67,282482.31,88440,370922.31
311360,202306,168,104,64,137282.19,84480,221762.19
311370,202306,1300,558,742,736588.05,980770.19,1717358.24
311380,202306,7,6,1,7920,1320,9240
311390,202306,262,154,108,203282.47,142560.2,345842.67
311400,202306,143,87,56,114840.8,73920,188760.8
311410,202306,131,64,67,84480.95,88440,172920.95
311420,202306,341,168,173,221766.05,228361.76,450127.81
311430,202306,891,591,300,780130.22,396000.5,1176130.72
311440,202306,485,327,158,431649.28,208561.5,640210.78
311450,202306,323,189,134,249482.25,176880.92,426363.17
311455,202306,281,188,93,248166.87,122760.87,370927.74
311460,202306,139,64,75,84480.3,99000,183480.3
311470,202306,34,16,18,21120,23760,44880
311480,202306,61,34,27,44880,35640,80520
311490,202306,11,6,5,7920,6600,14520
311500,202306,33,17,16,22440.78,21120,43560.78
311510,202306,841,581,260,766939.04,344520.93,1111459.97
311520,202306,41,35,6,46200,7920,54120
311530,202306,1964,1414,550,1866582.18,727323.12,2593905.30
311535,202306,71,45,26,59400.96,34320.52,93721.48
311540,202306,35,30,5,39600.16,6600,46200.16
311545,202306,191,137,54,180843.01,71280,252123.01
311547,202306,62,48,14,63360,18480.23,81840.23
311550,202306,740,344,396,454089.33,525363.19,979452.52
311560,202306,44,27,17,35640.83,22440,58080.83
311570,202306,306,203,103,269283.33,135962.25,405245.58
311580,202306,450,292,158,388085.23,208560.76,596645.99
311590,202306,29,23,6,30360.21,7920,38280.21
311600,202306,97,77,20,101644.14,26400.86,128045.00
311610,202306,261,226,35,298321.8,46200.73,344522.53
311615,202306,186,157,29,207241.57,38280.52,245522.09
311620,202306,33,25,8,33000.9,10560,43560.9
311630,202306,115,100,15,132000.92,19800,151800.92
311640,202306,146,76,70,100321.74,92403.8,192725.54
311650,202306,138,94,44,125400,58080.2,183480.2
311660,202306,469,216,253,285123.46,333960.83,619084.29
311670,202306,164,114,50,150293.2,66000.43,216293.63
311680,202306,238,178,60,234961.16,79200.18,314161.34
311690,202306,13,13,0,17160.5,,17160.5
311700,202306,204,155,49,204602.83,64680.96,269283.79
311710,202306,189,128,61,168962,80520,249482
311720,202306,38,29,9,38280.89,11880,50160.89
311730,202306,608,428,180,564977.09,237601.15,802578.24
311740,202306,27,19,8,25080,10560,35640
311750,202306,769,520,249,686406.92,328680.93,1015087.85
311760,202306,87,38,49,50162.18,64681.08,114843.26
311770,202306,394,195,199,257402.51,264000.81,521403.32
311780,202306,231,124,107,163682.3,141240.37,304922.67
311783,202306,106,91,15,120120.7,19800,139920.7
311787,202306,50,19,31,25080,40920.25,66000.25
311790,202306,271,122,149,161041.78,196682.65,357724.43
311800,202306,823,495,328,653414.82,432963,1086377.82
311810,202306,57,41,16,54121.41,21120,75241.41
311820,202306,137,105,32,138603.54,42241.28,180844.82
311830,202306,2102,1221,881,1613083.78,1165562.51,2778646.29
311840,202306,1188,689,499,910812.03,658683.43,1569495.46
311850,202306,19,13,6,17160.28,7920.2,25080.48
311860,202306,11288,4869,6419,6429938.61,8481075.31,14911013.92
311870,202306,120,69,51,91083.31,67320.31,158403.62
311880,202306,1015,726,289,959669.4,381489.43,1341158.83
311890,202306,211,98,113,129254.2,149164.13,278418.33
311900,202306,69,28,41,36960,54120.15,91080.15
311910,202306,1506,942,564,1243466.02,744485.25,1987951.27
311920,202306,252,165,87,217802.4,114840.2,332642.6
311930,202306,994,558,436,736572.32,576842.98,1313415.30
311940,202306,2916,1619,1297,2138471.68,1712043.27,3850514.95
311950,202306,181,109,72,143882.37,95041.05,238923.42
311960,202306,66,46,20,60720.58,26400,87120.58
311970,202306,27,15,12,19800,15840,35640
311980,202306,43,33,10,43560,13200,56760
311990,202306,39,27,12,35640.08,15840.64,51480.72
311995,202306,61,36,25,47520.7,33000.2,80520.9
312000,202306,21,15,6,19800,7920,27720
312010,202306,74,57,17,75241.13,22440.1,97681.23
312015,202306,90,63,27,83160.69,35640,118800.69
312020,202306,141,104,37,137280.25,48840,186120.25
312030,202306,83,63,20,83160,26400,109560
312040,202306,94,56,38,73920,50160,124080
312050,202306,206,120,86,158400.2,113520,271920.2
312060,202306,21,13,8,17160,10560,27720
312070,202306,86,57,29,75240.23,38280,113520.23
312080,202306,519,255,264,337922.66,348480.3,686402.96
312083,202306,86,55,31,72600.37,40920,113520.37
312087,202306,109,80,29,105601.45,38280,143881.45
312090,202306,3757,2331,1426,3078400.59,1883656.59,4962057.18
312100,202306,156,110,46,145202.27,60720.86,205923.13
312110,202306,133,81,52,106921.98,68641.41,175563.39
312120,202306,132,93,39,122762.03,51480,174242.03
312125,202306,84,56,28,73921.65,36960.88,110882.53
312130,202306,137,93,44,122762.11,58080,180842.11
312140,202306,157,120,37,158401.54,48840,207241.54
312150,202306,39,33,6,43560,7920,51480
312160,202306,1550,1023,527,1350505.74,695645.55,2046151.29
312170,202306,15,11,4,14520,5280,19800
312180,202306,89,65,24,85800,31680,117480
312190,202306,50,43,7,56760.96,9240,66000.96
312200,202306,787,667,120,881780.05,158401.76,1040181.81
312210,202306,140,76,64,100320.99,84480.59,184801.58
312220,202306,156,115,41,151801.88,54120,205921.88
312230,202306,4170,1852,2318,2446045.24,3061088.73,5507133.97
312235,202306,183,120,63,158400,83160,241560
312240,202306,92,67,25,88442.59,33000.93,121443.52
312245,202306,243,178,65,234965.39,85800.43,320765.82
312247,202306,85,62,23,81840.37,30360.38,112200.75
312250,202306,188,96,92,126722.91,121440,248162.91
312260,202306,116,74,42,97680,55440,153120
312270,202306,149,88,61,116161.67,80520,196681.67
312280,202306,31,16,15,21120,19800,40920
312290,202306,152,105,47,138602.97,62040.75,200643.72
312300,202306,213,141,72,186123.01,99000.84,285123.85
312310,202306,67,58,9,76560,11880,88440
312320,202306,448,275,173,363001.39,228360,591361.39
312330,202306,109,95,14,125400,18480.97,143880.97
312340,202306,34,17,17,22440,22440,44880
312350,202306,14,8,6,10560.64,7920,18480.64
312352,202306,95,69,26,91080.12,34320,125400.12
312360,202306,617,274,343,361685.86,452760.2,814446.06
312370,202306,403,222,181,294360.43,238920.99,533281.42
312380,202306,150,98,52,129366.04,68641.84,198007.88
312385,202306,185,148,37,195362.92,48841.03,244203.95
312390,202306,317,200,117,264002.59,154440,418442.59
312400,202306,405,306,99,403922.22,130680.07,534602.29
312410,202306,1341,498,843,658701.21,1112783.37,1771484.58
312420,202306,722,549,173,724688.47,228361.15,953049.62
312430,202306,906,655,251,865932.36,331323.37,1197255.73
312440,202306,55,41,14,54120,18480,72600
312450,202306,234,139,95,183480,125400,308880
312460,202306,39,18,21,23760.92,27720,51480.92
312470,202306,50,34,16,44880,21120,66000
312480,202306,168,105,63,138603.22,83161.19,221764.41
312490,202306,341,230,111,303607.06,146522.48,450129.54
312500,202306,32,22,10,29040.79,13200,42240.79
312510,202306,757,302,455,398650.27,600608.51,999258.78
312520,202306,26,9,17,11880,22440,34320
312530,202306,39,27,12,35641.78,15840.1,51481.88
312540,202306,90,76,14,100320.6,18480,118800.6
312550,202306,33,25,8,33000,10560,43560
312560,202306,217,169,48,223082.11,63360,286442.11
312570,202306,524,312,212,411851.68,279842.38,691694.06
312580,202306,88,54,34,71280,44880,116160
312590,202306,222,174,48,229683.58,63360,293043.58
312595,202306,170,140,30,184800.51,39600,224400.51
312600,202306,74,34,40,44880,52800,97680
312610,202306,1679,882,797,1166510.62,1053362.75,2219873.37
312620,202306,237,175,62,231001.76,81840,312841.76
312630,202306,73,59,14,77880.52,18480,96360.52
312640,202306,47,12,35,15840,46200,62040
312650,202306,160,138,22,182605.74,29040.1,211645.84
312660,202306,116,81,35,106925.2,46200.59,153125.79
312670,202306,996,626,370,826344.42,488403.91,1314748.33
312675,202306,51,39,12,51480,15840,67320
312680,202306,81,53,28,69960,36960,106920
312690,202306,285,147,138,194043.59,183480.8,377524.39
312695,202306,34,26,8,34320,10560,44880
312700,202306,275,159,116,209884.33,154440.64,364324.97
312705,202306,89,70,19,92400,25080,117480
312707,202306,135,95,40,125400.25,52800,178200.25
312710,202306,2015,1138,877,1502207.81,1160290.14,2662497.95
312720,202306,45,24,21,31680.56,27720,59400.56
312730,202306,302,176,126,232324.1,166322.42,398646.52
312733,202306,51,41,10,54120.7,13200,67320.7
312735,202306,22,17,5,22440.71,6600.3,29041.01
312737,202306,87,52,35,68640.93,46200,114840.93
312738,202306,83,51,32,67320.7,42240,109560.7
312740,202306,81,49,32,64681.89,42240,106921.89
312750,202306,125,85,40,112200.28,52800,165000.28
312760,202306,287,192,95,253444.4,125400.97,378845.37
312770,202306,9817,4751,5066,6274116.8,6697697.19,12971813.99
312780,202306,469,359,110,473887.24,145202.81,619090.05
312790,202306,22,16,6,21120,7920.9,29040.9
312800,202306,1781,1227,554,1619657.18,731283.2,2350940.38
312810,202306,371,257,114,339241.14,150480,489721.14
312820,202306,202,156,46,205922.49,60720,266642.49
312825,202306,48,35,13,46203.48,17160,63363.48
312830,202306,197,107,90,141241.94,118801.04,260042.98
312840,202306,212,148,64,195361.28,85800,281161.28
312850,202306,37,32,5,42241.63,6600,48841.63
312860,202306,159,106,53,139921.28,69960,209881.28
312870,202306,1290,680,610,897622.83,806520.8,1704143.63
312880,202306,131,99,32,130683,42240,172923
312890,202306,180,128,52,168963.65,68640,237603.65
312900,202306,161,123,38,162361.92,51480,213841.92
312910,202306,190,106,84,139925.63,110881.8,250807.43
312920,202306,116,66,50,87120.42,66000,153120.42
312930,202306,350,226,124,299643.62,163681.44,463325.06
312940,202306,167,114,53,150480.28,69960,220440.28
312950,202306,802,570,232,752420.45,307563.54,1059983.99
312960,202306,150,109,41,143888.34,54121.32,198009.66
312965,202306,120,96,24,126720.1,31680,158400.1
312970,202306,309,248,61,327370.88,80521.14,407892.02
312980,202306,2890,1511,1379,1997225.49,1822929.81,3820155.30
312990,202306,49,20,29,26400.9,38280,64680.9
313000,202306,58,32,26,42240.86,34320,76560.86
313005,202306,194,149,45,196680.97,59400.79,256081.76
313010,202306,1066,472,594,623056.86,784087.23,1407144.09
313020,202306,194,102,92,134640,122760,257400
313030,202306,221,147,74,194042.02,97680.76,291722.78
313040,202306,99,29,70,38280.86,92400,130680.86
313050,202306,228,167,61,220440,80520,300960
313055,202306,44,31,13,40920,17160,58080
313060,202306,158,110,48,145201.05,64680,209881.05
313065,202306,60,46,14,60720,18480,79200
313070,202306,126,65,61,85803.11,80520,166323.11
313080,202306,47,25,22,33000,29040,62040
313090,202306,724,471,253,621727.27,333960.49,955687.76
313100,202306,223,83,140,109560.2,184800,294360.2
313110,202306,169,93,76,122760.32,100321.9,223082.22
313115,202306,284,155,129,204603.51,170280.67,374884.18
313120,202306,901,518,383,683775.58,505563.25,1189338.83
313130,202306,6594,3687,2907,4869629.6,3843870.2,8713499.8
313140,202306,147,86,61,114842.33,80521.35,195363.68
313150,202306,312,242,70,320763.5,92400,413163.5
313160,202306,191,144,47,190084.98,62040,252124.98
313170,202306,1532,970,562,1280444.79,747122.92,2027567.71
313180,202306,367,235,132,310206.85,174243.93,484450.78
313190,202306,821,473,348,624375.94,463323.91,1087699.85
313200,202306,35,29,6,38280.78,7920.2,46200.98
313210,202306,1057,905,152,1194659.58,200643.09,1395302.67
313220,202306,347,209,138,275880,182160,458040
313230,202306,314,246,68,324721.41,89760.03,414481.44
313240,202306,2467,1240,1227,1636837.39,1620961.72,3257799.11
313250,202306,1297,971,326,1281752.47,431644.9,1713397.37
313260,202306,105,52,53,68640.2,69960,138600.2
313270,202306,1130,673,457,888370.69,604564.31,1492935.00
313280,202306,45,34,11,44880,14520,59400
313290,202306,241,193,48,254766.6,63360,318126.6
313300,202306,349,170,179,224405.52,236280.58,460686.10
313310,202306,268,121,147,159722.17,194041.1,353763.27
313320,202306,414,306,108,403923.87,142560.07,546483.94
313330,202306,1516,945,571,1247431.65,753727.07,2001158.72
313340,202306,351,253,98,333966.55,129360.91,463327.46
313350,202306,468,288,180,380162.51,237600.24,617762.75
313360,202306,209,96,113,126721.02,149160,275881.02
313370,202306,245,89,156,117481.42,205920,323401.42
313375,202306,343,219,124,289084.97,163680.32,452765.29
313380,202306,1397,733,664,967586.49,876481.73,1844068.22
313390,202306,56,50,6,66000,7920,73920
313400,202306,429,303,126,399976.9,166322.92,566299.82
313410,202306,101,64,37,85801.5,48840,134641.5
313420,202306,5009,2877,2132,3801730.03,2816896.36,6618626.39
313430,202306,125,61,64,80520.31,84480.33,165000.64
313440,202306,1447,1033,414,1366261.89,549129.58,1915391.47
313450,202306,74,32,42,42240,55440,97680
313460,202306,422,187,235,246843.96,312841,559684.96
313470,202306,535,261,274,344533.24,361685.87,706219.11
313480,202306,171,131,40,172921.62,52800,225721.62
313490,202306,600,273,327,360374.12,434288.41,794662.53
313500,202306,31,17,14,22440,18480,40920
313505,202306,1153,887,266,1170877.64,352447.55,1523325.19
313507,202306,121,83,38,109561.46,50160,159721.46
313510,202306,3142,1940,1202,2561008.73,1587986.78,4148995.51
313520,202306,3611,2795,816,3690868.26,1078448.93,4769317.19
313530,202306,42,25,17,33000,22440.94,55440.94
313535,202306,98,79,19,104282.89,25080.5,129363.39
313540,202306,71,49,22,64680,29040,93720
313545,202306,133,113,20,149160.8,26400,175560.8
313550,202306,226,192,34,253442.4,44881.11,298323.51
313560,202306,373,181,192,238927.38,253445.39,492372.77
313570,202306,87,30,57,39600,75240.92,114840.92
313580,202306,1451,866,585,1143140.91,772204.73,1915345.64
313590,202306,79,50,29,66000.76,38281.3,104282.06
313600,202306,725,441,284,582830.05,374881.14,957711.19
313610,202306,60,47,13,62041.62,17160.35,79201.97
313620,202306,1634,787,847,1038874.99,1118044.92,2156919.91
313630,202306,1804,1368,436,1805802.44,576843.03,2382645.47
313640,202306,119,71,48,93721.08,63360.7,157081.78
313650,202306,254,135,119,178201.44,157082.22,335283.66
313652,202306,34,32,2,42240,2640,44880
313655,202306,98,67,31,88440.76,40920.41,129361.17
313657,202306,53,48,5,63361.59,6600,69961.59
313660,202306,157,105,52,138601.75,68640.93,207242.68
313665,202306,776,366,410,484456.67,541208.78,1025665.45
313670,202306,12010,8246,3764,10891824.85,4973806.83,15865631.68
313680,202306,48,38,10,50160.73,13200,63360.73
313690,202306,141,102,39,134640.54,51480,186120.54
313695,202306,92,71,21,93721.75,27720,121441.75
313700,202306,386,302,84,398645.67,110880.88,509526.55
313710,202306,128,93,35,122762.54,46200,168962.54
313720,202306,1281,600,681,792030.56,900250.15,1692280.71
313730,202306,80,46,34,60721.63,44880,105601.63
313740,202306,165,123,42,162361.54,56760,219121.54
313750,202306,423,298,125,393366.27,165000.79,558367.06
313753,202306,247,189,58,249484.5,77880.1,327364.6
313760,202306,1503,594,909,784099.84,1199894.48,1983994.32
313770,202306,454,303,151,399970.26,199322.93,599293.19
313780,202306,939,519,420,686405.95,555724.13,1242130.08
313790,202306,37,37,0,48840,,48840.0
313800,202306,172,108,64,142565.46,84481.72,227047.18
313810,202306,100,56,44,73920.81,59401.02,133321.83
313820,202306,1508,727,781,960982.78,1034880.84,1995863.62
313830,202306,56,37,19,48840.89,25080,73920.89
313835,202306,68,58,10,76560.2,13200,89760.2
313840,202306,1857,1129,728,1490333.5,960965.22,2451298.72
313850,202306,237,108,129,142564.69,170280.5,312845.19
313860,202306,508,384,124,506889.85,163680.64,670570.49
313862,202306,185,131,54,172925.93,71280,244205.93
313865,202306,194,134,60,176881.78,79200,256081.78
313867,202306,62,53,9,69960,11880.1,81840.1
313868,202306,55,36,19,47520.5,25080,72600.5
313870,202306,84,47,37,62040.2,48840,110880.2
313880,202306,415,257,158,339243.4,211200.69,550444.09
313890,202306,360,200,160,264005.42,211200.63,475206.05
313900,202306,888,491,397,648136.96,525368.7,1173505.66
313910,202306,148,100,48,132000.04,63360,195360.04
313920,202306,696,479,217,632283.23,286441.71,918724.94
313925,202306,37,31,6,40920,7920,48840
313930,202306,961,737,224,972883.04,295684.6,1268567.64
313940,202306,2107,1257,850,1660596.92,1124648.76,2785245.68
313950,202306,924,563,361,744495.9,477840.45,1222336.35
313960,202306,1573,909,664,1199900.46,876486.13,2076386.59
313970,202306,193,109,84,143880.1,110880,254760.1
313980,202306,262,168,94,221767.19,124081.26,345848.45
313990,202306,295,176,119,232320.82,157080,389400.82
314000,202306,954,624,330,823693.78,435604.28,1259298.06
314010,202306,113,72,41,95040.15,54120,149160.15
314015,202306,102,28,74,36960.63,99000.9,135961.53
314020,202306,61,39,22,51480.86,29040,80520.86
314030,202306,79,41,38,54120.75,50160,104280.75
314040,202306,49,26,23,34320,30360,64680
314050,202306,305,168,137,221765.8,180840,402605.8
314053,202306,97,62,35,81841.2,46200,128041.2
314055,202306,323,209,114,276589.55,150481.54,427071.09
314060,202306,129,110,19,145200.67,25080,170280.67
314070,202306,1156,582,574,768263.52,759012.69,1527276.21
314080,202306,229,138,91,182165.45,120121,302286.45
314085,202306,201,139,62,183480.8,81840,265320.8
314090,202306,437,315,122,415808.27,161040.16,576848.43
314100,202306,565,444,121,586096.22,159723.32,745819.54
314110,202306,815,354,461,471257.45,609844.61,1081102.06
314120,202306,70,44,26,58080,34320,92400
314130,202306,29,21,8,27720,10560,38280
314140,202306,1276,806,470,1066583.54,620405.85,1686989.39
314150,202306,203,128,75,168963.41,99000.37,267963.78
314160,202306,324,244,80,322083.39,105600.56,427683.95
314170,202306,90,67,23,88441.39,30360,118801.39
314180,202306,818,726,92,958351.78,122761.27,1081113.05
314190,202306,93,57,36,75241.18,47520,122761.18
314200,202306,558,388,170,512177.39,224407.03,736584.42
314210,202306,250,194,56,256084.09,73920,330004.09
314220,202306,329,234,95,308884.9,125401.32,434286.22
314225,202306,39,24,15,31681.15,19800,51481.15
314230,202306,129,57,72,75240.55,95040,170280.55
314240,202306,191,138,53,182162.7,69960,252122.7
314250,202306,58,36,22,47522.47,29040,76562.47
314260,202306,222,113,109,149160.63,143880,293040.63
314270,202306,436,341,95,451458.71,125400.5,576859.21
314280,202306,774,418,356,553031.22,469922.82,1022954.04
314290,202306,572,445,127,587407.46,167640.72,755048.18
314300,202306,350,263,87,347167.43,117480,464647.43
314310,202306,1397,967,430,1276480.83,567600.21,1844081.04
314315,202306,52,38,14,50160.72,18480,68640.72
314320,202306,629,445,184,587412.09,244201.95,831614.04
314330,202306,12741,6224,6517,8226556.87,8610412.79,16836969.66
314340,202306,713,321,392,423731.07,517444.77,941175.84
314345,202306,62,46,16,60720,21120,81840
314350,202306,187,114,73,150480.88,96360.66,246841.54
314360,202306,56,31,25,40922.66,33000.99,73923.65
314370,202306,75,53,22,69960,29040,99000
314380,202306,144,78,66,102961.54,87120,190081.54
314390,202306,3806,2472,1334,3263158.22,1762202.65,5025360.87
314400,202306,745,520,225,686412.47,297001.87,983414.34
314410,202306,585,388,197,513493.05,260043.23,773536.28
314420,202306,28,18,10,23760,13200,36960
314430,202306,2614,1015,1599,1339839.13,2115994.5,3455833.63
314435,202306,153,92,61,121441.05,80520,201961.05
314437,202306,58,46,12,60720,15840,76560
314440,202306,102,65,37,87120.49,48840.1,135960.59
314450,202306,181,125,56,165001.34,73920.96,238922.30
314460,202306,659,330,329,435607.51,434283.01,869890.52
314465,202306,131,85,46,113520.99,60720,174240.99
314467,202306,76,62,14,81840,18480,100320
314470,202306,441,218,223,289082.73,294362.65,583445.38
314480,202306,1167,534,633,704895.23,839524.68,1544419.91
314490,202306,40,21,19,27720,25080,52800
314500,202306,286,196,90,258724.93,118800.45,377525.38
314505,202306,124,78,46,102961.09,60720,163681.09
314510,202306,263,216,47,285124.13,62040,347164.13
314520,202306,1540,789,751,1041516.32,992650.9,2034167.22
314530,202306,823,655,168,864629.94,221763.41,1086393.35
314535,202306,191,123,68,162360,89760,252120
314537,202306,70,43,27,56760.97,36960.98,93721.95
314540,202306,22,13,9,17160,11880,29040
314545,202306,70,47,23,62040,30360,92400
314550,202306,82,46,36,62041.06,47521.83,109562.89
314560,202306,907,486,421,641534.06,555725.75,1197259.81
314570,202306,15,13,2,17160.56,2640,19800.56
314580,202306,10,4,6,5280,7920,13200
314585,202306,34,26,8,34320,10560.47,44880.47
314587,202306,79,66,13,87120.7,17160,104280.7
314590,202306,648,439,209,579495.99,275881.64,855377.63
314600,202306,1044,681,363,900276.42,479169.86,1379446.28
314610,202306,1040,538,502,710171.32,665286.96,1375458.28
314620,202306,159,121,38,159720.6,50160,209880.6
314625,202306,98,76,22,100321.09,29040,129361.09
314630,202306,1180,673,507,888385.3,669247.82,1557633.12
314640,202306,97,59,38,77881.17,50160,128041.17
314650,202306,162,95,67,125402.77,88441.57,213844.34
314655,202306,65,47,18,62040,23760,85800
314660,202306,21,17,4,22440,5280,27720
314670,202306,230,180,50,237612.36,66002.97,303615.33
314675,202306,226,139,87,183482.48,114840.23,298322.71
314690,202306,594,321,273,423727.24,361682.32,785409.56
314700,202306,2298,1231,1067,1624986.3,1408446.05,3033432.35
314710,202306,2000,1114,886,1473149.93,1170841.26,2643991.19
314720,202306,442,246,196,324726.18,258721.25,583447.43
314730,202306,541,290,251,382805.58,331322.52,714128.10
314740,202306,869,388,481,512171.27,634924.23,1147095.50
314750,202306,27,20,7,26400,9240,35640
314760,202306,380,155,225,204602.13,298320.88,502923.01
314770,202306,104,67,37,88441.39,48840,137281.39
314780,202306,19,8,11,10560,14520,25080
314790,202306,2726,1755,971,2316671.39,1283041.71,3599713.10
314795,202306,78,67,11,88440.2,14520,102960.2
314800,202306,3160,1863,1297,2460540.17,1713363.71,4173903.88
314810,202306,1605,915,690,1210462.09,910800.54,2121262.63
314820,202306,125,73,52,96360.99,68640.1,165001.09
314830,202306,236,199,37,262685.23,48840,311525.23
314840,202306,92,53,39,69960,51480,121440
314850,202306,463,226,237,298455.56,312840.05,611295.61
314860,202306,669,508,161,670566.35,212520.08,883086.43
314870,202306,1783,977,806,1289674.19,1063935.95,2353610.14
314875,202306,72,65,7,85800,9240,95040
314880,202306,45,33,12,43560,15840,59400
314890,202306,59,33,26,44880,34320,79200
314900,202306,28,21,7,27721.1,9240.92,36962.02
314910,202306,243,161,82,212520.98,109560,322080.98
314915,202306,151,126,25,166322.23,33000.68,199322.91
314920,202306,83,54,29,71280.85,38280,109560.85
314930,202306,1130,510,620,673221.2,819721.85,1492943.05
314940,202306,40,31,9,40920,11880,52800
314950,202306,24,19,5,25081.59,6600,31681.59
314960,202306,31,20,11,26400.39,14520.18,40920.57
314970,202306,185,85,100,112201.37,132000.39,244201.76
314980,202306,331,216,115,285123.09,151800.75,436923.84
314990,202306,480,258,222,340565.91,293041.52,633607.43
314995,202306,154,71,83,93720.5,110880,204600.5
315000,202306,106,82,24,108240.49,31680.1,139920.59
315010,202306,41,25,16,33000,21120,54120
315015,202306,173,140,33,184800.4,43560,228360.4
315020,202306,68,56,12,73920,15840,89760
315030,202306,121,91,30,120120,39600,159720
315040,202306,92,56,36,73920.37,47520,121440.37
315050,202306,222,138,84,182160.92,110880.68,293041.60
315053,202306,72,50,22,66000,29040,95040
315057,202306,135,103,32,135960.65,42240,178200.65
315060,202306,62,52,10,68641.88,13200,81841.88
315070,202306,122,75,47,99001.78,62040,161041.78
315080,202306,410,329,81,434286.2,106921,541207.2
315090,202306,109,64,45,84481.39,59400,143881.39
315100,202306,99,49,50,64681.73,67320.38,132002.11
315110,202306,297,153,144,201963.23,190080,392043.23
315120,202306,1998,944,1054,1246128.31,1392629.36,2638757.67
315130,202306,377,267,110,353765.43,145200.44,498965.87
315140,202306,580,312,268,411849.68,353764.93,765614.61
315150,202306,1030,502,528,662661.57,696965.99,1359627.56
315160,202306,206,111,95,146528.25,125404.12,271932.37
315170,202306,305,195,110,257402.89,145200.8,402603.69
315180,202306,3465,1481,1984,1954975.8,2625495.29,4580471.09
315190,202306,305,188,117,248165.46,154440.73,402606.19
315200,202306,1313,804,509,1061305.87,675844.05,1737149.92
315210,202306,1938,1185,753,1565557.85,995283.07,2560840.92
315213,202306,26,16,10,21121.63,14520,35641.63
315217,202306,233,182,51,240241.42,67320.55,307561.97
315220,202306,1716,1264,452,1668522.02,596648.91,2265170.93
315230,202306,200,156,44,205922.33,58080,264002.33
315240,202306,390,260,130,343208.66,171602.3,514810.96
315250,202306,2919,1401,1518,1849381.26,2005084.47,3854465.73
315260,202306,139,82,57,108240,75240.1,183480.1
315270,202306,160,113,47,149160.8,63360,212520.8
315280,202306,650,427,223,563665.64,295691.43,859357.07
315290,202306,206,132,74,174242.53,97680.2,271922.73
315300,202306,107,82,25,108240.01,33000,141240.01
315310,202306,90,80,10,105600,13200,118800
315320,202306,141,92,49,121445.56,64680,186125.56
315330,202306,65,52,13,68640,17160,85800
315340,202306,398,289,109,381484.33,143881.76,525366.09
315350,202306,172,110,62,145201.38,81840.34,227041.72
315360,202306,110,52,58,68640.15,76560.23,145200.38
315370,202306,59,39,20,51481.12,26400,77881.12
315380,202306,6,5,1,6600,1320,7920
315390,202306,71,27,44,36960,58081.31,95041.31
315400,202306,898,680,218,897616.52,287761.19,1185377.71
315410,202306,335,201,134,265333.75,176884.9,442218.65
315415,202306,59,45,14,59400.27,18480,77880.27
315420,202306,214,155,59,204602.24,77880,282482.24
315430,202306,663,369,294,487084.59,388080.38,875164.97
315440,202306,96,62,34,81840.2,44880,126720.2
315445,202306,244,201,43,265328.29,56760.37,322088.66
315450,202306,183,134,49,176880,64680,241560
315460,202306,5340,2483,2857,3277694.36,3776572.28,7054266.64
315470,202306,52,20,32,26400.9,42240,68640.9
315480,202306,90,30,60,39601.68,79202.19,118803.87
315490,202306,766,504,262,665288.32,345840.48,1011128.80
315500,202306,22,18,4,23760,5280,29040
315510,202306,165,119,46,157081.06,60720,217801.06
315520,202306,78,66,12,87120.98,15840,102960.98
315530,202306,47,28,19,36960,25080.2,62040.2
315540,202306,283,195,88,257403.9,116160.88,373564.78
315550,202306,203,161,42,213841.63,55440,269281.63
315560,202306,749,593,156,782778.21,207243.81,990022.02
315570,202306,323,158,165,208564.89,217800.91,426365.80
315580,202306,799,548,251,724687.07,331320.96,1056008.03
315590,202306,196,98,98,129362.45,129360.63,258723.08
315600,202306,373,292,81,385443.78,106920.78,492364.56
315610,202306,106,50,56,66000,73920,139920
315620,202306,41,29,12,38282.7,15840,54122.7
315630,202306,139,106,33,139920.96,43560,183480.96
315640,202306,62,40,22,52800.98,29040,81840.98
315645,202306,54,36,18,47520,23760,71280
315650,202306,175,129,46,170280.71,60720,231000.71
315660,202306,445,208,237,274571,312845.53,587416.53
315670,202306,2619,1186,1433,1565580.05,1894221.9,3459801.95
315680,202306,800,578,222,764288.54,293040.5,1057329.04
315690,202306,725,486,239,641536.41,315482.93,957019.34
315700,202306,2184,1150,1034,1518041.4,1366229.36,2884270.76
315710,202306,393,137,256,180841.94,337920.18,518762.12
315720,202306,537,324,213,427687.72,282480.92,710168.64
315725,202306,215,168,47,221760.27,62040,283800.27
315727,202306,94,57,37,75244.13,48840,124084.13
315730,202306,58,51,7,67320,9240,76560
315733,202306,88,50,38,66000.5,50160,116160.5
315737,202306,52,40,12,52800.86,15840,68640.86
315740,202306,32,24,8,31680.35,10560,42240.35
315750,202306,180,128,52,170280.17,68640,238920.17
315760,202306,48,36,12,47520,15840,63360
315765,202306,144,85,59,112204.15,79202.44,191406.59
315770,202306,257,175,82,231003.37,108240.64,339244.01
315780,202306,4394,2182,2212,2881647.02,2921169.43,5802816.45
315790,202306,259,197,62,261364.32,81840.87,343205.19
315800,202306,340,225,115,297003.39,151800,448803.39
315810,202306,63,39,24,51481.16,31680,83161.16
315820,202306,812,610,202,805226.17,267964.39,1073190.56
315830,202306,129,87,42,114841.02,56760.39,171601.41
315840,202306,86,60,26,79200,34320.66,113520.66
315850,202306,278,183,95,241566.21,125400.81,366967.02
315860,202306,21,9,12,11880,15840,27720
315870,202306,40,31,9,40921.04,11880,52801.04
315880,202306,101,66,35,87120,46200,133320
315890,202306,111,77,34,101641.44,44880,146521.44
315895,202306,425,283,142,373576.7,187441.44,561018.14
315900,202306,93,42,51,55440,67320.08,122760.08
315910,202306,52,32,20,42240,26400,68640
315920,202306,161,109,52,143882.57,68640,212522.57
315930,202306,55,20,35,26402.87,46201.04,72603.91
315935,202306,137,109,28,143883.04,36960,180843.04
315940,202306,101,74,27,97680,35640,133320
315950,202306,43,34,9,44880,11880.35,56760.35
315960,202306,617,293,324,386770.56,429006.56,815777.12
315970,202306,34,29,5,38280.96,6600,44880.96
315980,202306,707,370,337,488413.91,446161.66,934575.57
315990,202306,271,153,118,201962.39,155760.62,357723.01
316000,202306,52,31,21,40920,27720,68640
316010,202306,100,85,15,112201.48,19800,132001.48
316020,202306,96,87,9,114841.25,11880,126721.25
316030,202306,389,229,160,302286.59,211202.19,513488.78
316040,202306,587,244,343,323403.85,452760.61,776164.46
316045,202306,55,49,6,64680,7920,72600
316050,202306,27,19,8,25080,10560,35640
316060,202306,112,79,33,104281.17,43560,147841.17
316070,202306,1330,899,431,1186714.74,572884.26,1759599.00
316080,202306,97,64,33,84596.76,43560,128156.76
316090,202306,36,17,19,22440,25080.36,47520.36
316095,202306,89,76,13,100321.67,17160.44,117482.11
316100,202306,373,206,167,271924.98,221760.32,493685.30
316105,202306,58,37,21,48840.57,27720,76560.57
316110,202306,1974,1522,452,2009087.21,596648.58,2605735.79
316120,202306,77,53,24,69960,31680,101640
316130,202306,126,93,33,122763.35,44880,167643.35
316140,202306,31,21,10,27720,13200,40920
316150,202306,244,173,71,228362.69,93720.33,322083.02
316160,202306,87,58,29,76561.99,38280.28,114842.27
316165,202306,76,48,28,63360.78,36960,100320.78
316170,202306,191,123,68,162360.07,89760,252120.07
316180,202306,230,91,139,120123.58,183481.85,303605.43
316190,202306,152,108,44,142561.39,58080,200641.39
316200,202306,729,405,324,535935.37,427681.79,963617.16
316210,202306,790,548,242,723608.84,320761.54,1044370.38
316220,202306,132,84,48,110881.8,63360,174241.8
316225,202306,43,28,15,36962.16,19800,56762.16
316230,202306,51,30,21,39600.56,27720,67320.56
316240,202306,710,557,153,735257.12,201964.37,937221.49
316245,202306,177,155,22,204602.82,29040.99,233643.81
316250,202306,1804,1197,607,1580092.91,801244.02,2381336.93
316255,202306,141,109,32,143880,42240.92,186120.92
316257,202306,184,93,91,122761.37,120121.46,242882.83
316260,202306,216,145,71,191402.18,93720,285122.18
316265,202306,38,27,11,35641.46,14520.67,50162.13
316270,202306,723,509,214,673212.74,282482.13,955694.87
316280,202306,615,394,221,520092.05,293041.2,813133.25
316290,202306,930,647,283,854063.75,373564.12,1227627.87
316292,202306,693,289,404,381487.9,534603.05,916090.95
316294,202306,114,71,43,93721.9,56760,150481.9
316295,202306,435,203,232,267966.94,306246.65,574213.59
316300,202306,39,25,14,33000,18480,51480
316310,202306,25,13,12,17160,15840,33000
316320,202306,76,35,41,46201.02,54120,100321.02
316330,202306,188,135,53,178200.88,69960,248160.88
316340,202306,144,93,51,122760,67320,190080
316350,202306,205,139,66,183480.59,87120.2,270600.79
316360,202306,28,18,10,23760,13200,36960
316370,202306,1428,702,726,926660.96,959647.01,1886307.97
316380,202306,128,100,28,132000.72,36960,168960.72
316390,202306,103,77,26,101640,34320,135960
316400,202306,177,134,43,176883.89,56760.36,233644.25
316410,202306,329,239,90,315481.84,118800.2,434282.04
316420,202306,231,154,77,203286.76,101641.59,304928.35
316430,202306,174,98,76,129360.82,101640,231000.82
316440,202306,79,43,36,56760.58,47520.08,104280.66
316443,202306,50,40,10,52800,13200,66000
316447,202306,49,41,8,54122.61,10560,64682.61
316450,202306,257,188,69,248160.85,91080,339240.85
316460,202306,49,16,33,21120.43,43560.34,64680.77
316470,202306,1913,1415,498,1867847.19,658680.43,2526527.62
316480,202306,9,7,2,9240,2640,11880
316490,202306,20,6,14,7920,18480,26400
316500,202306,181,118,63,155760.27,84480.47,240240.74
316510,202306,142,114,28,150481.45,36960,187441.45
316520,202306,190,103,87,135961.05,114840.67,250801.72
316530,202306,191,121,70,159721.21,92400,252121.21
316540,202306,166,88,78,116161.52,102960.65,219122.17
316550,202306,179,111,68,146522.3,89760,236282.3
316553,202306,509,253,256,333967.87,337921.6,671889.47
316555,202306,73,63,10,83160.8,13200,96360.8
316556,202306,20,14,6,18480.41,7920,26400.41
316557,202306,43,31,12,40921.07,15840,56761.07
316560,202306,76,53,23,69960.2,30360,100320.2
316570,202306,238,218,20,287762.39,26400,314162.39
316580,202306,25,17,8,22440,10560,33000
316590,202306,90,76,14,100320.82,18480.4,118801.22
316600,202306,184,154,30,203282.16,39600,242882.16
316610,202306,73,53,20,69960.22,26400,96360.22
316620,202306,156,109,47,143880,62040.85,205920.85
316630,202306,67,50,17,66000,22440,88440
316640,202306,25,14,11,18480,14520,33000
316650,202306,119,93,26,122760,34320,157080
316660,202306,4,1,3,1320,3960,5280
316670,202306,440,149,291,196683.94,384122.82,580806.76
316680,202306,183,143,40,188764.93,52800,241564.93
316690,202306,152,94,58,124080,76560,200640
316695,202306,55,47,8,62040,10560,72600
316700,202306,31,22,9,29040,11880,40920
316710,202306,871,657,214,867255.42,282483.4,1149738.82
316720,202306,5628,2629,2999,3471705.29,3962650.68,7434355.97
316730,202306,16,14,2,18480,2640,21120
316740,202306,169,105,64,138600.1,84480,223080.1
316750,202306,19,11,8,14520.32,10560,25080.32
316760,202306,363,285,78,376207.17,102961.06,479168.23
316770,202306,185,101,84,133321.59,110880,244201.59
316780,202306,67,38,29,50160,39600,89760
316790,202306,73,50,23,66000.27,30360.5,96360.77
316800,202306,1913,1161,752,1532558.33,995297.34,2527855.67
316805,202306,33,22,11,29040.08,14520,43560.08
316810,202306,52,30,22,39600.7,30360.5,69961.2
316820,202306,42,24,18,31680,23760,55440
316830,202306,108,50,58,66000.6,76560.2,142560.8
316840,202306,536,325,211,429004.62,278522.52,707527.14
316850,202306,319,223,96,295683.62,126720,422403.62
316860,202306,6859,3129,3730,4132137.87,4930221.73,9062359.60
316870,202306,1895,1228,667,1621036.36,883086.15,2504122.51
316880,202306,172,87,85,114844.34,112201.44,227045.78
316890,202306,239,156,83,205922.33,109560.69,315483.02
316900,202306,459,323,136,426364.37,179520,605884.37
316905,202306,26,11,15,14520,19800,34320
316910,202306,90,37,53,48840,69960,118800
316920,202306,165,128,37,168966.08,48840,217806.08
316930,202306,2205,1129,1076,1490306.6,1421642.16,2911948.76
316935,202306,1044,617,427,814455.1,564968.3,1379423.4
316940,202306,1173,693,480,914779.07,636241.15,1551020.22
316950,202306,215,106,109,139922,143880,283802
316960,202306,1163,648,515,855386.61,679812.05,1535198.66
316970,202306,702,561,141,741862.55,186123.23,927985.78
316980,202306,90,49,41,64680,54120,118800
316990,202306,2470,1682,788,2221614.96,1040165.01,3261779.97
317000,202306,358,276,82,364330.35,108241.84,472572.19
317005,202306,231,162,69,213845.07,91080.9,304925.97
317010,202306,7492,4301,3191,5683486.84,4222735.89,9906222.73
317020,202306,16844,7423,9421,9804055.47,12446381.08,22250436.55
317030,202306,102,50,52,66000,68640,134640
317040,202306,3302,2181,1121,2880317.53,1482367.97,4362685.50
317043,202306,78,62,16,83167.77,21121.27,104289.04
317047,202306,42,26,16,34320,21120,55440
317050,202306,164,131,33,172923.18,43560,216483.18
317052,202306,166,137,29,180841.57,38280,219121.57
317057,202306,195,148,47,195362.58,62040,257402.58
317060,202306,66,39,27,51480.45,35640.8,87121.25
317065,202306,55,42,13,55440,17160,72600
317070,202306,2121,985,1136,1300247.22,1504801.36,2805048.58
317075,202306,98,56,42,73920.25,55440,129360.25
317080,202306,1012,519,493,685111.88,653401.92,1338513.80
317090,202306,758,590,168,778818.39,221764.24,1000582.63
317100,202306,473,353,120,465967.77,158400.95,624368.72
317103,202306,144,117,27,154442.28,35640,190082.28
317107,202306,57,44,13,58080,17160,75240
317110,202306,81,44,37,58080.2,48841.36,106921.56
317115,202306,50,44,6,58142.04,7920,66062.04
317120,202306,2326,1170,1156,1545783.12,1528574.67,3074357.79
317130,202306,2261,1537,724,2030185.2,959643.41,2989828.61
317140,202306,14,11,3,14520.5,3960,18480.5
317150,202306,303,180,123,237602.97,163680.33,401283.30
317160,202306,377,280,97,370924.8,128041.18,498965.98
317170,202306,251,163,88,215161.2,116160.6,331321.8
317180,202306,444,302,142,398644.69,187442.1,586086.79
317190,202306,267,192,75,253441.52,99000,352441.52
317200,202306,934,655,279,864634.84,368288.28,1232923.12
317210,202306,188,98,90,129364.44,118800.21,248164.65
317220,202306,23,11,12,14520,15840,30360
320010,202306,593,423,170,558379.75,224406.32,782786.07
320013,202306,151,97,54,129363.66,71281.65,200645.31
320016,202306,265,161,104,213846.74,137280,351126.74
320020,202306,799,476,323,629664.69,427689.58,1057354.27
320030,202306,184,130,54,171602.91,71281.66,242884.57
320035,202306,145,96,49,126720.2,64680.52,191400.72
320040,202306,515,256,259,339251.08,343209.95,682461.03
320050,202306,127,87,40,114847.84,52801.25,167649.09
320060,202306,2086,982,1104,1296290.04,1457305.23,2753595.27
320070,202306,112,72,40,95040.25,52800,147840.25
320080,202306,877,498,379,657382.48,501606.29,1158988.77
320090,202306,1444,921,523,1215753.99,690376.38,1906130.37
320100,202306,394,221,173,291728.88,228362.32,520091.20
320110,202306,142,87,55,116169.36,72600.6,188769.96
320115,202306,122,104,18,137284.79,23760,161044.79
320120,202306,4153,2188,1965,2896194.33,2601767.63,5497961.96
320130,202306,9013,3868,5145,5112572.49,6798123.54,11910696.03
320140,202306,558,359,199,473904.17,264007.77,737911.94
320150,202306,2386,1323,1063,1749079.99,1404494.74,3153574.73
320160,202306,708,306,402,403930.31,531962.72,935893.03
320170,202306,121,98,23,129362.59,30360.02,159722.61
320180,202306,59,33,26,43561.38,34320,77881.38
320190,202306,271,158,113,208565.39,149160.1,357725.49
320200,202306,66,54,12,71282.94,15840,87122.94
320210,202306,998,544,454,719421.5,599287.62,1318709.12
320220,202306,315,110,205,145200.5,270600.2,415800.7
320225,202306,92,76,16,100320.39,21120.83,121441.22
320230,202306,795,510,285,673235,376208.38,1049443.38
320240,202306,3901,1756,2145,2319328.04,2836720.55,5156048.59
320245,202306,577,395,182,521414.12,240246.86,761660.98
320250,202306,259,123,136,162366.54,182163.02,344529.56
320255,202306,126,93,33,122762.52,43560.66,166323.18
320260,202306,327,170,157,225721.9,208562.59,434284.49
320265,202306,157,119,38,158401.73,50160.13,208561.86
320270,202306,164,125,39,165002.19,51481.35,216483.54
320280,202306,1523,860,663,1135241.97,876501.6,2011743.57
320290,202306,73,57,16,75240.9,21120,96360.9
320300,202306,676,464,212,612499.92,281162.8,893662.72
320305,202306,830,459,371,607223.42,491054,1098277.42
320310,202306,226,133,93,175563.27,122760.9,298324.17
320313,202306,395,173,222,228369.63,293041.4,521411.03
320316,202306,114,86,28,113522.43,36960.3,150482.73
320320,202306,3787,1715,2072,2267830.2,2739039.65,5006869.85
320330,202306,313,225,88,297002.02,116160,413162.02
320332,202306,864,517,347,683800.36,458054.9,1141855.26
320334,202306,305,167,138,220442.64,182161.3,402603.94
320335,202306,152,98,54,129365.68,71281.56,200647.24
320340,202306,639,456,183,601951.08,244208.81,846159.89
320350,202306,1216,500,716,660024.56,947774.22,1607798.78
320360,202306,183,83,100,109561,132000,241561
320370,202306,249,184,65,242884.59,85800.69,328685.28
320380,202306,368,262,106,345847.75,139920.89,485768.64
320390,202306,1239,714,525,942511.61,693008.89,1635520.50
320400,202306,353,243,110,320774.83,145200.64,465975.47
320405,202306,1073,435,638,574230.12,843500.72,1417730.84
320410,202306,1014,501,513,662659.4,677165.61,1339825.01
320420,202306,654,296,358,390738.35,472574.44,863312.79
320425,202306,231,120,111,158402.73,147840.3,306243.03
320430,202306,430,226,204,298333.12,269289.05,567622.17
320435,202306,204,139,65,183482.14,85801.97,269284.11
320440,202306,226,127,99,167643.34,132004.69,299648.03
320450,202306,148,78,70,102960.96,92401.06,195362.02
320455,202306,250,194,56,256084.78,73920.66,330005.44
320460,202306,362,215,147,283803.62,194040.21,477843.83
320465,202306,128,87,41,114845.67,54120.7,168966.37
320470,202306,826,490,336,646830.47,443531.8,1090362.27
320480,202306,246,161,85,212528.79,112200.02,324728.81
320490,202306,3621,1723,1898,2275774.22,2505421.93,4781196.15
320495,202306,140,80,60,105600.75,79200,184800.75
320500,202306,11557,5625,5932,7426667.18,7839607.11,15266274.29
320501,202306,607,316,291,417139.13,384130.75,801269.88
320503,202306,349,244,105,322086.99,139921.08,462008.07
320506,202306,304,206,98,271924.06,129360.38,401284.44
320510,202306,1405,611,794,807865.83,1048098.08,1855963.91
320515,202306,95,74,21,97682.72,27720,125402.72
320517,202306,254,186,68,245526.32,89760.52,335286.84
320520,202306,9019,3792,5227,5010897.96,6907677.02,11918574.98
320530,202306,8078,3854,4224,5087433.26,5578393.94,10665827.20
330010,202306,3918,1906,2012,2517343.34,2659833.56,5177176.90
330015,202306,229,100,129,132001.66,170280.56,302282.22
330020,202306,4518,1716,2802,2266514.74,3700001.1,5966515.84
330022,202306,288,144,144,190085.08,190081.02,380166.10
330023,202306,974,270,704,356406.66,929289.88,1285696.54
330025,202306,1088,186,902,245521.93,1195809.22,1441331.15
330030,202306,2054,1271,783,1679121.26,1034895.69,2714016.95
330040,202306,2988,1517,1471,2003831.5,1950990.63,3954822.13
330045,202306,11561,3724,7837,4919823,10362165.09,15281988.09
330050,202306,957,578,379,762981.61,500285.55,1263267.16
330060,202306,1379,806,573,1063972.04,756371.09,1820343.13
330070,202306,4939,1679,3260,2216362.62,4308537.45,6524900.07
330080,202306,1819,787,1032,1038881.79,1363579.34,2402461.13
330090,202306,428,234,194,308889.8,256081.8,564971.6
330093,202306,245,103,142,135962.07,187441.48,323403.55
330095,202306,74,39,35,51480.35,46200,97680.35
330100,202306,12407,6180,6227,8163252.21,8235625.78,16398877.99
330110,202306,521,238,283,314167.66,373566.52,687734.18
330115,202306,561,274,287,361688.82,380162.15,741850.97
330120,202306,454,234,220,308885.63,290401.6,599287.23
330130,202306,1773,482,1291,637593.31,1705477.68,2343070.99
330140,202306,758,393,365,518768.36,481802.17,1000570.53
330150,202306,573,346,227,458053.65,299642.84,757696.49
330160,202306,218,126,92,167652.02,121444.95,289096.97
330170,202306,30006,10711,19295,14148364.67,25498889.5,39647254.17
330180,202306,286,154,132,203283.58,174243.27,377526.85
330185,202306,1348,526,822,694346.04,1085059.42,1779405.46
330187,202306,694,205,489,270611.79,648125.37,918737.16
330190,202306,7102,2717,4385,3590528.83,5792231.5,9382760.33
330200,202306,5180,1764,3416,2329890.97,4510534.55,6840425.52
330205,202306,546,305,241,402612.75,318123.64,720736.39
330210,202306,1002,590,412,780143.6,545165.83,1325309.43
330220,202306,3109,1822,1287,2406465.63,1701511.49,4107977.12
330225,202306,715,349,366,460687.78,483122.34,943810.12
330227,202306,2686,888,1798,1172227.48,2376097.36,3548324.84
330230,202306,260,137,123,180843.52,162363.54,343207.06
330240,202306,4971,2318,2653,3059891.5,3507301.32,6567192.82
330245,202306,184,86,98,113522.42,129360.86,242883.28
330250,202306,7456,3559,3897,4707332.23,5149406.74,9856738.97
330260,202306,873,240,633,316807.01,836884.68,1153691.69
330270,202306,4518,1470,3048,1941787.7,4027394.03,5969181.73
330280,202306,506,302,204,398661.56,270606.02,669267.58
330285,202306,7007,2263,4744,2991275.93,6274106.94,9265382.87
330290,202306,857,293,564,386776.26,745805.5,1132581.76
330300,202306,826,504,322,667436.91,426368.1,1093805.01
330310,202306,521,301,220,397332.41,291721.53,689053.94
330320,202306,8519,2920,5599,3857231.05,7400041.77,11257272.82
330330,202306,10719,3880,6839,5127056.37,9032889.49,14159945.86
330340,202306,3104,1693,1411,2234814.74,1865180.65,4099995.39
330350,202306,23483,8248,15235,10899767.68,20135689.72,31035457.40
330360,202306,2059,977,1082,1289698.33,1430913.16,2720611.49
330370,202306,1089,575,514,760347.36,678496.88,1438844.24
330380,202306,1148,468,680,617780.09,901571.99,1519352.08
330385,202306,732,355,377,469931.11,497643.72,967574.83
330390,202306,7034,3671,3363,4852604.72,4448536.37,9301141.09
330395,202306,448,285,163,376212.66,216484.6,592697.26
330400,202306,775,395,380,521422.99,501603.77,1023026.76
330410,202306,571,408,163,538576.97,215164.11,753741.08
330411,202306,412,222,190,293043.36,250800,543843.36
330412,202306,243,115,128,151803.61,168960.1,320763.71
330414,202306,6296,2369,3927,3128541.9,5192937.41,8321479.31
330415,202306,684,291,393,384132.07,518765,902897.07
330420,202306,2726,1410,1316,1866531.78,1738453.58,3604985.36
330430,202306,1971,843,1128,1115427.94,1492937.16,2608365.10
330440,202306,436,214,222,282485.32,293041.68,575527.00
330450,202306,136,62,74,81840.87,99000.98,180841.85
330452,202306,2821,1147,1674,1515419.09,2216305,3731724.09
330455,202306,142400,50148,92252,66241910.15,121917524.94,188159435.09
330460,202306,285,131,154,172922.02,203280.4,376202.42
330470,202306,1378,734,644,970226.87,852731.96,1822958.83
330475,202306,2077,627,1450,827656.85,1917977.22,2745634.07
330480,202306,875,483,392,637580.73,517445.71,1155026.44
330490,202306,18754,5810,12944,7678826.5,17103460.52,24782287.02
330500,202306,1771,769,1002,1015107.25,1323972.25,2339079.50
330510,202306,12409,4416,7993,5832022.08,10566756.85,16398778.93
330513,202306,107,57,50,75240.45,66000,141240.45
330515,202306,741,330,411,435610.7,543855.54,979466.24
330520,202306,2804,953,1851,1260650.26,2447324.34,3707974.60
330530,202306,194,114,80,150484.38,105600.1,256084.48
330540,202306,384,198,186,265323.36,245523.88,510847.24
330550,202306,3118,1049,2069,1386031.23,2732426.46,4118457.69
330555,202306,1276,454,822,600613.88,1085044.97,1685658.85
330560,202306,865,300,565,396012.05,745809.41,1141821.46
330570,202306,363,251,112,331322.44,149160.09,480482.53
330575,202306,982,363,619,479175.5,818414.94,1297590.44
330580,202306,3896,2056,1840,2714000.18,2432795.98,5146796.16
330590,202306,273,143,130,190085.4,171602.08,361687.48
330600,202306,1610,946,664,1248767.16,876496.1,2125263.26
330610,202306,1793,907,886,1197271.81,1172166.12,2369437.93
330615,202306,242,194,48,256083.74,63362.97,319446.71
330620,202306,1067,454,613,599308.2,810494.18,1409802.38
330630,202306,5308,3048,2260,4026154.81,2987207.21,7013362.02
350010,202306,636,417,219,550466.35,289082.69,839549.04
350020,202306,62,23,39,30361.8,51480,81841.8
350030,202306,627,366,261,485787.23,344527.45,830314.68
350040,202306,116,50,66,66003.04,87120.68,153123.72
350050,202306,401,185,216,244209.42,285123.38,529332.80
350055,202306,147,63,84,83163.06,110880.21,194043.27
350060,202306,84,35,49,46202.06,64680.2,110882.26
350070,202306,863,476,387,629676.85,512174.23,1141851.08
350075,202306,87,51,36,67322.9,47520,114842.9
350080,202306,64,30,34,39600.82,44880.2,84481.02
350090,202306,86,47,39,62042,51480,113522
350100,202306,309,195,114,257405.46,150480,407885.46
350110,202306,50,32,18,42242.54,23760,66002.54
350115,202306,199,96,103,126724.02,135961.36,262685.38
350120,202306,120,79,41,104283.64,54120.61,158404.25
350130,202306,445,191,254,253457.81,335288.29,588746.10
350140,202306,38,23,15,30360.64,19800,50160.64
350150,202306,83,57,26,75242.18,34320.22,109562.40
350160,202306,2599,1026,1573,1354365.72,2082969.96,3437335.68
350170,202306,462,269,193,356413.91,256083.57,612497.48
350180,202306,170,92,78,121442.85,102960.41,224403.26
350190,202306,1075,579,496,764320.74,654722.25,1419042.99
350200,202306,64,27,37,35641.35,48840,84481.35
350210,202306,1415,745,670,983447.79,885743,1869190.79
350220,202306,656,520,136,686419.73,180842.47,867262.20
350230,202306,73,44,29,58080.67,38280.9,96361.57
350240,202306,60,37,23,48840.65,30360.65,79201.30
350250,202306,1188,528,660,696988.92,872532.39,1569521.31
350260,202306,116,84,32,110882.93,43560.87,154443.80
350270,202306,1056,691,365,916087,483122.58,1399209.58
350275,202306,371,139,232,183482.27,306243.93,489726.20
350280,202306,4750,2238,2512,2959578.99,3322460.04,6282039.03
350290,202306,531,226,305,298326,402602.42,700928.42
350300,202306,51,27,24,35645.22,31680.9,67326.12
350310,202306,86,50,36,66001.86,48840.59,114842.45
350315,202306,13,11,2,14520,2640,17160
350320,202306,3721,1739,1982,2296914.99,2618910.16,4915825.15
350330,202306,1818,875,943,1156360.72,1255324.34,2411685.06
350335,202306,25,15,10,19800,13200,33000
350340,202306,134,52,82,68641.3,108244.01,176885.31
350350,202306,99,47,52,62040,68640,130680
350360,202306,119,77,42,101643.59,55440.64,157084.23
350370,202306,93,53,40,69963.1,52800.48,122763.58
350380,202306,951,410,541,541217.91,719407.06,1260624.97
350390,202306,2014,749,1265,988705.39,1669816.5,2658521.89
350395,202306,20,14,6,18480,7920,26400
350400,202306,1917,898,1019,1185403.22,1351681.51,2537084.73
350410,202306,3454,1376,2078,1820336.96,2742984.45,4563321.41
350420,202306,306,177,129,233644.44,170281.28,403925.72
350430,202306,110,56,54,73923.44,72602.52,146525.96
350440,202306,148,106,42,139929.41,55440.35,195369.76
350450,202306,1890,1027,863,1357013.93,1143122.64,2500136.57
350460,202306,459,158,301,208569.19,397330.97,605900.16
350470,202306,24,13,11,17160,15840,33000
350480,202306,216,111,105,147847.56,138600.88,286448.44
350490,202306,265,121,144,159722.72,190080.8,349803.52
350500,202306,62,20,42,26400,55440,81840
350510,202306,155,87,68,114843.96,89760.37,204604.33
350520,202306,480,256,224,339264.96,295690.35,634955.31
350530,202306,544,260,284,343217.81,374892.47,718110.28
350535,202306,99,65,34,85800.37,44880.23,130680.60
350540,202306,361,191,170,252128.8,228365.75,480494.55
350550,202306,3043,1685,1358,2224310.52,1795208.91,4019519.43
350560,202306,626,423,203,559699.35,267962.51,827661.86
350570,202306,4977,2051,2926,2708734.48,3868951.92,6577686.40
350580,202306,407,195,212,257410.08,279844.64,537254.72
350590,202306,1096,575,521,760345.24,689185.07,1449530.31
350600,202306,7055,3186,3869,4211019.79,5113729.68,9324749.47
350610,202306,1644,856,788,1129963.82,1040166.12,2170129.94
350620,202306,24,14,10,18480,13200,31680
350630,202306,274,134,140,176884.69,184802.48,361687.17
350635,202306,1481,639,842,843505.53,1111459.19,1954964.72
350640,202306,134,92,42,121440.6,55440.7,176881.3
350650,202306,2087,1358,729,1795289.85,963605.78,2758895.63
350660,202306,873,340,533,448809.54,703568.39,1152377.93
350670,202306,310,153,157,201964.76,207240.2,409204.96
350680,202306,160,85,75,112204.07,99000.92,211204.99
350690,202306,218,99,119,130682.1,157080,287762.1
350700,202306,1086,525,561,693026.85,740528.99,1433555.84
350710,202306,468,169,299,223087.77,396004.68,619092.45
350715,202306,60,47,13,62040.97,17160,79200.97
350720,202306,17,13,4,17160.99,5280,22440.99
350730,202306,49,30,19,40922.35,25080.61,66002.96
350740,202306,267,147,120,194043.53,158401.78,352445.31
350745,202306,35,16,19,21121.48,25081.44,46202.92
350750,202306,2830,1637,1193,2160921.28,1576094.23,3737015.51
350760,202306,4408,1836,2572,2424913.76,3397705.81,5822619.57
350770,202306,64,41,23,54120.57,30360,84480.57
350775,202306,72,55,17,72606.52,22441.63,95048.15
350780,202306,505,249,256,328694.42,337922.9,666617.32
350790,202306,381,157,224,208564.72,295684.8,504249.52
350800,202306,585,344,241,454085.7,319441.59,773527.29
350810,202306,549,413,136,545188.65,179520.39,724709.04
350820,202306,100,55,45,72601.19,59400,132001.19
350830,202306,87,44,43,58080.67,56760,114840.67
350840,202306,909,360,549,477852.66,727449.46,1205302.12
350850,202306,2052,1042,1010,1375483.51,1333207.52,2708691.03
350860,202306,775,392,383,517462.29,505572,1023034.29
350870,202306,494,339,155,447491.55,204601.26,652092.81
350880,202306,310,161,149,212526.89,198004.41,410531.30
350890,202306,43,26,17,34320,22440.08,56760.08
350900,202306,1799,600,1199,792028.44,1584031.71,2376060.15
350910,202306,28,15,13,19800,17160.36,36960.36
350920,202306,881,444,437,586090.8,578160.94,1164251.74
350925,202306,1277,626,651,827683.68,859336.95,1687020.63
350930,202306,136,75,61,99003.64,80520.28,179523.92
350940,202306,799,409,390,539907.39,514814.57,1054721.96
350945,202306,129,88,41,116163.22,54120.18,170283.40
350950,202306,20032,9241,10791,12209076.04,14270634.86,26479710.90
350960,202306,1937,773,1164,1021700.72,1539134.85,2560835.57
350970,202306,1205,561,644,740405.78,852734.45,1593140.23
350980,202306,101,68,33,89764,43560,133324
350990,202306,436,159,277,209881.65,365641.19,575522.84
350995,202306,47,20,27,26401.15,35640.84,62041.99
351000,202306,652,410,242,541220.41,320768.1,861988.51
351010,202306,54,36,18,48843,23760,72603
351015,202306,43,23,20,30360,26400,56760
351020,202306,1597,948,649,1254040.56,856689.21,2110729.77
351030,202306,366,205,161,270604.16,213840.32,484444.48
351040,202306,1142,632,510,835587.3,674524.55,1510111.85
351050,202306,4118,1847,2271,2438859.73,3001708.18,5440567.91
351060,202306,6931,2529,4402,3339724.83,5814629.27,9154354.10
351070,202306,441,274,167,361694.81,220446.49,582141.30
351080,202306,850,627,223,827664.08,294363.87,1122027.95
351090,202306,50,25,25,33000.6,33000.41,66001.01
351100,202306,457,237,220,312864.46,290413.18,603277.64
351110,202306,2290,1046,1244,1383409.84,1643403.38,3026813.22
351120,202306,68,32,36,42241.46,47520,89761.46
351130,202306,202,67,135,88442.99,178204.02,266647.01
351140,202306,343,205,138,270610.34,182163.2,452773.54
351150,202306,552,275,277,364328.45,366963.41,731291.86
351160,202306,363,200,163,264005.76,216480.72,480486.48
351170,202306,258,150,108,198004.28,143880.05,341884.33
351190,202306,108,62,46,81841.6,60720,142561.6
351200,202306,365,235,130,310209.2,171601.65,481810.85
351210,202306,140,66,74,87122.72,97680.78,184803.50
351220,202306,642,354,288,467295.83,380161.2,847457.03
351230,202306,341,211,130,278525.75,171600.8,450126.55
351240,202306,264,131,133,174243.19,179522.92,353766.11
351250,202306,93,66,27,88448.72,35640.1,124088.82
351260,202306,155,107,48,141240.28,63360.99,204601.27
351270,202306,50,22,28,30360.91,36960,67320.91
351280,202306,1143,555,588,732625.52,776169.33,1508794.85
351290,202306,267,126,141,167643.35,186120.7,353764.05
351300,202306,4559,1891,2668,2496193.91,3523132.74,6019326.65
351310,202306,787,380,407,502949.73,539894.12,1042843.85
351320,202306,126,71,55,93721.46,72600.6,166322.06
351330,202306,42,26,16,34320,21120,55440
351340,202306,1629,866,763,1143154.15,1008484.4,2151638.55
351350,202306,2698,1598,1100,2110783.12,1453328.77,3564111.89
351360,202306,864,401,463,529329.31,611164.94,1140494.25
351370,202306,483,238,245,314168.83,323400.19,637569.02
351380,202306,9434,4143,5291,5476839.07,6988114.79,12464953.86
351385,202306,26,19,7,25081.67,9240,34321.67
351390,202306,302,217,85,286447.02,112200.82,398647.84
351400,202306,64,42,22,55440.8,29040,84480.8
351410,202306,520,300,220,396014.63,291722.35,687736.98
351420,202306,83,60,23,79201.32,30360,109561.32
351430,202306,75,40,35,52801.03,46200.2,99001.23
351440,202306,904,586,318,773556.68,421088.06,1194644.74
351450,202306,317,159,158,209882.68,208564.57,418447.25
351460,202306,147,62,85,81844.47,112201.29,194045.76
351470,202306,147,81,66,106924.64,87120.89,194045.53
351480,202306,498,285,213,376204.69,281160.2,657364.89
351490,202306,334,134,200,176882.05,264000.72,440882.77
351492,202306,30,18,12,23760.63,15840,39600.63
351495,202306,28,20,8,26400.65,10560,36960.65
351500,202306,3712,1470,2242,1941761.58,2963420.58,4905182.16
351510,202306,2367,842,1525,1111473.87,2016978.41,3128452.28
351512,202306,16,10,6,13200,7920,21120
351515,202306,222,128,94,168966.19,126720,295686.19
351518,202306,730,430,300,567633.24,396023.44,963656.68
351519,202306,87,51,36,67322.12,47520,114842.12
351520,202306,186,118,68,155763.04,89784.78,245547.82
351530,202306,28,15,13,19800,17160,36960
351535,202306,146,85,61,112202.89,80521.78,192724.67
351540,202306,514,320,194,423734.82,257405.17,681139.99
351550,202306,1760,1023,737,1351724.57,972847.71,2324572.28
351560,202306,89,48,41,63362.16,54120,117482.16
351565,202306,16,8,8,10560.32,10560,21120.32
351570,202306,3153,1401,1752,1849391.83,2317939.09,4167330.92
351580,202306,36,33,3,43560,3960,47520
351590,202306,68,40,28,52801.76,36960.86,89762.62
351600,202306,181,132,49,175567.89,64680.76,240248.65
351610,202306,56,24,32,31680.53,42240,73920.53
351620,202306,6553,3421,3132,4515911.39,4135600.44,8651511.83
351630,202306,3756,1754,2002,2315357.02,2642666.85,4958023.87
351640,202306,2901,1250,1651,1650050.52,2184612.83,3834663.35
351650,202306,38,29,9,38281.45,11880,50161.45
351660,202306,147,90,57,120120.3,75240,195360.3
351670,202306,821,456,365,603265.15,481809.83,1085074.98
351680,202306,102,71,31,93720.9,40920,134640.9
351685,202306,16,12,4,15840.13,5280,21120.13
351690,202306,317,201,116,265330.34,153121.42,418451.76
351700,202306,198,133,65,175854.88,85800.2,261655.08
351710,202306,64,41,23,54122.02,30360,84482.02
351720,202306,126,72,54,95043.15,71280,166323.15
351730,202306,131,87,44,116161.24,58080,174241.24
351740,202306,847,529,318,700958.16,422406.5,1123364.66
351750,202306,413,170,243,224405.04,320761.6,545166.64
351760,202306,731,568,163,749670.3,216480.6,966150.9
351770,202306,317,252,65,332659.59,87120.56,419780.15
351780,202306,145,90,55,118801.71,72600,191401.71
351790,202306,284,138,146,182167.72,192723.24,374890.96
351800,202306,49,32,17,42240.18,22440,64680.18
351810,202306,125,78,47,102965.71,62041.64,165007.35
351820,202306,780,546,234,720766.4,310206.94,1030973.34
351830,202306,730,226,504,299650.06,665288.32,964938.38
351840,202306,2543,1126,1417,1486363.65,1873086,3359449.65
351850,202306,283,190,93,250808.81,122760,373568.81
351860,202306,641,423,218,558392.18,287763.48,846155.66
351870,202306,6501,2876,3625,3797775.52,4787724.36,8585499.88
351880,202306,25296,9637,15659,12741002.44,20692352.99,33433355.43
351885,202306,111,59,52,77882.6,69960.3,147842.9
351890,202306,79,52,27,68641.26,35640,104281.26
351900,202306,265,134,131,176888.28,172920.95,349809.23
351905,202306,107,53,54,69962.11,71280.24,141242.35
351907,202306,4187,1698,2489,2241440.59,3285507.14,5526947.73
351910,202306,169,72,97,95044.89,128040.93,223085.82
351920,202306,123,66,57,87120,75240,162360
351925,202306,97,57,40,75242.77,52801.51,128044.28
351930,202306,507,314,193,414502.01,254766.78,669268.79
351940,202306,259,107,152,141242.25,200641.07,341883.32
351950,202306,147,80,67,105601.02,89764.89,195365.91
351960,202306,1074,521,553,687748.43,731301.51,1419049.94
351970,202306,2378,1103,1275,1455989.29,1685660.84,3141650.13
351980,202306,161,70,91,92402.29,120122.09,212524.38
351990,202306,258,159,99,209884.53,130680.87,340565.40
352000,202306,267,177,90,233655.25,118804.16,352459.41
352010,202306,472,302,170,398748.82,224411.65,623160.47
352020,202306,218,68,150,89760,198000,287760
352030,202306,1300,596,704,786743.61,929294.88,1716038.49
352040,202306,767,293,474,386766.72,627005.19,1013771.91
352042,202306,376,93,283,122763.57,373562.87,496326.44
352044,202306,385,211,174,278534.8,229686.98,508221.78
352050,202306,3605,1315,2290,1735843.83,3026775.76,4762619.59
352060,202306,108,62,46,81840.18,60720.92,142561.10
352070,202306,112,73,39,97685.35,51480,149165.35
352080,202306,71,42,29,55442.69,38280.48,93723.17
352090,202306,201,123,78,162363.49,102961.17,265324.66
352100,202306,340,164,176,216486.32,232321.73,448808.05
352110,202306,114,31,83,40920.61,109560,150480.61
352115,202306,69,25,44,33000,59400.2,92400.2
352120,202306,71,47,24,62040,31680,93720
352130,202306,240,180,60,237613.66,79200.57,316814.23
352140,202306,215,107,108,141243.28,146522.36,287765.64
352150,202306,138,73,65,96361.48,85801.83,182163.31
352160,202306,146,96,50,126723.89,66000.54,192724.43
352170,202306,465,302,163,398644.82,215160.08,613804.90
352180,202306,768,448,320,591382.03,423726.95,1015108.98
352190,202306,255,106,149,139927.13,196682.49,336609.62
352200,202306,30,13,17,17161.33,22440.1,39601.43
352210,202306,5006,1955,3051,2583365.61,4029987.16,6613352.77
352215,202306,80,40,40,52800.2,52800,105600.2
352220,202306,6571,2440,4131,3222237.26,5462223.34,8684460.60
352230,202306,4023,2499,1524,3301460.63,2013007.12,5314467.75
352240,202306,3065,1703,1362,2248033.22,1799176.46,4047209.68
352250,202306,4203,1858,2345,2452632.24,3096729.36,5549361.60
352260,202306,1123,584,539,770902.38,712812.59,1483714.97
352265,202306,73,43,30,56760,39600,96360
352270,202306,431,228,203,300986.62,267967.14,568953.76
352280,202306,553,327,226,431649.61,300960,732609.61
352290,202306,188,104,84,137285.48,112201.9,249487.38
352300,202306,107,63,44,84485.86,58080.77,142566.63
352310,202306,8630,3745,4885,4947562.92,6458774.08,11406337.00
352320,202306,1248,643,605,848779.95,798607.78,1647387.73
352330,202306,565,290,275,382802.59,363000.57,745803.16
352340,202306,1528,691,837,912148.62,1108806.6,2020955.22
352350,202306,406,223,183,294366.82,241561.58,535928.40
352360,202306,233,102,131,134642.52,172920.7,307563.22
352370,202306,131,80,51,105604.35,67321.98,172926.33
352380,202306,121,87,34,114843.97,44881.39,159725.36
352390,202306,2834,1185,1649,1564253.5,2180648.02,3744901.52
352400,202306,605,261,344,345845.6,455403.82,801249.42
352410,202306,1012,668,344,881802.94,456737.7,1338540.64
352420,202306,94,69,25,91081.56,33000,124081.56
352430,202306,1870,806,1064,1065287.1,1408467.94,2473755.04
352440,202306,3868,1693,2175,2238807.73,2874971.18,5113778.91
352450,202306,200,153,47,201963.91,62041.37,264005.28
352460,202306,696,340,356,448808.45,469925.18,918733.63
352470,202306,750,286,464,377537.18,612484.39,990021.57
352480,202306,1794,1007,787,1329282.89,1038858.7,2368141.59
352490,202306,58,24,34,31680.1,44880.16,76560.26
352500,202306,1699,670,1029,884418.71,1358287.31,2242706.02
352510,202306,782,402,380,533305.31,501603.69,1034909.00
352520,202306,966,431,535,568938.58,706213.28,1275151.86
352530,202306,2127,1036,1091,1367583.32,1445410.09,2812993.41
352540,202306,71,50,21,66003.09,27720,93723.09
352550,202306,230,126,104,166322.21,138600,304922.21
352560,202306,57,41,16,54121.49,21120.84,75242.33
352570,202306,840,401,439,529347.61,579496,1108843.61
352580,202306,56,43,13,56762.91,17160,73922.91
352585,202306,17,5,12,6600.25,15840.95,22441.20
352590,202306,4941,2412,2529,3189255.16,3339622.47,6528877.63
352600,202306,405,274,131,361692.71,172927.68,534620.39
352610,202306,971,417,554,550451.7,731285.55,1281737.25
352620,202306,1227,462,765,609852.87,1009808.73,1619661.60
352630,202306,200,76,124,100320.99,165000.08,265321.07
352640,202306,562,355,207,468623.42,274564.02,743187.44
352650,202306,97,65,32,85802.81,42240,128042.81
352660,202306,75,38,37,50160.67,48840,99000.67
352670,202306,1889,989,900,1305557.96,1188003.21,2493561.17
352680,202306,1072,625,447,826351.66,591380.3,1417731.96
352690,202306,5157,2233,2924,2947676.39,3880829.35,6828505.74
352700,202306,93,48,45,63363.06,59401.38,122764.44
352710,202306,1638,841,797,1111492.58,1054682.56,2166175.14
352720,202306,1769,720,1049,951764.7,1384711.31,2336476.01
352725,202306,30,22,8,29041.73,10560,39601.73
352730,202306,447,217,230,286448.39,303603.59,590051.98
352740,202306,406,258,148,340577.74,196682.67,537260.41
352750,202306,24,16,8,21121.75,10560,31681.75
352760,202306,250,159,91,209884.86,121440.63,331325.49
352770,202306,81,59,22,77882.34,29040,106922.34
352780,202306,77,42,35,55440,46200.78,101640.78
352790,202306,26,17,9,22442.57,11880.18,34322.75
352800,202306,263,198,65,262687.86,85802.56,348490.42
352810,202306,161,103,58,135962.55,77883.26,213845.81
352820,202306,41,33,8,43560.07,10560,54120.07
352830,202306,74,47,27,62040.74,35640.01,97680.75
352840,202306,771,331,440,436938.98,582128.81,1019067.79
352850,202306,2034,603,1431,798616.82,1890250.86,2688867.68
352860,202306,128,79,49,104283.53,64680.12,168963.65
352870,202306,52,32,20,42244.76,26400.92,68645.68
352880,202306,197,111,86,146526.93,113521.97,260048.90
352885,202306,36,24,12,31680.32,15840,47520.32
352890,202306,61,38,23,50162.43,30360,80522.43
352900,202306,4977,2325,2652,3070437.73,3504616.62,6575054.35
352910,202306,40,31,9,40920.88,11880,52800.88
352920,202306,676,382,294,504262.96,388087.3,892350.26
352930,202306,1271,589,682,778832.49,901564.69,1680397.18
352940,202306,6958,2601,4357,3437366.4,5765825.41,9203191.81
352950,202306,136,64,72,84482.42,95042.6,179525.02
352960,202306,70,48,22,63360.93,29040,92400.93
352965,202306,16,9,7,11880,9240,21120
352970,202306,582,418,164,551782.97,216486.98,768269.95
352980,202306,162,95,67,125407.23,88441.37,213848.60
352990,202306,1030,474,556,625707.78,735253.61,1360961.39
353000,202306,63,32,31,42240.03,40920.01,83160.04
353010,202306,556,332,224,438254.71,295683.54,733938.25
353020,202306,360,231,129,304930.46,170283.02,475213.48
353030,202306,1490,665,825,877834.45,1092984.03,1970818.48
353040,202306,99,52,47,68642.03,62041.61,130683.64
353050,202306,1444,934,510,1234266.42,673203.25,1907469.67
353060,202306,10116,4382,5734,5784478.77,7583462.21,13367940.98
353070,202306,2205,1280,925,1690996.44,1223408.42,2914404.86
353080,202306,1424,756,668,999283.8,881762.37,1881046.17
353090,202306,71,37,34,48841.83,44880,93721.83
353100,202306,48,35,13,46201.34,17161.54,63362.88
353110,202306,2508,838,1670,1107541.55,2208437.35,3315978.90
353120,202306,151,87,64,114840.23,84480.56,199320.79
353130,202306,926,434,492,572906.53,649445.17,1222351.70
353140,202306,623,287,336,378862.85,444846.82,823709.67
353150,202306,334,171,163,225727.6,217804.58,443532.18
353160,202306,109,82,27,108247.02,35640,143887.02
353170,202306,211,74,137,97681.11,180840.51,278521.62
353180,202306,1421,654,767,864622.11,1012453.08,1877075.19
353190,202306,528,371,157,492383.84,207242.4,699626.24
353200,202306,301,145,156,191403.16,205920.64,397323.80
353205,202306,21,13,8,17160,10560,27720
353210,202306,78,45,33,59401.8,43560.17,102961.97
353215,202306,44,25,19,33000.2,25080,58080.2
353220,202306,86,47,39,62041.46,51480.68,113522.14
353230,202306,164,73,91,97682.04,120120,217802.04
353240,202306,432,184,248,242882.55,328680.28,571562.83
353250,202306,191,97,94,128043.15,124081.61,252124.76
353260,202306,497,314,183,414497.85,242886.01,657383.86
353270,202306,71,54,17,71283.87,22440,93723.87
353280,202306,124,54,70,71284.35,92404.42,163688.77
353282,202306,136,90,46,118801.67,60720.99,179522.66
353284,202306,33,24,9,33002.16,11880,44882.16
353286,202306,9,4,5,5280.2,6600.31,11880.51
353290,202306,90,51,39,67321.09,51480,118801.09
353300,202306,484,236,248,311535.85,327369.5,638905.35
353310,202306,39,31,8,40921.45,10560.95,51482.40
353320,202306,43,23,20,30360.81,26400.2,56761.01
353325,202306,48,24,24,31681.26,31680,63361.26
353330,202306,61,40,21,52800.1,27720.38,80520.48
353340,202306,764,285,479,376209.93,632287.85,1008497.78
353350,202306,1007,489,518,649463.27,685095.4,1334558.67
353360,202306,113,91,22,120121.91,29040.03,149161.94
353370,202306,115,62,53,81842.78,69960.38,151803.16
353380,202306,28,13,15,17160.2,19800,36960.2
353390,202306,1218,574,644,757714.33,850095.15,1607809.48
353400,202306,57,31,26,40922.37,34321.39,75243.76
353410,202306,124,67,57,88445.1,75241.6,163686.7
353420,202306,69,34,35,44880,46200,91080
353430,202306,603,391,212,517464.2,282490.04,799954.24
353440,202306,14783,6538,8245,8633008.52,10891374.16,19524382.68
353450,202306,54,26,28,34320.8,36960.83,71281.63
353460,202306,699,364,335,480501.37,443531.16,924032.53
353470,202306,2486,1188,1298,1570873.1,1714689.17,3285562.27
353475,202306,301,192,109,253444.99,143880.91,397325.90
353480,202306,242,175,67,231003.84,88440,319443.84
353490,202306,238,136,102,179526.12,135960.22,315486.34
353500,202306,220,127,93,167643.32,122761.22,290404.54
353510,202306,86,55,31,73921.24,40920.24,114841.48
353520,202306,274,193,81,254763.16,106920,361683.16
353530,202306,523,258,265,340574.48,349806.09,690380.57
353540,202306,393,246,147,324735.46,194045.57,518781.03
353550,202306,815,505,310,666645.91,409213.2,1075859.11
353560,202306,577,232,345,308881.77,456721.88,765603.65
353570,202306,65,46,19,62042.05,27720,89762.05
353580,202306,385,238,147,314166.33,194040,508206.33
353590,202306,99,74,25,97682.44,33000,130682.44
353600,202306,301,174,127,229687.05,167640.28,397327.33
353610,202306,153,84,69,110880.96,91080,201960.96
353620,202306,720,348,372,459372.48,491049.09,950421.57
353625,202306,66,32,34,42242.06,44880.33,87122.39
353630,202306,237,162,75,213848.18,99000.78,312848.96
353640,202306,143,88,55,116165.28,72600.54,188765.82
353650,202306,1172,459,713,607212.25,941168.32,1548380.57
353657,202306,25,19,6,25080,7920,33000
353660,202306,316,165,151,217805.19,199323.65,417128.84
353670,202306,775,433,342,571582.32,455406.53,1026988.85
353680,202306,156,99,57,130680.58,75240,205920.58
353690,202306,46,29,17,38280.73,22441.09,60721.82
353700,202306,304,203,101,269288.09,133321.88,402609.97
353710,202306,614,300,314,397337.55,414481.44,811818.99
353715,202306,43,24,19,31680,25080,56760
353720,202306,330,150,180,198006.38,237603.22,435609.60
353730,202306,1257,732,525,966293.29,694322.56,1660615.85
353740,202306,642,348,294,460699.58,388088.38,848787.96
353750,202306,100,52,48,68642.42,63360,132002.42
353760,202306,3677,1434,2243,1896921.84,2962122.79,4859044.63
353770,202306,78,62,16,81840.4,21120.2,102960.6
353780,202306,1505,679,826,896302.43,1092968.56,1989270.99
353790,202306,537,315,222,415814.34,294367.67,710182.01
353800,202306,4261,1932,2329,2556977.58,3078249.61,5635227.19
353810,202306,253,126,127,166331.59,170280.82,336612.41
353820,202306,296,120,176,158400.85,232321.71,390722.56
353830,202306,76,63,13,84482.31,17160.9,101643.21
353850,202306,223,97,126,128044.05,166322.37,294366.42
353860,202306,583,269,314,355088.91,414483.69,769572.60
353870,202306,6452,3262,3190,4309934.67,4217429.65,8527364.32
353880,202306,789,502,287,662667,378843.36,1041510.36
353890,202306,620,350,270,463343.81,357724.36,821068.17
353900,202306,150,80,70,105602.83,92402.31,198005.14
353910,202306,220,92,128,121443.07,170281.1,291724.17
353920,202306,520,262,258,345848.31,341885.72,687734.03
353930,202306,1138,657,481,868593.26,634923.51,1503516.77
353940,202306,227,108,119,142562.12,157082.31,299644.43
353950,202306,556,359,197,475224.12,260043.57,735267.69
353960,202306,82,66,16,88443.16,21120,109563.16
353970,202306,43,29,14,38281,18481.66,56762.66
353980,202306,2246,965,1281,1275159.17,1692259.95,2967419.12
353990,202306,89,56,33,73922.51,43560.61,117483.12
354000,202306,413,183,230,241568.67,303601.9,545170.57
354010,202306,91,51,40,67323.21,52800.69,120123.90
354020,202306,561,346,215,458056.53,283806.1,741862.63
354025,202306,43,36,7,47521.6,9240,56761.6
354030,202306,47,26,21,34322.52,27720.15,62042.67
354040,202306,103,77,26,101644.21,34320,135964.21
354050,202306,169,88,81,116162.02,106921.28,223083.30
354060,202306,906,426,480,564971.82,633603.86,1198575.68
354070,202306,995,550,445,726022.54,588728.77,1314751.31
354075,202306,209,97,112,129363.77,147841.17,277204.94
354080,202306,321,147,174,194045.71,229681.89,423727.60
354085,202306,29,18,11,23761.52,14520,38281.52
354090,202306,299,171,128,225613.89,170281.52,395895.41
354100,202306,6874,2769,4105,3657860.22,5423963.95,9081824.17
354105,202306,111,59,52,77882.41,68640,146522.41
354110,202306,44,22,22,29040,29040.52,58080.52
354120,202306,169,101,68,133324.46,89760.64,223085.10
354130,202306,864,535,329,706229.1,435603.46,1141832.56
354140,202306,3684,1655,2029,2184697.72,2679617.18,4864314.90
354150,202306,703,402,301,530670.16,397327.12,927997.28
354160,202306,728,442,286,583477.84,378850.21,962328.05
354165,202306,13,7,6,9240,7920,17160
354170,202306,192,125,67,165006.63,89760.23,254766.86
354180,202306,55,33,22,43560.4,29040.57,72600.97
354190,202306,302,106,196,139923.3,260041.67,399964.97
354200,202306,120,59,61,77882.68,80522.12,158404.80
354210,202306,81,37,44,48840,58080,106920
354220,202306,649,385,264,508229.26,348486.53,856715.79
354230,202306,185,82,103,108242.47,135960.67,244203.14
354240,202306,365,222,143,293054.42,188760.72,481815.14
354250,202306,80,46,34,60720.61,44880,105600.61
354260,202306,2292,1039,1253,1371524.85,1657949.26,3029474.11
354270,202306,93,66,27,87122.23,35640.5,122762.73
354280,202306,60,34,26,44880.79,34320,79200.79
354290,202306,163,108,55,142566.77,72600,215166.77
354300,202306,340,239,101,316807.03,133321.64,450128.67
354310,202306,97,67,30,88445.11,39600.6,128045.71
354320,202306,246,110,136,145202.15,179520,324722.15
354323,202306,11,8,3,10560,3960,14520
354325,202306,129,70,59,92401.49,77880.43,170281.92
354330,202306,2676,896,1780,1185407.25,2353568.6,3538975.85
354340,202306,11748,5276,6472,6977528.85,8551028.16,15528557.01
354350,202306,155,102,53,134641.21,69960,204601.21
354360,202306,81,47,34,62042.23,44880.55,106922.78
354370,202306,254,126,128,166324.61,168961.56,335286.17
354380,202306,190,107,83,141243.75,109560,250803.75
354390,202306,3062,1105,1957,1459967.68,2588545.89,4048513.57
354400,202306,404,215,189,286445.8,249480.79,535926.59
354410,202306,789,342,447,452776.58,594009.83,1046786.41
354420,202306,299,200,99,264008.52,130682.91,394691.43
354425,202306,363,200,163,264069.47,215163.31,479232.78
354430,202306,136,83,53,109566.59,69960.3,179526.89
354440,202306,28,22,6,29041.29,7920,36961.29
354450,202306,59,41,18,54121.34,23760,77881.34
354460,202306,104,58,46,76567.68,60722.35,137290.03
354470,202306,23,13,10,17161.25,13200.76,30362.01
354480,202306,126,69,57,91080.55,75240.51,166321.06
354490,202306,128,73,55,96364.27,72602.7,168966.97
354500,202306,446,187,259,246843.2,341881.19,588724.39
354510,202306,87,61,26,80523.71,34321.19,114844.90
354515,202306,53,19,34,25081.36,44880.1,69961.46
354520,202306,1857,744,1113,983248.3,1482361.16,2465609.46
354530,202306,932,455,477,600618.11,629642.67,1230260.78
354540,202306,261,127,134,167645.11,176881.57,344526.68
354550,202306,46,24,22,31680.32,29040,60720.32
354560,202306,173,93,80,122761.08,105600,228361.08
354570,202306,147,97,50,128040.58,66000.49,194041.07
354580,202306,2074,966,1108,1276475.14,1465205.76,2741680.90
354600,202306,312,144,168,190088.21,221760.5,411848.71
354610,202306,66,54,12,71280.99,15840.82,87121.81
354620,202306,81,24,57,31680,75240.58,106920.58
354625,202306,16,11,5,14522.12,6600.72,21122.84
354630,202306,391,263,128,347178.63,168963.29,516141.92
354640,202306,917,533,384,706468,508206.71,1214674.71
354650,202306,69,41,28,54122.12,36960,91082.12
354660,202306,909,655,254,864647.47,335283.45,1199930.92
354670,202306,247,94,153,124080.97,201960.2,326041.17
354680,202306,1493,530,963,700938.73,1271166.53,1972105.26
354690,202306,83,52,31,68642.5,42240.27,110882.77
354700,202306,79,55,24,72600.38,31680,104280.38
354710,202306,47,33,14,43560.3,18480,62040.3
354720,202306,23,19,4,25080.35,5280,30360.35
354730,202306,2056,834,1222,1102230.25,1615699.62,2717929.87
354740,202306,76,56,20,73921.56,27720,101641.56
354750,202306,435,234,201,308889.36,265322.36,574211.72
354760,202306,567,352,215,465995.07,285128.28,751123.35
354765,202306,8,3,5,3960,6600,10560
354770,202306,385,244,141,322094.22,186123.38,508217.60
354780,202306,9520,3435,6085,4538282.05,8038842.17,12577124.22
354790,202306,94,54,40,71280.82,52800.11,124080.93
354800,202306,468,254,214,336675.47,282485.77,619161.24
354805,202306,81,39,42,51481.21,55440.27,106921.48
354810,202306,106,56,50,73921.41,66000,139921.41
354820,202306,227,94,133,124081.34,175563.14,299644.48
354830,202306,43,23,20,30360,26400,56760
354840,202306,56,36,20,47520.28,26400,73920.28
354850,202306,6012,2381,3631,3144373.77,4795611.46,7939985.23
354860,202306,379,165,214,217801.18,283802.31,501603.49
354870,202306,13980,6047,7933,7986235,10486157.52,18472392.52
354880,202306,2975,1076,1899,1420365.21,2510729.21,3931094.42
354890,202306,3435,1817,1618,2401208.77,2142379.87,4543588.64
354900,202306,66,48,18,63361.62,23760.19,87121.81
354910,202306,1448,724,724,957033.28,955681.74,1912715.02
354920,202306,39,34,5,44880.6,6600,51480.6
354925,202306,28,18,10,23760.77,13200,36960.77
354930,202306,39,30,9,39601.97,11880,51481.97
354940,202306,817,562,255,743195.88,336606.2,1079802.08
354950,202306,213,127,86,167644.27,113522.38,281166.65
354960,202306,135,48,87,63361.87,114840.75,178202.62
354970,202306,1316,923,393,1218414.39,518762.37,1737176.76
354980,202306,10665,3898,6767,5150841.25,8937788.37,14088629.62
354990,202306,11877,5247,6630,6930201.97,8762215.13,15692417.10
354995,202306,652,219,433,289083.65,572888.83,861972.48
355000,202306,464,158,306,208562.74,403920.7,612483.44
355010,202306,760,475,285,627041.52,376208.05,1003249.57
355020,202306,882,533,349,703580.65,462006.72,1165587.37
355030,202306,242142,89450,152692,118197036.57,201803865.03,320000901.60
355040,202306,1143,562,581,741867,768253.13,1510120.13
355050,202306,188,103,85,135961.61,112200,248161.61
355060,202306,2052,950,1102,1255384.77,1457286.86,2712671.63
355070,202306,1839,788,1051,1040187.05,1387337.52,2427524.57
355080,202306,225,132,93,174243.09,122762.18,297005.27
355090,202306,332,202,130,266650.12,171602.72,438252.84
355100,202306,6278,2893,3385,3821465.78,4470889.02,8292354.80
355110,202306,220,144,76,190082.35,100321.08,290403.43
355120,202306,52,33,19,43560.64,25080,68640.64
355130,202306,59,32,27,42241.44,35640,77881.44
355140,202306,217,124,93,163683.79,122760.02,286443.81
355150,202306,789,467,322,616464.27,425045,1041509.27
355160,202306,563,263,300,347176.99,396004.54,743181.53
355170,202306,2276,1159,1117,1531268.61,1474457.09,3005725.70
355180,202306,741,288,453,380167,599289.88,979456.88
355190,202306,233,156,77,205928.16,101641.54,307569.70
355200,202306,120,57,63,75241.37,83160,158401.37
355210,202306,798,403,395,531970.52,522723.41,1054693.93
355220,202306,8898,4129,4769,5454444.03,6305698.08,11760142.11
355230,202306,99,52,47,68641.5,62041.87,130683.37
355240,202306,5141,2028,3113,2676983.39,4115780.79,6792764.18
355250,202306,7957,3477,4480,4593801.71,5922868.96,10516670.67
355255,202306,51,30,21,39600.62,27720,67320.62
355260,202306,203,113,90,150483.91,118801.22,269285.13
355270,202306,173,114,59,150486.08,77880.98,228367.06
355280,202306,8117,3005,5112,3969365.81,6754531.52,10723897.33
355290,202306,72,55,17,72600.51,22440,95040.51
355300,202306,254,143,111,188766.29,146520.79,335287.08
355310,202306,115,65,50,87120.37,66000,153120.37
355320,202306,114,56,58,73920.6,76560.96,150481.56
355330,202306,359,207,152,273249.34,200643.09,473892.43
355340,202306,1406,528,878,698318,1159004.82,1857322.82
355350,202306,182,84,98,110880,129360.2,240240.2
355360,202306,210,137,73,180850.51,96361.29,277211.80
355365,202306,22,17,5,22440.7,6600,29040.7
355370,202306,1114,635,479,838242.09,633604.5,1471846.59
355380,202306,905,531,374,703594.65,493687.81,1197282.46
355385,202306,102,65,37,85800.2,48840,134640.2
355390,202306,112,61,51,80521.02,67320.21,147841.23
355395,202306,215,106,109,139928.44,145204.61,285133.05
355400,202306,1992,1098,894,1449303.76,1181402.43,2630706.19
355410,202306,5841,2606,3235,3440048.83,4275499.26,7715548.09
355420,202306,48,33,15,43560.93,19800,63360.93
355430,202306,500,285,215,376225.36,283810.39,660035.75
355440,202306,100,55,45,72601.1,59401.49,132002.59
355450,202306,495,258,237,340575,314162.2,654737.2
355460,202306,59,42,17,55441.1,22440.8,77881.9
355465,202306,54,29,25,38280.51,33000,71280.51
355470,202306,207,83,124,109562.42,163681.35,273243.77
355475,202306,8,5,3,6600.81,3960,10560.81
355480,202306,703,282,421,372257.53,555725.33,927982.86
355490,202306,116,85,31,112205.43,40922.71,153128.14
355495,202306,125,52,73,68640.1,96361.29,165001.39
355500,202306,1715,923,792,1218395.45,1046766.13,2265161.58
355510,202306,287,194,93,256091.07,122761.24,378852.31
355520,202306,28,19,9,25080.18,11880,36960.18
355530,202306,24,13,11,17160,14520,31680
355535,202306,91,42,49,55442.45,64680,120122.45
355540,202306,3175,1241,1934,1638179.03,2552924.85,4191103.88
355550,202306,70,39,31,51480.37,40920,92400.37
355560,202306,289,126,163,166323.33,215163.01,381486.34
355570,202306,18,12,6,15841.14,7920,23761.14
355580,202306,241,165,76,217811.07,100321.84,318132.91
355590,202306,16,11,5,14520.24,6600,21120.24
355600,202306,292,137,155,180846.6,204601.65,385448.25
355610,202306,262,154,108,203288.43,142563.15,345851.58
355620,202306,1433,594,839,785425.7,1107483.15,1892908.85
355630,202306,444,313,131,413180.23,172921.08,586101.31
355635,202306,135,54,81,71280.02,106920,178200.02
355640,202306,640,333,307,439570.9,405246.09,844816.99
355645,202306,973,343,630,452777.73,831609.93,1284387.66
355650,202306,2006,867,1139,1145811.27,1507442.8,2653254.07
355660,202306,232,118,114,155763.69,150482.11,306245.80
355670,202306,725,302,423,398645.85,558364.33,957010.18
355680,202306,222,117,105,154449.96,138602.37,293052.33
355690,202306,103,46,57,60721.75,75240.57,135962.32
355695,202306,26,16,10,21120,13200,34320
355700,202306,1457,649,808,856710.99,1089005.46,1945716.45
355710,202306,2497,1378,1119,1821693,1478405.42,3300098.42
355715,202306,15,12,3,15842.08,3960.1,19802.18
355720,202306,280,172,108,227046.45,143882.23,370928.68
355730,202306,111,65,46,85801.28,60720.15,146521.43
410010,202306,111,89,22,118803.54,29040,147843.54
410020,202306,122,85,37,112203.84,48840.2,161044.04
410030,202306,204,107,97,141242.73,128044.38,269287.11
410040,202306,1568,740,828,978143.78,1094290.92,2072434.70
410045,202306,43,33,10,43560,13200,56760
410050,202306,562,324,238,429004.59,314160.74,743165.33
410060,202306,224,161,63,212529.58,83160.5,295690.08
410070,202306,259,210,49,277208.56,64681.19,341889.75
410080,202306,206,123,83,162363.65,109560,271923.65
410090,202306,54,46,8,60724.87,10560,71284.87
410100,202306,279,178,101,236284.15,133320.1,369604.25
410105,202306,44,25,19,33000,25080,58080
410110,202306,388,235,153,311535.85,201966.72,513502.57
410115,202306,52,28,24,36960,31680.2,68640.2
410120,202306,497,226,271,299649.89,357724.02,657373.91
410130,202306,73,39,34,51480.99,44880,96360.99
410140,202306,3535,1607,1928,2122614.27,2548944.67,4671558.94
410150,202306,2856,1150,1706,1518036.19,2251939.01,3769975.20
410160,202306,516,296,220,390727.7,290403.31,681131.01
410165,202306,63,40,23,52800.41,30360,83160.41
410170,202306,222,127,95,168963.21,126720.99,295684.20
410180,202306,2632,1367,1265,1804502.54,1671146.06,3475648.60
410185,202306,38,31,7,40920,9240,50160
410190,202306,523,338,185,446169.58,244200.9,690370.48
410200,202306,1160,806,354,1063939.73,468603.64,1532543.37
410210,202306,705,368,337,485775.45,444841.82,930617.27
410220,202306,53,24,29,31680.91,38280,69960.91
410230,202306,215,91,124,120120.75,163682.19,283802.94
410240,202306,770,489,281,645503.33,370922.56,1016425.89
410250,202306,396,265,131,349804.88,174242.22,524047.10
410260,202306,332,181,151,238928.99,199328.81,438257.80
410270,202306,31,21,10,27720.79,13200,40920.79
410275,202306,64,44,20,58081.97,26400,84481.97
410280,202306,338,203,135,267971.52,178200.78,446172.30
410290,202306,287,159,128,209885.19,168960.5,378845.69
410300,202306,96,56,40,73920,52800,126720
410302,202306,28,15,13,19800.05,17160,36960.05
410304,202306,47,31,16,40921.2,21120,62041.2
410305,202306,222,133,89,175567.04,117480.13,293047.17
410310,202306,200,118,82,155764.18,108242.93,264007.11
410315,202306,39,31,8,40920.2,10560,51480.2
410320,202306,151,106,45,139921.24,59400,199321.24
410322,202306,43,26,17,34320.97,22440,56760.97
410330,202306,184,119,65,157082.98,85800,242882.98
410335,202306,108,59,49,77880,64680,142560
410337,202306,47,37,10,48840.5,13200,62040.5
410340,202306,37,30,7,39601.1,9240,48841.1
410345,202306,207,133,74,175562.18,97680.2,273242.38
410347,202306,42,32,10,42240.84,13200.09,55440.93
410350,202306,263,152,111,200645.72,147840,348485.72
410360,202306,487,296,191,390731.87,252120.39,642852.26
410370,202306,2480,1078,1402,1425639.26,1851975.67,3277614.93
410380,202306,207,116,91,153125.59,120121.04,273246.63
410390,202306,444,269,175,355085.92,231000.64,586086.56
410395,202306,31,21,10,27721.72,13200.8,40922.52
410400,202306,1030,433,597,571581.54,790691.58,1362273.12
410405,202306,83,64,19,84485.33,25080.22,109565.55
410410,202306,34,18,16,23762.37,21120.1,44882.47
410420,202306,2002,879,1123,1160190.86,1486338.2,2646529.06
410425,202306,221,94,127,124082.43,170280.2,294362.63
410430,202306,2634,1340,1294,1768840.19,1709418.04,3478258.23
410440,202306,373,268,105,353763.23,138602.19,492365.42
410442,202306,374,234,140,308890.59,184801.92,493692.51
410445,202306,354,247,107,326047,141240.76,467287.76
410450,202306,421,201,220,265327,294360.45,559687.45
410460,202306,610,331,279,436924.32,369602.01,806526.33
410465,202306,285,157,128,207245.9,168960.89,376206.79
410470,202306,257,147,110,195367.03,145201.44,340568.47
410480,202306,7295,3489,3806,4608261.67,5031896.8,9640158.47
410490,202306,1534,826,708,1090349.35,935889.77,2026239.12
410500,202306,298,177,121,234962.73,159720.55,394683.28
410510,202306,216,162,54,213848.48,71281.51,285129.99
410520,202306,297,209,88,275881.27,117480,393361.27
410530,202306,280,87,193,114840.61,256080,370920.61
410540,202306,414,297,117,392048.04,154440.61,546488.65
410550,202306,1841,782,1059,1032259.36,1397889.19,2430148.55
410560,202306,192,122,70,161042.6,92400.94,253443.54
410570,202306,466,303,163,399967.31,215161.95,615129.26
410580,202306,4254,1773,2481,2341755.14,3276294.31,5618049.45
410590,202306,465,301,164,397309.34,217800,615109.34
410600,202306,114,95,19,125400.94,25080,150480.94
410610,202306,66,53,13,69961.42,17160,87121.42
410620,202306,300,179,121,236287.91,159721.37,396009.28
410630,202306,496,271,225,357722.72,297000.38,654723.10
410640,202306,1289,799,490,1056017.77,648122.24,1704140.01
410645,202306,115,85,30,112203.66,39600.2,151803.86
410650,202306,399,243,156,320762.38,205922.52,526684.90
410655,202306,92,66,26,87121.29,34320.08,121441.37
410657,202306,39,16,23,21120,30360,51480
410660,202306,697,473,224,624380.6,297003.21,921383.81
410670,202306,74,59,15,77882.93,19800.13,97683.06
410680,202306,196,156,40,207244.89,52800.2,260045.09
410685,202306,38,26,12,34320.49,15840,50160.49
410690,202306,32307,13054,19253,17238329,25445916.35,42684245.35
410700,202306,346,247,99,327647.26,130681.24,458328.50
410710,202306,127,104,23,137282.5,30360.2,167642.7
410712,202306,46,31,15,40920.65,19800,60720.65
410715,202306,110,79,31,104283.5,40920,145203.5
410720,202306,711,399,312,526690.41,411842.2,938532.61
410725,202306,206,137,69,180842.77,91080,271922.77
410730,202306,108,46,62,60721.36,83160,143881.36
410740,202306,78,58,20,76561.87,26400,102961.87
410750,202306,313,198,115,261365.7,153120.06,414485.76
410752,202306,22,17,5,22440.14,6600,29040.14
410753,202306,64,22,42,29040.4,55440,84480.4
410754,202306,67,32,35,42240.5,46200,88440.5
410755,202306,91,45,46,59400.2,60720,120120.2
410760,202306,816,444,372,586085.9,493682.76,1079768.66
410765,202306,2202,978,1224,1291006.27,1619669.53,2910675.80
410770,202306,130,87,43,114841.93,56760.76,171602.69
410773,202306,70,43,27,56761.91,35640,92401.91
410775,202306,233,157,76,207242.86,100320,307562.86
410780,202306,90,51,39,67320.87,51480,118800.87
410785,202306,57,49,8,64681.66,10560,75241.66
410790,202306,92,41,51,54120.2,67320,121440.2
410800,202306,297,182,115,240254.5,151801.04,392055.54
410810,202306,28,17,11,22440,14520.64,36960.64
410820,202306,151,106,45,139924.97,59400.9,199325.87
410830,202306,10468,4137,6331,5464956.92,8370211.28,13835168.20
410832,202306,120,78,42,102962.27,55440.05,158402.32
410840,202306,1562,849,713,1122024.96,943804.45,2065829.41
410845,202306,64,34,30,44881.29,39600,84481.29
410850,202306,157,116,41,153125.1,54120,207245.1
410855,202306,82,74,8,97682.63,10560,108242.63
410860,202306,951,462,489,611168.27,645484.55,1256652.82
410865,202306,97,66,31,87120.9,40920,128040.9
410870,202306,144,117,27,154441.56,35640.79,190082.35
410880,202306,1272,607,665,802579.43,880446.69,1683026.12
410890,202306,126,73,53,96361.48,71280,167641.48
410895,202306,80,62,18,81840.76,23760.95,105601.71
410900,202306,38,30,8,39601.41,10560,50161.41
410910,202306,15,9,6,11880.95,7920,19800.95
410920,202306,49,29,20,38280,26400,64680
410930,202306,587,355,232,468603.5,306241.39,774844.89
410940,202306,4907,2442,2465,3223574.51,3260448.95,6484023.46
410950,202306,97,72,25,95043.05,33000,128043.05
410960,202306,1079,396,683,522734.69,901571.33,1424306.02
410965,202306,68,48,20,63360.97,26400,89760.97
410970,202306,645,421,224,555729.34,295682.63,851411.97
410975,202306,129,80,49,105601.91,64680,170281.91
410980,202306,1709,778,931,1026996.47,1228933,2255929.47
410990,202306,281,203,78,267960.54,102960.98,370921.52
411000,202306,68,39,29,51481.02,38280.73,89761.75
411005,202306,37,32,5,42240,6600,48840
411007,202306,292,167,125,220440.47,165000,385440.47
411010,202306,655,402,253,530651.78,336602.8,867254.58
411020,202306,295,188,107,248165.3,141242.25,389407.55
411030,202306,30,17,13,22440,17160,39600
411040,202306,77,46,31,60720.89,40920,101640.89
411050,202306,217,153,64,203282.1,84480.94,287763.04
411060,202306,582,399,183,526688.09,242881.61,769569.70
411065,202306,42,37,5,48840.4,6600,55440.4
411070,202306,1368,763,605,1008497.09,798604.67,1807101.76
411080,202306,273,174,99,229680.13,130680.23,360360.36
411090,202306,87,61,26,80520.4,34320.96,114841.36
411095,202306,365,122,243,161040.7,320760.16,481800.86
411100,202306,113,90,23,118801.66,30360,149161.66
411110,202306,168,86,82,113520.22,108240.2,221760.42
411120,202306,201,133,68,176891.6,91080,267971.6
411125,202306,404,196,208,258729.57,274569.23,533298.80
411130,202306,165,140,25,184802.46,33000,217802.46
411140,202306,223,147,76,194040,100320,294360
411150,202306,1332,845,487,1115424.58,645485.87,1760910.45
411155,202306,118,78,40,102960,52800,155760
411160,202306,38,17,21,22440,27720,50160
411170,202306,61,50,11,66000,14520,80520
411180,202306,1116,734,382,968913.08,506887.19,1475800.27
411190,202306,386,220,166,290404.1,219120,509524.1
411200,202306,718,383,335,505577.2,442204.24,947781.44
411210,202306,723,370,353,488404.48,467282.79,955687.27
411220,202306,165,116,49,153122.49,64681.25,217803.74
411230,202306,33,26,7,34320.7,9240,43560.7
411240,202306,114,74,40,97681.08,52800,150481.08
411250,202306,434,312,122,411844.18,161040,572884.18
411260,202306,10,7,3,9240,3960,13200
411270,202306,280,143,137,188767.7,182162.46,370930.16
411275,202306,202,167,35,221762.93,46200,267962.93
411280,202306,296,199,97,262684.63,128040.7,390725.33
411290,202306,72,54,18,71280,23760,95040
411295,202306,136,97,39,128041.59,51480.81,179522.40
411300,202306,90,43,47,56760.82,62040,118800.82
411310,202306,101,71,30,93721.4,39600,133321.4
411320,202306,896,535,361,706210.6,477841.08,1184051.68
411325,202306,59,41,18,54120.1,23760,77880.1
411330,202306,1023,650,373,858026.01,492363.82,1350389.83
411340,202306,38,23,15,30360,19800.09,50160.09
411342,202306,66,52,14,68640,18480,87120
411345,202306,97,46,51,60723.04,67320.95,128043.99
411350,202306,585,432,153,570257.38,201963.06,772220.44
411360,202306,65,43,22,56763.21,29042.5,85805.71
411370,202306,14489,5926,8563,7826508.3,11327035.7,19153544.0
411373,202306,190,126,64,168960.98,84480.17,253441.15
411375,202306,96,77,19,101642.87,25080,126722.87
411380,202306,82,55,27,72604.8,35640,108244.8
411390,202306,174,94,80,124081.67,105600,229681.67
411400,202306,377,238,139,314168,183480,497648
411410,202306,593,281,312,370926.57,414482.33,785408.90
411420,202306,1029,420,609,554412.76,805205.34,1359618.10
411430,202306,626,317,309,418458.32,407887.41,826345.73
411435,202306,27,19,8,25080,10560,35640
411440,202306,525,417,108,551768.98,143880.7,695649.68
411450,202306,409,331,78,438249.34,102960.63,541209.97
411460,202306,868,331,537,436933.17,711484.91,1148418.08
411470,202306,117,80,37,105605.43,48840,154445.43
411480,202306,785,394,391,520099.23,517443.33,1037542.56
411490,202306,304,190,114,250804.52,150480.9,401285.42
411500,202306,116,88,28,116161.56,36960,153121.56
411510,202306,242,181,61,238925.46,80521.19,319446.65
411520,202306,6996,2329,4667,3075669.59,6163122.57,9238792.16
411530,202306,128,81,47,106921.05,62040,168961.05
411535,202306,50,14,36,18480.6,47520,66000.6
411540,202306,409,269,140,356406.5,184802.03,541208.53
411545,202306,56,39,17,51480.96,22440,73920.96
411550,202306,90,67,23,88441.37,30360,118801.37
411560,202306,412,163,249,215160.39,328680.15,543840.54
411570,202306,1134,358,776,473767.33,1025650.96,1499418.29
411573,202306,25,16,9,21120.2,11880,33000.2
411575,202306,340,213,127,281163.34,167640,448803.34
411580,202306,1346,465,881,613808.35,1165566.32,1779374.67
411585,202306,74,36,38,47520,50160,97680
411590,202306,12,7,5,9240,6600,15840
411600,202306,16,8,8,10560.7,10560,21120.7
411605,202306,185,70,115,92402.03,151800,244202.03
411610,202306,264,160,104,211204.85,137280.2,348485.05
411620,202306,414,196,218,258731.79,287768.49,546500.28
411630,202306,54,37,17,48840.55,22440.99,71281.54
411640,202306,32,21,11,27720.5,14520,42240.5
411650,202306,6,4,2,5280,2640,7920
411660,202306,47,35,12,46200,15840,62040
411670,202306,252,169,83,223082.58,109561.49,332644.07
411680,202306,173,132,41,174241.85,54120,228361.85
411690,202306,725,378,347,498964.87,458042.29,957007.16
411695,202306,69,47,22,62040.2,29040,91080.2
411700,202306,151,117,34,154444.94,44880,199324.94
411705,202306,107,74,33,97681.39,43560.4,141241.79
411710,202306,295,195,100,257406.44,132000.87,389407.31
411720,202306,163,108,55,142560.5,72600.2,215160.7
411721,202306,93,71,22,93720.2,29040,122760.2
411722,202306,106,51,55,67321.04,72600,139921.04
411725,202306,169,120,49,158400.9,64680,223080.9
411727,202306,105,87,18,114844.14,23760.33,138604.47
411729,202306,57,44,13,58081.6,17160,75241.6
411730,202306,598,375,223,495007.39,294361.87,789369.26
411740,202306,27,17,10,22440.23,14520,36960.23
411745,202306,75,56,19,73920,25080,99000
411750,202306,915,374,541,493691.06,715444.56,1209135.62
411760,202306,1390,995,395,1313445.52,521407.77,1834853.29
411770,202306,448,282,166,372244.71,219121.96,591366.67
411780,202306,397,255,142,336600.49,187440.21,524040.70
411790,202306,636,352,284,464651.85,374880.54,839532.39
411800,202306,167,117,50,154445.97,66000.18,220446.15
411810,202306,203,155,48,204604.4,63360.79,267965.19
411820,202306,2919,1130,1789,1492994.91,2364156.58,3857151.49
411830,202306,20,13,7,17160.62,9240,26400.62
411840,202306,2455,1403,1052,1857291.21,1391303.42,3248594.63
411845,202306,77,24,53,31680.9,69960,101640.9
411850,202306,1385,735,650,970226.54,859329.06,1829555.60
411860,202306,67,41,26,54120.99,34320,88440.99
411870,202306,79,49,30,64680,39600,104280
411880,202306,435,262,173,345848.46,229682.17,575530.63
411885,202306,112,73,39,96362.9,51481.37,147844.27
411890,202306,357,245,112,324728.09,149161.68,473889.77
411900,202306,118,85,33,112200.55,43560,155760.55
411910,202306,240,158,82,208568.02,108242.04,316810.06
411915,202306,2713,1037,1676,1370197.37,2212359.25,3582556.62
411920,202306,119,84,35,110882.83,46200.98,157083.81
411925,202306,23,16,7,21120.59,9240,30360.59
411930,202306,853,566,287,747231,381485.86,1128716.86
411940,202306,619,381,238,504251.14,314162.62,818413.76
411950,202306,1420,642,778,848795.92,1029620.12,1878416.04
411960,202306,1220,739,481,976814.35,634922.38,1611736.73
411965,202306,20,13,7,17160.18,9240,26400.18
411970,202306,96,82,14,108241.09,18480,126721.09
411980,202306,248,124,124,163680.76,163680,327360.76
411990,202306,5846,3038,2808,4010556.72,3709351.8,7719908.52
411995,202306,706,211,495,278528.55,653417.46,931946.01
412000,202306,362,241,121,318128.2,159722.33,477850.53
412010,202306,67,35,32,46200.9,42240.72,88441.62
412015,202306,38,27,11,35640,14520,50160
412020,202306,24,18,6,23761.22,7920,31681.22
412030,202306,38,33,5,43561.07,6600,50161.07
412033,202306,46,24,22,31681.29,29040,60721.29
412035,202306,69,45,24,59400.7,31680,91080.7
412040,202306,32,16,16,21120.97,21120,42240.97
412050,202306,226,166,60,219133.08,80522.86,299655.94
412060,202306,855,609,246,803907.14,324724.31,1128631.45
412065,202306,61,30,31,39602.38,40920.15,80522.53
412070,202306,153,105,48,138602.05,63360.07,201962.12
412080,202306,366,175,191,231012.35,253445,484457.35
412085,202306,39,14,25,18480.33,33000,51480.33
412090,202306,922,551,371,727339.74,491044.23,1218383.97
412100,202306,278,229,49,302289.71,64680,366969.71
412110,202306,75,55,20,72600.57,26400,99000.57
412120,202306,398,209,189,275887.25,249483.13,525370.38
412125,202306,75,40,35,52800.2,46200,99000.2
412130,202306,50,32,18,43562.47,23760,67322.47
412135,202306,33,20,13,26400.2,17160,43560.2
412140,202306,496,325,171,428724.75,229682.45,658407.20
412150,202306,274,161,113,212522.53,149160.73,361683.26
412160,202306,75,51,24,67320.79,33000.2,100320.99
412170,202306,730,465,265,615126.77,349802.91,964929.68
412175,202306,40,25,15,33000.74,21120.5,54121.24
412180,202306,164,120,44,158404.31,58080.2,216484.51
412190,202306,341,264,77,348487.39,101640,450127.39
412200,202306,198,115,83,151801.17,110880,262681.17
412210,202306,104,76,28,100320,36960.73,137280.73
412215,202306,245,163,82,215163.59,108241.28,323404.87
412217,202306,72,57,15,75240.91,19800,95040.91
412220,202306,938,601,337,795988.59,444850.45,1240839.04
412230,202306,305,173,132,228366.57,174246.66,402613.23
412240,202306,1463,719,744,950427.5,984728.53,1935156.03
412250,202306,449,268,181,353763.96,238920,592683.96
412260,202306,139,94,45,124083.58,59400.2,183483.78
412265,202306,168,130,38,171600.83,51480,223080.83
412270,202306,97,57,40,75240.59,52800,128040.59
412280,202306,83,63,20,83160.2,26400,109560.2
412290,202306,93,57,36,75241.84,47520,122761.84
412300,202306,222,157,65,207241.13,85800,293041.13
412310,202306,60,47,13,62041.57,17160,79201.57
412320,202306,95,69,26,91084.14,34320,125404.14
412330,202306,211,158,53,208561.49,69960,278521.49
412340,202306,195,123,72,162360.85,95040,257400.85
412350,202306,738,326,412,430324.77,543842.79,974167.56
412360,202306,23,18,5,23760,6600,30360
412370,202306,150,122,28,161044.55,36960.02,198004.57
412380,202306,191,139,52,184804.82,68640.71,253445.53
412382,202306,59,34,25,44880,34320,79200
412385,202306,171,120,51,158404.34,67320.92,225725.26
412390,202306,338,252,86,332652.3,113520.88,446173.18
412395,202306,72,58,14,76561.54,18480,95041.54
412400,202306,101,68,33,89761.96,43560,133321.96
412402,202306,248,137,111,180841.81,146520,327361.81
412405,202306,1014,336,678,443522.7,896282.25,1339804.95
412410,202306,1060,630,430,832954.74,567606.06,1400560.80
412420,202306,17,16,1,21120,1320,22440
412430,202306,26,24,2,31681.83,2640.2,34322.03
412440,202306,753,376,377,496328.49,497641.41,993969.90
412450,202306,65,57,8,75241.42,10560,85801.42
412460,202306,86,57,29,75241.46,38280.19,113521.65
412470,202306,247,196,51,260045.08,68641.33,328686.41
412480,202306,163,118,45,155764.4,59400.2,215164.6
412490,202306,183,151,32,199322.58,42240,241562.58
412500,202306,426,333,93,440890.84,122762.67,563653.51
412510,202306,180,145,35,191405.13,46200,237605.13
412520,202306,91,60,31,80521.66,40920,121441.66
412530,202306,113,50,63,66000.71,83160,149160.71
412535,202306,61,47,14,63361.56,18480,81841.56
412540,202306,58,33,25,43561.65,33000.56,76562.21
412545,202306,94,67,27,88441.18,35640,124081.18
412550,202306,4648,1877,2771,2480502.9,3663061.91,6143564.81
412555,202306,15,8,7,10560,9240,19800
412560,202306,739,477,262,629656.73,345842.18,975498.91
412570,202306,922,394,528,521415.93,696963.4,1218379.33
412575,202306,98,68,30,89761.8,39600,129361.8
412580,202306,187,127,60,167649.66,79202.08,246851.74
412590,202306,30,26,4,34321.11,5280,39601.11
412600,202306,221,157,64,207245.29,84480.83,291726.12
412610,202306,50,21,29,27721.57,38280,66001.57
412620,202306,130,108,22,142563.74,29040.96,171604.70
412625,202306,2332,1096,1236,1448077.57,1634172.68,3082250.25
412627,202306,65,50,15,66002.3,19800,85802.3
412630,202306,398,266,132,351130.01,174240.52,525370.53
412635,202306,79,22,57,29040,75240,104280
412640,202306,115,82,33,108240.3,43560,151800.3
412650,202306,330,217,113,286445.27,149160.94,435606.21
412660,202306,592,313,279,413164.49,369600.41,782764.90
412665,202306,43,38,5,50160.32,6600,56760.32
412667,202306,283,175,108,231004.18,142560,373564.18
412670,202306,87,65,22,85800.64,29040,114840.64
412680,202306,347,263,84,347169.93,110880.45,458050.38
412690,202306,135,87,48,114843.03,63360,178203.03
412700,202306,196,121,75,159720.23,99000.23,258720.46
412710,202306,1459,790,669,1042822.59,885730.16,1928552.75
412720,202306,258,140,118,184803.26,155760.69,340563.95
412730,202306,184,153,31,201967.29,42240.99,244208.28
412740,202306,430,201,229,267966.13,302280.41,570246.54
412750,202306,433,238,195,314166.3,258720.93,572887.23
412760,202306,401,203,198,267969.35,261365.24,529334.59
412770,202306,2296,1222,1074,1614390.56,1420327.69,3034718.25
412780,202306,146,101,45,133322.58,59400.1,192722.68
412785,202306,331,173,158,228362.24,209880.02,438242.26
412788,202306,60,35,25,46201.14,33000,79201.14
412790,202306,131,106,25,139925.34,33000,172925.34
412795,202306,154,104,50,137283.2,66000,203283.2
412796,202306,318,198,120,261362.69,158400.76,419763.45
412800,202306,762,423,339,558365.71,448800.81,1007166.52
412810,202306,3382,1849,1533,2443395.1,2024903.74,4468298.84
412820,202306,1135,642,493,848787.37,650773.54,1499560.91
412830,202306,15,14,1,18480.2,1320,19800.2
412840,202306,256,167,89,220443.63,117480.2,337923.83
412850,202306,605,394,211,520088.72,278520.68,798609.40
412853,202306,181,82,99,108240.26,132000,240240.26
412855,202306,210,113,97,149163.26,128040.73,277203.99
412860,202306,104,70,34,92403.61,44880.91,137284.52
412862,202306,77,51,26,67320,34320,101640
412863,202306,9,6,3,7920,3960,11880
412865,202306,45,35,10,46200,13200.6,59400.6
412870,202306,124,79,45,104283.49,59401.4,163684.89
412880,202306,98,69,29,91082.6,38280,129362.6
420005,202306,43,36,7,47520.69,9240,56760.69
420010,202306,384,254,130,335285.36,171600.89,506886.25
420020,202306,101,76,25,100322.17,33000,133322.17
420030,202306,32,24,8,31680.2,10560,42240.2
420040,202306,97,75,22,99002.36,29040.2,128042.56
420050,202306,53,35,18,46200.52,23760,69960.52
420055,202306,19,16,3,21120.67,3960,25080.67
420060,202306,34,22,12,29040.89,15840.2,44881.09
420070,202306,114,98,16,129360.6,21120,150480.6
420075,202306,11,11,0,14520,,14520.0
420080,202306,44,37,7,48841.13,9240,58081.13
420090,202306,38,30,8,39600.72,10560.98,50161.70
420100,202306,171,146,25,192722.6,33000,225722.6
420110,202306,28,27,1,35640,1320,36960
420120,202306,66,47,19,62040,25080,87120
420125,202306,81,61,20,80520.6,26400,106920.6
420127,202306,41,32,9,42240,11880,54120
420130,202306,554,326,228,430337.69,300965.56,731303.25
420140,202306,1490,834,656,1100910.34,865938.99,1966849.33
420150,202306,51,37,14,48840,18480,67320
420160,202306,36,31,5,40920.93,6600,47520.93
420165,202306,18,14,4,18480.79,5280,23760.79
420170,202306,74,43,31,56760.09,40920,97680.09
420180,202306,24,22,2,29040,2640,31680
420190,202306,32,27,5,35640.18,6600,42240.18
420195,202306,143,70,73,92404.77,96362.69,188767.46
420200,202306,1491,615,876,813144.13,1157662.43,1970806.56
420205,202306,138,84,54,110884.22,71280.2,182164.42
420207,202306,166,89,77,117484.32,101641.96,219126.28
420208,202306,22,18,4,23760.21,5280,29040.21
420209,202306,14,12,2,15840,2640,18480
420210,202306,635,304,331,403930.8,436923.47,840854.27
420213,202306,56,39,17,51480.69,22440,73920.69
420215,202306,27,23,4,30361.14,5280,35641.14
420220,202306,64,41,23,54120.44,30360,84480.44
420230,202306,1117,678,439,896321.05,580813.9,1477134.95
420240,202306,2552,1665,887,2197842.86,1174810.5,3372653.36
420243,202306,46,37,9,48841.22,11880,60721.22
420245,202306,261,127,134,167646,176883.52,344529.52
420250,202306,70,46,24,60721.38,31680,92401.38
420253,202306,22,17,5,22440.76,6600,29040.76
420257,202306,16,10,6,13200.5,7920,21120.5
420260,202306,135,106,29,139923.31,38280.14,178203.45
420270,202306,37,26,11,34320.19,14520.36,48840.55
420280,202306,308,225,83,297014.54,110881.4,407895.94
420285,202306,26,20,6,26400,7920,34320
420287,202306,50,31,19,40921.42,25080,66001.42
420290,202306,1049,715,334,943817.36,440880,1384697.36
420300,202306,1738,1388,350,1832234.47,462006.61,2294241.08
420310,202306,43,31,12,40920.7,15840,56760.7
420315,202306,23,19,4,25080.78,5280.74,30361.52
420320,202306,1156,547,609,723389.18,806531.89,1529921.07
420325,202306,10,6,4,7920,5280.3,13200.3
420330,202306,123,82,41,108240.72,54121.13,162361.85
420340,202306,205,138,67,182162.06,88440,270602.06
420350,202306,274,194,80,256086.94,105600.97,361687.91
420360,202306,712,548,164,723384.74,216481.74,939866.48
420370,202306,148,81,67,106922.47,88440.43,195362.90
420380,202306,1322,883,439,1165606.55,584767.56,1750374.11
420390,202306,226,160,66,211204.9,87120.4,298325.3
420395,202306,199,144,55,191414.43,72602.63,264017.06
420400,202306,227,171,56,225724.18,73920.2,299644.38
420410,202306,55,42,13,55442.43,17160,72602.43
420415,202306,30,23,7,30360.2,9240,39600.2
420417,202306,66,53,13,69960.01,17160,87120.01
420419,202306,12,11,1,14520,1320,15840
420420,202306,3162,1955,1207,2584624.65,1594573.02,4179197.67
420425,202306,75,54,21,71285.84,27720,99005.84
420430,202306,1068,772,296,1019048.58,390722.03,1409770.61
420435,202306,13,10,3,13200,3960,17160
420440,202306,90,65,25,87121.66,33000,120121.66
420445,202306,32,29,3,38280.5,3960,42240.5
420450,202306,95,58,37,76562.05,48840,125402.05
420455,202306,177,134,43,176886.3,56760,233646.3
420460,202306,2573,1579,994,2087006.21,1313414.09,3400420.30
420470,202306,88,56,32,73920.2,42240,116160.2
420475,202306,9,8,1,10560.95,1320,11880.95
420480,202306,965,733,232,968927.88,306241.86,1275169.74
420490,202306,100,74,26,97684.07,34320,132004.07
420500,202306,419,247,172,326052.24,227040.95,553093.19
420510,202306,23,20,3,26400.34,3960,30360.34
420515,202306,29,15,14,19800.58,18480,38280.58
420517,202306,11,8,3,10560.91,3960,14520.91
420519,202306,8,6,2,7920,2640,10560
420520,202306,64,46,18,60722.09,23760.2,84482.29
420530,202306,145,92,53,121442.37,69960.2,191402.57
420535,202306,16,13,3,17160.41,3960,21120.41
420540,202306,7450,4588,2862,6058029.45,3784483.93,9842513.38
420543,202306,32,31,1,40921.33,1320,42241.33
420545,202306,233,161,72,212528.16,95040.6,307568.76
420550,202306,826,696,130,921393.76,171603.15,1092996.91
420555,202306,36,27,9,35641.45,11880,47521.45
420560,202306,64,49,15,64681.34,19800,84481.34
420570,202306,251,117,134,154443.81,176882.96,331326.77
420580,202306,350,182,168,240247.23,221760.93,462008.16
420590,202306,537,331,206,436931.37,271920.62,708851.99
420600,202306,165,89,76,117481.07,100320,217801.07
420610,202306,39,36,3,47520,3960,51480
420620,202306,78,62,16,81842.13,21120.41,102962.54
420630,202306,165,112,53,147842.79,69960,217802.79
420640,202306,77,68,9,89760.6,11880,101640.6
420650,202306,350,177,173,234963.93,228361.3,463325.23
420660,202306,42,31,11,40920.45,14520,55440.45
420665,202306,51,35,16,46201.6,21120,67321.6
420670,202306,242,185,57,244208.53,75240,319448.53
420675,202306,15,12,3,15840,3960,19800
420680,202306,35,29,6,38280.12,7920,46200.12
420690,202306,206,149,57,196683.47,75392.43,272075.90
420700,202306,768,500,268,660022.26,355083.97,1015106.23
420710,202306,157,86,71,113522.08,93721.75,207243.83
420720,202306,97,78,19,102964.21,25080.12,128044.33
420730,202306,787,463,324,611179.83,430327.81,1041507.64
420740,202306,60,58,2,76562.03,2640,79202.03
420750,202306,524,342,182,451445.87,242880.89,694326.76
420757,202306,20,17,3,22440,3960,26400
420760,202306,38,27,11,35640.86,14520,50160.86
420765,202306,73,50,23,66000.21,30360,96360.21
420768,202306,62,50,12,66002.91,15840,81842.91
420770,202306,73,63,10,83161.9,13200,96361.9
420775,202306,38,31,7,40920.26,9240,50160.26
420780,202306,201,154,47,203283.09,62040,265323.09
420785,202306,28,17,11,22440,14520,36960
420790,202306,141,117,24,154442.54,31680.09,186122.63
420800,202306,62,46,16,60720.62,21120,81840.62
420810,202306,297,221,76,291730.11,100320,392050.11
420820,202306,2925,1620,1305,2140767.25,1723947.04,3864714.29
420830,202306,787,421,366,555744.03,484451.15,1040195.18
420840,202306,133,90,43,118800.95,56760,175560.95
420845,202306,477,211,266,278528.23,351123.15,629651.38
420850,202306,300,231,69,304921.08,91080.3,396001.38
420860,202306,59,51,8,67321.52,10560,77881.52
420870,202306,138,96,42,126720.43,55440,182160.43
420880,202306,204,127,77,167644.55,102961.19,270605.74
420890,202306,1077,532,545,702256.27,719401.33,1421657.60
420895,202306,11,10,1,13200,1320,14520
420900,202306,432,345,87,456728.5,114841.31,571569.81
420910,202306,6475,3545,2930,4680873.96,3875566.95,8556440.91
420915,202306,60,55,5,72600.2,6600,79200.2
420917,202306,24,17,7,22440.54,9240,31680.54
420920,202306,21,15,6,19800,7920,27720
420930,202306,3890,2649,1241,3496756.14,1638152.81,5134908.95
420940,202306,614,425,189,561032.47,249487.55,810520.02
420945,202306,11,8,3,10560,3960,14520
420950,202306,46,34,12,44880.6,15840,60720.6
420960,202306,116,94,22,124085.1,29040.1,153125.2
420970,202306,290,236,54,311534.17,71280.71,382814.88
420980,202306,24,23,1,30360,1320,31680
420985,202306,52,44,8,58081.85,10560,68641.85
420990,202306,92,69,23,91081.71,30361.82,121443.53
421000,202306,67,36,31,47520,40920,88440
421003,202306,31,22,9,29040.63,11880,40920.63
421005,202306,8,6,2,7920.3,2640,10560.3
421010,202306,923,590,333,778831.07,439568.41,1218399.48
421020,202306,19,18,1,23762.25,1320,25082.25
421030,202306,119,96,23,126721.45,30360.8,157082.25
421040,202306,69,52,17,68642.84,22441.4,91084.24
421050,202306,332,231,101,304922.96,133320,438242.96
421055,202306,16,13,3,17160.2,3960,21120.2
421060,202306,118,64,54,84481.33,72600,157081.33
421070,202306,34,30,4,39600.86,5280,44880.86
421080,202306,48,39,9,51480.67,11880,63360.67
421085,202306,17,13,4,17160,5280,22440
421090,202306,39,29,10,38280.11,13200,51480.11
421100,202306,122,89,33,117481.71,43560.95,161042.66
421105,202306,202,159,43,209887.06,56760.2,266647.26
421110,202306,134,92,42,121444.95,55440,176884.95
421120,202306,201,139,62,183484.78,81840.99,265325.77
421125,202306,16,9,7,11880,9240.52,21120.52
421130,202306,937,560,377,739220.26,498966.03,1238186.29
421140,202306,33,24,9,31680.33,11880,43560.33
421145,202306,44,38,6,50160.34,7920,58080.34
421150,202306,87,67,20,88441.92,26400,114841.92
421160,202306,67,45,22,60720.5,29040.38,89760.88
421165,202306,16,12,4,15840,5280.2,21120.2
421170,202306,169,143,26,188928.06,34320.61,223248.67
421175,202306,199,139,60,183484.54,79201.78,262686.32
421180,202306,40,26,14,34320.42,18480,52800.42
421185,202306,17,14,3,18480.18,3960,22440.18
421187,202306,5,4,1,5280,1320,6600
421189,202306,47,33,14,43560.58,18480,62040.58
421190,202306,2267,1429,838,1887681.41,1107506.09,2995187.50
421200,202306,97,68,29,89762.9,38280,128042.9
421205,202306,24,17,7,22441.44,9240,31681.44
421210,202306,187,132,55,175562.55,72600,248162.55
421220,202306,263,203,60,270603.17,79200.74,349803.91
421223,202306,53,40,13,52801.77,17160,69961.77
421225,202306,77,51,26,67322.02,34321.2,101643.22
421227,202306,69,59,10,77881.69,13200,91081.69
421230,202306,82,55,27,72601.86,35640.18,108242.04
421240,202306,16,14,2,18482.09,2640,21122.09
421250,202306,446,236,210,311527.84,277206.9,588734.74
421260,202306,22,17,5,22440.59,6600,29040.59
421265,202306,13,8,5,10561.62,6600.1,17161.72
421270,202306,55,49,6,64680,7920,72600
421280,202306,439,223,216,294369.67,285122.25,579491.92
421290,202306,317,208,109,274562.58,143880.43,418443.01
421300,202306,23,20,3,26400,3960,30360
421310,202306,51,35,16,46200,21120,67320
421315,202306,33,19,14,25081.03,18480.08,43561.11
421320,202306,145,99,46,130683.61,60720,191403.61
421330,202306,108,82,26,108241.7,34320,142561.7
421335,202306,46,33,13,43562.44,17160,60722.44
421340,202306,252,167,85,221764.23,112200.41,333964.64
421350,202306,196,117,79,154443.83,104280.25,258724.08
421360,202306,773,528,245,698294.37,323405.02,1021699.39
421370,202306,208,155,53,204602.13,69960.7,274562.83
421380,202306,158,119,39,158401.41,51480,209881.41
421390,202306,16,11,5,14520.7,6600,21120.7
421400,202306,119,97,22,128040,29040,157080
421410,202306,20,16,4,21120,5280,26400
421415,202306,22,20,2,26400,2640,29040
421420,202306,101,85,16,112201.34,21120,133321.34
421430,202306,21,13,8,17160,10560,27720
421440,202306,63,53,10,69961.77,13200.98,83162.75
421450,202306,78,63,15,83160.47,19800,102960.47
421460,202306,52,42,10,56760.66,13200,69960.66
421470,202306,82,44,38,58080.63,50160,108240.63
421480,202306,847,623,224,822375.32,295682.54,1118057.86
421490,202306,25,22,3,29040.78,3960,33000.78
421500,202306,508,291,217,385461.8,287762.25,673224.05
421505,202306,44,35,9,46200.1,11880.2,58080.3
421507,202306,31,25,6,33000.6,7920,40920.6
421510,202306,67,41,26,54121.56,34320.61,88442.17
421520,202306,49,41,8,54120.98,10560,64680.98
421530,202306,54,45,9,59401.28,11880,71281.28
421535,202306,23,21,2,27721.29,2640,30361.29
421540,202306,50,40,10,52800.2,13200,66000.2
421545,202306,87,56,31,73924.4,40920.72,114845.12
421550,202306,318,226,92,298334.85,121441.24,419776.09
421555,202306,16,14,2,18481.56,2640,21121.56
421560,202306,8,7,1,9240,1320,10560
421565,202306,137,86,51,113521.91,67320.57,180842.48
421567,202306,39,28,11,36960,14520,51480
421568,202306,37,36,1,47520,2640,50160
421569,202306,11,10,1,13200.79,1320,14520.79
421570,202306,276,182,94,240245.45,124081.69,364327.14
421575,202306,27,24,3,31680.9,3960,35640.9
421580,202306,781,459,322,606113.97,426362.9,1032476.87
421590,202306,22,20,2,26400.2,2640,29040.2
421600,202306,184,136,48,179521.46,63360,242881.46
421605,202306,109,74,35,97682.01,46200.2,143882.21
421610,202306,174,126,48,166320.99,63360,229680.99
421620,202306,1125,638,487,843513.5,642849.74,1486363.24
421625,202306,23,20,3,27720.76,3960,31680.76
421630,202306,382,233,149,307571.52,196685.21,504256.73
421635,202306,28,14,14,18480,18480,36960
421640,202306,114,86,28,113525.52,36960,150485.52
421650,202306,351,205,146,271929.06,194043.12,465972.18
421660,202306,2930,1788,1142,2364203.25,1511428.84,3875632.09
421670,202306,160,116,44,153123.46,58080,211203.46
421680,202306,205,184,21,242885.27,27720,270605.27
421690,202306,366,244,122,322086.89,161040.49,483127.38
421700,202306,61,42,19,55440.7,25080,80520.7
421710,202306,23,23,0,30360.59,,30360.59
421715,202306,5,4,1,5280.61,1320,6600.61
421720,202306,677,450,227,595337.3,299642.02,894979.32
421725,202306,35,14,21,18480.22,27720.8,46201.02
421730,202306,23,18,5,23760,6600,30360
421740,202306,119,46,73,60722.25,96360,157082.25
421750,202306,200,142,58,187441.26,76560,264001.26
421755,202306,21,19,2,25080,2640,27720
421760,202306,106,74,32,97683.24,42240.19,139923.43
421770,202306,746,477,269,629664.32,355084.14,984748.46
421775,202306,30,19,11,25080.97,14520.09,39601.06
421780,202306,190,147,43,194040.4,56760,250800.4
421790,202306,156,132,24,174242.14,31680.15,205922.29
421795,202306,16,13,3,17160.33,3960,21120.33
421800,202306,621,370,251,488425.28,332646.15,821071.43
421810,202306,73,60,13,79201.08,17160,96361.08
421820,202306,323,198,125,262684.25,165000,427684.25
421825,202306,174,146,28,192727.02,36960,229687.02
421830,202306,169,103,66,135966.9,87121.04,223087.94
421835,202306,5,2,3,2640,3960,6600
421840,202306,44,36,8,47521.44,10560.22,58081.66
421850,202306,82,68,14,89760.5,18480,108240.5
421860,202306,39,27,12,35640.79,15840,51480.79
421870,202306,1251,890,361,1174848.33,477851.65,1652699.98
421875,202306,52,40,12,52800,15840,68640
421880,202306,202,142,60,187443.12,79200.7,266643.82
421885,202306,20,15,5,19800,6600.84,26400.84
421890,202306,179,128,51,168965.3,67321.74,236287.04
421895,202306,50,43,7,58081.1,9240,67321.1
421900,202306,138,102,36,134647.86,47520,182167.86
421910,202306,72,45,27,59401.26,35640,95041.26
421915,202306,31,24,7,31680,9240,40920
421917,202306,54,42,12,55441.66,15840,71281.66
421920,202306,37,32,5,42240,6600,48840
421930,202306,667,529,138,698299.4,182162.37,880461.77
421935,202306,44,37,7,48840.18,9240,58080.18
421940,202306,55,48,7,63360,10560,73920
421950,202306,965,639,326,844813.54,430323.55,1275137.09
421960,202306,44,36,8,47520.59,10560,58080.59
421970,202306,339,211,128,279845.07,168961.39,448806.46
421985,202306,18,11,7,14520.2,9240,23760.2
422000,202306,13,6,7,7920.2,9240.7,17160.9
430003,202306,201,60,141,79200.6,186120,265320.6
430005,202306,33,26,7,34320.82,9240,43560.82
430010,202306,268,197,71,260043.45,93720,353763.45
430020,202306,141,101,40,133322.17,52800.24,186122.41
430030,202306,135,107,28,141241.73,36960,178201.73
430040,202306,3114,1819,1295,2401126.58,1712044.03,4113170.61
430045,202306,79,69,10,91080,13200,104280
430047,202306,7,6,1,7920,1320,9240
430050,202306,90,75,15,99001.28,21120,120121.28
430055,202306,15,13,2,17160,2640,19800
430057,202306,5,3,2,3960,2640,6600
430060,202306,4587,2647,1940,3498139.04,2568744.39,6066883.43
430063,202306,61,48,13,63360,17160,80520
430064,202306,170,136,34,179520.99,44880,224400.99
430066,202306,7,4,3,5280,3960,9240
430070,202306,43,34,9,44880.28,11880,56760.28
430080,202306,86,58,28,76560.15,36960.18,113520.33
430085,202306,29,13,16,18480,21120,39600
430087,202306,38,28,10,36960.08,13200,50160.08
430090,202306,69,58,11,76560.76,14520,91080.76
430100,202306,156,106,50,139920.86,66000,205920.86
430105,202306,182,96,86,128047.13,113520.3,241567.43
430107,202306,21,16,5,21120.37,6600,27720.37
430110,202306,504,269,235,355081.02,310200,665281.02
430120,202306,185,169,16,223080.1,21120,244200.1
430130,202306,850,501,349,661328.67,462002,1123330.67
430140,202306,144,132,12,174240,15840,190080
430150,202306,119,73,46,96360.96,60720,157080.96
430155,202306,29,25,4,33000,5280,38280
430160,202306,4019,2241,1778,2963472.97,2354893.69,5318366.66
430163,202306,472,221,251,291729.28,331324.31,623053.59
430165,202306,31,19,12,25080.59,15840,40920.59
430170,202306,87,72,15,95040,19800,114840
430175,202306,87,68,19,89760,25080,114840
430180,202306,116,87,29,114840.93,38280,153120.93
430185,202306,28,20,8,26400,10560,36960
430187,202306,100,38,62,50161.58,81840,132001.58
430190,202306,248,124,124,163684.53,165002.29,328686.82
430192,202306,13,10,3,13200.4,3960,17160.4
430195,202306,17,13,4,17160.9,5280,22440.9
430200,202306,166,136,30,179524.86,39600,219124.86
430205,202306,19,19,0,25080,,25080.0
430210,202306,828,617,211,814454.72,278520.7,1092975.42
430215,202306,11,11,0,14520,,14520.0
430220,202306,80,53,27,69960,35640,105600
430222,202306,16,6,10,7920,13200,21120
430223,202306,19,13,6,17160,7920,25080
430225,202306,4,2,2,2640,2640,5280
430230,202306,367,228,139,300961.84,183480,484441.84
430235,202306,52,32,20,42240.11,26400,68640.11
430237,202306,21,15,6,19800,7920,27720
430240,202306,122,81,41,106921.07,54120,161041.07
430245,202306,69,56,13,73920,17160,91080
430250,202306,191,111,80,146521.67,105600,252121.67
430258,202306,12,9,3,11880.38,3960.2,15840.58
430260,202306,40,36,4,47520.1,5280,52800.1
430265,202306,37,33,4,43560,5280,48840
430270,202306,563,390,173,514815.54,228360,743175.54
430280,202306,1161,667,494,880447.48,652080.3,1532527.78
430290,202306,472,242,230,320765.75,303600,624365.75
430300,202306,2342,1274,1068,1681726.89,1413736.04,3095462.93
430310,202306,2376,1175,1201,1557667.8,1589311.25,3146979.05
430320,202306,60,49,11,64680,14520,79200
430330,202306,91,77,14,101640.86,18480,120120.86
430340,202306,74,59,15,77880,19800,97680
430350,202306,1797,1118,679,1475776.9,896280.85,2372057.75
430355,202306,20,18,2,23760,2640,26400
430360,202306,110,54,56,71280,73920,145200
430367,202306,52,37,15,48840,19800,68640
430370,202306,65,57,8,75240,10560,85800
430380,202306,111,78,33,102961.54,43560,146521.54
430390,202306,718,429,289,567533.33,382804.71,950338.04
430400,202306,261,177,84,233640.91,112200,345840.91
430410,202306,53,44,9,58080.2,11880,69960.2
430420,202306,575,371,204,489730.27,269281.49,759011.76
430430,202306,52,47,5,61160.88,6600,67760.88
430435,202306,154,111,43,146520.99,56760,203280.99
430440,202306,661,395,266,521410.01,351121.67,872531.68
430450,202306,1310,1068,242,1413739.24,319440.9,1733180.14
430460,202306,6562,3315,3247,4382544.11,4287407.48,8669951.59
430461,202306,19,17,2,22440,2640,25080
430462,202306,6,3,3,3960.1,3960,7920.1
430463,202306,1358,729,629,962304.38,831606.9,1793911.28
430465,202306,27,17,10,22440,14520,36960
430466,202306,816,568,248,749789.93,327366.54,1077156.47
430467,202306,134,75,59,99000.5,77880,176880.5
430468,202306,159,87,72,114841.5,95040.88,209882.38
430469,202306,21,14,7,18480.19,9240,27720.19
430470,202306,1254,680,574,899323.91,757683.8,1657007.71
430471,202306,84,59,25,77881.27,33000.57,110881.84
430480,202306,151,106,45,141240.94,60720.63,201961.57
430485,202306,8,8,0,10560,,10560.0
430490,202306,71,56,15,73920,19800,93720
430495,202306,36,26,10,34320.2,13200,47520.2
430500,202306,196,129,67,170280,89760,260040
430510,202306,4274,2728,1546,3603664.62,2044691.4,5648356.02
430511,202306,14,14,0,18480,,18480.0
430512,202306,184,123,61,162362.96,80520.4,242883.36
430513,202306,57,44,13,58080.1,17160,75240.1
430515,202306,24,22,2,29040,2640,31680
430517,202306,188,158,30,209880.2,39600,249480.2
430520,202306,350,242,108,319444.79,142560.25,462005.04
430530,202306,86,46,40,60720.7,52800,113520.7
430535,202306,506,320,186,422405.65,245523.54,667929.19
430537,202306,9,9,0,11880,,11880.0
430540,202306,80,54,26,71280,34320,105600
430543,202306,461,148,313,195360.24,413160.71,608520.95
430544,202306,52,48,4,63360.61,5280,68640.61
430545,202306,488,236,252,311539.08,332649.54,644188.62
430550,202306,47,37,10,48840.14,13200,62040.14
430558,202306,1,1,0,1320,,1320.0
430560,202306,54,32,22,42240,29040,71280
430570,202306,124,52,72,68643.18,95040,163683.18
430580,202306,126,100,26,132000.89,34320,166320.89
430583,202306,13,13,0,17160,,17160.0
430585,202306,14,10,4,13200.88,5280,18480.88
430587,202306,14,10,4,13200,6600.72,19800.72
430590,202306,198,159,39,209881.53,51480,261361.53
430593,202306,1,1,0,1320,,1320.0
430595,202306,18,14,4,18480,5280,23760
430597,202306,44,26,18,34320.21,23760,58080.21
430600,202306,232,169,63,223080,83160,306240
430605,202306,191,114,77,150480,101640,252120
430607,202306,32,25,7,33000,9240,42240
430610,202306,1919,909,1010,1199900.5,1335843.63,2535744.13
430613,202306,5,5,0,6600,,6600.0
430620,202306,104,72,32,95040.56,42240,137280.56
430630,202306,48,41,7,54121.13,9240,63361.13
430632,202306,31,27,4,35640,5280,40920
430635,202306,37,30,7,39600,9240,48840
430637,202306,69,30,39,39600,51480,91080
430640,202306,177,101,76,134645.03,100320.54,234965.57
430642,202306,17,15,2,19800,2640,22440
430645,202306,34,27,7,36960,9240,46200
430650,202306,241,193,48,254764.21,63360.2,318124.41
430655,202306,15,12,3,15840,3960,19800
430660,202306,1061,518,543,685095.1,716767.51,1401862.61
430670,202306,70,48,22,63360,29040,92400
430673,202306,86,57,29,75240,38280,113520
430675,202306,9,7,2,9240,2640,11880
430676,202306,708,433,275,572893.86,364322.81,937216.67
430680,202306,261,170,91,224402.01,121440,345842.01
430690,202306,590,356,234,469927.48,308882.73,778810.21
430692,202306,6,5,1,6600.7,1320,7920.7
430693,202306,141,91,50,120121.4,66000.2,186121.6
430695,202306,70,53,17,71280,22440,93720
430697,202306,69,44,25,58080,33000,91080
430700,202306,1435,961,474,1268538.2,625680.31,1894218.51
430705,202306,34,28,6,36960.7,7920,44880.7
430710,202306,278,173,105,228360,138600,366960
430720,202306,97,81,16,106920,21120,128040
430730,202306,157,133,24,175560,31680,207240
430740,202306,89,53,36,69960.3,47520,117480.3
430745,202306,29,18,11,23760,14520,38280
430750,202306,328,209,119,275882.67,157081.02,432963.69
430755,202306,85,47,38,62040.58,50160,112200.58
430760,202306,463,254,209,336607.9,275881.62,612489.52
430770,202306,1838,1001,837,1321364.19,1104847.35,2426211.54
430780,202306,388,239,149,315480.48,196680,512160.48
430781,202306,26,26,0,34320,,34320.0
430783,202306,64,46,18,60720,23760,84480
430786,202306,8,6,2,7920,2640,10560
430790,202306,567,351,216,463327.82,286442.56,749770.38
430800,202306,169,123,46,162360,60720,223080
430805,202306,37,30,7,39600,9240,48840
430807,202306,77,44,33,58080,43560,101640
430810,202306,80,51,29,67321.37,38280,105601.37
430820,202306,161,105,56,138602.91,73920,212522.91
430825,202306,12,9,3,11880,3960,15840
430830,202306,279,259,20,341882.55,26400,368282.55
430840,202306,151,102,49,134640.7,66000,200640.7
430843,202306,8,5,3,6600,3960,10560
430845,202306,84,50,34,66000,44880,110880
430850,202306,617,437,180,578163.69,237600,815763.69
430860,202306,185,124,61,165001.97,80520.82,245522.79
430865,202306,81,44,37,58080,48840,106920
430870,202306,74,60,14,79200.57,18480,97680.57
430880,202306,187,127,60,167644.07,79200.8,246844.87
430885,202306,11,9,2,11880,2640,14520
430890,202306,354,212,142,279842.54,187440,467282.54
430900,202306,563,387,176,513485.36,232320.1,745805.46
430905,202306,154,70,84,92400.57,110881.35,203281.92
430910,202306,320,173,147,228361.59,194040.8,422402.39
430912,202306,5,5,0,6600.32,,6600.32
430915,202306,43,40,3,52800,3960,56760
430920,202306,5297,2730,2567,3609030.55,3389816.73,6998847.28
430925,202306,7,6,1,7920,1320,9240
430930,202306,2357,1315,1042,1735833.78,1376762.9,3112596.68
430940,202306,288,182,106,240240.19,139921.1,380161.29
430950,202306,163,129,34,170281.85,44880,215161.85
430955,202306,29,18,11,23760.7,14520,38280.7
430957,202306,24,22,2,29040.11,2640,31680.11
430960,202306,278,181,97,238921.68,129361.22,368282.90
430965,202306,112,72,40,95040.09,52800,147840.09
430970,202306,94,74,20,97680,26400,124080
430975,202306,55,48,7,63361.03,9240,72601.03
430980,202306,56,34,22,44880.78,29040,73920.78
430990,202306,99,78,21,102960,29040,132000
430995,202306,118,107,11,141240,14520,155760
431000,202306,308,150,158,198001.2,208560,406561.2
431010,202306,385,229,156,303615.4,205922.21,509537.61
431020,202306,2049,1179,870,1556299.14,1152362.53,2708661.67
431030,202306,46,36,10,47520,13200,60720
431033,202306,528,238,290,314178.92,382813.52,696992.44
431036,202306,12,8,4,10560,5280,15840
431040,202306,156,108,48,142560.06,63360,205920.06
431041,202306,47,29,18,38280,23760,62040
431043,202306,40,23,17,30360.42,22440,52800.42
431046,202306,12,9,3,11880,3960,15840
431050,202306,214,134,80,176880.89,105600,282480.89
431053,202306,78,43,35,56761.49,46201.05,102962.54
431055,202306,66,42,24,55440,31680,87120
431057,202306,21,21,0,27720,,27720.0
431060,202306,1673,1060,613,1401855.74,811802.86,2213658.60
431065,202306,20,10,10,13200,13200,26400
431070,202306,66,57,9,75240.27,11880,87120.27
431075,202306,7,7,0,9240,,9240.0
431080,202306,135,73,62,96361.02,81840,178201.02
431085,202306,37,33,4,43560.56,5280,48840.56
431087,202306,17,13,4,17160,5280,22440
431090,202306,48,38,10,50160.3,13200,63360.3
431100,202306,1367,807,560,1066581.77,739203.54,1805785.31
431110,202306,237,147,90,194043.34,118800,312843.34
431112,202306,30,24,6,31680.33,7920,39600.33
431113,202306,31,19,12,25080.57,15840,40920.57
431115,202306,154,110,44,145200.66,58080,203280.66
431120,202306,624,364,260,480487.6,344520,825007.6
431123,202306,6,6,0,7920,,7920.0
431125,202306,97,85,12,112200,15840,128040
431127,202306,5,3,2,3960,2640,6600
431130,202306,746,477,269,629649.23,355083.72,984732.95
431140,202306,882,622,260,822367.56,343201.45,1165569.01
431142,202306,16,15,1,19800.56,1320,21120.56
431150,202306,211,146,65,192722.29,85800,278522.29
431160,202306,43,38,5,50160.7,6600,56760.7
431162,202306,5,5,0,6600.74,,6600.74
431164,202306,7,6,1,7920,1320,9240
431170,202306,120,82,38,108240.2,50160,158400.2
431171,202306,75,44,31,58080,40920,99000
431173,202306,8,7,1,9240,1320.8,10560.8
431175,202306,214,112,102,147841.66,134640.67,282482.33
431177,202306,111,75,36,99001.2,47520.31,146521.51
431179,202306,18,13,5,17160,6600,23760
431180,202306,423,258,165,340564.12,219120,559684.12
431190,202306,73,55,18,72600.6,23760.7,96361.3
431198,202306,77,53,24,69823.59,31680,101503.59
431200,202306,23,18,5,23760,6600,30360
431205,202306,24,22,2,29040.7,2640,31680.7
431210,202306,113,69,44,91080.7,58080,149160.7
431213,202306,33,27,6,35640,7920.56,43560.56
431215,202306,24,22,2,29040.91,2640,31680.91
431217,202306,7,6,1,7920,1320,9240
431220,202306,70,58,12,76561.12,15840,92401.12
431225,202306,181,110,71,145200.47,95040,240240.47
431230,202306,107,85,22,112203.33,29040,141243.33
431235,202306,5,4,1,5280,1320,6600
431237,202306,17,13,4,17160.1,5280,22440.1
431238,202306,15,10,5,13200,6600.2,19800.2
431240,202306,1056,646,410,854069.43,542521.96,1396591.39
431242,202306,43,42,1,55440,1320,56760
431244,202306,43,35,8,46201.52,10560,56761.52
431245,202306,57,43,14,56760.01,18480,75240.01
431247,202306,19,10,9,13200,11880,25080
431250,202306,321,156,165,207241.4,217800,425041.4
431260,202306,54,46,8,60720,10560,71280
431261,202306,23,16,7,21120.75,9240,30360.75
431262,202306,14,12,2,15840,2640,18480
431265,202306,153,89,64,117480.57,84480,201960.57
431267,202306,20,16,4,21120,5280,26400
431270,202306,352,268,84,353764.12,110881.44,464645.56
431275,202306,40,36,4,47520,5280,52800
431280,202306,21,16,5,21120,6600,27720
431290,202306,30,27,3,35640.65,3960,39600.65
431295,202306,4,1,3,1320,3960,5280
431300,202306,22,18,4,23760.6,5280,29040.6
431301,202306,7,7,0,9240,,9240.0
431303,202306,60,38,22,51480,29040,80520
431306,202306,249,122,127,161041.44,167640,328681.44
431308,202306,8,7,1,9240.6,1320,10560.6
431310,202306,62,48,14,63360.16,18480,81840.16
431320,202306,254,155,99,204601.32,132000,336601.32
431330,202306,236,161,75,212521.87,100320,312841.87
431333,202306,26,22,4,29040,5280,34320
431335,202306,10,8,2,10560.82,2640,13200.82
431337,202306,475,234,241,308891.44,318123.99,627015.43
431339,202306,26,19,7,25080,9240,34320
431340,202306,3455,1861,1594,2456469.28,2109368.89,4565838.17
431342,202306,38,25,13,33000,17160,50160
431344,202306,26,26,0,34320,,34320.0
431346,202306,5,4,1,5280,1320,6600
431349,202306,30,28,2,36960,2640,39600
431350,202306,1036,583,453,772228,597964.66,1370192.66
431360,202306,61,43,18,56760,23760,80520
431365,202306,405,176,229,232323.13,302280.49,534603.62
431370,202306,1289,719,570,949102.87,755044.59,1704147.46
431380,202306,104,91,13,120121.97,17160,137281.97
431390,202306,520,286,234,377523.72,310200.3,687724.02
431395,202306,340,147,193,195361.17,256080,451441.17
431400,202306,37,23,14,30360,18480,48840
431402,202306,94,69,25,92401.8,34320.81,126722.61
431403,202306,31,21,10,27720.09,13200,40920.09
431405,202306,789,462,327,609861.27,431644.97,1041506.24
431406,202306,37,29,8,39600.14,10560,50160.14
431407,202306,50,38,12,50160,15840,66000
431410,202306,3804,2329,1475,3075678.53,1948341.12,5024019.65
431413,202306,16,13,3,17160,3960,21120
431415,202306,80,58,22,76561.38,29040,105601.38
431417,202306,23,13,10,17160,13200,30360
431420,202306,402,265,137,349806.72,180840,530646.72
431430,202306,70,32,38,42241.23,50160,92401.23
431440,202306,10143,6798,3345,8978959.69,4422109.09,13401068.78
431442,202306,28,15,13,19800,17160,36960
431445,202306,30,28,2,36960,2640,39600
431446,202306,5,5,0,6600.19,,6600.19
431447,202306,91,70,21,92400.9,27720,120120.9
431449,202306,66,54,12,71280.59,17160,88440.59
431450,202306,445,290,155,382801.23,204600,587401.23
431454,202306,11,6,5,9240,6600,15840
431455,202306,50,38,12,50160.03,15840,66000.03
431460,202306,519,351,168,464647.91,223080,687727.91
431470,202306,142,104,38,138600.25,50160,188760.25
431475,202306,11,9,2,11880,2640,14520
431477,202306,41,25,16,33000,21120,54120
431478,202306,7,7,0,9240,,9240.0
431480,202306,787,474,313,625697.98,414482.56,1040180.54
431490,202306,33814,18829,14985,24887862.74,19812108.97,44699971.71
431500,202306,80,59,21,77880,27720,105600
431505,202306,31,22,9,29040.85,11880,40920.85
431507,202306,8,8,0,10560,,10560.0
431510,202306,246,176,70,232322.09,92400,324722.09
431513,202306,19,18,1,23761.25,1320,25081.25
431514,202306,5,3,2,3960,2640,6600
431515,202306,84,72,12,95040.65,15840,110880.65
431517,202306,6,4,2,5280,2640,7920
431520,202306,41,33,8,43560.2,10560,54120.2
431530,202306,1467,633,834,836890.78,1104841.13,1941731.91
431531,202306,26,24,2,31680.7,2640,34320.7
431532,202306,40,28,12,36960,15840,52800
431535,202306,28,16,12,21120,17160,38280
431540,202306,143,113,30,150483.22,39600,190083.22
431545,202306,15,12,3,15840,3960,19800
431550,202306,374,194,180,256084.16,237601.49,493685.65
431555,202306,19,15,4,19800.2,5280,25080.2
431560,202306,5375,3553,1822,4695422.65,2406407.34,7101829.99
431570,202306,935,498,437,658691.63,576844.69,1235536.32
431575,202306,60,36,24,48840,31680.58,80520.58
431580,202306,81,59,22,77880,29040,106920
431590,202306,151,126,25,166320,33000,199320
431595,202306,20,18,2,23760,2640,26400
431600,202306,270,156,114,205925.87,150481.25,356407.12
431610,202306,123,92,31,121442.47,40920.2,162362.67
431620,202306,35,28,7,36960,9240,46200
431630,202306,124,100,24,132000.79,31680,163680.79
431640,202306,1371,840,531,1111454.59,700921.01,1812375.60
431642,202306,32,28,4,38280,5280,43560
431643,202306,44,17,27,22440,35640,58080
431645,202306,348,205,143,270601.15,188760,459361.15
431647,202306,14,13,1,17160,1320,18480
431650,202306,35,20,15,27720,19800,47520
431660,202306,259,167,92,220440.73,121440,341880.73
431670,202306,239,101,138,133321.6,183480.11,316801.71
431673,202306,12,10,2,13200,2640,15840
431675,202306,28,21,7,27720,9240,36960
431680,202306,1274,911,363,1203885.91,479165.65,1683051.56
431690,202306,5513,3178,2335,4196407.31,3087523.6,7283930.91
431695,202306,18,11,7,14520,9240,23760
431697,202306,5,3,2,3960,2640,6600
431700,202306,201,149,52,196680.55,68640,265320.55
431710,202306,4501,1905,2596,2514638.81,3426734.33,5941373.14
431720,202306,1331,816,515,1076474,679800.53,1756274.53
431725,202306,3,1,2,1320,2640,3960
431730,202306,1280,832,448,1098295.86,591370.6,1689666.46
431740,202306,1382,676,706,894973.85,934565.36,1829539.21
431750,202306,1900,1234,666,1630229.79,881765.31,2511995.10
431755,202306,5,4,1,5280,1320,6600
431760,202306,1053,663,390,876500.9,516125.34,1392626.24
431770,202306,431,287,144,378841.22,190080.84,568922.06
431775,202306,27,19,8,25080,10560,35640
431780,202306,605,364,241,480482.28,318120,798602.28
431790,202306,149,116,33,153122.1,44880.1,198002.2
431795,202306,14,12,2,15840,2640,18480
431800,202306,3254,1680,1574,2218958.86,2081648.35,4300607.21
431805,202306,20,16,4,21120,5280,26400
431810,202306,596,384,212,506888.11,281160,788048.11
431820,202306,378,209,169,275880.91,223080,498960.91
431830,202306,2499,1517,982,2002398.61,1298883.33,3301281.94
431840,202306,532,337,195,447493.14,257400.67,704893.81
431842,202306,35,28,7,36960,9240,46200
431843,202306,9,7,2,9240.23,2640,11880.23
431844,202306,17,13,4,17160,5280,22440
431845,202306,27,25,2,33000,2640,35640
431846,202306,28,23,5,30360.72,6600,36960.72
431848,202306,13,10,3,13200.1,3960,17160.1
431849,202306,7,6,1,7920,1320,9240
431850,202306,866,680,186,900263.84,246842.21,1147106.05
431860,202306,117,74,43,97680.74,56760,154440.74
431861,202306,4,0,4,,5280,5280.0
431862,202306,70,51,19,67320.65,25080,92400.65
431870,202306,4211,2425,1786,3207722.98,2360194.38,5567917.36
431880,202306,1062,737,325,972851.87,430321.29,1403173.16
431890,202306,1294,735,559,970213.58,739201.08,1709414.66
431900,202306,200,131,69,172920.59,91080,264000.59
431910,202306,48,37,11,48840.1,14520,63360.1
431912,202306,56,39,17,51481.46,22440,73921.46
431915,202306,161,122,39,161041.2,51480,212521.2
431920,202306,160,113,47,149160.35,62040,211200.35
431930,202306,78,61,17,80520,22440,102960
431935,202306,5,4,1,5280,1320,6600
431936,202306,3,3,0,3960,,3960.0
431937,202306,22,17,5,22440.2,6600,29040.2
431940,202306,490,339,151,447489.36,199320.53,646809.89
431950,202306,516,323,193,426375.3,254761.4,681136.7
431960,202306,786,438,348,578171.28,459360,1037531.28
431970,202306,64,58,6,76560.54,7920,84480.54
431971,202306,5,4,1,5280,1320,6600
431973,202306,19,16,3,21120.65,3960,25080.65
431975,202306,10,10,0,13200.2,,13200.2
431980,202306,216,120,96,158400.5,126720,285120.5
431990,202306,1061,570,491,752422.45,648133.16,1400555.61
432000,202306,2174,1159,1015,1535228.46,1341136.25,2876364.71
432010,202306,267,172,95,227040.58,125400.2,352440.78
432020,202306,202,171,31,225723.44,40920.4,266643.84
432023,202306,14,12,2,15840,2640,18480
432026,202306,62,54,8,71280.1,10560,81840.1
432030,202306,56,24,32,31680.29,42240,73920.29
432032,202306,14,11,3,14520,3960,18480
432035,202306,78,58,20,76560,26400,102960
432040,202306,88,62,26,81841.09,34320,116161.09
432045,202306,3,3,0,3960,,3960.0
432050,202306,83,51,32,67320.69,42240,109560.69
432055,202306,141,96,45,126721.96,59400,186121.96
432057,202306,7,4,3,5280.7,3960,9240.7
432060,202306,30,25,5,34320,6600,40920
432065,202306,33,28,5,36960,6600,43560
432067,202306,85,78,7,102960.67,9240,112200.67
432070,202306,399,316,83,417125.15,109560,526685.15
432080,202306,882,621,261,822395.15,345842.15,1168237.30
432085,202306,22,18,4,23760,5280,29040
432090,202306,293,195,98,257400.2,129360.33,386760.53
432100,202306,178,111,67,147840.68,89760,237600.68
432110,202306,591,389,202,513486.3,266640.04,780126.34
432120,202306,1130,637,493,840857.33,650763.77,1491621.10
432130,202306,559,392,167,517443.01,220440,737883.01
432132,202306,21,19,2,25080,2640,27720
432135,202306,83,64,19,84480.85,25080,109560.85
432140,202306,280,209,71,275881.77,95040,370921.77
432143,202306,242,145,97,191403.84,129360.24,320764.08
432145,202306,331,233,98,307564.75,129360.69,436925.44
432146,202306,18,16,2,21120.55,2640,23760.55
432147,202306,101,62,39,81840,51480,133320
432149,202306,13,12,1,15840,1320,17160
432150,202306,1191,754,437,996625.22,576844.43,1573469.65
432160,202306,2203,1116,1087,1473159,1438811.19,2911970.19
432162,202306,7,4,3,5280,3960,9240
432163,202306,17,12,5,15840,6600,22440
432166,202306,135,95,40,125733.15,52801.23,178534.38
432170,202306,251,130,121,172926.93,159720.9,332647.83
432180,202306,598,384,214,506880.58,282480,789360.58
432183,202306,14,13,1,17160.43,1320,18480.43
432185,202306,82,67,15,88440.44,19800.79,108241.23
432190,202306,570,334,236,443521.58,312840.44,756362.02
432195,202306,97,76,21,100320.7,27720,128040.7
432200,202306,477,292,185,385446.13,244201.9,629648.03
432210,202306,119,69,50,91080.1,66000,157080.1
432215,202306,33,31,2,40920,2640,43560
432218,202306,21,21,0,27720,,27720.0
432220,202306,702,348,354,460688,467283.34,927971.34
432225,202306,19,14,5,19800.2,6600,26400.2
432230,202306,128,82,46,108240,60720.3,168960.3
432232,202306,30,27,3,35640,3960,39600
432234,202306,5,3,2,3960,2640,6600
432235,202306,2,2,0,2640,,2640.0
432237,202306,23,16,7,21120,9240,30360
432240,202306,4888,2710,2178,3583894.5,2880272.23,6464166.73
432250,202306,1251,834,417,1103535.02,551762.19,1655297.21
432252,202306,50,46,4,60720,5280,66000
432253,202306,77,59,18,77881.4,23760,101641.4
432254,202306,32,16,16,21120,21120,42240
432255,202306,11,10,1,13200,1320,14520
432260,202306,934,751,183,993980.15,242880.1,1236860.25
432270,202306,237,177,60,233652.78,79202.36,312855.14
432280,202306,182,138,44,182165.08,58080,240245.08
432285,202306,1,1,0,1320,,1320.0
432290,202306,60,49,11,64680,14520,79200
432300,202306,5666,3027,2639,3996985.66,3486145.69,7483131.35
432310,202306,136,114,22,150481.11,29040,179521.11
432320,202306,21,15,6,19800,7920,27720
432330,202306,17,11,6,14520,7920,22440
432335,202306,9,7,2,9240,2640,11880
432340,202306,35,28,7,36960,9240,46200
432345,202306,132,89,43,117483.31,58080,175563.31
432350,202306,26,24,2,31680,2640,34320
432360,202306,5,4,1,5280.7,1320,6600.7
432370,202306,28,27,1,35640.55,1320,36960.55
432375,202306,29,27,2,35640,2640,38280
432377,202306,9,9,0,11880.48,,11880.48
432380,202306,241,112,129,147842.34,170283.11,318125.45
500020,202306,316,165,151,217802.27,199320.8,417123.07
500025,202306,156,73,83,96362.43,109561.12,205923.55
500060,202306,1602,1021,581,1347762.99,768249.59,2116012.58
500070,202306,807,397,410,524052.59,541210.61,1065263.20
500080,202306,153,125,28,165004.73,36960,201964.73
500085,202306,157,115,42,151803.72,55440,207243.72
500090,202306,405,191,214,252126.72,282481.03,534607.75
500100,202306,716,372,344,492372.89,454081.46,946454.35
500110,202306,2444,1188,1256,1568215.54,1659266.78,3227482.32
500124,202306,284,148,136,195360.58,179521.76,374882.34
500150,202306,337,135,202,178203.2,266640.8,444844.0
500190,202306,615,413,202,545179.41,267963.17,813142.58
500200,202306,219,179,40,236284.68,52800,289084.68
500210,202306,1829,569,1260,751094.5,1663213.29,2414307.79
500215,202306,212,124,88,163688.17,116160.2,279848.37
500220,202306,760,474,286,625704.08,377522.94,1003227.02
500230,202306,256,146,110,192723.73,145201.34,337925.07
500240,202306,692,429,263,567616.74,348483.54,916100.28
500260,202306,630,259,371,341884.54,489720.46,831605.00
500270,202306,33588,14729,18859,19461637.57,24923285.23,44384922.80
500280,202306,211,74,137,97681.05,180840.66,278521.71
500290,202306,1267,798,469,1053386.72,619084.04,1672470.76
500295,202306,524,348,176,463329.28,233641.09,696970.37
500310,202306,124,42,82,55440.1,108240.81,163680.91
500315,202306,902,485,417,640201.37,550442.66,1190644.03
500320,202306,4039,1884,2155,2486976.52,2845937.95,5332914.47
500325,202306,1019,576,443,764312.93,586086.24,1350399.17
500330,202306,1647,811,836,1070609.54,1103533.49,2174143.03
500345,202306,331,229,102,302285.98,134640.21,436926.19
500348,202306,263,159,104,209882.9,137280,347162.9
500350,202306,107,50,57,66001.51,75241.14,141242.65
500370,202306,6249,2857,3392,3775588.96,4484080.2,8259669.16
500375,202306,384,251,133,331323.78,175560.2,506883.98
500380,202306,711,394,317,520095.03,418442.26,938537.29
500390,202306,81,34,47,44880.1,62040.7,106920.8
500400,202306,236,141,95,186124.51,126720.97,312845.48
500410,202306,464,210,254,277211.19,336604.45,613815.64
500430,202306,654,399,255,526693.55,336601.57,863295.12
500440,202306,208,118,90,155760.14,118800.2,274560.34
500450,202306,467,199,268,262684.69,353761.85,616446.54
500460,202306,296,163,133,215163.72,175560.96,390724.68
500470,202306,461,327,134,431648.52,176880.8,608529.32
500480,202306,118,68,50,89760.73,66001.48,155762.21
500490,202306,99,45,54,59400.68,71282.44,130683.12
500500,202306,1588,587,1001,776185.19,1325286.97,2101472.16
500510,202306,39,33,6,43560.51,7920,51480.51
500515,202306,125,83,42,109563.03,55441.47,165004.50
500520,202306,304,151,153,199327.35,203280.16,402607.51
500525,202306,97,50,47,67320.14,62040,129360.14
500540,202306,985,425,560,561022.12,740527.79,1301549.91
500560,202306,922,514,408,678494.09,538562.78,1217056.87
500568,202306,1177,548,629,726014.68,831606.14,1557620.82
500570,202306,1292,735,557,970217.51,737883.56,1708101.07
500580,202306,317,175,142,231006.78,187441.24,418448.02
500600,202306,427,202,225,266645.92,297002.34,563648.26
500620,202306,1116,778,338,1026986.63,446168.35,1473154.98
500625,202306,90,68,22,89760.41,29040,118800.41
500627,202306,47,20,27,26400,35640,62040
500630,202306,1694,979,715,1293079.74,943807.19,2236886.93
500635,202306,532,310,222,409201.84,293040,702241.84
500640,202306,366,197,169,261370.95,223082.85,484453.80
500660,202306,6541,2331,4210,3079633.9,5558558.27,8638192.17
500690,202306,677,244,433,322086.17,571560.26,893646.43
500710,202306,433,212,221,279846.67,293045.26,572891.93
500720,202306,1021,556,465,735258.02,613803.61,1349061.63
500730,202306,148,88,60,117485.95,79200,196685.95
500740,202306,1043,453,590,599296.98,780125.51,1379422.49
500750,202306,215,79,136,104284.03,179522.2,283806.23
500755,202306,114,85,29,112204.11,39600.93,151805.04
500769,202306,802,444,358,586099.03,473884.04,1059983.07
500770,202306,458,244,214,322081.21,282480,604561.21
500780,202306,141,95,46,126727.42,60721.33,187448.75
500790,202306,1163,566,597,747147.01,789365.67,1536512.68
500793,202306,313,161,152,212524.88,200643.16,413168.04
500795,202306,209,131,78,172922.47,102960.99,275883.46
500797,202306,49,34,15,44880.62,19800,64680.62
500800,202306,471,207,264,273246.74,349801.35,623048.09
500830,202306,2558,1321,1237,1743786.53,1638129.96,3381916.49
500840,202306,112,81,31,106924.45,40920.94,147845.39
510010,202306,175,97,78,128040,102960,231000
510020,202306,572,278,294,366974.73,389404.24,756378.97
510025,202306,1873,1062,811,1403201.65,1070532.25,2473733.90
510030,202306,680,361,319,476539.69,421086.69,897626.38
510035,202306,136,70,66,92400.25,88440,180840.25
510040,202306,427,200,227,264003.25,299641.66,563644.91
510050,202306,389,199,190,265322.98,250800.92,516123.90
510060,202306,146,64,82,84482.74,108240,192722.74
510080,202306,261,112,149,147841.51,198000,345841.51
510100,202306,68,29,39,38280.55,51480.36,89760.91
510120,202306,32,19,13,25080.99,17160.24,42241.23
510125,202306,409,260,149,343201.9,198000.21,541202.11
510130,202306,563,336,227,443530.85,299642.17,743173.02
510140,202306,469,156,313,205921.43,413161.38,619082.81
510160,202306,111,46,65,60722.08,85801.31,146523.39
510170,202306,832,493,339,650778.51,448806.41,1099584.92
510180,202306,3198,1439,1759,1899527.19,2325860.49,4225387.68
510185,202306,40,21,19,27720.7,25080,52800.7
510190,202306,278,96,182,126722.84,240241.61,366964.45
510250,202306,2915,1762,1153,2327206.39,1523286.91,3850493.30
510260,202306,174,124,50,163681.75,67320.7,231002.45
510263,202306,502,288,214,380167.7,282482.83,662650.53
510267,202306,659,370,289,488417.85,382803.12,871220.97
510268,202306,82,38,44,50160.01,58080,108240.01
510269,202306,81,37,44,48840,58080.5,106920.5
510270,202306,400,195,205,257401.94,270600.31,528002.25
510279,202306,222,163,59,216481.74,77880,294361.74
510285,202306,187,75,112,99001.65,147840,246841.65
510300,202306,556,292,264,385444.39,349802.33,735246.72
510305,202306,209,91,118,120120.33,155760,275880.33
510310,202306,109,58,51,76560.02,67320.1,143880.12
510320,202306,853,532,321,702252.07,423723.47,1125975.54
510325,202306,474,203,271,267964.2,359042.44,627006.64
510330,202306,487,275,212,363007.55,279841.47,642849.02
510335,202306,712,421,291,555735.33,384122.98,939858.31
510336,202306,55,38,17,50162.11,22440.76,72602.87
510337,202306,109,46,63,60720.03,83160,143880.03
510340,202306,20143,8584,11559,11347159.13,15280589.92,26627749.05
510343,202306,61,48,13,63360,17160,80520
510345,202306,157,95,62,125401.97,81840.68,207242.65
510350,202306,689,365,324,481810.84,427686.21,909497.05
510360,202306,225,138,87,182163.58,114840,297003.58
510370,202306,182,78,104,102960,137280.7,240240.7
510380,202306,81,59,22,77880,29040,106920
510385,202306,57,32,25,42240.2,33000,75240.2
510390,202306,101,45,56,59400.58,73920.54,133321.12
510395,202306,62,43,19,56760,25080,81840
510410,202306,869,560,309,739224.45,407886.58,1147111.03
510420,202306,588,285,303,376202.38,399960.7,776163.08
510450,202306,53,30,23,39600,30360,69960
510452,202306,61,29,32,38280,42240,80520
510454,202306,57,26,31,34320,40920.03,75240.03
510455,202306,121,73,48,96360,63360.97,159720.97
510460,202306,207,87,120,114842.32,158400,273242.32
510480,202306,810,462,348,609859.62,459368.91,1069228.53
510490,202306,336,164,172,216482.6,227040.5,443523.1
510500,202306,249,187,62,246840.5,81840,328680.5
510510,202306,911,533,378,704897.17,501604.94,1206502.11
510515,202306,1370,706,664,931939.59,877806.16,1809745.75
510517,202306,286,128,158,168962.6,208560,377522.6
510520,202306,246,153,93,201965.19,122760.58,324725.77
510523,202306,123,95,28,125400,36960,162360
510525,202306,944,582,362,769487.64,477843.18,1247330.82
510530,202306,30,15,15,19800,19800,39600
510550,202306,259,117,142,154443.1,187442.1,341885.2
510558,202306,331,164,167,216732.16,221760,438492.16
510560,202306,407,240,167,316806.64,220442.28,537248.92
510562,202306,711,505,206,666621.84,271921.62,938543.46
510590,202306,731,352,379,464652.31,501603.42,966255.73
510600,202306,218,118,100,155764.8,132000.55,287765.35
510610,202306,228,103,125,135963.87,165001.46,300965.33
510615,202306,239,113,126,149161,166320.42,315481.42
510617,202306,27,11,16,14520,21120,35640
510618,202306,131,65,66,85800,87122.37,172922.37
510619,202306,84,59,25,77882.1,33000,110882.1
510620,202306,166,89,77,117480.7,101640,219120.7
510621,202306,182,119,63,157080.2,83160.23,240240.43
510622,202306,535,281,254,372252.64,335285.29,707537.93
510623,202306,300,203,97,267963.67,128040.2,396003.87
510624,202306,97,46,51,60722.32,67320.83,128043.15
510625,202306,565,347,218,458055.36,287764.81,745820.17
510626,202306,120,65,55,85802.67,72600,158402.67
510627,202306,99,67,32,88441.43,43560,132001.43
510628,202306,176,108,68,142560.52,89760,232320.52
510629,202306,297,180,117,237602.57,157103.76,394706.33
510630,202306,480,250,230,330014.03,304921.51,634935.54
510631,202306,21,9,12,11880.13,15840,27720.13
510637,202306,370,214,156,282483.81,205920,488403.81
510642,202306,1271,684,587,902900.54,777486.43,1680386.97
510645,202306,13,3,10,3960,13200.18,17160.18
510650,202306,1299,832,467,1098288.63,616444.97,1714733.60
510665,202306,103,46,57,60721.04,75240.08,135961.12
510670,202306,60,34,26,44880.54,34320,79200.54
510675,202306,1169,744,425,982111.45,562324.28,1544435.73
510677,202306,367,194,173,256084.46,228360.51,484444.97
510680,202306,91,57,34,75241.95,44880,120121.95
510682,202306,202,94,108,125400.85,142560,267960.85
510685,202306,55,40,15,52800.55,19800.8,72601.35
510700,202306,621,353,268,465975.52,353763.3,819738.82
510704,202306,1365,686,679,905558.18,896293.51,1801851.69
510706,202306,169,86,83,113523.34,109561.26,223084.60
510710,202306,454,323,131,426367.82,172920,599287.82
510715,202306,57,39,18,51480,23760.63,75240.63
510718,202306,265,118,147,155762.31,194044.54,349806.85
510719,202306,53,24,29,31680,38280,69960
510720,202306,184,129,55,170280.37,73084,243364.37
510724,202306,80,31,49,40920,64680,105600
510726,202306,68,33,35,43560.7,46200.62,89761.32
510729,202306,17,6,11,7920,14520.3,22440.3
510730,202306,486,258,228,340562.31,303600,644162.31
510735,202306,123,46,77,60720.08,101640,162360.08
510740,202306,25,14,11,18481.43,14521.34,33002.77
510757,202306,28,23,5,30361.43,6600.16,36961.59
510760,202306,8186,4125,4061,5450415.76,5367165.69,10817581.45
510770,202306,759,341,418,450128.8,554403.35,1004532.15
510774,202306,18,7,11,9240.69,14520,23760.69
510775,202306,126,98,28,129360,36960,166320
510776,202306,36,12,24,15840,31680.2,47520.2
510777,202306,188,84,104,110880.2,138600,249480.2
510779,202306,41,24,17,31680,22440,54120
510780,202306,288,148,140,195369.21,184800,380169.21
510785,202306,348,190,158,250806.14,208560.76,459366.90
510787,202306,223,110,113,145204.08,149161.09,294365.17
510788,202306,9,4,5,5280.9,6600,11880.9
510790,202306,2884,1484,1400,1960318.83,1850648.99,3810967.82
510792,202306,1195,670,525,885866.29,693011.82,1578878.11
510794,202306,124,67,57,88441.06,75240,163681.06
510795,202306,2467,1383,1084,1825598.89,1434846.24,3260445.13
510800,202306,200,110,90,145201.31,118800.14,264001.45
510805,202306,222,149,73,196681.1,96360,293041.1
510810,202306,108,43,65,56761.58,85800.42,142562.00
510820,202306,271,138,133,182161.74,175560.81,357722.55
510830,202306,80,40,40,52800,52800,105600
510835,202306,26,19,7,25080.7,9240,34320.7
510840,202306,10151,4566,5585,6035290.84,7376243.54,13411534.38
510850,202306,221,89,132,117482.26,175560.26,293042.52
510860,202306,441,223,218,294363.11,287761.49,582124.60
510880,202306,83,60,23,79200.2,30360,109560.2
510885,202306,72,41,31,54121.63,40920,95041.63
510890,202306,79,38,41,50160.16,54120,104280.16
510895,202306,193,114,79,150480.64,104280,254760.64
520005,202306,160,66,94,87123.78,124081.86,211205.64
520010,202306,337,151,186,199322.95,248164.56,447487.51
520013,202306,800,556,244,733936.67,322083.21,1056019.88
520015,202306,38,25,13,33000,17160,50160
520017,202306,87,55,32,72600.84,42240,114840.84
520020,202306,12,6,6,7920,7920,15840
520025,202306,3250,1744,1506,2304834.09,1991938.12,4296772.21
520030,202306,929,481,448,634934.19,591363.84,1226298.03
520050,202306,63,47,16,62040.2,21120,83160.2
520055,202306,83,56,27,73920,35640.2,109560.2
520060,202306,192,130,62,171604.49,81841.25,253445.74
520080,202306,598,425,173,561001.75,228360,789361.75
520082,202306,17,13,4,17160,5280,22440
520085,202306,111,86,25,113520.18,33000.7,146520.88
520090,202306,87,64,23,84480.75,30360,114840.75
520110,202306,10081,4281,5800,5655046.91,7663990.05,13319036.96
520120,202306,12,8,4,10560,5280,15840
520130,202306,906,632,274,834251.77,363001.42,1197253.19
520140,202306,13154,7142,6012,9433060.42,7941213.02,17374273.44
520145,202306,63,35,28,46200.2,36960,83160.2
520150,202306,141,111,30,146527.28,40920,187447.28
520160,202306,42,26,16,34320,21120,55440
520170,202306,219,126,93,166328.26,122762.36,289090.62
520180,202306,202,96,106,126721.14,139921.36,266642.50
520215,202306,201,147,54,194041.19,71280.2,265321.39
520235,202306,92,69,23,91080,30360,121440
520250,202306,165,84,81,110881.96,106920,217801.96
520260,202306,127,75,52,99003.19,68641.05,167644.24
520280,202306,47,36,11,47520.38,14520,62040.38
520310,202306,30,18,12,23761.8,15840.7,39602.5
520320,202306,190,112,78,147842.04,102960.97,250803.01
520330,202306,899,496,403,654735.41,531964.47,1186699.88
520340,202306,310,177,133,233650.89,176881.46,410532.35
520350,202306,513,261,252,344525.61,332642.2,677167.81
520355,202306,109,66,43,87123.18,56760,143883.18
520357,202306,36,28,8,36960,10560,47520
520360,202306,16,6,10,7920.2,13200.28,21120.48
520380,202306,145,80,65,105600,85800,191400
520390,202306,236,105,131,138604.58,172920,311524.58
520393,202306,18,14,4,18480.1,5280,23760.1
520396,202306,76,56,20,73920,26400,100320
520400,202306,220,135,85,178205.65,112203.3,290408.95
520410,202306,205,102,103,134643.49,135960,270603.49
520420,202306,21,17,4,22440.94,5280,27720.94
520425,202306,262,126,136,166323.17,179520.98,345844.15
520430,202306,570,269,301,355081.68,397321.54,752403.22
520440,202306,695,503,192,665295.59,253441.33,918736.92
520450,202306,2370,1021,1349,1347763.32,1783339.74,3131103.06
520455,202306,63,35,28,46201.43,36960.51,83161.94
520460,202306,47,29,18,38280.69,23761.51,62042.20
520465,202306,37,32,5,42240,6600,48840
520470,202306,479,294,185,388082.64,244200.2,632282.84
520480,202306,78,50,28,66001.59,36960,102961.59
520485,202306,111,41,70,54120.83,92400.1,146520.93
520490,202306,568,415,153,547811.74,201962.7,749774.44
520495,202306,172,103,69,135960.1,91080,227040.1
520500,202306,263,214,49,282482.23,64680,347162.23
520505,202306,190,111,79,146520,104280,250800
520510,202306,2204,1041,1163,1374143.71,1535169.35,2909313.06
520520,202306,65,42,23,55440.97,30360,85800.97
520530,202306,216,171,45,225726.34,59400,285126.34
520540,202306,804,545,259,719410.51,341882.72,1061293.23
520545,202306,165,97,68,128045.35,89760.6,217805.95
520547,202306,81,46,35,60722.33,46200.1,106922.43
520549,202306,1634,782,852,1036236.82,1128614.53,2164851.35
520551,202306,323,171,152,225722.71,201961.23,427683.94
520552,202306,50,36,14,47520.5,18480,66000.5
520570,202306,15,12,3,15840,3960,19800
520580,202306,296,184,112,243019.48,147840.73,390860.21
520590,202306,161,91,70,120122.11,92400,212522.11
520620,202306,1336,621,715,819732.85,946447.73,1766180.58
520630,202306,56,30,26,39600,34320.18,73920.18
520640,202306,399,232,167,306246.66,220440.9,526687.56
520650,202306,72,33,39,43560,51480,95040
520660,202306,47,24,23,31681.1,30360.38,62041.48
520670,202306,49,36,13,47520.27,17160,64680.27
520680,202306,24,14,10,18480,13200,31680
520690,202306,37,10,27,13200,35640,48840
520710,202306,38,29,9,38280,11880,50160
520725,202306,198,148,50,195363.33,67320,262683.33
520735,202306,61,38,23,50160.4,30360.2,80520.6
520740,202306,490,245,245,323406.32,324721.22,648127.54
520750,202306,40,23,17,30360,22440,52800
520753,202306,78,56,22,73920.76,29040,102960.76
520760,202306,112,80,32,105601.49,42240,147841.49
520780,202306,272,210,62,277205.65,81843.34,359048.99
520790,202306,145,90,55,118800.22,72600,191400.22
520800,202306,3655,2068,1587,2731169.27,2097511.38,4828680.65
520810,202306,136,104,32,137634.45,42240.89,179875.34
520815,202306,7,5,2,6600.96,2640,9240.96
520830,202306,134,94,40,124082.91,52800.05,176882.96
520840,202306,419,267,152,352440.09,200640,553080.09
520850,202306,114,66,48,87122.18,63360,150482.18
520860,202306,1965,1244,721,1642119.85,951725,2593844.85
520870,202306,36431,16408,20023,21668592.17,26447832.35,48116424.52
520880,202306,1393,726,667,959684.08,883097.58,1842781.66
520890,202306,880,563,317,744503.52,418441.57,1162945.09
520910,202306,1030,538,492,710186.84,649442.61,1359629.45
520915,202306,96,63,33,83162.29,43560.6,126722.89
520920,202306,525,243,282,320771.53,372247.29,693018.82
520929,202306,16,14,2,18480.56,2640,21120.56
520940,202306,66,50,16,66001.02,21120.1,87121.12
520945,202306,17,10,7,13200,9240,22440
520960,202306,49,30,19,39600,25080,64680
520970,202306,439,254,185,336608.56,244204.3,580812.86
520980,202306,91,66,25,87120,33000,120120
520990,202306,440,311,129,411841.97,170280.63,582122.60
520993,202306,124,64,60,84483.2,79200.09,163683.29
520995,202306,275,149,126,196682.72,166320,363002.72
521000,202306,1702,929,773,1227623.86,1021692.02,2249315.88
521010,202306,659,350,309,462009.6,407882.78,869892.38
521015,202306,13,8,5,10560,6600,17160
521020,202306,1542,1083,459,1430916.07,607209.48,2038125.55
521030,202306,81,55,26,72600.95,34320,106920.95
521040,202306,1034,692,342,913463.41,451441,1364904.41
521056,202306,58,38,20,50160,26400,76560
521060,202306,127,81,46,106921.55,60720.76,167642.31
521080,202306,323,255,68,336618.77,89760.4,426379.17
521090,202306,616,420,196,555728.76,258720,814448.76
521100,202306,282,194,88,256087.52,116160.4,372247.92
521120,202306,1134,804,330,1061309.86,438244.47,1499554.33
521130,202306,332,235,97,310207.64,128040,438247.64
521140,202306,193,107,86,141245.26,114840.69,256085.95
521150,202306,2715,1142,1573,1507496.52,2077711.88,3585208.40
521160,202306,27,10,17,13200.42,22440,35640.42
521170,202306,231,123,108,162361.03,142560.2,304921.23
521180,202306,1263,790,473,1042831.66,624367.78,1667199.44
521190,202306,2781,1153,1628,1525960.63,2154258.9,3680219.53
521200,202306,62,45,17,59400.1,22440,81840.1
521205,202306,18,12,6,15840.2,7920,23760.2
521210,202306,144,88,56,116161.69,73920,190081.69
521220,202306,791,533,258,703572.15,340562.99,1044135.14
521225,202306,17,12,5,15841.2,6600.81,22442.01
521230,202306,111,73,38,96361.56,51481.63,147843.19
521250,202306,6855,3750,3105,4955495.29,4098654.73,9054150.02
521260,202306,47,19,28,25080,36960,62040
521270,202306,129,98,31,129361.16,40920,170281.16
521280,202306,431,270,161,357722.98,212520,570242.98
521290,202306,33,18,15,23760.92,19800,43560.92
521295,202306,107,71,36,93720.93,47520,141240.93
521300,202306,251,139,112,183482.39,147840.84,331323.23
521305,202306,45,32,13,42241.51,17160,59401.51
521308,202306,1038,796,242,1050752.44,319444.23,1370196.67
521310,202306,1483,815,668,1078474.72,883092.71,1961567.43
521340,202306,22,17,5,22440,6600,29040
521350,202306,91,69,22,91083.19,29040,120123.19
521370,202306,175,114,61,150480.5,80520,231000.5
521375,202306,208,99,109,130683.49,143881.16,274564.65
521377,202306,48,35,13,46200.93,17160.1,63361.03
521380,202306,1146,678,468,894997.81,620406.68,1515404.49
521385,202306,11,6,5,7920,6600,14520
521390,202306,103,81,22,106923.13,29040.49,135963.62
521400,202306,415,299,116,396012.13,153120.92,549133.05
521405,202306,173,112,61,147843.56,80520.66,228364.22
521410,202306,84,61,23,80521.27,30360,110881.27
521440,202306,220,151,69,199324.86,91080.64,290405.50
521450,202306,824,451,373,596653.63,495004.53,1091658.16
521460,202306,1162,806,356,1063965.44,469927.44,1533892.88
521470,202306,16,11,5,14520,6600,21120
521480,202306,42,27,15,35641.51,19800,55441.51
521483,202306,344,226,118,299642.93,155761.47,455404.40
521486,202306,318,213,105,281160.5,138600.84,419761.34
521487,202306,24,12,12,15840,15840,31680
521490,202306,29,17,12,22440,15840,38280
521500,202306,156,72,84,95040.46,110880.19,205920.65
521520,202306,46,34,12,44880,15840,60720
521523,202306,1254,679,575,897621.43,759005.34,1656626.77
521525,202306,59,44,15,58080,22440,80520
521530,202306,246,142,104,188760.45,137280.49,326040.94
521540,202306,46,22,24,29040,31680,60720
521550,202306,135,66,69,87121.38,91080.99,178202.37
521560,202306,962,643,319,850103.64,422402.55,1272506.19
521565,202306,73,52,21,68641.09,27720.7,96361.79
521570,202306,614,382,232,505568.45,307560.97,813129.42
521580,202306,45,29,16,38280,21120,59400
521590,202306,42,22,20,29040,26400,55440
521600,202306,25,12,13,15840,17160,33000
521630,202306,237,122,115,161047.13,151804.66,312851.79
521640,202306,330,180,150,237603.25,198000.67,435603.92
521645,202306,41,20,21,26400,27720,54120
521680,202306,266,162,104,213843.16,137280.87,351124.03
521690,202306,16,14,2,18480,2640,21120
521710,202306,1165,558,607,737894.37,802566.59,1540460.96
521720,202306,634,425,209,561005.61,278520.9,839526.51
521730,202306,752,346,406,458044.71,535921.91,993966.62
521740,202306,965,449,516,592687.62,681124.71,1273812.33
521760,202306,2605,1335,1270,1766336.57,1677761.32,3444097.89
521770,202306,880,536,344,707530.79,454082.98,1161613.77
521800,202306,2086,1420,666,1875762.18,881761.92,2757524.10
521805,202306,39,24,15,31680,19800,51480
521810,202306,93,52,41,68641.15,55440.19,124081.34
521830,202306,1082,794,288,1050751.86,380166.77,1430918.63
521839,202306,73,41,32,54120,42240.2,96360.2
521850,202306,1246,623,623,822384.33,823690.87,1646075.20
521860,202306,344,215,129,283804.95,170280,454084.95
521870,202306,92,60,32,79200,42240,121440
521878,202306,36,14,22,18480,29040.15,47520.15
521880,202306,5414,2371,3043,3131139.28,4019434.78,7150574.06
521890,202306,669,454,215,599291.67,283802.11,883093.78
521900,202306,290,228,62,300960.89,81840.8,382801.69
521910,202306,194,133,61,175566.69,80522.39,256089.08
521920,202306,37,22,15,29040,19800,48840
521925,202306,57,32,25,42240,33000,75240
521930,202306,1337,744,593,984755.26,784092.09,1768847.35
521935,202306,34,25,9,33001.61,11880,44881.61
521940,202306,251,113,138,149161.35,183480.75,332642.10
521945,202306,19,12,7,15840,9240,25080
521950,202306,23,14,9,18480,11880,30360
521960,202306,68,54,14,71280,18480,89760
521970,202306,417,272,145,359043.42,191400.89,550444.31
521971,202306,108,58,50,76560.8,66000,142560.8
521973,202306,39,18,21,23760.6,27720,51480.6
521975,202306,1784,947,837,1250081.11,1106177.71,2356258.82
521980,202306,244,168,76,221762.41,100320,322082.41
521990,202306,93,65,28,85801.16,36960,122761.16
522000,202306,292,197,95,259586.15,125400.79,384986.94
522005,202306,19,11,8,14520,10560,25080
522010,202306,1221,675,546,893670.28,720731.37,1614401.65
522015,202306,61,38,23,50160,30360,80520
522020,202306,925,555,370,733933.3,489725.16,1223658.46
522026,202306,28,19,9,25080,11880,36960
522028,202306,24,21,3,27720,3960,31680
522040,202306,888,396,492,522734.55,649447.75,1172182.30
522045,202306,2985,1759,1226,2323287.61,1619649.41,3942937.02
522050,202306,166,72,94,95044.93,125400.72,220445.65
522060,202306,558,351,207,463330.52,273240.35,736570.87
522068,202306,120,86,34,113520.89,44880,158400.89
522070,202306,18,16,2,21120,2640,23760
522100,202306,37,23,14,30360,18480,48840
522108,202306,42,33,9,43561.5,11880,55441.5
522119,202306,65,37,28,48840.93,36960,85800.93
522130,202306,86,33,53,43560.35,69960.98,113521.33
522140,202306,4632,2432,2200,3210346.47,2905344.03,6115690.50
522145,202306,51,36,15,47520.2,19800,67320.2
522150,202306,113,76,37,100320.19,48840.84,149161.03
522155,202306,59,40,19,52800.9,25080,77880.9
522157,202306,16,9,7,11880,9240,21120
522160,202306,1736,1035,701,1368878.93,926648.55,2295527.48
522170,202306,368,247,121,326052.98,159723.64,485776.62
522180,202306,32,13,19,17160,25080,42240
522185,202306,2804,1239,1565,1636864.33,2067169.56,3704033.89
522190,202306,77,45,32,59400.9,42240,101640.9
522200,202306,344,199,145,262682.75,191400.24,454082.99
522205,202306,142,98,44,129364.06,58080.1,187444.16
522220,202306,138,108,30,142560.2,39600,182160.2
522230,202306,31,27,4,35640.41,5280,40920.41
530010,202306,61501,31164,30337,41168391.02,40083921.95,81252312.97
110001,202307,555,453,102,597968.03,134640,732608.03
110002,202307,3220,2086,1134,2753580.27,1503487.84,4257068.11
110003,202307,82,64,18,84481.96,23760,108241.96
110004,202307,2300,1582,718,2089600.58,947766.5,3037367.08
110005,202307,464,360,104,475205.99,137280.2,612486.19
110006,202307,464,342,122,452764.25,161040,613804.25
110007,202307,82,65,17,85800,22440,108240
110008,202307,285,161,124,213841.61,163680.6,377522.21
110009,202307,1010,789,221,1041488.57,293040.24,1334528.81
110010,202307,1788,990,798,1306826.24,1054682.01,2361508.25
110011,202307,1784,1379,405,1820328.03,535929.17,2356257.20
110012,202307,4386,2532,1854,3342305.3,2449942.56,5792247.86
110013,202307,789,630,159,831624.8,209883.12,1041507.92
110014,202307,358,317,41,418447.62,54120,472567.62
110015,202307,1433,1090,343,1440136.56,452764.47,1892901.03
110018,202307,1084,687,397,906860.08,524040.33,1430900.41
110020,202307,17981,10070,7911,13300929.42,10454523.77,23755453.19
110025,202307,672,496,176,654724,232320.4,887044.4
110026,202307,35,24,11,31680.74,14520,46200.74
110028,202307,1700,1196,504,1580075.19,665286.69,2245361.88
110029,202307,131,119,12,157082.88,15840,172922.88
110030,202307,2588,1668,920,2201589.41,1215725.82,3417315.23
110032,202307,358,275,83,363009.65,109563.71,472573.36
110033,202307,715,508,207,670585.33,273246.08,943831.41
110034,202307,340,261,79,344522.54,104280,448802.54
110037,202307,99,84,15,110881.1,19800,130681.1
110040,202307,441,304,137,401281.94,180840,582121.94
110045,202307,1034,753,281,995306.46,370922.19,1366228.65
110050,202307,92,82,10,108241.95,13200.03,121441.98
110060,202307,62,43,19,56760.92,25080,81840.92
110070,202307,119,81,38,106921.51,50160,157081.51
110080,202307,595,348,247,459365.49,326040.73,785406.22
110090,202307,24,19,5,25080,6600,31680
110092,202307,132,63,69,83161.11,91080,174241.11
110094,202307,244,173,71,228362.96,93720,322082.96
110100,202307,58,44,14,58080.28,18480.06,76560.34
110110,202307,124,71,53,93721.43,69960,163681.43
110120,202307,82,70,12,92402.25,15840,108242.25
110130,202307,269,222,47,293046.99,62040.1,355087.09
110140,202307,280,200,80,264002.91,105600.1,369603.01
110143,202307,60,49,11,64680,14520,79200
110145,202307,48,37,11,48840,14520,63360
110146,202307,30,12,18,15840.2,23760,39600.2
110147,202307,45,28,17,36960.51,22440.58,59401.09
110148,202307,35,27,8,35640.7,10560,46200.7
110149,202307,321,225,96,297001.29,128040,425041.29
110150,202307,147,119,28,157081.1,36960,194041.1
110155,202307,13,12,1,15840,1320,17160
110160,202307,73,57,16,75241.21,21120,96361.21
110170,202307,227,170,57,224403.76,75240,299643.76
110175,202307,72,58,14,76560,18480,95040
110180,202307,94,74,20,97680.88,26400,124080.88
120001,202307,249,180,69,237610.66,91080.66,328691.32
120005,202307,244,139,105,183483.87,138600,322083.87
120010,202307,1228,750,478,990013.12,632282.17,1622295.29
120013,202307,182,122,60,161042.72,79200.1,240242.82
120017,202307,149,89,60,117481.3,79200,196681.3
120020,202307,3560,2878,682,3799048.46,901570.5,4700618.96
120025,202307,611,332,279,439605.84,368297.61,807903.45
120030,202307,1266,1096,170,1448105.38,224408.45,1672513.83
120032,202307,42,37,5,48840,6600,55440
120033,202307,234,202,32,266647.64,42240.55,308888.19
120034,202307,194,145,49,191401.34,64680,256081.34
120035,202307,63,56,7,73920.1,9240,83160.1
120038,202307,431,285,146,376213.05,194041.75,570254.80
120039,202307,37,34,3,44881.1,3960,48841.1
120040,202307,15634,10498,5136,13858853.6,6787754.75,20646608.35
120042,202307,53,48,5,63362.05,6600,69962.05
120043,202307,18,5,13,6600,17160,23760
120045,202307,585,375,210,495021.52,277203.5,772225.02
120050,202307,1364,1037,327,1368905.17,431650.9,1800556.07
120060,202307,1562,1308,254,1725870.89,335286.64,2061157.53
120070,202307,455,336,119,443534.78,157080.42,600615.20
120080,202307,218,144,74,190085.43,97680.55,287765.98
130002,202307,167,120,47,158400.95,62040,220440.95
130006,202307,113,77,36,101640,47520,149160
130008,202307,133,81,52,106920.73,69960,176880.73
130010,202307,178,112,66,147840.2,87120.85,234961.05
130014,202307,329,231,98,305253.2,129361.8,434615.0
130020,202307,160,115,45,151800.9,59400,211200.9
130030,202307,1039,581,458,766926.52,604562.04,1371488.56
130040,202307,430,224,206,295682.12,273240,568922.12
130050,202307,583,308,275,406576.17,364331.78,770907.95
130060,202307,912,619,293,817082.89,386760.7,1203843.59
130063,202307,653,419,234,553080.1,308880,861960.1
130068,202307,244,151,93,199321.54,122761.31,322082.85
130070,202307,1435,952,483,1259307.38,637565.34,1896872.72
130080,202307,742,514,228,678486.91,300962.11,979449.02
130083,202307,92,62,30,81840.44,39600,121440.44
130090,202307,355,219,136,289080.65,179520,468600.65
130100,202307,1436,770,666,1016411.66,879129.55,1895541.21
130110,202307,851,371,480,489723.28,634920.78,1124644.06
130115,202307,157,82,75,108240,99000.7,207240.7
130120,202307,1781,1112,669,1467855.75,883081.23,2350936.98
130130,202307,689,474,215,625681.05,283800.95,909482.00
130140,202307,1606,1251,355,1651332.21,468600.96,2119933.17
130150,202307,456,408,48,538561.35,63360,601921.35
130160,202307,473,300,173,396001.4,228360,624361.4
130165,202307,151,133,18,175560,23760,199320
130170,202307,1302,897,405,1183984.03,534609.99,1718594.02
130180,202307,309,247,62,326041.88,81840.1,407881.98
130185,202307,2404,1209,1195,1595922.4,1578742.73,3174665.13
130190,202307,3534,2226,1308,2939728.89,1726577.93,4666306.82
130195,202307,309,247,62,326040,81840,407880
130200,202307,230,148,82,195361.91,108240,303601.91
130210,202307,95,43,52,56760,69960,126720
130220,202307,226,174,52,229680.57,68640,298320.57
130230,202307,368,251,117,331320,154440,485760
130240,202307,1454,984,470,1298890.28,620402.03,1919292.31
130250,202307,5141,3358,1783,4432660.81,2354915.06,6787575.87
130255,202307,456,238,218,314160.52,287760.87,601921.39
130260,202307,71124,33274,37850,43937861.75,50016045.38,93953907.13
130270,202307,1560,1088,472,1436288.94,623042.42,2059331.36
130280,202307,149,86,63,113520.1,83160,196680.1
130290,202307,2132,1361,771,1796559.81,1017726.31,2814286.12
130300,202307,436,294,142,388081.6,187442.29,575523.89
130310,202307,981,553,428,729963.57,567600.46,1297564.03
130320,202307,576,317,259,418440.57,341880.94,760321.51
130330,202307,806,540,266,712805.33,351120.84,1063926.17
130340,202307,3696,2029,1667,2678368.07,2203108.21,4881476.28
130350,202307,485,348,137,459360.2,180840,640200.2
130353,202307,1035,500,535,660015.1,706210.6,1366225.7
130356,202307,915,433,482,571566.25,636243.47,1207809.72
130360,202307,109,86,23,113520.2,30360,143880.2
130370,202307,699,559,140,737882.96,184800,922682.96
130380,202307,684,534,150,704883.34,198000.95,902884.29
130390,202307,504,415,89,547800,117480,665280
130395,202307,177,71,106,93720.5,139920,233640.5
130400,202307,103,79,24,104281.39,31680,135961.39
130406,202307,2334,1355,979,1788616.79,1292283.75,3080900.54
130410,202307,497,279,218,368280,287760,656040
130420,202307,2928,2392,536,3157534.56,708842.28,3866376.84
130423,202307,223,146,77,192721.59,101640,294361.59
130426,202307,195,108,87,142560,114840,257400
130430,202307,459,272,187,359045.86,246840,605885.86
130440,202307,204,71,133,93723.75,175562.8,269286.55
140002,202307,61,19,42,25080.2,55440.6,80520.8
140005,202307,245,142,103,187444.72,135961.5,323406.22
140010,202307,14277,7981,6296,10540693,8314856.51,18855549.51
140015,202307,346,78,268,102962.58,353761.82,456724.40
140017,202307,163,88,75,116166.93,99003.44,215170.37
140020,202307,489,327,162,431655.69,213844.43,645500.12
140023,202307,91,52,39,68640,51480.59,120120.59
140028,202307,25,14,11,19800.84,14521.74,34322.58
140030,202307,445,289,156,381496.01,205921.51,587417.52
140040,202307,89,59,30,77880.6,39600,117480.6
140045,202307,438,118,320,155761.22,423722.83,579484.05
140047,202307,670,421,249,555734.22,328682.27,884416.49
140050,202307,161,99,62,130684.53,81840.94,212525.47
140060,202307,100,69,31,91081.96,40920.2,132002.16
140070,202307,23,22,1,29040.2,1320,30360.2
150010,202307,5582,3388,2194,4472278.84,2900069.54,7372348.38
150013,202307,191,127,64,167640.27,84480.99,252121.26
150020,202307,1238,709,529,935898.48,698281.01,1634179.49
150030,202307,761,361,400,476534.46,528004,1004538.46
150034,202307,229,132,97,174241.49,128040.5,302281.99
150040,202307,1847,1080,767,1425662.21,1015104.51,2440766.72
150050,202307,824,499,325,658686.11,429001.19,1087687.30
150060,202307,5362,3329,2033,4394287.45,2684146.17,7078433.62
150070,202307,244,189,55,249491.38,72601.11,322092.49
150080,202307,20041,9437,10604,12464012.81,14010804.37,26474817.18
150085,202307,529,319,210,422411.31,277203.45,699614.76
150090,202307,839,667,172,880460.4,227041.89,1107502.29
150095,202307,96,68,28,89761.44,36961,126722.44
150100,202307,86,52,34,68640,44881.25,113521.25
150110,202307,211,130,81,171600.69,106920.1,278520.79
150120,202307,420,303,117,399969.68,154441.18,554410.86
150125,202307,47,21,26,27720,34320,62040
150130,202307,2735,1343,1392,1772827.66,1837682.05,3610509.71
150140,202307,66749,28638,38111,37814195.26,50337985.92,88152181.18
150145,202307,296,161,135,212522.66,178200.45,390723.11
150150,202307,4011,1767,2244,2333827.19,2963442.66,5297269.85
150157,202307,397,286,111,377530.68,146521.19,524051.87
150160,202307,184,138,46,182160.74,60720,242880.74
150170,202307,4548,3274,1274,4321790.23,1683017.15,6004807.38
150172,202307,420,296,124,390725.71,163681.2,554406.91
150175,202307,91,50,41,66001,54120.7,120121.7
150178,202307,852,577,275,761662.86,363007.52,1124670.38
150180,202307,4741,2282,2459,3012305.43,3247209.99,6259515.42
150190,202307,429,292,137,385450.31,182162.33,567612.64
150195,202307,147,84,63,110880.3,83160.61,194040.91
150200,202307,221,121,100,159720.08,132000.2,291720.28
150210,202307,3466,2667,799,3520579.22,1056016.12,4576595.34
150215,202307,786,458,328,604582.92,434290.86,1038873.78
150220,202307,3828,2536,1292,3347615.52,1705472.66,5053088.18
150230,202307,1578,1256,322,1659280.86,426367.96,2085648.82
150240,202307,8283,4603,3680,6076192.96,4861655.58,10937848.54
150250,202307,100,60,40,79201.88,52800.92,132002.80
150260,202307,147,102,45,134643.5,59401.78,194045.28
150270,202307,2294,1493,801,1970801.08,1061284.52,3032085.60
150275,202307,603,397,206,524050.13,271921.08,795971.21
150276,202307,127,47,80,62040.2,106921.66,168961.86
150277,202307,945,418,527,551773.83,695655.87,1247429.70
150280,202307,181,177,4,233651.4,5280,238931.4
150285,202307,179,96,83,126723.03,109348.8,236071.83
150290,202307,1432,825,607,1089024.35,801248.69,1890273.04
150293,202307,943,443,500,584780.03,660009.51,1244789.54
150295,202307,651,322,329,425056.06,434282.11,859338.17
150300,202307,117,63,54,83160.1,71280,154440.1
150304,202307,233,141,92,186123.87,121442.96,307566.83
150307,202307,480,393,87,518770.83,114840.5,633611.33
150309,202307,657,469,188,619110.7,249483.8,868594.5
150310,202307,323,221,102,291724.54,134640,426364.54
150320,202307,2093,1454,639,1919313.78,844807.64,2764121.42
150330,202307,2314,1330,984,1755622.23,1298885.35,3054507.58
150340,202307,222,141,81,186121.33,106920.42,293041.75
150345,202307,711,397,314,525368.71,414480.63,939849.34
150350,202307,458,369,89,487109.02,117483.2,604592.22
150360,202307,5628,3299,2329,4356237.5,3076953.69,7433191.19
150370,202307,908,605,303,798633.87,399966.98,1198600.85
150375,202307,208,87,121,114841.6,159720.68,274562.28
150380,202307,1645,1098,547,1450712.77,723364.7,2174077.47
150390,202307,1019,606,413,801274.79,545165.61,1346440.40
150400,202307,136,115,21,151800.4,27720,179520.4
150405,202307,1791,1141,650,1507464.42,858002.72,2365467.14
150410,202307,108,69,39,91080.77,51480.2,142560.97
150420,202307,8662,4691,3971,6195258.72,5244487.77,11439746.49
150430,202307,719,451,268,595365.02,353770.14,949135.16
150440,202307,509,312,197,411855.74,260042.78,671898.52
150442,202307,2715,1453,1262,1919347.03,1665866.8,3585213.83
150445,202307,596,392,204,517446.23,269280.2,786726.43
150450,202307,46,34,12,44881.63,15840.1,60721.73
150460,202307,749,568,181,749791.82,238921.76,988713.58
150470,202307,1375,830,545,1095637.91,719405.95,1815043.86
150475,202307,276,206,70,271929.71,92402.76,364332.47
150480,202307,1599,1130,469,1491671.11,619089.6,2110760.71
150490,202307,630,387,243,510844.01,320760.2,831604.21
150495,202307,388,294,94,388081.07,125400,513481.07
150497,202307,311,201,110,265322.86,146520.3,411843.16
150500,202307,300,177,123,233642.42,162360,396002.42
150503,202307,1581,809,772,1067908.56,1021691.75,2089600.31
150506,202307,966,672,294,887057.8,388081.12,1275138.92
150510,202307,1480,834,646,1100911.91,855367.28,1956279.19
150520,202307,352,237,115,312841.85,151800.92,464642.77
150530,202307,2269,1340,929,1768930.91,1226341.9,2995272.81
150540,202307,251,180,71,237603.44,93720.81,331324.25
150543,202307,991,512,479,675859.57,633607.53,1309467.10
150548,202307,476,341,135,450125.36,179520.9,629646.26
150549,202307,99,68,31,89762.35,40920.26,130682.61
150550,202307,3518,1781,1737,2350991.7,2294183.44,4645175.14
150553,202307,4278,2403,1875,3173414.31,2477682.54,5651096.85
150555,202307,148,83,65,109560.2,85801.99,195362.19
150560,202307,94,47,47,62040.75,62040,124080.75
150563,202307,143,76,67,101645.47,88441.86,190087.33
150565,202307,238,143,95,188761.64,125400.64,314162.28
150570,202307,431,286,145,377521.28,191400,568921.28
150580,202307,1903,984,919,1298891.27,1214401.19,2513292.46
150590,202307,920,618,302,815789.78,398641.58,1214431.36
150600,202307,565,370,195,488413.69,257405.75,745819.44
150610,202307,205,157,48,207243.4,63360,270603.4
150611,202307,167,118,49,155760,64680,220440
150613,202307,3809,2128,1681,2809053.01,2223002.5,5032055.51
150616,202307,648,346,302,456727.69,398643.2,855370.89
150618,202307,1511,780,731,1030929.25,964921.89,1995851.14
150619,202307,448,342,106,451445.63,139925.07,591370.70
150620,202307,1426,820,606,1082429.54,801245.38,1883674.92
150630,202307,204,134,70,176889.19,92401.23,269290.42
150635,202307,535,254,281,336610.12,370924.33,707534.45
150640,202307,53,24,29,31681.91,38280,69961.91
150650,202307,2666,1534,1132,2024966.95,1495596.19,3520563.14
150655,202307,301,212,89,279840.42,117480,397320.42
150658,202307,70,43,27,56760,35640,92400
150660,202307,705,433,272,571572.1,360363.73,931935.83
150670,202307,1263,466,797,615131.16,1052048.43,1667179.59
150680,202307,12622,6709,5913,8858912.13,7809280.61,16668192.74
150690,202307,46,23,23,30361.14,30360,60721.14
150700,202307,619,416,203,549143.89,267963.81,817107.70
150710,202307,325,189,136,249486.9,179520.61,429007.51
150715,202307,896,572,324,755059.49,427682.82,1182742.31
150720,202307,487,368,119,485769.85,157081.07,642850.92
150730,202307,1274,598,676,789382.03,892328.68,1681710.71
150740,202307,289,185,104,244200.86,137280,381480.86
150745,202307,900,514,386,679822.76,512166.76,1191989.52
150746,202307,81,41,40,54121.55,52800,106921.55
150747,202307,287,198,89,261363.84,117480.3,378844.14
150750,202307,159,89,70,117484.38,92404.08,209888.46
150760,202307,2058,1357,701,1792602.63,927967.28,2720569.91
150770,202307,434,263,171,347161,225720.91,572881.91
150775,202307,104,58,46,76560.48,60720.2,137280.68
150780,202307,233,139,94,183481.92,124080,307561.92
150790,202307,770,462,308,609852.86,409203.33,1019056.19
150795,202307,1921,1175,746,1551027.77,984731.89,2535759.66
150796,202307,337,192,145,253442.3,191401.28,444843.58
150797,202307,475,232,243,306249.08,320761.99,627011.07
150800,202307,1812,1004,808,1325299.32,1067883.52,2393182.84
150803,202307,387,292,95,385454.76,125400.41,510855.17
150805,202307,234,143,91,188762.33,120120,308882.33
150808,202307,1217,592,625,781444.14,826322.89,1607767.03
150810,202307,3422,2307,1115,3045331.24,1471808.15,4517139.39
150812,202307,586,310,276,409207.66,364321.98,773529.64
150815,202307,1392,865,527,1141812.68,695643.43,1837456.11
150820,202307,1901,1138,763,1502216.93,1007178.48,2509395.41
150830,202307,620,469,151,619097.77,199321.1,818418.87
150835,202307,264,167,97,220443.43,128040,348483.43
150840,202307,1589,913,676,1205196.67,893651.03,2098847.70
160005,202307,73,49,24,64680.99,31680.12,96361.11
160010,202307,231,141,90,186126.3,118800.47,304926.77
160015,202307,183,124,59,163691.89,77881.51,241573.40
160020,202307,161,81,80,106921.53,105600,212521.53
160021,202307,72,38,34,50162.12,44880.81,95042.93
160023,202307,85,56,29,73922.4,38280.14,112202.54
160025,202307,31,16,15,21121.25,19800.12,40921.37
160027,202307,1613,901,712,1189374.72,939846.93,2129221.65
160030,202307,19332,10116,9216,13360288.16,12171933.99,25532222.15
160040,202307,403,259,144,341890.84,190081.29,531972.13
160050,202307,875,384,491,506897,649451.14,1156348.14
160053,202307,329,200,129,264010.67,170283.46,434294.13
160055,202307,29,21,8,27721.27,10560.9,38282.17
160060,202307,7518,4188,3330,5529749.58,4398332.5,9928082.08
160070,202307,198,116,82,153124.27,108241.07,261365.34
160080,202307,163,86,77,113520.22,101640.28,215160.50
170025,202307,25,14,11,18480,14520.2,33000.2
170030,202307,174,141,33,186127.04,43560,229687.04
170035,202307,211,106,105,141244.23,138601.86,279846.09
170040,202307,189,141,48,186120,63360,249480
170070,202307,342,217,125,286449.2,165000.54,451449.74
170100,202307,366,264,102,348491.46,134640.3,483131.76
170105,202307,40,34,6,44881.39,7920,52801.39
170110,202307,115,72,43,95040.49,56760.1,151800.59
170130,202307,88,45,43,59400,56760,116160
170190,202307,105,62,43,81840.39,56760,138600.39
170200,202307,364,248,116,327363.43,153120,480483.43
170210,202307,7325,4080,3245,5388073.93,4288722.02,9676795.95
170215,202307,162,102,60,134643.72,79201.39,213845.11
170220,202307,1388,988,400,1304187.2,529325.9,1833513.1
170230,202307,162,113,49,149163.8,64680.3,213844.1
170240,202307,511,357,154,471263.29,203282.72,674546.01
170255,202307,1047,816,231,1077139.48,304921.95,1382061.43
170270,202307,53,38,15,50160,19800,69960
170290,202307,152,96,56,126721.46,73920,200641.46
170300,202307,118,80,38,105600.54,50160,155760.54
170305,202307,58,43,15,56760.8,19800,76560.8
170307,202307,58,43,15,56761.26,19800.9,76562.16
170310,202307,128,86,42,113521.67,55440,168961.67
170320,202307,44,30,14,39600.2,18480,58080.2
170330,202307,37,27,10,35641.07,13200.1,48841.17
170360,202307,38,24,14,31680.39,18481.41,50161.80
170370,202307,84,51,33,67321.39,43560.2,110881.59
170380,202307,88,67,21,88441.34,27720,116161.34
170382,202307,40,33,7,43560,9240,52800
170384,202307,155,117,38,154440.43,50160.89,204601.32
170386,202307,74,33,41,43560.61,54120,97680.61
170388,202307,45,23,22,30360.23,30360,60720.23
170389,202307,28,21,7,27720.4,9240,36960.4
170390,202307,91,52,39,68640.65,51480.25,120120.90
170410,202307,26,23,3,30362.04,3960,34322.04
170460,202307,13,8,5,10560.22,6600,17160.22
170510,202307,35,26,9,34322.29,11880,46202.29
170550,202307,1685,991,694,1308152.06,916089.06,2224241.12
170555,202307,123,90,33,118804.88,43560,162364.88
170560,202307,103,77,26,101640.71,34320.43,135961.14
170600,202307,42,16,26,21121.36,34320.7,55442.06
170610,202307,202,115,87,151803.92,114840.1,266644.02
170625,202307,35,21,14,27720.99,18480,46200.99
170650,202307,108,76,32,100320.68,42240.2,142560.88
170700,202307,616,458,158,605887.31,208560,814447.31
170710,202307,143,85,58,112204.04,76562.24,188766.28
170720,202307,120,93,27,122760.81,35640,158400.81
170730,202307,126,74,52,97681.76,68640,166321.76
170740,202307,91,68,23,89760,30360,120120
170755,202307,49,28,21,36961.89,27720.76,64682.65
170765,202307,140,85,55,112203.63,72600.86,184804.49
170770,202307,195,127,68,167642.05,89760.73,257402.78
170820,202307,632,425,207,561009.45,273240.62,834250.07
170825,202307,58,31,27,40920.3,35640,76560.3
170830,202307,99,76,23,100320.06,30360.33,130680.39
170900,202307,180,138,42,182163.18,55440.91,237604.09
170930,202307,1080,606,474,801266.62,628326.77,1429593.39
170950,202307,3576,1765,1811,2331180.4,2393181.38,4724361.78
170980,202307,15,10,5,13200.83,6600,19800.83
171050,202307,162,124,38,163680,50160.2,213840.2
171070,202307,62,49,13,64680.89,17160.95,81841.84
171090,202307,52,40,12,52800,15840,68640
171110,202307,26,19,7,25081.2,9240,34321.2
171150,202307,49,34,15,44880,19800,64680
171180,202307,28,15,13,19800,17161.12,36961.12
171190,202307,210,118,92,155763.3,121440,277203.3
171195,202307,61,52,9,68641.4,11880,80521.4
171200,202307,31,14,17,18480.51,22440,40920.51
171215,202307,13,10,3,13200,3960,17160
171240,202307,64,51,13,67320,17160,84480
171245,202307,58,49,9,64681.13,11880,76561.13
171250,202307,86,51,35,67320.2,46200,113520.2
171270,202307,14,9,5,11880.1,6600.22,18480.32
171280,202307,51,41,10,54121.32,13200.1,67321.42
171320,202307,1145,675,470,891014.44,620401.67,1511416.11
171330,202307,477,251,226,331322.3,298320.21,629642.51
171360,202307,113,81,32,106920.62,42240,149160.62
171370,202307,40,24,16,31680,21120.18,52800.18
171380,202307,138,118,20,155761.52,26400,182161.52
171395,202307,44,27,17,35640,22440,58080
171420,202307,275,180,95,237601.46,125400.2,363001.66
171430,202307,74,59,15,77880.2,19800.95,97681.15
171488,202307,226,131,95,172920.7,125400,298320.7
171500,202307,70,42,28,55440.2,36960,92400.2
171510,202307,78,53,25,69960,33000.52,102960.52
171515,202307,43,36,7,47523.13,9240,56763.13
171525,202307,27,24,3,31682.26,3960,35642.26
171550,202307,17,11,6,14520.9,7920,22440.9
171570,202307,60,32,28,42240,36960.1,79200.1
171575,202307,262,178,84,234960.95,110880,345840.95
171610,202307,2156,1128,1028,1488988.79,1356985.26,2845974.05
171620,202307,167,122,45,162360.9,59400.61,221761.51
171630,202307,53,31,22,40920,29040,69960
171650,202307,365,255,110,336611.46,145201.62,481813.08
171660,202307,273,158,115,208567.61,151800.7,360368.31
171665,202307,93,58,35,76561.47,46200.33,122761.80
171670,202307,465,300,165,396007.67,219123.05,615130.72
171700,202307,69,56,13,73920.6,17160,91080.6
171720,202307,26,9,17,11880.7,22440.2,34320.9
171750,202307,110,59,51,77880,67320.7,145200.7
171780,202307,83,63,20,83160.83,26400,109560.83
171790,202307,106,85,21,112200,27720,139920
171800,202307,33,25,8,33000,10560,43560
171820,202307,2272,1335,937,1762243.34,1236844.62,2999087.96
171830,202307,38,30,8,39600.2,10560,50160.2
171840,202307,54,35,19,46200.54,25080,71280.54
171845,202307,36,25,11,33000.88,14520,47520.88
171850,202307,52,42,10,55440.91,13200.49,68641.40
171855,202307,70,51,19,67320.1,25080,92400.1
171865,202307,5,3,2,3960,2640,6600
171870,202307,37,25,12,33000.2,15840.45,48840.65
171875,202307,92,69,23,91080,30360,121440
171880,202307,47,29,18,38280,23760.25,62040.25
171884,202307,59,32,27,42240.8,35640,77880.8
171886,202307,138,66,72,87121.07,96360,183481.07
171888,202307,28,21,7,27721.96,9240.1,36962.06
171889,202307,16,8,8,10560,10560,21120
171890,202307,64,51,13,67320.11,17160,84480.11
171900,202307,25,17,8,22440.2,10560,33000.2
172000,202307,36,32,4,42240.2,5280.2,47520.4
172010,202307,59,42,17,55440,22440.22,77880.22
172015,202307,20,15,5,19801.76,6600,26401.76
172020,202307,126,77,49,101640.86,64680,166320.86
172025,202307,43,27,16,35640.46,21120,56760.46
172030,202307,62,38,24,50161.12,31680,81841.12
172049,202307,89,59,30,78496.3,39600.64,118096.94
172065,202307,119,79,40,104282.94,52800.46,157083.40
172080,202307,134,81,53,106921.84,72601.19,179523.03
172085,202307,32,17,15,22440,19800,42240
172090,202307,490,354,136,467288.93,179520.94,646809.87
172093,202307,17,15,2,19800,2640,22440
172097,202307,17,8,9,10560,11880,22440
172100,202307,6783,4005,2778,5288064.31,3669650.56,8957714.87
172110,202307,86,60,26,79201.01,34320,113521.01
172120,202307,1824,1502,322,1982715.98,425045.91,2407761.89
172125,202307,17,12,5,15840,6600,22440
172130,202307,33,21,12,27720.59,15840.28,43560.87
172208,202307,211,136,75,180840,100321.38,281161.38
172210,202307,364,185,179,244206.64,236281.19,480487.83
210005,202307,3243,2078,1165,2743084.79,1539144.94,4282229.73
210010,202307,149,102,47,134641.29,62040,196681.29
210015,202307,47,34,13,44881.06,17160,62041.06
210020,202307,408,248,160,327367.98,211202.58,538570.56
210030,202307,325,221,104,291745.45,137283.88,429029.33
210040,202307,119,99,20,130680.1,26400,157080.1
210043,202307,280,233,47,307565.21,62040,369605.21
210047,202307,499,324,175,427681.76,231000,658681.76
210050,202307,279,194,85,256080,112200.2,368280.2
210055,202307,60,50,10,66001.01,13200,79201.01
210060,202307,560,458,102,604589.34,134642.81,739232.15
210070,202307,501,387,114,510840.7,150480.32,661321.02
210080,202307,147,137,10,180841.48,13200,194041.48
210083,202307,295,155,140,204600.99,184800.19,389401.18
210087,202307,11,6,5,7920,6600,14520
210090,202307,511,373,138,492383.72,182162.82,674546.54
210095,202307,426,345,81,455409.6,106920.42,562330.02
210100,202307,723,579,144,764293.66,190080.2,954373.86
210110,202307,119,83,36,109560.91,47520.9,157081.81
210120,202307,4883,3964,919,5234041.39,1214416.97,6448458.36
210125,202307,196,128,68,168962.26,89761.74,258724.00
210130,202307,463,292,171,385450.8,225720.89,611171.69
210135,202307,35,26,9,34320.93,11880,46200.93
210140,202307,4784,3643,1141,4808901.98,1506137.93,6315039.91
210150,202307,389,256,133,337932.17,175562.62,513494.79
210160,202307,3312,2826,486,3730411.75,641526.28,4371938.03
210170,202307,1324,1078,246,1423017.13,324721.05,1747738.18
210173,202307,130,120,10,158401.48,13200,171601.48
210177,202307,292,169,123,223081.35,162360,385441.35
210180,202307,34,18,16,23760.2,21120,44880.2
210190,202307,470,324,146,427680.99,192720.7,620401.69
210193,202307,8,6,2,7920.59,2640,10560.59
210197,202307,68,50,18,66000.3,23760.2,89760.5
210200,202307,633,542,91,715465.29,120120.39,835585.68
210203,202307,246,179,67,236282.35,88441.12,324723.47
210207,202307,321,276,45,364323.18,59400,423723.18
210210,202307,733,684,49,902892.58,64680.6,967573.18
210215,202307,81,73,8,96362.88,10560,106922.88
210220,202307,356,308,48,406575.99,63360.01,469936.00
210230,202307,337,274,63,361685.74,83160,444845.74
210232,202307,1236,909,327,1199909.63,431642.01,1631551.64
210235,202307,188,143,45,188764.2,60720.4,249484.6
210237,202307,58,30,28,39602.09,36960,76562.09
210240,202307,81,71,10,93720.7,13200.21,106920.91
210250,202307,197,172,25,227041.13,33000.2,260041.33
210255,202307,414,308,106,406575.06,139921.08,546496.14
210260,202307,396,289,107,381483.02,141240,522723.02
210270,202307,640,465,175,613812.5,231001.66,844814.16
210275,202307,114,91,23,120120.91,30360,150480.91
210280,202307,1129,750,379,990017.67,500282.95,1490300.62
210290,202307,555,376,179,496330.51,236281.49,732612.00
210300,202307,4993,3301,1692,4360050.92,2236085.99,6596136.91
210310,202307,129,84,45,110880.2,59400,170280.2
210312,202307,120,90,30,118802.28,39600,158402.28
210315,202307,130,112,18,147840.18,23760,171600.18
210317,202307,151,118,33,155760.57,43560,199320.57
210320,202307,2531,2189,342,2889563.87,451441.04,3341004.91
210325,202307,156,92,64,121441.14,84480.56,205921.70
210330,202307,4204,2536,1668,3347588.83,2201763.35,5549352.18
210340,202307,1235,961,274,1268568.47,363003.74,1631572.21
210350,202307,707,597,110,789377.46,145200,934577.46
210355,202307,156,133,23,176880.2,30360,207240.2
210360,202307,2053,1515,538,1999849.56,710163.19,2710012.75
210370,202307,1262,679,583,896299.02,770885.06,1667184.08
210375,202307,194,94,100,124089.8,132001.48,256091.28
210380,202307,751,595,156,785409.42,205920.97,991330.39
210390,202307,200,168,32,221763.28,42240,264003.28
210400,202307,433,384,49,506894.06,64680,571574.06
210405,202307,1170,832,338,1098267.74,446161.76,1544429.50
210407,202307,74,63,11,83160,14520,97680
210408,202307,51,47,4,62041.18,5280,67321.18
210409,202307,357,313,44,413163.89,58080.98,471244.87
210410,202307,456,369,87,487081.95,114840,601921.95
210420,202307,213,173,40,228362.84,52800.32,281163.16
210430,202307,63,46,17,60720.5,22440,83160.5
210440,202307,374,258,116,340570.21,153120,493690.21
210450,202307,111,98,13,129362.37,17160,146522.37
210455,202307,255,133,122,175565.66,161042.65,336608.31
210460,202307,325,224,101,295687.89,133320.25,429008.14
210462,202307,79,65,14,85801.64,18480.33,104281.97
210465,202307,128,104,24,137280.91,31680,168960.91
210467,202307,586,450,136,594015.16,179520.5,773535.66
210470,202307,42,37,5,48840,6600,55440
210480,202307,1411,1037,374,1368879.59,493685.26,1862564.85
210490,202307,179,128,51,168962.55,67320.2,236282.75
210500,202307,516,343,173,452779.81,228362.32,681142.13
210510,202307,535,440,95,580803.8,125402.12,706205.92
210515,202307,332,226,106,298323.73,139920.2,438243.93
210520,202307,401,366,35,483128.98,46200.36,529329.34
210530,202307,10206,5191,5015,6856418.23,6622623.81,13479042.04
210535,202307,124,98,26,129361.8,34320,163681.8
210540,202307,1615,1119,496,1477131.51,654724.61,2131856.12
210542,202307,1092,569,523,751102.13,690373.52,1441475.65
210545,202307,23,21,2,27720.71,2640,30360.71
210547,202307,128,114,14,150482.41,18480.31,168962.72
210550,202307,611,437,174,576865.4,231001.71,807867.11
210560,202307,167,147,20,194042.05,26400.33,220442.38
210565,202307,31,22,9,29040.89,11880.25,40921.14
210570,202307,1323,1129,194,1490314.8,256081.34,1746396.14
210580,202307,131,116,15,153120.78,19800.16,172920.94
210590,202307,678,575,103,759002.95,135960,894962.95
210592,202307,52,46,6,60720,7920,68640
210594,202307,117,102,15,134641.1,19800,154441.1
210596,202307,120,107,13,141241.81,17160,158401.81
210598,202307,140,108,32,142560.9,42240.2,184801.1
210600,202307,304,264,40,348490.61,52800.7,401291.31
210610,202307,260,242,18,319445.34,23760.26,343205.60
210620,202307,44,31,13,40920.92,17160,58080.92
210630,202307,93,85,8,112201.4,10560,122761.4
210632,202307,989,714,275,942484.87,363000,1305484.87
210635,202307,28,24,4,31680.9,5280.2,36961.1
210637,202307,115,85,30,112200.2,39600,151800.2
210640,202307,577,519,58,685084.03,76560,761644.03
210650,202307,416,355,61,468608.73,80520.7,549129.43
210660,202307,390,310,80,409222.37,105602.1,514824.47
210663,202307,87,70,17,92400.56,22440,114840.56
210667,202307,89,49,40,64681.52,52800.67,117482.19
210670,202307,266,237,29,312845.55,38280,351125.55
210675,202307,488,295,193,389411.45,254762.49,644173.94
210680,202307,235,157,78,207242.42,102960,310202.42
210690,202307,112,98,14,129361.04,18480,147841.04
210700,202307,153,116,37,153120.4,48840.2,201960.6
210710,202307,269,170,99,224401.23,130680.6,355081.83
210720,202307,134,121,13,159720.08,17160,176880.08
210725,202307,66,56,10,73925.4,13200,87125.4
210730,202307,21,14,7,18480,9240,27720
210735,202307,293,215,78,283801.13,102960,386761.13
210740,202307,520,456,64,601946.09,84480,686426.09
210745,202307,167,132,35,174240.52,46200,220440.52
210750,202307,2907,1612,1295,2129214.66,1709416.24,3838630.90
210760,202307,261,206,55,271922.19,72600.19,344522.38
210770,202307,249,207,42,273257.47,55442.24,328699.71
210780,202307,418,319,99,421094.53,130681.29,551775.82
210790,202307,204,175,29,231003.69,38280,269283.69
210800,202307,186,144,42,191411.98,55440.55,246852.53
210805,202307,70,63,7,83160,9240,92400
210810,202307,438,364,74,480498.08,97680,578178.08
210820,202307,1982,1687,295,2228234.84,389403.43,2617638.27
210825,202307,157,100,57,132002.08,75240.2,207242.28
210830,202307,707,507,200,669247.84,264001.93,933249.77
210840,202307,207,156,51,205921.34,67320,273241.34
210845,202307,232,181,51,238923.43,67320,306243.43
210850,202307,717,527,190,695667.94,250802.66,946470.60
210860,202307,3496,2169,1327,2863137.81,1751647.7,4614785.51
210870,202307,399,317,82,418457.48,108240.2,526697.68
210880,202307,94,78,16,102961.59,21120,124081.59
210890,202307,321,285,36,376214.92,47520,423734.92
210900,202307,729,469,260,619100.02,343203.91,962303.93
210905,202307,75,42,33,55440.2,43560,99000.2
210910,202307,2132,1611,521,2126575.37,687728.59,2814303.96
210920,202307,143,68,75,89761.83,99000,188761.83
210923,202307,78,63,15,83161.43,19800,102961.43
210927,202307,421,227,194,299641.8,256080.2,555722.0
210930,202307,89,78,11,102960.4,14520,117480.4
210940,202307,80,64,16,84482.19,21120,105602.19
210945,202307,214,129,85,170281.91,112200,282481.91
210950,202307,524,389,135,513484.91,178200.65,691685.56
210955,202307,101,62,39,81841.25,51480.9,133322.15
210960,202307,2518,1325,1193,1749016.93,1576084.28,3325101.21
210970,202307,109,92,17,121440.82,22440.9,143881.72
210975,202307,75,72,3,95040.79,3960.36,99001.15
210980,202307,1061,554,507,731299.98,669242.67,1400542.65
210990,202307,4537,3259,1278,4302007.05,1688302.01,5990309.06
211000,202307,1343,1103,240,1456003.12,316803.06,1772806.18
211003,202307,966,730,236,963615.6,312840.56,1276456.16
211010,202307,502,452,50,596648.38,66000.29,662648.67
211020,202307,1368,659,709,869902.3,939859.09,1809761.39
211023,202307,41,35,6,46201,7920,54121
211027,202307,85,66,19,87120.78,25080,112200.78
211030,202307,373,271,102,357722.01,134640.5,492362.51
211040,202307,304,262,42,345842.44,55440,401282.44
211050,202307,1168,822,346,1085072.63,456722.29,1541794.92
211060,202307,641,570,71,752432.1,93720.4,846152.5
211065,202307,27,22,5,29043.97,6600.03,35644.00
211070,202307,842,710,132,937241.45,174241.57,1111483.02
211080,202307,89,87,2,114841.02,2640,117481.02
211085,202307,65,35,30,46200,39600,85800
211090,202307,93,82,11,108244.17,14520,122764.17
211100,202307,476,405,71,534614.63,93720.2,628334.83
211102,202307,230,171,59,225720.4,77880,303600.4
211105,202307,228,167,61,220440,80520.26,300960.26
211107,202307,128,83,45,109560,59400,168960
211110,202307,1005,690,315,910826.34,415804.67,1326631.01
211120,202307,5429,3017,2412,3983970.62,3183880.94,7167851.56
211125,202307,26,18,8,23760,10560,34320
211130,202307,43420,21594,21826,28510593.56,28829204.54,57339798.10
211140,202307,361,324,37,427697.14,48840.47,476537.61
211150,202307,1240,901,339,1189357.69,447483.7,1636841.39
211153,202307,174,105,69,138600,91080.2,229680.2
211157,202307,72,60,12,79200,15840,95040
211160,202307,698,589,109,777491.29,143880.9,921372.19
211163,202307,3,2,1,2640,1320,3960
211167,202307,10,10,0,13200,,13200.0
211170,202307,423,322,101,425042.55,133321.35,558363.90
211172,202307,98,73,25,96360.99,33000,129360.99
211174,202307,29,17,12,22440,15840.33,38280.33
211176,202307,467,345,122,455406.57,161042.25,616448.82
211178,202307,98,68,30,89761.82,39600,129361.82
211180,202307,214,178,36,234962.04,47520,282482.04
211190,202307,74,66,8,87120.2,10560,97680.2
211195,202307,47,34,13,44884.57,17160,62044.57
211200,202307,148,123,25,162361.29,33000,195361.29
211210,202307,402,306,96,403929.69,126720.59,530650.28
211220,202307,4584,2789,1795,3682989.65,2374895.14,6057884.79
211223,202307,141,129,12,170283.89,15840,186123.89
211227,202307,62,46,16,60720.2,21120,81840.2
211230,202307,726,604,122,797316.17,161042.47,958358.64
211240,202307,379,322,57,425043.97,76560,501603.97
211245,202307,189,105,84,138602.82,110880.2,249483.02
211250,202307,1485,1282,203,1692318.99,267964.47,1960283.46
211260,202307,817,704,113,929289.99,149160,1078449.99
211270,202307,1851,1558,293,2056601.91,386761.63,2443363.54
211280,202307,1825,1295,530,1709432.41,699600.75,2409033.16
211285,202307,231,154,77,204600.83,101640,306240.83
211290,202307,829,601,228,793326.82,300960.54,1094287.36
211300,202307,782,640,142,844821.6,187441.16,1032262.76
211400,202307,1583,1060,523,1400554.29,691681.94,2092236.23
220005,202307,23,21,2,27720,2640,30360
220010,202307,79,67,12,88440.96,15840,104280.96
220020,202307,774,634,140,836891.24,184801.29,1021692.53
220025,202307,111,105,6,138601.04,7920,146521.04
220027,202307,61,49,12,64680.2,15840,80520.2
220030,202307,139,113,26,149160.99,34320,183480.99
220040,202307,1364,1054,310,1391307.86,409203.33,1800511.19
220045,202307,30,23,7,30362.3,9240.4,39602.7
220050,202307,690,582,108,768182.04,143880.94,912062.98
220060,202307,193,169,24,223086.42,31680.35,254766.77
220070,202307,114,100,14,132003,18480.7,150483.7
220080,202307,14,12,2,15840.22,2640,18480.22
220090,202307,45,32,13,42240.78,17160,59400.78
220095,202307,3,2,1,2640,1320,3960
220100,202307,24,20,4,26400.71,5280,31680.71
220105,202307,33,30,3,39600.95,3960,43560.95
220110,202307,271,247,24,326042.48,31680,357722.48
220115,202307,52,44,8,58080,10560,68640
220117,202307,25,23,2,30360,2640,33000
220120,202307,1578,1240,338,1638150.09,446160.2,2084310.29
220130,202307,30,29,1,38280,1320,39600
220140,202307,88,75,13,99001.1,17160.96,116162.06
220150,202307,511,387,124,510863.5,163683.67,674547.17
220155,202307,27,26,1,34320.36,1320,35640.36
220157,202307,25,22,3,29041.49,3960,33001.49
220160,202307,111,99,12,130680.7,15840,146520.7
220170,202307,49,39,10,51480,13200,64680
220173,202307,21,18,3,23760,3960,27720
220177,202307,20,20,0,26400.4,,26400.4
220180,202307,67,64,3,84481.48,3960,88441.48
220190,202307,1237,1062,175,1401867.79,231004.69,1632872.48
220191,202307,39,35,4,46201.11,5280,51481.11
220192,202307,96,89,7,117481.64,9240,126721.64
220194,202307,59,53,6,69960.72,7920,77880.72
220196,202307,81,68,13,89764.22,17160.2,106924.42
220198,202307,2,2,0,2640,,2640.0
220200,202307,416,359,57,473904.37,75240.61,549144.98
220202,202307,37,32,5,42241.17,6600,48841.17
220205,202307,70,62,8,81840.2,10560,92400.2
220207,202307,16,16,0,21120.92,,21120.92
220208,202307,72,46,26,60720.27,34320.2,95040.47
220209,202307,35,30,5,39600,6600,46200
220210,202307,33,28,5,36960,6600,43560
220211,202307,37,36,1,47524.46,1320,48844.46
220213,202307,38,34,4,44881,5280,50161
220217,202307,43,34,9,44880.3,11880,56760.3
220220,202307,2498,1680,818,2217638.63,1081092.31,3298730.94
220225,202307,12,7,5,9240.58,6600,15840.58
220230,202307,1040,785,255,1036220.64,336606.29,1372826.93
220240,202307,169,151,18,199321.43,23760.54,223081.97
220245,202307,49,46,3,60721.41,3960,64681.41
220250,202307,154,129,25,170281.92,33000,203281.92
220253,202307,53,47,6,62040.25,7920,69960.25
220255,202307,52,45,7,59400.2,9240,68640.2
220260,202307,732,562,170,741854.29,224401.62,966255.91
220265,202307,20,17,3,22440,3960,26400
220270,202307,900,810,90,1069213.08,120120.72,1189333.80
220271,202307,42,32,10,42241.83,13200,55441.83
220272,202307,21,21,0,27720.7,,27720.7
220273,202307,17,16,1,21120.4,1320,22440.4
220275,202307,67,58,9,76560,11880,88440
220277,202307,36,28,8,36960.9,10560.44,47521.34
220280,202307,23,18,5,23760,6600,30360
220285,202307,49,45,4,59400.77,5280,64680.77
220290,202307,1608,1378,230,1821575.37,304923.53,2126498.90
220300,202307,46,44,2,58082.39,2640,60722.39
220310,202307,359,304,55,401295.2,72602.45,473897.65
220320,202307,481,440,41,580825.31,54121.68,634946.99
220323,202307,2,1,1,1320.8,1320,2640.8
220325,202307,9,8,1,10560,1320,11880
220327,202307,17,17,0,22440.67,,22440.67
220330,202307,218,156,62,205920.56,81840,287760.56
220335,202307,137,118,19,155761.12,25080,180841.12
220340,202307,57,44,13,58080,17160.1,75240.1
220342,202307,56,49,7,64683.19,9240,73923.19
220345,202307,93,82,11,108240.46,14520.03,122760.49
220350,202307,479,419,60,553083.53,79200.05,632283.58
220360,202307,50,34,16,44880,21120,66000
220370,202307,1428,1196,232,1580075.03,307560.4,1887635.43
220375,202307,23,22,1,29041.65,1320,30361.65
220380,202307,26,20,6,26401.4,7920,34321.4
220385,202307,17,15,2,19800,2640.66,22440.66
220390,202307,2552,1415,1137,1867864.56,1500866.27,3368730.83
220400,202307,37,31,6,40920,7920,48840
220410,202307,24,23,1,30360.2,1320,31680.2
220415,202307,14,12,2,15841.16,2640,18481.16
220420,202307,135,114,21,150480.78,27720,178200.78
220430,202307,160,141,19,186125.64,25080.2,211205.84
220435,202307,27,21,6,27720.72,7920,35640.72
220440,202307,301,257,44,339256.97,58080,397336.97
220450,202307,376,193,183,254767.86,241567.39,496335.25
220455,202307,56,54,2,71281.39,2640,73921.39
220460,202307,22,21,1,27721.7,1320.26,29041.96
220465,202307,69,49,20,64680.87,26400.41,91081.28
220470,202307,246,217,29,286447.28,38280.86,324728.14
220480,202307,66,61,5,80520.54,6600,87120.54
220490,202307,88,75,13,99000,17160,116160
220500,202307,131,110,21,145200.93,27720,172920.93
220510,202307,369,288,81,380172.57,106920.88,487093.45
220515,202307,30,27,3,35641.2,3960,39601.2
220520,202307,397,349,48,460690.83,63361.26,524052.09
220525,202307,11,6,5,7920.38,6600.92,14521.30
220527,202307,14,14,0,18480.38,,18480.38
220530,202307,50,23,27,30360,35640.87,66000.87
220535,202307,4,4,0,5280.74,,5280.74
220540,202307,116,102,14,134641.2,18480.2,153121.4
220545,202307,25,18,7,23761,9240.8,33001.8
220550,202307,792,630,162,831628.01,213842.24,1045470.25
220551,202307,14,12,2,15840,2640,18480
220552,202307,15,15,0,19800,,19800.0
220553,202307,67,62,5,81840.85,6600,88440.85
220554,202307,5,3,2,3960.95,2640,6600.95
220555,202307,51,40,11,52802.02,14520,67322.02
220556,202307,39,36,3,47521.04,3960,51481.04
220557,202307,67,62,5,81841.3,6600.74,88442.04
220558,202307,15,8,7,10560,9240.54,19800.54
220559,202307,8,8,0,10560.07,,10560.07
220560,202307,89,58,31,76561,40920,117481
220570,202307,747,473,274,624370.71,361684.24,986054.95
220580,202307,574,529,45,698316.43,59401.8,757718.23
220585,202307,14,11,3,14520.2,3960.37,18480.57
220590,202307,18,16,2,21121.95,2640,23761.95
220595,202307,77,60,17,79200.33,22440,101640.33
220600,202307,22,16,6,21120,7920,29040
220605,202307,35,32,3,42240.2,3960,46200.2
220610,202307,103,87,16,114840,21120,135960
220620,202307,584,504,80,665293.17,105602.09,770895.26
220630,202307,3,2,1,2640,1320,3960
220635,202307,34,31,3,40922.23,3960,44882.23
220640,202307,113,95,18,125400,23760,149160
220650,202307,119,113,6,149160.93,7920,157080.93
220660,202307,94,70,24,92401.85,31680.7,124082.55
220665,202307,17,17,0,22440,,22440.0
220667,202307,30,27,3,35640.26,3960,39600.26
220669,202307,48,42,6,55440.2,7920,63360.2
220670,202307,76,58,18,76560.9,23760,100320.9
220672,202307,83,60,23,79205.69,30361.21,109566.90
220675,202307,30,24,6,31682.23,7920,39602.23
220680,202307,64,55,9,72600.2,11880,84480.2
220690,202307,51,48,3,63360.61,3960,67320.61
220695,202307,29,17,12,22441.19,15840,38281.19
220700,202307,1970,1534,436,2026228.47,575525,2601753.47
220710,202307,11,9,2,11880.2,2640.78,14520.98
220720,202307,115,101,14,133320,18480,151800
220730,202307,36,35,1,46200.01,1320,47520.01
220735,202307,10,8,2,10560,2640,13200
220740,202307,69,60,9,79200.2,11880.91,91081.11
220750,202307,146,121,25,159722.8,33000.18,192722.98
220755,202307,22,21,1,27721.29,1320,29041.29
220760,202307,74,65,9,85801.02,11880,97681.02
220770,202307,6412,3732,2680,4929121.84,3538999.9,8468121.74
220775,202307,14,11,3,14520.7,3960.39,18481.09
220777,202307,26,25,1,33000,1320,34320
220779,202307,6,1,5,1320,6600,7920
220780,202307,986,836,150,1103532.12,198000.69,1301532.81
220785,202307,7,4,3,5280,3960.2,9240.2
220790,202307,1308,1054,254,1391313.23,335287.56,1726600.79
220793,202307,10,7,3,9240,3960,13200
220795,202307,26,25,1,33000.27,1320,34320.27
220800,202307,4243,3241,1002,4281092.9,1322653.13,5603746.03
220810,202307,85,71,14,93721.86,18480,112201.86
220820,202307,261,236,25,311527.84,33001.8,344529.64
220830,202307,1390,1234,156,1628695.45,205921.33,1834616.78
220840,202307,2714,1924,790,2542396.93,1042821.2,3585218.13
220850,202307,85,72,13,95040,17160,112200
220855,202307,9,4,5,5280,6600,11880
220860,202307,17,14,3,18482.9,3960,22442.9
220865,202307,30,27,3,35640.1,3960,39600.1
220870,202307,96,87,9,114841.08,11880,126721.08
220880,202307,354,293,61,386772.37,80521.92,467294.29
220885,202307,30,28,2,36962.75,2640,39602.75
220887,202307,6,5,1,6600.2,1320,7920.2
220890,202307,87,74,13,97681.9,17160,114841.9
220900,202307,29,18,11,23760,14520,38280
220910,202307,51,39,12,51482.13,15840,67322.13
220915,202307,12,10,2,13200,2640,15840
220920,202307,50,45,5,59401.28,6600,66001.28
220930,202307,57,55,2,72600.28,2640,75240.28
220935,202307,18,18,0,23760.97,,23760.97
220937,202307,34,30,4,39600.9,5280,44880.9
220940,202307,69,61,8,80520.3,10560,91080.3
220945,202307,6,6,0,7920.65,,7920.65
220950,202307,39,31,8,40920.2,10560,51480.2
220955,202307,27,25,2,33000.77,2640,35640.77
220960,202307,44,39,5,51480,6600,58080
220965,202307,58,53,5,69960,6600,76560
220970,202307,65,55,10,72600,13200,85800
220975,202307,16,13,3,17160.9,3960,21120.9
220980,202307,29,27,2,35640.76,2640,38280.76
220985,202307,57,49,8,64680,10560,75240
220987,202307,35,34,1,44883.01,1320.28,46203.29
220990,202307,25,23,2,30360,2992,33352
220995,202307,16,14,2,18480,2640,21120
220997,202307,79,71,8,93721.78,10560,104281.78
221000,202307,1376,1216,160,1606481.11,211200.86,1817681.97
221005,202307,47,43,4,56760,5280.82,62040.82
221010,202307,28,20,8,26400,10560,36960
221020,202307,46,41,5,54120.46,6600,60720.46
221030,202307,48,40,8,52696.43,10560,63256.43
221035,202307,22,21,1,27722.23,1320,29042.23
221037,202307,14,10,4,13200,5280,18480
221038,202307,26,23,3,30360,3960,34320
221039,202307,30,29,1,38280.04,1320,39600.04
221040,202307,271,228,43,300965.65,56761.4,357727.05
221050,202307,246,205,41,270610.09,54120.2,324730.29
221060,202307,2118,1818,300,2402449.42,396005.25,2798454.67
221062,202307,31,31,0,42242.18,,42242.18
221063,202307,20,15,5,19800,6600,26400
221065,202307,82,66,16,87122.89,21120,108242.89
221070,202307,171,150,21,198004.16,27720,225724.16
221080,202307,443,375,68,495013.82,89760,584773.82
221090,202307,33,26,7,34322.42,9240,43562.42
221093,202307,54,39,15,51481.2,19800.45,71281.65
221095,202307,5,5,0,6600,,6600.0
221097,202307,13,10,3,13200,3960,17160
221100,202307,29169,17504,11665,23112908.63,15409982.69,38522891.32
221110,202307,1232,958,274,1264605.52,361686.99,1626292.51
221120,202307,625,453,172,597972.5,227040.39,825012.89
221130,202307,1074,870,204,1149738.85,269283.33,1419022.18
221135,202307,36,33,3,43561.09,3960,47521.09
221140,202307,49,43,6,56760.2,7920,64680.2
221150,202307,15,11,4,14520.18,5280,19800.18
221160,202307,19,17,2,22441.39,2640,25081.39
221170,202307,22,21,1,27720,1320,29040
230010,202307,176,152,24,200642.16,31680,232322.16
230015,202307,179,149,30,196680.9,39600,236280.9
230020,202307,2006,1584,422,2090933.66,557052.17,2647985.83
230030,202307,1788,1310,478,1729261.3,630966.49,2360227.79
230040,202307,256,205,51,270601.6,67320,337921.6
230050,202307,262,181,81,238920.45,106920.4,345840.85
230060,202307,193,153,40,201960.69,52800.94,254761.63
230070,202307,339,288,51,380165.16,67320,447485.16
230075,202307,1003,832,171,1098264.4,225725.34,1323989.74
230080,202307,253,207,46,273242.76,60720,333962.76
230090,202307,209,153,56,201961.03,73920,275881.03
230100,202307,3028,1705,1323,2250689.67,1747702.4,3998392.07
230110,202307,3333,2101,1232,2774711.15,1627578.98,4402290.13
230120,202307,1322,1008,314,1330586.06,414483.19,1745069.25
230125,202307,199,159,40,209880.83,52800.44,262681.27
230130,202307,553,478,75,630967.49,100320.2,731287.69
230140,202307,244,200,44,264000.51,58080,322080.51
230150,202307,157,121,36,159721.41,47520.51,207241.92
230160,202307,1041,846,195,1116728.53,257400.82,1374129.35
230170,202307,710,608,102,802581.88,134643.93,937225.81
230180,202307,72,65,7,85800.39,9240,95040.39
230185,202307,464,398,66,525369.04,87121.14,612490.18
230190,202307,2772,2081,691,2748316,912129.37,3660445.37
230195,202307,561,480,81,633617.63,106920,740537.63
230200,202307,507,393,114,518766.5,150480.2,669246.7
230205,202307,435,286,149,377521.17,196680.2,574201.37
230210,202307,1526,1158,368,1529903.95,487080.78,2016984.73
230220,202307,1782,1180,602,1558959.95,795967.06,2354927.01
230230,202307,1108,886,222,1169547.3,293043.87,1462591.17
230240,202307,2341,2050,291,2708693.75,384123.19,3092816.94
230250,202307,2028,1638,390,2162231.65,514808.83,2677040.48
230260,202307,3610,2238,1372,2954195.14,1811045.22,4765240.36
230270,202307,1502,1154,348,1523301.14,459363.94,1982665.08
230280,202307,3133,2404,729,3173376.26,962288.95,4135665.21
230290,202307,377,329,48,435615.01,63360.71,498975.72
230300,202307,560,411,149,542523,196680.29,739203.29
230310,202307,462,350,112,462135.12,147840.91,609976.03
230320,202307,1016,841,175,1110140.98,231000.95,1341141.93
230330,202307,359,290,69,382802.53,91080,473882.53
230340,202307,493,393,100,518768.39,132000.81,650769.20
230350,202307,3767,2287,1480,3020247.83,1953614.99,4973862.82
230360,202307,294,242,52,319445.52,68640.28,388085.80
230365,202307,159,127,32,167642.33,42240,209882.33
230370,202307,12943,6514,6429,8600222.52,8497067.39,17097289.91
230380,202307,566,482,84,636254.86,110882.49,747137.35
230390,202307,574,334,240,440883.46,316800,757683.46
230393,202307,259,210,49,277201.99,64680.5,341882.49
230395,202307,402,320,82,422423.94,108242.59,530666.53
230400,202307,725,574,151,757687.86,201960.2,959648.06
230410,202307,3209,2055,1154,2715309.41,1524618.85,4239928.26
230420,202307,7216,4735,2481,6254433.76,3277657.44,9532091.20
230423,202307,374,323,51,426363.79,67320.1,493683.89
230425,202307,572,455,117,600608.9,154441.24,755050.14
230426,202307,132,106,26,139920.7,34320,174240.7
230427,202307,80,69,11,91080.67,14520,105600.67
230428,202307,1974,951,1023,1255353.61,1351692.52,2607046.13
230430,202307,500,402,98,530651.23,129362.2,660013.43
230435,202307,1028,735,293,970223.81,386761.34,1356985.15
230440,202307,110131,50958,59173,67299321.03,78159900.98,145459222.01
230445,202307,360,242,118,319448.58,155760,475208.58
230450,202307,632,492,140,649444,184800.7,834244.7
230460,202307,119,85,34,112200.49,44880,157080.49
230465,202307,343,276,67,364324.64,88440,452764.64
230470,202307,2228,1746,482,2306064.07,637563.86,2943627.93
230480,202307,159,143,16,188760.5,21121.37,209881.87
230490,202307,369,290,79,382803.26,104280.13,487083.39
230495,202307,550,393,157,518773.16,208562.71,727335.87
230500,202307,1282,955,327,1260611.56,432963.79,1693575.35
230510,202307,84,57,27,75240,35640,110880
230520,202307,453,338,115,446164.49,151800.62,597965.11
230523,202307,2956,1805,1151,2382678.02,1520658.05,3903336.07
230526,202307,270,224,46,295681.59,60720,356401.59
230530,202307,751,530,221,699613.01,291723.16,991336.17
230533,202307,238,217,21,286443.33,27720.2,314163.53
230535,202307,458,340,118,448816.66,155761.15,604577.81
230540,202307,1937,1725,212,2277056.39,281163.73,2558220.12
230550,202307,4664,2948,1716,3891551.54,2267806.73,6159358.27
230560,202307,636,490,146,646810.76,192720.57,839531.33
230565,202307,249,184,65,242880.7,85801.99,328682.69
230570,202307,342,292,50,385442.3,66000.45,451442.75
230580,202307,1357,925,432,1221013.18,570245.16,1791258.34
230590,202307,1212,927,285,1223549.56,376202.06,1599751.62
230600,202307,323,291,32,384129.3,42240,426369.3
230610,202307,530,392,138,517450.3,182160.2,699610.5
230620,202307,188,158,30,208563.01,39600,248163.01
230625,202307,971,650,321,859338.97,423721.29,1283060.26
230630,202307,1643,1215,428,1603836.79,566284.35,2170121.14
230640,202307,4418,3557,861,4696732.07,1136543.71,5833275.78
230650,202307,556,473,83,624365.7,109561.33,733927.03
230655,202307,827,650,177,859350.98,233644.28,1092995.26
230660,202307,426,346,80,456725.02,105600.2,562325.22
230670,202307,530,417,113,550459.23,149161.15,699620.38
230680,202307,250,209,41,275886.41,54120,330006.41
230690,202307,1060,884,176,1166909.75,232321.88,1399231.63
230700,202307,1153,953,200,1259309.92,264001.68,1523311.60
230710,202307,739,674,65,889705.4,85800.8,975506.2
230720,202307,162,138,24,182160,31680.7,213840.7
230725,202307,326,246,80,324723.4,105601.17,430324.57
230730,202307,14457,7615,6842,10053718.73,9043475.32,19097194.05
230740,202307,778,626,152,826342.83,200641.1,1026983.93
230750,202307,919,752,167,993977.3,220440.95,1214418.25
230760,202307,1810,1524,286,2011750.17,377522.63,2389272.80
230763,202307,415,349,66,460683.86,87120,547803.86
230765,202307,10048,4835,5213,6383914.93,6885340.76,13269255.69
230770,202307,5816,3037,2779,4010313.06,3672271.04,7682584.10
230780,202307,891,759,132,1003210.27,174240.1,1177450.37
230790,202307,351,283,68,373560.61,89760.41,463321.02
230800,202307,1348,951,397,1256657.39,524042,1780699.39
230810,202307,1555,1340,215,1768875.07,283805.46,2052680.53
230820,202307,417,271,146,357724.86,192721.27,550446.13
230830,202307,1038,867,171,1144459.8,225720.9,1370180.7
230835,202307,311,255,56,336605.44,73920.68,410526.12
230837,202307,208,165,43,217801.75,56760.83,274562.58
230840,202307,1075,804,271,1061289.77,359042.89,1420332.66
230850,202307,1519,1272,247,1679085.77,327364.26,2006450.03
230860,202307,375,295,80,389404.07,105606.6,495010.67
230870,202307,2015,1695,320,2237439.53,422400.47,2659840.00
230880,202307,90,69,21,91080,27720,118800
230890,202307,631,555,76,732606.5,100321.72,832928.22
230900,202307,347,259,88,341882.54,116160.24,458042.78
230910,202307,247,191,56,252123.03,73920,326043.03
230920,202307,553,428,125,564968.21,165000,729968.21
230930,202307,1268,891,377,1177465.52,500282.14,1677747.66
230940,202307,943,725,218,958338.56,287760.73,1246099.29
230945,202307,635,503,132,663985.32,174245.09,838230.41
230950,202307,486,418,68,553101.78,89760.23,642862.01
230960,202307,3163,2128,1035,2809096.17,1366232.69,4175328.86
230970,202307,2124,1176,948,1552373.28,1251378.81,2803752.09
230980,202307,256,186,70,245522.8,92400,337922.8
230990,202307,152,119,33,157080.5,43560,200640.5
231000,202307,229,211,18,278522.9,23760,302282.9
231010,202307,208,140,68,184802.4,89760,274562.4
231020,202307,1649,1083,566,1429617.4,749774.07,2179391.47
231025,202307,1264,870,394,1148440.43,521413.58,1669854.01
231030,202307,1178,948,230,1252694.69,303602.47,1556297.16
231040,202307,207,146,61,192723.4,80520,273243.4
231050,202307,1037,882,155,1165581.16,204607.46,1370188.62
231060,202307,178,142,36,187444.61,47521,234965.61
231070,202307,1700,1171,529,1545752.99,699607.95,2245360.94
231080,202307,292,255,37,336608.45,48840,385448.45
231085,202307,792,485,307,640217.97,405240.26,1045458.23
231090,202307,290,235,55,310204.41,72601.64,382806.05
231095,202307,176,130,46,171600,60720.65,232320.65
231100,202307,216,172,44,227041.6,58080,285121.6
231110,202307,404,333,71,439570.09,93722.46,533292.55
231120,202307,285,232,53,306244.17,69961.08,376205.25
231123,202307,161,153,8,201963.42,10560,212523.42
231126,202307,369,287,82,380161.09,108240,488401.09
231130,202307,5576,4344,1232,5735625.84,1627586.43,7363212.27
231135,202307,244,212,32,279842.14,42241.41,322083.55
231140,202307,3392,2434,958,3212976.18,1264573.72,4477549.90
231150,202307,434,398,36,525371.78,47521.12,572892.90
231160,202307,1387,1133,254,1498225.98,335280.92,1833506.90
231170,202307,582,403,179,531964.09,237600,769564.09
231180,202307,2168,1870,298,2471108.47,393366.29,2864474.76
231190,202307,258,206,52,271920.54,68640,340560.54
231195,202307,257,209,48,275882.16,63360.07,339242.23
231200,202307,970,771,199,1017744.89,262682.2,1280427.09
231210,202307,562,465,97,613808.46,128041.39,741849.85
231220,202307,1191,832,359,1098265.84,475203.57,1573469.41
231230,202307,1758,1286,472,1697545.34,624361.27,2321906.61
231240,202307,1866,1248,618,1648718.44,818408.81,2467127.25
231250,202307,100,93,7,122760.2,9240,132000.2
231260,202307,288,193,95,254762.15,125402.15,380164.30
231270,202307,1074,818,256,1079789.06,337921.09,1417710.15
231280,202307,92,70,22,92401.49,29040.8,121442.29
231290,202307,9050,5055,3995,6674190.21,5274816.45,11949006.66
231300,202307,651,584,67,770889.11,88440,859329.11
231310,202307,939,854,85,1127294.94,112200.93,1239495.87
231320,202307,704,526,178,694326.34,234961.62,929287.96
231325,202307,112,95,17,125400.18,22440.54,147840.72
231330,202307,2162,1630,532,2152984.39,703569.37,2856553.76
231335,202307,273,241,32,318125.08,42240,360365.08
231340,202307,2191,1480,711,1954965.14,941169.2,2896134.34
231350,202307,1625,1254,371,1655341.53,489734.75,2145076.28
231355,202307,456,375,81,495006.04,106921.24,601927.28
231360,202307,658,439,219,579495.32,289081.94,868577.26
231370,202307,103,87,16,114840,21120,135960
231375,202307,307,229,78,302285.65,102960.1,405245.75
231380,202307,592,467,125,616445.04,165000,781445.04
231390,202307,226,172,54,227041.37,71280,298321.37
231395,202307,855,501,354,662645.54,467280.55,1129926.09
231400,202307,1367,1137,230,1500870.72,303604.41,1804475.13
231410,202307,1581,1275,306,1683030.65,405242.42,2088273.07
240010,202307,435,204,231,269291.02,304929.5,574220.52
240020,202307,2525,2069,456,2731195.32,601929.6,3333124.92
240030,202307,125,97,28,128041.63,36960,165001.63
240040,202307,39,37,2,48840,2640,51480
240050,202307,560,478,82,630992.29,108240.1,739232.39
240060,202307,91,80,11,105601.71,14520,120121.71
240070,202307,319,242,77,319445.09,101640.2,421085.29
240080,202307,646,433,213,571581.83,281167.64,852749.47
240090,202307,113,100,13,132000.32,17160,149160.32
240100,202307,1688,1576,112,2080384.89,147842.38,2228227.27
240110,202307,1161,792,369,1045520.19,488423.14,1533943.33
240120,202307,168,124,44,163681.68,58080.75,221762.43
240130,202307,282,256,26,337933.74,34320.7,372254.44
240140,202307,100,65,35,85801.29,46200.64,132001.93
240145,202307,807,712,95,939873.84,125400.7,1065274.54
240150,202307,31,23,8,30360,10560,40920
240160,202307,38,32,6,42240,7920,50160
240165,202307,40,33,7,43563.26,9240.1,52803.36
240170,202307,179,125,54,165000.92,71280,236280.92
240180,202307,138,100,38,132002.68,50160,182162.68
240185,202307,59,50,9,66000.39,11880,77880.39
240190,202307,15,13,2,17160.43,2640,19800.43
240200,202307,3410,1818,1592,2401142.87,2104101.31,4505244.18
240210,202307,173,129,44,170280.73,58080,228360.73
240220,202307,1269,855,414,1128645.73,546486.42,1675132.15
240230,202307,903,804,99,1061324.44,130680.88,1192005.32
240240,202307,94,62,32,81840.2,42240.69,124080.89
240250,202307,110,94,16,124080.76,21120,145200.76
240260,202307,2127,1491,636,1968182.59,839532.49,2807715.08
240270,202307,184,155,29,204601,38280,242881
240280,202307,74,60,14,79200.2,18480.1,97680.3
240290,202307,43,41,2,54120,2640,56760
240300,202307,186,102,84,134641.78,110880,245521.78
240310,202307,2808,1519,1289,2005143.28,1702824.61,3707967.89
240320,202307,181,166,15,219120.07,19800,238920.07
240325,202307,5609,3100,2509,4094845.1,3314609.38,7409454.48
240330,202307,89,83,6,109560.23,7920,117480.23
240340,202307,125,92,33,121440,43560.59,165000.59
240350,202307,105,83,22,109560.2,29040,138600.2
240360,202307,882,565,317,747153.82,418447.45,1165601.27
240370,202307,69,59,10,77882.65,13201.65,91084.30
240375,202307,48,31,17,40921.59,22441.69,63363.28
240380,202307,230,187,43,246851.69,56760.5,303612.19
240390,202307,17,16,1,21120,1320,22440
240400,202307,90,79,11,104281.38,14520,118801.38
240410,202307,13,10,3,13200,3960,17160
240420,202307,1241,867,374,1144475.95,495008.04,1639483.99
240430,202307,284,254,30,335294.34,39600.2,374894.54
240440,202307,171,101,70,133323.7,92400.97,225724.67
240450,202307,293,177,116,233652.19,153122.23,386774.42
240460,202307,105,83,22,109561.12,29040,138601.12
240470,202307,239,215,24,283818.37,31681.56,315499.93
240480,202307,16,14,2,18480,2640,21120
240485,202307,93,75,18,99000.5,23760,122760.5
240490,202307,71,64,7,84480.21,9240,93720.21
240500,202307,117,92,25,121440,33000,154440
240510,202307,38,28,10,36960,13200,50160
240520,202307,97,92,5,121441.72,6600.61,128042.33
240530,202307,71,53,18,69960,23760,93720
240540,202307,106,90,16,118800.1,21120,139920.1
240550,202307,11,9,2,11880,2640,14520
240560,202307,441,295,146,389411.9,194040.6,583452.5
240570,202307,471,283,188,373568.19,249481.35,623049.54
240580,202307,1507,1085,422,1432241.3,557041.97,1989283.27
240590,202307,32,31,1,40921.12,1320,42241.12
240600,202307,108,101,7,133321.45,9240,142561.45
240610,202307,527,435,92,575547.66,121446.29,696993.95
240615,202307,10,10,0,13200.8,,13200.8
240620,202307,91,86,5,113521.08,6600,120121.08
240630,202307,46,38,8,50160.97,10560.29,60721.26
240640,202307,39,28,11,36960,14520,51480
240650,202307,260,204,56,270601.51,73920.28,344521.79
240660,202307,121,102,19,134640.77,25080,159720.77
240670,202307,332,185,147,244214.24,194049.03,438263.27
240680,202307,58,46,12,60720.67,15840,76560.67
240690,202307,49,47,2,62041.98,2640,64681.98
240700,202307,186,156,30,207240.6,39601.02,246841.62
240710,202307,2562,1525,1037,2014398.17,1370176.49,3384574.66
240720,202307,1151,793,358,1046796.55,472569.02,1519365.57
240725,202307,79,71,8,93721.53,10560.88,104282.41
240730,202307,156,128,28,168960.08,36960.9,205920.98
240740,202307,255,204,51,269291.07,67320.62,336611.69
240750,202307,58,36,22,47520,29040,76560
240760,202307,66,52,14,68640,18480,87120
240770,202307,164,128,36,168961.94,47520.93,216482.87
240780,202307,826,674,152,889705.35,200641.01,1090346.36
240790,202307,41,38,3,50161.98,3960,54121.98
240800,202307,10768,7223,3545,9542915.14,4682226.34,14225141.48
240810,202307,24312,12843,11469,16958926.91,15146024.64,32104951.55
240820,202307,298,183,115,242886.79,151803.81,394690.60
240830,202307,1721,1423,298,1878414.78,394686.27,2273101.05
240840,202307,84,71,13,93720,17160,110880
240850,202307,92,78,14,102960,18480,121440
240860,202307,117,112,5,147842.09,6600.85,154442.94
240870,202307,62,51,11,67323.2,14520,81843.2
240880,202307,35,30,5,39600,6600,46200
240890,202307,1330,743,587,982116.17,776170.04,1758286.21
240895,202307,69,51,18,67320.2,23760.19,91080.39
240910,202307,195,161,34,212522.19,46200.2,258722.39
240920,202307,14,12,2,15842.05,2640,18482.05
240930,202307,456,405,51,534626.21,67321.49,601947.70
240933,202307,66,43,23,56760.95,30360,87120.95
240940,202307,2445,2130,315,2812999.67,415804.63,3228804.30
240950,202307,42,37,5,48840,6600,55440
240960,202307,26,22,4,29040.2,5280.3,34320.5
240970,202307,120,84,36,110880.96,47520,158400.96
240980,202307,224,176,48,232320.9,63360.8,295681.7
240990,202307,154,97,57,128041.43,75240,203281.43
241000,202307,61,55,6,72600.6,7920,80520.6
241010,202307,103,80,23,105600.59,30360,135960.59
241020,202307,115,106,9,139921.79,11880.82,151802.61
241025,202307,22,14,8,18480.6,10560.5,29041.1
241030,202307,123,94,29,124080,38280,162360
241040,202307,48,37,11,48840.1,14520,63360.1
241050,202307,78,72,6,95041.18,7920,102961.18
241060,202307,30,25,5,33000.78,6600,39600.78
241070,202307,25,25,0,33002.73,,33002.73
241080,202307,61,53,8,69960.2,10560,80520.2
241090,202307,59,48,11,63363.55,14520,77883.55
241100,202307,68,61,7,80520.48,9240.28,89760.76
241105,202307,32,20,12,26404.44,15840.73,42245.17
241110,202307,58,45,13,59400.15,17160,76560.15
241120,202307,1882,1416,466,1870484.36,615123.88,2485608.24
241140,202307,219,178,41,234963.77,54120,289083.77
241142,202307,53,41,12,54121.26,15840,69961.26
241150,202307,1255,1086,169,1434886.82,223082.55,1657969.37
241160,202307,31,22,9,29040,11880,40920
241170,202307,57,49,8,64680,10560,75240
241180,202307,51,38,13,50160,17160,67320
241190,202307,42,37,5,48842.4,6600,55442.4
241200,202307,5510,2862,2648,3778050.12,3498114.79,7276164.91
241210,202307,74,62,12,81840.1,15840,97680.1
241220,202307,1720,1078,642,1424346.12,847452.62,2271798.74
241230,202307,274,217,57,286444.7,75240.91,361685.61
241240,202307,54,40,14,52801,18480,71281
241250,202307,1200,1091,109,1441480.59,143883.06,1585363.65
241255,202307,78,63,15,83161.28,19800,102961.28
241260,202307,818,623,195,822377.88,257402.78,1079780.66
241270,202307,79,58,21,76561.23,27720,104281.23
241280,202307,103,89,14,117482.31,18480,135962.31
241290,202307,150,111,39,146523.67,51480.7,198004.37
241300,202307,89,58,31,76560.7,40920.98,117481.68
241310,202307,58,40,18,52801.23,23760.1,76561.33
241320,202307,37,20,17,26401.74,22440,48841.74
241330,202307,63,54,9,71281.01,11880,83161.01
241335,202307,118,104,14,137284.18,18480,155764.18
241340,202307,198,134,64,176880.81,84480,261360.81
241350,202307,66,55,11,72600.59,14520,87120.59
241355,202307,59,48,11,63362.51,14520,77882.51
241360,202307,65,62,3,81840.78,3960,85800.78
241370,202307,74,58,16,76560,21120,97680
241380,202307,37,33,4,43561.5,5280,48841.5
241390,202307,97,78,19,102960,25080,128040
241400,202307,246,181,65,239877.96,85801.01,325678.97
241410,202307,201,182,19,240240.54,25080.8,265321.34
241415,202307,112,89,23,117480.1,30360.8,147840.9
241420,202307,165,99,66,130681.14,87120,217801.14
241430,202307,21,18,3,23760.88,3960,27720.88
241440,202307,579,487,92,642868.64,121443.76,764312.40
241445,202307,49,43,6,56760.2,7920,64680.2
241450,202307,270,226,44,298331.58,58080.44,356412.02
241460,202307,184,168,16,221765.05,21121.09,242886.14
241470,202307,33,27,6,35640.8,7920.43,43561.23
241475,202307,54,50,4,66000,5280,71280
241480,202307,160,116,44,153122.38,59400.2,212522.58
241490,202307,13,11,2,14521.32,2640.1,17161.42
241500,202307,53,40,13,52802.33,18480.02,71282.35
250010,202307,104,88,16,116160.69,21120.66,137281.35
250020,202307,35,30,5,39600,6600,46200
250030,202307,955,714,241,942511.71,318123.49,1260635.20
250040,202307,431,343,88,454098.13,116161.12,570259.25
250050,202307,305,249,56,328682.37,75240.5,403922.87
250053,202307,69,57,12,75240.6,15840,91080.6
250057,202307,4,3,1,3960.2,1320,5280.2
250060,202307,669,483,186,637581.29,246842,884423.29
250070,202307,708,561,147,740539.93,194040.64,934580.57
250073,202307,11,8,3,10560.83,3960.01,14520.84
250077,202307,200,145,55,191401.4,72600.2,264001.6
250080,202307,419,334,85,440889.94,112200.38,553090.32
250090,202307,231,144,87,190081.03,114840,304921.03
250100,202307,633,498,135,657367.19,178201,835568.19
250110,202307,749,535,214,706218.36,283801.68,990020.04
250115,202307,14,4,10,5280.18,13200.26,18480.44
250120,202307,129,94,35,124080.4,46201.92,170282.32
250130,202307,609,503,106,663981.2,139921.26,803902.46
250135,202307,35,15,20,19800.59,26400,46200.59
250140,202307,98,82,16,108242.75,21120,129362.75
250150,202307,694,474,220,625691.58,290401.43,916093.01
250153,202307,20,15,5,19800.1,6600,26400.1
250157,202307,50,38,12,50160.42,15840,66000.42
250160,202307,263,199,64,262682.9,84480,347162.9
250170,202307,91,60,31,79200.2,40920,120120.2
250180,202307,5455,3793,1662,5007040.67,2195219.6,7202260.27
250190,202307,815,553,262,729968.83,345842.83,1075811.66
250200,202307,80,63,17,83161.35,22440.7,105602.05
250205,202307,24,19,5,25080.61,6600,31680.61
250210,202307,92,77,15,101641.17,19800,121441.17
250215,202307,105,68,37,89760.02,48840.35,138600.37
250220,202307,32,21,11,29040.78,14520,43560.78
250230,202307,82,71,11,93720.3,14520.2,108240.5
250240,202307,265,195,70,257404.04,92400.2,349804.24
250250,202307,442,377,65,497653.18,85800,583453.18
250260,202307,59,48,11,63360.1,14520,77880.1
250270,202307,81,60,21,79200.8,29040,108240.8
250280,202307,424,345,79,455404.73,104280,559684.73
250290,202307,122,109,13,143880,17160.88,161040.88
250300,202307,538,365,173,481812.46,228360.1,710172.56
250310,202307,59,54,5,71281.83,6600,77881.83
250320,202307,2231,1490,741,1968217.01,978141.56,2946358.57
250330,202307,126,109,17,143882.84,22440.1,166322.94
250340,202307,35,29,6,38280.94,7920,46200.94
250350,202307,216,143,73,188764.68,96360,285124.68
250355,202307,48,38,10,50160,13200.25,63360.25
250360,202307,196,162,34,213844.29,44880.67,258724.96
250370,202307,2562,1637,925,2160919.63,1221026.19,3381945.82
250375,202307,16,10,6,13200.36,7920.58,21120.94
250380,202307,57,48,9,63360.26,11880.19,75240.45
250390,202307,55,45,10,59401.3,13200,72601.3
250400,202307,19161,9929,9232,13117416.21,12215543.55,25332959.76
250403,202307,311,241,70,318122.17,92400,410522.17
250407,202307,70,56,14,73920.1,18480.85,92400.95
250410,202307,32,27,5,35640.31,6600.8,42241.11
250415,202307,55,36,19,47520,25080,72600
250420,202307,44,37,7,48840.3,9240,58080.3
250430,202307,1624,1414,210,1866856.21,277201.85,2144058.06
250435,202307,45,34,11,44883.66,14521.97,59405.63
250440,202307,695,571,124,753728.99,163681,917409.99
250450,202307,92,68,24,89761.44,31680,121441.44
250460,202307,539,357,182,471245.63,241562.04,712807.67
250470,202307,109,77,32,101641.5,42240,143881.5
250480,202307,362,284,78,374892.58,102960.98,477853.56
250485,202307,7,6,1,7920,1320,9240
250490,202307,259,205,54,270604.65,71281.39,341886.04
250500,202307,108,82,26,108240.1,34320,142560.1
250510,202307,917,727,190,959652.52,250800.94,1210453.46
250520,202307,177,121,56,159720,73920.7,233640.7
250523,202307,135,108,27,142560.74,35640.12,178200.86
250527,202307,125,89,36,117480.91,47520,165000.91
250530,202307,14,10,4,13200,5280,18480
250535,202307,30,23,7,30360,9240,39600
250540,202307,150,120,30,158400.87,39600,198000.87
250550,202307,76,74,2,97681.19,2640,100321.19
250560,202307,67,40,27,52800.84,35640.07,88440.91
250570,202307,167,137,30,180841.55,39600.7,220442.25
250580,202307,94,76,18,100405.2,23760,124165.2
250590,202307,23,16,7,21120,9240,30360
250600,202307,1767,1174,593,1549713.66,784085.09,2333798.75
250610,202307,162,128,34,168969.91,44880.22,213850.13
250620,202307,27,22,5,29040.81,6600,35640.81
250625,202307,73,57,16,75241.58,21120.08,96361.66
250630,202307,3297,2047,1250,2705008.64,1652662.42,4357671.06
250640,202307,205,163,42,215166.35,55440.95,270607.30
250650,202307,36,24,12,31680.57,15840.86,47521.43
250660,202307,67,49,18,64680,23760,88440
250670,202307,86,68,18,89761.17,23760.94,113522.11
250680,202307,456,365,91,481813.81,120120.59,601934.40
250690,202307,2400,1622,778,2143728.37,1029615.62,3173343.99
250700,202307,1010,847,163,1118055.6,215160.2,1333215.8
250710,202307,540,417,123,550473.92,162365.57,712839.49
250720,202307,127,92,35,121441.15,46200,167641.15
250730,202307,441,362,79,477846.9,104282.02,582128.92
250740,202307,76,69,7,91081.86,9240,100321.86
250750,202307,27681,16215,11466,21417858.73,15144731.81,36562590.54
250760,202307,128,99,29,130680.5,38281.04,168961.54
250770,202307,390,260,130,344528.4,171600.7,516129.1
250780,202307,86,57,29,75240.58,38280,113520.58
250790,202307,488,305,183,402605.88,241563.01,644168.89
250800,202307,159,142,17,187440,22440.51,209880.51
250810,202307,76,63,13,83160,17160,100320
250820,202307,164,133,31,175562.05,40920,216482.05
250830,202307,530,347,183,458054.93,241563.51,699618.44
250840,202307,64,54,10,71281.71,13200.2,84481.91
250850,202307,79,65,14,85800.2,18480,104280.2
250855,202307,16,13,3,17160.2,3960,21120.2
250860,202307,253,161,92,212521.04,121440,333961.04
250870,202307,35,32,3,42240,3960,46200
250880,202307,102,77,25,101640.79,33000,134640.79
250890,202307,3480,2552,928,3368729.18,1224976.97,4593706.15
250900,202307,75,61,14,80520.7,18480,99000.7
250905,202307,133,100,33,132000.9,43560,175560.9
250910,202307,1030,755,275,996623.58,363005.2,1359628.78
250915,202307,122,85,37,112201.55,48841.03,161042.58
250920,202307,161,122,39,161040,51480.7,212520.7
250930,202307,204,117,87,154440,114841.1,269281.1
250933,202307,11,8,3,10560,3960,14520
250937,202307,21,19,2,25080,2640,27720
250939,202307,44,33,11,43560.94,14520,58080.94
250940,202307,141,103,38,135962.36,50161.13,186123.49
250950,202307,87,63,24,83162.48,31680,114842.48
250960,202307,89,52,37,68643.21,48840.3,117483.51
250970,202307,1397,994,403,1312104.57,531964.52,1844069.09
250980,202307,99,66,33,87120.7,43560,130680.7
250990,202307,177,136,41,179520,54120,233640
251000,202307,93,77,16,101640,21120,122760
251010,202307,155,110,45,145200,60720,205920
251020,202307,98,82,16,108240.37,21120,129360.37
251030,202307,51,37,14,48840.97,18480,67320.97
251040,202307,77,54,23,71280,30360,101640
251050,202307,29,25,4,33000,5280,38280
251060,202307,53,41,12,54120.92,15840.64,69961.56
251065,202307,6,3,3,3960,3960,7920
251070,202307,19,17,2,22441.53,2640,25081.53
251080,202307,6036,2803,3233,3702771.13,4270290.26,7973061.39
251090,202307,207,169,38,223081.11,50160,273241.11
251100,202307,27,24,3,31680.52,3960,35640.52
251110,202307,69,45,24,59400.61,31680,91080.61
251120,202307,2105,1314,791,1734558.42,1044138.22,2778696.64
251130,202307,476,391,85,516126.58,113520.05,629646.63
251140,202307,669,441,228,582126.32,300961.5,883087.82
251150,202307,358,301,57,397324.14,75240.94,472565.08
251160,202307,102,84,18,110880.31,23760,134640.31
251170,202307,84,70,14,92400.26,18480,110880.26
251180,202307,318,184,134,244204.42,178201.86,422406.28
251190,202307,116,85,31,112205.08,40920.49,153125.57
251200,202307,340,260,80,344528.63,105600.44,450129.07
251203,202307,38,32,6,42240.69,7920,50160.69
251207,202307,90,73,17,96360.69,22440,118800.69
251210,202307,1692,1228,464,1622307.52,612485.83,2234793.35
251220,202307,52,41,11,54120.78,14520,68640.78
251230,202307,619,518,101,683771.15,133321.71,817092.86
251240,202307,127,89,38,117480.5,50160,167640.5
251250,202307,1742,1253,489,1653896.1,645487.89,2299383.99
251260,202307,14,10,4,13200.4,5280.19,18480.59
251270,202307,350,274,76,361685.27,100320.69,462005.96
251272,202307,67,57,10,75240.2,13200,88440.2
251274,202307,21,16,5,21120.47,6600,27720.47
251275,202307,40,23,17,30360.65,22440,52800.65
251276,202307,33,26,7,34320.82,9240,43560.82
251278,202307,18,13,5,17161.24,6600,23761.24
251280,202307,125,120,5,158400.2,6600,165000.2
251290,202307,1243,875,368,1155075.04,485781.63,1640856.67
251300,202307,20,15,5,19800,6600,26400
251310,202307,332,235,97,310208.73,128041.22,438249.95
251315,202307,52,46,6,60720,7920,68640
251320,202307,77,61,16,80521.03,21120,101641.03
251330,202307,89,79,10,104280,13200,117480
251335,202307,25,17,8,22440,10560,33000
251340,202307,906,505,401,666615.85,529323.2,1195939.05
251350,202307,41,38,3,50160,3960,54120
251360,202307,93,79,14,104280.2,18480,122760.2
251365,202307,8,7,1,9241.86,1320,10561.86
251370,202307,6516,4433,2083,5858346.62,2753562.08,8611908.70
251380,202307,51,38,13,50160.54,17160,67320.54
251385,202307,6,5,1,6600,1320,7920
251390,202307,1115,820,295,1082425.56,389407.03,1471832.59
251392,202307,45,33,12,43560.5,15840,59400.5
251394,202307,19,14,5,18480.6,6600,25080.6
251396,202307,11,7,4,9240,5280.2,14520.2
251398,202307,21,17,4,22440.04,5280,27720.04
251400,202307,57,44,13,58080,17160,75240
251410,202307,50,40,10,52800.7,13200,66000.7
251420,202307,120,87,33,114842.18,43560,158402.18
251430,202307,53,45,8,59400.55,10560,69960.55
251440,202307,56,31,25,40920,33000,73920
251445,202307,67,58,9,76563.91,11880,88443.91
251450,202307,412,349,63,460691.61,83160.91,543852.52
251455,202307,6,5,1,6600,1320,7920
251460,202307,26,20,6,26400,7920.02,34320.02
251465,202307,14,8,6,10560,7920,18480
251470,202307,51,37,14,48840,18480,67320
251480,202307,26,22,4,29040.62,5280.26,34320.88
251490,202307,116,67,49,88441.97,64680.33,153122.30
251500,202307,113,91,22,120121.23,29040,149161.23
251510,202307,103,66,37,87121.04,48840.62,135961.66
251520,202307,42,34,8,44880,10560,55440
251530,202307,4536,3193,1343,4217477.76,1774089.44,5991567.20
251540,202307,103,84,19,110880,25081.67,135961.67
251550,202307,458,349,109,460697.1,143883.36,604580.46
251560,202307,25,19,6,25080.1,7920,33000.1
251570,202307,16,15,1,19800,1320,21120
251580,202307,133,103,30,137281.56,39600,176881.56
251590,202307,105,74,31,97680.2,40920.8,138601.0
251593,202307,34,19,15,25080.93,19800,44880.93
251597,202307,134,109,25,143881.36,33000.04,176881.40
251600,202307,1163,805,358,1062619.88,472562.72,1535182.60
251610,202307,288,207,81,273247.01,106920,380167.01
251615,202307,25,21,4,27720,5280,33000
251620,202307,4396,2778,1618,3669691.23,2138426.48,5808117.71
251630,202307,515,375,140,495021.86,184804.45,679826.31
251640,202307,106,75,31,99004.41,40920,139924.41
251650,202307,325,234,91,308884.53,120120,429004.53
251660,202307,218,194,24,256084.57,31680.3,287764.87
251670,202307,445,339,106,447488.47,139920.41,587408.88
251675,202307,14,11,3,14520,3960,18480
251680,202307,109,96,13,126721.07,17160,143881.07
251690,202307,342,283,59,373899.22,79200.2,453099.42
251700,202307,286,244,42,322083.93,55440,377523.93
251710,202307,22,15,7,19800.41,9240,29040.41
251720,202307,38,27,11,35640,14520,50160
251740,202307,15,11,4,14520.3,5280,19800.3
260005,202307,4116,2124,1992,2803221.95,2629491.45,5432713.40
260010,202307,1927,1439,488,1900832.33,644164.46,2544996.79
260020,202307,448,393,55,520088.25,72600.9,592689.15
260030,202307,681,460,221,607213.46,291721.9,898935.36
260040,202307,808,521,287,687742.19,381483.6,1069225.79
260050,202307,1216,884,332,1166906.72,438243.19,1605149.91
260060,202307,378,343,35,452771.61,46200,498971.61
260070,202307,1423,867,556,1144496.62,735265.57,1879762.19
260080,202307,801,588,213,776176.64,281160,1057336.64
260090,202307,495,326,169,431643.35,223080.6,654723.95
260100,202307,231,153,78,201962.27,102960,304922.27
260105,202307,300,176,124,232321.67,163680.1,396001.77
260110,202307,3274,2360,914,3115253.79,1209130.96,4324384.75
260120,202307,2930,1560,1370,2059608.18,1808422.65,3868030.83
260130,202307,228,161,67,212523.81,88440,300963.81
260140,202307,2435,1568,867,2069805.42,1145772.93,3215578.35
260150,202307,209,136,73,179520.93,96361.4,275882.33
260160,202307,376,296,80,390732.44,105601.79,496334.23
260170,202307,3704,2210,1494,2917281,1974750.04,4892031.04
260180,202307,164,140,24,184804.88,31680.3,216485.18
260190,202307,2718,1747,971,2306079.1,1281726.01,3587805.11
260200,202307,1082,844,238,1114102.77,314160.85,1428263.62
260210,202307,1472,1065,407,1405837.37,537244.15,1943081.52
260220,202307,650,576,74,760337.33,97681.67,858019.00
260230,202307,1414,1033,381,1363602.55,502928.66,1866531.21
260240,202307,229,173,56,228366.51,73922.23,302288.74
260250,202307,109,84,25,112200.75,33000,145200.75
260260,202307,1192,821,371,1083733.69,489722.98,1573456.67
260270,202307,258,184,74,242885.38,97680,340565.38
260280,202307,1237,973,264,1284388.48,348483.41,1632871.89
260290,202307,7717,4139,3578,5467466.85,4736197.54,10203664.39
260300,202307,1133,952,181,1256692.85,238922.8,1495615.65
260310,202307,559,441,118,582131,155760.1,737891.1
260320,202307,850,621,229,819722.59,302280.4,1122002.99
260330,202307,100,76,24,100320.3,31680.3,132000.6
260340,202307,89,66,23,87120.65,30360,117480.65
260345,202307,6493,3291,3202,4344283.56,4230656.29,8574939.85
260350,202307,513,364,149,481810.39,196680.58,678490.97
260360,202307,264,156,108,205920.5,143880.45,349800.95
260370,202307,756,495,261,653412.67,344522.45,997935.12
260380,202307,576,417,159,550449.93,209882.18,760332.11
260390,202307,302,256,46,337925.04,60720,398645.04
260392,202307,133,112,21,147843.08,27721.12,175564.20
260400,202307,4890,2787,2103,3682868.05,2778619.33,6461487.38
260410,202307,16796,8639,8157,11409078.17,10780529.52,22189607.69
260415,202307,171,139,32,183480.96,42240,225720.96
260420,202307,1907,1199,708,1582712.62,934562.91,2517275.53
260430,202307,181,162,19,213847.28,25080.2,238927.48
260440,202307,222,148,74,195366.29,97681.15,293047.44
260450,202307,470,356,114,469932.79,150481.85,620414.64
260460,202307,930,487,443,642855.03,584766.86,1227621.89
260470,202307,349,215,134,283805.87,176881.63,460687.50
260480,202307,276,170,106,224400,139920,364320
260490,202307,239,179,60,236281.2,79200,315481.2
260500,202307,1239,825,414,1089024.22,547806.3,1636830.52
260510,202307,893,713,180,941177,237601.07,1178778.07
260515,202307,273,251,22,331322.8,29040.91,360363.71
260520,202307,3427,2102,1325,2774641.55,1751659.3,4526300.85
260530,202307,929,742,187,979479.4,246840.9,1226320.3
260540,202307,589,458,131,604571.26,174241.36,778812.62
260545,202307,38,20,18,26401.29,23760.56,50161.85
260550,202307,383,247,136,326042.34,179520.11,505562.45
260560,202307,526,403,123,531973.97,162361.22,694335.19
260570,202307,1102,882,220,1165599.79,290401.18,1456000.97
260580,202307,385,304,81,402602.45,106920,509522.45
260590,202307,657,387,270,510841.38,356400.4,867241.78
260600,202307,8491,4966,3525,6556588.02,4659642.02,11216230.04
260610,202307,537,366,171,483133.48,225722.36,708855.84
260620,202307,4178,2178,2000,2876383.41,2641494.12,5517877.53
260630,202307,89,75,14,99000.49,18480,117480.49
260640,202307,3600,2201,1399,2909343.48,1848018.13,4757361.61
260650,202307,336,245,91,323406.02,120120.4,443526.42
260660,202307,658,442,216,583457.75,285124.89,868582.64
260670,202307,122,85,37,112200,48840.12,161040.12
260680,202307,4498,2404,2094,3174727.85,2765442.66,5940170.51
260690,202307,141,110,31,145200.28,40920,186120.28
260700,202307,338,236,102,311526.79,134640.69,446167.48
260710,202307,52,43,9,56760,11880,68640
260720,202307,2955,1713,1242,2261199.24,1640768.5,3901967.74
260730,202307,845,619,226,817089.68,298321.17,1115410.85
260740,202307,79,67,12,88440.9,15840,104280.9
260750,202307,583,434,149,572891.84,196680.82,769572.66
260760,202307,835,412,423,545182.19,558371.47,1103553.66
260765,202307,1108,585,523,773535.37,690369.75,1463905.12
260770,202307,238,169,69,224382.02,91080.99,315463.01
260775,202307,947,472,475,623060.21,627009.57,1250069.78
260780,202307,245,146,99,192722.08,130680,323402.08
260790,202307,17838,8514,9324,11242839.12,12317032.13,23559871.25
260795,202307,167,107,60,141240.62,79200,220440.62
260800,202307,321,262,59,345844,77880.46,423724.46
260805,202307,49,32,17,42241.98,22440.38,64682.36
260810,202307,923,727,196,959649.52,260040.62,1219690.14
260820,202307,340,226,114,298322.56,150480,448802.56
260825,202307,229,156,73,205921.02,96360,302281.02
260830,202307,316,208,108,274560,142560,417120
260840,202307,297,211,86,278524.22,113520.03,392044.25
260845,202307,224,135,89,178200.98,117481.73,295682.71
260850,202307,444,333,111,440886.12,146520,587406.12
260860,202307,256,194,62,256084.01,81840,337924.01
260870,202307,360,281,79,370925.55,104280,475205.55
260875,202307,798,576,222,760359.24,293041.02,1053400.26
260880,202307,1768,1173,595,1548390.04,785401.86,2333791.90
260890,202307,2772,1888,884,2493531.73,1166886.98,3660418.71
260900,202307,1126,842,284,1112775.26,374880.96,1487656.22
260910,202307,264,212,52,281164.59,68640.6,349805.19
260915,202307,298,225,73,297000.7,96360,393360.7
260920,202307,251,141,110,186120.2,145200,331320.2
260930,202307,381,324,57,427691.81,75240.17,502931.98
260940,202307,2736,1458,1278,1924629.64,1686980.37,3611610.01
260950,202307,2141,1217,924,1610450.5,1221020.62,2831471.12
260960,202307,15487,7396,8091,9767200.56,10688247.53,20455448.09
260970,202307,471,376,95,496327.04,125400,621727.04
260980,202307,234,214,20,282484.28,26400,308884.28
260990,202307,2913,2308,605,3047964.15,798605.59,3846569.74
261000,202307,4544,2827,1717,3733020.31,2266455.75,5999476.06
261010,202307,140,105,35,138601.26,46200,184801.26
261020,202307,635,466,169,615132.24,223080.1,838212.34
261030,202307,278,207,71,273243.21,95040,368283.21
261040,202307,404,338,66,446168.24,87120,533288.24
261050,202307,590,475,115,627010.76,151801.93,778812.69
261060,202307,1785,1116,669,1473135.78,883083.48,2356219.26
261070,202307,11000,5138,5862,6787811.54,7740689.19,14528500.73
261080,202307,378,296,82,390727.31,108240,498967.31
261090,202307,2188,1676,512,2212401.48,677164.8,2889566.28
261100,202307,1324,904,420,1194631.15,554405.86,1749037.01
261110,202307,10404,6520,3884,8608113.58,5132258.27,13740371.85
261120,202307,232,196,36,258721.3,47520,306241.3
261130,202307,597,355,242,468614.42,320768.65,789383.07
261140,202307,238,147,91,194040.67,120120,314160.67
261150,202307,682,446,236,588724.09,312840.78,901564.87
261153,202307,78,73,5,96360,6600,102960
261160,202307,84865,41098,43767,54284151,57831557.74,112115708.74
261170,202307,526,393,133,518761.28,176881.02,695642.30
261180,202307,1949,1233,716,1627897.76,945129.74,2573027.50
261190,202307,628,423,205,558368.28,270603.22,828971.50
261200,202307,228,180,48,237605.81,63360.36,300966.17
261210,202307,50,34,16,44880.1,21120,66000.1
261220,202307,3106,2159,947,2853915.92,1251378.2,4105294.12
261230,202307,400,293,107,386766.9,141240.97,528007.87
261240,202307,453,387,66,510853.43,87120.97,597974.40
261245,202307,285,241,44,318120.31,58080,376200.31
261247,202307,188,143,45,188762.95,59400,248162.95
261250,202307,4327,2087,2240,2756210.08,2956822.23,5713032.31
261255,202307,272,240,32,316800.52,42240,359040.52
261260,202307,920,782,138,1032295.31,182163.14,1214458.45
261270,202307,218,152,66,200640.83,87120,287760.83
261280,202307,207,170,37,224402.73,48840.14,273242.87
261290,202307,117,83,34,109560.24,44880.2,154440.44
261300,202307,1553,1160,393,1532555.91,518765.51,2051321.42
261310,202307,888,588,300,776176.83,397322.06,1173498.89
261320,202307,536,376,160,496333.82,211202.36,707536.18
261330,202307,933,741,192,978164.93,253448.91,1231613.84
261340,202307,356,197,159,260042.04,211202.04,471244.08
261350,202307,1008,698,310,922714.08,409210.95,1331925.03
261360,202307,1489,930,559,1227606.2,739204.98,1966811.18
261370,202307,5484,3178,2306,4195063.21,3043959.34,7239022.55
261380,202307,615,487,128,642846.36,170280,813126.36
261390,202307,4152,2842,1310,3751576.67,1733199.07,5484775.74
261400,202307,293,259,34,341886.68,44880.74,386767.42
261410,202307,1205,781,424,1030945.74,559683.62,1590629.36
261420,202307,1040,625,415,825014.62,547803.01,1372817.63
261430,202307,341,306,35,403925.14,46200,450125.14
261440,202307,109,103,6,135962.69,7920,143882.69
261450,202307,2788,2135,653,2818249.69,863286.41,3681536.10
261460,202307,854,653,201,863304.73,265321.8,1128626.53
261470,202307,245,196,49,258721.03,64680.5,323401.53
261480,202307,512,383,129,505573.17,170221.76,675794.93
261485,202307,428,251,177,331329.16,233640.2,564969.36
261500,202307,699,445,254,588730.06,335281.9,924011.96
261510,202307,55,38,17,50160.98,23760.1,73921.08
261520,202307,112,95,17,125402.5,22440.2,147842.7
261530,202307,4668,3024,1644,3994391.64,2170096.35,6164487.99
261540,202307,1677,959,718,1265904.02,947769,2213673.02
261550,202307,283,137,146,180841.75,192720,373561.75
261560,202307,1068,705,363,931941.02,480484.94,1412425.96
261570,202307,426,342,84,451446.49,110880.95,562327.44
261580,202307,418,331,87,436925.64,114840,551765.64
261590,202307,212,165,47,217807.18,62041.34,279848.52
261600,202307,341,262,79,345848.83,104280.2,450129.03
261610,202307,109,86,23,113521.24,30360,143881.24
261618,202307,86,62,24,81840.48,33000,114840.48
261620,202307,224,143,81,188763.28,106921.18,295684.46
261630,202307,718,556,162,735246.13,213843.21,949089.34
261640,202307,7451,3929,3522,5189079.8,4653074.79,9842154.59
261650,202307,455,288,167,380161.88,220440.3,600602.18
270010,202307,523,462,61,609856.08,80520.74,690376.82
270020,202307,251,208,43,274565.02,56760.47,331325.49
270030,202307,9857,6326,3531,8354498.41,4667517.24,13022015.65
270040,202307,2178,1464,714,1936481.61,945126.67,2881608.28
270050,202307,257,200,57,264005.29,75240.94,339246.23
270060,202307,55,39,16,51483.11,21120.33,72603.44
270070,202307,800,594,206,784090.13,273241.1,1057331.23
270080,202307,62,48,14,63360.1,18480,81840.1
270090,202307,20,16,4,21120,5280,26400
270100,202307,1373,940,433,1240827.23,572882.12,1813709.35
270110,202307,62,51,11,67320,14520,81840
270120,202307,297,244,53,322090.52,69960.53,392051.05
270130,202307,346,270,76,356403.87,100320,456723.87
270135,202307,124,91,33,120121,43560,163681
270140,202307,1480,995,485,1313440.08,640210.7,1953650.78
270150,202307,272,192,80,253444.53,105600.83,359045.36
270160,202307,491,390,101,516955.44,133323.36,650278.80
270170,202307,840,557,283,735245.51,373561.67,1108807.18
270180,202307,64,49,15,64680.7,19800.09,84480.79
270190,202307,116,102,14,134644.7,18480,153124.7
270200,202307,127,110,17,145200.02,23760,168960.02
270210,202307,565,354,211,467283.55,278520.1,745803.65
270220,202307,198,141,57,186120.65,75240.7,261361.35
270230,202307,2327,1501,826,1982679.7,1091644.03,3074323.73
270235,202307,519,408,111,538584.57,146520,685104.57
270240,202307,3471,2737,734,3612895.89,968884.19,4581780.08
270250,202307,114,90,24,118802.05,31680,150482.05
270255,202307,219,184,35,242882.25,46200.44,289082.69
270260,202307,436,344,92,454094.41,121440.7,575535.11
270270,202307,94,49,45,64680.12,59400,124080.12
270280,202307,201,128,73,168960,96360,265320
270290,202307,1188,930,258,1227622.58,340563.49,1568186.07
270300,202307,391,287,104,378841.07,137280.2,516121.27
270310,202307,840,706,134,931940.91,176880.54,1108821.45
270320,202307,780,674,106,891014.85,139920,1030934.85
270330,202307,331,287,44,378840.62,58080,436920.62
270340,202307,72,59,13,77880,17160,95040
270350,202307,80,46,34,60722.72,44880,105602.72
270360,202307,87,48,39,63360,51480,114840
270370,202307,73,57,16,75240,21120,96360
270375,202307,87,56,31,73921.42,40920,114841.42
270380,202307,1072,742,330,979441.84,436920,1416361.84
270390,202307,130,78,52,102960.2,68640.5,171600.7
270400,202307,804,618,186,816962.38,245520.92,1062483.30
270410,202307,223,168,55,221768.35,72600,294368.35
270420,202307,427,302,125,398643.76,165000.3,563644.06
270430,202307,37439,26582,10857,35115235.76,14344767.02,49460002.78
270440,202307,470,370,100,488414.3,132001.68,620415.98
270450,202307,936,563,373,743167.15,495001.71,1238168.86
270460,202307,184,146,38,192725.23,50160,242885.23
270470,202307,1802,1265,537,1671150.45,708843.55,2379994.00
270480,202307,586,472,114,623049.01,150480,773529.01
270490,202307,27,21,6,27720,7920,35640
270500,202307,483,400,83,528006.81,109560,637566.81
270510,202307,945,641,304,846072.36,401282.23,1247354.59
270520,202307,279,186,93,245521.3,122760,368281.3
270530,202307,64,51,13,67320.36,17160,84480.36
270540,202307,83,60,23,79200,30360,109560
270550,202307,1654,1277,377,1685677.51,497641.91,2183319.42
270560,202307,257,160,97,211203.14,129360,340563.14
270570,202307,623,448,175,591365.91,231000,822365.91
270580,202307,23,18,5,23760,6600,30360
270590,202307,58,48,10,63360.3,13200.08,76560.38
270600,202307,175,146,29,192726.12,38280.1,231006.22
270610,202307,259,205,54,270603.9,71280.1,341884.0
270620,202307,17,17,0,22440,,22440.0
270630,202307,3752,2807,945,3706986.15,1247410.14,4954396.29
270640,202307,919,677,242,894976.05,320762.25,1215738.30
270642,202307,225,184,41,242882.53,54120,297002.53
270644,202307,263,172,91,227043.73,120121.76,347165.49
270650,202307,355,224,131,295685.26,172922.11,468607.37
270660,202307,189,166,23,219130.59,30360,249490.59
270670,202307,3083,2360,723,3115266.26,954361.54,4069627.80
270680,202307,404,270,134,356408.3,176880,533288.3
270690,202307,1296,879,417,1160310.95,550444.1,1710755.05
270700,202307,24,19,5,25080.19,6600,31680.19
270710,202307,569,451,118,595327.62,155760,751087.62
270720,202307,229,187,42,246843.65,55441.02,302284.67
270730,202307,2001,1274,727,1685665.21,959645.67,2645310.88
270740,202307,33,24,9,31680.62,11880,43560.62
270750,202307,622,483,139,637568.56,183481.39,821049.95
270760,202307,292,213,79,281166.57,104280.76,385447.33
270770,202307,3015,2091,924,2760195.71,1221010.22,3981205.93
270780,202307,72,43,29,56760,38280.76,95040.76
270790,202307,200,130,70,171601.94,92400.58,264002.52
270800,202307,2095,1688,407,2228200.38,538560,2766760.38
270810,202307,209,170,39,224401.28,51480,275881.28
270820,202307,118,83,35,109564.33,46200,155764.33
270830,202307,885,685,200,904230.24,264001.14,1168231.38
270840,202307,1331,1043,288,1376780.34,382801.7,1759582.04
270850,202307,1587,1049,538,1384693.24,711483.16,2096176.40
270860,202307,2710,1845,865,2435437.88,1141810.57,3577248.45
270870,202307,133,81,52,106920.2,68640.2,175560.4
270880,202307,886,700,186,924029.31,245522.92,1169552.23
270890,202307,259,204,55,269282.04,72601.21,341883.25
270895,202307,81,77,4,101640,5280,106920
270900,202307,69,57,12,75242.29,15840,91082.29
270910,202307,311,262,49,345849.28,64681.54,410530.82
270915,202307,2016,1368,648,1805797.01,856682.84,2662479.85
270920,202307,397,327,70,431644.97,92400,524044.97
270930,202307,5590,4341,1249,5730241.72,1648687.04,7378928.76
270940,202307,2250,1814,436,2398486.86,576842.58,2975329.44
280010,202307,33,27,6,35640.2,7920,43560.2
280020,202307,533,451,82,595335.34,108240.97,703576.31
280030,202307,23699,15169,8530,20034717.36,11265175.86,31299893.22
280040,202307,345,215,130,283804.37,172920.4,456724.77
280050,202307,467,359,108,473888.2,142560,616448.2
280060,202307,439,288,151,380170.59,199320.82,579491.41
280067,202307,1209,877,332,1157661.51,438241.06,1595902.57
280070,202307,130,111,19,146521.39,25080,171601.39
280100,202307,728,560,168,739211.28,221760.49,960971.77
280110,202307,97,84,13,110881.89,17160,128041.89
280120,202307,740,616,124,814451.72,163681.52,978133.24
280130,202307,1916,1253,663,1653983.8,875161.08,2529144.88
280140,202307,556,460,96,607207.18,126720.2,733927.38
280150,202307,450,327,123,431650.58,162360,594010.58
280160,202307,155,117,38,154442.34,50160,204602.34
280170,202307,449,323,126,426374.56,166321.03,592695.59
280190,202307,34,27,7,35640,9240,44880
280200,202307,54,42,12,55446.19,15840.3,71286.49
280210,202307,3231,2305,926,3043898.68,1222327.31,4266225.99
280220,202307,68,57,11,75242.32,14520,89762.32
280230,202307,346,279,67,368295.96,88441.87,456737.83
280240,202307,146,136,10,179522.58,13200,192722.58
280250,202307,23,11,12,14520.1,15841.37,30361.47
280260,202307,78,69,9,91083.69,11880,102963.69
280270,202307,141,110,31,145200.58,40920.53,186121.11
280280,202307,199,137,62,180843.19,81840.09,262683.28
280290,202307,4139,3021,1118,3989112.32,1477095.28,5466207.60
280300,202307,1803,1434,369,1892906.87,488403.95,2381310.82
280310,202307,111,103,8,135962.26,10560,146522.26
280320,202307,732,507,225,669259.76,297002.33,966262.09
280330,202307,339,248,91,327367.01,120120.2,447487.21
280340,202307,451,373,78,492370.37,102961.1,595331.47
280350,202307,4036,3079,957,4065785.97,1264578.29,5330364.26
280360,202307,494,336,158,443534.59,208560.78,652095.37
280370,202307,98,83,15,109561.09,19800,129361.09
280380,202307,52,40,12,52800,15840,68640
280390,202307,183,155,28,204602.48,36960,241562.48
280400,202307,444,289,155,381495.65,205923.01,587418.66
280410,202307,310,261,49,344528.4,64680,409208.4
280420,202307,146,126,20,166330.81,26400.95,192731.76
280430,202307,110,88,22,116161.67,29040,145201.67
280440,202307,758,626,132,826342.97,174242.58,1000585.55
280445,202307,123,113,10,149162.64,13200.8,162363.44
280450,202307,1433,1228,205,1620995.53,271923.28,1892918.81
280460,202307,716,536,180,707535.72,237601.49,945137.21
280470,202307,82,78,4,102961.56,5280,108241.56
280480,202307,3503,2351,1152,3106177.99,1520678.16,4626856.15
280490,202307,204,191,13,252134.33,17160,269294.33
280500,202307,41,38,3,50161.2,3960.03,54121.23
280510,202307,139,109,30,143880.89,39600.85,183481.74
280520,202307,55,39,16,51481.29,21120,72601.29
280530,202307,77,50,27,66004.23,35640.38,101644.61
280540,202307,595,514,81,679809.55,106920,786729.55
280550,202307,776,714,62,943822.23,81840,1025662.23
280560,202307,506,456,50,601931.45,66000.93,667932.38
280570,202307,2572,2030,542,2680969.75,718085.13,3399054.88
280580,202307,619,488,131,645486.6,172920.96,818407.56
280590,202307,240,159,81,209896.08,106926.57,316822.65
280600,202307,439,357,82,471307.23,108240.2,579547.43
280610,202307,124,88,36,116165.58,47521.91,163687.49
280620,202307,577,466,111,615127.4,146520,761647.4
280630,202307,150,122,28,161043.4,36960.9,198004.3
280640,202307,176,142,34,187440.3,44880,232320.3
280650,202307,83,51,32,67321.58,42240,109561.58
280660,202307,128,98,30,129365.81,39600.21,168966.02
280670,202307,2167,1384,783,1828330.28,1034906.94,2863237.22
280680,202307,256,216,40,285122.41,52800,337922.41
280690,202307,77,67,10,88440,13200,101640
280700,202307,23,23,0,30360,,30360.0
280710,202307,1633,1261,372,1664553.06,491042.1,2155595.16
280720,202307,145,103,42,135962.05,55440,191402.05
280730,202307,31,27,4,35641.62,5280.05,40921.67
280740,202307,2728,2060,668,2719237.79,881764.37,3601002.16
280750,202307,228,202,26,266648.11,34320.8,300968.91
280760,202307,1013,676,337,892344.88,444841.99,1337186.87
290010,202307,199,140,59,184800.96,77880,262680.96
290020,202307,212,188,24,248162.22,31680.9,279843.12
290030,202307,656,423,233,558367.61,307561.12,865928.73
290035,202307,142,114,28,150481.71,36960.93,187442.64
290040,202307,279,199,80,262686.75,105600,368286.75
290050,202307,99,80,19,105600,25080,130680
290060,202307,252,108,144,142561.05,190080,332641.05
290070,202307,6557,3114,3443,4110610.65,4547449.81,8658060.46
290080,202307,504,224,280,295683.36,369600.09,665283.45
290090,202307,327,154,173,203280.2,228360.36,431640.56
290100,202307,1848,1173,675,1548390.24,891002.9,2439393.14
290110,202307,959,535,424,707548.39,559688.38,1267236.77
290115,202307,188,172,16,227043.22,21120,248163.22
290120,202307,874,593,281,784090.86,370921.37,1155012.23
290130,202307,500,307,193,405243.73,254760.91,660004.64
290135,202307,300,226,74,298325.89,97680.1,396005.99
290140,202307,342,288,54,380166.4,72600.36,452766.76
290150,202307,152,104,48,137280.1,63360.01,200640.11
290160,202307,245,191,54,252127.59,71280.85,323408.44
290170,202307,117,86,31,113522.08,40920,154442.08
290180,202307,207,148,59,195362.23,77880.2,273242.43
290190,202307,313,241,72,318124.48,95040.4,413164.88
290195,202307,316,219,97,289083.71,128040.1,417123.81
290200,202307,267,214,53,282480.97,69960.1,352441.07
290205,202307,169,105,64,138600.4,85800,224400.4
290210,202307,1342,978,364,1292314.37,480482.88,1772797.25
290220,202307,168,104,64,137286.4,84481.1,221767.5
290225,202307,302,119,183,157082.99,241560.59,398643.58
290230,202307,99,60,39,79201.97,51480,130681.97
290240,202307,403,140,263,184801.4,347161.22,531962.62
290250,202307,251,231,20,304927.63,26400,331327.63
290260,202307,372,289,83,381497.41,109564.28,491061.69
290265,202307,199,173,26,228364.89,34320.13,262685.02
290270,202307,1449,1191,258,1573498.57,340560.6,1914059.17
290280,202307,531,371,160,489725.92,211200.4,700926.32
290290,202307,1584,974,610,1285702.94,807841.49,2093544.43
290300,202307,400,339,61,447489,80521.67,528010.67
290310,202307,287,141,146,186121.36,195360,381481.36
290320,202307,4653,2766,1887,3652587.12,2493503.2,6146090.32
290323,202307,220,189,31,249487,40920.2,290407.2
290327,202307,178,139,39,184805.75,51480,236285.75
290330,202307,133,65,68,85800.48,91080,176880.48
290340,202307,826,348,478,459376.44,632283.84,1091660.28
290350,202307,730,439,291,579484.37,384121.35,963605.72
290360,202307,323,257,66,339245.49,87120,426365.49
290370,202307,903,421,482,555722.35,636241.61,1191963.96
290380,202307,353,228,125,300962.93,166321.63,467284.56
290390,202307,2576,1597,979,2108093.87,1293608.79,3401702.66
290395,202307,243,146,97,192720.67,128040,320760.67
290400,202307,307,225,82,297001.54,108240,405241.54
290405,202307,254,219,35,289084,46200,335284
290410,202307,691,573,118,756365.97,155760,912125.97
290420,202307,295,241,54,318122.53,71280,389402.53
290430,202307,528,337,191,444842.81,252120,696962.81
290440,202307,94,75,19,99000.4,25080,124080.4
290450,202307,204,147,57,194040,76560,270600
290460,202307,2117,1250,867,1651358.91,1144442.26,2795801.17
290470,202307,1412,635,777,838222.88,1025648.45,1863871.33
290475,202307,587,548,39,724693.55,51480,776173.55
290480,202307,192,112,80,147840.93,105600,253440.93
290485,202307,244,219,25,289082.88,34320,323402.88
290490,202307,1367,963,404,1271182.1,535923.76,1807105.86
290500,202307,864,470,394,620411.09,520082.31,1140493.40
290510,202307,187,150,37,198012.66,48840.35,246853.01
290515,202307,201,125,76,165002,100320,265322
290520,202307,1516,1007,509,1329250.93,671881.08,2001132.01
290530,202307,283,248,35,327373.74,46200.93,373574.67
290540,202307,148,71,77,93720,102960,196680
290550,202307,188,153,35,201961.48,46200,248161.48
290560,202307,3341,1536,1805,2031531.22,2385253.88,4416785.10
290570,202307,7777,3677,4100,4857794.76,5421329.33,10279124.09
290580,202307,1365,821,544,1085057.53,719401.23,1804458.76
290590,202307,608,489,119,645516.71,157083.65,802600.36
290600,202307,1934,1326,608,1750386.83,803890.85,2554277.68
290610,202307,186,172,14,227048.93,18480,245528.93
290620,202307,407,359,48,473889.55,64680.6,538570.15
290630,202307,2091,890,1201,1174831.53,1586646.31,2761477.84
290640,202307,139,108,31,142564.24,40920.05,183484.29
290650,202307,2267,1061,1206,1401885.07,1591931.14,2993816.21
290660,202307,286,237,49,312841.14,64680.72,377521.86
290670,202307,1152,579,573,764296.04,757687.85,1521983.89
290680,202307,1349,1077,272,1424303.01,359041.56,1783344.57
290682,202307,370,277,93,365643.3,122760,488403.3
290685,202307,274,163,111,215164.39,146520.2,361684.59
290687,202307,1317,867,450,1144679.76,594001.15,1738680.91
290689,202307,148,73,75,96360,99000,195360
290690,202307,573,271,302,357727.63,398641.82,756369.45
290700,202307,269,138,131,182167.26,172923.04,355090.30
290710,202307,850,598,252,789373.55,332643.31,1122016.86
290720,202307,1188,933,255,1231601.82,336602.13,1568203.95
290730,202307,1323,786,537,1037541.06,708844.84,1746385.90
290740,202307,30,26,4,34320,5280,39600
290750,202307,1590,702,888,927988.81,1173496.13,2101484.94
290755,202307,88,75,13,99000,17160,116160
290760,202307,265,229,36,302289.67,47521.06,349810.73
290770,202307,197,188,9,248164.82,11880,260044.82
290780,202307,1199,967,232,1277787.7,306245.68,1584033.38
290790,202307,434,297,137,392045.61,180843.44,572889.05
290800,202307,2514,1034,1480,1364906.25,1954929.71,3319835.96
290810,202307,516,353,163,465966.39,215160.52,681126.91
290820,202307,435,249,186,328687.43,245524.29,574211.72
290830,202307,517,366,151,483126.27,200640.86,683767.13
290840,202307,1992,1258,734,1660606.24,968886.23,2629492.47
290850,202307,1153,588,565,776172.08,745806.75,1521978.83
290860,202307,737,367,370,484446.95,488402.22,972849.17
290870,202307,672,466,206,616448.38,271920.61,888368.99
290880,202307,127,67,60,88440.44,79200,167640.44
290890,202307,540,326,214,430323.48,282482.16,712805.64
290900,202307,166,126,40,166320.94,52800,219120.94
290910,202307,418,316,102,418441.43,134640,553081.43
290920,202307,221,197,24,260043.13,31680,291723.13
290930,202307,575,439,136,579497.48,180842.1,760339.58
290940,202307,223,189,34,249481,44880,294361
290950,202307,168,98,70,129360,92400,221760
290960,202307,535,385,150,508206.14,198000.69,706206.83
290970,202307,244,213,31,281162.36,40920.2,322082.56
290980,202307,2128,1506,622,1987962.41,823689.44,2811651.85
290990,202307,453,379,74,500304.82,97683.69,597988.51
291000,202307,963,326,637,430321.29,840840,1271161.29
291005,202307,2901,1241,1660,1638190.66,2195191.69,3833382.35
291010,202307,134,116,18,153120.94,23760,176880.94
291020,202307,86,70,16,92400,21120,113520
291030,202307,120,85,35,112201.83,46200,158401.83
291040,202307,672,403,269,531962.06,356400.11,888362.17
291050,202307,1667,861,806,1136546.05,1063929.25,2200475.30
291060,202307,1820,1014,806,1338507.69,1063927.92,2402435.61
291070,202307,2110,1594,516,2104128.22,681129.98,2785258.20
291072,202307,7767,3028,4739,4003732.49,6260808.01,10264540.50
291075,202307,269,221,48,291720.6,63360,355080.6
291077,202307,62,44,18,58080,23760,81840
291080,202307,23321,10005,13316,13212358.97,17586601.1,30798960.07
291085,202307,291,237,54,312844.51,71280.65,384125.16
291090,202307,255,102,153,134641.4,201960,336601.4
291100,202307,977,342,635,451440.37,838200,1289640.37
291110,202307,475,362,113,477848.78,150480.6,628329.38
291120,202307,2553,1379,1174,1822950.25,1551007.32,3373957.57
291125,202307,71,36,35,47520,46200,93720
291130,202307,193,164,29,216484.16,38280,254764.16
291140,202307,149,121,28,159720.81,36960.1,196680.91
291150,202307,365,136,229,179520.38,303600,483120.38
291160,202307,421,329,92,435615.22,122761.57,558376.79
291165,202307,56,42,14,55440,18480.62,73920.62
291170,202307,3686,1836,1850,2423571.06,2442007.46,4865578.52
291180,202307,1284,556,728,733930.42,960962.25,1694892.67
291185,202307,124,115,9,151802.76,11880,163682.76
291190,202307,1445,712,733,939861.58,968890.27,1908751.85
291200,202307,183,135,48,178200.9,63360,241560.9
291210,202307,2591,1077,1514,1422987.3,1998490.48,3421477.78
291220,202307,346,266,80,351122.43,105600.2,456722.63
291230,202307,967,363,604,479168.78,797283.08,1276451.86
291240,202307,404,371,33,489723.26,43560,533283.26
291250,202307,418,343,75,452760.69,99000,551760.69
291260,202307,70,58,12,76560.1,15840,92400.1
291270,202307,811,385,426,508220.93,562325.98,1070546.91
291280,202307,364,174,190,229683.07,250800.3,480483.37
291290,202307,1691,899,792,1186726.38,1046776.02,2233502.40
291300,202307,261,191,70,253443.12,92400,345843.12
291310,202307,235,204,31,269285.79,40920.7,310206.49
291320,202307,1330,925,405,1221040.15,534602.06,1755642.21
291330,202307,145,121,24,159722.34,31680.2,191402.54
291340,202307,256,159,97,209885.84,129361.95,339247.79
291345,202307,125,91,34,120120.4,44880,165000.4
291350,202307,1916,754,1162,995284.8,1533840.2,2529125.0
291360,202307,9316,4422,4894,5839947.42,6470766.96,12310714.38
291370,202307,1275,781,494,1032286.08,652089.86,1684375.94
291380,202307,282,217,65,286442.38,85800,372242.38
291390,202307,4353,1939,2414,2559530.73,3187816.18,5747346.91
291400,202307,2230,1543,687,2036816.44,906853,2943669.44
291410,202307,248,203,45,267963.43,59400,327363.43
291420,202307,129,98,31,129360,40920,170280
291430,202307,192,117,75,154440,99000,253440
291440,202307,573,466,107,615136.19,141240.2,756376.39
291450,202307,1074,718,356,949107.2,471245.41,1420352.61
291460,202307,2265,1760,505,2323281.12,670573.06,2993854.18
291465,202307,2447,1191,1256,1572152.59,1657926.41,3230079.00
291470,202307,3088,1557,1531,2056605.1,2023578.28,4080183.38
291480,202307,13024,5682,7342,7505801,9700745.99,17206546.99
291490,202307,739,297,442,392044.17,583440.2,975484.37
291500,202307,380,231,149,305947.11,198000.47,503947.58
291510,202307,1178,473,705,624363.68,931920.49,1556284.17
291520,202307,947,437,510,576853.51,673200.4,1250053.91
291530,202307,932,281,651,370921.84,859320.1,1230241.94
291535,202307,150,121,29,159720.19,38280.91,198001.10
291540,202307,343,116,227,153122.83,299641.09,452763.92
291550,202307,1316,634,682,836892,901562.52,1738454.52
291560,202307,5349,2737,2612,3612895.17,3447849.83,7060745.00
291570,202307,250,133,117,175561.39,154442.33,330003.72
291580,202307,1302,828,474,1092981.11,625682.29,1718663.40
291590,202307,127,64,63,84480.55,83160,167640.55
291600,202307,1204,612,592,807856.39,782764.01,1590620.40
291610,202307,1532,742,790,979495.77,1045463.39,2024959.16
291620,202307,584,274,310,361691.93,409202.89,770894.82
291630,202307,486,152,334,200641.16,440880.2,641521.36
291640,202307,4378,2128,2250,2810346.98,2971344.67,5781691.65
291650,202307,479,340,139,450137.72,183481.87,633619.59
291660,202307,371,156,215,205922.48,283801.35,489723.83
291670,202307,160,99,61,130681.45,80520.73,211202.18
291680,202307,657,406,251,535953.41,331323.2,867276.61
291685,202307,661,379,282,500291.29,372242.88,872534.17
291690,202307,529,346,183,456723.74,241561.28,698285.02
291700,202307,1113,853,260,1125985.31,343202.24,1469187.55
291710,202307,1651,802,849,1058659.16,1122005.75,2180664.91
291720,202307,478,327,151,431641.42,199320.9,630962.32
291730,202307,982,572,410,755065.06,541204.83,1296269.89
291733,202307,331,221,110,291722.49,145200.65,436923.14
291735,202307,100,75,25,99000.2,33000.31,132000.51
291740,202307,351,268,83,353761.07,109560,463321.07
291750,202307,2619,1643,976,2170186.17,1288341.01,3458527.18
291760,202307,3249,1807,1442,2386574.44,1903442.71,4290017.15
291770,202307,806,542,264,715473.54,348488.5,1063962.04
291780,202307,115,73,42,96360.58,55440.78,151801.36
291790,202307,171,96,75,126720,99001.27,225721.27
291800,202307,11222,4944,6278,6527611.5,8296285.18,14823896.68
291810,202307,1119,839,280,1107506.82,369605.07,1477111.89
291820,202307,308,224,84,295680.18,110880,406560.18
291830,202307,1054,451,603,595339.89,795967.52,1391307.41
291835,202307,587,544,43,718091.25,56760.18,774851.43
291840,202307,6003,3038,2965,4011693.34,3913884.2,7925577.54
291845,202307,296,103,193,135960,254760,390720
291850,202307,324,282,42,372251.66,56761.57,429013.23
291855,202307,271,113,158,149161.59,208560.48,357722.07
291860,202307,160,103,57,135960.52,75240.99,211201.51
291870,202307,91,43,48,56760,63360,120120
291875,202307,159,146,13,192720.3,17160.84,209881.14
291880,202307,447,370,77,488412.21,101643.06,590055.27
291890,202307,266,91,175,120120.2,233640,353760.2
291900,202307,59,37,22,48840,29040,77880
291905,202307,121,91,30,120121.77,39600.42,159722.19
291910,202307,154,126,28,166320.66,36960.1,203280.76
291915,202307,473,413,60,545180.97,79201.13,624382.10
291920,202307,6847,3264,3583,4311324.66,4734925.1,9046249.76
291930,202307,176,106,70,141242,92400.25,233642.25
291940,202307,441,260,181,343202.77,238920,582122.77
291950,202307,1266,985,281,1300209.84,372240.2,1672450.04
291955,202307,1586,950,636,1254032.81,839527.55,2093560.36
291960,202307,217,158,59,208561.33,77880,286441.33
291970,202307,817,600,217,792019.68,286442.28,1078461.96
291980,202307,1495,1287,208,1698871.69,274562.86,1973434.55
291990,202307,158,146,12,192723.59,15840,208563.59
291992,202307,233,112,121,147847.25,159723.3,307570.55
291995,202307,206,135,71,178201.21,93720,271921.21
292000,202307,443,315,128,415806.91,168960.28,584767.19
292010,202307,393,270,123,357720.41,162360.6,520081.01
292020,202307,331,240,91,316803.69,120120,436923.69
292030,202307,164,126,38,167642.52,50160,217802.52
292040,202307,621,341,280,450120,369600,819720
292045,202307,132,116,16,153120.7,21120.6,174241.3
292050,202307,1002,731,271,964930.92,357721.48,1322652.40
292060,202307,1009,824,185,1087715.42,244202.05,1331917.47
292070,202307,79,29,50,40920.2,66000,106920.2
292080,202307,183,129,54,170280.41,71280,241560.41
292090,202307,599,225,374,298321,493680.2,792001.2
292100,202307,1791,784,1007,1036242.02,1330587.33,2366829.35
292105,202307,177,161,16,212520,21120,233640
292110,202307,2419,917,1502,1210467.39,1983967.82,3194435.21
292120,202307,764,572,192,755074.59,253441.59,1008516.18
292130,202307,519,283,236,374884.54,311520.99,686405.53
292140,202307,229,184,45,242885.57,59401.01,302286.58
292145,202307,180,104,76,137280,100320,237600
292150,202307,1601,1344,257,1774109.59,339243.29,2113352.88
292160,202307,188,146,42,192720.7,55440.09,248160.79
292170,202307,1224,1028,196,1358325.54,258723.73,1617049.27
292180,202307,264,187,77,246840,101640.1,348480.1
292190,202307,159,104,55,137281.14,72600.97,209882.11
292200,202307,1542,572,970,755054.77,1281726.73,2036781.50
292205,202307,135,113,22,149160.88,29040,178200.88
292210,202307,431,277,154,365646.92,203280.73,568927.65
292220,202307,40,28,12,36960.4,15840,52800.4
292225,202307,69,54,15,71282.91,19800.64,91083.55
292230,202307,1047,815,232,1075829.41,307561.78,1383391.19
292240,202307,677,493,184,650780.45,242880.56,893661.01
292250,202307,1701,1094,607,1444124.35,802567.88,2246692.23
292260,202307,441,265,176,349805.63,232321.71,582127.34
292265,202307,265,204,61,269284.03,80521.02,349805.05
292270,202307,743,384,359,509528.29,473880,983408.29
292273,202307,221,132,89,174240.9,117480.02,291720.92
292275,202307,194,103,91,135960.5,120120,256080.5
292280,202307,161,112,49,147840,64680,212520
292285,202307,103,79,24,105600,31680,137280
292290,202307,686,458,228,604571.75,300960.9,905532.65
292300,202307,2037,811,1226,1070541.16,1620982.21,2691523.37
292303,202307,153,107,46,141242.39,60720.77,201963.16
292305,202307,126,92,34,121441.38,44880,166321.38
292310,202307,1049,704,345,929301.87,458046.28,1387348.15
292320,202307,635,478,157,632288.42,207241.73,839530.15
292330,202307,180,118,62,155760.77,81840,237600.77
292335,202307,333,262,71,347163.52,93720,440883.52
292340,202307,594,417,177,550445.35,233640.55,784085.90
292350,202307,295,151,144,199321.18,190080,389401.18
292360,202307,790,593,197,782762.59,260041.01,1042803.60
292370,202307,750,574,176,757690.11,232321.38,990011.49
292380,202307,626,520,106,686416.29,139920.49,826336.78
292390,202307,388,156,232,205922.15,306241.59,512163.74
292400,202307,4129,2514,1615,3318582.34,2135773.78,5454356.12
292405,202307,283,185,98,244200.89,129360,373560.89
292410,202307,111,71,40,93721.4,52800,146521.4
292420,202307,276,240,36,316800.9,47520,364320.9
292430,202307,569,409,160,539884.09,211200.51,751084.60
292440,202307,707,587,120,774855.07,158402.13,933257.20
292450,202307,247,188,59,248162.48,77880.3,326042.78
292460,202307,538,408,130,538564.04,171601.42,710165.46
292465,202307,221,189,32,249481.85,42240.1,291721.95
292467,202307,188,127,61,167640.27,80520,248160.27
292470,202307,332,222,110,293040.59,145200,438240.59
292480,202307,429,283,146,373568.72,192721.32,566290.04
292490,202307,265,199,66,262681.82,87122.4,349804.22
292500,202307,1006,505,501,666622.01,661327.07,1327949.08
292510,202307,3903,1932,1971,2551610.53,2604377.33,5155987.86
292520,202307,1315,632,683,835589.29,902890.96,1738480.25
292525,202307,492,369,123,487091.58,162362.68,649454.26
292530,202307,5548,2296,3252,3034749.88,4297956.33,7332706.21
292540,202307,493,285,208,376203.03,274560.97,650764.00
292550,202307,1199,667,532,880454.4,703564.08,1584018.48
292560,202307,341,310,31,409214.11,40920.16,450134.27
292570,202307,371,282,89,372242.03,117480,489722.03
292575,202307,610,444,166,587426.39,220442.96,807869.35
292580,202307,1104,754,350,995289.43,462002.7,1457292.13
292590,202307,604,535,69,706206.8,91080.8,797287.6
292593,202307,158,125,33,165000.58,43560,208560.58
292595,202307,229,180,49,237604.32,64680,302284.32
292600,202307,1366,972,394,1283081.06,520089.55,1803170.61
292610,202307,113,96,17,126726.65,22441.34,149167.99
292620,202307,551,457,94,603272.71,124081.73,727354.44
292630,202307,1690,917,773,1210466.4,1021685.11,2232151.51
292640,202307,937,648,289,855373.75,381485.53,1236859.28
292650,202307,195,144,51,190087.51,67320,257407.51
292660,202307,2132,1485,647,1960264.72,855372.91,2815637.63
292665,202307,142,99,43,130681.02,56760,187441.02
292670,202307,404,307,97,405242.18,128040.21,533282.39
292680,202307,269,203,66,267960.97,87120,355080.97
292690,202307,216,146,70,192720.7,93720,286440.7
292700,202307,1091,717,374,946465.77,493686.38,1440152.15
292710,202307,115,98,17,129360.84,22440.31,151801.15
292720,202307,1088,625,463,826328.43,611160.78,1437489.21
292730,202307,236,112,124,147842.24,163680.4,311522.64
292740,202307,85857,40667,45190,53727774.96,59702045.61,113429820.57
292750,202307,436,318,118,419769.93,155762.97,575532.90
292760,202307,360,308,52,406562.18,68640.38,475202.56
292770,202307,959,399,560,526688.04,741848.47,1268536.51
292780,202307,56,24,32,31681.52,42240.99,73922.51
292790,202307,823,446,377,588723.36,497640.2,1086363.56
292800,202307,1367,818,549,1079779.95,726005.94,1805785.89
292805,202307,418,159,259,209880.64,341880.95,551761.59
292810,202307,1951,1155,796,1525948.14,1050723.41,2576671.55
292820,202307,733,621,112,819752.83,147842.97,967595.80
292830,202307,144,111,33,146524.03,44881.08,191405.11
292840,202307,755,608,147,802584.21,195362.68,997946.89
292850,202307,149,100,49,132002.23,64682.08,196684.31
292860,202307,2254,1293,961,1706829.92,1269855.25,2976685.17
292870,202307,4053,2641,1412,3488833.91,1865169.16,5354003.07
292880,202307,1547,1024,523,1351705.24,691685.33,2043390.57
292890,202307,594,495,99,653418.09,130681.97,784100.06
292895,202307,155,111,44,146520.75,58080,204600.75
292900,202307,353,258,95,340576.11,125403.11,465979.22
292905,202307,550,273,277,360365.18,365644.03,726009.21
292910,202307,578,434,144,572888.32,191400.87,764289.19
292920,202307,646,291,355,384129.28,468607.74,852737.02
292925,202307,496,454,42,599281.62,55441.22,654722.84
292930,202307,794,484,310,638890.36,409203.55,1048093.91
292935,202307,282,123,159,162361.61,209881.1,372242.71
292937,202307,216,145,71,191401.65,93720,285121.65
292940,202307,209,157,52,207241.73,68640,275881.73
292950,202307,1501,724,777,957026.15,1026968.89,1983995.04
292960,202307,525,379,146,500299.64,194041.5,694341.14
292970,202307,270,198,72,261365.1,95043.48,356408.58
292975,202307,100,53,47,69964.95,62041.06,132006.01
292980,202307,376,262,114,345845.03,150481.94,496326.97
292990,202307,1371,1035,336,1366209.1,443521.81,1809730.91
293000,202307,119,83,36,109562.53,47520,157082.53
293010,202307,3304,1952,1352,2576778.33,1787312.59,4364090.92
293015,202307,651,537,114,710173.99,150480,860653.99
293020,202307,375,296,79,390734.93,104282.31,495017.24
293030,202307,583,522,61,689049.55,80520,769569.55
293040,202307,396,316,80,417122.09,105600.68,522722.77
293050,202307,3348,1958,1390,2584629.74,1836139.73,4420769.47
293060,202307,242,194,48,256090.58,63360.5,319451.08
293070,202307,4277,2133,2144,2819626.51,2832754,5652380.51
293075,202307,98,69,29,91081.59,38280,129361.59
293076,202307,92,69,23,91082.35,30360,121442.35
293077,202307,677,385,292,508223.63,385446.08,893669.71
293080,202307,448,398,50,525365.06,66000.66,591365.72
293090,202307,142,126,16,166320,21120,187440
293100,202307,574,389,185,513488.13,244200.79,757688.92
293105,202307,371,275,96,363002.21,126720,489722.21
293110,202307,123,81,42,106926,55442.21,162368.21
293120,202307,312,225,87,297008.45,114844.1,411852.55
293130,202307,262,173,89,228365.67,117480,345845.67
293135,202307,9011,3682,5329,4860371.86,7043541.36,11903913.22
293140,202307,208,126,82,166324.93,108241.53,274566.46
293150,202307,338,293,45,386768.86,59400.2,446169.06
293160,202307,445,282,163,373563.44,215160,588723.44
293170,202307,280,173,107,228365.66,141242.51,369608.17
293180,202307,656,452,204,596641.43,270600,867241.43
293190,202307,1479,1017,462,1345113.36,613807.77,1958921.13
293200,202307,625,539,86,711497.32,113520,825017.32
293210,202307,454,349,105,460689.54,138600,599289.54
293220,202307,2537,1154,1383,1523303.89,1830848.65,3354152.54
293230,202307,1997,750,1247,990019.79,1646044.42,2636064.21
293240,202307,242,218,24,287770.9,31681.1,319452.0
293245,202307,132,107,25,142562.19,33000,175562.19
293250,202307,842,361,481,477854.22,636253.83,1114108.05
293260,202307,339,264,75,348482.6,99000,447482.6
293270,202307,1234,551,683,727326.35,901560.71,1628887.06
293280,202307,331,227,104,299642.78,137281.42,436924.20
293290,202307,3275,2107,1168,2782643,1543094.41,4325737.41
293300,202307,964,659,305,869889.94,402600.24,1272490.18
293305,202307,205,157,48,207241.6,63360.65,270602.25
293310,202307,180,134,46,176881.92,60720.7,237602.62
293315,202307,188,144,44,190084.16,58081.39,248165.55
293317,202307,97,73,24,96360.2,31680,128040.2
293320,202307,1362,697,665,920099.38,877822.11,1797921.49
293325,202307,216,92,124,121440,163680,285120
293330,202307,16167,7533,8634,9950439.7,11406237.52,21356677.22
293340,202307,298,212,86,279841.4,113520,393361.4
293345,202307,277,232,45,306246.53,59400,365646.53
293350,202307,610,396,214,522732.39,282481.66,805214.05
293360,202307,1582,1108,474,1462592.64,625688.28,2088280.92
310010,202307,145,78,67,102960.77,88440.04,191400.81
310020,202307,1007,549,458,726016.66,604564.55,1330581.21
310030,202307,324,256,68,337925.61,89762.5,427688.11
310040,202307,50,34,16,44880,21120,66000
310050,202307,178,115,63,151800.21,83160,234960.21
310060,202307,293,213,80,281168.87,105600.67,386769.54
310070,202307,23,16,7,21120.24,9240.2,30360.44
310080,202307,54,37,17,48840,22440.83,71280.83
310090,202307,1194,672,522,888377.83,689045.22,1577423.05
310100,202307,409,283,126,374892.02,166322.05,541214.07
310110,202307,746,400,346,528009.65,456724.43,984734.08
310120,202307,462,262,200,345840.99,265320.73,611161.72
310130,202307,35,21,14,27720.2,18480,46200.2
310140,202307,25,10,15,13200,19800.76,33000.76
310150,202307,1282,840,442,1110153.9,584770.65,1694924.55
310160,202307,2290,1131,1159,1494272.46,1531208.68,3025481.14
310163,202307,105,63,42,83160,55440,138600
310170,202307,2760,1342,1418,1771481.47,1873093.89,3644575.36
310180,202307,207,98,109,129362.19,143880,273242.19
310190,202307,524,345,179,455406.81,236282.44,691689.25
310200,202307,446,280,166,369603.75,219120.2,588723.95
310205,202307,90,63,27,83160.93,35640,118800.93
310210,202307,284,227,57,299641.81,75240,374881.81
310220,202307,68,44,24,58080.3,31680,89760.3
310230,202307,306,220,86,290403.75,113520,403923.75
310240,202307,136,109,27,143880.2,35640,179520.2
310250,202307,103,82,21,108241.95,27720,135961.95
310260,202307,817,439,378,579499.82,498963.94,1078463.76
310270,202307,302,199,103,262686.83,135960.14,398646.97
310280,202307,433,300,133,396001.96,175560,571561.96
310285,202307,215,166,49,219122.36,66000.15,285122.51
310290,202307,242,130,112,171602.58,147840,319442.58
310300,202307,192,154,38,203282.13,50160,253442.13
310310,202307,18,15,3,19800,3960,23760
310320,202307,30,12,18,15840.18,23760.54,39600.72
310330,202307,51,38,13,50160.24,17160.66,67320.90
310340,202307,2027,1461,566,1929870.01,748442.59,2678312.60
310350,202307,2974,1524,1450,2013067.18,1914010.08,3927077.26
310360,202307,54,40,14,52800,18480.33,71280.33
310370,202307,149,124,25,163680,33000,196680
310375,202307,112,42,70,55440.82,92400.99,147841.81
310380,202307,52,34,18,44880,23760,68640
310390,202307,109,70,39,92401.65,51480,143881.65
310400,202307,2778,1861,917,2457939.74,1214409.72,3672349.46
310410,202307,127,76,51,100321.02,67320,167641.02
310420,202307,734,385,349,508210.55,460681.49,968892.04
310430,202307,300,192,108,253441.81,142560,396001.81
310440,202307,82,53,29,69960.52,38280,108240.52
310445,202307,90,77,13,101640.71,17160,118800.71
310450,202307,705,471,234,621734.13,308881.29,930615.42
310460,202307,271,185,86,244202.62,113520.56,357723.18
310470,202307,581,377,204,497650.6,269282.18,766932.78
310480,202307,110,73,37,96360,48840,145200
310490,202307,638,317,321,418446.42,425041.11,843487.53
310500,202307,143,63,80,83161.81,105600,188761.81
310510,202307,646,456,190,603254.99,250800.91,854055.90
310520,202307,158,109,49,143881.9,64680,208561.9
310530,202307,131,54,77,71280.01,101640,172920.01
310540,202307,531,298,233,394689.51,308882.05,703571.56
310550,202307,88,60,28,79201.99,36960,116161.99
310560,202307,3479,2385,1094,3148291.77,1446724.85,4595016.62
310570,202307,124,81,43,106920.81,56760,163680.81
310590,202307,440,260,180,343208.5,237600.7,580809.2
310600,202307,151,73,78,96361.4,102960,199321.4
310610,202307,41,14,27,18480.25,35640,54120.25
310620,202307,55865,26601,29264,35132777.12,38682840.51,73815617.63
310630,202307,833,509,324,673215.45,429001.91,1102217.36
310640,202307,170,111,59,146520.2,77880.2,224400.4
310650,202307,187,168,19,221760.46,26400,248160.46
310660,202307,116,78,38,102960.2,50160,153120.2
310665,202307,74,51,23,67320,30360,97680
310670,202307,8230,3581,4649,4732373.43,6144630.43,10877003.86
310680,202307,62,41,21,54120,27720,81840
310690,202307,632,451,181,595330.92,238923.38,834254.30
310700,202307,64,38,26,50160.2,34320.97,84481.17
310710,202307,1367,926,441,1222338.55,583446.19,1805784.74
310720,202307,167,47,120,62040,158400,220440
310730,202307,1707,1158,549,1529938.86,726015.2,2255954.06
310740,202307,1090,591,499,780149.45,658685.65,1438835.10
310750,202307,269,175,94,232322.28,124080.37,356402.65
310760,202307,80,62,18,81841.68,23760,105601.68
310770,202307,86,42,44,55440.1,58080,113520.1
310780,202307,390,315,75,415805.1,99000.6,514805.7
310790,202307,126,102,24,134640.78,31680.59,166321.37
310800,202307,503,239,264,316801.98,348480,665281.98
310810,202307,189,125,64,165000.84,84480.59,249481.43
310820,202307,319,256,63,337926.39,83160.04,421086.43
310825,202307,208,176,32,232322.01,42240,274562.01
310830,202307,487,222,265,293042.93,351122.02,644164.95
310840,202307,393,246,147,324722.15,194040.83,518762.98
310850,202307,79,64,15,84480.95,19800,104280.95
310855,202307,472,375,97,495007.04,128040,623047.04
310860,202307,1736,1283,453,1693612.75,601929.62,2295542.37
310870,202307,68,57,11,75240.6,14520,89760.6
310880,202307,97,76,21,100320,27720,128040
310890,202307,309,180,129,237602.18,170280,407882.18
310900,202307,672,310,362,409206.59,477845.11,887051.70
310910,202307,255,169,86,223081.27,113520,336601.27
310920,202307,457,264,193,348490.06,256088.93,604578.99
310925,202307,47,38,9,50160.82,11880,62040.82
310930,202307,1459,988,471,1304177.88,621725.77,1925903.65
310940,202307,741,361,380,476536.82,501605.58,978142.40
310945,202307,158,105,53,138600.85,69960,208560.85
310950,202307,221,176,45,233642.27,59400,293042.27
310960,202307,76,29,47,38281.63,62041.57,100323.20
310970,202307,184,105,79,138603.6,104280,242883.6
310980,202307,55,39,16,51485.68,21120,72605.68
310990,202307,169,91,78,120120.15,102961.05,223081.20
311000,202307,943,489,454,645492.7,599283.27,1244775.97
311010,202307,56,43,13,56760.94,17160,73920.94
311020,202307,46,31,15,40920.55,19800,60720.55
311030,202307,430,237,193,312842.02,254761.47,567603.49
311040,202307,38,30,8,39600,10560,50160
311050,202307,553,212,341,279840.84,450121.58,729962.42
311060,202307,889,492,397,649450.59,525364.2,1174814.79
311070,202307,372,172,200,227041.87,264000.43,491042.30
311080,202307,128,73,55,96361.63,72600.4,168962.03
311090,202307,375,189,186,249484,245521.12,495005.12
311100,202307,601,365,236,483123.98,311520.25,794644.23
311110,202307,729,518,211,683779.86,279845.06,963624.92
311115,202307,88,60,28,79200.58,36960.2,116160.78
311120,202307,1196,669,527,885748.05,699606.57,1585354.62
311130,202307,293,169,124,223085.18,163680,386765.18
311140,202307,178,101,77,133324.18,101642.18,234966.36
311150,202307,340,217,123,286444.11,162360,448804.11
311160,202307,823,583,240,770893.43,318121.16,1089014.59
311170,202307,101,81,20,106920.94,26400,133320.94
311180,202307,329,227,102,299649.33,134640.84,434290.17
311190,202307,36,17,19,22440,25080,47520
311200,202307,353,242,111,319442.07,146520.9,465962.97
311205,202307,40,33,7,43560,9240,52800
311210,202307,39,34,5,44880,6600,51480
311220,202307,32,29,3,38280,3960,42240
311230,202307,1794,1211,583,1598573.28,770888.21,2369461.49
311240,202307,93,65,28,85804.1,36960.5,122764.6
311250,202307,59,25,34,33000,44880,77880
311260,202307,570,349,221,460688.45,293040.14,753728.59
311265,202307,145,96,49,126720.24,64680,191400.24
311270,202307,297,203,94,267964.41,124081.8,392046.21
311280,202307,209,91,118,120121.3,155760,275881.3
311290,202307,114,98,16,129361.96,21120,150481.96
311300,202307,627,406,221,535929.55,291721.71,827651.26
311310,202307,19,16,3,21120,3960,25080
311320,202307,688,512,176,675852.31,232321.53,908173.84
311330,202307,1300,942,358,1243468.03,472571.65,1716039.68
311340,202307,2888,2028,860,2677023.02,1135205.44,3812228.46
311350,202307,279,213,66,281162.86,87120,368282.86
311360,202307,170,103,67,137281.46,88440,225721.46
311370,202307,1301,558,743,736587.6,980770.4,1717358.0
311380,202307,7,6,1,7920,1320,9240
311390,202307,265,155,110,204602.47,145200.2,349802.67
311400,202307,137,83,54,110880.8,71280,182160.8
311410,202307,132,64,68,84480.95,89760,174240.95
311420,202307,339,168,171,221766.05,227041.76,448807.81
311430,202307,907,598,309,789370.87,409200.5,1198571.37
311440,202307,488,329,159,435609.59,209881.87,645491.46
311450,202307,324,190,134,250802.25,178200,429002.25
311455,202307,282,190,92,250807.52,121440.91,372248.43
311460,202307,139,64,75,84480.3,99000,183480.3
311470,202307,34,16,18,21120,23760,44880
311480,202307,65,37,28,48840,36960,85800
311490,202307,11,6,5,7920,6600,14520
311500,202307,33,17,16,22440,21120,43560
311510,202307,844,580,264,768260.18,348480.93,1116741.11
311520,202307,41,35,6,46200,7920,54120
311530,202307,2004,1439,565,1899579.31,747123.95,2646703.26
311535,202307,74,45,29,59400.96,38280.52,97681.48
311540,202307,35,30,5,39600.16,6600,46200.16
311545,202307,193,139,54,183482.76,71280,254762.76
311547,202307,63,49,14,64680,18480.04,83160.04
311550,202307,757,350,407,463330.02,537241.93,1000571.95
311560,202307,44,27,17,35640.83,22440,58080.83
311570,202307,309,204,105,269283.39,138602.19,407885.58
311580,202307,455,295,160,389405.6,211201.05,600606.65
311590,202307,30,24,6,31680.21,7920,39600.21
311600,202307,96,77,19,102963.6,25080.93,128044.53
311610,202307,262,228,34,300962.5,44880.73,345843.23
311615,202307,187,157,30,207241.52,39600.52,246842.04
311620,202307,33,25,8,33000.9,10560,43560.9
311630,202307,120,105,15,138601.57,19800,158401.57
311640,202307,150,77,73,101641.74,96363.78,198005.52
311650,202307,140,96,44,126720,58080.2,184800.2
311660,202307,477,221,256,291723.27,337920.77,629644.04
311670,202307,161,114,47,150293.2,63360.43,213653.63
311680,202307,245,183,62,241561.16,81840.18,323401.34
311690,202307,14,13,1,17160.5,1320,18480.5
311700,202307,204,154,50,203283.06,66000.96,269284.02
311710,202307,188,126,62,166322,81840,248162
311720,202307,38,29,9,38280.89,11880,50160.89
311730,202307,614,432,182,570257.53,240241.15,810498.68
311740,202307,27,19,8,25080,10560,35640
311750,202307,769,520,249,686406.87,328680.93,1015087.80
311760,202307,88,39,49,51482.18,64681.08,116163.26
311770,202307,400,201,199,265322.97,262680.86,528003.83
311780,202307,237,128,109,168962.3,143880.37,312842.67
311783,202307,109,94,15,124081.6,19800,143881.6
311787,202307,50,19,31,25080,40920.98,66000.98
311790,202307,274,122,152,161041.71,200641.68,361683.39
311800,202307,846,505,341,669255.25,450123,1119378.25
311810,202307,57,42,15,55441.41,21120,76561.41
311820,202307,140,106,34,139922.98,44880.58,184803.56
311830,202307,2138,1241,897,1639483.68,1185362.78,2824846.46
311840,202307,1205,707,498,933251.21,658683.54,1591934.75
311850,202307,19,13,6,17160.28,7920.2,25080.48
311860,202307,11457,4933,6524,6517054.73,8617049.42,15134104.15
311870,202307,122,70,52,92403.31,68640.31,161043.62
311880,202307,1022,734,288,968909.8,382809.69,1351719.49
311890,202307,218,100,118,131894.2,155763.68,287657.88
311900,202307,69,29,40,38280,52800.15,91080.15
311910,202307,1520,954,566,1259305.94,748445.25,2007751.19
311920,202307,253,166,87,219122.08,114840.2,333962.28
311930,202307,1011,567,444,748453.31,587402.98,1335856.29
311940,202307,2972,1670,1302,2205789.51,1725243.44,3931032.95
311950,202307,185,111,74,146522.37,97681.05,244203.42
311960,202307,68,46,22,60720.39,29040,89760.39
311970,202307,27,15,12,19800,15840,35640
311980,202307,43,33,10,43560,13200,56760
311990,202307,37,26,11,34320.08,14520.64,48840.72
311995,202307,59,36,23,47520.7,31680.2,79200.9
312000,202307,22,16,6,21120,7920,29040
312010,202307,74,56,18,73921.07,23760.1,97681.17
312015,202307,93,65,28,85800.69,36960,122760.69
312020,202307,145,107,38,141240.25,50160,191400.25
312030,202307,85,65,20,85800,26400,112200
312040,202307,95,57,38,75240,50160,125400
312050,202307,207,121,86,159720.2,113520,273240.2
312060,202307,20,12,8,15840,10560,26400
312070,202307,86,57,29,75240.54,38280,113520.54
312080,202307,523,257,266,339242.66,352440.3,691682.96
312083,202307,89,57,32,75240.37,42240,117480.37
312087,202307,111,80,31,105601.39,40920,146521.39
312090,202307,3788,2355,1433,3112678.82,1894216.34,5006895.16
312100,202307,158,111,47,146522.27,62040.86,208563.13
312110,202307,133,81,52,106921.98,68641.03,175563.01
312120,202307,133,95,38,125402.03,50160,175562.03
312125,202307,89,61,28,80521.65,36960.88,117482.53
312130,202307,135,93,42,122761.48,55440,178201.48
312140,202307,159,121,38,159721.54,50160,209881.54
312150,202307,39,33,6,43560,7920,51480
312160,202307,1566,1030,536,1359744.43,707524.99,2067269.42
312170,202307,15,11,4,14520,5280,19800
312180,202307,90,65,25,87120,33000,120120
312190,202307,51,44,7,58080.96,9240,67320.96
312200,202307,790,670,120,884421.55,159721.76,1044143.31
312210,202307,142,77,65,101640.99,85800.53,187441.52
312220,202307,159,117,42,154442.26,55440,209882.26
312230,202307,4226,1865,2361,2464521.47,3116528.69,5581050.16
312235,202307,190,124,66,163680,87120,250800
312240,202307,91,66,25,87122.59,33000.93,120123.52
312245,202307,246,180,66,237605.04,87120.43,324725.47
312247,202307,82,61,21,80520.37,27720.38,108240.75
312250,202307,189,97,92,128042.91,121440,249482.91
312260,202307,116,74,42,97680,55440,153120
312270,202307,149,87,62,114841.61,81840,196681.61
312280,202307,32,16,16,21120,21120,42240
312290,202307,153,105,48,138603.53,63360.11,201963.64
312300,202307,211,140,71,184802.79,93721.02,278523.81
312310,202307,67,58,9,76560,11880,88440
312320,202307,453,277,176,365641.34,232320,597961.34
312330,202307,111,97,14,128040.05,18480.91,146520.96
312340,202307,34,17,17,22440,22440,44880
312350,202307,14,8,6,10560.78,7920,18480.78
312352,202307,96,69,27,91080.12,35640,126720.12
312360,202307,620,275,345,363006.72,455400.2,818406.92
312370,202307,406,226,180,298320.77,238920.99,537241.76
312380,202307,151,100,51,132005.45,67321.78,199327.23
312385,202307,186,148,38,195362.71,50161.03,245523.74
312390,202307,320,202,118,266642.6,155760,422402.6
312400,202307,409,309,100,409201.93,132000.07,541202.00
312410,202307,1362,508,854,671901.05,1127302.76,1799203.81
312420,202307,730,553,177,729969.1,233641.15,963610.25
312430,202307,907,656,251,865932.37,332643.37,1198575.74
312440,202307,62,46,16,60720,21120,81840
312450,202307,237,140,97,184800,128040,312840
312460,202307,38,17,21,22440,27720,50160
312470,202307,53,37,16,48840,21120,69960
312480,202307,168,105,63,138603.22,83161.19,221764.41
312490,202307,338,228,110,300967.73,145202.48,446170.21
312500,202307,37,26,11,34320.85,14520,48840.85
312510,202307,772,308,464,406569.48,612486.15,1019055.63
312520,202307,25,9,16,11880,21120,33000
312530,202307,40,28,12,36961.78,15840.1,52801.88
312540,202307,89,75,14,99000.53,18480,117480.53
312550,202307,35,27,8,35640,10560,46200
312560,202307,221,172,49,227042.43,64680,291722.43
312570,202307,526,314,212,414491.21,279842.38,694333.59
312580,202307,88,54,34,71280,44880,116160
312590,202307,223,176,47,232323.41,62040,294363.41
312595,202307,174,143,31,188761.28,40920,229681.28
312600,202307,72,33,39,43560,51480,95040
312610,202307,1709,904,805,1197267.64,1065242.64,2262510.28
312620,202307,242,178,64,234962.19,84480,319442.19
312630,202307,74,60,14,79200.52,18480,97680.52
312640,202307,50,14,36,18480,47520,66000
312650,202307,160,137,23,182605.74,30360.1,212965.84
312660,202307,118,82,36,108245.76,47520.59,155766.35
312670,202307,1008,634,374,836905.22,493683.91,1330589.13
312675,202307,51,38,13,50160,17160,67320
312680,202307,82,54,28,71280,36960,108240
312690,202307,293,151,142,199323.4,187440.8,386764.2
312695,202307,35,27,8,35640,10560,46200
312700,202307,275,159,116,209883.32,153120.64,363003.96
312705,202307,91,71,20,93720,26400,120120
312707,202307,135,96,39,126720.24,51480,178200.24
312710,202307,2021,1146,875,1515409.5,1156331.31,2671740.81
312720,202307,45,24,21,31680.56,27720,59400.56
312730,202307,307,179,128,236284.04,168962.42,405246.46
312733,202307,51,41,10,54120.7,13200,67320.7
312735,202307,23,18,5,23760.71,6600.3,30361.01
312737,202307,91,54,37,71280.93,48840,120120.93
312738,202307,87,54,33,71280.63,43560,114840.63
312740,202307,82,49,33,64681.89,43560,108241.89
312750,202307,130,90,40,118800.28,52800,171600.28
312760,202307,287,192,95,253444.4,125400.97,378845.37
312770,202307,9989,4857,5132,6416668.25,6782176.42,13198844.67
312780,202307,470,361,109,476527.73,145202.81,621730.54
312790,202307,22,16,6,21120,7920.9,29040.9
312800,202307,1798,1238,560,1635496.59,740523.2,2376019.79
312810,202307,373,260,113,343201.24,149160,492361.24
312820,202307,205,160,45,211202.49,60720,271922.49
312825,202307,47,35,12,46203.48,15840,62043.48
312830,202307,202,111,91,146521.94,120121.35,266643.29
312840,202307,215,150,65,198001.28,85800,283801.28
312850,202307,37,32,5,42241.63,6600,48841.63
312860,202307,162,107,55,141241.28,72600.47,213841.75
312870,202307,1310,690,620,913464.51,819720.79,1733185.30
312880,202307,133,100,33,132003.69,43560,175563.69
312890,202307,182,130,52,171603.84,68640,240243.84
312900,202307,161,123,38,162361.92,50160,212521.92
312910,202307,189,105,84,138605.63,110882.13,249487.76
312920,202307,117,67,50,88440.42,66000,154440.42
312930,202307,351,228,123,302283.46,162361.79,464645.25
312940,202307,167,114,53,150480.28,69960,220440.28
312950,202307,812,576,236,760340.3,314162.94,1074503.24
312960,202307,152,111,41,146528.05,54120.99,200649.04
312965,202307,125,98,27,129360.1,35640,165000.1
312970,202307,313,250,63,330010.73,83161.11,413171.84
312980,202307,2941,1542,1399,2036823.76,1850649.31,3887473.07
312990,202307,49,20,29,26400.9,38280,64680.9
313000,202307,58,32,26,42240.86,34320,76560.86
313005,202307,193,147,46,194040.91,60720.79,254761.70
313010,202307,1079,476,603,629657.41,795967.56,1425624.97
313020,202307,194,103,91,135960,121440,257400
313030,202307,221,147,74,194041.64,97680.76,291722.40
313040,202307,104,30,74,39600.73,97680,137280.73
313050,202307,228,167,61,220440,80520,300960
313055,202307,45,31,14,40920,18480,59400
313060,202307,159,112,47,147841.05,62040,209881.05
313065,202307,61,47,14,62040,18480,80520
313070,202307,125,65,60,85802.45,79200,165002.45
313080,202307,47,25,22,33000,29040,62040
313090,202307,736,480,256,634926.94,339240.49,974167.43
313100,202307,226,85,141,112200.2,186120,298320.2
313110,202307,172,95,77,125401.29,101641.56,227042.85
313115,202307,290,159,131,209882.96,174241.26,384124.22
313120,202307,915,527,388,695652.96,512163.25,1207816.21
313130,202307,6692,3750,2942,4952795.8,3886109.43,8838905.23
313140,202307,148,87,61,114842.33,80521.35,195363.68
313150,202307,314,244,70,322083.4,92400,414483.4
313160,202307,194,147,47,194044.9,62040,256084.9
313170,202307,1551,980,571,1294964.86,753723.73,2048688.59
313180,202307,374,238,136,315485.59,179523.59,495009.18
313190,202307,831,474,357,625696.04,471243.3,1096939.34
313200,202307,35,30,5,39600.78,6600,46200.78
313210,202307,1064,908,156,1198620.17,205923.54,1404543.71
313220,202307,348,209,139,275880,183480,459360
313230,202307,318,248,70,327361.41,92400.03,419761.44
313240,202307,2510,1256,1254,1659275.99,1656600.83,3315876.82
313250,202307,1296,970,326,1281752.28,430324.9,1712077.18
313260,202307,109,54,55,71281.1,72600,143881.1
313270,202307,1136,679,457,896291.2,604564.59,1500855.79
313280,202307,45,34,11,44880,14520,59400
313290,202307,242,193,49,256086.25,64680,320766.25
313300,202307,352,172,180,227045.47,238920.58,465966.05
313310,202307,273,123,150,162362.17,198001.1,360363.27
313320,202307,418,309,109,407882.95,143880.07,551763.02
313330,202307,1527,954,573,1260629.9,757685.87,2018315.77
313340,202307,355,256,99,337926.83,132000.91,469927.74
313350,202307,464,285,179,376201.74,236280.24,612481.98
313360,202307,221,101,120,133320.84,158400,291720.84
313370,202307,249,92,157,121441.42,207240,328681.42
313375,202307,347,223,124,294364.58,165000.97,459365.55
313380,202307,1414,742,672,979466.2,887041.73,1866507.93
313390,202307,56,49,7,64680,9240,73920
313400,202307,429,305,124,402617.58,163682.92,566300.50
313410,202307,104,66,38,87120.7,50160,137280.7
313420,202307,5040,2907,2133,3840007.6,2820855.23,6660862.83
313430,202307,126,61,65,80520.31,85800.33,166320.64
313440,202307,1457,1036,421,1368900.35,555729.58,1924629.93
313450,202307,76,32,44,42240,58080,100320
313460,202307,423,187,236,246844.8,312841.92,559686.72
313470,202307,535,261,274,344532.12,361685.8,706217.92
313480,202307,172,132,40,175561.77,52800,228361.77
313490,202307,612,280,332,370934.97,438248.06,809183.03
313500,202307,32,18,14,23760,18480,42240
313505,202307,1162,892,270,1177476.62,356407.99,1533884.61
313507,202307,122,84,38,110881.46,50160,161041.46
313510,202307,3180,1960,1220,2587409.5,1610426.37,4197835.87
313520,202307,3645,2814,831,3714629.89,1096930.38,4811560.27
313530,202307,44,27,17,35640,22440.94,58080.94
313535,202307,102,82,20,108243.31,26400.5,134643.81
313540,202307,70,49,21,64680,29040,93720
313545,202307,132,113,19,149160.8,25080,174240.8
313550,202307,230,194,36,257402.82,47521,304923.82
313560,202307,372,180,192,238926.8,256085.33,495012.13
313570,202307,89,31,58,40920,76560.06,117480.06
313580,202307,1462,874,588,1153700.88,777484.27,1931185.15
313590,202307,83,52,31,68640.76,40921.3,109562.06
313600,202307,724,443,281,584766.36,372241.14,957007.50
313610,202307,64,51,13,67321.62,17160.35,84481.97
313620,202307,1642,798,844,1053396.45,1118044.85,2171441.30
313630,202307,1823,1385,438,1828243.73,578163.03,2406406.76
313640,202307,117,69,48,91081.08,63360.7,154441.78
313650,202307,254,135,119,178201.33,157081.8,335283.13
313652,202307,35,33,2,43560,2640,46200
313655,202307,102,69,33,91080.76,43560.73,134641.49
313657,202307,54,49,5,64681.91,6600,71281.91
313660,202307,156,105,51,138601.81,68640.98,207242.79
313665,202307,787,367,420,485775.97,554409.57,1040185.54
313670,202307,12230,8427,3803,11130740.87,5029241.93,16159982.80
313680,202307,48,38,10,50160.73,13200,63360.73
313690,202307,141,102,39,135961.29,51480,187441.29
313695,202307,93,72,21,95040.76,27720,122760.76
313700,202307,392,306,86,403926.58,113520.88,517447.46
313710,202307,126,91,35,121442.02,46200,167642.02
313720,202307,1296,610,686,805233.11,906849.33,1712082.44
313730,202307,81,47,34,62041.63,44880,106921.63
313740,202307,165,122,43,161040.83,56760,217800.83
313750,202307,425,299,126,394685.67,166320.79,561006.46
313753,202307,250,192,58,253443.85,76560.1,330003.95
313760,202307,1524,599,925,792018.45,1222332.56,2014351.01
313770,202307,458,307,151,405250.38,199322.87,604573.25
313780,202307,949,525,424,694326.35,559684.06,1254010.41
313790,202307,36,36,0,47520,,47520.0
313800,202307,175,111,64,146526.32,84481.72,231008.04
313810,202307,101,57,44,75240.81,58081.02,133321.83
313820,202307,1528,732,796,966263.54,1054681.32,2020944.86
313830,202307,59,39,20,51480.89,26400,77880.89
313835,202307,70,60,10,79200.2,13200,92400.2
313840,202307,1890,1149,741,1516734.25,978125.32,2494859.57
313850,202307,237,107,130,141244.69,171600.5,312845.19
313860,202307,518,390,128,514810.63,168960.64,683771.27
313862,202307,186,132,54,175566.22,71280,246846.22
313865,202307,199,138,61,182161.06,80520,262681.06
313867,202307,65,54,11,71280,14520.1,85800.1
313868,202307,58,37,21,48840.5,27720,76560.5
313870,202307,84,47,37,62040.2,48840,110880.2
313880,202307,417,257,160,339244.12,211200.69,550444.81
313890,202307,363,201,162,265325.07,213840.63,479165.70
313900,202307,898,493,405,650777.39,534608.68,1185386.07
313910,202307,149,100,49,132000.04,64680,196680.04
313920,202307,701,484,217,638883.55,287761.14,926644.69
313925,202307,37,31,6,40920,7920,48840
313930,202307,973,746,227,984762.78,299644.56,1284407.34
313940,202307,2141,1282,859,1693596.04,1137848.06,2831444.10
313950,202307,932,571,361,753735.32,476520.79,1230256.11
313960,202307,1585,920,665,1215740.94,877806.1,2093547.04
313970,202307,197,111,86,146520.1,113520,260040.1
313980,202307,267,170,97,224407.72,128041.84,352449.56
313990,202307,301,179,122,236280.82,161040,397320.82
314000,202307,969,635,334,839534.62,440884.24,1280418.86
314010,202307,117,75,42,99000.15,55440,154440.15
314015,202307,112,33,79,43560.63,104280.9,147841.53
314020,202307,62,40,22,52800.84,29040,81840.84
314030,202307,80,41,39,54120.72,51480,105600.72
314040,202307,49,26,23,34320,30360,64680
314050,202307,309,172,137,227045.27,180840,407885.27
314053,202307,100,63,37,83161.2,48840,132001.2
314055,202307,326,211,115,278525.21,151801.54,430326.75
314060,202307,133,114,19,150480.59,25080,175560.59
314070,202307,1159,579,580,764303.4,765612.56,1529915.96
314080,202307,231,140,91,184805.4,121441,306246.4
314085,202307,206,142,64,187440.8,84480,271920.8
314090,202307,445,321,124,423728.16,163680.16,587408.32
314100,202307,569,447,122,590056.28,161043.32,751099.60
314110,202307,828,358,470,472576.83,621724.06,1094300.89
314120,202307,70,44,26,58080,34320,92400
314130,202307,29,21,8,27720,10560,38280
314140,202307,1287,814,473,1074502.58,624365.19,1698867.77
314150,202307,209,134,75,176883.41,100320.37,277203.78
314160,202307,323,243,80,320763.1,105600.56,426363.66
314170,202307,90,67,23,88441.39,30360,118801.39
314180,202307,818,728,90,960989.49,118801.27,1079790.76
314190,202307,92,57,35,75241.18,46200,121441.18
314200,202307,559,391,168,516137.37,221766.83,737904.20
314210,202307,249,193,56,254763.77,73920,328683.77
314220,202307,335,236,99,311525.22,130681.32,442206.54
314225,202307,39,24,15,31680.48,19800,51480.48
314230,202307,130,58,72,76560.55,95040,171600.55
314240,202307,194,140,54,184802.7,71280,256082.7
314250,202307,58,36,22,47522.36,29040,76562.36
314260,202307,223,114,109,150480.69,143880,294360.69
314270,202307,439,341,98,451456.89,129361.1,580817.99
314280,202307,775,421,354,555671.22,468603.39,1024274.61
314290,202307,578,451,127,595327.63,168960.72,764288.35
314300,202307,346,261,85,344528.7,113520,458048.7
314310,202307,1404,968,436,1277800.04,575520.21,1853320.25
314315,202307,53,39,14,51480.54,18480,69960.54
314320,202307,633,449,184,592691.03,242882.6,835573.63
314330,202307,12924,6324,6600,8351964.43,8726576.09,17078540.52
314340,202307,719,326,393,430330.6,518764.77,949095.37
314345,202307,62,46,16,60720,21120,81840
314350,202307,186,113,73,149160.88,96360.66,245521.54
314360,202307,58,34,24,44882.78,31681.04,76563.82
314370,202307,77,55,22,72600,29040,101640
314380,202307,145,79,66,104280.81,87120,191400.81
314390,202307,3850,2501,1349,3302758.52,1784641.93,5087400.45
314400,202307,754,526,228,694332.87,300961.96,995294.83
314410,202307,592,394,198,520093.01,261362.28,781455.29
314420,202307,29,19,10,25080,13200,38280
314430,202307,2616,1015,1601,1339839.14,2114673.04,3454512.18
314435,202307,159,96,63,126721.05,83160,209881.05
314437,202307,56,44,12,59400,15840,75240
314440,202307,105,65,40,85800.74,52800.1,138600.84
314450,202307,180,124,56,163681.34,73920.96,237602.30
314460,202307,660,330,330,435606.63,435603.89,871210.52
314465,202307,134,86,48,113520.99,63360,176880.99
314467,202307,79,64,15,84480,19800,104280
314470,202307,448,225,223,297002.05,294362.65,591364.70
314480,202307,1185,543,642,716773.59,848763.95,1565537.54
314490,202307,43,22,21,29040,27720,56760
314500,202307,289,196,93,258725.69,122760.45,381486.14
314505,202307,126,79,47,104281.9,62040,166321.9
314510,202307,265,214,51,282485.14,67320,349805.14
314520,202307,1545,786,759,1038876.9,1003211.09,2042087.99
314530,202307,828,661,167,875191.52,220443.41,1095634.93
314535,202307,193,123,70,162360,92400,254760
314537,202307,72,44,28,58080.97,36960.98,95041.95
314540,202307,23,14,9,18480,11880,30360
314545,202307,70,48,22,63360,30360,93720
314550,202307,83,47,36,62040.84,48841.83,110882.67
314560,202307,921,496,425,654733.19,563646.08,1218379.27
314570,202307,16,14,2,18480.56,2640,21120.56
314580,202307,12,4,8,5280,10560,15840
314585,202307,34,26,8,34320,10560.16,44880.16
314587,202307,83,69,14,91080.7,18480,109560.7
314590,202307,659,446,213,588735.31,281161.64,869896.95
314600,202307,1062,693,369,916115.98,487089.71,1403205.69
314610,202307,1064,552,512,728652.53,675846.56,1404499.09
314620,202307,160,122,38,161040.6,50160,211200.6
314625,202307,100,78,22,102960.91,29040,132000.91
314630,202307,1192,684,508,902904.99,670566.6,1573471.59
314640,202307,97,59,38,77881.81,50160,128041.81
314650,202307,164,96,68,126722.65,89760.73,216483.38
314655,202307,66,48,18,63360,23760,87120
314660,202307,21,17,4,22440,5280,27720
314670,202307,234,183,51,241572.18,67322.96,308895.14
314675,202307,228,142,86,187441.94,113520.23,300962.17
314690,202307,599,322,277,425047.24,365642.32,790689.56
314700,202307,2316,1238,1078,1634219.97,1426925.27,3061145.24
314710,202307,2023,1117,906,1475788.39,1201201.62,2676990.01
314720,202307,451,248,203,327368.09,267961.25,595329.34
314730,202307,544,290,254,382805.99,335282.49,718088.48
314740,202307,873,391,482,517450.99,638883.59,1156334.58
314750,202307,28,21,7,27720,9240,36960
314760,202307,386,158,228,208562.13,300960.88,509523.01
314770,202307,105,67,38,88441.39,50160,138601.39
314780,202307,19,8,11,10560,14520,25080
314790,202307,2756,1773,983,2340428.52,1298881.71,3639310.23
314795,202307,78,67,11,88440.2,14520,102960.2
314800,202307,3184,1884,1300,2488257.48,1717323.71,4205581.19
314810,202307,1628,935,693,1235542.21,914761.63,2150303.84
314820,202307,125,74,51,97680.89,67320.1,165000.99
314830,202307,237,200,37,264005.16,48840,312845.16
314840,202307,95,55,40,72600,52800,125400
314850,202307,474,228,246,301095.56,324720.05,625815.61
314860,202307,669,507,162,669244.45,213840.08,883084.53
314870,202307,1812,995,817,1313433.26,1078455.49,2391888.75
314875,202307,73,65,8,85800,10560,96360
314880,202307,44,32,12,42240,15840,58080
314890,202307,60,32,28,42240,36960,79200
314900,202307,27,20,7,27721.1,9240.92,36962.02
314910,202307,244,162,82,213841.79,108240,322081.79
314915,202307,152,127,25,167642.23,33000.68,200642.91
314920,202307,84,55,29,72600.85,38280,110880.85
314930,202307,1155,519,636,685100.97,840841.83,1525942.80
314940,202307,39,31,8,40920,11880,52800
314950,202307,23,18,5,23761.59,6600,30361.59
314960,202307,31,20,11,26400.73,14520.18,40920.91
314970,202307,191,86,105,113521.37,138600.68,252122.05
314980,202307,334,218,116,287763.01,153120.75,440883.76
314990,202307,484,260,224,343206.58,295681.49,638888.07
314995,202307,161,75,86,99000.96,113520,212520.96
315000,202307,106,83,23,109560.49,30360.1,139920.59
315010,202307,41,25,16,33000,21120,54120
315015,202307,174,141,33,186120.4,43560,229680.4
315020,202307,68,55,13,72600,17160,89760
315030,202307,122,91,31,120120,40920,161040
315040,202307,95,56,39,73920.37,51480,125400.37
315050,202307,224,139,85,183480.92,112200.68,295681.60
315053,202307,76,54,22,71280,29040,100320
315057,202307,134,103,31,135960.65,42240,178200.65
315060,202307,62,52,10,68641.88,13200,81841.88
315070,202307,126,78,48,102961.78,63360,166321.78
315080,202307,415,334,81,440886.15,106921.62,547807.77
315090,202307,110,64,46,84480.9,60720,145200.9
315100,202307,103,51,52,67321.39,68640.38,135961.77
315110,202307,298,155,143,204603.37,188760,393363.37
315120,202307,2021,947,1074,1250090.05,1419028.13,2669118.18
315130,202307,379,268,111,355084.23,146521.28,501605.51
315140,202307,583,313,270,413170.49,357724.93,770895.42
315150,202307,1043,512,531,675862.32,700925.7,1376788.02
315160,202307,207,111,96,146526.65,126724.31,273250.96
315170,202307,309,197,112,260042.85,147840.8,407883.65
315180,202307,3516,1506,2010,1987978.61,2657176.68,4645155.29
315190,202307,303,186,117,246844.74,154440.25,401284.99
315200,202307,1327,821,506,1083745.64,667924.05,1751669.69
315210,202307,1955,1200,755,1585356.64,1001883.07,2587239.71
315213,202307,26,16,10,21121.63,13200,34321.63
315217,202307,238,186,52,245521.85,68640.55,314162.40
315220,202307,1727,1272,455,1679083.25,600608.8,2279692.05
315230,202307,202,157,45,207242.31,59400,266642.31
315240,202307,394,263,131,347168.63,174242.3,521410.93
315250,202307,2953,1421,1532,1877103.51,2023564.41,3900667.92
315260,202307,142,82,60,108240,79200.1,187440.1
315270,202307,160,113,47,149160.8,62040,211200.8
315280,202307,666,435,231,574225.16,304931.37,879156.53
315290,202307,206,133,73,176882.52,96360.19,273242.71
315300,202307,112,86,26,113520.01,34320,147840.01
315310,202307,91,81,10,106920,13200,120120
315320,202307,145,95,50,125405.39,66000,191405.39
315330,202307,65,53,12,69960,15840,85800
315340,202307,403,293,110,386764.36,145201.76,531966.12
315350,202307,171,110,61,145201.38,80520.34,225721.72
315360,202307,114,55,59,72600.15,77880.23,150480.38
315370,202307,61,40,21,52801.26,27720,80521.26
315380,202307,6,5,1,6600,1320,7920
315390,202307,75,28,47,36960,62041.31,99001.31
315400,202307,920,699,221,922697.94,293041.19,1215739.13
315410,202307,336,202,134,266653.18,176884.52,443537.70
315415,202307,60,45,15,59400.27,19800,79200.27
315420,202307,214,155,59,204602.24,77880,282482.24
315430,202307,666,370,296,488404.9,390720.59,879125.49
315440,202307,97,62,35,81840.2,46200,128040.2
315445,202307,246,203,43,267968.81,56760.37,324729.18
315450,202307,184,134,50,176880,66000,242880
315460,202307,5417,2523,2894,3334456.66,3822768.01,7157224.67
315470,202307,53,21,32,27720.9,42240,69960.9
315480,202307,92,31,61,40922.07,80522.19,121444.26
315490,202307,767,502,265,662649,351120.48,1013769.48
315500,202307,25,21,4,27720,5280,33000
315510,202307,171,122,49,161040.83,64680,225720.83
315520,202307,79,66,13,87120.5,17160,104280.5
315530,202307,48,28,20,36960,26400.2,63360.2
315540,202307,283,195,88,257403.28,116160.39,373563.67
315550,202307,202,161,41,212520.7,54120,266640.7
315560,202307,755,599,156,790698.04,205923.81,996621.85
315570,202307,328,161,167,212524.77,220440.91,432965.68
315580,202307,808,556,252,733926.82,333960.96,1067887.78
315590,202307,198,101,97,133322.17,128040.63,261362.80
315600,202307,385,301,84,397324.74,110880.78,508205.52
315610,202307,109,53,56,69960,73920,143880
315620,202307,42,30,12,39602.64,15840,55442.64
315630,202307,138,104,34,138600.26,44880,183480.26
315640,202307,62,40,22,52800.98,29040,81840.98
315645,202307,55,38,17,50160,22440,72600
315650,202307,175,130,45,171600.99,59400,231000.99
315660,202307,445,211,234,278531.14,310205.4,588736.54
315670,202307,2648,1204,1444,1590658.32,1907422.41,3498080.73
315680,202307,801,582,219,769568.09,289080,1058648.09
315690,202307,732,492,240,649455.63,316802.54,966258.17
315700,202307,2194,1153,1041,1522004.1,1376790.37,2898794.47
315710,202307,394,137,257,180841.49,339240.18,520081.67
315720,202307,547,332,215,438247.57,283800.92,722048.49
315725,202307,217,171,46,225720.27,60720,286440.27
315727,202307,105,67,38,88444.67,50160,138604.67
315730,202307,59,52,7,68640,9240,77880
315733,202307,92,52,40,68640.2,52800,121440.2
315737,202307,51,40,11,52800.86,14520,67320.86
315740,202307,32,25,7,33000.35,9240,42240.35
315750,202307,180,128,52,168960.17,68640,237600.17
315760,202307,47,35,12,46200,15840,62040
315765,202307,146,85,61,112204.05,80522.44,192726.49
315770,202307,260,177,83,233643.46,109560.64,343204.10
315780,202307,4472,2219,2253,2929166.71,2975289.5,5904456.21
315790,202307,263,202,61,266644.32,80520.87,347165.19
315800,202307,348,229,119,302283.7,157080,459363.7
315810,202307,65,39,26,51481.16,34320,85801.16
315820,202307,817,617,200,814465.42,266644.29,1081109.71
315830,202307,130,88,42,116161.02,55440.39,171601.41
315840,202307,88,62,26,81840,34320.66,116160.66
315850,202307,280,185,95,244205.52,125400.8,369606.32
315860,202307,21,9,12,11880,15840,27720
315870,202307,42,33,9,43561.04,11880,55441.04
315880,202307,104,68,36,89760,47520,137280
315890,202307,111,79,32,104281.44,42240,146521.44
315895,202307,425,283,142,373576.9,187441.44,561018.34
315900,202307,95,44,51,58080,67320.08,125400.08
315910,202307,52,32,20,42240,26400,68640
315920,202307,162,108,54,143882.57,71280,215162.57
315930,202307,55,20,35,26403,46200.91,72603.91
315935,202307,136,108,28,142563.04,36960,179523.04
315940,202307,103,75,28,99000,36960,135960
315950,202307,43,34,9,44880,11880.35,56760.35
315960,202307,632,300,332,396011.32,438245.91,834257.23
315970,202307,35,30,5,39600.96,6600,46200.96
315980,202307,712,376,336,496334.35,443521.66,939856.01
315990,202307,272,154,118,203282.39,155760.62,359043.01
316000,202307,52,32,20,42240,26400,68640
316010,202307,104,89,15,117481.48,19800,137281.48
316020,202307,102,92,10,121441.25,13200,134641.25
316030,202307,387,227,160,299646.59,211202.19,510848.78
316040,202307,591,245,346,323403.75,458040.61,781444.36
316045,202307,57,51,6,67320,7920,75240
316050,202307,29,20,9,26400,11880,38280
316060,202307,113,81,32,106921.17,43560,150481.17
316070,202307,1352,917,435,1211795.14,574204.26,1785999.40
316080,202307,101,66,35,87236.76,46200,133436.76
316090,202307,40,19,21,25080,27720.36,52800.36
316095,202307,92,79,13,104281.75,17160.44,121442.19
316100,202307,376,208,168,274564.7,221760.32,496325.02
316105,202307,61,38,23,50160.62,30360,80520.62
316110,202307,1990,1527,463,2018326.73,611168.64,2629495.37
316120,202307,76,51,25,68640,33000,101640
316130,202307,126,93,33,122762.86,43560,166322.86
316140,202307,33,22,11,29040,14520,43560
316150,202307,248,177,71,233642.69,93720.33,327363.02
316160,202307,87,58,29,76561.81,38280.28,114842.09
316165,202307,77,48,29,63360.78,38280,101640.78
316170,202307,194,123,71,162360.07,93720,256080.07
316180,202307,233,92,141,121443.87,186121.85,307565.72
316190,202307,153,109,44,143881.39,58080,201961.39
316200,202307,739,407,332,538574.65,440881.24,979455.89
316210,202307,800,554,246,731531.3,324721.59,1056252.89
316220,202307,138,87,51,114841.79,67320,182161.79
316225,202307,42,27,15,35641.02,19800,55441.02
316230,202307,51,29,22,38280.78,29040,67320.78
316240,202307,717,563,154,743177.11,203284.37,946461.48
316245,202307,178,157,21,207242.82,27720.99,234963.81
316250,202307,1813,1201,612,1585371.96,807843.48,2393215.44
316255,202307,144,112,32,147840,42240.92,190080.92
316257,202307,186,93,93,122761.37,122761.46,245522.83
316260,202307,221,147,74,194042.18,97680,291722.18
316265,202307,41,30,11,39601.46,14520.67,54122.13
316270,202307,726,509,217,671892.71,286442.24,958334.95
316280,202307,625,403,222,533291.11,293041.2,826332.31
316290,202307,942,658,284,868581.69,374884.09,1243465.78
316292,202307,703,293,410,386768.58,541203.73,927972.31
316294,202307,116,73,43,96361.9,56760,153121.9
316295,202307,437,207,230,273245.75,303606.49,576852.24
316300,202307,39,25,14,33000,18480,51480
316310,202307,24,13,11,17160,14520,31680
316320,202307,77,35,42,46200.75,55440,101640.75
316330,202307,188,135,53,178200.88,69960,248160.88
316340,202307,146,95,51,125400,67320,192720
316350,202307,206,140,66,184800.59,87120.2,271920.79
316360,202307,29,18,11,23760,14520,38280
316370,202307,1450,712,738,941179.97,978125.49,1919305.46
316380,202307,127,100,27,132000.72,36960,168960.72
316390,202307,104,76,28,100320,36960,137280
316400,202307,186,139,47,183483.8,62040.36,245524.16
316410,202307,333,240,93,316801.84,122760.2,439562.04
316420,202307,233,154,79,203286.47,104281.59,307568.06
316430,202307,175,99,76,130680.46,100320,231000.46
316440,202307,80,44,36,58080.58,47520.08,105600.66
316443,202307,48,40,8,52800.88,10560,63360.88
316447,202307,53,44,9,58082.64,11880,69962.64
316450,202307,265,196,69,258721.17,91080,349801.17
316460,202307,51,17,34,22440.43,44880.34,67320.77
316470,202307,1930,1423,507,1882365.51,670561.37,2552926.88
316480,202307,9,7,2,9240,2640,11880
316490,202307,22,6,16,7920,21120,29040
316500,202307,183,118,65,155760.27,85800,241560.27
316510,202307,145,116,29,153121.8,38280,191401.8
316520,202307,190,104,86,137281.05,113520.67,250801.72
316530,202307,189,121,68,159721.21,89760,249481.21
316540,202307,171,91,80,120121.1,105600.65,225721.75
316550,202307,186,116,70,153122.3,92400,245522.3
316553,202307,524,263,261,347167.53,345842.06,693009.59
316555,202307,73,65,8,85800.8,10560,96360.8
316556,202307,19,13,6,17160.41,7920,25080.41
316557,202307,47,34,13,44881.07,17160,62041.07
316560,202307,77,54,23,71280.2,30360,101640.2
316570,202307,239,219,20,289082.39,26400,315482.39
316580,202307,27,18,9,23760,11880,35640
316590,202307,91,77,14,101640.82,18480.4,120121.22
316600,202307,182,152,30,200641.96,39600,240241.96
316610,202307,72,52,20,68640.55,26400,95040.55
316620,202307,159,111,48,146520,63360.85,209880.85
316630,202307,70,52,18,68640,23760,92400
316640,202307,24,13,11,18480,14520,33000
316650,202307,124,98,26,129360.14,34320,163680.14
316660,202307,4,1,3,1320,3960,5280
316670,202307,445,151,294,199323.87,388082.92,587406.79
316680,202307,187,146,41,192724.48,54120,246844.48
316690,202307,156,97,59,128040,77880,205920
316695,202307,56,47,9,62040,11880,73920
316700,202307,31,22,9,29040,11880,40920
316710,202307,874,662,212,875174.11,279843.4,1155017.51
316720,202307,5709,2667,3042,3520549.23,4020730.6,7541279.83
316730,202307,16,14,2,18480,2640,21120
316740,202307,174,109,65,143880.1,85800,229680.1
316750,202307,19,11,8,14520.32,10560,25080.32
316760,202307,372,291,81,384128.12,106921.06,491049.18
316770,202307,189,104,85,137281.59,112200,249481.59
316780,202307,68,38,30,50160,39600,89760
316790,202307,76,51,25,67320.27,33000.5,100320.77
316800,202307,1917,1163,754,1536517.22,995297.23,2531814.45
316805,202307,36,23,13,30360.08,17160,47520.08
316810,202307,54,32,22,42240.7,29040.45,71281.15
316820,202307,41,25,16,33000,22440,55440
316830,202307,108,50,58,67320.53,76560.2,143880.73
316840,202307,535,327,208,432964.58,275882.43,708847.01
316850,202307,318,222,96,293043.3,126720,419763.3
316860,202307,6912,3168,3744,4185596.06,4952662.11,9138258.17
316870,202307,1936,1259,677,1661955.07,896286.48,2558241.55
316880,202307,171,88,83,116163.78,109561.44,225725.22
316890,202307,238,155,83,204602.33,109560.69,314163.02
316900,202307,467,331,136,436924.27,179520,616444.27
316905,202307,28,12,16,15840,21120,36960
316910,202307,91,38,53,50160,69960,120120
316920,202307,169,130,39,171605.04,51480,223085.04
316930,202307,2230,1136,1094,1500864.59,1445402.61,2946267.20
316935,202307,1059,625,434,826335.45,574208.29,1400543.74
316940,202307,1197,703,494,929299.84,653401.15,1582700.99
316950,202307,218,108,110,142561.01,145200,287761.01
316960,202307,1170,653,517,861988.26,683771.95,1545760.21
316970,202307,711,567,144,748461.84,192723.23,941185.07
316980,202307,90,49,41,66000,54120,120120
316990,202307,2480,1690,790,2230856.8,1042804.34,3273661.14
317000,202307,363,281,82,372251.4,108241.84,480493.24
317005,202307,235,165,70,217805.41,92400.9,310206.31
317010,202307,7609,4378,3231,5781870.75,4267615.92,10049486.67
317020,202307,17037,7534,9503,9958487.75,12557257.9,22515745.65
317030,202307,103,49,54,65560,71280,136840
317040,202307,3326,2200,1126,2905396.25,1488969.28,4394365.53
317043,202307,79,63,16,83167.29,21121.27,104288.56
317047,202307,44,28,16,36960,21120,58080
317050,202307,173,138,35,182163.18,46200,228363.18
317052,202307,166,137,29,180841.57,38280,219121.57
317057,202307,200,151,49,199322.58,64680,264002.58
317060,202307,66,39,27,51480.45,35640.8,87121.25
317065,202307,55,42,13,55440,17160,72600
317070,202307,2148,999,1149,1320047.76,1521961.98,2842009.74
317075,202307,99,57,42,75240.25,55440,130680.25
317080,202307,1025,524,501,691712.45,662642.12,1354354.57
317090,202307,773,598,175,789378.42,231004.53,1020382.95
317100,202307,478,354,124,467287.65,163680.95,630968.60
317103,202307,144,117,27,154442.08,35640,190082.08
317107,202307,62,49,13,64680,17160,81840
317110,202307,82,45,37,59400.2,48841.34,108241.54
317115,202307,50,44,6,58142.04,7920,66062.04
317120,202307,2357,1193,1164,1577461.95,1536493.41,3113955.36
317130,202307,2287,1560,727,2059226.21,962284.29,3021510.50
317140,202307,16,13,3,17161.2,3960,21121.2
317150,202307,307,182,125,240242.97,165000.98,405243.95
317160,202307,379,281,98,370923.96,129360.98,500284.94
317170,202307,255,166,89,219121.01,118800.6,337921.61
317180,202307,453,308,145,406564.39,191402.1,597966.49
317190,202307,266,192,74,253441.79,97680,351121.79
317200,202307,951,668,283,881794.56,373568.54,1255363.10
317210,202307,188,98,90,129364.68,118800.21,248164.89
317220,202307,25,11,14,14520,18480,33000
320010,202307,599,426,173,563659.46,228367.41,792026.87
320013,202307,152,97,55,130684.35,73921.58,204605.93
320016,202307,274,165,109,217805.95,143880,361685.95
320020,202307,808,479,329,632305.13,434289.75,1066594.88
320030,202307,187,130,57,171602.87,75241.62,246844.49
320035,202307,148,97,51,128040.2,67320.3,195360.5
320040,202307,516,254,262,335291.04,345849.89,681140.93
320050,202307,129,87,42,114848.1,55441.05,170289.15
320060,202307,2115,996,1119,1314769.89,1482384.18,2797154.07
320070,202307,118,75,43,99000.25,56760,155760.25
320080,202307,887,500,387,661341.64,510845.9,1172187.54
320090,202307,1467,935,532,1234233.64,702256.96,1936490.60
320100,202307,404,224,180,295689.62,237602.7,533292.32
320110,202307,143,89,54,117487.91,71280.73,188768.64
320115,202307,124,106,18,139924.24,23760,163684.24
320120,202307,4229,2227,2002,2943709.69,2644003.97,5587713.66
320130,202307,9161,3932,5229,5193091.84,6911640.01,12104731.85
320140,202307,569,364,205,480504.4,270608.46,751112.86
320150,202307,2413,1343,1070,1774158.43,1412414.65,3186573.08
320160,202307,716,306,410,403929.08,542523.02,946452.10
320170,202307,123,99,24,130681.72,31680.02,162361.74
320180,202307,60,34,26,44881.32,34320,79201.32
320190,202307,279,160,119,211207.06,157080.1,368287.16
320200,202307,67,55,12,72603.23,15840,88443.23
320210,202307,1007,551,456,727340.46,601927.23,1329267.69
320220,202307,314,108,206,142560.5,271920.2,414480.7
320225,202307,94,78,16,102960.39,21120.14,124080.53
320230,202307,811,524,287,691713.12,378848.02,1070561.14
320240,202307,3955,1775,2180,2343087.65,2878960.13,5222047.78
320245,202307,590,402,188,531974.97,248166.6,780141.57
320250,202307,262,125,137,165006.47,182163.02,347169.49
320255,202307,127,94,33,124082.86,43560.66,167643.52
320260,202307,335,175,160,231001.09,211202.57,442203.66
320265,202307,159,122,37,162361.73,48840.06,211201.79
320270,202307,167,124,43,163681.9,56761.35,220443.25
320280,202307,1559,885,674,1169564.78,896300.6,2065865.38
320290,202307,74,58,16,76560.9,21120,97680.9
320300,202307,685,470,215,620421.4,283802.8,904224.2
320305,202307,843,472,371,623064.61,489734.07,1112798.68
320310,202307,227,136,91,179523.44,120120.9,299644.34
320313,202307,406,178,228,234968.56,300961.4,535929.96
320316,202307,116,86,30,113522.01,39600.3,153122.31
320320,202307,3841,1741,2100,2299510.13,2773359.33,5072869.46
320330,202307,318,229,89,302281.52,117480,419761.52
320332,202307,878,525,353,693039.88,465976.4,1159016.28
320334,202307,310,169,141,223082.64,186121.3,409203.94
320335,202307,155,100,55,132005.68,72601.51,204607.19
320340,202307,653,466,187,616469.37,246848.34,863317.71
320350,202307,1229,508,721,670585.74,951734.33,1622320.07
320360,202307,186,84,102,110881,134640,245521
320370,202307,250,186,64,245526.18,84480.69,330006.87
320380,202307,371,267,104,352449.66,137280.89,489730.55
320390,202307,1253,726,527,958351.18,695648.76,1653999.94
320400,202307,353,243,110,320773.85,145201.2,465975.05
320405,202307,1064,429,635,566306.78,839540.9,1405847.68
320410,202307,1033,506,527,667940.34,695645.61,1363585.95
320420,202307,674,306,368,403937.22,487095.19,891032.41
320425,202307,232,121,111,159722.73,147840.3,307563.03
320430,202307,439,231,208,304931.27,274569.05,579500.32
320435,202307,211,143,68,190082.51,89761.71,279844.22
320440,202307,232,129,103,170283.41,135963.84,306247.25
320450,202307,152,79,73,104282.03,96361.06,200643.09
320455,202307,258,199,59,262684.78,77880.66,340565.44
320460,202307,368,222,146,293043.32,192720.21,485763.53
320465,202307,129,88,41,116165.43,54120.7,170286.13
320470,202307,834,496,338,654750.41,446172.12,1100922.53
320480,202307,251,164,87,216488.88,116160.02,332648.90
320490,202307,3667,1747,1920,2306134.19,2534461.67,4840595.86
320495,202307,139,81,58,106921.37,76560.77,183482.14
320500,202307,11812,5744,6068,7592987.74,8015167.09,15608154.83
320501,202307,616,319,297,421099.1,393371.05,814470.15
320503,202307,355,248,107,327366.76,142561.08,469927.84
320506,202307,313,213,100,281164.06,132000.38,413164.44
320510,202307,1434,631,803,832946.58,1062617.96,1895564.54
320515,202307,96,75,21,99002.72,27720,126722.72
320517,202307,257,189,68,249485.32,89760.52,339245.84
320520,202307,9260,3916,5344,5169293.79,7058152.59,12227446.38
320530,202307,8245,3936,4309,5199636.87,5698509.94,10898146.81
330010,202307,3993,1931,2062,2551661,2721874.57,5273535.57
330015,202307,232,101,131,133321.66,172920.56,306242.22
330020,202307,4614,1755,2859,2316672.17,3781840.32,6098512.49
330022,202307,292,145,147,191405.55,194040.45,385446.00
330023,202307,990,271,719,357726.04,949089.83,1306815.87
330025,202307,1122,189,933,249482.29,1232770.33,1482252.62
330030,202307,2084,1280,804,1689676.79,1061297.55,2750974.34
330040,202307,3032,1533,1499,2024950.58,1978708.93,4003659.51
330045,202307,11792,3807,7985,5029384.62,10558840.69,15588225.31
330050,202307,1008,598,410,790702.5,542526.54,1333229.04
330060,202307,1412,824,588,1091692.75,776170.14,1867862.89
330070,202307,5029,1704,3325,2250681.76,4391694.79,6642376.55
330080,202307,1838,788,1050,1042843.49,1388658.8,2431502.29
330090,202307,431,236,195,311529.11,257401.8,568930.91
330093,202307,249,106,143,139922.07,188761.48,328683.55
330095,202307,74,39,35,51480.35,46200,97680.35
330100,202307,12641,6246,6395,8253007.12,8448138.97,16701146.09
330110,202307,527,236,291,311525.83,384126.79,695652.62
330115,202307,567,279,288,368290.05,380162.15,748452.20
330120,202307,459,236,223,311525.96,294361.6,605887.56
330130,202307,1785,490,1295,649472.89,1712077.7,2361550.59
330140,202307,774,397,377,525368.25,497642.17,1023010.42
330150,202307,576,348,228,459372.34,300963.39,760335.73
330160,202307,175,108,67,142568.43,88442.08,231010.51
330170,202307,30685,10855,19830,14342443.08,26195839.59,40538282.67
330180,202307,291,155,136,204602.94,179523.27,384126.21
330185,202307,1382,541,841,714147.56,1112779.09,1826926.65
330187,202307,714,213,501,281170.93,661325.06,942495.99
330190,202307,7196,2747,4449,3630125.38,5875389.18,9505514.56
330200,202307,5248,1796,3452,2373452.12,4562010.06,6935462.18
330205,202307,555,308,247,406571.8,326043.31,732615.11
330210,202307,1009,596,413,786743.49,546485.63,1333229.12
330220,202307,3136,1831,1305,2419665.03,1722631.23,4142296.26
330225,202307,721,345,376,456728.59,497642.34,954370.93
330227,202307,2549,881,1668,1162978.74,2205792.3,3368771.04
330230,202307,259,137,122,180845.64,161043.27,341888.91
330240,202307,5087,2360,2727,3116652.48,3602342.63,6718995.11
330245,202307,186,86,100,113522.42,132000.86,245523.28
330250,202307,7560,3594,3966,4745604.04,5244443.28,9990047.32
330260,202307,895,248,647,327367.67,855364.48,1182732.15
330270,202307,4618,1486,3132,1962905.66,4135629.65,6098535.31
330280,202307,511,302,209,398659.22,277206.45,675865.67
330285,202307,7108,2290,4818,3022957.64,6370459,9393416.64
330290,202307,870,297,573,392054.48,759005.12,1151059.60
330300,202307,831,505,326,667436.24,430328.1,1097764.34
330310,202307,526,306,220,405252.28,293041.53,698293.81
330320,202307,8698,2942,5756,3887590.67,7608594.92,11496185.59
330330,202307,11546,3913,7633,5167973.4,10091529.47,15259502.87
330340,202307,3137,1708,1429,2257253.67,1888939.41,4146193.08
330350,202307,23370,8342,15028,11021227.15,19869040.84,30890267.99
330360,202307,2061,973,1088,1284417.94,1440150.58,2724568.52
330370,202307,1092,578,514,762987.81,679816.23,1442804.04
330380,202307,1176,480,696,633619.68,920052.74,1553672.42
330385,202307,747,361,386,477850.41,510843.75,988694.16
330390,202307,7136,3720,3416,4914641.96,4513213.72,9427855.68
330395,202307,453,288,165,381494.08,219124.6,600618.68
330400,202307,779,395,384,521424.58,510843.77,1032268.35
330410,202307,580,417,163,550455.27,215163.75,765619.02
330411,202307,411,219,192,289082.25,253440,542522.25
330412,202307,249,119,130,157083.42,172920.1,330003.52
330414,202307,6328,2395,3933,3165495.67,5198215.56,8363711.23
330415,202307,698,297,401,392052.27,529325,921377.27
330420,202307,2770,1429,1341,1888973.76,1771453.46,3660427.22
330430,202307,1991,846,1145,1118068.42,1516695.96,2634764.38
330440,202307,447,220,227,290406.1,299641.68,590047.78
330450,202307,139,65,74,85801.8,97681.11,183482.91
330452,202307,2867,1156,1711,1529936.14,2261185.37,3791121.51
330455,202307,144918,51049,93869,67453687.35,124059849.26,191513536.61
330460,202307,288,133,155,175562.02,204600.4,380162.42
330470,202307,1400,744,656,983423.46,865931.43,1849354.89
330475,202307,2110,644,1466,850095.47,1939096.45,2789191.92
330480,202307,882,486,396,641538.15,524045.98,1165584.13
330490,202307,19164,5912,13252,7810827.53,17519261.03,25330088.56
330500,202307,1805,782,1023,1032266.8,1351691.35,2383958.15
330510,202307,12611,4466,8145,5899336.53,10767395.66,16666732.19
330513,202307,106,56,50,73920.45,66000,139920.45
330515,202307,743,331,412,436930.87,545175.35,982106.22
330520,202307,2854,966,1888,1275170.71,2493521.56,3768692.27
330530,202307,196,113,83,149164.38,109560.1,258724.48
330540,202307,388,198,190,261363.02,250803.4,512166.42
330550,202307,3162,1061,2101,1400552.03,2775986.65,4176538.68
330555,202307,1320,475,845,628333.69,1118043.84,1746377.53
330560,202307,875,302,573,398651.15,756369.79,1155020.94
330570,202307,372,253,119,333962.44,157080.09,491042.53
330575,202307,1008,368,640,485776.08,848775.07,1334551.15
330580,202307,3948,2080,1868,2745678.64,2472391.48,5218070.12
330590,202307,270,141,129,186124.46,170282.08,356406.54
330600,202307,1635,955,680,1260647,900256.44,2160903.44
330610,202307,1815,914,901,1207347.31,1189326.68,2396673.99
330615,202307,248,196,52,258723.36,68642.93,327366.29
330620,202307,1068,458,610,605908.89,807854.07,1413762.96
330630,202307,5428,3083,2345,4072356.24,3098083.05,7170439.29
350010,202307,642,421,221,555744.65,291722.23,847466.88
350020,202307,63,24,39,31682.06,52800,84482.06
350030,202307,636,367,269,484466.61,356407.6,840874.21
350040,202307,117,51,66,67322.51,87120.68,154443.19
350050,202307,408,189,219,249487.35,289083.15,538570.50
350055,202307,148,63,85,83163.5,112200.21,195363.71
350060,202307,86,36,50,47522.06,66000.2,113522.26
350070,202307,870,477,393,630997.22,520094.81,1151092.03
350075,202307,89,52,37,68643.12,48840,117483.12
350080,202307,66,30,36,39600.82,47520.2,87121.02
350090,202307,85,46,39,60721.9,51480,112201.9
350100,202307,313,200,113,264005.5,150480,414485.5
350110,202307,49,32,17,42242.53,22440,64682.53
350115,202307,196,96,100,126724.62,132001.07,258725.69
350120,202307,123,81,42,106923.67,55440.97,162364.64
350130,202307,449,191,258,252136.34,340567.85,592704.19
350140,202307,38,23,15,30360.64,19800,50160.64
350150,202307,84,58,26,76562.23,34320.15,110882.38
350160,202307,2623,1040,1583,1372841.23,2094849.62,3467690.85
350170,202307,469,269,200,355093.31,264003.88,619097.19
350180,202307,174,93,81,122762.95,106920.41,229683.36
350190,202307,1077,582,495,768281.1,656041.31,1424322.41
350200,202307,64,27,37,35641.35,48840,84481.35
350210,202307,1427,750,677,992688.83,894981.83,1887670.66
350220,202307,663,527,136,695660.25,179522.47,875182.72
350230,202307,74,45,29,59400.67,38280.9,97681.57
350240,202307,60,38,22,50160.65,29040.65,79201.30
350250,202307,1195,523,672,691708.28,888372.22,1580080.50
350260,202307,117,83,34,109563.61,44880.87,154444.48
350270,202307,1053,690,363,910806.35,480482.84,1391289.19
350275,202307,370,138,232,182162.37,306244.48,488406.85
350280,202307,4783,2257,2526,2982020.46,3340940.98,6322961.44
350290,202307,540,231,309,304925.77,411842.42,716768.19
350300,202307,52,28,24,36965.27,31680,68645.27
350310,202307,88,51,37,67321.86,48840.59,116162.45
350315,202307,16,12,4,15840,5280,21120
350320,202307,3741,1752,1989,2315394.89,2632108.17,4947503.06
350330,202307,1825,874,951,1157681.76,1256644.8,2414326.56
350335,202307,27,17,10,22440,13200,35640
350340,202307,135,53,82,69961.3,108243.62,178204.92
350350,202307,99,46,53,62040,69960,132000
350360,202307,122,79,43,105602.87,56760.64,162363.51
350370,202307,93,53,40,69963.1,52800.48,122763.58
350380,202307,964,415,549,547816.96,724687.13,1272504.09
350390,202307,2029,763,1266,1008504.56,1675096.51,2683601.07
350395,202307,20,14,6,18480,7920,26400
350400,202307,1937,906,1031,1197281.56,1364881.51,2562163.07
350410,202307,3491,1388,2103,1834551.24,2778624.06,4613175.30
350420,202307,313,182,131,240243.42,172921.28,413164.70
350430,202307,111,56,55,73923.43,72602.52,146525.95
350440,202307,148,105,43,138610.31,56760.35,195370.66
350450,202307,1892,1027,865,1355691.55,1144442.63,2500134.18
350460,202307,468,162,306,213849.5,403930.12,617779.62
350470,202307,24,13,11,17160,14520,31680
350480,202307,221,114,107,150487.81,141241.4,291729.21
350490,202307,266,122,144,161043.02,190080.8,351123.82
350500,202307,64,20,44,26400,58080,84480
350510,202307,156,88,68,116162.84,89760.37,205923.21
350520,202307,490,262,228,345861.83,300970.1,646831.93
350530,202307,547,265,282,349816.52,372253.12,722069.64
350535,202307,103,68,35,89760.37,46200.46,135960.83
350540,202307,358,189,169,249487.04,224406.29,473893.33
350550,202307,3060,1693,1367,2238829.31,1805768.92,4044598.23
350560,202307,633,426,207,562338.24,274563.5,836901.74
350570,202307,5051,2082,2969,2749656.66,3924392.92,6674049.58
350580,202307,408,194,214,256090.33,282484.65,538574.98
350590,202307,1111,583,528,770905.39,697105.59,1468010.98
350600,202307,7141,3220,3921,4254576.77,5181047.42,9435624.19
350610,202307,1668,871,797,1149766.16,1053366.12,2203132.28
350620,202307,24,14,10,18480,13200,31680
350630,202307,276,137,139,180844.29,183482.48,364326.77
350635,202307,1508,657,851,868589.25,1123339.83,1991929.08
350640,202307,134,91,43,120120.6,56760.7,176881.3
350650,202307,2107,1375,732,1816406.38,967566.31,2783972.69
350660,202307,873,338,535,446169.33,706208.08,1152377.41
350670,202307,315,156,159,205924.13,209880.2,415804.33
350680,202307,162,86,76,113524.07,100320.92,213844.99
350690,202307,231,104,127,137282.1,167640,304922.1
350700,202307,1098,534,564,706226.34,745808.79,1452035.13
350710,202307,475,168,307,221768,405245.58,627013.58
350715,202307,61,48,13,63360.97,17160,80520.97
350720,202307,17,13,4,17160.25,5280,22440.25
350730,202307,49,30,19,39602.35,25080.61,64682.96
350740,202307,266,148,118,195363.75,155761.78,351125.53
350745,202307,35,16,19,21121.59,25080.75,46202.34
350750,202307,2858,1660,1198,2191279.78,1581374.45,3772654.23
350760,202307,4454,1862,2592,2465833.68,3425426.58,5891260.26
350770,202307,66,41,25,54120.5,33000,87120.5
350775,202307,77,55,22,72605.54,29041.58,101647.12
350780,202307,511,252,259,333974.56,341882.33,675856.89
350790,202307,389,162,227,213844.54,300965.6,514810.14
350800,202307,585,343,242,452766.08,320761.59,773527.67
350810,202307,550,415,135,547828.81,178200.39,726029.20
350820,202307,98,54,44,71281.47,58080,129361.47
350830,202307,87,44,43,58080.67,56760,114840.67
350840,202307,911,362,549,477853.21,726128.21,1203981.42
350850,202307,2086,1058,1028,1396602.8,1356968.11,2753570.91
350860,202307,782,392,390,517459.86,516130.76,1033590.62
350870,202307,498,340,158,448810.45,208561.64,657372.09
350880,202307,314,163,151,215166.39,199323.62,414490.01
350890,202307,43,25,18,34320,23760.08,58080.08
350900,202307,1812,610,1202,806549,1590628.78,2397177.78
350910,202307,28,15,13,19800,17160.36,36960.36
350920,202307,897,451,446,595331.67,588720.4,1184052.07
350925,202307,1288,632,656,835602.85,868577.52,1704180.37
350930,202307,139,76,63,100323.28,83160.28,183483.56
350940,202307,807,413,394,547827.11,520096.16,1067923.27
350945,202307,132,89,43,117482.5,56760.17,174242.67
350950,202307,20245,9394,10851,12409699.81,14347194.47,26756894.28
350960,202307,1958,785,1173,1038863.01,1551016.73,2589879.74
350970,202307,1213,567,646,749646.32,852734.59,1602380.91
350980,202307,102,68,34,89763.94,44880,134643.94
350990,202307,441,160,281,211201.65,370921.19,582122.84
350995,202307,48,20,28,26401.15,36960.84,63361.99
351000,202307,654,411,243,543859.91,322088.92,865948.83
351010,202307,55,36,19,47523.18,25080,72603.18
351015,202307,43,23,20,30360,26400,56760
351020,202307,1610,962,648,1271203.36,855369.14,2126572.50
351030,202307,370,206,164,273243.94,216480.32,489724.26
351040,202307,1171,651,520,859346.18,687724.47,1547070.65
351050,202307,4160,1872,2288,2472478.22,3022827.69,5495305.91
351060,202307,7048,2573,4475,3396481.92,5909669.39,9306151.31
351070,202307,444,277,167,365652.95,220446.77,586099.72
351080,202307,868,644,224,854064.14,298323.85,1152387.99
351090,202307,52,25,27,33001.52,35640.41,68641.93
351100,202307,461,238,223,314184.52,294372.76,608557.28
351110,202307,2319,1061,1258,1401891.68,1661883.81,3063775.49
351120,202307,69,32,37,42241.46,48840,91081.46
351130,202307,202,67,135,88442.91,178204.02,266646.93
351140,202307,344,206,138,271929.6,182163.86,454093.46
351150,202307,556,277,279,365649.16,369602.68,735251.84
351160,202307,375,202,173,266645.38,228360.72,495006.10
351170,202307,261,150,111,198004.19,146520.05,344524.24
351190,202307,108,64,44,84481.31,58080,142561.31
351200,202307,363,235,128,312849.19,168961.64,481810.83
351210,202307,141,67,74,88443.17,97680.78,186123.95
351220,202307,647,362,285,479176.02,376201.2,855377.22
351230,202307,347,214,133,282485.88,175560.8,458046.68
351240,202307,265,133,132,175562.45,174243.02,349805.47
351250,202307,96,68,28,89770.84,36960.1,126730.94
351260,202307,157,110,47,145200.28,62040.99,207241.27
351270,202307,51,23,28,30360.72,36960,67320.72
351280,202307,1141,556,585,735265.58,776171.18,1511436.76
351290,202307,270,128,142,168962.63,187440.7,356403.33
351300,202307,4647,1926,2721,2542395.11,3598368.89,6140764.00
351310,202307,793,385,408,509549.18,539895.34,1049444.52
351320,202307,125,71,54,93721.76,72600.6,166322.36
351330,202307,42,26,16,34320,21120,55440
351340,202307,1657,887,770,1170874.23,1017724.4,2188598.63
351350,202307,2731,1622,1109,2142463.15,1465208.3,3607671.45
351360,202307,872,406,466,535928.8,615124.93,1151053.73
351370,202307,489,242,247,319449.92,326040.15,645490.07
351380,202307,9555,4205,5350,5552080.51,7067311.99,12619392.50
351385,202307,26,19,7,25081.67,9240,34321.67
351390,202307,305,221,84,291727,110880.72,402607.72
351400,202307,63,42,21,55440.8,29040,84480.8
351410,202307,523,301,222,398654.52,294362.35,693016.87
351420,202307,83,59,24,77881.32,31680,109561.32
351430,202307,76,41,35,54121.03,46200.2,100321.23
351440,202307,919,602,317,795997.29,419767.28,1215764.57
351450,202307,316,159,157,209882.68,207244.7,417127.38
351460,202307,145,61,84,80523.72,110881.29,191405.01
351470,202307,149,81,68,106925.13,89760.89,196686.02
351480,202307,502,287,215,378845.48,283800.2,662645.68
351490,202307,339,134,205,176882.45,270600.72,447483.17
351492,202307,30,18,12,23760.63,15840,39600.63
351495,202307,28,20,8,26400.65,10560,36960.65
351500,202307,3741,1476,2265,1949681.1,2995099.7,4944780.8
351510,202307,2395,855,1540,1128636.71,2035457.77,3164094.48
351512,202307,16,10,6,13200,7920,21120
351515,202307,229,130,99,171606.19,130680,302286.19
351518,202307,735,434,301,572909.7,397342.93,970252.63
351519,202307,87,50,37,66002.05,48840,114842.05
351520,202307,184,115,69,151803.86,91104.78,242908.64
351530,202307,28,15,13,19800,17160,36960
351535,202307,146,86,60,113522.88,80520.89,194043.77
351540,202307,524,326,198,430336.34,262684.73,693021.07
351550,202307,1789,1041,748,1374167.42,987367.55,2361534.97
351560,202307,89,48,41,63362.16,54120,117482.16
351565,202307,17,9,8,11880.32,10560,22440.32
351570,202307,3191,1418,1773,1871830.4,2345658.63,4217489.03
351580,202307,36,33,3,43560,3960,47520
351590,202307,68,40,28,52800.96,36960.86,89761.82
351600,202307,180,131,49,172926.43,64680.76,237607.19
351610,202307,56,24,32,31680.84,42240,73920.84
351620,202307,6653,3490,3163,4608310.72,4176518.22,8784828.94
351630,202307,3810,1790,2020,2364195.67,2673025.72,5037221.39
351640,202307,2951,1277,1674,1689648.12,2212332.35,3901980.47
351650,202307,39,29,10,38281.45,13200,51481.45
351660,202307,148,89,59,117480,77880,195360
351670,202307,824,463,361,611183.18,479169.59,1090352.77
351680,202307,102,70,32,92400.9,42240,134640.9
351685,202307,16,12,4,15840.13,5280,21120.13
351690,202307,320,202,118,266649.13,155761.42,422410.55
351700,202307,194,132,62,174536,81840.2,256376.2
351710,202307,63,41,22,54122.02,29040,83162.02
351720,202307,124,70,54,92401.93,71280,163681.93
351730,202307,132,89,43,117481.24,56760,174241.24
351740,202307,860,537,323,708879.18,426366.37,1135245.55
351750,202307,417,174,243,229686.95,320761.6,550448.55
351760,202307,734,572,162,756269.95,213840.6,970110.55
351770,202307,321,255,66,336619.83,87120.56,423740.39
351780,202307,149,92,57,121442.48,75240,196682.48
351790,202307,287,139,148,183487.87,195363.24,378851.11
351800,202307,50,32,18,42240.18,23760,66000.18
351810,202307,128,80,48,105607.76,63362.08,168969.84
351820,202307,783,550,233,727366.71,307566.55,1034933.26
351830,202307,741,230,511,303610.72,674527.33,978138.05
351840,202307,2565,1134,1431,1498242.59,1888927.29,3387169.88
351850,202307,286,193,93,254768.52,122760,377528.52
351860,202307,643,424,219,559710.78,289083.09,848793.87
351870,202307,6605,2919,3686,3854556.72,4872216.71,8726773.43
351880,202307,25659,9810,15849,12958798.82,20948435.23,33907234.05
351885,202307,116,64,52,84482.6,68640.3,153122.9
351890,202307,79,52,27,68641.45,35640,104281.45
351900,202307,269,136,133,180848.28,175560.95,356409.23
351905,202307,110,53,57,69961.7,75240.24,145201.94
351907,202307,4232,1716,2516,2265196.79,3327748.14,5592944.93
351910,202307,171,74,97,97684.89,128040.93,225725.82
351920,202307,124,68,56,89760,75240,165000
351925,202307,101,59,42,77882.75,55441.51,133324.26
351930,202307,518,319,199,421102.01,264006.99,685109.00
351940,202307,257,107,150,141242.89,198001.07,339243.96
351950,202307,150,80,70,105601.02,92404.88,198005.90
351960,202307,1080,524,556,691709.64,733941.54,1425651.18
351970,202307,2406,1120,1286,1479749.12,1702820.6,3182569.72
351980,202307,165,73,92,96363.02,121442.09,217805.11
351990,202307,261,161,100,212525.33,132000.87,344526.20
352000,202307,277,185,92,244214.37,121444.1,365658.47
352010,202307,480,307,173,406667.14,228372.22,635039.36
352020,202307,217,67,150,88440,198000,286440
352030,202307,1319,604,715,797303.77,945134.61,1742438.38
352040,202307,773,297,476,392046.17,628325.19,1020371.36
352042,202307,382,96,286,126723.18,377522.19,504245.37
352044,202307,391,210,181,277214.65,238926.24,516140.89
352050,202307,3647,1336,2311,1763562.81,3053175.99,4816738.80
352060,202307,109,63,46,83160.18,60720.92,143881.10
352070,202307,115,74,41,97685.35,54120,151805.35
352080,202307,73,44,29,58082.94,38280.48,96363.42
352090,202307,206,125,81,165003.74,106921.17,271924.91
352100,202307,350,170,180,224405.73,237601.73,462007.46
352110,202307,117,32,85,42240.51,112200,154440.51
352115,202307,70,26,44,34320,58080.2,92400.2
352120,202307,76,50,26,66000,34320,100320
352130,202307,246,182,64,240253.16,84480.57,324733.73
352140,202307,214,108,106,142562.91,141242.62,283805.53
352150,202307,140,73,67,97681.9,88441.83,186123.73
352160,202307,146,97,49,128044.14,64680.54,192724.68
352170,202307,467,306,161,403924.82,215160.08,619084.90
352180,202307,770,447,323,591382.22,426367.24,1017749.46
352190,202307,256,105,151,138605.91,199322.56,337928.47
352200,202307,32,15,17,19801.33,22440.1,42241.43
352210,202307,5074,1981,3093,2617682.92,4093346.68,6711029.60
352215,202307,81,41,40,54120.2,52800,106920.2
352220,202307,6612,2453,4159,3242036.09,5495217.21,8737253.30
352230,202307,4063,2526,1537,3337104.13,2031487.68,5368591.81
352240,202307,3093,1719,1374,2275752.73,1813696.46,4089449.19
352250,202307,4270,1888,2382,2493551.53,3145568.69,5639120.22
352260,202307,1135,591,544,784102.43,719410.96,1503513.39
352265,202307,78,46,32,60720,42240,102960
352270,202307,435,229,206,302306.43,273246.88,575553.31
352280,202307,558,328,230,432970.49,303600,736570.49
352290,202307,190,106,84,139925.42,110881.15,250806.57
352300,202307,105,61,44,80525.47,58080.77,138606.24
352310,202307,8816,3847,4969,5080879.11,6565695.68,11646574.79
352320,202307,1269,656,613,868579.24,810487.38,1679066.62
352330,202307,567,292,275,385442.56,363000.54,748443.10
352340,202307,1544,695,849,920069.2,1122006.2,2042075.4
352350,202307,408,228,180,300968.61,240241.69,541210.30
352360,202307,238,103,135,135962.52,178200.9,314163.42
352370,202307,135,83,52,109565.15,68641.98,178207.13
352380,202307,123,88,35,116163.48,46201.39,162364.87
352390,202307,2865,1203,1662,1588013.9,2196488.93,3784502.83
352400,202307,609,264,345,348484.93,455403.74,803888.67
352410,202307,1025,677,348,893684.37,459377.72,1353062.09
352420,202307,95,70,25,92401.18,33000,125401.18
352430,202307,1880,811,1069,1071890.48,1411106.24,2482996.72
352440,202307,3914,1710,2204,2261243.95,2910611.25,5171855.20
352450,202307,200,153,47,201964.02,62041.21,264005.23
352460,202307,705,351,354,463328.59,468605.86,931934.45
352470,202307,757,291,466,384137.39,616444.63,1000582.02
352480,202307,1804,1016,788,1342483.68,1040177.78,2382661.46
352490,202307,63,28,35,36960.1,46200.16,83160.26
352500,202307,1727,678,1049,894976.91,1386008.57,2280985.48
352510,202307,799,414,385,546506.75,510844.19,1057350.94
352520,202307,975,432,543,571577.6,718093.53,1289671.13
352530,202307,2150,1048,1102,1383420.35,1454649.32,2838069.67
352540,202307,73,52,21,68643.31,27720,96363.31
352550,202307,237,131,106,172922.21,139920,312842.21
352560,202307,56,40,16,52800.87,21120.84,73921.71
352570,202307,857,415,442,549148.32,583455.55,1132603.87
352580,202307,56,42,14,55442.36,18480,73922.36
352585,202307,17,5,12,6600.25,15840.95,22441.20
352590,202307,4970,2426,2544,3206401.81,3362065.26,6568467.07
352600,202307,406,275,131,364332.53,172927.41,537259.94
352610,202307,979,419,560,553092.32,740525.31,1293617.63
352620,202307,1247,466,781,615131.87,1030929.74,1646061.61
352630,202307,206,76,130,100320.99,171600.08,271921.07
352640,202307,564,358,206,472582.68,271923.48,744506.16
352650,202307,97,65,32,85802.81,42240,128042.81
352660,202307,74,37,37,48840.67,48840,97680.67
352670,202307,1915,1012,903,1337234.75,1191962.62,2529197.37
352680,202307,1082,628,454,828990.11,600619.56,1429609.67
352690,202307,5209,2273,2936,3001791.55,3879509.18,6881300.73
352700,202307,95,51,44,67323.06,58081.38,125404.44
352710,202307,1660,854,806,1131292.13,1065243.07,2196535.20
352720,202307,1791,736,1055,971562.57,1392629.17,2364191.74
352725,202307,33,24,9,31681.55,11880,43561.55
352730,202307,452,219,233,289088.1,307563.59,596651.69
352740,202307,406,258,148,341898.53,196682.67,538581.20
352750,202307,24,16,8,21121.75,10560,31681.75
352760,202307,255,164,91,216485.82,120120.97,336606.79
352770,202307,83,60,23,79202.34,30360,109562.34
352780,202307,77,42,35,55440,46200.78,101640.78
352790,202307,26,17,9,22442.57,11880.18,34322.75
352800,202307,266,200,66,264007.39,87122.05,351129.44
352810,202307,162,105,57,138602.63,76562.86,215165.49
352820,202307,41,33,8,43560.89,10560,54120.89
352830,202307,74,47,27,62041.55,35640.01,97681.56
352840,202307,781,338,443,446177.45,586088.37,1032265.82
352850,202307,2082,616,1466,814457.01,1935130.31,2749587.32
352860,202307,130,81,49,106923.53,64680.12,171603.65
352870,202307,52,33,19,43565.18,25080.92,68646.10
352880,202307,200,111,89,146526.66,117482.35,264009.01
352885,202307,36,24,12,31680.32,15840,47520.32
352890,202307,61,38,23,50162.17,30360,80522.17
352900,202307,5016,2347,2669,3098158.62,3524417.92,6622576.54
352910,202307,40,31,9,40920.78,11880,52800.78
352920,202307,686,387,299,510862.27,394686.13,905548.40
352930,202307,1278,589,689,777513.2,909484.73,1686997.93
352940,202307,7035,2647,4388,3496766.78,5798824.51,9295591.29
352950,202307,135,62,73,81842.72,96362.6,178205.32
352960,202307,72,50,22,66000.93,29040,95040.93
352965,202307,16,9,7,11880,9240,21120
352970,202307,592,425,167,562341.82,220445.93,782787.75
352980,202307,167,98,69,129367.4,91081.37,220448.77
352990,202307,1031,475,556,628349.46,733933.07,1362282.53
353000,202307,65,33,32,43560.03,42240.98,85801.01
353010,202307,556,330,226,435615.48,298324.45,733939.93
353020,202307,366,235,131,310211.21,172923.39,483134.60
353030,202307,1503,674,829,889713.1,1096942.12,1986655.22
353040,202307,101,53,48,71281.67,63361.55,134643.22
353050,202307,1467,952,515,1258026.38,679803.25,1937829.63
353060,202307,10222,4454,5768,5884797.27,7625701.23,13510498.50
353070,202307,2228,1299,929,1716071.53,1231328.19,2947399.72
353080,202307,1430,756,674,999282.63,891002.37,1890285.00
353090,202307,73,38,35,50161.83,46200,96361.83
353100,202307,49,36,13,47521.16,17161.54,64682.70
353110,202307,2547,855,1692,1129981.2,2236157.14,3366138.34
353120,202307,150,89,61,117480.09,80520.56,198000.65
353130,202307,922,435,487,575545.27,642843.6,1218388.87
353140,202307,623,285,338,376222.42,446166.82,822389.24
353150,202307,340,174,166,229687.79,219123.94,448811.73
353160,202307,109,82,27,108246.58,35640,143886.58
353170,202307,212,74,138,97681.54,182160.51,279842.05
353180,202307,1451,667,784,883098.4,1036212.5,1919310.9
353190,202307,533,376,157,497665.07,207242.85,704907.92
353200,202307,314,149,165,196683.46,219120.84,415804.30
353205,202307,21,13,8,17160,10560,27720
353210,202307,82,48,34,63361.8,44880.17,108241.97
353215,202307,45,25,20,33000.2,26400,59400.2
353220,202307,89,47,42,62041.46,55440.68,117482.14
353230,202307,168,75,93,99001.97,122760,221761.97
353240,202307,439,187,252,246842.55,333960.28,580802.83
353250,202307,194,100,94,132003.15,124081.33,256084.48
353260,202307,500,318,182,419776.57,240245.79,660022.36
353270,202307,72,55,17,72603.87,22440,95043.87
353280,202307,122,53,69,69964.02,91084.89,161048.91
353282,202307,133,88,45,117481.67,59400,176881.67
353284,202307,33,25,8,33002.16,11880,44882.16
353286,202307,9,4,5,5280.2,6600.24,11880.44
353290,202307,89,51,38,67321.09,50160,117481.09
353300,202307,482,235,247,310216.07,328689.05,638905.12
353310,202307,41,32,9,43561.69,11880.95,55442.64
353320,202307,45,23,22,30360.81,29040.2,59401.01
353325,202307,48,24,24,33002.33,31680,64682.33
353330,202307,61,40,21,52800.1,27720.38,80520.48
353340,202307,776,293,483,386771.35,637566.25,1024337.60
353350,202307,1014,498,516,657383.11,682456.3,1339839.41
353360,202307,111,89,22,117482.5,29040.35,146522.85
353370,202307,115,62,53,81842.61,69960.38,151802.99
353380,202307,30,15,15,19800.2,19800,39600.2
353390,202307,1228,577,651,761675.01,859335.22,1621010.23
353400,202307,58,32,26,42241.83,34321.32,76563.15
353410,202307,123,66,57,87124.18,75241.6,162365.78
353420,202307,70,34,36,44880,47520,92400
353430,202307,615,395,220,521424.3,290410.72,811835.02
353440,202307,14970,6641,8329,8772928.22,11012816.66,19785744.88
353450,202307,55,26,29,34320.8,38280.83,72601.63
353460,202307,719,371,348,491061.82,459369.74,950431.56
353470,202307,2502,1192,1310,1573513.6,1730528.46,3304042.06
353475,202307,304,194,110,256084.55,145200.91,401285.46
353480,202307,244,177,67,233643.87,89760,323403.87
353490,202307,240,137,103,180846.51,135960.22,316806.73
353500,202307,226,130,96,171603.32,126721.22,298324.54
353510,202307,87,55,32,73921.23,42240.24,116161.47
353520,202307,272,193,79,254763.74,104280,359043.74
353530,202307,531,265,266,349814.11,352444.77,702258.88
353540,202307,390,243,147,322096.24,194045.36,516141.60
353550,202307,823,510,313,673246.84,414492.86,1087739.70
353560,202307,590,239,351,315483.16,465962.01,781445.17
353570,202307,64,45,19,59401.4,25080,84481.4
353580,202307,391,240,151,318127.64,199320,517447.64
353590,202307,99,74,25,99002.44,33000,132002.44
353600,202307,304,175,129,231007.31,171600.28,402607.59
353610,202307,153,84,69,110880.96,91080,201960.96
353620,202307,720,349,371,460691.9,491048.77,951740.67
353625,202307,67,33,34,43562.05,44880.33,88442.38
353630,202307,240,164,76,216488.03,100320.78,316808.81
353640,202307,142,88,54,116166.09,71280.54,187446.63
353650,202307,1193,469,724,619092.37,955689.33,1574781.70
353657,202307,27,21,6,27720,7920,35640
353660,202307,316,165,151,217804.94,199323.4,417128.34
353670,202307,786,440,346,580822.2,456725.86,1037548.06
353680,202307,157,98,59,132000.58,77880,209880.58
353690,202307,47,30,17,39600.73,22441.09,62041.82
353700,202307,307,206,101,271927.85,133321.88,405249.73
353710,202307,633,309,324,407897.16,427681.58,835578.74
353715,202307,43,24,19,31680,25080,56760
353720,202307,332,152,180,200646.04,238922.55,439568.59
353730,202307,1263,736,527,972891.19,696962.53,1669853.72
353740,202307,647,352,295,464659.76,390728.41,855388.17
353750,202307,103,54,49,72602.42,64680,137282.42
353760,202307,3713,1462,2251,1931241.49,2972680.69,4903922.18
353770,202307,78,62,16,81840.4,21120.2,102960.6
353780,202307,1527,691,836,913461.22,1103528.82,2016990.04
353790,202307,547,320,227,422413.87,299648.28,722062.15
353800,202307,4315,1962,2353,2591293.04,3109928.41,5701221.45
353810,202307,252,128,124,168973.05,163680.82,332653.87
353820,202307,304,126,178,166320.85,234961.01,401281.86
353830,202307,77,63,14,83162.19,18480.9,101643.09
353850,202307,225,97,128,128043.86,168961.89,297005.75
353860,202307,591,273,318,360370.65,419763.14,780133.79
353870,202307,6504,3310,3194,4370650.84,4226670.95,8597321.79
353880,202307,796,508,288,670588.2,381484.36,1052072.56
353890,202307,630,352,278,465982.69,366964.23,832946.92
353900,202307,153,82,71,108243.01,93721.85,201964.86
353910,202307,228,97,131,128042.23,172921.66,300963.89
353920,202307,527,264,263,349808.49,347163.96,696972.45
353930,202307,1146,662,484,875195.3,638884.93,1514080.23
353940,202307,224,108,116,142562.12,153122.31,295684.43
353950,202307,557,361,196,476543.15,258723.1,735266.25
353960,202307,83,66,17,87123.12,22440,109563.12
353970,202307,43,29,14,38280.34,18481.33,56761.67
353980,202307,2283,978,1305,1296276.36,1725258.49,3021534.85
353990,202307,89,56,33,73922.8,43560.61,117483.41
354000,202307,412,182,230,240248.51,303602.1,543850.61
354010,202307,92,51,41,67323.21,54120.69,121443.90
354020,202307,564,347,217,458055.48,287765.95,745821.43
354025,202307,43,36,7,47521.92,9240,56761.92
354030,202307,48,26,22,34322.52,29040.15,63362.67
354040,202307,102,77,25,101644.21,33000,134644.21
354050,202307,168,88,80,116162.02,105601.28,221763.30
354060,202307,922,432,490,570251.51,646803,1217054.51
354070,202307,1003,559,444,737901.79,588728,1326629.79
354075,202307,214,100,114,132004.43,150481.17,282485.60
354080,202307,323,147,176,194044.95,233641.89,427686.84
354085,202307,28,17,11,22441.52,14520,36961.52
354090,202307,298,170,128,224293.8,168961.45,393255.25
354100,202307,6971,2817,4154,3719900.08,5488641.34,9208541.42
354105,202307,112,62,50,81842.41,67320,149162.41
354110,202307,45,22,23,29040,30360.84,59400.84
354120,202307,168,101,67,133324.38,89760.97,223085.35
354130,202307,870,542,328,715469.79,435602.7,1151072.49
354140,202307,3724,1682,2042,2220338.35,2698095.85,4918434.20
354150,202307,715,414,301,546510.95,398646.29,945157.24
354160,202307,726,436,290,578196.16,382808.21,961004.37
354165,202307,11,7,4,9240,5280,14520
354170,202307,199,130,69,171606.42,91080.22,262686.64
354180,202307,55,33,22,43560.4,29040.57,72600.97
354190,202307,303,106,197,139923.33,260041.51,399964.84
354200,202307,122,60,62,79202.68,81842.12,161044.80
354210,202307,82,38,44,50160,58080,108240
354220,202307,658,392,266,517468.92,352446.53,869915.45
354230,202307,185,82,103,108242.47,135960.67,244203.14
354240,202307,371,224,147,295693.52,194040.72,489734.24
354250,202307,80,46,34,60720.61,44880,105600.61
354260,202307,2307,1048,1259,1383402.81,1663229.1,3046631.91
354270,202307,99,70,29,92402.23,38280.5,130682.73
354280,202307,61,35,26,46200.79,34320,80520.79
354290,202307,164,109,55,143886.77,72600,216486.77
354300,202307,342,240,102,316806.56,134641.64,451448.20
354310,202307,99,68,31,89765.11,40920.6,130685.71
354320,202307,247,112,135,147842.43,178200,326042.43
354323,202307,11,8,3,10560,3960,14520
354325,202307,128,70,58,92400.94,76560.42,168961.36
354330,202307,2694,907,1787,1197285.76,2364128.6,3561414.36
354340,202307,11861,5339,6522,7054088.26,8618350.47,15672438.73
354350,202307,161,106,55,139921.21,72600,212521.21
354360,202307,78,47,31,62042.53,42240.55,104283.08
354370,202307,259,128,131,168963.07,172921.56,341884.63
354380,202307,191,107,84,141243.06,110880,252123.06
354390,202307,3101,1124,1977,1486368.62,2613626.87,4099995.49
354400,202307,404,213,191,281165.37,253440.79,534606.16
354410,202307,793,346,447,456738.34,591369.43,1048107.77
354420,202307,303,203,100,267968.57,133322.91,401291.48
354425,202307,367,202,165,266709.43,217803.59,484513.02
354430,202307,134,83,51,109567,67320.29,176887.29
354440,202307,30,23,7,30361.47,9240,39601.47
354450,202307,58,40,18,52801.34,23760,76561.34
354460,202307,103,57,46,75246.79,60722.17,135968.96
354470,202307,14,8,6,10560.63,7920.76,18481.39
354480,202307,126,66,60,87120.6,79200.51,166321.11
354490,202307,129,75,54,99005.34,71282.62,170287.96
354500,202307,446,187,259,246843.46,341881.38,588724.84
354510,202307,87,61,26,80523.52,34321.13,114844.65
354515,202307,53,19,34,25081.36,44880.1,69961.46
354520,202307,1855,748,1107,989846.78,1462561.16,2452407.94
354530,202307,946,464,482,613817.06,638882.65,1252699.71
354540,202307,263,127,136,167647.16,179521.57,347168.73
354550,202307,45,25,20,33000.59,26400,59400.59
354560,202307,176,96,80,126721.08,105600,232321.08
354570,202307,150,100,50,132000.58,66000,198000.58
354580,202307,2095,984,1111,1300236.09,1469167.05,2769403.14
354600,202307,314,147,167,194048.24,220441.07,414489.31
354610,202307,64,52,12,68640.99,15840.82,84481.81
354620,202307,80,22,58,29040,76560.58,105600.58
354625,202307,21,15,6,19802.12,7920.72,27722.84
354630,202307,398,269,129,355099.14,170283.29,525382.43
354640,202307,926,538,388,713068.04,514806.63,1227874.67
354650,202307,69,41,28,54122.26,36960,91082.26
354660,202307,919,660,259,871246.36,341882.75,1213129.11
354670,202307,247,94,153,124081.14,201960.2,326041.34
354680,202307,1506,533,973,704898.46,1284366.73,1989265.19
354690,202307,79,49,30,64682.49,39600,104282.49
354700,202307,80,56,24,73920.38,31680,105600.38
354710,202307,47,33,14,43560.3,18480,62040.3
354720,202307,24,20,4,26400.35,5280,31680.35
354730,202307,2089,844,1245,1114107.7,1643419.77,2757527.47
354740,202307,76,56,20,73921.56,26400,100321.56
354750,202307,447,241,206,318128.38,271922.13,590050.51
354760,202307,578,361,217,477875.77,286448.28,764324.05
354765,202307,7,3,4,3960,5280,9240
354770,202307,387,245,142,323413.35,188762.96,512176.31
354780,202307,9644,3509,6135,4635957.78,8115399.33,12751357.11
354790,202307,95,55,40,72600.82,52800.11,125400.93
354800,202307,479,257,222,339315.78,293046.06,632361.84
354805,202307,80,41,39,54121.21,51480.27,105601.48
354810,202307,106,55,51,72601.41,67320,139921.41
354820,202307,232,98,134,129361.33,176883.95,306245.28
354830,202307,47,27,20,35640,26400,62040
354840,202307,56,36,20,47520.21,26400,73920.21
354850,202307,6038,2418,3620,3198491.27,4789009.08,7987500.35
354860,202307,385,166,219,220441.12,289082.24,509523.36
354870,202307,14141,6139,8002,8106351.83,10564035.28,18670387.11
354880,202307,3007,1095,1912,1445442.65,2525249.21,3970691.86
354890,202307,3473,1841,1632,2430249.55,2154255.76,4584505.31
354900,202307,67,49,18,64681.62,23760.19,88441.81
354910,202307,1470,735,735,970232.22,970201.91,1940434.13
354920,202307,39,34,5,44880.6,6600,51480.6
354925,202307,29,19,10,25080.4,13200,38280.4
354930,202307,41,32,9,42241.97,11880,54121.97
354940,202307,822,566,256,747155.78,339246.19,1086401.97
354950,202307,211,126,85,166323.75,112202.38,278526.13
354960,202307,136,48,88,63361.87,116160.75,179522.62
354970,202307,1344,947,397,1251411.4,524041.92,1775453.32
354980,202307,10760,3952,6808,5222120.5,9002467.53,14224588.03
354990,202307,12026,5319,6707,7029194.98,8866490.86,15895685.84
354995,202307,660,223,437,294364.08,578168.19,872532.27
355000,202307,463,157,306,207243.12,403920.7,611163.82
355010,202307,775,487,288,642878.18,380166.95,1023045.13
355020,202307,892,540,352,714140.03,464645.81,1178785.84
355030,202307,245264,90721,154543,119833911.64,204220868.3,324054779.94
355040,202307,1173,577,596,761666.31,788053,1549719.31
355050,202307,183,101,82,134641.42,109560,244201.42
355060,202307,2095,975,1120,1287063.83,1478408.08,2765471.91
355070,202307,1851,793,1058,1049428.71,1397897.2,2447325.91
355080,202307,225,132,93,174242.66,122762.45,297005.11
355090,202307,341,209,132,275890.53,174243.12,450133.65
355100,202307,6374,2948,3426,3894062.84,4530284.34,8424347.18
355110,202307,224,146,78,192722.34,102961.08,295683.42
355120,202307,52,33,19,43560.64,25080,68640.64
355130,202307,62,35,27,47521.12,35640,83161.12
355140,202307,217,124,93,163684.37,122760.14,286444.51
355150,202307,806,476,330,628344.54,435605.53,1063950.07
355160,202307,570,266,304,351136.18,401284.16,752420.34
355170,202307,2302,1178,1124,1556350.6,1483698.69,3040049.29
355180,202307,749,288,461,380167.06,609849.71,990016.77
355190,202307,236,157,79,207247.25,104282.26,311529.51
355200,202307,124,57,67,75241.37,88440,163681.37
355210,202307,800,405,395,535930.53,524043.41,1059973.94
355220,202307,9022,4185,4837,5528361.2,6395455.4,11923816.6
355230,202307,99,54,45,71281.3,60721.87,132003.17
355240,202307,5193,2041,3152,2694140.83,4161980.92,6856121.75
355250,202307,8072,3545,4527,4691478.9,5978306.86,10669785.76
355255,202307,50,30,20,39600.62,26400,66000.62
355260,202307,209,117,92,154444.3,121441.31,275885.61
355270,202307,174,115,59,151805.73,77880.98,229686.71
355280,202307,8239,3057,5182,4039333.53,6845608.58,10884942.11
355290,202307,70,54,16,71280.58,21120,92400.58
355300,202307,259,146,113,192726.27,149160.79,341887.06
355310,202307,117,67,50,88440,66000,154440
355320,202307,115,56,59,73920.6,77880.96,151801.56
355330,202307,364,212,152,279849.65,200642.84,480492.49
355340,202307,1407,530,877,699699.1,1157683.53,1857382.63
355350,202307,182,84,98,110880,129360.2,240240.2
355360,202307,211,137,74,182169.94,97681.64,279851.58
355365,202307,22,17,5,22440.83,6600,29040.83
355370,202307,1123,648,475,855401.71,629644.5,1485046.21
355380,202307,912,532,380,702273.43,506889.06,1209162.49
355385,202307,105,66,39,87120.2,51480,138600.2
355390,202307,113,61,52,80521.02,68640.21,149161.23
355395,202307,218,107,111,141248.12,146524.61,287772.73
355400,202307,2012,1106,906,1459860.09,1201202.43,2661062.52
355410,202307,5900,2636,3264,3483607.24,4313780.37,7797387.61
355420,202307,48,32,16,42240.8,21120,63360.8
355430,202307,510,289,221,381507.9,291730.36,673238.26
355440,202307,104,57,47,75241.1,62041.9,137283.0
355450,202307,506,264,242,348494.52,319442.2,667936.72
355460,202307,60,41,19,54121.1,25080.8,79201.9
355465,202307,54,29,25,38280.51,33000,71280.51
355470,202307,211,86,125,113522.24,166321.74,279843.98
355475,202307,8,5,3,6600.81,3960,10560.81
355480,202307,715,289,426,381497.82,562324.74,943822.56
355490,202307,119,87,32,114845.96,42242.71,157088.67
355495,202307,126,54,72,71280.1,95040.44,166320.54
355500,202307,1724,935,789,1236876.2,1044126.13,2281002.33
355510,202307,290,197,93,260050.97,122761.24,382812.21
355520,202307,28,19,9,25080.18,11880,36960.18
355530,202307,24,13,11,17160,14520,31680
355535,202307,95,44,51,58082.19,67320,125402.19
355540,202307,3189,1241,1948,1638178.9,2574046.89,4212225.79
355550,202307,71,39,32,51480,42240,93720
355560,202307,295,129,166,170284.14,219123.01,389407.15
355570,202307,18,13,5,17160.34,6600,23760.34
355580,202307,242,164,78,216488.9,102961.75,319450.65
355590,202307,16,11,5,14520.24,6600,21120.24
355600,202307,297,144,153,190086.91,201961.22,392048.13
355610,202307,266,159,107,209888.64,141243.09,351131.73
355620,202307,1448,601,847,794664.69,1119363.14,1914027.83
355630,202307,447,313,134,413177.65,176881.08,590058.73
355635,202307,139,56,83,73920.47,109560,183480.47
355640,202307,644,336,308,443529.69,406565.41,850095.10
355645,202307,976,343,633,454097.06,835569.93,1289666.99
355650,202307,2015,873,1142,1153733.06,1511402.1,2665135.16
355660,202307,237,122,115,161043.63,151802.11,312845.74
355670,202307,735,307,428,405244.77,564963.92,970208.69
355680,202307,224,118,106,155771.39,139922.35,295693.74
355690,202307,103,46,57,60721.75,75240.57,135962.32
355695,202307,23,13,10,17160,13200,30360
355700,202307,1452,650,802,858031.28,1059966.87,1917998.15
355710,202307,2518,1388,1130,1833568.09,1491604.7,3325172.79
355715,202307,15,12,3,15842.08,3960.1,19802.18
355720,202307,281,172,109,227045.93,145202.23,372248.16
355730,202307,111,64,47,84481.28,62040.15,146521.43
410010,202307,110,89,21,117482.87,27720,145202.87
410020,202307,128,88,40,116163.84,52800.58,168964.42
410030,202307,206,108,98,142562.63,129364.38,271927.01
410040,202307,1588,755,833,997945.01,1100891.2,2098836.21
410045,202307,45,35,10,46200,13200,59400
410050,202307,565,324,241,427684.41,319440.74,747125.15
410060,202307,224,162,62,213847.23,81840.5,295687.73
410070,202307,262,212,50,279849.47,66001.19,345850.66
410080,202307,207,123,84,163683.2,110880,274563.2
410090,202307,56,48,8,63364.73,10560,73924.73
410100,202307,285,181,104,238923.19,137280.1,376203.29
410105,202307,45,27,18,35640,23760,59400
410110,202307,391,237,154,312856.31,203287.04,516143.35
410115,202307,52,27,25,35640,33000.2,68640.2
410120,202307,506,232,274,306250.64,363004.02,669254.66
410130,202307,73,38,35,50160.8,46200,96360.8
410140,202307,3600,1646,1954,2174091.28,2581943.72,4756035.00
410150,202307,2880,1167,1713,1541795.9,2262497.77,3804293.67
410160,202307,520,296,224,390727.7,297002.74,687730.44
410165,202307,62,39,23,51480.41,30360,81840.41
410170,202307,226,128,98,168963.25,129360.99,298324.24
410180,202307,2660,1388,1272,1836185.44,1680385.51,3516570.95
410185,202307,39,32,7,42240,9240,51480
410190,202307,531,345,186,455408.71,246840.9,702249.61
410200,202307,1176,820,356,1082417.61,469923.64,1552341.25
410210,202307,715,371,344,489732.09,454082.01,943814.10
410220,202307,55,25,30,33000.84,39600,72600.84
410230,202307,217,94,123,124080.75,162362.19,286442.94
410240,202307,771,487,284,645504.11,378842.6,1024346.71
410250,202307,407,272,135,359044.83,178202.22,537247.05
410260,202307,345,187,158,246848.08,208568.81,455416.89
410270,202307,30,20,10,26400.79,13200,39600.79
410275,202307,64,44,20,58081.97,26400,84481.97
410280,202307,335,203,132,267972.23,176880.78,444853.01
410290,202307,291,163,128,215165.93,168960.5,384126.43
410300,202307,97,57,40,75240,52800,128040
410302,202307,29,16,13,21120.05,17160,38280.05
410304,202307,47,31,16,40921.2,21120,62041.2
410305,202307,221,134,87,176887.93,116160,293047.93
410310,202307,202,120,82,158403.57,108242.25,266645.82
410315,202307,42,34,8,44880.2,10560,55440.2
410320,202307,152,107,45,141241.24,59400,200641.24
410322,202307,43,26,17,34320.97,22440,56760.97
410330,202307,184,118,66,155763.46,87120,242883.46
410335,202307,108,60,48,79200,63360,142560
410337,202307,48,38,10,50160.5,13200,63360.5
410340,202307,37,30,7,39601.1,9240,48841.1
410345,202307,210,134,76,176882.18,100320.2,277202.38
410347,202307,41,31,10,40920.28,13200.16,54120.44
410350,202307,267,155,112,204605.71,149160,353765.71
410360,202307,491,300,191,396012.21,253440.34,649452.55
410370,202307,2496,1090,1406,1438841.06,1858575.41,3297416.47
410380,202307,208,115,93,151805.05,122761.37,274566.42
410390,202307,450,273,177,360365.3,234960.64,595325.94
410395,202307,33,22,11,29041.72,14520.45,43562.17
410400,202307,1045,443,602,586100.83,799930.6,1386031.43
410405,202307,85,66,19,87124.55,25080.22,112204.77
410410,202307,33,17,16,22443.07,21120.1,43563.17
410420,202307,2030,897,1133,1185271.63,1496897.77,2682169.40
410425,202307,232,104,128,137282.43,168960.2,306242.63
410430,202307,2668,1357,1311,1793920.09,1730538.01,3524458.10
410440,202307,381,274,107,361683.68,141242.19,502925.87
410442,202307,378,235,143,310210.82,188760.85,498971.67
410445,202307,356,249,107,328687.78,141241.22,469929.00
410450,202307,426,204,222,269286.81,293040.45,562327.26
410460,202307,621,339,282,447485.17,373562.32,821047.49
410465,202307,285,158,127,208566.41,168960.89,377527.30
410470,202307,258,147,111,194047.03,146521.3,340568.33
410480,202307,7425,3571,3854,4717818.21,5093937.78,9811755.99
410490,202307,1545,832,713,1102230.04,942488.3,2044718.34
410500,202307,302,179,123,236282.73,162360.55,398643.28
410510,202307,218,164,54,217807.9,71281.85,289089.75
410520,202307,303,215,88,283801.27,116160,399961.27
410530,202307,281,89,192,117480.59,254760,372240.59
410540,202307,416,298,118,393368.81,155760.61,549129.42
410550,202307,1873,801,1072,1058658.64,1417687.62,2476346.26
410560,202307,190,121,69,163683.51,91080.94,254764.45
410570,202307,472,307,165,406566.64,217802.23,624368.87
410580,202307,4314,1794,2520,2372110.52,3330412.15,5702522.67
410590,202307,473,306,167,403909.68,220440,624349.68
410600,202307,114,96,18,126720.93,23760,150480.93
410610,202307,66,53,13,69960.48,17160,87120.48
410620,202307,303,177,126,233647.74,166321.37,399969.11
410630,202307,508,275,233,363002.72,307560.38,670563.10
410640,202307,1311,812,499,1071857.96,658682.8,1730540.76
410645,202307,115,86,29,113523.59,38280.2,151803.79
410650,202307,407,250,157,332644.23,207242.52,539886.75
410655,202307,92,66,26,87121.26,34320.08,121441.34
410657,202307,40,16,24,21120,31680,52800
410660,202307,708,483,225,637579.96,297003.21,934583.17
410670,202307,74,59,15,77882.93,19800.13,97683.06
410680,202307,198,157,41,207245.42,54120.2,261365.62
410685,202307,45,33,12,43560.49,15840,59400.49
410690,202307,32682,13275,19407,17530040.38,25655787.47,43185827.85
410700,202307,353,252,101,332927.49,133321.24,466248.73
410710,202307,126,103,23,135962.43,30360.2,166322.63
410712,202307,45,30,15,39600.65,19800,59400.65
410715,202307,110,81,29,106923.5,38280,145203.5
410720,202307,707,397,310,524049.35,409202.2,933251.55
410725,202307,208,138,70,182162.69,92400,274562.69
410730,202307,109,48,61,63361.18,83160,146521.18
410740,202307,81,60,21,79201.36,27720,106921.36
410750,202307,322,202,120,266645.7,158400.06,425045.76
410752,202307,21,16,5,21120.14,6600,27720.14
410753,202307,68,25,43,33000.4,56760,89760.4
410754,202307,69,36,33,47520.5,43560,91080.5
410755,202307,92,46,46,60720.2,60720,121440.2
410760,202307,823,449,374,595325.45,495002.76,1090328.21
410765,202307,2249,1005,1244,1326644.96,1642109.06,2968754.02
410770,202307,132,89,43,117482.06,56760.76,174242.82
410773,202307,71,46,25,60721.91,33000,93721.91
410775,202307,233,155,78,204602.86,102960,307562.86
410780,202307,90,51,39,67321.23,52800,120121.23
410785,202307,59,50,9,66001.66,11880,77881.66
410790,202307,99,44,55,58080.2,72600,130680.2
410800,202307,297,184,113,242896.32,150481.04,393377.36
410810,202307,27,17,10,22440,13200.24,35640.24
410820,202307,150,105,45,138603.35,59400.9,198004.25
410830,202307,10627,4190,6437,5532277.65,8503534.47,14035812.12
410832,202307,120,77,43,101642.27,56760.05,158402.32
410840,202307,1573,863,710,1140503.78,937205.2,2077708.98
410845,202307,68,35,33,46201.29,43560,89761.29
410850,202307,163,120,43,158404.68,56760.14,215164.82
410855,202307,83,75,8,99002.49,10560,109562.49
410860,202307,960,466,494,615128.97,652084.96,1267213.93
410865,202307,96,66,30,87120.84,39600,126720.84
410870,202307,147,119,28,157081.56,36960.62,194042.18
410880,202307,1283,615,668,811819.55,881766.97,1693586.52
410890,202307,127,75,52,100321.75,68640,168961.75
410895,202307,80,62,18,81841.01,23760.95,105601.96
410900,202307,43,33,10,43561.41,13200,56761.41
410910,202307,14,8,6,10560.95,7920,18480.95
410920,202307,50,30,20,39600,26400,66000
410930,202307,592,360,232,475204.44,308881.39,784085.83
410940,202307,4955,2464,2491,3255255.47,3292128.05,6547383.52
410950,202307,99,74,25,97683,33000,130683
410960,202307,1088,398,690,525373.56,910810.51,1436184.07
410965,202307,70,50,20,66001.24,26400,92401.24
410970,202307,648,424,224,559689.1,297002.63,856691.73
410975,202307,129,80,49,105601.91,64680,170281.91
410980,202307,1724,786,938,1038877.37,1238174.55,2277051.92
410990,202307,284,206,78,271920.54,102960.98,374881.52
411000,202307,68,40,28,52800.95,36960.54,89761.49
411005,202307,39,33,6,43560,7920,51480
411007,202307,298,172,126,228360.47,166320,394680.47
411010,202307,660,404,256,533293.54,337923.68,871217.22
411020,202307,299,190,109,250805.29,143882.52,394687.81
411030,202307,31,18,13,23760,17160,40920
411040,202307,79,47,32,62040.89,42240,104280.89
411050,202307,217,154,63,203282.08,84480.94,287763.02
411060,202307,585,404,181,533286.74,238920.44,772207.18
411065,202307,42,37,5,48840.4,6600,55440.4
411070,202307,1390,777,613,1028297.39,809164.95,1837462.34
411080,202307,271,173,98,228360.39,130680.23,359040.62
411090,202307,88,61,27,80520.4,35640.96,116161.36
411095,202307,375,124,251,163680.51,331320.16,495000.67
411100,202307,115,90,25,118801.66,33000,151801.66
411110,202307,170,87,83,114840.22,109560.2,224400.42
411120,202307,202,134,68,176890.43,89760,266650.43
411125,202307,411,197,214,261368.54,283809.35,545177.89
411130,202307,164,139,25,183482.39,33000,216482.39
411140,202307,224,149,75,196680,99000,295680
411150,202307,1344,860,484,1135221.91,638886.32,1774108.23
411155,202307,120,80,40,105600,52800,158400
411160,202307,39,17,22,22440,29040,51480
411170,202307,62,51,11,67320,14520,81840
411180,202307,1134,753,381,993990.57,504247.12,1498237.69
411190,202307,391,224,167,295684.58,221760,517444.58
411200,202307,724,384,340,508216.12,448804.68,957020.80
411210,202307,735,377,358,497645.91,472563.11,970209.02
411220,202307,166,117,49,154442.62,64681.25,219123.87
411230,202307,33,27,6,35640,7920,43560
411240,202307,111,72,39,95041.08,51480,146521.08
411250,202307,439,318,121,419764.18,161040,580804.18
411260,202307,10,7,3,9240,3960,13200
411270,202307,289,150,139,198008.37,183482.46,381490.83
411275,202307,203,166,37,219122.93,48840,267962.93
411280,202307,302,203,99,267965.11,130680.7,398645.81
411290,202307,74,54,20,71280,26400,97680
411295,202307,137,97,40,128041.59,52800.81,180842.40
411300,202307,92,44,48,58080.82,63360,121440.82
411310,202307,101,71,30,93721.4,39600,133321.4
411320,202307,908,545,363,720202.77,479160.88,1199363.65
411325,202307,59,41,18,54120.1,23760,77880.1
411330,202307,1036,655,381,864625.59,502923.74,1367549.33
411340,202307,39,24,15,31680,21120.09,52800.09
411342,202307,68,54,14,71280,18480,89760
411345,202307,96,46,50,60722.96,66000.95,126723.91
411350,202307,596,438,158,578176.69,208562.58,786739.27
411360,202307,64,42,22,55443.21,29042.5,84485.71
411370,202307,14578,5999,8579,7929989.95,11350790.73,19280780.68
411373,202307,193,126,67,166320.43,88440.17,254760.60
411375,202307,96,77,19,102963.38,25080,128043.38
411380,202307,83,56,27,73924.87,35640,109564.87
411390,202307,176,97,79,128041.67,105600,233641.67
411400,202307,387,242,145,319448.4,191400,510848.4
411410,202307,597,281,316,372248.56,417121.13,789369.69
411420,202307,1031,424,607,559691.79,805206.35,1364898.14
411430,202307,635,320,315,422418.01,419768.52,842186.53
411435,202307,28,20,8,26400,10560,36960
411440,202307,525,417,108,551768.79,142560.7,694329.49
411450,202307,414,336,78,444848.36,102960.63,547808.99
411460,202307,886,342,544,451454.4,719403.96,1170858.36
411470,202307,116,79,37,105605.41,48840,154445.41
411480,202307,798,401,397,529340.84,526683.1,1056023.94
411490,202307,307,193,114,254764.21,151800.9,406565.11
411500,202307,117,88,29,116161.56,38280,154441.56
411510,202307,245,184,61,242885.46,80521.19,323406.65
411520,202307,7075,2369,4706,3132427.49,6219881.05,9352308.54
411530,202307,133,85,48,112201.22,63360,175561.22
411535,202307,51,15,36,19800.6,47520,67320.6
411540,202307,418,277,141,365646.26,186122.03,551768.29
411545,202307,56,39,17,51480.96,22440,73920.96
411550,202307,93,69,24,91081.37,31680,122761.37
411560,202307,416,164,252,216480.39,332640.15,549120.54
411570,202307,1148,366,782,484326.81,1032250.88,1516577.69
411573,202307,27,17,10,22440.2,13200,35640.2
411575,202307,345,217,128,286443.25,168960,455403.25
411580,202307,1353,470,883,620407.8,1165565.77,1785973.57
411585,202307,74,36,38,47520,50160,97680
411590,202307,13,8,5,10560,6600,17160
411600,202307,16,8,8,10560.7,10560,21120.7
411605,202307,183,69,114,91082.03,151800,242882.03
411610,202307,270,164,106,216484.85,139920.2,356405.05
411620,202307,419,199,220,262691.83,290408.4,553100.23
411630,202307,54,36,18,48840.53,25080.99,73921.52
411640,202307,33,22,11,29040.5,15840,44880.5
411650,202307,6,4,2,5280,2640,7920
411660,202307,49,36,13,47520,17160,64680
411670,202307,255,169,86,224402.58,113521.49,337924.07
411680,202307,172,131,41,174241.72,54120,228361.72
411690,202307,726,376,350,497644.88,462002.29,959647.17
411695,202307,70,47,23,62040.2,30360,92400.2
411700,202307,153,118,35,155764.76,46200,201964.76
411705,202307,107,74,33,97681.63,43560.4,141242.03
411710,202307,293,195,98,257406.06,130680.87,388086.93
411720,202307,160,106,54,139920.96,71280.2,211201.16
411721,202307,94,72,22,96360.2,29040,125400.2
411722,202307,107,51,56,67321.04,73920,141241.04
411725,202307,170,120,50,158400.9,66000,224400.9
411727,202307,105,87,18,114844.1,23760.33,138604.43
411729,202307,59,46,13,60721.03,17160,77881.03
411730,202307,602,379,223,500287,294363.43,794650.43
411740,202307,27,17,10,22440.23,13200,35640.23
411745,202307,75,57,18,75240,23760,99000
411750,202307,926,383,543,505570.64,719404.03,1224974.67
411760,202307,1410,1014,396,1339846.55,525367.86,1865214.41
411770,202307,452,285,167,377524.71,220441.96,597966.67
411780,202307,404,262,142,345840.49,187440.21,533280.70
411790,202307,637,353,284,465970.97,377520.54,843491.51
411800,202307,170,120,50,158405.97,66000.18,224406.15
411810,202307,203,155,48,204605.3,63360.79,267966.09
411820,202307,2971,1157,1814,1528629.82,2398473.79,3927103.61
411830,202307,21,13,8,17160.62,10560,27720.62
411840,202307,2486,1422,1064,1878409.54,1404503.72,3282913.26
411845,202307,75,23,52,30360.9,68640,99000.9
411850,202307,1398,740,658,976827.12,871209,1848036.12
411860,202307,67,42,25,55440.99,33000,88440.99
411870,202307,80,50,30,66000,39600,105600
411880,202307,440,265,175,349808.65,231002.17,580810.82
411885,202307,114,74,40,99002.21,52801.37,151803.58
411890,202307,357,248,109,328687.2,146521.68,475208.88
411900,202307,119,85,34,112200.55,44880,157080.55
411910,202307,242,160,82,211207.95,108242.04,319449.99
411915,202307,2749,1053,1696,1391318.75,2240074.02,3631392.77
411920,202307,118,86,32,113522.83,43560.98,157083.81
411925,202307,22,15,7,19800.59,9240,29040.59
411930,202307,877,580,297,765711.54,392046.44,1157757.98
411940,202307,624,381,243,502931.13,322082.55,825013.68
411950,202307,1460,666,794,880475.4,1048100.2,1928575.6
411960,202307,1225,742,483,979453.44,637562.38,1617015.82
411965,202307,21,14,7,18481.17,9240,27721.17
411970,202307,100,86,14,113521.02,18480,132001.02
411980,202307,251,125,126,165000.76,166320,331320.76
411990,202307,5944,3094,2850,4085447.73,3772714.71,7858162.44
411995,202307,715,213,502,281168.52,662656.67,943825.19
412000,202307,367,244,123,322087.42,162361.74,484449.16
412010,202307,69,36,33,47520.9,43560.72,91081.62
412015,202307,37,27,10,35640,13200,48840
412020,202307,25,18,7,23761.22,9240,33001.22
412030,202307,39,32,7,42241.07,9240,51481.07
412033,202307,47,25,22,33001.29,29040,62041.29
412035,202307,71,47,24,62040.7,31680,93720.7
412040,202307,34,17,17,22440.97,22440,44880.97
412050,202307,222,166,56,219129.67,73920.7,293050.37
412060,202307,857,610,247,807866.05,327364.31,1135230.36
412065,202307,61,30,31,39602.38,40920.15,80522.53
412070,202307,158,108,50,142562.05,66000.07,208562.12
412080,202307,375,180,195,237611.37,257404.56,495015.93
412085,202307,40,15,25,19800.33,33000,52800.33
412090,202307,929,555,374,733940.13,493683.27,1227623.40
412100,202307,281,232,49,307570.19,64680,372250.19
412110,202307,76,56,20,73920.57,26400,100320.57
412120,202307,403,212,191,279846.86,253442.95,533289.81
412125,202307,74,40,34,52800.2,44880,97680.2
412130,202307,55,37,18,48841.91,23760,72601.91
412135,202307,32,19,13,25080.2,17160,42240.2
412140,202307,499,328,171,432684.24,227042.24,659726.48
412150,202307,277,163,114,215162.53,150480.73,365643.26
412160,202307,76,52,24,68640.71,31680.2,100320.91
412170,202307,738,473,265,624366.79,349802.91,974169.70
412175,202307,41,26,15,34320.74,19800,54120.74
412180,202307,167,123,44,162363.87,58080.2,220444.07
412190,202307,345,266,79,351127.72,105600,456727.72
412200,202307,202,115,87,151801.17,114840,266641.17
412210,202307,103,76,27,100320,35640.73,135960.73
412215,202307,248,163,85,215164.32,112201.28,327365.60
412217,202307,73,58,15,76561.79,19800,96361.79
412220,202307,949,606,343,801267.68,452771.38,1254039.06
412230,202307,314,177,137,233646.96,180846.16,414493.12
412240,202307,1469,722,747,953066.3,987368.2,1940434.5
412250,202307,450,267,183,352444.48,241560,594004.48
412260,202307,143,95,48,125402.74,63360.2,188762.94
412265,202307,168,130,38,171600.83,50160,221760.83
412270,202307,99,58,41,76560.86,54120,130680.86
412280,202307,86,63,23,83160.2,30360,113520.2
412290,202307,96,58,38,76561.77,50160,126721.77
412300,202307,226,161,65,212520.59,85800,298320.59
412310,202307,60,47,13,62041.5,17160,79201.5
412320,202307,95,70,25,92404.18,34320,126724.18
412330,202307,213,159,54,209881.49,71280.95,281162.44
412340,202307,200,128,72,168961.5,95040.9,264002.4
412350,202307,746,327,419,431644.56,553082.79,984727.35
412360,202307,23,18,5,23760,6600,30360
412370,202307,152,124,28,163684.8,36960.96,200645.76
412380,202307,194,141,53,186124.68,69960.71,256085.39
412382,202307,59,35,24,46200,33000,79200
412385,202307,171,120,51,158404.52,67320.92,225725.44
412390,202307,341,254,87,335294.09,114840.88,450134.97
412395,202307,72,57,15,75242.46,19800,95042.46
412400,202307,104,72,32,95041.96,42240,137281.96
412402,202307,250,136,114,179521.81,150480,330001.81
412405,202307,1025,341,684,450122.7,902882.25,1353004.95
412410,202307,1076,638,438,842196.38,579485.46,1421681.84
412420,202307,17,16,1,21120,1320,22440
412430,202307,26,24,2,31681.83,2640.2,34322.03
412440,202307,764,382,382,504248.88,504241.67,1008490.55
412450,202307,67,59,8,77882.39,10560,88442.39
412460,202307,89,59,30,77881.33,39600.19,117481.52
412470,202307,253,202,51,266644.33,68641.33,335285.66
412480,202307,162,116,46,154444.39,60720.2,215164.59
412490,202307,188,155,33,204602.33,43560,248162.33
412500,202307,432,338,94,446169.74,124082.67,570252.41
412510,202307,181,144,37,190084.44,48840,238924.44
412520,202307,93,63,30,83161.66,39600,122761.66
412530,202307,115,50,65,66001.63,85800,151801.63
412535,202307,61,47,14,62041.56,18480,80521.56
412540,202307,63,37,26,48841.65,34320.56,83162.21
412545,202307,95,67,28,88441.18,36960,125401.18
412550,202307,4696,1898,2798,2508219.94,3698699.58,6206919.52
412555,202307,16,8,8,10560,10560,21120
412560,202307,746,481,265,637576.28,351122.18,988698.46
412570,202307,929,400,529,528013.96,698283.62,1226297.58
412575,202307,100,70,30,92401.75,39600,132001.75
412580,202307,188,127,61,168969.89,80522.08,249491.97
412590,202307,30,26,4,34321.11,5280,39601.11
412600,202307,228,164,64,217805.22,84480.83,302286.05
412610,202307,51,22,29,29041.57,38280,67321.57
412620,202307,130,108,22,142563.23,29040.96,171604.19
412625,202307,2361,1112,1249,1469195.13,1651332.7,3120527.83
412627,202307,67,52,15,68641.75,19800,88441.75
412630,202307,399,265,134,351131.54,176881.45,528012.99
412635,202307,82,24,58,31680,76560,108240
412640,202307,118,84,34,110880.86,44880,155760.86
412650,202307,333,221,112,291726,147840.94,439566.94
412660,202307,596,317,279,418444.2,369600.41,788044.61
412665,202307,41,36,5,47520.32,6600,54120.32
412667,202307,281,175,106,231005.56,141240,372245.56
412670,202307,85,65,20,85800.4,27720,113520.4
412680,202307,350,265,85,349809.6,112200.53,462010.13
412690,202307,138,87,51,114843.03,67320,182163.03
412700,202307,194,119,75,157080.79,99000.23,256081.02
412710,202307,1472,799,673,1057342.03,891009.58,1948351.61
412720,202307,258,138,120,182163.74,158400.69,340564.43
412730,202307,185,155,30,205928.22,39600.99,245529.21
412740,202307,431,204,227,269285.37,299640.41,568925.78
412750,202307,437,238,199,315485.93,262680.83,578166.76
412760,202307,408,207,201,273248.63,265325.14,538573.77
412770,202307,2328,1241,1087,1639471.69,1434847.49,3074319.18
412780,202307,149,103,46,135962.51,62040.1,198002.61
412785,202307,332,174,158,229682.17,209880.02,439562.19
412788,202307,59,34,25,46201.14,33000,79201.14
412790,202307,135,108,27,142565.34,35640,178205.34
412795,202307,153,104,49,137283.15,64680,201963.15
412796,202307,320,199,121,262682.83,159720.3,422403.13
412800,202307,771,428,343,564966.02,455400.81,1020366.83
412810,202307,3417,1874,1543,2476396.92,2039424.07,4515820.99
412820,202307,1145,642,503,847470.03,666614.41,1514084.44
412830,202307,16,15,1,19800.2,1320,21120.2
412840,202307,254,165,89,217803.63,117480.2,335283.83
412850,202307,612,400,212,528010.13,281160.68,809170.81
412853,202307,184,82,102,108240.26,134640,242880.26
412855,202307,214,116,98,153123.47,129360.73,282484.20
412860,202307,104,70,34,92403.61,44880.91,137284.52
412862,202307,79,51,28,67320,36960,104280
412863,202307,10,7,3,9240,3960,13200
412865,202307,45,35,10,46200,13200.6,59400.6
412870,202307,125,82,43,108244.39,56761.68,165006.07
412880,202307,96,68,28,89763.1,36960,126723.1
420005,202307,48,39,9,51480.69,11880,63360.69
420010,202307,386,254,132,336605.3,174240.89,510846.19
420020,202307,104,79,25,104282.17,33000,137282.17
420030,202307,31,24,7,31680.2,9240,40920.2
420040,202307,101,78,23,102962.51,30360.2,133322.71
420050,202307,54,34,20,44880.46,26400,71280.46
420055,202307,19,16,3,21120.6,3960,25080.6
420060,202307,35,23,12,30360.89,15840.2,46201.09
420070,202307,115,100,15,132000.6,19800,151800.6
420075,202307,12,12,0,15840,,15840.0
420080,202307,44,37,7,48841.13,9240,58081.13
420090,202307,39,31,8,40920.72,10560.25,51480.97
420100,202307,177,151,26,199322.57,34320,233642.57
420110,202307,28,27,1,35640,1320,36960
420120,202307,67,49,18,64680,23760,88440
420125,202307,81,61,20,80520.6,26400,106920.6
420127,202307,39,32,7,42240,9240,51480
420130,202307,573,344,229,454097,302285.48,756382.48
420140,202307,1515,849,666,1123349.68,880459.64,2003809.32
420150,202307,52,38,14,50160,18480,68640
420160,202307,38,33,5,43560.93,6600,50160.93
420165,202307,19,15,4,19800.79,5280,25080.79
420170,202307,76,43,33,56760.09,43560,100320.09
420180,202307,24,22,2,29040,2640,31680
420190,202307,30,25,5,33000.18,6600,39600.18
420195,202307,148,73,75,96364.64,99002.69,195367.33
420200,202307,1520,627,893,828984.41,1181425.36,2010409.77
420205,202307,144,86,58,113524.46,77880.2,191404.66
420207,202307,172,92,80,121443.44,105601.96,227045.40
420208,202307,22,18,4,23760.21,5280,29040.21
420209,202307,14,12,2,15840,2640,18480
420210,202307,649,311,338,410531.35,448803.81,859335.16
420213,202307,55,38,17,50160.69,22440,72600.69
420215,202307,28,24,4,31681.14,5280,36961.14
420220,202307,63,41,22,54120.44,29040,83160.44
420230,202307,1138,699,439,924040.4,580813.01,1504853.41
420240,202307,2608,1715,893,2265162.12,1180089.61,3445251.73
420243,202307,46,38,8,50161.22,10560,60721.22
420245,202307,268,128,140,168966.16,184803.52,353769.68
420250,202307,68,45,23,59400.94,30360,89760.94
420253,202307,22,17,5,22440.76,6600,29040.76
420257,202307,17,10,7,13200.5,9240,22440.5
420260,202307,133,105,28,138603.03,36960.14,175563.17
420270,202307,38,27,11,35640,14520.36,50160.36
420280,202307,313,229,84,302293.85,110880.51,413174.36
420285,202307,26,20,6,26400,7920,34320
420287,202307,53,33,20,43561.42,26400,69961.42
420290,202307,1061,722,339,953055.93,448800,1401855.93
420300,202307,1751,1403,348,1853355.04,460686.44,2314041.48
420310,202307,45,33,12,43560.7,15840,59400.7
420315,202307,24,20,4,26400.78,5280.74,31681.52
420320,202307,1174,562,612,743187.27,807851.8,1551039.07
420325,202307,8,6,2,7920,2640.3,10560.3
420330,202307,124,83,41,109561.17,54121.13,163682.30
420340,202307,205,138,67,182162.06,88440,270602.06
420350,202307,276,196,80,258727.35,105600.97,364328.32
420360,202307,720,558,162,736584.7,213841.2,950425.9
420370,202307,145,82,63,108242.4,84480.43,192722.83
420380,202307,1355,902,453,1190686.38,599287.36,1789973.74
420390,202307,233,165,68,217805.51,89760.4,307565.91
420395,202307,202,146,56,192735.42,73922.73,266658.15
420400,202307,227,172,55,228364.8,72600,300964.8
420410,202307,57,44,13,58082.65,17160,75242.65
420415,202307,29,22,7,29040.2,9240,38280.2
420417,202307,69,54,15,71280.01,19800,91080.01
420419,202307,12,11,1,14520,1320,15840
420420,202307,3199,1980,1219,2616302.01,1613050.95,4229352.96
420425,202307,73,52,21,68645.69,27720,96365.69
420430,202307,1065,774,291,1021688.58,385442.03,1407130.61
420435,202307,13,10,3,13200,3960,17160
420440,202307,94,67,27,88441.66,35640,124081.66
420445,202307,32,29,3,38280.5,3960,42240.5
420450,202307,96,59,37,77882.97,48840,126722.97
420455,202307,192,149,43,196685.97,56760,253445.97
420460,202307,2605,1600,1005,2113407.68,1329252.74,3442660.42
420470,202307,86,54,32,72600.2,42240,114840.2
420475,202307,9,8,1,10560.95,1320,11880.95
420480,202307,988,759,229,1001928.54,307562.14,1309490.68
420490,202307,100,74,26,97684.11,34320,132004.11
420500,202307,420,247,173,326050.96,228360.95,554411.91
420510,202307,25,21,4,27720.34,5280,33000.34
420515,202307,31,16,15,21120.58,19800,40920.58
420517,202307,11,8,3,10560.91,3960,14520.91
420519,202307,8,6,2,7920,2640,10560
420520,202307,63,44,19,58081.39,25080.2,83161.59
420530,202307,148,95,53,125401.67,69960.2,195361.87
420535,202307,16,13,3,17160.41,3960,21120.41
420540,202307,7567,4668,2899,6163623.95,3830680.05,9994304.00
420543,202307,32,31,1,40921.28,1320,42241.28
420545,202307,241,167,74,220446.87,97680.6,318127.47
420550,202307,828,702,126,926675.01,166322.7,1092997.71
420555,202307,40,30,10,39601.45,13200,52801.45
420560,202307,64,48,16,63361.34,21120,84481.34
420570,202307,257,120,137,158403.34,180842.4,339245.74
420580,202307,356,186,170,245527.5,224400.93,469928.43
420590,202307,553,343,210,452770.74,277200.62,729971.36
420600,202307,163,88,75,116160.6,101640,217800.6
420610,202307,39,36,3,47520,3960,51480
420620,202307,78,62,16,81842.18,21120.41,102962.59
420630,202307,166,112,54,147842.51,71280,219122.51
420640,202307,78,68,10,89760.6,13200,102960.6
420650,202307,350,177,173,234963.85,228360.4,463324.25
420660,202307,42,31,11,40920.45,14520,55440.45
420665,202307,51,34,17,47521.6,22440,69961.6
420670,202307,243,187,56,246848.19,73920,320768.19
420675,202307,17,14,3,18480,3960,22440
420680,202307,35,29,6,38280.12,7920,46200.12
420690,202307,205,149,56,196683.01,74072.43,270755.44
420700,202307,787,512,275,677181.65,363003.6,1040185.25
420710,202307,160,88,72,116162.04,95041.13,211203.17
420720,202307,102,81,21,106923.84,27720.39,134644.23
420730,202307,794,469,325,620421.47,430327.78,1050749.25
420740,202307,60,58,2,76562.03,2640,79202.03
420750,202307,530,348,182,459364.42,241560.7,700925.12
420757,202307,20,17,3,22440,3960,26400
420760,202307,39,27,12,35640.86,15840,51480.86
420765,202307,73,50,23,66001.14,30360,96361.14
420768,202307,63,51,12,67322.91,15840,83162.91
420770,202307,73,63,10,83161.9,13200,96361.9
420775,202307,38,31,7,40920.26,9240,50160.26
420780,202307,202,155,47,204602.95,62040,266642.95
420785,202307,28,17,11,22440,14520,36960
420790,202307,141,118,23,155762.54,30360,186122.54
420800,202307,61,48,13,63360.62,18480,81840.62
420810,202307,298,223,75,294369.77,99000,393369.77
420820,202307,2963,1639,1324,2171479.88,1752984.13,3924464.01
420830,202307,799,427,372,563662.91,492370.66,1056033.57
420840,202307,136,91,45,120120.95,59400,179520.95
420845,202307,493,216,277,285128.01,366963.5,652091.51
420850,202307,306,237,69,312939.62,91080.3,404019.92
420860,202307,58,50,8,66001.52,10560,76561.52
420870,202307,140,99,41,130680.43,54120,184800.43
420880,202307,207,130,77,171603.79,101640.3,273244.09
420890,202307,1105,551,554,727335.82,732602.06,1459937.88
420895,202307,11,10,1,13200,1320,14520
420900,202307,442,354,88,467289.17,116161.31,583450.48
420910,202307,6594,3624,2970,4789116.57,3925727.57,8714844.14
420915,202307,63,58,5,76560.2,6600,83160.2
420917,202307,26,19,7,25080.54,9240,34320.54
420920,202307,21,15,6,19800,7920,27720
420930,202307,3969,2721,1248,3593109.28,1648711.95,5241821.23
420940,202307,619,427,192,564990.4,253446.1,818436.5
420945,202307,11,8,3,10560,3960,14520
420950,202307,45,33,12,43560.6,15840,59400.6
420960,202307,118,96,22,126724.94,29040.1,155765.04
420970,202307,296,241,55,318133.21,72600.71,390733.92
420980,202307,24,23,1,30360,1320,31680
420985,202307,52,44,8,58081.85,10560,68641.85
420990,202307,93,69,24,91081.29,31682.76,122764.05
421000,202307,72,38,34,50160,44880,95040
421003,202307,31,22,9,29040.63,11880,40920.63
421005,202307,8,6,2,7920.3,2640,10560.3
421010,202307,941,601,340,793350.91,448807.22,1242158.13
421020,202307,20,18,2,23762.25,2640,26402.25
421030,202307,116,94,22,125402.2,29040.8,154443.0
421040,202307,72,54,18,71283.4,23761.05,95044.45
421050,202307,333,234,99,308883.33,130680,439563.33
421055,202307,16,13,3,17160.2,3960,21120.2
421060,202307,119,64,55,84481.33,72600,157081.33
421070,202307,34,31,3,40920.86,3960,44880.86
421080,202307,48,39,9,51480.67,11880,63360.67
421085,202307,17,13,4,17160,5280,22440
421090,202307,38,29,9,38280.11,11880,50160.11
421100,202307,125,92,33,121442.08,43560.95,165003.03
421105,202307,205,161,44,212526.84,58080.2,270607.04
421110,202307,135,92,43,121444.95,56760,178204.95
421120,202307,206,142,64,187444.78,84480.42,271925.20
421125,202307,17,10,7,13200,9240.71,22440.71
421130,202307,956,576,380,762981.29,502926.27,1265907.56
421140,202307,34,25,9,33000.33,11880,44880.33
421145,202307,44,38,6,50160.11,7920,58080.11
421150,202307,88,68,20,89761.92,26400,116161.92
421160,202307,66,45,21,59400.5,27720.38,87120.88
421165,202307,16,12,4,15840,5280.2,21120.2
421170,202307,170,144,26,190247.6,34320.61,224568.21
421175,202307,202,140,62,184804.03,81841.75,266645.78
421180,202307,39,24,15,31680.22,19800,51480.22
421185,202307,19,16,3,21120.18,3960,25080.18
421187,202307,5,4,1,5280,1320,6600
421189,202307,47,33,14,43560.58,18480,62040.58
421190,202307,2341,1481,860,1955003.57,1135222.15,3090225.72
421200,202307,98,70,28,92403.11,36960,129363.11
421205,202307,24,17,7,22440.69,9240,31680.69
421210,202307,190,134,56,176881.83,73920,250801.83
421220,202307,270,207,63,273242.86,83160.74,356403.60
421223,202307,55,42,13,55442.06,17160,72602.06
421225,202307,77,51,26,67322.02,34321.04,101643.06
421227,202307,70,58,12,76560.9,15840,92400.9
421230,202307,82,56,26,73922.3,34320.18,108242.48
421240,202307,15,13,2,17161.11,2640,19801.11
421250,202307,457,243,214,320768.69,283806.2,604574.89
421260,202307,23,18,5,23760.59,6600,30360.59
421265,202307,17,11,6,14521.62,7920.1,22441.72
421270,202307,54,48,6,63360,7920,71280
421280,202307,450,233,217,307569.58,287762.25,595331.83
421290,202307,321,212,109,279842.58,143880.43,423723.01
421300,202307,24,20,4,26400,5280,31680
421310,202307,51,35,16,46200,21120,67320
421315,202307,34,19,15,25081.03,19800.08,44881.11
421320,202307,146,99,47,130682.91,62040,192722.91
421330,202307,113,85,28,112201.51,36960,149161.51
421335,202307,46,33,13,43561.63,17160,60721.63
421340,202307,257,170,87,224404.23,114840.41,339244.64
421350,202307,200,121,79,159724.86,104280.25,264005.11
421360,202307,779,533,246,704894.55,326045.31,1030939.86
421370,202307,208,154,54,203282.13,71280.81,274562.94
421380,202307,160,120,40,158401.41,52800,211201.41
421390,202307,16,11,5,14520.58,6600,21120.58
421400,202307,121,98,23,129360,30360,159720
421410,202307,19,16,3,21120,5280,26400
421415,202307,22,20,2,26400,2640,29040
421420,202307,102,86,16,113521.34,21120,134641.34
421430,202307,21,13,8,17160,10560,27720
421440,202307,63,53,10,69961.77,13200.98,83162.75
421450,202307,81,64,17,84480.47,22440,106920.47
421460,202307,52,42,10,55440.66,13200,68640.66
421470,202307,86,47,39,62040.51,51480,113520.51
421480,202307,863,634,229,839534.79,302282.28,1141817.07
421490,202307,24,22,2,29040.78,2640,31680.78
421500,202307,514,293,221,386779.96,291722.25,678502.21
421505,202307,47,38,9,50160.1,11880.2,62040.3
421507,202307,32,26,6,34320.6,7920,42240.6
421510,202307,65,42,23,55441.36,30360.61,85801.97
421520,202307,51,42,9,55440.98,11880,67320.98
421530,202307,55,46,9,60721.28,11880,72601.28
421535,202307,23,21,2,27721.29,2640,30361.29
421540,202307,47,39,8,51480.2,10560,62040.2
421545,202307,92,61,31,80524.4,40921.04,121445.44
421550,202307,318,226,92,299656.48,121441.24,421097.72
421555,202307,16,14,2,18481.56,2640,21121.56
421560,202307,8,7,1,9240,1320,10560
421565,202307,139,87,52,114842.62,68640.57,183483.19
421567,202307,40,29,11,38280,14520,52800
421568,202307,37,36,1,47520,1320,48840
421569,202307,11,10,1,13200.79,1320,14520.79
421570,202307,282,186,96,245525.31,126721.59,372246.90
421575,202307,28,25,3,33000.9,3960,36960.9
421580,202307,799,468,331,617862.42,436921.09,1054783.51
421590,202307,23,20,3,26400.2,3960,30360.2
421600,202307,183,134,49,176881.01,64680,241561.01
421605,202307,114,77,37,101641.35,48840.2,150481.55
421610,202307,175,126,49,166320.48,64680,231000.48
421620,202307,1141,650,491,858035.39,649450.42,1507485.81
421625,202307,23,20,3,26400.76,3960,30360.76
421630,202307,377,229,148,302291.48,195365.13,497656.61
421635,202307,30,17,13,22440,17160,39600
421640,202307,114,88,26,117485.45,34320,151805.45
421650,202307,361,213,148,281169.38,195363.13,476532.51
421660,202307,2997,1826,1171,2411719.01,1547065.1,3958784.11
421670,202307,160,116,44,153123.39,58080,211203.39
421680,202307,207,185,22,244909.21,29040,273949.21
421690,202307,375,250,125,330006.88,165002.23,495009.11
421700,202307,60,41,19,54120.7,25080,79200.7
421710,202307,23,23,0,30360.59,,30360.59
421715,202307,4,4,0,5281.53,,5281.53
421720,202307,686,453,233,597975.23,307562.06,905537.29
421725,202307,34,13,21,17160.22,27720.8,44881.02
421730,202307,23,18,5,23760,6600,30360
421740,202307,120,48,72,63361.56,95040,158401.56
421750,202307,202,143,59,188761.26,77880,266641.26
421755,202307,20,18,2,23760,2640,26400
421760,202307,109,76,33,100322.46,43560.19,143882.65
421770,202307,752,482,270,637584.79,356404.35,993989.14
421775,202307,29,19,10,25080.97,13200.09,38281.06
421780,202307,194,150,44,198000.49,58080,256080.49
421790,202307,156,133,23,175562,30360.15,205922.15
421795,202307,16,13,3,17160.33,3960,21120.33
421800,202307,626,375,251,497664.03,332646.05,830310.08
421810,202307,73,60,13,79201.08,17160,96361.08
421820,202307,340,212,128,279844.33,168960,448804.33
421825,202307,176,148,28,195367.03,36960,232327.03
421830,202307,172,108,64,143887.71,84481.04,228368.75
421835,202307,6,2,4,2640,5280,7920
421840,202307,47,39,8,51481.39,10560.15,62041.54
421850,202307,81,67,14,88440.5,18480,106920.5
421860,202307,39,27,12,35640.73,15840,51480.73
421870,202307,1285,917,368,1210486.32,485772.22,1696258.54
421875,202307,52,40,12,52800,15840,68640
421880,202307,206,145,61,191402.93,80520.7,271923.63
421885,202307,20,15,5,19800,6600.84,26400.84
421890,202307,180,129,51,170285.15,67321.74,237606.89
421895,202307,53,46,7,60721.92,9240,69961.92
421900,202307,139,103,36,135968.77,47520,183488.77
421910,202307,71,44,27,58081.2,35640,93721.2
421915,202307,34,27,7,35640,9240,44880
421917,202307,55,42,13,55441.66,17160,72601.66
421920,202307,37,33,4,43560,5280,48840
421930,202307,675,536,139,708858.98,183482.37,892341.35
421935,202307,46,37,9,48840,11880,60720
421940,202307,56,49,7,64680,9240,73920
421950,202307,977,649,328,856694.26,432964.71,1289658.97
421960,202307,45,37,8,48840.59,10560,59400.59
421970,202307,345,214,131,282485.63,172921.39,455407.02
421985,202307,18,11,7,14520.2,9240,23760.2
422000,202307,15,7,8,9240.2,10560.63,19800.83
430003,202307,204,62,142,81840.6,187440,269280.6
430005,202307,33,26,7,34320.82,9240,43560.82
430010,202307,263,194,69,256083.77,91080,347163.77
430020,202307,141,101,40,133322.07,52800.24,186122.31
430030,202307,136,107,29,141241.73,38280,179521.73
430040,202307,3148,1843,1305,2432805.22,1723923.13,4156728.35
430045,202307,81,71,10,93720,13200,106920
430047,202307,6,5,1,6600,1320,7920
430050,202307,90,75,15,99001.28,19800,118801.28
430055,202307,16,14,2,18480,2640,21120
430057,202307,5,3,2,3960,2640,6600
430060,202307,4664,2713,1951,3582624.19,2577986.67,6160610.86
430063,202307,62,49,13,64680,17160,81840
430064,202307,173,139,34,183480.99,44880,228360.99
430066,202307,7,4,3,5280,3960,9240
430070,202307,43,34,9,44880.28,11880,56760.28
430080,202307,87,59,28,77880.72,36960.18,114840.90
430085,202307,29,14,15,18480,19800,38280
430087,202307,39,29,10,38280.08,13200,51480.08
430090,202307,70,59,11,77880.76,14520,92400.76
430100,202307,158,108,50,142560.86,66000,208560.86
430105,202307,189,102,87,134647.43,114840.3,249487.73
430107,202307,21,16,5,21120.54,6600,27720.54
430110,202307,513,274,239,361681.02,316800.89,678481.91
430120,202307,193,175,18,231000.1,23760,254760.1
430130,202307,863,508,355,673209.81,468601.92,1141811.73
430140,202307,146,132,14,174240.33,18480,192720.33
430150,202307,118,74,44,97680.96,59400,157080.96
430155,202307,29,25,4,33000,5280,38280
430160,202307,4062,2264,1798,2992511.58,2374692.79,5367204.37
430163,202307,481,228,253,300969.22,333964.02,634933.24
430165,202307,32,19,13,25080.59,17160,42240.59
430170,202307,87,72,15,95040,19800,114840
430175,202307,89,70,19,92400,25080,117480
430180,202307,113,86,27,113520.55,36960,150480.55
430185,202307,27,19,8,25080,10560,35640
430187,202307,106,41,65,54121.21,85800,139921.21
430190,202307,256,128,128,168963.4,168962.29,337925.69
430192,202307,13,10,3,13200.56,3960,17160.56
430195,202307,18,14,4,18480.9,5280,23760.9
430200,202307,166,137,29,182164.16,38280,220444.16
430205,202307,19,19,0,25080,,25080.0
430210,202307,838,622,216,822376.3,285120.7,1107497.0
430215,202307,13,13,0,17160,,17160.0
430220,202307,78,52,26,68640,34320,102960
430222,202307,14,4,10,5280,13200,18480
430223,202307,19,13,6,17160,7920,25080
430225,202307,4,2,2,2640,2640,5280
430230,202307,367,228,139,300961.84,183480,484441.84
430235,202307,56,35,21,46200.11,27720,73920.11
430237,202307,22,16,6,21120,7920,29040
430240,202307,120,80,40,105601.07,52800,158401.07
430245,202307,69,56,13,73920,17160,91080
430250,202307,191,112,79,147841.67,104280,252121.67
430258,202307,12,9,3,11880.38,3960.2,15840.58
430260,202307,43,40,3,52800.1,3960,56760.1
430265,202307,40,34,6,44880,7920,52800
430270,202307,566,391,175,516136.58,231000,747136.58
430280,202307,1167,668,499,885727.48,660000.3,1545727.78
430290,202307,480,250,230,330007.44,303600,633607.44
430300,202307,2369,1297,1072,1713406.01,1417697.65,3131103.66
430310,202307,2413,1202,1211,1590669.14,1601191.18,3191860.32
430320,202307,61,50,11,66000,14520,80520
430330,202307,91,77,14,101640.1,18480,120120.1
430340,202307,75,60,15,79200,19800,99000
430350,202307,1817,1129,688,1490297.12,909480.85,2399777.97
430355,202307,20,18,2,23760,2640,26400
430360,202307,113,58,55,76560,73920,150480
430367,202307,51,37,14,48840,18480,67320
430370,202307,64,56,8,73920,10560,84480
430380,202307,111,78,33,102961.54,43560,146521.54
430390,202307,735,440,295,580731.53,390724.71,971456.24
430400,202307,264,180,84,237600.91,110880,348480.91
430410,202307,54,45,9,59400.2,11880,71280.2
430420,202307,583,378,205,500291.73,270601.49,770893.22
430430,202307,51,46,5,59840.88,6600,66440.88
430435,202307,156,111,45,147840.93,59400,207240.93
430440,202307,669,401,268,529329.75,353761.67,883091.42
430450,202307,1328,1085,243,1432220.57,322080.9,1754301.47
430460,202307,6637,3379,3258,4467022.45,4309854.22,8776876.67
430461,202307,20,18,2,23760,2640,26400
430462,202307,5,3,2,3960.1,2640,6600.1
430463,202307,1386,744,642,982104.65,848765.36,1830870.01
430465,202307,27,17,10,22440,13200,35640
430466,202307,831,579,252,764309.62,332646.47,1096956.09
430467,202307,137,75,62,99000.5,81840,180840.5
430468,202307,169,94,75,124081.5,99000.88,223082.38
430469,202307,21,14,7,18480.19,9240,27720.19
430470,202307,1270,691,579,912524.49,764283.5,1676807.99
430471,202307,87,60,27,79201.27,35640.57,114841.84
430480,202307,152,109,43,143880.87,58080,201960.87
430485,202307,8,8,0,10560,,10560.0
430490,202307,71,56,15,73920,19800,93720
430495,202307,38,27,11,35640.2,14520,50160.2
430500,202307,202,134,68,176880,89760,266640
430510,202307,4330,2765,1565,3651185.15,2067132.11,5718317.26
430511,202307,14,14,0,18480,,18480.0
430512,202307,190,128,62,168962.96,81840.4,250803.36
430513,202307,60,45,15,59400,19800,79200
430515,202307,24,22,2,29040,2640,31680
430517,202307,192,162,30,213840.2,39600,253440.2
430520,202307,354,246,108,324724.79,143880.35,468605.14
430530,202307,89,48,41,63360.7,54120,117480.7
430535,202307,514,323,191,426365.65,252123.34,678488.99
430537,202307,9,9,0,11880,,11880.0
430540,202307,80,55,25,72600,33000,105600
430543,202307,471,149,322,196680.24,425040.71,621720.95
430544,202307,54,50,4,66000.61,5280,71280.61
430545,202307,498,243,255,322098.54,337929.47,660028.01
430550,202307,48,38,10,50160.14,13200,63360.14
430558,202307,1,1,0,1320,,1320.0
430560,202307,53,31,22,40920,29040,69960
430570,202307,124,52,72,68643.18,95040,163683.18
430580,202307,129,103,26,135960.89,34320,170280.89
430583,202307,14,14,0,18480,,18480.0
430585,202307,14,10,4,13200.88,5280,18480.88
430587,202307,13,9,4,11880,5280,17160
430590,202307,202,163,39,215160.83,51480,266640.83
430593,202307,1,1,0,1320,,1320.0
430595,202307,18,14,4,18480,5280,23760
430597,202307,44,26,18,34320.66,23760,58080.66
430600,202307,233,169,64,223080,84480,307560
430605,202307,194,114,80,150480,105600,256080
430607,202307,32,25,7,33000,9240,42240
430610,202307,1942,925,1017,1221018.23,1346404.03,2567422.26
430613,202307,5,5,0,6600,,6600.0
430620,202307,106,74,32,97680.56,42240,139920.56
430630,202307,48,41,7,54121.13,9240,63361.13
430632,202307,33,29,4,38280,5280,43560
430635,202307,38,31,7,40920,9240,50160
430637,202307,72,31,41,40920,54120,95040
430640,202307,180,106,74,141245.03,100320.54,241565.57
430642,202307,17,15,2,19800,2640,22440
430645,202307,35,28,7,36960,9240,46200
430650,202307,244,196,48,258723.75,63360.2,322083.95
430655,202307,15,12,3,15840,3960,19800
430660,202307,1073,528,545,698294.23,719407.51,1417701.74
430670,202307,69,48,21,63360,27720,91080
430673,202307,89,58,31,76560.2,40920,117480.2
430675,202307,9,7,2,9240,2640,11880
430676,202307,725,444,281,587511.32,370922.55,958433.87
430680,202307,267,175,92,231002.32,121440,352442.32
430690,202307,596,360,236,475207.18,314162.73,789369.91
430692,202307,6,5,1,6600.7,1320,7920.7
430693,202307,143,92,51,121440.87,67320.2,188761.07
430695,202307,70,53,17,69960,22440,92400
430697,202307,71,44,27,58080,35640,93720
430700,202307,1443,968,475,1277779.46,629640.31,1907419.77
430705,202307,36,30,6,39600.7,7920,47520.7
430710,202307,277,174,103,229680,135960,365640
430720,202307,100,83,17,110880,22440,133320
430730,202307,159,135,24,179520.42,31680,211200.42
430740,202307,89,54,35,71280.55,46200,117480.55
430745,202307,29,17,12,22440,15840,38280
430750,202307,329,208,121,274563.37,161041.02,435604.39
430755,202307,84,47,37,62040.58,50160,112200.58
430760,202307,475,259,216,341887.99,285121.96,627009.95
430770,202307,1877,1032,845,1363602.4,1115407.96,2479010.36
430780,202307,390,241,149,318120.4,196680,514800.4
430781,202307,26,26,0,34320,,34320.0
430783,202307,64,46,18,60720,23760,84480
430786,202307,8,6,2,7920,2640,10560
430790,202307,578,358,220,473887.8,291722.56,765610.36
430800,202307,173,127,46,167640,60720,228360
430805,202307,38,30,8,39600,10560,50160
430807,202307,83,49,34,64680,44880,109560
430810,202307,83,53,30,69960.63,39600,109560.63
430820,202307,166,110,56,145202.54,73920,219122.54
430825,202307,11,9,2,11880,2640,14520
430830,202307,284,262,22,345842.11,29040,374882.11
430840,202307,151,102,49,134640.7,64680,199320.7
430843,202307,8,5,3,6600,3960,10560
430845,202307,83,49,34,64680,44880,109560
430850,202307,617,434,183,575524.73,241560.25,817084.98
430860,202307,191,130,61,171602.04,80520.82,252122.86
430865,202307,80,43,37,56760,48840,105600
430870,202307,74,60,14,79200.57,18480,97680.57
430880,202307,187,127,60,167644.07,79200.8,246844.87
430885,202307,11,9,2,11880,2640,14520
430890,202307,354,213,141,281161.88,187440,468601.88
430900,202307,564,387,177,512164.91,233640.1,745805.01
430905,202307,161,75,86,99000.57,113521.35,212521.92
430910,202307,321,171,150,225721.59,198000.8,423722.39
430912,202307,5,5,0,6600.32,,6600.32
430915,202307,43,40,3,52800,3960,56760
430920,202307,5391,2793,2598,3690864.75,3433377.14,7124241.89
430925,202307,7,6,1,7920,1320,9240
430930,202307,2396,1348,1048,1779393.79,1384683.06,3164076.85
430940,202307,291,184,107,244200.55,141241.1,385441.65
430950,202307,166,131,35,174241.66,46200,220441.66
430955,202307,30,19,11,25080.7,14520,39600.7
430957,202307,25,23,2,30360.11,2640,33000.11
430960,202307,282,186,96,245522.23,128041.22,373563.45
430965,202307,113,72,41,95040.09,54120,149160.09
430970,202307,94,73,21,96360,27720,124080
430975,202307,55,48,7,63361.03,9240,72601.03
430980,202307,59,36,23,47520.78,30360,77880.78
430990,202307,99,78,21,102960,27720,130680
430995,202307,120,109,11,143880,14520,158400
431000,202307,309,152,157,200641.2,207240,407881.2
431010,202307,389,231,158,306253.53,208562.95,514816.48
431020,202307,2073,1194,879,1576100,1160281.93,2736381.93
431030,202307,44,34,10,44880,13200,58080
431033,202307,542,243,299,320778.72,396014.07,716792.79
431036,202307,12,8,4,10560,5280,15840
431040,202307,158,107,51,142560,67320,209880
431041,202307,48,30,18,39600,23760,63360
431043,202307,40,23,17,30360.42,22440,52800.42
431046,202307,12,9,3,11880,3960,15840
431050,202307,215,135,80,178200.82,105600,283800.82
431053,202307,79,43,36,56761.49,47522.14,104283.63
431055,202307,68,43,25,56760,33000,89760
431057,202307,21,21,0,27720,,27720.0
431060,202307,1689,1068,621,1409775.71,821042.79,2230818.50
431065,202307,19,10,9,13200,11880,25080
431070,202307,65,56,9,73920.27,11880,85800.27
431075,202307,7,7,0,9240,,9240.0
431080,202307,137,74,63,97680.99,83160,180840.99
431085,202307,40,36,4,47520.51,5280,52800.51
431087,202307,17,13,4,17160,5280,22440
431090,202307,48,37,11,48840.3,14520,63360.3
431100,202307,1391,822,569,1087700.21,751082.94,1838783.15
431110,202307,235,148,87,195363.53,114840,310203.53
431112,202307,30,24,6,31680.33,7920,39600.33
431113,202307,31,19,12,25080.57,15840,40920.57
431115,202307,155,112,43,147840.66,58080,205920.66
431120,202307,627,366,261,484447.62,345840.78,830288.40
431123,202307,7,7,0,9240,,9240.0
431125,202307,97,86,11,113520,14520,128040
431127,202307,6,4,2,5280,2640,7920
431130,202307,760,488,272,644168.74,359044.37,1003213.11
431140,202307,898,635,263,838207.9,348481.6,1186689.5
431142,202307,16,14,2,18480.56,2640,21120.56
431150,202307,212,146,66,192721.81,87120,279841.81
431160,202307,43,38,5,50160.7,6600,56760.7
431162,202307,5,5,0,6600.74,,6600.74
431164,202307,7,6,1,7920,1320,9240
431170,202307,120,83,37,109560.2,48840,158400.2
431171,202307,77,47,30,62040,39600,101640
431173,202307,10,9,1,11880,1320.8,13200.8
431175,202307,213,114,99,150481.66,132000.48,282482.14
431177,202307,113,77,36,101641.64,47520.31,149161.95
431179,202307,18,13,5,17160,6600,23760
431180,202307,429,262,167,345844.73,220440,566284.73
431190,202307,74,55,19,72600.6,25080.7,97681.3
431198,202307,79,55,24,72463.59,31680,104143.59
431200,202307,24,18,6,23760,7920,31680
431205,202307,24,22,2,29040.7,2640,31680.7
431210,202307,113,69,44,91080.7,58080,149160.7
431213,202307,34,28,6,36960,7920.56,44880.56
431215,202307,25,23,2,30360.91,2640,33000.91
431217,202307,7,6,1,7920,1320,9240
431220,202307,71,58,13,76561.05,17160,93721.05
431225,202307,182,111,71,146520.24,93720,240240.24
431230,202307,109,85,24,112204.35,31680,143884.35
431235,202307,5,4,1,5280,1320,6600
431237,202307,18,14,4,18480,5280,23760
431238,202307,15,10,5,13200,6600.2,19800.2
431240,202307,1079,670,409,884427.55,542522.06,1426949.61
431242,202307,43,42,1,55440,1320,56760
431244,202307,45,37,8,48841.52,10560,59401.52
431245,202307,59,44,15,58080.01,19800,77880.01
431247,202307,19,10,9,13200,11880,25080
431250,202307,327,161,166,212521.74,219120,431641.74
431260,202307,54,46,8,60720,10560,71280
431261,202307,23,16,7,21120.75,9240,30360.75
431262,202307,14,12,2,15840,2640,18480
431265,202307,154,91,63,120120.57,83160,203280.57
431267,202307,22,18,4,23760,5280,29040
431270,202307,352,269,83,355083.51,110881.31,465964.82
431275,202307,41,37,4,48840,5280,54120
431280,202307,21,16,5,21120,6600,27720
431290,202307,29,26,3,35640.65,3960,39600.65
431295,202307,4,1,3,1320,3960,5280
431300,202307,24,19,5,25080.6,6600,31680.6
431301,202307,7,7,0,9240,,9240.0
431303,202307,60,38,22,50160,29040,79200
431306,202307,251,124,127,163681.44,167640,331321.44
431308,202307,8,7,1,9240.6,1320,10560.6
431310,202307,64,50,14,66000.16,18480,84480.16
431320,202307,261,159,102,209881.98,134640,344521.98
431330,202307,239,166,73,219121.97,97680,316801.97
431333,202307,28,23,5,30360,6600,36960
431335,202307,10,8,2,10560.82,2640,13200.82
431337,202307,481,236,245,311532.21,323404.17,634936.38
431339,202307,26,20,6,26400,7920,34320
431340,202307,3508,1895,1613,2507947.74,2129169.25,4637116.99
431342,202307,40,27,13,35640,17160,52800
431344,202307,26,26,0,34320,,34320.0
431346,202307,5,4,1,5280,1320,6600
431349,202307,30,28,2,36960,2640,39600
431350,202307,1055,594,461,784110.49,609844.75,1393955.24
431360,202307,61,43,18,56760,23760,80520
431365,202307,406,176,230,233644.67,303600.49,537245.16
431370,202307,1303,732,571,966262.55,755044.59,1721307.14
431380,202307,106,92,14,121441.97,18480,139921.97
431390,202307,524,287,237,381483.72,312840.3,694324.02
431395,202307,340,149,191,196681.17,253440,450121.17
431400,202307,39,24,15,31680,19800,51480
431402,202307,96,71,25,93721.8,33000.81,126722.61
431403,202307,31,21,10,27720.09,13200,40920.09
431405,202307,811,479,332,633620.49,439565.04,1073185.53
431406,202307,37,30,7,39600.14,10560,50160.14
431407,202307,50,38,12,50160,15840,66000
431410,202307,3851,2358,1493,3115280.11,1972101.67,5087381.78
431413,202307,16,13,3,17160,3960,21120
431415,202307,79,57,22,75240.6,29040,104280.6
431417,202307,24,13,11,17160,14520,31680
431420,202307,401,264,137,348486.67,180840,529326.67
431430,202307,71,33,38,43561.22,50160,93721.22
431440,202307,10313,6920,3393,9141311.14,4482829.01,13624140.15
431442,202307,28,15,13,19800,17160,36960
431445,202307,32,29,3,38280,3960,42240
431446,202307,5,5,0,6600.19,,6600.19
431447,202307,90,70,20,92400.43,26400,118800.43
431449,202307,66,54,12,71280.52,15840,87120.52
431450,202307,449,292,157,385441.23,207240,592681.23
431454,202307,12,7,5,9240,6600,15840
431455,202307,50,38,12,50160.03,15840,66000.03
431460,202307,526,356,170,469927.09,224400,694327.09
431470,202307,143,105,38,138600.25,50160,188760.25
431475,202307,11,9,2,11880,2640,14520
431477,202307,41,25,16,33000,21120,54120
431478,202307,7,7,0,9240,,9240.0
431480,202307,796,480,316,634936.39,417122.54,1052058.93
431490,202307,34417,19238,15179,25431653.03,20065548.51,45497201.54
431500,202307,80,59,21,77880,27720,105600
431505,202307,31,22,9,29040.85,11880,40920.85
431507,202307,8,8,0,10560,,10560.0
431510,202307,247,178,69,234961.92,91080,326041.92
431513,202307,19,18,1,23762.06,1320,25082.06
431514,202307,6,4,2,5280,2640,7920
431515,202307,89,76,13,100320.65,17160,117480.65
431517,202307,7,5,2,6600,2640,9240
431520,202307,41,33,8,43560.2,10560,54120.2
431530,202307,1479,643,836,850090.7,1106161.13,1956251.83
431531,202307,26,24,2,31680.7,2640,34320.7
431532,202307,41,29,12,38280,15840,54120
431535,202307,29,17,12,22440,15840,38280
431540,202307,145,114,31,150483.16,40920,191403.16
431545,202307,13,10,3,13200,3960,17160
431550,202307,380,196,184,258724.22,244201.27,502925.49
431555,202307,19,15,4,19800.2,5280,25080.2
431560,202307,5485,3642,1843,4814222.18,2436767.31,7250989.49
431570,202307,954,510,444,673211.33,587403.91,1260615.24
431575,202307,61,38,23,50160,30360,80520
431580,202307,82,59,23,77880,30360,108240
431590,202307,153,127,26,167640,34320,201960
431595,202307,20,18,2,23760,2640,26400
431600,202307,277,161,116,213845.85,153121.25,366967.10
431610,202307,124,93,31,122762.47,40920.2,163682.67
431620,202307,36,29,7,38280,9240,47520
431630,202307,125,99,26,132000.79,34320,166320.79
431640,202307,1370,844,526,1116735.2,698281.01,1815016.21
431642,202307,32,28,4,36960,5280,42240
431643,202307,44,17,27,22440,35640,58080
431645,202307,354,209,145,275881.15,191400,467281.15
431647,202307,15,14,1,18480,1320,19800
431650,202307,35,20,15,26400,19800,46200
431660,202307,257,165,92,219121.43,121440,340561.43
431670,202307,242,102,140,134641.6,184800.11,319441.71
431673,202307,13,11,2,14520,2640,17160
431675,202307,29,21,8,27720,10560,38280
431680,202307,1296,929,367,1226323.51,485765.25,1712088.76
431690,202307,5587,3226,2361,4262404.31,3121840.34,7384244.65
431695,202307,18,11,7,14520,9240,23760
431697,202307,5,3,2,3960,2640,6600
431700,202307,202,150,52,198000.55,68640,266640.55
431710,202307,4557,1936,2621,2556879.07,3465013.73,6021892.80
431720,202307,1355,837,518,1105514.94,685080.85,1790595.79
431725,202307,3,1,2,1320,2640,3960
431730,202307,1294,842,452,1111492.5,596649.58,1708142.08
431740,202307,1394,683,711,902893.54,939845.51,1842739.05
431750,202307,1940,1271,669,1677750.13,887045.77,2564795.90
431755,202307,5,4,1,5280,1320,6600
431760,202307,1069,676,393,893659.48,522725.38,1416384.86
431770,202307,435,288,147,380161.22,194040,574201.22
431775,202307,27,19,8,25080,10560,35640
431780,202307,608,364,244,480482.28,322080,802562.28
431790,202307,151,118,33,155762.1,43560.1,199322.2
431795,202307,14,12,2,15840,2640,18480
431800,202307,3283,1699,1584,2244037.96,2092208.66,4336246.62
431805,202307,20,16,4,21120,5280,26400
431810,202307,599,385,214,508207.02,282480,790687.02
431820,202307,379,211,168,278520.91,221760,500280.91
431830,202307,2549,1547,1002,2043318.48,1325282.85,3368601.33
431840,202307,539,343,196,452774.56,260040.67,712815.23
431842,202307,36,29,7,38280,9240,47520
431843,202307,8,6,2,7920.16,2640,10560.16
431844,202307,17,13,4,17160,5280,22440
431845,202307,27,25,2,33000,2640,35640
431846,202307,29,24,5,31680.72,6600,38280.72
431848,202307,13,10,3,13200.1,3960,17160.1
431849,202307,8,7,1,9240,1320,10560
431850,202307,873,685,188,904223.89,248162.52,1152386.41
431860,202307,119,76,43,100320.74,56760,157080.74
431861,202307,4,0,4,,5280,5280.0
431862,202307,70,51,19,67320.65,25080,92400.65
431870,202307,4298,2499,1799,3300127.53,2378672.99,5678800.52
431880,202307,1075,747,328,987372.8,432961.29,1420334.09
431890,202307,1309,745,564,984732.71,745801.08,1730533.79
431900,202307,205,134,71,176880.56,93720,270600.56
431910,202307,48,37,11,48840.1,14520,63360.1
431912,202307,58,41,17,54121.27,22440,76561.27
431915,202307,161,123,38,162361.2,50160,212521.2
431920,202307,160,113,47,149160.35,62040,211200.35
431930,202307,79,62,17,81840,22440,104280
431935,202307,6,5,1,6600,1320,7920
431936,202307,3,3,0,3960,,3960.0
431937,202307,22,17,5,22440.2,6600,29040.2
431940,202307,490,339,151,447488.43,199320.46,646808.89
431950,202307,527,331,196,436935.2,260040.5,696975.7
431960,202307,789,440,349,580810.03,462000,1042810.03
431970,202307,64,58,6,76560.85,7920,84480.85
431971,202307,5,4,1,5280,1320,6600
431973,202307,20,17,3,22440.2,3960,26400.2
431975,202307,10,10,0,13200.2,,13200.2
431980,202307,221,123,98,162360.41,129360,291720.41
431990,202307,1077,588,489,776183.03,646813.34,1422996.37
432000,202307,2220,1197,1023,1581425.68,1351696.05,2933121.73
432010,202307,262,170,92,224401.1,121440.2,345841.3
432020,202307,201,172,29,227043.44,40920.4,267963.84
432023,202307,15,13,2,17160,2640,19800
432026,202307,65,57,8,75240.1,10560,85800.1
432030,202307,57,25,32,33000.29,42240,75240.29
432032,202307,14,11,3,14520,3960,18480
432035,202307,78,58,20,76560,26400,102960
432040,202307,88,62,26,81840.92,34320,116160.92
432045,202307,3,3,0,3960,,3960.0
432050,202307,83,51,32,67320.69,42240,109560.69
432055,202307,144,99,45,130681.56,59400,190081.56
432057,202307,7,4,3,5280.7,3960,9240.7
432060,202307,29,25,4,33000,5280,38280
432065,202307,32,27,5,35640,6600,42240
432067,202307,82,75,7,99000.59,9240,108240.59
432070,202307,408,323,85,426364.48,112200,538564.48
432080,202307,892,631,261,832957.85,345842.12,1178799.97
432085,202307,21,18,3,23760,3960,27720
432090,202307,296,194,102,256080.2,135960.33,392040.53
432100,202307,182,114,68,150480.68,89760,240240.68
432110,202307,601,397,204,524045.98,270600.04,794646.02
432120,202307,1151,656,495,867256.01,653403.01,1520659.02
432130,202307,565,398,167,525363.14,220440,745803.14
432132,202307,21,19,2,25080,2640,27720
432135,202307,88,68,20,89760.66,26400,116160.66
432140,202307,287,213,74,281162.42,97680,378842.42
432143,202307,247,149,98,196682.73,129360.24,326042.97
432145,202307,334,235,99,311524.75,130680.69,442205.44
432146,202307,17,15,2,19800.55,2640,22440.55
432147,202307,103,63,40,83160,52800,135960
432149,202307,13,12,1,15840,1320,17160
432150,202307,1217,774,443,1023022.99,584763.4,1607786.39
432160,202307,2236,1141,1095,1508797.82,1445410.2,2954208.02
432162,202307,8,4,4,5280,5280,10560
432163,202307,17,12,5,15840,6600,22440
432166,202307,139,96,43,127052.59,56761.23,183813.82
432170,202307,250,128,122,170287.13,162360.9,332648.03
432180,202307,597,384,213,506880.54,281160,788040.54
432183,202307,16,13,3,17160.43,3960,21120.43
432185,202307,82,67,15,88440.56,19800.79,108241.35
432190,202307,575,339,236,447481.58,311520.44,759002.02
432195,202307,100,78,22,102961.3,29040,132001.3
432200,202307,482,294,188,389406.07,248161.9,637567.97
432210,202307,121,71,50,93720.1,66000,159720.1
432215,202307,33,31,2,42240,2640,44880
432218,202307,21,21,0,27720,,27720.0
432220,202307,707,352,355,465967.08,469923.58,935890.66
432225,202307,19,14,5,18480.2,6600,25080.2
432230,202307,128,81,47,106920,62040.3,168960.3
432232,202307,34,30,4,39600,5280,44880
432234,202307,5,3,2,3960,2640,6600
432235,202307,2,2,0,2640,,2640.0
432237,202307,24,16,8,21120,10560.95,31680.95
432240,202307,4925,2745,2180,3631413.77,2878951.38,6510365.15
432250,202307,1254,836,418,1104853.58,551761.64,1656615.22
432252,202307,52,47,5,62040,6600,68640
432253,202307,78,59,19,77881.4,25080,102961.4
432254,202307,32,16,16,21120,21120,42240
432255,202307,11,10,1,13200,1320,14520
432260,202307,955,765,190,1009820.7,250800.1,1260620.8
432270,202307,242,182,60,240252.65,79202.36,319455.01
432280,202307,186,140,46,186124.5,60720,246844.5
432285,202307,1,1,0,1320,,1320.0
432290,202307,61,50,11,66000,14520,80520
432300,202307,5735,3080,2655,4070909.8,3511224.8,7582134.6
432310,202307,140,117,23,154440.8,30360,184800.8
432320,202307,24,18,6,23760,7920,31680
432330,202307,18,12,6,15840,7920,23760
432335,202307,9,7,2,9240,2640,11880
432340,202307,36,29,7,38280,9240,47520
432345,202307,133,91,42,120123.31,55440,175563.31
432350,202307,25,23,2,30360,2640,33000
432360,202307,6,5,1,6600.7,1320,7920.7
432370,202307,27,27,0,35640.14,,35640.14
432375,202307,30,28,2,36960,2640,39600
432377,202307,9,9,0,11880.48,,11880.48
432380,202307,249,120,129,158402.43,170283.28,328685.71
500020,202307,320,168,152,221762.41,200640.8,422403.21
500025,202307,159,75,84,99002.34,110881.12,209883.46
500060,202307,1628,1044,584,1378124.4,770888.51,2149012.91
500070,202307,821,404,417,534611.12,551770.28,1086381.40
500080,202307,154,126,28,166324.31,36960,203284.31
500085,202307,155,114,41,150483.72,54120,204603.72
500090,202307,410,195,215,257407.01,283801.87,541208.88
500100,202307,719,375,344,495013.7,455400.89,950414.59
500110,202307,2460,1202,1258,1586692.99,1660582.14,3247275.13
500124,202307,293,151,142,199320.99,187441.35,386762.34
500150,202307,338,139,199,183482.94,262680.65,446163.59
500190,202307,613,412,201,543861.64,265323.17,809184.81
500200,202307,222,182,40,240244.57,52800,293044.57
500210,202307,1840,574,1266,757694.77,1673773.77,2431468.54
500215,202307,212,123,89,163687.52,117480.2,281167.72
500220,202307,769,479,290,632305.16,382802.58,1015107.74
500230,202307,257,147,110,194043.77,147841.34,341885.11
500240,202307,690,427,263,564975.71,347163.54,912139.25
500260,202307,631,258,373,340564.54,492360.46,832925.00
500270,202307,33864,14902,18962,19684226.68,25063201.03,44747427.71
500280,202307,210,73,137,96360.94,180840.66,277201.60
500290,202307,1277,804,473,1061307.41,624363.49,1685670.90
500295,202307,532,353,179,467289.35,237601.09,704890.44
500310,202307,123,43,80,56760.1,105600.5,162360.6
500315,202307,915,495,420,654721.37,555722.66,1210444.03
500320,202307,4091,1923,2168,2537139.75,2861775.12,5398914.87
500325,202307,1024,578,446,765631.13,591365.43,1356996.56
500330,202307,1665,832,833,1099647.78,1103532.61,2203180.39
500345,202307,336,231,105,304926.53,138600.21,443526.74
500348,202307,266,161,105,213844.45,138600,352444.45
500350,202307,107,50,57,66001.43,75241.14,141242.57
500370,202307,6306,2898,3408,3829704.41,4499918.92,8329623.33
500375,202307,387,254,133,335283.84,175560.26,510844.10
500380,202307,717,395,322,521414.43,426361.29,947775.72
500390,202307,80,34,46,44880.1,62040.7,106920.8
500400,202307,238,142,96,187445.75,128040.97,315486.72
500410,202307,465,211,254,278530.55,335284.04,613814.59
500430,202307,662,408,254,538574.58,336601.5,875176.08
500440,202307,210,120,90,158400.14,118800.2,277200.34
500450,202307,473,202,271,266644.44,357721.25,624365.69
500460,202307,304,165,139,217803.52,183480.96,401284.48
500470,202307,469,332,137,438247.67,180840.78,619088.45
500480,202307,121,68,53,89760.73,69961.48,159722.21
500490,202307,99,46,53,60720.68,69963.37,130684.05
500500,202307,1604,595,1009,786746.25,1334528.13,2121274.38
500510,202307,39,33,6,43560.31,7920,51480.31
500515,202307,124,82,42,108243.03,55441.47,163684.50
500520,202307,317,160,157,211208.31,207240.16,418448.47
500525,202307,97,50,47,66000.14,62040,128040.14
500540,202307,993,434,559,572902.66,737887.98,1310790.64
500560,202307,931,520,411,687733.91,543842.61,1231576.52
500568,202307,1199,561,638,740534.28,843486.67,1584020.95
500570,202307,1312,751,561,992657.91,740523.92,1733181.83
500580,202307,319,177,142,234968.2,187441.24,422409.44
500600,202307,434,205,229,270605.65,302282.34,572887.99
500620,202307,1133,790,343,1042827.5,452768.06,1495595.56
500625,202307,92,68,24,89760.41,33000,122760.41
500627,202307,51,23,28,30360,36960,67320
500630,202307,1708,990,718,1307596.53,949088.04,2256684.57
500635,202307,531,313,218,414481.84,287760,702241.84
500640,202307,370,198,172,261371.18,227042.81,488413.99
500660,202307,6607,2338,4269,3087551.86,5637755.82,8725307.68
500690,202307,686,247,439,327366.12,579480.26,906846.38
500710,202307,442,216,226,287766.88,298325.26,586092.14
500720,202307,1041,573,468,756379.04,617763.31,1374142.35
500730,202307,146,88,58,116166.48,76560,192726.48
500740,202307,1044,456,588,603256.77,777484.99,1380741.76
500750,202307,216,81,135,106923.23,179521.85,286445.08
500755,202307,119,88,31,116164.19,40920.93,157085.12
500769,202307,810,449,361,592698.7,476523.37,1069222.07
500770,202307,460,247,213,326041.32,281160,607201.32
500780,202307,141,96,45,126727.74,59401.33,186129.07
500790,202307,1181,574,607,757705.75,801244.78,1558950.53
500793,202307,314,162,152,213844.01,200643.11,414487.12
500795,202307,213,133,80,175562.76,105600.99,281163.75
500797,202307,49,34,15,44880.75,19800,64680.75
500800,202307,475,210,265,277206.67,349801.35,627008.02
500830,202307,2576,1339,1237,1770190.13,1638130.71,3408320.84
500840,202307,111,81,30,106924.84,39600.94,146525.78
510010,202307,176,97,79,128040,104280,232320
510020,202307,574,277,297,365654.63,392044.26,757698.89
510025,202307,1896,1077,819,1423001.43,1083729.51,2506730.94
510030,202307,681,364,317,480499.91,418446.69,898946.60
510035,202307,137,71,66,93720.25,87120,180840.25
510040,202307,431,203,228,269283.03,302281.66,571564.69
510050,202307,389,196,193,258722.22,254760,513482.22
510060,202307,148,66,82,87122.74,108240,195362.74
510080,202307,266,116,150,153120.95,199320,352440.95
510100,202307,68,29,39,38280.55,51480.69,89761.24
510120,202307,32,19,13,25080.99,17160.24,42241.23
510125,202307,414,264,150,348481.9,198000.21,546482.11
510130,202307,565,338,227,446171.3,299642.17,745813.47
510140,202307,480,164,316,216481.43,417121.04,633602.47
510160,202307,113,47,66,62043.18,87121.31,149164.49
510170,202307,850,505,345,666616.83,455406.3,1122023.13
510180,202307,3238,1459,1779,1927244.11,2349621.34,4276865.45
510185,202307,41,22,19,29040.7,25080,54120.7
510190,202307,285,102,183,134642.65,241561.49,376204.14
510250,202307,2952,1790,1162,2364164.31,1536485.77,3900650.08
510260,202307,176,126,50,166321.75,66000.62,232322.37
510263,202307,510,295,215,389408.1,283803.12,673211.22
510267,202307,681,386,295,509538.08,389402.94,898941.02
510268,202307,81,38,43,50160.01,56760,106920.01
510269,202307,81,37,44,48840,58080.5,106920.5
510270,202307,404,198,206,261362.1,273240.31,534602.41
510279,202307,227,167,60,220441.92,79200,299641.92
510285,202307,190,77,113,101641.59,150480,252121.59
510300,202307,557,298,259,393364.39,343201.58,736565.97
510305,202307,212,90,122,118800.33,161040,279840.33
510310,202307,113,59,54,77880.02,71280.1,149160.12
510320,202307,861,538,323,710172.96,426363.75,1136536.71
510325,202307,479,209,270,275884.12,359042.33,634926.45
510330,202307,501,282,219,372246.83,289081.55,661328.38
510335,202307,721,432,289,570256.73,382803.06,953059.79
510336,202307,57,39,18,51481.56,23760.85,75242.41
510337,202307,110,46,64,60720.03,84480,145200.03
510340,202307,20391,8735,11656,11541200.89,15407300.04,26948500.93
510343,202307,64,50,14,66000,18480,84480
510345,202307,158,96,62,126721.97,81840.68,208562.65
510350,202307,694,370,324,489731.74,427685.98,917417.72
510360,202307,225,139,86,183483.58,113520,297003.58
510370,202307,181,77,104,101640,137280.7,238920.7
510380,202307,82,60,22,79200,29040,108240
510385,202307,56,32,24,42240.2,31680,73920.2
510390,202307,104,47,57,62040.33,75240.63,137280.96
510395,202307,62,43,19,56760,25080,81840
510410,202307,887,574,313,760346.07,413165.63,1173511.70
510420,202307,588,286,302,377524.25,398640.7,776164.95
510450,202307,55,32,23,42240,30360,72600
510452,202307,61,30,31,39600,40920,80520
510454,202307,57,26,31,34320,40920.03,75240.03
510455,202307,119,72,47,95040,63360.97,158400.97
510460,202307,212,90,122,118802.32,161040,279842.32
510480,202307,823,470,353,620418.87,465970.29,1086389.16
510490,202307,339,164,175,216482.6,231000.5,447483.1
510500,202307,250,188,62,248160.5,81840,330000.5
510510,202307,925,542,383,715457.21,508205.65,1223662.86
510515,202307,1380,714,666,945139.9,879125.69,1824265.59
510517,202307,287,128,159,168963.33,209880,378843.33
510520,202307,247,153,94,203284.75,124080.43,327365.18
510523,202307,124,96,28,126720,36960,163680
510525,202307,951,589,362,777496.15,477842.22,1255338.37
510530,202307,32,16,16,21120,21120,42240
510550,202307,259,117,142,154442.49,187442.06,341884.55
510558,202307,330,163,167,215412.11,220440,435852.11
510560,202307,411,242,169,319445.5,223082.26,542527.76
510562,202307,717,514,203,679820.27,267961.62,947781.89
510590,202307,737,358,379,472572.54,501602.66,974175.20
510600,202307,218,119,99,157084.8,130680.55,287765.35
510610,202307,228,103,125,135963.81,165001.4,300965.21
510615,202307,244,116,128,153121,168960.31,322081.31
510617,202307,27,11,16,14520,21120,35640
510618,202307,127,66,61,87120,80522.26,167642.26
510619,202307,86,61,25,80521.92,33000,113521.92
510620,202307,166,89,77,117480.7,101640,219120.7
510621,202307,185,122,63,161040.17,83160.23,244200.40
510622,202307,544,287,257,378851.58,340565.71,719417.29
510623,202307,299,203,96,267963.47,126720.2,394683.67
510624,202307,102,49,53,64681.76,69960.83,134642.59
510625,202307,569,350,219,462014.77,289084.1,751098.87
510626,202307,123,67,56,88442.67,73920,162362.67
510627,202307,103,69,34,91081.42,44880,135961.42
510628,202307,178,109,69,143880.45,91080,234960.45
510629,202307,306,187,119,246842.75,157103.76,403946.51
510630,202307,486,255,231,336614.9,304921.51,641536.41
510631,202307,21,9,12,11880.13,15840,27720.13
510637,202307,377,217,160,286443.81,211200.1,497643.91
510642,202307,1284,690,594,912139.78,784085.73,1696225.51
510645,202307,14,5,9,6600,11880.18,18480.18
510650,202307,1312,837,475,1107526.81,627004.64,1734531.45
510665,202307,101,46,55,60720.87,72600.08,133320.95
510670,202307,61,35,26,46200.82,34320,80520.82
510675,202307,1179,748,431,988711.04,570244.84,1558955.88
510677,202307,367,196,171,258724.74,225720.51,484445.25
510680,202307,91,58,33,76562.49,43560,120122.49
510682,202307,206,96,110,126720.85,145200,271920.85
510685,202307,56,40,16,52800.55,21120.8,73921.35
510700,202307,621,356,265,471256.49,349803.3,821059.79
510704,202307,1393,710,683,937237.73,901573.16,1838810.89
510706,202307,175,88,87,116162.99,114841.03,231004.02
510710,202307,461,328,133,432966.4,175560,608526.4
510715,202307,57,39,18,51480,23760.63,75240.63
510718,202307,267,117,150,154442.31,198005.23,352447.54
510719,202307,56,26,30,34320,39600,73920
510720,202307,185,131,54,172920.37,71280,244200.37
510724,202307,82,32,50,42240,66000,108240
510726,202307,70,35,35,46200.7,46200.62,92401.32
510729,202307,16,6,10,7920,13200.3,21120.3
510730,202307,490,259,231,341882.31,304920,646802.31
510735,202307,126,47,79,62040.08,104280,166320.08
510740,202307,27,16,11,21121.07,14521.34,35642.41
510757,202307,30,25,5,33001.43,6600.16,39601.59
510760,202307,8294,4200,4094,5544138.98,5410722.37,10954861.35
510770,202307,768,346,422,456728.66,557043.42,1013772.08
510774,202307,19,7,12,9240.69,15840,25080.69
510775,202307,128,101,27,133320,36960,170280
510776,202307,36,12,24,15840,31680.2,47520.2
510777,202307,190,86,104,113520.2,137280,250800.2
510779,202307,40,25,15,33000,19800,52800
510780,202307,288,150,138,198009.21,182160,380169.21
510785,202307,351,192,159,253446.45,209880.76,463327.21
510787,202307,231,117,114,154443.4,150481.09,304924.49
510788,202307,11,4,7,5280.9,9240,14520.9
510790,202307,2920,1497,1423,1977478.12,1879687.94,3857166.06
510792,202307,1203,671,532,888239.32,702252.88,1590492.20
510794,202307,127,69,58,91081.06,77880,168961.06
510795,202307,2497,1406,1091,1857278.37,1440126.01,3297404.38
510800,202307,201,110,91,145200.66,120120.14,265320.80
510805,202307,232,160,72,211201.1,95040,306241.1
510810,202307,110,44,66,58081.51,87120.42,145201.93
510820,202307,271,137,134,180841.74,178200.6,359042.34
510830,202307,82,42,40,55440,52800,108240
510835,202307,29,22,7,29040.7,9240,38280.7
510840,202307,10291,4654,5637,6146168.26,7454118.73,13600286.99
510850,202307,222,89,133,117482.26,175560.26,293042.52
510860,202307,444,222,222,293043.72,293041.49,586085.21
510880,202307,82,59,23,77880.2,30360,108240.2
510885,202307,72,41,31,54121.63,40920,95041.63
510890,202307,80,38,42,50160.16,55440,105600.16
510895,202307,196,115,81,151800.64,106920,258720.64
520005,202307,168,70,98,92403.05,129361.86,221764.91
520010,202307,341,152,189,200643.05,249484.3,450127.35
520013,202307,813,570,243,752415.57,320763.21,1073178.78
520015,202307,38,25,13,33000,17160,50160
520017,202307,88,56,32,73920.84,42240,116160.84
520020,202307,12,6,6,7920,7920,15840
520025,202307,3319,1803,1516,2380077.05,2002499.45,4382576.50
520030,202307,948,489,459,645493.51,605884.28,1251377.79
520050,202307,63,47,16,62040.2,21120,83160.2
520055,202307,86,59,27,77880,35640.2,113520.2
520060,202307,193,131,62,172924.04,81841.25,254765.29
520080,202307,604,430,174,567602.08,229680.56,797282.64
520082,202307,18,13,5,17160,6600,23760
520085,202307,113,88,25,116160.18,33000.7,149160.88
520090,202307,88,65,23,85800.75,30360,116160.75
520110,202307,10152,4321,5831,5706518.82,7708869.01,13415387.83
520120,202307,10,7,3,9240,5280,14520
520130,202307,921,648,273,855372.23,360361.42,1215733.65
520140,202307,13365,7285,6080,9622826.96,8030973.43,17653800.39
520145,202307,68,40,28,52800.2,36960,89760.2
520150,202307,141,110,31,145205.59,40920,186125.59
520160,202307,42,26,16,34320,21120,55440
520170,202307,218,124,94,165007.59,124082.12,289089.71
520180,202307,202,96,106,126721,139921.36,266642.36
520215,202307,204,150,54,198000.83,71280.2,269281.03
520235,202307,94,71,23,93720,30360,124080
520250,202307,169,87,82,114842.09,108240,223082.09
520260,202307,129,78,51,102963.14,67321.05,170284.19
520280,202307,49,38,11,50160,14520,64680
520310,202307,29,17,12,22441.8,15840.7,38282.5
520320,202307,192,114,78,150481.98,102960.97,253442.95
520330,202307,905,503,402,665295.76,530643.98,1195939.74
520340,202307,313,182,131,240249.63,174241.46,414491.09
520350,202307,514,263,251,347164.77,332642.2,679806.97
520355,202307,113,68,45,89762.51,59400,149162.51
520357,202307,37,29,8,38280,10560,48840
520360,202307,18,7,11,9240.2,14520.28,23760.48
520380,202307,148,82,66,108240,87120,195360
520390,202307,241,106,135,139923.59,178200,318123.59
520393,202307,19,15,4,19800.1,5280,25080.1
520396,202307,78,57,21,75240,27720,102960
520400,202307,225,139,86,183486.52,113522.83,297009.35
520410,202307,209,106,103,139923.8,135960,275883.8
520420,202307,22,18,4,23760.94,5280,29040.94
520425,202307,263,126,137,166323.17,180840.98,347164.15
520430,202307,576,268,308,353761.68,406560.9,760322.58
520440,202307,705,513,192,677175.89,253441.33,930617.22
520450,202307,2403,1046,1357,1380763.44,1793899.44,3174662.88
520455,202307,65,36,29,47521.37,38280.51,85801.88
520460,202307,47,29,18,38280.69,23761.51,62042.20
520465,202307,39,34,5,44880,6600,51480
520470,202307,484,298,186,393363.11,245520.2,638883.31
520480,202307,77,51,26,67321.59,34320,101641.59
520485,202307,112,43,69,56760.83,91080.1,147840.93
520490,202307,580,425,155,561011.05,204602.73,765613.78
520495,202307,173,103,70,135960.1,92400,228360.1
520500,202307,265,217,48,286441.8,63360,349801.8
520505,202307,193,113,80,149160,105600,254760
520510,202307,2232,1053,1179,1389983.94,1558928.59,2948912.53
520520,202307,66,42,24,55440.97,31680,87120.97
520530,202307,218,173,45,228366.24,59400,287766.24
520540,202307,831,564,267,745813.86,352442.34,1098256.20
520545,202307,164,98,66,129364.27,87120.6,216484.87
520547,202307,82,47,35,63362.64,46200.1,109562.74
520549,202307,1652,799,853,1054715.71,1128615,2183330.71
520551,202307,338,181,157,238921.98,208561.23,447483.21
520552,202307,57,42,15,55440.5,19800,75240.5
520570,202307,15,12,3,15840,3960,19800
520580,202307,296,185,111,244339.56,146520.73,390860.29
520590,202307,164,91,73,120122.26,96360,216482.26
520620,202307,1354,631,723,832931.19,954368.63,1787299.82
520630,202307,56,30,26,39600,34320.18,73920.18
520640,202307,401,233,168,307566.66,223080.9,530647.56
520650,202307,74,34,40,44880,52800,97680
520660,202307,47,25,22,33001.06,29040.38,62041.44
520670,202307,49,37,12,48840.22,15840,64680.22
520680,202307,25,15,10,19800,13200,33000
520690,202307,39,10,29,13200,38280,51480
520710,202307,37,28,9,36960,11880,48840
520725,202307,198,149,49,196683.33,64680,261363.33
520735,202307,61,37,24,48840.2,31680.2,80520.4
520740,202307,491,243,248,322087.34,327361.22,649448.56
520750,202307,41,24,17,31680,22440,54120
520753,202307,79,57,22,75240.76,29040,104280.76
520760,202307,112,78,34,102961.49,44880,147841.49
520780,202307,275,212,63,279844.79,83163.11,363007.90
520790,202307,149,93,56,122760.65,73920,196680.65
520800,202307,3706,2104,1602,2778685.26,2118624.81,4897310.07
520810,202307,140,108,32,142562.45,42240.89,184803.34
520815,202307,7,5,2,6600.96,2640,9240.96
520830,202307,136,95,41,125402.83,54120.05,179522.88
520840,202307,423,268,155,355080.96,204600,559680.96
520850,202307,115,68,47,89762.18,64680,154442.18
520860,202307,1989,1261,728,1664558.98,960964.98,2625523.96
520870,202307,36912,16704,20208,22060625.55,26692019.33,48752644.88
520880,202307,1416,744,672,982123.24,887057.55,1869180.79
520890,202307,886,569,317,751103.8,419761.57,1170865.37
520910,202307,1035,541,494,714144.88,652082.61,1366227.49
520915,202307,93,63,30,83162.29,39600,122762.29
520920,202307,539,250,289,330011.63,381487.29,711498.92
520929,202307,16,14,2,18480.62,2640,21120.62
520940,202307,66,50,16,66001.02,21120.1,87121.12
520945,202307,19,12,7,15840,9240,25080
520960,202307,47,28,19,36960,25080,62040
520970,202307,453,265,188,349808.56,248164.3,597972.86
520980,202307,93,67,26,88440,34320,122760
520990,202307,443,312,131,411842.41,172920.63,584763.04
520993,202307,122,63,59,84483.11,77880.09,162363.20
520995,202307,280,153,127,201962.72,167640,369602.72
521000,202307,1718,937,781,1236866.45,1032250.19,2269116.64
521010,202307,659,352,307,464649.29,405242.78,869892.07
521015,202307,14,9,5,11880,6600,18480
521020,202307,1560,1096,464,1446756.78,612488.64,2059245.42
521030,202307,84,58,26,76560.95,34320,110880.95
521040,202307,1060,716,344,945144.85,454081,1399225.85
521056,202307,61,40,21,52800.95,27720,80520.95
521060,202307,130,84,46,110881.37,60720.76,171602.13
521080,202307,322,255,67,336620.05,88440.4,425060.45
521090,202307,627,432,195,570248.66,258720,828968.66
521100,202307,285,197,88,260046.6,116160.4,376207.0
521120,202307,1143,810,333,1070548.56,439563.92,1510112.48
521130,202307,332,238,94,314167.07,124080,438247.07
521140,202307,196,108,88,142565.26,116161.29,258726.55
521150,202307,2737,1155,1582,1524653.85,2089589.69,3614243.54
521160,202307,25,9,16,11880,21120,33000
521170,202307,230,123,107,162361.03,141240.2,303601.23
521180,202307,1289,805,484,1063818.07,638887.58,1702705.65
521190,202307,2831,1191,1640,1572160.07,2166138.78,3738298.85
521200,202307,64,47,17,62040.1,22440,84480.1
521205,202307,19,13,6,17160.2,7920,25080.2
521210,202307,143,88,55,116161.69,72600,188761.69
521220,202307,792,531,261,702253,344522.99,1046775.99
521225,202307,18,13,5,17161.17,6600.74,23761.91
521230,202307,114,75,39,99001.38,51480.7,150482.08
521250,202307,6942,3820,3122,5047891.69,4125055.37,9172947.06
521260,202307,47,19,28,25080,36960,62040
521270,202307,129,98,31,129360.93,40920,170280.93
521280,202307,432,268,164,353762.89,216480,570242.89
521290,202307,33,18,15,23760.92,19800,43560.92
521295,202307,108,72,36,95040.93,47520,142560.93
521300,202307,257,146,111,192722.41,146520.84,339243.25
521305,202307,49,34,15,44881.51,19800,64681.51
521308,202307,1057,815,242,1075833.61,320764.23,1396597.84
521310,202307,1499,822,677,1085074.05,893653.09,1978727.14
521340,202307,22,17,5,22440,6600,29040
521350,202307,94,71,23,93722.44,30360,124082.44
521370,202307,179,116,63,153120.5,83160,236280.5
521375,202307,213,102,111,134643.49,149161.09,283804.58
521377,202307,47,34,13,44880.87,17160.1,62040.97
521380,202307,1151,679,472,898911.39,623046.32,1521957.71
521385,202307,11,6,5,7920,6600,14520
521390,202307,106,84,22,110882.41,29040.49,139922.90
521400,202307,419,303,116,399973.75,153120.92,553094.67
521405,202307,175,112,63,147843.34,83160.66,231004.00
521410,202307,85,62,23,81841.27,30360,112201.27
521440,202307,223,152,71,200645.44,93720.64,294366.08
521450,202307,836,457,379,603252.92,500283.96,1103536.88
521460,202307,1183,829,354,1094323.92,467287.41,1561611.33
521470,202307,16,12,4,15840,5280,21120
521480,202307,43,27,16,35641.51,21120,56761.51
521483,202307,347,229,118,303602.93,155761.47,459364.40
521486,202307,324,217,107,286441.2,141240.84,427682.04
521487,202307,24,12,12,15840,15840,31680
521490,202307,28,16,12,21120,15840,36960
521500,202307,157,74,83,97680.33,109560.19,207240.52
521520,202307,49,37,12,48840,15840,64680
521523,202307,1274,691,583,912141.88,769565.09,1681706.97
521525,202307,66,51,15,67320,19800,87120
521530,202307,248,144,104,190080.45,137280.49,327360.94
521540,202307,47,23,24,30360,31680,62040
521550,202307,134,67,67,88441.29,88440.99,176882.28
521560,202307,976,659,317,872544.92,419762.48,1292307.40
521565,202307,73,51,22,67321.54,29040.7,96362.24
521570,202307,625,393,232,518770.01,310200.97,828970.98
521580,202307,44,28,16,38280,21120,59400
521590,202307,43,23,20,30360,26400,56760
521600,202307,25,12,13,15840,17160,33000
521630,202307,239,123,116,162365.96,153123.52,315489.48
521640,202307,332,180,152,237603.4,201960.67,439564.07
521645,202307,41,20,21,26400,27720,54120
521680,202307,269,165,104,217803.47,137280.87,355084.34
521690,202307,16,14,2,18480,2640,21120
521710,202307,1185,572,613,755052.41,811805.9,1566858.31
521720,202307,634,426,208,562325.47,274561.46,836886.93
521730,202307,766,352,414,464645.86,546481.84,1011127.70
521740,202307,980,461,519,608526.79,685084.03,1293610.82
521760,202307,2695,1387,1308,1833652.66,1729237.4,3562890.06
521770,202307,887,542,345,715450.39,455402.79,1170853.18
521800,202307,2136,1461,675,1928561.84,892321.92,2820883.76
521805,202307,40,25,15,33000,19800,52800
521810,202307,92,53,39,69960.91,51480,121440.91
521830,202307,1091,803,288,1059992,381486.7,1441478.7
521839,202307,74,41,33,54120,43560.2,97680.2
521850,202307,1269,634,635,836904.5,840850,1677754.5
521860,202307,348,219,129,289085.17,170280,459365.17
521870,202307,97,64,33,84480,43560,128040
521878,202307,37,15,22,19800,29040.12,48840.12
521880,202307,5519,2453,3066,3243339.96,4049791.13,7293131.09
521890,202307,683,465,218,613810.84,287762.11,901572.95
521900,202307,295,231,64,304920.49,84480.8,389401.29
521910,202307,196,135,61,178206.69,80522.39,258729.08
521920,202307,37,22,15,29040,19800,48840
521925,202307,58,33,25,43560,33000,76560
521930,202307,1349,757,592,1000595.62,782771.95,1783367.57
521935,202307,36,27,9,35641.61,11880,47521.61
521940,202307,250,113,137,150481.62,180840.75,331322.37
521945,202307,21,15,6,19800,7920,27720
521950,202307,25,14,11,18480,14520,33000
521960,202307,68,54,14,71280,18480,89760
521970,202307,424,277,147,365643,194040.89,559683.89
521971,202307,109,59,50,77880.8,66000,143880.8
521973,202307,39,18,21,23760.6,27720,51480.6
521975,202307,1833,981,852,1294958.47,1127297.19,2422255.66
521980,202307,247,171,76,225722.38,100320,326042.38
521990,202307,96,67,29,88441.13,38280,126721.13
522000,202307,296,201,95,264866.54,125400.79,390267.33
522005,202307,19,11,8,14520,10560,25080
522010,202307,1239,691,548,913470.85,723372.05,1636842.90
522015,202307,65,41,24,54120,31680,85800
522020,202307,931,561,370,740533.71,488406.07,1228939.78
522026,202307,28,18,10,23760,13200,36960
522028,202307,25,22,3,29040,3960,33000
522040,202307,902,406,496,535935.23,654727.75,1190662.98
522045,202307,3039,1794,1245,2368166.03,1646050.04,4014216.07
522050,202307,164,71,93,93724.9,122760.72,216485.62
522060,202307,556,351,205,463331.41,270600.35,733931.76
522068,202307,123,89,34,117480.89,44880,162360.89
522070,202307,18,16,2,21120,2640,23760
522100,202307,37,22,15,29040,19800,48840
522108,202307,44,35,9,46201.64,11880,58081.64
522119,202307,67,37,30,48841.48,39600,88441.48
522130,202307,87,34,53,44880.46,69960.89,114841.35
522140,202307,4674,2460,2214,3251262.33,2923824.56,6175086.89
522145,202307,54,38,16,50160.2,21120,71280.2
522150,202307,117,79,38,104280.19,50160.84,154441.03
522155,202307,62,41,21,54120.9,27720,81840.9
522157,202307,18,11,7,14520,9240,23760
522160,202307,1754,1051,703,1387360.21,930608.95,2317969.16
522170,202307,367,251,116,331331.05,153122.31,484453.36
522180,202307,34,14,20,18480,26400,44880
522185,202307,2881,1293,1588,1706824.05,2098848.12,3805672.17
522190,202307,78,46,32,60720.23,42240,102960.23
522200,202307,347,201,146,265322.74,194040.24,459362.98
522205,202307,142,98,44,129363.8,58080.1,187443.9
522220,202307,138,108,30,142560.2,39600,182160.2
522230,202307,32,28,4,38104.41,5280,43384.41
530010,202307,62558,31907,30651,42142538.45,40501023.91,82643562.36
110001,202308,557,456,101,601926.73,135960,737886.73
110002,202308,3275,2122,1153,2802423.1,1525928,4328351.1
110003,202308,85,66,19,87121.83,25080,112201.83
110004,202308,2327,1609,718,2123920.01,949085.49,3073005.50
110005,202308,468,365,103,481805.63,135960.2,617765.83
110006,202308,468,343,125,452764.85,165000,617764.85
110007,202308,81,64,17,84480,22440,106920
110008,202308,299,171,128,225721.47,170280.6,396002.07
110009,202308,1025,803,222,1059967.47,293040,1353007.47
110010,202308,1798,994,804,1313424.21,1061282.01,2374706.22
110011,202308,1794,1385,409,1828250.91,541209.09,2369460.00
110012,202308,4410,2550,1860,3371344.48,2456539.6,5827884.08
110013,202308,799,642,157,847463.92,207242.29,1054706.21
110014,202308,359,318,41,419767.79,54120,473887.79
110015,202308,1439,1092,347,1444097.85,458043.71,1902141.56
110018,202308,1089,691,398,913459.59,525360.55,1438820.14
110020,202308,18171,10187,7984,13456675.52,10545601.01,24002276.53
110025,202308,675,498,177,657364.81,233640.4,891005.21
110026,202308,36,25,11,33000.68,14520,47520.68
110028,202308,1724,1209,515,1595914.71,679806.5,2275721.21
110029,202308,130,119,11,157082.8,15840,172922.8
110030,202308,2607,1680,927,2217428.98,1224965.68,3442394.66
110032,202308,362,280,82,369609.7,108243.33,477853.03
110033,202308,726,517,209,682466.41,275885.74,958352.15
110034,202308,341,262,79,345841.94,104280,450121.94
110037,202308,100,84,16,110881.75,21120,132001.75
110040,202308,447,307,140,405242.5,187440,592682.5
110045,202308,1047,765,282,1012466.89,373562.19,1386029.08
110050,202308,94,84,10,110881.95,13200.03,124081.98
110060,202308,65,46,19,60720.92,25080,85800.92
110070,202308,123,85,38,112201.39,50160,162361.39
110080,202308,600,353,247,465966.27,326040.06,792006.33
110090,202308,24,19,5,25080,6600,31680
110092,202308,132,65,67,85801.11,88440,174241.11
110094,202308,245,174,71,231002.49,93720,324722.49
110100,202308,59,45,14,59401.05,18480.06,77881.11
110110,202308,127,74,53,97682.25,69960,167642.25
110120,202308,80,68,12,89761.48,15840,105601.48
110130,202308,270,222,48,293047.12,63360.1,356407.22
110140,202308,282,200,82,264003.46,108240.1,372243.56
110143,202308,59,48,11,63360,14520,77880
110145,202308,49,37,12,48840,15840,64680
110146,202308,33,14,19,18480.2,25080,43560.2
110147,202308,45,28,17,36960.51,22440.58,59401.09
110148,202308,35,27,8,35640.7,10560,46200.7
110149,202308,322,226,96,298321.29,126720,425041.29
110150,202308,150,121,29,159721.1,38280,198001.1
110155,202308,15,14,1,18480,1320,19800
110160,202308,73,57,16,75241.21,21120,96361.21
110170,202308,227,172,55,227043.76,72600,299643.76
110175,202308,71,57,14,75240,18480,93720
110180,202308,92,72,20,95040.77,26400,121440.77
120001,202308,256,186,70,245529.94,92400.64,337930.58
120005,202308,247,141,106,186124.53,139920,326044.53
120010,202308,1240,757,483,999252.92,637562.17,1636815.09
120013,202308,186,125,61,165002.07,80520.1,245522.17
120017,202308,153,93,60,122761.2,79200.88,201962.08
120020,202308,3594,2901,693,3829407.75,914770.5,4744178.25
120025,202308,620,335,285,442244.12,376216.16,818460.28
120030,202308,1284,1112,172,1469223.32,228368.45,1697591.77
120032,202308,44,39,5,51480,6600,58080
120033,202308,238,206,32,271928.7,43560.55,315489.25
120034,202308,199,150,49,198001.34,64680,262681.34
120035,202308,65,58,7,76560.1,9240,85800.1
120038,202308,439,290,149,382811.71,196681.75,579493.46
120039,202308,38,35,3,46201.8,3960,50161.8
120040,202308,15831,10662,5169,14087189.53,6840547.96,20927737.49
120042,202308,56,52,4,68642.05,5280,73922.05
120043,202308,19,5,14,6600,18480,25080
120045,202308,594,377,217,497660.13,286443.5,784103.63
120050,202308,1384,1053,331,1391342.58,436930.79,1828273.37
120060,202308,1584,1323,261,1748308.51,344526.64,2092835.15
120070,202308,460,340,120,450133.79,158400.42,608534.21
120080,202308,221,149,72,196685.33,95040.55,291725.88
130002,202308,171,124,47,165000.95,62040,227040.95
130006,202308,113,77,36,101640,47520,149160
130008,202308,134,82,52,108240.73,68640,176880.73
130010,202308,179,113,66,149160.2,87120.85,236281.05
130014,202308,328,233,95,307893.08,125401.54,433294.62
130020,202308,160,115,45,151800.9,59400,211200.9
130030,202308,1048,589,459,777486.44,608521.94,1386008.38
130040,202308,430,227,203,299643.42,269280,568923.42
130050,202308,586,310,276,409214.94,364330.71,773545.65
130060,202308,916,621,295,819722.87,390720.7,1210443.57
130063,202308,662,430,232,567600.1,306240,873840.1
130068,202308,244,151,93,199321.69,122761.2,322082.89
130070,202308,1444,962,482,1269868.01,637565.04,1907433.05
130080,202308,743,514,229,678487.54,302281.99,980769.53
130083,202308,94,63,31,83161.23,40920,124081.23
130090,202308,358,222,136,293040.65,179520,472560.65
130100,202308,1447,774,673,1021690.99,888368.57,1910059.56
130110,202308,868,378,490,498963.75,646800.68,1145764.43
130115,202308,162,83,79,109560,104280.7,213840.7
130120,202308,1800,1124,676,1483694.45,893641.6,2377336.05
130130,202308,695,478,217,630960.84,286440.95,917401.79
130140,202308,1604,1250,354,1650010.63,467280.96,2117291.59
130150,202308,458,412,46,543842.01,60720,604562.01
130160,202308,477,303,174,399961.4,229680,629641.4
130165,202308,152,134,18,176880,23760,200640
130170,202308,1335,916,419,1210391.46,553090.76,1763482.22
130180,202308,308,245,63,323402.26,83160.1,406562.36
130185,202308,2398,1209,1189,1595918.43,1570819.85,3166738.28
130190,202308,3566,2247,1319,2967448.29,1742416.28,4709864.57
130195,202308,312,249,63,328680,83160,411840
130200,202308,230,148,82,195361.94,108240,303601.94
130210,202308,95,43,52,56760,68640,125400
130220,202308,224,173,51,229680.57,68640,298320.57
130230,202308,364,249,115,330000,151800,481800
130240,202308,1465,996,469,1314729.9,619082.56,1933812.46
130250,202308,5176,3380,1796,4465664.63,2373392.92,6839057.55
130255,202308,457,239,218,315480.52,287760.87,603241.39
130260,202308,71919,33687,38232,44505432.46,50536045.99,95041478.45
130270,202308,1558,1082,476,1429688.1,628366.3,2058054.4
130280,202308,148,87,61,114840,80520,195360
130290,202308,2149,1370,779,1809760.13,1028285.62,2838045.75
130300,202308,432,291,141,384121.5,186122.19,570243.69
130310,202308,989,560,429,739203.57,567600.5,1306804.07
130320,202308,582,317,265,419760.48,349800,769560.48
130330,202308,800,537,263,708845.26,347160.84,1056006.10
130340,202308,3714,2038,1676,2690249.51,2212347.94,4902597.45
130350,202308,489,353,136,465960,179520,645480
130353,202308,1061,516,545,681135.69,719409.42,1400545.11
130356,202308,914,430,484,567606.08,638883.53,1206489.61
130360,202308,110,87,23,114840.2,30360,145200.2
130370,202308,701,561,140,740521.47,184800,925321.47
130380,202308,685,536,149,707524.75,198000.69,905525.44
130390,202308,504,415,89,547800,117480,665280
130395,202308,175,71,104,93720.38,137280,231000.38
130400,202308,102,79,23,104281.59,30360,134641.59
130406,202308,2345,1355,990,1788617.77,1306803.75,3095421.52
130410,202308,500,284,216,374880,285120,660000
130420,202308,2944,2400,544,3168085.87,718082.72,3886168.59
130423,202308,221,144,77,190081.48,101640,291721.48
130426,202308,194,108,86,142560,113520,256080
130430,202308,458,272,186,359046.29,245520,604566.29
130440,202308,205,73,132,96363.6,174241.16,270604.76
140002,202308,64,21,43,27720.2,56760.6,84480.8
140005,202308,254,146,108,192724.65,142561.4,335286.05
140010,202308,14617,8095,6522,10692486.04,8618449.04,19310935.08
140015,202308,382,80,302,105602.58,398641.82,504244.40
140017,202308,170,93,77,122769.21,101642.82,224412.03
140020,202308,499,336,163,443534.95,215164.61,658699.56
140023,202308,95,55,40,72600,52800.46,125400.46
140028,202308,30,16,14,21120.99,18481.17,39602.16
140030,202308,456,292,164,385454.86,216481.31,601936.17
140040,202308,91,60,31,79200.6,40920,120120.6
140045,202308,462,124,338,163682.1,446162.6,609844.7
140047,202308,697,442,255,583454.06,336602.04,920056.10
140050,202308,168,106,62,139924.45,81841.39,221765.84
140060,202308,108,76,32,100321.87,42240.2,142562.07
140070,202308,26,25,1,33000.2,1320,34320.2
150010,202308,5662,3442,2220,4543563.65,2933069.68,7476633.33
150013,202308,194,129,65,170281.18,85800.99,256082.17
150020,202308,1241,711,530,939857.17,699601.01,1639458.18
150030,202308,763,363,400,479174.43,528003.91,1007178.34
150034,202308,235,134,101,176881.49,133320.5,310201.99
150040,202308,1864,1089,775,1437543.9,1023025.73,2460569.63
150050,202308,832,505,327,666605.8,432961.19,1099566.99
150060,202308,5448,3386,2062,4469528.89,2722421.28,7191950.17
150070,202308,254,197,57,260048.88,75240.59,335289.47
150080,202308,20318,9596,10722,12672558.14,14161275.66,26833833.80
150085,202308,543,329,214,434291.85,282484.12,716775.97
150090,202308,857,682,175,900261.16,231002.49,1131263.65
150095,202308,98,69,29,91081.33,38281,129362.33
150100,202308,89,53,36,69960,47521.25,117481.25
150110,202308,228,144,84,190080.61,110880.1,300960.71
150120,202308,418,301,117,397328.93,154440.85,551769.78
150125,202308,46,21,25,27720,33000,60720
150130,202308,2781,1367,1414,1805826.7,1866720.26,3672546.96
150140,202308,67472,29027,38445,38341016.02,50777488.33,89118504.35
150145,202308,300,164,136,216482.84,179520.22,396003.06
150150,202308,4062,1804,2258,2383981.41,2983243.67,5367225.08
150157,202308,398,285,113,376211.41,149160.84,525372.25
150160,202308,185,138,47,182161.57,62040,244201.57
150170,202308,4576,3295,1281,4349507.26,1692259.09,6041766.35
150172,202308,427,303,124,399965.55,165002.14,564967.69
150175,202308,93,52,41,68641,54120.7,122761.7
150178,202308,862,588,274,776184.68,361685.89,1137870.57
150180,202308,4754,2299,2455,3036062.9,3245889.24,6281952.14
150190,202308,437,299,138,394688.78,182164.03,576852.81
150195,202308,152,88,64,116160.2,84480.61,200640.81
150200,202308,222,123,99,162360.08,130680.2,293040.28
150210,202308,3489,2681,808,3539057.04,1069215.17,4608272.21
150215,202308,801,461,340,609864.45,448810.42,1058674.87
150220,202308,3868,2561,1307,3383259.6,1729232.37,5112491.97
150230,202308,1598,1277,321,1685684.9,423727.3,2109412.2
150240,202308,8375,4668,3707,6163308.51,4894653.21,11057961.72
150250,202308,92,54,38,71281.79,50160.92,121442.71
150260,202308,152,104,48,137284.16,63360.8,200644.96
150270,202308,2309,1508,801,1990599.59,1058644.58,3049244.17
150275,202308,610,402,208,531972.39,274560.96,806533.35
150276,202308,130,49,81,64680.2,106921.08,171601.28
150277,202308,943,416,527,550453.03,696975.72,1247428.75
150280,202308,187,183,4,241571.1,5280,246851.1
150285,202308,178,96,82,126721.06,109348.8,236069.86
150290,202308,1437,833,604,1099586.23,797287.93,1896874.16
150293,202308,958,448,510,592699.43,673210.3,1265909.73
150295,202308,653,324,329,427696.92,434281.95,861978.87
150300,202308,123,69,54,91080.1,71280,162360.1
150304,202308,234,142,92,187444.72,121442.86,308887.58
150307,202308,485,400,85,528011.56,112200.5,640212.06
150309,202308,666,474,192,625711.52,253443.8,879155.32
150310,202308,327,225,102,297004.4,134640,431644.4
150320,202308,2099,1457,642,1924592.05,847447.47,2772039.52
150330,202308,2334,1339,995,1767501.81,1314725.28,3082227.09
150340,202308,220,141,79,186121.9,104280.42,290402.32
150345,202308,721,403,318,531967.85,419760,951727.85
150350,202308,465,374,91,493708.8,120123.98,613832.78
150360,202308,5691,3332,2359,4398341.8,3115233.81,7513575.61
150370,202308,915,611,304,806552.47,401286.61,1207839.08
150375,202308,211,87,124,114841.26,163680.68,278521.94
150380,202308,1659,1111,548,1466551.07,724685.09,2191236.16
150390,202308,1025,610,415,805236,547805.37,1353041.37
150400,202308,136,116,20,153120.4,26400,179520.4
150405,202308,1808,1153,655,1521985.44,865922.83,2387908.27
150410,202308,108,69,39,91080.77,51480.2,142560.97
150420,202308,8747,4744,4003,6269173.28,5289363.25,11558536.53
150430,202308,736,462,274,611203.54,361688.32,972891.86
150440,202308,512,311,201,410534.52,265322.7,675857.22
150442,202308,2733,1466,1267,1935185.38,1673785.96,3608971.34
150445,202308,603,399,204,526686.23,269280.2,795966.43
150450,202308,60,43,17,56761.46,22440.1,79201.56
150460,202308,749,568,181,751110.22,238921.57,990031.79
150470,202308,1378,836,542,1106197.85,715445.12,1821642.97
150475,202308,282,212,70,279849.47,92402.49,372251.96
150480,202308,1621,1153,468,1522028.96,619089.28,2141118.24
150490,202308,632,389,243,513484.7,320760,834244.7
150495,202308,395,302,93,398641.07,122760,521401.07
150497,202308,312,202,110,266643.06,145200.3,411843.36
150500,202308,303,180,123,237602.29,162360,399962.29
150503,202308,1595,812,783,1071868.09,1034893.84,2106761.93
150506,202308,978,681,297,898937.26,392041.12,1290978.38
150510,202308,1491,842,649,1112790.76,856687.18,1969477.94
150520,202308,350,236,114,311520.93,151800.46,463321.39
150530,202308,2277,1343,934,1772891.07,1232941.96,3005833.03
150540,202308,252,180,72,237601.67,95040.25,332641.92
150543,202308,1001,511,490,674539.04,646806.96,1321346.00
150548,202308,485,345,140,455404.8,184800.9,640205.7
150549,202308,99,68,31,89762.35,40920.26,130682.61
150550,202308,3546,1804,1742,2381350.94,2303423.27,4684774.21
150553,202308,4327,2436,1891,3215655.91,2506715.74,5722371.65
150555,202308,153,87,66,114840.2,87121.92,201962.12
150560,202308,98,49,49,64680.75,64680,129360.75
150563,202308,149,80,69,105605.47,91081.65,196687.12
150565,202308,241,144,97,190082.18,128040.29,318122.47
150570,202308,440,291,149,384121.28,196680,580801.28
150580,202308,1926,1004,922,1325291.26,1217041.19,2542332.45
150590,202308,931,628,303,830311.13,401281.58,1231592.71
150600,202308,573,376,197,496333.52,260045.43,756378.95
150610,202308,209,159,50,209883.06,66000,275883.06
150611,202308,170,120,50,158400,66000,224400
150613,202308,3824,2137,1687,2823567.64,2228282.09,5051849.73
150616,202308,652,352,300,464647.08,396003.2,860650.28
150618,202308,1530,789,741,1041489.19,978122.7,2019611.89
150619,202308,451,345,106,455405.43,139924.98,595330.41
150620,202308,1440,830,610,1096949.36,805204.71,1902154.07
150630,202308,203,135,68,178208.91,89761,267969.91
150635,202308,538,253,285,333970.08,376204.33,710174.41
150640,202308,55,27,28,35641.79,36960,72601.79
150650,202308,2686,1545,1141,2042127.76,1506157.08,3548284.84
150655,202308,305,214,91,282480.32,120120,402600.32
150658,202308,64,41,23,54120,31680,85800
150660,202308,717,443,274,584771.81,361684.03,946455.84
150670,202308,1281,482,799,636250.38,1054687.85,1690938.23
150680,202308,12714,6765,5949,8931033.35,7859438.16,16790471.51
150690,202308,47,24,23,31681.1,30360,62041.1
150700,202308,633,424,209,559701.64,275884.62,835586.26
150710,202308,329,194,135,256086.78,178200.61,434287.39
150715,202308,898,573,325,756377.19,430322.06,1186699.25
150720,202308,482,365,117,481811.41,154441.07,636252.48
150730,202308,1324,639,685,843500.29,908168.81,1751669.10
150740,202308,297,191,106,252120.55,139920,392040.55
150745,202308,911,524,387,693022.53,510846.45,1203868.98
150746,202308,82,41,41,54121.21,54120,108241.21
150747,202308,291,201,90,265323.19,118800.3,384123.49
150750,202308,161,91,70,120123.17,92403.91,212527.08
150760,202308,2080,1376,704,1817677.35,930607.59,2748284.94
150770,202308,433,261,172,344520.7,228360.91,572881.61
150775,202308,106,60,46,79200.48,60720.1,139920.58
150780,202308,236,141,95,186121.92,125400,311521.92
150790,202308,773,463,310,611172.6,409203.33,1020375.93
150795,202308,1939,1192,747,1573467.96,987370.25,2560838.21
150796,202308,336,190,146,250802.3,192720.62,443522.92
150797,202308,472,229,243,302288.84,320761.22,623050.06
150800,202308,1820,1009,811,1331899.3,1070522.81,2402422.11
150803,202308,384,292,92,386771.16,121440.32,508211.48
150805,202308,237,144,93,190082.26,122760,312842.26
150808,202308,1219,594,625,784084.38,825003.7,1609088.08
150810,202308,3475,2346,1129,3098131.83,1490288.02,4588419.85
150812,202308,587,311,276,411847.49,364365.97,776213.46
150815,202308,1408,877,531,1157652.99,700922.55,1858575.54
150820,202308,1927,1157,770,1527297.08,1016418.37,2543715.45
150830,202308,625,473,152,625697.02,200641.1,826338.12
150835,202308,271,172,99,227043.01,130680,357723.01
150840,202308,1601,922,679,1217075.89,900250.26,2117326.15
160005,202308,75,49,26,64680.84,34320.12,99000.96
160010,202308,236,146,90,192725.36,118800.47,311525.83
160015,202308,185,124,61,163691.05,80521.51,244212.56
160020,202308,165,84,81,110881.11,106920,217801.11
160021,202308,69,36,33,47521.85,43560.81,91082.66
160023,202308,82,55,27,72602.45,35640.14,108242.59
160025,202308,32,15,17,19801.06,22440.12,42241.18
160027,202308,1627,909,718,1199938.83,949086.83,2149025.66
160030,202308,19667,10370,9297,13691608.01,12280161.47,25971769.48
160040,202308,407,261,146,344530.37,192721.63,537252.00
160050,202308,891,386,505,509535.21,666611.33,1176146.54
160053,202308,336,204,132,269291.99,174243.1,443535.09
160055,202308,30,22,8,29041.27,10560.8,39602.07
160060,202308,7583,4243,3340,5602345.67,4411533.5,10013879.17
160070,202308,202,119,83,157084.37,109560.97,266645.34
160080,202308,163,87,76,114840.06,100320,215160.06
170025,202308,26,16,10,21120,13200.2,34320.2
170030,202308,174,141,33,186125.97,43560,229685.97
170035,202308,210,105,105,138604.69,138601.86,277206.55
170040,202308,187,139,48,183480,63360,246840
170070,202308,340,220,120,290408.01,158400.54,448808.55
170100,202308,369,266,103,351130.87,135960.2,487091.07
170105,202308,40,34,6,44880.31,7920,52800.31
170110,202308,113,71,42,93720.49,56760.1,150480.59
170130,202308,91,47,44,62040,58080,120120
170190,202308,105,61,44,80520,58080,138600
170200,202308,366,250,116,330002.99,154440,484442.99
170210,202308,7405,4159,3246,5493676.23,4287402.42,9781078.65
170215,202308,166,103,63,135964.69,83161.12,219125.81
170220,202308,1394,997,397,1316067.06,524044.31,1840111.37
170230,202308,164,114,50,150484.27,66000.3,216484.57
170240,202308,510,356,154,469942.79,204602.72,674545.51
170255,202308,1056,820,236,1082419.94,312842.1,1395262.04
170270,202308,55,39,16,51480,21120,72600
170290,202308,158,100,58,132003.3,76560,208563.3
170300,202308,120,81,39,106920.41,51480,158400.41
170305,202308,61,45,16,59400.8,21120,80520.8
170307,202308,59,43,16,56761.26,21120.9,77882.16
170310,202308,130,87,43,114841.95,56760,171601.95
170320,202308,46,30,16,39600.2,21120,60720.2
170330,202308,38,28,10,36961.48,13200.1,50161.58
170360,202308,38,24,14,31680.2,18480.95,50161.15
170370,202308,84,51,33,67321.29,43560.2,110881.49
170380,202308,92,69,23,91081.34,30360,121441.34
170382,202308,40,33,7,43560,9240,52800
170384,202308,157,120,37,158400.22,48840.71,207240.93
170386,202308,75,34,41,44880.61,54120,99000.61
170388,202308,47,23,24,30360.11,31680,62040.11
170389,202308,28,21,7,27720.4,9240,36960.4
170390,202308,90,51,39,67320.87,51480.14,118801.01
170410,202308,26,23,3,30362.04,3960,34322.04
170460,202308,13,8,5,10560.09,6600,17160.09
170510,202308,34,25,9,33002.21,11880,44882.21
170550,202308,1718,1022,696,1349070.58,918729.03,2267799.61
170555,202308,123,90,33,118804.69,43560,162364.69
170560,202308,104,78,26,102960.82,34320.33,137281.15
170600,202308,43,17,26,22441.36,34320.7,56762.06
170610,202308,201,114,87,150483.92,114840.1,265324.02
170625,202308,37,23,14,30360.99,18480,48840.99
170650,202308,108,76,32,100320.46,42240.2,142560.66
170700,202308,624,461,163,608526.72,215160,823686.72
170710,202308,142,85,57,112203.54,75242.75,187446.29
170720,202308,124,96,28,126720.81,36960,163680.81
170730,202308,126,75,51,99001.76,67320,166321.76
170740,202308,92,69,23,91080,30360,121440
170755,202308,52,31,21,40920.87,27720.76,68641.63
170765,202308,140,85,55,112203.93,72600.76,184804.69
170770,202308,200,131,69,172922.11,91080.73,264002.84
170820,202308,629,422,207,558370.46,274560.32,832930.78
170825,202308,59,32,27,42240.3,35640,77880.3
170830,202308,101,78,23,102960.97,30360.33,133321.30
170900,202308,181,140,41,184803.18,54121.2,238924.38
170930,202308,1098,617,481,814468.9,637566.09,1452034.99
170950,202308,3594,1776,1818,2345700.33,2402419.67,4748120.00
170980,202308,15,10,5,13201.72,6600,19801.72
171050,202308,163,125,38,165000,50160.2,215160.2
171070,202308,63,49,14,64680.99,18480.95,83161.94
171090,202308,54,42,12,55440,15840,71280
171110,202308,27,21,6,27721.2,7920,35641.2
171150,202308,49,34,15,44880,19800,64680
171180,202308,29,15,14,19800,18481.12,38281.12
171190,202308,212,121,91,159723.57,120120,279843.57
171195,202308,62,53,9,69960.99,11880,81840.99
171200,202308,30,14,16,18480.51,21120,39600.51
171215,202308,13,10,3,13200,3960,17160
171240,202308,64,51,13,67320,17160,84480
171245,202308,57,48,9,63361.96,11880,75241.96
171250,202308,88,53,35,69960.2,46200,116160.2
171270,202308,15,10,5,13200,6600.22,19800.22
171280,202308,51,41,10,54122.18,13200.1,67322.28
171320,202308,1147,682,465,901572.82,616441.57,1518014.39
171330,202308,475,251,224,331322.3,295680.21,627002.51
171360,202308,115,84,31,110880.43,40920,151800.43
171370,202308,41,25,16,33000,21120.18,54120.18
171380,202308,140,120,20,158401.42,26400,184801.42
171395,202308,45,27,18,35640,23760,59400
171420,202308,275,181,94,238920.73,125400.2,364320.93
171430,202308,76,61,15,80520.2,19800.95,100321.15
171488,202308,234,138,96,182160.7,126720,308880.7
171500,202308,70,42,28,55440.2,36960,92400.2
171510,202308,79,54,25,71280,33000.52,104280.52
171515,202308,43,36,7,47522.81,9240,56762.81
171525,202308,27,24,3,31682.16,3960,35642.16
171550,202308,17,11,6,14520.9,7920,22440.9
171570,202308,63,34,29,44880,38280.1,83160.1
171575,202308,266,180,86,237601.05,113520,351121.05
171610,202308,2179,1143,1036,1510107.75,1371504.39,2881612.14
171620,202308,168,123,45,162360.9,59400.61,221761.51
171630,202308,52,30,22,39600,29040,68640
171650,202308,372,263,109,347171.47,143881.62,491053.09
171660,202308,276,161,115,212527.62,153120.7,365648.32
171665,202308,95,59,36,77881.39,47520.33,125401.72
171670,202308,475,308,167,406567.2,220442.79,627009.99
171700,202308,64,54,10,71281.61,13200,84481.61
171720,202308,28,10,18,13200.7,23760.2,36960.9
171750,202308,110,57,53,76560,69960.7,146520.7
171780,202308,81,63,18,83160.61,23760,106920.61
171790,202308,107,86,21,113520,27720,141240
171800,202308,34,26,8,34320,10560,44880
171820,202308,2292,1346,946,1778087.07,1248726.07,3026813.14
171830,202308,36,28,8,36960.2,10560,47520.2
171840,202308,56,36,20,47520.43,26400,73920.43
171845,202308,35,25,10,33000.78,13200,46200.78
171850,202308,55,43,12,56760.44,15840.49,72600.93
171855,202308,70,51,19,67320.1,25080,92400.1
171865,202308,5,3,2,3960,2640,6600
171870,202308,38,26,12,34320.2,15840.45,50160.65
171875,202308,93,70,23,92400,30360,122760
171880,202308,47,29,18,38280,23760.17,62040.17
171884,202308,60,33,27,43560.43,35640,79200.43
171886,202308,139,67,72,88441.07,95040,183481.07
171888,202308,28,21,7,27721.45,9240.1,36961.55
171889,202308,18,10,8,13200,10560,23760
171890,202308,69,56,13,73920.11,17160,91080.11
171900,202308,26,18,8,23760.2,10560,34320.2
172000,202308,37,33,4,43560.2,5280.2,48840.4
172010,202308,61,43,18,56760,23760.72,80520.72
172015,202308,20,15,5,19801.66,6600,26401.66
172020,202308,128,80,48,105601.14,64680,170281.14
172025,202308,43,27,16,35640.46,21120,56760.46
172030,202308,63,39,24,51481.12,31680,83161.12
172049,202308,89,59,30,77880.22,39600.64,117480.86
172065,202308,119,79,40,104282.31,52800.46,157082.77
172080,202308,135,82,53,108242.21,71281.05,179523.26
172085,202308,31,16,15,21120,19800,40920
172090,202308,493,354,139,467288.47,183480.94,650769.41
172093,202308,17,15,2,19800,2640,22440
172097,202308,16,8,8,10560,11880,22440
172100,202308,6884,4094,2790,5410120.2,3689446.97,9099567.17
172110,202308,84,59,25,77881.01,33000,110881.01
172120,202308,1840,1518,322,2003835.43,425044.79,2428880.22
172125,202308,18,13,5,17160,6600,23760
172130,202308,34,21,13,27720.59,17160.28,44880.87
172208,202308,214,141,73,186120,96361.38,282481.38
172210,202308,368,188,180,248166.48,237601.19,485767.67
210005,202308,3268,2099,1169,2772121.25,1544426.42,4316547.67
210010,202308,149,103,46,135961.47,60720,196681.47
210015,202308,47,34,13,44881.06,17160,62041.06
210020,202308,408,248,160,327368.61,211202.56,538571.17
210030,202308,325,221,104,291744.05,137284.53,429028.58
210040,202308,120,99,21,130680.1,27720,158400.1
210043,202308,281,234,47,308884.51,62040,370924.51
210047,202308,502,328,174,432962.12,229680,662642.12
210050,202308,280,194,86,256080,113520.2,369600.2
210055,202308,60,50,10,66000.62,13200,79200.62
210060,202308,558,456,102,601951.17,134642.68,736593.85
210070,202308,501,386,115,509520.7,151800.32,661321.02
210080,202308,149,139,10,183481.61,13200,196681.61
210083,202308,298,158,140,208560.92,184800.19,393361.11
210087,202308,11,6,5,7920,6600,14520
210090,202308,514,373,141,492384.02,186122.13,678506.15
210095,202308,428,345,83,455409.39,109561.22,564970.61
210100,202308,723,580,143,765613.35,188760.2,954373.55
210110,202308,121,84,37,110880.8,48840.9,159721.7
210120,202308,4882,3965,917,5234039.82,1210457.7,6444497.52
210125,202308,196,125,71,165003.17,93720.58,258723.75
210130,202308,463,292,171,385451.22,225720.89,611172.11
210135,202308,34,25,9,33001.68,11880,44881.68
210140,202308,4812,3656,1156,4826062.84,1527258.51,6353321.35
210150,202308,392,259,133,341892.02,175562.68,517454.70
210160,202308,3322,2833,489,3739652.21,646806.52,4386458.73
210170,202308,1335,1084,251,1430934.45,331320.79,1762255.24
210173,202308,130,120,10,158401.48,13200,171601.48
210177,202308,292,169,123,223081.72,162360,385441.72
210180,202308,33,18,15,23760.2,19800,43560.2
210190,202308,470,324,146,427680.81,192720.7,620401.51
210193,202308,8,6,2,7920.59,2640,10560.59
210197,202308,68,50,18,66000.3,23760.2,89760.5
210200,202308,635,544,91,718106.78,120120.39,838227.17
210203,202308,245,180,65,237603.48,85801.12,323404.60
210207,202308,323,278,45,366963.96,59400,426363.96
210210,202308,735,686,49,905532.36,64680.6,970212.96
210215,202308,81,73,8,96362.52,10560,106922.52
210220,202308,359,311,48,410536.77,63360.71,473897.48
210230,202308,344,280,64,369605.74,84480,454085.74
210232,202308,1237,910,327,1201229.51,432961.86,1634191.37
210235,202308,188,143,45,188763.52,59400.4,248163.92
210237,202308,61,31,30,40922.16,39600,80522.16
210240,202308,82,72,10,95040.7,13200.21,108240.91
210250,202308,196,171,25,225720.68,33000.2,258720.88
210255,202308,416,307,109,405256.15,143881.08,549137.23
210260,202308,403,293,110,386762.68,145200,531962.68
210270,202308,642,470,172,620411.71,227041.66,847453.37
210275,202308,115,92,23,121440.75,30360,151800.75
210280,202308,1131,753,378,995296.04,498962.83,1494258.87
210290,202308,554,376,178,496330.8,234961.39,731292.19
210300,202308,5014,3309,1705,4367970.24,2251925.91,6619896.15
210310,202308,129,85,44,112200.2,58080,170280.2
210312,202308,121,91,30,120121.71,39600,159721.71
210315,202308,130,112,18,147840.08,23760,171600.08
210317,202308,152,119,33,157080.45,43560,200640.45
210320,202308,2538,2195,343,2897483.29,454081.04,3351564.33
210325,202308,158,92,66,121440.81,87120.68,208561.49
210330,202308,4218,2545,1673,3360787.92,2208363.35,5569151.27
210340,202308,1232,959,273,1265930.67,361683.66,1627614.33
210350,202308,709,597,112,788056.65,147840.7,935897.35
210355,202308,157,134,23,176880.2,30360,207240.2
210360,202308,2054,1517,537,2002489.87,711483.12,2713972.99
210370,202308,1269,685,584,904218.17,770885.14,1675103.31
210375,202308,196,97,99,128049.09,130681.56,258730.65
210380,202308,750,594,156,784089.33,205920.97,990010.30
210390,202308,200,167,33,220443.36,43560,264003.36
210400,202308,433,384,49,506893.88,64680,571573.88
210405,202308,1178,834,344,1100907.83,454081.64,1554989.47
210407,202308,75,63,12,83160,15840,99000
210408,202308,50,46,4,60722,5280,66002
210409,202308,358,314,44,414483.74,58080.97,472564.71
210410,202308,464,374,90,493681.95,118800,612481.95
210420,202308,213,173,40,228362.51,52800.32,281162.83
210430,202308,61,45,16,59400.5,22440,81840.5
210440,202308,375,258,117,340570.07,155760,496330.07
210450,202308,112,99,13,130682.37,17160,147842.37
210455,202308,257,138,119,182165.68,157082.47,339248.15
210460,202308,324,223,101,294368.36,133320.25,427688.61
210462,202308,79,64,15,84481.64,19800.44,104282.08
210465,202308,127,103,24,135960.91,31680,167640.91
210467,202308,590,449,141,592693.5,186120.5,778814.0
210470,202308,42,37,5,48840,6600,55440
210480,202308,1412,1039,373,1372840.95,492364.77,1865205.72
210490,202308,180,128,52,168962.43,68640.2,237602.63
210500,202308,518,346,172,456739.17,227041.92,683781.09
210510,202308,537,439,98,579482.42,129361.91,708844.33
210515,202308,330,225,105,298323.66,138600.2,436923.86
210520,202308,400,365,35,481808.73,46200.2,528008.93
210530,202308,10278,5227,5051,6901285.03,6670138.01,13571423.04
210535,202308,125,99,26,130681.98,34320,165001.98
210540,202308,1624,1127,497,1489010.29,656044.83,2145055.12
210542,202308,1093,571,522,753740.11,689051.5,1442791.61
210545,202308,24,21,3,27720.71,3960,31680.71
210547,202308,128,114,14,150482.85,18480.31,168963.16
210550,202308,615,440,175,580826.08,231001.71,811827.79
210560,202308,166,146,20,192722.05,26400.33,219122.38
210565,202308,30,21,9,27721.8,11880.25,39602.05
210570,202308,1322,1129,193,1490315.82,254761.34,1745077.16
210580,202308,131,116,15,153120.78,19800.16,172920.94
210590,202308,676,573,103,756362.89,135960,892322.89
210592,202308,51,45,6,59400,7920,67320
210594,202308,118,103,15,135961.1,19800,155761.1
210596,202308,120,107,13,141241.41,17160,158401.41
210598,202308,140,108,32,142560.9,42240.2,184801.1
210600,202308,304,264,40,348489.99,52800.7,401290.69
210610,202308,260,242,18,319445.32,23760.17,343205.49
210620,202308,45,31,14,40920.63,18480,59400.63
210630,202308,91,85,6,112201.4,7920,120121.4
210632,202308,996,720,276,950404.26,364320,1314724.26
210635,202308,28,24,4,31680.9,5280.2,36961.1
210637,202308,116,85,31,112200.2,40920,153120.2
210640,202308,576,519,57,685083.88,76560,761643.88
210650,202308,418,356,62,469929.41,81840.7,551770.11
210660,202308,388,310,78,409221.97,102962.01,512183.98
210663,202308,89,72,17,95040.43,22440,117480.43
210667,202308,90,50,40,66001.52,52800.67,118802.19
210670,202308,268,238,30,314164.87,39600,353764.87
210675,202308,492,299,193,394691.21,254762.23,649453.44
210680,202308,237,157,80,207243.17,105600,312843.17
210690,202308,115,100,15,132000.96,19800,151800.96
210700,202308,153,116,37,153120.4,48840.2,201960.6
210710,202308,272,170,102,224401.23,134640.8,359042.03
210720,202308,134,121,13,159720.08,17160,176880.08
210725,202308,69,58,11,76565.32,14520,91085.32
210730,202308,22,15,7,19800,9240,29040
210735,202308,294,217,77,286440.96,101640,388080.96
210740,202308,518,454,64,600625.52,84480,685105.52
210745,202308,170,134,36,176880.44,47520,224400.44
210750,202308,2922,1628,1294,2149017.14,1709416.73,3858433.87
210760,202308,263,208,55,274562.16,72600.19,347162.35
210770,202308,250,208,42,274577.69,55442.24,330019.93
210780,202308,420,320,100,422413.75,132001.29,554415.04
210790,202308,206,176,30,232324.37,39600,271924.37
210800,202308,188,146,42,192731.84,55440.55,248172.39
210805,202308,71,63,8,83160,10560,93720
210810,202308,438,366,72,483138.9,95040,578178.9
210820,202308,1987,1693,294,2234834.55,388083.04,2622917.59
210825,202308,156,99,57,130681.44,75240.2,205921.64
210830,202308,710,509,201,671888.24,265321.86,937210.10
210840,202308,206,156,50,205920.4,66000,271920.4
210845,202308,233,182,51,240243.1,67320,307563.1
210850,202308,718,528,190,696985.98,250802.74,947788.72
210860,202308,3505,2183,1322,2881614.72,1745047.5,4626662.22
210870,202308,399,318,81,419776.63,106920.2,526696.83
210880,202308,92,76,16,100322.76,21120,121442.76
210890,202308,322,285,37,376213.79,48840,425053.79
210900,202308,733,473,260,624378.33,343203.65,967581.98
210905,202308,74,41,33,54120.2,43560,97680.2
210910,202308,2136,1616,520,2133178.94,686409.11,2819588.05
210920,202308,142,68,74,89761.73,97680,187441.73
210923,202308,78,63,15,83161.43,19800,102961.43
210927,202308,420,226,194,298320.78,256080.2,554400.98
210930,202308,91,80,11,105600.4,14520,120120.4
210940,202308,81,65,16,85801.79,21120,106921.79
210945,202308,216,130,86,171602.6,113520,285122.6
210950,202308,522,389,133,513484.99,175560.65,689045.64
210955,202308,105,64,41,84481.18,54120.9,138602.08
210960,202308,2541,1334,1207,1760895.15,1593244.04,3354139.19
210970,202308,109,92,17,121440.75,22440.9,143881.65
210975,202308,75,72,3,95040.69,3960.36,99001.05
210980,202308,1061,554,507,731300.68,669242.67,1400543.35
210990,202308,4559,3279,1280,4328398.69,1689620.76,6018019.45
211000,202308,1341,1107,234,1461283.38,308882.48,1770165.86
211003,202308,967,729,238,962294.91,314160.56,1276455.47
211010,202308,501,451,50,595327.5,66000.25,661327.75
211020,202308,1373,663,710,875181.78,937217.64,1812399.42
211023,202308,42,36,6,47521.2,7920,55441.2
211027,202308,87,67,20,88440.65,26400,114840.65
211030,202308,371,269,102,355082.01,134640.5,489722.51
211040,202308,306,262,44,345842.02,58080,403922.02
211050,202308,1183,834,349,1100910.86,460682.19,1561593.05
211060,202308,642,570,72,752431.17,95040.4,847471.57
211065,202308,28,23,5,30363.21,6600.8,36964.01
211070,202308,844,714,130,942523.02,171601.57,1114124.59
211080,202308,90,88,2,116160.93,2640,118800.93
211085,202308,66,36,30,47520,39600,87120
211090,202308,95,84,11,110883.83,14520,125403.83
211100,202308,473,404,69,533293.42,91080.2,624373.62
211102,202308,231,172,59,227040.4,77880,304920.4
211105,202308,225,166,59,219120.91,79200.26,298321.17
211107,202308,127,82,45,108240,59400,167640
211110,202308,1010,693,317,914786.34,419764.29,1334550.63
211120,202308,5458,3040,2418,4013003.08,3191801.3,7204804.38
211125,202308,25,18,7,23760,9240,33000
211130,202308,43690,21778,21912,28749498.67,28940068.17,57689566.84
211140,202308,364,327,37,431656.97,48840.47,480497.44
211150,202308,1245,906,339,1195960.71,447483.7,1643444.41
211153,202308,175,107,68,141240,89760.2,231000.2
211157,202308,70,58,12,76560,15840,92400
211160,202308,704,590,114,778809.88,150480.9,929290.78
211163,202308,3,2,1,2640,1320,3960
211167,202308,10,10,0,13200,,13200.0
211170,202308,423,323,100,426363.06,132001.35,558364.41
211172,202308,97,73,24,96360.99,31680,128040.99
211174,202308,30,17,13,22440,17160.14,39600.14
211176,202308,466,343,123,452766.45,162362.25,615128.70
211178,202308,98,68,30,89761.82,39600,129361.82
211180,202308,213,175,38,231001.91,50160,281161.91
211190,202308,74,66,8,87120.2,10560,97680.2
211195,202308,47,35,12,46204.45,15840,62044.45
211200,202308,148,122,26,161041.12,34320,195361.12
211210,202308,402,306,96,403929.42,126720.26,530649.68
211220,202308,4622,2811,1811,3710713.56,2393375.1,6104088.66
211223,202308,143,131,12,172923.87,15840,188763.87
211227,202308,63,47,16,62040.2,21120,83160.2
211230,202308,735,610,125,805235.27,165002.47,970237.74
211240,202308,384,324,60,427683.42,79200,506883.42
211245,202308,187,104,83,137282.74,110880.4,248163.14
211250,202308,1488,1282,206,1692319.1,271923.5,1964242.6
211260,202308,822,708,114,934568.09,150480,1085048.09
211270,202308,1855,1560,295,2059243.63,389401.63,2448645.26
211280,202308,1839,1305,534,1722630.1,704880.75,2427510.85
211285,202308,234,153,81,201960.83,106920,308880.83
211290,202308,832,603,229,795968.33,302280.34,1098248.67
211300,202308,784,642,142,847461.4,187441.16,1034902.56
211400,202308,1587,1063,524,1403196.1,691681.94,2094878.04
220005,202308,22,20,2,26400,2640,29040
220010,202308,82,69,13,91080.19,17160,108240.19
220020,202308,779,638,141,842170.98,186121.29,1028292.27
220025,202308,111,106,5,139921.04,6600,146521.04
220027,202308,62,49,13,64680.2,17160,81840.2
220030,202308,143,117,26,154440.89,34320,188760.89
220040,202308,1373,1064,309,1404506.57,407882.94,1812389.51
220045,202308,31,23,8,30362.3,10560.4,40922.7
220050,202308,688,581,107,766861.12,141240.94,908102.06
220060,202308,194,170,24,224406.26,31680.35,256086.61
220070,202308,115,101,14,133322.74,18480.7,151803.44
220080,202308,16,14,2,18480.22,2640,21120.22
220090,202308,45,32,13,42240.65,17160,59400.65
220095,202308,3,2,1,2640,1320,3960
220100,202308,24,20,4,26400.71,5280,31680.71
220105,202308,34,30,4,39600.95,5280,44880.95
220110,202308,271,247,24,326041.54,31680,357721.54
220115,202308,53,45,8,59400,10560,69960
220117,202308,25,23,2,30360,2640,33000
220120,202308,1583,1248,335,1648708.97,442200.2,2090909.17
220130,202308,30,29,1,38280.25,1320,39600.25
220140,202308,92,78,14,102961.1,18480.96,121442.06
220150,202308,511,387,124,510864.32,163683.67,674547.99
220155,202308,29,28,1,36960.2,1320,38280.2
220157,202308,25,22,3,29041.49,3960,33001.49
220160,202308,113,101,12,133321.59,15840,149161.59
220170,202308,53,42,11,55440,14520,69960
220173,202308,21,18,3,23760,3960,27720
220177,202308,22,22,0,29040.4,,29040.4
220180,202308,66,63,3,83161.3,3960,87121.3
220190,202308,1248,1074,174,1417706.76,231004.57,1648711.33
220191,202308,41,37,4,48841.11,5280,54121.11
220192,202308,94,87,7,114842.41,9240,124082.41
220194,202308,59,53,6,69960.87,7920,77880.87
220196,202308,84,70,14,92404.03,18480.2,110884.23
220198,202308,2,2,0,2640,,2640.0
220200,202308,417,360,57,475225.71,75241.03,550466.74
220202,202308,36,32,4,42241.17,5280,47521.17
220205,202308,68,60,8,79200.2,10560,89760.2
220207,202308,16,16,0,21120.8,,21120.8
220208,202308,74,48,26,63360.27,34320.2,97680.47
220209,202308,36,31,5,40920,6600,47520
220210,202308,33,28,5,36960,6600,43560
220211,202308,38,37,1,48844.25,1320,50164.25
220213,202308,37,34,3,44881,3960,48841
220217,202308,44,35,9,46200.3,11880,58080.3
220220,202308,2516,1693,823,2237439.67,1090330.97,3327770.64
220225,202308,12,7,5,9240.58,6600,15840.58
220230,202308,1044,787,257,1038860.03,339246.29,1378106.32
220240,202308,170,151,19,199321.35,25080.42,224401.77
220245,202308,57,53,4,69961.41,5280,75241.41
220250,202308,158,133,25,175563.22,33000,208563.22
220253,202308,53,47,6,62040.25,7920,69960.25
220255,202308,54,47,7,62040.2,9240,71280.2
220260,202308,737,566,171,747135.17,225721.52,972856.69
220265,202308,19,16,3,21120,3960,25080
220270,202308,909,818,91,1079773.98,120120,1199893.98
220271,202308,42,33,9,43561.7,11880,55441.7
220272,202308,22,22,0,29040.7,,29040.7
220273,202308,17,16,1,21120.4,1320,22440.4
220275,202308,68,59,9,77880,11880,89760
220277,202308,37,28,9,36960.81,11880.56,48841.37
220280,202308,23,17,6,22440,7920,30360
220285,202308,50,46,4,60721.05,5280,66001.05
220290,202308,1608,1379,229,1821573.96,302283.08,2123857.04
220300,202308,47,45,2,59402.22,2640,62042.22
220310,202308,366,309,57,407894.69,75242.45,483137.14
220320,202308,485,443,42,584785.06,55441.68,640226.74
220323,202308,2,1,1,1320.8,1320,2640.8
220325,202308,11,10,1,13200,1320,14520
220327,202308,18,18,0,23761.14,,23761.14
220330,202308,222,160,62,211200.56,81840,293040.56
220335,202308,139,120,19,158401.95,25080,183481.95
220340,202308,57,45,12,59400,15840,75240
220342,202308,55,48,7,63363.87,9240,72603.87
220345,202308,93,83,10,109560.29,13200.03,122760.32
220350,202308,483,422,61,557044.26,80520.05,637564.31
220360,202308,52,35,17,46200,22440,68640
220370,202308,1444,1208,236,1594593.72,311520.4,1906114.12
220375,202308,23,22,1,29041.79,1320,30361.79
220380,202308,26,20,6,26401.4,7920,34321.4
220385,202308,17,15,2,19800,2640.66,22440.66
220390,202308,2575,1427,1148,1883704.68,1515385.81,3399090.49
220400,202308,36,31,5,40920,6600,47520
220410,202308,24,23,1,30360.2,1320,31680.2
220415,202308,13,12,1,15841.16,1320,17161.16
220420,202308,135,114,21,150480.78,27720,178200.78
220430,202308,162,141,21,186125.54,27720.2,213845.74
220435,202308,29,22,7,29040.72,9240,38280.72
220440,202308,307,263,44,347174.85,58080,405254.85
220450,202308,374,192,182,253447.45,240246.8,493694.25
220455,202308,56,54,2,71280.5,2640,73920.5
220460,202308,22,21,1,27721.53,1320.13,29041.66
220465,202308,70,50,20,66001.79,26400.41,92402.20
220470,202308,250,220,30,290406.98,39600.86,330007.84
220480,202308,66,61,5,80520.52,6600,87120.52
220490,202308,89,76,13,100320,17160,117480
220500,202308,132,111,21,146520.68,27720,174240.68
220510,202308,375,294,81,388091.24,106920.88,495012.12
220515,202308,30,27,3,35641.66,3960,39601.66
220520,202308,397,349,48,460690.94,63361.06,524052.00
220525,202308,12,7,5,9240.62,6600.92,15841.54
220527,202308,14,14,0,18480.38,,18480.38
220530,202308,50,23,27,30360,35640.87,66000.87
220535,202308,4,4,0,5280.74,,5280.74
220540,202308,119,105,14,138601.85,18480.2,157082.05
220545,202308,25,18,7,23761,9240.8,33001.8
220550,202308,801,636,165,839548.01,217802.35,1057350.36
220551,202308,15,12,3,15840,3960,19800
220552,202308,18,17,1,22440,1320,23760
220553,202308,69,64,5,84480.85,6600,91080.85
220554,202308,5,3,2,3960.88,2640,6600.88
220555,202308,52,40,12,52801.83,15840,68641.83
220556,202308,40,37,3,48841.04,3960,52801.04
220557,202308,67,62,5,81841.98,6600.74,88442.72
220558,202308,16,8,8,10560,10560.54,21120.54
220559,202308,8,8,0,10560.07,,10560.07
220560,202308,89,58,31,76561.44,40920,117481.44
220570,202308,753,478,275,630970.95,363003,993973.95
220580,202308,574,529,45,700957.72,59401.8,760359.52
220585,202308,14,11,3,14520.2,3960.14,18480.34
220590,202308,20,18,2,23761.86,2640,26401.86
220595,202308,78,61,17,80520.33,22440,102960.33
220600,202308,23,17,6,22440,7920,30360
220605,202308,36,32,4,42240.2,5280,47520.2
220610,202308,102,86,16,113520,21120,134640
220620,202308,584,506,78,667934.1,102962.05,770896.15
220630,202308,3,2,1,2640,1320,3960
220635,202308,33,30,3,39602.23,3960,43562.23
220640,202308,115,97,18,128040,23760,151800
220650,202308,120,114,6,150480.8,7920,158400.8
220660,202308,94,69,25,91081.85,33000.6,124082.45
220665,202308,16,16,0,21120,,21120.0
220667,202308,30,28,2,36960.18,2640,39600.18
220669,202308,48,42,6,55440.2,7920,63360.2
220670,202308,80,62,18,81840.9,23760,105600.9
220672,202308,83,60,23,79205.57,30361.21,109566.78
220675,202308,30,24,6,31682.23,7920,39602.23
220680,202308,67,58,9,76560.2,11880,88440.2
220690,202308,51,48,3,63360.51,3960,67320.51
220695,202308,30,18,12,23761.06,15840,39601.06
220700,202308,1979,1543,436,2036786.65,575524.87,2612311.52
220710,202308,12,10,2,13200.2,2640.93,15841.13
220720,202308,115,101,14,133320,18480,151800
220730,202308,35,34,1,44880.01,1320,46200.01
220735,202308,12,10,2,13200,2640,15840
220740,202308,66,57,9,75241.19,11880.91,87122.10
220750,202308,147,122,25,161042.81,33000.18,194042.99
220755,202308,24,23,1,30362.11,1320,31682.11
220760,202308,75,65,10,85801.89,13200,99001.89
220770,202308,6479,3785,2694,4997761.06,3558798.75,8556559.81
220775,202308,16,12,4,15840.7,5280.39,21121.09
220777,202308,26,25,1,33000,1320,34320
220779,202308,7,2,5,2640,6600,9240
220780,202308,990,839,151,1107492.17,199320.69,1306812.86
220785,202308,7,4,3,5280,3960.2,9240.2
220790,202308,1314,1062,252,1401872.65,333967.48,1735840.13
220793,202308,10,7,3,9240,3960,13200
220795,202308,29,27,2,35640.11,2640,38280.11
220800,202308,4259,3248,1011,4290330.93,1334532.64,5624863.57
220810,202308,85,72,13,95041.07,17160,112201.07
220820,202308,264,238,26,314167.59,34321.8,348489.39
220830,202308,1395,1241,154,1639257.91,205921.22,1845179.13
220840,202308,2726,1935,791,2556917.89,1045459.9,3602377.79
220850,202308,86,73,13,96360,17160,113520
220855,202308,9,4,5,5280,6600,11880
220860,202308,17,14,3,18481.83,3960,22441.83
220865,202308,30,27,3,35640.1,3960,39600.1
220870,202308,99,90,9,118801.7,11880,130681.7
220880,202308,356,294,62,388091.29,81841.92,469933.21
220885,202308,30,28,2,36962.67,2640,39602.67
220887,202308,6,5,1,6600.2,1320,7920.2
220890,202308,87,74,13,97681.64,17160,114841.64
220900,202308,29,18,11,23760,14520,38280
220910,202308,52,39,13,51481.95,17160,68641.95
220915,202308,12,10,2,13200,2640,15840
220920,202308,48,43,5,56761.21,6600,63361.21
220930,202308,60,58,2,76560.93,2640,79200.93
220935,202308,19,19,0,25080.97,,25080.97
220937,202308,34,30,4,39600.59,5280,44880.59
220940,202308,68,61,7,80520.2,9240,89760.2
220945,202308,6,6,0,7920.1,,7920.1
220950,202308,39,31,8,40920.2,10560,51480.2
220955,202308,25,23,2,31680.59,2640,34320.59
220960,202308,46,41,5,54120,6600,60720
220965,202308,58,53,5,69960,6600,76560
220970,202308,65,55,10,72600,13200,85800
220975,202308,16,13,3,17160.9,3960,21120.9
220980,202308,28,26,2,34320.76,2640,36960.76
220985,202308,58,49,9,64680,11880,76560
220987,202308,36,35,1,46202.93,1320.28,47523.21
220990,202308,27,25,2,33000,2992,35992
220995,202308,18,16,2,21120,2640,23760
220997,202308,82,73,9,96362.55,11880,108242.55
221000,202308,1390,1229,161,1622319.45,212521.06,1834840.51
221005,202308,50,46,4,60720,5280.82,66000.82
221010,202308,30,21,9,27720,11880,39600
221020,202308,46,41,5,54120.52,6600,60720.52
221030,202308,49,41,8,54016.43,10560,64576.43
221035,202308,22,21,1,27722.45,1320,29042.45
221037,202308,13,10,3,13200,3960,17160
221038,202308,26,23,3,30360,3960,34320
221039,202308,28,28,0,36960.04,,36960.04
221040,202308,274,232,42,306245.49,55441.4,361686.89
221050,202308,253,211,42,278531.6,55440.2,333971.8
221060,202308,2131,1829,302,2414327.7,399965.11,2814292.81
221062,202308,32,32,0,42241.92,,42241.92
221063,202308,20,15,5,19800,6600,26400
221065,202308,83,67,16,88442.76,21120,109562.76
221070,202308,171,151,20,199324.99,26400,225724.99
221080,202308,446,377,69,497654.16,91080,588734.16
221090,202308,34,26,8,34322.13,10560,44882.13
221093,202308,56,40,16,52801.2,21120.45,73921.65
221095,202308,5,5,0,6600,,6600.0
221097,202308,12,10,2,13200,2640,15840
221100,202308,29469,17684,11785,23353149.33,15561779.32,38914928.65
221110,202308,1243,968,275,1277801.98,363007.61,1640809.59
221120,202308,630,454,176,599292.91,232320.01,831612.92
221130,202308,1083,874,209,1153700.31,275884.19,1429584.50
221135,202308,38,35,3,46201.09,3960,50161.09
221140,202308,49,43,6,56760.2,7920,64680.2
221150,202308,15,12,3,15840.18,3960,19800.18
221160,202308,19,17,2,22441.39,2640,25081.39
221170,202308,22,21,1,27720,1320,29040
230010,202308,171,148,23,195361.84,30360,225721.84
230015,202308,185,154,31,203280.9,40920,244200.9
230020,202308,2025,1603,422,2117330.78,557051.15,2674381.93
230030,202308,1789,1316,473,1737178.44,625686.49,2362864.93
230040,202308,261,210,51,277201.75,67320,344521.75
230050,202308,262,181,81,238920.97,106920.29,345841.26
230060,202308,191,151,40,199320.69,52800.94,252121.63
230070,202308,342,289,53,381484.77,69960,451444.77
230075,202308,1013,835,178,1102225.85,234964.43,1337190.28
230080,202308,256,209,47,275882.99,62040,337922.99
230090,202308,210,153,57,203281.43,75240,278521.43
230100,202308,3064,1726,1338,2278406.21,1766179.78,4044585.99
230110,202308,3341,2113,1228,2789231.39,1622298.45,4411529.84
230120,202308,1338,1019,319,1345107.58,422402.91,1767510.49
230125,202308,202,161,41,212520.83,54120.44,266641.27
230130,202308,556,479,77,632286.34,101640.2,733926.54
230140,202308,249,204,45,269281.17,59400,328681.17
230150,202308,159,122,37,161042.25,48840.51,209882.76
230160,202308,1044,848,196,1119366.87,260040.82,1379407.69
230170,202308,714,610,104,805220.56,137283.82,942504.38
230180,202308,74,67,7,88440.39,9240,97680.39
230185,202308,463,398,65,525369.46,87121.14,612490.60
230190,202308,2789,2093,696,2762833.52,920048.85,3682882.37
230195,202308,569,485,84,640219.21,110880,751099.21
230200,202308,506,390,116,514806.34,153120.2,667926.54
230205,202308,441,289,152,381481.17,200640.2,582121.37
230210,202308,1539,1168,371,1541783.9,489720.85,2031504.75
230220,202308,1796,1184,612,1564237.36,810487.45,2374724.81
230230,202308,1112,887,225,1173511.1,297003.87,1470514.97
230240,202308,2385,2096,289,2770733.81,381482.83,3152216.64
230250,202308,2037,1650,387,2178074.76,510850.83,2688925.59
230260,202308,3634,2255,1379,2976631.73,1821605.15,4798236.88
230270,202308,1510,1156,354,1525939.42,467284.8,1993224.22
230280,202308,3174,2440,734,3220899.62,968889.12,4189788.74
230290,202308,380,330,50,435613.97,66000.71,501614.68
230300,202308,563,413,150,545163.65,198000.1,743163.75
230310,202308,463,352,111,464640.32,146520.91,611161.23
230320,202308,1028,848,180,1120701.56,237600.76,1358302.32
230330,202308,359,291,68,384123.47,89760,473883.47
230340,202308,500,399,101,526688.73,133320.4,660009.13
230350,202308,3794,2305,1489,3042686.87,1970777.01,5013463.88
230360,202308,297,243,54,320764.57,71280.28,392044.85
230365,202308,163,131,32,172921.83,42240,215161.83
230370,202308,13081,6582,6499,8695264.09,8584185.62,17279449.71
230380,202308,573,487,86,642856.37,113523.42,756379.79
230390,202308,574,334,240,440883.37,316800,757683.37
230393,202308,260,211,49,278564.61,64680.5,343245.11
230395,202308,408,325,83,429021.8,109563.09,538584.89
230400,202308,737,585,152,772207.62,200640.2,972847.82
230410,202308,3237,2066,1171,2729825.74,1547059.77,4276885.51
230420,202308,7248,4758,2490,6282155.32,3292172.5,9574327.82
230423,202308,380,328,52,432963.7,68640,501603.7
230425,202308,579,460,119,608529.09,157081.24,765610.33
230426,202308,134,108,26,142560.7,34320,176880.7
230427,202308,79,69,10,91080.96,13200,104280.96
230428,202308,1996,964,1032,1273832.72,1362253.3,2636086.02
230430,202308,503,405,98,534610.95,129361.93,663972.88
230435,202308,1043,744,299,982103.28,394681.34,1376784.62
230440,202308,111312,51572,59740,68116359.01,78901703.2,147018062.21
230445,202308,360,243,117,320768.17,154440,475208.17
230450,202308,638,493,145,650763.67,191400.7,842164.37
230460,202308,122,88,34,116160.38,44880,161040.38
230465,202308,343,278,65,366963.88,85800,452763.88
230470,202308,2250,1768,482,2335105.97,636243.37,2971349.34
230480,202308,163,145,18,191400.5,23761.37,215161.87
230490,202308,369,289,80,381483.18,105600.13,487083.31
230495,202308,552,397,155,524052.5,204602.71,728655.21
230500,202308,1292,966,326,1275132.28,430322.83,1705455.11
230510,202308,87,59,28,77880,36960,114840
230520,202308,454,339,115,447485.17,153120.62,600605.79
230523,202308,2987,1824,1163,2409075.93,1537817.27,3946893.20
230526,202308,273,226,47,298321.41,62040,360361.41
230530,202308,762,536,226,707529.74,298322.63,1005852.37
230533,202308,240,218,22,287763.62,29040.2,316803.82
230535,202308,462,342,120,451455.81,158402.53,609858.34
230540,202308,1951,1737,214,2292893.37,282483.66,2575377.03
230550,202308,4706,2978,1728,3932467.62,2282325.12,6214792.74
230560,202308,639,491,148,648130.35,195360.57,843490.92
230565,202308,250,186,64,245521.31,84481.99,330003.30
230570,202308,349,296,53,390722.31,69960.45,460682.76
230580,202308,1371,934,437,1232894.78,578164.55,1811059.33
230590,202308,1223,937,286,1238070.87,378842.05,1616912.92
230600,202308,329,296,33,390727.95,43560,434287.95
230610,202308,537,396,141,522729.74,186120.2,708849.94
230620,202308,188,157,31,207242.13,40920,248162.13
230625,202308,976,657,319,867259.43,421081.07,1288340.50
230630,202308,1655,1223,432,1614394.8,570244.38,2184639.18
230640,202308,4453,3573,880,4719174.08,1161622.31,5880796.39
230650,202308,563,479,84,632285.61,112201.33,744486.94
230655,202308,839,655,184,864631.32,242884.06,1107515.38
230660,202308,429,351,78,463324.7,102960.2,566284.9
230670,202308,531,420,111,554419.12,147840.91,702260.03
230680,202308,252,210,42,277206.25,55440,332646.25
230690,202308,1069,893,176,1178790.13,232321.88,1411112.01
230700,202308,1167,961,206,1268548.7,271921.68,1540470.38
230710,202308,743,677,66,893664.08,87120.8,980784.88
230720,202308,162,137,25,180840,33000.7,213840.7
230725,202308,331,247,84,326043.4,110881.09,436924.49
230730,202308,14595,7700,6895,10171189.89,9108144.02,19279333.91
230740,202308,786,633,153,838221.67,201961.1,1040182.77
230750,202308,920,756,164,999258.45,219120.87,1218379.32
230760,202308,1832,1535,297,2026270.15,393362.48,2419632.63
230763,202308,427,360,67,475203.5,88440,563643.5
230765,202308,10199,4926,5273,6502696.92,6965856.15,13468553.07
230770,202308,5874,3075,2799,4060470.1,3697349.71,7757819.81
230780,202308,899,768,131,1013771.96,174240.1,1188012.06
230790,202308,355,286,69,377520.43,91080.41,468600.84
230800,202308,1354,952,402,1259298.11,530641.66,1789939.77
230810,202308,1565,1346,219,1776797.24,289084.32,2065881.56
230820,202308,420,274,146,361684.04,192721.27,554405.31
230830,202308,1039,868,171,1145779.46,225720.9,1371500.36
230835,202308,309,254,55,335285.27,72600.68,407885.95
230837,202308,209,166,43,219122.02,56760.47,275882.49
230840,202308,1085,807,278,1065249.69,366961.34,1432211.03
230850,202308,1530,1277,253,1687003.44,335284.26,2022287.70
230860,202308,380,299,81,394683.8,106926.6,501610.4
230870,202308,2030,1705,325,2250641.41,429000.47,2679641.88
230880,202308,91,70,21,92400,27720,120120
230890,202308,641,562,79,741846.85,104281.51,846128.36
230900,202308,347,260,87,343201.87,116160.24,459362.11
230910,202308,249,192,57,253443.2,75240,328683.2
230920,202308,564,435,129,575351.42,170280,745631.42
230930,202308,1277,899,378,1186708.11,500281.11,1686989.22
230940,202308,956,734,222,968899.42,293040.73,1261940.15
230945,202308,637,505,132,667943.74,174244.86,842188.60
230950,202308,492,424,68,559701.15,89760.56,649461.71
230960,202308,3186,2153,1033,2842092.1,1367552.38,4209644.48
230970,202308,2167,1202,965,1586696.08,1273816.15,2860512.23
230980,202308,260,189,71,249482.7,93720,343202.7
230990,202308,156,120,36,158400.5,47520,205920.5
231000,202308,230,211,19,278522.16,25080,303602.16
231010,202308,212,143,69,188762.2,91080,279842.2
231020,202308,1665,1093,572,1442816.5,755053.88,2197870.38
231025,202308,1274,878,396,1159000.57,522731.26,1681731.83
231030,202308,1183,948,235,1251373.31,310202.49,1561575.80
231040,202308,206,145,61,191402.66,80520,271922.66
231050,202308,1046,889,157,1173500.01,207246.81,1380746.82
231060,202308,179,142,37,187443.73,48840.9,236284.63
231070,202308,1726,1189,537,1569510.65,708847.16,2278357.81
231080,202308,298,258,40,340567.97,52800,393367.97
231085,202308,800,495,305,653419.26,402600.26,1056019.52
231090,202308,295,241,54,318124.78,71281.64,389406.42
231095,202308,175,130,45,171600,59400.89,231000.89
231100,202308,217,174,43,229681.6,56760,286441.6
231110,202308,407,336,71,443528.12,93722.11,537250.23
231120,202308,291,233,58,307564.75,76560.39,384125.14
231123,202308,159,151,8,199323.28,10560,209883.28
231126,202308,373,291,82,384121.5,108240,492361.5
231130,202308,5620,4388,1232,5792375.37,1628906.81,7421282.18
231135,202308,245,213,32,281162.14,42241.41,323403.55
231140,202308,3417,2453,964,3238053.35,1273813.86,4511867.21
231150,202308,437,402,35,530651.07,46201.12,576852.19
231160,202308,1395,1141,254,1506142.09,335281.75,1841423.84
231170,202308,586,403,183,531964.09,241560,773524.09
231180,202308,2197,1893,304,2498821.77,401285.3,2900107.07
231190,202308,261,208,53,274560.95,69960,344520.95
231195,202308,262,211,51,278522.9,67320.15,345843.05
231200,202308,980,780,200,1032261.83,264002.9,1296264.73
231210,202308,566,468,98,617769.69,130681.39,748451.08
231220,202308,1210,844,366,1114103.69,483124.83,1597228.52
231230,202308,1773,1298,475,1713385.67,628321.04,2341706.71
231240,202308,1884,1263,621,1669837.33,821049.02,2490886.35
231250,202308,100,93,7,122760.2,9240,132000.2
231260,202308,290,196,94,258721.98,124081.19,382803.17
231270,202308,1084,825,259,1090347.52,341881.09,1432228.61
231280,202308,95,72,23,95041.49,31680.8,126722.29
231290,202308,9148,5107,4041,6745469.6,5334217.48,12079687.08
231300,202308,659,590,69,778808,91080,869888
231310,202308,944,858,86,1132573.18,113520.83,1246094.01
231320,202308,714,531,183,702246,241561.62,943807.62
231325,202308,114,97,17,128040.18,22440.54,150480.72
231330,202308,2172,1637,535,2160904.14,707528.99,2868433.13
231335,202308,274,241,33,318124.88,43560,361684.88
231340,202308,2223,1507,716,1990606.46,946449.95,2937056.41
231350,202308,1638,1261,377,1665902.81,498974,2164876.81
231355,202308,454,375,79,495007.25,104281.24,599288.49
231360,202308,668,447,221,591375.46,291721.94,883097.40
231370,202308,103,88,15,116160,19800,135960
231375,202308,307,230,77,303605.05,101640.1,405245.15
231380,202308,596,472,124,623044.87,163680,786724.87
231390,202308,226,169,57,223081.37,75240,298321.37
231395,202308,867,509,358,671884.25,472560.55,1144444.80
231400,202308,1385,1156,229,1525948.16,302284.35,1828232.51
231410,202308,1599,1290,309,1702831.47,409202.24,2112033.71
240010,202308,437,203,234,269291.12,308888.95,578180.07
240020,202308,2541,2086,455,2753637.58,600610.16,3354247.74
240030,202308,125,97,28,128041.52,36960,165001.52
240040,202308,39,37,2,48840,2640,51480
240050,202308,571,485,86,640229.06,113520.78,753749.84
240060,202308,92,81,11,106921.63,14520,121441.63
240070,202308,325,245,80,323405.34,105600.2,429005.54
240080,202308,651,435,216,575542.94,285127.04,860669.98
240090,202308,116,101,15,133320.16,19800,153120.16
240100,202308,1706,1589,117,2097545.08,154442.02,2251987.10
240110,202308,1175,802,373,1060036.45,492382.52,1552418.97
240120,202308,167,125,42,165001.83,55440.75,220442.58
240130,202308,286,259,27,341895.31,35640.7,377536.01
240140,202308,102,66,36,87121.29,47520.64,134641.93
240145,202308,815,718,97,949112.95,128040.7,1077153.65
240150,202308,32,23,9,30360,11880,42240
240160,202308,38,32,6,42240,7920,50160
240165,202308,40,33,7,43562.25,9240.1,52802.35
240170,202308,184,130,54,171601.7,71280,242881.7
240180,202308,139,100,39,132002,51480,183482
240185,202308,60,51,9,67320.28,11880,79200.28
240190,202308,15,13,2,17160.43,2640,19800.43
240200,202308,3447,1834,1613,2423582.87,2129182.18,4552765.05
240210,202308,174,129,45,170280.73,59400,229680.73
240220,202308,1286,860,426,1136564.87,562325.67,1698890.54
240230,202308,907,810,97,1069245.46,128040.78,1197286.24
240240,202308,95,63,32,83160.2,42240.59,125400.79
240250,202308,112,96,16,126720.59,21120,147840.59
240260,202308,2155,1511,644,1994582.58,850091.19,2844673.77
240270,202308,186,155,31,204601,40920,245521
240280,202308,75,61,14,80520.2,18480.1,99000.3
240290,202308,44,42,2,55440,2640,58080
240300,202308,186,101,85,133321.67,112200,245521.67
240310,202308,2817,1528,1289,2017023.17,1702823.55,3719846.72
240320,202308,181,166,15,219120.07,19800,238920.07
240325,202308,5675,3150,2525,4160845.93,3333088.93,7493934.86
240330,202308,88,83,5,109560.23,6600,116160.23
240340,202308,127,94,33,124080,43560.59,167640.59
240350,202308,103,81,22,106920.2,29040,135960.2
240360,202308,900,579,321,764313.53,425046.12,1189359.65
240370,202308,71,61,10,80521.72,13201.65,93723.37
240375,202308,48,31,17,40920.87,22441.68,63362.55
240380,202308,234,190,44,250811.78,58080.5,308892.28
240390,202308,19,17,2,22440,2640,25080
240400,202308,90,79,11,104281.28,14520,118801.28
240410,202308,13,10,3,13200,3960,17160
240420,202308,1249,868,381,1147117.03,502927.66,1650044.69
240430,202308,288,257,31,339254.1,40920.2,380174.3
240440,202308,176,107,69,141243.53,91080.97,232324.50
240450,202308,297,179,118,236291.35,155762.03,392053.38
240460,202308,109,86,23,113521.12,30360,143881.12
240470,202308,240,216,24,286460.54,31680.71,318141.25
240480,202308,16,14,2,18480,2640,21120
240485,202308,95,78,17,102960.51,22440,125400.51
240490,202308,71,63,8,83160.08,10560,93720.08
240500,202308,119,94,25,124080,33000,157080
240510,202308,38,28,10,36960,13200,50160
240520,202308,100,94,6,124081.5,7920.61,132002.11
240530,202308,73,55,18,72600,23760,96360
240540,202308,106,90,16,118800.1,21120,139920.1
240550,202308,11,9,2,11880,2640,14520
240560,202308,441,295,146,389411.7,192720.5,582132.2
240570,202308,472,285,187,376208.19,246842.05,623050.24
240580,202308,1528,1098,430,1449400.21,567601.72,2017001.93
240590,202308,32,31,1,40921.12,1320,42241.12
240600,202308,109,102,7,134641.62,9240,143881.62
240610,202308,528,435,93,574226.43,122766.22,696992.65
240615,202308,10,10,0,13200.8,,13200.8
240620,202308,91,86,5,113521.58,6600,120121.58
240630,202308,51,42,9,55440.97,11880.29,67321.26
240640,202308,42,30,12,39600,15840,55440
240650,202308,262,204,58,269281.87,76560.2,345842.07
240660,202308,123,104,19,137280.77,25080,162360.77
240670,202308,336,189,147,249494.25,195369.32,444863.57
240680,202308,59,47,12,62040.67,15840,77880.67
240690,202308,53,50,3,66001.91,3960,69961.91
240700,202308,188,157,31,207240.6,40921.02,248161.62
240710,202308,2600,1550,1050,2046080.41,1386015.75,3432096.16
240720,202308,1161,799,362,1054716.22,479169.18,1533885.40
240725,202308,79,71,8,93721.46,10560.88,104282.34
240730,202308,156,128,28,170280.08,36960.9,207240.98
240740,202308,259,206,53,271930.38,69960.62,341891.00
240750,202308,59,36,23,47520,30360,77880
240760,202308,68,52,16,69960,21120,91080
240770,202308,165,126,39,166321.68,51481.43,217803.11
240780,202308,832,677,155,893664.55,204600.99,1098265.54
240790,202308,42,39,3,51481.77,3960,55441.77
240800,202308,10874,7295,3579,9631347.74,4729746.39,14361094.13
240810,202308,24691,13053,11638,17237434.21,15378328.78,32615762.99
240820,202308,302,182,120,240247.24,158403.81,398651.05
240830,202308,1722,1423,299,1878418.29,394686.18,2273104.47
240840,202308,86,73,13,96360,17160,113520
240850,202308,93,79,14,104280,18480,122760
240860,202308,119,114,5,150482.09,6600.85,157082.94
240870,202308,61,50,11,66003.16,14520,80523.16
240880,202308,34,29,5,38280,6600,44880
240890,202308,1336,747,589,986074.34,780130.54,1766204.88
240895,202308,72,54,18,71280.2,23760.59,95040.79
240910,202308,196,160,36,211202.19,47520.2,258722.39
240920,202308,13,12,1,15841.32,1320,17161.32
240930,202308,459,407,52,538584.45,69961.49,608545.94
240933,202308,66,43,23,56760.95,30360,87120.95
240940,202308,2465,2148,317,2835443.08,418444.63,3253887.71
240950,202308,43,39,4,51480,5280,56760
240960,202308,26,22,4,29040.2,5280.3,34320.5
240970,202308,117,83,34,109560.96,44880,154440.96
240980,202308,224,177,47,233640.9,62040.8,295681.7
240990,202308,156,98,58,129361.43,76560,205921.43
241000,202308,61,55,6,72600.51,7920,80520.51
241010,202308,107,79,28,104280.59,36960,141240.59
241020,202308,114,105,9,138601.51,11880.82,150482.33
241025,202308,23,15,8,19800.37,10560.5,30360.87
241030,202308,126,96,30,126720,39600,166320
241040,202308,50,38,12,50160.1,15840,66000.1
241050,202308,80,74,6,97681.55,7920,105601.55
241060,202308,30,25,5,33000.78,6600,39600.78
241070,202308,25,25,0,33002.51,,33002.51
241080,202308,62,53,9,69960.2,11880,81840.2
241090,202308,60,48,12,63363.15,15840,79203.15
241100,202308,71,62,9,81841.05,11880.28,93721.33
241105,202308,32,20,12,26404.41,15840.53,42244.94
241110,202308,57,46,11,60720.15,14520,75240.15
241120,202308,1901,1431,470,1888965.01,620403.72,2509368.73
241140,202308,218,177,41,233643.72,54120,287763.72
241142,202308,55,41,14,54121.44,18480,72601.44
241150,202308,1266,1095,171,1445448.73,225722.45,1671171.18
241160,202308,32,21,11,27720,14520,42240
241170,202308,60,50,10,66000,13200,79200
241180,202308,51,38,13,50160,17160,67320
241190,202308,44,39,5,51482.28,6600,58082.28
241200,202308,5570,2891,2679,3816335.52,3537717.97,7354053.49
241210,202308,74,62,12,81840.1,15840,97680.1
241220,202308,1731,1085,646,1434903.04,854053.96,2288957.00
241230,202308,275,218,57,287765.08,75240.91,363005.99
241240,202308,54,40,14,52801.15,18480,71281.15
241250,202308,1215,1106,109,1459958.85,143882.93,1603841.78
241255,202308,79,64,15,84481.28,19800,104281.28
241260,202308,826,628,198,830299.87,261361.94,1091661.81
241270,202308,78,57,21,75240.39,27720,102960.39
241280,202308,104,90,14,118802.27,18480,137282.27
241290,202308,154,117,37,154443.84,48840,203283.84
241300,202308,90,58,32,76560.7,42240.98,118801.68
241310,202308,58,40,18,52801.07,23760.1,76561.17
241320,202308,41,21,20,27721.36,26400,54121.36
241330,202308,63,54,9,71281.01,11880,83161.01
241335,202308,115,103,12,135963.94,15840,151803.94
241340,202308,199,136,63,179520.81,83160,262680.81
241350,202308,66,55,11,72600.67,14520,87120.67
241355,202308,60,49,11,64682.43,14520,79202.43
241360,202308,64,61,3,80520.68,3960,84480.68
241370,202308,75,59,16,77880,21120,99000
241380,202308,36,32,4,42241.5,5280,47521.5
241390,202308,96,77,19,101640.66,25080,126720.66
241400,202308,250,184,66,243837.72,87121.24,330958.96
241410,202308,203,183,20,241560.54,26400.01,267960.55
241415,202308,116,92,24,121440.1,31680.8,153120.9
241420,202308,171,103,68,135962.05,89760,225722.05
241430,202308,20,17,3,22440,3960,26400
241440,202308,585,490,95,646829.1,125403.72,772232.82
241445,202308,49,43,6,56760.2,7920,64680.2
241450,202308,271,227,44,299650.49,58080.44,357730.93
241460,202308,192,173,19,228364.88,25081.08,253445.96
241470,202308,33,27,6,35640.8,7920,43560.8
241475,202308,54,50,4,66000,5280,71280
241480,202308,161,117,44,154442.26,58080.2,212522.46
241490,202308,15,13,2,17161.42,2640.1,19801.52
241500,202308,54,41,13,54122.33,17160.02,71282.35
250010,202308,107,90,17,118800.69,22440.66,141241.35
250020,202308,37,32,5,42240,6600,48840
250030,202308,962,720,242,950429.81,319444.3,1269874.11
250040,202308,437,346,91,456737.58,120121.12,576858.70
250050,202308,307,250,57,330002.35,75240.5,405242.85
250053,202308,69,57,12,75240.6,15840,91080.6
250057,202308,4,3,1,3960.2,1320,5280.2
250060,202308,668,484,184,640219.55,242881.7,883101.25
250070,202308,716,569,147,752420.87,194040.64,946461.51
250073,202308,13,10,3,13200.7,3960.01,17160.71
250077,202308,202,145,57,191401.32,75240.2,266641.52
250080,202308,423,338,85,446169.33,112200.38,558369.71
250090,202308,230,145,85,191401.03,112200,303601.03
250100,202308,640,504,136,665287.62,179521,844808.62
250110,202308,749,534,215,707536.66,285121.68,992658.34
250115,202308,14,4,10,5280.18,13200.26,18480.44
250120,202308,128,93,35,122761.42,46201.92,168963.34
250130,202308,608,503,105,663981.3,139921.26,803902.56
250135,202308,36,15,21,19800.59,27720,47520.59
250140,202308,99,84,15,110882.58,19800,130682.58
250150,202308,702,482,220,636250.89,290401.43,926652.32
250153,202308,19,15,4,19800.1,5280,25080.1
250157,202308,56,42,14,55440.42,18480,73920.42
250160,202308,263,199,64,262682.71,85800,348482.71
250170,202308,92,60,32,79200.2,42240,121440.2
250180,202308,5543,3868,1675,5106037.03,2212379.08,7318416.11
250190,202308,822,559,263,737889.74,347162.83,1085052.57
250200,202308,82,65,17,85801.26,22440.7,108241.96
250205,202308,25,19,6,25080.61,7920,33000.61
250210,202308,93,77,16,101641.75,21120,122761.75
250215,202308,110,70,40,92400.83,52800.25,145201.08
250220,202308,32,21,11,27720.56,14520,42240.56
250230,202308,82,71,11,93720.3,14520.2,108240.5
250240,202308,266,197,69,260044.39,91080.2,351124.59
250250,202308,450,381,69,504255.42,91080,595335.42
250260,202308,60,49,11,64680.1,14520,79200.1
250270,202308,81,59,22,77880.8,29040,106920.8
250280,202308,433,351,82,464644.66,108240,572884.66
250290,202308,123,110,13,145200,17160.88,162360.88
250300,202308,540,366,174,483132.05,229680.1,712812.15
250310,202308,60,55,5,72601.77,6600,79201.77
250320,202308,2244,1500,744,1980093.54,983421.66,2963515.20
250330,202308,126,108,18,142562.84,23760.1,166322.94
250340,202308,36,29,7,38280.94,9240,47520.94
250350,202308,219,145,74,191403.95,97680,289083.95
250355,202308,50,40,10,52800,13200.25,66000.25
250360,202308,197,162,35,213844.16,46200.67,260044.83
250370,202308,2587,1654,933,2183357.8,1231585.2,3414943.0
250375,202308,16,10,6,13200.36,7920.32,21120.68
250380,202308,56,47,9,62040.2,11880.61,73920.81
250390,202308,59,48,11,63361.3,14520,77881.3
250400,202308,19361,10046,9315,13265238.02,12314541,25579779.02
250403,202308,310,240,70,316802.71,92400,409202.71
250407,202308,70,56,14,73920.1,18480.85,92400.95
250410,202308,32,27,5,35640.31,6600.8,42241.11
250415,202308,54,35,19,46200,25080,71280
250420,202308,44,37,7,48840.3,9240,58080.3
250430,202308,1633,1420,213,1874777.81,281161.75,2155939.56
250435,202308,31,28,3,36960.8,3960,40920.8
250440,202308,696,571,125,753728.62,165001,918729.62
250450,202308,93,69,24,91081.58,31680,122761.58
250460,202308,548,358,190,472564.98,250802.24,723367.22
250470,202308,108,77,31,101641.5,40920,142561.5
250480,202308,366,285,81,376211.1,106920.98,483132.08
250485,202308,7,6,1,7920,1320,9240
250490,202308,264,208,56,274563.92,73921.39,348485.31
250500,202308,110,84,26,110880.1,34320,145200.1
250510,202308,927,735,192,970213.94,253440.32,1223654.26
250520,202308,181,123,58,162360,76560.7,238920.7
250523,202308,136,109,27,143880.74,35640.12,179520.86
250527,202308,130,90,40,118800.91,52800.2,171601.11
250530,202308,16,12,4,15840,5280,21120
250535,202308,30,23,7,30360,9240,39600
250540,202308,151,121,30,159720.87,39600,199320.87
250550,202308,78,75,3,99001.19,3960,102961.19
250560,202308,68,42,26,55441.28,34320.07,89761.35
250570,202308,170,139,31,183482.1,40920.7,224402.8
250580,202308,94,76,18,100405.2,23760,124165.2
250590,202308,23,16,7,21120,9240,30360
250600,202308,1775,1181,594,1558952.74,784084.03,2343036.77
250610,202308,161,128,33,168968.45,43560.22,212528.67
250620,202308,27,22,5,29040.81,6600,35640.81
250625,202308,75,58,17,76562.33,22440.08,99002.41
250630,202308,3320,2062,1258,2722170.87,1661904.61,4384075.48
250640,202308,206,164,42,216486.08,55440.85,271926.93
250650,202308,37,26,11,34320.5,14520,48840.5
250660,202308,67,48,19,63360,25080,88440
250670,202308,86,68,18,89761.09,23760,113521.09
250680,202308,456,364,92,480493.74,121440.59,601934.33
250690,202308,2405,1626,779,2146370.01,1028293.35,3174663.36
250700,202308,1020,849,171,1120698.64,225720.2,1346418.84
250710,202308,546,421,125,555752.55,165005.47,720758.02
250720,202308,131,95,36,125401.15,47520,172921.15
250730,202308,441,361,80,476527.84,105602.02,582129.86
250740,202308,78,71,7,93721.86,9240,102961.86
250750,202308,28021,16424,11597,21692403.71,15318965.27,37011368.98
250760,202308,130,101,29,133320.5,38280.34,171600.84
250770,202308,388,260,128,343210.41,170280.7,513491.11
250780,202308,86,57,29,75240.48,38280,113520.48
250790,202308,487,304,183,401285.89,241563.01,642848.90
250800,202308,159,144,15,190080,19800,209880
250810,202308,75,62,13,81840,17160,99000
250820,202308,164,133,31,175562.05,40920,216482.05
250830,202308,537,351,186,463334.39,245522.08,708856.47
250840,202308,65,55,10,72601.71,13200.2,85801.91
250850,202308,80,66,14,87120.2,18480,105600.2
250855,202308,17,14,3,18480.2,3960,22440.2
250860,202308,256,163,93,215161.12,122760,337921.12
250870,202308,37,33,4,43560,5280,48840
250880,202308,101,77,24,101640.79,33000,134640.79
250890,202308,3503,2562,941,3383251.51,1242135.35,4625386.86
250900,202308,80,66,14,87120.63,18480,105600.63
250905,202308,134,100,34,132001.76,44880,176881.76
250910,202308,1044,767,277,1012466.42,365645.04,1378111.46
250915,202308,124,86,38,113521.43,50161.03,163682.46
250920,202308,160,121,39,159720,51480.7,211200.7
250930,202308,208,118,90,155760.7,118801.1,274561.8
250933,202308,11,8,3,10560,3960.89,14520.89
250937,202308,21,19,2,25080,2640,27720
250939,202308,46,34,12,44880.76,15840,60720.76
250940,202308,145,105,40,138601.66,52800.97,191402.63
250950,202308,88,64,24,84482.77,31680,116162.77
250960,202308,92,55,37,72603.11,48840.3,121443.41
250970,202308,1412,1003,409,1323988.03,539884.51,1863872.54
250980,202308,102,69,33,91081.14,43560,134641.14
250990,202308,178,135,43,178200,56760,234960
251000,202308,94,78,16,102960,21120,124080
251010,202308,158,113,45,149160,59400,208560
251020,202308,98,82,16,108240.37,21120,129360.37
251030,202308,52,38,14,50160.05,18480,68640.05
251040,202308,80,57,23,75240,30360,105600
251050,202308,30,26,4,34320,5280,39600
251060,202308,53,41,12,54120.92,15840.64,69961.56
251065,202308,6,3,3,3960,3960,7920
251070,202308,19,17,2,22441.53,2640,25081.53
251080,202308,6083,2819,3264,3721246.02,4311203.38,8032449.40
251090,202308,208,171,37,225721.72,48840,274561.72
251100,202308,29,26,3,34321.39,3960,38281.39
251110,202308,72,47,25,62040,33000.67,95040.67
251120,202308,2125,1333,792,1760958.61,1045460.18,2806418.79
251130,202308,480,394,86,520086.96,113520.05,633607.01
251140,202308,674,445,229,587404.53,302281.32,889685.85
251150,202308,359,301,58,397323.68,76560,473883.68
251160,202308,100,83,17,109560.42,22440,132000.42
251170,202308,85,70,15,92400.26,19800,112200.26
251180,202308,319,185,134,244204.01,176881.76,421085.77
251190,202308,117,86,31,113525.57,40920.38,154445.95
251200,202308,346,264,82,348487.99,108240.44,456728.43
251203,202308,38,32,6,42240.69,7920,50160.69
251207,202308,91,73,18,96360.84,23760,120120.84
251210,202308,1703,1239,464,1635508.05,612485.73,2247993.78
251220,202308,51,40,11,52800.78,14520,67320.78
251230,202308,624,522,102,689050.62,134641.64,823692.26
251240,202308,129,89,40,117480.5,52800,170280.5
251250,202308,1759,1266,493,1671055.55,653407.86,2324463.41
251260,202308,14,10,4,13200.87,5280.19,18481.06
251270,202308,355,276,79,364326.23,104280.69,468606.92
251272,202308,65,57,8,75240.2,10560,85800.2
251274,202308,21,16,5,21120.36,6600,27720.36
251275,202308,40,23,17,30360.65,22440,52800.65
251276,202308,33,26,7,34320.82,9240,43560.82
251278,202308,21,15,6,19802.54,7920,27722.54
251280,202308,125,120,5,158400.2,6600,165000.2
251290,202308,1262,896,366,1182795.55,483140.34,1665935.89
251300,202308,21,16,5,21120,6600,27720
251310,202308,337,237,100,312848.55,132001.11,444849.66
251315,202308,52,46,6,60720,7920,68640
251320,202308,77,61,16,80521.03,21120,101641.03
251330,202308,90,79,11,104280,14520,118800
251335,202308,26,18,8,23760,10560,34320
251340,202308,919,507,412,669255.23,543843.2,1213098.43
251350,202308,42,39,3,51480,3960,55440
251360,202308,94,79,15,104280.2,19800,124080.2
251365,202308,9,8,1,10562.34,1320,11882.34
251370,202308,6556,4469,2087,5903227.67,2761480.83,8664708.50
251380,202308,50,38,12,50160.54,15840,66000.54
251385,202308,8,7,1,9240,1320,10560
251390,202308,1130,835,295,1102225.09,389406.93,1491632.02
251392,202308,50,35,15,46200.5,19800,66000.5
251394,202308,20,15,5,19800.6,6600,26400.6
251396,202308,11,7,4,9240,5280.2,14520.2
251398,202308,20,17,3,22440.91,3960,26400.91
251400,202308,60,46,14,60720,18480,79200
251410,202308,50,40,10,52800.7,13200,66000.7
251420,202308,121,88,33,116162.18,43560,159722.18
251430,202308,51,44,7,58080.33,9240,67320.33
251440,202308,57,32,25,42240,33000,75240
251445,202308,67,58,9,76563.51,11880,88443.51
251450,202308,413,349,64,460691.4,84480.32,545171.72
251455,202308,6,5,1,6600,1320,7920
251460,202308,26,20,6,26400,7920.02,34320.02
251465,202308,16,10,6,13200,7920,21120
251470,202308,50,36,14,47520,18480,66000
251480,202308,26,22,4,29040.62,5280.2,34320.82
251490,202308,101,61,40,80521.99,52801.1,133323.09
251500,202308,111,90,21,118801.11,27720,146521.11
251510,202308,106,68,38,89761.06,50160.62,139921.68
251520,202308,43,35,8,46200,10560,56760
251530,202308,4556,3209,1347,4238594.72,1779368.96,6017963.68
251540,202308,106,87,19,114840,25081.57,139921.57
251550,202308,462,352,110,464658.21,145203.36,609861.57
251560,202308,25,19,6,25080.1,7920,33000.1
251570,202308,17,16,1,21120,1320,22440
251580,202308,133,103,30,135961.56,39600,175561.56
251590,202308,104,73,31,96360.2,40920.8,137281.0
251593,202308,35,19,16,25080.77,21120,46200.77
251597,202308,134,109,25,143881.18,34320.04,178201.22
251600,202308,1169,811,358,1070541.87,473882.72,1544424.59
251610,202308,293,213,80,281167.77,105600,386767.77
251615,202308,26,22,4,29040,5280,34320
251620,202308,4405,2779,1626,3671016.19,2147666.51,5818682.70
251630,202308,516,376,140,496340.92,184805.25,681146.17
251640,202308,106,75,31,99005.22,40920,139925.22
251650,202308,328,236,92,311524.61,121440,432964.61
251660,202308,222,195,27,257404.47,35640.3,293044.77
251670,202308,445,338,107,446166.74,141240.61,587407.35
251675,202308,14,11,3,14520,3960,18480
251680,202308,108,95,13,125401.07,17160,142561.07
251690,202308,342,282,60,372578.88,79200.2,451779.08
251700,202308,288,244,44,322083.72,58080,380163.72
251710,202308,23,16,7,21120.41,9240,30360.41
251720,202308,41,28,13,36960,17160,54120
251740,202308,15,10,5,13200.3,6600,19800.3
260005,202308,4165,2135,2030,2819063.14,2682289.81,5501352.95
260010,202308,1954,1465,489,1933831.62,650765.12,2584596.74
260020,202308,458,403,55,531967.43,72600.9,604568.33
260030,202308,685,463,222,611173.95,293041.9,904215.85
260040,202308,810,522,288,689060.4,380163.04,1069223.44
260050,202308,1218,889,329,1173504.36,434283.09,1607787.45
260060,202308,380,345,35,455412.39,46200,501612.39
260070,202308,1433,870,563,1149775.98,743183.91,1892959.89
260080,202308,805,593,212,782777.77,279840,1062617.77
260090,202308,496,328,168,434282.32,223080.6,657362.92
260100,202308,234,155,79,204602.27,104280,308882.27
260105,202308,301,178,123,234961.67,162360.1,397321.77
260110,202308,3287,2373,914,3135051.48,1210450.53,4345502.01
260120,202308,2948,1565,1383,2067527.82,1825582.95,3893110.77
260130,202308,234,167,67,220443.15,88440,308883.15
260140,202308,2451,1579,872,2084326.1,1151053.19,3235379.29
260150,202308,209,137,72,180840.93,95040.6,275881.53
260160,202308,383,302,81,398653.39,106921.29,505574.68
260170,202308,3733,2228,1505,2943679.45,1986628.11,4930307.56
260180,202308,164,140,24,184805.76,31680.98,216486.74
260190,202308,2747,1757,990,2319281.3,1306805.48,3626086.78
260200,202308,1081,844,237,1114102.51,315480.93,1429583.44
260210,202308,1473,1067,406,1408477.51,535923.38,1944400.89
260220,202308,651,577,74,761656.77,97681.67,859338.44
260230,202308,1428,1046,382,1380760.76,504247.71,1885008.47
260240,202308,229,174,55,229687,72602.23,302289.23
260250,202308,111,86,25,113520.35,33000,146520.35
260260,202308,1202,828,374,1092974.38,493682.98,1586657.36
260270,202308,260,185,75,244205.85,99000,343205.85
260280,202308,1249,982,267,1296267.27,352444.2,1648711.47
260290,202308,7805,4186,3619,5530832.59,4781074.16,10311906.75
260300,202308,1139,959,180,1265933.59,237602.6,1503536.19
260310,202308,561,443,118,587410.73,155760.1,743170.83
260320,202308,850,622,228,823682.42,300960.4,1124642.82
260330,202308,103,79,24,104280.3,31680.3,135960.6
260340,202308,90,67,23,88440.65,30360,118800.65
260345,202308,6562,3314,3248,4374643.43,4288733.88,8663377.31
260350,202308,517,367,150,484450.78,198000.42,682451.20
260360,202308,269,159,110,209881.07,145200.45,355081.52
260370,202308,757,498,259,658691.93,343202.35,1001894.28
260380,202308,579,417,162,550450.33,213842.18,764292.51
260390,202308,306,260,46,343205.54,60720,403925.54
260392,202308,134,113,21,149162.71,27721.12,176883.83
260400,202308,4942,2820,2122,3723788.99,2803701.28,6527490.27
260410,202308,16938,8715,8223,11505442.59,10861043.46,22366486.05
260415,202308,173,139,34,183481.87,44880,228361.87
260420,202308,1922,1211,711,1598550.11,939842.74,2538392.85
260430,202308,183,164,19,216488.37,25080.2,241568.57
260440,202308,226,149,77,196685.76,101641.6,298327.36
260450,202308,480,362,118,477852.86,155761.85,633614.71
260460,202308,946,498,448,657375.83,592686.2,1250062.03
260470,202308,353,217,136,286445.58,179521.65,465967.23
260480,202308,283,172,111,228360,146520,374880
260490,202308,246,183,63,241561.2,83160,324721.2
260500,202308,1254,830,424,1095622.8,559684.85,1655307.65
260510,202308,900,719,181,949098.98,238921.07,1188020.05
260515,202308,276,253,23,333962.27,30360.91,364323.18
260520,202308,3442,2114,1328,2791804.97,1754298.14,4546103.11
260530,202308,935,748,187,988716.86,246840.9,1235557.76
260540,202308,592,461,131,608531.42,172921.36,781452.78
260545,202308,40,19,21,25081.19,29040.56,54121.75
260550,202308,390,250,140,330002.34,186120.11,516122.45
260560,202308,529,405,124,534614.78,163681.22,698296.00
260570,202308,1110,888,222,1172199.22,293041.18,1465240.40
260580,202308,380,300,80,397322.27,105600,502922.27
260590,202308,659,393,266,520081.5,351120.4,871201.9
260600,202308,8539,4998,3541,6601466.96,4675480.28,11276947.24
260610,202308,553,381,172,502934.16,227042.26,729976.42
260620,202308,4181,2186,1995,2900146.39,2648095.67,5548242.06
260630,202308,91,75,16,99000.49,21120,120120.49
260640,202308,3625,2209,1416,2915938.75,1870456.97,4786395.72
260650,202308,339,248,91,327364.96,120120.4,447485.36
260660,202308,660,444,216,586096.64,285124.1,871220.74
260670,202308,125,88,37,116160,48840.12,165000.12
260680,202308,4543,2421,2122,3201129.52,2801084.59,6002214.11
260690,202308,143,111,32,146521.16,42240,188761.16
260700,202308,338,234,104,310206.52,137280.69,447487.21
260710,202308,55,46,9,60720,11880,72600
260720,202308,2981,1715,1266,2265155.41,1673768.08,3938923.49
260730,202308,855,623,232,822368.89,306241.17,1128610.06
260740,202308,78,66,12,87120.83,15840,102960.83
260750,202308,590,439,151,579492.08,200640.2,780132.28
260760,202308,846,417,429,551783.55,566289.18,1118072.73
260765,202308,1113,586,527,773533.44,698290.67,1471824.11
260770,202308,244,173,71,228342.02,93720.78,322062.80
260775,202308,959,477,482,629662.34,636250.38,1265912.72
260780,202308,248,147,101,194041.99,133320,327361.99
260790,202308,18088,8629,9459,11395953.66,12493909.74,23889863.40
260795,202308,175,110,65,145201.34,85800,231001.34
260800,202308,323,261,62,344524,81840.46,426364.46
260805,202308,49,31,18,40921.81,23760.27,64682.08
260810,202308,934,736,198,971528.7,261360.62,1232889.32
260820,202308,342,227,115,299643.41,151800,451443.41
260825,202308,229,157,72,207241.02,95040,302281.02
260830,202308,321,211,110,278520,145200,423720
260840,202308,303,213,90,281164.12,118800.03,399964.15
260845,202308,233,139,94,183480.98,124081.73,307562.71
260850,202308,444,334,110,440885.77,145200,586085.77
260860,202308,261,196,65,258724.1,85800,344524.1
260870,202308,358,279,79,368286.02,104280,472566.02
260875,202308,807,585,222,772241.87,293041.02,1065282.89
260880,202308,1784,1179,605,1556307.91,798601.76,2354909.67
260890,202308,2795,1902,893,2510689.41,1180088.38,3690777.79
260900,202308,1136,854,282,1127295.16,372240.86,1499536.02
260910,202308,264,212,52,279845.41,68640.6,348486.01
260915,202308,299,224,75,295680.7,99000,394680.7
260920,202308,252,141,111,186120.2,146520,332640.2
260930,202308,385,328,57,432971.35,75240.17,508211.52
260940,202308,2755,1467,1288,1937832.54,1700179.81,3638012.35
260950,202308,2155,1227,928,1619688.03,1226301.25,2845989.28
260960,202308,15603,7451,8152,9847720.55,10767451.07,20615171.62
260970,202308,474,379,95,500285.85,125400,625685.85
260980,202308,234,216,18,285126.62,23760,308886.62
260990,202308,2936,2319,617,3062482.14,814445.75,3876927.89
261000,202308,4580,2843,1737,3752818.71,2294177.16,6046995.87
261010,202308,141,106,35,139921.26,46200,186121.26
261020,202308,640,467,173,616452.39,228360.1,844812.49
261030,202308,280,209,71,275883.06,93720,369603.06
261040,202308,407,339,68,447488.96,89760,537248.96
261050,202308,599,481,118,634932.1,155761.8,790693.9
261060,202308,1808,1130,678,1491617.06,894962.45,2386579.51
261070,202308,11121,5194,5927,6863053.85,7826485.69,14689539.54
261080,202308,383,299,84,394688.35,110880,505568.35
261090,202308,2189,1675,514,2211080.65,679805.64,2890886.29
261100,202308,1330,910,420,1201230.25,554405.27,1755635.52
261110,202308,10556,6625,3931,8748041.41,5192972.31,13941013.72
261120,202308,232,196,36,258721.27,47520,306241.27
261130,202308,603,362,241,477852.16,318128.33,795980.49
261140,202308,237,144,93,191401.07,122760,314161.07
261150,202308,684,447,237,590044.19,312840.78,902884.97
261153,202308,78,73,5,96360,6600,102960
261160,202308,85735,41548,44187,54889988.8,58388561.47,113278550.27
261170,202308,527,395,132,521401.1,174240.92,695642.02
261180,202308,1963,1234,729,1629213.65,962289.83,2591503.48
261190,202308,626,425,201,561007.44,265323.22,826330.66
261200,202308,226,178,48,234964.94,63360.36,298325.30
261210,202308,54,38,16,50160.1,22440,72600.1
261220,202308,3134,2176,958,2872391.53,1264576.12,4136967.65
261230,202308,404,296,108,390729.22,142560.97,533290.19
261240,202308,463,398,65,525371.11,85800.97,611172.08
261245,202308,290,246,44,324720.01,58080,382800.01
261247,202308,189,143,46,188762.48,60720,249482.48
261250,202308,4374,2118,2256,2798448.18,2979261.83,5777710.01
261255,202308,273,239,34,315480.52,44880,360360.52
261260,202308,928,790,138,1042859.93,182163.88,1225023.81
261270,202308,220,154,66,203280.83,87120,290400.83
261280,202308,204,168,36,223082.53,47520.14,270602.67
261290,202308,122,85,37,112200.24,48840.2,161040.44
261300,202308,1562,1169,393,1544436.21,518765.08,2063201.29
261310,202308,902,593,309,782776.58,407882.06,1190658.64
261320,202308,540,378,162,498974.49,213842.36,712816.85
261330,202308,929,742,187,979480.47,246848.54,1226329.01
261340,202308,357,195,162,257402.45,213841.57,471244.02
261350,202308,1020,705,315,930638.88,415811.03,1346449.91
261360,202308,1494,935,559,1236933.92,739204.83,1976138.75
261370,202308,5534,3202,2332,4226742.61,3080921.4,7307664.01
261380,202308,626,499,127,658687.12,167640,826327.12
261390,202308,4165,2853,1312,3766093.57,1733197.86,5499291.43
261400,202308,291,258,33,340565.78,43560.74,384126.52
261410,202308,1219,790,429,1042827.79,566283.71,1609111.50
261420,202308,1052,628,424,828972.24,559683.01,1388655.25
261430,202308,342,307,35,405246.02,46200,451446.02
261440,202308,112,106,6,139921.75,7920,147841.75
261450,202308,2805,2143,662,2828808.01,873846.53,3702654.54
261460,202308,860,658,202,868583.77,266641.8,1135225.57
261470,202308,250,199,51,262680.92,67320.4,330001.32
261480,202308,515,384,131,506892.43,172861.76,679754.19
261485,202308,433,254,179,335288.88,237600.2,572889.08
261500,202308,701,448,253,591369.96,333961.9,925331.86
261510,202308,57,40,17,52800.98,22440.1,75241.08
261520,202308,113,96,17,126722.13,22440.2,149162.33
261530,202308,4716,3050,1666,4027394.7,2201775.03,6229169.73
261540,202308,1690,958,732,1264586.34,966248.71,2230835.05
261550,202308,289,139,150,183481.75,198000,381481.75
261560,202308,1075,711,364,938540.47,480483.22,1419023.69
261570,202308,430,346,84,456725.4,110880.95,567606.35
261580,202308,423,334,89,440885.49,117480,558365.49
261590,202308,213,166,47,219126.9,62041.3,281168.2
261600,202308,345,266,79,351129.46,104280.2,455409.66
261610,202308,114,89,25,117481.15,33000,150481.15
261618,202308,88,64,24,84480.77,31680,116160.77
261620,202308,228,144,84,190083.16,110881.18,300964.34
261630,202308,724,559,165,737885.97,217803.21,955689.18
261640,202308,7492,3960,3532,5228679.84,4666275.47,9894955.31
261650,202308,457,288,169,380161.68,224400.1,604561.78
270010,202308,527,465,62,613816.12,81840.67,695656.79
270020,202308,251,209,42,275885.02,55440.47,331325.49
270030,202308,9936,6381,3555,8424460.37,4696556.18,13121016.55
270040,202308,2194,1474,720,1947045.76,950406.87,2897452.63
270050,202308,258,200,58,264004.13,76560.14,340564.27
270060,202308,56,40,16,52802.84,21120.33,73923.17
270070,202308,807,600,207,792011.42,273241.1,1065252.52
270080,202308,62,46,16,60720.1,21120,81840.1
270090,202308,21,16,5,21120,6600,27720
270100,202308,1382,947,435,1251387.81,576842.12,1828229.93
270110,202308,64,52,12,68640,15840,84480
270120,202308,299,246,53,324730.92,69960.53,394691.45
270130,202308,355,274,81,361683.7,106920,468603.7
270135,202308,123,91,32,120121,42240,162361
270140,202308,1487,996,491,1314759.13,648130.18,1962889.31
270150,202308,274,195,79,257405.14,104280.83,361685.97
270160,202308,491,389,102,513522.49,134643.36,648165.85
270170,202308,841,556,285,735244.75,376201.67,1111446.42
270180,202308,62,48,14,63360.7,18480.09,81840.79
270190,202308,117,103,14,135964.38,18480,154444.38
270200,202308,126,109,17,143880.94,22440,166320.94
270210,202308,566,356,210,469923,277200,747123
270220,202308,197,141,56,186120.53,73920.6,260041.13
270230,202308,2328,1501,827,1990601.06,1095604.23,3086205.29
270235,202308,525,414,111,546504.03,146520.1,693024.13
270240,202308,3483,2740,743,3622139.41,982083.91,4604223.32
270250,202308,113,92,21,121441.77,27720,149161.77
270255,202308,224,187,37,246842.55,48840.44,295682.99
270260,202308,433,344,89,454093.62,117480.7,571574.32
270270,202308,95,50,45,66000.02,59400,125400.02
270280,202308,198,126,72,166320,95040,261360
270290,202308,1188,930,258,1228941.78,340564.11,1569505.89
270300,202308,394,291,103,384121.15,135960.2,520081.35
270310,202308,840,708,132,935902.52,174240.44,1110142.96
270320,202308,784,677,107,893656.73,141240,1034896.73
270330,202308,336,291,45,384120.62,59400,443520.62
270340,202308,74,60,14,79200,18480,97680
270350,202308,79,46,33,60722.62,43560,104282.62
270360,202308,88,48,40,63360,52800,116160
270370,202308,74,57,17,75240,22440,97680
270375,202308,87,59,28,77881.32,38280,116161.32
270380,202308,1080,747,333,986041.23,439560,1425601.23
270390,202308,131,79,52,104280.2,68640.5,172920.7
270400,202308,805,623,182,822374.44,240240.92,1062615.36
270410,202308,225,171,54,225728.17,71280,297008.17
270420,202308,431,304,127,401283.69,167640.3,568923.99
270430,202308,37730,26787,10943,35379528.87,14466196.3,49845725.17
270440,202308,471,371,100,489734.57,132001.51,621736.08
270450,202308,944,571,373,753726.79,493681.01,1247407.80
270460,202308,184,146,38,192724.79,50160,242884.79
270470,202308,1811,1276,535,1687342.99,706202.82,2393545.81
270480,202308,594,476,118,628330.17,155760,784090.17
270490,202308,28,20,8,26400,10560,36960
270500,202308,484,400,84,528006.37,110880,638886.37
270510,202308,946,643,303,850030.61,399962.15,1249992.76
270520,202308,280,187,93,246841.3,122760,369601.3
270530,202308,64,51,13,67320.18,17160,84480.18
270540,202308,83,60,23,79200,30360,109560
270550,202308,1658,1283,375,1693596.59,495002.72,2188599.31
270560,202308,260,161,99,212523.08,130680,343203.08
270570,202308,626,451,175,596645.61,231000,827645.61
270580,202308,22,17,5,22440,6600,29040
270590,202308,58,48,10,63360.3,13200.08,76560.38
270600,202308,173,146,27,192725.5,36960.1,229685.6
270610,202308,264,209,55,275884.63,72600.1,348484.73
270620,202308,18,17,1,22440,1320,23760
270630,202308,3755,2810,945,3709436.5,1250050.56,4959487.06
270640,202308,920,678,242,896076.61,319442.25,1215518.86
270642,202308,225,185,40,244202.53,52800,297002.53
270644,202308,265,172,93,227042.31,122761.76,349804.07
270650,202308,352,222,130,293044.88,172922.15,465967.03
270660,202308,177,154,23,203285.08,30360,233645.08
270670,202308,3104,2372,732,3132425.86,966243.33,4098669.19
270680,202308,407,272,135,359046.52,179520,538566.52
270690,202308,1300,887,413,1170869.75,545163.75,1716033.50
270700,202308,24,19,5,25080.19,6600,31680.19
270710,202308,572,450,122,594006.42,161040,755046.42
270720,202308,228,188,40,248163.65,54120.92,302284.57
270730,202308,2009,1281,728,1692264.22,960965.79,2653230.01
270740,202308,32,23,9,30360.55,11880,42240.55
270750,202308,627,488,139,644168.09,183480.87,827648.96
270760,202308,296,217,79,286447.01,104280.76,390727.77
270770,202308,3029,2101,928,2777354.78,1226290.73,4003645.51
270780,202308,73,43,30,56760,39600.76,96360.76
270790,202308,198,131,67,172921.75,89761.24,262682.99
270800,202308,2090,1686,404,2225561.21,533280,2758841.21
270810,202308,210,171,39,225721.64,51480,277201.64
270820,202308,117,82,35,108244.24,46200,154444.24
270830,202308,892,691,201,912149.37,265321.14,1177470.51
270840,202308,1333,1045,288,1379419.68,380161.7,1759581.38
270850,202308,1586,1049,537,1384693.85,708843.16,2093537.01
270860,202308,2719,1851,868,2443358.46,1147090.69,3590449.15
270870,202308,134,81,53,106920.2,69960.2,176880.4
270880,202308,893,708,185,934590.58,244202.82,1178793.40
270890,202308,260,203,57,267961.96,75241.01,343202.97
270895,202308,81,77,4,102960,5280,108240
270900,202308,68,56,12,73922.29,15840,89762.29
270910,202308,313,265,48,349808.98,64681.54,414490.52
270915,202308,2015,1366,649,1803156.09,856681.8,2659837.89
270920,202308,399,327,72,431644.19,95040,526684.19
270930,202308,5583,4340,1243,5731561.21,1644726.23,7376287.44
270940,202308,2261,1824,437,2409046.27,576842.18,2985888.45
280010,202308,33,27,6,35640.2,7920,43560.2
280020,202308,539,455,84,600614.9,110880.97,711495.87
280030,202308,23863,15256,8607,20144273.15,11364170.89,31508444.04
280040,202308,347,216,131,285123.59,172920.4,458043.99
280050,202308,467,359,108,473887.5,142560,616447.5
280060,202308,441,291,150,384130.24,198000.74,582130.98
280067,202308,1222,887,335,1170861.41,442201.06,1613062.47
280070,202308,128,109,19,143881.96,25080,168961.96
280100,202308,730,560,170,739210.16,224400.2,963610.36
280110,202308,97,83,14,109561.89,18480,128041.89
280120,202308,751,625,126,827650.67,166320.84,993971.51
280130,202308,1927,1258,669,1663223.76,883080.9,2546304.66
280140,202308,556,460,96,607207.15,126720.2,733927.35
280150,202308,454,330,124,435610.78,165000,600610.78
280160,202308,155,118,37,155762.99,48840,204602.99
280170,202308,454,327,127,431654.88,167640.93,599295.81
280190,202308,35,28,7,36960,9240,46200
280200,202308,56,44,12,58086.37,15840.3,73926.67
280210,202308,3266,2336,930,3084820.85,1227608.02,4312428.87
280220,202308,69,58,11,76562.32,14520,91082.32
280230,202308,352,281,71,370936.88,93722.19,464659.07
280240,202308,146,136,10,180842.81,13200,194042.81
280250,202308,21,10,11,13200.1,14522.19,27722.29
280260,202308,80,69,11,91083.06,14520,105603.06
280270,202308,140,110,30,145200.58,39600.53,184801.11
280280,202308,203,138,65,182163.19,85800.09,267963.28
280290,202308,4167,3044,1123,4018147.89,1482374.38,5500522.27
280300,202308,1824,1448,376,1912704.08,497644.88,2410348.96
280310,202308,114,105,9,138601.84,11880,150481.84
280320,202308,737,507,230,669258.59,304922.33,974180.92
280330,202308,338,249,89,330007.18,118800.2,448807.38
280340,202308,465,382,83,505569.93,109562,615131.93
280350,202308,4052,3091,961,4081618.34,1268536.73,5350155.07
280360,202308,490,334,156,440896.06,205920.78,646816.84
280370,202308,97,82,15,108241.09,19800,128041.09
280380,202308,52,40,12,52800,15840,68640
280390,202308,183,155,28,204603.25,36960,241563.25
280400,202308,446,288,158,380174.96,208562.91,588737.87
280410,202308,313,262,51,345848.15,67320,413168.15
280420,202308,143,123,20,162370.46,26400.95,188771.41
280430,202308,110,88,22,116161.43,29040,145201.43
280440,202308,765,630,135,831622.68,178203.43,1009826.11
280445,202308,125,115,10,151802.64,13200.8,165003.44
280450,202308,1441,1236,205,1632876.02,270603.71,1903479.73
280460,202308,723,543,180,716774.54,237601.39,954375.93
280470,202308,79,76,3,100321.92,3960,104281.92
280480,202308,3539,2373,1166,3135213.73,1539158.69,4674372.42
280490,202308,190,177,13,233650.17,17160,250810.17
280500,202308,43,40,3,52801.04,3960.96,56762.00
280510,202308,142,108,34,142560.89,44880.74,187441.63
280520,202308,54,38,16,50161.32,21120,71281.32
280530,202308,77,50,27,66003.96,35640.38,101644.34
280540,202308,596,513,83,677171.08,109560,786731.08
280550,202308,780,717,63,946460.38,83160,1029620.38
280560,202308,507,458,49,604570.65,64680.93,669251.58
280570,202308,2591,2047,544,2703408.77,719404.98,3422813.75
280580,202308,623,492,131,649447.39,172920.96,822368.35
280590,202308,240,158,82,208575.08,108247.14,316822.22
280600,202308,445,362,83,477907.1,109560.2,587467.3
280610,202308,127,91,36,120127.72,47521.8,167649.52
280620,202308,580,465,115,613808.51,151800,765608.51
280630,202308,150,123,27,162363.47,35640.9,198004.37
280640,202308,176,142,34,187440.3,44880,232320.3
280650,202308,84,51,33,67323.4,43560,110883.4
280660,202308,133,102,31,134645.82,40920.21,175566.03
280670,202308,2179,1391,788,1837570.39,1040185.14,2877755.53
280680,202308,261,220,41,290401.5,54120,344521.5
280690,202308,80,70,10,92400,13200,105600
280700,202308,23,23,0,30360,,30360.0
280710,202308,1641,1264,377,1668513.11,497642.38,2166155.49
280720,202308,146,104,42,137282.05,55440,192722.05
280730,202308,31,28,3,36961.52,3960.05,40921.57
280740,202308,2745,2073,672,2737717.69,887044.35,3624762.04
280750,202308,224,196,28,258726.52,36960.8,295687.32
280760,202308,1019,681,338,898945.04,447481.71,1346426.75
290010,202308,202,142,60,187441.11,79200,266641.11
290020,202308,213,189,24,249482,31680.9,281162.9
290030,202308,660,426,234,562328.45,310201.12,872529.57
290035,202308,143,114,29,150481.71,38280.93,188762.64
290040,202308,279,201,78,265326.28,102960,368286.28
290050,202308,98,79,19,104280,25080,129360
290060,202308,253,108,145,142561.05,191400,333961.05
290070,202308,6625,3144,3481,4151528.12,4598928.55,8750456.67
290080,202308,511,229,282,302283.18,372240.09,674523.27
290090,202308,329,157,172,207240.2,227040.36,434280.56
290100,202308,1856,1184,672,1562911.35,889682.81,2452594.16
290110,202308,975,545,430,719429.79,567607.52,1287037.31
290115,202308,186,170,16,225723.12,21120,246843.12
290120,202308,886,599,287,790690.19,378841.37,1169531.56
290130,202308,507,312,195,411842.97,257400.85,669243.82
290135,202308,300,224,76,295685.69,100320.1,396005.79
290140,202308,346,291,55,384125.68,72600.36,456726.04
290150,202308,154,106,48,139920.1,63360.01,203280.11
290160,202308,250,196,54,258728.25,71280.85,330009.10
290170,202308,118,87,31,114841.89,40920,155761.89
290180,202308,209,150,59,198002.23,77880.2,275882.43
290190,202308,300,231,69,304923.29,91080.2,396003.49
290195,202308,316,219,97,289083.19,128040.1,417123.29
290200,202308,268,215,53,283800.37,69960.1,353760.47
290205,202308,175,110,65,145200.4,85800,231000.4
290210,202308,1350,982,368,1296274.57,485762.85,1782037.42
290220,202308,166,102,64,134647.45,84481.1,219128.55
290225,202308,307,121,186,159722.02,245520.59,405242.61
290230,202308,103,63,40,83162.37,52800,135962.37
290240,202308,401,139,262,183481.4,345840.55,529321.95
290250,202308,251,232,19,306247.41,25080,331327.41
290260,202308,373,290,83,382817.8,109564.03,492381.83
290265,202308,202,176,26,232324.34,34320.13,266644.47
290270,202308,1448,1191,257,1572179.15,340560.6,1912739.75
290280,202308,536,373,163,492367.07,215160.4,707527.47
290290,202308,1597,982,615,1296264.04,813121.49,2109385.53
290300,202308,397,337,60,444849.2,79201.73,524050.93
290310,202308,285,139,146,183481.29,192720,376201.29
290320,202308,4709,2808,1901,3709351.28,2514620.66,6223971.94
290323,202308,222,190,32,250806.65,42240.2,293046.85
290327,202308,179,140,39,184805.56,51480,236285.56
290330,202308,136,67,69,88440.29,91080,179520.29
290340,202308,826,348,478,460696.42,630963.1,1091659.52
290350,202308,741,448,293,591365.78,388081.5,979447.28
290360,202308,320,253,67,333964.95,88440,422404.95
290370,202308,906,423,483,558361.3,638881.61,1197242.91
290380,202308,356,229,127,302283.73,167641.86,469925.59
290390,202308,2586,1602,984,2114692.53,1302849.23,3417541.76
290395,202308,244,146,98,192720.67,129360,322080.67
290400,202308,308,227,81,299641.65,106920,406561.65
290405,202308,257,222,35,293043.62,46200,339243.62
290410,202308,696,578,118,762965.54,155760,918725.54
290420,202308,300,246,54,324722.53,71280,396002.53
290430,202308,528,337,191,444842.76,252120,696962.76
290440,202308,96,76,20,100320.4,26400,126720.4
290450,202308,203,146,57,192720,75240,267960
290460,202308,2138,1265,873,1671157.49,1152362.01,2823519.50
290470,202308,1415,637,778,840862.8,1029607.94,1870470.74
290475,202308,590,551,39,727332.66,51480,778812.66
290480,202308,192,111,81,146520.26,106920,253440.26
290485,202308,250,223,27,294362.88,35640,330002.88
290490,202308,1376,968,408,1277780.41,538563.83,1816344.24
290500,202308,870,478,392,633610.13,517442.76,1151052.89
290510,202308,187,151,36,199332.1,47520.35,246852.45
290515,202308,206,130,76,171601.71,100320,271921.71
290520,202308,1520,1010,510,1333210.46,673201.08,2006411.54
290530,202308,284,249,35,328694.36,46200.93,374895.29
290540,202308,150,70,80,92400,105600,198000
290550,202308,189,154,35,203281.48,46200,249481.48
290560,202308,3364,1545,1819,2043413.08,2403733.7,4447146.78
290570,202308,7900,3748,4152,4951515.91,5483362.65,10434878.56
290580,202308,1374,829,545,1094298.85,719401.55,1813700.40
290590,202308,606,486,120,644199.49,158404.3,802603.79
290600,202308,1952,1335,617,1764905.08,814450.77,2579355.85
290610,202308,176,163,13,215168.09,17160,232328.09
290620,202308,409,361,48,476529.43,63360.6,539890.03
290630,202308,2103,896,1207,1182752.46,1593245.78,2775998.24
290640,202308,140,110,30,145203.78,39600,184803.78
290650,202308,2293,1073,1220,1416405.18,1610409.66,3026814.84
290660,202308,289,240,49,316801.14,64680.72,381481.86
290670,202308,1168,588,580,776175.7,765607.73,1541783.43
290680,202308,1356,1083,273,1429581.2,360362.27,1789943.47
290682,202308,375,281,94,370921.71,124080,495001.71
290685,202308,275,163,112,215164.98,147840.2,363005.18
290687,202308,1329,878,451,1159200.96,595321.49,1754522.45
290689,202308,153,74,79,97680,104280,201960
290690,202308,574,273,301,361687.63,397321.82,759009.45
290700,202308,272,140,132,184807.73,174242.61,359050.34
290710,202308,859,603,256,795973.78,337923.85,1133897.63
290720,202308,1193,938,255,1239521.11,336601.65,1576122.76
290730,202308,1335,790,545,1044140.41,719405.3,1763545.71
290740,202308,32,27,5,35640,6600,42240
290750,202308,1604,713,891,942507.5,1176135.64,2118643.14
290755,202308,88,74,14,99000,18480,117480
290760,202308,270,234,36,308889.43,47520.86,356410.29
290770,202308,199,190,9,250804.17,11880,262684.17
290780,202308,1207,972,235,1283068.47,310204.59,1593273.06
290790,202308,442,302,140,398646.47,184802.91,583449.38
290800,202308,2526,1037,1489,1370188.54,1965489.05,3335677.59
290810,202308,528,358,170,472566.27,224400.52,696966.79
290820,202308,439,254,185,335286.8,244203.95,579490.75
290830,202308,519,368,151,485766.56,200640.2,686406.76
290840,202308,2001,1275,726,1683043.81,958326.01,2641369.82
290850,202308,1172,599,573,790692.92,756366.01,1547058.93
290860,202308,749,378,371,498967.9,489722.22,988690.12
290870,202308,676,471,205,621727.39,271920.61,893648.00
290880,202308,129,70,59,92400.31,77880,170280.31
290890,202308,549,333,216,439563.23,285123.06,724686.29
290900,202308,165,125,40,165000.94,52800,217800.94
290910,202308,422,320,102,422401.31,134640,557041.31
290920,202308,225,200,25,264531.18,33000,297531.18
290930,202308,580,443,137,584775.99,180842.1,765618.09
290940,202308,222,189,33,249481,44880,294361
290950,202308,170,98,72,129360,95040,224400
290960,202308,540,387,153,510845.22,201961.08,712806.30
290970,202308,244,213,31,281162.36,40920.2,322082.56
290980,202308,2173,1535,638,2026240.15,842168.54,2868408.69
290990,202308,457,381,76,502943.67,100323.59,603267.26
291000,202308,966,325,641,429001.8,846120,1275121.8
291005,202308,2940,1263,1677,1667232.1,2213670.39,3880902.49
291010,202308,136,118,18,155760.94,23760,179520.94
291020,202308,84,69,15,91080,19800,110880
291030,202308,120,87,33,114841.73,44880,159721.73
291040,202308,684,412,272,543842.06,359040.41,902882.47
291050,202308,1672,864,808,1140509.66,1067888.98,2208398.64
291060,202308,1853,1032,821,1362267.32,1085048.06,2447315.38
291070,202308,2127,1607,520,2123927.38,686407.94,2810335.32
291072,202308,7789,3042,4747,4016926.47,6267403.46,10284329.93
291075,202308,274,226,48,298320.6,63360,361680.6
291077,202308,62,45,17,59400,23760,83160
291080,202308,23510,10116,13394,13357556.35,17697474.48,31055030.83
291085,202308,293,238,55,314162.76,72600.65,386763.41
291090,202308,260,106,154,139921.4,203280,343201.4
291100,202308,987,349,638,460680.37,842160,1302840.37
291110,202308,477,363,114,479167.53,150480.6,629648.13
291120,202308,2569,1398,1171,1845387.5,1547048.14,3392435.64
291125,202308,71,37,34,48840,44880,93720
291130,202308,194,165,29,217804.06,38280,256084.06
291140,202308,153,124,29,163680.81,38280.1,201960.91
291150,202308,368,139,229,183480.79,302280,485760.79
291160,202308,433,333,100,439574.16,132001.57,571575.73
291165,202308,56,42,14,55440,18480.62,73920.62
291170,202308,3706,1850,1856,2442050.87,2451247.19,4893298.06
291180,202308,1286,559,727,739209.47,959642.17,1698851.64
291185,202308,129,119,10,157082.69,13200,170282.69
291190,202308,1442,709,733,935901.67,968889.88,1904791.55
291200,202308,186,136,50,179520.9,66000,245520.9
291210,202308,2617,1097,1520,1449384.11,2007729.63,3457113.74
291220,202308,347,267,80,352442.53,105600.2,458042.73
291230,202308,971,368,603,485768.42,795963.08,1281731.50
291240,202308,408,375,33,495002.73,43560,538562.73
291250,202308,418,344,74,454080.69,97680,551760.69
291260,202308,69,57,12,75240.1,15840,91080.1
291270,202308,782,376,406,497658.55,535925.34,1033583.89
291280,202308,363,174,189,229683.07,249480.3,479163.37
291290,202308,1689,899,790,1186724.49,1044135.47,2230859.96
291300,202308,262,191,71,252123.05,93720,345843.05
291310,202308,237,205,32,270605.54,42240.7,312846.24
291320,202308,1332,925,407,1221039.26,538562.29,1759601.55
291330,202308,145,121,24,161042.34,31680.2,192722.54
291340,202308,257,160,97,211205.37,128041.95,339247.32
291345,202308,125,91,34,120120.4,44880,165000.4
291350,202308,1925,764,1161,1008486.6,1533840.4,2542327.0
291360,202308,9366,4432,4934,5851819.91,6522247.29,12374067.20
291370,202308,1290,793,497,1049443.77,656049.73,1705493.50
291380,202308,284,219,65,289082.38,85800,374882.38
291390,202308,4373,1949,2424,2575371.51,3203655.34,5779026.85
291400,202308,2245,1547,698,2042097.15,921373.14,2963470.29
291410,202308,252,206,46,271923.3,60720,332643.3
291420,202308,131,100,31,132000.67,40920,172920.67
291430,202308,190,116,74,153120,97680,250800
291440,202308,578,472,106,624376.24,141240.2,765616.44
291450,202308,1083,723,360,954386.1,476525.31,1430911.41
291460,202308,2297,1778,519,2348361.23,686412.83,3034774.06
291465,202308,2459,1196,1263,1580070.31,1668486.58,3248556.89
291470,202308,3104,1563,1541,2063204.91,2038096.55,4101301.46
291480,202308,13127,5752,7375,7602161.08,9748260.97,17350422.05
291490,202308,751,302,449,398644.99,594000.2,992645.19
291500,202308,377,232,145,307267.11,194040.47,501307.58
291510,202308,1175,473,702,624363.39,926640.38,1551003.77
291520,202308,951,442,509,583454.47,671880.4,1255334.87
291530,202308,933,283,650,373561.75,860640,1234201.75
291535,202308,150,122,28,161040.19,36960.87,198001.06
291540,202308,343,116,227,153123.21,299641.86,452765.07
291550,202308,1327,639,688,844812.09,908161.97,1752974.06
291560,202308,5370,2746,2624,3626088.43,3463688.86,7089777.29
291570,202308,255,137,118,180841.39,155762.09,336603.48
291580,202308,1318,841,477,1110140.36,632282.29,1742422.65
291590,202308,127,64,63,84480.55,83160,167640.55
291600,202308,1202,613,589,809175.81,777483.98,1586659.79
291610,202308,1531,742,789,980817.79,1041502.7,2022320.49
291620,202308,586,276,310,364330.59,409202.87,773533.46
291630,202308,485,151,334,199321.55,440880.2,640201.75
291640,202308,4415,2147,2268,2834108.75,2996422.36,5830531.11
291650,202308,488,348,140,459378.59,184801.77,644180.36
291660,202308,373,156,217,205922.29,287762.25,493684.54
291670,202308,157,96,61,126720.84,80520.73,207241.57
291680,202308,663,411,252,542552.63,332643.66,875196.29
291685,202308,666,383,283,506892.66,373563.36,880456.02
291690,202308,539,353,186,465962.6,245521.22,711483.82
291700,202308,1121,859,262,1135226.24,347162.14,1482388.38
291710,202308,1656,804,852,1061300.99,1124645.44,2185946.43
291720,202308,483,330,153,435601.42,201960.9,637562.32
291730,202308,996,581,415,766944.7,547804.76,1314749.46
291733,202308,331,220,111,290402.51,146520.13,436922.64
291735,202308,102,77,25,101640.57,33000.31,134640.88
291740,202308,352,269,83,355080.13,109560,464640.13
291750,202308,2626,1643,983,2170180.68,1297579.66,3467760.34
291760,202308,3257,1815,1442,2395812.41,1904762.24,4300574.65
291770,202308,813,547,266,722073.05,351128.07,1073201.12
291780,202308,120,79,41,104281.07,54120.78,158401.85
291790,202308,173,97,76,128040,100321.27,228361.27
291800,202308,11291,4970,6321,6561933.57,8349081.8,14911015.37
291810,202308,1131,847,284,1118065.34,374884.84,1492950.18
291820,202308,311,227,84,299640.11,110880,410520.11
291830,202308,1060,454,606,599299.52,799927.03,1399226.55
291835,202308,589,547,42,722051.11,55440.08,777491.19
291840,202308,6070,3064,3006,4044691.13,3973280.17,8017971.30
291845,202308,300,104,196,137280,258720,396000
291850,202308,330,288,42,380172.15,55441.56,435613.71
291855,202308,272,113,159,149160.95,209880.48,359041.43
291860,202308,159,103,56,135960.52,73920.99,209881.51
291870,202308,92,44,48,58080,63360,121440
291875,202308,160,147,13,194040.3,17160.84,211201.14
291880,202308,445,369,76,487093.87,100322.73,587416.60
291890,202308,267,92,175,121440.2,231000,352440.2
291900,202308,58,36,22,47520,29040,76560
291905,202308,118,88,30,116161.49,39600.19,155761.68
291910,202308,153,127,26,167641.38,34320.1,201961.48
291915,202308,479,419,60,553101.57,79200.8,632302.37
291920,202308,6946,3329,3617,4394474.73,4779803.49,9174278.22
291930,202308,181,110,71,145202,93720.25,238922.25
291940,202308,444,262,182,345842.44,240240,586082.44
291950,202308,1275,992,283,1309448.26,374880,1684328.26
291955,202308,1602,959,643,1265911.92,848767.91,2114679.83
291960,202308,218,159,59,209881.08,77880,287761.08
291970,202308,820,603,217,795977.85,286442.28,1082420.13
291980,202308,1497,1289,208,1701512.83,274562.9,1976075.73
291990,202308,158,147,11,194043.47,14520,208563.47
291992,202308,242,118,124,155768.88,163683.6,319452.48
291995,202308,206,136,70,179522.09,92400,271922.09
292000,202308,447,318,129,419766.59,170280.81,590047.40
292010,202308,398,274,124,363000.41,163680.6,526681.01
292020,202308,338,243,95,320763.55,125400,446163.55
292030,202308,164,127,37,167642.43,48840,216482.43
292040,202308,623,342,281,451440,370920,822360
292045,202308,132,116,16,153120.7,21120.49,174241.19
292050,202308,1006,734,272,968890.42,359041.48,1327931.90
292060,202308,1018,830,188,1096955.08,248163.09,1345118.17
292070,202308,78,29,49,38280.2,64680,102960.2
292080,202308,189,133,56,175560.41,73920,249480.41
292090,202308,615,232,383,306241,505560.9,811801.9
292100,202308,1812,799,1013,1054728.48,1338508.79,2393237.27
292105,202308,176,160,16,211200,21120,232320
292110,202308,2430,919,1511,1213105.27,1995846.99,3208952.26
292120,202308,764,572,192,756393.81,253441.12,1009834.93
292130,202308,526,288,238,380164.29,314160.73,694325.02
292140,202308,231,186,45,245525.73,59400.34,304926.07
292145,202308,187,110,77,145200,101640,246840
292150,202308,1606,1348,258,1779387.44,340563.37,2119950.81
292160,202308,189,147,42,194040.7,55440.09,249480.79
292170,202308,1231,1032,199,1363607,262684.02,1626291.02
292180,202308,266,187,79,246840,104280.1,351120.1
292190,202308,161,106,55,139921.14,72600.97,212522.11
292200,202308,1555,581,974,766932.76,1288325.72,2055258.48
292205,202308,137,116,21,153120.91,27720,180840.91
292210,202308,434,276,158,364328.67,208560.66,572889.33
292220,202308,41,29,12,38280.4,15840,54120.4
292225,202308,71,55,16,72602.82,21120.64,93723.46
292230,202308,1062,824,238,1089032.13,314161.67,1403193.80
292240,202308,687,505,182,666620.71,240240.5,906861.21
292250,202308,1709,1105,604,1458644.94,798607,2257251.94
292260,202308,445,264,181,348484.9,238921.6,587406.5
292265,202308,269,205,64,270603.84,84480.56,355084.40
292270,202308,744,385,359,508207.6,473880,982087.6
292273,202308,219,131,88,172920.9,116160.02,289080.92
292275,202308,198,105,93,138600.5,122760,261360.5
292280,202308,164,114,50,150480,66000,216480
292285,202308,104,80,24,105600,31680,137280
292290,202308,691,463,228,611170.8,300960.7,912131.5
292300,202308,2049,815,1234,1077141.91,1628902.69,2706044.60
292303,202308,153,107,46,141242.39,60720.7,201963.09
292305,202308,127,93,34,122761.19,44880,167641.19
292310,202308,1059,710,349,937219.52,460685.72,1397905.24
292320,202308,641,483,158,637568.86,208561.82,846130.68
292330,202308,183,121,62,159720.73,81840,241560.73
292335,202308,342,268,74,353763.52,97680,451443.52
292340,202308,596,418,178,551764.32,234960.55,786724.87
292350,202308,293,150,143,198001.23,188760,386761.23
292360,202308,794,596,198,786722.88,261361.01,1048083.89
292370,202308,748,573,175,757689.8,231000.97,988690.77
292380,202308,629,525,104,693016.72,137280.2,830296.92
292390,202308,385,156,229,205922.72,303601.08,509523.80
292400,202308,4172,2534,1638,3346300.05,2163491.21,5509791.26
292405,202308,288,189,99,249480.57,130680,380160.57
292410,202308,110,70,40,92400.7,52800,145200.7
292420,202308,275,240,35,316800.9,46200,363000.9
292430,202308,569,408,161,538563.16,212520.51,751083.67
292440,202308,713,592,121,781455.53,159722.13,941177.66
292450,202308,252,192,60,253442.48,79200.2,332642.68
292460,202308,539,409,130,539883.94,171601.26,711485.20
292465,202308,224,192,32,253441.69,42240.1,295681.79
292467,202308,193,129,64,170280.27,84480,254760.27
292470,202308,335,224,111,297000.59,146520,443520.59
292480,202308,433,284,149,374888.83,196681.32,571570.15
292490,202308,267,200,67,265321.82,88442.43,353764.25
292500,202308,1013,515,498,679821.65,658687.08,1338508.73
292510,202308,3918,1938,1980,2558213.3,2617577.09,5175790.39
292520,202308,1336,642,694,847467.9,916091.69,1763559.59
292525,202308,491,369,122,487093.51,161042.76,648136.27
292530,202308,5624,2336,3288,3083588.5,4344156.37,7427744.87
292540,202308,501,289,212,381482.91,279841.65,661324.56
292550,202308,1202,672,530,887054.21,699604.97,1586659.18
292560,202308,341,309,32,407893.84,42240.16,450134.00
292570,202308,375,287,88,378842.19,116160,495002.19
292575,202308,619,453,166,597985.47,219122.28,817107.75
292580,202308,1108,757,351,999248.34,463322.83,1462571.17
292590,202308,609,539,70,711486.56,92400.8,803887.36
292593,202308,160,127,33,167640.58,43560,211200.58
292595,202308,236,184,52,242884.02,68640,311524.02
292600,202308,1372,974,398,1285720.46,526689.27,1812409.73
292610,202308,113,94,19,124084.27,25080.4,149164.67
292620,202308,557,462,95,609873.59,125401.73,735275.32
292630,202308,1702,926,776,1223665.49,1026964.96,2250630.45
292640,202308,942,652,290,861973.57,384125.3,1246098.87
292650,202308,197,147,50,194046.78,66000,260046.78
292660,202308,2150,1496,654,1974784.84,863292.67,2838077.51
292665,202308,144,100,44,132001.45,58080,190081.45
292670,202308,406,308,98,406562.18,129360.21,535922.39
292680,202308,271,205,66,270601.88,87120,357721.88
292690,202308,218,147,71,194040.7,93720,287760.7
292700,202308,1100,725,375,957023.65,495007,1452030.65
292710,202308,118,100,18,132001.31,23760.31,155761.62
292720,202308,1104,639,465,844809.45,613800.78,1458610.23
292730,202308,247,117,130,154441.51,171600.4,326041.91
292740,202308,87384,41422,45962,54703220.53,60727662.49,115430883.02
292750,202308,438,321,117,423729.22,154443.68,578172.90
292760,202308,365,313,52,413162.12,68640.27,481802.39
292770,202308,973,404,569,533288.47,751087.93,1284376.40
292780,202308,58,25,33,33001.52,43560.54,76562.06
292790,202308,822,447,375,590044.66,495000.2,1085044.86
292800,202308,1380,827,553,1094299.58,729965.81,1824265.39
292805,202308,425,163,262,215160.11,345841.02,561001.13
292810,202308,1971,1167,804,1541785.42,1061282.96,2603068.38
292820,202308,743,629,114,830310.72,150482.8,980793.52
292830,202308,146,111,35,146525.14,46200.96,192726.10
292840,202308,763,614,149,811826.81,196683.35,1008510.16
292850,202308,156,106,50,139922.42,66002.02,205924.44
292860,202308,2265,1303,962,1720022.85,1269853.17,2989876.02
292870,202308,4099,2675,1424,3532397.63,1879688.07,5412085.70
292880,202308,1556,1030,526,1359623.85,695645.78,2055269.63
292890,202308,595,496,99,654737.13,130681.97,785419.10
292895,202308,155,111,44,146520.75,58080,204600.75
292900,202308,361,264,97,349814.06,128043.11,477857.17
292905,202308,549,273,276,360365.58,364324.03,724689.61
292910,202308,582,434,148,574207.86,195361.03,769568.89
292920,202308,666,300,366,396011.28,483126.88,879138.16
292925,202308,498,454,44,599281.62,58081.22,657362.84
292930,202308,802,491,311,648131.62,410523.16,1058654.78
292935,202308,281,122,159,162360.73,209881.45,372242.18
292937,202308,218,146,72,192721.65,95040,287761.65
292940,202308,207,157,50,207241.25,66000,273241.25
292950,202308,1525,735,790,970226.68,1042808.87,2013035.55
292960,202308,531,380,151,501618.73,199321.5,700940.23
292970,202308,272,200,72,264004.79,95042.4,359047.19
292975,202308,105,55,50,72605.45,66000.73,138606.18
292980,202308,376,261,115,344525.07,151801.94,496327.01
292990,202308,1388,1050,338,1386009.89,446161.03,1832170.92
293000,202308,119,83,36,109562.33,47520,157082.33
293010,202308,3331,1966,1365,2595254.04,1805792.62,4401046.66
293015,202308,655,539,116,711494,153120,864614
293020,202308,377,297,80,392053.89,105603.01,497656.90
293030,202308,585,524,61,691689.11,80520,772209.11
293040,202308,398,317,81,418442.75,106920.68,525363.43
293050,202308,3394,1986,1408,2622909.54,1858579.69,4481489.23
293060,202308,244,196,48,258731.17,63360.5,322091.67
293070,202308,4320,2163,2157,2856588.02,2851233.98,5707822.00
293075,202308,100,70,30,92400.81,39600,132000.81
293076,202308,93,69,24,91082.08,31680,122762.08
293077,202308,681,384,297,506902.26,392044.44,898946.70
293080,202308,449,397,52,524047.76,68640.66,592688.42
293090,202308,143,127,16,167640,21120,188760
293100,202308,582,393,189,518768.46,249480.71,768249.17
293105,202308,374,276,98,364322.21,129360,493682.21
293110,202308,125,80,45,105605.51,59402.74,165008.25
293120,202308,312,224,88,295687.5,116163.93,411851.43
293130,202308,263,173,90,228364.52,118800,347164.52
293135,202308,9079,3715,5364,4903931.18,7083140.77,11987071.95
293140,202308,210,126,84,166323.26,110880.79,277204.05
293150,202308,338,293,45,386768.46,59400.2,446168.66
293160,202308,447,286,161,377523.32,212520,590043.32
293170,202308,281,172,109,227046.64,143882.51,370929.15
293180,202308,652,450,202,594001.26,266640,860641.26
293190,202308,1491,1023,468,1350391.76,617767.68,1968159.44
293200,202308,630,544,86,718097.23,113520,831617.23
293210,202308,459,352,107,464650.15,141240,605890.15
293220,202308,2570,1172,1398,1548383.73,1846687.68,3395071.41
293230,202308,2018,758,1260,1000579.5,1664523.95,2665103.45
293240,202308,242,217,25,286450.16,33000.4,319450.56
293245,202308,132,107,25,141242.15,33000,174242.15
293250,202308,833,361,472,476534.05,623052.65,1099586.70
293260,202308,347,269,78,355082.29,102960,458042.29
293270,202308,1229,550,679,726006.95,896280.1,1622287.05
293280,202308,333,230,103,303602.65,135961.42,439564.07
293290,202308,3300,2122,1178,2803755.06,1561572.82,4365327.88
293300,202308,971,666,305,879128.96,402600.24,1281729.20
293305,202308,206,157,49,207241.6,64680.65,271922.25
293310,202308,181,135,46,178201.92,60720.7,238922.62
293315,202308,191,147,44,194044.49,58081.26,252125.75
293317,202308,99,75,24,99000.2,31680,130680.2
293320,202308,1383,709,674,937260.54,889703.92,1826964.46
293325,202308,216,93,123,122760,162360,285120
293330,202308,16318,7636,8682,10082436.43,11469592.82,21552029.25
293340,202308,299,211,88,278521.4,116160,394681.4
293345,202308,279,234,45,311525.25,59400,370925.25
293350,202308,621,403,218,531970.45,287761.64,819732.09
293360,202308,1583,1109,474,1463914.62,625687.09,2089601.71
310010,202308,148,80,68,105600.77,89760.04,195360.81
310020,202308,1020,556,464,733936.81,613804.45,1347741.26
310030,202308,329,259,70,341884.9,92402.44,434287.34
310040,202308,51,34,17,44880,22440,67320
310050,202308,175,113,62,149160.21,81840,231000.21
310060,202308,297,217,80,287504.63,105600.67,393105.30
310070,202308,24,16,8,21120.44,10560.2,31680.64
310080,202308,53,36,17,47520,22440.83,69960.83
310090,202308,1199,674,525,891017.11,693005.67,1584022.78
310100,202308,409,284,125,374891.01,166322.72,541213.73
310110,202308,753,403,350,531969.6,462003.88,993973.48
310120,202308,461,261,200,344520.89,264000.73,608521.62
310130,202308,37,22,15,29040.2,19800,48840.2
310140,202308,25,10,15,13200,19800.76,33000.76
310150,202308,1285,834,451,1100914.18,595330.06,1696244.24
310160,202308,2302,1138,1164,1503513.15,1539129.5,3042642.65
310163,202308,106,64,42,84480,55440,139920
310170,202308,2774,1344,1430,1775441.54,1887613.26,3663054.80
310180,202308,218,104,114,137281.44,150480,287761.44
310190,202308,527,346,181,456725.03,238921.54,695646.57
310200,202308,443,278,165,366963.53,217800.2,584763.73
310205,202308,90,64,26,84480.93,34320,118800.93
310210,202308,285,228,57,300962,75240,376202
310220,202308,70,45,25,59400.3,33000,92400.3
310230,202308,310,223,87,294363.71,114840,409203.71
310240,202308,135,108,27,142560,35640,178200
310250,202308,100,80,20,105601.93,27720,133321.93
310260,202308,821,445,376,588739.58,498963.79,1087703.37
310270,202308,306,201,105,265326.58,138600.14,403926.72
310280,202308,439,304,135,401281.84,178200,579481.84
310285,202308,216,168,48,221761.95,63360.48,285122.43
310290,202308,243,131,112,172922.25,147840,320762.25
310300,202308,197,159,38,209882.13,50160,260042.13
310310,202308,19,16,3,21120,3960,25080
310320,202308,31,12,19,15840.18,25080.76,40920.94
310330,202308,51,38,13,50160.24,17160.66,67320.90
310340,202308,2036,1465,571,1935150.74,753722.59,2688873.33
310350,202308,2991,1523,1468,2011750.3,1937768.59,3949518.89
310360,202308,54,40,14,52800,18480.25,71280.25
310370,202308,148,123,25,162360,33000,195360
310375,202308,112,42,70,55440.69,92401.93,147842.62
310380,202308,52,34,18,44880,23760,68640
310390,202308,108,69,39,91081.55,51480,142561.55
310400,202308,2816,1882,934,2485654.99,1232890,3718544.99
310410,202308,129,78,51,102961.04,67320,170281.04
310420,202308,735,387,348,510850.51,460681.49,971532.00
310430,202308,304,194,110,256081.81,146520,402601.81
310440,202308,84,55,29,72600.02,38280,110880.02
310445,202308,91,78,13,102960.71,17160,120120.71
310450,202308,708,475,233,627013.92,307561.29,934575.21
310460,202308,277,190,87,250802.36,114840.56,365642.92
310470,202308,580,374,206,493688.65,273242.01,766930.66
310480,202308,111,73,38,96360,50160,146520
310490,202308,644,321,323,423726.07,426361.11,850087.18
310500,202308,145,64,81,84481.74,106920,191401.74
310510,202308,652,459,193,605893.1,256080.91,861974.01
310520,202308,158,109,49,143882.38,64680,208562.38
310530,202308,135,57,78,75240.91,102960,178200.91
310540,202308,541,303,238,399970.65,314162.05,714132.70
310550,202308,88,61,27,80520.88,35640,116160.88
310560,202308,3496,2398,1098,3165933.43,1450685.25,4616618.68
310570,202308,126,82,44,108240,58080,166320
310590,202308,446,268,178,353769.14,236280.7,590049.84
310600,202308,152,71,81,93721.4,106920,200641.4
310610,202308,41,14,27,18480.04,35640,54120.04
310620,202308,56701,26981,29720,35639648.17,39257034.42,74896682.59
310630,202308,839,516,323,681137.31,429001.91,1110139.22
310640,202308,170,110,60,145200.2,79200.2,224400.4
310650,202308,189,170,19,224400.61,25080,249480.61
310660,202308,118,79,39,104280.2,52800,157080.2
310665,202308,75,52,23,68640,30360,99000
310670,202308,8296,3592,4704,4749532.43,6214587.27,10964119.70
310680,202308,63,42,21,55440,27720,83160
310690,202308,641,457,184,604570.2,242882.44,847452.64
310700,202308,62,38,24,50160.2,31680.97,81841.17
310710,202308,1376,932,444,1231577.12,587405.98,1818983.10
310720,202308,164,46,118,60720,155760,216480
310730,202308,1736,1171,565,1545775.78,745814.37,2291590.15
310740,202308,1105,600,505,792027.84,666605.65,1458633.49
310750,202308,271,177,94,233642.09,124080.37,357722.46
310760,202308,81,63,18,83161.85,23760,106921.85
310770,202308,85,41,44,54120.1,58080,112200.1
310780,202308,395,318,77,421085.86,101640.6,522726.46
310790,202308,128,101,27,133320.78,35640.59,168961.37
310800,202308,509,241,268,318121.98,353760,671881.98
310810,202308,191,125,66,165000.84,87120.59,252121.43
310820,202308,316,254,62,335287.62,81840.04,417127.66
310825,202308,208,177,31,233641.3,40920,274561.3
310830,202308,489,222,267,293043.45,352442.02,645485.47
310840,202308,399,250,149,330002.15,196680.83,526682.98
310850,202308,80,65,15,85800.95,19800,105600.95
310855,202308,483,382,101,504246.53,133320,637566.53
310860,202308,1746,1288,458,1700213.32,605889.43,2306102.75
310870,202308,67,56,11,73920.6,14520,88440.6
310880,202308,100,77,23,101640,30360,132000
310890,202308,310,181,129,240242.06,171600,411842.06
310900,202308,691,323,368,426367.45,485763.77,912131.22
310910,202308,257,169,88,223080.88,116160,339240.88
310920,202308,455,263,192,347169.96,253448.53,600618.49
310925,202308,47,39,8,51480.86,11880,63360.86
310930,202308,1467,996,471,1316058.46,621725.69,1937784.15
310940,202308,741,359,382,473896.43,505565.4,979461.83
310945,202308,161,106,55,139920.68,72600,212520.68
310950,202308,224,178,46,234962.23,60720,295682.23
310960,202308,76,29,47,38281.7,62041.57,100323.27
310970,202308,181,105,76,138603.52,100320,238923.52
310980,202308,55,39,16,51486.9,21120,72606.9
310990,202308,167,91,76,120120.02,100321.05,220441.07
311000,202308,948,487,461,642851.07,608523.87,1251374.94
311010,202308,56,43,13,56760.94,17160,73920.94
311020,202308,46,31,15,40920.55,19800,60720.55
311030,202308,431,237,194,312842.25,256081.34,568923.59
311040,202308,37,30,7,39600,9240,48840
311050,202308,560,212,348,279840.84,459361.58,739202.42
311060,202308,901,494,407,653411.37,538563.62,1191974.99
311070,202308,378,171,207,225722.47,273240,498962.47
311080,202308,131,73,58,96361.68,76560.4,172922.08
311090,202308,382,193,189,254763.47,249481.05,504244.52
311100,202308,603,366,237,483124.91,312840.25,795965.16
311110,202308,732,519,213,685098.88,281165.98,966264.86
311115,202308,87,60,27,79200.58,35640.2,114840.78
311120,202308,1200,674,526,891025.74,695646.26,1586672.00
311130,202308,292,168,124,223085.44,163680,386765.44
311140,202308,176,100,76,132004.11,100322.18,232326.29
311150,202308,347,221,126,291724.35,166320,458044.35
311160,202308,827,582,245,769571.22,323401.16,1092972.38
311170,202308,103,83,20,109561.35,26400,135961.35
311180,202308,331,226,105,299649.16,138600.75,438249.91
311190,202308,39,17,22,22440,29040,51480
311200,202308,353,242,111,319442.07,147840.9,467282.97
311205,202308,39,32,7,42240,9240,51480
311210,202308,38,33,5,43560,6600,50160
311220,202308,32,29,3,38280,3960,42240
311230,202308,1796,1213,583,1601213.53,772208.21,2373421.74
311240,202308,94,65,29,85803.92,38280.5,124084.42
311250,202308,58,25,33,33000,43560,76560
311260,202308,574,351,223,463328.18,294360.14,757688.32
311265,202308,149,99,50,130680.1,66000,196680.1
311270,202308,296,201,95,265324.38,126721.72,392046.10
311280,202308,208,90,118,120121.3,155760,275881.3
311290,202308,117,100,17,132001.85,22440,154441.85
311300,202308,629,410,219,541209.36,289081.35,830290.71
311310,202308,19,16,3,21120,3960,25080
311320,202308,688,511,177,674532.72,233641.53,908174.25
311330,202308,1313,946,367,1248749.68,485770.83,1734520.51
311340,202308,2915,2042,873,2696825.88,1155005.44,3851831.32
311350,202308,276,211,65,278523.31,85800,364323.31
311360,202308,170,104,66,137281.44,87120,224401.44
311370,202308,1301,555,746,733948.75,984730.18,1718678.93
311380,202308,7,6,1,7920,1320,9240
311390,202308,266,155,111,204602.78,146520.2,351122.98
311400,202308,138,83,55,109560.8,72600,182160.8
311410,202308,140,67,73,88440.95,96360,184800.95
311420,202308,344,169,175,223085.18,231001.22,454086.40
311430,202308,919,604,315,797288.98,415800.5,1213089.48
311440,202308,499,333,166,439569.91,219121.87,658691.78
311450,202308,328,191,137,252121.57,180840,432961.57
311455,202308,284,192,92,253446.51,121441.57,374888.08
311460,202308,139,65,74,85800.3,97680,183480.3
311470,202308,37,18,19,23760,25080,48840
311480,202308,67,39,28,51480,36960,88440
311490,202308,12,6,6,7920,7920,15840
311500,202308,35,19,16,25080,21120,46200
311510,202308,862,589,273,777499.32,360360.93,1137860.25
311520,202308,41,35,6,46200,7920,54120
311530,202308,2015,1443,572,1907499.68,755043.78,2662543.46
311535,202308,74,45,29,59400.84,38280.52,97681.36
311540,202308,35,30,5,39600.16,6600,46200.16
311545,202308,190,135,55,178203.73,72600,250803.73
311547,202308,64,50,14,66000,18480.94,84480.94
311550,202308,773,360,413,475209.15,546482.09,1021691.24
311560,202308,44,27,17,35640.83,22440,58080.83
311570,202308,312,206,106,273243.58,139921.81,413165.39
311580,202308,459,298,161,393365.2,213840.84,607206.04
311590,202308,30,24,6,31680.89,7920,39600.89
311600,202308,97,77,20,101643.34,26400.93,128044.27
311610,202308,262,228,34,300962.4,44880.73,345843.13
311615,202308,194,164,30,216481.19,39600.52,256081.71
311620,202308,33,25,8,33000.9,10560,43560.9
311630,202308,123,108,15,142560.75,19800,162360.75
311640,202308,151,79,72,104281.74,95043.62,199325.36
311650,202308,142,96,46,126720,60720.2,187440.2
311660,202308,483,224,259,295683.17,341880.73,637563.90
311670,202308,164,117,47,154253.13,62040.43,216293.56
311680,202308,246,185,61,244201.09,80520.18,324721.27
311690,202308,13,13,0,17160.5,,17160.5
311700,202308,206,156,50,205923.06,66000.96,271924.02
311710,202308,188,126,62,166321.91,81840,248161.91
311720,202308,37,29,8,38280.89,10560,48840.89
311730,202308,618,435,183,575536.64,241561.15,817097.79
311740,202308,25,19,6,25080,7920,33000
311750,202308,772,526,246,694326.93,324720.93,1019047.86
311760,202308,86,38,48,50161.6,63360.11,113521.71
311770,202308,401,206,195,271922.97,257400.86,529323.83
311780,202308,242,131,111,172922.3,146521.17,319443.47
311783,202308,108,93,15,122760.7,19800,142560.7
311787,202308,51,20,31,26400,40920.41,67320.41
311790,202308,276,122,154,162361.54,203281.95,365643.49
311800,202308,852,509,343,673213.51,455403,1128616.51
311810,202308,61,44,17,58081.41,22440,80521.41
311820,202308,144,108,36,142562.84,47520.58,190083.42
311830,202308,2161,1252,909,1652682.9,1201202.92,2853885.82
311840,202308,1212,713,499,941171.6,660003.43,1601175.03
311850,202308,19,13,6,17160.28,7920.2,25080.48
311860,202308,11603,5003,6600,6608128.65,8718677.16,15326805.81
311870,202308,122,71,51,93723.31,67320.31,161043.62
311880,202308,1021,735,286,971548.49,377529.32,1349077.81
311890,202308,221,102,119,134534.09,157083.67,291617.76
311900,202308,69,29,40,38280,52800.15,91080.15
311910,202308,1526,953,573,1259305.04,756365.25,2015670.29
311920,202308,256,170,86,224402.17,113520.2,337922.37
311930,202308,1021,572,449,755053.43,592682.98,1347736.41
311940,202308,3012,1689,1323,2233510.95,1746363.17,3979874.12
311950,202308,186,111,75,146522.56,99001.05,245523.61
311960,202308,70,48,22,63360.27,29040,92400.27
311970,202308,29,16,13,21120,17160,38280
311980,202308,45,35,10,46200,13200,59400
311990,202308,39,26,13,34320.08,17160.64,51480.72
311995,202308,59,36,23,47520.7,30360.2,77880.9
312000,202308,22,16,6,21120,7920,29040
312010,202308,74,56,18,75241.07,23760.1,99001.17
312015,202308,95,66,29,87120.69,38280,125400.69
312020,202308,145,107,38,141240.25,50160,191400.25
312030,202308,85,65,20,85800,26400,112200
312040,202308,95,57,38,75240,50160,125400
312050,202308,208,122,86,161040.2,113520,274560.2
312060,202308,20,12,8,15840,10560,26400
312070,202308,86,57,29,75240.54,38280,113520.54
312080,202308,527,260,267,343203.58,352440.3,695643.88
312083,202308,91,59,32,77880.37,42240,120120.37
312087,202308,112,80,32,105601.07,42240,147841.07
312090,202308,3827,2379,1448,3144353.71,1911376.35,5055730.06
312100,202308,159,110,49,146522.15,64680.86,211203.01
312110,202308,135,82,53,108241.9,69961.03,178202.93
312120,202308,133,95,38,125401.91,50160,175561.91
312125,202308,89,59,30,79202.46,39600.88,118803.34
312130,202308,134,92,42,121441.67,55440,176881.67
312140,202308,162,121,41,159721.54,54120,213841.54
312150,202308,39,33,6,43560,7920,51480
312160,202308,1570,1029,541,1359744.16,715444.84,2075189.00
312170,202308,16,11,5,14520,6600,21120
312180,202308,90,66,24,87120,31680,118800
312190,202308,50,44,6,58080.96,7920,66000.96
312200,202308,794,671,123,885740.51,162361.76,1048102.27
312210,202308,144,78,66,102960.52,88440.48,191401.00
312220,202308,161,119,42,157081.92,56760,213841.92
312230,202308,4259,1874,2385,2476401.7,3154808.5,5631210.2
312235,202308,190,125,65,165000,87120,252120
312240,202308,94,69,25,91082.59,33000.93,124083.52
312245,202308,250,183,67,241566.78,88440.43,330007.21
312247,202308,85,62,23,81840.37,30360.38,112200.75
312250,202308,191,98,93,129362.97,122760,252122.97
312260,202308,117,75,42,99000,55440,154440
312270,202308,151,87,64,114841.61,84480,199321.61
312280,202308,31,15,16,19800,21120,40920
312290,202308,156,106,50,139922.93,66000.38,205923.31
312300,202308,214,141,73,186121.8,96361.15,282482.95
312310,202308,68,59,9,77880,11880,89760
312320,202308,461,280,181,369601.13,240240,609841.13
312330,202308,114,99,15,130680.96,19800.91,150481.87
312340,202308,34,17,17,22440,22440,44880
312350,202308,14,8,6,10560.98,7920,18480.98
312352,202308,96,69,27,92400.04,35640,128040.04
312360,202308,626,278,348,366965.78,460680.2,827645.98
312370,202308,411,232,179,308880.27,237600.99,546481.26
312380,202308,151,101,50,133327.3,66000.84,199328.14
312385,202308,191,152,39,200642.89,51480.27,252123.16
312390,202308,321,203,118,267962.52,157080,425042.52
312400,202308,408,310,98,409202.33,130680.07,539882.40
312410,202308,1375,515,860,682462.51,1135221.5,1817684.01
312420,202308,738,559,179,737889.15,236281.15,974170.30
312430,202308,912,659,253,871212.05,335283.21,1206495.26
312440,202308,63,48,15,63360,19800,83160
312450,202308,239,142,97,187440,128040,315480
312460,202308,38,17,21,22440,27720,50160
312470,202308,52,36,16,47520,21120,68640
312480,202308,169,106,63,141243.16,83161.19,224404.35
312490,202308,341,229,112,302288.53,147842.58,450131.11
312500,202308,36,26,10,34320.85,13200,47520.85
312510,202308,778,311,467,410530.27,617767.33,1028297.60
312520,202308,25,9,16,11880,21120,33000
312530,202308,40,28,12,36961.69,15840.1,52801.79
312540,202308,89,75,14,100320.53,18480,118800.53
312550,202308,35,27,8,35640,10560,46200
312560,202308,222,171,51,225722.27,67320,293042.27
312570,202308,534,321,213,425050.89,281162.38,706213.27
312580,202308,88,54,34,71280,44880,116160
312590,202308,226,178,48,234963.74,63360,298323.74
312595,202308,173,141,32,186121.21,42240,228361.21
312600,202308,72,33,39,43560,51480,95040
312610,202308,1715,914,801,1209146.56,1059962.05,2269108.61
312620,202308,243,179,64,236281.98,84480,320761.98
312630,202308,77,61,16,80520.45,21120,101640.45
312640,202308,52,16,36,21120,47520,68640
312650,202308,163,139,24,183925.74,33000.1,216925.84
312660,202308,115,79,36,104285.22,47520.39,151805.61
312670,202308,1011,633,378,835587.11,498963.91,1334551.02
312675,202308,49,37,12,48840,15840,64680
312680,202308,82,53,29,69960,38280,108240
312690,202308,297,153,144,201963.22,190080.8,392044.02
312695,202308,38,30,8,39600,10560,50160
312700,202308,279,161,118,212523.25,155760.64,368283.89
312705,202308,94,74,20,97680,26400,124080
312707,202308,136,97,39,128040.24,51480,179520.24
312710,202308,2040,1159,881,1531253.46,1166890.43,2698143.89
312720,202308,50,26,24,34320.56,31680,66000.56
312730,202308,305,178,127,234963.79,167642.42,402606.21
312733,202308,51,41,10,54120.7,13200,67320.7
312735,202308,23,18,5,23760.71,6600.3,30361.01
312737,202308,92,55,37,72600.93,48840,121440.93
312738,202308,88,54,34,71280.53,44880,116160.53
312740,202308,82,49,33,64681.33,43560,108241.33
312750,202308,140,96,44,126720.01,58080,184800.01
312760,202308,287,192,95,253444.4,125400.97,378845.37
312770,202308,10085,4914,5171,6489278.86,6837616.28,13326895.14
312780,202308,473,361,112,476527.59,147842.81,624370.40
312790,202308,21,16,5,21120,6600,27720
312800,202308,1802,1243,559,1643417.01,740523.2,2383940.21
312810,202308,375,261,114,344521.62,151800,496321.62
312820,202308,207,164,43,216481.79,56760,273241.79
312825,202308,46,34,12,44883.29,15840,60723.29
312830,202308,202,111,91,146521.94,120121.27,266643.21
312840,202308,217,150,67,198001.38,88440,286441.38
312850,202308,37,32,5,42240.91,6600,48840.91
312860,202308,161,108,53,142561.03,69960,212521.03
312870,202308,1329,695,634,918743.04,836880.53,1755623.57
312880,202308,134,101,33,133323.54,43560,176883.54
312890,202308,185,131,54,172923.84,71280,244203.84
312900,202308,163,125,38,165001.83,50160,215161.83
312910,202308,187,105,82,139925.21,108241.87,248167.08
312920,202308,119,68,51,89760.32,67320,157080.32
312930,202308,357,232,125,306243.26,165001.6,471244.86
312940,202308,169,114,55,150480.07,72600,223080.07
312950,202308,818,581,237,766940.96,314163.55,1081104.51
312960,202308,151,109,42,143886.45,55440.99,199327.44
312965,202308,125,98,27,129360.1,35640,165000.1
312970,202308,311,249,62,328690.71,81841.11,410531.82
312980,202308,3008,1568,1440,2071145.35,1902128.99,3973274.34
312990,202308,50,20,30,26400.9,39600,66000.9
313000,202308,58,32,26,42240.86,34320,76560.86
313005,202308,197,149,48,196680.91,63360.71,260041.62
313010,202308,1079,474,605,627016.21,799927.46,1426943.67
313020,202308,196,101,95,133320,125400,258720
313030,202308,226,150,76,198001.37,100320.76,298322.13
313040,202308,104,30,74,39600.73,97680,137280.73
313050,202308,228,168,60,221760,80520,302280
313055,202308,45,31,14,40920,18480,59400
313060,202308,158,113,45,149161.05,59400,208561.05
313065,202308,62,47,15,62040,19800,81840
313070,202308,126,66,60,87123.12,79200,166323.12
313080,202308,48,25,23,33000,30360,63360
313090,202308,741,484,257,638888.22,339240.72,978128.94
313100,202308,231,86,145,113520.2,191400,304920.2
313110,202308,175,97,78,128041.29,102961.39,231002.68
313115,202308,290,159,131,209882.97,172921.07,382804.04
313120,202308,927,529,398,698293.75,525363.13,1223656.88
313130,202308,6747,3780,2967,4992392.84,3924389.84,8916782.68
313140,202308,148,87,61,114842.15,80521.35,195363.50
313150,202308,314,245,69,323403.3,91080,414483.3
313160,202308,193,147,46,194044.83,60720,254764.83
313170,202308,1577,1000,577,1320043.83,764283.63,2084327.46
313180,202308,373,238,135,315485.11,178203.85,493688.96
313190,202308,834,474,360,627015.64,475203.38,1102219.02
313200,202308,38,31,7,40920.78,9240,50160.78
313210,202308,1068,910,158,1201255.19,208564.79,1409819.98
313220,202308,350,210,140,277200,184800,462000
313230,202308,319,248,71,327362.08,93720.03,421082.11
313240,202308,2519,1261,1258,1667197.71,1661880.83,3329078.54
313250,202308,1301,974,327,1285712.66,432964.1,1718676.76
313260,202308,109,55,54,72600.7,71280,143880.7
313270,202308,1144,686,458,905531.66,607204.65,1512736.31
313280,202308,47,36,11,47520,14520,62040
313290,202308,240,191,49,253446.84,66000,319446.84
313300,202308,353,173,180,228365.47,238920.58,467286.05
313310,202308,277,124,153,163682.17,201961,365643.17
313320,202308,422,312,110,411843.08,146520.07,558363.15
313330,202308,1546,967,579,1277791.47,764285.72,2042077.19
313340,202308,355,254,101,335285.24,133320.91,468606.15
313350,202308,467,290,177,382803.3,233640.24,616443.54
313360,202308,223,102,121,134640.88,159720.1,294360.98
313370,202308,251,93,158,122761.42,208560,331321.42
313375,202308,354,227,127,299646.16,167640.32,467286.48
313380,202308,1425,748,677,987385.32,896281.73,1883667.05
313390,202308,55,48,7,63360,9240,72600
313400,202308,430,307,123,405257.31,162362.92,567620.23
313410,202308,103,67,36,88440.7,47520,135960.7
313420,202308,5085,2944,2141,3887529.48,2827453.92,6714983.40
313430,202308,127,62,65,81840.31,85800.33,167640.64
313440,202308,1461,1042,419,1375500.36,554409.22,1929909.58
313450,202308,79,33,46,43560,60720,104280
313460,202308,429,192,237,254765.05,312841.82,567606.87
313470,202308,538,262,276,345852.81,364325.7,710178.51
313480,202308,174,133,41,175560.73,54120,229680.73
313490,202308,616,281,335,370936.5,442207.94,813144.44
313500,202308,32,18,14,23760,18480,42240
313505,202308,1174,896,278,1184079.01,366967.45,1551046.46
313507,202308,121,85,36,112201.36,47520,159721.36
313510,202308,3192,1963,1229,2591369.83,1627585.72,4218955.55
313520,202308,3659,2817,842,3719911.25,1112769.28,4832680.53
313530,202308,44,27,17,35640,22440.94,58080.94
313535,202308,100,79,21,104282.22,27720.5,132002.72
313540,202308,69,49,20,64680,26400,91080
313545,202308,137,116,21,153120.85,27720,180840.85
313550,202308,230,194,36,256083.46,47520.9,303604.36
313560,202308,373,181,192,238925.82,253446,492371.82
313570,202308,90,30,60,39600,79200.06,118800.06
313580,202308,1462,873,589,1155020.79,778805.25,1933826.04
313590,202308,86,55,31,72600.76,40921.3,113522.06
313600,202308,732,450,282,595326.85,372241.04,967567.89
313610,202308,65,51,14,67321.62,18480.35,85801.97
313620,202308,1655,800,855,1056035.51,1129924.82,2185960.33
313630,202308,1836,1396,440,1842761.39,580803.03,2423564.42
313640,202308,119,68,51,89761.79,67320.7,157082.49
313650,202308,255,136,119,179520.66,158402.47,337923.13
313652,202308,37,34,3,44880,3960,48840
313655,202308,102,69,33,91080.76,43560.31,134641.07
313657,202308,55,50,5,66001.79,6600,72601.79
313660,202308,158,106,52,139921.21,68640.78,208561.99
313665,202308,793,370,423,488416.57,558369.98,1046786.55
313670,202308,12416,8570,3846,11322135.27,5084678.83,16406814.10
313680,202308,50,39,11,52800.73,14520,67320.73
313690,202308,144,102,42,134640.98,55440,190080.98
313695,202308,93,72,21,95041.23,27720,122761.23
313700,202308,395,308,87,406565.62,114840.88,521406.50
313710,202308,129,93,36,122761.97,47520,170281.97
313720,202308,1311,619,692,817112.52,914769.7,1731882.22
313730,202308,81,47,34,62041.63,44880,106921.63
313740,202308,162,120,42,158400.91,55440,213840.91
313750,202308,427,302,125,398645.52,165000.79,563646.31
313753,202308,254,196,58,258724.33,76560.1,335284.43
313760,202308,1533,599,934,790699.21,1234212.15,2024911.36
313770,202308,464,311,153,410533.42,201962.87,612496.29
313780,202308,955,529,426,699606.57,564964.06,1264570.63
313790,202308,35,35,0,46200,,46200.0
313800,202308,179,112,67,147845.29,88441.72,236287.01
313810,202308,106,61,45,80520.81,59401.02,139921.83
313820,202308,1538,737,801,972863.1,1058641.22,2031504.32
313830,202308,61,41,20,54120.89,26400,80520.89
313835,202308,69,60,9,79200.2,11880,91080.2
313840,202308,1892,1150,742,1518050.48,982085.8,2500136.28
313850,202308,238,109,129,143883.63,170280.5,314164.13
313860,202308,519,391,128,517450,170280.64,687730.64
313862,202308,188,132,56,174246.03,73920,248166.03
313865,202308,196,136,60,179521.06,80520,260041.06
313867,202308,66,55,11,72600,14520.1,87120.1
313868,202308,60,38,22,50160.5,29040,79200.5
313870,202308,84,48,36,63360.2,47520,110880.2
313880,202308,414,257,157,339243.75,207240.69,546484.44
313890,202308,362,201,161,265324.5,213840.63,479165.13
313900,202308,895,489,406,646817.6,537248.46,1184066.06
313910,202308,151,101,50,133320.19,66000,199320.19
313920,202308,712,486,226,642843.73,298322.1,941165.83
313925,202308,37,31,6,40920,7920,48840
313930,202308,973,742,231,982120.51,306245.34,1288365.85
313940,202308,2160,1292,868,1705477.41,1148408.09,2853885.50
313950,202308,943,578,365,762975.23,481800.54,1244775.77
313960,202308,1605,928,677,1226301.47,894965.88,2121267.35
313970,202308,206,112,94,147840.1,124080.2,271920.3
313980,202308,268,169,99,223088.66,130681.06,353769.72
313990,202308,309,182,127,240240.82,167640,407880.82
314000,202308,981,641,340,846132.66,448804.55,1294937.21
314010,202308,121,76,45,100320.15,59400,159720.15
314015,202308,112,35,77,46200.47,101640.9,147841.37
314020,202308,63,41,22,54121.66,29040,83161.66
314030,202308,77,41,36,54120.62,47520,101640.62
314040,202308,49,26,23,34320,30360,64680
314050,202308,313,173,140,228365.75,184800,413165.75
314053,202308,101,65,36,85801.2,47520,133321.2
314055,202308,325,211,114,278524.89,150481.54,429006.43
314060,202308,132,113,19,149160.33,25080,174240.33
314070,202308,1166,577,589,761664.03,778812.9,1540476.93
314080,202308,229,137,92,180845.12,121441,302286.12
314085,202308,206,145,61,191401.15,80520,271921.15
314090,202308,450,324,126,427688.37,166320.16,594008.53
314100,202308,575,449,126,592696.86,166323.32,759020.18
314110,202308,833,358,475,472575.94,628323.46,1100899.40
314120,202308,71,44,27,58080,35640,93720
314130,202308,28,20,8,26400,10560,36960
314140,202308,1298,824,474,1087700.64,625685,1713385.64
314150,202308,209,134,75,176882.86,99000,275882.86
314160,202308,325,245,80,323403.36,105600.56,429003.92
314170,202308,92,69,23,91081.39,30360,121441.39
314180,202308,826,732,94,966270.12,124081.27,1090351.39
314190,202308,92,57,35,75240.67,46200,121440.67
314200,202308,566,395,171,521416.82,225726.32,747143.14
314210,202308,251,193,58,254764.56,76560,331324.56
314220,202308,335,236,99,311525.08,130681.11,442206.19
314225,202308,40,25,15,33000.52,19800,52800.52
314230,202308,132,58,74,76560.55,97680,174240.55
314240,202308,192,140,52,184802.53,69960,254762.53
314250,202308,58,36,22,47522.6,29040,76562.6
314260,202308,219,113,106,149161.11,139920,289081.11
314270,202308,438,340,98,448817.4,129361.1,578178.5
314280,202308,779,422,357,558310.11,472562.54,1030872.65
314290,202308,585,457,128,603247.19,168960.72,772207.91
314300,202308,345,261,84,344528.16,110880,455408.16
314310,202308,1405,969,436,1279117.54,575520.21,1854637.75
314315,202308,55,41,14,54120.15,18480,72600.15
314320,202308,645,455,190,600610.91,250801.88,851412.79
314330,202308,13032,6359,6673,8399475.91,8817651.05,17217126.96
314340,202308,724,328,396,432971.01,522723.14,955694.15
314345,202308,64,47,17,62040,22440,84480
314350,202308,189,115,74,151800.88,99000.66,250801.54
314360,202308,61,36,25,47522.66,33001.04,80523.70
314370,202308,77,56,21,73920,27720,101640
314380,202308,146,81,65,106920.72,87120,194040.72
314390,202308,3893,2525,1368,3334432.48,1807082.73,5141515.21
314400,202308,757,532,225,703573.55,297002.12,1000575.67
314410,202308,605,403,202,531972.89,266642.94,798615.83
314420,202308,30,20,10,26400,13200,39600
314430,202308,2615,1008,1607,1334556.7,2123912.04,3458468.74
314435,202308,163,98,65,129361.05,85800,215161.05
314437,202308,57,45,12,59400.19,15840,75240.19
314440,202308,105,65,40,85800.61,52800.1,138600.71
314450,202308,181,124,57,163681.34,75240.96,238922.30
314460,202308,659,330,329,435607.5,435603.81,871211.31
314465,202308,135,88,47,116161.2,63360,179521.2
314467,202308,80,64,16,84480,21120,105600
314470,202308,455,229,226,302282.98,298322.65,600605.63
314480,202308,1198,548,650,724693.56,859323.95,1584017.51
314490,202308,41,21,20,27720,26400,54120
314500,202308,293,197,96,260044.47,126721.29,386765.76
314505,202308,126,79,47,104281.31,62040,166321.31
314510,202308,264,213,51,281164.78,67320,348484.78
314520,202308,1555,791,764,1044155.84,1011130.77,2055286.61
314530,202308,831,662,169,875190.28,224403.34,1099593.62
314535,202308,193,123,70,162360,92400,254760
314537,202308,71,43,28,56761.72,36960.98,93722.70
314540,202308,23,14,9,18480,11880,30360
314545,202308,72,50,22,66000,29040,95040
314550,202308,85,47,38,62041.7,50161.83,112203.53
314560,202308,928,499,429,658693.17,567604.82,1226297.99
314570,202308,17,15,2,19800.48,2640,22440.48
314580,202308,10,5,5,6600,7920,14520
314585,202308,34,26,8,34320,10560.79,44880.79
314587,202308,84,70,14,92400,18480,110880
314590,202308,663,445,218,588735.08,287761.64,876496.72
314600,202308,1077,703,374,927996.48,496328.36,1424324.84
314610,202308,1083,560,523,740532.55,691685.25,1432217.80
314620,202308,163,124,39,163680.6,51480,215160.6
314625,202308,100,78,22,102961.13,29040,132001.13
314630,202308,1201,688,513,908184.94,678486.6,1586671.54
314640,202308,100,60,40,79201.87,52800,132001.87
314650,202308,165,97,68,128042.92,89760.73,217803.65
314655,202308,66,48,18,63360,23760,87120
314660,202308,21,17,4,22440,5280,27720
314670,202308,236,182,54,240252.63,71283.36,311535.99
314675,202308,228,143,85,188761.09,112200.23,300961.32
314690,202308,600,320,280,422406.29,369602.25,792008.54
314700,202308,2324,1244,1080,1642134.52,1426926.19,3069060.71
314710,202308,2042,1126,916,1487665.53,1210441.61,2698107.14
314720,202308,453,250,203,330006.81,267961.15,597967.96
314730,202308,555,294,261,389407.1,345843.23,735250.33
314740,202308,879,393,486,518770.08,641524.76,1160294.84
314750,202308,30,22,8,29040,10560,39600
314760,202308,387,157,230,207242.25,303600.88,510843.13
314770,202308,102,67,35,88441.39,46200,134641.39
314780,202308,18,7,11,9240,14520,23760
314790,202308,2773,1784,989,2356271.39,1309441.61,3665713.00
314795,202308,79,68,11,89760.2,14520,104280.2
314800,202308,3206,1896,1310,2502782.73,1729203.71,4231986.44
314810,202308,1637,940,697,1240824.17,921360.58,2162184.75
314820,202308,123,73,50,96360.89,66000.1,162360.99
314830,202308,240,205,35,270604.64,47520,318124.64
314840,202308,93,55,38,72600,50160,122760
314850,202308,474,230,244,303736.27,323400.05,627136.32
314860,202308,670,509,161,671884.82,215160.08,887044.90
314870,202308,1822,995,827,1313435.59,1091654.08,2405089.67
314875,202308,71,64,7,84480,9240,93720
314880,202308,43,31,12,40920,15840,56760
314890,202308,56,29,27,38280,36960,75240
314900,202308,27,20,7,26401.1,9240.92,35642.02
314910,202308,246,165,81,217801.52,106920,324721.52
314915,202308,151,127,24,167642.23,31680.68,199322.91
314920,202308,85,56,29,73920.85,38280,112200.85
314930,202308,1166,523,643,691701.78,848761.73,1540463.51
314940,202308,39,31,8,40920,10560,51480
314950,202308,24,19,5,25081.6,6600,31681.6
314960,202308,31,19,12,25080.39,15840.18,40920.57
314970,202308,196,88,108,116162.13,142560.15,258722.28
314980,202308,338,221,117,291725.14,154440.75,446165.89
314990,202308,483,260,223,343208.44,294361.44,637569.88
314995,202308,164,78,86,102960.77,113520,216480.77
315000,202308,109,85,24,112200.49,31680.1,143880.59
315010,202308,41,25,16,33000,21120,54120
315015,202308,175,142,33,187440.4,43560,231000.4
315020,202308,68,56,12,73920,15840,89760
315030,202308,121,90,31,118800,40920,159720
315040,202308,94,55,39,72600.3,51480,124080.3
315050,202308,225,142,83,187440.92,109560.68,297001.60
315053,202308,77,55,22,72600,29040,101640
315057,202308,133,103,30,135960.65,39600,175560.65
315060,202308,63,53,10,69961.88,13200,83161.88
315070,202308,133,81,52,106922.66,68640.91,175563.57
315080,202308,421,337,84,444846.45,110881.35,555727.80
315090,202308,113,66,47,87121.39,62040,149161.39
315100,202308,106,53,53,69961.86,69960.38,139922.24
315110,202308,295,153,142,201963.94,188760.72,390724.66
315120,202308,2043,947,1096,1252724.41,1452026.85,2704751.26
315130,202308,388,274,114,361683.87,150480.56,512164.43
315140,202308,588,317,271,418449.95,357724.93,776174.88
315150,202308,1062,520,542,686421.62,715445.52,1401867.14
315160,202308,205,111,94,146526.67,124084.19,270610.86
315170,202308,309,198,111,261362.85,146520.8,407883.65
315180,202308,3538,1513,2025,1998536.92,2675656.98,4674193.90
315190,202308,307,186,121,245524.29,159720.25,405244.54
315200,202308,1343,830,513,1095626.23,677163.08,1772789.31
315210,202308,1967,1205,762,1590636.49,1008482.51,2599119.00
315213,202308,26,16,10,21121.63,13200,34321.63
315217,202308,244,191,53,252121.85,69960.55,322082.40
315220,202308,1742,1275,467,1684364.69,617769.13,2302133.82
315230,202308,204,158,46,208561.69,60720,269281.69
315240,202308,405,271,134,357729.49,176882.2,534611.69
315250,202308,2983,1428,1555,1887664.74,2053925.99,3941590.73
315260,202308,142,83,59,109560,79200.1,188760.1
315270,202308,163,114,49,150481.25,64680,215161.25
315280,202308,679,446,233,588745.61,307571.12,896316.73
315290,202308,210,133,77,175562.01,101640.23,277202.24
315300,202308,112,86,26,113520.01,34320,147840.01
315310,202308,92,80,12,105600,15840,121440
315320,202308,144,95,49,125404.7,64680,190084.7
315330,202308,65,53,12,69960,15840,85800
315340,202308,400,292,108,385444.5,142561.03,528005.53
315350,202308,175,110,65,145201.38,85800.34,231001.72
315360,202308,117,56,61,73920.15,80520.23,154440.38
315370,202308,62,40,22,52801.28,29040,81841.28
315380,202308,6,5,1,6600,1320,7920
315390,202308,74,28,46,36960,60721.72,97681.72
315400,202308,927,703,224,927976.45,295681.95,1223658.40
315410,202308,340,202,138,266652.34,182164.41,448816.75
315415,202308,61,45,16,59400.27,21120,80520.27
315420,202308,215,154,61,203282.16,80520,283802.16
315430,202308,669,370,299,488404.02,394680.38,883084.40
315440,202308,97,64,33,84480.2,44880,129360.2
315445,202308,246,203,43,267970.98,56760.37,324731.35
315450,202308,185,134,51,176880,67320,244200
315460,202308,5491,2558,2933,3378019.32,3875569.85,7253589.17
315470,202308,54,21,33,27720.9,43560,71280.9
315480,202308,95,32,63,42241.79,83162.58,125404.37
315490,202308,766,503,263,665288.74,347160.48,1012449.22
315500,202308,24,20,4,26400,5280,31680
315510,202308,173,124,49,163680.7,64680,228360.7
315520,202308,79,66,13,87120.47,17160,104280.47
315530,202308,50,29,21,38280,27720.2,66000.2
315540,202308,282,193,89,254764.97,117480.39,372245.36
315550,202308,201,160,41,211201.11,54120,265321.11
315560,202308,758,601,157,793338.66,207244.21,1000582.87
315570,202308,329,163,166,215164.5,219120.81,434285.31
315580,202308,805,553,252,731287.58,332640.96,1063928.54
315590,202308,204,102,102,134642.7,134640.63,269283.33
315600,202308,389,302,87,398644.11,114840.78,513484.89
315610,202308,111,53,58,70444,76560,147004
315620,202308,44,32,12,42242.55,15840,58082.55
315630,202308,140,106,34,139920.1,44880,184800.1
315640,202308,63,41,22,54120.98,29040,83160.98
315645,202308,55,38,17,50160,22440,72600
315650,202308,174,130,44,171600.54,58080,229680.54
315660,202308,452,215,237,283810.21,314164.93,597975.14
315670,202308,2684,1214,1470,1602536.9,1940422.1,3542959.0
315680,202308,798,585,213,773528.49,281160,1054688.49
315690,202308,737,494,243,652095.61,320762.44,972858.05
315700,202308,2197,1150,1047,1519360.61,1383387.9,2902748.51
315710,202308,395,138,257,182161,339241.09,521402.09
315720,202308,555,337,218,444846.81,287760.22,732607.03
315725,202308,219,173,46,228360.27,60720,289080.27
315727,202308,108,70,38,92403.47,50160,142563.47
315730,202308,59,52,7,68640,9240,77880
315733,202308,92,52,40,68640.2,52800,121440.2
315737,202308,51,40,11,52801.67,14520,67321.67
315740,202308,33,26,7,34320.35,9240,43560.35
315750,202308,180,127,53,168960.17,69960,238920.17
315760,202308,47,35,12,46200,15840,62040
315765,202308,150,88,62,116162.87,81842.31,198005.18
315770,202308,264,180,84,237602.38,110880.64,348483.02
315780,202308,4532,2243,2289,2963483.2,3022808.2,5986291.4
315790,202308,274,212,62,279844.15,81840.87,361685.02
315800,202308,351,230,121,303603.4,159720,463323.4
315810,202308,65,38,27,50160.96,35640,85800.96
315820,202308,831,627,204,827665.02,269284.08,1096949.10
315830,202308,132,90,42,118801.84,55440.39,174242.23
315840,202308,88,62,26,81840,34320.66,116160.66
315850,202308,281,184,97,242885.38,128040.8,370926.18
315860,202308,21,9,12,11880,15840,27720
315870,202308,42,33,9,43560.81,11880,55440.81
315880,202308,103,68,35,89760,47520,137280
315890,202308,116,81,35,106921.65,46200,153121.65
315895,202308,429,285,144,376217.8,190081.44,566299.24
315900,202308,97,46,51,60720,67320.08,128040.08
315910,202308,55,32,23,42240,30360,72600
315920,202308,162,107,55,142562.47,72600,215162.47
315930,202308,58,23,35,30362.82,46200.91,76563.73
315935,202308,140,111,29,146523.49,38280,184803.49
315940,202308,103,75,28,99000,36960,135960
315950,202308,46,35,11,46200,14520.35,60720.35
315960,202308,637,304,333,401290.31,440885.98,842176.29
315970,202308,38,30,8,39600.96,10560,50160.96
315980,202308,716,379,337,500293.71,446161.54,946455.25
315990,202308,271,154,117,203282.39,154440.81,357723.20
316000,202308,51,31,20,40920,26400,67320
316010,202308,105,90,15,118801.52,19800,138601.52
316020,202308,100,91,9,120120.49,11880,132000.49
316030,202308,388,229,159,302286.24,209882.19,512168.43
316040,202308,599,247,352,326043.91,464640.2,790684.11
316045,202308,56,50,6,66000,7920,73920
316050,202308,29,19,10,25080,13200,38280
316060,202308,113,81,32,106921.17,42240,149161.17
316070,202308,1360,917,443,1210473.18,584764.23,1795237.41
316080,202308,102,67,35,88556.76,46200,134756.76
316090,202308,40,19,21,25080,27720.36,52800.36
316095,202308,92,79,13,104282.28,17160.44,121442.72
316100,202308,377,210,167,277204.99,220440.32,497645.31
316105,202308,62,38,24,50160.51,31680,81840.51
316110,202308,1997,1530,467,2020967.17,617769.34,2638736.51
316120,202308,76,51,25,67320,33000,100320
316130,202308,128,93,35,122762.95,46200.21,168963.16
316140,202308,32,21,11,27720,14520,42240
316150,202308,253,181,72,238922.51,95040.33,333962.84
316160,202308,87,58,29,76561.57,38280.28,114841.85
316165,202308,81,50,31,66000.78,40920,106920.78
316170,202308,198,126,72,166320.22,95040,261360.22
316180,202308,238,93,145,122764.47,192721.54,315486.01
316190,202308,155,110,45,145201.39,59400,204601.39
316200,202308,743,413,330,545175.05,436921.76,982096.81
316210,202308,806,556,250,734168.72,330001.39,1064170.11
316220,202308,139,89,50,117481.79,66000,183481.79
316225,202308,43,27,16,35640.75,21120,56760.75
316230,202308,51,29,22,38280.54,29040,67320.54
316240,202308,724,569,155,751096.44,204604.37,955700.81
316245,202308,179,159,20,209882.56,26400.99,236283.55
316250,202308,1814,1201,613,1585855.62,813123.48,2398979.10
316255,202308,140,109,31,145200,40920.92,186120.92
316257,202308,188,94,94,124081.37,124081.46,248162.83
316260,202308,224,147,77,194042.18,101640,295682.18
316265,202308,42,30,12,39601.87,15840.67,55442.54
316270,202308,729,511,218,674532.36,287762.7,962295.06
316280,202308,634,410,224,542531.57,295681.2,838212.77
316290,202308,954,668,286,881782.8,378843.53,1260626.33
316292,202308,703,297,406,392047.91,537243.76,929291.67
316294,202308,116,74,42,97681.9,55440,153121.9
316295,202308,440,209,231,275885.34,304926.85,580812.19
316300,202308,44,27,17,35640,22440,58080
316310,202308,24,13,11,17160,14520,31680
316320,202308,78,34,44,44880.7,58080,102960.7
316330,202308,189,135,54,179520.88,71280,250800.88
316340,202308,148,96,52,126720,68640,195360
316350,202308,208,143,65,188760.59,85800.2,274560.79
316360,202308,30,18,12,23760,15840,39600
316370,202308,1467,723,744,955701.19,984725.22,1940426.41
316380,202308,128,101,27,133321.39,35640,168961.39
316390,202308,104,76,28,100320,36960,137280
316400,202308,189,141,48,186123.36,63360.36,249483.72
316410,202308,331,241,90,318121.66,118800.2,436921.86
316420,202308,233,155,78,204605.96,102961.35,307567.31
316430,202308,176,99,77,130680.46,101640,232320.46
316440,202308,82,45,37,59400.58,48840.08,108240.66
316443,202308,49,41,8,54120.17,10560,64680.17
316447,202308,53,44,9,58082.81,11880,69962.81
316450,202308,265,195,70,258720.2,92400,351120.2
316460,202308,52,18,34,23760.43,44880.34,68640.77
316470,202308,1954,1441,513,1902166.2,677160.43,2579326.63
316480,202308,10,7,3,9240,3960,13200
316490,202308,25,8,17,10560,22440,33000
316500,202308,184,119,65,157080.27,85800,242880.27
316510,202308,143,115,28,151801.34,36960,188761.34
316520,202308,193,104,89,137281.05,117480.67,254761.72
316530,202308,193,124,69,165001.21,91080,256081.21
316540,202308,172,92,80,121441.76,105600.65,227042.41
316550,202308,192,120,72,158402.3,95040,253442.3
316553,202308,543,273,270,360367.2,356402.06,716769.26
316555,202308,76,66,10,87120.8,13200,100320.8
316556,202308,19,13,6,17160.41,7920,25080.41
316557,202308,49,35,14,47520.24,18480,66000.24
316560,202308,75,53,22,69960.2,29040,99000.2
316570,202308,243,222,21,293041.47,27720,320761.47
316580,202308,27,18,9,23760,11880,35640
316590,202308,92,77,15,101640.82,19800.72,121441.54
316600,202308,182,151,31,200641.93,40920,241561.93
316610,202308,72,52,20,69960.73,26400,96360.73
316620,202308,164,116,48,153120,63360.85,216480.85
316630,202308,70,51,19,67320,25080,92400
316640,202308,24,13,11,17160,14520,31680
316650,202308,122,97,25,128040,33000,161040
316660,202308,4,1,3,1320,3960,5280
316670,202308,451,152,299,200644.62,394683.36,595327.98
316680,202308,192,149,43,196683.96,56760,253443.96
316690,202308,154,96,58,126720,76560,203280
316695,202308,58,48,10,63360,13200,76560
316700,202308,32,23,9,30360,11880,42240
316710,202308,876,664,212,876495.64,281163.4,1157659.04
316720,202308,5760,2680,3080,3539028.24,4066930.99,7605959.23
316730,202308,15,14,1,18480,1320,19800
316740,202308,177,110,67,145200.1,88440,233640.1
316750,202308,19,11,8,14520.32,10560,25080.32
316760,202308,377,294,83,388088.4,109560.93,497649.33
316770,202308,190,107,83,141241.59,112200,253441.59
316780,202308,71,41,30,54120,39600,93720
316790,202308,75,51,24,67320.44,31680.5,99000.94
316800,202308,1925,1169,756,1543117.33,997937.52,2541054.85
316805,202308,36,23,13,30360.08,17160,47520.08
316810,202308,57,34,23,44881.3,30360.45,75241.75
316820,202308,42,25,17,33000,22440,55440
316830,202308,107,51,56,67320.53,73920.2,141240.73
316840,202308,532,327,205,431644.48,270602.32,702246.80
316850,202308,317,221,96,291723.26,126720,418443.26
316860,202308,6943,3179,3764,4204512.5,4977741.58,9182254.08
316870,202308,1978,1286,692,1697596.11,913447.34,2611043.45
316880,202308,173,87,86,114844.36,113521.44,228365.80
316890,202308,238,155,83,204602.33,109560.69,314163.02
316900,202308,473,335,138,442204.29,182160,624364.29
316905,202308,27,12,15,15840,19800,35640
316910,202308,92,38,54,50160,71280,121440
316920,202308,170,131,39,172925.84,51480,224405.84
316930,202308,2237,1140,1097,1506146.41,1449361.39,2955507.80
316935,202308,1067,627,440,827654.8,580808.33,1408463.13
316940,202308,1207,702,505,926658.01,667921.15,1594579.16
316950,202308,224,113,111,149161.23,146520,295681.23
316960,202308,1184,657,527,867264.87,695651.95,1562916.82
316970,202308,712,569,143,751101.74,190083.23,941184.97
316980,202308,91,50,41,66000,54120,120120
316990,202308,2491,1699,792,2244055.62,1048084.24,3292139.86
317000,202308,363,279,84,369609.88,110881.84,480491.72
317005,202308,239,169,70,223084.96,92400.9,315485.86
317010,202308,7664,4414,3250,5826752.32,4296653.92,10123406.24
317020,202308,17191,7595,9596,10035035.8,12676060.22,22711096.02
317030,202308,107,50,57,66000,75240,141240
317040,202308,3330,2199,1131,2904074.03,1494248.7,4398322.73
317043,202308,81,64,17,84487.16,22441.27,106928.43
317047,202308,44,28,16,36960,21120,58080
317050,202308,171,136,35,179523.08,46200,225723.08
317052,202308,166,137,29,180841.77,38280,219121.77
317057,202308,202,153,49,201963.16,64680,266643.16
317060,202308,67,40,27,52800.45,35640.8,88441.25
317065,202308,55,42,13,55440,17160,72600
317070,202308,2173,1014,1159,1338528.25,1533841.36,2872369.61
317075,202308,101,57,44,75240.15,58080,133320.15
317080,202308,1033,529,504,698311.99,665282.12,1363594.11
317090,202308,775,599,176,790697.27,233643.84,1024341.11
317100,202308,481,358,123,472566.26,162360.95,634927.21
317103,202308,148,120,28,158402.72,36960,195362.72
317107,202308,64,50,14,66000,18480,84480
317110,202308,81,45,36,59400.2,47521.36,106921.56
317115,202308,52,46,6,60782.04,7920,68702.04
317120,202308,2387,1207,1180,1594622.99,1558933,3153555.99
317130,202308,2312,1580,732,2085626.62,967563.69,3053190.31
317140,202308,19,14,5,18481.2,6600,25081.2
317150,202308,312,185,127,244203.34,167640.98,411844.32
317160,202308,383,282,101,372243.96,133320.98,505564.94
317170,202308,254,166,88,219120.86,116160.6,335281.46
317180,202308,454,309,145,407884.1,191402.1,599286.2
317190,202308,263,190,73,250801.52,96360,347161.52
317200,202308,970,686,284,905559.16,374888.36,1280447.52
317210,202308,192,99,93,130685.95,122760.21,253446.16
317220,202308,27,13,14,17160,18480,35640
320010,202308,599,426,173,562338.64,231007.25,793345.89
320013,202308,153,98,55,129363.69,72602.45,201966.14
320016,202308,277,168,109,221765.47,143880,365645.47
320020,202308,826,488,338,645503.91,447488.6,1092992.51
320030,202308,189,131,58,172922.55,77881.62,250804.17
320035,202308,149,98,51,129360.2,67320.19,196680.39
320040,202308,518,256,262,337930.48,345849.6,683780.08
320050,202308,145,99,46,130688.09,60721.05,191409.14
320060,202308,2133,1008,1125,1331931.61,1490303.08,2822234.69
320070,202308,122,78,44,102960.25,58080,161040.25
320080,202308,901,508,393,670584.95,518766.33,1189351.28
320090,202308,1478,942,536,1243474.46,708855.56,1952330.02
320100,202308,412,229,183,302289.31,241562.42,543851.73
320110,202308,149,95,54,125408.41,71280.6,196689.01
320115,202308,126,108,18,142563.76,23760,166323.76
320120,202308,4317,2291,2026,3026865.34,2678324.98,5705190.32
320130,202308,9292,3977,5315,5252487.41,7027791.05,12280278.46
320140,202308,590,380,210,501625.21,277208.88,778834.09
320150,202308,2448,1355,1093,1793955.04,1444094.54,3238049.58
320160,202308,725,309,416,407889.03,549123.83,957012.86
320170,202308,125,100,25,132001.6,33000,165001.6
320180,202308,60,33,27,43561.02,35640,79201.02
320190,202308,286,166,120,219127.37,158400.1,377527.47
320200,202308,69,57,12,75243.07,15840,91083.07
320210,202308,1016,554,462,731299.17,609847.23,1341146.40
320220,202308,320,110,210,145200.5,278520.2,423720.7
320225,202308,94,78,16,102960.39,21120.2,124080.59
320230,202308,829,533,296,704911.26,390728.21,1095639.47
320240,202308,4014,1798,2216,2373443.48,2926474.56,5299918.04
320245,202308,602,409,193,539893.72,254766.86,794660.58
320250,202308,261,126,135,166326.69,178202.79,344529.48
320255,202308,127,95,32,125402.76,42240.54,167643.30
320260,202308,342,179,163,236281.82,215162.57,451444.39
320265,202308,161,123,38,162361.66,50160.06,212521.72
320270,202308,168,125,43,165002.85,56761.35,221764.20
320280,202308,1594,906,688,1195964.57,910818.48,2106783.05
320290,202308,73,57,16,75240.9,21120,96360.9
320300,202308,689,476,213,629660.99,282482.8,912143.79
320305,202308,847,471,376,623066.09,497653.26,1120719.35
320310,202308,232,141,91,186124.2,120120.9,306245.1
320313,202308,419,180,239,237608.01,315481.3,553089.31
320316,202308,114,86,28,113522.01,36960.3,150482.31
320320,202308,3890,1774,2116,2341753.35,2795794.83,5137548.18
320330,202308,328,236,92,311521.13,121440,432961.13
320332,202308,887,537,350,708880.71,462012.9,1170893.61
320334,202308,322,176,146,232322.23,192721.3,425043.53
320335,202308,159,103,56,135965.48,73922.39,209887.87
320340,202308,660,471,189,623069.54,250807.54,873877.08
320350,202308,1236,515,721,679825.2,953054.38,1632879.58
320360,202308,190,86,104,113521,137280,250801
320370,202308,257,190,67,250805.37,88440.69,339246.06
320380,202308,378,272,106,359049.86,139920.89,498970.75
320390,202308,1274,735,539,970232.65,711488.75,1681721.40
320400,202308,354,243,111,320775.7,146521.08,467296.78
320405,202308,1070,432,638,571586.51,842179.44,1413765.95
320410,202308,1043,507,536,669257.67,707526.31,1376783.98
320420,202308,682,310,372,409217.34,491054.33,900271.67
320425,202308,232,121,111,159722.73,146520.2,306242.93
320430,202308,445,236,209,312852.84,275889.87,588742.71
320435,202308,217,146,71,192722.26,93721.61,286443.87
320440,202308,238,135,103,178204.53,137283.64,315488.17
320450,202308,153,80,73,105602.75,96361.06,201963.81
320455,202308,264,204,60,269284.69,79200.66,348485.35
320460,202308,375,225,150,297004.18,200640.21,497644.39
320465,202308,131,88,43,116164.28,56760.63,172924.91
320470,202308,839,499,340,658712.85,448812.68,1107525.53
320480,202308,261,172,89,227049.09,117480.02,344529.11
320490,202308,3720,1773,1947,2341770.01,2575378.6,4917148.61
320495,202308,144,85,59,112200.75,77880,190080.75
320500,202308,12074,5908,6166,7806817.85,8148481.73,15955299.58
320501,202308,621,323,298,426378.94,394691.54,821070.48
320503,202308,359,252,107,332646.31,141241.08,473887.39
320506,202308,318,218,100,287764,132000.38,419764.38
320510,202308,1450,635,815,838226.43,1075817.63,1914044.06
320515,202308,98,76,22,100322.23,29040,129362.23
320517,202308,262,192,70,253445.8,92400.52,345846.32
320520,202308,9441,3989,5452,5270936.26,7199394.51,12470330.77
320530,202308,8413,4010,4403,5294681.23,5815988.63,11110669.86
330010,202308,4084,1970,2114,2601816.89,2794472.91,5396289.80
330015,202308,234,101,133,133321.59,176880.56,310202.15
330020,202308,4731,1782,2949,2354949.44,3901142.75,6256092.19
330022,202308,294,145,149,192725.19,196680.35,389405.54
330023,202308,1001,272,729,359045.97,963609.48,1322655.45
330025,202308,1166,198,968,261362.15,1278969.04,1540331.19
330030,202308,2182,1299,883,1716076.67,1169536.91,2885613.58
330040,202308,3081,1559,1522,2060588.48,2016985.84,4077574.32
330045,202308,12071,3920,8151,5178540.04,10767395.96,15945936.00
330050,202308,1030,615,415,811822.27,550445.7,1362267.97
330060,202308,1440,844,596,1115455.33,786729.87,1902185.20
330070,202308,5172,1751,3421,2312720.7,4521055.2,6833775.9
330080,202308,1858,797,1061,1052083.18,1405819.76,2457902.94
330090,202308,437,241,196,318128.33,260041.8,578170.13
330093,202308,251,105,146,138601.32,192721.48,331322.80
330095,202308,76,41,35,54120.17,46200,100320.17
330100,202308,12938,6435,6503,8497298.31,8601258.47,17098556.78
330110,202308,539,242,297,319446.53,393365.85,712812.38
330115,202308,574,284,290,376210.73,384122.15,760332.88
330120,202308,469,239,230,315485.4,303601.6,619087.0
330130,202308,1803,502,1301,662673.12,1719995.02,2382668.14
330140,202308,806,412,394,543848.87,520081.95,1063930.82
330150,202308,586,358,228,472571.91,300963.39,773535.30
330160,202308,172,109,63,143888.43,84481.85,228370.28
330170,202308,31300,11166,20134,14747632.72,26597097.73,41344730.45
330180,202308,289,156,133,205923.08,175562.32,381485.40
330185,202308,1420,570,850,752428.51,1123338.28,1875766.79
330187,202308,736,212,524,281170.05,694324.8,975494.85
330190,202308,7326,2808,4518,3709325.44,5969107.81,9678433.25
330200,202308,5327,1830,3497,2418328.63,4628007.47,7046336.10
330205,202308,559,308,251,407892.81,332643.61,740536.42
330210,202308,1022,606,416,799943.98,549125.32,1349069.30
330220,202308,3191,1875,1316,2475103.2,1739788.9,4214892.1
330225,202308,738,348,390,459366.06,514802.34,974168.40
330227,202308,2558,910,1648,1202573.49,2182023.52,3384597.01
330230,202308,261,137,124,180844.95,163683.27,344528.22
330240,202308,5176,2417,2759,3195853.93,3643261.18,6839115.11
330245,202308,189,87,102,114842.42,134640.86,249483.28
330250,202308,7722,3675,4047,4852518.26,5352680.41,10205198.67
330260,202308,939,272,667,359047.09,881764.38,1240811.47
330270,202308,4728,1526,3202,2017028.17,4228032.73,6245060.90
330280,202308,518,305,213,402618.54,281166.09,683784.63
330285,202308,7195,2330,4865,3078394.02,6429859.25,9508253.27
330290,202308,890,306,584,403932.72,770887.19,1174819.91
330300,202308,846,513,333,677995.44,439568.1,1117563.54
330310,202308,538,312,226,411852.4,298321.53,710173.93
330320,202308,8955,2985,5970,3946989.68,7885789.05,11832778.73
330330,202308,12082,3982,8100,5259046.9,10696084.75,15955131.65
330340,202308,3195,1739,1456,2295537.85,1924580.13,4220117.98
330350,202308,23845,8582,15263,11335324.16,20173928.95,31509253.11
330360,202308,2064,972,1092,1283098.91,1442790.61,2725889.52
330370,202308,1105,588,517,776188.64,682454.13,1458642.77
330380,202308,1204,491,713,649460.72,942492.71,1591953.43
330385,202308,759,365,394,483130.53,520084.05,1003214.58
330390,202308,7290,3812,3478,5037396.59,4596370.85,9633767.44
330395,202308,470,304,166,401292.71,219124.52,620417.23
330400,202308,787,406,381,535943.53,504243.46,1040186.99
330410,202308,589,425,164,561017.21,216484.06,777501.27
330411,202308,412,220,192,293043.61,253440,546483.61
330412,202308,254,122,132,161043.03,174240.1,335283.13
330414,202308,6490,2459,4031,3247336.06,5322296.06,8569632.12
330415,202308,712,303,409,399972.9,539884.66,939857.56
330420,202308,2872,1447,1425,1910092.22,1882332.97,3792425.19
330430,202308,2011,857,1154,1131270.23,1524615.16,2655885.39
330440,202308,456,227,229,302286.13,302281.68,604567.81
330450,202308,139,65,74,85800.66,99001.17,184801.83
330452,202308,2917,1170,1747,1548415.13,2307385.57,3855800.70
330455,202308,148382,52747,95635,69679116.48,126375073.74,196054190.22
330460,202308,288,134,154,176882.12,203280.4,380162.52
330470,202308,1418,759,659,1003224.76,871210.33,1874435.09
330475,202308,2139,661,1478,872534.96,1954934.7,2827469.66
330480,202308,894,497,397,656061.21,525364.4,1181425.61
330490,202308,19573,6077,13496,8025982.32,17825486.69,25851469.01
330500,202308,1860,816,1044,1078466.92,1379412.09,2457879.01
330510,202308,12871,4582,8289,6049811.34,10960108.63,17009919.97
330513,202308,106,57,49,75240.45,64680,139920.45
330515,202308,746,332,414,438249.78,547815.33,986065.11
330520,202308,2898,986,1912,1301566.55,2526518.18,3828084.73
330530,202308,201,117,84,155763.6,110880.1,266643.7
330540,202308,397,202,195,266643.2,258723.29,525366.49
330550,202308,3218,1080,2138,1426953.02,2828787.95,4255740.97
330555,202308,1352,493,859,652093.48,1139163.49,1791256.97
330560,202308,888,315,573,415811.58,757688.52,1173500.10
330570,202308,382,262,120,345842.12,158400.09,504242.21
330575,202308,1028,379,649,500295.71,859333.82,1359629.53
330580,202308,3975,2099,1876,2773398.83,2484271.55,5257670.38
330590,202308,271,142,129,187444.63,171602.08,359046.71
330600,202308,1683,987,696,1302887.09,921372.71,2224259.80
330610,202308,1835,929,906,1226311.77,1195926.24,2422238.01
330615,202308,249,196,53,258723.1,69962.46,328685.56
330620,202308,1085,470,615,620431.15,814452.42,1434883.57
330630,202308,5506,3128,2378,4134393,3144286.06,7278679.06
350010,202308,640,418,222,551783.88,293043.49,844827.37
350020,202308,65,24,41,31682.06,54120,85802.06
350030,202308,641,368,273,485785.82,360367.88,846153.70
350040,202308,118,51,67,67322.82,88440.47,155763.29
350050,202308,411,189,222,249486.34,293043.17,542529.51
350055,202308,148,63,85,83161.97,112200.21,195362.18
350060,202308,86,36,50,47522.06,66001.01,113523.07
350070,202308,879,483,396,638915.38,522735.38,1161650.76
350075,202308,91,52,39,68643.2,51480,120123.2
350080,202308,69,33,36,43560.82,47520.2,91081.02
350090,202308,86,46,40,60721.91,52800,113521.91
350100,202308,308,196,112,260045.21,150480,410525.21
350110,202308,48,32,16,42242.31,21120,63362.31
350115,202308,198,98,100,129364.83,132000.99,261365.82
350120,202308,123,81,42,106923.5,55440.97,162364.47
350130,202308,449,191,258,252136.22,341886.73,594022.95
350140,202308,39,24,15,31680.64,19800,51480.64
350150,202308,84,58,26,76562.23,34320.15,110882.38
350160,202308,2658,1054,1604,1396601.65,2121249.3,3517850.95
350170,202308,476,274,202,363010.51,266644.06,629654.57
350180,202308,173,92,81,121442.72,108240.2,229682.92
350190,202308,1084,590,494,780158.31,652081.13,1432239.44
350200,202308,63,27,36,35641.35,47520,83161.35
350210,202308,1441,756,685,999285.78,904221.14,1903506.92
350220,202308,671,530,141,699620.27,186122.47,885742.74
350230,202308,76,48,28,63360.67,36960.9,100321.57
350240,202308,61,39,22,51480.65,29040.46,80521.11
350250,202308,1201,523,678,690390.31,896292.34,1586682.65
350260,202308,120,85,35,112205.1,47520.87,159725.97
350270,202308,1071,695,376,917405.6,496322.75,1413728.35
350275,202308,378,144,234,190082.37,308883.88,498966.25
350280,202308,4840,2283,2557,3015014.45,3377898.78,6392913.23
350290,202308,549,234,315,308885.41,419762.01,728647.42
350300,202308,54,30,24,39603.58,31680,71283.58
350310,202308,88,51,37,67321.69,48840.59,116162.28
350315,202308,18,13,5,17160,7920,25080
350320,202308,3762,1764,1998,2329912.77,2640027.08,4969939.85
350330,202308,1834,881,953,1162960.55,1257964.34,2420924.89
350335,202308,25,16,9,21120,11880,33000
350340,202308,137,54,83,71281.54,110883.8,182165.34
350350,202308,99,46,53,60720,71280,132000
350360,202308,120,81,39,106924.11,51480.54,158404.65
350370,202308,92,52,40,68641.99,52800.48,121442.47
350380,202308,976,421,555,557058.35,732606.43,1289664.78
350390,202308,2050,775,1275,1023024.45,1685657.96,2708682.41
350395,202308,20,14,6,18480,7920,26400
350400,202308,1961,920,1041,1215761.01,1375441.04,2591202.05
350410,202308,3520,1395,2125,1841459.6,2811623.61,4653083.21
350420,202308,317,185,132,244202.82,175561.28,419764.10
350430,202308,113,58,55,76563.23,72602.42,149165.65
350440,202308,148,105,43,138610.56,56760.35,195370.91
350450,202308,1907,1028,879,1364933.55,1160281.94,2525215.49
350460,202308,476,164,312,216487.42,411850.16,628337.58
350470,202308,25,13,12,17160,15840,33000
350480,202308,221,114,107,150487.18,142561.3,293048.48
350490,202308,265,123,142,162363.08,188760.8,351123.88
350500,202308,66,22,44,29040,58080,87120
350510,202308,154,87,67,114843.45,91080.37,205923.82
350520,202308,497,270,227,356421.32,302289.82,658711.14
350530,202308,556,271,285,357736.59,377533.23,735269.82
350535,202308,105,69,36,91081.17,47520.46,138601.63
350540,202308,359,188,171,248167.28,225725.46,473892.74
350550,202308,3098,1717,1381,2266543.27,1826888.9,4093432.17
350560,202308,642,433,209,571580.43,275883.5,847463.93
350570,202308,5110,2120,2990,2798493.21,3952111.03,6750604.24
350580,202308,407,194,213,256090.46,281165.62,537256.08
350590,202308,1128,587,541,776185.95,714265.63,1490451.58
350600,202308,7196,3247,3949,4286255.57,5214044.17,9500299.74
350610,202308,1692,886,806,1169565.6,1063926.89,2233492.49
350620,202308,24,14,10,18480,13200,31680
350630,202308,284,142,142,187443.63,187442.39,374886.02
350635,202308,1527,666,861,880470.79,1136538.9,2017009.69
350640,202308,135,92,43,121440.6,56760.7,178201.3
350650,202308,2133,1393,740,1842805.5,982085.78,2824891.28
350660,202308,878,337,541,444847.09,716767.85,1161614.94
350670,202308,319,160,159,211203.4,211200.1,422403.5
350680,202308,165,87,78,114844.07,102960.92,217804.99
350690,202308,228,101,127,133322.03,167640,300962.03
350700,202308,1122,551,571,727348.34,755047.85,1482396.19
350710,202308,479,170,309,224407.61,407885.48,632293.09
350715,202308,62,47,15,62040.81,19800,81840.81
350720,202308,16,12,4,17161.16,5280,22441.16
350730,202308,54,33,21,43562.55,27720.61,71283.16
350740,202308,268,150,118,198002.97,155761.78,353764.75
350745,202308,37,17,20,22441.49,26400.75,48842.24
350750,202308,2907,1689,1218,2230880.06,1607773.42,3838653.48
350760,202308,4494,1871,2623,2473750.8,3466346.15,5940096.95
350770,202308,66,41,25,54120.5,33000,87120.5
350775,202308,78,57,21,75246.32,27720.67,102966.99
350780,202308,518,255,263,336611.41,347162.33,683773.74
350790,202308,392,164,228,216484.62,302285.08,518769.70
350800,202308,585,341,244,450127.43,322081.59,772209.02
350810,202308,547,413,134,545187.7,176880.39,722068.09
350820,202308,99,55,44,72601.82,58080,130681.82
350830,202308,89,45,44,59400.67,58080,117480.67
350840,202308,919,366,553,483135.22,730089.87,1213225.09
350850,202308,2099,1073,1026,1416402.26,1358288.49,2774690.75
350860,202308,795,398,397,525379.94,524052.26,1049432.20
350870,202308,500,341,159,451451.08,209881.26,661332.34
350880,202308,317,164,153,216486.73,201963.33,418450.06
350890,202308,43,25,18,33000,23760.08,56760.08
350900,202308,1826,616,1210,813145.65,1598547.91,2411693.56
350910,202308,28,15,13,19800,17160.36,36960.36
350920,202308,911,458,453,604573.3,597960.3,1202533.6
350925,202308,1299,637,662,840885.77,876497.4,1717383.17
350930,202308,141,77,64,101643.64,84480.28,186123.92
350940,202308,806,411,395,545186.48,522733.96,1067920.44
350945,202308,133,90,43,118802.78,56760.17,175562.95
350950,202308,20552,9554,10998,12620898.89,14541228.16,27162127.05
350960,202308,1983,795,1188,1052061.66,1572136.44,2624198.10
350970,202308,1216,570,646,752288.15,852734.68,1605022.83
350980,202308,103,68,35,91083.84,46200,137283.84
350990,202308,442,161,281,212521.7,370921.09,583442.79
350995,202308,51,23,28,30361,36960.84,67321.84
351000,202308,655,412,243,545180.55,320768.61,865949.16
351010,202308,54,36,18,47523.5,25080,72603.5
351015,202308,44,23,21,30360,27720,58080
351020,202308,1632,975,657,1288361.27,869888.93,2158250.20
351030,202308,371,206,165,271924.06,217800.32,489724.38
351040,202308,1186,662,524,876508.31,693004.15,1569512.46
351050,202308,4211,1893,2318,2500202.14,3065070.44,5565272.58
351060,202308,7125,2597,4528,3428162.07,5978305.2,9406467.27
351070,202308,441,278,163,366973.58,215166.48,582140.06
351080,202308,886,659,227,869904.02,299643.85,1169547.87
351090,202308,52,25,27,33001.6,35640.41,68642.01
351100,202308,461,240,221,316823.64,291731.51,608555.15
351110,202308,2341,1073,1268,1417731,1676404.11,3094135.11
351120,202308,68,32,36,42241.46,47520,89761.46
351130,202308,202,66,136,87123.28,179524.02,266647.30
351140,202308,347,210,137,277210.85,182163.15,459374.00
351150,202308,565,284,281,374888.36,370922.97,745811.33
351160,202308,382,205,177,270605.58,233640.72,504246.30
351170,202308,265,151,114,199323.43,150480.05,349803.48
351190,202308,110,66,44,87121.31,58080,145201.31
351200,202308,365,236,129,311529.16,170281.89,481811.05
351210,202308,142,67,75,88442.53,99000.78,187443.31
351220,202308,652,364,288,480495.91,380161.2,860657.11
351230,202308,352,218,134,287766.23,178200.6,465966.83
351240,202308,271,137,134,180842.33,176882.32,357724.65
351250,202308,99,70,29,93730.74,38280.1,132010.84
351260,202308,157,109,48,143880.58,63360.81,207241.39
351270,202308,52,23,29,30361.63,38280,68641.63
351280,202308,1156,565,591,745823.25,781449.97,1527273.22
351290,202308,273,130,143,171603.39,188760.7,360364.09
351300,202308,4718,1957,2761,2583316.24,3648527.18,6231843.42
351310,202308,791,386,405,509548.66,535934.9,1045483.56
351320,202308,130,74,56,97681.17,73920.6,171601.77
351330,202308,42,26,16,34320,21120,55440
351340,202308,1677,898,779,1185392.82,1028286.53,2213679.35
351350,202308,2764,1643,1121,2170181.17,1482368.23,3652549.40
351360,202308,876,407,469,537248.71,619084.81,1156333.52
351370,202308,498,247,251,326049.68,331320.15,657369.83
351380,202308,9644,4248,5396,5612792.75,7130672.1,12743464.85
351385,202308,27,20,7,26402.31,9240,35642.31
351390,202308,302,219,83,289086.22,109560.45,398646.67
351400,202308,62,41,21,54120.94,27720,81840.94
351410,202308,527,304,223,401295.14,294362.41,695657.55
351420,202308,86,61,25,80521.32,33000,113521.32
351430,202308,80,43,37,56761.64,48840.2,105601.84
351440,202308,930,609,321,805235.26,426367.25,1231602.51
351450,202308,317,158,159,208562.68,209884.7,418447.38
351460,202308,147,62,85,81844.44,112201.29,194045.73
351470,202308,148,78,70,102964.84,92400.89,195365.73
351480,202308,500,286,214,377524.99,282480.2,660005.19
351490,202308,342,136,206,179522.45,274560.72,454083.17
351492,202308,30,18,12,23760.63,17160,40920.63
351495,202308,29,21,8,27720.65,10560,38280.65
351500,202308,3775,1491,2284,1969479.31,3016218.26,4985697.57
351510,202308,2418,873,1545,1153716.3,2039416.09,3193132.39
351512,202308,16,10,6,13200,7920,21120
351515,202308,229,130,99,172925.63,130680,303605.63
351518,202308,739,435,304,574232.15,401303.04,975535.19
351519,202308,87,50,37,66002.23,48840,114842.23
351520,202308,187,116,71,153123.96,93721.02,246844.98
351530,202308,28,15,13,19800,17160,36960
351535,202308,146,86,60,113524.31,79200.51,192724.82
351540,202308,532,330,202,435615.81,266645.31,702261.12
351550,202308,1802,1050,752,1387364.74,993966.84,2381331.58
351560,202308,90,48,42,63362.16,55440,118802.16
351565,202308,16,9,7,11880.32,9240,21120.32
351570,202308,3237,1431,1806,1888989.39,2386581.28,4275570.67
351580,202308,37,34,3,44880,3960,48840
351590,202308,69,40,29,52801.71,38280.86,91082.57
351600,202308,180,131,49,172925.99,64680.76,237606.75
351610,202308,61,26,35,34320.79,46200,80520.79
351620,202308,6735,3531,3204,4669030.87,4235918.29,8904949.16
351630,202308,3847,1812,2035,2391915.23,2688865.36,5080780.59
351640,202308,3014,1304,1710,1721325.62,2259851.35,3981176.97
351650,202308,41,30,11,39601.22,14520,54121.22
351660,202308,147,91,56,120120.59,75240,195360.59
351670,202308,831,465,366,615145.43,484448.69,1099594.12
351680,202308,101,69,32,92400.9,42240,134640.9
351685,202308,17,13,4,17160.13,5280,22440.13
351690,202308,324,203,121,267968.2,159721.42,427689.62
351700,202308,191,132,59,174535.69,77880.2,252415.89
351710,202308,63,41,22,54122.5,29040,83162.5
351720,202308,125,71,54,93721.93,71280,165001.93
351730,202308,130,88,42,117481.07,55440,172921.07
351740,202308,865,538,327,710199.87,431646.7,1141846.57
351750,202308,421,174,247,229686.75,326041.6,555728.35
351760,202308,736,571,165,754952.42,217800.42,972752.84
351770,202308,325,257,68,340579.01,89760.56,430339.57
351780,202308,150,92,58,121442.38,76560,198002.38
351790,202308,295,142,153,187447.38,201963.24,389410.62
351800,202308,50,32,18,42240.18,23760,66000.18
351810,202308,127,80,47,105607.77,62041.47,167649.24
351820,202308,788,556,232,733968.51,307566.55,1041535.06
351830,202308,748,228,520,300970.69,686406.1,987376.79
351840,202308,2592,1150,1442,1518042.31,1904766.23,3422808.54
351850,202308,289,196,93,260049.63,122760,382809.63
351860,202308,650,433,217,571586.11,287763.25,859349.36
351870,202308,6683,2954,3729,3899440.1,4926342.97,8825783.07
351880,202308,26027,9943,16084,13138314.31,21252026.6,34390340.91
351885,202308,120,65,55,85802.72,72600.3,158403.02
351890,202308,83,54,29,71281.37,38280,109561.37
351900,202308,267,135,132,179527.95,174240.95,353768.90
351905,202308,113,55,58,72601.93,76560.24,149162.17
351907,202308,4274,1735,2539,2290282.06,3354145.75,5644427.81
351910,202308,171,75,96,99005.58,126721.18,225726.76
351920,202308,125,67,58,88440,76560,165000
351925,202308,100,59,41,77883.01,54121.51,132004.52
351930,202308,523,321,202,423742.32,266647.33,690389.65
351940,202308,259,108,151,142562.34,199321.07,341883.41
351950,202308,153,80,73,105600.98,96363.96,201964.94
351960,202308,1091,532,559,702270.03,739219.21,1441489.24
351970,202308,2424,1122,1302,1483708.7,1722620.1,3206328.8
351980,202308,167,74,93,97683.58,122762.09,220445.67
351990,202308,260,161,99,212524.61,130680.84,343205.45
352000,202308,281,187,94,246854.08,124084.1,370938.18
352010,202308,485,309,176,407987.23,232331.46,640318.69
352020,202308,224,70,154,92400,203280,295680
352030,202308,1335,609,726,805224.86,958333.86,1763558.72
352040,202308,784,303,481,399967.5,634925.51,1034893.01
352042,202308,384,95,289,125402.57,381482.19,506884.76
352044,202308,392,208,184,274574.56,242886.81,517461.37
352050,202308,3675,1350,2325,1783364.1,3074296.47,4857660.57
352060,202308,110,64,46,84480.18,60720.92,145201.10
352070,202308,118,76,42,100325.35,55440,155765.35
352080,202308,72,43,29,56762.84,38280.48,95043.32
352090,202308,211,127,84,167643.61,110881.17,278524.78
352100,202308,352,173,179,228365.96,236281.73,464647.69
352110,202308,117,32,85,42240.51,112200,154440.51
352115,202308,70,26,44,34320,58080.2,92400.2
352120,202308,77,51,26,67320,34320,101640
352130,202308,248,182,66,240253.59,87120.57,327374.16
352140,202308,215,110,105,145203.46,138602.39,283805.85
352150,202308,141,74,67,97682.52,88441.88,186124.40
352160,202308,146,97,49,129363.74,64680.54,194044.28
352170,202308,474,312,162,411844.44,213840.08,625684.52
352180,202308,778,452,326,596663.08,431647.23,1028310.31
352190,202308,261,107,154,141246.35,203281.85,344528.20
352200,202308,33,15,18,19801.15,23760.1,43561.25
352210,202308,5125,2001,3124,2642760.32,4126344.86,6769105.18
352215,202308,81,40,41,52800.2,54120,106920.2
352220,202308,6640,2465,4175,3253908.01,5516336.21,8770244.22
352230,202308,4096,2538,1558,3351621.27,2061847.63,5413468.90
352240,202308,3102,1721,1381,2275754.09,1824257.34,4100011.43
352250,202308,4349,1921,2428,2535798.23,3207608.03,5743406.26
352260,202308,1146,596,550,786742.37,726011.62,1512753.99
352265,202308,81,48,33,63360,43560,106920
352270,202308,438,234,204,308906.28,269286.12,578192.40
352280,202308,560,330,230,435610.72,304920,740530.72
352290,202308,191,107,84,141246.49,110882.21,252128.70
352300,202308,105,60,45,79205.12,59400.77,138605.89
352310,202308,9000,3925,5075,5181196.95,6705613.94,11886810.89
352320,202308,1278,662,616,873859.72,813127.05,1686986.77
352330,202308,572,294,278,389403.19,366960.79,756363.98
352340,202308,1558,702,856,926668.9,1132565.9,2059234.8
352350,202308,411,229,182,302287.22,240242.07,542529.29
352360,202308,238,103,135,135962.28,178200.7,314162.98
352370,202308,135,83,52,109564.7,68641.62,178206.32
352380,202308,121,87,34,114844.29,44881.39,159725.68
352390,202308,2900,1216,1684,1606495.15,2224207.49,3830702.64
352400,202308,617,267,350,352445.16,463322.83,815767.99
352410,202308,1035,682,353,900282.58,465977.92,1366260.50
352420,202308,100,75,25,99001.24,33000,132001.24
352430,202308,1894,817,1077,1078492.09,1421666.91,2500159.00
352440,202308,3976,1722,2254,2275762.17,2979252.14,5255014.31
352450,202308,200,154,46,203284.58,60721.11,264005.69
352460,202308,709,355,354,468608.98,468605.13,937214.11
352470,202308,759,293,466,388095.57,615124.39,1003219.96
352480,202308,1814,1027,787,1355685.41,1041498.2,2397183.61
352490,202308,67,30,37,39600.1,48840.16,88440.26
352500,202308,1738,677,1061,894977.8,1401848.28,2296826.08
352510,202308,810,422,388,557069.11,512164.1,1069233.21
352520,202308,985,437,548,576855.1,723373.36,1300228.46
352530,202308,2180,1067,1113,1408502.13,1474449.74,2882951.87
352540,202308,76,53,23,69963.13,30360,100323.13
352550,202308,242,133,109,175561.24,143880,319441.24
352560,202308,57,40,17,52800.87,22440.84,75241.71
352570,202308,869,416,453,553108.24,597975.93,1151084.17
352580,202308,57,43,14,56762.27,18480,75242.27
352585,202308,17,5,12,6600.25,15840.95,22441.20
352590,202308,5009,2440,2569,3224876.47,3397705.39,6622581.86
352600,202308,409,278,131,366972.71,174247.55,541220.26
352610,202308,982,420,562,555732.73,743164.24,1298896.97
352620,202308,1268,474,794,625692.42,1048089.68,1673782.10
352630,202308,208,77,131,101640.3,172920.08,274560.38
352640,202308,565,359,206,475224.56,271923.48,747148.04
352650,202308,96,65,31,85802.73,42240,128042.73
352660,202308,74,37,37,48840.67,48840,97680.67
352670,202308,1920,1012,908,1337235.75,1198561.72,2535797.47
352680,202308,1083,630,453,831631.11,599300.27,1430931.38
352690,202308,5250,2298,2952,3037430.83,3903267.99,6940698.82
352700,202308,98,53,45,69963.65,59401.38,129365.03
352710,202308,1681,868,813,1145809.11,1073162.62,2218971.73
352720,202308,1804,739,1065,978161.08,1405828.2,2383989.28
352725,202308,32,23,9,30361.44,11880,42241.44
352730,202308,463,223,240,294370.82,316803.49,611174.31
352740,202308,408,260,148,343217.71,195362.67,538580.38
352750,202308,26,17,9,22441.65,11880,34321.65
352760,202308,256,164,92,216486.07,121440.92,337926.99
352770,202308,84,60,24,79201.24,31680,110881.24
352780,202308,77,42,35,55440,46200.78,101640.78
352790,202308,27,17,10,22442.57,13200.18,35642.75
352800,202308,268,203,65,267967.16,85801.68,353768.84
352810,202308,162,106,56,139921.49,73922.86,213844.35
352820,202308,43,33,10,43560.89,13200,56760.89
352830,202308,76,48,28,63361.15,36960.01,100321.16
352840,202308,795,342,453,451458.82,597967.3,1049426.12
352850,202308,2111,625,1486,825014.79,1964169.7,2789184.49
352860,202308,133,83,50,109563.2,66000.12,175563.32
352870,202308,54,33,21,43565.55,27720.82,71286.37
352880,202308,202,112,90,147846,118802.3,266648.3
352885,202308,35,23,12,31680.32,15840,47520.32
352890,202308,62,39,23,51481.46,30360,81841.46
352900,202308,5038,2359,2679,3116642.07,3540254.99,6656897.06
352910,202308,40,31,9,40920.88,11880,52800.88
352920,202308,693,393,300,520102.5,397324.98,917427.48
352930,202308,1292,592,700,782794.64,925324.58,1708119.22
352940,202308,7107,2676,4431,3533727.88,5860860.56,9394588.44
352950,202308,135,63,72,83162.62,95042.86,178205.48
352960,202308,75,52,23,68641.13,30360,99001.13
352965,202308,17,10,7,13200,9240,22440
352970,202308,595,428,167,564982.27,221765.91,786748.18
352980,202308,165,96,69,126724.54,91081.37,217805.91
352990,202308,1035,474,561,625710.03,740531.83,1366241.86
353000,202308,66,34,32,44880.95,42240.98,87121.93
353010,202308,563,335,228,442216.78,302284.3,744501.08
353020,202308,374,243,131,320770.39,174243.2,495013.59
353030,202308,1513,686,827,906871.38,1094301.8,2001173.18
353040,202308,102,53,49,69961.35,64680.74,134642.09
353050,202308,1486,971,515,1281784.91,682443.12,1964228.03
353060,202308,10318,4498,5820,5941564.51,7687741.17,13629305.68
353070,202308,2248,1306,942,1725309.39,1245846.84,2971156.23
353080,202308,1436,760,676,1003240.31,893642.37,1896882.68
353090,202308,75,41,34,54121.83,44880,99001.83
353100,202308,49,36,13,47522.3,17161.54,64683.84
353110,202308,2578,865,1713,1141859.78,2262553.57,3404413.35
353120,202308,151,89,62,117480.48,81840.56,199321.04
353130,202308,934,440,494,580824.82,654723.44,1235548.26
353140,202308,630,288,342,380181.21,451446.75,831627.96
353150,202308,344,174,170,229686.27,224403.51,454089.78
353160,202308,110,83,27,109565.2,35640,145205.2
353170,202308,213,73,140,96361.35,184800.51,281161.86
353180,202308,1464,674,790,889697.5,1042813.12,1932510.62
353190,202308,540,381,159,502944.96,211202.53,714147.49
353200,202308,317,153,164,201963.33,217801.22,419764.55
353205,202308,22,14,8,18480,10560,29040
353210,202308,82,48,34,63361.8,44880.17,108241.97
353215,202308,46,26,20,34320.2,26400,60720.2
353220,202308,89,48,41,63361.46,54120.68,117482.14
353230,202308,172,78,94,102961.89,124080,227041.89
353240,202308,443,188,255,248162.55,336600.28,584762.83
353250,202308,195,100,95,132003.12,125401.26,257404.38
353260,202308,503,315,188,417137.59,249486.46,666624.05
353270,202308,74,56,18,73923.77,23760,97683.77
353280,202308,126,55,71,72603.7,93724.79,166328.49
353282,202308,134,89,45,117481.57,59400,176881.57
353284,202308,31,25,6,33002.16,7920,40922.16
353286,202308,10,4,6,5280.2,7920.14,13200.34
353290,202308,88,50,38,66001.09,50160,116161.09
353300,202308,482,235,247,310215.1,326049.03,636264.13
353310,202308,41,31,10,40921.49,13200.95,54122.44
353320,202308,46,24,22,31680.81,29040.2,60721.01
353325,202308,49,25,24,33002.07,31680,64682.07
353330,202308,62,41,21,54120.1,27720.26,81840.36
353340,202308,784,297,487,393370.45,644165.84,1037536.29
353350,202308,1038,510,528,673222.82,696975.43,1370198.25
353360,202308,111,89,22,117482.54,29040.6,146523.14
353370,202308,113,61,52,80522.91,69960.38,150483.29
353380,202308,29,14,15,18480.2,19800,38280.2
353390,202308,1238,583,655,769592.79,864614.78,1634207.57
353400,202308,60,33,27,43561.95,35641.25,79203.20
353410,202308,130,68,62,89763.89,81841.31,171605.20
353420,202308,68,32,36,42240,47520,89760
353430,202308,618,400,218,528024.64,290408.23,818432.87
353440,202308,15097,6686,8411,8831001.44,11110497.51,19941498.95
353450,202308,54,26,28,34320.8,36960.2,71281.0
353460,202308,724,374,350,493700.61,462010.13,955710.74
353470,202308,2517,1198,1319,1584070.65,1742409.43,3326480.08
353475,202308,305,194,111,256084.94,146520.91,402605.85
353480,202308,246,178,68,234963.85,89760,324723.85
353490,202308,238,136,102,179525.32,134640.22,314165.54
353500,202308,229,128,101,168964.16,133320.93,302285.09
353510,202308,87,55,32,72601.87,42240.14,114842.01
353520,202308,274,193,81,254763.81,108240,363003.81
353530,202308,531,265,266,351134.34,352444.57,703578.91
353540,202308,394,246,148,327377.8,198005.26,525383.06
353550,202308,835,512,323,675885.64,426373.37,1102259.01
353560,202308,589,241,348,318122.27,462002.4,780124.67
353570,202308,64,45,19,59401.53,25080,84481.53
353580,202308,403,242,161,320766.94,212520,533286.94
353590,202308,103,75,28,99002.44,36960,135962.44
353600,202308,307,178,129,234967.11,171600.32,406567.43
353610,202308,153,85,68,112200.59,89760,201960.59
353620,202308,726,349,377,460692.29,497649.27,958341.56
353625,202308,69,36,33,47521.62,43560.33,91081.95
353630,202308,244,167,77,220447.71,101640.78,322088.49
353640,202308,147,90,57,118806.56,75240.41,194046.97
353650,202308,1196,471,725,621731.26,957008.19,1578739.45
353657,202308,27,21,6,27720,7920,35640
353660,202308,318,166,152,219124.76,200643.02,419767.78
353670,202308,799,446,353,588740.89,467286.1,1056026.99
353680,202308,155,96,59,128040.58,77880,205920.58
353690,202308,49,32,17,42240.83,22441.09,64681.92
353700,202308,310,210,100,277207.5,133321.88,410529.38
353710,202308,626,303,323,399978.23,426363.45,826341.68
353715,202308,42,23,19,30360,25080,55440
353720,202308,333,152,181,200646.77,240244.09,440890.86
353730,202308,1274,738,536,975531.78,708842.73,1684374.51
353740,202308,648,350,298,463338.12,393368.24,856706.36
353750,202308,102,54,48,71282.42,63360,134642.42
353760,202308,3739,1465,2274,1935203.34,3005681.89,4940885.23
353770,202308,79,63,16,83160.4,21120.2,104280.6
353780,202308,1550,701,849,926662.51,1123328.62,2049991.13
353790,202308,553,323,230,426374.48,303608.1,729982.58
353800,202308,4355,1975,2380,2609764.51,3142927.49,5752692.00
353810,202308,248,127,121,167651.22,159720.98,327372.20
353820,202308,308,128,180,168960.85,237601.01,406561.86
353830,202308,79,65,14,85801.75,18480.9,104282.65
353850,202308,225,97,128,128043.77,168962.07,297005.84
353860,202308,597,276,321,365650.6,423723,789373.6
353870,202308,6567,3346,3221,4419495.39,4257030.63,8676526.02
353880,202308,801,514,287,678508.5,380164.45,1058672.95
353890,202308,645,364,281,481821.49,372244.66,854066.15
353900,202308,151,79,72,104283.83,95041.62,199325.45
353910,202308,231,98,133,129362.83,175560.66,304923.49
353920,202308,533,266,267,351128.09,352444.4,703572.49
353930,202308,1170,677,493,893676.73,652083.69,1545760.42
353940,202308,223,108,115,142563.01,153122.31,295685.32
353950,202308,564,367,197,485780.68,261363.62,747144.30
353960,202308,82,65,17,85802.99,22440,108242.99
353970,202308,43,28,15,36960.34,19801.56,56761.90
353980,202308,2315,999,1316,1318719.48,1739778.3,3058497.78
353990,202308,88,54,34,71282.07,44880.61,116162.68
354000,202308,412,180,232,238927.1,308881.9,547809.0
354010,202308,91,51,40,67323.52,52800.69,120124.21
354020,202308,571,351,220,463334.66,293044.59,756379.25
354025,202308,45,36,9,47521.37,11880,59401.37
354030,202308,47,25,22,33001.67,29040.15,62041.82
354040,202308,103,77,26,101643.35,34320,135963.35
354050,202308,167,88,79,116161.92,104281.28,220443.20
354060,202308,929,436,493,575529.24,654722.18,1230251.42
354070,202308,1012,566,446,747141.7,590046.16,1337187.86
354075,202308,218,103,115,135964.39,151802.06,287766.45
354080,202308,325,147,178,194045.63,236281.89,430327.52
354085,202308,28,17,11,22441.7,14520,36961.7
354090,202308,300,171,129,226933.03,170281.35,397214.38
354100,202308,7072,2853,4219,3767425.31,5575754.64,9343179.95
354105,202308,112,61,51,80521.75,67320,147841.75
354110,202308,48,23,25,30360,33000.2,63360.2
354120,202308,172,104,68,137284.97,89760.97,227045.94
354130,202308,880,552,328,729987.64,435602.7,1165590.34
354140,202308,3752,1694,2058,2236178.35,2721856.51,4958034.86
354150,202308,725,423,302,559709.28,398646.45,958355.73
354160,202308,727,435,292,575554.2,385448.15,961002.35
354165,202308,13,8,5,10560,6600,17160
354170,202308,203,135,68,178206.33,91080.22,269286.55
354180,202308,55,33,22,43560.4,29040.57,72600.97
354190,202308,309,109,200,143882.53,264001.51,407884.04
354200,202308,120,59,61,77882.3,80522.12,158404.42
354210,202308,81,37,44,48840,59400,108240
354220,202308,659,392,267,517468.8,352446.38,869915.18
354230,202308,183,84,99,110882.5,130680.87,241563.37
354240,202308,378,224,154,295692.83,203280.72,498973.55
354250,202308,81,47,34,62040.66,44880,106920.66
354260,202308,2326,1050,1276,1387361.93,1688307.45,3075669.38
354270,202308,103,74,29,97682.23,38280.5,135962.73
354280,202308,62,36,26,47520.79,34320,81840.79
354290,202308,165,109,56,143886.1,73920,217806.1
354300,202308,343,241,102,318126.5,134641.64,452768.14
354310,202308,101,69,32,91086.01,42240.6,133326.61
354320,202308,246,114,132,150482.21,176880,327362.21
354323,202308,12,8,4,10560,5280,15840
354325,202308,130,70,60,92401.75,79200.42,171602.17
354330,202308,2709,912,1797,1203887.88,2379968.66,3583856.54
354340,202308,11980,5385,6595,7108199.74,8716027.17,15824226.91
354350,202308,165,108,57,142561.07,75240,217801.07
354360,202308,76,45,31,60721.43,40921.36,101642.79
354370,202308,259,127,132,168963.82,174241.56,343205.38
354380,202308,193,109,84,143883.68,110880,254763.68
354390,202308,3148,1147,2001,1519367.8,2643986.56,4163354.36
354400,202308,410,219,191,289085.93,253440.59,542526.52
354410,202308,795,346,449,458057.75,595329.5,1053387.25
354420,202308,305,204,101,269289.55,133322.91,402612.46
354425,202308,371,205,166,270669.98,220443.5,491113.48
354430,202308,137,83,54,109567.45,71280.29,180847.74
354440,202308,31,24,7,31681.14,9240,40921.14
354450,202308,56,39,17,51481.34,22440,73921.34
354460,202308,101,55,46,72604.95,60721.88,133326.83
354470,202308,14,8,6,10560.63,7920.76,18481.39
354480,202308,127,66,61,87120.65,80520.86,167641.51
354490,202308,129,77,52,101645.89,68642.43,170288.32
354500,202308,449,191,258,252123.46,340561.38,592684.84
354510,202308,87,62,25,81843.33,34320.87,116164.20
354515,202308,52,19,33,25082.19,43560.1,68642.29
354520,202308,1869,753,1116,993809.65,1474441.16,2468250.81
354530,202308,965,469,496,619096.65,656041.83,1275138.48
354540,202308,265,129,136,171606.03,180841.65,352447.68
354550,202308,45,25,20,34320.59,26400,60720.59
354560,202308,180,97,83,128041.23,109560,237601.23
354570,202308,154,102,52,134640.58,68640,203280.58
354580,202308,2118,988,1130,1306832.72,1494246.06,2801078.78
354600,202308,318,147,171,194046.48,225720.5,419766.98
354610,202308,66,54,12,71280.99,15840.82,87121.81
354620,202308,85,25,60,33000,79200.58,112200.58
354625,202308,20,14,6,18482.34,7920.72,26403.06
354630,202308,404,273,131,360379.87,172923.29,533303.16
354640,202308,922,534,388,706464.49,512166.79,1218631.28
354650,202308,69,42,27,55441.88,35640,91081.88
354660,202308,928,667,261,881803.13,345842.75,1227645.88
354670,202308,251,97,154,128040.97,203280.2,331321.17
354680,202308,1533,547,986,723377.91,1301527.04,2024904.95
354690,202308,80,51,29,67323.43,38280,105603.43
354700,202308,81,57,24,75240.55,31680,106920.55
354710,202308,50,34,16,44880.3,21120,66000.3
354720,202308,24,21,3,27720.35,5280,33000.35
354730,202308,2102,852,1250,1124667.44,1650016.65,2774684.09
354740,202308,77,56,21,73920.76,27720,101640.76
354750,202308,443,243,200,322088.52,265322.66,587411.18
354760,202308,584,367,217,484475.59,286448.18,770923.77
354765,202308,8,3,5,3960,6600,10560
354770,202308,391,246,145,324733.34,191402.47,516135.81
354780,202308,9744,3543,6201,4676874.69,8191959.18,12868833.87
354790,202308,98,55,43,72600.82,56761.68,129362.50
354800,202308,486,258,228,340635.56,302286.23,642921.79
354805,202308,81,41,40,54121.21,52800.27,106921.48
354810,202308,106,55,51,72601.41,67320,139921.41
354820,202308,234,98,136,129361.94,179523.85,308885.79
354830,202308,50,30,20,39600,26400,66000
354840,202308,56,36,20,47520.25,26400,73920.25
354850,202308,6144,2472,3672,3264497.91,4849731.06,8114228.97
354860,202308,385,169,216,223081.01,287761.98,510842.99
354870,202308,14314,6232,8082,8229114.91,10682832.3,18911947.21
354880,202308,3048,1120,1928,1479763.24,2549004.42,4028767.66
354890,202308,3536,1880,1656,2484363.64,2187256.25,4671619.89
354900,202308,65,47,18,62041.01,23760.19,85801.20
354910,202308,1471,739,732,975511.3,966241.53,1941752.83
354920,202308,38,33,5,43560.6,6600,50160.6
354925,202308,28,19,9,25080.4,11880,36960.4
354930,202308,41,32,9,42241.97,11880,54121.97
354940,202308,834,579,255,764315.56,337926.21,1102241.77
354950,202308,211,127,84,167644.91,110882.26,278527.17
354960,202308,136,49,87,64681.87,114840.75,179522.62
354970,202308,1385,984,401,1298931.37,529321.92,1828253.29
354980,202308,10858,3981,6877,5264360.15,9092229.04,14356589.19
354990,202308,12187,5392,6795,7124239.47,8976050.15,16100289.62
354995,202308,662,223,439,294363.66,579488.94,873852.60
355000,202308,463,159,304,209882.43,401280.7,611163.13
355010,202308,782,492,290,649480.67,382806.45,1032287.12
355020,202308,896,540,356,712818.96,471246.26,1184065.22
355030,202308,248276,91925,156351,121436098.45,206653568.4,328089666.85
355040,202308,1187,589,598,777506.73,792012.02,1569518.75
355050,202308,182,100,82,133322.15,108240,241562.15
355060,202308,2113,984,1129,1298944.48,1490287.25,2789231.73
355070,202308,1860,797,1063,1053390.35,1405819.26,2459209.61
355080,202308,225,131,94,172922.41,124081.78,297004.19
355090,202308,348,213,135,281172.65,179522.98,460695.63
355100,202308,6474,2982,3492,3938938.85,4610800.69,8549739.54
355110,202308,226,147,79,195362.11,105601.08,300963.19
355120,202308,50,32,18,43560.54,23760,67320.54
355130,202308,63,36,27,47520.89,35640,83160.89
355140,202308,217,124,93,163684.07,122760.71,286444.78
355150,202308,806,474,332,625706.01,439566.05,1065272.06
355160,202308,585,277,308,365658.82,407884.36,773543.18
355170,202308,2306,1179,1127,1557661,1488975.21,3046636.21
355180,202308,754,290,464,382806.38,612489.12,995295.50
355190,202308,238,157,81,208567.36,106922.71,315490.07
355200,202308,127,57,70,75241.37,92400,167641.37
355210,202308,799,406,393,537250.33,520084.28,1057334.61
355220,202308,9142,4237,4905,5599630.72,6479938.33,12079569.05
355230,202308,101,54,47,71281.3,62041.87,133323.17
355240,202308,5259,2070,3189,2732426.24,4212141.19,6944567.43
355250,202308,8163,3603,4560,4757481.51,6032429.07,10789910.58
355255,202308,50,30,20,39600.62,26400,66000.62
355260,202308,211,116,95,153124.67,125401.29,278525.96
355270,202308,174,115,59,151804.7,77880.98,229685.68
355280,202308,8370,3105,5265,4104011.47,6955162.12,11059173.59
355290,202308,73,55,18,72600.58,23760,96360.58
355300,202308,261,149,112,198004.22,149161.28,347165.50
355310,202308,116,67,49,88440,64680,153120
355320,202308,116,57,59,75240.6,77880.96,153121.56
355330,202308,370,215,155,283810.82,205922.75,489733.57
355340,202308,1415,534,881,706297.56,1165603.96,1871901.52
355350,202308,185,89,96,117480,126720.2,244200.2
355360,202308,215,140,75,184808.75,99001.53,283810.28
355365,202308,23,17,6,22440,7920,30360
355370,202308,1124,650,474,858042.03,630963,1489005.03
355380,202308,926,540,386,712833.43,510847.52,1223680.95
355385,202308,109,68,41,89760.2,54120,143880.2
355390,202308,117,64,53,84481.02,69960.11,154441.13
355395,202308,220,106,114,139927.05,151804.61,291731.66
355400,202308,2033,1114,919,1470419.62,1215721.48,2686141.10
355410,202308,5995,2691,3304,3557529.21,4365259.91,7922789.12
355420,202308,50,34,16,44880.8,21120,66000.8
355430,202308,517,293,224,389425.6,297009.45,686435.05
355440,202308,103,57,46,75241.1,60721.27,135962.37
355450,202308,511,260,251,343213.5,331322.2,674535.7
355460,202308,64,43,21,56761.1,27720.8,84481.9
355465,202308,55,29,26,38280.51,34320,72600.51
355470,202308,210,87,123,114842.88,163681.11,278523.99
355475,202308,8,5,3,6600.81,3960,10560.81
355480,202308,722,292,430,385457.87,567604.54,953062.41
355490,202308,121,88,33,116166.27,43562.71,159728.98
355495,202308,128,54,74,71280,97681.49,168961.49
355500,202308,1744,949,795,1254038.38,1050725.06,2304763.44
355510,202308,294,201,93,265331.56,122761.27,388092.83
355520,202308,30,20,10,26400.18,13200,39600.18
355530,202308,24,13,11,17160,14520,31680
355535,202308,95,44,51,58083.85,67320,125403.85
355540,202308,3210,1252,1958,1656664.48,2587247.83,4243912.31
355550,202308,74,40,34,52800,44880,97680
355560,202308,292,128,164,168964.57,216483.01,385447.58
355570,202308,17,13,4,17160.25,5280,22440.25
355580,202308,244,164,80,216489.93,105601.48,322091.41
355590,202308,16,11,5,14520.24,6600,21120.24
355600,202308,296,144,152,191405.88,200642.14,392048.02
355610,202308,273,162,111,213847.09,146523.15,360370.24
355620,202308,1465,605,860,799945.85,1135203.45,1935149.30
355630,202308,444,313,131,413178.64,175562,588740.64
355635,202308,140,55,85,73920.28,112200,186120.28
355640,202308,655,339,316,448809.36,419766,868575.36
355645,202308,983,341,642,451455.89,850088.56,1301544.45
355650,202308,2031,879,1152,1160329.22,1521961.72,2682290.94
355660,202308,239,123,116,162363.56,154442.11,316805.67
355670,202308,744,312,432,411844.93,570244.34,982089.27
355680,202308,229,121,108,159733.63,142561.52,302295.15
355690,202308,102,45,57,59401.75,75240.57,134642.32
355695,202308,22,12,10,15840,13200,29040
355700,202308,1462,652,810,860671.76,1070525.64,1931197.40
355710,202308,2522,1389,1133,1836201.57,1499524.02,3335725.59
355715,202308,16,13,3,17162.08,3960.1,21122.18
355720,202308,282,174,108,229686.96,143881.51,373568.47
355730,202308,115,67,48,88441.83,63360.15,151801.98
410010,202308,110,89,21,117483,27720,145203
410020,202308,127,89,38,117483.84,50160.2,167644.04
410030,202308,211,108,103,143883.05,135964.38,279847.43
410040,202308,1605,764,841,1008506.12,1110129.36,2118635.48
410045,202308,43,34,9,44880.92,11880,56760.92
410050,202308,573,328,245,434284.57,324720.74,759005.31
410060,202308,224,163,61,215168.48,80520.5,295688.98
410070,202308,264,212,52,279850.62,68641.19,348491.81
410080,202308,207,127,80,167643.38,108240,275883.38
410090,202308,57,49,8,64684.76,10560,75244.76
410100,202308,287,180,107,237603.34,141240.1,378843.44
410105,202308,44,27,17,35640,22440,58080
410110,202308,397,241,156,318135.87,205926.07,524061.94
410115,202308,52,27,25,35640,33000.2,68640.2
410120,202308,508,233,275,307569.35,364323.57,671892.92
410130,202308,75,39,36,51480.73,47520,99000.73
410140,202308,3626,1658,1968,2188613.32,2600422.49,4789035.81
410150,202308,2903,1182,1721,1560093.81,2275697.04,3835790.85
410160,202308,523,298,225,393367.54,297003.21,690370.75
410165,202308,64,41,23,54120.41,30360,84480.41
410170,202308,225,127,98,167643.05,129360.99,297004.04
410180,202308,2683,1396,1287,1847363.54,1700184.58,3547548.12
410185,202308,39,32,7,42240,9240,51480
410190,202308,534,346,188,456729.57,248160.9,704890.47
410200,202308,1186,827,359,1092976.47,473883.64,1566860.11
410210,202308,716,371,345,489731.2,455401.82,945133.02
410220,202308,56,26,30,34320.84,39600,73920.84
410230,202308,215,93,122,122760.75,161042.19,283802.94
410240,202308,767,488,279,644183.16,369601.95,1013785.11
410250,202308,404,269,135,355084.76,178202.22,533286.98
410260,202308,346,188,158,248167.11,208568.81,456735.92
410270,202308,29,20,9,26400.72,11880,38280.72
410275,202308,64,44,20,58081.97,26400,84481.97
410280,202308,338,204,134,269290.63,176880.2,446170.83
410290,202308,291,164,127,216485.08,167640.5,384125.58
410300,202308,101,61,40,80520,52800,133320
410302,202308,29,16,13,21120.94,17160,38280.94
410304,202308,47,31,16,40921.2,21120,62041.2
410305,202308,222,136,86,179527.59,113520,293047.59
410310,202308,204,119,85,157082.67,112202.42,269285.09
410315,202308,40,33,7,44880.2,9240,54120.2
410320,202308,152,107,45,141241.24,59400,200641.24
410322,202308,41,24,17,31680.88,22440,54120.88
410330,202308,186,120,66,158402.31,87120,245522.31
410335,202308,109,61,48,80520,63360,143880
410337,202308,48,38,10,50160.5,13200,63360.5
410340,202308,38,31,7,40921.45,9240,50161.45
410345,202308,209,132,77,175254.18,101640.2,276894.38
410347,202308,40,30,10,39600.14,13200.16,52800.30
410350,202308,266,154,112,203284.54,147840,351124.54
410360,202308,491,298,193,393370.7,254760.53,648131.23
410370,202308,2523,1101,1422,1453357.76,1878374.42,3331732.18
410380,202308,211,117,94,154444.66,124080.98,278525.64
410390,202308,457,276,181,364325.82,238921.55,603247.37
410395,202308,36,22,14,29041.72,18480.95,47522.67
410400,202308,1058,452,606,596661.35,799929.76,1396591.11
410405,202308,87,68,19,89764.01,25080.22,114844.23
410410,202308,34,18,16,23762.35,21120.1,44882.45
410420,202308,2061,909,1152,1202434.07,1520657.73,2723091.80
410425,202308,234,106,128,139922.25,168960.2,308882.45
410430,202308,2683,1364,1319,1800518.98,1742418.24,3542937.22
410440,202308,381,274,107,361683.6,141242.19,502925.79
410442,202308,383,236,147,311530.18,194041.98,505572.16
410445,202308,362,254,108,335287.56,142561.1,477848.66
410450,202308,426,205,221,270606.54,293040.26,563646.80
410460,202308,623,341,282,451443.99,372242.01,823686.00
410465,202308,288,160,128,211205.62,168960.89,380166.51
410470,202308,263,149,114,196687.37,150481.21,347168.58
410480,202308,7478,3610,3868,4767974.5,5112411.31,9880385.81
410490,202308,1546,833,713,1099589.59,942488.61,2042078.20
410500,202308,306,183,123,242882.37,162360.55,405242.92
410510,202308,219,164,55,216488.36,72601.85,289090.21
410520,202308,306,218,88,287761.06,116160,403921.06
410530,202308,279,90,189,118800.59,252120,370920.59
410540,202308,418,301,117,398648.24,154440.61,553088.85
410550,202308,1890,815,1075,1075818.38,1421647.52,2497465.90
410560,202308,193,124,69,163683.99,91080.94,254764.93
410570,202308,476,309,167,409206.54,220442.35,629648.89
410580,202308,4344,1811,2533,2391912.03,3350210.3,5742122.33
410590,202308,477,308,169,406547.34,223080,629627.34
410600,202308,116,97,19,128040.93,25080,153120.93
410610,202308,68,55,13,72600.8,17160,89760.8
410620,202308,306,177,129,234966.28,170281.37,405247.65
410630,202308,502,272,230,360362.69,304920.38,665283.07
410640,202308,1319,822,497,1085058.53,657362.78,1742421.31
410645,202308,117,88,29,116163.77,38280.2,154443.97
410650,202308,411,252,159,332645.67,209882.13,542527.80
410655,202308,93,67,26,88441.04,34320.08,122761.12
410657,202308,40,17,23,22440,30360,52800
410660,202308,714,489,225,645500.93,297002.66,942503.59
410670,202308,75,60,15,79202.83,19800.13,99002.96
410680,202308,202,159,43,209885.03,56760.2,266645.23
410685,202308,47,34,13,44880.49,17160,62040.49
410690,202308,33092,13520,19572,17865798.47,25866987.97,43732786.44
410700,202308,355,254,101,335566.75,133320.37,468887.12
410710,202308,125,102,23,134642.33,30360.2,165002.53
410712,202308,45,30,15,39600.65,19800,59400.65
410715,202308,113,84,29,110882.86,38280,149162.86
410720,202308,721,409,312,539890.58,411841.47,951732.05
410725,202308,210,137,73,180842.54,96360,277202.54
410730,202308,112,49,63,64680.79,83160,147840.79
410740,202308,80,60,20,79201.34,26400,105601.34
410750,202308,320,201,119,265325.71,157080.06,422405.77
410752,202308,21,16,5,21120.14,6600,27720.14
410753,202308,64,24,40,31680,55440,87120
410754,202308,71,38,33,50160.39,43560,93720.39
410755,202308,93,46,47,60720.2,62040,122760.2
410760,202308,824,449,375,592685.66,496323.44,1089009.10
410765,202308,2291,1028,1263,1358324.92,1668506.36,3026831.28
410770,202308,133,90,43,118802.71,56760.76,175563.47
410773,202308,73,48,25,63361.57,33000,96361.57
410775,202308,232,155,77,204602.71,101640,306242.71
410780,202308,91,52,39,68641.38,51480,120121.38
410785,202308,58,49,9,64681.09,11880,76561.09
410790,202308,102,44,58,58080.2,76560,134640.2
410800,202308,297,185,112,244214.73,147840.84,392055.57
410810,202308,27,17,10,22440,13200.14,35640.14
410820,202308,156,107,49,141243.48,64680.9,205924.38
410830,202308,10747,4215,6532,5565274.11,8631570.77,14196844.88
410832,202308,121,78,43,102962.27,56760.98,159723.25
410840,202308,1594,875,719,1155024.64,950404.73,2105429.37
410845,202308,67,34,33,44881.12,43560,88441.12
410850,202308,165,123,42,162364.9,55440,217804.9
410855,202308,83,76,7,100322.27,9240,109562.27
410860,202308,975,474,501,625690.1,662644.2,1288334.3
410865,202308,98,68,30,89760.58,39600,129360.58
410870,202308,146,120,26,158400.9,34320.62,192721.52
410880,202308,1294,618,676,815778.75,893646.72,1709425.47
410890,202308,127,75,52,99001.49,68640,167641.49
410895,202308,83,63,20,83161.03,26400.95,109561.98
410900,202308,45,34,11,44881.31,14520,59401.31
410910,202308,15,9,6,11880.95,7920,19800.95
410920,202308,51,31,20,40920,26400,67320
410930,202308,600,369,231,487084.59,304921.29,792005.88
410940,202308,4973,2478,2495,3273733.58,3297403.81,6571137.39
410950,202308,99,75,24,99003.73,31680,130683.73
410960,202308,1104,404,700,533292.2,924010.11,1457302.31
410965,202308,70,50,20,66002.46,26400,92402.46
410970,202308,656,430,226,568928.22,302282.63,871210.85
410975,202308,128,79,49,104281.91,64680,168961.91
410980,202308,1720,781,939,1030956.08,1240813.65,2271769.73
410990,202308,285,206,79,271921.25,104280.98,376202.23
411000,202308,70,41,29,54120.87,38280.54,92401.41
411005,202308,41,33,8,43560,10560,54120
411007,202308,302,174,128,229680.47,168960,398640.47
411010,202308,668,409,259,539893.52,343202.95,883096.47
411020,202308,301,192,109,253445.65,143882.4,397328.05
411030,202308,32,20,12,26400,15840,42240
411040,202308,79,46,33,62040.89,43560,105600.89
411050,202308,217,155,62,204602.13,81840.69,286442.82
411060,202308,592,409,183,539887.32,241560.44,781447.76
411065,202308,44,39,5,51480.4,6600,58080.4
411070,202308,1393,783,610,1033577.8,806525.11,1840102.91
411080,202308,276,177,99,234960.64,130680.23,365640.87
411090,202308,84,58,26,77880.4,34320.96,112201.36
411095,202308,382,126,256,166321.24,339240.16,505561.40
411100,202308,112,90,22,118801.66,29040,147841.66
411110,202308,174,88,86,116161.06,113520.2,229681.26
411120,202308,207,138,69,182169.39,92400,274569.39
411125,202308,419,203,216,269288.72,286448.39,555737.11
411130,202308,167,142,25,187441.58,33000,220441.58
411140,202308,227,148,79,195360,104280,299640
411150,202308,1353,864,489,1140504.71,645485.73,1785990.44
411155,202308,120,80,40,105600,54120,159720
411160,202308,39,17,22,22440,29040,51480
411170,202308,61,51,10,67320,14520,81840
411180,202308,1134,756,378,997950.23,498966.84,1496917.07
411190,202308,388,221,167,293043.95,220440.41,513484.36
411200,202308,727,385,342,508214.33,451444.06,959658.39
411210,202308,733,375,358,495006.32,472563.08,967569.40
411220,202308,164,116,48,153122.61,63361.25,216483.86
411230,202308,35,29,6,38280,7920,46200
411240,202308,112,71,41,93721.08,54120,147841.08
411250,202308,438,318,120,419765.23,159720,579485.23
411260,202308,10,7,3,9240,3960,13200
411270,202308,288,148,140,195367.64,184801.88,380169.52
411275,202308,201,164,37,216482.85,48840,265322.85
411280,202308,305,204,101,269285.15,133320.7,402605.85
411290,202308,74,55,19,72600,25080,97680
411295,202308,136,97,39,128041.59,52801.31,180842.90
411300,202308,92,44,48,58080,63360,121440
411310,202308,101,70,31,92401.4,40920,133321.4
411320,202308,910,546,364,720731.29,481800.88,1202532.17
411325,202308,58,41,17,54120.1,22440,76560.1
411330,202308,1035,657,378,868584.49,498963.53,1367548.02
411340,202308,39,24,15,31680,19800.09,51480.09
411342,202308,68,54,14,71280,18480,89760
411345,202308,99,49,50,64681.75,66000.95,130682.70
411350,202308,601,440,161,582137.83,212522.58,794660.41
411360,202308,64,43,21,56762.66,27722.5,84485.16
411370,202308,14647,6040,8607,7976985.95,11371908.87,19348894.82
411373,202308,194,127,67,167640.25,88440.17,256080.42
411375,202308,99,80,19,105603.18,25080,130683.18
411380,202308,84,57,27,75244.59,35640,110884.59
411390,202308,182,100,82,132001.57,108240,240241.57
411400,202308,394,244,150,322088.49,198000,520088.49
411410,202308,601,282,319,372247.84,421081.13,793328.97
411420,202308,1041,427,614,563652.18,810484.96,1374137.14
411430,202308,643,324,319,429019.89,421087.92,850107.81
411435,202308,29,21,8,27720,10560,38280
411440,202308,526,419,107,553088.94,142560.7,695649.64
411450,202308,414,336,78,443529.3,102960.43,546489.73
411460,202308,894,342,552,451454.28,728642.37,1180096.65
411470,202308,116,79,37,104284.88,48840,153124.88
411480,202308,803,403,400,533301.74,528003.1,1061304.84
411490,202308,308,195,113,257404.44,149160.9,406565.34
411500,202308,118,88,30,116161.72,39600,155761.72
411510,202308,248,188,60,248165.16,79201.19,327366.35
411520,202308,7130,2394,4736,3161469.91,6262119.04,9423588.95
411530,202308,132,84,48,110880.9,63360,174240.9
411535,202308,52,17,35,22440.6,46200,68640.6
411540,202308,421,276,145,364326.83,191402.23,555729.06
411545,202308,57,39,18,51481.13,23760,75241.13
411550,202308,93,69,24,91081.37,31680,122761.37
411560,202308,415,165,250,217801.24,331320.15,549121.39
411570,202308,1167,371,796,489606.86,1050729.81,1540336.67
411573,202308,25,15,10,19800.2,13200,33000.2
411575,202308,347,219,128,289083.25,168960,458043.25
411580,202308,1355,467,888,617768.3,1174805.96,1792574.26
411585,202308,74,36,38,47520,50160,97680
411590,202308,13,8,5,10560,6600,17160
411600,202308,16,8,8,10560.7,10560,21120.7
411605,202308,182,69,113,91082.03,149160,240242.03
411610,202308,265,162,103,213844.85,137280.2,351125.05
411620,202308,425,202,223,266652.48,294367.56,561020.04
411630,202308,53,36,17,47520.53,23760.08,71280.61
411640,202308,34,23,11,30360.41,14520,44880.41
411650,202308,6,4,2,5280,2640,7920
411660,202308,50,37,13,48840,17160,66000
411670,202308,256,169,87,223082.4,114841.49,337923.89
411680,202308,173,131,42,172921.51,55440,228361.51
411690,202308,736,383,353,505565.76,467282.29,972848.05
411695,202308,69,47,22,62040.2,29040,91080.2
411700,202308,152,117,35,154445.56,46200,200645.56
411705,202308,109,76,33,100321.52,43560.4,143881.92
411710,202308,297,195,102,258726.35,134641.71,393368.06
411720,202308,161,107,54,141241.68,71280.2,212521.88
411721,202308,94,72,22,95040.2,29040,124080.2
411722,202308,111,54,57,71281.19,75240,146521.19
411725,202308,172,123,49,162360.9,64680,227040.9
411727,202308,105,87,18,114845.33,23760.33,138605.66
411729,202308,60,47,13,62041.6,17160,79201.6
411730,202308,608,383,225,505567.11,297003.73,802570.84
411740,202308,27,17,10,22440.66,13200,35640.66
411745,202308,74,57,17,75240,23760,99000
411750,202308,931,391,540,516129.93,714123.86,1230253.79
411760,202308,1410,1016,394,1341163.98,521407.69,1862571.67
411770,202308,451,283,168,374884.39,221761.85,596646.24
411780,202308,412,266,146,351120.49,192720.21,543840.70
411790,202308,642,357,285,471251.47,378840.54,850092.01
411800,202308,173,121,52,159725.41,68640.18,228365.59
411810,202308,200,155,45,204604.1,59400.79,264004.89
411820,202308,2995,1165,1830,1539186.6,2420913.15,3960099.75
411830,202308,21,13,8,17160.46,10560,27720.46
411840,202308,2517,1446,1071,1908767.88,1416383.29,3325151.17
411845,202308,74,23,51,30360.9,67320,97680.9
411850,202308,1407,749,658,990025.57,868568.24,1858593.81
411860,202308,67,42,25,55440.99,33000,88440.99
411870,202308,80,49,31,64680,40920,105600
411880,202308,443,266,177,351129.62,234962.07,586091.69
411885,202308,115,77,38,101642.23,51480.94,153123.17
411890,202308,359,249,110,330007.38,145201.68,475209.06
411900,202308,121,87,34,114840.95,44880,159720.95
411910,202308,243,160,83,211207.43,109561.7,320769.13
411915,202308,2776,1058,1718,1400555.53,2267790.49,3668346.02
411920,202308,115,83,32,110882.83,42240.98,153123.81
411925,202308,22,15,7,19800,9240,29040
411930,202308,882,586,296,773630.66,392045.86,1165676.52
411940,202308,624,380,244,502933.51,322082.39,825015.90
411950,202308,1449,663,786,876512.07,1041499.48,1918011.55
411960,202308,1228,743,485,983413.02,641522.38,1624935.40
411965,202308,22,15,7,19801.05,9240,29041.05
411970,202308,102,87,15,114840.9,19800,134640.9
411980,202308,255,127,128,167640.76,170280,337920.76
411990,202308,5971,3111,2860,4110078.3,3777988.01,7888066.31
411995,202308,723,217,506,286449.4,667933.98,954383.38
412000,202308,374,250,124,330009.07,163681.74,493690.81
412010,202308,72,39,33,51480.9,43560.72,95041.62
412015,202308,37,27,10,35640,13200,48840
412020,202308,23,16,7,21120,9240,30360
412030,202308,40,32,8,42241.07,10560,52801.07
412033,202308,48,26,22,34321.29,29040,63361.29
412035,202308,73,49,24,64680.09,31680,96360.09
412040,202308,32,16,16,21120.97,21120,42240.97
412050,202308,221,166,55,219127.37,73920,293047.37
412060,202308,872,620,252,818427.12,333964.31,1152391.43
412065,202308,62,30,32,39602.38,42240.15,81842.53
412070,202308,161,109,52,143881.84,69960.07,213841.91
412080,202308,378,183,195,241572.03,257404.38,498976.41
412085,202308,40,15,25,19800.23,33000,52800.23
412090,202308,935,559,376,739217.25,496323.22,1235540.47
412100,202308,281,232,49,306250.28,64680,370930.28
412110,202308,76,55,21,72600.74,27720,100320.74
412120,202308,408,215,193,283806.34,254762.49,538568.83
412125,202308,75,41,34,54120.2,44880,99000.2
412130,202308,55,37,18,48841.99,23760,72601.99
412135,202308,32,19,13,25080.2,17160,42240.2
412140,202308,500,330,170,435323.95,225722.48,661046.43
412150,202308,277,165,112,217802.41,147840.73,365643.14
412160,202308,73,50,23,66000.95,30360,96360.95
412170,202308,737,472,265,623047.3,352442.91,975490.21
412175,202308,41,27,14,35640.74,18480,54120.74
412180,202308,170,126,44,166324.16,58080.2,224404.36
412190,202308,352,268,84,353765.84,110880,464645.84
412200,202308,205,116,89,153120.59,117480,270600.59
412210,202308,105,78,27,102960,35640.73,138600.73
412215,202308,251,166,85,219124.31,112201.11,331325.42
412217,202308,73,58,15,76561.65,19800,96361.65
412220,202308,959,610,349,805226.71,460691.07,1265917.78
412230,202308,319,180,139,237607.2,184807,422414.2
412240,202308,1482,725,757,958344.4,1000567.37,1958911.77
412250,202308,458,273,185,360364.48,244200,604564.48
412260,202308,144,97,47,128042.74,62040.2,190082.94
412265,202308,170,131,39,172920.83,51480,224400.83
412270,202308,98,57,41,75240.56,55440,130680.56
412280,202308,88,64,24,84480.2,31680,116160.2
412290,202308,97,58,39,76561.67,51480,128041.67
412300,202308,225,162,63,213841.74,84480,298321.74
412310,202308,62,48,14,63361.5,18480,81841.5
412320,202308,99,74,25,97684.59,33000,130684.59
412330,202308,216,163,53,215161.49,69960,285121.49
412340,202308,196,126,70,166321.5,93720,260041.5
412350,202308,755,333,422,439565.43,558362.79,997928.22
412360,202308,24,18,6,23760,7920,31680
412370,202308,157,126,31,166324.03,40920.96,207244.99
412380,202308,197,144,53,190084.66,69960.71,260045.37
412382,202308,59,34,25,44880,33000,77880
412385,202308,174,122,52,161044.15,68640.92,229685.07
412390,202308,347,258,89,340575.61,117480.88,458056.49
412395,202308,72,58,14,76562.37,18480,95042.37
412400,202308,104,70,34,92401.08,44880,137281.08
412402,202308,251,136,115,179521.03,153120,332641.03
412405,202308,1036,347,689,458043.42,912121.98,1370165.40
412410,202308,1089,650,439,858032.92,580805.6,1438838.52
412420,202308,18,17,1,22440,1320,23760
412430,202308,27,25,2,33001.8,2640.2,35642.0
412440,202308,769,384,385,506886.57,509521.67,1016408.24
412450,202308,65,56,9,73921.42,11880,85801.42
412460,202308,88,59,29,77880.7,38280.19,116160.89
412470,202308,255,203,52,269285.45,68641.33,337926.78
412480,202308,167,120,47,158405.33,62040.2,220445.53
412490,202308,194,159,35,209882.89,46200,256082.89
412500,202308,434,340,94,448810.69,126722.67,575533.36
412510,202308,183,146,37,192723.71,48840,241563.71
412520,202308,92,63,29,83161.66,38280,121441.66
412530,202308,119,53,66,69961.63,87120,157081.63
412535,202308,58,45,13,60720.78,17160,77880.78
412540,202308,63,37,26,50161.65,34320.67,84482.32
412545,202308,97,69,28,91081.06,36960,128041.06
412550,202308,4736,1909,2827,2526388.5,3735656.45,6262044.95
412555,202308,16,8,8,10560,10560,21120
412560,202308,746,478,268,630976.33,355082.18,986058.51
412570,202308,938,405,533,534615.09,703563.52,1238178.61
412575,202308,98,69,29,91081.75,38280,129361.75
412580,202308,188,127,61,167649.57,81841.31,249490.88
412590,202308,31,27,4,35641.04,5280,40921.04
412600,202308,237,173,64,228364.46,84480.83,312845.29
412610,202308,52,22,30,29041.41,39600,68641.41
412620,202308,129,107,22,141243.12,29040.86,170283.98
412625,202308,2401,1130,1271,1492954.9,1680371.9,3173326.8
412627,202308,66,51,15,67322.26,19800,87122.26
412630,202308,404,270,134,359050.87,176881.08,535931.95
412635,202308,87,27,60,35640,79200,114840
412640,202308,119,85,34,112200.3,44880,157080.3
412650,202308,338,225,113,297004.98,149160.94,446165.92
412660,202308,598,320,278,422403.87,366960.41,789364.28
412665,202308,42,37,5,48840.19,6600,55440.19
412667,202308,278,174,104,231003.94,137280,368283.94
412670,202308,87,66,21,87120.4,27720,114840.4
412680,202308,352,265,87,349810.81,116161.18,465971.99
412690,202308,136,87,49,114843,64680,179523
412700,202308,197,121,76,159720.7,100320.23,260040.93
412710,202308,1479,802,677,1058661.46,894968.38,1953629.84
412720,202308,261,141,120,186123.08,158400.69,344523.77
412730,202308,185,154,31,203288.47,40920,244208.47
412740,202308,435,205,230,270604.11,303600.41,574204.52
412750,202308,436,239,197,315487.66,260040.93,575528.59
412760,202308,402,205,197,270607.37,262684.3,533291.67
412770,202308,2370,1268,1102,1676428.84,1457286.79,3133715.63
412780,202308,150,102,48,134642.83,63360.1,198002.93
412785,202308,333,174,159,229682.06,209880.02,439562.08
412788,202308,60,33,27,43561.07,35640,79201.07
412790,202308,134,107,27,141245.34,35640,176885.34
412795,202308,156,107,49,141242.35,64680,205922.35
412796,202308,320,199,121,265323.15,159720.3,425043.45
412800,202308,775,432,343,570245.26,454080.81,1024326.07
412810,202308,3430,1891,1539,2496196.93,2034141.17,4530338.10
412820,202308,1156,648,508,855388.11,670573.58,1525961.69
412830,202308,16,15,1,19800.2,1320,21120.2
412840,202308,257,169,88,223082.24,117480.2,340562.44
412850,202308,613,398,215,528010.4,283800.68,811811.08
412853,202308,184,81,103,106920.24,135960,242880.24
412855,202308,217,116,101,153123.3,133320.73,286444.03
412860,202308,105,71,34,93724.26,44880.91,138605.17
412862,202308,81,52,29,68640,38280,106920
412863,202308,10,7,3,9240,3960,13200
412865,202308,46,36,10,47520,13200.6,60720.6
412870,202308,127,84,43,112204.25,56761.83,168966.08
412880,202308,98,70,28,92403,38280,130683
420005,202308,49,40,9,52800.69,11880,64680.69
420010,202308,387,256,131,339245.15,172920.89,512166.04
420020,202308,104,80,24,105602.17,33000,138602.17
420030,202308,33,24,9,31680.2,11880,43560.2
420040,202308,101,78,23,102962.36,30360.2,133322.56
420050,202308,56,34,22,44880.22,29040,73920.22
420055,202308,20,17,3,22440.6,3960,26400.6
420060,202308,36,24,12,31680.68,15840.2,47520.88
420070,202308,116,100,16,132000.6,21120,153120.6
420075,202308,12,12,0,15840,,15840.0
420080,202308,44,37,7,48841.13,9240,58081.13
420090,202308,42,34,8,44880.48,10560.4,55440.88
420100,202308,178,152,26,200642.36,34320,234962.36
420110,202308,26,25,1,33000,1320,34320
420120,202308,66,48,18,63360,23760,87120
420125,202308,83,64,19,84480.6,25080,109560.6
420127,202308,38,32,6,42240,7920,50160
420130,202308,575,346,229,456737.18,302285.48,759022.66
420140,202308,1527,859,668,1135229.31,884418.98,2019648.29
420150,202308,52,38,14,50160,18480,68640
420160,202308,39,34,5,44880.1,6600,51480.1
420165,202308,19,15,4,19800.79,5280,25080.79
420170,202308,78,45,33,59400.02,43560,102960.02
420180,202308,25,23,2,30360,2640,33000
420190,202308,30,25,5,33000.18,6600,39600.18
420195,202308,149,72,77,95044.26,101642.75,196687.01
420200,202308,1540,635,905,839547.71,1197262.27,2036809.98
420205,202308,148,88,60,116163.66,79200.2,195363.86
420207,202308,171,93,78,122764.4,102961.96,225726.36
420208,202308,21,17,4,22440.21,5280,27720.21
420209,202308,14,12,2,15840,2640,18480
420210,202308,664,324,340,427691.63,450123.85,877815.48
420213,202308,55,38,17,50160.69,23760,73920.69
420215,202308,26,23,3,30361.07,3960,34321.07
420220,202308,65,41,24,54120.44,31680,85800.44
420230,202308,1157,710,447,938559.25,591370.94,1529930.19
420240,202308,2640,1737,903,2292882.39,1191969.12,3484851.51
420243,202308,47,39,8,51481.22,10560,62041.22
420245,202308,278,128,150,168966.19,198003.52,366969.71
420250,202308,69,45,24,59401.11,31680,91081.11
420253,202308,23,18,5,23760.66,6600,30360.66
420257,202308,17,10,7,13200.5,9240,22440.5
420260,202308,134,106,28,139922.94,36960.14,176883.08
420270,202308,38,27,11,35640,14520.36,50160.36
420280,202308,312,228,84,302292.35,110880.95,413173.30
420285,202308,26,20,6,26400,7920,34320
420287,202308,51,32,19,43561.42,25080,68641.42
420290,202308,1067,722,345,953055.33,455400.51,1408455.84
420300,202308,1760,1412,348,1863913.29,460686.96,2324600.25
420310,202308,46,34,12,44880.7,15840,60720.7
420315,202308,24,20,4,26400.78,5280.74,31681.52
420320,202308,1190,569,621,751107.07,821050.91,1572157.98
420325,202308,8,6,2,7920,2640.3,10560.3
420330,202308,127,84,43,110881.17,56761.28,167642.45
420340,202308,208,139,69,183482.06,91080,274562.06
420350,202308,280,199,81,262688.51,106920.86,369609.37
420360,202308,729,568,161,749785.97,212521.07,962307.04
420370,202308,144,81,63,106922.47,83160.43,190082.90
420380,202308,1369,915,454,1207842.31,600607.36,1808449.67
420390,202308,235,165,70,217805.85,92400.4,310206.25
420395,202308,206,149,57,196696.01,75242.58,271938.59
420400,202308,224,170,54,224404.54,71280,295684.54
420410,202308,57,44,13,58081.7,17160,75241.7
420415,202308,31,22,9,29040.2,11880,40920.2
420417,202308,68,53,15,69960.01,19800,89760.01
420419,202308,13,12,1,15840,1320,17160
420420,202308,3217,1998,1219,2638740.22,1615689.8,4254430.02
420425,202308,72,51,21,67326.17,27720,95046.17
420430,202308,1063,774,289,1021687.54,382801.92,1404489.46
420435,202308,14,11,3,14520,3960,18480
420440,202308,94,68,26,89761.66,34320,124081.66
420445,202308,32,29,3,38280.5,3960,42240.5
420450,202308,96,57,39,75242.6,51480,126722.6
420455,202308,195,153,42,201965.82,55440,257405.82
420460,202308,2639,1617,1022,2135850.62,1353012.39,3488863.01
420470,202308,85,54,31,71280.2,40920,112200.2
420475,202308,9,8,1,10560.77,1320,11880.77
420480,202308,999,765,234,1009849.68,308882.3,1318731.98
420490,202308,101,75,26,99004.07,34320,133324.07
420500,202308,419,247,172,326050.85,228360.82,554411.67
420510,202308,25,21,4,27720.34,5280,33000.34
420515,202308,32,17,15,22440.5,19800,42240.5
420517,202308,11,8,3,10560.91,3960,14520.91
420519,202308,9,7,2,9240.34,2640,11880.34
420520,202308,62,44,18,58081.39,23760.2,81841.59
420530,202308,149,97,52,128041.6,68640.2,196681.8
420535,202308,16,13,3,17160.41,3960,21120.41
420540,202308,7715,4766,2949,6294306.74,3892720.78,10187027.52
420543,202308,31,30,1,39601,1320,40921
420545,202308,249,174,75,229687.34,99000.6,328687.94
420550,202308,827,700,127,925354.71,167642.7,1092997.41
420555,202308,42,32,10,42240.9,13200,55440.9
420560,202308,64,48,16,63361.34,21120,84481.34
420570,202308,267,128,139,168962.89,183483.21,352446.10
420580,202308,361,190,171,250807.92,225720.93,476528.85
420590,202308,552,347,205,458050.62,270600.62,728651.24
420600,202308,164,90,74,118800.6,97680,216480.6
420610,202308,39,36,3,47520,3960,51480
420620,202308,80,64,16,84482.05,21120.41,105602.46
420630,202308,169,115,54,151802.51,71280,223082.51
420640,202308,79,69,10,91080.6,13200,104280.6
420650,202308,356,182,174,240243.92,229680.4,469924.32
420660,202308,45,31,14,40920.45,18480,59400.45
420665,202308,52,34,18,44882.18,23760,68642.18
420670,202308,245,189,56,249486.89,73920,323406.89
420675,202308,18,15,3,19800,3960,23760
420680,202308,35,29,6,38280.12,7920,46200.12
420690,202308,208,150,58,198003.21,76712.3,274715.51
420700,202308,794,516,278,682464.2,366964.08,1049428.28
420710,202308,161,88,73,116162.48,96361.29,212523.77
420720,202308,104,80,24,105603.91,31680.39,137284.30
420730,202308,800,473,327,625699.97,432967.6,1058667.57
420740,202308,61,59,2,77882.15,2640,80522.15
420750,202308,527,348,179,459365.19,236280.5,695645.69
420757,202308,20,17,3,22440,3960,26400
420760,202308,37,26,11,34320.86,14520,48840.86
420765,202308,71,49,22,64681.14,29040,93721.14
420768,202308,61,50,11,66002.91,14520,80522.91
420770,202308,76,65,11,85801.72,14520,100321.72
420775,202308,37,30,7,39600.26,9240,48840.26
420780,202308,207,159,48,209883.31,63360,273243.31
420785,202308,29,17,12,22440,15840,38280
420790,202308,143,118,25,155762.47,33000,188762.47
420800,202308,63,51,12,67320.62,15840,83160.62
420810,202308,301,226,75,298330.57,99000,397330.57
420820,202308,2999,1676,1323,2215691.2,1749023.17,3964714.37
420830,202308,816,439,377,580824.61,497650.83,1078475.44
420840,202308,137,92,45,121441.71,59400,180841.71
420845,202308,496,219,277,289088.57,365642.71,654731.28
420850,202308,309,238,71,314258.52,93720.3,407978.82
420860,202308,59,50,9,66001.52,11880,77881.52
420870,202308,142,102,40,134640.97,54120,188760.97
420880,202308,207,130,77,171604.51,101640.3,273244.81
420890,202308,1126,569,557,751096.55,737882.8,1488979.35
420895,202308,11,10,1,13200,1320,14520
420900,202308,444,354,90,467288.19,118801.31,586089.50
420910,202308,6663,3671,2992,4851154.45,3954768.49,8805922.94
420915,202308,61,57,4,75240.2,5280,80520.2
420917,202308,26,19,7,25080.42,9240,34320.42
420920,202308,21,15,6,19800,7920,27720
420930,202308,4021,2771,1250,3660426.44,1651350.76,5311777.20
420940,202308,629,435,194,575551.4,256087.11,831638.51
420945,202308,11,8,3,10560,3960,14520
420950,202308,46,34,12,44880.51,15840,60720.51
420960,202308,115,94,21,125405.6,29040.1,154445.7
420970,202308,298,244,54,322092.67,71280.71,393373.38
420980,202308,24,23,1,30360,1320,31680
420985,202308,52,44,8,58081.01,10560,68641.01
420990,202308,93,70,23,92402.16,30362.76,122764.92
421000,202308,75,38,37,50160,48840,99000
421003,202308,31,22,9,29040.55,11880,40920.55
421005,202308,8,6,2,7920.3,2640,10560.3
421010,202308,951,607,344,801273.13,454086.38,1255359.51
421020,202308,20,18,2,23762.18,2640,26402.18
421030,202308,117,95,22,125401.41,29040,154441.41
421040,202308,72,54,18,71282.27,25081.05,96363.32
421050,202308,340,238,102,314162.5,134640,448802.5
421055,202308,17,13,4,17160.2,5280,22440.2
421060,202308,120,65,55,85801.92,72600,158401.92
421070,202308,34,31,3,40920.86,3960,44880.86
421080,202308,50,40,10,52800.4,13200,66000.4
421085,202308,18,13,5,17160,6600,23760
421090,202308,37,29,8,38280.11,11880,50160.11
421100,202308,125,92,33,121442.9,43560.95,165003.85
421105,202308,208,162,46,213846.24,60720.2,274566.44
421110,202308,137,94,43,124084.22,56760,180844.22
421120,202308,207,143,64,188763.96,84480.42,273244.38
421125,202308,17,10,7,13200,9240.43,22440.43
421130,202308,963,583,380,769584.77,502925.3,1272510.07
421140,202308,36,27,9,35640.54,11880,47520.54
421145,202308,45,38,7,50160.11,9240,59400.11
421150,202308,90,69,21,91081.71,27720,118801.71
421160,202308,66,45,21,59400.5,27720,87120.5
421165,202308,16,13,3,17160,3960,21120
421170,202308,174,147,27,194208.18,35640.1,229848.28
421175,202308,204,142,62,188764.17,81841.36,270605.53
421180,202308,38,23,15,30360.22,19800,50160.22
421185,202308,20,17,3,22440.18,3960,26400.18
421187,202308,5,4,1,5280,1320,6600
421189,202308,47,34,13,44880.58,17160,62040.58
421190,202308,2388,1517,871,2002520.99,1149742.97,3152263.96
421200,202308,98,70,28,92401.39,36960,129361.39
421205,202308,24,17,7,22441.3,9240,31681.3
421210,202308,192,134,58,176882.66,76560,253442.66
421220,202308,267,206,61,273242.68,80520.56,353763.24
421223,202308,52,40,12,52801.77,15840,68641.77
421225,202308,78,53,25,69961.81,33000.91,102962.72
421227,202308,72,59,13,77880.9,17160,95040.9
421230,202308,84,57,27,75242.13,35640.18,110882.31
421240,202308,16,14,2,18481.04,2640,21121.04
421250,202308,462,246,216,324728.63,285126.38,609855.01
421260,202308,23,18,5,23760.59,6600,30360.59
421265,202308,17,11,6,14521.11,7920.1,22441.21
421270,202308,54,48,6,63360,7920,71280
421280,202308,455,237,218,312848.96,287762.58,600611.54
421290,202308,321,213,108,281162.58,142560.31,423722.89
421300,202308,24,20,4,26400,5280,31680
421310,202308,51,35,16,46200,21120,67320
421315,202308,36,20,16,26401.03,21120.08,47521.11
421320,202308,145,98,47,129362.91,62040,191402.91
421330,202308,113,85,28,112202.19,36960,149162.19
421335,202308,47,33,14,43561.63,18480,62041.63
421340,202308,263,175,88,231004.56,116160.41,347164.97
421350,202308,204,124,80,163684.19,106920.33,270604.52
421360,202308,783,536,247,707532.1,326045.39,1033577.49
421370,202308,211,157,54,207242.13,71280.88,278523.01
421380,202308,160,120,40,158400.44,52800,211200.44
421390,202308,17,12,5,15840.49,6600,22440.49
421400,202308,121,97,24,128040,31680,159720
421410,202308,20,17,3,22440,3960,26400
421415,202308,22,20,2,26400,2640,29040
421420,202308,102,86,16,113521.34,21120,134641.34
421430,202308,22,14,8,18480,10560,29040
421440,202308,64,53,11,69961.68,14520.98,84482.66
421450,202308,80,63,17,84480.47,22440,106920.47
421460,202308,51,42,9,55440.66,11880,67320.66
421470,202308,84,46,38,60720.37,50160,110880.37
421480,202308,871,640,231,844815.55,306242.88,1151058.43
421490,202308,25,23,2,30360.78,2640,33000.78
421500,202308,517,293,224,386779.3,295682.25,682461.55
421505,202308,47,38,9,50160.1,11880.2,62040.3
421507,202308,34,28,6,36960.6,7920,44880.6
421510,202308,65,41,24,54121.36,31680.61,85801.97
421520,202308,49,41,8,54120.98,10560,64680.98
421530,202308,54,46,8,60721.28,10560,71281.28
421535,202308,23,21,2,27721.29,2640,30361.29
421540,202308,47,39,8,51480.2,10560,62040.2
421545,202308,93,63,30,83164.42,39600.63,122765.05
421550,202308,318,228,90,300977.35,118801.1,419778.45
421555,202308,17,15,2,19801.56,2640,22441.56
421560,202308,8,7,1,9240,1320,10560
421565,202308,142,91,51,120123.42,67320.57,187443.99
421567,202308,41,30,11,39600,14520,54120
421568,202308,38,37,1,48840,1320,50160
421569,202308,11,10,1,13200.79,1320,14520.79
421570,202308,285,188,97,248164.88,128041.45,376206.33
421575,202308,28,25,3,33001.19,3960,36961.19
421580,202308,800,472,328,623144.49,435602.68,1058747.17
421590,202308,24,21,3,27720.2,3960,31680.2
421600,202308,182,134,48,176880.88,63360,240240.88
421605,202308,112,75,37,99002.01,48840.2,147842.21
421610,202308,178,128,50,168960.99,66000,234960.99
421620,202308,1155,659,496,869914.16,654727.77,1524641.93
421625,202308,23,20,3,26400,3960,30360
421630,202308,383,232,151,306252.2,199324.22,505576.42
421635,202308,31,18,13,23760,17160,40920
421640,202308,112,89,23,117484.76,30360,147844.76
421650,202308,360,212,148,279848.82,195362.86,475211.68
421660,202308,3046,1854,1192,2450000.28,1577427.3,4027427.58
421670,202308,161,116,45,153123.03,59400,212523.03
421680,202308,209,185,24,244204.66,31680,275884.66
421690,202308,382,254,128,335286.82,168961.39,504248.21
421700,202308,59,41,18,54120.7,23760,77880.7
421710,202308,24,24,0,31680.52,,31680.52
421715,202308,4,4,0,5281.46,,5281.46
421720,202308,691,455,236,600616.32,311522.06,912138.38
421725,202308,33,12,21,17160.04,27720.8,44880.84
421730,202308,23,18,5,23760,6600,30360
421740,202308,123,50,73,66001.32,96360,162361.32
421750,202308,204,146,58,192721.26,76560,269281.26
421755,202308,19,18,1,23760,2640,26400
421760,202308,109,75,34,99002.46,44880.19,143882.65
421770,202308,756,483,273,637585.55,361684.14,999269.69
421775,202308,29,19,10,25080.97,13200.09,38281.06
421780,202308,196,149,47,196680.4,62040,258720.4
421790,202308,158,135,23,178201.77,30360.94,208562.71
421795,202308,16,13,3,17160.33,3960,21120.33
421800,202308,630,379,251,500303.79,331325.29,831629.08
421810,202308,73,60,13,79201.08,17160,96361.08
421820,202308,345,218,127,287764.96,167640,455404.96
421825,202308,179,151,28,199326.32,36960,236286.32
421830,202308,177,113,64,149169.36,85801.3,234970.66
421835,202308,6,2,4,2640,5280,7920
421840,202308,47,39,8,51481.27,10560.15,62041.42
421850,202308,81,67,14,88440.5,18480,106920.5
421860,202308,39,27,12,35640.73,15840,51480.73
421870,202308,1310,934,376,1232923,496330.97,1729253.97
421875,202308,52,40,12,52800,15840,68640
421880,202308,209,149,60,196682.89,80520.7,277203.59
421885,202308,20,15,5,19800,6600.84,26400.84
421890,202308,182,131,51,172926.63,67321.13,240247.76
421895,202308,54,47,7,62041.43,9240,71281.43
421900,202308,136,101,35,133328.33,46200,179528.33
421910,202308,72,43,29,56761.1,38280,95041.1
421915,202308,33,26,7,34320,9240,43560
421917,202308,55,42,13,55441.54,17160,72601.54
421920,202308,37,33,4,43560,5280,48840
421930,202308,679,540,139,714138.31,183482.18,897620.49
421935,202308,47,38,9,50160,11880,62040
421940,202308,57,49,8,64680,10560,75240
421950,202308,984,654,330,863293.31,436923.71,1300217.02
421960,202308,46,38,8,50160,10560,60720
421970,202308,346,214,132,282485.2,174241.39,456726.59
421985,202308,20,12,8,15840.2,10560,26400.2
422000,202308,14,7,7,9240.2,9240.63,18480.83
430003,202308,207,63,144,83160.6,190080,273240.6
430005,202308,32,25,7,34320.72,9240,43560.72
430010,202308,265,196,69,258722.95,91080,349802.95
430020,202308,143,103,40,135961.99,52800.24,188762.23
430030,202308,135,107,28,141241.73,36960,178201.73
430040,202308,3168,1860,1308,2456563.95,1730522.77,4187086.72
430045,202308,82,73,9,96360,11880,108240
430047,202308,6,5,1,6600,1320,7920
430050,202308,92,77,15,101641.28,19800,121441.28
430055,202308,16,14,2,18480,2640,21120
430057,202308,7,5,2,6600,2640,9240
430060,202308,4693,2730,1963,3611659.23,2597785.39,6209444.62
430063,202308,62,49,13,64680,17160,81840
430064,202308,173,139,34,183480.92,44880,228360.92
430066,202308,7,4,3,5280,3960,9240
430070,202308,43,34,9,44880.52,11880,56760.52
430080,202308,88,60,28,79200.63,36960.18,116160.81
430085,202308,27,14,13,18480,17160,35640
430087,202308,43,33,10,43560.08,13200,56760.08
430090,202308,70,59,11,77880.6,14520,92400.6
430100,202308,161,110,51,145200.86,67320,212520.86
430105,202308,193,105,88,138607.12,116160.3,254767.42
430107,202308,23,18,5,23760.58,6600,30360.58
430110,202308,515,278,237,366961.16,314160.89,681122.05
430120,202308,192,175,17,231000.1,22440,253440.1
430130,202308,865,511,354,675849.55,468601.74,1144451.29
430140,202308,146,131,15,172920,19800,192720
430150,202308,117,73,44,96360.96,58080,154440.96
430155,202308,29,25,4,33000,5280,38280
430160,202308,4082,2277,1805,3009669.45,2390532.06,5400201.51
430163,202308,491,231,260,304929.04,343203.38,648132.42
430165,202308,32,19,13,25080.59,17160,42240.59
430170,202308,87,72,15,95040,19800,114840
430175,202308,90,71,19,93720,25080,118800
430180,202308,112,85,27,112200.42,35640,147840.42
430185,202308,31,23,8,30360,10560,40920
430187,202308,109,43,66,56761.21,87120,143881.21
430190,202308,252,127,125,167643.1,165002.29,332645.39
430192,202308,13,10,3,13200.56,3960,17160.56
430195,202308,18,14,4,18480.9,5280,23760.9
430200,202308,169,139,30,183484,39600,223084
430205,202308,20,20,0,26400,,26400.0
430210,202308,855,638,217,842174.68,286440.7,1128615.38
430215,202308,12,12,0,15840,,15840.0
430220,202308,76,51,25,67320,33000,100320
430222,202308,15,4,11,5280,14520,19800
430223,202308,19,13,6,17160,7920,25080
430225,202308,5,3,2,3960,2640,6600
430230,202308,370,230,140,304921.84,186120,491041.84
430235,202308,56,35,21,46200.04,27720,73920.04
430237,202308,21,15,6,19800,7920,27720
430240,202308,122,81,41,106921.16,54120,161041.16
430245,202308,69,57,12,75240,15840,91080
430250,202308,191,113,78,149161.67,102960,252121.67
430258,202308,12,9,3,11880.54,3960.2,15840.74
430260,202308,43,40,3,52800.1,3960,56760.1
430265,202308,41,35,6,46200,7920,54120
430270,202308,574,398,176,525375.74,232320,757695.74
430280,202308,1178,675,503,891007.07,663960.3,1554967.37
430290,202308,485,252,233,332647.06,307560,640207.06
430300,202308,2395,1314,1081,1734526.41,1428253.8,3162780.21
430310,202308,2422,1206,1216,1591985.59,1606469.91,3198455.50
430320,202308,64,52,12,68640,15840,84480
430330,202308,92,78,14,102960.1,18480,121440.1
430340,202308,76,61,15,80520,19800,100320
430350,202308,1825,1129,696,1491617.08,921360.85,2412977.93
430355,202308,20,18,2,23760,2640,26400
430360,202308,113,59,54,77880,71280,149160
430367,202308,51,37,14,48840,18480,67320
430370,202308,65,57,8,75240,10560,85800
430380,202308,111,78,33,102961.54,43560,146521.54
430390,202308,736,438,298,580731.22,393364.71,974095.93
430400,202308,266,182,84,240240.19,110880,351120.19
430410,202308,55,46,9,60720.2,11880,72600.2
430420,202308,585,378,207,498970.87,273241.49,772212.36
430430,202308,51,46,5,59840.88,6600,66440.88
430435,202308,156,112,44,147840.81,58080,205920.81
430440,202308,677,406,271,535927.82,359041.58,894969.40
430450,202308,1345,1101,244,1455979.33,322080.9,1778060.23
430460,202308,6705,3427,3278,4527740.22,4327013.22,8854753.44
430461,202308,20,18,2,23760,2640,26400
430462,202308,5,3,2,3960.1,2640,6600.1
430463,202308,1409,759,650,1001901.47,858006.32,1859907.79
430465,202308,27,17,10,22440,13200,35640
430466,202308,841,588,253,776191.79,337926.52,1114118.31
430467,202308,141,76,65,100320.5,85800,186120.5
430468,202308,175,99,76,130681.5,100320.88,231002.38
430469,202308,21,14,7,18480.56,9240,27720.56
430470,202308,1279,695,584,917805.86,774842.68,1692648.54
430471,202308,88,61,27,80521.11,35640.57,116161.68
430480,202308,157,112,45,147840.87,59400,207240.87
430485,202308,8,8,0,10560,,10560.0
430490,202308,72,57,15,75240,19800,95040
430495,202308,37,26,11,34320.2,14520,48840.2
430500,202308,201,134,67,176880,89760,266640
430510,202308,4360,2781,1579,3676265.83,2084290.75,5760556.58
430511,202308,14,14,0,18480,,18480.0
430512,202308,190,127,63,168963.11,83160.4,252123.51
430513,202308,60,45,15,59400,19800,79200
430515,202308,24,22,2,29040,2640,31680
430517,202308,193,163,30,215160.2,39600,254760.2
430520,202308,356,248,108,327364.1,142560.53,469924.63
430530,202308,88,48,40,63360.7,52800,116160.7
430535,202308,514,325,189,429005.55,250803.34,679808.89
430537,202308,9,9,0,11880,,11880.0
430540,202308,81,57,24,75240,31680,106920
430543,202308,473,150,323,198000.13,426360.71,624360.84
430544,202308,56,51,5,67320.61,6600,73920.61
430545,202308,499,244,255,323418.2,336607.65,660025.85
430550,202308,47,37,10,48840.14,13200,62040.14
430558,202308,1,1,0,1320,,1320.0
430560,202308,53,30,23,40920,30360,71280
430570,202308,125,53,72,69962.46,95040,165002.46
430580,202308,128,103,25,137280.64,33000,170280.64
430583,202308,13,13,0,17160,,17160.0
430585,202308,14,10,4,13200.88,5280,18480.88
430587,202308,13,9,4,11880,5280,17160
430590,202308,204,164,40,216480.62,52800,269280.62
430593,202308,1,1,0,1320,,1320.0
430595,202308,18,14,4,18480,5280,23760
430597,202308,45,27,18,35640.16,23760,59400.16
430600,202308,235,170,65,224400,85800,310200
430605,202308,196,115,81,151800,106920,258720
430607,202308,35,28,7,36960,9240,46200
430610,202308,1947,931,1016,1228937.56,1341123.59,2570061.15
430613,202308,5,5,0,6600,,6600.0
430620,202308,107,75,32,99000.56,42240,141240.56
430630,202308,48,41,7,54121.37,9240,63361.37
430632,202308,33,29,4,38280,5280,43560
430635,202308,38,31,7,40920,9240,50160
430637,202308,74,34,40,44880,54120,99000
430640,202308,180,106,74,139925.05,97680.54,237605.59
430642,202308,17,15,2,19800,2640,22440
430645,202308,34,27,7,35640,9240,44880
430650,202308,247,197,50,260043.47,66001.15,326044.62
430655,202308,15,12,3,17160,3960,21120
430660,202308,1079,531,548,702253.08,724687.42,1426940.50
430670,202308,71,50,21,66000,27720,93720
430673,202308,91,60,31,79200.2,40920,120120.2
430675,202308,9,7,2,9240,2640,11880
430676,202308,741,458,283,605990.28,373562.81,979553.09
430680,202308,273,180,93,237602.66,122760,360362.66
430690,202308,605,367,238,484448.44,314161.78,798610.22
430692,202308,6,5,1,6600.7,1320,7920.7
430693,202308,146,95,51,126720.87,67320.2,194041.07
430695,202308,73,55,18,72600,23760,96360
430697,202308,71,44,27,58080,35640,93720
430700,202308,1450,976,474,1290979.4,628320.31,1919299.71
430705,202308,36,30,6,39600.7,7920,47520.7
430710,202308,277,173,104,228360,137280,365640
430720,202308,100,82,18,108240,23760,132000
430730,202308,161,137,24,180840.42,31680,212520.42
430740,202308,90,56,34,73920.3,44880,118800.3
430745,202308,31,19,12,25080,15840,40920
430750,202308,332,211,121,278522.97,161041.02,439563.99
430755,202308,87,49,38,64680.49,50160,114840.49
430760,202308,477,260,217,344528.74,287761.78,632290.52
430770,202308,1901,1051,850,1393962.48,1122007.71,2515970.19
430780,202308,388,243,145,320760.33,191400,512160.33
430781,202308,26,26,0,34320,,34320.0
430783,202308,65,47,18,62040,25080,87120
430786,202308,9,7,2,9240,2640,11880
430790,202308,582,359,223,473887.39,295682.56,769569.95
430800,202308,173,126,47,166320,62040,228360
430805,202308,39,30,9,39600,11880,51480
430807,202308,85,51,34,67320,44880,112200
430810,202308,87,57,30,75241.54,39600,114841.54
430820,202308,168,110,58,145203.16,76560,221763.16
430825,202308,11,9,2,11880,2640,14520
430830,202308,287,264,23,348481.94,30360,378841.94
430840,202308,155,105,50,138600.7,66000,204600.7
430843,202308,8,5,3,6600,3960,10560
430845,202308,83,49,34,64680,44880,109560
430850,202308,615,432,183,570244.73,242880,813124.73
430860,202308,191,130,61,171601.89,80520.82,252122.71
430865,202308,82,44,38,58080,50160,108240
430870,202308,74,60,14,79200.57,18480,97680.57
430880,202308,187,126,61,166324.07,80520.8,246844.87
430885,202308,11,9,2,11880,2640,14520
430890,202308,355,214,141,282481.88,187440,469921.88
430900,202308,568,390,178,514804.7,234960.88,749765.58
430905,202308,164,78,86,102960.78,113521.35,216482.13
430910,202308,322,171,151,225721.76,200640.8,426362.56
430912,202308,5,5,0,6600.22,,6600.22
430915,202308,43,40,3,52800,3960,56760
430920,202308,5424,2814,2610,3717261.52,3449214.36,7166475.88
430925,202308,7,6,1,7920,1320,9240
430930,202308,2412,1358,1054,1797873.85,1391283.02,3189156.87
430940,202308,293,184,109,242880,143881.1,386761.1
430950,202308,165,132,33,174241.47,43560,217801.47
430955,202308,30,19,11,25080.7,14520,39600.7
430957,202308,25,23,2,30360.11,2640,33000.11
430960,202308,286,188,98,248160.45,129360.33,377520.78
430965,202308,116,75,41,99000.09,54120,153120.09
430970,202308,95,74,21,97680,27720,125400
430975,202308,56,48,8,63360.87,10560,73920.87
430980,202308,59,36,23,47520.78,30360,77880.78
430990,202308,101,80,21,105600,27720,133320
430995,202308,123,112,11,147840,14520,162360
431000,202308,311,155,156,204601.2,207240,411841.2
431010,202308,397,235,162,310213.58,213842.8,524056.38
431020,202308,2086,1200,886,1589301.09,1172162.17,2761463.26
431030,202308,45,35,10,46200,13200,59400
431033,202308,549,247,302,326057.64,398651.83,724709.47
431036,202308,12,8,4,10560,5280,15840
431040,202308,162,111,51,146520.81,67320,213840.81
431041,202308,48,30,18,39600,23760,63360
431043,202308,41,24,17,31680.42,22440,54120.42
431046,202308,12,9,3,11880,3960,15840
431050,202308,217,137,80,180840.63,105600,286440.63
431053,202308,86,49,37,66001.39,48841.8,114843.19
431055,202308,69,44,25,58080,33000,91080
431057,202308,21,21,0,27720,,27720.0
431060,202308,1696,1073,623,1417695.44,822362.7,2240058.14
431065,202308,20,10,10,13200,13200,26400
431070,202308,66,57,9,75240.18,11880,87120.18
431075,202308,8,8,0,10560,,10560.0
431080,202308,139,78,61,102961.83,80520,183481.83
431085,202308,39,35,4,46200.39,5280,51480.39
431087,202308,17,13,4,17160,5280,22440
431090,202308,48,37,11,48840.3,14520,63360.3
431100,202308,1392,823,569,1087700.55,753722.08,1841422.63
431110,202308,233,146,87,192723.34,114840,307563.34
431112,202308,31,25,6,33000.33,7920,40920.33
431113,202308,32,20,12,26400.56,15840,42240.56
431115,202308,155,112,43,147840.66,56760,204600.66
431120,202308,632,372,260,492366.7,343200.78,835567.48
431123,202308,7,7,0,9240,,9240.0
431125,202308,98,87,11,114840,14520,129360
431127,202308,6,4,2,5280,2640,7920
431130,202308,763,491,272,650768.3,359043.58,1009811.88
431140,202308,904,637,267,840848.4,352441.6,1193290.0
431142,202308,16,14,2,18480.56,2640,21120.56
431150,202308,213,147,66,194042.06,87120,281162.06
431160,202308,42,37,5,48840.7,6600,55440.7
431162,202308,5,5,0,6600.88,,6600.88
431164,202308,7,6,1,7920,1320,9240
431170,202308,120,83,37,109560.2,48840,158400.2
431171,202308,77,46,31,60720,40920,101640
431173,202308,9,8,1,10560,1320.8,11880.8
431175,202308,211,114,97,150481.66,128040.42,278522.08
431177,202308,118,79,39,105601.54,51480.91,157082.45
431179,202308,19,13,6,17160,7920,25080
431180,202308,427,263,164,347164.83,216480,563644.83
431190,202308,72,54,18,72600.6,23760.7,96361.3
431198,202308,78,55,23,72463.48,30360,102823.48
431200,202308,24,18,6,23760,7920,31680
431205,202308,24,22,2,29040.7,2640,31680.7
431210,202308,113,68,45,89760.7,59400,149160.7
431213,202308,33,27,6,35640,7920.56,43560.56
431215,202308,25,23,2,30360.79,2640,33000.79
431217,202308,7,6,1,7920,1320,9240
431220,202308,70,57,13,76561.05,17160,93721.05
431225,202308,183,110,73,145200.24,96360,241560.24
431230,202308,109,85,24,112204.08,31680,143884.08
431235,202308,6,4,2,5280,2640,7920
431237,202308,20,16,4,21120,5280,26400
431238,202308,16,11,5,14520,6600.2,21120.2
431240,202308,1092,675,417,891028.95,551761.96,1442790.91
431242,202308,43,42,1,56760,1320,58080
431244,202308,46,37,9,48841.52,11880,60721.52
431245,202308,59,44,15,58080.67,19800,77880.67
431247,202308,19,10,9,13200,11880,25080
431250,202308,326,160,166,212522.15,219120,431642.15
431260,202308,55,45,10,59400,13200,72600
431261,202308,22,15,7,19800.18,9240,29040.18
431262,202308,14,12,2,15840,2640,18480
431265,202308,154,91,63,120121.47,83160,203281.47
431267,202308,22,18,4,23760,5280,29040
431270,202308,353,269,84,355083.81,110880.55,465964.36
431275,202308,41,37,4,48840,5280,54120
431280,202308,21,16,5,21120,6600,27720
431290,202308,29,26,3,34320.56,3960,38280.56
431295,202308,4,1,3,1320,3960,5280
431300,202308,25,20,5,26400.6,6600,33000.6
431301,202308,7,7,0,9240,,9240.0
431303,202308,62,39,23,51480,30360,81840
431306,202308,252,125,127,165001.91,167640,332641.91
431308,202308,8,7,1,9240.6,1320,10560.6
431310,202308,63,49,14,64680.16,18480,83160.16
431320,202308,269,166,103,219121.6,137280,356401.6
431330,202308,238,165,73,217802.86,96360,314162.86
431333,202308,28,23,5,30360,6600,36960
431335,202308,11,9,2,11880.65,2640,14520.65
431337,202308,481,236,245,311532.56,323404.09,634936.65
431339,202308,26,20,6,26400,7920,34320
431340,202308,3568,1939,1629,2562072.03,2154249.86,4716321.89
431342,202308,41,27,14,35640,18480,54120
431344,202308,28,28,0,36960,,36960.0
431346,202308,5,4,1,5280,1320,6600
431349,202308,30,28,2,36960,2640,39600
431350,202308,1067,602,465,795990.74,613803.87,1409794.61
431360,202308,61,43,18,56760,23760,80520
431365,202308,407,176,231,232323.56,304920.49,537244.05
431370,202308,1305,735,570,970221.43,752404.29,1722625.72
431380,202308,107,93,14,122761.78,18480,141241.78
431390,202308,534,295,239,389403.05,315480.2,704883.25
431395,202308,341,150,191,198001.17,252120,450121.17
431400,202308,39,23,16,30360,21120,51480
431402,202308,95,70,25,92401.7,33000.71,125402.41
431403,202308,32,22,10,29040,13200,42240
431405,202308,826,495,331,653419.46,438246.47,1091665.93
431406,202308,37,30,7,39600.14,9240,48840.14
431407,202308,49,38,11,50160,15840,66000
431410,202308,3856,2366,1490,3123199.27,1970780.85,5093980.12
431413,202308,15,12,3,15840,3960,19800
431415,202308,80,58,22,76560.6,29040,105600.6
431417,202308,24,14,10,18480,13200,31680
431420,202308,402,266,136,351126.33,179520,530646.33
431430,202308,70,33,37,43561.63,48840,92401.63
431440,202308,10384,6969,3415,9209950.68,4511867.41,13721818.09
431442,202308,28,15,13,19800,17160,36960
431445,202308,32,30,2,39600,2640,42240
431446,202308,5,5,0,6600.98,,6600.98
431447,202308,90,70,20,92400.9,26400,118800.9
431449,202308,68,56,12,73920.39,15840,89760.39
431450,202308,450,294,156,388081.77,205920,594001.77
431454,202308,13,8,5,10560,6600,17160
431455,202308,50,38,12,50160.03,15840,66000.03
431460,202308,529,357,172,471246.53,227040,698286.53
431470,202308,143,105,38,138600.25,50160,188760.25
431475,202308,11,9,2,11880,2640,14520
431477,202308,42,26,16,34320,21120,55440
431478,202308,7,7,0,9240,,9240.0
431480,202308,809,490,319,646815.67,421082.54,1067898.21
431490,202308,34905,19563,15342,25852791.29,20279389.49,46132180.78
431500,202308,81,59,22,77880,29040,106920
431505,202308,31,22,9,29040.85,11880,40920.85
431507,202308,9,8,1,10560,1320,11880
431510,202308,244,175,69,232320.86,91080,323400.86
431513,202308,19,18,1,23762.06,1320,25082.06
431514,202308,6,4,2,5280,2640,7920
431515,202308,91,77,14,101640.54,18480,120120.54
431517,202308,7,5,2,6600,2640,9240
431520,202308,41,33,8,43560.2,10560,54120.2
431530,202308,1483,645,838,851410.71,1107481.13,1958891.84
431531,202308,26,24,2,31680.7,2640,34320.7
431532,202308,41,29,12,38280,15840,54120
431535,202308,31,18,13,23760,17160,40920
431540,202308,146,116,30,153123.09,40920,194043.09
431545,202308,12,9,3,11880,3960,15840
431550,202308,380,196,184,258724.95,244201.27,502926.22
431555,202308,20,16,4,21120.2,5280,26400.2
431560,202308,5540,3686,1854,4867020.28,2451283.48,7318303.76
431570,202308,960,510,450,674532.61,595324.81,1269857.42
431575,202308,62,39,23,51480.45,30360,81840.45
431580,202308,84,61,23,80520,30360,110880
431590,202308,156,129,27,170280,35640,205920
431595,202308,20,18,2,23760,2640,26400
431600,202308,276,163,113,215165.68,153121.25,368286.93
431610,202308,126,95,31,125401.77,40920.2,166321.97
431620,202308,38,31,7,40920,9240,50160
431630,202308,123,97,26,128040.79,34320,162360.79
431640,202308,1378,851,527,1124654.25,698281.01,1822935.26
431642,202308,33,29,4,38280,5280,43560
431643,202308,44,17,27,22440,36960,59400
431645,202308,355,211,144,278520.97,191400,469920.97
431647,202308,15,14,1,18480,1320,19800
431650,202308,36,21,15,27720,19800,47520
431660,202308,260,166,94,219121.43,124080,343201.43
431670,202308,246,104,142,137281.6,187440.11,324721.71
431673,202308,13,11,2,14520,2640,17160
431675,202308,29,22,7,29040,9240,38280
431680,202308,1313,942,371,1243483.27,489724.34,1733207.61
431690,202308,5619,3246,2373,4287577.62,3137680.31,7425257.93
431695,202308,17,11,6,14520,7920,22440
431697,202308,6,4,2,5280,2640,7920
431700,202308,204,151,53,199320.55,69960,269280.55
431710,202308,4576,1942,2634,2567439.56,3479533.95,6046973.51
431720,202308,1371,846,525,1121354.11,693000.72,1814354.83
431725,202308,3,1,2,1320,2640,3960
431730,202308,1303,848,455,1120731.58,600609.75,1721341.33
431740,202308,1395,678,717,894973.6,946444.43,1841418.03
431750,202308,1933,1267,666,1673217.32,880444.07,2553661.39
431755,202308,5,4,1,5280,1320,6600
431760,202308,1073,680,393,898938.95,518765.8,1417704.75
431770,202308,434,284,150,376200.9,198000,574200.9
431775,202308,27,19,8,25080,10560,35640
431780,202308,609,365,244,483123.03,322080,805203.03
431790,202308,151,118,33,155762.1,43560.1,199322.2
431795,202308,14,12,2,15840,2640,18480
431800,202308,3311,1715,1596,2267796.19,2113328.55,4381124.74
431805,202308,20,16,4,21120,5280,26400
431810,202308,601,388,213,512166.88,281160,793326.88
431820,202308,383,214,169,283801.36,224400,508201.36
431830,202308,2571,1562,1009,2063117.31,1334522.68,3397639.99
431840,202308,542,347,195,459374.64,258720.67,718095.31
431842,202308,36,29,7,38280,9240,47520
431843,202308,8,6,2,7920.09,2640,10560.09
431844,202308,18,14,4,18480.86,5280,23760.86
431845,202308,28,25,3,33000,3960,36960
431846,202308,29,24,5,31680.72,6600,38280.72
431848,202308,14,11,3,14520,3960,18480
431849,202308,8,7,1,9240,1320,10560
431850,202308,882,689,193,909504.82,254762.52,1164267.34
431860,202308,120,78,42,102960.64,55440,158400.64
431861,202308,4,0,4,,5280,5280.0
431862,202308,68,49,19,64680.65,25080,89760.65
431870,202308,4333,2534,1799,3351605.72,2377352.48,5728958.20
431880,202308,1081,753,328,993972.5,434282.11,1428254.61
431890,202308,1317,753,564,993972.8,744481.08,1738453.88
431900,202308,206,133,73,175560.43,96360,271920.43
431910,202308,48,37,11,48840.1,14520,63360.1
431912,202308,58,41,17,54121.2,22440,76561.2
431915,202308,162,124,38,163681.2,50160,213841.2
431920,202308,161,114,47,150480.35,62040,212520.35
431930,202308,80,63,17,83160,22440,105600
431935,202308,5,4,1,5280,1320,6600
431936,202308,4,4,0,5280,,5280.0
431937,202308,22,17,5,22440.2,6600,29040.2
431940,202308,488,337,151,444846.82,200640.46,645487.28
431950,202308,519,325,194,430334.96,256080.4,686415.36
431960,202308,797,444,353,586091.04,465960,1052051.04
431970,202308,64,58,6,76560.58,7920,84480.58
431971,202308,6,5,1,6600,1320,7920
431973,202308,20,17,3,22440.98,3960,26400.98
431975,202308,10,10,0,13200.2,,13200.2
431980,202308,225,128,97,168960.41,128040,297000.41
431990,202308,1087,598,489,789382.44,646811.58,1436194.02
432000,202308,2244,1210,1034,1599910.4,1366216.02,2966126.42
432010,202308,262,170,92,224401.1,121440.2,345841.3
432020,202308,203,172,31,228364.23,40920.4,269284.63
432023,202308,15,13,2,17160,2640,19800
432026,202308,66,58,8,76560.1,10560,87120.1
432030,202308,56,25,31,33000.19,40920,73920.19
432032,202308,14,11,3,14520,3960,18480
432035,202308,78,58,20,76560,26400,102960
432040,202308,90,64,26,84481.04,34320,118801.04
432045,202308,4,4,0,5280,,5280.0
432050,202308,84,53,31,69960.69,42240,112200.69
432055,202308,145,101,44,133321.56,58080,191401.56
432057,202308,7,4,3,5280.7,3960,9240.7
432060,202308,29,25,4,33000,5280,38280
432065,202308,33,28,5,36960,6600,43560
432067,202308,81,74,7,99000.51,9240,108240.51
432070,202308,415,330,85,435604.58,113520,549124.58
432080,202308,897,635,262,838235.21,345842.77,1184077.98
432085,202308,21,18,3,23760,3960,27720
432090,202308,298,196,102,258720.2,134640.33,393360.53
432100,202308,186,119,67,157080.59,88440,245520.59
432110,202308,604,398,206,526687.5,271920.04,798607.54
432120,202308,1162,666,496,879135.94,658682.59,1537818.53
432130,202308,572,402,170,530644.09,225720,756364.09
432132,202308,21,19,2,25080,2640,27720
432135,202308,86,66,20,87120.66,26400,113520.66
432140,202308,289,215,74,283801.86,97680,381481.86
432143,202308,247,151,96,200642.44,126720.24,327362.68
432145,202308,338,238,100,314163.68,132000.69,446164.37
432146,202308,17,15,2,19800,2640,22440
432147,202308,105,65,40,85800,52800,138600
432149,202308,13,12,1,15840,1320,17160
432150,202308,1231,788,443,1040183.94,588722.88,1628906.82
432160,202308,2256,1145,1111,1512754.7,1470492,2983246.7
432162,202308,8,4,4,5280,5280,10560
432163,202308,17,12,5,15840,6600,22440
432166,202308,141,97,44,128372.9,58080.52,186453.42
432170,202308,251,132,119,174248.29,157080.9,331329.19
432180,202308,601,389,212,513481.28,279840,793321.28
432183,202308,16,13,3,17160.43,3960,21120.43
432185,202308,82,68,14,89760.42,18480,108240.42
432190,202308,575,341,234,450121.67,312840.44,762962.11
432195,202308,100,78,22,102961.3,29040,132001.3
432200,202308,488,298,190,393367.78,250801.9,644169.68
432210,202308,120,71,49,93720.1,64680,158400.1
432215,202308,34,32,2,42240,2640,44880
432218,202308,21,21,0,27720,,27720.0
432220,202308,709,352,357,464647.57,471243.46,935891.03
432225,202308,20,15,5,19800.2,6600,26400.2
432230,202308,128,82,46,108240,60720.3,168960.3
432232,202308,36,31,5,40920,6600,47520
432234,202308,5,3,2,3960,2640,6600
432235,202308,2,2,0,2640,,2640.0
432237,202308,26,18,8,23760,10560.95,34320.95
432240,202308,4954,2758,2196,3641971.7,2900069.63,6542041.33
432250,202308,1270,852,418,1125973.83,553082.91,1679056.74
432252,202308,52,47,5,62040,6600,68640
432253,202308,78,59,19,77881.25,25080,102961.25
432254,202308,32,16,16,21120,21120,42240
432255,202308,11,10,1,13200,1320,14520
432260,202308,966,773,193,1020377.33,256080.1,1276457.43
432270,202308,243,182,61,241571.6,80522.2,322093.8
432280,202308,187,141,46,186124.51,60720,246844.51
432285,202308,1,1,0,1320,,1320.0
432290,202308,60,49,11,64680,14520,79200
432300,202308,5786,3120,2666,4122394.16,3525746.3,7648140.46
432310,202308,141,118,23,155760.49,30360,186120.49
432320,202308,24,18,6,23760,7920,31680
432330,202308,18,12,6,15840,7920,23760
432335,202308,9,7,2,9240,2640,11880
432340,202308,36,29,7,38280,9240,47520
432345,202308,134,91,43,120122.61,56760,176882.61
432350,202308,26,23,3,30360,3960,34320
432360,202308,6,5,1,6600.7,1320,7920.7
432370,202308,27,27,0,35640.11,,35640.11
432375,202308,30,28,2,36960,2640,39600
432377,202308,10,9,1,11880.48,1320,13200.48
432380,202308,252,121,131,159722.11,172923.08,332645.19
500020,202308,328,171,157,225722.75,207240.8,432963.55
500025,202308,155,73,82,96362.27,109562.06,205924.33
500060,202308,1644,1058,586,1399243.14,778808.17,2178051.31
500070,202308,820,410,410,541213.52,542530.32,1083743.84
500080,202308,154,126,28,166324.6,36960,203284.6
500085,202308,163,120,43,159723.65,56760,216483.65
500090,202308,415,197,218,260046.87,287762.25,547809.12
500100,202308,725,377,348,498973.75,460680.99,959654.74
500110,202308,2476,1207,1269,1595934.48,1676420.31,3272354.79
500124,202308,295,152,143,200640.99,188761.26,389402.25
500150,202308,337,138,199,182162.78,262680.65,444843.43
500190,202308,616,416,200,550460.6,264003.07,814463.67
500200,202308,224,183,41,241563.66,54120,295683.66
500210,202308,1852,577,1275,761651.82,1683012.99,2444664.81
500215,202308,215,124,91,163688.12,120120.2,283808.32
500220,202308,782,489,293,645506.44,388082.56,1033589.00
500230,202308,260,149,111,196682.57,146521.34,343203.91
500240,202308,688,423,265,558374.53,352442.72,910817.25
500260,202308,634,260,374,343205.26,493680.46,836885.72
500270,202308,34120,15057,19063,19896286.8,25191666.43,45087953.23
500280,202308,209,72,137,95040.18,180840.66,275880.84
500290,202308,1278,803,475,1059989.15,627003.51,1686992.66
500295,202308,534,356,178,471248.3,234961.09,706209.39
500310,202308,123,42,81,56760.1,106920.5,163680.6
500315,202308,919,497,422,656041.16,557042.56,1213083.72
500320,202308,4134,1940,2194,2559583.43,2898734.45,5458317.88
500325,202308,1026,581,445,766950.76,587405.03,1354355.79
500330,202308,1685,844,841,1114163.9,1111453.22,2225617.12
500345,202308,344,234,110,308885.24,145200.21,454085.45
500348,202308,273,164,109,216484.46,143880,360364.46
500350,202308,105,50,55,66002.36,72601.14,138603.50
500370,202308,6342,2919,3423,3864019.94,4521034.88,8385054.82
500375,202308,395,258,137,340563.27,182160.15,522723.42
500380,202308,721,397,324,524055.44,427681.29,951736.73
500390,202308,86,36,50,47520.1,66000.2,113520.3
500400,202308,240,143,97,188765.52,128040.97,316806.49
500410,202308,463,210,253,277210.62,333963.14,611173.76
500430,202308,662,408,254,538574.99,335281.5,873856.49
500440,202308,211,121,90,159720.14,118800.2,278520.34
500450,202308,479,208,271,274564.59,357721.08,632285.67
500460,202308,309,168,141,221763.52,186120.96,407884.48
500470,202308,475,335,140,442208.31,184800.68,627008.99
500480,202308,118,67,51,89760.73,67321.48,157082.21
500490,202308,103,48,55,63360.68,72603.57,135964.25
500500,202308,1621,604,1017,797304.98,1342446.63,2139751.61
500510,202308,40,34,6,44880.31,7920,52800.31
500515,202308,129,85,44,112202.38,58081.47,170283.85
500520,202308,325,165,160,217806.95,211200.16,429007.11
500525,202308,101,52,49,68640.14,64680,133320.14
500540,202308,1000,440,560,582141.93,739206.82,1321348.75
500560,202308,936,522,414,689053.71,546483.51,1235537.22
500568,202308,1217,567,650,748457.82,858007.54,1606465.36
500570,202308,1313,755,558,997938.56,736562.24,1734500.80
500580,202308,322,178,144,234968.26,190081.13,425049.39
500600,202308,436,206,230,271925.64,303601.64,575527.28
500620,202308,1142,799,343,1057347.09,454087.16,1511434.25
500625,202308,92,68,24,89760.41,33000,122760.41
500627,202308,52,23,29,30360,38280,68640
500630,202308,1719,998,721,1318157.76,951726.44,2269884.20
500635,202308,534,316,218,417120.98,287760,704880.98
500640,202308,364,196,168,260050.32,223082.7,483133.02
500660,202308,6674,2364,4310,3120551.35,5689235.22,8809786.57
500690,202308,692,249,443,328685.87,586080.26,914766.13
500710,202308,445,218,227,289086.52,299644.29,588730.81
500720,202308,1047,575,472,759020.6,623043.21,1382063.81
500730,202308,145,87,58,114845.49,76560,191405.49
500740,202308,1048,457,591,603255.51,780124.73,1383380.24
500750,202308,219,80,139,105603.23,183481.15,289084.38
500755,202308,118,88,30,116164.34,39600.93,155765.27
500769,202308,818,459,359,605898.13,475203.71,1081101.84
500770,202308,465,252,213,332640.68,282480,615120.68
500780,202308,141,95,46,125406.75,60721.33,186128.08
500790,202308,1196,581,615,766947.82,813124.68,1580072.50
500793,202308,316,162,154,215163.49,204602.75,419766.24
500795,202308,212,133,79,176883.54,104280.7,281164.24
500797,202308,51,36,15,47520.62,19800,67320.62
500800,202308,480,210,270,277206.21,356401.35,633607.56
500830,202308,2600,1347,1253,1779427.35,1653969.68,3433397.03
500840,202308,112,81,31,106924.96,40920.94,147845.90
510010,202308,176,97,79,128040,105600,233640
510020,202308,572,277,295,365653.69,392044.15,757697.84
510025,202308,1918,1092,826,1441482.97,1092970.53,2534453.50
510030,202308,685,369,316,487097.32,417126.35,904223.67
510035,202308,137,72,65,95040.25,87120,182160.25
510040,202308,431,202,229,266642.81,302281.66,568924.47
510050,202308,392,200,192,264003.29,253440,517443.29
510060,202308,148,66,82,87122.98,108240,195362.98
510080,202308,264,115,149,151801.77,196680,348481.77
510100,202308,68,28,40,36960.55,52800.73,89761.28
510120,202308,32,19,13,25080.99,17160.04,42241.03
510125,202308,417,265,152,349801.9,200640.21,550442.11
510130,202308,567,342,225,451450.05,297002.17,748452.22
510140,202308,482,166,316,219121.15,418440.53,637561.68
510160,202308,112,47,65,62042.6,85801.31,147843.91
510170,202308,861,506,355,669256.24,468605.88,1137862.12
510180,202308,3244,1465,1779,1936486.24,2349619.68,4286105.92
510185,202308,42,22,20,29040.7,26400,55440.7
510190,202308,285,106,179,139922.56,238921.49,378844.05
510250,202308,2978,1802,1176,2378682.42,1553644.58,3932327.00
510260,202308,177,127,50,167641.67,66000.49,233642.16
510263,202308,514,297,217,393365.76,286443.12,679808.88
510267,202308,690,391,299,516138.02,396002.84,912140.86
510268,202308,82,39,43,51480.01,56760,108240.01
510269,202308,80,37,43,48840,56760.5,105600.5
510270,202308,405,196,209,260042.1,277200.31,537242.41
510279,202308,227,166,61,219122.31,81840,300962.31
510285,202308,190,77,113,101641.48,149160,250801.48
510300,202308,558,300,258,396004.39,341882.33,737886.72
510305,202308,217,93,124,122760.33,163680,286440.33
510310,202308,114,59,55,77880.02,72600.1,150480.12
510320,202308,871,545,326,719412.87,431643.35,1151056.22
510325,202308,474,207,267,273243.7,355082.33,628326.03
510330,202308,496,278,218,368286.57,287761.55,656048.12
510335,202308,729,440,289,582136.97,381482.72,963619.69
510336,202308,58,40,18,52801.38,23760.24,76561.62
510337,202308,109,45,64,59400.03,84480,143880.03
510340,202308,20614,8847,11767,11683748.52,15548527.7,27232276.22
510343,202308,63,50,13,66000,17160,83160
510345,202308,158,97,61,128042.17,80520.68,208562.85
510350,202308,705,372,333,492373.18,439565.85,931939.03
510360,202308,226,140,86,184803.49,114840,299643.49
510370,202308,181,77,104,101640,138600.7,240240.7
510380,202308,82,60,22,79200,29040,108240
510385,202308,56,32,24,42240.2,31680,73920.2
510390,202308,102,48,54,63360.57,71280.4,134640.97
510395,202308,60,42,18,55440,25080,80520
510410,202308,898,581,317,766948.75,419765.42,1186714.17
510420,202308,592,292,300,385444.24,396000.7,781444.94
510450,202308,55,32,23,42240,30360,72600
510452,202308,62,30,32,39600,42240,81840
510454,202308,56,26,30,34320,39600.03,73920.03
510455,202308,119,72,47,95040,62040.97,157080.97
510460,202308,214,96,118,126722.32,157080,283802.32
510480,202308,830,474,356,625699.01,471249.29,1096948.30
510490,202308,339,163,176,215162.5,232320.5,447483.0
510500,202308,254,190,64,250800.65,84480,335280.65
510510,202308,938,546,392,723376.79,517445.57,1240822.36
510515,202308,1386,718,668,949101.95,881765.3,1830867.25
510517,202308,287,128,159,168962.97,209880,378842.97
510520,202308,249,155,94,204603.61,124081.15,328684.76
510523,202308,123,96,27,126720,35640,162360
510525,202308,951,589,362,777495.82,479162.91,1256658.73
510530,202308,33,16,17,21120,22440,43560
510550,202308,259,117,142,154442.19,187441.93,341884.12
510558,202308,334,165,169,218053.01,223080,441133.01
510560,202308,412,244,168,322085.99,221762.44,543848.43
510562,202308,720,515,205,682021.82,270601.62,952623.44
510590,202308,745,360,385,475212,509522.49,984734.49
510600,202308,218,120,98,158404.5,129360.55,287765.05
510610,202308,229,105,124,138604.25,163681.4,302285.65
510615,202308,246,116,130,153120.84,171600.31,324721.15
510617,202308,27,11,16,14520,21120,35640
510618,202308,128,66,62,87120,81842.26,168962.26
510619,202308,87,61,26,80521.82,34320,114841.82
510620,202308,165,88,77,116160.7,101640,217800.7
510621,202308,183,120,63,158400.17,83160.23,241560.40
510622,202308,552,292,260,385451.83,343204.48,728656.31
510623,202308,305,206,99,271923.27,130680.2,402603.47
510624,202308,103,50,53,66001.65,69960.55,135962.20
510625,202308,576,355,221,468614.61,291724.67,760339.28
510626,202308,123,66,57,87122.54,75240,162362.54
510627,202308,103,68,35,89761.42,46200,135961.42
510628,202308,176,108,68,142560.28,89760,232320.28
510629,202308,310,189,121,250802.41,159743.76,410546.17
510630,202308,489,258,231,340574.49,304921.51,645496.00
510631,202308,22,9,13,11880.13,17160,29040.13
510637,202308,375,217,158,286442.34,209880.1,496322.44
510642,202308,1307,703,604,927980.02,797287.55,1725267.57
510645,202308,12,5,7,6600,10560,17160
510650,202308,1310,835,475,1102245.52,628323.79,1730569.31
510665,202308,102,46,56,60720.67,73920.08,134640.75
510670,202308,60,35,25,46200.72,34320,80520.72
510675,202308,1195,759,436,1003228.98,575523.67,1578752.65
510677,202308,369,196,173,258724.19,228360.51,487084.70
510680,202308,92,57,35,75241.85,46200,121441.85
510682,202308,210,100,110,132000.85,145200,277200.85
510685,202308,59,41,18,54120.55,23760.8,77881.35
510700,202308,636,364,272,481814.82,360363.21,842178.03
510704,202308,1406,722,684,953079.49,906852.43,1859931.92
510706,202308,175,88,87,116162.88,114841.67,231004.55
510710,202308,462,329,133,435607.26,175560,611167.26
510715,202308,57,39,18,51480,23760.63,75240.63
510718,202308,268,118,150,155762.02,199324.13,355086.15
510719,202308,56,26,30,34320,39600,73920
510720,202308,189,135,54,178200.37,71280,249480.37
510724,202308,82,32,50,42240,66000,108240
510726,202308,67,34,33,44880.7,44880.62,89761.32
510729,202308,17,6,11,7920,14520.3,22440.3
510730,202308,494,258,236,340562.24,311520,652082.24
510735,202308,127,49,78,64680.41,102960,167640.41
510740,202308,27,16,11,21121.25,14521.24,35642.49
510757,202308,29,24,5,31680.68,6600.16,38280.84
510760,202308,8355,4247,4108,5615414.27,5427881.68,11043295.95
510770,202308,773,350,423,462009.15,558363.42,1020372.57
510774,202308,17,6,11,7920.69,14520,22440.69
510775,202308,128,102,26,134640,34320,168960
510776,202308,37,13,24,17160,31680.2,48840.2
510777,202308,195,89,106,117480,139920,257400
510779,202308,38,24,14,31680,18480,50160
510780,202308,289,152,137,200648.65,182160,382808.65
510785,202308,355,195,160,257406.58,211200.76,468607.34
510787,202308,231,117,114,154445.17,150481.29,304926.46
510788,202308,11,4,7,5280.9,9240,14520.9
510790,202308,2941,1503,1438,1986713.59,1900807.99,3887521.58
510792,202308,1205,676,529,892463.96,698290,1590753.96
510794,202308,126,69,57,91081.06,75240,166321.06
510795,202308,2509,1409,1100,1862559.79,1453325.65,3315885.44
510800,202308,200,110,90,145201.56,118800,264001.56
510805,202308,234,162,72,213840.9,96360,310200.9
510810,202308,110,44,66,58081.42,87120.42,145201.84
510820,202308,271,138,133,182161.74,175561.24,357722.98
510830,202308,82,42,40,55440,52800,108240
510835,202308,29,22,7,29040.7,9240,38280.7
510840,202308,10386,4698,5688,6205561.6,7514837.21,13720398.81
510850,202308,222,88,134,116162.17,176880.26,293042.43
510860,202308,448,227,221,299643.36,293041.49,592684.85
510880,202308,82,59,23,77880.2,30360,108240.2
510885,202308,75,42,33,55441.3,43560,99001.3
510890,202308,80,38,42,50160.05,55440,105600.05
510895,202308,197,117,80,154440.44,105600,260040.44
520005,202308,171,72,99,95043.05,130681.05,225724.10
520010,202308,346,157,189,207242.19,249483.17,456725.36
520013,202308,815,571,244,753735.53,322084.09,1075819.62
520015,202308,39,25,14,33000,18480,51480
520017,202308,88,57,31,76560.84,40920,117480.84
520020,202308,12,6,6,7920,7920,15840
520025,202308,3385,1856,1529,2451350.61,2022299.12,4473649.73
520030,202308,957,497,460,656054,607203.95,1263257.95
520050,202308,63,47,16,62040.2,21120.9,83161.1
520055,202308,85,58,27,77880,36960.2,114840.2
520060,202308,196,134,62,176883.5,81841.25,258724.75
520080,202308,611,437,174,576841.26,229680.75,806522.01
520082,202308,19,13,6,17160,7920,25080
520085,202308,116,91,25,120120.18,33000.7,153120.88
520090,202308,89,65,24,85800.75,31680,117480.75
520110,202308,10246,4371,5875,5771198.08,7765622.64,13536820.72
520120,202308,10,7,3,9240,3960,13200
520130,202308,928,651,277,859330.89,365641.42,1224972.31
520140,202308,13481,7356,6125,9712889.14,8093006.68,17805895.82
520145,202308,70,40,30,52800.2,39600,92400.2
520150,202308,141,109,32,145206.3,42240,187446.3
520160,202308,45,27,18,35640,23760,59400
520170,202308,222,125,97,165008.54,128041.32,293049.86
520180,202308,212,99,113,130680.78,149161.36,279842.14
520215,202308,208,153,55,201960.73,72600.2,274560.93
520235,202308,96,73,23,96360,30360,126720
520250,202308,171,87,84,114841.5,110880,225721.5
520260,202308,130,79,51,104282.37,67321.05,171603.42
520280,202308,51,39,12,51480,15840,67320
520310,202308,29,17,12,22441.8,15840.7,38282.5
520320,202308,197,118,79,155762.15,105600.97,261363.12
520330,202308,910,506,404,667934.89,534604.3,1202539.19
520340,202308,315,181,134,238927.85,176881.46,415809.31
520350,202308,513,264,249,348484.59,330002.2,678486.79
520355,202308,111,67,44,88441.52,58080,146521.52
520357,202308,37,29,8,38280,10560,48840
520360,202308,20,7,13,9240.2,17160.28,26400.48
520380,202308,149,83,66,109560,87120,196680
520390,202308,245,108,137,142564.05,180840,323404.05
520393,202308,18,14,4,18480.1,5280,23760.1
520396,202308,78,57,21,75240,27720,102960
520400,202308,224,139,85,183485.12,112202.83,295687.95
520410,202308,208,107,101,141243.72,133320,274563.72
520420,202308,23,18,5,23760.84,6600,30360.84
520425,202308,264,125,139,165002.98,183480.98,348483.96
520430,202308,578,269,309,355081.68,407880.64,762962.32
520440,202308,721,529,192,699616.71,253441.33,953058.04
520450,202308,2415,1060,1355,1399246.07,1789940.18,3189186.25
520455,202308,69,39,30,51481.37,39600.51,91081.88
520460,202308,48,29,19,38280.69,25081.51,63362.20
520465,202308,41,36,5,47520,6600,54120
520470,202308,487,302,185,398643.34,244200.2,642843.54
520480,202308,77,51,26,67321.59,34320,101641.59
520485,202308,113,44,69,58080.83,91080.1,149160.93
520490,202308,585,431,154,568930.54,203283.55,772214.09
520495,202308,175,106,69,139920.1,92400,232320.1
520500,202308,267,219,48,289082.17,63360,352442.17
520505,202308,197,117,80,154440,105600,260040
520510,202308,2257,1068,1189,1411105.47,1573449.24,2984554.71
520520,202308,68,44,24,58080.97,31680,89760.97
520530,202308,221,178,43,234966.13,56760,291726.13
520540,202308,850,577,273,761650.98,360363.2,1122014.18
520545,202308,161,96,65,126724.71,85800.6,212525.31
520547,202308,83,47,36,62042.64,47520.98,109563.62
520549,202308,1670,816,854,1079794.4,1129933.52,2209727.92
520551,202308,344,186,158,245521.86,208561.23,454083.09
520552,202308,59,44,15,58080.5,19800,77880.5
520570,202308,15,12,3,15840,3960,19800
520580,202308,299,187,112,246979.79,147840.6,394820.39
520590,202308,167,93,74,122762.06,97680,220442.06
520620,202308,1373,642,731,847451.7,966247.3,1813699.0
520630,202308,58,30,28,39600,36960.18,76560.18
520640,202308,413,244,169,322086.4,223080.9,545167.3
520650,202308,76,35,41,46200,54120,100320
520660,202308,47,25,22,33000.85,29040.38,62041.23
520670,202308,48,36,12,47520.22,15840,63360.22
520680,202308,26,16,10,21120,13200,34320
520690,202308,39,10,29,13200,38280,51480
520710,202308,38,28,10,36960,13200,50160
520725,202308,203,150,53,198002.82,69960,267962.82
520735,202308,62,38,24,50160.2,31680.2,81840.4
520740,202308,493,245,248,323407.05,327361.22,650768.27
520750,202308,42,24,18,31680,23760,55440
520753,202308,83,60,23,79200.76,30360,109560.76
520760,202308,110,77,33,101641.38,43560,145201.38
520780,202308,275,212,63,279844.83,83162.63,363007.46
520790,202308,147,92,55,121440.48,72600,194040.48
520800,202308,3727,2121,1606,2801121.86,2125225.12,4926346.98
520810,202308,140,108,32,142562.33,42240.89,184803.22
520815,202308,7,5,2,6600.96,2640,9240.96
520830,202308,135,95,40,125403.74,52800.05,178203.79
520840,202308,430,273,157,360360.74,207240,567600.74
520850,202308,114,68,46,89762.18,60720,150482.18
520860,202308,1998,1264,734,1668517.63,971524.86,2640042.49
520870,202308,37317,16878,20439,22293409.9,26999573.53,49292983.43
520880,202308,1427,752,675,994001.05,892336,1886337.05
520890,202308,896,582,314,768262.08,414481.57,1182743.65
520910,202308,1041,544,497,718105.35,656042.61,1374147.96
520915,202308,96,64,32,84482.58,42240,126722.58
520920,202308,550,258,292,340571.21,385446.7,726017.91
520929,202308,16,14,2,18480.3,2640,21120.3
520940,202308,69,52,17,68641.18,22440.1,91081.28
520945,202308,20,12,8,15840,10560,26400
520960,202308,49,30,19,39600,25080,64680
520970,202308,463,271,192,359047.21,253444.3,612491.51
520980,202308,94,68,26,89760,34320,124080
520990,202308,446,315,131,415801.97,172920.63,588722.60
520993,202308,122,63,59,83163.4,77880.09,161043.49
520995,202308,285,159,126,209883.73,166320,376203.73
521000,202308,1730,944,786,1246104.92,1037529.88,2283634.80
521010,202308,667,357,310,471249.45,409202.78,880452.23
521015,202308,14,9,5,11880,6600,18480
521020,202308,1574,1106,468,1459954.94,617768.53,2077723.47
521030,202308,86,59,27,77880.95,35640,113520.95
521040,202308,1064,718,346,947782.67,456720.79,1404503.46
521056,202308,62,40,22,52800,29040,81840
521060,202308,132,84,48,110881.25,63360.76,174242.01
521080,202308,319,252,67,332658.77,88440.4,421099.17
521090,202308,632,434,198,574208.37,261360,835568.37
521100,202308,287,198,89,261366.12,117480.4,378846.52
521120,202308,1152,817,335,1078467.97,442203.74,1520671.71
521130,202308,333,239,94,315486.62,124080,439566.62
521140,202308,200,112,88,147844.25,116160.69,264004.94
521150,202308,2754,1165,1589,1537855.32,2098828.45,3636683.77
521160,202308,25,9,16,11880,21120,33000
521170,202308,232,128,104,168960.76,137280.2,306240.96
521180,202308,1308,818,490,1079790.23,646807.3,1726597.53
521190,202308,2853,1209,1644,1597240.76,2170094.37,3767335.13
521200,202308,64,47,17,62040.1,22440,84480.1
521205,202308,19,13,6,17160.2,7920,25080.2
521210,202308,145,89,56,117481.55,73920,191401.55
521220,202308,796,536,260,707533.59,343202.19,1050735.78
521225,202308,17,12,5,15841.1,6600.36,22441.46
521230,202308,116,77,39,101642.08,51480,153122.08
521250,202308,7006,3866,3140,5108612.26,4155413.02,9264025.28
521260,202308,48,20,28,26400,36960,63360
521270,202308,131,99,32,130680.6,42240,172920.6
521280,202308,433,268,165,353763.1,217800,571563.1
521290,202308,35,18,17,23760.92,22440.36,46201.28
521295,202308,109,73,36,96360.93,47520,143880.93
521300,202308,265,153,112,201962.36,147840.84,349803.20
521305,202308,48,33,15,43561.53,19800,63361.53
521308,202308,1063,821,242,1085073.93,319444.1,1404518.03
521310,202308,1505,826,679,1092994.37,896292.97,1989287.34
521340,202308,22,17,5,22440,6600,29040
521350,202308,94,71,23,93722.42,30360,124082.42
521370,202308,181,116,65,154440.5,85800,240240.5
521375,202308,217,103,114,135962.65,150481.23,286443.88
521377,202308,48,35,13,46200.75,17160.1,63360.85
521380,202308,1157,681,476,900277.35,629646.9,1529924.25
521385,202308,11,6,5,7920,6600,14520
521390,202308,104,83,21,109561.73,27720.49,137282.22
521400,202308,422,305,117,402613,154440.92,557053.92
521405,202308,175,113,62,149163.12,81840.66,231003.78
521410,202308,86,63,23,83161.27,30360,113521.27
521440,202308,227,154,73,203285.92,96360.64,299646.56
521450,202308,838,461,377,608531.98,497643.96,1106175.94
521460,202308,1190,836,354,1103564.87,467286.39,1570851.26
521470,202308,15,11,4,14520,5280,19800
521480,202308,45,28,17,36961.32,22440,59401.32
521483,202308,352,234,118,308883.03,155761.47,464644.50
521486,202308,330,222,108,293040.5,142560.84,435601.34
521487,202308,24,13,11,17160,14520,31680
521490,202308,27,15,12,19800,15840,35640
521500,202308,162,78,84,102961,110880.19,213841.19
521520,202308,49,37,12,48840,15840,64680
521523,202308,1296,705,591,931943.12,780124.11,1712067.23
521525,202308,65,50,15,66000,19800,85800
521530,202308,255,147,108,194040.45,142560.68,336601.13
521540,202308,45,22,23,29040,30360,59400
521550,202308,134,66,68,87121.19,89760.99,176882.18
521560,202308,990,670,320,884424.89,422402.48,1306827.37
521565,202308,74,52,22,68641.36,29040.7,97682.06
521570,202308,637,404,233,533289.4,308880.87,842170.27
521580,202308,43,27,16,35640,21120,56760
521590,202308,45,24,21,31680,27720,59400
521600,202308,25,12,13,15840,17160,33000
521630,202308,238,124,114,165005.76,150484.13,315489.89
521640,202308,332,181,151,238922.43,200640.67,439563.10
521645,202308,40,19,21,25080,27720,52800
521680,202308,268,165,103,217803.47,135960.87,353764.34
521690,202308,16,14,2,18480,2640,21120
521710,202308,1189,577,612,761651.21,807845.23,1569496.44
521720,202308,637,429,208,566285.12,274561.3,840846.42
521730,202308,774,360,414,475204.55,549121.84,1024326.39
521740,202308,980,466,514,615830.89,678484.16,1294315.05
521760,202308,2749,1427,1322,1885126.72,1746392.71,3631519.43
521770,202308,894,546,348,720729.14,460683.62,1181412.76
521800,202308,2138,1465,673,1936482.55,888361.6,2824844.15
521805,202308,41,26,15,34320,19800,54120
521810,202308,92,53,39,69960.91,51480,121440.91
521830,202308,1096,807,289,1065273.76,381486.4,1446760.16
521839,202308,74,41,33,54120,43560.2,97680.2
521850,202308,1288,646,642,852745.02,848769.99,1701515.01
521860,202308,351,221,130,291725.27,171600,463325.27
521870,202308,104,71,33,93720.38,43560,137280.38
521878,202308,38,16,22,21120,29040.02,50160.02
521880,202308,5612,2526,3086,3334416.79,4073552.34,7407969.13
521890,202308,691,471,220,621730.77,290402.11,912132.88
521900,202308,299,233,66,308880.39,88440.8,397321.19
521910,202308,193,134,59,176886.29,77881.48,254767.77
521920,202308,39,25,14,33000,18480,51480
521925,202308,62,36,26,47520,34320,81840
521930,202308,1367,774,593,1023036.56,782771.7,1805808.26
521935,202308,40,31,9,40921.38,11880,52801.38
521940,202308,254,115,139,151801.63,183481,335282.63
521945,202308,20,14,6,18480,7920,26400
521950,202308,25,15,10,19800,13200,33000
521960,202308,69,55,14,72600,18480,91080
521970,202308,424,276,148,364322.58,195360.89,559683.47
521971,202308,108,60,48,79200.8,63360,142560.8
521973,202308,41,20,21,26400.6,27720,54120.6
521975,202308,1859,1001,858,1322678.61,1133896.43,2456575.04
521980,202308,248,171,77,225721.44,101640,327361.44
521990,202308,95,66,29,87121.13,38280,125401.13
522000,202308,297,204,93,268826.4,122760.79,391587.19
522005,202308,19,11,8,14520,10560,25080
522010,202308,1260,706,554,931949.33,731291.84,1663241.17
522015,202308,64,40,24,52800,31680,84480
522020,202308,937,566,371,748453.92,489725.6,1238179.52
522026,202308,28,18,10,23760,13200,36960
522028,202308,26,22,4,29040,5280,34320
522040,202308,903,412,491,545174.5,648128.67,1193303.17
522045,202308,3067,1818,1249,2399846.25,1650009.62,4049855.87
522050,202308,166,73,93,96364.9,122760.72,219125.62
522060,202308,559,352,207,464652.06,273240.35,737892.41
522068,202308,127,93,34,122760.89,44880,167640.89
522070,202308,18,16,2,21120,2640,23760
522100,202308,36,22,14,29040,18480,47520
522108,202308,43,33,10,43562.54,13200,56762.54
522119,202308,68,37,31,48841.28,40920,89761.28
522130,202308,86,33,53,43560.46,69960.89,113521.35
522140,202308,4707,2480,2227,3275027.88,2942302.4,6217330.28
522145,202308,55,39,16,51480.2,21120,72600.2
522150,202308,117,79,38,104280.19,50160.84,154441.03
522155,202308,65,43,22,56760.9,29040,85800.9
522157,202308,17,10,7,13200,9240,22440
522160,202308,1768,1060,708,1400562.58,937208.17,2337770.75
522170,202308,370,255,115,336609.66,151800,488409.66
522180,202308,35,15,20,19800,26400,46200
522185,202308,2961,1344,1617,1775462.76,2137128.83,3912591.59
522190,202308,85,50,35,66000.17,46200,112200.17
522200,202308,350,203,147,267962.62,194040.24,462002.86
522205,202308,143,99,44,130684.34,58080.1,188764.44
522220,202308,141,111,30,146520.2,39600,186120.2
522230,202308,36,32,4,42240.41,5280,47520.41
530010,202308,63562,32581,30981,43037327.34,40939242.82,83976570.16
110001,202309,568,461,107,608526.96,141240,749766.96
110002,202309,3338,2158,1180,2848624.32,1560247.1,4408871.42
110003,202309,87,67,20,88440.82,26400,114840.82
110004,202309,2356,1633,723,2156923.16,955685.21,3112608.37
110005,202309,476,369,107,487085.37,141240.2,628325.57
110006,202309,483,351,132,463324.81,174240,637564.81
110007,202309,82,65,17,85800,22440,108240
110008,202309,308,178,130,234962.3,171600.6,406562.9
110009,202309,1041,814,227,1077127.25,299640,1376767.25
110010,202309,1837,1009,828,1331904.57,1094282.01,2426186.58
110011,202309,1814,1399,415,1846728.74,547808.05,2394536.79
110012,202309,4440,2550,1890,3367383,2498780.82,5866163.82
110013,202309,828,666,162,879144.57,213842.19,1092986.76
110014,202309,359,319,40,421087.18,52800,473887.18
110015,202309,1443,1096,347,1446737.79,459363.82,1906101.61
110018,202309,1105,702,403,926659.33,533280.33,1459939.66
110020,202309,18497,10353,8144,13670516.76,10768674.6,24439191.36
110025,202309,672,494,178,652084.73,236280.2,888364.93
110026,202309,36,25,11,33000.57,14520,47520.57
110028,202309,1742,1216,526,1606475.03,696965.92,2303440.95
110029,202309,129,119,10,157082.33,13200,170282.33
110030,202309,2610,1675,935,2210826.83,1235525.5,3446352.33
110032,202309,376,293,83,386771.09,109563.28,496334.37
110033,202309,737,529,208,698307.1,274566.28,972873.38
110034,202309,345,267,78,352441.94,102960,455401.94
110037,202309,101,84,17,110881.1,22440,133321.1
110040,202309,458,319,139,421082.5,183480,604562.5
110045,202309,1065,775,290,1023029.96,382801.77,1405831.73
110050,202309,93,84,9,110881.17,11880,122761.17
110060,202309,71,52,19,68640.92,25080,93720.92
110070,202309,122,84,38,110881.2,50160,161041.2
110080,202309,610,352,258,464645.76,340560.06,805205.82
110090,202309,27,21,6,27720,7920,35640
110092,202309,137,68,69,89761.11,91080,180841.11
110094,202309,252,179,73,236281.98,96360,332641.98
110100,202309,61,46,15,60720.28,19800.06,80520.34
110110,202309,129,76,53,100321.72,69960,170281.72
110120,202309,78,67,11,88442.18,14520,102962.18
110130,202309,272,222,50,294365.73,66000.1,360365.83
110140,202309,291,207,84,273242.38,110880.1,384122.48
110143,202309,59,48,11,63360,14520,77880
110145,202309,51,37,14,48840,18480,67320
110146,202309,32,13,19,17160.2,25080,42240.2
110147,202309,47,28,19,36960.51,25080.58,62041.09
110148,202309,37,29,8,38280.28,10560,48840.28
110149,202309,331,233,98,307561.29,129360,436921.29
110150,202309,150,120,30,159721.1,39600,199321.1
110155,202309,14,13,1,17160,1320,18480
110160,202309,76,58,18,76561.21,23760,100321.21
110170,202309,227,173,54,228363.76,71280,299643.76
110175,202309,70,56,14,73920,18480,92400
110180,202309,91,71,20,93721.66,26400,120121.66
120001,202309,259,190,69,250810.06,91080.53,341890.59
120005,202309,253,146,107,192723.33,143880,336603.33
120010,202309,1253,763,490,1007215.9,646801.97,1654017.87
120013,202309,196,132,64,174242.76,84480.1,258722.86
120017,202309,157,97,60,128041.2,79200.88,207242.08
120020,202309,3609,2903,706,3834688.17,931929.95,4766618.12
120025,202309,630,340,290,448842.8,382816.93,831659.73
120030,202309,1283,1110,173,1465262.66,228368.45,1693631.11
120032,202309,45,40,5,52800,6600,59400
120033,202309,239,206,33,271928.15,43560.55,315488.70
120034,202309,206,154,52,203281.34,68640,271921.34
120035,202309,63,56,7,73920.1,9240,83160.1
120038,202309,443,292,151,385451.19,199321.75,584772.94
120039,202309,37,34,3,44881.1,3960,48841.1
120040,202309,16063,10778,5285,14232386.39,6977817.48,21210203.87
120042,202309,58,53,5,69962.6,6600.55,76563.15
120043,202309,19,5,14,6600,18480,25080
120045,202309,605,383,222,505578.24,293043.31,798621.55
120050,202309,1397,1056,341,1395305.82,450130.69,1845436.51
120060,202309,1601,1335,266,1762827.31,351126.64,2113953.95
120070,202309,467,344,123,454093.97,162360.42,616454.39
120080,202309,220,148,72,195365.68,95040.55,290406.23
130002,202309,172,125,47,165000.95,62040,227040.95
130006,202309,116,79,37,104280,48840,153120
130008,202309,134,81,53,106920.73,69960,176880.73
130010,202309,181,115,66,151800.2,87120.85,238921.05
130014,202309,333,234,99,309212.96,130681.47,439894.43
130020,202309,163,114,49,151800.9,64680,216480.9
130030,202309,1058,594,464,784087.47,612481.94,1396569.41
130040,202309,433,228,205,300962.85,271920,572882.85
130050,202309,591,314,277,414496.8,366969.76,781466.56
130060,202309,920,621,299,819722.61,394680.7,1214403.31
130063,202309,664,432,232,570240.1,306240,876480.1
130068,202309,243,151,92,199321.49,122760.44,322081.93
130070,202309,1459,971,488,1284386.24,644166.4,1928552.64
130080,202309,741,510,231,673206.91,304923.48,978130.39
130083,202309,98,65,33,85800.96,43560,129360.96
130090,202309,364,228,136,300961.06,179520,480481.06
130100,202309,1461,786,675,1037531.04,893648.57,1931179.61
130110,202309,892,400,492,528004.03,650760.68,1178764.71
130115,202309,170,87,83,114840,109560.7,224400.7
130120,202309,1813,1128,685,1488976.29,905521.49,2394497.78
130130,202309,700,482,218,636241.56,287760.95,924002.51
130140,202309,1600,1248,352,1647369.66,464640.96,2112010.62
130150,202309,465,419,46,553082.13,60720,613802.13
130160,202309,481,305,176,402601.4,233640,636241.4
130165,202309,152,134,18,176880,23760,200640
130170,202309,1373,942,431,1244712.74,570252.63,1814965.37
130180,202309,308,245,63,323402.04,83160.1,406562.14
130185,202309,2408,1209,1199,1595919.81,1584016.7,3179936.51
130190,202309,3576,2254,1322,2975363.7,1745055.96,4720419.66
130195,202309,310,248,62,327360,81840,409200
130200,202309,234,152,82,200641.76,108240,308881.76
130210,202309,97,43,54,56760,71280,128040
130220,202309,225,173,52,228360.57,68640,297000.57
130230,202309,365,248,117,327360,154440,481800
130240,202309,1473,1003,470,1323969.86,620402.02,1944371.88
130250,202309,5254,3428,1826,4527693.79,2411667.33,6939361.12
130255,202309,461,241,220,318120.52,290400.87,608521.39
130260,202309,73291,34086,39205,45020481.84,51790014.74,96810496.58
130270,202309,1566,1086,480,1433649.75,633602.3,2067252.05
130280,202309,149,89,60,117480,80520,198000
130290,202309,2175,1387,788,1832195.31,1040166,2872361.31
130300,202309,436,296,140,390721.5,184802.19,575523.69
130310,202309,990,561,429,740523.57,566280.5,1306804.07
130320,202309,586,324,262,427681.1,345840,773521.1
130330,202309,803,541,262,714125.76,345840.84,1059966.60
130340,202309,3753,2045,1708,2700808.14,2255906.93,4956715.07
130350,202309,491,355,136,468600,179520,648120
130353,202309,1059,516,543,681138.03,718089.96,1399227.99
130356,202309,936,438,498,578165.38,658683.35,1236848.73
130360,202309,112,87,25,114840.2,33000,147840.2
130370,202309,698,558,140,736562.01,184800,921362.01
130380,202309,694,539,155,711484.62,204600.06,916084.68
130390,202309,504,415,89,547800,117480,665280
130395,202309,174,69,105,91080.5,138600,229680.5
130400,202309,102,76,26,100321.39,34320,134641.39
130406,202309,2356,1350,1006,1782019,1327923.75,3109942.75
130410,202309,504,289,215,381480,283800,665280
130420,202309,2989,2430,559,3209012.21,737883.24,3946895.45
130423,202309,220,143,77,188761.48,101640,290401.48
130426,202309,198,112,86,147840,114840,262680
130430,202309,454,269,185,355084.92,244200,599284.92
130440,202309,211,77,134,101644.47,176881.93,278526.40
140002,202309,65,20,45,26400.2,59400.6,85800.8
140005,202309,260,150,110,198004.54,145201.4,343205.94
140010,202309,15089,8169,6920,10787598.63,9137203.6,19924802.23
140015,202309,385,82,303,108242.58,399961.82,508204.40
140017,202309,174,95,79,125407.92,104282.82,229690.74
140020,202309,509,337,172,446173.7,227044.55,673218.25
140023,202309,98,56,42,73920,55440.28,129360.28
140028,202309,33,16,17,21120.77,22440.61,43561.38
140030,202309,463,291,172,384134.03,228361.31,612495.34
140040,202309,89,57,32,75240.6,42240,117480.6
140045,202309,520,125,395,165001.77,521402.39,686404.16
140047,202309,711,450,261,594013.96,345841.81,939855.77
140050,202309,173,108,65,142563.7,85801.39,228365.09
140060,202309,108,76,32,101641.91,42240.2,143882.11
140070,202309,27,25,2,33000.2,2640,35640.2
150010,202309,5741,3465,2276,4575236.43,3004349.97,7579586.40
150013,202309,195,128,67,168960.99,88440.99,257401.98
150020,202309,1243,707,536,934575.7,708841.76,1643417.46
150030,202309,762,361,401,476535.59,529323.01,1005858.60
150034,202309,234,134,100,176881.49,132000.5,308881.99
150040,202309,1922,1136,786,1499583.21,1037547.29,2537130.50
150050,202309,840,505,335,666605.34,443521.19,1110126.53
150060,202309,5532,3426,2106,4522323.96,2780501.57,7302825.53
150070,202309,256,197,59,260047.8,77880.59,337928.39
150080,202309,20631,9656,10975,12754399.11,14493902.62,27248301.73
150085,202309,567,342,225,451451.84,297003.93,748455.77
150090,202309,860,683,177,901582.9,233642.41,1135225.31
150095,202309,106,73,33,96361.3,43561,139922.3
150100,202309,89,54,35,71280,46201.25,117481.25
150110,202309,229,142,87,187441.2,114840.1,302281.3
150120,202309,423,304,119,401289.77,157080.7,558370.47
150125,202309,45,21,24,27720,31680,59400
150130,202309,2836,1384,1452,1826946.44,1916876.1,3743822.54
150140,202309,68549,29304,39245,38696057.65,51829459.07,90525516.72
150145,202309,309,171,138,225723.35,183480.12,409203.47
150150,202309,4114,1815,2299,2395863.84,3037360.46,5433224.30
150157,202309,402,288,114,380171.51,150480.83,530652.34
150160,202309,196,144,52,190081.57,68640,258721.57
150170,202309,4634,3306,1328,4365344.97,1752977.13,6118322.10
150172,202309,433,308,125,406565.55,166321.2,572886.75
150175,202309,94,53,41,69961,54120.7,124081.7
150178,202309,881,594,287,784104.59,378846.98,1162951.57
150180,202309,4786,2309,2477,3047945.27,3270970.65,6318915.92
150190,202309,451,307,144,405250.42,190083.57,595333.99
150195,202309,155,87,68,114840.2,89760.61,204600.81
150200,202309,222,123,99,162360.08,130680.2,293040.28
150210,202309,3518,2697,821,3560176.53,1083733.93,4643910.46
150215,202309,811,466,345,615143.11,456730.06,1071873.17
150220,202309,3881,2557,1324,3377977.24,1749030.23,5127007.47
150230,202309,1613,1281,332,1690963.93,438248.25,2129212.18
150240,202309,8462,4663,3799,6158024.42,5018731.33,11176755.75
150250,202309,98,57,41,75241.52,54120.92,129362.44
150260,202309,156,108,48,142563.22,63360.8,205924.02
150270,202309,2306,1494,812,1972116.49,1073163.83,3045280.32
150275,202309,617,404,213,533293.68,281160.83,814454.51
150276,202309,131,46,85,60720.2,112201.74,172921.94
150277,202309,963,419,544,553092.51,718095.88,1271188.39
150280,202309,194,189,5,249489.2,6600,256089.2
150285,202309,197,113,84,149161.8,110668.8,259830.6
150290,202309,1449,828,621,1092985.54,819728.45,1912713.99
150293,202309,977,450,527,594017.84,695649.39,1289667.23
150295,202309,662,326,336,430336.5,443521.19,873857.69
150300,202309,122,68,54,89760.1,71280,161040.1
150304,202309,239,146,93,192724.41,122763.67,315488.08
150307,202309,490,403,87,531973.02,114840.5,646813.52
150309,202309,668,472,196,623069.11,258723.6,881792.71
150310,202309,329,225,104,297004.95,137280,434284.95
150320,202309,2104,1454,650,1920633.23,859327.18,2779960.41
150330,202309,2354,1349,1005,1782021.09,1327925.36,3109946.45
150340,202309,218,134,84,176882.05,110880.42,287762.47
150345,202309,724,405,319,534609.07,421080,955689.07
150350,202309,470,375,95,495027.97,125403.85,620431.82
150360,202309,5788,3378,2410,4461701.84,3189152.03,7650853.87
150370,202309,939,623,316,822392.13,417126.56,1239518.69
150375,202309,216,87,129,114840.68,170280.68,285121.36
150380,202309,1668,1116,552,1473152.75,728645.35,2201798.10
150390,202309,1038,611,427,807878.65,563645.54,1371524.19
150400,202309,135,115,20,151800.4,26400,178200.4
150405,202309,1833,1164,669,1536506.11,884402.7,2420908.81
150410,202309,108,68,40,89760.77,52800.2,142560.97
150420,202309,8820,4754,4066,6278409.96,5369876.9,11648286.86
150430,202309,745,456,289,601962.79,382807.93,984770.72
150440,202309,520,316,204,417132.84,269282.47,686415.31
150442,202309,2755,1475,1280,1947066.24,1692266.32,3639332.56
150445,202309,609,402,207,530646.23,274560.2,805206.43
150450,202309,70,48,22,63361.23,29040.1,92401.33
150460,202309,759,573,186,756388.73,245522.16,1001910.89
150470,202309,1392,845,547,1115436.96,722045.01,1837481.97
150475,202309,288,216,72,285129.14,95043.09,380172.23
150480,202309,1630,1155,475,1524669.37,627009.19,2151678.56
150490,202309,654,408,246,538563.56,324720.62,863284.18
150495,202309,403,307,96,405241.07,126720,531961.07
150497,202309,313,203,110,267962.46,145200.1,413162.56
150500,202309,308,182,126,240242.13,166320,406562.13
150503,202309,1624,813,811,1073186.57,1070531.42,2143717.99
150506,202309,999,692,307,913457.76,405241.12,1318698.88
150510,202309,1532,870,662,1148428.41,875166.19,2023594.60
150520,202309,350,234,116,308880.93,153120.5,462001.43
150530,202309,2307,1363,944,1799283.9,1246138.52,3045422.42
150540,202309,260,185,75,244201.67,99000.25,343201.92
150543,202309,1032,525,507,694337.65,671887.3,1366224.95
150548,202309,492,346,146,456724.57,192720.9,649445.47
150549,202309,101,69,32,91082.35,42240.26,133322.61
150550,202309,3621,1840,1781,2430190.83,2352262.24,4782453.07
150553,202309,4399,2466,1933,3256572.17,2552912.79,5809484.96
150555,202309,153,86,67,113520.2,88441.8,201962.0
150560,202309,99,47,52,62040.75,68640,130680.75
150563,202309,155,83,72,109565.47,95041.46,204606.93
150565,202309,242,146,96,192721.61,126720.82,319442.43
150570,202309,462,307,155,405241.28,204600,609841.28
150580,202309,1926,1003,923,1325290.96,1218361.19,2543652.15
150590,202309,931,625,306,825027.23,403922,1228949.23
150600,202309,574,377,197,497654.72,260045.32,757700.04
150610,202309,215,160,55,211202.23,72600,283802.23
150611,202309,181,126,55,166320,72600,238920
150613,202309,3870,2147,1723,2836762.78,2274478.62,5111241.40
150616,202309,660,354,306,467287.13,405243.2,872530.33
150618,202309,1564,802,762,1058649.23,1005841.89,2064491.12
150619,202309,464,352,112,464645.71,147845.03,612490.74
150620,202309,1442,821,621,1083749.23,819724.98,1903474.21
150630,202309,212,139,73,183490.45,96361,279851.45
150635,202309,547,258,289,340568.24,381484.33,722052.57
150640,202309,56,27,29,35641.68,38280,73921.68
150650,202309,2706,1547,1159,2042128.3,1529916.97,3572045.27
150655,202309,307,217,90,286441.18,118800,405241.18
150658,202309,66,43,23,56760,30360,87120
150660,202309,721,442,279,583450.38,368283.93,951734.31
150670,202309,1293,484,809,640211.13,1067887.83,1708098.96
150680,202309,12898,6860,6038,9059554.05,7975587.68,17035141.73
150690,202309,50,25,25,33001.17,33000,66001.17
150700,202309,640,428,212,566302.59,281165.3,847467.89
150710,202309,342,201,141,265326.6,186120.61,451447.21
150715,202309,911,576,335,760337.25,442202.97,1202540.22
150720,202309,487,368,119,485770.36,157081.07,642851.43
150730,202309,1390,674,716,889699.79,947768.84,1837468.63
150740,202309,300,190,110,250800.62,145200,396000.62
150745,202309,911,521,390,689061.84,514806.53,1203868.37
150746,202309,84,41,43,54121.02,56760,110881.02
150747,202309,298,203,95,267964.79,125400.3,393365.09
150750,202309,164,90,74,118804.64,97683.71,216488.35
150760,202309,2097,1371,726,1809758.18,958326.91,2768085.09
150770,202309,436,262,174,345842.31,229680.2,575522.51
150775,202309,104,58,46,76560.48,60720.1,137280.58
150780,202309,244,145,99,191401.92,130680,322081.92
150790,202309,783,468,315,617772.13,415803.33,1033575.46
150795,202309,1965,1208,757,1594589.08,999250.09,2593839.17
150796,202309,334,189,145,249481.61,191401.33,440882.94
150797,202309,480,233,247,307570.16,326041.09,633611.25
150800,202309,1852,1019,833,1345097.99,1099562.81,2444660.80
150803,202309,391,300,91,396013.05,120120.37,516133.42
150805,202309,245,150,95,198001.85,125400,323401.85
150808,202309,1241,602,639,794647.67,846123.59,1640771.26
150810,202309,3506,2354,1152,3107368.42,1521968.29,4629336.71
150812,202309,600,314,286,414487.28,377521.97,792009.25
150815,202309,1422,886,536,1169533.68,708842.55,1878376.23
150820,202309,1959,1155,804,1524655.11,1062616.1,2587271.21
150830,202309,632,475,157,627015.52,207241.1,834256.62
150835,202309,279,174,105,229682.47,138600,368282.47
150840,202309,1619,919,700,1213115.57,924011.41,2137126.98
160005,202309,75,50,25,66000.83,33000.12,99000.95
160010,202309,236,143,93,188765.75,122760.47,311526.22
160015,202309,189,127,62,167651.66,81841.51,249493.17
160020,202309,168,84,84,110881.75,110880,221761.75
160021,202309,70,38,32,50161.77,42240.81,92402.58
160023,202309,84,57,27,75243.07,36960.14,112203.21
160025,202309,36,18,18,23761.78,23760.12,47521.90
160027,202309,1638,916,722,1209179.29,954366.83,2163546.12
160030,202309,20030,10530,9500,13906769.89,12549439.9,26456209.79
160040,202309,427,274,153,361693.55,201962.04,563655.59
160050,202309,919,388,531,512175.69,700931.77,1213107.46
160053,202309,342,209,133,275890.42,176882.88,452773.30
160055,202309,30,22,8,29041.27,10560.8,39602.07
160060,202309,7667,4283,3384,5653826.88,4466973.87,10120800.75
160070,202309,212,124,88,163683.39,116160.8,279844.19
160080,202309,165,88,77,116160.76,101640,217800.76
170025,202309,25,16,9,21120,11880.2,33000.2
170030,202309,176,142,34,187446.96,44880,232326.96
170035,202309,212,106,106,139925.25,139921.86,279847.11
170040,202309,188,140,48,184800.2,63360,248160.2
170070,202309,347,227,120,299648.12,158400.54,458048.66
170100,202309,372,267,105,353770.1,138600.2,492370.3
170105,202309,41,35,6,46200.15,7920,54120.15
170110,202309,115,72,43,95040.49,58081.06,153121.55
170130,202309,93,48,45,63360,59400,122760
170190,202309,107,62,45,81840,59400,141240
170200,202309,374,255,119,336602.16,157080,493682.16
170210,202309,7502,4197,3305,5541198.81,4365281.44,9906480.25
170215,202309,172,106,66,139923.48,87122.73,227046.21
170220,202309,1401,1000,401,1320026.87,529324.85,1849351.72
170230,202309,160,110,50,145203.81,66000.3,211204.11
170240,202309,513,358,155,472583.75,204602.72,677186.47
170255,202309,1059,815,244,1078459.93,323402.84,1401862.77
170270,202309,56,40,16,52800,21120,73920
170290,202309,159,100,59,132002.77,77880,209882.77
170300,202309,122,83,39,109560.21,51480,161040.21
170305,202309,64,46,18,60720.8,23760,84480.8
170307,202309,57,43,14,56761.26,18480.9,75242.16
170310,202309,132,88,44,116161.71,58080,174241.71
170320,202309,49,32,17,42240.2,22440,64680.2
170330,202309,40,29,11,38281.58,14520.1,52801.68
170360,202309,40,26,14,34320.24,18480.75,52800.99
170370,202309,84,51,33,67321.29,43560.2,110881.49
170380,202309,96,72,24,95041.34,31680,126721.34
170382,202309,42,35,7,46200,9240,55440
170384,202309,160,123,37,162360,48840.44,211200.44
170386,202309,79,36,43,47520.61,56760,104280.61
170388,202309,47,24,23,31680.96,30360,62040.96
170389,202309,29,22,7,29040.4,9240,38280.4
170390,202309,93,54,39,71280.77,51480.14,122760.91
170410,202309,26,23,3,30362.04,3960,34322.04
170460,202309,13,8,5,10560.91,6600,17160.91
170510,202309,36,27,9,35643.04,11880,47523.04
170550,202309,1759,1052,707,1389992.97,934570.73,2324563.70
170555,202309,124,91,33,120124.43,43560,163684.43
170560,202309,102,77,25,101640.42,33000.33,134640.75
170600,202309,44,18,26,23761.36,34320.7,58082.06
170610,202309,206,118,88,155763.92,117480.1,273244.02
170625,202309,36,22,14,29040.99,18480,47520.99
170650,202309,108,77,31,101640.35,40920.2,142560.55
170700,202309,646,477,169,629648.58,223080,852728.58
170710,202309,145,88,57,116163.48,75241.97,191405.45
170720,202309,123,95,28,125400.81,36960,162360.81
170730,202309,122,72,50,96361.76,66000,162361.76
170740,202309,96,71,25,93720.2,33000,126720.2
170755,202309,51,31,20,40920.89,26400.76,67321.65
170765,202309,139,84,55,110883.71,72600.6,183484.31
170770,202309,202,135,67,178201.69,88440.73,266642.42
170820,202309,640,427,213,564969.78,281160.32,846130.10
170825,202309,59,31,28,42240.3,36960,79200.3
170830,202309,100,77,23,101640.79,30360.33,132001.12
170900,202309,183,142,41,187443.18,54120.62,241563.80
170930,202309,1118,630,488,832946.01,644165.63,1477111.64
170950,202309,3661,1811,1850,2394057.66,2444659.56,4838717.22
170980,202309,16,11,5,14521.56,6600,21121.56
171050,202309,165,125,40,166320,52800.22,219120.22
171070,202309,63,50,13,66000.88,17160.95,83161.83
171090,202309,54,42,12,55440,15840,71280
171110,202309,28,22,6,29040.44,7920,36960.44
171150,202309,50,35,15,46200,19800,66000
171180,202309,30,16,14,21120,18481.12,39601.12
171190,202309,213,121,92,159723.04,122760,282483.04
171195,202309,64,54,10,71281.07,13200,84481.07
171200,202309,29,13,16,17160.51,21120,38280.51
171215,202309,13,10,3,13200,3960,17160
171240,202309,64,51,13,67320,17160,84480
171245,202309,58,49,9,64681.96,11880,76561.96
171250,202309,86,52,34,68640.2,46200,114840.2
171270,202309,15,9,6,11880,7920.22,19800.22
171280,202309,51,41,10,54121.32,13200.1,67321.42
171320,202309,1161,691,470,912132.12,620401.57,1532533.69
171330,202309,481,255,226,336602.3,298320.21,634922.51
171360,202309,114,82,32,108240.15,42240,150480.15
171370,202309,39,24,15,31680,19800.18,51480.18
171380,202309,140,120,20,158401.42,26400,184801.42
171395,202309,45,28,17,36960,22440,59400
171420,202309,279,184,95,242881.39,125400.2,368281.59
171430,202309,78,64,14,84480.2,18480.95,102961.15
171488,202309,239,141,98,186120.14,129360,315480.14
171500,202309,70,42,28,55440.2,36960.2,92400.4
171510,202309,82,57,25,75240,33000.52,108240.52
171515,202309,43,36,7,47522.22,9240,56762.22
171525,202309,28,24,4,31682.05,5280,36962.05
171550,202309,17,11,6,14520.9,7920,22440.9
171570,202309,64,34,30,44880,39600.1,84480.1
171575,202309,264,179,85,240240.67,112200,352440.67
171610,202309,2211,1156,1055,1528064.15,1392623.52,2920687.67
171620,202309,168,123,45,162360.9,59400.61,221761.51
171630,202309,53,30,23,39600,30360,69960
171650,202309,372,265,107,349812.59,141242.45,491055.04
171660,202309,274,159,115,211207.2,151800.7,363007.9
171665,202309,95,60,35,79201.17,46200.33,125401.50
171670,202309,476,307,169,406566.58,223082.68,629649.26
171700,202309,64,53,11,69960.95,14520,84480.95
171720,202309,29,11,18,14520.7,23760.2,38280.9
171750,202309,111,57,54,75240,71280.7,146520.7
171780,202309,83,65,18,85800.33,23760,109560.33
171790,202309,107,86,21,113520,27720,141240
171800,202309,35,27,8,35640,10560,46200
171820,202309,2303,1349,954,1780727.6,1259286.3,3040013.9
171830,202309,36,28,8,36960.2,10560,47520.2
171840,202309,55,36,19,47520.3,25080,72600.3
171845,202309,37,27,10,35640.78,13200,48840.78
171850,202309,56,44,12,58080.44,15840.46,73920.90
171855,202309,70,51,19,67320.1,25080,92400.1
171865,202309,5,3,2,3960,2640,6600
171870,202309,43,30,13,39600.2,17160.45,56760.65
171875,202309,98,75,23,99000,30360,129360
171880,202309,48,30,18,39600,23760.04,63360.04
171884,202309,58,33,25,43560.53,34320,77880.53
171886,202309,145,71,74,93721.07,99000,192721.07
171888,202309,28,21,7,27721.32,9240.1,36961.42
171889,202309,17,9,8,11880,10560,22440
171890,202309,67,56,11,73920.11,14520,88440.11
171900,202309,26,17,9,22440.2,11880,34320.2
172000,202309,37,33,4,43560.2,5280.2,48840.4
172010,202309,62,43,19,56760,25080.62,81840.62
172015,202309,21,16,5,21121.52,6600,27721.52
172020,202309,129,79,50,105601.09,66000,171601.09
172025,202309,43,28,15,36960.46,19800,56760.46
172030,202309,64,40,24,52800.95,31680,84480.95
172049,202309,92,62,30,81841.02,39600.2,121441.22
172065,202309,119,80,39,105602.6,51480.46,157083.06
172080,202309,139,86,53,113521.11,69961.42,183482.53
172085,202309,33,17,16,22440,21120,43560
172090,202309,495,354,141,467289.35,186120.94,653410.29
172093,202309,19,17,2,22440,2640,25080
172097,202309,18,10,8,13200,10560,23760
172100,202309,7017,4168,2849,5502567.27,3760724.74,9263292.01
172110,202309,85,60,25,79201.01,33000,112201.01
172120,202309,1842,1524,318,2011756.14,419765.43,2431521.57
172125,202309,17,12,5,16764,6600,23364
172130,202309,33,21,12,27720.59,15840,43560.59
172208,202309,216,140,76,186120,100321.38,286441.38
172210,202309,370,189,181,249487.21,238921.19,488408.40
210005,202309,3266,2096,1170,2768150.71,1548385.47,4316536.18
210010,202309,149,103,46,135961.4,60720,196681.4
210015,202309,46,33,13,43561.06,17160,60721.06
210020,202309,407,249,158,328688.37,208562.49,537250.86
210030,202309,330,225,105,297028.06,138605.17,435633.23
210040,202309,120,100,20,132000.1,26400,158400.1
210043,202309,281,233,48,307563.61,63360,370923.61
210047,202309,510,334,176,440881.69,232320,673201.69
210050,202309,286,199,87,262680,114840.2,377520.2
210055,202309,63,52,11,68640.91,14520,83160.91
210060,202309,551,449,102,592709.2,134642.62,727351.82
210070,202309,504,390,114,514800.7,150480.32,665281.02
210080,202309,151,141,10,186121.4,13200,199321.4
210083,202309,300,160,140,211200.77,184800.19,396000.96
210087,202309,11,6,5,7920,6600,14520
210090,202309,527,385,142,508222.85,188762.55,696985.40
210095,202309,432,350,82,462009.09,108241.69,570250.78
210100,202309,734,590,144,778814.15,191400.2,970214.35
210110,202309,121,84,37,110881.69,48840.9,159722.59
210120,202309,4863,3954,909,5222158.6,1199895.6,6422054.2
210125,202309,200,128,72,168963.01,95040.66,264003.67
210130,202309,465,294,171,388091.75,225720.89,613812.64
210135,202309,34,25,9,33001.39,11880,44881.39
210140,202309,4857,3686,1171,4866988.43,1547061.66,6414050.09
210150,202309,394,263,131,347171.48,172922.93,520094.41
210160,202309,3349,2859,490,3773973.02,646806.14,4420779.16
210170,202309,1346,1088,258,1436213.23,340561.73,1776774.96
210173,202309,131,121,10,159721.48,13200,172921.48
210177,202309,293,169,124,223081.85,163680,386761.85
210180,202309,33,18,15,23760.2,19800,43560.2
210190,202309,482,334,148,440880.5,195360.7,636241.2
210193,202309,9,7,2,9240.59,2640,11880.59
210197,202309,67,48,19,63360.3,25080.2,88440.5
210200,202309,640,547,93,722069.55,122760.59,844830.14
210203,202309,241,176,65,232324.15,87121.12,319445.27
210207,202309,326,281,45,370925.55,59400,430325.55
210210,202309,739,690,49,910812.05,64680.6,975492.65
210215,202309,83,74,9,97682.98,11880,109562.98
210220,202309,361,312,49,411857,64680.39,476537.39
210230,202309,345,282,63,372245.74,83160,455405.74
210232,202309,1241,912,329,1203871.87,434281.57,1638153.44
210235,202309,192,146,46,192724.22,60720.4,253444.62
210237,202309,61,32,29,42242.63,38280,80522.63
210240,202309,81,71,10,93720.7,13200.21,106920.91
210250,202309,198,173,25,228360.77,33000.2,261360.97
210255,202309,416,307,109,405255.56,143881.38,549136.94
210260,202309,406,296,110,390722.72,145200,535922.72
210270,202309,645,472,173,623050.78,228361.66,851412.44
210275,202309,118,94,24,124080.13,31680,155760.13
210280,202309,1137,757,380,999256.88,501602.66,1500859.54
210290,202309,552,375,177,495011.48,233641.39,728652.87
210300,202309,5025,3313,1712,4373252.59,2261165.61,6634418.20
210310,202309,132,87,45,114840.2,59400,174240.2
210312,202309,123,93,30,122761.47,39600,162361.47
210315,202309,132,114,18,150480.97,23760,174240.97
210317,202309,155,122,33,161040.27,43560,204600.27
210320,202309,2550,2207,343,2914643.37,452761.04,3367404.41
210325,202309,164,98,66,129360.95,87120.67,216481.62
210330,202309,4205,2533,1672,3344945.9,2208363.05,5553308.95
210340,202309,1237,961,276,1268572.35,364322.74,1632895.09
210350,202309,718,602,116,794654.9,153120.2,947775.1
210355,202309,161,138,23,182160.44,30360,212520.44
210360,202309,2071,1532,539,2023611.43,711482.87,2735094.30
210370,202309,1273,690,583,910816.98,769564.58,1680381.56
210375,202309,202,103,99,135969.97,130681.46,266651.43
210380,202309,759,601,158,793329.86,208560.97,1001890.83
210390,202309,200,168,32,221762.88,42240,264002.88
210400,202309,443,394,49,520093.83,64680,584773.83
210405,202309,1178,832,346,1098268.16,456721.53,1554989.69
210407,202309,75,63,12,83160,15840,99000
210408,202309,51,47,4,62041.73,5280,67321.73
210409,202309,360,316,44,417123.86,58080.96,475204.82
210410,202309,462,372,90,491041.95,118800,609841.95
210420,202309,216,174,42,229682.04,55440.32,285122.36
210430,202309,65,49,16,64680.5,21120,85800.5
210440,202309,378,260,118,343209.95,155760,498969.95
210450,202309,112,99,13,130682.37,17160,147842.37
210455,202309,257,140,117,184806.39,154443.2,339249.59
210460,202309,325,225,100,297007.62,132000.25,429007.87
210462,202309,80,67,13,88441.64,17160,105601.64
210465,202309,127,103,24,135960.91,31680,167640.91
210467,202309,598,454,144,599295.17,190080.5,789375.67
210470,202309,42,37,5,48840,6600,55440
210480,202309,1424,1046,378,1380760.6,500283.96,1881044.56
210490,202309,180,129,51,170282.28,67320,237602.28
210500,202309,517,345,172,455419.01,227041.75,682460.76
210510,202309,542,443,99,584762.85,130681.71,715444.56
210515,202309,329,225,104,297003.55,137280.2,434283.75
210520,202309,405,370,35,488408.28,46200.93,534609.21
210530,202309,10373,5282,5091,6973887.5,6722978.04,13696865.54
210535,202309,126,100,26,132001.55,34320,166321.55
210540,202309,1645,1146,499,1512767.77,658685.15,2171452.92
210542,202309,1097,575,522,760340.71,690370.57,1450711.28
210545,202309,24,21,3,27720.71,3960,31680.71
210547,202309,127,114,13,150482.47,18480.31,168962.78
210550,202309,616,442,174,583463.9,229681.01,813144.91
210560,202309,168,148,20,195362.05,26400.33,221762.38
210565,202309,29,21,8,27721.62,10560.25,38281.87
210570,202309,1329,1134,195,1496916.21,257401.34,1754317.55
210580,202309,132,115,17,151800.78,22440.16,174240.94
210590,202309,674,571,103,753722.81,135960,889682.81
210592,202309,49,45,4,59400,5280,64680
210594,202309,118,103,15,135961.1,19800,155761.1
210596,202309,121,108,13,142561.28,17160,159721.28
210598,202309,139,107,32,141240.9,42240.2,183481.1
210600,202309,308,268,40,353769.39,52800,406569.39
210610,202309,261,242,19,319446.56,25080.54,344527.10
210620,202309,48,33,15,43560.74,19800,63360.74
210630,202309,93,87,6,114841.4,7920,122761.4
210632,202309,997,722,275,953043.61,363000,1316043.61
210635,202309,29,25,4,33000.9,5280.2,38281.1
210637,202309,114,85,29,112200.2,38280,150480.2
210640,202309,577,518,59,683764.34,79200,762964.34
210650,202309,421,358,63,472568.31,83160.7,555729.01
210660,202309,401,321,80,423742.3,105601.9,529344.2
210663,202309,88,71,17,93720.17,22440,116160.17
210667,202309,88,48,40,63361.52,52800.99,116162.51
210670,202309,274,241,33,318125.87,43560,361685.87
210675,202309,495,304,191,401289.57,252122.23,653411.80
210680,202309,241,160,81,211202.52,106920,318122.52
210690,202309,114,101,13,133320.85,17160,150480.85
210700,202309,153,117,36,154440.4,47520.2,201960.6
210710,202309,269,167,102,220441.23,134640.6,355081.83
210720,202309,136,123,13,162360.08,17160,179520.08
210725,202309,69,58,11,76565.1,14520,91085.1
210730,202309,23,16,7,21120,9240,30360
210735,202309,296,219,77,289081.7,101640,390721.7
210740,202309,521,457,64,603266.16,84480,687746.16
210745,202309,172,135,37,178200.33,48840,227040.33
210750,202309,2955,1656,1299,2185978.62,1716014.81,3901993.43
210760,202309,265,212,53,281161.84,69960.19,351122.03
210770,202309,249,207,42,273258.76,55442.24,328701.00
210780,202309,426,323,103,426373.78,135961.29,562335.07
210790,202309,202,172,30,227043.87,39600,266643.87
210800,202309,189,146,43,192731.1,58080.55,250811.65
210805,202309,73,64,9,84480,11880,96360
210810,202309,442,371,71,489737.83,93720,583457.83
210820,202309,1996,1702,294,2246719.95,388084.18,2634804.13
210825,202309,158,101,57,133321.36,75240.2,208561.56
210830,202309,720,519,201,685087.65,265320.6,950408.25
210840,202309,207,156,51,205920.4,67320,273240.4
210845,202309,235,184,51,242883.32,67320,310203.32
210850,202309,723,531,192,700946.81,253442.31,954389.12
210860,202309,3513,2195,1318,2897456.82,1739767.5,4637224.32
210870,202309,405,322,83,425056.13,109560.2,534616.33
210880,202309,96,80,16,105602.46,21120,126722.46
210890,202309,328,291,37,384134.26,48840,432974.26
210900,202309,742,480,262,633618.7,347163.92,980782.62
210905,202309,75,42,33,55440.2,43560,99000.2
210910,202309,2138,1619,519,2137137.01,685088.61,2822225.62
210920,202309,142,68,74,89761.73,97680,187441.73
210923,202309,77,62,15,81841.43,19800,101641.43
210927,202309,417,223,194,294362.77,256080.2,550442.97
210930,202309,94,83,11,109560.4,14520,124080.4
210940,202309,83,66,17,87121.51,22440,109561.51
210945,202309,216,132,84,174243.42,110880,285123.42
210950,202309,524,390,134,514805.96,176880.65,691686.61
210955,202309,111,70,41,92401.08,54120.9,146521.98
210960,202309,2551,1346,1205,1776734.57,1590603.09,3367337.66
210970,202309,112,94,18,124081.56,23760.9,147842.46
210975,202309,76,73,3,96360.51,3960.36,100320.87
210980,202309,1061,554,507,731300.1,669242.67,1400542.77
210990,202309,4586,3303,1283,4360075.05,1694898.94,6054973.99
211000,202309,1360,1120,240,1478444.4,316803.15,1795247.55
211003,202309,967,727,240,959653.64,316800.56,1276454.20
211010,202309,501,451,50,595326.98,66000.59,661327.57
211020,202309,1379,667,712,880461.87,939857.11,1820318.98
211023,202309,43,37,6,48841.2,7920,56761.2
211027,202309,89,69,20,91080.54,26400,117480.54
211030,202309,374,271,103,357722.01,135960.5,493682.51
211040,202309,309,264,45,348482.44,59400,407882.44
211050,202309,1182,834,348,1100912.01,459361.99,1560274.00
211060,202309,644,572,72,755070.99,95040.4,850111.39
211065,202309,27,22,5,29042.69,6600.3,35642.99
211070,202309,842,711,131,938564.46,172921.57,1111486.03
211080,202309,89,87,2,114840.75,2640,117480.75
211085,202309,70,39,31,51480,40920,92400
211090,202309,100,87,13,114844.88,17160,132004.88
211100,202309,474,404,70,533294.33,92400.96,625695.29
211102,202309,232,173,59,228360.4,77880,306240.4
211105,202309,228,170,58,224400.73,76560.26,300960.99
211107,202309,132,87,45,114840,59400,174240
211110,202309,1019,697,322,920064.91,425043.83,1345108.74
211120,202309,5521,3087,2434,4075045.57,3212918.25,7287963.82
211125,202309,28,21,7,27720,9240,36960
211130,202309,44044,22016,22028,29071611.36,29090539.59,58162150.95
211140,202309,371,333,38,439575.4,50160.47,489735.87
211150,202309,1253,917,336,1210479.89,443523.7,1654003.59
211153,202309,179,109,70,143880,92400,236280
211157,202309,69,57,12,75240,15840,91080
211160,202309,711,600,111,792012.27,147840.9,939853.17
211163,202309,3,2,1,2640,1320,3960
211167,202309,10,10,0,13200,,13200.0
211170,202309,427,327,100,431642.67,132001.35,563644.02
211172,202309,97,73,24,96360.99,31680,128040.99
211174,202309,30,17,13,22440,17161.43,39601.43
211176,202309,474,349,125,460686.75,165002.25,625689.00
211178,202309,98,68,30,89761.82,39600,129361.82
211180,202309,217,179,38,236281.75,50160,286441.75
211190,202309,73,66,7,87120,9240,96360
211195,202309,49,37,12,48843.86,15840,64683.86
211200,202309,155,128,27,168960.76,35640,204600.76
211210,202309,404,306,98,403929.3,129360.41,533289.71
211220,202309,4645,2825,1820,3729186.9,2402610.67,6131797.57
211223,202309,150,138,12,182164.61,15840,198004.61
211227,202309,64,48,16,63360.2,21120,84480.2
211230,202309,736,609,127,803915.23,167642.52,971557.75
211240,202309,392,330,62,435604.19,81840,517444.19
211245,202309,191,105,86,138602.64,113520.2,252122.84
211250,202309,1492,1283,209,1693637.57,275883.39,1969520.96
211260,202309,832,716,116,945127.32,153120,1098247.32
211270,202309,1852,1556,296,2053963.58,390721.63,2444685.21
211280,202309,1850,1310,540,1729231.18,712801.68,2442032.86
211285,202309,233,151,82,199320.83,108240,307560.83
211290,202309,833,602,231,794645.77,304920.34,1099566.11
211300,202309,787,644,143,850100.9,188761.16,1038862.06
211400,202309,1601,1073,528,1416394.81,696962.25,2113357.06
220005,202309,20,18,2,23760,2640,26400
220010,202309,84,71,13,93720.87,17160,110880.87
220020,202309,782,640,142,844813.97,187441.29,1032255.26
220025,202309,114,109,5,143881.04,6600,150481.04
220027,202309,66,51,15,67320.2,19800.2,87120.4
220030,202309,143,117,26,154440.69,34320,188760.69
220040,202309,1383,1071,312,1415066.79,414482.94,1829549.73
220045,202309,30,22,8,29042.3,10560.4,39602.7
220050,202309,689,583,106,769501.17,139920.94,909422.11
220060,202309,193,170,23,224406.49,30360.35,254766.84
220070,202309,113,100,13,132002.3,17160.7,149163.0
220080,202309,15,13,2,17160.22,2640,19800.22
220090,202309,45,32,13,42240.5,17160,59400.5
220095,202309,4,3,1,3960,1320,5280
220100,202309,27,22,5,29040.71,6600,35640.71
220105,202309,35,31,4,40920.95,5280,46200.95
220110,202309,275,249,26,328682.12,34320,363002.12
220115,202309,53,45,8,59400,10560,69960
220117,202309,24,23,1,30360,1320,31680
220120,202309,1598,1266,332,1671147.81,440880.2,2112028.01
220130,202309,31,30,1,39600.78,1320,40920.78
220140,202309,88,74,14,97681.1,18480.96,116162.06
220150,202309,510,387,123,510863.22,165003.67,675866.89
220155,202309,30,29,1,38280.93,1320,39600.93
220157,202309,25,21,4,27721.49,5280,33001.49
220160,202309,115,103,12,135961.14,15840,151801.14
220170,202309,54,42,12,55440,15840,71280
220173,202309,22,19,3,25080,3960,29040
220177,202309,23,23,0,30360.4,,30360.4
220180,202309,69,66,3,87121.17,3960,91081.17
220190,202309,1267,1091,176,1440147.4,232324.46,1672471.86
220191,202309,42,38,4,50161.11,5280,55441.11
220192,202309,95,87,8,114841.64,10560,125401.64
220194,202309,60,53,7,69960.65,9240,79200.65
220196,202309,85,71,14,93724.75,18480.2,112204.95
220198,202309,3,3,0,3960,,3960.0
220200,202309,426,367,59,484463.98,77880.84,562344.82
220202,202309,37,33,4,43561.17,5280,48841.17
220205,202309,71,63,8,83160.2,10560,93720.2
220207,202309,16,16,0,21120.92,,21120.92
220208,202309,74,49,25,64680.27,33000.93,97681.20
220209,202309,38,33,5,43560,6600,50160
220210,202309,33,28,5,36960,6600,43560
220211,202309,38,36,2,47523.98,2640,50163.98
220213,202309,42,39,3,51481,3960,55441
220217,202309,44,35,9,46200.3,11880,58080.3
220220,202309,2534,1700,834,2244038.68,1100890.59,3344929.27
220225,202309,12,7,5,9240.58,6600,15840.58
220230,202309,1049,789,260,1041500.86,343206.09,1384706.95
220240,202309,168,150,18,198001.24,23760.31,221761.55
220245,202309,58,54,4,71281.4,5280,76561.4
220250,202309,160,134,26,176884.65,34320,211204.65
220253,202309,58,52,6,68640.25,7920,76560.25
220255,202309,59,51,8,67320.2,10560,77880.2
220260,202309,741,569,172,751095.32,227040.95,978136.27
220265,202309,21,18,3,23760,3960,27720
220270,202309,918,827,91,1091653.69,120120,1211773.69
220271,202309,43,34,9,44881.48,11880,56761.48
220272,202309,20,20,0,26400.7,,26400.7
220273,202309,20,17,3,22440.4,3960,26400.4
220275,202309,69,60,9,79200,11880,91080
220277,202309,34,26,8,34320.63,10560.94,44881.57
220280,202309,26,19,7,25080,9240,34320
220285,202309,48,44,4,58080.94,5280,63360.94
220290,202309,1637,1409,228,1859856.68,300963.16,2160819.84
220300,202309,50,48,2,63361.94,2640,66001.94
220310,202309,371,314,57,414496.24,75242.45,489738.69
220320,202309,495,449,46,592704.69,60721.68,653426.37
220323,202309,3,1,2,1320.8,2640,3960.8
220325,202309,12,10,2,13200,2640,15840
220327,202309,19,19,0,25080.24,,25080.24
220330,202309,226,163,63,215160.56,83160,298320.56
220335,202309,139,118,21,155761.95,27720,183481.95
220340,202309,62,50,12,66000.21,15840,81840.21
220342,202309,55,48,7,63363.96,9240,72603.96
220345,202309,96,86,10,113520.21,13200.03,126720.24
220350,202309,482,421,61,555724.61,80520.05,636244.66
220360,202309,54,35,19,46200,25080,71280
220370,202309,1446,1211,235,1598552.43,310200.4,1908752.83
220375,202309,23,22,1,29041.42,1320,30361.42
220380,202309,29,22,7,29041.4,9240,38281.4
220385,202309,19,17,2,22440,2640.66,25080.66
220390,202309,2601,1448,1153,1911425.9,1521982.83,3433408.73
220400,202309,37,32,5,42240,6600,48840
220410,202309,24,23,1,30360.2,1320,31680.2
220415,202309,13,12,1,15841.16,1320,17161.16
220420,202309,141,120,21,158400.78,27720,186120.78
220430,202309,165,142,23,187444.39,30360.2,217804.59
220435,202309,29,22,7,29040.72,9240,38280.72
220440,202309,311,267,44,352455.17,58080,410535.17
220450,202309,380,195,185,257407.39,244206.12,501613.51
220455,202309,55,53,2,69960.59,2640,72600.59
220460,202309,21,20,1,26401.76,1320.27,27722.03
220465,202309,70,50,20,66001.67,26400.41,92402.08
220470,202309,251,222,29,293046.56,38280.86,331327.42
220480,202309,66,61,5,80520.36,6600,87120.36
220490,202309,89,76,13,100320,17160,117480
220500,202309,134,111,23,146521.37,30360,176881.37
220510,202309,373,291,82,384131.86,108240.88,492372.74
220515,202309,32,29,3,38281.29,3960,42241.29
220520,202309,406,357,49,472570.36,64681.06,537251.42
220525,202309,12,7,5,9240.46,6600.92,15841.38
220527,202309,13,13,0,17160.38,,17160.38
220530,202309,51,25,26,33000,34320.87,67320.87
220535,202309,4,4,0,5280.74,,5280.74
220540,202309,125,108,17,142561.49,22440.2,165001.69
220545,202309,26,18,8,23761,10560.8,34321.8
220550,202309,802,637,165,840866.69,217801.51,1058668.20
220551,202309,15,12,3,15840,3960,19800
220552,202309,17,16,1,21120,1320,22440
220553,202309,67,63,4,83160.85,5280,88440.85
220554,202309,5,3,2,3960.73,2640,6600.73
220555,202309,58,45,13,59402.56,17160,76562.56
220556,202309,43,39,4,51481.04,5280,56761.04
220557,202309,68,63,5,83162.04,6600,89762.04
220558,202309,17,9,8,11880,10560.54,22440.54
220559,202309,8,8,0,10560.07,,10560.07
220560,202309,91,60,31,79201.48,40920,120121.48
220570,202309,750,474,276,625690.74,364322.87,990013.61
220580,202309,574,528,46,696997.83,60721.33,757719.16
220585,202309,14,11,3,14520.2,3960.37,18480.57
220590,202309,21,19,2,25081.68,2640,27721.68
220595,202309,81,63,18,83160.33,23760,106920.33
220600,202309,23,17,6,22440,7920,30360
220605,202309,38,34,4,44880.2,5280,50160.2
220610,202309,103,87,16,114840,21120,135960
220620,202309,581,502,79,662653.35,104282.78,766936.13
220630,202309,4,3,1,3960,1320,5280
220635,202309,37,33,4,43562.23,5280,48842.23
220640,202309,117,99,18,130680,23760,154440
220650,202309,120,114,6,150481.65,7920,158401.65
220660,202309,101,76,25,100321.85,33000.6,133322.45
220665,202309,17,17,0,22440,,22440.0
220667,202309,31,29,2,38280.01,2640,40920.01
220669,202309,48,42,6,55440.2,7920,63360.2
220670,202309,81,63,18,83160.9,23760,106920.9
220672,202309,88,63,25,83165.18,33001.21,116166.39
220675,202309,30,24,6,31682.23,7920,39602.23
220680,202309,67,58,9,76560.2,11880,88440.2
220690,202309,51,48,3,63360.51,3960,67320.51
220695,202309,31,19,12,25080.95,15840,40920.95
220700,202309,2002,1560,442,2060548.52,583444.25,2643992.77
220710,202309,12,10,2,13200.2,2640.7,15840.9
220720,202309,116,102,14,134640,18480,153120
220730,202309,36,35,1,46200.01,1320,47520.01
220735,202309,12,10,2,13200,2640,15840
220740,202309,70,61,9,80521.19,11880.91,92402.10
220750,202309,147,122,25,161042.64,33000.18,194042.82
220755,202309,24,23,1,30361.92,1320,31681.92
220760,202309,78,68,10,89761.69,13200,102961.69
220770,202309,6506,3801,2705,5020197.7,3571997.94,8592195.64
220775,202309,15,11,4,14520.7,5280.39,19801.09
220777,202309,27,26,1,34320,1320,35640
220779,202309,7,3,4,3960,5280,9240
220780,202309,994,841,153,1110131.94,201960.69,1312092.63
220785,202309,7,4,3,5280,3960.2,9240.2
220790,202309,1332,1075,257,1419033.43,339247.37,1758280.80
220793,202309,11,8,3,10560,3960,14520
220795,202309,29,27,2,35640.84,2640,38280.84
220800,202309,4302,3285,1017,4339171.28,1346412.85,5685584.13
220810,202309,91,78,13,102960.95,17160,120120.95
220820,202309,271,240,31,316809.18,40921.8,357730.98
220830,202309,1412,1255,157,1659056.1,208561,1867617.1
220840,202309,2763,1959,804,2587274.26,1061300.59,3648574.85
220850,202309,89,76,13,100320,17160,117480
220855,202309,9,4,5,5280,6600,11880
220860,202309,17,14,3,18482.44,3960,22442.44
220865,202309,30,27,3,35640.1,3960,39600.1
220870,202309,104,94,10,124081.6,13200,137281.6
220880,202309,359,296,63,390732.09,83161.92,473894.01
220885,202309,33,31,2,40923.59,2640,43563.59
220887,202309,6,5,1,6600.2,1320,7920.2
220890,202309,87,74,13,97681.33,17160,114841.33
220900,202309,31,19,12,25080,15840,40920
220910,202309,53,40,13,52802.68,17160,69962.68
220915,202309,11,9,2,11880,2640,14520
220920,202309,51,45,6,59400.93,7920,67320.93
220930,202309,62,60,2,79200.08,2640,81840.08
220935,202309,17,17,0,22440.97,,22440.97
220937,202309,37,34,3,44880.67,3960,48840.67
220940,202309,68,61,7,80520,9240,89760
220945,202309,6,6,0,7920.16,,7920.16
220950,202309,40,32,8,42240.2,10560,52800.2
220955,202309,25,23,2,30360.41,2640,33000.41
220960,202309,47,40,7,52800,9240,62040
220965,202309,60,55,5,72600,6600,79200
220970,202309,64,54,10,71280,13200,84480
220975,202309,16,13,3,17160.9,3960,21120.9
220980,202309,28,26,2,34320.76,2640,36960.76
220985,202309,60,51,9,67320,11880,79200
220987,202309,36,35,1,46202.81,1320.28,47523.09
220990,202309,27,25,2,33000,2992,35992
220995,202309,20,18,2,23760,2640,26400
220997,202309,77,69,8,91082.65,10560,101642.65
221000,202309,1396,1235,161,1630242.67,212520.86,1842763.53
221005,202309,54,50,4,66000,5280.82,71280.82
221010,202309,32,23,9,30360,11880,42240
221020,202309,52,46,6,60720.11,7920,68640.11
221030,202309,48,39,9,51376.43,11880,63256.43
221035,202309,22,21,1,27722.35,1320,29042.35
221037,202309,14,11,3,14520,3960,18480
221038,202309,26,23,3,30360,3960,34320
221039,202309,28,28,0,36960.04,,36960.04
221040,202309,280,237,43,312846.22,56761.4,369607.62
221050,202309,253,211,42,278530.58,55440.2,333970.78
221060,202309,2137,1834,303,2420927.86,399965.01,2820892.87
221062,202309,33,33,0,43561.61,,43561.61
221063,202309,21,16,5,21120,6600,27720
221065,202309,83,67,16,88442.58,21120,109562.58
221070,202309,176,156,20,205924.73,26400,232324.73
221080,202309,450,380,70,501614.67,92400,594014.67
221090,202309,31,24,7,31681.74,9240,40921.74
221093,202309,63,46,17,60721.2,22440.45,83161.65
221095,202309,5,5,0,6600,,6600.0
221097,202309,12,10,2,13200,2640,15840
221100,202309,29810,17905,11905,23642229.94,15732057.24,39374287.18
221110,202309,1246,973,273,1285720.3,360368.11,1646088.41
221120,202309,634,455,179,600613.97,236280.39,836894.36
221130,202309,1084,874,210,1153697.41,277203.53,1430900.94
221135,202309,41,37,4,48841.09,5280,54121.09
221140,202309,49,43,6,56760.2,7920,64680.2
221150,202309,15,12,3,15840.18,3960,19800.18
221160,202309,19,17,2,22441.39,2640,25081.39
221170,202309,23,22,1,29040,1320,30360
230010,202309,171,148,23,195361.6,30360,225721.6
230015,202309,189,159,30,209881.33,39600,249481.33
230020,202309,2032,1609,423,2123929.75,558371.66,2682301.41
230030,202309,1785,1313,472,1733217.33,623046.41,2356263.74
230040,202309,266,213,53,281160.92,69960,351120.92
230050,202309,262,181,81,238921.19,106920.13,345841.32
230060,202309,184,144,40,190080.69,52800.94,242881.63
230070,202309,345,291,54,384123.72,71280,455403.72
230075,202309,1028,844,184,1114110.49,242885.18,1356995.67
230080,202309,257,209,48,275882.62,63360,339242.62
230090,202309,210,155,55,204600.89,72600,277200.89
230100,202309,3081,1734,1347,2292926.74,1780699.26,4073626.00
230110,202309,3345,2111,1234,2786587.96,1630215.92,4416803.88
230120,202309,1354,1034,320,1364908.32,422404.05,1787312.37
230125,202309,200,158,42,208560.83,55440.44,264001.27
230130,202309,555,477,78,629646.8,102960.2,732607.0
230140,202309,249,204,45,269281.05,59400,328681.05
230150,202309,160,123,37,162361.98,48840.51,211202.49
230160,202309,1056,856,200,1129926.49,264001.6,1393928.09
230170,202309,704,596,108,786740.02,142563.72,929303.74
230180,202309,75,68,7,89760.39,9240,99000.39
230185,202309,473,407,66,537249.04,87121.14,624370.18
230190,202309,2805,2100,705,2772072.32,931929.02,3704001.34
230195,202309,580,493,87,650780.06,114840,765620.06
230200,202309,507,391,116,516126.26,153120.2,669246.46
230205,202309,453,299,154,394681.17,203280.2,597961.37
230210,202309,1565,1188,377,1568187.12,497641.25,2065828.37
230220,202309,1788,1179,609,1557636.2,803887,2361523.2
230230,202309,1113,887,226,1170869.03,298323.87,1469192.90
230240,202309,2403,2116,287,2793169.31,380164.04,3173333.35
230250,202309,2065,1669,396,2204473.26,522729.9,2727203.16
230260,202309,3672,2290,1382,3022833.04,1824245.43,4847078.47
230270,202309,1515,1159,356,1531219.8,469924.6,2001144.4
230280,202309,3206,2462,744,3249933.05,982089.37,4232022.42
230290,202309,380,330,50,435612.26,66000.71,501612.97
230300,202309,565,417,148,550443.93,195360.1,745804.03
230310,202309,472,362,110,477840.32,145200.91,623041.23
230320,202309,1038,857,181,1132582.18,238921.58,1371503.76
230330,202309,364,294,70,388083.5,92400,480483.5
230340,202309,503,402,101,530649.19,133320.4,663969.59
230350,202309,3812,2316,1496,3057209.28,1977376.52,5034585.80
230360,202309,298,243,55,320765.05,72600.39,393365.44
230365,202309,163,130,33,171601.43,43560,215161.43
230370,202309,13242,6678,6564,8820651.74,8669981,17490632.74
230380,202309,574,488,86,644175.5,113523.23,757698.73
230390,202309,582,341,241,450123.25,318120,768243.25
230393,202309,267,217,50,286441.34,66000.5,352441.84
230395,202309,412,327,85,431663.38,112204.01,543867.39
230400,202309,750,597,153,788047.37,201960.2,990007.57
230410,202309,3245,2079,1166,2745669.18,1541778.45,4287447.63
230420,202309,7311,4802,2509,6338905.71,3317252.27,9656157.98
230423,202309,383,330,53,435603.56,71280,506883.56
230425,202309,586,467,119,616449.93,157081.24,773531.17
230426,202309,133,108,25,142560.7,33000,175560.7
230427,202309,80,70,10,92400.96,13200,105600.96
230428,202309,2024,974,1050,1285713.66,1388654.21,2674367.87
230430,202309,513,415,98,549129.81,129362.1,678491.91
230435,202309,1046,753,293,993982.84,386761.4,1380744.24
230440,202309,112481,52099,60382,68806740.06,79759673.83,148566413.89
230445,202309,359,242,117,319448.48,155760,475208.48
230450,202309,652,503,149,663963.54,196680.7,860644.24
230460,202309,121,87,34,114840.26,44880,159720.26
230465,202309,349,283,66,373563.88,87120,460683.88
230470,202309,2276,1791,485,2364145.86,641522.4,3005668.26
230480,202309,167,148,19,195360.5,25081.37,220441.87
230490,202309,369,288,81,380163.36,106920.13,487083.49
230495,202309,548,391,157,516131.3,207242.71,723374.01
230500,202309,1314,985,329,1301531.38,434283.49,1735814.87
230510,202309,86,59,27,77880.39,35640,113520.39
230520,202309,462,343,119,452764.7,157080.62,609845.32
230523,202309,3021,1845,1176,2436795.41,1556295.64,3993091.05
230526,202309,273,227,46,299641.12,60720,360361.12
230530,202309,775,545,230,719410.27,303602.73,1023013.00
230533,202309,248,224,24,295683.58,31680.2,327363.78
230535,202309,463,338,125,446172.79,165002.17,611174.96
230540,202309,1969,1750,219,2310054.48,289083.26,2599137.74
230550,202309,4751,3018,1733,3989228.13,2288921.75,6278149.88
230560,202309,646,496,150,656050.04,198000.57,854050.61
230565,202309,255,188,67,248161.31,88441.14,336602.45
230570,202309,349,296,53,390721.97,69960.45,460682.42
230580,202309,1371,932,439,1230254.88,579484.77,1809739.65
230590,202309,1242,954,288,1259189.82,380162.04,1639351.86
230600,202309,336,301,35,397328.45,46200,443528.45
230610,202309,541,400,141,528011.81,186120.2,714132.01
230620,202309,190,159,31,209881.94,40920,250801.94
230625,202309,982,661,321,872537.37,423721.07,1296258.44
230630,202309,1673,1234,439,1628914.38,579484.13,2208398.51
230640,202309,4518,3608,910,4768007.33,1202543.69,5970551.02
230650,202309,567,481,86,634924.52,113521.33,748445.85
230655,202309,859,667,192,880472.25,254763.56,1135235.81
230660,202309,441,361,80,476523.91,105600.2,582124.11
230670,202309,535,423,112,558380.79,147841.69,706222.48
230680,202309,255,212,43,279846.67,56760,336606.67
230690,202309,1072,896,176,1182751.64,233641.88,1416393.52
230700,202309,1179,972,207,1283068.15,273241.68,1556309.83
230710,202309,739,672,67,887066.35,88441,975507.35
230720,202309,161,137,24,180840,31680.7,212520.7
230725,202309,337,253,84,333963.4,110880.97,444844.37
230730,202309,14711,7763,6948,10249069.23,9182060.07,19431129.30
230740,202309,796,642,154,847461.87,203281.1,1050742.97
230750,202309,922,759,163,1001901.42,216480.77,1218382.19
230760,202309,1850,1552,298,2048712.36,393361.72,2442074.08
230763,202309,429,361,68,476523.83,89760,566283.83
230765,202309,10314,4992,5322,6591138.13,7030526.81,13621664.94
230770,202309,5928,3115,2813,4111944.92,3718469.15,7830414.07
230780,202309,899,765,134,1009811.06,176880.1,1186691.16
230790,202309,357,288,69,380160.12,91080.41,471240.53
230800,202309,1376,970,406,1280421.84,535921.97,1816343.81
230810,202309,1571,1348,223,1779436.28,295683.91,2075120.19
230820,202309,421,272,149,359043.52,196681.27,555724.79
230830,202309,1060,884,176,1166898.69,232320.9,1399219.59
230835,202309,309,255,54,336605.12,71280.68,407885.80
230837,202309,209,167,42,220441.87,56760,277201.87
230840,202309,1095,813,282,1073168.99,372240.78,1445409.77
230850,202309,1531,1276,255,1684360.54,336604.26,2020964.80
230860,202309,384,306,78,403923.27,102966.6,506889.87
230870,202309,2058,1725,333,2277039.94,439560.47,2716600.41
230880,202309,93,72,21,95040,27720,122760
230890,202309,645,565,80,745806.26,105601.2,851407.46
230900,202309,353,263,90,347161.96,118800.24,465962.20
230910,202309,253,195,58,257403.09,76560,333963.09
230920,202309,574,445,129,587408.7,170280,757688.7
230930,202309,1289,907,382,1197268.44,504240.91,1701509.35
230940,202309,968,744,224,982098.64,295680.73,1277779.37
230945,202309,653,513,140,678500.97,184804.56,863305.53
230950,202309,494,425,69,562340.64,91080.5,653421.14
230960,202309,3214,2168,1046,2861887.37,1380750.97,4242638.34
230970,202309,2195,1212,983,1601214.93,1297576.33,2898791.26
230980,202309,260,187,73,246842.59,96360,343202.59
230990,202309,162,126,36,166320.5,47520,213840.5
231000,202309,235,216,19,285122.08,25080,310202.08
231010,202309,212,144,68,190082.58,89760,279842.58
231020,202309,1685,1106,579,1461297.77,764293.73,2225591.50
231025,202309,1287,883,404,1165599.11,533291.11,1698890.22
231030,202309,1182,951,231,1255333.69,307562.48,1562896.17
231040,202309,206,148,58,195363.26,76560,271923.26
231050,202309,1045,889,156,1173500.74,205926.94,1379427.68
231060,202309,179,142,37,187443.36,48840.9,236284.26
231070,202309,1730,1189,541,1570833.86,716765.94,2287599.80
231080,202309,295,255,40,336607.82,52800,389407.82
231085,202309,811,505,306,667939.07,403920.26,1071859.33
231090,202309,302,245,57,323403.83,75241.64,398645.47
231095,202309,174,129,45,170280,59400.22,229680.22
231100,202309,221,178,43,234961.6,56760,291721.6
231110,202309,414,343,71,452769.11,93722.21,546491.32
231120,202309,292,236,56,311524.73,73920.52,385445.25
231123,202309,159,151,8,199323.09,10560,209883.09
231126,202309,381,298,83,393361.53,109560,502921.53
231130,202309,5695,4463,1232,5891386.87,1627585.43,7518972.30
231135,202309,248,216,32,285121.97,42241.41,327363.38
231140,202309,3457,2492,965,3289529.42,1275134.5,4564663.92
231150,202309,441,406,35,537252.22,46201.12,583453.34
231160,202309,1392,1137,255,1500864.01,336601.56,1837465.57
231170,202309,606,416,190,549123.67,250800,799923.67
231180,202309,2231,1922,309,2537118.89,407885.87,2945004.76
231190,202309,269,213,56,281160.95,73920,355080.95
231195,202309,266,213,53,281162.68,69960.15,351122.83
231200,202309,986,785,201,1036224.25,265322.78,1301547.03
231210,202309,576,477,99,629648.81,130681.39,760330.20
231220,202309,1220,851,369,1123344.11,487084.45,1610428.56
231230,202309,1780,1307,473,1725266.13,624361.27,2349627.40
231240,202309,1904,1269,635,1675121.35,838208.8,2513330.15
231250,202309,96,89,7,117480.2,9240,126720.2
231260,202309,287,195,92,257401.72,121442.02,378843.74
231270,202309,1078,819,259,1081106.29,343201.34,1424307.63
231280,202309,95,72,23,95041.49,30360.8,125402.29
231290,202309,9212,5145,4067,6795628.09,5371173.35,12166801.44
231300,202309,663,593,70,782768.3,92400,875168.3
231310,202309,957,874,83,1153695.02,109560.83,1263255.85
231320,202309,731,539,192,711486.53,253441.98,964928.51
231325,202309,115,98,17,129360.18,22440.54,151800.72
231330,202309,2180,1648,532,2176739.97,702248.29,2878988.26
231335,202309,275,242,33,319446.35,43560,363006.35
231340,202309,2270,1540,730,2034167.86,963607.58,2997775.44
231350,202309,1669,1288,381,1700219.38,502934.88,2203154.26
231355,202309,462,380,82,501607.93,108241.24,609849.17
231360,202309,680,457,223,603254.95,294361.94,897616.89
231370,202309,103,89,14,117480,19800,137280
231375,202309,319,242,77,319445.35,101640.1,421085.45
231380,202309,599,472,127,623044.54,167640,790684.54
231390,202309,234,176,58,232321.37,76560,308881.37
231395,202309,874,516,358,681124.38,472560.55,1153684.93
231400,202309,1395,1163,232,1536507.26,306244.58,1842751.84
231410,202309,1627,1312,315,1733190.78,415802.95,2148993.73
240010,202309,438,204,234,269289.31,308889.41,578178.72
240020,202309,2585,2126,459,2807754.03,607210.05,3414964.08
240030,202309,126,97,29,128041.36,38280,166321.36
240040,202309,41,39,2,51480,2640,54120
240050,202309,577,492,85,649473.62,112200.1,761673.72
240060,202309,94,81,13,106921.41,17160,124081.41
240070,202309,326,244,82,322085.09,108240.2,430325.29
240080,202309,656,438,218,579503.46,289087.02,868590.48
240090,202309,116,102,14,134640.32,18480,153120.32
240100,202309,1711,1598,113,2109427.51,149162.42,2258589.93
240110,202309,1189,815,374,1075877.98,493702.21,1569580.19
240120,202309,173,130,43,171601.6,56760.75,228362.35
240130,202309,291,262,29,345855.02,38280.7,384135.72
240140,202309,101,63,38,83161.09,50160.64,133321.73
240145,202309,823,722,101,953074.62,133320.7,1086395.32
240150,202309,31,22,9,29040,11880,40920
240160,202309,39,33,6,43560,7920,51480
240165,202309,41,33,8,43563.75,10560.1,54123.85
240170,202309,182,128,54,168961.48,71280,240241.48
240180,202309,143,103,40,135961.87,52800,188761.87
240185,202309,61,51,10,67320.16,13200,80520.16
240190,202309,15,13,2,17160.43,2640,19800.43
240200,202309,3485,1850,1635,2442066.97,2159542.03,4601609.00
240210,202309,174,129,45,170280.73,59400,229680.73
240220,202309,1285,860,425,1135243.89,561005.87,1696249.76
240230,202309,909,811,98,1070565.21,129360.58,1199925.79
240240,202309,97,63,34,83160.2,44880.43,128040.63
240250,202309,114,97,17,128040.33,22440,150480.33
240260,202309,2166,1522,644,2010418.2,852731.35,2863149.55
240270,202309,188,156,32,205921,42240,248161
240280,202309,77,62,15,81840.2,19800.1,101640.3
240290,202309,47,45,2,59400,2640,62040
240300,202309,186,103,83,135961.67,109560,245521.67
240310,202309,2835,1538,1297,2030222.92,1713383.18,3743606.10
240320,202309,182,167,15,220440.07,19800,240240.07
240325,202309,5724,3174,2550,4192526.78,3370043.45,7562570.23
240330,202309,91,86,5,113520.23,6600,120120.23
240340,202309,128,96,32,126720,42240,168960
240350,202309,107,84,23,110880.2,30360,141240.2
240360,202309,929,602,327,794673.48,432966.65,1227640.13
240370,202309,70,59,11,77881.5,14521.65,92403.15
240375,202309,49,32,17,42240.96,22441.68,64682.64
240380,202309,239,194,45,256093.03,59400.5,315493.53
240390,202309,19,17,2,22440,2640,25080
240400,202309,93,82,11,108241.2,14520,122761.2
240410,202309,15,11,4,14520,5280,19800
240420,202309,1261,875,386,1155039.11,509527.73,1664566.84
240430,202309,281,250,31,331332.83,40920.2,372253.03
240440,202309,179,109,70,143883.9,92400.97,236284.87
240450,202309,301,182,119,240250.92,157082.77,397333.69
240460,202309,108,87,21,114841.12,27720,142561.12
240470,202309,244,220,24,290419.57,31680.4,322099.97
240480,202309,17,15,2,19800,2640,22440
240485,202309,93,78,15,102960.99,19800,122760.99
240490,202309,70,62,8,81841.67,10560,92401.67
240500,202309,116,92,24,121440,31680,153120
240510,202309,37,27,10,35640,13200,48840
240520,202309,99,93,6,122762.16,7920.61,130682.77
240530,202309,76,57,19,75240,25080,100320
240540,202309,107,90,17,118800.1,22440,141240.1
240550,202309,12,10,2,13200,2640,15840
240560,202309,442,298,144,393371.29,191400.5,584771.79
240570,202309,470,287,183,380168.19,242882.05,623050.24
240580,202309,1548,1105,443,1458639.33,584763.02,2043402.35
240590,202309,32,31,1,40921.12,1320,42241.12
240600,202309,109,102,7,134641.49,9240,143881.49
240610,202309,531,436,95,575544.42,125406.11,700950.53
240615,202309,10,10,0,13200.8,,13200.8
240620,202309,91,88,3,116161.09,3960,120121.09
240630,202309,53,44,9,58080.97,11880.29,69961.26
240640,202309,42,29,13,38280,17160,55440
240650,202309,270,210,60,277203.41,79200,356403.41
240660,202309,125,105,20,138600.77,26400,165000.77
240670,202309,340,192,148,253455.42,195368.7,448824.12
240680,202309,60,47,13,62040.67,17160,79200.67
240690,202309,55,52,3,68641.7,3960,72601.7
240700,202309,188,158,30,208560.6,39601.02,248161.62
240710,202309,2633,1569,1064,2071158.16,1404495.65,3475653.81
240720,202309,1154,791,363,1044155.12,479168.63,1523323.75
240725,202309,78,70,8,92401.34,10560.88,102962.22
240730,202309,158,130,28,171600.08,36960.9,208560.98
240740,202309,260,209,51,275890.4,67320.62,343211.02
240750,202309,59,35,24,46200,31680,77880
240760,202309,67,53,14,69960,18480,88440
240770,202309,167,128,39,168962.36,52800.94,221763.30
240780,202309,847,685,162,904225.49,215161.61,1119387.10
240790,202309,41,38,3,50162.35,3960,54122.35
240800,202309,10986,7369,3617,9731683.64,4778583.26,14510266.90
240810,202309,24989,13210,11779,17449951.93,15559165.22,33009117.15
240820,202309,311,189,122,249487.05,161042.86,410529.91
240830,202309,1746,1442,304,1903495.2,401285.78,2304780.98
240840,202309,86,73,13,96360,17160,113520
240850,202309,94,79,15,104280,19800,124080
240860,202309,119,114,5,150482.09,6600.85,157082.94
240870,202309,61,50,11,66002.7,14520,80522.7
240880,202309,37,31,6,40920,7920,48840
240890,202309,1353,758,595,1000596.45,785409.59,1786006.04
240895,202309,75,59,16,77880.2,21120.03,99000.23
240910,202309,199,163,36,215162.19,47520.2,262682.39
240920,202309,14,12,2,15841.6,2640,18481.6
240930,202309,458,407,51,537265.9,67321.49,604587.39
240933,202309,66,42,24,55440.95,31680,87120.95
240940,202309,2463,2143,320,2828840.57,422404.63,3251245.20
240950,202309,41,36,5,47520,6600,54120
240960,202309,26,22,4,29040.2,5280.3,34320.5
240970,202309,120,86,34,113520.96,44880,158400.96
240980,202309,226,179,47,236280.9,62040.8,298321.7
240990,202309,157,98,59,129361.43,77880,207241.43
241000,202309,62,56,6,73921.33,7920,81841.33
241010,202309,104,76,28,100320.59,36960,137280.59
241020,202309,119,110,9,145201.06,11880.82,157081.88
241025,202309,23,16,7,21121.18,9240.5,30361.68
241030,202309,129,99,30,130680,39600,170280
241040,202309,50,39,11,51480.1,14520,66000.1
241050,202309,80,74,6,97681.69,7920,105601.69
241060,202309,32,27,5,35640.78,6600,42240.78
241070,202309,25,25,0,33001.79,,33001.79
241080,202309,63,55,8,72600.2,10560,83160.2
241090,202309,69,57,12,75243.57,15840,91083.57
241100,202309,71,61,10,80522.38,13200.28,93722.66
241105,202309,34,22,12,29044,15840.64,44884.64
241110,202309,61,48,13,63360.15,17160,80520.15
241120,202309,1906,1422,484,1878402.55,638883.33,2517285.88
241140,202309,217,175,42,231003.91,55440,286443.91
241142,202309,54,40,14,52801.3,18480,71281.3
241150,202309,1275,1108,167,1462606.95,223082.25,1685689.20
241160,202309,31,21,10,27720,13200,40920
241170,202309,59,49,10,64680,13200,77880
241180,202309,52,38,14,50160,18480,68640
241190,202309,44,39,5,51481.56,6600,58081.56
241200,202309,5639,2925,2714,3862520.28,3586544.17,7449064.45
241210,202309,75,63,12,83160.1,15840,99000.1
241220,202309,1735,1083,652,1429621.28,860653.58,2290274.86
241230,202309,275,222,53,293045.01,69960.91,363005.92
241240,202309,58,44,14,58080.7,18480,76560.7
241250,202309,1229,1120,109,1478439.74,145203,1623642.74
241255,202309,82,66,16,87121.28,21120,108241.28
241260,202309,832,626,206,826339.51,271921.67,1098261.18
241270,202309,79,59,20,77881.23,26400,104281.23
241280,202309,105,92,13,121442.69,17160,138602.69
241290,202309,156,119,37,157083.68,48840,205923.68
241300,202309,91,58,33,76560.7,43560.98,120121.68
241310,202309,59,40,19,52801.8,25080.1,77881.9
241320,202309,45,25,20,33002.03,27720,60722.03
241330,202309,68,57,11,75241.01,14520,89761.01
241335,202309,116,104,12,137283.87,15840,153123.87
241340,202309,202,137,65,180840.81,85800,266640.81
241350,202309,68,57,11,75240.43,14520,89760.43
241355,202309,60,48,12,63362.14,15840,79202.14
241360,202309,65,60,5,79200.49,6600,85800.49
241370,202309,76,59,17,77880,22440,100320
241380,202309,37,33,4,43561.5,5280,48841.5
241390,202309,96,77,19,101640.66,25080,126720.66
241400,202309,252,185,67,246478.27,89761.96,336240.23
241410,202309,205,185,20,244200.54,26400.85,270601.39
241415,202309,115,91,24,120120.1,31680.8,151800.9
241420,202309,175,106,69,139922.06,91080,231002.06
241430,202309,22,18,4,23760,5280,29040
241440,202309,590,496,94,654748.42,125403.29,780151.71
241445,202309,52,44,8,58080.2,10560,68640.2
241450,202309,274,229,45,302290.49,59400.44,361690.93
241460,202309,194,177,17,234965.36,22441.08,257406.44
241470,202309,34,28,6,36960.8,7920,44880.8
241475,202309,54,50,4,66000,5280,71280
241480,202309,165,118,47,155762.06,63360.2,219122.26
241490,202309,17,15,2,19800.84,2640.1,22440.94
241500,202309,55,42,13,55442.33,17160.02,72602.35
250010,202309,111,94,17,124080.69,22440.66,146521.35
250020,202309,35,30,5,39600,6600,46200
250030,202309,972,728,244,963631.03,322083.71,1285714.74
250040,202309,438,347,91,458057.33,120121.12,578178.45
250050,202309,307,252,55,332642.35,72600.5,405242.85
250053,202309,70,58,12,76560.6,15840,92400.6
250057,202309,4,3,1,3960.2,1320,5280.2
250060,202309,666,482,184,636259.55,242881.48,879141.03
250070,202309,716,572,144,756380.11,190080.44,946460.55
250073,202309,13,10,3,13200.94,3960.01,17160.95
250077,202309,205,146,59,192722.22,77880.2,270602.42
250080,202309,425,337,88,444849.96,116160.38,561010.34
250090,202309,233,145,88,191401.03,116160,307561.03
250100,202309,653,515,138,679808.63,182161,861969.63
250110,202309,752,538,214,711496.67,283801.68,995298.35
250115,202309,17,7,10,9240.18,13200.26,22440.44
250120,202309,127,92,35,121441.42,46201.92,167643.34
250130,202309,610,506,104,667939.79,137281.26,805221.05
250135,202309,36,16,20,21120.59,27720,48840.59
250140,202309,101,85,16,112202.16,21120,133322.16
250150,202309,716,494,222,652090.56,293041.43,945131.99
250153,202309,20,16,4,21120.1,5280,26400.1
250157,202309,57,43,14,56760.42,18480,75240.42
250160,202309,271,205,66,270603.44,87120,357723.44
250170,202309,100,65,35,85800.2,46200,132000.2
250180,202309,5637,3933,1704,5193152.41,2250657.21,7443809.62
250190,202309,831,563,268,743169.67,353762.15,1096931.82
250200,202309,86,67,19,88441.08,25080.7,113521.78
250205,202309,26,19,7,25080.61,9240,34320.61
250210,202309,92,76,16,100321.32,21120,121441.32
250215,202309,115,72,43,95040.75,56760.25,151801.00
250220,202309,32,20,12,26400.41,15840,42240.41
250230,202309,82,70,12,92400.3,15840.2,108240.5
250240,202309,270,203,67,267964.47,88440.2,356404.67
250250,202309,458,388,70,512174.91,92400,604574.91
250260,202309,62,51,11,67320.1,14520,81840.1
250270,202309,82,59,23,77880.8,30360,108240.8
250280,202309,433,351,82,463324.51,108240,571564.51
250290,202309,122,108,14,142560,18480.88,161040.88
250300,202309,537,363,174,479172.41,229680.1,708852.51
250310,202309,65,58,7,76561.4,9240,85801.4
250320,202309,2265,1509,756,1993295.58,997941.55,2991237.13
250330,202309,126,107,19,141242.84,25080.1,166322.94
250340,202309,37,30,7,39600.94,9240,48840.94
250350,202309,223,148,75,195362.98,99000,294362.98
250355,202309,51,40,11,52800,14520.25,67320.25
250360,202309,198,163,35,215163.23,46200.67,261363.90
250370,202309,2607,1669,938,2203160.49,1238186.87,3441347.36
250375,202309,16,10,6,13200.36,7920.31,21120.67
250380,202309,60,50,10,66000.89,13200.29,79201.18
250390,202309,56,45,11,59401.3,14520,73921.3
250400,202309,19627,10254,9373,13538482.42,12381857.86,25920340.28
250403,202309,313,242,71,319442.52,93720,413162.52
250407,202309,72,57,15,75240.1,19800.85,95040.95
250410,202309,34,29,5,38280.31,6600.8,44881.11
250415,202309,57,37,20,48840,26400,75240
250420,202309,46,39,7,51480.3,9240,60720.3
250430,202309,1634,1427,207,1884017.86,274561.75,2158579.61
250435,202309,32,29,3,38281.36,3960,42241.36
250440,202309,699,576,123,760328.46,162361,922689.46
250450,202309,95,71,24,93721.35,31680,125401.35
250460,202309,562,365,197,481804.71,260042.04,741846.75
250470,202309,107,76,31,100321.5,40920,141241.5
250480,202309,370,290,80,382812.13,105600.98,488413.11
250485,202309,8,7,1,9240,1320,10560
250490,202309,264,208,56,274563.67,73921.39,348485.06
250500,202309,110,84,26,110880,34320,145200
250510,202309,933,737,196,972852.22,258720.7,1231572.92
250520,202309,179,123,56,162360,73920.7,236280.7
250523,202309,138,111,27,146520.74,35640.12,182160.86
250527,202309,131,90,41,118800.91,54120.2,172921.11
250530,202309,15,11,4,14520,5280,19800
250535,202309,31,24,7,31680,9240,40920
250540,202309,149,119,30,157080.87,39600,196680.87
250550,202309,79,76,3,100321.19,3960,104281.19
250560,202309,69,43,26,56761.11,34320.07,91081.18
250570,202309,171,139,32,183482.1,42240.7,225722.8
250580,202309,95,75,20,99085.2,26400,125485.2
250590,202309,23,16,7,21120,9240,30360
250600,202309,1771,1183,588,1561590.69,778804.69,2340395.38
250610,202309,161,128,33,168967.76,43560.22,212527.98
250620,202309,25,20,5,26400.81,6600,33000.81
250625,202309,77,59,18,77882.33,23760.08,101642.41
250630,202309,3351,2079,1272,2744611.49,1680381.87,4424993.36
250640,202309,212,170,42,224405.61,55440.85,279846.46
250650,202309,34,24,10,31680.1,13200,44880.1
250660,202309,68,48,20,63360,26400,89760
250670,202309,86,69,17,91080.99,22440,113520.99
250680,202309,469,374,95,493692.93,125400.59,619093.52
250690,202309,2406,1622,784,2143726.94,1034892.59,3178619.53
250700,202309,1031,858,173,1132577.31,228360.2,1360937.51
250710,202309,564,436,128,575554.62,168965.11,744519.73
250720,202309,136,101,35,133321.15,46200,179521.15
250730,202309,442,361,81,476527.81,108242.51,584770.32
250740,202309,78,71,7,93721.86,9240,102961.86
250750,202309,28449,16708,11741,22064646.59,15509031.21,37573677.80
250760,202309,132,103,29,135960.7,38281.17,174241.87
250770,202309,395,263,132,347169.07,174240.7,521409.77
250780,202309,86,57,29,75240.33,38280,113520.33
250790,202309,490,307,183,405245.95,241563.01,646808.96
250800,202309,162,145,17,191400,22440,213840
250810,202309,76,63,13,83160,17160,100320
250820,202309,163,134,29,176882.05,38280,215162.05
250830,202309,549,361,188,476535.39,248162.08,724697.47
250840,202309,66,55,11,72601.71,14520.2,87121.91
250850,202309,81,66,15,87120.2,19800,106920.2
250855,202309,17,14,3,18480.2,3960,22440.2
250860,202309,254,162,92,213841.37,121440,335281.37
250870,202309,38,34,4,44880,5280,50160
250880,202309,103,79,24,104280.79,31680,135960.79
250890,202309,3505,2555,950,3375324.22,1255334.67,4630658.89
250900,202309,80,66,14,87120.48,18480,105600.48
250905,202309,137,102,35,134641.67,46200,180841.67
250910,202309,1047,768,279,1015107.95,368284.93,1383392.88
250915,202309,126,85,41,112202.03,54121.23,166323.26
250920,202309,166,127,39,167640,51480.7,219120.7
250930,202309,212,120,92,158401.35,121441.1,279842.45
250933,202309,13,9,4,11880,5280.89,17160.89
250937,202309,21,19,2,25080,2640,27720
250939,202309,47,34,13,44880.5,17160,62040.5
250940,202309,149,108,41,142561.53,54120.78,196682.31
250950,202309,90,66,24,87122.77,31680,118802.77
250960,202309,91,53,38,69963.92,50160.3,120124.22
250970,202309,1417,1001,416,1321347.66,549124.51,1870472.17
250980,202309,102,69,33,91080.99,43560,134640.99
250990,202309,179,136,43,179520,56760,236280
251000,202309,93,77,16,101640,21120,122760
251010,202309,158,113,45,149160,59400,208560
251020,202309,102,86,16,113520.37,21120,134640.37
251030,202309,51,37,14,48840.84,18480,67320.84
251040,202309,83,60,23,79200,30360,109560
251050,202309,32,28,4,36960,5280,42240
251060,202309,53,41,12,54120.92,15840.64,69961.56
251065,202309,7,4,3,5280,3960,9240
251070,202309,19,17,2,22441.53,2640,25081.53
251080,202309,6147,2861,3286,3778001.78,4338919.86,8116921.64
251090,202309,208,172,36,227041.32,47520,274561.32
251100,202309,27,24,3,31681.23,3960,35641.23
251110,202309,74,48,26,63360,34320,97680
251120,202309,2153,1359,794,1793959.98,1048099.82,2842059.80
251130,202309,483,397,86,524171.16,113520.05,637691.21
251140,202309,677,449,228,592684.31,300962.13,893646.44
251150,202309,370,309,61,407884.21,80520,488404.21
251160,202309,101,84,17,110880.33,22440,133320.33
251170,202309,85,70,15,92400.26,19800,112200.26
251180,202309,320,188,132,249484.21,174241.76,423725.97
251190,202309,125,91,34,120125.75,44880.25,165006.00
251200,202309,355,272,83,359048.43,109560.44,468608.87
251203,202309,38,32,6,42240.69,7920,50160.69
251207,202309,93,74,19,97680.61,25080,122760.61
251210,202309,1721,1255,466,1657947.86,615125.73,2273073.59
251220,202309,52,41,11,54120.78,14520,68640.78
251230,202309,626,525,101,693011.88,133322.03,826333.91
251240,202309,128,88,40,116160.5,52800,168960.5
251250,202309,1788,1289,499,1701415.24,660008.15,2361423.39
251260,202309,13,9,4,13200.97,5280.19,18481.16
251270,202309,357,274,83,361686.65,109560.69,471247.34
251272,202309,66,58,8,76560.2,10560,87120.2
251274,202309,21,16,5,21120.25,6600,27720.25
251275,202309,41,25,16,33000.65,21120,54120.65
251276,202309,35,26,9,34320.82,11880,46200.82
251278,202309,21,16,5,21122.26,6600,27722.26
251280,202309,126,121,5,159720.2,6600,166320.2
251290,202309,1275,907,368,1197318,485779.91,1683097.91
251300,202309,22,17,5,22440,6600,29040
251310,202309,334,234,100,308888.29,132000.98,440889.27
251315,202309,51,45,6,59400,7920,67320
251320,202309,78,60,18,79201.03,23760,102961.03
251330,202309,90,79,11,104280,14520,118800
251335,202309,28,20,8,26400,10560,36960
251340,202309,928,511,417,674535.65,550443.2,1224978.85
251350,202309,43,41,2,54120,3960,58080
251360,202309,93,79,14,104280.2,18480,122760.2
251365,202309,9,8,1,10561.71,1320,11881.71
251370,202309,6613,4510,2103,5953386.4,2777322.8,8730709.2
251380,202309,51,38,13,50160.54,17160,67320.54
251385,202309,9,7,2,9240,2640,11880
251390,202309,1135,835,300,1102223.75,396006.83,1498230.58
251392,202309,56,38,18,50160.5,23760,73920.5
251394,202309,22,17,5,22440.6,6600,29040.6
251396,202309,11,7,4,9240,5280.2,14520.2
251398,202309,21,17,4,22440.75,5280,27720.75
251400,202309,61,47,14,62040,18480,80520
251410,202309,50,40,10,52800.7,13200,66000.7
251420,202309,123,90,33,118801.81,43560,162361.81
251430,202309,52,45,7,59400.55,9240,68640.55
251440,202309,58,32,26,42240,34320,76560
251445,202309,71,61,10,80523.16,13200,93723.16
251450,202309,413,350,63,462010.64,83160.73,545171.37
251455,202309,6,5,1,6600,1320,7920
251460,202309,25,19,6,25080,7920.02,33000.02
251465,202309,16,10,6,13200,7920,21120
251470,202309,51,36,15,47520,19800,67320
251480,202309,27,23,4,30360.62,5280.97,35641.59
251490,202309,97,60,37,79202.29,48840.3,128042.59
251500,202309,110,88,22,116160.99,29040,145200.99
251510,202309,108,69,39,91080.7,51480.62,142561.32
251520,202309,44,36,8,47520,10560,58080
251530,202309,4564,3218,1346,4249152.26,1776730.35,6025882.61
251540,202309,106,87,19,114840,25081.57,139921.57
251550,202309,470,359,111,473897.92,146523.36,620421.28
251560,202309,26,20,6,26400.1,7920,34320.1
251570,202309,18,17,1,22440,1320,23760
251580,202309,136,106,30,139921.56,39600,179521.56
251590,202309,106,75,31,99000.2,40920.8,139921.0
251593,202309,35,19,16,25080.5,21120.59,46201.09
251597,202309,129,104,25,137280.87,33000.04,170280.91
251600,202309,1168,813,355,1073181.59,471242.45,1544424.04
251610,202309,302,219,83,289086.72,109560,398646.72
251615,202309,27,23,4,30360,5280,35640
251620,202309,4436,2799,1637,3696096.91,2162185.67,5858282.58
251630,202309,520,381,139,502938.19,183484.29,686422.48
251640,202309,107,76,31,100324.91,40920,141244.91
251650,202309,329,239,90,315485.12,118800,434285.12
251660,202309,226,200,26,264003.98,34320.3,298324.28
251670,202309,455,348,107,459367.34,141240.52,600607.86
251675,202309,15,12,3,15840,3960,19800
251680,202309,111,99,12,130681.07,15840,146521.07
251690,202309,341,281,60,371259.7,79200.2,450459.9
251700,202309,286,243,43,320763.45,56760,377523.45
251710,202309,23,16,7,21120.41,9240,30360.41
251720,202309,44,31,13,40920,17160,58080
251740,202309,16,10,6,13200.3,7920,21120.3
260005,202309,4180,2141,2039,2825665.81,2694167.61,5519833.42
260010,202309,1956,1463,493,1931189.12,650764.18,2581953.30
260020,202309,466,409,57,539888.37,75240.9,615129.27
260030,202309,691,463,228,611173.4,300961.9,912135.3
260040,202309,814,521,293,689060.06,388082.92,1077142.98
260050,202309,1215,889,326,1176142.77,430323.09,1606465.86
260060,202309,382,344,38,454090.97,50160,504250.97
260070,202309,1432,873,559,1152415.85,737904.22,1890320.07
260080,202309,816,597,219,788057.55,289080,1077137.55
260090,202309,496,330,166,435601.95,219120.6,654722.55
260100,202309,238,157,81,207242.27,106920,314162.27
260105,202309,300,175,125,231001.47,165000.1,396001.57
260110,202309,3296,2375,921,3135050.26,1217051.03,4352101.29
260120,202309,2960,1572,1388,2075448.06,1832181.32,3907629.38
260130,202309,238,171,67,225723.52,88440.2,314163.72
260140,202309,2457,1586,871,2094887.38,1149733.66,3244621.04
260150,202309,213,139,74,183480.93,97680.6,281161.53
260160,202309,387,305,82,403932.82,108241.1,512173.92
260170,202309,3751,2232,1519,2947633.81,2006426.95,4954060.76
260180,202309,161,140,21,184805.31,27720,212525.31
260190,202309,2763,1765,998,2331161.73,1317365.35,3648527.08
260200,202309,1083,842,241,1111461.35,318120.62,1429581.97
260210,202309,1483,1070,413,1412436.85,545163.38,1957600.23
260220,202309,653,580,73,765617.17,96361.67,861978.84
260230,202309,1428,1043,385,1376802.26,508208.25,1885010.51
260240,202309,226,173,53,228367.3,69962.23,298329.53
260250,202309,113,87,26,114840.61,34320,149160.61
260260,202309,1212,832,380,1100893.86,501602.98,1602496.84
260270,202309,269,195,74,257404.6,97680,355084.6
260280,202309,1242,977,265,1289668.12,349803.77,1639471.89
260290,202309,7893,4227,3666,5580990.19,4843111.93,10424102.12
260300,202309,1138,957,181,1263286.82,238922.33,1502209.15
260310,202309,570,446,124,588729.94,163680.1,752410.04
260320,202309,860,629,231,830282.11,304921.1,1135203.21
260330,202309,106,80,26,105600.3,34320.3,139920.6
260340,202309,90,67,23,88440.65,30360,118800.65
260345,202309,6647,3352,3295,4424796.15,4349453.87,8774250.02
260350,202309,523,372,151,491050.26,199320.42,690370.68
260360,202309,269,161,108,212521.1,142560.45,355081.55
260370,202309,752,491,261,648134.54,344522.35,992656.89
260380,202309,576,416,160,549131.61,211202.18,760333.79
260390,202309,312,266,46,351125.26,60720,411845.26
260392,202309,134,114,20,151802.5,26401.12,178203.62
260400,202309,5017,2860,2157,3775269.43,2848579.3,6623848.73
260410,202309,17100,8802,8298,11622923.34,10958721.51,22581644.85
260415,202309,176,140,36,184801.72,47520,232321.72
260420,202309,1942,1226,716,1618352.48,945122.45,2563474.93
260430,202309,184,165,19,217807.15,25080.2,242887.35
260440,202309,219,144,75,190085.2,100320.72,290405.92
260450,202309,485,367,118,484452.16,155761.85,640214.01
260460,202309,953,502,451,662657.69,595325.65,1257983.34
260470,202309,357,220,137,290406.12,180841.99,471248.11
260480,202309,287,173,114,228360,150480,378840
260490,202309,253,188,65,248161.2,85800,333961.2
260500,202309,1249,830,419,1095623.07,554405.41,1650028.48
260510,202309,906,720,186,950418.81,245521.07,1195939.88
260515,202309,278,256,22,337921.22,29040.91,366962.13
260520,202309,3474,2141,1333,2826121.26,1763538.2,4589659.46
260530,202309,938,752,186,992676.73,248160.9,1240837.63
260540,202309,594,462,132,609852.88,174241.36,784094.24
260545,202309,42,21,21,27721.19,27720.56,55441.75
260550,202309,397,256,141,337922.34,186120.11,524042.45
260560,202309,532,406,126,535934.31,166320.59,702254.90
260570,202309,1115,888,227,1172196.26,299641.18,1471837.44
260580,202309,391,310,81,409202.27,106920,516122.27
260590,202309,661,397,264,524042.49,349800.4,873842.89
260600,202309,8494,4956,3538,6546024.71,4675479.11,11221503.82
260610,202309,548,381,167,504254.7,220442.14,724696.84
260620,202309,4204,2196,2008,2900144.05,2650732.7,5550876.75
260630,202309,91,76,15,100320.49,19800,120120.49
260640,202309,3640,2227,1413,2941016.72,1867815.57,4808832.29
260650,202309,340,249,91,328684.54,120120.4,448804.94
260660,202309,671,454,217,600616.79,286444.82,887061.61
260670,202309,127,91,36,120120,47520,167640
260680,202309,4551,2429,2122,3210369.26,2802402.95,6012772.21
260690,202309,149,115,34,151801.01,44880,196681.01
260700,202309,343,241,102,318127.47,134640.69,452768.16
260710,202309,57,47,10,62040,13200,75240
260720,202309,3035,1759,1276,2323235.11,1686968.12,4010203.23
260730,202309,852,621,231,819730.33,304920.75,1124651.08
260740,202309,77,65,12,85800.64,15840,101640.64
260750,202309,591,439,152,579494.09,200640.2,780134.29
260760,202309,855,418,437,551784.02,576849.15,1128633.17
260765,202309,1123,592,531,781455.29,700929.69,1482384.98
260770,202309,244,172,72,227022.02,95041.67,322063.69
260775,202309,971,482,489,636259.54,645489.7,1281749.24
260780,202309,253,148,105,195361.7,138600,333961.7
260790,202309,18281,8673,9608,11450069.93,12694549.82,24144619.75
260795,202309,181,111,70,146520.62,92400,238920.62
260800,202309,323,260,63,343203.82,83160.46,426364.28
260805,202309,53,33,20,43561.5,26400.26,69961.76
260810,202309,949,745,204,983410.82,269280.62,1252691.44
260820,202309,347,229,118,303602.13,155760,459362.13
260825,202309,230,158,72,208561.02,95040,303601.02
260830,202309,313,204,109,269280,143880,413160
260840,202309,301,211,90,278524.03,118800.03,397324.06
260845,202309,237,140,97,184800.98,128041.73,312842.71
260850,202309,455,342,113,451445.05,149160,600605.05
260860,202309,265,198,67,261364,88440,349804
260870,202309,358,278,80,366965.7,105600,472565.7
260875,202309,816,594,222,784121.33,294361.02,1078482.35
260880,202309,1786,1184,602,1562907.84,794641.76,2357549.60
260890,202309,2795,1897,898,2504090.01,1186687.64,3690777.65
260900,202309,1146,863,283,1139175.16,373560.86,1512736.02
260910,202309,260,208,52,274565.21,68640.6,343205.81
260915,202309,298,226,72,298320.7,96360,394680.7
260920,202309,247,140,107,184800.2,141240,326040.2
260930,202309,391,332,59,438251.49,77880.17,516131.66
260940,202309,2771,1471,1300,1944430.82,1716019.98,3660450.80
260950,202309,2167,1236,931,1631573.51,1230259.88,2861833.39
260960,202309,15773,7536,8237,9954634.8,10879647.16,20834281.96
260970,202309,478,382,96,504246.48,126720,630966.48
260980,202309,235,217,18,286444.97,23760,310204.97
260990,202309,2929,2304,625,3042680.82,827645.83,3870326.65
261000,202309,4596,2842,1754,3751501.99,2315297.9,6066799.89
261010,202309,139,105,34,138601.26,44880,183481.26
261020,202309,637,463,174,611170.95,229680.1,840851.05
261030,202309,279,208,71,274562.83,93720,368282.83
261040,202309,409,340,69,448810.38,91080,539890.38
261050,202309,608,486,122,641532.93,162361.69,803894.62
261060,202309,1836,1137,699,1500855.28,922682.76,2423538.04
261070,202309,11269,5257,6012,6943581.98,7942637.89,14886219.87
261080,202309,384,296,88,390728.07,116160,506888.07
261090,202309,2209,1695,514,2238802.9,679805.39,2918608.29
261100,202309,1330,906,424,1195951.61,559686.33,1755637.94
261110,202309,10683,6692,3991,8835155.33,5269528.1,14104683.43
261120,202309,233,197,36,260040.97,47520,307560.97
261130,202309,615,369,246,487092.25,324726.85,811819.10
261140,202309,239,149,90,196680.99,118800,315480.99
261150,202309,687,449,238,592684.78,314160.78,906845.56
261153,202309,78,74,4,97680,5280,102960
261160,202309,86594,41930,44664,55374409.8,59006301.35,114380711.15
261170,202309,531,398,133,525361.02,175560.92,700921.94
261180,202309,1955,1224,731,1616014.97,964929.5,2580944.47
261190,202309,633,431,202,568928.54,266643.22,835571.76
261200,202309,226,178,48,234965.83,63360.36,298326.19
261210,202309,56,38,18,50160.1,23760,73920.1
261220,202309,3142,2178,964,2875032.86,1272496,4147528.86
261230,202309,408,300,108,396008.21,142561.69,538569.90
261240,202309,459,393,66,518771.06,87120.97,605892.03
261245,202309,294,248,46,327360.31,60720,388080.31
261247,202309,192,146,46,192722.52,60720,253442.52
261250,202309,4451,2157,2294,2847292.22,3028099.73,5875391.95
261255,202309,277,242,35,319440.52,46200,365640.52
261260,202309,927,789,138,1041537.56,182163.6,1223701.16
261270,202309,221,156,65,205920.83,85800,291720.83
261280,202309,205,168,37,221762.07,48840.14,270602.21
261290,202309,124,86,38,113520.24,50160.2,163680.44
261300,202309,1581,1186,395,1565554.13,522724.4,2088278.53
261310,202309,913,599,314,790697.79,414482.06,1205179.85
261320,202309,536,374,162,493693.72,213842.36,707536.08
261330,202309,928,737,191,972881.19,253448.14,1226329.33
261340,202309,361,202,159,266641.82,209882.24,476524.06
261350,202309,1035,718,317,947798.82,421091.63,1368890.45
261360,202309,1497,937,560,1236846.6,739204.92,1976051.52
261370,202309,5601,3233,2368,4267661.63,3127116.75,7394778.38
261380,202309,624,497,127,656045.79,167640,823685.79
261390,202309,4217,2897,1320,3824171.37,1742435.87,5566607.24
261400,202309,295,262,33,345848.09,43560.74,389408.83
261410,202309,1213,783,430,1034908.77,568923.25,1603832.02
261420,202309,1065,636,429,839534.8,566282.82,1405817.62
261430,202309,345,310,35,409205.91,46200,455405.91
261440,202309,111,105,6,138601.44,7920,146521.44
261450,202309,2817,2144,673,2830126.43,889686.41,3719812.84
261460,202309,876,674,202,889704.82,266641.2,1156346.02
261470,202309,252,202,50,267961.8,66000.4,333962.2
261480,202309,520,386,134,509532.55,176821.76,686354.31
261485,202309,440,259,181,341888.49,238920.2,580808.69
261500,202309,699,447,252,591369.96,333961.9,925331.86
261510,202309,58,41,17,54120.98,22440.1,76561.08
261520,202309,115,98,17,129362.51,22440.2,151802.71
261530,202309,4779,3088,1691,4076236.54,2232135.15,6308371.69
261540,202309,1705,966,739,1276465.11,975488.46,2251953.57
261550,202309,301,148,153,195361.75,201960,397321.75
261560,202309,1066,705,361,930621.92,479163.22,1409785.14
261570,202309,439,352,87,464648.19,114840.95,579489.14
261580,202309,426,334,92,440885.07,121440,562325.07
261590,202309,215,168,47,221766.57,63361.3,285127.87
261600,202309,354,271,83,357729.03,109560.2,467289.23
261610,202309,114,89,25,117480.97,33000,150480.97
261618,202309,87,63,24,83160.86,31680,114840.86
261620,202309,222,140,82,184802.89,110881.18,295684.07
261630,202309,732,564,168,744486.7,221763.21,966249.91
261640,202309,7505,3977,3528,5251120.59,4663630.39,9914750.98
261650,202309,457,290,167,382801.47,220440.1,603241.57
270010,202309,540,475,65,627014.52,85800.52,712815.04
270020,202309,252,214,38,282484.79,50160.47,332645.26
270030,202309,10080,6489,3591,8570102.36,4744075.58,13314177.94
270040,202309,2213,1489,724,1965524.35,955687.13,2921211.48
270050,202309,261,202,59,266643.89,77880.91,344524.80
270060,202309,59,42,17,55442.84,22440.33,77883.17
270070,202309,804,596,208,786732.62,274561.1,1061293.72
270080,202309,64,49,15,64680.1,19800,84480.1
270090,202309,23,18,5,23760,6600,30360
270100,202309,1382,948,434,1251387.33,572882.12,1824269.45
270110,202309,68,53,15,69960,19800,89760
270120,202309,311,253,58,333970.58,76560.53,410531.11
270130,202309,365,282,83,372243.17,109560,481803.17
270135,202309,124,92,32,121441,42240,163681
270140,202309,1496,1004,492,1325317.08,649450.72,1974767.80
270150,202309,273,195,78,257404.54,102960.83,360365.37
270160,202309,496,392,104,517482.94,137283.36,654766.30
270170,202309,842,558,284,736565.57,374881.67,1111447.24
270180,202309,63,50,13,66000.7,17160.09,83160.79
270190,202309,119,105,14,138604.18,18480,157084.18
270200,202309,128,111,17,146520.77,22440,168960.77
270210,202309,567,358,209,472563,275880,748443
270220,202309,198,144,54,190080.35,71280.6,261360.95
270230,202309,2335,1510,825,1993238.04,1089002.78,3082240.82
270235,202309,529,419,110,553105.53,145200,698305.53
270240,202309,3497,2748,749,3628738.69,988683.91,4617422.60
270250,202309,111,92,19,121441.11,25080,146521.11
270255,202309,227,189,38,249483.27,50160.44,299643.71
270260,202309,434,344,90,454094.24,118800.7,572894.94
270270,202309,97,52,45,68640.83,59400,128040.83
270280,202309,199,127,72,167640,95040,262680
270290,202309,1190,931,259,1228940.56,341883.57,1570824.13
270300,202309,396,293,103,386761.35,135960.2,522721.55
270310,202309,846,716,130,945139.84,171600.54,1116740.38
270320,202309,788,681,107,898938.44,141240,1040178.44
270330,202309,340,294,46,388080.62,60720,448800.62
270340,202309,70,56,14,73920,18480,92400
270350,202309,78,45,33,59402.43,43560,102962.43
270360,202309,91,50,41,66000,54120,120120
270370,202309,76,59,17,77880,22440,100320
270375,202309,89,61,28,80521.17,36960,117481.17
270380,202309,1086,752,334,992640.7,440880,1433520.7
270390,202309,132,81,51,106920.2,67320.5,174240.7
270400,202309,820,635,185,838214.93,244200.92,1082415.85
270410,202309,228,174,54,229688.06,71280,300968.06
270420,202309,440,310,130,409203.54,171600.3,580803.84
270430,202309,38086,27015,11071,35668778.3,14620631.92,50289410.22
270440,202309,472,372,100,491054.93,132001.3,623056.23
270450,202309,962,584,378,770886.91,498960.57,1269847.48
270460,202309,180,142,38,188764.73,50160,238924.73
270470,202309,1829,1288,541,1700189.86,714122.82,2414312.68
270480,202309,600,481,119,634929.22,157080,792009.22
270490,202309,27,20,7,27720,9240,36960
270500,202309,490,406,84,535926.47,110880,646806.47
270510,202309,950,647,303,853990.93,399962.04,1253952.97
270520,202309,275,184,91,242881.3,121440,364321.3
270530,202309,63,51,12,67320.1,15840,83160.1
270540,202309,82,59,23,77880,30360,108240
270550,202309,1664,1291,373,1704157.41,492361.32,2196518.73
270560,202309,264,167,97,220443.82,128040,348483.82
270570,202309,632,456,176,601925.53,232320,834245.53
270580,202309,21,16,5,21120,6600,27720
270590,202309,62,51,11,67320.3,14520.08,81840.38
270600,202309,173,145,28,191406,36960.1,228366.1
270610,202309,264,208,56,275884.17,73920.1,349804.27
270620,202309,17,17,0,22440,,22440.0
270630,202309,3795,2841,954,3751683.4,1260610.5,5012293.9
270640,202309,924,681,243,898937.52,320761.3,1219698.82
270642,202309,228,188,40,248162.53,52800,300962.53
270644,202309,265,174,91,229682.91,120122.47,349805.38
270650,202309,358,229,129,302285.22,170282.15,472567.37
270660,202309,174,152,22,200645.35,29040,229685.35
270670,202309,3108,2382,726,3144308.33,959642.37,4103950.70
270680,202309,416,279,137,368286.7,180840,549126.7
270690,202309,1309,895,414,1181431.03,546483.55,1727914.58
270700,202309,24,19,5,25080.19,6600,31680.19
270710,202309,580,457,123,603247.46,162360,765607.46
270720,202309,232,192,40,253443.65,54120.92,307564.57
270730,202309,2025,1293,732,1708105.33,968885.59,2676990.92
270740,202309,34,25,9,33000.36,11880,44880.36
270750,202309,628,490,138,646808.27,182160,828968.27
270760,202309,296,216,80,285125.97,105600,390725.97
270770,202309,3071,2134,937,2816956.19,1238170.11,4055126.30
270780,202309,75,46,29,60720,38280.76,99000.76
270790,202309,199,132,67,174242.56,88440.6,262683.16
270800,202309,2092,1682,410,2220282.03,541200,2761482.03
270810,202309,208,168,40,221761.36,52800,274561.36
270820,202309,119,83,36,109564.1,47520,157084.1
270830,202309,901,698,203,921387.17,267961.14,1189348.31
270840,202309,1332,1047,285,1382058.64,377521.4,1759580.04
270850,202309,1589,1054,535,1392613.94,708843.16,2101457.10
270860,202309,2751,1870,881,2468434.84,1162929.78,3631364.62
270870,202309,135,82,53,109560.2,69960.2,179520.4
270880,202309,899,717,182,946468.91,241562.62,1188031.53
270890,202309,259,201,58,265321.86,76560.8,341882.66
270895,202309,82,78,4,102960,5280,108240
270900,202309,68,56,12,73922.29,15840,89762.29
270910,202309,318,270,48,356409.76,63361.54,419771.30
270915,202309,2006,1362,644,1797878.12,851401.59,2649279.71
270920,202309,397,328,69,432964.67,92400,525364.67
270930,202309,5585,4347,1238,5742122.69,1635485.66,7377608.35
270940,202309,2277,1839,438,2428846.72,578161.8,3007008.52
280010,202309,34,28,6,36960.2,7920,44880.2
280020,202309,549,464,85,612495.49,112200.97,724696.46
280030,202309,24107,15404,8703,20343583.89,11496174.7,31839758.59
280040,202309,353,222,131,293044.43,172920.4,465964.83
280050,202309,469,359,110,475206.84,145200,620406.84
280060,202309,450,297,153,392049.01,201960.61,594009.62
280067,202309,1218,886,332,1169543.65,438241.06,1607784.71
280070,202309,132,112,20,147841.75,26400,174241.75
280100,202309,736,565,171,745810.68,225720.2,971530.88
280110,202309,99,85,14,112202.18,18480,130682.18
280120,202309,756,629,127,830291.99,167641.14,997933.13
280130,202309,1930,1254,676,1657942.03,892320.9,2550262.93
280140,202309,560,463,97,611165.92,128040.2,739206.12
280150,202309,462,335,127,442209.75,167640,609849.75
280160,202309,155,117,38,154442.42,50160,204602.42
280170,202309,461,330,131,435616.63,172920.93,608537.56
280190,202309,34,27,7,35640,9240,44880
280200,202309,57,45,12,59406.36,15840.3,75246.66
280210,202309,3308,2365,943,3121777.23,1244767.74,4366544.97
280220,202309,69,57,12,75242.32,15840,91082.32
280230,202309,350,281,69,370939.56,91081.71,462021.27
280240,202309,147,137,10,180842.71,13200,194042.71
280250,202309,21,10,11,13200.1,14521.37,27721.47
280260,202309,87,73,14,96363.09,18480,114843.09
280270,202309,144,114,30,150480.58,39600.53,190081.11
280280,202309,206,138,68,182163.19,89760.09,271923.28
280290,202309,4214,3082,1132,4070952.2,1496894.66,5567846.86
280300,202309,1832,1450,382,1915346.84,504244.66,2419591.50
280310,202309,116,107,9,141241.67,11880,153121.67
280320,202309,739,508,231,674538.12,306242.33,980780.45
280330,202309,339,250,89,330007.49,117480.2,447487.69
280340,202309,474,392,82,518769.56,108241.9,627011.46
280350,202309,4108,3126,982,4127818.97,1296257.13,5424076.10
280360,202309,491,334,157,440895.45,207240.78,648136.23
280370,202309,100,84,16,110881.09,21120,132001.09
280380,202309,51,39,12,51480,15840,67320
280390,202309,187,157,30,207243.71,39600,246843.71
280400,202309,448,286,162,377533.95,213843.54,591377.49
280410,202309,315,265,50,349807.5,66000,415807.5
280420,202309,145,125,20,165010.38,26400.95,191411.33
280430,202309,112,90,22,118801.57,29040,147841.57
280440,202309,781,646,135,852741.77,178203.16,1030944.93
280445,202309,127,117,10,154442.62,13200.8,167643.42
280450,202309,1436,1229,207,1622315.12,273243.85,1895558.97
280460,202309,739,550,189,726016.06,249481.28,975497.34
280470,202309,78,75,3,99002.46,3960,102962.46
280480,202309,3590,2404,1186,3174813.18,1565558.4,4740371.58
280490,202309,186,174,12,229689.51,15840,245529.51
280500,202309,43,40,3,52801.77,3960.84,56762.61
280510,202309,145,109,36,143880.89,47520.74,191401.63
280520,202309,56,38,18,50161.19,23760,73921.19
280530,202309,78,52,26,68643.51,34320.38,102963.89
280540,202309,598,516,82,681130.11,108240,789370.11
280550,202309,788,724,64,955703.96,84480,1040183.96
280560,202309,507,458,49,604568.26,64680.93,669249.19
280570,202309,2617,2072,545,2735089.06,720725.77,3455814.83
280580,202309,626,494,132,652087.5,174240.96,826328.46
280590,202309,237,156,81,205936.24,106926.65,312862.89
280600,202309,446,363,83,479227.46,109560.2,588787.66
280610,202309,129,92,37,121446.87,48841.68,170288.55
280620,202309,581,462,119,609849.06,157080,766929.06
280630,202309,155,128,27,168962.63,35640.9,204603.53
280640,202309,177,145,32,191400.3,42240,233640.3
280650,202309,84,52,32,68643.04,42240,110883.04
280660,202309,128,98,30,129365.19,39600.21,168965.40
280670,202309,2198,1407,791,1857366.64,1046788.54,2904155.18
280680,202309,264,224,40,295681.37,52800,348481.37
280690,202309,79,70,9,93720,11880,105600
280700,202309,22,22,0,29040,,29040.0
280710,202309,1654,1276,378,1684350.81,500282.64,2184633.45
280720,202309,147,106,41,139922.05,54120,194042.05
280730,202309,35,32,3,42241.33,3960.05,46201.38
280740,202309,2755,2072,683,2736398.15,901564.64,3637962.79
280750,202309,221,194,27,256085.33,35640.8,291726.13
280760,202309,1038,694,344,917423.13,454082.03,1371505.16
290010,202309,202,140,62,184800.75,81840,266640.75
290020,202309,217,193,24,254761.63,31680.9,286442.53
290030,202309,666,430,236,567607.85,311520.94,879128.79
290035,202309,147,118,29,155761.71,38280.93,194042.64
290040,202309,282,201,81,265326.1,106920,372246.1
290050,202309,100,81,19,106920,25080,132000
290060,202309,254,109,145,143881.21,191400,335281.21
290070,202309,6676,3169,3507,4184526.25,4630604.54,8815130.79
290080,202309,520,230,290,303602.92,382800.09,686403.01
290090,202309,328,156,172,205920.2,227041,432961.2
290100,202309,1873,1187,686,1569515.02,905522.97,2475037.99
290110,202309,971,541,430,718108.77,568927.45,1287036.22
290115,202309,187,171,16,225723.98,21120,246843.98
290120,202309,889,595,294,785410.14,388081.37,1173491.51
290130,202309,513,315,198,417124.06,261360.85,678484.91
290135,202309,302,224,78,295685.6,102960.1,398645.7
290140,202309,349,295,54,389406.67,71280.36,460687.03
290150,202309,155,106,49,139920,64680.01,204600.01
290160,202309,248,195,53,257407.44,69960.85,327368.29
290170,202309,117,87,30,114841.61,39600,154441.61
290180,202309,210,149,61,196682.23,80520.44,277202.67
290190,202309,291,225,66,297003.09,87120.2,384123.29
290195,202309,316,220,96,290402.96,128040.1,418443.06
290200,202309,275,220,55,290400.37,72600.1,363000.47
290205,202309,174,108,66,142560.4,87120,229680.4
290210,202309,1361,986,375,1301554.02,495002.76,1796556.78
290220,202309,168,104,64,137288.27,84481.1,221769.37
290225,202309,311,122,189,161041.61,249480.59,410522.20
290230,202309,105,64,41,84482.03,54120,138602.03
290240,202309,415,148,267,195361.49,352440.55,547802.04
290250,202309,252,233,19,307566.94,25080,332646.94
290260,202309,382,295,87,389417.29,114843.8,504261.09
290265,202309,201,175,26,231004.59,34320.13,265324.72
290270,202309,1453,1191,262,1573497.74,345841.1,1919338.84
290280,202309,544,380,164,501605.95,216480.4,718086.35
290290,202309,1625,1004,621,1325305.23,821041.49,2146346.72
290300,202309,401,341,60,450129.01,79201.48,529330.49
290310,202309,285,138,147,182160.92,194040,376200.92
290320,202309,4718,2804,1914,3704069.02,2529140.62,6233209.64
290323,202309,223,191,32,253447.38,42240.2,295687.58
290327,202309,182,141,41,186125.28,54120,240245.28
290330,202309,142,69,73,91080.02,96360,187440.02
290340,202309,835,349,486,460694.46,641522.99,1102217.45
290350,202309,749,449,300,592686.59,396001.31,988687.90
290360,202309,322,253,69,333965.29,91080,425045.29
290370,202309,908,424,484,559680.77,638880.91,1198561.68
290380,202309,352,229,123,302283.21,162361.67,464644.88
290390,202309,2585,1596,989,2106769.29,1306808.73,3413578.02
290395,202309,248,148,100,196680.27,133320,330000.27
290400,202309,309,227,82,299640.82,108240,407880.82
290405,202309,254,218,36,289083.08,47520,336603.08
290410,202309,697,579,118,764284.83,155760,920044.83
290420,202309,301,248,53,327362.53,69960,397322.53
290430,202309,526,336,190,444841.79,250800,695641.79
290440,202309,98,78,20,102960.4,26400,129360.4
290450,202309,206,150,56,198000,73920,271920
290460,202309,2150,1269,881,1675117.28,1164241.57,2839358.85
290470,202309,1422,643,779,848782.95,1028287.94,1877070.89
290475,202309,590,551,39,727332.01,51480,778812.01
290480,202309,195,113,82,149160.07,108240,257400.07
290485,202309,251,225,26,297002.8,34320,331322.8
290490,202309,1378,964,414,1273821.75,547803.3,1821625.05
290500,202309,866,478,388,630970.16,513483.42,1144453.58
290510,202309,187,151,36,199331.45,47520.35,246851.80
290515,202309,210,136,74,180842.37,97680,278522.37
290520,202309,1537,1024,513,1351690.55,678481.08,2030171.63
290530,202309,285,251,34,331333.98,46200.93,377534.91
290540,202309,155,74,81,97680,106920,204600
290550,202309,193,156,37,205921.48,48840,254761.48
290560,202309,3366,1546,1820,2043410.82,2407693.3,4451104.12
290570,202309,8015,3799,4216,5017519.35,5569162.19,10586681.54
290580,202309,1380,832,548,1098256.84,723360.6,1821617.44
290590,202309,603,480,123,633636.03,162363.55,795999.58
290600,202309,1962,1336,626,1763586.19,826329.67,2589915.86
290610,202309,177,164,13,216487.95,17160,233647.95
290620,202309,414,366,48,483130.55,63360.6,546491.15
290630,202309,2109,903,1206,1191992.25,1591926.92,2783919.17
290640,202309,140,109,31,143884.38,40920,184804.38
290650,202309,2338,1095,1243,1445443.82,1640770.25,3086214.07
290660,202309,291,242,49,319441.14,64680.72,384121.86
290670,202309,1184,600,584,792015.12,770887.62,1562902.74
290680,202309,1356,1082,274,1430899.93,361682.19,1792582.12
290682,202309,375,279,96,368282.23,126720,495002.23
290685,202309,281,166,115,219124.11,151800.2,370924.31
290687,202309,1343,882,461,1165798.11,608522.39,1774320.50
290689,202309,156,77,79,101640,104280,205920
290690,202309,578,276,302,364327.33,398641.82,762969.15
290700,202309,279,144,135,190087.57,178203.32,368290.89
290710,202309,881,620,261,818414.6,344524.01,1162938.61
290720,202309,1214,952,262,1256679.65,345842.52,1602522.17
290730,202309,1332,790,542,1042819.66,716764.5,1759584.16
290740,202309,33,28,5,36960,6600,43560
290750,202309,1611,718,893,947786.52,1178775.18,2126561.70
290755,202309,88,74,14,97680,18480,116160
290760,202309,270,235,35,310211.22,46200.86,356412.08
290770,202309,200,191,9,252124.07,11880,264004.07
290780,202309,1216,976,240,1288344.14,316804.22,1605148.36
290790,202309,436,299,137,396006.29,180842.78,576849.07
290800,202309,2542,1043,1499,1379425.74,1981329.83,3360755.57
290810,202309,526,355,171,468606.16,225720.52,694326.68
290820,202309,438,252,186,332647.15,246843.12,579490.27
290830,202309,523,369,154,487085.92,203280.14,690366.06
290840,202309,2018,1282,736,1692288.79,971526.35,2663815.14
290850,202309,1177,601,576,793331.95,760327.53,1553659.48
290860,202309,748,374,374,495006.43,493682.22,988688.65
290870,202309,675,472,203,623048.74,267960.61,891009.35
290880,202309,128,68,60,89760.17,79200,168960.17
290890,202309,556,333,223,439564.67,295683.08,735247.75
290900,202309,163,124,39,163680.94,51480,215160.94
290910,202309,428,323,105,426361.24,138600,564961.24
290920,202309,230,204,26,269284.79,34320,303604.79
290930,202309,579,439,140,579495.72,184801.7,764297.42
290940,202309,225,191,34,252121,44880,297001
290950,202309,170,99,71,130680,93720,224400
290960,202309,544,391,153,516125.56,201960.88,718086.44
290970,202309,245,215,30,283802.36,39600.2,323402.56
290980,202309,2185,1542,643,2035477.79,848766.99,2884244.78
290990,202309,463,386,77,509542.83,101642.68,611185.51
291000,202309,972,333,639,439561.61,843480,1283041.61
291005,202309,2945,1261,1684,1665907.63,2224231.2,3890138.83
291010,202309,133,115,18,151800.94,23760,175560.94
291020,202309,85,70,15,92400,19800,112200
291030,202309,120,88,32,116162.42,43560,159722.42
291040,202309,695,419,276,553082.06,364320.7,917402.76
291050,202309,1689,874,815,1153706.21,1075808.63,2229514.84
291060,202309,1877,1043,834,1376788.11,1103528.9,2480317.01
291070,202309,2122,1605,517,2119970.6,683768.14,2803738.74
291072,202309,7771,3043,4728,4016922.8,6242324.19,10259246.99
291075,202309,280,232,48,307560.6,63360,370920.6
291077,202309,62,45,17,59400,22440,81840
291080,202309,23677,10194,13483,13460512.76,17810988.44,31271501.20
291085,202309,294,240,54,316804.46,71280.65,388085.11
291090,202309,259,105,154,138600.71,203280,341880.71
291100,202309,983,348,635,459360.15,838200,1297560.15
291110,202309,483,368,115,485768.24,151800.6,637568.84
291120,202309,2589,1415,1174,1870469.66,1549689.66,3420159.32
291125,202309,76,41,35,54120,46200,100320
291130,202309,196,166,30,219123.95,39600,258723.95
291140,202309,164,133,31,175560.81,40920.1,216480.91
291150,202309,366,137,229,180840.61,302280,483120.61
291160,202309,438,337,101,444855.63,133321.57,578177.20
291165,202309,59,44,15,58080,19800.62,77880.62
291170,202309,3736,1862,1874,2459206.94,2476327.67,4935534.61
291180,202309,1296,562,734,741849.6,968882.04,1710731.64
291185,202309,129,120,9,158402.57,11880,170282.57
291190,202309,1430,700,730,925340.93,963608.71,1888949.64
291200,202309,191,141,50,186120.9,66000,252120.9
291210,202309,2590,1085,1505,1433544.34,1989249.26,3422793.60
291220,202309,347,267,80,352442.95,105600.2,458043.15
291230,202309,977,368,609,485768.69,803883.08,1289651.77
291240,202309,406,374,32,493682.97,42240,535922.97
291250,202309,420,346,74,456720.69,97680,554400.69
291260,202309,69,57,12,75240.1,15840,91080.1
291270,202309,782,382,400,504259.18,528004.16,1032263.34
291280,202309,362,176,186,232323.07,245520.3,477843.37
291290,202309,1699,908,791,1198605.94,1044135.21,2242741.15
291300,202309,264,192,72,253443.05,95040,348483.05
291310,202309,231,200,31,264005.9,40920.7,304926.6
291320,202309,1341,933,408,1231601.68,538562.88,1770164.56
291330,202309,146,121,25,159723.33,33000.2,192723.53
291340,202309,262,165,97,217805.91,129361.95,347167.86
291345,202309,125,92,33,121440.4,43560,165000.4
291350,202309,1923,764,1159,1008485.4,1529880.4,2538365.8
291360,202309,9359,4437,4922,5857107.28,6501121.75,12358229.03
291370,202309,1296,797,499,1052083.02,658688.63,1710771.65
291380,202309,289,223,66,294362.38,87120,381482.38
291390,202309,4391,1958,2433,2588575.84,3212893.74,5801469.58
291400,202309,2259,1554,705,2052658,931932.6,2984590.6
291410,202309,257,210,47,277203.2,62040,339243.2
291420,202309,130,100,30,132000.88,40920,172920.88
291430,202309,188,115,73,151800,96360,248160
291440,202309,584,476,108,628335.41,142560.2,770895.61
291450,202309,1095,728,367,960984.07,484445.05,1445429.12
291460,202309,2315,1785,530,2356273.47,699612.4,3055885.87
291465,202309,2480,1212,1268,1599870.79,1673766.5,3273637.29
291470,202309,3078,1554,1524,2052642.67,2011696.08,4064338.75
291480,202309,13150,5762,7388,7608754.75,9762779.12,17371533.87
291490,202309,755,306,449,403924.3,594000.2,997924.5
291500,202309,378,228,150,301987.11,198000,499987.11
291510,202309,1180,478,702,630963.29,926640.26,1557603.55
291520,202309,949,441,508,582136.48,670560.4,1252696.88
291530,202309,943,294,649,388082.27,856680,1244762.27
291535,202309,153,125,28,165000.19,36960.75,201960.94
291540,202309,349,121,228,159723.15,300961.93,460685.08
291550,202309,1322,638,684,842170.94,905521.26,1747692.20
291560,202309,5352,2730,2622,3603648.63,3462368.75,7066017.38
291570,202309,260,142,118,187441.39,155761.7,343203.09
291580,202309,1340,862,478,1137861.15,633601.29,1771462.44
291590,202309,128,65,63,85800.55,83160,168960.55
291600,202309,1208,619,589,817096.18,778803.63,1595899.81
291610,202309,1549,747,802,986096.08,1058662.51,2044758.59
291620,202309,589,279,310,368289.71,410522.69,778812.40
291630,202309,488,154,334,203281.55,440880.2,644161.75
291640,202309,4453,2163,2290,2855226.01,3022820.89,5878046.90
291650,202309,491,350,141,462016.95,186121.77,648138.72
291660,202309,370,155,215,204602.21,285122.25,489724.46
291670,202309,157,96,61,126720.84,80520.73,207241.57
291680,202309,674,418,256,551792.79,337923.32,889716.11
291685,202309,676,387,289,510851.12,381483.36,892334.48
291690,202309,539,357,182,471245.96,240241.22,711487.18
291700,202309,1128,864,264,1140504.43,349802.14,1490306.57
291710,202309,1655,800,855,1056018.5,1129924.76,2185943.26
291720,202309,485,331,154,436921.42,203280.9,640202.32
291730,202309,993,583,410,770903.55,541204.54,1312108.09
291733,202309,337,224,113,295681.45,149160.19,444841.64
291735,202309,101,76,25,100320.95,33000,133320.95
291740,202309,354,271,83,357720.13,109560,467280.13
291750,202309,2628,1650,978,2179413.71,1292298.17,3471711.88
291760,202309,3283,1834,1449,2422213.84,1912682.12,4334895.96
291770,202309,805,544,261,718113.05,345846.59,1063959.64
291780,202309,122,78,44,102961.07,58080.78,161041.85
291790,202309,174,99,75,130680,99000.84,229680.84
291800,202309,11414,5063,6351,6687340.57,8388677.16,15076017.73
291810,202309,1145,857,288,1131264.43,380164.73,1511429.16
291820,202309,317,234,83,310201.06,110880,421081.06
291830,202309,1066,457,609,603259.22,803886.47,1407145.69
291835,202309,587,545,42,719410.06,55440.22,774850.28
291840,202309,6120,3094,3026,4089568.48,3998358.45,8087926.93
291845,202309,302,105,197,138600,260040,398640
291850,202309,341,296,45,390731.58,59401.56,450133.14
291855,202309,278,117,161,154441.58,212520.48,366962.06
291860,202309,160,103,57,135960.52,75240.99,211201.51
291870,202309,95,46,49,60720,64680,125400
291875,202309,161,149,12,196680.1,15840,212520.1
291880,202309,454,374,80,493696.12,105602.73,599298.85
291890,202309,266,92,174,121440.2,229680,351120.2
291900,202309,63,40,23,52800.2,30360,83160.2
291905,202309,120,90,30,118801.15,39600.4,158401.55
291910,202309,155,127,28,167640.92,36960.1,204601.02
291915,202309,484,424,60,559701.28,79200.79,638902.07
291920,202309,7035,3364,3671,4440680.33,4849761.72,9290442.05
291930,202309,179,109,70,143882,92400.25,236282.25
291940,202309,455,272,183,359042.39,242880,601922.39
291950,202309,1283,995,288,1313406.92,380160,1693566.92
291955,202309,1619,977,642,1289671.64,847448.1,2137119.74
291960,202309,215,158,57,208561.08,75240,283801.08
291970,202309,832,613,219,809178.04,289082.28,1098260.32
291980,202309,1505,1295,210,1709434.17,277202.66,1986636.83
291990,202309,158,147,11,194043.36,14520,208563.36
291992,202309,245,119,126,157088.65,166323.14,323411.79
291995,202309,211,140,71,184801.94,93720,278521.94
292000,202309,457,326,131,430326.29,172920.7,603246.99
292010,202309,400,271,129,359040.41,170280,529320.41
292020,202309,341,246,95,324723.51,125400,450123.51
292030,202309,168,130,38,171602.25,50160,221762.25
292040,202309,627,346,281,456720,370920,827640
292045,202309,132,115,17,151800.7,22440.49,174241.19
292050,202309,1015,744,271,982089.73,357721.48,1339811.21
292060,202309,1019,832,187,1098275.37,246842.82,1345118.19
292070,202309,81,32,49,42240.2,64680,106920.2
292080,202309,192,136,56,179521.38,73920,253441.38
292090,202309,617,232,385,306241,509520.9,815761.9
292100,202309,1826,803,1023,1060005.02,1353030.08,2413035.10
292105,202309,178,161,17,212520,22440,234960
292110,202309,2437,922,1515,1217063.75,1999807.08,3216870.83
292120,202309,775,581,194,768274.79,256081.12,1024355.91
292130,202309,531,291,240,384124.29,316800.19,700924.48
292140,202309,234,187,47,246845.62,62040.34,308885.96
292145,202309,188,111,77,146520,101640,248160
292150,202309,1611,1351,260,1783349.29,343203.08,2126552.37
292160,202309,190,148,42,195360.7,55440.09,250800.79
292170,202309,1225,1031,194,1360968.88,256083.11,1617051.99
292180,202309,268,189,79,249480,104280.1,353760.1
292190,202309,165,108,57,142561.14,75240.97,217802.11
292200,202309,1561,592,969,781451.78,1281727.37,2063179.15
292205,202309,135,114,21,150480.72,27720,178200.72
292210,202309,440,280,160,369608.57,211200.66,580809.23
292220,202309,43,31,12,40920.4,15840,56760.4
292225,202309,72,55,17,72602.63,22440.64,95043.27
292230,202309,1069,828,241,1092989.61,318121.56,1411111.17
292240,202309,689,511,178,674542.33,234960.5,909502.83
292250,202309,1721,1116,605,1473163.12,798606.51,2271769.63
292260,202309,455,274,181,361684.44,238921.35,600605.79
292265,202309,271,209,62,275884.32,81840.56,357724.88
292270,202309,745,388,357,512168.1,471240,983408.1
292273,202309,223,134,89,176880.9,117480.29,294361.19
292275,202309,199,105,94,138600.5,124080,262680.5
292280,202309,160,112,48,149160,64680,213840
292285,202309,107,82,25,108240,33000,141240
292290,202309,685,458,227,605891.99,299640.72,905532.71
292300,202309,2073,826,1247,1091663.13,1646061.77,2737724.90
292303,202309,152,106,46,139922.39,60720.59,200642.98
292305,202309,129,95,34,125401.89,44880,170281.89
292310,202309,1057,711,346,939858.81,456725.44,1396584.25
292320,202309,641,482,159,636248.5,209882.15,846130.65
292330,202309,180,119,61,157080.47,80520,237600.47
292335,202309,346,270,76,356402.81,100320,456722.81
292340,202309,601,422,179,557045.02,236280.55,793325.57
292350,202309,296,151,145,199322.03,191400,390722.03
292360,202309,791,591,200,780122.68,264001.01,1044123.69
292370,202309,748,573,175,757689.59,231000.92,988690.51
292380,202309,641,539,102,711495.03,134640.2,846135.23
292390,202309,383,158,225,208561.96,297000.96,505562.92
292400,202309,4169,2537,1632,3350254.24,2155572.55,5505826.79
292405,202309,296,195,101,257400.44,133320,390720.44
292410,202309,111,71,40,93720.7,52800,146520.7
292420,202309,277,242,35,319440.9,46200,365640.9
292430,202309,565,402,163,530642.57,216480.52,747123.09
292440,202309,720,599,121,790695.43,159722.13,950417.56
292450,202309,249,189,60,249482.48,79200.2,328682.68
292460,202309,538,409,129,539885.69,170281.08,710166.77
292465,202309,220,189,31,249482.9,40920.1,290403.0
292467,202309,192,126,66,166320.27,87120,253440.27
292470,202309,342,228,114,300960.59,150480,451440.59
292480,202309,434,285,149,376207.95,196681.32,572889.27
292490,202309,270,200,70,264001.82,92401.76,356403.58
292500,202309,1009,512,497,675859.62,656047.27,1331906.89
292510,202309,3923,1936,1987,2555573.41,2625498.54,5181071.95
292520,202309,1335,638,697,842186.66,920051.55,1762238.21
292525,202309,491,369,122,487092.35,161043.24,648135.59
292530,202309,5668,2362,3306,3119230.7,4367912.99,7487143.69
292540,202309,502,290,212,382803.03,279841.42,662644.45
292550,202309,1213,680,533,898932.63,703564.43,1602497.06
292560,202309,350,319,31,421093.16,40920.16,462013.32
292570,202309,383,291,92,384122.15,121440,505562.15
292575,202309,628,465,163,613826.05,215161.48,828987.53
292580,202309,1113,759,354,1001888.23,468603.67,1470491.90
292590,202309,611,539,72,711487.07,95040.8,806527.87
292593,202309,161,128,33,168960.58,43560,212520.58
292595,202309,238,184,54,242883.59,71280,314163.59
292600,202309,1390,989,401,1305524.12,530648.96,1836173.08
292610,202309,110,92,18,121442.24,23760.4,145202.64
292620,202309,559,463,96,611193.79,126721.73,737915.52
292630,202309,1707,932,775,1230265.44,1024326.37,2254591.81
292640,202309,948,658,290,868573.8,382805.53,1251379.33
292650,202309,201,150,51,198008.18,67320,265328.18
292660,202309,2145,1495,650,1974781.17,858013.1,2832794.27
292665,202309,143,101,42,133321.58,55440,188761.58
292670,202309,408,310,98,409202.18,129360.21,538562.39
292680,202309,274,208,66,274561.99,87120,361681.99
292690,202309,219,147,72,194040.7,95040,289080.7
292700,202309,1109,734,375,968907.76,496325.69,1465233.45
292710,202309,120,101,19,133321.41,25080.31,158401.72
292720,202309,1114,644,470,850088.25,620400.78,1470489.03
292730,202309,248,118,130,155761.17,171600.4,327361.57
292740,202309,88512,41752,46760,55148055.09,61790224.13,116938279.22
292750,202309,443,325,118,429009.31,155763.08,584772.39
292760,202309,362,310,52,409201.73,68640.15,477841.88
292770,202309,980,409,571,539888.55,756367.64,1296256.19
292780,202309,66,31,35,40922.16,46200.86,87123.02
292790,202309,821,445,376,588724.72,496320.2,1085044.92
292800,202309,1374,827,547,1091659.15,722046.18,1813705.33
292805,202309,429,166,263,219121.1,347161.37,566282.47
292810,202309,1969,1159,810,1529904.17,1069202.53,2599106.70
292820,202309,746,631,115,834270.62,151802.61,986073.23
292830,202309,150,113,37,149164.3,48840.83,198005.13
292840,202309,758,607,151,801268.69,199322.98,1000591.67
292850,202309,153,103,50,135961.63,66001.15,201962.78
292860,202309,2268,1309,959,1727942.89,1267212.55,2995155.44
292870,202309,4099,2673,1426,3529758.9,1884967.78,5414726.68
292880,202309,1568,1036,532,1367546.54,702245.79,2069792.33
292890,202309,607,507,100,669256.76,133321.97,802578.73
292895,202309,157,113,44,149160.75,58080,207240.75
292900,202309,365,264,101,348495.14,133323.11,481818.25
292905,202309,549,273,276,360367.47,364324.03,724691.50
292910,202309,586,436,150,575526.39,198000.82,773527.21
292920,202309,678,309,369,407892.75,487087.55,894980.30
292925,202309,501,456,45,601921.62,59401.22,661322.84
292930,202309,809,491,318,648130.86,419764.25,1067895.11
292935,202309,279,121,158,159721.35,209880.9,369602.25
292937,202309,222,150,72,198001.65,95040,293041.65
292940,202309,206,155,51,204601.17,67320,271921.17
292950,202309,1534,736,798,971545,1056009.01,2027554.01
292960,202309,527,377,150,497660.37,198001.5,695661.87
292970,202309,275,202,73,266645.07,96362.82,363007.89
292975,202309,108,59,49,77885.26,64681.06,142566.32
292980,202309,378,261,117,344524.33,154441.94,498966.27
292990,202309,1402,1060,342,1401848.94,451440.77,1853289.71
293000,202309,122,86,36,113522.33,47520,161042.33
293010,202309,3323,1960,1363,2588646.77,1800511.23,4389158.00
293015,202309,657,540,117,712815.15,154440,867255.15
293020,202309,383,302,81,398654.41,106921.62,505576.03
293030,202309,586,525,61,693009.05,80520,773529.05
293040,202309,399,318,81,421081.8,106920.68,528002.48
293050,202309,3403,1989,1414,2625543.77,1866500.01,4492043.78
293060,202309,242,194,48,256092.5,63360.5,319453.0
293070,202309,4357,2173,2184,2869791.42,2885553.59,5755345.01
293075,202309,101,71,30,93720.99,39600,133320.99
293076,202309,95,72,23,95042.09,30360,125402.09
293077,202309,691,389,302,513501.63,398644.35,912145.98
293080,202309,447,395,52,521406.98,68640.66,590047.64
293090,202309,142,126,16,166320,21120,187440
293100,202309,591,396,195,522729.15,257400.62,780129.77
293105,202309,374,276,98,365642.21,129360,495002.21
293110,202309,122,79,43,104285.73,56762.95,161048.68
293120,202309,315,227,88,299646.41,116164.39,415810.80
293130,202309,266,175,91,231004.19,120120,351124.19
293135,202309,9105,3731,5374,4927687.47,7101618.29,12029305.76
293140,202309,213,127,86,167644.83,113520.79,281165.62
293150,202309,339,293,46,386768.24,60720.2,447488.44
293160,202309,448,287,161,378842.91,212520,591362.91
293170,202309,285,173,112,228364.79,147842.51,376207.30
293180,202309,659,456,203,601921.33,267960,869881.33
293190,202309,1503,1031,472,1360954.24,623047.56,1984001.80
293200,202309,633,546,87,720738.1,114840,835578.1
293210,202309,460,351,109,463329.61,143880,607209.61
293220,202309,2570,1170,1400,1544422.62,1850647.46,3395070.08
293230,202309,2018,757,1261,999260.47,1664523.6,2663784.07
293240,202309,245,219,26,289089.34,34320.2,323409.54
293245,202309,137,110,27,145202.01,35640,180842.01
293250,202309,831,364,467,481813.38,617771.85,1099585.23
293260,202309,351,273,78,360362.1,102960,463322.1
293270,202309,1238,561,677,740525.63,893640.1,1634165.73
293280,202309,337,231,106,304922.51,139921.42,444843.93
293290,202309,3347,2160,1187,2852599.96,1566852.08,4419452.04
293300,202309,975,670,305,884408.61,402600.24,1287008.85
293305,202309,206,157,49,207241.6,64680.65,271922.25
293310,202309,181,135,46,178201.22,60720.7,238921.92
293315,202309,193,147,46,194044.44,60721.07,254765.51
293317,202309,103,77,26,101640.2,34320,135960.2
293320,202309,1400,720,680,950460.85,897623.56,1848084.41
293325,202309,218,93,125,122760,165000,287760
293330,202309,16509,7750,8759,10235562.54,11573869.94,21809432.48
293340,202309,302,213,89,281161.4,117480,398641.4
293345,202309,282,238,44,314165.6,58080,372245.6
293350,202309,628,406,222,535930.35,293041.24,828971.59
293360,202309,1598,1120,478,1478435.31,632288.13,2110723.44
310010,202309,148,80,68,105600.77,89760.04,195360.81
310020,202309,1019,553,466,729976.85,615124.45,1345101.30
310030,202309,328,259,69,341884.58,91082.32,432966.90
310040,202309,55,36,19,47520,25080,72600
310050,202309,177,116,61,153120.21,80520,233640.21
310060,202309,303,222,81,293048.69,106920.67,399969.36
310070,202309,24,17,7,22440.21,9240.2,31680.41
310080,202309,53,36,17,47520,22440.83,69960.83
310090,202309,1205,672,533,887056.92,703564.66,1590621.58
310100,202309,415,288,127,380170.28,167642.11,547812.39
310110,202309,759,408,351,538568.41,463323.64,1001892.05
310120,202309,461,262,199,345840.71,262680.73,608521.44
310130,202309,43,22,21,29040.2,27720,56760.2
310140,202309,24,9,15,11880,19800.76,31680.76
310150,202309,1276,829,447,1094313.43,590050.83,1684364.26
310160,202309,2316,1142,1174,1507477.13,1552330.04,3059807.17
310163,202309,108,62,46,81840,60720,142560
310170,202309,2803,1364,1439,1800519.9,1899492.82,3700012.72
310180,202309,215,102,113,134641.44,149160,283801.44
310190,202309,525,345,180,455405.72,238921.54,694327.26
310200,202309,441,275,166,363003.04,219120,582123.04
310205,202309,91,64,27,84480.93,35640,120120.93
310210,202309,289,232,57,306241.93,75240,381481.93
310220,202309,69,46,23,60720.3,30360,91080.3
310230,202309,315,227,88,299643.27,116160,415803.27
310240,202309,137,110,27,145200,35640,180840
310250,202309,100,79,21,104282.56,27720,132002.56
310260,202309,816,439,377,580817.69,498963.57,1079781.26
310270,202309,311,205,106,270605.85,139920.14,410525.99
310280,202309,444,304,140,401282.73,186120,587402.73
310285,202309,216,168,48,221762.01,63360.21,285122.22
310290,202309,246,131,115,172922.33,151800,324722.33
310300,202309,198,160,38,211202.13,50160,261362.13
310310,202309,21,18,3,23760,3960,27720
310320,202309,31,12,19,15840.18,25080.97,40921.15
310330,202309,50,37,13,48840.24,17160.66,66000.90
310340,202309,2026,1454,572,1920632.02,755042.59,2675674.61
310350,202309,2999,1513,1486,1998549.27,1962848.52,3961397.79
310360,202309,55,42,13,55440.87,17160.14,72601.01
310370,202309,156,130,26,171600,34320,205920
310375,202309,113,42,71,55441.73,93721.87,149163.60
310380,202309,54,36,18,47520,23760,71280
310390,202309,109,68,41,89761.09,54120,143881.09
310400,202309,2824,1883,941,2485656.86,1242129.49,3727786.35
310410,202309,130,77,53,101640.82,69960,171600.82
310420,202309,740,388,352,512170.73,464642.59,976813.32
310430,202309,304,196,108,258721.18,142560,401281.18
310440,202309,83,56,27,73920.52,35640,109560.52
310445,202309,87,74,13,97680.71,17160,114840.71
310450,202309,707,474,233,625694.2,308881.29,934575.49
310460,202309,278,190,88,250803.42,116160.56,366963.98
310470,202309,579,372,207,491048.77,274561.82,765610.59
310480,202309,110,71,39,93720,51480,145200
310490,202309,642,315,327,417126.61,431641.11,848767.72
310500,202309,143,61,82,80521.45,108240,188761.45
310510,202309,655,462,193,609852.24,254760.91,864613.15
310520,202309,164,114,50,150482.44,66000,216482.44
310530,202309,137,59,78,77880.91,102960,180840.91
310540,202309,547,307,240,405249.22,316802.05,722051.27
310550,202309,83,56,27,73920.66,35640,109560.66
310560,202309,3499,2396,1103,3165449.43,1458605.54,4624054.97
310570,202309,130,85,45,112200,59400,171600
310590,202309,447,270,177,356408.57,233640.7,590049.27
310600,202309,156,72,84,95041.4,110880,205921.4
310610,202309,40,14,26,18480.73,34320,52800.73
310620,202309,57022,26979,30043,35635694.86,39695260.73,75330955.59
310630,202309,835,517,318,682456.8,421081.91,1103538.71
310640,202309,175,112,63,147840.2,83160.2,231000.4
310650,202309,187,168,19,221760.39,25080,246840.39
310660,202309,123,82,41,108240.2,54120,162360.2
310665,202309,76,53,23,69960,30360,100320
310670,202309,8363,3599,4764,4750842.81,6296426.88,11047269.69
310680,202309,66,45,21,59400,27720,87120
310690,202309,645,456,189,601930.24,249482.44,851412.68
310700,202309,62,38,24,50160.2,31680.97,81841.17
310710,202309,1387,941,446,1243457.34,590046.18,1833503.52
310720,202309,163,46,117,60720,155760,216480
310730,202309,1728,1163,565,1535217.05,747134.59,2282351.64
310740,202309,1103,596,507,786749.35,670566.48,1457315.83
310750,202309,270,175,95,231001.98,125400.37,356402.35
310760,202309,81,63,18,83162.7,23760,106922.7
310770,202309,83,40,43,52800.1,56760,109560.1
310780,202309,393,317,76,418446.44,101640.6,520087.04
310790,202309,136,107,29,141240.78,38280.59,179521.37
310800,202309,512,241,271,318121.98,357720,675841.98
310810,202309,191,126,65,166320.84,85800.59,252121.43
310820,202309,315,253,62,333966.72,81840.04,415806.76
310825,202309,208,176,32,232321.3,42240,274561.3
310830,202309,498,229,269,302282.04,355082.02,657364.06
310840,202309,405,255,150,337922.15,199320.83,537242.98
310850,202309,81,66,15,87120.95,19800,106920.95
310855,202309,486,387,99,510848.28,130680,641528.28
310860,202309,1750,1286,464,1697570.95,613809.96,2311380.91
310870,202309,68,57,11,75240.6,14520,89760.6
310880,202309,96,74,22,97680,29040,126720
310890,202309,316,183,133,241561.87,176880,418441.87
310900,202309,694,320,374,422407.37,493684.04,916091.41
310910,202309,258,171,87,225720.47,114840,340560.47
310920,202309,462,270,192,357730.43,253448.53,611178.96
310925,202309,43,35,8,46200.66,11880,58080.66
310930,202309,1469,1001,468,1321340.58,619085.58,1940426.16
310940,202309,751,363,388,479175.3,512165.21,991340.51
310945,202309,158,106,52,139920.42,68640,208560.42
310950,202309,225,178,47,236281.93,62040,298321.93
310960,202309,76,28,48,36961.44,63361.57,100323.01
310970,202309,181,105,76,138603.32,100320,238923.32
310980,202309,54,38,16,50166.43,21120,71286.43
310990,202309,171,93,78,122760.9,102960.45,225721.35
311000,202309,967,501,466,662650.9,616443.16,1279094.06
311010,202309,55,42,13,55440.94,17160,72600.94
311020,202309,48,32,16,42240.55,21120,63360.55
311030,202309,430,238,192,314162,257401.15,571563.15
311040,202309,37,30,7,39600,9240,48840
311050,202309,562,211,351,278520.84,464640.82,743161.66
311060,202309,903,491,412,648130.42,543844.42,1191974.84
311070,202309,379,173,206,228362.16,273240,501602.16
311080,202309,130,72,58,95040.95,76560.4,171601.35
311090,202309,382,191,191,252125.65,252120.86,504246.51
311100,202309,600,366,234,483125.32,310200.25,793325.57
311110,202309,733,518,215,683778.3,283805.97,967584.27
311115,202309,87,60,27,79200.58,35640.2,114840.78
311120,202309,1206,676,530,892346.67,699606.31,1591952.98
311130,202309,294,170,124,224406.64,163680,388086.64
311140,202309,174,99,75,130683.92,99002.18,229686.10
311150,202309,354,229,125,302285.53,165000,467285.53
311160,202309,831,582,249,768249.9,328681.07,1096930.97
311170,202309,105,85,20,112200.95,26400,138600.95
311180,202309,329,225,104,297007.8,138600.64,435608.44
311190,202309,39,18,21,23760,30360,54120
311200,202309,358,245,113,324722.07,149160.9,473882.97
311205,202309,41,33,8,43560,10560,54120
311210,202309,40,35,5,46200,6600,52800
311220,202309,33,30,3,39600,3960,43560
311230,202309,1796,1217,579,1606494.92,766928.21,2373423.13
311240,202309,97,65,32,85804.68,42240.5,128045.18
311250,202309,58,26,32,34320,42240,76560
311260,202309,568,345,223,459367.06,295680.14,755047.20
311265,202309,151,101,50,133321.68,66000,199321.68
311270,202309,298,200,98,264004.48,129361.59,393366.07
311280,202309,212,93,119,122761.4,157080,279841.4
311290,202309,118,101,17,133321.67,22440,155761.67
311300,202309,631,409,222,539889.96,293041.25,832931.21
311310,202309,19,16,3,21120,3960,25080
311320,202309,694,515,179,679813.9,236281.53,916095.43
311330,202309,1315,941,374,1243466.58,493691.02,1737157.60
311340,202309,2898,2026,872,2675703.08,1152365.44,3828068.52
311350,202309,276,210,66,277202.39,87120,364322.39
311360,202309,168,102,66,134641.85,87120,221761.85
311370,202309,1307,556,751,733950.14,991329.5,1725279.64
311380,202309,7,6,1,7920,1320,9240
311390,202309,267,156,111,205923.61,146520.2,352443.81
311400,202309,136,83,53,109560.8,71280,180840.8
311410,202309,141,69,72,91080.95,95040,186120.95
311420,202309,342,167,175,220445.13,231001.22,451446.35
311430,202309,931,613,318,809167.92,419760.51,1228928.43
311440,202309,506,338,168,446169.5,221761.87,667931.37
311450,202309,330,191,139,252122.19,183480,435602.19
311455,202309,281,190,91,250807.18,121441.74,372248.92
311460,202309,138,63,75,83160.3,99000,182160.3
311470,202309,36,17,19,22440,25080,47520
311480,202309,67,38,29,50160,38280,88440
311490,202309,12,6,6,7920,7920,15840
311500,202309,33,17,16,22440,21120,43560
311510,202309,873,599,274,792018.93,361680.74,1153699.67
311520,202309,40,34,6,44880,7920,52800
311530,202309,1987,1415,572,1867897.94,756363.78,2624261.72
311535,202309,72,44,28,58081.7,36960.52,95042.22
311540,202309,35,30,5,39600.16,6600,46200.16
311545,202309,195,138,57,182162.96,75240,257402.96
311547,202309,63,48,15,63360,19800.79,83160.79
311550,202309,771,357,414,471248.5,547801.61,1019050.11
311560,202309,44,26,18,34320.83,23760,58080.83
311570,202309,310,207,103,273243.08,135961.95,409205.03
311580,202309,465,304,161,401285.37,212520.74,613806.11
311590,202309,30,24,6,31680.95,7920,39600.95
311600,202309,96,76,20,100323.96,26400.93,126724.89
311610,202309,260,227,33,300961.8,43560.73,344522.53
311615,202309,202,172,30,227041.28,39600.52,266641.80
311620,202309,34,24,10,31680.9,13200,44880.9
311630,202309,125,110,15,145200.49,19800,165000.49
311640,202309,149,79,70,104281.74,92403.4,196685.14
311650,202309,146,98,48,129360,63360.2,192720.2
311660,202309,487,222,265,294363.02,349800.73,644163.75
311670,202309,166,118,48,155572.98,63360.43,218933.41
311680,202309,247,184,63,242880.9,83160.18,326041.08
311690,202309,14,13,1,17160.5,1320,18480.5
311700,202309,208,157,51,207242.44,67320.96,274563.40
311710,202309,189,127,62,167641.81,81840,249481.81
311720,202309,38,29,9,38280.89,11880,50160.89
311730,202309,619,437,182,578176.33,240241.15,818417.48
311740,202309,27,21,6,27720,7920,35640
311750,202309,768,521,247,690366.27,326040.93,1016407.20
311760,202309,85,38,47,50161.6,62040.11,112201.71
311770,202309,412,213,199,282482.97,262680.86,545163.83
311780,202309,242,130,112,171602.3,147840.89,319443.19
311783,202309,108,93,15,122760.7,19800,142560.7
311787,202309,54,23,31,30360,40920.83,71280.83
311790,202309,281,122,159,161041.2,209882.16,370923.36
311800,202309,851,500,351,662653.62,463323,1125976.62
311810,202309,62,45,17,59401.61,22440,81841.61
311820,202309,143,106,37,139923.36,48840.58,188763.94
311830,202309,2158,1237,921,1634201.93,1215722.72,2849924.65
311840,202309,1213,713,500,941169.47,660003.71,1601173.18
311850,202309,21,14,7,18480.28,9240.2,27720.48
311860,202309,11702,5053,6649,6674126.81,8787316.39,15461443.20
311870,202309,121,71,50,93723.31,67320.31,161043.62
311880,202309,1032,739,293,975506.58,386769.21,1362275.79
311890,202309,221,99,122,130573.91,161043.66,291617.57
311900,202309,70,30,40,39600,52800.15,92400.15
311910,202309,1518,946,572,1248743.82,755045.25,2003789.07
311920,202309,262,172,90,227042.02,120120.2,347162.22
311930,202309,1022,576,446,760333.03,588722.98,1349056.01
311940,202309,3030,1703,1327,2248027.8,1752963.07,4000990.87
311950,202309,187,109,78,143882.16,102961.05,246843.21
311960,202309,68,48,20,63360.13,26400,89760.13
311970,202309,28,15,13,19800,17160,36960
311980,202309,45,35,10,46200,13200,59400
311990,202309,42,27,15,35640.08,19800.64,55440.72
311995,202309,58,35,23,46200.7,30360.2,76560.9
312000,202309,22,17,5,22440,6600,29040
312010,202309,73,56,17,73921.07,22440.1,96361.17
312015,202309,94,64,30,84480.69,39600,124080.69
312020,202309,146,109,37,143880.25,48840,192720.25
312030,202309,83,63,20,83160,26400,109560
312040,202309,99,59,40,77880,52800,130680
312050,202309,208,124,84,163680.2,110880,274560.2
312060,202309,19,11,8,14520,10560,25080
312070,202309,87,58,29,76560.97,38280,114840.97
312080,202309,532,262,270,345843.46,356400.74,702244.20
312083,202309,90,58,32,76560.37,42240,118800.37
312087,202309,114,82,32,108241.12,42240,150481.12
312090,202309,3784,2334,1450,3080995.63,1915337.4,4996333.03
312100,202309,159,109,50,143883,66000.86,209883.86
312110,202309,140,83,57,109561.73,75241.03,184802.76
312120,202309,134,96,38,126722.07,50160,176882.07
312125,202309,89,60,29,79202.38,38280.88,117483.26
312130,202309,136,93,43,122761.47,56760,179521.47
312140,202309,163,122,41,161041.54,54120,215161.54
312150,202309,39,32,7,42240,9240,51480
312160,202309,1560,1022,538,1354462.04,714125.25,2068587.29
312170,202309,17,10,7,13200,9240,22440
312180,202309,90,66,24,87120,31680,118800
312190,202309,51,44,7,58080.96,9240,67320.96
312200,202309,795,673,122,888379.33,161041.76,1049421.09
312210,202309,143,77,66,101641.42,87120.48,188761.90
312220,202309,164,122,42,161041.88,55440,216481.88
312230,202309,4265,1864,2401,2461883.93,3173288.33,5635172.26
312235,202309,193,126,67,166320,88440,254760
312240,202309,92,69,23,91082.59,30360.93,121443.52
312245,202309,253,186,67,245525.8,88440.43,333966.23
312247,202309,86,63,23,83160.37,30360.38,113520.75
312250,202309,190,97,93,128042.97,124080,252122.97
312260,202309,115,74,41,97680,54120,151800
312270,202309,153,88,65,116161.87,85800,201961.87
312280,202309,32,15,17,19800,22440,42240
312290,202309,158,108,50,142563.76,66000.3,208564.06
312300,202309,216,142,74,187443.3,97681.64,285124.94
312310,202309,69,61,8,80520,10560,91080
312320,202309,458,279,179,368280.92,236280,604560.92
312330,202309,118,103,15,135960.8,19800.91,155761.71
312340,202309,34,17,17,22440,22440,44880
312350,202309,14,8,6,10560.82,7920,18480.82
312352,202309,97,70,27,92400.97,35640,128040.97
312360,202309,621,276,345,364327.2,455400.2,819727.4
312370,202309,425,242,183,319440.81,241560.89,561001.70
312380,202309,155,102,53,134647,69961.52,204608.52
312385,202309,191,151,40,199323.38,52801.08,252124.46
312390,202309,321,202,119,267962.35,157080,425042.35
312400,202309,415,316,99,417121.99,130680.07,547802.06
312410,202309,1390,518,872,683782.97,1152380.04,1836163.01
312420,202309,742,561,181,741849.65,238921.15,980770.80
312430,202309,916,660,256,871211.9,339241.97,1210453.87
312440,202309,62,47,15,62040,19800,81840
312450,202309,243,143,100,188760,132000,320760
312460,202309,40,17,23,22440,30360,52800
312470,202309,52,36,16,47520,21120,68640
312480,202309,165,104,61,137284.03,80521.19,217805.22
312490,202309,347,232,115,306248,151802.37,458050.37
312500,202309,36,26,10,34320.85,13200,47520.85
312510,202309,780,311,469,410530.24,620407.71,1030937.95
312520,202309,27,9,18,11880,23760,35640
312530,202309,40,28,12,36961.5,15840.1,52801.6
312540,202309,90,76,14,100320.53,18480,118800.53
312550,202309,34,27,7,35640,9240,44880
312560,202309,228,176,52,232322.11,68640,300962.11
312570,202309,539,326,213,430332.09,282482.82,712814.91
312580,202309,89,54,35,71280,46200,117480
312590,202309,227,177,50,234963.75,66000,300963.75
312595,202309,178,146,32,192721.02,42240,234961.02
312600,202309,72,33,39,43560,51480,95040
312610,202309,1698,908,790,1198587.51,1046762.27,2245349.78
312620,202309,247,182,65,240241.82,85800,326041.82
312630,202309,80,63,17,84480.26,22440,106920.26
312640,202309,52,16,36,21120,47520,68640
312650,202309,166,143,23,189205.74,30360.1,219565.84
312660,202309,113,79,34,104284.97,44880.39,149165.36
312670,202309,1017,640,377,844828.91,497643.68,1342472.59
312675,202309,50,38,12,50160,15840,66000
312680,202309,83,54,29,71280,38280,109560
312690,202309,298,154,144,203283.04,190080.8,393363.84
312695,202309,38,30,8,39600,10560,50160
312700,202309,278,158,120,208564.32,158400.64,366964.96
312705,202309,92,72,20,95040,26400,121440
312707,202309,134,94,40,124080.24,52800,176880.24
312710,202309,2039,1167,872,1540490.4,1152370.99,2692861.39
312720,202309,49,25,24,33000.56,31680,64680.56
312730,202309,307,179,128,236283.99,168962.42,405246.41
312733,202309,50,40,10,52800.7,13200,66000.7
312735,202309,22,16,6,21120.71,7920.3,29041.01
312737,202309,91,55,36,72600.93,47520,120120.93
312738,202309,91,54,37,71280.53,48840,120120.53
312740,202309,84,50,34,66000.06,44880,110880.06
312750,202309,144,98,46,129360.28,60720,190080.28
312760,202309,287,191,96,252124.4,126720.97,378845.37
312770,202309,10127,4926,5201,6507756.31,6874576.17,13382332.48
312780,202309,472,360,112,475209.11,147842.81,623051.92
312790,202309,22,17,5,22440,6600,29040
312800,202309,1804,1231,573,1626256.87,756363.2,2382620.07
312810,202309,381,267,114,352441,150480,502921
312820,202309,208,165,43,217801.79,56760,274561.79
312825,202309,48,35,13,46203.02,17160,63363.02
312830,202309,207,113,94,149161.94,124081.14,273243.08
312840,202309,217,150,67,198001.02,88440,286441.02
312850,202309,38,33,5,43561.57,6600,50161.57
312860,202309,162,107,55,141241.17,72600,213841.17
312870,202309,1356,714,642,943821.86,847440.12,1791261.98
312880,202309,136,103,33,135963.1,43560,179523.1
312890,202309,185,132,53,174243.84,69960,244203.84
312900,202309,161,123,38,162362.65,50160,212522.65
312910,202309,190,107,83,141245.49,109561.81,250807.30
312920,202309,120,70,50,92400.26,66000,158400.26
312930,202309,364,236,128,311523.98,168961.3,480485.28
312940,202309,169,114,55,150480.8,72600,223080.8
312950,202309,807,570,237,753740.9,314162.3,1067903.2
312960,202309,148,107,41,141247.82,54120.99,195368.81
312965,202309,122,97,25,128040.74,33000,161040.74
312970,202309,314,250,64,330009.54,84481.62,414491.16
312980,202309,3028,1576,1452,2080383.05,1919288.71,3999671.76
312990,202309,50,20,30,26400.9,39600,66000.9
313000,202309,57,32,25,42240,33000,75240
313005,202309,199,150,49,198000.94,64680.61,262681.55
313010,202309,1089,479,610,632293.29,805207.14,1437500.43
313020,202309,199,102,97,134640,128040,262680
313030,202309,228,153,75,201962.81,99000.76,300963.57
313040,202309,104,30,74,39600.73,97680,137280.73
313050,202309,231,170,61,224400,81840,306240
313055,202309,45,31,14,40920,18480,59400
313060,202309,157,112,45,147841.05,59400,207241.05
313065,202309,62,47,15,62040,19800,81840
313070,202309,123,65,58,85802.2,76560,162362.2
313080,202309,48,26,22,34320,29040,63360
313090,202309,749,491,258,648125.11,340560.52,988685.63
313100,202309,232,85,147,112200.2,194040,306240.2
313110,202309,172,95,77,125401.29,101642.13,227043.42
313115,202309,285,155,130,204602.02,171600.89,376202.91
313120,202309,946,542,404,715454.36,533283.44,1248737.80
313130,202309,6760,3760,3000,4967302.72,3962667.39,8929970.11
313140,202309,146,84,62,110883.07,81841.35,192724.42
313150,202309,314,247,67,326043.3,88440,414483.3
313160,202309,192,145,47,192724.55,62040,254764.55
313170,202309,1588,1004,584,1325325.35,772203.63,2097528.98
313180,202309,375,241,134,318124.83,176882.9,495007.73
313190,202309,832,473,359,624375.93,476523.26,1100899.19
313200,202309,37,30,7,39600.78,9240,48840.78
313210,202309,1074,912,162,1203894.38,213844.12,1417738.50
313220,202309,349,211,138,279840,183480,463320
313230,202309,326,253,73,335280.98,96360.03,431641.01
313240,202309,2529,1270,1259,1676441.75,1664520.83,3340962.58
313250,202309,1304,975,329,1287031.56,434284.1,1721315.66
313260,202309,105,52,53,68641.1,69960,138601.1
313270,202309,1140,683,457,902890.63,604564.41,1507455.04
313280,202309,48,37,11,48840,14520,63360
313290,202309,250,201,49,265327.1,64680,330007.1
313300,202309,358,175,183,231005.47,241560.58,472566.05
313310,202309,275,123,152,162362.17,200641,363003.17
313320,202309,425,313,112,413162.66,147840.07,561002.73
313330,202309,1554,974,580,1285708.83,765605.19,2051314.02
313340,202309,359,258,101,340565.74,133320.91,473886.65
313350,202309,467,292,175,386764.06,231000.24,617764.30
313360,202309,225,103,122,135960.2,161040,297000.2
313370,202309,251,93,158,122761.42,208560,331321.42
313375,202309,365,231,134,304925.85,176880.3,481806.15
313380,202309,1429,746,683,984747.47,904201.73,1888949.20
313390,202309,55,48,7,63360,9240,72600
313400,202309,432,307,125,405257.68,165002,570259.68
313410,202309,108,69,39,91080.7,51480,142560.7
313420,202309,5079,2948,2131,3891496.53,2816894.51,6708391.04
313430,202309,127,61,66,80520.31,87120.33,167640.64
313440,202309,1450,1034,416,1364939.12,549129.48,1914068.60
313450,202309,80,33,47,43560,62040.51,105600.51
313460,202309,431,193,238,254763.6,315481.61,570245.21
313470,202309,543,266,277,351132.75,365645.52,716778.27
313480,202309,172,132,40,175561.85,52800,228361.85
313490,202309,624,285,339,376214.59,447487.94,823702.53
313500,202309,33,19,14,25080,18480,43560
313505,202309,1167,885,282,1168239.11,372246.75,1540485.86
313507,202309,124,87,37,114841.17,48840,163681.17
313510,202309,3169,1939,1230,2559690.15,1624945.74,4184635.89
313520,202309,3640,2792,848,3685586.97,1119368.53,4804955.50
313530,202309,43,25,18,33000,23760.94,56760.94
313535,202309,104,84,20,110881.98,26400.5,137282.48
313540,202309,69,49,20,64680,26400,91080
313545,202309,139,119,20,157080.56,26400,183480.56
313550,202309,232,196,36,258723.11,47520.1,306243.21
313560,202309,375,182,193,240246.43,256085.31,496331.74
313570,202309,88,30,58,39600,76560.06,116160.06
313580,202309,1484,892,592,1178782.92,782765.25,1961548.17
313590,202309,88,57,31,75240.76,40921.3,116162.06
313600,202309,743,458,285,604566.44,376200.36,980766.80
313610,202309,72,57,15,75241.62,19800.35,95041.97
313620,202309,1668,811,857,1071878.42,1132564.19,2204442.61
313630,202309,1839,1393,446,1840120.51,590043.03,2430163.54
313640,202309,119,69,50,91081.61,66000.7,157082.31
313650,202309,256,136,120,179520.48,158401.76,337922.24
313652,202309,36,33,3,43560,3960,47520
313655,202309,106,72,34,95040.76,44880.31,139921.07
313657,202309,56,51,5,67321.57,6600,73921.57
313660,202309,161,108,53,142561.37,69960.14,212521.51
313665,202309,797,368,429,485775.85,567609.24,1053385.09
313670,202309,12529,8643,3886,11413212.7,5138799,16552011.7
313680,202309,49,37,12,48840.73,15840,64680.73
313690,202309,148,104,44,137281.02,58080,195361.02
313695,202309,91,71,20,93721.23,27720,121441.23
313700,202309,400,313,87,413165.62,114840.88,528006.50
313710,202309,127,89,38,117482.63,50160,167642.63
313720,202309,1299,605,694,798632.98,917409.7,1716042.68
313730,202309,80,47,33,62042.6,43560,105602.6
313740,202309,167,124,43,163680.66,56760,220440.66
313750,202309,433,303,130,399966.02,171600.79,571566.81
313753,202309,256,199,57,262684.31,75240.1,337924.41
313760,202309,1522,588,934,776178.02,1232892.15,2009070.17
313770,202309,468,314,154,414492.3,203282.87,617775.17
313780,202309,964,537,427,708846.92,563643.44,1272490.36
313790,202309,35,35,0,46200,,46200.0
313800,202309,173,108,65,142564.76,85801.72,228366.48
313810,202309,104,59,45,77880.81,59401.02,137281.83
313820,202309,1551,745,806,983423.53,1063921.22,2047344.75
313830,202309,59,38,21,50160.89,27720,77880.89
313835,202309,68,59,9,77880.2,11880,89760.2
313840,202309,1891,1153,738,1523328.26,974164.57,2497492.83
313850,202309,240,110,130,145203.43,171600.5,316803.93
313860,202309,525,392,133,518768.69,175560.64,694329.33
313862,202309,190,132,58,174245.19,76560,250805.19
313865,202309,198,138,60,182161.06,79200,261361.06
313867,202309,64,54,10,71280,13200.1,84480.1
313868,202309,61,38,23,50160.5,30360,80520.5
313870,202309,84,48,36,63360.2,47520,110880.2
313880,202309,413,256,157,337923.43,208560.69,546484.12
313890,202309,358,201,157,265324.55,207240.63,472565.18
313900,202309,896,490,406,648136.66,535929.12,1184065.78
313910,202309,151,101,50,133320.07,66000,199320.07
313920,202309,712,482,230,636243.6,303602.1,939845.7
313925,202309,38,32,6,42240,7920,50160
313930,202309,976,740,236,976838.08,311525.22,1288363.30
313940,202309,2193,1316,877,1738475.86,1162927.91,2901403.77
313950,202309,959,592,367,781453.87,484440.53,1265894.40
313960,202309,1604,922,682,1218381.08,900245.77,2118626.85
313970,202309,204,111,93,146520.1,122760,269280.1
313980,202309,268,167,101,220447.79,133321.06,353768.85
313990,202309,318,188,130,248160.85,172920,421080.85
314000,202309,966,626,340,827652.88,448805.43,1276458.31
314010,202309,122,79,43,104280.15,56760,161040.15
314015,202309,114,35,79,46200.31,104280.9,150481.21
314020,202309,63,41,22,54121.58,29040,83161.58
314030,202309,77,40,37,52800.43,48840,101640.43
314040,202309,50,26,24,34320,31680,66000
314050,202309,316,174,142,229685.74,187440,417125.74
314053,202309,102,65,37,85801.2,48840,134641.2
314055,202309,324,213,111,281166.17,147841.54,429007.71
314060,202309,133,115,18,151800.3,23760,175560.3
314070,202309,1168,582,586,768263.69,774852.51,1543116.20
314080,202309,231,138,93,182163.97,122761,304924.97
314085,202309,203,142,61,187441.15,80520,267961.15
314090,202309,450,325,125,429007.25,165000.16,594007.41
314100,202309,573,446,127,590058.15,167643.32,757701.47
314110,202309,835,358,477,473894.86,629643.41,1103538.27
314120,202309,71,43,28,56760,36960,93720
314130,202309,29,20,9,26400,11880,38280
314140,202309,1301,825,476,1090297.1,628323.9,1718621.0
314150,202309,210,135,75,178202.34,100320,278522.34
314160,202309,329,249,80,328683.15,105600.56,434283.71
314170,202309,93,69,24,91081.39,31680,122761.39
314180,202309,819,726,93,958350.7,122761.27,1081111.97
314190,202309,94,58,36,76560.67,47520,124080.67
314200,202309,569,397,172,525378.05,227046.32,752424.37
314210,202309,249,193,56,254766.57,73920,328686.57
314220,202309,333,235,98,310204.14,129361.84,439565.98
314225,202309,42,26,16,34320.5,21120,55440.5
314230,202309,134,59,75,77880.55,99000,176880.55
314240,202309,191,138,53,182161.96,69960,252121.96
314250,202309,60,38,22,50162.41,29040,79202.41
314260,202309,222,116,106,153121.76,139920,293041.76
314270,202309,439,340,99,448816.2,130680.5,579496.7
314280,202309,783,425,358,562270.17,473882.49,1036152.66
314290,202309,589,459,130,605887.38,171600.72,777488.10
314300,202309,347,264,83,348488.53,109560,458048.53
314310,202309,1420,983,437,1297598.55,576840.21,1874438.76
314315,202309,55,41,14,54120.25,18480,72600.25
314320,202309,638,449,189,592690.28,252121.88,844812.16
314330,202309,13114,6392,6722,8441768.21,8886288.29,17328056.50
314340,202309,726,326,400,430329.81,528004.58,958334.39
314345,202309,66,48,18,63360,23760,87120
314350,202309,189,116,73,153120.88,96360.66,249481.54
314360,202309,57,33,24,44882.56,31681.04,76563.60
314370,202309,80,57,23,75240,30360,105600
314380,202309,147,82,65,108240.54,85800,194040.54
314390,202309,3887,2514,1373,3321229.54,1813682.57,5134912.11
314400,202309,761,535,226,706215.2,298322.12,1004537.32
314410,202309,604,403,201,533293.31,265321.89,798615.20
314420,202309,28,18,10,23760,13200,36960
314430,202309,2626,1016,1610,1345113.69,2127870.4,3472984.09
314435,202309,160,96,64,126721.25,84480,211201.25
314437,202309,60,47,13,62040,17160,79200
314440,202309,109,69,40,91080.5,52800.1,143880.6
314450,202309,181,124,57,163681.34,75240.96,238922.30
314460,202309,658,329,329,434287.56,435603.13,869890.69
314465,202309,138,91,47,120120.61,62040,182160.61
314467,202309,78,62,16,81840,21120,102960
314470,202309,448,226,222,298322.96,293042.4,591365.36
314480,202309,1200,549,651,724694.51,860643.95,1585338.46
314490,202309,41,21,20,27720,26400,54120
314500,202309,290,193,97,254765.24,128040.45,382805.69
314505,202309,123,75,48,99001.16,63360,162361.16
314510,202309,268,218,50,287764.7,66000,353764.7
314520,202309,1556,791,765,1046794.94,1013771.5,2060566.44
314530,202309,831,660,171,871232.59,225724.22,1096956.81
314535,202309,198,127,71,167640,93720,261360
314537,202309,72,43,29,56760.97,38280.98,95041.95
314540,202309,23,14,9,18480,11880,30360
314545,202309,73,49,24,66000,31680,97680
314550,202309,89,50,39,66001.08,51481.83,117482.91
314560,202309,924,489,435,645492.84,574205.41,1219698.25
314570,202309,19,16,3,21121.15,3960,25081.15
314580,202309,11,5,6,6600,7920,14520
314585,202309,33,25,8,33000,10560.26,43560.26
314587,202309,82,68,14,91080,18480,109560
314590,202309,663,441,222,583455.86,293041.64,876497.50
314600,202309,1075,696,379,921397.62,500287.59,1421685.21
314610,202309,1084,560,524,739211.34,691685.98,1430897.32
314620,202309,164,124,40,163680.6,52800,216480.6
314625,202309,100,78,22,102961.01,29040,132001.01
314630,202309,1212,695,517,917425.38,682446.38,1599871.76
314640,202309,101,61,40,80521.65,52800,133321.65
314650,202309,161,96,65,126722.76,85800,212522.76
314655,202309,65,47,18,62040,23760,85800
314660,202309,21,17,4,22440,5280,27720
314670,202309,238,182,56,240251.93,73923.36,314175.29
314675,202309,230,143,87,188761.85,114840.23,303602.08
314690,202309,606,322,284,426366.95,374882.14,801249.09
314700,202309,2352,1257,1095,1659295.73,1448045.97,3107341.70
314710,202309,2043,1123,920,1482386.68,1214401.6,2696788.28
314720,202309,453,250,203,330005.89,269281.15,599287.04
314730,202309,565,296,269,390726.56,355081.98,745808.54
314740,202309,876,390,486,514811.54,644163.68,1158975.22
314750,202309,31,23,8,30360,10560,40920
314760,202309,386,153,233,203281.89,307560.88,510842.77
314770,202309,100,66,34,87121.39,44880,132001.39
314780,202309,17,7,10,9240,13200,22440
314790,202309,2776,1788,988,2362873.25,1308121.42,3670994.67
314795,202309,82,71,11,93720.2,14520,108240.2
314800,202309,3216,1901,1315,2510702.05,1735803.71,4246505.76
314810,202309,1651,952,699,1256660.47,922681.13,2179341.60
314820,202309,120,70,50,92400.89,66000,158400.89
314830,202309,238,205,33,270604.99,43560,314164.99
314840,202309,92,55,37,72600,48840,121440
314850,202309,470,228,242,301096.02,320760.05,621856.07
314860,202309,675,514,161,678484.82,213840.08,892324.90
314870,202309,1850,1016,834,1341153.44,1100894.95,2442048.39
314875,202309,69,62,7,81840,9240,91080
314880,202309,49,36,13,47520,17160,64680
314890,202309,58,29,29,38280,38280,76560
314900,202309,26,19,7,25081.1,9240.92,34322.02
314910,202309,247,167,80,220442.11,105600,326042.11
314915,202309,154,129,25,170282.23,33000.68,203282.91
314920,202309,86,56,30,73920.85,39600,113520.85
314930,202309,1179,527,652,695662.02,861961.57,1557623.59
314940,202309,37,30,7,39600,9240,48840
314950,202309,24,18,6,23761.1,7920,31681.1
314960,202309,32,19,13,25080.39,17160.18,42240.57
314970,202309,202,89,113,117481.84,149160.02,266641.86
314980,202309,341,222,119,294364.84,157080.75,451445.59
314990,202309,482,257,225,339246.3,297001.37,636247.67
314995,202309,161,75,86,99000.69,113520,212520.69
315000,202309,112,87,25,114840.49,33000.1,147840.59
315010,202309,42,26,16,34320,21120,55440
315015,202309,175,142,33,187440.4,43560,231000.4
315020,202309,71,59,12,77880.08,15840,93720.08
315030,202309,124,91,33,120120,43560,163680
315040,202309,95,56,39,73920.89,51480,125400.89
315050,202309,221,140,81,184800.37,106920.68,291721.05
315053,202309,76,54,22,71280,29040,100320
315057,202309,136,106,30,139920.65,39600,179520.65
315060,202309,64,54,10,71281.88,13200,84481.88
315070,202309,132,80,52,105602.55,68640,174242.55
315080,202309,425,340,85,448806.7,112201.34,561008.04
315090,202309,113,65,48,85801.39,63360,149161.39
315100,202309,109,54,55,71281.61,72600.38,143881.99
315110,202309,301,158,143,208563.71,188760,397323.71
315120,202309,2057,951,1106,1255369.13,1459945.8,2715314.93
315130,202309,386,271,115,359044.69,151800.42,510845.11
315140,202309,590,315,275,415811.14,363005.89,778817.03
315150,202309,1071,527,544,696981.65,718084.82,1415066.47
315160,202309,209,114,95,150486.27,125404.12,275890.39
315170,202309,310,198,112,261362.85,147840.8,409203.65
315180,202309,3566,1519,2047,2007778.91,2704695.98,4712474.89
315190,202309,309,188,121,248164.57,159720.25,407884.82
315200,202309,1342,828,514,1094309.32,679803.46,1774112.78
315210,202309,1956,1199,757,1585359.15,1000562.97,2585922.12
315213,202309,25,15,10,19801.63,13200,33001.63
315217,202309,242,189,53,249480.58,69960.55,319441.13
315220,202309,1735,1264,471,1668523.08,621728.8,2290251.88
315230,202309,210,162,48,213842.12,63360,277202.12
315240,202309,404,271,133,358081.3,175562.2,533643.5
315250,202309,2998,1441,1557,1902181.83,2059204.37,3961386.20
315260,202309,146,86,60,113520,79200.1,192720.1
315270,202309,167,117,50,154441.25,66000,220441.25
315280,202309,679,445,234,587425.22,310211.31,897636.53
315290,202309,209,134,75,176882.01,99000.11,275882.12
315300,202309,110,84,26,110880.01,34320,145200.01
315310,202309,96,84,12,112200,15840,128040
315320,202309,140,91,49,120123.48,64680,184803.48
315330,202309,64,53,11,69960,15840,85800
315340,202309,399,291,108,384125.06,142561.76,526686.82
315350,202309,181,115,66,151801.38,87120.34,238921.72
315360,202309,121,59,62,77880.15,81840.23,159720.38
315370,202309,63,42,21,55440.77,27720,83160.77
315380,202309,6,5,1,6600,1320,7920
315390,202309,75,27,48,35640,63361.55,99001.55
315400,202309,937,710,227,937216.83,299641.95,1236858.78
315410,202309,337,198,139,261373.58,183483.52,444857.10
315415,202309,61,45,16,59400.27,21120,80520.27
315420,202309,216,155,61,204602,80520,285122
315430,202309,668,367,301,484444.02,397320.38,881764.40
315440,202309,99,66,33,87120.2,43560,130680.2
315445,202309,251,209,42,275890.27,55440.37,331330.64
315450,202309,187,136,51,179520,67320,246840
315460,202309,5510,2561,2949,3383292.26,3898007.13,7281299.39
315470,202309,56,22,34,29040.9,44880,73920.9
315480,202309,95,32,63,42242.1,84482.39,126724.49
315490,202309,765,504,261,665288.9,347160.48,1012449.38
315500,202309,25,21,4,27720,5280,33000
315510,202309,171,123,48,162360.54,63360,225720.54
315520,202309,80,66,14,87120.36,18480,105600.36
315530,202309,51,29,22,38280,29040.2,67320.2
315540,202309,285,195,90,257404.73,118800.39,376205.12
315550,202309,203,162,41,215160.52,54120,269280.52
315560,202309,764,605,159,798618.11,209884.35,1008502.46
315570,202309,328,163,165,216484.41,217800.81,434285.22
315580,202309,812,559,253,737887.62,333960.96,1071848.58
315590,202309,206,101,105,134642.65,138600.63,273243.28
315600,202309,389,301,88,397323.99,116160.78,513484.77
315610,202309,110,53,57,69960,75240,145200
315620,202309,48,34,14,44882.37,18480,63362.37
315630,202309,142,109,33,143880.83,43560,187440.83
315640,202309,63,41,22,54120.98,29040,83160.98
315645,202309,58,40,18,52800,23760,76560
315650,202309,171,129,42,171600.28,55440,227040.28
315660,202309,461,221,240,291730.06,316804.79,608534.85
315670,202309,2700,1219,1481,1610461.44,1958902.32,3569363.76
315680,202309,803,591,212,780128.59,279840,1059968.59
315690,202309,746,498,248,658696.08,327362.6,986058.68
315700,202309,2197,1144,1053,1510123.07,1393947.61,2904070.68
315710,202309,398,141,257,186121.66,339241.09,525362.75
315720,202309,553,336,217,443526.86,287760.22,731287.08
315725,202309,221,174,47,229680.27,62040,291720.27
315727,202309,117,79,38,104283.35,50160,154443.35
315730,202309,61,54,7,71280,9240,80520
315733,202309,92,52,40,68640.2,52800,121440.2
315737,202309,51,40,11,52801.4,14520,67321.4
315740,202309,34,26,8,34320.35,10560,44880.35
315750,202309,180,127,53,167640.17,69960,237600.17
315760,202309,47,35,12,46200,15840,62040
315765,202309,148,87,61,114842.51,80522.2,195364.71
315770,202309,265,180,85,237602.3,112200.64,349802.94
315780,202309,4556,2231,2325,2945006.68,3072968.72,6017975.40
315790,202309,271,208,63,274564.24,83160.87,357725.11
315800,202309,352,230,122,303603.15,161040,464643.15
315810,202309,67,39,28,51480.6,36960,88440.6
315820,202309,818,618,200,817108.62,264004.08,1081112.70
315830,202309,131,90,41,118801.53,54120.39,172921.92
315840,202309,86,59,27,77880,35640.66,113520.66
315850,202309,281,184,97,242886.1,128040.8,370926.9
315860,202309,24,10,14,13200,18480,31680
315870,202309,41,32,9,42240.16,11880,54120.16
315880,202309,103,67,36,88440,47520,135960
315890,202309,114,81,33,106921.65,43560,150481.65
315895,202309,430,289,141,381497.61,186121.44,567619.05
315900,202309,94,44,50,58080,66000,124080
315910,202309,54,31,23,40920,30360,71280
315920,202309,166,110,56,145202.36,73920,219122.36
315930,202309,60,23,37,30362.51,48840.91,79203.42
315935,202309,139,109,30,143883.5,39600,183483.5
315940,202309,102,75,27,99000,35640,134640
315950,202309,47,35,12,46200,15840.35,62040.35
315960,202309,636,305,331,402610.14,436925.77,839535.91
315970,202309,38,31,7,40920.74,9240,50160.74
315980,202309,716,378,338,498972.48,447481.43,946453.91
315990,202309,272,153,119,201962.39,157080.27,359042.66
316000,202309,51,32,19,42240,25080,67320
316010,202309,107,92,15,121441.38,19800,141241.38
316020,202309,101,92,9,121440.49,11880,133320.49
316030,202309,389,231,158,304926.67,209882.19,514808.86
316040,202309,590,240,350,316803.63,462000.2,778803.83
316045,202309,59,53,6,69960,7920,77880
316050,202309,28,19,9,25080,11880,36960
316060,202309,113,81,32,106921.17,42240,149161.17
316070,202309,1361,921,440,1215753.92,583444.19,1799198.11
316080,202309,99,66,33,87236.76,43560,130796.76
316090,202309,43,21,22,27720,29040.26,56760.26
316095,202309,90,77,13,101642.05,17160.86,118802.91
316100,202309,383,209,174,275885.23,229680.32,505565.55
316105,202309,64,39,25,51480.51,33000,84480.51
316110,202309,1995,1520,475,2006444.17,629650.48,2636094.65
316120,202309,78,51,27,67320,35640,102960
316130,202309,129,93,36,122762.65,47520.21,170282.86
316140,202309,31,21,10,27720,13200,40920
316150,202309,256,182,74,240242.26,97680.33,337922.59
316160,202309,88,59,29,77881.27,38280.28,116161.55
316165,202309,77,46,31,60720.78,40920,101640.78
316170,202309,198,126,72,166320.05,95040,261360.05
316180,202309,241,95,146,125403.58,192721.65,318125.23
316190,202309,155,111,44,146521.39,58080,204601.39
316200,202309,745,414,331,546493.82,436921.26,983415.08
316210,202309,793,547,246,723608.12,326041.39,1049649.51
316220,202309,140,89,51,117481.79,67320,184801.79
316225,202309,45,28,17,36961.12,22440,59401.12
316230,202309,52,29,23,38280.91,30360,68640.91
316240,202309,719,565,154,745816.15,203284.37,949100.52
316245,202309,180,160,20,211203.05,26400.99,237604.04
316250,202309,1816,1190,626,1570850.98,826323.48,2397174.46
316255,202309,143,110,33,145200,43560.92,188760.92
316257,202309,188,93,95,122761.37,125401.46,248162.83
316260,202309,223,146,77,192722.18,101640,294362.18
316265,202309,41,30,11,39601.77,14520.67,54122.44
316270,202309,737,518,219,683771.29,289082.11,972853.40
316280,202309,632,406,226,535931.03,299641.2,835572.23
316290,202309,973,683,290,902903.68,382804.09,1285707.77
316292,202309,706,297,409,392046.87,539883.57,931930.44
316294,202309,114,72,42,95041.9,55440,150481.9
316295,202309,445,209,236,275886.31,311526.85,587413.16
316300,202309,44,27,17,35640,22440,58080
316310,202309,24,13,11,17160,14520,31680
316320,202309,77,33,44,43560.65,58080,101640.65
316330,202309,192,138,54,182160.88,71280,253440.88
316340,202309,150,99,51,130680,67320,198000
316350,202309,210,145,65,191400.59,85800.2,277200.79
316360,202309,31,18,13,23760,17160,40920
316370,202309,1468,719,749,951740.12,990005.14,1941745.26
316380,202309,132,104,28,137281.32,36960,174241.32
316390,202309,105,77,28,101640,36960,138600
316400,202309,194,145,49,191403.21,64680.36,256083.57
316410,202309,330,239,91,315481.38,120120.2,435601.58
316420,202309,237,156,81,205924.32,106921.35,312845.67
316430,202309,175,98,77,129360.46,101640,231000.46
316440,202309,84,46,38,60720.58,50160.08,110880.66
316443,202309,47,39,8,51480.24,10560,62040.24
316447,202309,53,44,9,58082.63,11880,69962.63
316450,202309,269,199,70,262680.2,92400,355080.2
316460,202309,52,17,35,22440.43,46200.34,68640.77
316470,202309,1949,1436,513,1898207.08,677160.43,2575367.51
316480,202309,10,7,3,9240,3960,13200
316490,202309,24,8,16,10560,21120,31680
316500,202309,186,121,65,159720.27,85800,245520.27
316510,202309,140,112,28,147841.15,36960,184801.15
316520,202309,194,104,90,137280.9,118800.67,256081.57
316530,202309,192,122,70,161041.21,92400,253441.21
316540,202309,177,94,83,124081.46,109560.65,233642.11
316550,202309,191,123,68,162362.3,91080,253442.3
316553,202309,552,283,269,373568.5,355081.23,728649.73
316555,202309,87,75,12,99000.8,15840,114840.8
316556,202309,19,13,6,17160.41,7920,25080.41
316557,202309,50,34,16,44881.01,21120,66001.01
316560,202309,75,53,22,69960.2,29040,99000.2
316570,202309,248,227,21,299641.47,27720,327361.47
316580,202309,30,19,11,25080,14520,39600
316590,202309,90,75,15,99000.82,19800.7,118801.52
316600,202309,179,148,31,195361.65,40920,236281.65
316610,202309,73,53,20,69960.2,26400,96360.2
316620,202309,169,120,49,158400,64680.85,223080.85
316630,202309,72,52,20,68640,26400,95040
316640,202309,23,13,10,17160,13200,30360
316650,202309,122,97,25,128040,33000,161040
316660,202309,6,2,4,2640,5280,7920
316670,202309,454,152,302,200644.38,399963.36,600607.74
316680,202309,187,143,44,188764.65,58080,246844.65
316690,202309,154,95,59,125400,77880,203280
316695,202309,61,49,12,64680,15840,80520
316700,202309,34,24,10,31680,13200,44880
316710,202309,875,662,213,873855.82,281163.4,1155019.22
316720,202309,5795,2681,3114,3539023.8,4111810.41,7650834.21
316730,202309,15,14,1,18480,1320,19800
316740,202309,179,111,68,146520.1,89760,236280.1
316750,202309,20,11,9,14520.32,11880,26400.32
316760,202309,376,293,83,386767.66,109560.79,496328.45
316770,202309,191,107,84,141241.59,110880,252121.59
316780,202309,72,41,31,54120,40920,95040
316790,202309,77,52,25,68640.2,33000.5,101640.7
316800,202309,1917,1160,757,1531235.7,1000577.66,2531813.36
316805,202309,37,24,13,31680.08,17160,48840.08
316810,202309,61,37,24,48841.3,31680.45,80521.75
316820,202309,43,25,18,33000,23760,56760
316830,202309,109,52,57,68640.36,75240.2,143880.56
316840,202309,537,331,206,436924.29,273242.12,710166.41
316850,202309,324,226,98,298323.26,129360,427683.26
316860,202309,7011,3223,3788,4257093.5,5008099.71,9265193.21
316870,202309,1963,1266,697,1673833.95,922687.22,2596521.17
316880,202309,171,86,85,113522.89,112201.44,225724.33
316890,202309,239,157,82,207242.33,108240.69,315483.02
316900,202309,471,331,140,436925.94,184800,621725.94
316905,202309,29,14,15,18480,19800,38280
316910,202309,93,38,55,51480,72600,124080
316920,202309,168,130,38,171605.56,50160,221765.56
316930,202309,2245,1144,1101,1511427.27,1455961.39,2967388.66
316935,202309,1062,621,441,819733.08,582128.33,1401861.41
316940,202309,1211,701,510,926662.98,673201.15,1599864.13
316950,202309,229,118,111,155761.77,146520,302281.77
316960,202309,1177,654,523,865946.1,690371.95,1556318.05
316970,202309,708,567,141,748462.92,186123.23,934586.15
316980,202309,91,49,42,64680,55440,120120
316990,202309,2532,1729,803,2284974.63,1061284.04,3346258.67
317000,202309,364,281,83,370929.77,109561.84,480491.61
317005,202309,237,167,70,220445.43,92400.9,312846.33
317010,202309,7715,4433,3282,5855708.07,4333614.59,10189322.66
317020,202309,17245,7616,9629,10061445.18,12719613.94,22781059.12
317030,202309,107,50,57,66000,75240,141240
317040,202309,3346,2215,1131,2923877.84,1494248.88,4418126.72
317043,202309,82,63,19,83166.75,25081.27,108248.02
317047,202309,45,29,16,38280,21120,59400
317050,202309,170,136,34,179523.08,44880,224403.08
317052,202309,168,138,30,182161.4,39600,221761.4
317057,202309,201,153,48,201963.4,63360,265323.4
317060,202309,66,39,27,51480,35640.8,87120.8
317065,202309,55,43,12,56760,15840,72600
317070,202309,2178,1010,1168,1334566.21,1544401.36,2878967.57
317075,202309,104,59,45,77880.15,59400,137280.15
317080,202309,1035,529,506,698311.11,669242.12,1367553.23
317090,202309,781,601,180,793337.07,237603.63,1030940.70
317100,202309,495,370,125,488407.1,165000.95,653408.05
317103,202309,144,116,28,153122.83,36960,190082.83
317107,202309,60,46,14,62040,18480,80520
317110,202309,81,46,35,60720.2,46201.36,106921.56
317115,202309,53,47,6,62102.04,7920,70022.04
317120,202309,2416,1216,1200,1605183.01,1585331.55,3190514.56
317130,202309,2335,1606,729,2119945.44,962283.59,3082229.03
317140,202309,17,12,5,15841.2,6600,22441.2
317150,202309,314,186,128,245523.76,168960.98,414484.74
317160,202309,387,284,103,374883.86,135960.98,510844.84
317170,202309,256,166,90,219121.56,118800.6,337922.16
317180,202309,449,308,141,406563.81,186122.1,592685.91
317190,202309,264,192,72,253441.18,95040,348481.18
317200,202309,979,696,283,918757.66,373568.86,1292326.52
317210,202309,195,100,95,132005.52,125400.21,257405.73
317220,202309,27,14,13,18480,17160,35640
320010,202309,606,431,175,568939.49,231007.12,799946.61
320013,202309,152,97,55,128043.78,72602.33,200646.11
320016,202309,284,173,111,228364.61,146520,374884.61
320020,202309,835,495,340,654742.5,448809.59,1103552.09
320030,202309,194,136,58,179522.34,79201.62,258723.96
320035,202309,151,100,51,132000.2,67320.19,199320.39
320040,202309,523,262,261,345850.95,345849.31,691700.26
320050,202309,148,99,49,130688.34,64681.05,195369.39
320060,202309,2146,1008,1138,1333251.45,1504821.63,2838073.08
320070,202309,125,79,46,104280.25,60720,165000.25
320080,202309,908,507,401,671903.53,529326.7,1201230.23
320090,202309,1488,948,540,1251394.23,712813.84,1964208.07
320100,202309,411,230,181,303608.5,238922.4,542530.9
320110,202309,155,98,57,129368.65,75240.6,204609.25
320115,202309,129,109,20,145204.99,26400,171604.99
320120,202309,4366,2316,2050,3058546.92,2706041.45,5764588.37
320130,202309,9364,3989,5375,5270961.64,7100393.52,12371355.16
320140,202309,599,386,213,509544.74,281168.59,790713.33
320150,202309,2458,1352,1106,1784715.71,1459934.21,3244649.92
320160,202309,736,309,427,407890.26,563643.09,971533.35
320170,202309,122,98,24,129362.44,31680,161042.44
320180,202309,62,36,26,47521.07,34320,81841.07
320190,202309,287,167,120,220446.73,158400.1,378846.83
320200,202309,69,57,12,75242.51,15840,91082.51
320210,202309,1019,551,468,727340.51,617767.23,1345107.74
320220,202309,316,109,207,143880.5,275880.2,419760.7
320225,202309,96,78,18,102960.39,23760.2,126720.59
320230,202309,837,536,301,708871.46,397327.06,1106198.52
320240,202309,4018,1783,2235,2356281.56,2950233.59,5306515.15
320245,202309,602,409,193,539892.83,254766.86,794659.69
320250,202309,260,126,134,166326.88,176882.55,343209.43
320255,202309,135,103,32,135962.76,43560.43,179523.19
320260,202309,345,177,168,233641.82,221762.09,455403.91
320265,202309,156,120,36,158401.47,47520.06,205921.53
320270,202309,167,125,42,165002.76,55441.35,220444.11
320280,202309,1604,918,686,1211803.6,905537.84,2117341.44
320290,202309,75,58,17,76560.9,22440,99000.9
320300,202309,703,484,219,638902.81,289082.8,927985.61
320305,202309,853,482,371,636264.55,489732.5,1125997.05
320310,202309,236,145,91,191404.77,120120.9,311525.67
320313,202309,429,182,247,240249.81,326041.46,566291.27
320316,202309,114,86,28,113522.33,36960.3,150482.63
320320,202309,3901,1778,2123,2348354.35,2802395.83,5150750.18
320330,202309,329,236,93,311521.78,122760,434281.78
320332,202309,904,546,358,720762.21,472572.48,1193334.69
320334,202309,320,174,146,229681.96,194041.3,423723.26
320335,202309,168,110,58,145205.29,76562.21,221767.50
320340,202309,660,470,190,620430.49,252126.86,872557.35
320350,202309,1235,506,729,667946.88,962294.8,1630241.68
320360,202309,190,86,104,113521,137280,250801
320370,202309,263,195,68,257406.23,89760.69,347166.92
320380,202309,378,269,109,355089.47,143880.89,498970.36
320390,202309,1292,750,542,990030.74,716768.83,1706799.57
320400,202309,365,251,114,331336.91,150480.84,481817.75
320405,202309,1083,431,652,568947.43,863296.94,1432244.37
320410,202309,1040,505,535,667938.03,710166.19,1378104.22
320420,202309,687,312,375,411858.14,496334.36,908192.50
320425,202309,235,124,111,163682.73,146520.2,310202.93
320430,202309,461,250,211,330013.9,278529.61,608543.51
320435,202309,216,145,71,191402.16,93721.61,285123.77
320440,202309,239,136,103,179525,135963.64,315488.64
320450,202309,150,77,73,101642.33,96361.06,198003.39
320455,202309,264,204,60,270605.01,79200.66,349805.67
320460,202309,373,222,151,293043.47,199320.21,492363.68
320465,202309,136,92,44,121446.35,58080.33,179526.68
320470,202309,849,502,347,663991.05,458051.35,1122042.40
320480,202309,265,173,92,228368.63,121440.02,349808.65
320490,202309,3729,1786,1943,2357608.87,2566138.28,4923747.15
320495,202309,141,84,57,110880.75,75240,186120.75
320500,202309,12285,6017,6268,7948058.22,8281799.89,16229858.11
320501,202309,623,321,302,423737.72,399970.98,823708.70
320503,202309,368,262,106,345846.25,139921.08,485767.33
320506,202309,319,214,105,283803.59,138600.38,422403.97
320510,202309,1449,632,817,834267.22,1079776.66,1914043.88
320515,202309,99,77,22,101642.62,29040,130682.62
320517,202309,264,190,74,250807.32,97680.52,348487.84
320520,202309,9510,3997,5513,5278849.13,7287832.48,12566681.61
320530,202309,8521,4047,4474,5346155.18,5911024.7,11257179.88
330010,202309,4186,2002,2184,2644061.5,2884232.82,5528294.32
330015,202309,240,103,137,135961.44,180840.56,316802.00
330020,202309,4877,1811,3066,2390593.64,4051116.54,6441710.18
330022,202309,302,150,152,198005.64,200640.35,398645.99
330023,202309,1029,281,748,370926.77,988690.13,1359616.90
330025,202309,1180,200,980,264002.87,1296129.06,1560131.93
330030,202309,2195,1322,873,1746436.46,1152375.33,2898811.79
330040,202309,3146,1597,1549,2109428.53,2044708.43,4154136.96
330045,202309,12427,4076,8351,5385778.31,11040630.04,16426408.35
330050,202309,1038,617,421,814461.03,555725.61,1370186.64
330060,202309,1505,869,636,1148453.87,843490.43,1991944.30
330070,202309,5350,1799,3551,2374760.74,4692649.62,7067410.36
330080,202309,1891,809,1082,1069241.15,1428258.65,2497499.80
330090,202309,437,242,195,320768.75,257401.25,578170.00
330093,202309,262,113,149,149161.59,196681.48,345843.07
330095,202309,78,43,35,56760.9,46200,102960.9
330100,202309,13210,6548,6662,8646364.14,8807176.87,17453541.01
330110,202309,553,249,304,328686.89,401285.85,729972.74
330115,202309,579,287,292,378849.79,385442.15,764291.94
330120,202309,477,239,238,315486.51,314161.6,629648.11
330130,202309,1820,508,1312,670590.92,1733194.81,2403785.73
330140,202309,830,421,409,555729.22,539882.21,1095611.43
330150,202309,599,370,229,489731.97,302283.39,792015.36
330160,202309,170,109,61,143888.43,80521.85,224410.28
330170,202309,31866,11418,20448,15084225.71,27022124.19,42106349.90
330180,202309,298,158,140,208562.24,184802.32,393364.56
330185,202309,1448,586,862,773546.18,1137858.1,1911404.28
330187,202309,778,216,562,285129.69,741844.68,1026974.37
330190,202309,7446,2848,4598,3763444.32,6070744.83,9834189.15
330200,202309,5416,1896,3520,2504125.18,4649123.94,7153249.12
330205,202309,558,305,253,402612.72,335283.51,737896.23
330210,202309,1022,607,415,802584.63,547804.68,1350389.31
330220,202309,3220,1876,1344,2476425.57,1776747,4253172.57
330225,202309,746,348,398,460686.19,525362.34,986048.53
330227,202309,2602,932,1670,1230291.08,2205779.18,3436070.26
330230,202309,264,140,124,184804.63,163683.27,348487.90
330240,202309,5282,2450,2832,3234124.8,3743578.63,6977703.43
330245,202309,196,91,105,120122.42,138600.86,258723.28
330250,202309,7836,3727,4109,4922472.83,5434516.72,10356989.55
330260,202309,981,295,686,389406.08,905524.38,1294930.46
330270,202309,4866,1548,3318,2044790.09,4382473.45,6427263.54
330280,202309,527,311,216,411857.44,285128.02,696985.46
330285,202309,7345,2397,4948,3165507.14,6539415.39,9704922.53
330290,202309,905,304,601,401294.28,793325.11,1194619.39
330300,202309,832,503,329,666119.28,434288.1,1100407.38
330310,202309,546,317,229,418451.44,303601.53,722052.97
330320,202309,9096,3000,6096,3965464.65,8052104.44,12017569.09
330330,202309,12225,4049,8176,5344852.23,10804322.33,16149174.56
330340,202309,3261,1761,1500,2329855.84,1982658.39,4312514.23
330350,202309,24308,8774,15534,11586124.6,20527669.85,32113794.45
330360,202309,2072,968,1104,1277819.5,1458630.05,2736449.55
330370,202309,1114,594,520,784106.09,686410.77,1470516.86
330380,202309,1233,504,729,665298.42,963612.02,1628910.44
330385,202309,775,374,401,493688.84,529324.06,1023012.90
330390,202309,7480,3916,3564,5175993.91,4711205.42,9887199.33
330395,202309,486,313,173,413173.18,228365.12,641538.30
330400,202309,789,401,388,530660.9,512163.46,1042824.36
330410,202309,589,422,167,557058.25,221764.47,778822.72
330411,202309,430,229,201,302282.83,266640,568922.83
330412,202309,260,126,134,166323.59,176880.92,343204.51
330414,202309,6606,2503,4103,3304096.03,5421293.96,8725389.99
330415,202309,722,309,413,409212.13,545164.38,954376.51
330420,202309,2955,1468,1487,1939134.08,1965491.69,3904625.77
330430,202309,2029,856,1173,1132587.07,1548375.16,2680962.23
330440,202309,471,230,241,303605.84,318121.68,621727.52
330450,202309,145,66,79,87120.66,104280.34,191401.00
330452,202309,3000,1196,1804,1578776.97,2382623.27,3961400.24
330455,202309,152714,54681,98033,72230057.32,129531142.77,201761200.09
330460,202309,296,141,155,186121.75,204600.4,390722.15
330470,202309,1436,765,671,1009826.94,887049.91,1896876.85
330475,202309,2171,675,1496,892335.05,1974733.66,2867068.71
330480,202309,899,498,401,658700.19,530646.29,1189346.48
330490,202309,20154,6223,13931,8220018.47,18399680.49,26619698.96
330500,202309,1894,825,1069,1089025.15,1411090.06,2500115.21
330510,202309,13158,4721,8437,6241208.74,11150180.61,17391389.35
330513,202309,108,58,50,76560.45,66000,142560.45
330515,202309,736,328,408,432969.68,539894.23,972863.91
330520,202309,2968,1006,1962,1329293.79,2591195.9,3920489.69
330530,202309,204,118,86,155764.04,113520.1,269284.14
330540,202309,410,206,204,271923.92,269283.81,541207.73
330550,202309,3249,1086,2163,1434870.99,2863108.25,4297979.24
330555,202309,1388,500,888,660012.34,1174802.76,1834815.10
330560,202309,897,321,576,423732.43,761647.26,1185379.69
330570,202309,393,268,125,353764.25,165000.09,518764.34
330575,202309,1054,382,672,504254.73,887054.61,1391309.34
330580,202309,4058,2129,1929,2810357.81,2550270.94,5360628.75
330590,202309,273,146,127,192724.5,167641.74,360366.24
330600,202309,1724,1012,712,1335885.16,943810.45,2279695.61
330610,202309,1841,935,906,1234233.11,1195926.41,2430159.52
330615,202309,262,206,56,271923.75,73922.26,345846.01
330620,202309,1085,472,613,623065.11,810492.71,1433557.82
330630,202309,5648,3208,2440,4236032.55,3222163.65,7458196.20
350010,202309,636,409,227,539903.56,299643.16,839546.72
350020,202309,62,22,40,29042.06,54120,83162.06
350030,202309,639,366,273,483145.97,363006.92,846152.89
350040,202309,120,51,69,67322.18,91081.26,158403.44
350050,202309,417,190,227,250805.22,300963.01,551768.23
350055,202309,152,65,87,85803.24,114840.21,200643.45
350060,202309,88,39,49,51482.06,64681.01,116163.07
350070,202309,887,486,401,641555.36,529334.44,1170889.80
350075,202309,92,53,39,69962.47,51480,121442.47
350080,202309,70,33,37,43560.82,48840.2,92401.02
350090,202309,87,46,41,60722.33,54120,114842.33
350100,202309,310,199,111,262684.23,146520,409204.23
350110,202309,47,32,15,42242.2,19800,62042.2
350115,202309,205,104,101,137284.71,133320.37,270605.08
350120,202309,123,79,44,104283.24,58080.97,162364.21
350130,202309,466,200,266,264017.07,351127.72,615144.79
350140,202309,42,26,16,34320.64,21120,55440.64
350150,202309,84,58,26,76561.59,34320.15,110881.74
350160,202309,2686,1066,1620,1407157.94,2139730.02,3546887.96
350170,202309,473,273,200,360371.81,265323.85,625695.66
350180,202309,175,93,82,122762.59,108240.2,231002.79
350190,202309,1087,585,502,772240.24,665281.99,1437522.23
350200,202309,64,27,37,35642.05,48840,84482.05
350210,202309,1455,761,694,1005883.95,916101.92,1921985.87
350220,202309,672,531,141,700941.7,186122.47,887064.17
350230,202309,75,47,28,62040.67,36960.9,99001.57
350240,202309,61,39,22,51480.65,29041.25,80521.90
350250,202309,1201,518,683,683789.62,905532.21,1589321.83
350260,202309,116,82,34,108244.3,44880.87,153125.17
350270,202309,1081,703,378,927965.99,498962.63,1426928.62
350275,202309,378,141,237,188762.37,312843.88,501606.25
350280,202309,4870,2291,2579,3026893.12,3406938.19,6433831.31
350290,202309,556,236,320,312845.42,422401.73,735247.15
350300,202309,55,31,24,40923.45,31680,72603.45
350310,202309,86,50,36,66001.43,47520.59,113522.02
350315,202309,18,13,5,17160,6600,23760
350320,202309,3748,1744,2004,2302189.09,2650587.51,4952776.60
350330,202309,1828,882,946,1164280.26,1251364.34,2415644.60
350335,202309,25,17,8,22440.12,10560,33000.12
350340,202309,134,53,81,69961.61,106923.67,176885.28
350350,202309,100,47,53,62040,69960,132000
350360,202309,116,77,39,101644.28,51480.54,153124.82
350370,202309,93,53,40,69962.02,52800.48,122762.50
350380,202309,993,439,554,579498.5,732605.53,1312104.03
350390,202309,2063,773,1290,1020384.72,1702818.64,2723203.36
350395,202309,21,15,6,19800,7920,27720
350400,202309,1974,925,1049,1221040.91,1384681.04,2605721.95
350410,202309,3541,1386,2155,1829579.79,2845944.06,4675523.85
350420,202309,318,185,133,244204.23,175561.28,419765.51
350430,202309,113,58,55,77883.69,72602.22,150485.91
350440,202309,153,108,45,142568.76,59400.35,201969.11
350450,202309,1936,1043,893,1379455.47,1178761.87,2558217.34
350460,202309,481,168,313,221769.19,413168.22,634937.41
350470,202309,22,11,11,14520,14520,29040
350480,202309,222,114,108,150487.42,142560.68,293048.10
350490,202309,266,126,140,166323.1,184800.76,351123.86
350500,202309,65,20,45,26400,59400,85800
350510,202309,158,89,69,117483.32,91080.37,208563.69
350520,202309,496,266,230,351142.14,303609.7,654751.84
350530,202309,563,269,294,355095.19,388093.25,743188.44
350535,202309,106,68,38,89760.9,50160.56,139921.46
350540,202309,359,189,170,249486.05,224406.96,473893.01
350550,202309,3086,1698,1388,2245424.59,1832168,4077592.59
350560,202309,647,436,211,576860.12,278523.5,855383.62
350570,202309,5167,2122,3045,2801134.51,4023388.34,6824522.85
350580,202309,415,201,214,265329.07,282485.62,547814.69
350590,202309,1129,585,544,772227.54,718224.88,1490452.42
350600,202309,7264,3272,3992,4320572.57,5276083.74,9596656.31
350610,202309,1700,888,812,1172203.36,1075806.76,2248010.12
350620,202309,24,14,10,18480,13200,31680
350630,202309,279,139,140,183482.49,186122.28,369604.77
350635,202309,1553,670,883,885750.64,1165579.15,2051329.79
350640,202309,138,93,45,122761.31,59400.7,182162.01
350650,202309,2119,1378,741,1823004.15,979445.18,2802449.33
350660,202309,884,340,544,448807.51,718088.02,1166895.53
350670,202309,325,163,162,215162.51,213840.1,429002.61
350680,202309,168,88,80,116164.92,105600.92,221765.84
350690,202309,232,104,128,137281.82,168960,306241.82
350700,202309,1123,542,581,715466.54,766927.02,1482393.56
350710,202309,480,168,312,221767.56,413165.48,634933.04
350715,202309,62,47,15,62041.35,19800,81841.35
350720,202309,16,11,5,14521,6600,21121
350730,202309,53,32,21,42242.55,27720.61,69963.16
350740,202309,271,151,120,199323.67,159721.78,359045.45
350745,202309,35,16,19,21121.49,25080.75,46202.24
350750,202309,2917,1689,1228,2229558.97,1620973.43,3850532.40
350760,202309,4488,1850,2638,2444711.24,3490105.87,5934817.11
350770,202309,65,40,25,52800.5,33000,85800.5
350775,202309,74,55,19,72605.85,25081.33,97687.18
350780,202309,522,256,266,339252.97,351122.7,690375.67
350790,202309,394,161,233,212524.48,307564.85,520089.33
350800,202309,595,347,248,458047.2,327361.59,785408.79
350810,202309,554,414,140,546507.86,184800.39,731308.25
350820,202309,99,54,45,71281.35,59400,130681.35
350830,202309,90,46,44,60720.67,58080,118800.67
350840,202309,933,368,565,485774.4,747248.22,1233022.62
350850,202309,2098,1060,1038,1399245.19,1370169.87,2769415.06
350860,202309,792,400,392,528021.74,517452.88,1045474.62
350870,202309,504,347,157,458049.97,207240.56,665290.53
350880,202309,317,163,154,215166.77,203283.31,418450.08
350890,202309,43,24,19,31680,25080.08,56760.08
350900,202309,1836,620,1216,818424.14,1606466.8,2424890.94
350910,202309,27,14,13,18480,17160.36,35640.36
350920,202309,925,463,462,611173.29,611160.3,1222333.59
350925,202309,1298,635,663,839560.96,876497.92,1716058.88
350930,202309,147,81,66,106923.64,87120.28,194043.92
350940,202309,820,415,405,547825.13,534614.92,1082440.05
350945,202309,134,90,44,118802.54,58080.17,176882.71
350950,202309,20686,9606,11080,12696114.08,14660018.17,27356132.25
350960,202309,2002,799,1203,1056018.59,1587977.47,2643996.06
350970,202309,1216,569,647,752290.8,854054.09,1606344.89
350980,202309,108,71,37,93723.66,48840,142563.66
350990,202309,454,168,286,221761.88,377521.09,599282.97
350995,202309,51,21,30,27720.8,39600.84,67321.64
351000,202309,656,414,242,546502.23,319448.66,865950.89
351010,202309,52,34,18,44883.1,23760,68643.1
351015,202309,48,26,22,34320.17,29040,63360.17
351020,202309,1626,974,652,1287040.62,861968.71,2149009.33
351030,202309,374,207,167,273244.19,220440.32,493684.51
351040,202309,1177,659,518,871227.23,686403.3,1557630.53
351050,202309,4247,1894,2353,2501523.58,3108633.55,5610157.13
351060,202309,7147,2577,4570,3401759.14,6039022.97,9440782.11
351070,202309,445,277,168,365654.08,221766.84,587420.92
351080,202309,889,661,228,873867.66,300963.51,1174831.17
351090,202309,51,25,26,33001.46,34320.41,67321.87
351100,202309,462,242,220,319463.91,291730.91,611194.82
351110,202309,2340,1069,1271,1412453.72,1679043.61,3091497.33
351120,202309,70,33,37,43561.46,48840,92401.46
351130,202309,198,65,133,85802.98,175563.85,261366.83
351140,202309,345,205,140,270609.25,184802.49,455411.74
351150,202309,560,281,279,370927.58,369602.64,740530.22
351160,202309,387,209,178,275886.19,234960.72,510846.91
351170,202309,270,157,113,207243.61,149160.05,356403.66
351190,202309,109,66,43,87121.31,58080,145201.31
351200,202309,365,234,131,308889.38,172921.73,481811.11
351210,202309,145,68,77,89762.95,101640.78,191403.73
351220,202309,651,364,287,480497.02,378841.2,859338.22
351230,202309,360,223,137,294366.09,180840.6,475206.69
351240,202309,270,137,133,180843.09,176882.93,357726.02
351250,202309,95,66,29,87131.15,38280.1,125411.25
351260,202309,162,112,50,147843.12,66000.5,213843.62
351270,202309,55,24,31,31681.51,40920,72601.51
351280,202309,1170,576,594,761662.33,785408.99,1547071.32
351290,202309,273,128,145,168962.16,191400.7,360362.86
351300,202309,4772,1966,2806,2595197.13,3710566.48,6305763.61
351310,202309,796,387,409,510869.34,541214.21,1052083.55
351320,202309,130,74,56,97680.99,73920.6,171601.59
351330,202309,44,28,16,36960,21120,58080
351340,202309,1680,891,789,1177472.63,1042806.14,2220278.77
351350,202309,2753,1619,1134,2138502.54,1498208.65,3636711.19
351360,202309,876,401,475,530648.78,627004.67,1157653.45
351370,202309,494,241,253,318130,333960.15,652090.15
351380,202309,9694,4259,5435,5624672.62,7187433.96,12812106.58
351385,202309,26,19,7,25082.31,9240,34322.31
351390,202309,304,222,82,293046,108240.4,401286.4
351400,202309,59,38,21,51480.72,27720,79200.72
351410,202309,531,306,225,403934.51,297002.32,700936.83
351420,202309,85,59,26,77880.72,34320,112200.72
351430,202309,78,42,36,55441.25,47520.2,102961.45
351440,202309,936,604,332,797314.16,438245.52,1235559.68
351450,202309,324,161,163,212523.65,215164.7,427688.35
351460,202309,146,61,85,80524.77,112201.29,192726.06
351470,202309,146,76,70,101644.84,92400.89,194045.73
351480,202309,502,289,213,381484.15,281160.2,662644.35
351490,202309,338,131,207,172922.45,273240.72,446163.17
351492,202309,28,17,11,22440.63,14520,36960.63
351495,202309,30,21,9,27720.65,11880,39600.65
351500,202309,3792,1494,2298,1973441.94,3034699.36,5008141.30
351510,202309,2440,866,1574,1144476.67,2079016.91,3223493.58
351512,202309,16,10,6,13200,7920,21120
351515,202309,228,131,97,172925.56,129360,302285.56
351518,202309,734,430,304,567630.77,401303.26,968934.03
351519,202309,85,49,36,64681.79,47520,112201.79
351520,202309,184,114,70,150484.73,92401.02,242885.75
351530,202309,29,15,14,19800,18480,38280
351535,202309,147,88,59,116164,79200.5,195364.5
351540,202309,533,330,203,435616.59,267965.33,703581.92
351550,202309,1803,1047,756,1382084.66,997925.94,2380010.60
351560,202309,92,49,43,64682.16,56760,121442.16
351565,202309,15,8,7,10560.32,9240,19800.32
351570,202309,3254,1427,1827,1883709.18,2412980.09,4296689.27
351580,202309,39,35,4,46200.4,5280,51480.4
351590,202309,69,40,29,52801.34,38280.86,91082.20
351600,202309,183,131,52,172927.2,68640.76,241567.96
351610,202309,63,25,38,33001.15,50160,83161.15
351620,202309,6765,3530,3235,4661113.48,4274196.88,8935310.36
351630,202309,3830,1779,2051,2349675.41,2707344.83,5057020.24
351640,202309,3006,1282,1724,1692284.87,2279650.58,3971935.45
351650,202309,42,31,11,40921.03,14520,55441.03
351660,202309,147,90,57,118800.35,76560,195360.35
351670,202309,835,466,369,615144.48,487088.53,1102233.01
351680,202309,99,67,32,88440.9,42240,130680.9
351685,202309,19,13,6,17160.13,7920,25080.13
351690,202309,326,203,123,267968.2,162361.42,430329.62
351700,202309,189,131,58,173215.42,76560.51,249775.93
351710,202309,64,42,22,55442.27,29040,84482.27
351720,202309,132,73,59,96361.93,77880,174241.93
351730,202309,130,87,43,114840.58,56760,171600.58
351740,202309,861,527,334,695678.29,440886.68,1136564.97
351750,202309,423,173,250,228366.9,330001.6,558368.5
351760,202309,744,576,168,761551.24,221760.34,983311.58
351770,202309,337,266,71,351138.73,93720.56,444859.29
351780,202309,156,95,61,125402.38,80520,205922.38
351790,202309,295,141,154,186126.28,203283.24,389409.52
351800,202309,50,32,18,42240.16,23760,66000.16
351810,202309,128,80,48,105607.4,63361.32,168968.72
351820,202309,792,558,234,736606.91,308885.21,1045492.12
351830,202309,766,237,529,314170.74,698287.81,1012458.55
351840,202309,2582,1136,1446,1502204.89,1911365.39,3413570.28
351850,202309,288,195,93,257409.21,122760,380169.21
351860,202309,659,439,220,582149.99,290403.02,872553.01
351870,202309,6730,2962,3768,3912646.23,4979147.51,8891793.74
351880,202309,26334,10015,16319,13233349.29,21556943.64,34790292.93
351885,202309,119,63,56,83162.41,73920.3,157082.71
351890,202309,85,56,29,73921.27,38280,112201.27
351900,202309,264,132,132,174247.71,174240.95,348488.66
351905,202309,116,57,59,75241.61,77880.24,153121.85
351907,202309,4285,1726,2559,2278398.69,3380546.75,5658945.44
351910,202309,173,76,97,100325.72,128041.18,228366.90
351920,202309,125,65,60,85800,79200,165000
351925,202309,99,58,41,76563.14,54121.51,130684.65
351930,202309,523,316,207,417142.15,273246.85,690389.00
351940,202309,259,106,153,139923.29,201961.07,341884.36
351950,202309,156,81,75,106922.09,100323.62,207245.71
351960,202309,1089,528,561,698308.39,740539.5,1438847.89
351970,202309,2428,1121,1307,1479747.03,1726578.82,3206325.85
351980,202309,168,73,95,96363.76,125402.09,221765.85
351990,202309,261,161,100,212524.47,132000.63,344525.10
352000,202309,284,190,94,250816.01,125404.1,376220.11
352010,202309,485,310,175,409307.48,231011.59,640319.07
352020,202309,230,73,157,96360,207240,303600
352030,202309,1341,611,730,806546.38,964933,1771479.38
352040,202309,797,309,488,407886.85,645485.99,1053372.84
352042,202309,392,97,295,128043.28,389402.19,517445.47
352044,202309,396,210,186,277214.3,248167.33,525381.63
352050,202309,3683,1340,2343,1770165.28,3094095.64,4864260.92
352060,202309,112,63,49,83160.18,64680.92,147841.10
352070,202309,115,73,42,96365.35,55440,151805.35
352080,202309,72,43,29,56762.45,38280.48,95042.93
352090,202309,209,126,83,166323.06,109561.17,275884.23
352100,202309,355,172,183,227046.04,241561.73,468607.77
352110,202309,115,31,84,40920.51,110880,151800.51
352115,202309,72,28,44,36960,58080.2,95040.2
352120,202309,78,51,27,67320,35640,102960
352130,202309,250,185,65,244212.82,87120.57,331333.39
352140,202309,215,109,106,145202.68,139922.39,285125.07
352150,202309,141,74,67,97681.84,88441.88,186123.72
352160,202309,145,97,48,128044.36,63360.54,191404.90
352170,202309,475,311,164,410523.96,216480.08,627004.04
352180,202309,778,455,323,600622.67,426366.03,1026988.70
352190,202309,259,107,152,141245.99,200641.72,341887.71
352200,202309,33,15,18,19800.84,23760.1,43560.94
352210,202309,5161,2003,3158,2648041.42,4176505.55,6824546.97
352215,202309,82,40,42,52800.2,55440,108240.2
352220,202309,6670,2469,4201,3261826.5,5553295,8815121.5
352230,202309,4081,2511,1570,3314659.17,2073727.48,5388386.65
352240,202309,3109,1717,1392,2266507.49,1838777.35,4105284.84
352250,202309,4379,1916,2463,2529192.72,3253807.91,5783000.63
352260,202309,1148,596,552,786741.26,731290.99,1518032.25
352265,202309,78,46,32,60720,42240,102960
352270,202309,435,231,204,304945.1,269286.12,574231.22
352280,202309,563,332,231,439571.12,306240,745811.12
352290,202309,195,108,87,142566.62,114842.01,257408.63
352300,202309,106,61,45,80524.76,59400.77,139925.53
352310,202309,9115,3947,5168,5212874.92,6825731.67,12038606.59
352320,202309,1278,656,622,867260.07,821047.09,1688307.16
352330,202309,576,296,280,392043.72,369600.65,761644.37
352340,202309,1542,692,850,913468.2,1124645.06,2038113.26
352350,202309,415,229,186,303605.59,245523.01,549128.60
352360,202309,239,103,136,135962.23,179520.7,315482.93
352370,202309,139,85,54,112204.25,71282.08,183486.33
352380,202309,127,93,34,122764.09,44881.39,167645.48
352390,202309,2901,1197,1704,1582734.9,2250607.06,3833341.96
352400,202309,624,268,356,353764.17,469922.73,823686.90
352410,202309,1030,676,354,893682.37,467298.65,1360981.02
352420,202309,98,73,25,96361.05,33000,129361.05
352430,202309,1891,812,1079,1073213.22,1425627.81,2498841.03
352440,202309,3990,1708,2282,2257282.42,3014892.3,5272174.72
352450,202309,198,151,47,199325.21,62041.27,261366.48
352460,202309,711,356,355,469927.98,469925.07,939853.05
352470,202309,752,289,463,381496.04,612484.03,993980.07
352480,202309,1807,1012,795,1335880.95,1050737.47,2386618.42
352490,202309,67,30,37,39600.14,48840.16,88440.30
352500,202309,1757,684,1073,904218.35,1416367.09,2320585.44
352510,202309,809,418,391,551786.42,517444.25,1069230.67
352520,202309,994,435,559,574216.51,737891.66,1312108.17
352530,202309,2181,1067,1114,1409822.86,1473129.04,2882951.90
352540,202309,74,51,23,67323.59,30360,97683.59
352550,202309,239,131,108,172920.99,142560,315480.99
352560,202309,56,40,16,52800.87,21120,73920.87
352570,202309,867,414,453,549150.28,599295.51,1148445.79
352580,202309,55,41,14,54122.16,18480,72602.16
352585,202309,17,5,12,6600.15,15840.95,22441.10
352590,202309,5053,2443,2610,3224880.67,3449182.54,6674063.21
352600,202309,410,277,133,365653.2,175567.41,541220.61
352610,202309,986,420,566,554412.87,747124.75,1301537.62
352620,202309,1279,473,806,624372.06,1065250.14,1689622.20
352630,202309,204,76,128,100320.3,168960.08,269280.38
352640,202309,563,352,211,464665.66,278523.48,743189.14
352650,202309,97,65,32,85802.61,42240,128042.61
352660,202309,74,38,36,50161.14,47520,97681.14
352670,202309,1937,1018,919,1343832.68,1214401.52,2558234.20
352680,202309,1069,615,454,811829.99,599300.41,1411130.40
352690,202309,5236,2266,2970,2992555.13,3925707.02,6918262.15
352700,202309,103,56,47,73923.03,62041.38,135964.41
352710,202309,1676,859,817,1133929.26,1079762.39,2213691.65
352720,202309,1821,746,1075,984758.84,1424307.3,2409066.14
352725,202309,32,24,8,31681.29,10560,42241.29
352730,202309,465,224,241,297009.43,318123.49,615132.92
352740,202309,411,263,148,347177.43,195362.67,542540.10
352750,202309,25,16,9,21121.65,11880,33001.65
352760,202309,264,168,96,221765.61,126720.97,348486.58
352770,202309,83,60,23,79201.08,30360,109561.08
352780,202309,77,41,36,54120,47520.78,101640.78
352790,202309,29,19,10,25082.57,13200.18,38282.75
352800,202309,262,197,65,260048.06,85801.68,345849.74
352810,202309,161,104,57,137282.94,75242.86,212525.80
352820,202309,44,34,10,44880.89,13200,58080.89
352830,202309,78,49,29,64681.64,38280.01,102961.65
352840,202309,796,336,460,443539.77,609847.57,1053387.34
352850,202309,2138,628,1510,828975.9,1993210.25,2822186.15
352860,202309,135,84,51,110882.39,67320.12,178202.51
352870,202309,57,36,21,47526.59,27720.82,75247.41
352880,202309,200,111,89,146524.82,117481.88,264006.70
352885,202309,38,25,13,33000.32,17160,50160.32
352890,202309,63,39,24,51480.98,31680,83160.98
352900,202309,5061,2355,2706,3114004,3574575.42,6688579.42
352910,202309,39,30,9,39600.88,11880,51480.88
352920,202309,695,391,304,516139.99,401285.12,917425.11
352930,202309,1293,591,702,781472.22,927963.74,1709435.96
352940,202309,7159,2690,4469,3553524.66,5905737.76,9459262.42
352950,202309,143,70,73,92402.61,97682.88,190085.49
352960,202309,74,49,25,66000.93,33000,99000.93
352965,202309,18,11,7,14520,9240,23760
352970,202309,597,426,171,562341.7,227045.69,789387.39
352980,202309,168,98,70,129367.54,92401.37,221768.91
352990,202309,1043,478,565,632306.75,747131.72,1379438.47
353000,202309,64,32,32,43560.17,42240.98,85801.15
353010,202309,558,331,227,436937.32,302283.02,739220.34
353020,202309,373,241,132,318129.19,174243.69,492372.88
353030,202309,1506,675,831,891033.86,1096941.35,1987975.21
353040,202309,101,51,50,67321.35,66001.03,133322.38
353050,202309,1485,967,518,1276502.75,683762.93,1960265.68
353060,202309,10361,4493,5868,5933631,7749775.87,13683406.87
353070,202309,2236,1282,954,1694949.09,1268287.78,2963236.87
353080,202309,1419,747,672,986081.3,889682.37,1875763.67
353090,202309,77,42,35,55441.83,46200,101641.83
353100,202309,46,35,11,46201.94,14521.54,60723.48
353110,202309,2594,871,1723,1152420.13,2277070.13,3429490.26
353120,202309,152,87,65,114840.48,85800.56,200641.04
353130,202309,933,441,492,584783.98,650763.21,1235547.19
353140,202309,629,288,341,380181.66,452766.56,832948.22
353150,202309,346,176,170,232326.86,224402.97,456729.83
353160,202309,108,81,27,106924.95,35640,142564.95
353170,202309,213,73,140,96361.84,184800.51,281162.35
353180,202309,1463,667,796,883098.38,1052052.81,1935151.19
353190,202309,545,385,160,509542.59,211203.15,720745.74
353200,202309,313,149,164,198004,216481.41,414485.41
353205,202309,24,16,8,21120,10560,31680
353210,202309,80,46,34,60721.8,46200.17,106921.97
353215,202309,49,29,20,38280.2,26400,64680.2
353220,202309,90,49,41,64681.46,54120.68,118802.14
353230,202309,170,77,93,101641.72,122760,224401.72
353240,202309,456,194,262,256081.95,345840.28,601922.23
353250,202309,194,100,94,132002.87,124081.19,256084.06
353260,202309,509,320,189,422416.85,249486.38,671903.23
353270,202309,75,57,18,75243.01,23760,99003.01
353280,202309,127,56,71,73924.29,93724.79,167649.08
353282,202309,136,92,44,121441.57,58080,179521.57
353284,202309,31,24,7,31682.16,9240,40922.16
353286,202309,10,4,6,5280.2,7920,13200.2
353290,202309,86,48,38,63361.09,50160,113521.09
353300,202309,480,231,249,304935.03,328688.52,633623.55
353310,202309,42,32,10,42241.21,13200.95,55442.16
353320,202309,48,25,23,33000.81,30360.2,63361.01
353325,202309,50,26,24,34321.96,31680,66001.96
353330,202309,62,41,21,54120.1,27720.05,81840.15
353340,202309,786,297,489,392050.53,646806.61,1038857.14
353350,202309,1044,512,532,675863.51,702254.96,1378118.47
353360,202309,111,89,22,117482.13,29040.87,146523.00
353370,202309,114,62,52,81842.45,68640.38,150482.83
353380,202309,29,14,15,18480.2,19800,38280.2
353390,202309,1238,582,656,768273.15,869894.03,1638167.18
353400,202309,60,33,27,43561.78,35641.05,79202.83
353410,202309,132,68,64,89764.25,84480.69,174244.94
353420,202309,70,33,37,43560,48840,92400
353430,202309,617,399,218,526705.51,289088.31,815793.82
353440,202309,15198,6689,8509,8833646.49,11243812.77,20077459.26
353450,202309,55,26,29,34320.8,38280.2,72601.0
353460,202309,730,373,357,492379.97,471249.23,963629.20
353470,202309,2521,1188,1333,1570867.79,1763529.28,3334397.07
353475,202309,304,186,118,245524.88,155760.91,401285.79
353480,202309,251,183,68,241564.44,89760,331324.44
353490,202309,237,137,100,180846.93,132000.22,312847.15
353500,202309,230,125,105,166323.18,138601.03,304924.21
353510,202309,86,54,32,71281.87,42240.14,113522.01
353520,202309,276,195,81,257403.68,106920,364323.68
353530,202309,531,261,270,344533.73,357724.57,702258.30
353540,202309,404,253,151,333977.37,199325.21,533302.58
353550,202309,828,507,321,669286.71,425052.27,1094338.98
353560,202309,590,239,351,315481.77,463322,778803.77
353570,202309,64,44,20,58082.31,26400,84482.31
353580,202309,413,246,167,324725.66,220440,545165.66
353590,202309,104,76,28,100322.44,36960,137282.44
353600,202309,307,179,128,236288.04,168960.19,405248.23
353610,202309,157,89,68,117481.28,89760,207241.28
353620,202309,729,353,376,465973.1,496328.31,962301.41
353625,202309,68,35,33,46201.34,43560.16,89761.50
353630,202309,244,167,77,220446.74,101640.78,322087.52
353640,202309,149,90,59,118805.75,77880.26,196686.01
353650,202309,1210,471,739,621733.65,978128.49,1599862.14
353657,202309,28,22,6,29040,7920,36960
353660,202309,323,167,156,220443.88,205923.54,426367.42
353670,202309,804,449,355,592701.08,468605.32,1061306.40
353680,202309,153,95,58,125400.58,76560,201960.58
353690,202309,48,31,17,40920.83,22441.09,63361.92
353700,202309,318,214,104,282487.35,137281.88,419769.23
353710,202309,616,294,322,389417.2,425042.86,814460.06
353715,202309,43,23,20,30360,26400,56760
353720,202309,340,156,184,205926.48,242883.67,448810.15
353730,202309,1282,735,547,970250.38,722042.57,1692292.95
353740,202309,644,346,298,456738.37,393368.45,850106.82
353750,202309,105,57,48,75242.42,63360,138602.42
353760,202309,3737,1462,2275,1929923.28,3004361.9,4934285.18
353770,202309,81,63,18,83160.4,23760.2,106920.6
353780,202309,1556,704,852,929301.2,1125968.05,2055269.25
353790,202309,565,325,240,429016.69,316807.49,745824.18
353800,202309,4348,1947,2401,2571485.24,3173287.49,5744772.73
353810,202309,247,122,125,161051.24,165000.84,326052.08
353820,202309,311,128,183,168961.63,242881.01,411842.64
353830,202309,80,65,15,85802.25,19800.9,105603.15
353850,202309,223,97,126,128045.39,166321.46,294366.85
353860,202309,596,270,326,356408.89,430323.9,786732.79
353870,202309,6611,3351,3260,4427409.21,4307186.79,8734596.00
353880,202309,810,520,290,687748.75,382803.48,1070552.23
353890,202309,658,371,287,489742.05,378844.64,868586.69
353900,202309,149,77,72,101643.53,95042.39,196685.92
353910,202309,222,95,127,125402.83,167640.35,293043.18
353920,202309,527,263,264,347169.16,348483.96,695653.12
353930,202309,1179,681,498,900274.5,657363.23,1557637.73
353940,202309,221,108,113,142562.26,150481.94,293044.20
353950,202309,560,361,199,479178.21,262683.7,741861.91
353960,202309,82,65,17,85803.34,22440,108243.34
353970,202309,39,24,15,31680.34,19801.56,51481.90
353980,202309,2343,999,1344,1320041.16,1776739.13,3096780.29
353990,202309,91,56,35,73923.49,47520.61,121444.10
354000,202309,417,183,234,241568.79,308882.7,550451.49
354010,202309,91,52,39,68643.13,51480,120123.13
354020,202309,576,352,224,465974.64,295684.87,761659.51
354025,202309,47,38,9,50161.59,11880,62041.59
354030,202309,48,24,24,31682.49,31680.15,63362.64
354040,202309,101,77,24,101643.97,31680,133323.97
354050,202309,170,88,82,116161.92,108241.28,224403.20
354060,202309,932,439,493,579490.62,652082.5,1231573.12
354070,202309,1013,566,447,748461.8,590047.36,1338509.16
354075,202309,223,101,122,133323.43,161042.24,294365.67
354080,202309,326,147,179,194046.98,236281.89,430328.87
354085,202309,28,17,11,22441.46,14520,36961.46
354090,202309,299,170,129,225613.43,170281.35,395894.78
354100,202309,7150,2886,4264,3810978.36,5633834.6,9444812.96
354105,202309,112,61,51,80522.58,67320,147842.58
354110,202309,47,22,25,29040,33000.2,62040.2
354120,202309,172,102,70,134645.45,92400.97,227046.42
354130,202309,888,553,335,731307.74,442201.64,1173509.38
354140,202309,3804,1723,2081,2275779.83,2749575.81,5025355.64
354150,202309,723,416,307,550469.21,405246.33,955715.54
354160,202309,737,437,300,576873.86,396007.8,972881.66
354165,202309,15,9,6,11880,7920,19800
354170,202309,204,134,70,178206.1,93720.53,271926.63
354180,202309,55,33,22,43560.4,29040.57,72600.97
354190,202309,307,107,200,142563.35,264001.51,406564.86
354200,202309,125,62,63,81842.51,83162.12,165004.63
354210,202309,85,42,43,55440,56760,112200
354220,202309,654,393,261,518785.11,344526.24,863311.35
354230,202309,187,84,103,110882.31,135960.62,246842.93
354240,202309,378,225,153,297013.82,201960.72,498974.54
354250,202309,80,45,35,59400.5,46200,105600.5
354260,202309,2352,1069,1283,1411121.88,1693586.32,3104708.20
354270,202309,105,76,29,100322.23,38280.5,138602.73
354280,202309,61,33,28,43560,36960,80520
354290,202309,167,110,57,145207.19,75240,220447.19
354300,202309,345,244,101,323407.89,133321.64,456729.53
354310,202309,101,69,32,91085.08,42240.6,133325.68
354320,202309,243,114,129,150481.84,170280,320761.84
354323,202309,11,8,3,10560,3960,14520
354325,202309,135,75,60,99001.67,79200.42,178202.09
354330,202309,2706,912,1794,1203888.7,2370726.93,3574615.63
354340,202309,12006,5362,6644,7088395.74,8783344.51,15871740.25
354350,202309,171,112,59,147841.12,77880,225721.12
354360,202309,75,45,30,59401.78,39601.05,99002.83
354370,202309,262,129,133,171604.35,176881.56,348485.91
354380,202309,195,110,85,145204,112200,257404
354390,202309,3153,1131,2022,1494288.19,2671705.94,4165994.13
354400,202309,421,228,193,300965.02,254760.59,555725.61
354410,202309,803,350,453,463336.47,597968.75,1061305.22
354420,202309,310,205,105,270609.2,138602.91,409212.11
354425,202309,372,203,169,268030.03,223083.39,491113.42
354430,202309,138,82,56,108246.34,73920.29,182166.63
354440,202309,29,22,7,29040.92,9240,38280.92
354450,202309,59,41,18,54121.34,23760,77881.34
354460,202309,100,54,46,71285.75,60721.99,132007.74
354470,202309,14,8,6,10560.63,7920.76,18481.39
354480,202309,128,67,61,88440.55,80520.56,168961.11
354490,202309,129,77,52,101645.53,68642.33,170287.86
354500,202309,449,189,260,249483.46,344521.38,594004.84
354510,202309,88,62,26,81844.15,34321.13,116165.28
354515,202309,52,17,35,22441.57,46200.1,68641.67
354520,202309,1863,750,1113,989850.72,1470481.16,2460331.88
354530,202309,964,469,495,619094,657362.72,1276456.72
354540,202309,260,125,135,165005.99,178201.65,343207.64
354550,202309,45,26,19,34320.59,25080,59400.59
354560,202309,179,97,82,128041.94,108240,236281.94
354570,202309,155,102,53,134640.58,69960,204600.58
354580,202309,2119,987,1132,1304194.52,1494246.06,2798440.58
354600,202309,323,148,175,195368.16,232320.5,427688.66
354610,202309,67,54,13,71280.99,17160.82,88441.81
354620,202309,87,27,60,35640,80520.2,116160.2
354625,202309,21,14,7,18482.16,9240.72,27722.88
354630,202309,407,275,132,363018.83,174243.29,537262.12
354640,202309,929,539,390,711745.27,514806.34,1226551.61
354650,202309,70,44,26,58081.12,34320,92401.12
354660,202309,936,673,263,888408.77,347162.75,1235571.52
354670,202309,251,97,154,128040.97,203280.2,331321.17
354680,202309,1531,542,989,715457.13,1308126.38,2023583.51
354690,202309,80,49,31,66002.23,40920,106922.23
354700,202309,83,58,25,76560,33000,109560
354710,202309,49,33,16,43560.3,21120,64680.3
354720,202309,23,20,3,26400.35,3960,30360.35
354730,202309,2131,853,1278,1125988.48,1689616.32,2815604.80
354740,202309,77,55,22,72600.66,29040,101640.66
354750,202309,449,247,202,326048.43,267962.58,594011.01
354760,202309,587,371,216,491074.61,285127.1,776201.71
354765,202309,7,3,4,3960,5280,9240
354770,202309,388,244,144,322091.92,190082.21,512174.13
354780,202309,9826,3556,6270,4699319.29,8286997.94,12986317.23
354790,202309,97,52,45,68640.82,59401.38,128042.20
354800,202309,481,254,227,335356.17,299645.27,635001.44
354805,202309,82,42,40,55441.21,54120.27,109561.48
354810,202309,106,55,51,72601.41,67320,139921.41
354820,202309,239,100,139,132002.41,183483.34,315485.75
354830,202309,48,27,21,35640,27720,63360
354840,202309,58,37,21,48840.07,27720,76560.07
354850,202309,6165,2468,3697,3260532.99,4893289.1,8153822.09
354860,202309,384,166,218,219120.82,287762.24,506883.06
354870,202309,14434,6261,8173,8267391.89,10796347.51,19063739.40
354880,202309,3059,1132,1927,1495601.45,2545043.44,4040644.89
354890,202309,3553,1879,1674,2480404.37,2211014.98,4691419.35
354900,202309,63,44,19,58080.83,25080.19,83161.02
354910,202309,1472,739,733,976834.88,971520.96,1948355.84
354920,202309,36,31,5,40920.6,6600,47520.6
354925,202309,26,17,9,22440.4,11880,34320.4
354930,202309,41,32,9,42241.97,11880,54121.97
354940,202309,840,584,256,770914.53,337926.58,1108841.11
354950,202309,211,128,83,168964.44,110882.14,279846.58
354960,202309,130,45,85,60721.87,112200.75,172922.62
354970,202309,1375,976,399,1288370.52,526681.92,1815052.44
354980,202309,10897,3973,6924,5247201.14,9147667.3,14394868.44
354990,202309,12292,5405,6887,7138751.36,9098809.36,16237560.72
354995,202309,668,228,440,300963.66,580807.9,881771.56
355000,202309,466,158,308,208562.75,407880.7,616443.45
355010,202309,758,470,288,620440.69,380166.11,1000606.80
355020,202309,903,542,361,715459.49,476527.43,1191986.92
355030,202309,250161,92122,158039,121684246.08,208809062.21,330493308.29
355040,202309,1189,583,606,772226.38,803891.16,1576117.54
355050,202309,180,99,81,130681.92,108240,238921.92
355060,202309,2106,966,1140,1275181.87,1504806.76,2779988.63
355070,202309,1895,804,1091,1062629.21,1440138.55,2502767.76
355080,202309,225,131,94,172923.06,124081.83,297004.89
355090,202309,344,209,135,275892.65,179522.86,455415.51
355100,202309,6505,2974,3531,3925740,4664922.12,8590662.12
355110,202309,228,148,80,195362.8,105601.08,300963.88
355120,202309,48,30,18,39600.54,23760,63360.54
355130,202309,64,37,27,48840.72,35640,84480.72
355140,202309,224,128,96,168963.87,126720.51,295684.38
355150,202309,816,480,336,633627.17,443526.25,1077153.42
355160,202309,584,268,316,355097.75,417124.07,772221.82
355170,202309,2296,1171,1125,1545788.13,1486333.35,3032121.48
355180,202309,757,291,466,384125.58,615128.76,999254.34
355190,202309,240,157,83,207247.77,109562.09,316809.86
355200,202309,129,57,72,75241.37,95040,170281.37
355210,202309,806,407,399,537250.69,526683.11,1063933.80
355220,202309,9204,4245,4959,5604911.73,6555177.28,12160089.01
355230,202309,105,54,51,71281.3,67321.11,138602.41
355240,202309,5264,2061,3203,2721863.06,4231941.14,6953804.20
355250,202309,8222,3597,4625,4749562.4,6108987.13,10858549.53
355255,202309,50,30,20,39600.62,26400,66000.62
355260,202309,214,117,97,154445.53,128041.29,282486.82
355270,202309,175,117,58,154445.86,76560.98,231006.84
355280,202309,8453,3121,5332,4123809.55,7046241.23,11170050.78
355290,202309,73,55,18,72600.58,23760,96360.58
355300,202309,263,149,114,196686.2,150480.97,347167.17
355310,202309,117,68,49,89760,64680,154440
355320,202309,120,60,60,79200.6,79200.96,158401.56
355330,202309,374,220,154,291729.61,203282.74,495012.35
355340,202309,1420,533,887,703660.58,1173521.76,1877182.34
355350,202309,190,90,100,118800,132000.2,250800.2
355360,202309,220,144,76,191409.23,100321.53,291730.76
355365,202309,23,17,6,22440.89,7920,30360.89
355370,202309,1120,647,473,854081.5,625683,1479764.5
355380,202309,929,545,384,720752.6,506887.69,1227640.29
355385,202309,108,67,41,88440.2,54120,142560.2
355390,202309,120,66,54,87121.02,71280.11,158401.13
355395,202309,221,107,114,141247.93,150483.94,291731.87
355400,202309,2041,1114,927,1471744.85,1224962.4,2696707.25
355410,202309,6024,2688,3336,3553568.34,4407499.96,7961068.30
355420,202309,49,33,16,43560.8,21120,64680.8
355430,202309,523,298,225,393385.5,297008.98,690394.48
355440,202309,100,54,46,71281.1,60721.75,132002.85
355450,202309,512,259,253,341896.08,333963.1,675859.18
355460,202309,62,42,20,55441.1,26400.8,81841.9
355465,202309,56,29,27,38280.51,35640,73920.51
355470,202309,208,86,122,113522.56,161041.49,274564.05
355475,202309,9,6,3,7920.81,3960,11880.81
355480,202309,720,289,431,382818.56,570245.19,953063.75
355490,202309,118,85,33,112205.64,43562.71,155768.35
355495,202309,128,54,74,71280,97681.19,168961.19
355500,202309,1755,950,805,1254037.61,1062604.39,2316642.00
355510,202309,302,205,97,270614.24,128042.13,398656.37
355520,202309,29,19,10,25080.18,13200,38280.18
355530,202309,24,13,11,17160,14520,31680
355535,202309,95,44,51,58083.08,67320,125403.08
355540,202309,3236,1261,1975,1664581.43,2612329.5,4276910.93
355550,202309,73,39,34,52800,44880,97680
355560,202309,293,129,164,170284.12,216483.01,386767.13
355570,202309,17,13,4,17161.07,5280,22441.07
355580,202309,238,160,78,211210.95,102961.57,314172.52
355590,202309,15,11,4,14520.24,5280,19800.24
355600,202309,296,143,153,188767.48,201962.14,390729.62
355610,202309,272,161,111,212528.77,146523.15,359051.92
355620,202309,1479,600,879,793344.01,1161603.45,1954947.46
355630,202309,449,314,135,414498.45,178201.03,592699.48
355635,202309,140,55,85,72600.2,112200,184800.2
355640,202309,671,347,324,458051.53,427685.63,885737.16
355645,202309,987,344,643,454093.52,848769.31,1302862.83
355650,202309,2014,861,1153,1139205.57,1524602,2663807.57
355660,202309,238,122,116,161043.07,153122.11,314165.18
355670,202309,757,315,442,415803.73,586084.7,1001888.43
355680,202309,236,125,111,165013.4,146521.5,311534.9
355690,202309,104,46,58,60721.75,76560.57,137282.32
355695,202309,23,13,10,17160,13200,30360
355700,202309,1470,652,818,860668.38,1082405.64,1943074.02
355710,202309,2517,1387,1130,1832240.56,1492924.09,3325164.65
355715,202309,15,12,3,15842.08,3960.1,19802.18
355720,202309,280,172,108,227047.23,143881.51,370928.74
355730,202309,114,67,47,88441.83,62040.15,150481.98
410010,202309,110,89,21,117482.9,27720,145202.9
410020,202309,126,87,39,114843.84,51480.2,166324.04
410030,202309,217,114,103,150483.28,135963.58,286446.86
410040,202309,1619,764,855,1008505.76,1128610.47,2137116.23
410045,202309,43,34,9,44880.79,11880,56760.79
410050,202309,580,330,250,435604.32,330000.64,765604.96
410060,202309,223,163,60,215168.36,79200.5,294368.86
410070,202309,271,218,53,287770.11,69961.02,357731.13
410080,202309,207,128,79,168962.95,105600,274562.95
410090,202309,56,48,8,63364.62,10560,73924.62
410100,202309,282,177,105,233643.54,138600.1,372243.64
410105,202309,45,28,17,36960,22440,59400
410110,202309,399,242,157,319455.6,208566.06,528021.66
410115,202309,51,27,24,35640,31680.2,67320.2
410120,202309,507,232,275,308888.79,363003.94,671892.73
410130,202309,73,38,35,50160.58,46200,96360.58
410140,202309,3618,1650,1968,2179369.76,2599100.8,4778470.56
410150,202309,2891,1183,1708,1562734.62,2255895.33,3818629.95
410160,202309,530,306,224,403928.71,295682.54,699611.25
410165,202309,62,39,23,51480.41,30360,81840.41
410170,202309,226,126,100,166323.45,132000.99,298324.44
410180,202309,2691,1397,1294,1845428.77,1708106.41,3553535.18
410185,202309,39,32,7,42240,9240,51480
410190,202309,531,344,187,454088.4,246840.9,700929.3
410200,202309,1193,830,363,1095615.97,479162.81,1574778.78
410210,202309,725,377,348,497655.44,460681.82,958337.26
410220,202309,55,25,30,33000.84,39600,72600.84
410230,202309,214,93,121,122760.75,161042.19,283802.94
410240,202309,769,489,280,645501.92,370921.4,1016423.32
410250,202309,406,270,136,357724.44,179522.22,537246.66
410260,202309,345,188,157,248166.76,208567.71,456734.47
410270,202309,29,20,9,26400.53,11880,38280.53
410275,202309,68,45,23,59401.97,30360,89761.97
410280,202309,337,203,134,267970.38,176880.2,444850.58
410290,202309,288,163,125,215166.19,166320.5,381486.69
410300,202309,99,60,39,79200,51480,130680
410302,202309,29,16,13,21120.78,17160,38280.78
410304,202309,49,32,17,42241.2,22440,64681.2
410305,202309,221,135,86,178207.26,113520,291727.26
410310,202309,202,120,82,158403.66,109562.23,267965.89
410315,202309,40,33,7,43560.2,9240,52800.2
410320,202309,151,106,45,139921.24,59400,199321.24
410322,202309,41,24,17,31680.7,22440,54120.7
410330,202309,188,122,66,161042.55,87120,248162.55
410335,202309,110,62,48,81840,63360,145200
410337,202309,49,39,10,51480.5,13200,64680.5
410340,202309,38,31,7,40921.21,9240,50161.21
410345,202309,212,134,78,176882.18,102960.2,279842.38
410347,202309,39,29,10,38280.14,13200.16,51480.30
410350,202309,266,152,114,200645.67,150480,351125.67
410360,202309,501,307,194,405253.88,256080.12,661334.00
410370,202309,2514,1099,1415,1451912.9,1870453.04,3322365.94
410380,202309,211,119,92,157083.71,122760.52,279844.23
410390,202309,461,276,185,364325.18,245521.55,609846.73
410395,202309,33,21,12,27721.72,15840.83,43562.55
410400,202309,1073,457,616,603258.45,813130.82,1416389.27
410405,202309,86,67,19,88443.44,25080.22,113523.66
410410,202309,38,21,17,27721.93,22440.1,50162.03
410420,202309,2066,910,1156,1201115.37,1529895.04,2731010.41
410425,202309,230,104,126,137370.84,166320.2,303691.04
410430,202309,2689,1361,1328,1799201.02,1755617.2,3554818.22
410440,202309,375,271,104,357723.43,137282.19,495005.62
410442,202309,386,233,153,308889.89,203281.78,512171.67
410445,202309,358,252,106,333967.24,139920.85,473888.09
410450,202309,431,207,224,273246.07,295680.1,568926.17
410460,202309,624,341,283,450125.11,373562.01,823687.12
410465,202309,291,162,129,213845.99,170280.89,384126.88
410470,202309,261,148,113,195367.42,149161.63,344529.05
410480,202309,7512,3639,3873,4807571.51,5120329.85,9927901.36
410490,202309,1543,835,708,1102978.42,939848.61,2042827.03
410500,202309,304,182,122,240242.73,161040.55,401283.28
410510,202309,218,163,55,215168.79,72601.85,287770.64
410520,202309,309,219,90,289080.73,118800,407880.73
410530,202309,276,89,187,117480.59,246840,364320.59
410540,202309,414,297,117,392047.56,154440.61,546488.17
410550,202309,1895,821,1074,1083739.17,1420327.52,2504066.69
410560,202309,194,122,72,161043.57,95040.94,256084.51
410570,202309,478,312,166,411848.53,219122.22,630970.75
410580,202309,4362,1819,2543,2402470.81,3362089.77,5764560.58
410590,202309,475,303,172,401268.26,227040,628308.26
410600,202309,116,97,19,128040.94,25080,153120.94
410610,202309,70,56,14,73920.96,18480,92400.96
410620,202309,309,175,134,231006.37,176881.37,407887.74
410630,202309,504,273,231,360361.64,306240.38,666602.02
410640,202309,1319,823,496,1086380.82,656041.87,1742422.69
410645,202309,118,90,28,118803.2,36960.2,155763.4
410650,202309,411,253,158,333965.87,208561.72,542527.59
410655,202309,94,68,26,89760.73,34320.08,124080.81
410657,202309,40,17,23,22440,30360,52800
410660,202309,711,486,225,641540.04,298322.66,939862.70
410670,202309,77,61,16,80522.73,21120.13,101642.86
410680,202309,206,160,46,211204.15,60720.2,271924.35
410685,202309,44,31,13,40920.49,17160,58080.49
410690,202309,33205,13571,19634,17926037.04,25944859.77,43870896.81
410700,202309,359,257,102,339526.98,134640.37,474167.35
410710,202309,125,102,23,134642.21,30360.2,165002.41
410712,202309,47,32,15,42240.65,19800,62040.65
410715,202309,113,84,29,110883.65,38280,149163.65
410720,202309,725,414,311,547812.2,413161.2,960973.4
410725,202309,211,137,74,180843.24,97680,278523.24
410730,202309,110,48,62,63360.89,81840,145200.89
410740,202309,81,61,20,80521.34,26400,106921.34
410750,202309,322,202,120,266645.38,158400.06,425045.44
410752,202309,21,16,5,21120.14,6600,27720.14
410753,202309,62,22,40,29040,52800,81840
410754,202309,68,36,32,47521.28,42240,89761.28
410755,202309,95,46,49,60720.2,64680,125400.2
410760,202309,816,439,377,579485.45,497643.44,1077128.89
410765,202309,2300,1026,1274,1354364.17,1684345.35,3038709.52
410770,202309,132,91,41,120122.54,54120.76,174243.30
410773,202309,74,49,25,64681.73,33000,97681.73
410775,202309,235,155,80,204602.54,105600,310202.54
410780,202309,92,53,39,69961.18,51480,121441.18
410785,202309,58,50,8,66001.16,10560,76561.16
410790,202309,105,47,58,62040.4,76560,138600.4
410800,202309,299,187,112,246853.57,149160.84,396014.41
410810,202309,27,17,10,22440,13200.14,35640.14
410820,202309,153,105,48,138603.64,63360.9,201964.54
410830,202309,10780,4207,6573,5556028.53,8688324.82,14244353.35
410832,202309,128,82,46,108242.27,60720.86,168963.13
410840,202309,1598,873,725,1152384.1,958323.95,2110708.05
410845,202309,66,35,31,46201.12,40920,87121.12
410850,202309,164,122,42,161044.18,55440,216484.18
410855,202309,84,78,6,102963.11,7920,110883.11
410860,202309,981,475,506,627009.56,667924.2,1294933.76
410865,202309,97,67,30,88441.67,39600,128041.67
410870,202309,148,122,26,161042.07,34320.62,195362.69
410880,202309,1296,620,676,819739.88,893647.44,1713387.32
410890,202309,132,77,55,101641,72600,174241
410895,202309,83,62,21,81841.15,27720.95,109562.10
410900,202309,46,34,12,44881.49,15840,60721.49
410910,202309,14,8,6,10560.95,7920,18480.95
410920,202309,50,31,19,40920,25080,66000
410930,202309,596,368,228,485764.27,300961.49,786725.76
410940,202309,4944,2456,2488,3243369.53,3288158.79,6531528.32
410950,202309,100,75,25,99003.47,33000,132003.47
410960,202309,1115,408,707,538570.92,934570.44,1473141.36
410965,202309,70,50,20,66002.46,26400,92402.46
410970,202309,656,429,227,566287.95,299642.63,865930.58
410975,202309,129,79,50,104281.91,66000,170281.91
410980,202309,1719,786,933,1038877.16,1231573.67,2270450.83
410990,202309,285,209,76,275882.47,101640.98,377523.45
411000,202309,73,44,29,58080.77,38280.54,96361.31
411005,202309,43,35,8,46200,10560,56760
411007,202309,302,173,129,228360.47,170280,398640.47
411010,202309,671,408,263,538573.57,347162.53,885736.10
411020,202309,300,190,110,250805.01,145202.02,396007.03
411030,202309,32,20,12,26400,15840,42240
411040,202309,80,46,34,60720.89,44880,105600.89
411050,202309,218,156,62,205921.9,81840.4,287762.3
411060,202309,589,405,184,534606.76,242880.66,777487.42
411065,202309,44,39,5,51480.78,6600,58080.78
411070,202309,1398,784,614,1036218.72,813124.65,1849343.37
411080,202309,275,176,99,234961.54,130680.23,365641.77
411090,202309,84,58,26,77880.4,34320.96,112201.36
411095,202309,374,122,252,161041.7,332640.16,493681.86
411100,202309,112,92,20,121441.66,26400,147841.66
411110,202309,181,94,87,124080.84,114840.2,238921.04
411120,202309,206,138,68,182169.73,89760,271929.73
411125,202309,422,206,216,271929.49,285128.92,557058.41
411130,202309,169,145,24,191403.04,31680,223083.04
411140,202309,225,146,79,192720,104280,297000
411150,202309,1353,866,487,1143145.09,644163.7,1787308.79
411155,202309,120,80,40,105600,52800,158400
411160,202309,40,18,22,23760,29040,52800
411170,202309,61,52,9,68640,11880,80520
411180,202309,1132,754,378,995311.1,500285.9,1495597.0
411190,202309,392,226,166,298323.94,219120.41,517444.35
411200,202309,736,388,348,512172.59,459364.32,971536.91
411210,202309,730,372,358,491046.32,472563.11,963609.43
411220,202309,163,115,48,151802.25,63361.25,215163.50
411230,202309,31,25,6,33000,7920,40920
411240,202309,113,71,42,93721.08,55440,149161.08
411250,202309,439,315,124,417124.75,163680,580804.75
411260,202309,11,8,3,10560,3960,14520
411270,202309,286,149,137,196689.26,180841.69,377530.95
411275,202309,198,161,37,212522.95,48840,261362.95
411280,202309,307,205,102,270604.63,134640.7,405245.33
411290,202309,73,54,19,71280,25080,96360
411295,202309,137,98,39,129361.59,51480.82,180842.41
411300,202309,92,44,48,58080,63360,121440
411310,202309,102,70,32,92401.4,42240,134641.4
411320,202309,896,532,364,702249.83,480480.88,1182730.71
411325,202309,63,42,21,55440.1,27720,83160.1
411330,202309,1034,656,378,865943.95,498962.85,1364906.80
411340,202309,39,23,16,30360,21120.09,51480.09
411342,202309,69,55,14,72600,18480,91080
411345,202309,101,50,51,67321.76,68640.95,135962.71
411350,202309,597,436,161,576505.03,215162.58,791667.61
411360,202309,62,41,21,54122.81,27722.5,81845.31
411370,202309,14642,6049,8593,7988857.32,11353424.21,19342281.53
411373,202309,192,126,66,166320.17,87120.17,253440.34
411375,202309,96,77,19,101642.89,25080,126722.89
411380,202309,84,57,27,75244.95,35640,110884.95
411390,202309,180,99,81,130681.19,106920,237601.19
411400,202309,394,244,150,322088.01,199320,521408.01
411410,202309,600,286,314,377526.73,417121.13,794647.86
411420,202309,1035,425,610,561009.9,805204.91,1366214.81
411430,202309,653,330,323,435618.47,427689.1,863307.57
411435,202309,31,23,8,30360,10560,40920
411440,202309,519,411,108,542528.72,142560.7,685089.42
411450,202309,414,337,77,444848.37,101640.25,546488.62
411460,202309,886,338,548,448813.76,723362.37,1172176.13
411470,202309,115,78,37,102964.47,48840,151804.47
411480,202309,804,400,404,528021.13,534601.74,1062622.87
411490,202309,311,199,112,262683.6,147840.9,410524.5
411500,202309,118,88,30,117481.18,39600,157081.18
411510,202309,248,186,62,245525.16,83161.19,328686.35
411520,202309,7159,2406,4753,3179954.82,6276637.23,9456592.05
411530,202309,131,83,48,109560.77,63360,172920.77
411535,202309,50,17,33,22440.6,43560,66000.6
411540,202309,421,276,145,364325.14,191402.03,555727.17
411545,202309,55,38,17,50160.77,22440,72600.77
411550,202309,93,68,25,89761.37,33000,122761.37
411560,202309,415,165,250,217801.07,330000.15,547801.22
411570,202309,1174,376,798,496207.54,1056010.36,1552217.90
411573,202309,24,13,11,17160.2,14520,31680.2
411575,202309,346,220,126,290403.4,166320,456723.4
411580,202309,1364,468,896,617768.65,1182725.35,1800494.00
411585,202309,75,37,38,48840,50160,99000
411590,202309,14,9,5,11880,6600,18480
411600,202309,17,9,8,11880.7,10560,22440.7
411605,202309,180,67,113,88442.03,149160,237602.03
411610,202309,269,163,106,215164.85,139920.2,355085.05
411620,202309,424,202,222,266651.92,293047.97,559699.89
411630,202309,53,37,16,48840.53,21120.64,69961.17
411640,202309,36,25,11,33000.23,14520,47520.23
411650,202309,5,3,2,3960,2640,6600
411660,202309,53,39,14,51480,18480,69960
411670,202309,253,166,87,219122.22,114841.49,333963.71
411680,202309,177,133,44,175561.22,58080,233641.22
411690,202309,736,384,352,506885.39,464642.29,971527.68
411695,202309,67,45,22,59400.2,29040,88440.2
411700,202309,150,115,35,151805.88,46200,198005.88
411705,202309,110,76,34,100321.13,44880.4,145201.53
411710,202309,301,196,105,258725.79,138600.87,397326.66
411720,202309,163,106,57,139921.49,75240.2,215161.69
411721,202309,97,73,24,96360.2,31680,128040.2
411722,202309,110,54,56,71281.1,73920,145201.1
411725,202309,172,123,49,162360.9,64680,227040.9
411727,202309,110,92,18,121445.14,23760.33,145205.47
411729,202309,60,46,14,60721.6,18480,79201.6
411730,202309,604,382,222,508207.65,293042.88,801250.53
411740,202309,29,19,10,25080.78,13200,38280.78
411745,202309,74,56,18,73920,23760,97680
411750,202309,940,393,547,518772.83,722043.64,1240816.47
411760,202309,1410,1014,396,1339843.42,522728.33,1862571.75
411770,202309,452,282,170,372244.36,224401.6,596645.96
411780,202309,411,265,146,349800.49,192720.21,542520.70
411790,202309,640,354,286,468612.91,377520.54,846133.45
411800,202309,174,122,52,161045.7,68640.18,229685.88
411810,202309,197,153,44,201964.52,58080.79,260045.31
411820,202309,3023,1180,1843,1557670.55,2434111.85,3991782.40
411830,202309,21,13,8,17160.19,10560,27720.19
411840,202309,2513,1433,1080,1894249.88,1432224.61,3326474.49
411845,202309,73,21,52,27720.9,68640,96360.9
411850,202309,1403,747,656,986064.66,867246.04,1853310.70
411860,202309,67,42,25,55440.99,33000,88440.99
411870,202309,80,49,31,64680,40920,105600
411880,202309,445,268,177,353769,233642.07,587411.07
411885,202309,112,74,38,97682.19,50160.94,147843.13
411890,202309,364,252,112,332647.9,147841.68,480489.58
411900,202309,121,88,33,116160.28,43560,159720.28
411910,202309,245,162,83,213848,109561.7,323409.7
411915,202309,2813,1077,1736,1422998.04,2292867.21,3715865.25
411920,202309,117,85,32,112201.92,42240,154441.92
411925,202309,24,16,8,21120,10560,31680
411930,202309,890,592,298,782872.92,393364.75,1176237.67
411940,202309,626,382,244,504251.95,322082.08,826334.03
411950,202309,1451,668,783,881792.84,1034899.11,1916691.95
411960,202309,1219,740,479,976812.48,632282.38,1609094.86
411965,202309,22,15,7,19800.94,9240,29040.94
411970,202309,101,85,16,112200.79,21120,133320.79
411980,202309,254,127,127,167640.76,167640,335280.76
411990,202309,5980,3110,2870,4109199.43,3789866.76,7899066.19
411995,202309,725,223,502,294368.44,663974.53,958342.97
412000,202309,375,251,124,331328.41,163681.74,495010.15
412010,202309,70,39,31,51480.9,42240.72,93721.62
412015,202309,38,28,10,36960,13200,50160
412020,202309,22,16,6,21120,7920,29040
412030,202309,38,31,7,40921.07,9240,50161.07
412033,202309,47,25,22,33001.29,29040,62041.29
412035,202309,70,46,24,60720.23,31680,92400.23
412040,202309,33,17,16,22441.84,21120,43561.84
412050,202309,221,167,54,220447.14,71280,291727.14
412060,202309,864,614,250,811828.5,330003.86,1141832.36
412065,202309,60,28,32,36962.38,42240.15,79202.53
412070,202309,159,109,50,143882.56,66000.07,209882.63
412080,202309,385,186,199,245530.59,262685.11,508215.70
412085,202309,39,14,25,18480.23,33000,51480.23
412090,202309,929,552,377,729978.51,497641.95,1227620.46
412100,202309,281,231,50,304929.02,66000,370929.02
412110,202309,79,56,23,73921.5,30360,104281.5
412120,202309,409,217,192,286446.71,254762.75,541209.46
412125,202309,75,41,34,54120.2,44880,99000.2
412130,202309,52,35,17,46202.82,22440,68642.82
412135,202309,34,20,14,26400.2,18480,44880.2
412140,202309,498,325,173,431363.71,228363.81,659727.52
412150,202309,275,163,112,215162.27,147840.73,363003.00
412160,202309,75,53,22,69961.52,29040,99001.52
412170,202309,738,469,269,619085.95,355082.91,974168.86
412175,202309,41,27,14,35640.74,18480,54120.74
412180,202309,172,128,44,168964.54,58080.2,227044.74
412190,202309,349,265,84,351126.05,110880,462006.05
412200,202309,205,117,88,154441.08,116160,270601.08
412210,202309,104,78,26,102960,34320.73,137280.73
412215,202309,253,167,86,220444.31,113520.99,333965.30
412217,202309,73,59,14,77881.21,18480,96361.21
412220,202309,964,609,355,805227.67,468610.64,1273838.31
412230,202309,316,178,138,236287.47,182167.01,418454.48
412240,202309,1487,728,759,962304.04,1003208.12,1965512.16
412250,202309,458,275,183,363004.95,241560,604564.95
412260,202309,147,100,47,132002.94,62040.2,194043.14
412265,202309,167,130,37,171600.83,50160,221760.83
412270,202309,99,58,41,76561.21,54120,130681.21
412280,202309,88,64,24,84480.2,31680,116160.2
412290,202309,97,58,39,76561.48,51480.52,128042.00
412300,202309,227,164,63,216481.48,83160,299641.48
412310,202309,62,48,14,63361.5,18480,81841.5
412320,202309,100,76,24,100324.16,33000,133324.16
412330,202309,216,163,53,215162.23,69960,285122.23
412340,202309,201,129,72,170282.2,95040,265322.2
412350,202309,753,331,422,436924.3,559681.92,996606.22
412360,202309,24,18,6,23760,7920,31680
412370,202309,159,127,32,167643.92,42240.96,209884.88
412380,202309,195,141,54,186125.22,71280.71,257405.93
412382,202309,59,34,25,44880,33000,77880
412385,202309,174,120,54,158404.68,71280.92,229685.60
412390,202309,352,264,88,348493.78,116160.88,464654.66
412395,202309,73,59,14,77882.19,18480,96362.19
412400,202309,105,71,34,93721.33,44880,138601.33
412402,202309,255,141,114,186121.84,150480,336601.84
412405,202309,1031,346,685,456724.03,905522.83,1362246.86
412410,202309,1074,635,439,839555.99,580805.51,1420361.50
412420,202309,17,16,1,21120,1320,22440
412430,202309,27,25,2,33001.14,2640.2,35641.34
412440,202309,765,382,383,504246.49,505561.33,1009807.82
412450,202309,65,56,9,73921.42,11880,85801.42
412460,202309,88,59,29,79200.87,38280.19,117481.06
412470,202309,253,203,50,267964.33,66001.33,333965.66
412480,202309,169,121,48,159723.82,63360.2,223084.02
412490,202309,190,156,34,205921.71,44880,250801.71
412500,202309,434,338,96,446170.24,128042.47,574212.71
412510,202309,179,143,36,188763.76,47520,236283.76
412520,202309,97,65,32,85801.66,42240,128041.66
412530,202309,120,53,67,69961.63,88440,158401.63
412535,202309,61,46,15,60720.78,19800,80520.78
412540,202309,66,39,27,51481.65,35640.67,87122.32
412545,202309,97,69,28,91080.94,36960,128040.94
412550,202309,4750,1916,2834,2530658.96,3746214.83,6276873.79
412555,202309,16,8,8,10560,10560,21120
412560,202309,746,474,272,625695.08,359042.18,984737.26
412570,202309,946,407,539,537253.26,711483.33,1248736.59
412575,202309,100,72,28,95041.75,36960,132001.75
412580,202309,188,127,61,167649.6,81841.31,249490.91
412590,202309,32,28,4,36960.93,5280,42240.93
412600,202309,239,174,65,229684.33,85800.83,315485.16
412610,202309,50,21,29,27721.14,38280,66001.14
412620,202309,127,105,22,138602.6,29040.86,167643.46
412625,202309,2418,1143,1275,1511434.97,1683011.21,3194446.18
412627,202309,65,50,15,66001.49,19800,85801.49
412630,202309,407,271,136,357729.31,179521.22,537250.53
412635,202309,87,27,60,35640,79200,114840
412640,202309,118,84,34,110880.3,44880,155760.3
412650,202309,341,227,114,299645.22,150480.94,450126.16
412660,202309,601,325,276,430325.84,365640.41,795966.25
412665,202309,41,37,4,48841.04,5280,54121.04
412667,202309,276,173,103,228363.46,135960,364323.46
412670,202309,87,65,22,85800.4,29040,114840.4
412680,202309,355,269,86,355089.98,113521.1,468611.08
412690,202309,136,87,49,114842.52,64680,179522.52
412700,202309,195,120,75,158400.92,99000.23,257401.15
412710,202309,1491,807,684,1065262.97,902887.32,1968150.29
412720,202309,263,142,121,187443.01,159720.69,347163.70
412730,202309,182,152,30,200648.16,39600,240248.16
412740,202309,437,207,230,273244.64,303600.41,576845.05
412750,202309,427,234,193,310205.67,256080.94,566286.61
412760,202309,402,204,198,269287.96,262684.55,531972.51
412770,202309,2363,1265,1098,1669832.24,1452007.33,3121839.57
412780,202309,150,102,48,134642.83,63360.1,198002.93
412785,202309,335,177,158,233641.88,208560.02,442201.90
412788,202309,57,32,25,42240.92,33000,75240.92
412790,202309,134,106,28,139925.34,36960,176885.34
412795,202309,157,108,49,142563.03,64680,207243.03
412796,202309,318,198,120,261362.6,158400,419762.6
412800,202309,775,432,343,571566.08,452760.81,1024326.89
412810,202309,3427,1891,1536,2500154.58,2027538.96,4527693.54
412820,202309,1158,649,509,858028.46,671893.53,1529921.99
412830,202309,16,15,1,19800.2,1320,21120.2
412840,202309,254,166,88,220442.88,116160.2,336603.08
412850,202309,613,397,216,524049.8,285120.68,809170.48
412853,202309,184,81,103,106920.99,135960,242880.99
412855,202309,223,121,102,159722.99,134640.73,294363.72
412860,202309,104,69,35,91084.17,46200.91,137285.08
412862,202309,81,53,28,69960,38280,108240
412863,202309,12,8,4,10560,5280,15840
412865,202309,44,35,9,46200,11880.6,58080.6
412870,202309,129,86,43,113523.76,56761.69,170285.45
412880,202309,97,69,28,91084.14,36960,128044.14
420005,202309,47,39,8,51480.69,10560,62040.69
420010,202309,380,250,130,330005.81,171600.89,501606.70
420020,202309,103,79,24,104282.17,33000,137282.17
420030,202309,34,25,9,33000.2,11880,44880.2
420040,202309,97,75,22,99003.03,29040.2,128043.23
420050,202309,57,34,23,44880.38,30360,75240.38
420055,202309,20,17,3,22440.6,3960,26400.6
420060,202309,35,23,12,30360.41,15840.2,46200.61
420070,202309,116,101,15,133320.6,19800,153120.6
420075,202309,11,11,0,14520,,14520.0
420080,202309,45,38,7,51481.13,9240,60721.13
420090,202309,41,34,7,44880.77,9240.23,54121.00
420100,202309,177,150,27,198002.2,35640,233642.2
420110,202309,28,27,1,36960,1320,38280
420120,202309,65,47,18,62040,23760,85800
420125,202309,87,65,22,85800.83,29040,114840.83
420127,202309,38,32,6,42240,7920,50160
420130,202309,583,354,229,468615.75,303605.28,772221.03
420140,202309,1532,866,666,1144469.8,880459.23,2024929.03
420150,202309,52,38,14,50160,18480,68640
420160,202309,38,33,5,43560.87,6600,50160.87
420165,202309,18,14,4,18480.79,5280,23760.79
420170,202309,79,45,34,59400.83,44880,104280.83
420180,202309,26,24,2,31680,2640,34320
420190,202309,33,28,5,36960.18,6600,43560.18
420195,202309,155,78,77,102964.93,101642.57,204607.50
420200,202309,1549,639,910,843504.38,1201223.66,2044728.04
420205,202309,153,93,60,122763.79,79200.2,201963.99
420207,202309,174,94,80,124085.03,105601.17,229686.20
420208,202309,21,17,4,22440.21,5280,27720.21
420209,202309,14,12,2,15840,2640,18480
420210,202309,676,331,345,438252.27,456722.21,894974.48
420213,202309,53,37,16,48840.69,21120,69960.69
420215,202309,26,23,3,30360.88,3960,34320.88
420220,202309,64,40,24,52800.44,31680,84480.44
420230,202309,1163,718,445,947799.93,590049.65,1537849.58
420240,202309,2668,1761,907,2325882.3,1197249.2,3523131.5
420243,202309,47,39,8,51481.22,10560,62041.22
420245,202309,278,126,152,166325.49,200644.11,366969.60
420250,202309,68,44,24,58080.93,31680,89760.93
420253,202309,23,18,5,23760.56,6600,30360.56
420257,202309,17,10,7,13200.5,9240,22440.5
420260,202309,134,106,28,139922.82,36960.14,176882.96
420270,202309,38,27,11,35640,14520.36,50160.36
420280,202309,315,229,86,302292.19,113520.33,415812.52
420285,202309,26,20,6,26400,7920,34320
420287,202309,48,30,18,39601.42,23760,63361.42
420290,202309,1090,741,349,979456.27,463320.51,1442776.78
420300,202309,1751,1397,354,1845428.98,467287.57,2312716.55
420310,202309,46,33,13,43560.7,17160,60720.7
420315,202309,26,22,4,29040.78,5280.74,34321.52
420320,202309,1203,578,625,762984.13,825010.87,1587995.00
420325,202309,8,6,2,7920,2640.3,10560.3
420330,202309,127,84,43,110881.17,56761.03,167642.20
420340,202309,206,136,70,179522.06,92400,271922.06
420350,202309,284,202,82,266647.65,108240.73,374888.38
420360,202309,731,571,160,753746.26,211201.26,964947.52
420370,202309,144,80,64,105602.92,84480.43,190083.35
420380,202309,1365,914,451,1206522.09,595327.59,1801849.68
420390,202309,233,164,69,216485.18,92400.4,308885.58
420395,202309,205,150,55,198017.42,72602.08,270619.50
420400,202309,226,173,53,228364.67,69960,298324.67
420410,202309,58,45,13,59403.25,17160,76563.25
420415,202309,31,22,9,29040.2,11880,40920.2
420417,202309,67,52,15,68640.01,19800,88440.01
420419,202309,13,12,1,15840,1320,17160
420420,202309,3212,1989,1223,2625540.22,1618328.96,4243869.18
420425,202309,75,53,22,69965.6,29040,99005.6
420430,202309,1063,775,288,1024328.27,380162.62,1404490.89
420435,202309,14,11,3,14520,3960,18480
420440,202309,93,67,26,88441.66,34320,122761.66
420445,202309,32,29,3,38280.5,3960,42240.5
420450,202309,96,59,37,77883.28,50160,128043.28
420455,202309,200,159,41,209885.11,54120,264005.11
420460,202309,2650,1627,1023,2149045.17,1355652,3504697.17
420470,202309,83,54,29,71280.2,38280,109560.2
420475,202309,9,8,1,10560.46,1320,11880.46
420480,202309,995,761,234,1004569.04,310201.68,1314770.72
420490,202309,101,74,27,97684.07,35640,133324.07
420500,202309,414,245,169,323409.43,224400.63,547810.06
420510,202309,24,20,4,26400.34,5280,31680.34
420515,202309,31,17,14,22440.29,18480,40920.29
420517,202309,11,8,3,10560.91,3960,14520.91
420519,202309,9,8,1,10560,1320,11880
420520,202309,62,44,18,58081.39,23760.2,81841.59
420530,202309,146,94,52,124081.44,68640.2,192721.64
420535,202309,16,13,3,17160.41,3960,21120.41
420540,202309,7822,4827,2995,6374821.77,3960041.5,10334863.27
420543,202309,31,30,1,39601.06,1320,40921.06
420545,202309,255,179,76,236287.31,100320.6,336607.91
420550,202309,828,702,126,926671.71,166322.7,1092994.41
420555,202309,43,33,10,43560.9,13200,56760.9
420560,202309,63,48,15,63361.34,19800,83161.34
420570,202309,272,132,140,174243.45,184802.86,359046.31
420580,202309,362,191,171,252127.56,225720.93,477848.49
420590,202309,558,349,209,460691.14,275880.62,736571.76
420600,202309,169,93,76,122760.6,100320,223080.6
420610,202309,39,36,3,47520,3960,51480
420620,202309,81,65,16,85802.34,21120.41,106922.75
420630,202309,172,119,53,157082.51,69960,227042.51
420640,202309,77,67,10,88440.6,13200,101640.6
420650,202309,360,185,175,244205.27,231000.82,475206.09
420660,202309,45,31,14,40920.45,18480,59400.45
420665,202309,51,33,18,43561.6,23760,67321.6
420670,202309,245,188,57,248167.51,75240,323407.51
420675,202309,17,13,4,17160,5280,22440
420680,202309,36,29,7,38280.12,9240,47520.12
420690,202309,216,156,60,205922.48,79352.18,285274.66
420700,202309,785,509,276,671902.13,365643.54,1037545.67
420710,202309,162,89,73,117482.15,96361.07,213843.22
420720,202309,109,82,27,108244.58,35640.39,143884.97
420730,202309,822,492,330,649460.88,435607.2,1085068.08
420740,202309,62,60,2,79201.44,2640,81841.44
420750,202309,529,349,180,460684.53,237600.7,698285.23
420757,202309,20,17,3,22440,3960,26400
420760,202309,39,28,11,36960.86,14520,51480.86
420765,202309,70,49,21,64681.14,27720,92401.14
420768,202309,60,49,11,64682.91,14520,79202.91
420770,202309,78,67,11,88441.53,14520,102961.53
420775,202309,38,30,8,39600.26,10560,50160.26
420780,202309,209,161,48,212523.35,63360,275883.35
420785,202309,29,18,11,23760,14520,38280
420790,202309,141,116,25,154442.28,33000,187442.28
420800,202309,64,51,13,67320.62,17160,84480.62
420810,202309,301,228,73,300970.5,96360,397330.5
420820,202309,3011,1682,1329,2220314.99,1756941.54,3977256.53
420830,202309,833,453,380,597983.59,501611.87,1099595.46
420840,202309,136,92,44,121440.95,58080,179520.95
420845,202309,502,217,285,286448.09,376203.13,662651.22
420850,202309,313,241,72,318122.47,95040.3,413162.77
420860,202309,61,52,9,68641.52,11880,80521.52
420870,202309,143,103,40,135960.78,52800,188760.78
420880,202309,211,133,78,175564.02,102960.3,278524.32
420890,202309,1146,590,556,778814.69,735242.71,1514057.40
420895,202309,11,10,1,13200,1320,14520
420900,202309,437,349,88,460688.31,116160.78,576849.09
420910,202309,6653,3683,2970,4863032.15,3925726.66,8788758.81
420915,202309,62,57,5,75240.2,6600,81840.2
420917,202309,27,20,7,26400.31,9240,35640.31
420920,202309,21,15,6,19800,7920,27720
420930,202309,4020,2759,1261,3644577.92,1665869.29,5310447.21
420940,202309,634,435,199,574229.06,262687.26,836916.32
420945,202309,10,7,3,9240,3960,13200
420950,202309,47,35,12,46200.33,15840,62040.33
420960,202309,119,97,22,128045.78,29040,157085.78
420970,202309,296,242,54,319452.9,71280.71,390733.61
420980,202309,24,23,1,30360,1320,31680
420985,202309,52,44,8,58081.58,10560,68641.58
420990,202309,93,70,23,92402.09,30362.76,122764.85
421000,202309,77,38,39,50160,51480,101640
421003,202309,31,22,9,29040.38,11880,40920.38
421005,202309,8,6,2,7920.3,2640,10560.3
421010,202309,961,609,352,803912.18,465965.51,1269877.69
421020,202309,20,18,2,23762.99,2640,26402.99
421030,202309,117,95,22,125401.36,29040,154441.36
421040,202309,72,55,17,72601.98,22441.05,95043.03
421050,202309,341,238,103,314162.35,135960,450122.35
421055,202309,16,13,3,17160.2,3960,21120.2
421060,202309,121,65,56,85801.65,73920,159721.65
421070,202309,32,29,3,39600.86,3960,43560.86
421080,202309,49,39,10,51480.23,13200,64680.23
421085,202309,20,14,6,18480,7920,26400
421090,202309,38,29,9,38280.11,11880,50160.11
421100,202309,122,89,33,117482.48,43560.95,161043.43
421105,202309,208,163,45,215165.81,59400.2,274566.01
421110,202309,143,97,46,128043.46,60720,188763.46
421120,202309,210,145,65,191403.77,85800.42,277204.19
421125,202309,17,10,7,13200,9240.32,22440.32
421130,202309,969,589,380,778820.79,501605.81,1280426.60
421140,202309,36,27,9,35640.32,11880,47520.32
421145,202309,45,37,8,50160.11,10560,60720.11
421150,202309,89,69,20,91081.88,26400,117481.88
421160,202309,66,44,22,58080.5,29040,87120.5
421165,202309,17,14,3,18480,3960,22440
421170,202309,175,149,26,196847.97,34320.1,231168.07
421175,202309,208,144,64,190084.62,84481.43,274566.05
421180,202309,37,22,15,29040.22,19800,48840.22
421185,202309,20,17,3,22440.18,3960,26400.18
421187,202309,5,4,1,5280,1320,6600
421189,202309,45,33,12,43560.58,15840,59400.58
421190,202309,2417,1532,885,2022321.48,1168223.56,3190545.04
421200,202309,97,69,28,91082.61,36960,128042.61
421205,202309,23,16,7,21121.01,9240,30361.01
421210,202309,189,132,57,174242.47,75240,249482.47
421220,202309,269,207,62,273242.6,81840.48,355083.08
421223,202309,51,40,11,52800.83,15840,68640.83
421225,202309,80,55,25,72601.54,33000.6,105602.14
421227,202309,72,59,13,77880.9,18480,96360.9
421230,202309,84,55,29,72601.09,38280.18,110881.27
421240,202309,16,13,3,17160.8,3960,21120.8
421250,202309,469,253,216,333968.74,285126.38,619095.12
421260,202309,23,18,5,23760.59,6600,30360.59
421265,202309,19,13,6,17161.32,7920.1,25081.42
421270,202309,55,49,6,64680,7920,72600
421280,202309,453,234,219,308887.96,289082.43,597970.39
421290,202309,319,211,108,278522.58,142560.2,421082.78
421300,202309,23,20,3,26400,3960,30360
421310,202309,52,36,16,47520,21120,68640
421315,202309,36,21,15,27721.03,19800.08,47521.11
421320,202309,144,98,46,130682.91,60720,191402.91
421330,202309,115,87,28,114841.88,36960,151801.88
421335,202309,49,35,14,46201.63,18480,64681.63
421340,202309,263,176,87,232325.34,114840.41,347165.75
421350,202309,198,120,78,158404,104280.33,262684.33
421360,202309,783,534,249,704893.41,328685,1033578.41
421370,202309,204,151,53,199322.13,71281.09,270603.22
421380,202309,160,119,41,157082.34,54120,211202.34
421390,202309,18,13,5,17160.58,6600,23760.58
421400,202309,120,96,24,126720,31680,158400
421410,202309,21,18,3,23760,3960,27720
421415,202309,22,20,2,26400,2640,29040
421420,202309,102,86,16,113521.34,21120,134641.34
421430,202309,21,13,8,17160,10560,27720
421440,202309,60,49,11,64681.5,14520.98,79202.48
421450,202309,83,66,17,87120.47,22440,109560.47
421460,202309,52,43,9,56760.66,11880,68640.66
421470,202309,86,46,40,60720.19,52800,113520.19
421480,202309,869,639,230,844815.58,303603.26,1148418.84
421490,202309,25,23,2,30360.78,2640,33000.78
421500,202309,516,293,223,386778.01,297002.25,683780.26
421505,202309,48,39,9,51480.1,11880.2,63360.3
421507,202309,36,29,7,38280.6,9240,47520.6
421510,202309,66,41,25,54121.36,33000.61,87121.97
421520,202309,49,41,8,54120.98,10560,64680.98
421530,202309,53,45,8,59401.28,10560,69961.28
421535,202309,22,20,2,26401.29,2640,29041.29
421540,202309,49,41,8,54120.2,10560,64680.2
421545,202309,95,64,31,84484.07,40920.63,125404.70
421550,202309,322,233,89,307575.7,117480.99,425056.69
421555,202309,17,15,2,19801.56,2640,22441.56
421560,202309,9,7,2,9240,2640,11880
421565,202309,139,88,51,118803.09,67320.57,186123.66
421567,202309,39,29,10,38280,13200,51480
421568,202309,38,37,1,48840,1320,50160
421569,202309,10,9,1,11880.79,1320,13200.79
421570,202309,290,190,100,250805.33,132001.41,382806.74
421575,202309,27,25,2,33000.04,2640,35640.04
421580,202309,796,470,326,620502.9,430322.26,1050825.16
421590,202309,23,21,2,27720.2,2640,30360.2
421600,202309,184,134,50,176880.73,66000,242880.73
421605,202309,114,77,37,101642.01,48840.2,150482.21
421610,202309,175,126,49,166320.99,64680,231000.99
421620,202309,1166,662,504,875194.86,665287.8,1540482.66
421625,202309,23,20,3,26400,3960,30360
421630,202309,389,239,150,315490.61,198007.03,513497.64
421635,202309,32,18,14,23760,18480,42240
421640,202309,116,90,26,118804.11,34320,153124.11
421650,202309,353,207,146,273247.89,192723.14,465971.03
421660,202309,3078,1872,1206,2473758.25,1593262.18,4067020.43
421670,202309,161,115,46,151803.62,60720,212523.62
421680,202309,209,185,24,244205.08,31680,275885.08
421690,202309,380,252,128,332647.64,168961.22,501608.86
421700,202309,57,41,16,55440.7,21120,76560.7
421710,202309,25,25,0,33000.33,,33000.33
421715,202309,4,4,0,5281.27,,5281.27
421720,202309,690,455,235,600613.99,310201.41,910815.40
421725,202309,36,14,22,18480.25,29040.8,47521.05
421730,202309,22,18,4,23760,6600,30360
421740,202309,128,56,72,73920.89,95040,168960.89
421750,202309,204,144,60,190081.26,79200,269281.26
421755,202309,20,19,1,25080,1320,26400
421760,202309,112,78,34,102962.46,44880.19,147842.65
421770,202309,755,482,273,637582.36,360363.1,997945.46
421775,202309,29,19,10,25080.97,13200.09,38281.06
421780,202309,198,151,47,199321.35,62040,261361.35
421790,202309,156,134,22,176882.4,29040.72,205923.12
421795,202309,16,13,3,17160.33,3960,21120.33
421800,202309,636,380,256,501622.8,337925.29,839548.09
421810,202309,72,60,12,79201.08,15840,95041.08
421820,202309,344,220,124,290406.37,163680,454086.37
421825,202309,178,150,28,198006.22,36960,234966.22
421830,202309,175,108,67,142567.83,88441.14,231008.97
421835,202309,7,3,4,3960,5280,9240
421840,202309,47,39,8,51481.08,10560.97,62042.05
421850,202309,81,67,14,88440.5,18480,106920.5
421860,202309,39,27,12,35640.73,15840,51480.73
421870,202309,1314,931,383,1228966.99,505570.71,1734537.70
421875,202309,52,40,12,52800,15840,68640
421880,202309,209,148,61,195362.22,80520.7,275882.92
421885,202309,20,15,5,19800,6600.84,26400.84
421890,202309,184,131,53,172925.85,69961.13,242886.98
421895,202309,53,46,7,60721.92,9240,69961.92
421900,202309,139,103,36,135967.61,47520,183487.61
421910,202309,74,45,29,59400.91,38280,97680.91
421915,202309,34,27,7,35640,9240,44880
421917,202309,56,43,13,56760.91,17160,73920.91
421920,202309,38,34,4,44880.3,5280,50160.3
421930,202309,669,528,141,698298.65,186123.25,884421.90
421935,202309,47,37,10,48840,13200,62040
421940,202309,58,50,8,66000,10560,76560
421950,202309,995,666,329,879134.53,434283.71,1313418.24
421960,202309,45,37,8,50160,10560,60720
421970,202309,343,211,132,278525.18,174241.39,452766.57
421985,202309,19,12,7,15840.2,9240,25080.2
422000,202309,17,10,7,13200.5,9240.69,22441.19
430003,202309,205,62,143,81840.6,188760,270600.6
430005,202309,32,25,7,33000.53,9240,42240.53
430010,202309,268,199,69,262683.46,91080,353763.46
430020,202309,143,102,41,134641.57,54120.24,188761.81
430030,202309,137,108,29,143881.73,38280,182161.73
430040,202309,3139,1840,1299,2428846.26,1714682.86,4143529.12
430045,202309,82,73,9,96360,11880,108240
430047,202309,6,5,1,6600,1320,7920
430050,202309,93,78,15,102961.28,19800,122761.28
430055,202309,15,13,2,17160,2640,19800
430057,202309,7,5,2,6600,2640,9240
430060,202309,4718,2741,1977,3620897.65,2613623.49,6234521.14
430063,202309,62,49,13,64680,17160,81840
430064,202309,171,136,35,179520.77,46200,225720.77
430066,202309,7,4,3,5280,3960,9240
430070,202309,41,33,8,43560.28,10560,54120.28
430080,202309,85,58,27,76560.45,35640.18,112200.63
430085,202309,27,13,14,17160,18480,35640
430087,202309,43,33,10,44880.08,13200,58080.08
430090,202309,69,58,11,76560.6,14520,91080.6
430100,202309,163,112,51,147840.37,67320,215160.37
430105,202309,194,109,85,143886.69,113520.3,257406.99
430107,202309,24,19,5,25080.31,6600,31680.31
430110,202309,517,280,237,369600.36,312840,682440.36
430120,202309,192,176,16,232320.1,21120,253440.1
430130,202309,862,506,356,667928.56,469921.55,1137850.11
430140,202309,148,133,15,175560,19800,195360
430150,202309,118,74,44,97680.96,58080,155760.96
430155,202309,29,25,4,33000,5280,38280
430160,202309,4081,2267,1814,2995148.76,2397131.2,5392279.96
430163,202309,492,231,261,304930.03,344523.38,649453.41
430165,202309,33,20,13,26400.59,17160,43560.59
430170,202309,84,69,15,91080,19800,110880
430175,202309,90,71,19,95040,25080,120120
430180,202309,110,84,26,110880.26,34320,145200.26
430185,202309,31,23,8,30360,10560,40920
430187,202309,107,41,66,54121.21,87120,141241.21
430190,202309,255,127,128,167643.59,168962.29,336605.88
430192,202309,13,10,3,13200.56,3960,17160.56
430195,202309,19,15,4,19800.9,5280,25080.9
430200,202309,167,138,29,182163.73,38280,220443.73
430205,202309,20,20,0,26400,,26400.0
430210,202309,837,618,219,817094.98,289080.7,1106175.68
430215,202309,12,12,0,15840,,15840.0
430220,202309,81,55,26,72600,34320,106920
430222,202309,15,4,11,5280,14520,19800
430223,202309,18,13,5,17160,6600,23760
430225,202309,5,3,2,3960,2640,6600
430230,202309,375,231,144,304921.84,190080,495001.84
430235,202309,54,36,18,47520.89,23760,71280.89
430237,202309,22,16,6,21120,7920,29040
430240,202309,123,82,41,108240.78,54120,162360.78
430245,202309,70,58,12,77880,15840,93720
430250,202309,192,113,79,149161.67,104280,253441.67
430258,202309,13,10,3,13200.28,3960.2,17160.48
430260,202309,42,39,3,51480.1,3960,55440.1
430265,202309,42,36,6,47520,7920,55440
430270,202309,574,399,175,526695.86,231000,757695.86
430280,202309,1180,674,506,889688.58,667920.3,1557608.88
430290,202309,484,250,234,331327.18,308880,640207.18
430300,202309,2363,1297,1066,1712084.72,1408451.24,3120535.96
430310,202309,2427,1211,1216,1598591.87,1606465.98,3205057.85
430320,202309,64,52,12,68640,15840,84480
430330,202309,97,83,14,109560.1,18480,128040.1
430340,202309,76,61,15,80520,19800,100320
430350,202309,1820,1125,695,1486337.77,918720.85,2405058.62
430355,202309,20,18,2,23760,2640,26400
430360,202309,112,59,53,77880,69960,147840
430367,202309,50,36,14,47520,18480,66000
430370,202309,65,57,8,75240.29,10560,85800.29
430380,202309,112,79,33,104281.54,43560,147841.54
430390,202309,729,436,293,575449.59,388084.6,963534.19
430400,202309,265,182,83,240240.07,109560,349800.07
430410,202309,56,47,9,62040.2,11880,73920.2
430420,202309,584,378,206,498971.36,273241.49,772212.85
430430,202309,50,46,4,59840.88,5280,65120.88
430435,202309,158,112,46,147840.63,60720,208560.63
430440,202309,686,410,276,541210.55,364322.4,905532.95
430450,202309,1331,1092,239,1441457.83,316800.9,1758258.73
430460,202309,6698,3429,3269,4534343.02,4323050.28,8857393.30
430461,202309,20,18,2,23760,2640,26400
430462,202309,6,4,2,5280.1,2640,7920.1
430463,202309,1434,779,655,1028305.64,864605.54,1892911.18
430465,202309,27,17,10,22440,13200,35640
430466,202309,841,590,251,780151.32,332645.77,1112797.09
430467,202309,141,75,66,99000,87120,186120
430468,202309,176,100,76,132001.5,100320.88,232322.38
430469,202309,22,15,7,19800.71,9240,29040.71
430470,202309,1274,691,583,912524.8,769562.5,1682087.3
430471,202309,86,61,25,80521.84,34320.57,114842.41
430480,202309,160,111,49,147841.49,64680,212521.49
430485,202309,8,8,0,10560,,10560.0
430490,202309,71,56,15,75240,19800,95040
430495,202309,37,26,11,34320.2,14520,48840.2
430500,202309,202,135,67,178200,88440,266640
430510,202309,4359,2787,1572,3684188.84,2079010.66,5763199.50
430511,202309,15,14,1,18480,1320,19800
430512,202309,191,128,63,168962.87,83160.4,252123.27
430513,202309,61,45,16,59400,21120,80520
430515,202309,24,22,2,29040,2640,31680
430517,202309,194,165,29,217800.2,38280,256080.2
430520,202309,352,246,106,324725.1,139920.26,464645.36
430530,202309,88,47,41,62040.7,54120,116160.7
430535,202309,516,320,196,426365.22,258724.11,685089.33
430537,202309,9,9,0,11880,,11880.0
430540,202309,81,57,24,75240,31680,106920
430543,202309,477,153,324,201961,427680.71,629641.71
430544,202309,53,48,5,63360.61,6600,69960.61
430545,202309,504,246,258,324739.38,340569.23,665308.61
430550,202309,46,36,10,47520.14,13200,60720.14
430558,202309,2,2,0,2640,,2640.0
430560,202309,53,31,22,40920,30360,71280
430570,202309,124,52,72,68642.18,96360,165002.18
430580,202309,130,105,25,138600.42,33000,171600.42
430583,202309,13,13,0,17160,,17160.0
430585,202309,14,10,4,13200.88,5280,18480.88
430587,202309,14,10,4,13200,5280,18480
430590,202309,209,169,40,223081.35,52800,275881.35
430593,202309,1,1,0,1320,,1320.0
430595,202309,18,14,4,18480,5280,23760
430597,202309,46,28,18,36960.63,23760,60720.63
430600,202309,237,173,64,228360,84480,312840
430605,202309,199,116,83,153120,109560,262680
430607,202309,35,28,7,36960,9240,46200
430610,202309,1927,917,1010,1213097.34,1334522.7,2547620.04
430613,202309,5,5,0,6600,,6600.0
430620,202309,102,71,31,93720.56,40920,134640.56
430630,202309,48,41,7,54121.13,9240,63361.13
430632,202309,33,29,4,38280,5280,43560
430635,202309,39,31,8,40920,10560,51480
430637,202309,71,32,39,42240,51480,93720
430640,202309,178,104,74,137284.83,97680.54,234965.37
430642,202309,17,15,2,19800,2640,22440
430645,202309,34,27,7,35640,9240,44880
430650,202309,247,195,52,257402.28,68641.15,326043.43
430655,202309,13,10,3,13200,3960,17160
430660,202309,1078,530,548,699612.4,724687.24,1424299.64
430670,202309,71,50,21,66000,27720,93720
430673,202309,86,55,31,72600.2,40920,113520.2
430675,202309,9,7,2,9240,2640,11880
430676,202309,737,451,286,596752.92,377523.7,974276.62
430680,202309,272,180,92,237601.89,121440,359041.89
430690,202309,601,366,235,485768.25,310202.58,795970.83
430692,202309,6,5,1,6600.7,1320,7920.7
430693,202309,146,94,52,124081.72,68640.2,192721.92
430695,202309,73,54,19,71280,25080,96360
430697,202309,71,44,27,58080,35640,93720
430700,202309,1457,986,471,1301537.44,621720.1,1923257.54
430705,202309,36,30,6,39600.7,7920,47520.7
430710,202309,275,172,103,227040,135960,363000
430720,202309,98,80,18,105600,23760,129360
430730,202309,164,140,24,184800.43,31680,216480.43
430740,202309,92,58,34,76560.3,46200,122760.3
430745,202309,29,18,11,23760,14520,38280
430750,202309,330,209,121,275882.33,159721.02,435603.35
430755,202309,86,48,38,63360.31,50160,113520.31
430760,202309,476,261,215,344528.51,283801.66,628330.17
430770,202309,1919,1065,854,1407167.04,1128606.67,2535773.71
430780,202309,380,238,142,314161.14,190080,504241.14
430781,202309,25,25,0,33000,,33000.0
430783,202309,67,48,19,63360,25080,88440
430786,202309,8,6,2,7920,2640,10560
430790,202309,581,359,222,473888.75,293042.4,766931.15
430800,202309,169,122,47,161040,62040,223080
430805,202309,41,30,11,39600,14520,54120
430807,202309,82,48,34,64680,44880,109560
430810,202309,83,54,29,71281.36,38280,109561.36
430820,202309,169,112,57,147843.05,75240,223083.05
430825,202309,11,9,2,11880,2640,14520
430830,202309,289,265,24,349802.56,31680,381482.56
430840,202309,153,102,51,134640.7,67320,201960.7
430843,202309,8,5,3,6600,3960,10560
430845,202309,82,48,34,63360,44880,108240
430850,202309,615,431,184,568924.35,242880,811804.35
430860,202309,192,131,61,172921.64,80520.82,253442.46
430865,202309,83,44,39,58080,51480,109560
430870,202309,73,59,14,77880.57,18480,96360.57
430880,202309,186,127,59,167644.07,77880.8,245524.87
430885,202309,11,9,2,11880,2640,14520
430890,202309,349,212,137,279842.15,182160,462002.15
430900,202309,566,386,180,509525.45,237600.84,747126.29
430905,202309,165,78,87,102960.62,114841.35,217801.97
430910,202309,325,173,152,228362.48,200640.8,429003.28
430912,202309,5,5,0,6600.03,,6600.03
430915,202309,43,40,3,52800,3960,56760
430920,202309,5442,2831,2611,3738380.49,3449206.64,7187587.13
430925,202309,7,6,1,7920,1320,9240
430930,202309,2408,1359,1049,1796467.46,1387322.73,3183790.19
430940,202309,293,184,109,242880,143881.1,386761.1
430950,202309,163,131,32,172921.21,42240,215161.21
430955,202309,30,19,11,25080.7,14520,39600.7
430957,202309,26,24,2,31680.11,2640,34320.11
430960,202309,285,187,98,246842.07,129360.05,376202.12
430965,202309,114,73,41,97680,54120,151800
430970,202309,96,76,20,100320,26400,126720
430975,202309,54,46,8,60720.6,10560,71280.6
430980,202309,58,36,22,47520.78,29040,76560.78
430990,202309,101,80,21,105600,27720,133320
430995,202309,126,114,12,150480,15840,166320
431000,202309,308,152,156,200641.2,205920,406561.2
431010,202309,404,242,162,319453.24,213842.79,533296.03
431020,202309,2082,1191,891,1572141.83,1176121.96,2748263.79
431030,202309,47,37,10,48840,13200,62040
431033,202309,557,253,304,333978.35,401292.84,735271.19
431036,202309,12,8,4,10560,5280,15840
431040,202309,163,111,52,146520.6,68640,215160.6
431041,202309,48,30,18,39600,23760,63360
431043,202309,42,25,17,33000.42,22440,55440.42
431046,202309,12,9,3,11880,3960,15840
431050,202309,215,136,79,179521.35,105600,285121.35
431053,202309,84,47,37,62041.35,48841.96,110883.31
431055,202309,69,44,25,58080,33000,91080
431057,202309,20,20,0,26400,,26400.0
431060,202309,1696,1073,623,1417696.01,822362.44,2240058.45
431065,202309,21,12,9,15840,11880,27720
431070,202309,65,56,9,73920,11880,85800
431075,202309,8,8,0,10560,,10560.0
431080,202309,141,80,61,105602.14,80520,186122.14
431085,202309,39,35,4,46200.2,5280,51480.2
431087,202309,17,13,4,17160,5280,22440
431090,202309,48,37,11,48840.3,14520,63360.3
431100,202309,1385,812,573,1071862.33,756362.08,1828224.41
431110,202309,234,147,87,194043.57,114840,308883.57
431112,202309,31,23,8,30360.33,10560,40920.33
431113,202309,30,18,12,23760.28,15840,39600.28
431115,202309,153,111,42,146520.66,55440,201960.66
431120,202309,624,366,258,483126.27,343200.78,826327.05
431123,202309,6,6,0,7920,,7920.0
431125,202309,99,88,11,116160,14520,130680
431127,202309,7,5,2,6600,2640,9240
431130,202309,753,486,267,641529.66,352444.43,993974.09
431140,202309,888,623,265,822369.43,349801.6,1172171.03
431142,202309,16,14,2,18480.56,2640,21120.56
431150,202309,217,149,68,196681.86,89760,286441.86
431160,202309,42,37,5,48840.7,6600,55440.7
431162,202309,6,6,0,7920.65,,7920.65
431164,202309,8,6,2,7920,2640,10560
431170,202309,119,82,37,108240.2,48840,157080.2
431171,202309,74,43,31,56760,40920,97680
431173,202309,10,9,1,11880,1320.8,13200.8
431175,202309,212,113,99,149161.66,130680.22,279841.88
431177,202309,121,81,40,106921.5,52800.31,159721.81
431179,202309,18,12,6,15840,7920,23760
431180,202309,433,266,167,351124.48,220440,571564.48
431190,202309,74,54,20,71280.6,26400.7,97681.3
431198,202309,81,58,23,76423.34,30360,106783.34
431200,202309,24,18,6,23760,7920,31680
431205,202309,22,21,1,27720.7,1320,29040.7
431210,202309,115,70,45,92400.7,59400,151800.7
431213,202309,33,27,6,35640,7920.56,43560.56
431215,202309,25,23,2,30360.64,2640,33000.64
431217,202309,7,6,1,7920,1320,9240
431220,202309,69,56,13,73921.05,17160,91081.05
431225,202309,179,107,72,141240.24,95040,236280.24
431230,202309,109,84,25,110883.56,33000,143883.56
431235,202309,6,4,2,5280,2640,7920
431237,202309,20,16,4,21120,5280,26400
431238,202309,16,11,5,14520,6600.2,21120.2
431240,202309,1100,678,422,894986.93,558361.96,1453348.89
431242,202309,44,43,1,56760,1320,58080
431244,202309,42,33,9,43561.52,11880,55441.52
431245,202309,60,45,15,59400.01,19800,79200.01
431247,202309,19,11,8,14520,10560,25080
431250,202309,332,163,169,215163.02,223080,438243.02
431260,202309,55,45,10,59400,13200,72600
431261,202309,24,17,7,22440.84,9240,31680.84
431262,202309,14,12,2,15840,2640,18480
431265,202309,153,91,62,120121.25,81840,201961.25
431267,202309,21,16,5,22440,6600,29040
431270,202309,356,269,87,355083.62,114840.55,469924.17
431275,202309,40,36,4,47520,5280,52800
431280,202309,21,16,5,21120,6600,27720
431290,202309,27,24,3,31680.39,3960,35640.39
431295,202309,4,1,3,1320,3960,5280
431300,202309,25,19,6,25080.6,7920,33000.6
431301,202309,7,7,0,9240,,9240.0
431303,202309,63,39,24,51480,31680,83160
431306,202309,254,126,128,166322.01,168960,335282.01
431308,202309,9,8,1,10560.6,1320,11880.6
431310,202309,62,48,14,63360.16,18480,81840.16
431320,202309,284,174,110,229681.32,145200,374881.32
431330,202309,237,165,72,219123.48,95040,314163.48
431333,202309,27,22,5,29040,6600,35640
431335,202309,10,7,3,9240.39,3960,13200.39
431337,202309,482,236,246,311531.69,324723.41,636255.10
431339,202309,25,20,5,26400,6600,33000
431340,202309,3554,1933,1621,2556792.89,2143688.82,4700481.71
431342,202309,42,27,15,35640,19800,55440
431344,202309,28,28,0,36960,,36960.0
431346,202309,5,4,1,5280,1320,6600
431349,202309,30,28,2,36960,2640,39600
431350,202309,1071,607,464,802591.31,612484.21,1415075.52
431360,202309,61,43,18,56760,23760,80520
431365,202309,400,171,229,225722.96,302280.49,528003.45
431370,202309,1301,730,571,963622.73,755043.91,1718666.64
431380,202309,105,91,14,120121.7,18480,138601.7
431390,202309,523,289,234,381482.86,308880.2,690363.06
431395,202309,341,149,192,196681.17,254760,451441.17
431400,202309,40,24,16,31680,21120,52800
431402,202309,91,67,24,88441.59,31680.71,120122.30
431403,202309,31,21,10,27720,13200,40920
431405,202309,830,498,332,657379.62,438245.57,1095625.19
431406,202309,37,30,7,39600.14,9240,48840.14
431407,202309,51,40,11,52800,14520,67320
431410,202309,3809,2330,1479,3080958.72,1956259.25,5037217.97
431413,202309,15,12,3,15840,3960,19800
431415,202309,80,58,22,76560.6,29040,105600.6
431417,202309,25,14,11,18480,14520,33000
431420,202309,399,263,136,347165.52,179520,526685.52
431430,202309,70,33,37,44881.03,48840,93721.03
431440,202309,10445,7001,3444,9246911.11,4548824.76,13795735.87
431442,202309,28,15,13,19800,17160,36960
431445,202309,31,29,2,38280,2640,40920
431446,202309,4,4,0,5280.71,,5280.71
431447,202309,90,68,22,89760,29040,118800
431449,202309,67,55,12,72600.28,15840,88440.28
431450,202309,448,293,155,388081.77,204600,592681.77
431454,202309,13,8,5,10560,6600,17160
431455,202309,50,38,12,50160.03,15840,66000.03
431460,202309,531,358,173,472568.43,228360,700928.43
431470,202309,144,106,38,139920.25,50160,190080.25
431475,202309,12,10,2,13200,2640,15840
431477,202309,40,24,16,31680,21120,52800
431478,202309,7,7,0,9240,,9240.0
431480,202309,800,485,315,640216.55,415802.54,1056019.09
431490,202309,34984,19613,15371,25912185.25,20316346.16,46228531.41
431500,202309,81,59,22,77880,29040,106920
431505,202309,30,22,8,29040.85,10560,39600.85
431507,202309,9,8,1,10560,1320,11880
431510,202309,242,174,68,229681.5,89760,319441.5
431513,202309,20,19,1,25082.06,1320,26402.06
431514,202309,7,5,2,6600,2640,9240
431515,202309,90,76,14,100320.43,18480,118800.43
431517,202309,9,7,2,9240,2640,11880
431520,202309,40,32,8,42240.2,10560,52800.2
431530,202309,1491,653,838,863290.87,1106161.13,1969452.00
431531,202309,26,24,2,31680.7,2640,34320.7
431532,202309,41,29,12,38280,15840,54120
431535,202309,30,17,13,22440,17160,39600
431540,202309,151,121,30,159722.88,39600,199322.88
431545,202309,12,9,3,11880,3960,15840
431550,202309,384,196,188,258724.68,248161.27,506885.95
431555,202309,19,16,3,21120.2,3960,25080.2
431560,202309,5571,3711,1860,4902670.26,2459201.48,7361871.74
431570,202309,964,515,449,679811.01,592684.81,1272495.82
431575,202309,61,38,23,51480.45,30360,81840.45
431580,202309,86,63,23,83160,30360,113520
431590,202309,154,127,27,167640,35640,203280
431595,202309,17,15,2,19800,2640,22440
431600,202309,277,163,114,215164.93,150481.23,365646.16
431610,202309,124,92,32,121441.77,42240.2,163681.97
431620,202309,35,28,7,36960,9240,46200
431630,202309,127,101,26,133320.79,34320,167640.79
431640,202309,1375,846,529,1119375.62,700921.01,1820296.63
431642,202309,35,30,5,39600,6600,46200
431643,202309,45,18,27,23760,35640,59400
431645,202309,352,208,144,275880.89,190080,465960.89
431647,202309,15,14,1,18480,1320,19800
431650,202309,35,20,15,26400,19800,46200
431660,202309,261,165,96,217801.43,126720,344521.43
431670,202309,248,106,142,141241.6,188760.11,330001.71
431673,202309,14,12,2,15840,2640,18480
431675,202309,29,22,7,29040,9240,38280
431680,202309,1315,942,373,1244803.73,493684.73,1738488.46
431690,202309,5633,3253,2380,4297828.84,3145600.24,7443429.08
431695,202309,17,11,6,14520,7920,22440
431697,202309,7,5,2,6600,2640,9240
431700,202309,206,152,54,200640.55,71280,271920.55
431710,202309,4607,1962,2645,2589876.93,3492733.75,6082610.68
431720,202309,1370,849,521,1121355.75,689040.59,1810396.34
431725,202309,3,1,2,1320,2640,3960
431730,202309,1312,851,461,1123371.3,608529.39,1731900.69
431740,202309,1391,676,715,892333.48,945124.93,1837458.41
431750,202309,1909,1253,656,1655177.5,867244.4,2522421.9
431755,202309,5,4,1,5280,1320,6600
431760,202309,1061,672,389,887059.59,514806.07,1401865.66
431770,202309,438,285,153,377521.62,201960,579481.62
431775,202309,27,19,8,25080,10560,35640
431780,202309,607,363,244,479162.58,322080,801242.58
431790,202309,150,118,32,157082.1,42240.1,199322.2
431795,202309,14,12,2,15840,2640,18480
431800,202309,3320,1718,1602,2270437.9,2119929.09,4390366.99
431805,202309,20,16,4,21120,5280,26400
431810,202309,594,386,208,509528.9,275880,785408.9
431820,202309,380,212,168,279840.78,221760,501600.78
431830,202309,2565,1558,1007,2059155.05,1333202.42,3392357.47
431840,202309,541,346,195,456732.79,257400.67,714133.46
431842,202309,36,29,7,38280,9240,47520
431843,202309,9,7,2,9240.9,2640,11880.9
431844,202309,18,14,4,18480.67,5280,23760.67
431845,202309,28,26,2,34320,2640,36960
431846,202309,29,24,5,31680.72,6600,38280.72
431848,202309,14,11,3,14520,3960,18480
431849,202309,8,7,1,9240,1320,10560
431850,202309,889,693,196,914783.63,258722.52,1173506.15
431860,202309,122,79,43,104280.48,56760,161040.48
431861,202309,4,0,4,,5280,5280.0
431862,202309,65,47,18,63360.65,23760,87120.65
431870,202309,4320,2532,1788,3350288.16,2362829.38,5713117.54
431880,202309,1081,757,324,999253.67,427681.29,1426934.96
431890,202309,1308,746,562,986052.04,744481.08,1730533.12
431900,202309,205,133,72,175560.24,95040,270600.24
431910,202309,50,39,11,51480.1,14520,66000.1
431912,202309,58,41,17,54121.05,22440,76561.05
431915,202309,161,124,37,163681.2,48840,212521.2
431920,202309,162,114,48,150480.35,63360,213840.35
431930,202309,83,67,16,88440,21120,109560
431935,202309,5,4,1,5280,1320,6600
431936,202309,4,4,0,5280,,5280.0
431937,202309,22,17,5,22440.2,6600,29040.2
431940,202309,488,338,150,447486.49,198000.36,645486.85
431950,202309,519,323,196,427695.14,258720.4,686415.54
431960,202309,794,441,353,582131,467280,1049411
431970,202309,65,59,6,77880,7920,85800
431971,202309,6,5,1,6600,1320,7920
431973,202309,20,17,3,22440.88,3960,26400.88
431975,202309,10,10,0,13200.2,,13200.2
431980,202309,225,129,96,170280.41,126720,297000.41
431990,202309,1099,612,487,807863.93,642851.11,1450715.04
432000,202309,2242,1219,1023,1609145.82,1350375.8,2959521.62
432010,202309,263,171,92,225721.1,121440.2,347161.3
432020,202309,207,174,33,229684.02,43560.4,273244.42
432023,202309,16,14,2,18480,2640,21120
432026,202309,65,57,8,75240,10560,85800
432030,202309,57,26,31,34320.19,40920,75240.19
432032,202309,15,12,3,15840,3960,19800
432035,202309,82,62,20,83160,26400,109560
432040,202309,93,67,26,88441.34,34320,122761.34
432045,202309,4,4,0,5280,,5280.0
432050,202309,85,53,32,69960.69,42240,112200.69
432055,202309,147,103,44,135961.56,58080,194041.56
432057,202309,7,4,3,5280,3960,9240
432060,202309,30,25,5,33000,6600,39600
432065,202309,30,25,5,33000,6600,39600
432067,202309,81,74,7,97680.4,9240,106920.4
432070,202309,412,327,85,434284.19,112200,546484.19
432080,202309,892,629,263,831633.38,347162.52,1178795.90
432085,202309,23,19,4,25080,5280,30360
432090,202309,292,192,100,254760.2,132000.33,386760.53
432100,202309,183,118,65,155760.21,87120,242880.21
432110,202309,608,401,207,529326.64,273240.04,802566.68
432120,202309,1178,673,505,888375.55,666602.42,1554977.97
432130,202309,571,401,170,529325.08,224400,753725.08
432132,202309,21,19,2,25080,2640,27720
432135,202309,82,63,19,83160.66,25080,108240.66
432140,202309,287,213,74,282481.29,97680,380161.29
432143,202309,247,152,95,200642.21,125400.24,326042.45
432145,202309,337,237,100,314163.04,132000,446163.04
432146,202309,17,15,2,19800,2640,22440
432147,202309,102,64,38,84480,50160,134640
432149,202309,13,12,1,15840,1320,17160
432150,202309,1231,781,450,1030942.63,594002.18,1624944.81
432160,202309,2298,1169,1129,1545752.65,1492932.43,3038685.08
432162,202309,8,4,4,5280,5280,10560
432163,202309,17,12,5,15840,6600,22440
432166,202309,144,100,44,132334.05,58081.23,190415.28
432170,202309,253,133,120,175567.61,158400.9,333968.51
432180,202309,608,392,216,517440.54,285120,802560.54
432183,202309,18,15,3,19800.43,3960,23760.43
432185,202309,82,68,14,89760.23,18480,108240.23
432190,202309,582,345,237,455401.75,314160.44,769562.19
432195,202309,101,79,22,104281.3,29040,133321.3
432200,202309,489,300,189,396006.8,249481.9,645488.7
432210,202309,119,70,49,92400.1,64680,157080.1
432215,202309,33,31,2,40920,2640,43560
432218,202309,21,21,0,27720,,27720.0
432220,202309,699,342,357,451447.49,471243.22,922690.71
432225,202309,20,15,5,19800.2,6600,26400.2
432230,202309,128,82,46,108240,60720.3,168960.3
432232,202309,35,31,4,40920,5280,46200
432234,202309,5,3,2,3960,2640,6600
432235,202309,2,2,0,2640,,2640.0
432237,202309,26,18,8,23760,10560,34320
432240,202309,4924,2729,2195,3607654.5,2898748.93,6506403.43
432250,202309,1274,857,417,1131253.94,551761.95,1683015.89
432252,202309,51,46,5,60720,6600,67320
432253,202309,80,60,20,79201.7,26400,105601.7
432254,202309,32,16,16,21120,21120,42240
432255,202309,11,10,1,13200,1320,14520
432260,202309,960,767,193,1013778.18,254760.1,1268538.28
432270,202309,242,181,61,238931.8,80521.93,319453.73
432280,202309,184,139,45,184804,59400,244204
432285,202309,2,2,0,2640,,2640.0
432290,202309,62,50,12,66000,15840,81840
432300,202309,5801,3138,2663,4143507.13,3521786.46,7665293.59
432310,202309,140,117,23,154441.15,30360,184801.15
432320,202309,23,17,6,22440,7920,30360
432330,202309,18,12,6,15840,7920,23760
432335,202309,10,7,3,9240,3960,13200
432340,202309,36,29,7,38280,9240,47520
432345,202309,135,92,43,121442.32,58080,179522.32
432350,202309,24,23,1,30360,1320,31680
432360,202309,6,5,1,6600.7,1320,7920.7
432370,202309,27,27,0,35640.92,,35640.92
432375,202309,30,28,2,36960,2640,39600
432377,202309,10,10,0,13200.48,,13200.48
432380,202309,254,118,136,155762.4,179522.9,335285.3
500020,202309,334,172,162,227043.11,213840.8,440883.91
500025,202309,154,73,81,96361.89,106921.12,203283.01
500060,202309,1651,1056,595,1393966.2,786729.23,2180695.43
500070,202309,836,415,421,549132.86,555731,1104863.86
500080,202309,156,127,29,167644.15,39600,207244.15
500085,202309,168,123,45,162363.53,59400,221763.53
500090,202309,423,199,224,262686.56,295682.25,558368.81
500100,202309,735,378,357,498974.1,471240.98,970215.08
500110,202309,2491,1221,1270,1611774,1676418.75,3288192.75
500124,202309,303,154,149,203280,196681.34,399961.34
500150,202309,335,135,200,178202.37,264000.65,442203.02
500190,202309,622,419,203,555743.51,267962.37,823705.88
500200,202309,224,183,41,241564.11,54120,295684.11
500210,202309,1863,579,1284,765612.41,1694892.23,2460504.64
500215,202309,217,125,92,165006.75,121440.2,286446.95
500220,202309,796,495,301,653425.86,397322.66,1050748.52
500230,202309,267,150,117,198002.97,154441.34,352444.31
500240,202309,708,434,274,576853.79,361682.2,938535.99
500260,202309,642,263,379,348485.07,500280.46,848765.53
500270,202309,34641,15234,19407,20120725.19,25636054.26,45756779.45
500280,202309,213,75,138,99000.32,182160.66,281160.98
500290,202309,1294,810,484,1069230.2,638883.46,1708113.66
500295,202309,542,360,182,475207.67,240241.09,715448.76
500310,202309,126,42,84,55440,110880.5,166320.5
500315,202309,941,509,432,671880.94,570242.56,1242123.50
500320,202309,4174,1939,2235,2559576.75,2950214.4,5509791.15
500325,202309,1035,582,453,768267.16,597965.03,1366232.19
500330,202309,1708,853,855,1126048.34,1129933.2,2255981.54
500345,202309,347,238,109,315485.91,143880.21,459366.12
500348,202309,277,168,109,221763.9,143880,365643.9
500350,202309,109,50,59,66002.17,77881.14,143883.31
500370,202309,6470,2974,3496,3928693.2,4617392.64,8546085.84
500375,202309,395,257,138,339243.16,182160.15,521403.31
500380,202309,733,404,329,534616.78,434282.08,968898.86
500390,202309,86,35,51,47520.1,67320.2,114840.3
500400,202309,244,143,101,188765.9,133320.97,322086.87
500410,202309,465,211,254,278530.2,335283.34,613813.54
500430,202309,674,407,267,537255.15,352441.5,889696.65
500440,202309,216,126,90,166320.14,118800.2,285120.34
500450,202309,484,210,274,277204.41,363001,640205.41
500460,202309,306,165,141,219123.52,186120.96,405244.48
500470,202309,481,339,142,448807.61,187440,636247.61
500480,202309,117,66,51,87120.56,67321.48,154442.04
500490,202309,108,51,57,67320.68,75243.59,142564.27
500500,202309,1646,609,1037,803906.51,1370166.93,2174073.44
500510,202309,41,35,6,46200.31,7920,54120.31
500515,202309,132,88,44,116162.13,58081.47,174243.60
500520,202309,329,166,163,219125.06,215160.16,434285.22
500525,202309,100,51,49,67320.14,64680,132000.14
500540,202309,1005,440,565,580822.26,747126,1327948.26
500560,202309,948,525,423,693014.73,559683.51,1252698.24
500568,202309,1268,571,697,753733.85,922687.35,1676421.20
500570,202309,1317,750,567,990016.84,748442.04,1738458.88
500580,202309,322,177,145,233646.8,191401.02,425047.82
500600,202309,445,209,236,275886.35,311521.64,587407.99
500620,202309,1148,796,352,1053385.06,465967.16,1519352.22
500625,202309,94,69,25,91080.41,33000,124080.41
500627,202309,54,25,29,33000,38280,71280
500630,202309,1745,1022,723,1348515.78,957005.54,2305521.32
500635,202309,535,316,219,417121.76,289080,706201.76
500640,202309,370,200,170,264010.76,224402.7,488413.46
500660,202309,6784,2388,4396,3153550.7,5809356.96,8962907.66
500690,202309,702,249,453,328685.58,599280.26,927965.84
500710,202309,453,222,231,294367.35,304925.26,599292.61
500720,202309,1066,587,479,774860.29,634923.21,1409783.50
500730,202309,147,89,58,117485.7,77880,195365.7
500740,202309,1049,454,595,599294.94,786724.59,1386019.53
500750,202309,226,83,143,110882.87,188761.15,299644.02
500755,202309,121,89,32,117484.21,42240.93,159725.14
500769,202309,822,458,364,604577.71,480483.04,1085060.75
500770,202309,471,250,221,330000.57,291720,621720.57
500780,202309,140,94,46,124086.96,60721.33,184808.29
500790,202309,1213,587,626,776186.95,827642.98,1603829.93
500793,202309,317,162,155,213843.56,204602.94,418446.50
500795,202309,213,131,82,172923.5,109560.7,282484.2
500797,202309,50,36,14,48840.62,18480,67320.62
500800,202309,487,209,278,277205.89,368281.97,645487.86
500830,202309,2638,1354,1284,1787349.69,1694890.25,3482239.94
500840,202309,113,81,32,106924.65,42240.94,149165.59
510010,202309,175,96,79,126720,104280,231000
510020,202309,581,279,302,368293.9,398643.11,766937.01
510025,202309,1939,1100,839,1452043.33,1107490.29,2559533.62
510030,202309,688,370,318,488417.13,421086.56,909503.69
510035,202309,137,72,65,95040.25,85800,180840.25
510040,202309,432,201,231,265322.59,306241.66,571564.25
510050,202309,394,203,191,270603.32,253440,524043.32
510060,202309,148,65,83,85803.45,109560,195363.45
510080,202309,266,116,150,154441.28,198000,352441.28
510100,202309,70,29,41,38280.55,54120.67,92401.22
510120,202309,34,20,14,26400.99,18480.04,44881.03
510125,202309,423,268,155,353761.9,205920.21,559682.11
510130,202309,565,337,228,444852.11,302282.17,747134.28
510140,202309,492,170,322,224401.15,425040.33,649441.48
510160,202309,117,48,69,63361.92,91081.31,154443.23
510170,202309,867,505,362,666614.7,477845.31,1144460.01
510180,202309,3258,1468,1790,1940450.53,2362820.13,4303270.66
510185,202309,44,23,21,30360.7,27720,58080.7
510190,202309,289,109,180,143881.77,237601.49,381483.26
510250,202309,3010,1813,1197,2395843.54,1581364.36,3977207.90
510260,202309,181,129,52,170282.5,68640.23,238922.73
510263,202309,518,295,223,389405.89,295683.12,685089.01
510267,202309,697,393,304,518778.03,401282.84,920060.87
510268,202309,88,44,44,58080.01,58080,116160.01
510269,202309,82,39,43,51480,56760.5,108240.5
510270,202309,409,196,213,258722.1,281160.31,539882.41
510279,202309,234,171,63,225722.23,83160,308882.23
510285,202309,197,82,115,108241.3,153120,261361.3
510300,202309,573,306,267,403924.77,352442.33,756367.10
510305,202309,219,94,125,124080.33,166320,290400.33
510310,202309,118,59,59,77880.02,77880.1,155760.12
510320,202309,881,551,330,727332.46,435603.15,1162935.61
510325,202309,485,213,272,281165.05,359042.32,640207.37
510330,202309,506,283,223,373566.67,294361.06,667927.73
510335,202309,732,441,291,583454.74,384122.5,967577.24
510336,202309,58,39,19,51481.13,25080.64,76561.77
510337,202309,111,47,64,62040.03,84480,146520.03
510340,202309,20984,8984,12000,11865903.73,15854759.56,27720663.29
510343,202309,64,50,14,66000,18480,84480
510345,202309,158,96,62,126721.92,81840.68,208562.60
510350,202309,716,382,334,504253.18,440886.7,945139.88
510360,202309,228,139,89,183484.13,118800,302284.13
510370,202309,182,78,104,102960,137280.7,240240.7
510380,202309,80,58,22,76560,29040,105600
510385,202309,57,32,25,42240.2,33000,75240.2
510390,202309,105,49,56,64680.06,73920.6,138600.66
510395,202309,59,42,17,55440,22440,77880
510410,202309,902,581,321,768265.41,425044.6,1193310.01
510420,202309,595,293,302,386764.09,398640.7,785404.79
510450,202309,55,32,23,42240,30360,72600
510452,202309,64,32,32,42240,42240,84480
510454,202309,56,26,30,34320,39600.03,73920.03
510455,202309,120,72,48,95040,63360.97,158400.97
510460,202309,213,94,119,125402.32,157080,282482.32
510480,202309,836,479,357,632300.67,472568.77,1104869.44
510490,202309,351,170,181,224402.31,238920.5,463322.81
510500,202309,254,189,65,249480.43,85800,335280.43
510510,202309,960,561,399,740537.06,526685.46,1267222.52
510515,202309,1411,741,670,978143.12,884405.46,1862548.58
510517,202309,293,131,162,172923.82,213840,386763.82
510520,202309,254,158,96,208563.61,126721.1,335284.71
510523,202309,125,98,27,129360,35640,165000
510525,202309,956,593,363,782775.75,481802.98,1264578.73
510530,202309,35,16,19,21120,25080,46200
510550,202309,267,120,147,158402.22,194041.82,352444.04
510558,202309,336,166,170,219123.36,224400,443523.36
510560,202309,410,241,169,318125.85,223082.22,541208.07
510562,202309,729,522,207,689062.72,274561.62,963624.34
510590,202309,749,357,392,471252.69,517443.3,988695.99
510600,202309,221,121,100,159724.85,132000.55,291725.40
510610,202309,240,108,132,142563.9,174241.4,316805.3
510615,202309,244,115,129,151800.65,170280.96,322081.61
510617,202309,26,11,15,14520,21120,35640
510618,202309,127,65,62,85800,83162.26,168962.26
510619,202309,89,61,28,80521.67,36960,117481.67
510620,202309,166,89,77,117480.7,101640,219120.7
510621,202309,184,120,64,158400.17,84480.23,242880.40
510622,202309,555,288,267,380172.52,352443.56,732616.08
510623,202309,311,209,102,275883.05,134640.2,410523.25
510624,202309,107,52,55,69257.87,72600.92,141858.79
510625,202309,583,351,232,463334.39,306244.55,769578.94
510626,202309,125,67,58,88442.42,76560,165002.42
510627,202309,106,71,35,93721.42,46200,139921.42
510628,202309,175,108,67,142561.87,88440,231001.87
510629,202309,321,196,125,258722,165023.76,423745.76
510630,202309,496,260,236,343214.22,311521.51,654735.73
510631,202309,23,10,13,13200.13,17160,30360.13
510637,202309,374,217,157,287762.1,208560.1,496322.2
510642,202309,1334,714,620,942499.99,821045.59,1763545.58
510645,202309,12,5,7,6600,9240,15840
510650,202309,1312,836,476,1103565.73,628324.01,1731889.74
510665,202309,104,48,56,63360.33,73920.08,137280.41
510670,202309,59,34,25,44880.72,33000,77880.72
510675,202309,1210,773,437,1021712.03,576844.49,1598556.52
510677,202309,379,205,174,270603.89,231000.51,501604.40
510680,202309,93,58,35,76561.85,46200,122761.85
510682,202309,212,100,112,132000.85,147840,279840.85
510685,202309,64,44,20,58080.55,26400.8,84481.35
510700,202309,648,370,278,488415.84,366963.2,855379.04
510704,202309,1425,731,694,964960.24,916093.82,1881054.06
510706,202309,180,92,88,121443.18,116161.66,237604.84
510710,202309,475,341,134,450126.64,176880,627006.64
510715,202309,58,39,19,51480,25080.63,76560.63
510718,202309,269,121,148,159722.65,195364.43,355087.08
510719,202309,57,27,30,35640,39600,75240
510720,202309,193,138,55,182160.37,72600,254760.37
510724,202309,80,30,50,40920,66000,106920
510726,202309,67,36,31,47520.7,40920.62,88441.32
510729,202309,16,5,11,6600,14520.3,21120.3
510730,202309,495,257,238,339242.46,315480,654722.46
510735,202309,126,48,78,63360.29,102960,166320.29
510740,202309,26,15,11,19800.91,14521.24,34322.15
510757,202309,41,34,7,44880.57,9240.16,54120.73
510760,202309,8459,4271,4188,5637852.54,5537438.36,11175290.90
510770,202309,790,355,435,468608.91,574202.54,1042811.45
510774,202309,17,6,11,7920.69,14520,22440.69
510775,202309,130,104,26,137280,34320,171600
510776,202309,37,13,24,17160,31680.2,48840.2
510777,202309,194,86,108,113520,142560,256080
510779,202309,37,23,14,30360,18480,48840
510780,202309,296,155,141,204608.94,187440,392048.94
510785,202309,358,195,163,257405.37,215160.05,472565.42
510787,202309,235,118,117,155765.88,155761.09,311526.97
510788,202309,11,4,7,5280.9,9240,14520.9
510790,202309,2997,1519,1478,2007834.96,1950967.38,3958802.34
510792,202309,1224,682,542,900382.11,715449.88,1615831.99
510794,202309,127,70,57,92401.06,75240,167641.06
510795,202309,2545,1423,1122,1878398.83,1482366.01,3360764.84
510800,202309,204,111,93,146521.56,122760,269281.56
510805,202309,235,161,74,212520.9,97680,310200.9
510810,202309,110,43,67,56761.25,88440.42,145201.67
510820,202309,273,141,132,187441.74,174241.09,361682.83
510830,202309,82,42,40,55440,52800,108240
510835,202309,29,22,7,29040.7,9240,38280.7
510840,202309,10537,4724,5813,6237247.42,7685116.62,13922364.04
510850,202309,221,89,132,118802.02,174240.26,293042.28
510860,202309,461,238,223,314163.19,294361.49,608524.68
510880,202309,82,59,23,77880.2,30360,108240.2
510885,202309,75,42,33,55441.44,43560,99001.44
510890,202309,82,40,42,52800.94,55440.26,108241.20
510895,202309,196,116,80,154440.44,105600,260040.44
520005,202309,173,71,102,93723.05,134641.86,228364.91
520010,202309,358,161,197,212522.53,260043.78,472566.31
520013,202309,812,567,245,748453.16,323403.76,1071856.92
520015,202309,43,28,15,36960,19800,56760
520017,202309,90,58,32,76560.84,42240,118800.84
520020,202309,12,6,6,7920,7920,15840
520025,202309,3467,1886,1581,2492268.83,2089615.64,4581884.47
520030,202309,990,516,474,681133.82,625684.55,1306818.37
520050,202309,63,47,16,62040.2,21120.9,83161.1
520055,202309,84,60,24,79200,31680.2,110880.2
520060,202309,202,137,65,180842.98,85801.25,266644.23
520080,202309,625,445,180,588721.26,237600.55,826321.81
520082,202309,19,12,7,15840,9240,25080
520085,202309,121,97,24,128480.18,31680.7,160160.88
520090,202309,91,66,25,87120.75,33000,120120.75
520110,202309,10398,4406,5992,5822672.06,7921380.66,13744052.72
520120,202309,12,8,4,10560,5280,15840
520130,202309,945,668,277,882430.79,366961.42,1249392.21
520140,202309,13691,7420,6271,9801326.84,8283087.01,18084413.85
520145,202309,71,40,31,52800.2,40920,93720.2
520150,202309,141,109,32,143886.85,42240,186126.85
520160,202309,47,30,17,39600,22440,62040
520170,202309,219,123,96,162366.61,126721.32,289087.93
520180,202309,219,106,113,139920.74,149161.16,289081.90
520215,202309,208,154,54,203280.59,71280.2,274560.79
520235,202309,93,68,25,89760,33000,122760
520250,202309,176,89,87,117481.91,114840,232321.91
520260,202309,132,81,51,106924.44,67321.05,174245.49
520280,202309,60,42,18,55440,23760,79200
520310,202309,35,18,17,23761.8,22440.7,46202.5
520320,202309,198,122,76,161042.52,101640.97,262683.49
520330,202309,925,513,412,677175.7,543843.86,1221019.56
520340,202309,316,182,134,240249.42,178201.46,418450.88
520350,202309,514,264,250,348484.27,332642.59,681126.86
520355,202309,113,67,46,88441.79,60720,149161.79
520357,202309,40,29,11,38280,14520,52800
520360,202309,23,9,14,11880.2,18480.28,30360.48
520380,202309,149,83,66,109560,88440,198000
520390,202309,249,109,140,143883.34,184800,328683.34
520393,202309,19,15,4,19800.1,5280,25080.1
520396,202309,78,57,21,75240,29040,104280
520400,202309,226,139,87,183484.12,114841.99,298326.11
520410,202309,219,120,99,158404.99,130680,289084.99
520420,202309,26,19,7,25080.65,9240,34320.65
520425,202309,266,123,143,162362.7,188760.18,351122.88
520430,202309,586,273,313,360361.68,413160.9,773522.58
520440,202309,743,539,204,711496.28,269281.33,980777.61
520450,202309,2445,1064,1381,1404519.73,1825579.08,3230098.81
520455,202309,73,41,32,54121.37,42240.51,96361.88
520460,202309,50,30,20,39600.69,26401.51,66002.20
520465,202309,43,38,5,50160,6600,56760
520470,202309,496,306,190,403923.57,252120.2,656043.77
520480,202309,78,52,26,68641.47,34320,102961.47
520485,202309,114,46,68,60720.83,89760.1,150480.93
520490,202309,594,435,159,574211.22,209882.68,784093.90
520495,202309,179,108,71,142560.1,95040,237600.1
520500,202309,270,222,48,293041.61,63360,356401.61
520505,202309,198,116,82,153120,108240,261360
520510,202309,2312,1074,1238,1422985.95,1636809.25,3059795.20
520520,202309,69,46,23,60720.97,30360,91080.97
520530,202309,218,174,44,231006.05,58080,289086.05
520540,202309,861,586,275,773532.85,364322.34,1137855.19
520545,202309,163,98,65,129364.43,85800.6,215165.03
520547,202309,84,47,37,62042.64,48840.1,110882.74
520549,202309,1726,848,878,1120714.72,1161615.97,2282330.69
520551,202309,352,187,165,246841.33,217801.23,464642.56
520552,202309,62,46,16,60720.5,21120,81840.5
520570,202309,16,12,4,15840,5280,21120
520580,202309,301,188,113,249619.36,149160.47,398779.83
520590,202309,167,92,75,121442.91,99000,220442.91
520620,202309,1413,657,756,867252.14,999247.15,1866499.29
520630,202309,57,29,28,38280,36960.18,75240.18
520640,202309,416,246,170,324726,224400.9,549126.9
520650,202309,78,37,41,48840,55440,104280
520660,202309,46,25,21,33000.85,27720.38,60721.23
520670,202309,49,37,12,48840.22,15840,64680.22
520680,202309,25,15,10,19800,13200,33000
520690,202309,41,11,30,14520,39600,54120
520710,202309,39,28,11,36960,14520,51480
520725,202309,209,154,55,203282.83,72600,275882.83
520735,202309,65,39,26,51480.2,34320.2,85800.4
520740,202309,495,245,250,323406.2,330001.22,653407.42
520750,202309,43,24,19,31680,25080,56760
520753,202309,86,62,24,81840.76,31680,113520.76
520760,202309,110,76,34,100321.11,44880,145201.11
520780,202309,275,211,64,278524.54,84482.63,363007.17
520790,202309,147,90,57,118800.4,75240,194040.4
520800,202309,3786,2155,1631,2845425.87,2158222.89,5003648.76
520810,202309,140,109,31,143882.22,40920.89,184803.11
520815,202309,7,5,2,6600.96,2640,9240.96
520830,202309,134,94,40,124083.56,52800.05,176883.61
520840,202309,434,274,160,361680.67,211200,572880.67
520850,202309,115,66,49,87122.18,64680,151802.18
520860,202309,2020,1268,752,1675118.93,992644.61,2667763.54
520870,202309,37907,17070,20837,22543714.9,27536807.1,50080522.0
520880,202309,1464,767,697,1012482.31,920055.86,1932538.17
520890,202309,908,590,318,779217.27,421081.57,1200298.84
520910,202309,1040,540,500,712824.46,660002.25,1372826.71
520915,202309,95,62,33,81842.29,43560,125402.29
520920,202309,572,270,302,356411.05,401285.86,757696.91
520929,202309,16,14,2,18480.3,2640,21120.3
520940,202309,67,50,17,66001.01,22440.1,88441.11
520945,202309,21,13,8,17160,10560,27720
520960,202309,47,28,19,36960,25080,62040
520970,202309,473,273,200,360366.86,264004.3,624371.16
520980,202309,93,67,26,88440,34320,122760
520990,202309,451,317,134,419761.78,176880.63,596642.41
520993,202309,122,63,59,83163.41,77880.09,161043.50
520995,202309,286,160,126,211203.4,166320,377523.4
521000,202309,1749,945,804,1247424.59,1065249.31,2312673.90
521010,202309,676,363,313,479167.9,413162.78,892330.68
521015,202309,15,10,5,13200,6600,19800
521020,202309,1595,1114,481,1471833.41,637567.25,2109400.66
521030,202309,87,61,26,80520.95,34320,114840.95
521040,202309,1096,746,350,984743.64,462001.54,1446745.18
521056,202309,64,41,23,54120,31680,85800
521060,202309,131,85,46,112201.1,63360,175561.1
521080,202309,316,251,65,332658.7,87120.4,419779.1
521090,202309,637,436,201,575529.91,265320,840849.91
521100,202309,296,206,90,273246.38,118800.4,392046.78
521120,202309,1170,828,342,1094306.64,451443.65,1545750.29
521130,202309,335,242,93,319447.2,122760,442207.2
521140,202309,200,112,88,147844.57,116160.69,264005.26
521150,202309,2770,1158,1612,1531253.19,2130508.8,3661761.99
521160,202309,26,10,16,13200,21120,34320
521170,202309,231,128,103,168961.03,135960.2,304921.23
521180,202309,1329,829,500,1094309.21,660006.37,1754315.58
521190,202309,2903,1221,1682,1613080,2220254.28,3833334.28
521200,202309,66,48,18,63360.1,23760,87120.1
521205,202309,25,17,8,22440.2,10560,33000.2
521210,202309,147,89,58,117482.42,76560,194042.42
521220,202309,810,546,264,723373.02,348482.19,1071855.21
521225,202309,16,11,5,14521.1,6600.51,21121.61
521230,202309,113,76,37,100321.86,48840,149161.86
521250,202309,7112,3926,3186,5183845.38,4210849.5,9394694.88
521260,202309,52,22,30,29040,39600,68640
521270,202309,130,98,32,129360.65,42240,171600.65
521280,202309,436,266,170,351122.13,224400,575522.13
521290,202309,34,18,16,23760.97,21120,44880.97
521295,202309,112,75,37,99000.93,48840,147840.93
521300,202309,268,156,112,207241.94,147840.73,355082.67
521305,202309,50,35,15,46202.33,19800,66002.33
521308,202309,1093,849,244,1120711.16,322083.97,1442795.13
521310,202309,1535,833,702,1099594.59,927973.48,2027568.07
521340,202309,26,19,7,25080,9240,34320
521350,202309,98,73,25,96362.44,33000,129362.44
521370,202309,184,120,64,158400.5,84480,242880.5
521375,202309,218,101,117,134642.89,154441.26,289084.15
521377,202309,50,37,13,48840.57,17160.1,66000.67
521380,202309,1175,682,493,901596.83,650767.36,1552364.19
521385,202309,12,6,6,7920,7920,15840
521390,202309,111,90,21,118802.56,27720.49,146523.05
521400,202309,422,306,116,403931.78,153120.92,557052.70
521405,202309,179,118,61,155762.8,80520.66,236283.46
521410,202309,86,63,23,83161.27,30360,113521.27
521440,202309,232,155,77,204604.76,101640.64,306245.40
521450,202309,856,468,388,617773.16,513483.96,1131257.12
521460,202309,1216,861,355,1137887.13,469927.05,1607814.18
521470,202309,17,12,5,15840,6600,22440
521480,202309,45,28,17,36961.04,22440,59401.04
521483,202309,357,238,119,315482.7,157081.47,472564.17
521486,202309,335,228,107,300960.5,141240.84,442201.34
521487,202309,25,14,11,18480,14520,33000
521490,202309,28,16,12,21120,15840,36960
521500,202309,162,77,85,101641.05,112200.19,213841.24
521520,202309,48,37,11,48840,14520,63360
521523,202309,1363,746,617,984743.04,814443.91,1799186.95
521525,202309,66,51,15,67320,19800,87120
521530,202309,258,147,111,194040.25,146520.49,340560.74
521540,202309,46,23,23,30360,30360,60720
521550,202309,137,69,68,91081.19,89760.99,180842.18
521560,202309,1010,686,324,908183.07,429002.48,1337185.55
521565,202309,77,54,23,71281.28,30360.7,101641.98
521570,202309,645,403,242,531969.32,319440.87,851410.19
521580,202309,44,28,16,36960,21120,58080
521590,202309,48,26,22,34320,29040,63360
521600,202309,23,11,12,14520,17160,31680
521630,202309,243,126,117,166325.76,154444.53,320770.29
521640,202309,332,181,151,238922.23,199320.67,438242.90
521645,202309,40,19,21,25080,27720,52800
521680,202309,272,166,106,219123.97,139920.87,359044.84
521690,202309,16,14,2,18480,2640,21120
521710,202309,1205,580,625,765613,825005.81,1590618.81
521720,202309,641,433,208,572884.68,274561.13,847445.81
521730,202309,793,364,429,480485.62,567601.32,1048086.94
521740,202309,998,479,519,632287.2,686404.02,1318691.22
521760,202309,2821,1472,1349,1943205.61,1780710.71,3723916.32
521770,202309,905,554,351,731289.1,464643.35,1195932.45
521800,202309,2141,1469,672,1940441.01,888361.6,2828802.61
521805,202309,41,26,15,34320,19800,54120
521810,202309,94,56,38,73920.94,50160,124080.94
521830,202309,1111,821,290,1085074.54,382806.13,1467880.67
521839,202309,73,42,31,55440,40920.2,96360.2
521850,202309,1300,649,651,856703.36,861969.39,1718672.75
521860,202309,361,229,132,302284.8,174240,476524.8
521870,202309,112,79,33,104280,43560,147840
521878,202309,37,15,22,19800,29040.02,48840.02
521880,202309,5685,2530,3155,3341024.15,4167271.43,7508295.58
521890,202309,702,480,222,633611.68,293042.31,926653.99
521900,202309,297,228,69,300960.39,91080.8,392041.19
521910,202309,193,131,62,172924.8,81841.48,254766.28
521920,202309,37,23,14,30360,18480,48840
521925,202309,62,35,27,46200,35640,81840
521930,202309,1375,777,598,1025675.69,790690.99,1816366.68
521935,202309,39,30,9,39602.08,11880,51482.08
521940,202309,251,112,139,147841.52,184800.68,332642.20
521945,202309,23,15,8,19800,10560,30360
521950,202309,28,17,11,22440,14520,36960
521960,202309,71,55,16,72600,21120,93720
521970,202309,428,278,150,366963.39,198000.89,564964.28
521971,202309,106,60,46,79200.8,60720,139920.8
521973,202309,41,20,21,26400.6,27720,54120.6
521975,202309,1913,1030,883,1360958.02,1168216.38,2529174.40
521980,202309,256,174,82,229682.22,108240,337922.22
521990,202309,97,67,30,88441.13,39600,128041.13
522000,202309,310,212,98,279588.82,129360.79,408949.61
522005,202309,19,11,8,14520,10560,25080
522010,202309,1285,718,567,947789.88,751091.9,1698881.78
522015,202309,65,40,25,52800,33000,85800
522020,202309,987,614,373,810492.7,493685.73,1304178.43
522026,202309,30,18,12,23760,15840,39600
522028,202309,26,23,3,30360,3960,34320
522040,202309,911,417,494,550454.32,652087.75,1202542.07
522045,202309,3093,1811,1282,2391929.12,1693569.22,4085498.34
522050,202309,167,74,93,97684.91,122760.72,220445.63
522060,202309,569,356,213,469931.98,281160.35,751092.33
522068,202309,125,91,34,120120.89,44880,165000.89
522070,202309,19,17,2,22440,2640,25080
522100,202309,37,23,14,30360,18480,48840
522108,202309,44,34,10,44882.54,13200,58082.54
522119,202309,76,43,33,56761.01,43560,100321.01
522130,202309,89,33,56,43561.27,73920.89,117482.16
522140,202309,4780,2504,2276,3306707.52,3005662.56,6312370.08
522145,202309,57,39,18,51480.2,23760,75240.2
522150,202309,124,87,37,114840.19,50160.84,165001.03
522155,202309,67,44,23,58080.9,30360,88440.9
522157,202309,19,11,8,14520,10560,25080
522160,202309,1795,1064,731,1404519.11,967567.76,2372086.87
522170,202309,378,260,118,343208.87,155760,498968.87
522180,202309,35,16,19,21120,25080,46200
522185,202309,3015,1371,1644,1811108.22,2171446.38,3982554.60
522190,202309,86,50,36,66000.92,47520,113520.92
522200,202309,357,205,152,270602.44,200640.24,471242.68
522205,202309,142,98,44,129362.73,58080.1,187442.83
522220,202309,143,111,32,146520.2,42240,188760.2
522230,202309,38,32,6,42240.41,7920,50160.41
530010,202309,64952,33194,31758,43839884.04,41945195.95,85785079.99
110001,202310,572,464,108,612487.23,142560,755047.23
110002,202310,3380,2192,1188,2894829.35,1572127.2,4466956.55
110003,202310,86,66,20,87120.72,26400,113520.72
110004,202310,2376,1657,719,2187289.97,950405.69,3137695.66
110005,202310,479,371,108,489726.03,142560.2,632286.23
110006,202310,487,356,131,471025.44,172920,643945.44
110007,202310,81,64,17,84480,22440,106920
110008,202310,308,178,130,234962.3,171600.6,406562.9
110009,202310,1054,823,231,1086368.2,304920,1391288.2
110010,202310,1865,1020,845,1346424.83,1115402.91,2461827.74
110011,202310,1832,1414,418,1867858.24,553088.55,2420946.79
110012,202310,4511,2604,1907,3438668.38,2521220.17,5959888.55
110013,202310,840,676,164,892345.98,216481.89,1108827.87
110014,202310,358,319,39,421087.04,51480,472567.04
110015,202310,1452,1103,349,1455978.41,462002.77,1917981.18
110018,202310,1110,708,402,934578.53,530640.2,1465218.73
110020,202310,18872,10640,8232,14050699.28,10875601.12,24926300.40
110025,202310,678,501,177,661324.98,234960.2,896285.18
110026,202310,38,27,11,35640.57,14520,50160.57
110028,202310,1767,1239,528,1635517.77,698285.63,2333803.40
110029,202310,131,119,12,157082.53,15840,172922.53
110030,202310,2636,1690,946,2231948.49,1250046.42,3481994.91
110032,202310,378,294,84,389411.29,110884.12,500295.41
110033,202310,751,537,214,710187.17,282486.28,992673.45
110034,202310,347,270,77,356401.77,101640,458041.77
110037,202310,104,88,16,116161.1,21120,137281.1
110040,202310,469,328,141,432962.5,186120,619082.5
110045,202310,1075,780,295,1029632.19,389401.77,1419033.96
110050,202310,93,84,9,110881.17,11880,122761.17
110060,202310,71,52,19,68641.82,25080,93721.82
110070,202310,122,84,38,110881.2,50160,161041.2
110080,202310,628,366,262,483125.03,345840.06,828965.09
110090,202310,27,21,6,27720,7920,35640
110092,202310,145,75,70,99000.2,92400,191400.2
110094,202310,258,186,72,245522.31,95040,340562.31
110100,202310,67,50,17,66000.58,22440.06,88440.64
110110,202310,129,76,53,100322.59,69960,170282.59
110120,202310,79,67,12,88442.18,15840,104282.18
110130,202310,271,222,49,293045.01,66000.1,359045.11
110140,202310,295,210,85,277203.61,112200.1,389403.71
110143,202310,60,49,11,64680.9,14520,79200.9
110145,202310,51,38,13,50160,17160,67320
110146,202310,35,14,21,18480.2,27720,46200.2
110147,202310,45,27,18,36960.51,23760.58,60721.09
110148,202310,40,30,10,39600.7,13200,52800.7
110149,202310,332,234,98,308881.29,129360,438241.29
110150,202310,153,123,30,162361.95,39600,201961.95
110155,202310,14,13,1,17160,1320,18480
110160,202310,75,57,18,75241.21,23760,99001.21
110170,202310,232,178,54,234963.76,71280,306243.76
110175,202310,73,58,15,76560,19800,96360
110180,202310,93,74,19,97681.66,25080,122761.66
120001,202310,261,192,69,253450.69,91080.53,344531.22
120005,202310,256,150,106,198003.33,139920,337923.33
120010,202310,1268,773,495,1020373.37,654721.97,1675095.34
120013,202310,199,135,64,178202.76,84480.1,262682.86
120017,202310,156,97,59,128041.2,77881.15,205922.35
120020,202310,3657,2950,707,3898051.13,935889.81,4833940.94
120025,202310,644,348,296,459404.76,390739.42,850144.18
120030,202310,1296,1122,174,1481104.61,229688.66,1710793.27
120032,202310,48,42,6,56760,7920,64680
120033,202310,244,212,32,279848.91,42240.55,322089.46
120034,202310,214,162,52,213841.34,68640,282481.34
120035,202310,63,56,7,73920.1,9240,83160.1
120038,202310,456,302,154,398651.84,203281.75,601933.59
120039,202310,39,36,3,47521.1,3960,51481.1
120040,202310,16356,11016,5340,14547881.99,7058338.43,21606220.42
120042,202310,61,55,6,72603.24,7920.65,80523.89
120043,202310,19,5,14,6600,18480,25080
120045,202310,613,389,224,513500.64,295682.76,809183.40
120050,202310,1421,1079,342,1425665.12,451450.69,1877115.81
120060,202310,1620,1353,267,1785267.21,353766.64,2139033.85
120070,202310,475,352,123,464654.87,162360.42,627015.29
120080,202310,235,163,72,215165.44,95040.55,310205.99
130002,202310,177,130,47,171600.95,62040,233640.95
130006,202310,117,80,37,105600,48840,154440
130008,202310,136,81,55,106920.73,72600,179520.73
130010,202310,182,117,65,154440.2,85800.85,240241.05
130014,202310,347,245,102,323732.96,134641.73,458374.69
130020,202310,164,114,50,150480.9,66000,216480.9
130030,202310,1076,610,466,805208.3,616441.94,1421650.24
130040,202310,436,230,206,303603.27,271920.95,575524.22
130050,202310,592,318,274,419778.16,361691.97,781470.13
130060,202310,918,618,300,815761.73,396000.7,1211762.43
130063,202310,663,434,229,572882.91,303600,876482.91
130068,202310,242,150,92,198002.16,121440.44,319442.60
130070,202310,1470,979,491,1292307.01,648128.24,1940435.25
130080,202310,739,510,229,673207.33,302282.88,975490.21
130083,202310,99,65,34,85800.96,44880,130680.96
130090,202310,367,231,136,304922.38,180840,485762.38
130100,202310,1468,792,676,1045451.8,892328.37,1937780.17
130110,202310,910,410,500,541203.71,660000.68,1201204.39
130115,202310,174,90,84,118800,110880.7,229680.7
130120,202310,1846,1151,695,1519337,918721.49,2438058.49
130130,202310,705,487,218,642841.56,287760.95,930602.51
130140,202310,1594,1246,348,1644732.59,459360.96,2104093.55
130150,202310,465,419,46,553081.57,60720,613801.57
130160,202310,484,306,178,403921.6,234960,638881.6
130165,202310,152,133,19,175560,25080,200640
130170,202310,1410,968,442,1277716.66,583453.71,1861170.37
130180,202310,310,246,64,324722.81,84480.1,409202.91
130185,202310,2429,1225,1204,1617041.18,1589297.07,3206338.25
130190,202310,3650,2307,1343,3050611.34,1772779.74,4823391.08
130195,202310,310,247,63,326040,83160,409200
130200,202310,237,152,85,200642.39,112200,312842.39
130210,202310,95,43,52,56760,68640,125400
130220,202310,230,177,53,233640.57,69960,303600.57
130230,202310,367,250,117,330000,154440,484440
130240,202310,1479,1007,472,1329250.46,623042.59,1952293.05
130250,202310,5313,3485,1828,4601620.72,2415626.76,7017247.48
130255,202310,461,243,218,320760.52,287760.87,608521.39
130260,202310,74892,35118,39774,46378856.86,52539846.67,98918703.53
130270,202310,1564,1086,478,1433653.91,630962.3,2064616.21
130280,202310,151,90,61,118800.9,80520,199320.9
130290,202310,2197,1401,796,1849354.13,1050726.26,2900080.39
130300,202310,440,300,140,396001.5,184802.19,580803.69
130310,202310,1004,570,434,752405.29,572880.5,1325285.79
130320,202310,590,328,262,432960.95,345840,778800.95
130330,202310,803,540,263,712806.73,347160.84,1059967.57
130340,202310,3779,2053,1726,2710052.92,2279669.67,4989722.59
130350,202310,494,359,135,473880,178200,652080
130353,202310,1073,520,553,686418.45,731290.08,1417708.53
130356,202310,951,446,505,588725.96,666603.92,1255329.88
130360,202310,109,86,23,113520.2,30360,143880.2
130370,202310,698,557,141,735243.96,186120,921363.96
130380,202310,699,545,154,719403.93,203280.06,922683.99
130390,202310,503,415,88,547800,116160,663960
130395,202310,175,71,104,93720.61,137280,231000.61
130400,202310,101,76,25,100321.39,33000,133321.39
130406,202310,2373,1354,1019,1787298.58,1346403.75,3133702.33
130410,202310,511,295,216,389400,285120,674520
130420,202310,3029,2467,562,3256533,743162.72,3999695.72
130423,202310,219,142,77,187440.95,101640,289080.95
130426,202310,203,117,86,154440,113520,267960
130430,202310,456,271,185,357724.77,245520,603244.77
130440,202310,213,79,134,104284.47,176882.09,281166.56
140002,202310,67,22,45,29040.2,59400.6,88440.8
140005,202310,271,156,115,205925.2,151801.4,357726.6
140010,202310,15631,8430,7201,11129409.83,9506816.42,20636226.25
140015,202310,396,86,310,113522.58,409201.82,522724.40
140017,202310,181,103,78,135967.48,102962.88,238930.36
140020,202310,518,350,168,462014.32,221765.37,683779.69
140023,202310,104,60,44,79200,58080.28,137280.28
140028,202310,34,18,16,23760.77,21121.32,44882.09
140030,202310,481,306,175,403934.08,231001.31,634935.39
140040,202310,92,60,32,79200.6,42240,121440.6
140045,202310,553,132,421,174241.57,555723.52,729965.09
140047,202310,733,463,270,612494.33,356401.81,968896.14
140050,202310,174,108,66,142563.7,87122.36,229686.06
140060,202310,115,81,34,106921.39,44880.2,151801.59
140070,202310,28,27,1,35640.2,1320,36960.2
150010,202310,5864,3565,2299,4707248.52,3036028.57,7743277.09
150013,202310,197,130,67,171600.99,88440.99,260041.98
150020,202310,1272,737,535,972856.47,706201.76,1679058.23
150030,202310,768,367,401,484459.54,529322.97,1013782.51
150034,202310,235,136,99,179520.71,130680.5,310201.21
150040,202310,1932,1146,786,1512799.58,1038869.64,2551669.22
150050,202310,868,524,344,691686.24,454081.19,1145767.43
150060,202310,5659,3538,2121,4675457.96,2812183.65,7487641.61
150070,202310,260,201,59,265334.93,77882.29,343217.22
150080,202310,21112,10003,11109,13209842.57,14669476.83,27879319.40
150085,202310,588,359,229,473893.98,302284.02,776178.00
150090,202310,895,716,179,945146.25,236283.58,1181429.83
150095,202310,106,73,33,96361.1,43561,139922.1
150100,202310,91,57,34,75240.9,44881.25,120122.15
150110,202310,233,144,89,190081.2,117480.1,307561.3
150120,202310,423,304,119,401290.29,157080.7,558370.99
150125,202310,47,22,25,29040,33000,62040
150130,202310,2893,1420,1473,1876405.8,1948560.39,3824966.19
150140,202310,69728,30044,39684,39666329.86,52406335.74,92072665.60
150145,202310,313,176,137,232324.65,182160,414484.65
150150,202310,4176,1854,2322,2447355.28,3066404.42,5513759.70
150157,202310,402,289,113,381490.83,149160.13,530650.96
150160,202310,207,154,53,203281.57,71280.42,274561.99
150170,202310,4697,3352,1345,4426079.71,1775422.21,6201501.92
150172,202310,444,319,125,421085.55,165001.2,586086.75
150175,202310,94,52,42,68640.3,55440.7,124081.0
150178,202310,895,607,288,801264.94,380167.96,1181432.90
150180,202310,4834,2348,2486,3103392.61,3282851.62,6386244.23
150190,202310,462,321,141,423731.93,187443.98,611175.91
150195,202310,161,93,68,122760.2,89760.61,212520.81
150200,202310,231,131,100,172920.98,132000.2,304921.18
150210,202310,3537,2711,826,3578656.81,1091654.19,4670311.00
150215,202310,842,485,357,640223.42,471250.38,1111473.80
150220,202310,3961,2620,1341,3458507.18,1771474.4,5229981.58
150230,202310,1657,1315,342,1735855.48,451448.77,2187304.25
150240,202310,8644,4788,3856,6321723.31,5093986.04,11415709.35
150250,202310,102,61,41,80521.52,54120.92,134642.44
150260,202310,155,106,49,139923.28,64680.8,204604.08
150270,202310,2367,1530,837,2019638.7,1104845.15,3124483.85
150275,202310,632,418,214,551776.14,282482.63,834258.77
150276,202310,137,50,87,66000.2,114841.38,180841.58
150277,202310,976,428,548,564975.46,723376.18,1288351.64
150280,202310,194,189,5,249488.36,6600,256088.36
150285,202310,203,118,85,155761.8,111988.8,267750.6
150290,202310,1471,845,626,1115428.67,827649.98,1943078.65
150293,202310,993,458,535,604577.84,706208.06,1310785.90
150295,202310,675,336,339,443536.88,447482.09,891018.97
150300,202310,129,74,55,97681.98,72600,170281.98
150304,202310,241,146,95,192724.41,125403.67,318128.08
150307,202310,496,409,87,539892.82,114840.5,654733.32
150309,202310,678,483,195,637591.3,257403.6,894994.9
150310,202310,331,227,104,299644.28,137280,436924.28
150320,202310,2142,1485,657,1960238.13,867247.34,2827485.47
150330,202310,2400,1384,1016,1826903.32,1341125.31,3168028.63
150340,202310,226,142,84,187442.85,110880.42,298323.27
150345,202310,739,412,327,543849.46,431640,975489.46
150350,202310,484,388,96,512189.7,126723.25,638912.95
150360,202310,5879,3445,2434,4548832.52,3218191.83,7767024.35
150370,202310,962,634,328,836912.58,432966.57,1269879.15
150375,202310,224,91,133,120120.98,175560.68,295681.66
150380,202310,1698,1141,557,1506152.63,735245.35,2241397.98
150390,202310,1057,626,431,826360.41,570244.99,1396605.40
150400,202310,141,121,20,159720.4,26400,186120.4
150405,202310,1851,1181,670,1560267.48,884403.41,2444670.89
150410,202310,111,70,41,92400.77,54120.2,146520.97
150420,202310,8976,4874,4102,6436810.26,5416078.48,11852888.74
150430,202310,765,476,289,628363.82,381489.74,1009853.56
150440,202310,527,319,208,421092.44,274562.47,695654.91
150442,202310,2802,1504,1298,1985351.58,1713383.13,3698734.71
150445,202310,636,419,217,553088.13,286440.2,839528.33
150450,202310,79,55,24,72601.73,31680.1,104281.83
150460,202310,773,588,185,776188.87,244202.2,1020391.07
150470,202310,1422,866,556,1143160.71,733925.73,1877086.44
150475,202310,295,219,76,290410.04,100323.49,390733.53
150480,202310,1653,1177,476,1553710.96,629649.9,2183360.86
150490,202310,656,408,248,538570.32,327360.9,865931.22
150495,202310,403,307,96,405241.11,126720,531961.11
150497,202310,318,207,111,273242.46,146520.1,419762.56
150500,202310,313,184,129,242882.13,170280,413162.13
150503,202310,1658,824,834,1089027.09,1102210.9,2191237.99
150506,202310,1008,694,314,916097.43,414482.1,1330579.53
150510,202310,1554,890,664,1174833.88,876488.66,2051322.54
150520,202310,362,243,119,320760.87,157080.4,477841.27
150530,202310,2367,1414,953,1869279.13,1260662.32,3129941.45
150540,202310,274,197,77,260042.13,101640.5,361682.63
150543,202310,1042,531,511,700937.69,674527.88,1375465.57
150548,202310,506,361,145,476524.57,191402.86,667927.43
150549,202310,104,71,33,93722.55,43560.26,137282.81
150550,202310,3652,1861,1791,2457919.17,2364148.52,4822067.69
150553,202310,4515,2543,1972,3356890.87,2605712.25,5962603.12
150555,202310,158,87,71,114840.2,95040.83,209881.03
150560,202310,113,59,54,77880.75,71280,149160.75
150563,202310,157,88,69,116165.47,91082.49,207247.96
150565,202310,245,148,97,196681.61,128040.81,324722.42
150570,202310,463,309,154,407881.28,203280,611161.28
150580,202310,1938,1016,922,1341133.25,1217041.19,2558174.44
150590,202310,968,656,312,865949.02,411841.85,1277790.87
150600,202310,585,386,199,509535.43,262685.32,772220.75
150610,202310,222,166,56,219122.43,73920,293042.43
150611,202310,186,128,58,168960,76560,245520
150613,202310,3934,2189,1745,2889567.06,2307484.36,5197051.42
150616,202310,666,357,309,471247.2,407883.63,879130.83
150618,202310,1599,814,785,1074489.23,1036202.09,2110691.32
150619,202310,476,364,112,480489.31,149164.44,629653.75
150620,202310,1487,848,639,1119390.58,844804.48,1964195.06
150630,202310,233,157,76,207254.95,100321.9,307576.85
150635,202310,559,265,294,349808.49,388085.1,737893.59
150640,202310,62,28,34,36961.68,44880,81841.68
150650,202310,2764,1596,1168,2108135.74,1541800.58,3649936.32
150655,202310,315,221,94,291721.18,124080,415801.18
150658,202310,65,44,21,58080,27720,85800
150660,202310,746,461,285,608531.08,376205.48,984736.56
150670,202310,1311,494,817,653411.86,1079766.68,1733178.54
150680,202310,13076,6988,6088,9228546.94,8042925,17271471.94
150690,202310,54,27,27,35641.17,35640,71281.17
150700,202310,656,441,215,582149.76,283807.52,865957.28
150710,202310,345,206,139,273249.3,183480.84,456730.14
150715,202310,930,588,342,776176.49,451442.94,1227619.43
150720,202310,493,376,117,496331.16,155761.07,652092.23
150730,202310,1419,693,726,914780.21,958328.73,1873108.94
150740,202310,310,200,110,264001.01,145200,409201.01
150745,202310,928,535,393,706225.95,518769.08,1224995.03
150746,202310,84,41,43,54121.32,56760,110881.32
150747,202310,306,210,96,277207.1,126721.2,403928.3
150750,202310,171,95,76,125405.54,100322.75,225728.29
150760,202310,2153,1419,734,1873119.75,968888.58,2842008.33
150770,202310,444,269,175,355082.31,231000.2,586082.51
150775,202310,107,61,46,80520.48,60720.1,141240.58
150780,202310,249,149,100,196681.92,132000.15,328682.07
150790,202310,806,484,322,638891.07,425043.33,1063934.40
150795,202310,2036,1269,767,1676430.5,1012450.15,2688880.65
150796,202310,334,192,142,253441.61,188761.92,442203.53
150797,202310,491,242,249,319450.65,328681.99,648132.64
150800,202310,1878,1038,840,1372818.6,1110122.44,2482941.04
150803,202310,393,304,89,401295.46,117480.88,518776.34
150805,202310,245,150,95,198003.26,125400.27,323403.53
150808,202310,1248,606,642,799927.72,847443.59,1647371.31
150810,202310,3574,2399,1175,3166772.02,1551007.36,4717779.38
150812,202310,611,319,292,421089.36,385442.56,806531.92
150815,202310,1456,916,540,1209133.59,714123.92,1923257.51
150820,202310,2005,1190,815,1570855.94,1075816.23,2646672.17
150830,202310,646,487,159,642857,209881.1,852738.1
150835,202310,295,188,107,248162.47,141240,389402.47
150840,202310,1634,932,702,1230274.96,927970.38,2158245.34
160005,202310,76,52,24,68640.83,31680.12,100320.95
160010,202310,249,154,95,203285.75,125400.47,328686.22
160015,202310,186,125,61,165010.75,80521.51,245532.26
160020,202310,167,84,83,110882.51,109560,220442.51
160021,202310,73,39,34,51483.57,44880.81,96364.38
160023,202310,87,59,28,77883.44,36960.14,114843.58
160025,202310,36,19,17,25082.6,22440.12,47522.72
160027,202310,1670,938,732,1238224.1,966247.25,2204471.35
160030,202310,20442,10841,9601,14314699.78,12680127.96,26994827.74
160040,202310,442,288,154,381500.45,203283.5,584783.95
160050,202310,941,394,547,520097.86,723373.57,1243471.43
160053,202310,351,219,132,289091.32,174242.88,463334.20
160055,202310,31,23,8,30361.13,10560.8,40921.93
160060,202310,7778,4381,3397,5785864.54,4485463.77,10271328.31
160070,202310,215,127,88,168965.35,116160.7,285126.05
160080,202310,166,90,76,120120.76,100320,220440.76
170025,202310,26,17,9,22440,11880.2,34320.2
170030,202310,178,143,35,188766.96,46200,234966.96
170035,202310,215,108,107,142566.16,141241.86,283808.02
170040,202310,188,140,48,184800.2,63360,248160.2
170070,202310,347,226,121,299648.7,159720.59,459369.29
170100,202310,372,268,104,353771,138600.2,492371.2
170105,202310,43,37,6,48840.15,7920,56760.15
170110,202310,116,73,43,96360.49,56761.06,153121.55
170130,202310,93,49,44,64680,58080,122760
170190,202310,108,62,46,81840,60720,142560
170200,202310,378,258,120,340562.69,158400,498962.69
170210,202310,7640,4308,3332,5687721.55,4399604.83,10087326.38
170215,202310,187,115,72,151802.83,95042.73,246845.56
170220,202310,1407,1006,401,1327947.75,529324.19,1857271.94
170230,202310,165,116,49,153123.78,64680.3,217804.08
170240,202310,517,364,153,480504.04,201962.02,682466.06
170255,202310,1071,828,243,1092980.04,320761.92,1413741.96
170270,202310,56,40,16,53988,21120,75108
170290,202310,164,103,61,135962.67,80520,216482.67
170300,202310,129,86,43,113520.21,56760,170280.21
170305,202310,66,45,21,59400.8,27720,87120.8
170307,202310,56,42,14,55441.26,18480.9,73922.16
170310,202310,138,92,46,121442.47,60720,182162.47
170320,202310,50,33,17,43560.2,22440,66000.2
170330,202310,41,30,11,39601.58,14520.1,54121.68
170360,202310,42,28,14,36960.29,18480.75,55441.04
170370,202310,85,51,34,67321.29,44880.2,112201.49
170380,202310,99,74,25,97681.34,33000,130681.34
170382,202310,43,36,7,47520,9240,56760
170384,202310,160,123,37,162360,48840.44,211200.44
170386,202310,80,38,42,50160.61,55440,105600.61
170388,202310,46,23,23,30360.96,30360,60720.96
170389,202310,28,21,7,27720.4,9240,36960.4
170390,202310,92,53,39,69960.77,51480.14,121440.91
170410,202310,27,24,3,31682.04,3960,35642.04
170460,202310,14,9,5,11880.91,6600,18480.91
170510,202310,36,27,9,35643.04,11880,47523.04
170550,202310,1782,1071,711,1415073.88,938531.06,2353604.94
170555,202310,125,91,34,120124.43,44880,165004.43
170560,202310,105,79,26,104280.42,34320.33,138600.75
170600,202310,44,18,26,23761.36,34320.7,58082.06
170610,202310,209,119,90,157084.77,118800.1,275884.87
170625,202310,37,23,14,30360.99,18480,48840.99
170650,202310,108,78,30,102960.35,40920.2,143880.55
170700,202310,654,482,172,637568.79,227040,864608.79
170710,202310,147,89,58,117484,76561.97,194045.97
170720,202310,125,95,30,125400.81,39600,165000.81
170730,202310,125,75,50,99001.76,66000,165001.76
170740,202310,98,71,27,93720.2,35640,129360.2
170755,202310,50,31,19,40921.51,25080.76,66002.27
170765,202310,139,84,55,110883.71,72600.6,183484.31
170770,202310,201,136,65,179522.31,85800.73,265323.04
170820,202310,650,434,216,572889.28,285120.32,858009.60
170825,202310,61,32,29,42240.3,38280,80520.3
170830,202310,101,78,23,102960.79,30360.33,133321.12
170900,202310,190,149,41,196682.94,54121.33,250804.27
170930,202310,1135,647,488,854067.94,645485.63,1499553.57
170950,202310,3692,1834,1858,2423362.84,2453898.87,4877261.71
170980,202310,16,11,5,14521.63,6600,21121.63
171050,202310,167,127,40,167640,52800.2,220440.2
171070,202310,64,51,13,67320.88,17160.95,84481.83
171090,202310,54,43,11,56760,14520,71280
171110,202310,28,22,6,29040.44,7920,36960.44
171150,202310,51,36,15,47520,19800,67320
171180,202310,30,16,14,21120,18481.12,39601.12
171190,202310,215,123,92,162363.46,121440,283803.46
171195,202310,62,53,9,69961.07,11880,81841.07
171200,202310,29,12,17,15840,22440,38280
171215,202310,13,10,3,13200,3960,17160
171240,202310,64,51,13,67320,17160,84480
171245,202310,57,48,9,63361.96,11880,75241.96
171250,202310,87,54,33,71280.2,43560,114840.2
171270,202310,14,10,4,13200,5280.22,18480.22
171280,202310,53,43,10,56762.22,13200.1,69962.32
171320,202310,1173,700,473,924012.9,624361.57,1548374.47
171330,202310,487,263,224,347162.81,295680.21,642843.02
171360,202310,118,85,33,112200.15,43560,155760.15
171370,202310,43,26,17,34320,22440.18,56760.18
171380,202310,141,121,20,159721.42,26400,186121.42
171395,202310,48,30,18,39600.68,23760,63360.68
171420,202310,280,184,96,242881.39,126720.2,369601.59
171430,202310,81,66,15,87120.2,19800.95,106921.15
171488,202310,242,144,98,190080.24,129360,319440.24
171500,202310,75,45,30,59400.2,39600,99000.2
171510,202310,82,57,25,75240,33000.52,108240.52
171515,202310,45,38,7,50162.22,9240,59402.22
171525,202310,28,24,4,31682.05,5280,36962.05
171550,202310,17,11,6,14520.9,7920,22440.9
171570,202310,64,33,31,43560.52,40920.1,84480.62
171575,202310,258,178,80,234960.67,105600,340560.67
171610,202310,2240,1181,1059,1560278.27,1397907.68,2958185.95
171620,202310,171,125,46,165000.9,60720.61,225721.51
171630,202310,55,31,24,40920,31680,72600
171650,202310,376,270,106,359052.23,139922.45,498974.68
171660,202310,278,162,116,213848.56,153121.12,366969.68
171665,202310,99,64,35,84481.17,46200.33,130681.50
171670,202310,486,316,170,417127.84,225722.68,642850.52
171700,202310,65,54,11,71280.95,14520,85800.95
171720,202310,32,14,18,18480.7,23760.2,42240.9
171750,202310,111,58,53,76560,69960.7,146520.7
171780,202310,86,67,19,88440.33,25080,113520.33
171790,202310,112,90,22,118800,29040,147840
171800,202310,36,28,8,36960,10560,47520
171820,202310,2334,1369,965,1807128.18,1275127.71,3082255.89
171830,202310,37,28,9,36960.2,11880,48840.2
171840,202310,58,39,19,51480.3,25080,76560.3
171845,202310,37,27,10,35640.78,13200,48840.78
171850,202310,57,45,12,59400.44,15840.49,75240.93
171855,202310,73,55,18,72600.1,23760,96360.1
171865,202310,5,3,2,3960,2640,6600
171870,202310,43,31,12,40920.2,15840.45,56760.65
171875,202310,99,76,23,100320,30360,130680
171880,202310,51,32,19,42240,25080.2,67320.2
171884,202310,59,34,25,44880.85,33000,77880.85
171886,202310,149,74,75,97681.07,99000,196681.07
171888,202310,29,22,7,29041.55,9240.1,38281.65
171889,202310,17,8,9,10560,11880,22440
171890,202310,71,60,11,79200.11,14520,93720.11
171900,202310,27,18,9,23760.2,11880,35640.2
172000,202310,40,36,4,47520.2,5280.2,52800.4
172010,202310,64,43,21,58080,27720.62,85800.62
172015,202310,21,16,5,21121.52,6600,27721.52
172020,202310,127,79,48,104281.09,63360,167641.09
172025,202310,43,28,15,36960.46,19800,56760.46
172030,202310,64,40,24,52800.75,31680,84480.75
172049,202310,92,63,29,83161.02,38280.2,121441.22
172065,202310,121,80,41,105602.6,54120.46,159723.06
172080,202310,143,89,54,117481.41,71281.43,188762.84
172085,202310,33,17,16,22440,21120,43560
172090,202310,496,354,142,467596.63,187440.94,655037.57
172093,202310,20,18,2,23760,2640,26400
172097,202310,19,11,8,14520,10560,25080
172100,202310,7133,4244,2889,5604921.78,3816164.91,9421086.69
172110,202310,87,61,26,80521.01,34320,114841.01
172120,202310,1889,1569,320,2071155.84,422406.21,2493562.05
172125,202310,20,14,6,18480,7920,26400
172130,202310,34,21,13,27721.29,17160,44881.29
172208,202310,221,144,77,190080,101641.38,291721.38
172210,202310,373,190,183,250807.3,241560.67,492367.97
210005,202310,3348,2159,1189,2849993.63,1572142.09,4422135.72
210010,202310,149,103,46,135961.4,60720,196681.4
210015,202310,46,33,13,43560.39,17160,60720.39
210020,202310,408,250,158,330007.56,208562.29,538569.85
210030,202310,336,228,108,300988.5,142565.17,443553.67
210040,202310,117,98,19,129360.1,25080,154440.1
210043,202310,288,240,48,316805.21,63360.97,380166.18
210047,202310,513,337,176,444841.44,232320,677161.44
210050,202310,291,204,87,269280,114840.2,384120.2
210055,202310,68,57,11,75240.27,14520,89760.27
210060,202310,567,462,105,609872.08,138602.62,748474.70
210070,202310,515,399,116,526681.31,154440.32,681121.63
210080,202310,153,142,11,187441.82,14520,201961.82
210083,202310,300,161,139,212520.77,183480.19,396000.96
210087,202310,10,6,4,7920,5280,13200
210090,202310,532,390,142,514824.25,187441.88,702266.13
210095,202310,433,352,81,464649.29,106921.69,571570.98
210100,202310,740,597,143,788055.77,190080.2,978135.97
210110,202310,121,86,35,113522.65,46200.9,159723.55
210120,202310,4916,4000,916,5281551.47,1210455.37,6492006.84
210125,202310,202,130,72,171603.01,95040.66,266643.67
210130,202310,469,298,171,393370.91,225720.89,619091.80
210135,202310,35,26,9,34321.39,11880,46201.39
210140,202310,4939,3762,1177,4967313.15,1553662.31,6520975.46
210150,202310,403,271,132,357733.18,174242.91,531976.09
210160,202310,3370,2882,488,3804332.63,644166.14,4448498.77
210170,202310,1362,1104,258,1457334.34,340561.73,1797896.07
210173,202310,136,126,10,166321.48,13200,179521.48
210177,202310,291,170,121,224401.27,159720,384121.27
210180,202310,33,18,15,23760.2,19800,43560.2
210190,202310,484,337,147,444840.5,194040.7,638881.2
210193,202310,10,8,2,10560.59,2640,13200.59
210197,202310,69,50,19,66000.3,25080.2,91080.5
210200,202310,653,559,94,737911.87,124080.39,861992.26
210203,202310,247,181,66,238923.61,87121.12,326044.73
210207,202310,329,284,45,374885.55,59400,434285.55
210210,202310,743,694,49,916092.37,64680.6,980772.97
210215,202310,85,76,9,100322.98,11880,112202.98
210220,202310,362,314,48,414496.12,63360.39,477856.51
210230,202310,348,283,65,373565.74,85800,459365.74
210232,202310,1251,923,328,1218392.67,435601.57,1653994.24
210235,202310,194,147,47,194044.55,62040.4,256084.95
210237,202310,64,36,28,47522.63,36960,84482.63
210240,202310,84,74,10,97680.7,13200.21,110880.91
210250,202310,203,178,25,234961.45,33000.2,267961.65
210255,202310,421,312,109,411855.86,143881.9,555737.76
210260,202310,407,297,110,393363.02,145200,538563.02
210270,202310,649,476,173,628331.08,228361.46,856692.54
210275,202310,124,98,26,129360.13,34320,163680.13
210280,202310,1152,768,384,1015096.94,506882.66,1521979.60
210290,202310,568,388,180,512169.95,237601.39,749771.34
210300,202310,5058,3349,1709,4422089.5,2257204.76,6679294.26
210310,202310,131,88,43,116160.2,56760,172920.2
210312,202310,124,95,29,125401.79,38280,163681.79
210315,202310,136,118,18,155760.97,23760,179520.97
210317,202310,161,126,35,166320.27,46200,212520.27
210320,202310,2587,2240,347,2958203.9,459361.04,3417564.94
210325,202310,165,98,67,129361.27,88440.73,217802.00
210330,202310,4235,2562,1673,3381908.66,2208363.05,5590271.71
210340,202310,1241,965,276,1273851.1,364322.91,1638174.01
210350,202310,730,614,116,810495.17,153120.2,963615.37
210355,202310,162,139,23,183480,30360,213840
210360,202310,2087,1547,540,2042090.83,712802.72,2754893.55
210370,202310,1276,697,579,920056.99,764283.74,1684340.73
210375,202310,201,103,98,135969.24,129361.46,265330.70
210380,202310,762,605,157,798609.47,207240.97,1005850.44
210390,202310,202,170,32,224402.15,42240,266642.15
210400,202310,459,410,49,541213.86,64680,605893.86
210405,202310,1192,845,347,1115427.85,458042.51,1573470.36
210407,202310,77,65,12,85800,15840,101640
210408,202310,50,47,3,62041.53,3960,66001.53
210409,202310,363,321,42,423723.83,55440.76,479164.59
210410,202310,466,377,89,497641.95,117480,615121.95
210420,202310,221,178,43,234962.04,56760.32,291722.36
210430,202310,67,51,16,67320.5,21120,88440.5
210440,202310,381,262,119,345850.12,157080,502930.12
210450,202310,112,99,13,130682.37,17160,147842.37
210455,202310,265,145,120,191407.15,158403.2,349810.35
210460,202310,332,231,101,304928.03,133320.25,438248.28
210462,202310,81,68,13,89761.64,17160,106921.64
210465,202310,128,105,23,138600.91,30360,168960.91
210467,202310,616,466,150,615137.24,198000.5,813137.74
210470,202310,44,39,5,51480,6600,58080
210480,202310,1444,1061,383,1401880.05,505563.96,1907444.01
210490,202310,183,131,52,172922.28,68640,241562.28
210500,202310,523,353,170,465978.69,224401.82,690380.51
210510,202310,545,446,99,588723.08,130681.71,719404.79
210515,202310,338,234,104,308883.55,137280.2,446163.75
210520,202310,412,377,35,497648.35,46200.93,543849.28
210530,202310,10484,5359,5125,7075532.24,6767814.3,13843346.54
210535,202310,126,100,26,132001.96,34320,166321.96
210540,202310,1662,1161,501,1532569.23,661325.15,2193894.38
210542,202310,1092,577,515,761659.9,681128.72,1442788.62
210545,202310,25,22,3,29040.71,3960,33000.71
210547,202310,129,116,13,153122.88,17160.31,170283.19
210550,202310,621,448,173,591386,228361.01,819747.01
210560,202310,171,151,20,199322.05,26400.33,225722.38
210565,202310,31,23,8,30361.62,10560.25,40921.87
210570,202310,1342,1149,193,1516715.79,254761.42,1771477.21
210580,202310,132,116,16,153120.78,21120.16,174240.94
210590,202310,676,575,101,759003.55,134640,893643.55
210592,202310,52,47,5,62040,6600,68640
210594,202310,120,105,15,138601.1,19800,158401.1
210596,202310,121,108,13,143881.61,17160,161041.61
210598,202310,143,111,32,146520.9,42240.2,188761.1
210600,202310,311,272,39,359050.4,51480,410530.4
210610,202310,267,248,19,327368.7,25080.54,352449.24
210620,202310,48,33,15,43560,19800,63360
210630,202310,96,90,6,118802.01,7920,126722.01
210632,202310,1002,727,275,959644.29,363000,1322644.29
210635,202310,30,26,4,34320.9,5280.2,39601.1
210637,202310,116,87,29,114840.2,38280,153120.2
210640,202310,579,522,57,689044.57,75240,764284.57
210650,202310,425,363,62,479169.04,81840.89,561009.93
210660,202310,401,323,78,426383.16,104281.9,530665.06
210663,202310,90,73,17,96360.17,22440,118800.17
210667,202310,92,52,40,68641.72,52800.57,121442.29
210670,202310,277,243,34,320765.53,44880,365645.53
210675,202310,505,312,193,411848.87,254762.72,666611.59
210680,202310,241,161,80,212522.42,105600,318122.42
210690,202310,116,103,13,135960.85,17160.19,153121.04
210700,202310,155,117,38,154440.4,50160.2,204600.6
210710,202310,272,173,99,228361.23,130680.6,359041.83
210720,202310,135,123,12,162360.08,15840,178200.08
210725,202310,72,60,12,79205.1,15840,95045.1
210730,202310,23,16,7,21120,9240,30360
210735,202310,294,217,77,286441.7,101640,388081.7
210740,202310,521,458,63,604586.36,83160,687746.36
210745,202310,174,137,37,180840.33,48840,229680.33
210750,202310,2997,1691,1306,2232176.92,1725256.48,3957433.40
210760,202310,271,217,54,286441.64,71280.19,357721.83
210770,202310,252,210,42,277219.36,55441.25,332660.61
210780,202310,426,324,102,427693.66,134641.97,562335.63
210790,202310,208,178,30,234963.87,39600,274563.87
210800,202310,188,147,41,194049.21,54120.55,248169.76
210805,202310,72,64,8,84480,10560,95040
210810,202310,441,371,70,489739.28,92400,582139.28
210820,202310,2027,1731,296,2284999.87,390723.42,2675723.29
210825,202310,159,103,56,135961.36,73920.2,209881.56
210830,202310,729,527,202,695648.11,266640.6,962288.71
210840,202310,210,157,53,207240.4,69960,277200.4
210845,202310,236,186,50,245522.58,66000,311522.58
210850,202310,727,537,190,708867.5,250802.31,959669.81
210860,202310,3541,2227,1314,2939698.06,1734487.54,4674185.60
210870,202310,402,321,81,423735.61,106920.2,530655.81
210880,202310,99,83,16,109563.58,21120,130683.58
210890,202310,329,292,37,385455.87,48840,434295.87
210900,202310,760,494,266,652102.18,352444.62,1004546.80
210905,202310,73,42,31,55440.2,40920,96360.2
210910,202310,2160,1640,520,2164854.81,686408.61,2851263.42
210920,202310,145,71,74,93723.03,97680,191403.03
210923,202310,79,64,15,84482.26,19800,104282.26
210927,202310,427,230,197,303602.77,260040.2,563642.97
210930,202310,96,85,11,112200.4,14520,126720.4
210940,202310,86,68,18,89761.51,23760,113521.51
210945,202310,219,135,84,178203.46,110880,289083.46
210950,202310,530,395,135,521404.83,178200.65,699605.48
210955,202310,113,72,41,95041.98,54120.9,149162.88
210960,202310,2586,1374,1212,1813693.48,1599843.09,3413536.57
210970,202310,112,94,18,124081.56,23760.9,147842.46
210975,202310,75,72,3,95040.51,3960.36,99000.87
210980,202310,1065,559,506,737898.73,667922.67,1405821.40
210990,202310,4628,3354,1274,4428712.8,1681699.3,6110412.1
211000,202310,1370,1131,239,1492964.38,315482.85,1808447.23
211003,202310,983,742,241,979453.69,318120.56,1297574.25
211010,202310,514,460,54,607207.25,71280.59,678487.84
211020,202310,1387,678,709,894980.52,935897.03,1830877.55
211023,202310,44,38,6,50161.2,7920,58081.2
211027,202310,90,70,20,92400.54,26400,118800.54
211030,202310,373,273,100,360362.01,132000.5,492362.51
211040,202310,312,267,45,352442.44,59400,411842.44
211050,202310,1190,842,348,1111475.05,459361.99,1570837.04
211060,202310,657,582,75,768271.88,99000.4,867272.28
211065,202310,28,24,4,31682.94,5280.72,36963.66
211070,202310,851,721,130,951763.14,171601.57,1123364.71
211080,202310,94,90,4,118800.75,5280,124080.75
211085,202310,70,39,31,51480,40920,92400
211090,202310,105,92,13,121445.86,17160,138605.86
211100,202310,477,407,70,537254.56,92400.2,629654.76
211102,202310,233,174,59,229680.4,77880,307560.4
211105,202310,231,172,59,227041.68,77880.26,304921.94
211107,202310,133,87,46,114840,60720,175560
211110,202310,1024,703,321,927984.14,423724.1,1351708.24
211120,202310,5599,3150,2449,4159527.7,3232717.25,7392244.95
211125,202310,27,20,7,26400,9240,35640
211130,202310,44552,22442,22110,29631311.68,29189546.13,58820857.81
211140,202310,375,336,39,443536.05,51480.47,495016.52
211150,202310,1269,938,331,1239518.96,436923.7,1676442.66
211153,202310,181,110,71,145200,93720,238920
211157,202310,71,58,13,76560,17160,93720
211160,202310,714,605,109,798611.61,146520.9,945132.51
211163,202310,3,2,1,2640,1320,3960
211167,202310,11,11,0,14520,,14520.0
211170,202310,436,337,99,444843.3,130681.35,575524.65
211172,202310,96,72,24,95040.99,31680,126720.99
211174,202310,31,17,14,22440,18481.43,40921.43
211176,202310,477,355,122,468605.99,161042.25,629648.24
211178,202310,99,69,30,91081.82,39600,130681.82
211180,202310,217,179,38,236281.75,50160,286441.75
211190,202310,73,66,7,87120,9240,96360
211195,202310,48,36,12,47524.06,15840,63364.06
211200,202310,159,131,28,172920.76,36960,209880.76
211210,202310,406,308,98,406568.01,129360.74,535928.75
211220,202310,4693,2869,1824,3787266.01,2409209.91,6196475.92
211223,202310,155,142,13,187444.61,17160,204604.61
211227,202310,66,50,16,66000.2,21120,87120.2
211230,202310,749,623,126,822394.16,166322.52,988716.68
211240,202310,399,337,62,444844.61,81840,526684.61
211245,202310,192,107,85,141242.64,112200.4,253443.04
211250,202310,1498,1289,209,1702875.36,275883.39,1978758.75
211260,202310,841,727,114,959648.3,150480,1110128.3
211270,202310,1864,1568,296,2069802.1,390721.63,2460523.73
211280,202310,1867,1328,539,1755631.32,711481.68,2467113.00
211285,202310,236,154,82,203280.83,108240,311520.83
211290,202310,841,607,234,801245.44,308880.54,1110125.98
211300,202310,793,649,144,856698.41,190081.16,1046779.57
211400,202310,1626,1098,528,1449395.19,696962.25,2146357.44
220005,202310,22,20,2,26400,2640,29040
220010,202310,87,71,16,93720.91,21120,114840.91
220020,202310,807,662,145,873853.8,191401.29,1065255.09
220025,202310,116,112,4,147841.04,5280,153121.04
220027,202310,69,54,15,71280.2,19800.2,91080.4
220030,202310,144,120,24,158401.31,31680.82,190082.13
220040,202310,1404,1086,318,1433547.69,419762.94,1853310.63
220045,202310,29,23,6,30362.5,7920.4,38282.9
220050,202310,691,585,106,773462.82,139920.94,913383.76
220060,202310,194,171,23,225727.1,30360.35,256087.45
220070,202310,115,102,13,134642.3,17160.7,151803.0
220080,202310,15,13,2,17160.22,2640,19800.22
220090,202310,45,32,13,42240.5,17160,59400.5
220095,202310,5,4,1,5280,1320,6600
220100,202310,27,22,5,29040.71,6600,35640.71
220105,202310,38,33,5,43560.95,6600,50160.95
220110,202310,281,254,27,335282.32,35640,370922.32
220115,202310,54,46,8,60720,10560,71280
220117,202310,24,23,1,30360.82,1320,31680.82
220120,202310,1599,1269,330,1677749,435600.2,2113349.2
220130,202310,31,30,1,39600.29,1320,40920.29
220140,202310,94,80,14,105601.1,18480.96,124082.06
220150,202310,519,395,124,521423.58,163683.67,685107.25
220155,202310,33,32,1,42240.93,1320,43560.93
220157,202310,27,24,3,31681.49,3960,35641.49
220160,202310,117,103,14,135961.93,18480,154441.93
220170,202310,55,42,13,55440,17160,72600
220173,202310,24,21,3,27720,3960,31680
220177,202310,23,23,0,30360.4,,30360.4
220180,202310,70,67,3,88441.17,3960,92401.17
220190,202310,1289,1104,185,1457309.44,244204.95,1701514.39
220191,202310,44,40,4,52801.11,5280,58081.11
220192,202310,97,90,7,118801.98,9240,128041.98
220194,202310,58,51,7,67320.65,9240,76560.65
220196,202310,77,66,11,87123.85,14520.2,101644.05
220198,202310,4,4,0,5280,,5280.0
220200,202310,427,367,60,484464.76,79200.84,563665.60
220202,202310,39,35,4,46201.17,5280,51481.17
220205,202310,72,64,8,84480.2,10560,95040.2
220207,202310,16,16,0,21120.31,,21120.31
220208,202310,76,51,25,67320.27,33001.02,100321.29
220209,202310,38,33,5,43560,6600,50160
220210,202310,34,29,5,38280.87,6600,44880.87
220211,202310,40,38,2,50164.88,2640,52804.88
220213,202310,43,40,3,52801.9,3960,56761.9
220217,202310,46,36,10,47520.3,13200.8,60721.1
220220,202310,2575,1733,842,2288919.11,1111452.74,3400371.85
220225,202310,15,9,6,11880.58,7920,19800.58
220230,202310,1068,805,263,1063939.76,347166.12,1411105.88
220240,202310,171,153,18,201961.24,23760.31,225721.55
220245,202310,60,56,4,73921.4,5280,79201.4
220250,202310,166,139,27,183484.04,35640,219124.04
220253,202310,59,53,6,69960.25,7920,77880.25
220255,202310,61,52,9,68640.2,11880,80520.2
220260,202310,741,569,172,751096.28,227041.03,978137.31
220265,202310,22,19,3,25080,3960,29040
220270,202310,933,841,92,1110133.81,121440,1231573.81
220271,202310,44,35,9,46201.48,11880,58081.48
220272,202310,25,25,0,33000.7,,33000.7
220273,202310,20,18,2,23760.4,2640,26400.4
220275,202310,70,61,9,80520,11880,92400
220277,202310,40,32,8,42240.63,10560.94,52801.57
220280,202310,26,19,7,25080,9240,34320
220285,202310,51,47,4,62040.94,5280,67320.94
220290,202310,1656,1428,228,1884937.74,300963.29,2185901.03
220300,202310,49,48,1,63361.94,1320,64681.94
220310,202310,383,328,55,432976.53,72602.45,505578.98
220320,202310,501,454,47,599304.13,62041.68,661345.81
220323,202310,3,1,2,1320.8,2640,3960.8
220325,202310,14,12,2,15840,2640,18480
220327,202310,19,19,0,25080.67,,25080.67
220330,202310,229,165,64,217800.56,84480,302280.56
220335,202310,141,120,21,158401.95,27720,186121.95
220340,202310,67,53,14,69960.21,18480.12,88440.33
220342,202310,51,43,8,56764.56,10560,67324.56
220345,202310,100,90,10,118800.21,13200.03,132000.24
220350,202310,486,427,59,563644.61,77880.05,641524.66
220360,202310,56,35,21,46200.5,27720,73920.5
220370,202310,1466,1223,243,1614394.15,320760.4,1935154.55
220375,202310,23,22,1,29041.39,1320,30361.39
220380,202310,32,23,9,30361.4,11880,42241.4
220385,202310,19,17,2,22440,2640.66,25080.66
220390,202310,2648,1485,1163,1960273.56,1535185.38,3495458.94
220400,202310,39,34,5,44880,6600,51480
220410,202310,24,23,1,30360.2,1320,31680.2
220415,202310,13,12,1,15841.16,1320,17161.16
220420,202310,144,122,22,161040.58,29040,190080.58
220430,202310,174,150,24,198005.29,31680.2,229685.49
220435,202310,31,24,7,31680.72,9240,40920.72
220440,202310,321,276,45,364336.49,59400,423736.49
220450,202310,387,198,189,261367.66,249486.67,510854.33
220455,202310,60,58,2,76560.87,2640,79200.87
220460,202310,23,22,1,29041.76,1320.8,30362.56
220465,202310,68,50,18,66001.67,23760.41,89762.08
220470,202310,259,228,31,300968.73,40920.86,341889.59
220480,202310,67,62,5,81840.36,6600,88440.36
220490,202310,93,80,13,105600,17160,122760
220500,202310,137,116,21,153122.27,29040,182162.27
220510,202310,374,294,80,388091.31,105600.88,493692.19
220515,202310,34,31,3,40921.58,3960,44881.58
220520,202310,412,364,48,480491.35,63362.36,543853.71
220525,202310,12,8,4,10560.46,5280.92,15841.38
220527,202310,16,16,0,21120.38,,21120.38
220530,202310,51,25,26,33000,34320.87,67320.87
220535,202310,4,4,0,5280.74,,5280.74
220540,202310,126,111,15,146520.72,19800.2,166320.92
220545,202310,27,19,8,25081.11,10560.8,35641.91
220550,202310,809,644,165,852747.34,221761.9,1074509.24
220551,202310,15,13,2,17160,2640,19800
220552,202310,16,16,0,21120,,21120.0
220553,202310,70,67,3,88440.85,3960,92400.85
220554,202310,5,3,2,3960.73,2640,6600.73
220555,202310,61,47,14,62042.56,18480,80522.56
220556,202310,35,32,3,42241.86,3960,46201.86
220557,202310,66,61,5,80521.36,6600,87121.36
220558,202310,18,10,8,13200,10560.54,23760.54
220559,202310,11,11,0,14520.07,,14520.07
220560,202310,91,60,31,79200.85,40920,120120.85
220570,202310,774,497,277,656051.3,365643.07,1021694.37
220580,202310,582,536,46,707560.17,60721.33,768281.50
220585,202310,16,13,3,17160.2,3960.67,21120.87
220590,202310,21,19,2,25081.68,2640,27721.68
220595,202310,82,63,19,83160.33,25080,108240.33
220600,202310,24,18,6,23760,7920,31680
220605,202310,38,34,4,44880.2,5280,50160.2
220610,202310,108,92,16,121440.3,21120,142560.3
220620,202310,593,513,80,677172.67,105602.78,782775.45
220630,202310,4,3,1,3960,1320,5280
220635,202310,37,33,4,43562.23,5280,48842.23
220640,202310,116,99,17,130680,22440,153120
220650,202310,126,120,6,158401.65,7920,166321.65
220660,202310,101,76,25,100321.85,33000.6,133322.45
220665,202310,17,17,0,22440,,22440.0
220667,202310,33,31,2,40920.21,2640,43560.21
220669,202310,50,44,6,58080.2,7920,66000.2
220670,202310,87,69,18,91080.7,23760,114840.7
220672,202310,91,67,24,88445.18,31681.21,120126.39
220675,202310,30,24,6,31682.23,7920,39602.23
220680,202310,69,60,9,79200.2,11880,91080.2
220690,202310,51,48,3,63360.51,3960,67320.51
220695,202310,31,19,12,25080.95,15840,40920.95
220700,202310,2032,1591,441,2102790.57,582124.05,2684914.62
220710,202310,12,10,2,13200.2,2640.7,15840.9
220720,202310,116,102,14,134640,18480,153120
220730,202310,38,37,1,48840.01,1320,50160.01
220735,202310,13,10,3,13200,3960,17160
220740,202310,72,62,10,81841.19,13200.91,95042.10
220750,202310,150,125,25,165002.64,33000.18,198002.82
220755,202310,26,24,2,31681.92,2640,34321.92
220760,202310,79,69,10,91081.57,13200,104281.57
220770,202310,6649,3918,2731,5172006.51,3606319.87,8778326.38
220775,202310,17,13,4,17160.7,5280.39,22441.09
220777,202310,29,28,1,36960,1320,38280
220779,202310,7,3,4,3960,5280,9240
220780,202310,1000,845,155,1116730.64,204600.69,1321331.33
220785,202310,7,4,3,5280,3960.2,9240.2
220790,202310,1357,1094,263,1444113.31,347168.36,1791281.67
220793,202310,10,7,3,9240,3960,13200
220795,202310,31,29,2,38280.84,2640,40920.84
220800,202310,4351,3323,1028,4386692.71,1356972.8,5743665.51
220810,202310,94,81,13,106920.95,17160,124080.95
220820,202310,277,246,31,324729.23,40922.3,365651.53
220830,202310,1439,1282,157,1692059.81,207241,1899300.81
220840,202310,2805,1997,808,2636123.55,1067901.52,3704025.07
220850,202310,94,80,14,105600,18480,124080
220855,202310,9,4,5,5280,6600,11880
220860,202310,16,13,3,17162.44,3960,21122.44
220865,202310,30,27,3,35640.1,3960,39600.1
220870,202310,106,96,10,126721.8,13200,139921.8
220880,202310,367,303,64,399971.66,84481.92,484453.58
220885,202310,34,32,2,42242.85,2640,44882.85
220887,202310,6,5,1,6600.2,1320,7920.2
220890,202310,91,78,13,102961.33,17160,120121.33
220900,202310,32,20,12,26400.6,15840,42240.6
220910,202310,53,40,13,52802.68,17160,69962.68
220915,202310,12,10,2,13200,2640,15840
220920,202310,54,48,6,63361.5,7920,71281.5
220930,202310,63,61,2,80520.41,2640,83160.41
220935,202310,19,19,0,25080.97,,25080.97
220937,202310,39,36,3,47520.96,3960,51480.96
220940,202310,70,63,7,83160.2,9240,92400.2
220945,202310,6,6,0,7920.6,,7920.6
220950,202310,42,34,8,44880.2,10560,55440.2
220955,202310,28,26,2,34320.41,2640,36960.41
220960,202310,50,42,8,55440.95,10560,66000.95
220965,202310,60,55,5,72600,6600,79200
220970,202310,65,55,10,72600,13200,85800
220975,202310,17,14,3,18480.9,3960,22440.9
220980,202310,29,27,2,35641.07,2640,38281.07
220985,202310,60,51,9,67320,11880,79200
220987,202310,38,37,1,48843.1,1320.8,50163.9
220990,202310,27,25,2,33000,2992,35992
220995,202310,19,17,2,22440,2640,25080
220997,202310,80,72,8,95042.09,10560,105602.09
221000,202310,1410,1247,163,1646083.13,215160.86,1861243.99
221005,202310,59,55,4,72600,5280.82,77880.82
221010,202310,33,23,10,30360,13200,43560
221020,202310,52,46,6,60720.69,7920,68640.69
221030,202310,50,40,10,52696.43,13200,65896.43
221035,202310,23,22,1,29042.83,1320,30362.83
221037,202310,14,11,3,14520,3960,18480
221038,202310,26,23,3,30360,3960,34320
221039,202310,29,29,0,38280.04,,38280.04
221040,202310,281,239,42,315486.25,55441,370927.25
221050,202310,256,214,42,282490.08,55440.2,337930.28
221060,202310,2173,1867,306,2464487.49,403925.23,2868412.72
221062,202310,35,34,1,44880.92,1320,46200.92
221063,202310,22,17,5,22440,6600,29040
221065,202310,87,71,16,93722.58,21120,114842.58
221070,202310,178,158,20,208565.03,26400,234965.03
221080,202310,455,383,72,505575.48,95040,600615.48
221090,202310,33,26,7,34321.74,9240,43561.74
221093,202310,56,47,9,62042.47,11880,73922.47
221095,202310,5,5,0,6600,,6600.0
221097,202310,14,12,2,15840,2640,18480
221100,202310,30263,18270,11993,24118764.45,15840309.89,39959074.34
221110,202310,1264,988,276,1304202.86,364327.86,1668530.72
221120,202310,642,461,181,608534.02,238920.84,847454.86
221130,202310,1107,890,217,1174818.98,286444.15,1461263.13
221135,202310,40,36,4,47521.09,5280,52801.09
221140,202310,52,46,6,60720.2,7920,68640.2
221150,202310,16,13,3,17160.18,3960,21120.18
221160,202310,20,18,2,23761.41,2640,26401.41
221170,202310,23,22,1,29040,1320,30360
230010,202310,169,147,22,194042.02,29040,223082.02
230015,202310,194,163,31,215160.9,40920,256080.9
230020,202310,2082,1649,433,2176732.08,571573.96,2748306.04
230030,202310,1822,1345,477,1775455.38,629646.84,2405102.22
230040,202310,271,218,53,287760.92,69960,357720.92
230050,202310,269,184,85,242881.46,112200.13,355081.59
230060,202310,187,147,40,194040.69,52800.94,246841.63
230070,202310,350,293,57,386764.6,75240.1,462004.7
230075,202310,1044,858,186,1132589.92,245525.18,1378115.10
230080,202310,256,211,45,278522.62,59400,337922.62
230090,202310,218,164,54,216481.79,71280,287761.79
230100,202310,3139,1771,1368,2337811.31,1805781.39,4143592.70
230110,202310,3374,2141,1233,2827515.83,1627576.49,4455092.32
230120,202310,1372,1052,320,1388674.76,423724.63,1812399.39
230125,202310,211,167,44,220440.83,58080.44,278521.27
230130,202310,573,493,80,652086.8,105600.2,757687.0
230140,202310,251,207,44,273241.05,58080,331321.05
230150,202310,161,125,36,165002.42,47520.51,212522.93
230160,202310,1081,879,202,1160290.15,267961.03,1428251.18
230170,202310,722,612,110,807864.43,145205.32,953069.75
230180,202310,79,72,7,95040.39,9240,104280.39
230185,202310,479,412,67,543849.78,88441.14,632290.92
230190,202310,2847,2124,723,2806400.48,954369.56,3760770.04
230195,202310,587,501,86,661340.2,113520,774860.2
230200,202310,519,398,121,525366.39,161040.2,686406.59
230205,202310,466,308,158,406561.17,208560.2,615121.37
230210,202310,1589,1205,384,1590628.72,506881.25,2097509.97
230220,202310,1828,1209,619,1595920.68,817087.91,2413008.59
230230,202310,1134,905,229,1194628.95,302284.07,1496913.02
230240,202310,2461,2174,287,2869740.93,378845.17,3248586.10
230250,202310,2095,1691,404,2232200.56,533289.92,2765490.48
230260,202310,3729,2341,1388,3092794.56,1833485.99,4926280.55
230270,202310,1539,1184,355,1562901.32,469924.6,2032825.92
230280,202310,3244,2497,747,3296138.36,987372.79,4283511.15
230290,202310,386,335,51,442214.25,67320.71,509534.96
230300,202310,571,423,148,558364.89,195360.1,753724.99
230310,202310,480,371,109,489720.32,143880.78,633601.10
230320,202310,1048,864,184,1140503.96,242881.74,1383385.70
230330,202310,369,298,71,393364.81,93720,487084.81
230340,202310,516,416,100,549129.49,133320.4,682449.89
230350,202310,3854,2349,1505,3102097.1,1989256.95,5091354.05
230360,202310,305,248,57,327365.67,75240.39,402606.06
230365,202310,164,130,34,171601.43,44880,216481.43
230370,202310,13437,6819,6618,9001536.06,8738631.86,17740167.92
230380,202310,588,502,86,662657.23,113523.3,776180.53
230390,202310,590,346,244,456723.25,322080,778803.25
230393,202310,272,223,49,294362.61,64680.5,359043.11
230395,202310,418,333,85,439584.82,112205.52,551790.34
230400,202310,763,607,156,801249.59,205920.2,1007169.79
230410,202310,3321,2145,1176,2832799.32,1552339.88,4385139.20
230420,202310,7413,4884,2529,6447173.49,3338377.33,9785550.82
230423,202310,397,341,56,450123.82,73920,524043.82
230425,202310,601,481,120,634928.68,159721.25,794649.93
230426,202310,136,111,25,146520.7,33000,179520.7
230427,202310,80,70,10,92400.96,13200,105600.96
230428,202310,2050,990,1060,1306844.12,1400532.28,2707376.40
230430,202310,517,418,99,551769.68,130682.1,682451.78
230435,202310,1086,779,307,1028303.61,405241.34,1433544.95
230440,202310,113940,53097,60843,70115057.18,80360368.17,150475425.35
230445,202310,367,248,119,327368.91,157080,484448.91
230450,202310,658,509,149,671883.84,196680.7,868564.54
230460,202310,121,87,34,114840.26,44880,159720.26
230465,202310,356,285,71,377523.84,93720,471243.84
230470,202310,2295,1810,485,2389224.43,642843.07,3032067.50
230480,202310,170,152,18,200640.5,23761.37,224401.87
230490,202310,373,293,80,386763.36,105600.13,492363.49
230495,202310,560,403,157,531971.57,207242.71,739214.28
230500,202310,1342,1008,334,1331893.78,440883.19,1772776.97
230510,202310,85,58,27,76560.39,35640,112200.39
230520,202310,472,350,122,462004.37,161041.23,623045.60
230523,202310,3062,1872,1190,2471122.56,1574777.61,4045900.17
230526,202310,276,230,46,303601.12,60720,364321.12
230530,202310,781,548,233,724690.24,307564.7,1032254.94
230533,202310,251,225,26,297002.61,34320.2,331322.81
230535,202310,473,349,124,460693.25,165002.17,625695.42
230540,202310,2009,1791,218,2364182.68,287763.21,2651945.89
230550,202310,4837,3090,1747,4079002.12,2306082.45,6385084.57
230560,202310,654,503,151,663970.41,199320.57,863290.98
230565,202310,257,191,66,252121.31,87121.14,339242.45
230570,202310,349,298,51,393361.87,67320.45,460682.32
230580,202310,1400,955,445,1260615.61,587405.04,1848020.65
230590,202310,1270,978,292,1292192.08,385442.2,1677634.28
230600,202310,344,310,34,409209.27,44880,454089.27
230610,202310,555,411,144,542533.49,190080.31,732613.80
230620,202310,194,162,32,213841.94,42240,256081.94
230625,202310,1005,684,321,902899.35,423721.07,1326620.42
230630,202310,1696,1255,441,1656635.9,583443.94,2240079.84
230640,202310,4553,3638,915,4802327.4,1207829.43,6010156.83
230650,202310,577,491,86,648125.81,113521.75,761647.56
230655,202310,877,680,197,897632.67,260044.45,1157677.12
230660,202310,449,368,81,485762.99,106920.2,592683.19
230670,202310,543,430,113,567621.2,149161.23,716782.43
230680,202310,259,216,43,285127.97,56760,341887.97
230690,202310,1091,913,178,1206513,234961.78,1441474.78
230700,202310,1201,994,207,1312111.7,273241.47,1585353.17
230710,202310,747,680,67,901585.95,89761,991346.95
230720,202310,164,140,24,184800,31680.2,216480.2
230725,202310,348,261,87,344523.4,114840.97,459364.37
230730,202310,14879,7873,7006,10394317.91,9253350.77,19647668.68
230740,202310,833,674,159,889700.82,209881.8,1099582.62
230750,202310,938,773,165,1020383.31,217800.77,1238184.08
230760,202310,1878,1579,299,2084354.78,397322.56,2481677.34
230763,202310,441,373,68,492364.71,89760,582124.71
230765,202310,10489,5137,5352,6781258.88,7070141.21,13851400.09
230770,202310,6024,3186,2838,4205670.36,3747511.4,7953181.76
230780,202310,926,790,136,1042814.38,179520.1,1222334.48
230790,202310,365,293,72,388080.12,95040.41,483120.53
230800,202310,1398,989,409,1306822.57,539881.97,1846704.54
230810,202310,1606,1384,222,1828282.6,293044.31,2121326.91
230820,202310,428,278,150,366965.04,198001.27,564966.31
230830,202310,1069,889,180,1173500.57,237601.83,1411102.40
230835,202310,315,263,52,347164.61,68640.68,415805.29
230837,202310,215,171,44,225721.25,58080.43,283801.68
230840,202310,1111,828,283,1092972.46,374882.33,1467854.79
230850,202310,1550,1291,259,1704165.48,341884.26,2046049.74
230860,202310,391,312,79,411843.27,104286.6,516129.87
230870,202310,2069,1735,334,2290238.47,440880.47,2731118.94
230880,202310,97,76,21,100320,27720,128040
230890,202310,670,588,82,777487.47,108241.2,885728.67
230900,202310,360,269,91,355082.22,120120.24,475202.46
230910,202310,257,198,59,261363.09,77880,339243.09
230920,202310,583,455,128,600608,168960,769568
230930,202310,1303,919,384,1213107.91,506880.91,1719988.82
230940,202310,976,750,226,990019.02,298320.73,1288339.75
230945,202310,666,519,147,685103.15,194045,879148.15
230950,202310,502,433,69,571583.45,91080.5,662663.95
230960,202310,3252,2203,1049,2910734.55,1388673.49,4299408.04
230970,202310,2238,1242,996,1639496.58,1316054.99,2955551.57
230980,202310,263,190,73,252121.79,96360,348481.79
230990,202310,164,128,36,168960.5,47520,216480.5
231000,202310,238,219,19,289082.98,25080,314162.98
231010,202310,217,150,67,198002.98,88440,286442.98
231020,202310,1708,1126,582,1486379.9,768254.66,2254634.56
231025,202310,1309,902,407,1190682.93,539890.16,1730573.09
231030,202310,1192,959,233,1267215.33,307562.48,1574777.81
231040,202310,209,151,58,199323.26,76560,275883.26
231050,202310,1071,913,158,1205182.77,208568.15,1413750.92
231060,202310,181,143,38,188764.04,50160.9,238924.94
231070,202310,1752,1216,536,1605154.63,707526.61,2312681.24
231080,202310,296,256,40,337926.92,52800,390726.92
231085,202310,824,511,313,674540.92,413160.26,1087701.18
231090,202310,306,247,59,327364.12,77882.42,405246.54
231095,202310,177,132,45,174240,60720.22,234960.22
231100,202310,223,181,42,238922.4,55440,294362.4
231110,202310,426,352,74,464650.16,97682.55,562332.71
231120,202310,299,243,56,320764.06,73920.52,394684.58
231123,202310,161,153,8,201963.09,10560,212523.09
231126,202310,387,303,84,401281.53,110880,512161.53
231130,202310,5736,4500,1236,5940234.2,1632869.36,7573103.56
231135,202310,256,223,33,295682.92,43561.41,339244.33
231140,202310,3486,2510,976,3313291.39,1289652.62,4602944.01
231150,202310,449,413,36,545172.43,47521.12,592693.55
231160,202310,1409,1153,256,1521985.33,337922.51,1859907.84
231170,202310,604,414,190,546485.01,250800,797285.01
231180,202310,2276,1963,313,2592561.16,413166.37,3005727.53
231190,202310,271,219,52,289080.95,68640,357720.95
231195,202310,274,222,52,293042.68,68640.15,361682.83
231200,202310,1004,801,203,1057347.01,267962.78,1325309.79
231210,202310,587,489,98,645488.77,129361.39,774850.16
231220,202310,1240,869,371,1147107.22,489724.64,1636831.86
231230,202310,1822,1336,486,1763547.85,642841.57,2406389.42
231240,202310,1948,1305,643,1722643.11,848770.99,2571414.10
231250,202310,97,91,6,120120.2,7920,128040.2
231260,202310,291,199,92,262682.24,121442.02,384124.26
231270,202310,1092,833,259,1099587.95,343201.79,1442789.74
231280,202310,99,76,23,100321.69,30360,130681.69
231290,202310,9396,5278,4118,6971209.94,5437174.45,12408384.39
231300,202310,674,605,69,798608.51,91080,889688.51
231310,202310,972,887,85,1170856.97,112201.45,1283058.42
231320,202310,740,547,193,722050.2,254761.62,976811.82
231325,202310,119,102,17,134640.18,22440.54,157080.72
231330,202310,2205,1670,535,2204463.96,707529.75,2911993.71
231335,202310,283,250,33,330006.48,43560,373566.48
231340,202310,2335,1593,742,2102806.68,979448.11,3082254.79
231350,202310,1683,1304,379,1721341.07,501615.66,2222956.73
231355,202310,462,378,84,498968.69,110881.24,609849.93
231360,202310,700,471,229,621735.54,302282.23,924017.77
231370,202310,105,91,14,120120,18480,138600
231375,202310,319,240,79,316805.15,104280.1,421085.25
231380,202310,610,481,129,634926.48,170280,805206.48
231390,202310,241,182,59,240241.37,77880,318121.37
231395,202310,886,519,367,685084.25,484441.25,1169525.50
231400,202310,1422,1188,234,1568187.9,310204.58,1878392.48
231410,202310,1668,1351,317,1783353.27,419762.94,2203116.21
240010,202310,435,201,234,265329.8,308889.19,574218.99
240020,202310,2613,2155,458,2844720.14,604571.65,3449291.79
240030,202310,129,99,30,130681.36,39600,170281.36
240040,202310,42,40,2,52800.2,2640,55440.2
240050,202310,576,491,85,648152.93,112200.3,760353.23
240060,202310,93,82,11,108241.41,14520,122761.41
240070,202310,326,245,81,323405.14,106920.2,430325.34
240080,202310,665,444,221,586105.84,291727.28,877833.12
240090,202310,118,103,15,135960.55,19800,155760.55
240100,202310,1727,1609,118,2123948.51,155762.02,2279710.53
240110,202310,1207,829,378,1094357.82,498982.21,1593340.03
240120,202310,177,132,45,174241.6,59400.84,233642.44
240130,202310,292,264,28,348495.68,36960.7,385456.38
240140,202310,105,66,39,87121.09,51480.64,138601.73
240145,202310,835,731,104,964954.09,137280.7,1102234.79
240150,202310,33,24,9,31680,11880,43560
240160,202310,40,34,6,44880,7920,52800
240165,202310,40,33,7,43563.75,9240.1,52803.85
240170,202310,193,138,55,182162.4,72600,254762.4
240180,202310,145,103,42,135962.56,55440.97,191403.53
240185,202310,61,51,10,67320.16,13200,80520.16
240190,202310,16,14,2,18480.43,2640,21120.43
240200,202310,3502,1861,1641,2456584.46,2166141.76,4622726.22
240210,202310,180,133,47,175560.73,62040,237600.73
240220,202310,1297,873,424,1153725.24,559685.57,1713410.81
240230,202310,927,825,102,1090367.95,134640.76,1225008.71
240240,202310,97,63,34,83160.2,44880.43,128040.63
240250,202310,115,99,16,130680.33,21120,151800.33
240260,202310,2196,1551,645,2047389.23,851411.51,2898800.74
240270,202310,192,160,32,212521,42240,254761
240280,202310,77,62,15,81840.2,19800.1,101640.3
240290,202310,48,46,2,60720,2640,63360
240300,202310,189,103,86,135962.27,113520,249482.27
240310,202310,2852,1550,1302,2046066.03,1722622.87,3768688.90
240320,202310,183,170,13,224400.07,17160,241560.07
240325,202310,5798,3220,2578,4251931.6,3405692.3,7657623.9
240330,202310,91,86,5,113520.23,6600,120120.23
240340,202310,132,99,33,130680,43560,174240
240350,202310,110,86,24,113520.2,31680,145200.2
240360,202310,955,622,333,821081.39,439566.82,1260648.21
240370,202310,73,62,11,81841.51,14521.65,96363.16
240375,202310,49,32,17,42241.4,22440.98,64682.38
240380,202310,243,197,46,260054.07,60720.5,320774.57
240390,202310,20,18,2,23760,2640,26400
240400,202310,95,84,11,110881.84,14520,125401.84
240410,202310,15,11,4,14520,5280,19800
240420,202310,1271,880,391,1161637.92,516128.62,1677766.54
240430,202310,290,257,33,339253.25,43561.1,382814.35
240440,202310,182,114,68,150485.06,89760.97,240246.03
240450,202310,308,188,120,248171.2,158402.77,406573.97
240460,202310,114,91,23,120121.12,30360,150481.12
240470,202310,246,221,25,291740.96,33001.37,324742.33
240480,202310,18,15,3,19800,3960,23760
240485,202310,97,80,17,105601,22440,128041
240490,202310,70,62,8,81841.67,10560,92401.67
240500,202310,123,98,25,129360,33000,162360
240510,202310,38,29,9,38280,11880,50160
240520,202310,102,97,5,128042.16,6600.61,134642.77
240530,202310,79,59,20,77880,26400,104280
240540,202310,110,93,17,122760.1,23760,146520.1
240550,202310,13,11,2,14520,2640,17160
240560,202310,447,301,146,397332.03,192720.77,590052.80
240570,202310,475,288,187,380167.73,246841.65,627009.38
240580,202310,1560,1108,452,1463919.11,596642.27,2060561.38
240590,202310,33,32,1,42241.72,1320,43561.72
240600,202310,113,105,8,138601.49,10560,149161.49
240610,202310,535,441,94,582147.77,124085.38,706233.15
240615,202310,12,12,0,15841.4,,15841.4
240620,202310,94,91,3,120121.1,3960,124081.1
240630,202310,54,45,9,59400.97,11880.29,71281.26
240640,202310,43,30,13,39600,18480,58080
240650,202310,274,214,60,282484.69,79200,361684.69
240660,202310,129,107,22,141241.53,29040,170281.53
240670,202310,337,191,146,252135.68,194049.04,446184.72
240680,202310,60,47,13,62040.67,17160,79200.67
240690,202310,55,52,3,68641.7,3960,72601.7
240700,202310,192,161,31,212520.6,40921.02,253441.62
240710,202310,2693,1613,1080,2129250.75,1425615.72,3554866.47
240720,202310,1168,802,366,1058676.64,483128.63,1541805.27
240725,202310,78,70,8,92402.24,10560.88,102963.12
240730,202310,159,131,28,172920.08,36960.9,209880.98
240740,202310,266,212,54,279851.75,71280.62,351132.37
240750,202310,60,37,23,48840,30360,79200
240760,202310,68,54,14,71280,18480,89760
240770,202310,168,130,38,171601.87,50160.95,221762.82
240780,202310,850,686,164,906866.91,216481.51,1123348.42
240790,202310,42,39,3,51482.35,3960,55442.35
240800,202310,11185,7528,3657,9940279.18,4828752.92,14769032.10
240810,202310,25469,13538,11931,17880340.36,15754552.18,33634892.54
240820,202310,318,193,125,254768.08,165002.86,419770.94
240830,202310,1757,1453,304,1918021.04,401287.16,2319308.20
240840,202310,86,73,13,96360.13,17160,113520.13
240850,202310,95,80,15,105600,19800,125400
240860,202310,120,116,4,153122.09,5280,158402.09
240870,202310,61,50,11,66002.32,14520,80522.32
240880,202310,37,31,6,40920,7920,48840
240890,202310,1370,774,596,1021715.43,786728.93,1808444.36
240895,202310,76,60,16,79200.2,21120.72,100320.92
240910,202310,205,168,37,221761.16,48840.2,270601.36
240920,202310,14,12,2,15841.6,2640,18481.6
240930,202310,468,416,52,549145.84,68641.49,617787.33
240933,202310,70,46,24,60720.95,31680,92400.95
240940,202310,2476,2155,321,2844685.77,423725.45,3268411.22
240950,202310,41,36,5,47520,6600,54120
240960,202310,26,22,4,29040.2,5280.3,34320.5
240970,202310,122,88,34,116160.73,44880,161040.73
240980,202310,231,182,49,240241.55,64680.8,304922.35
240990,202310,159,101,58,133322.2,76560,209882.2
241000,202310,62,56,6,73921.33,7920,81841.33
241010,202310,109,80,29,105600.59,38280,143880.59
241020,202310,121,112,9,147841.06,11880.82,159721.88
241025,202310,25,18,7,23761.18,9240.5,33001.68
241030,202310,131,100,31,132000,40920,172920
241040,202310,52,41,11,54120.1,14520,68640.1
241050,202310,81,75,6,99001.18,7920,106921.18
241060,202310,32,27,5,35640.78,6600,42240.78
241070,202310,26,26,0,34321.79,,34321.79
241080,202310,67,58,9,76560.2,11880,88440.2
241090,202310,70,59,11,77883.57,14520,92403.57
241100,202310,71,61,10,80522.38,13200.28,93722.66
241105,202310,34,22,12,29044,15840.64,44884.64
241110,202310,61,48,13,63360.15,17160,80520.15
241120,202310,1949,1459,490,1925926.54,646805.13,2572731.67
241140,202310,220,178,42,234963.43,55440,290403.43
241142,202310,55,41,14,54121.3,18480,72601.3
241150,202310,1281,1115,166,1473170.06,219122.25,1692292.31
241160,202310,35,22,13,29040.1,17160,46200.1
241170,202310,61,50,11,66000,14520,80520
241180,202310,53,39,14,51480,18480,69960
241190,202310,46,41,5,54121.56,6600,60721.56
241200,202310,5725,3001,2724,3962857.72,3599743.85,7562601.57
241210,202310,76,64,12,84480.1,15840,100320.1
241220,202310,1760,1102,658,1456022.81,868573.87,2324596.68
241230,202310,277,224,53,295685.91,69960.91,365646.82
241240,202310,58,44,14,58080.7,18480,76560.7
241250,202310,1249,1138,111,1502202.97,146523.9,1648726.87
241255,202310,86,70,16,92401.44,21120,113521.44
241260,202310,853,647,206,854060.11,271922.36,1125982.47
241270,202310,86,65,21,85802.13,27720,113522.13
241280,202310,104,91,13,120122.02,17160,137282.02
241290,202310,161,123,38,162363.48,50160,212523.48
241300,202310,91,57,34,75240.7,44880.98,120121.68
241310,202310,59,40,19,52801.8,25080.1,77881.9
241320,202310,42,25,17,33002.31,22440,55442.31
241330,202310,68,56,12,73920.02,15840,89760.02
241335,202310,118,106,12,139924.57,15840,155764.57
241340,202310,204,138,66,182160.81,87120,269280.81
241350,202310,69,58,11,76560.08,14520,91080.08
241355,202310,62,50,12,66002.14,15840,81842.14
241360,202310,72,67,5,88440.49,6600,95040.49
241370,202310,77,59,18,77880,23760,101640
241380,202310,36,32,4,42241.3,5280,47521.3
241390,202310,97,78,19,102960.66,25080,128040.66
241400,202310,253,186,67,246479.27,88441.96,334921.23
241410,202310,210,190,20,250800.54,26400.85,277201.39
241415,202310,117,92,25,121440.1,33000.8,154440.9
241420,202310,179,107,72,141242.48,95040,236282.48
241430,202310,22,18,4,23760,5280,29040
241440,202310,596,508,88,670592.49,116162.87,786755.36
241445,202310,53,47,6,62040.2,7920,69960.2
241450,202310,277,232,45,306251.95,59400.44,365652.39
241460,202310,197,181,16,238925.36,21120.4,260045.76
241470,202310,35,29,6,38280.8,7920,46200.8
241475,202310,56,52,4,68640,5280,73920
241480,202310,174,125,49,165002.06,64680.2,229682.26
241490,202310,17,15,2,19800.84,2640.1,22440.94
241500,202310,57,44,13,58082.33,17160.02,75242.35
250010,202310,116,99,17,130680.77,22440.66,153121.43
250020,202310,38,33,5,43560,6600,50160
250030,202310,994,745,249,983433.04,330005.55,1313438.59
250040,202310,448,355,93,468618.69,122761.77,591380.46
250050,202310,310,255,55,336602.55,72600.5,409203.05
250053,202310,70,58,12,76561.18,15840,92401.18
250057,202310,4,3,1,3960.2,1320,5280.2
250060,202310,672,485,187,640218.99,246841.48,887060.47
250070,202310,719,575,144,759019.71,190080.44,949100.15
250073,202310,9,8,1,10560,1320.01,11880.01
250077,202310,206,147,59,194042.22,77880.2,271922.42
250080,202310,422,334,88,440891.99,116160.38,557052.37
250090,202310,231,145,86,191401.47,113520,304921.47
250100,202310,658,522,136,689048.63,179521,868569.63
250110,202310,766,554,212,731296.86,279841.68,1011138.54
250115,202310,17,7,10,9240.18,13200.26,22440.44
250120,202310,128,92,36,121441.87,47521.92,168963.79
250130,202310,614,511,103,674540.49,135961.26,810501.75
250135,202310,37,17,20,22440.59,26400,48840.59
250140,202310,106,87,19,114842.16,25080,139922.16
250150,202310,723,496,227,654732.46,299641.91,954374.37
250153,202310,23,18,5,23760.1,6600,30360.1
250157,202310,62,48,14,63360.42,18480,81840.42
250160,202310,275,209,66,275883.88,87120,363003.88
250170,202310,96,63,33,83160.2,43560,126720.2
250180,202310,5711,4000,1711,5281607.78,2261221.15,7542828.93
250190,202310,835,568,267,749769.87,352442.15,1102212.02
250200,202310,90,71,19,93721.08,25080.7,118801.78
250205,202310,27,20,7,26400.61,9240,35640.61
250210,202310,90,75,15,99001.55,19800,118801.55
250215,202310,117,74,43,97680.75,56760.6,154441.35
250220,202310,32,21,11,27720.41,14520,42240.41
250230,202310,83,71,12,93720.3,15840.2,109560.5
250240,202310,275,203,72,267965.48,95040.2,363005.68
250250,202310,462,392,70,517455.2,92400,609855.2
250260,202310,63,52,11,68640.1,14520.06,83160.16
250270,202310,83,60,23,79200.8,30360,109560.8
250280,202310,435,355,80,468604.51,105600,574204.51
250290,202310,126,112,14,147840.25,18480.88,166321.13
250300,202310,549,372,177,491054.2,233640.1,724694.3
250310,202310,70,62,8,81841.28,10560,92401.28
250320,202310,2276,1515,761,2001216.4,1008499.67,3009716.07
250330,202310,128,109,19,143883.15,25080.1,168963.25
250340,202310,37,29,8,38280.94,10560,48840.94
250350,202310,227,150,77,198002.36,101640,299642.36
250355,202310,51,41,10,54120,13200.25,67320.25
250360,202310,202,166,36,219123.74,47520.67,266644.41
250370,202310,2637,1696,941,2238806.2,1242146.46,3480952.66
250375,202310,16,10,6,13200.36,7920.31,21120.67
250380,202310,61,52,9,68640.89,11880.29,80521.18
250390,202310,58,47,11,62041.3,14520,76561.3
250400,202310,19877,10447,9430,13794579.04,12459749.8,26254328.84
250403,202310,308,237,71,312842.52,93720,406562.52
250407,202310,73,58,15,76560.1,19800.85,96360.95
250410,202310,35,30,5,39600.31,6600.8,46201.11
250415,202310,59,37,22,48840,29040,77880
250420,202310,49,41,8,54120.3,10560,64680.3
250430,202310,1658,1452,206,1918340.38,271921.55,2190261.93
250435,202310,34,29,5,38281.09,6600,44881.09
250440,202310,706,582,124,768253.68,163681,931934.68
250450,202310,97,74,23,97680.97,30360,128040.97
250460,202310,578,380,198,501605.48,261362.04,762967.52
250470,202310,107,76,31,100321.5,40920,141241.5
250480,202310,369,291,78,384133.18,102960.98,487094.16
250485,202310,8,7,1,9240,1320,10560
250490,202310,267,212,55,279842.85,72601.39,352444.24
250500,202310,115,88,27,116160,35640,151800
250510,202310,953,756,197,997932.82,261360.9,1259293.72
250520,202310,179,124,55,163680,72600.7,236280.7
250523,202310,143,113,30,149160.74,39600.12,188760.86
250527,202310,132,91,41,120120.91,54120.2,174241.11
250530,202310,16,12,4,15840,5280,21120
250535,202310,30,24,6,31680,7920,39600
250540,202310,150,121,29,159720.87,38280,198000.87
250550,202310,80,77,3,101641.19,3960,105601.19
250560,202310,70,44,26,58081.11,34320.07,92401.18
250570,202310,173,142,31,187441.55,40920.7,228362.25
250580,202310,93,74,19,97765.2,25080,122845.2
250590,202310,24,17,7,22440,9240,31680
250600,202310,1814,1220,594,1610433.2,784084.64,2394517.84
250610,202310,161,128,33,168968.05,43560.22,212528.27
250620,202310,27,22,5,29040.81,6600,35640.81
250625,202310,78,60,18,79202.33,23760.08,102962.41
250630,202310,3400,2113,1287,2789493.33,1701501.89,4490995.22
250640,202310,209,166,43,219125.61,56760.85,275886.46
250650,202310,35,25,10,33000.19,13200,46200.19
250660,202310,68,48,20,63360,26400,89760
250670,202310,90,73,17,96361.24,22440,118801.24
250680,202310,473,377,96,497651.39,126720.77,624372.16
250690,202310,2431,1648,783,2176727.38,1033571.42,3210298.80
250700,202310,1041,866,175,1143136.4,231000.2,1374136.6
250710,202310,575,442,133,583478.84,175565.6,759044.44
250720,202310,139,104,35,137282.05,46200,183482.05
250730,202310,445,363,82,479167.52,108242.51,587410.03
250740,202310,83,76,7,100321.86,9240,109561.86
250750,202310,29057,17182,11875,22686402.31,15685922.13,38372324.44
250760,202310,132,104,28,137280.87,36961.17,174242.04
250770,202310,397,265,132,349807.95,175560.7,525368.65
250780,202310,88,59,29,77880.8,38280,116160.8
250790,202310,499,315,184,415805.15,242882.69,658687.84
250800,202310,165,147,18,194040,23760,217800
250810,202310,75,62,13,81840,17160,99000
250820,202310,167,137,30,180842.55,39600.26,220442.81
250830,202310,562,373,189,492375.84,249481.3,741857.14
250840,202310,67,56,11,73921.71,14520.2,88441.91
250850,202310,83,67,16,88440.2,21120,109560.2
250855,202310,19,16,3,21120.2,3960,25080.2
250860,202310,259,165,94,217801.92,126720,344521.92
250870,202310,41,37,4,48840,5280,54120
250880,202310,105,79,26,104280.79,34320,138600.79
250890,202310,3531,2579,952,3405688.25,1257973.51,4663661.76
250900,202310,84,69,15,91080.48,19800,110880.48
250905,202310,137,105,32,138600.9,43560,182160.9
250910,202310,1060,775,285,1024347.27,376205.1,1400552.37
250915,202310,127,87,40,114841.77,52801.03,167642.80
250920,202310,171,132,39,174240,51480.7,225720.7
250930,202310,210,119,91,157080.55,120121.1,277201.65
250933,202310,14,10,4,13200,5280.89,18480.89
250937,202310,21,19,2,25080,2640,27720
250939,202310,49,36,13,47520.5,17160,64680.5
250940,202310,154,113,41,149161.53,54120.7,203282.23
250950,202310,91,66,25,87122.77,33000,120122.77
250960,202310,93,55,38,72603.92,50160.3,122764.22
250970,202310,1440,1019,421,1347748.09,555724.41,1903472.50
250980,202310,105,72,33,95040.99,43560,138600.99
250990,202310,183,139,44,183480,58080,241560
251000,202310,93,78,15,102960.9,19800,122760.9
251010,202310,164,116,48,153120,63360,216480
251020,202310,102,86,16,113520.37,21120,134640.37
251030,202310,52,37,15,48840.91,19800,68640.91
251040,202310,81,59,22,77880,29040,106920
251050,202310,34,30,4,39600,5280,44880
251060,202310,51,39,12,51480.92,15840.64,67321.56
251065,202310,7,4,3,5280,3960,9240
251070,202310,19,17,2,22441.53,2640,25081.53
251080,202310,6215,2900,3315,3829487.36,4379836.81,8209324.17
251090,202310,211,175,36,231001.7,47520,278521.7
251100,202310,27,24,3,31681.23,3960,35641.23
251110,202310,75,47,28,63360,36960,100320
251120,202310,2163,1368,795,1805842.68,1049418.49,2855261.17
251130,202310,489,404,85,533411.1,112200.05,645611.15
251140,202310,686,456,230,601923.68,303601.29,905524.97
251150,202310,375,313,62,413164.21,81840,495004.21
251160,202310,103,85,18,112200.45,23760.58,135961.03
251170,202310,85,70,15,92400.26,19800,112200.26
251180,202310,318,186,132,245523.99,174241.76,419765.75
251190,202310,128,92,36,121446.12,47521.12,168967.24
251200,202310,359,275,84,363009.02,110880.44,473889.46
251203,202310,38,32,6,42240.69,7920,50160.69
251207,202310,95,75,20,99000.61,26400,125400.61
251210,202310,1731,1259,472,1663231.89,623046.78,2286278.67
251220,202310,56,45,11,59400.78,14520,73920.78
251230,202310,639,536,103,707531.85,135961.22,843493.07
251240,202310,135,94,41,124080.51,54120,178200.51
251250,202310,1799,1296,503,1710657.33,663968.22,2374625.55
251260,202310,13,9,4,11880.41,5280.19,17160.60
251270,202310,364,280,84,369607.78,110880.69,480488.47
251272,202310,68,60,8,79200.2,10560,89760.2
251274,202310,21,16,5,21120.25,6600,27720.25
251275,202310,43,27,16,35640.65,21120,56760.65
251276,202310,40,30,10,39600.82,13200,52800.82
251278,202310,22,17,5,22442.26,6600,29042.26
251280,202310,132,127,5,167640.2,6600,174240.2
251290,202310,1309,929,380,1226359.54,501621.6,1727981.14
251300,202310,23,17,6,22440,7920,30360
251310,202310,333,234,99,308888.29,130680.8,439569.09
251315,202310,60,52,8,68640,10560,79200
251320,202310,81,63,18,83161.03,23760,106921.03
251330,202310,91,80,11,105600,14520,120120
251335,202310,28,20,8,26400,10560,36960
251340,202310,932,514,418,678497.77,553083.2,1231580.97
251350,202310,43,41,2,54120,2640,56760
251360,202310,94,80,14,105600.2,18480,124080.2
251365,202310,9,8,1,10561.58,1320.9,11882.48
251370,202310,6745,4619,2126,6097277.09,2807680.98,8904958.07
251380,202310,52,40,12,52800.54,15840,68640.54
251385,202310,7,6,1,7920.9,1320,9240.9
251390,202310,1157,852,305,1124666.16,402606.89,1527273.05
251392,202310,57,39,18,51480.5,23760,75240.5
251394,202310,23,18,5,23760.6,6600,30360.6
251396,202310,11,7,4,9240,5280.2,14520.2
251398,202310,21,17,4,22440.75,5280,27720.75
251400,202310,63,49,14,64680,18480,83160
251410,202310,50,40,10,52800.7,13200,66000.7
251420,202310,125,92,33,121441.34,43560,165001.34
251430,202310,53,46,7,60720.84,9240,69960.84
251440,202310,57,32,25,42240,33000,75240
251445,202310,72,62,10,81843.16,13200,95043.16
251450,202310,421,354,67,467290.64,88440.73,555731.37
251455,202310,8,7,1,9240,1320,10560
251460,202310,25,19,6,25080,7920.02,33000.02
251465,202310,16,11,5,14520,6600,21120
251470,202310,52,37,15,48840.2,19800,68640.2
251480,202310,27,24,3,31680.62,3960.02,35640.64
251490,202310,95,61,34,80522.15,44880.3,125402.45
251500,202310,113,92,21,121440.99,27720,149160.99
251510,202310,113,71,42,93721.08,55440.62,149161.70
251520,202310,44,36,8,47520,10560,58080
251530,202310,4623,3265,1358,4309877.48,1793890.32,6103767.80
251540,202310,106,87,19,114840,25081.57,139921.57
251550,202310,474,360,114,475218.73,150483.24,625701.97
251560,202310,27,20,7,26400.1,9240,35640.1
251570,202310,18,17,1,22440,1320,23760
251580,202310,137,108,29,142561.56,38280,180841.56
251590,202310,106,75,31,99000.2,40920.8,139921.0
251593,202310,36,21,15,27720.5,19800,47520.5
251597,202310,136,111,25,146520.87,33000.04,179520.91
251600,202310,1173,820,353,1082420.9,465962.72,1548383.62
251610,202310,309,224,85,295686.51,112200,407886.51
251615,202310,28,24,4,31680,5280,36960
251620,202310,4468,2816,1652,3717225.7,2180665.76,5897891.46
251630,202310,524,382,142,504258.33,187444.49,691702.82
251640,202310,110,79,31,104285.51,40920,145205.51
251650,202310,336,242,94,319445.12,124080.47,443525.59
251660,202310,231,205,26,270604.82,34320.3,304925.12
251670,202310,460,350,110,462008.28,146520.72,608529.00
251675,202310,15,12,3,15840,3960,19800
251680,202310,111,99,12,130681.07,15840,146521.07
251690,202310,348,284,64,375219.57,84480.2,459699.77
251700,202310,286,244,42,322083.45,55440,377523.45
251710,202310,24,17,7,22440.41,9240.6,31681.01
251720,202310,44,31,13,40920,17160,58080
251740,202310,17,11,6,14520.3,7920,22440.3
260005,202310,4246,2178,2068,2874512.14,2729809.05,5604321.19
260010,202310,2001,1502,499,1982671.77,658685.07,2641356.84
260020,202310,469,412,57,543848.69,75240.9,619089.59
260030,202310,698,473,225,624374.68,297001.9,921376.58
260040,202310,821,530,291,699622.16,385442.82,1085064.98
260050,202310,1228,900,328,1188024.49,432963.99,1620988.48
260060,202310,382,343,39,452770.77,51480,504250.77
260070,202310,1442,883,559,1165615.8,737903.3,1903519.1
260080,202310,818,600,218,793336.71,289080,1082416.71
260090,202310,505,336,169,443521.95,223081.5,666603.45
260100,202310,243,160,83,211202.27,109560,320762.27
260105,202310,306,179,127,236281.47,167640.1,403921.57
260110,202310,3347,2426,921,3205017.14,1218373.33,4423390.47
260120,202310,3010,1614,1396,2132211.5,1844062.3,3976273.8
260130,202310,245,175,70,231002.9,92400,323402.9
260140,202310,2483,1605,878,2119971.15,1158975.93,3278947.08
260150,202310,216,143,73,188760.93,96360,285120.93
260160,202310,394,310,84,409214.58,110880.43,520095.01
260170,202310,3813,2285,1528,3016284.49,2018308.48,5034592.97
260180,202310,166,145,21,191405.31,27720,219125.31
260190,202310,2828,1812,1016,2391880.95,1343765.76,3735646.71
260200,202310,1100,857,243,1132580.77,320760.62,1453341.39
260210,202310,1498,1081,417,1426959.24,551764.29,1978723.53
260220,202310,658,585,73,772218.53,96361.79,868580.32
260230,202310,1444,1057,387,1395284.73,513488.92,1908773.65
260240,202310,227,175,52,231008.81,68642.15,299650.96
260250,202310,116,89,27,117480.43,35640,153120.43
260260,202310,1227,845,382,1115415.08,504243.56,1619658.64
260270,202310,270,195,75,258724.99,99000,357724.99
260280,202310,1265,996,269,1318708.49,356403.77,1675112.26
260290,202310,7998,4304,3694,5681314.32,4878752.16,10560066.48
260300,202310,1149,965,184,1275167.39,242882.57,1518049.96
260310,202310,574,451,123,595330.39,162360.1,757690.49
260320,202310,866,636,230,839522.72,303601.1,1143123.82
260330,202310,106,82,24,108240.3,31680.3,139920.6
260340,202310,97,74,23,97680.65,30360,128040.65
260345,202310,6691,3377,3314,4459118.62,4374532.09,8833650.71
260350,202310,525,377,148,497650.29,195360.8,693011.09
260360,202310,272,163,109,215161.1,143880.45,359041.55
260370,202310,775,510,265,673213.08,349801.6,1023014.68
260380,202310,587,427,160,563652.6,211202.05,774854.65
260390,202310,313,268,45,353765.99,60720,414485.99
260392,202310,137,115,22,151802.1,29040.45,180842.55
260400,202310,5078,2915,2163,3847869.46,2855178.61,6703048.07
260410,202310,17295,8954,8341,11826223.35,11019445.99,22845669.34
260415,202310,180,143,37,188761.22,48840,237601.22
260420,202310,1963,1245,718,1644753.38,949082.45,2593835.83
260430,202310,186,167,19,220447.91,25080.2,245528.11
260440,202310,227,151,76,199324.85,100320.72,299645.57
260450,202310,507,387,120,510853.14,158402.25,669255.39
260460,202310,972,512,460,675856.45,607205.65,1283062.10
260470,202310,360,224,136,295686.12,179521.99,475208.11
260480,202310,294,180,114,237600.2,150480.9,388081.1
260490,202310,258,194,64,256081.2,84480,340561.2
260500,202310,1271,849,422,1120705.76,557045.89,1677751.65
260510,202310,921,734,187,968900.07,246841.07,1215741.14
260515,202310,282,259,23,341880.82,30360.91,372241.73
260520,202310,3499,2159,1340,2851202.32,1768818.73,4620021.05
260530,202310,957,771,186,1017758.13,245521.52,1263279.65
260540,202310,603,466,137,615131.65,180841.82,795973.47
260545,202310,46,23,23,30361.66,30360.47,60722.13
260550,202310,403,260,143,343202.34,188760.18,531962.52
260560,202310,537,413,124,545172.79,163680.59,708853.38
260570,202310,1132,905,227,1194637.2,299641.18,1494278.38
260580,202310,406,321,85,423722.27,112200,535922.27
260590,202310,671,403,268,531963.47,353760.88,885724.35
260600,202310,8606,5044,3562,6659556.38,4703199.13,11362755.51
260610,202310,565,395,170,521413.18,224402.14,745815.32
260620,202310,4249,2219,2030,2931822.51,2681094.18,5612916.69
260630,202310,92,77,15,101640.49,19800,121440.49
260640,202310,3680,2270,1410,2996457.53,1862535.47,4858993.00
260650,202310,346,252,94,332644.54,124080.4,456724.94
260660,202310,688,468,220,619098.12,291724.03,910822.15
260670,202310,130,92,38,121440,50160,171600
260680,202310,4613,2474,2139,3265816.75,2823530.98,6089347.73
260690,202310,154,119,35,157081.56,46200,203281.56
260700,202310,352,249,103,328688.85,135960.69,464649.54
260710,202310,62,51,11,67320,14520,81840
260720,202310,3084,1788,1296,2360194.11,1712048.12,4072242.23
260730,202310,874,641,233,846131.14,307561.69,1153692.83
260740,202310,78,65,13,85801.54,17160,102961.54
260750,202310,599,447,152,590053.38,200640.2,790693.58
260760,202310,866,427,439,563663.91,579490.57,1143154.48
260765,202310,1140,611,529,806537.15,698290.33,1504827.48
260770,202310,246,176,70,232301.34,92401.67,324703.01
260775,202310,986,488,498,644179.85,657369.42,1301549.27
260780,202310,263,156,107,205922.61,141240,347162.61
260790,202310,18530,8800,9730,11624330.52,12851632.25,24475962.77
260795,202310,185,116,69,153120.62,91080,244200.62
260800,202310,326,261,65,344525.44,85800.46,430325.90
260805,202310,56,36,20,47522.14,26400.26,73922.40
260810,202310,955,752,203,992651.54,267960.62,1260612.16
260820,202310,350,230,120,303602.45,158400,462002.45
260825,202310,234,162,72,213841.02,95040,308881.02
260830,202310,320,209,111,275880,146520,422400
260840,202310,307,216,91,285123.34,120120.03,405243.37
260845,202310,245,148,97,195361.38,128041.73,323403.11
260850,202310,460,349,111,462006.57,146520,608526.57
260860,202310,271,202,69,266644.27,91080,357724.27
260870,202310,363,281,82,370926.68,108240,479166.68
260875,202310,832,607,225,801281.31,298321.02,1099602.33
260880,202310,1801,1195,606,1577430.32,801241.76,2378672.08
260890,202310,2874,1957,917,2584617.61,1210447.81,3795065.42
260900,202310,1160,876,284,1156336.23,374880.86,1531217.09
260910,202310,263,211,52,279844.9,68640.6,348485.5
260915,202310,303,230,73,303600.7,96360,399960.7
260920,202310,251,145,106,191400.2,139920,331320.2
260930,202310,401,340,61,448811.82,80520.17,529331.99
260940,202310,2799,1489,1310,1965554.66,1729223.51,3694778.17
260950,202310,2191,1250,941,1651372.67,1242140.09,2893512.76
260960,202310,15955,7648,8307,10101170.03,10973384.12,21074554.15
260970,202310,485,388,97,512166.49,128040,640206.49
260980,202310,240,222,18,293045.58,23760,316805.58
260990,202310,2981,2353,628,3108686.8,828965.34,3937652.14
261000,202310,4665,2906,1759,3837305.89,2325858.62,6163164.51
261010,202310,141,109,32,143881.26,42240,186121.26
261020,202310,645,473,172,624370.42,228360.1,852730.52
261030,202310,281,211,70,278522.83,92400,370922.83
261040,202310,419,347,72,458050.4,95040.62,553091.02
261050,202310,613,491,122,648132.48,161041.69,809174.17
261060,202310,1880,1159,721,1529893.45,951722.94,2481616.39
261070,202310,11411,5345,6066,7062389.51,8020529.65,15082919.16
261080,202310,397,307,90,405248.4,118800,524048.4
261090,202310,2232,1715,517,2263887.01,682445.17,2946332.18
261100,202310,1334,915,419,1207832.08,553086.49,1760918.57
261110,202310,10871,6845,4026,9037153.09,5317053.36,14354206.45
261120,202310,237,201,36,265320.81,47520,312840.81
261130,202310,625,378,247,498974.91,326048.7,825023.61
261140,202310,241,153,88,201960.99,116160,318120.99
261150,202310,692,453,239,597964.78,315480.78,913445.56
261153,202310,81,76,5,100320.2,6600,106920.2
261160,202310,87556,42545,45011,56186305.34,59455161.06,115641466.40
261170,202310,542,407,135,537240.98,178200.92,715441.90
261180,202310,1994,1253,741,1655616.99,979449.5,2635066.49
261190,202310,640,435,205,574209.1,270603.22,844812.32
261200,202310,226,178,48,234965.93,63360.36,298326.29
261210,202310,58,40,18,52800.1,23760,76560.1
261220,202310,3194,2219,975,2931800.5,1288336.1,4220136.6
261230,202310,412,304,108,401288.21,142561.69,543849.90
261240,202310,470,402,68,530651.03,89760.97,620412.00
261245,202310,300,255,45,336600.31,59400,396000.31
261247,202310,196,149,47,196682.98,62040,258722.98
261250,202310,4518,2204,2314,2909341.58,3055820.12,5965161.70
261255,202310,276,244,32,322080.52,42240,364320.52
261260,202310,945,806,139,1063983.68,183483.5,1247467.18
261270,202310,222,157,65,207240.83,85800,293040.83
261280,202310,205,168,37,221762.45,48840.14,270602.59
261290,202310,127,90,37,118800.24,48840.2,167640.44
261300,202310,1613,1214,399,1602514.31,526685.07,2129199.38
261310,202310,929,609,320,803899.74,422402.06,1226301.80
261320,202310,547,387,160,510854.87,211202.86,722057.73
261330,202310,937,745,192,983443.7,253449.55,1236893.25
261340,202310,364,205,159,270602.57,211201.58,481804.15
261350,202310,1036,721,315,951763.13,415812.55,1367575.68
261360,202310,1524,959,565,1267207.13,745805.8,2013012.93
261370,202310,5679,3284,2395,4334983.39,3162758.4,7497741.79
261380,202310,633,507,126,669245.85,167640,836885.85
261390,202310,4277,2946,1331,3890167.34,1758276.31,5648443.65
261400,202310,296,263,33,347168.73,43560.04,390728.77
261410,202310,1242,809,433,1067907.84,571563.15,1639470.99
261420,202310,1085,652,433,860657.11,572882.82,1433539.93
261430,202310,342,308,34,406567.19,44880,451447.19
261440,202310,112,106,6,139921.44,7920,147841.44
261450,202310,2859,2175,684,2872369.18,904207.01,3776576.19
261460,202310,888,681,207,898945.54,274561.8,1173507.34
261470,202310,252,201,51,265322.38,67320.4,332642.78
261480,202310,526,393,133,518774.44,175502.23,694276.67
261485,202310,445,264,181,348489.39,238920.1,587409.49
261500,202310,713,456,257,601931.42,339241.9,941173.32
261510,202310,60,41,19,54120.98,25080.1,79201.08
261520,202310,118,101,17,133323.24,22440.2,155763.44
261530,202310,4825,3124,1701,4123757.2,2245335.61,6369092.81
261540,202310,1728,980,748,1294947.15,987369.29,2282316.44
261550,202310,309,152,157,200641.75,207240,407881.75
261560,202310,1105,735,370,970224.14,488403.22,1458627.36
261570,202310,442,354,88,467287.39,116160.95,583448.34
261580,202310,430,338,92,446165.77,121440.9,567606.67
261590,202310,215,169,46,223086.59,60720.5,283807.09
261600,202310,361,278,83,366969.27,109560.2,476529.47
261610,202310,120,96,24,126721.79,31680,158401.79
261618,202310,92,66,26,87120.86,34320,121440.86
261620,202310,231,149,82,196683.3,108241.18,304924.48
261630,202310,733,565,168,745808.72,221764.1,967572.82
261640,202310,7635,4080,3555,5388410.86,4696635.46,10085046.32
261650,202310,462,297,165,392042.43,217800.1,609842.53
270010,202310,545,478,67,630976.68,88440.52,719417.20
270020,202310,256,218,38,287766.59,50160,337926.59
270030,202310,10225,6602,3623,8725443.99,4787639.98,13513083.97
270040,202310,2231,1498,733,1978739.79,967567.73,2946307.52
270050,202310,265,208,57,274563.89,75240,349803.89
270060,202310,61,45,16,59402.96,21120.33,80523.29
270070,202310,811,603,208,795973.99,274561.1,1070535.09
270080,202310,69,54,15,71280.1,19800,91080.1
270090,202310,22,18,4,23760,5280,29040
270100,202310,1404,965,439,1273828.52,579482.12,1853310.64
270110,202310,65,52,13,68640,17160,85800
270120,202310,321,262,59,345850.4,77880.53,423730.93
270130,202310,376,294,82,388087.21,108240.96,496328.17
270135,202310,128,95,33,125401,43560,168961
270140,202310,1505,1013,492,1338298.86,649450.58,1987749.44
270150,202310,274,195,79,257405.44,105600.63,363006.07
270160,202310,502,397,105,524082.94,138603.36,662686.30
270170,202310,851,568,283,749767.43,373560.8,1123328.23
270180,202310,63,50,13,66000.7,17160.09,83160.79
270190,202310,119,105,14,138604.68,18480,157084.68
270200,202310,131,114,17,150480,22440,172920
270210,202310,576,362,214,477843,282480,760323
270220,202310,200,145,55,191401.05,72600.6,264001.65
270230,202310,2371,1548,823,2043399.35,1087682.54,3131081.89
270235,202310,538,426,112,562345.4,147840.84,710186.24
270240,202310,3512,2760,752,3643258.65,992644.5,4635903.15
270250,202310,110,91,19,120120.41,25080,145200.41
270255,202310,233,195,38,258721.83,50160.44,308882.27
270260,202310,436,350,86,462016.26,113520.6,575536.86
270270,202310,97,52,45,68640.83,60720,129360.83
270280,202310,200,128,72,168960,95040,264000
270290,202310,1206,948,258,1251381.56,340564.47,1591946.03
270300,202310,407,301,106,397321.3,139920.2,537241.5
270310,202310,849,718,131,947782.35,172920.54,1120702.89
270320,202310,793,684,109,902901.05,143880,1046781.05
270330,202310,346,297,49,392040.62,64680,456720.62
270340,202310,71,57,14,75240,18480,93720
270350,202310,80,47,33,62042.43,43560,105602.43
270360,202310,94,53,41,69960,54120,124080
270370,202310,78,60,18,79200,23760,102960
270375,202310,89,59,30,79201.17,39600,118801.17
270380,202310,1088,756,332,997921.68,439560,1437481.68
270390,202310,130,79,51,104281.1,67320.5,171601.6
270400,202310,821,637,184,842181.48,242880.92,1085062.40
270410,202310,230,175,55,231008.18,72600,303608.18
270420,202310,447,316,131,417125.92,172920.51,590046.43
270430,202310,38624,27438,11186,36249320.75,14781693.41,51031014.16
270440,202310,471,372,99,491054.17,130681.3,621735.47
270450,202310,977,596,381,786726.03,502920.57,1289646.60
270460,202310,183,145,38,191404.52,50160,241564.52
270470,202310,1862,1321,541,1745070.28,714122.82,2459193.10
270480,202310,602,483,119,638889.25,157080,795969.25
270490,202310,29,21,8,27720,10560,38280
270500,202310,496,411,85,542526.77,112200,654726.77
270510,202310,957,654,303,863234.02,401283.84,1264517.86
270520,202310,276,186,90,245521.3,120120,365641.3
270530,202310,65,51,14,67320.1,18480,85800.1
270540,202310,81,59,22,77880,29040,106920
270550,202310,1669,1301,368,1718677.63,487082.29,2205759.92
270560,202310,268,171,97,225724.72,128040,353764.72
270570,202310,636,458,178,604565.4,234960,839525.4
270580,202310,21,16,5,21120,6600,27720
270590,202310,63,52,11,68640.3,14520.08,83160.38
270600,202310,180,149,31,196687.8,40920.1,237607.9
270610,202310,265,210,55,277204.06,72600.1,349804.16
270620,202310,18,18,0,23760,,23760.0
270630,202310,3824,2867,957,3786004.06,1263251.69,5049255.75
270640,202310,923,679,244,897618.13,322080.97,1219699.10
270642,202310,232,192,40,253442.83,52800,306242.83
270644,202310,271,179,92,236283.22,121441.69,357724.91
270650,202310,364,235,129,310204.94,170282.15,480487.09
270660,202310,178,156,22,205924.52,29040,234964.52
270670,202310,3126,2399,727,3169217,960962.37,4130179.37
270680,202310,424,286,138,377527.5,182160,559687.5
270690,202310,1332,917,415,1211791.26,547803.69,1759594.95
270700,202310,24,19,5,25080.19,6600,31680.19
270710,202310,588,466,122,615126.74,161040,776166.74
270720,202310,239,199,40,262685.3,52800.92,315486.22
270730,202310,2041,1309,732,1727906.85,967565,2695471.85
270740,202310,34,26,8,34320.36,10560,44880.36
270750,202310,643,504,139,665289.58,183480.9,848770.48
270760,202310,297,217,80,286446.68,105600,392046.68
270770,202310,3130,2177,953,2876358.03,1257969.91,4134327.94
270780,202310,76,48,28,63360,36960.76,100320.76
270790,202310,202,135,67,178203.46,88440.88,266644.34
270800,202310,2117,1703,414,2249324.02,546480,2795804.02
270810,202310,212,171,41,225721.36,54120,279841.36
270820,202310,122,86,36,113525,47520.9,161045.9
270830,202310,910,704,206,929308.67,271921.14,1201229.81
270840,202310,1342,1056,286,1395259.73,377521.4,1772781.13
270850,202310,1606,1071,535,1413735.7,706203.16,2119938.86
270860,202310,2779,1897,882,2504075.7,1165568.74,3669644.44
270870,202310,138,83,55,109560.2,72600.2,182160.4
270880,202310,910,728,182,960991.13,240242.13,1201233.26
270890,202310,266,207,59,273242.68,77880.8,351123.48
270895,202310,85,80,5,105600,6600,112200
270900,202310,66,54,12,71280.93,15840,87120.93
270910,202310,324,275,49,363013.88,64681.54,427695.42
270915,202310,2018,1373,645,1816354.65,851401.59,2667756.24
270920,202310,398,329,69,434284.77,91080,525364.77
270930,202310,5619,4384,1235,5788327.31,1631524.86,7419852.17
270940,202310,2288,1853,435,2446008.62,574201.6,3020210.22
280010,202310,34,29,5,38281.1,6600,44881.1
280020,202310,553,468,85,617776.13,112200.97,729977.10
280030,202310,24520,15713,8807,20754161.64,11628189.93,32382351.57
280040,202310,357,225,132,297004.43,174240.4,471244.83
280050,202310,469,359,110,473887.47,145200,619087.47
280060,202310,468,311,157,410529.62,207240.61,617770.23
280067,202310,1230,897,333,1184062.6,439560.34,1623622.94
280070,202310,136,117,19,154441.75,26400,180841.75
280100,202310,751,577,174,761650.68,229680.2,991330.88
280110,202310,102,88,14,116162.18,18480,134642.18
280120,202310,772,645,127,851412.39,168961.29,1020373.68
280130,202310,1966,1288,678,1701502.67,894962.61,2596465.28
280140,202310,569,470,99,620407.3,130680.2,751087.5
280150,202310,461,334,127,443528.08,167640,611168.08
280160,202310,159,121,38,159722.43,50160,209882.43
280170,202310,469,340,129,448816.17,171601.43,620417.60
280190,202310,35,28,7,36960,9240,46200
280200,202310,59,47,12,62047.92,15840.3,77888.22
280210,202310,3361,2403,958,3171939.65,1265886.64,4437826.29
280220,202310,71,59,12,77882.32,15840,93722.32
280230,202310,356,286,70,378859.42,92402.33,471261.75
280240,202310,148,138,10,182161.96,13200,195361.96
280250,202310,26,10,16,13200.1,21121.32,34321.42
280260,202310,91,76,15,100323.69,19800,120123.69
280270,202310,143,114,29,150480.58,38280.53,188761.11
280280,202310,210,143,67,188763.19,88440.09,277203.28
280290,202310,4279,3142,1137,4147517.33,1502176.71,5649694.04
280300,202310,1856,1474,382,1945708.32,504245.62,2449953.94
280310,202310,119,110,9,145201.67,11880,157081.67
280320,202310,757,524,233,691703.05,307562.64,999265.69
280330,202310,350,258,92,340567.61,121440.2,462007.81
280340,202310,482,399,83,526689.56,109561.9,636251.46
280350,202310,4167,3175,992,4192503.47,1309457.03,5501960.50
280360,202310,502,343,159,452777.28,209881.49,662658.77
280370,202310,105,89,16,117481.09,21120.9,138601.99
280380,202310,51,39,12,51480,15840,67320
280390,202310,190,162,28,213843.83,36960,250803.83
280400,202310,458,294,164,388095.34,216483.08,604578.42
280410,202310,324,274,50,361686.91,66000,427686.91
280420,202310,153,133,20,175569,26400.96,201969.96
280430,202310,113,91,22,120121.78,29040,149161.78
280440,202310,779,646,133,852739.41,175563.16,1028302.57
280445,202310,133,123,10,162363,13200.8,175563.8
280450,202310,1473,1261,212,1664553.14,279843.56,1944396.70
280460,202310,761,569,192,751098.13,254761.28,1005859.41
280470,202310,81,78,3,102963.36,3960,106923.36
280480,202310,3675,2473,1202,3268541.06,1586679.59,4855220.65
280490,202310,191,179,12,236289.26,15840,252129.26
280500,202310,44,41,3,54121.77,3960.84,58082.61
280510,202310,147,111,36,146521.31,47521.35,194042.66
280520,202310,57,39,18,51481.19,23760,75241.19
280530,202310,79,52,27,68643.92,35640.38,104284.30
280540,202310,619,532,87,702249.75,114840.2,817089.95
280550,202310,792,730,62,963626.22,81840,1045466.22
280560,202310,507,459,48,607208.96,63361.53,670570.49
280570,202310,2658,2108,550,2782618.38,728646.01,3511264.39
280580,202310,629,497,132,656048.37,174240.96,830289.33
280590,202310,244,162,82,213855.31,108247.23,322102.54
280600,202310,453,370,83,488468.16,109560.2,598028.36
280610,202310,130,92,38,121447.29,50162.58,171609.87
280620,202310,589,471,118,621729.42,155760,777489.42
280630,202310,158,131,27,172922.63,35640.9,208563.53
280640,202310,179,147,32,194040.3,42240,236280.3
280650,202310,84,51,33,67323.04,43560,110883.04
280660,202310,131,101,30,133325.28,39600.21,172925.49
280670,202310,2236,1442,794,1903569.46,1049428.37,2952997.83
280680,202310,271,230,41,303602.28,54120,357722.28
280690,202310,80,71,9,93720,11880,105600
280700,202310,22,22,0,29040,,29040.0
280710,202310,1676,1292,384,1706790.27,506882.74,2213673.01
280720,202310,152,110,42,145202.05,55440,200642.05
280730,202310,35,32,3,42241.33,3960.05,46201.38
280740,202310,2803,2114,689,2790520.53,909484.97,3700005.50
280750,202310,222,195,27,257405.06,35640.8,293045.86
280760,202310,1050,709,341,935902.42,451442.03,1387344.45
290010,202310,203,141,62,186120.75,81840,267960.75
290020,202310,218,196,22,258721.83,29040.9,287762.73
290030,202310,676,439,237,579487.62,315480.94,894968.56
290035,202310,155,125,30,165001.71,39600.93,204602.64
290040,202310,286,205,81,270607.3,106920,377527.3
290050,202310,103,84,19,110880,25080,135960
290060,202310,256,109,147,143881.41,194040,337921.41
290070,202310,6776,3243,3533,4282211.22,4664928.48,8947139.70
290080,202310,531,238,293,314162.9,386760.09,700922.99
290090,202310,332,159,173,209880.2,228361,438241.2
290100,202310,1894,1211,683,1599875.24,902882.98,2502758.22
290110,202310,987,552,435,728669.45,574209.48,1302878.93
290115,202310,186,171,15,225723.98,19800,245523.98
290120,202310,907,614,293,810489.65,386761.37,1197251.02
290130,202310,521,322,199,425045.38,262680.85,687726.23
290135,202310,302,224,78,295685.37,102960.1,398645.47
290140,202310,352,297,55,392046.98,72600.36,464647.34
290150,202310,157,109,48,143880.1,64680.01,208560.11
290160,202310,255,202,53,266648.2,69960.85,336609.05
290170,202310,120,89,31,117481.61,40920,158401.61
290180,202310,213,153,60,201961.52,79200.2,281161.72
290190,202310,295,227,68,299643.89,89761.1,389404.99
290195,202310,316,220,96,290403.25,126720.1,417123.35
290200,202310,273,220,53,290400.37,69960,360360.37
290205,202310,177,110,67,145200.98,88440,233640.98
290210,202310,1373,998,375,1317394.78,496322.8,1813717.58
290220,202310,169,106,63,139928.27,83161.7,223089.97
290225,202310,313,126,187,166321.61,246840.59,413162.20
290230,202310,110,69,41,91082.03,54120,145202.03
290240,202310,416,149,267,196681.4,353760.55,550441.95
290250,202310,254,235,19,311526.94,25080,336606.94
290260,202310,382,296,86,390736.6,113523.9,504260.5
290265,202310,203,177,26,233645.49,34320.13,267965.62
290270,202310,1472,1208,264,1594617.12,348480.6,1943097.72
290280,202310,557,391,166,516127.7,219120.4,735248.1
290290,202310,1652,1028,624,1356985.73,823680.83,2180666.56
290300,202310,407,345,62,455409.53,81841.48,537251.01
290310,202310,292,143,149,188760.92,196680,385440.92
290320,202310,4789,2870,1919,3792521.58,2539701.6,6332223.18
290323,202310,224,192,32,253447.18,42240.2,295687.38
290327,202310,187,144,43,190084.48,56760,246844.48
290330,202310,141,69,72,91080.02,95040,186120.02
290340,202310,843,355,488,468615.36,644164.44,1112779.80
290350,202310,769,466,303,615126.89,399961.11,1015088.00
290360,202310,329,259,70,341885.29,92400,434285.29
290370,202310,914,434,480,572880.77,634920.91,1207801.68
290380,202310,352,230,122,303603.21,163681.67,467284.88
290390,202310,2621,1619,1002,2138457.99,1323968.74,3462426.73
290395,202310,251,150,101,198000.67,133320,331320.67
290400,202310,313,230,83,303601.79,109560,413161.79
290405,202310,261,224,37,295683.08,48840,344523.08
290410,202310,698,579,119,766925.58,158400.01,925325.59
290420,202310,306,253,53,333962.53,69960,403922.53
290430,202310,531,339,192,447482.58,253440,700922.58
290440,202310,97,78,19,102960.4,25080,128040.4
290450,202310,206,151,55,199320,72600,271920
290460,202310,2186,1295,891,1709437.06,1177441.57,2886878.63
290470,202310,1427,653,774,861982.7,1024326.95,1886309.65
290475,202310,590,552,38,728652.01,50160,778812.01
290480,202310,192,112,80,147840.07,105600,253440.07
290485,202310,255,229,26,302282.8,34320,336602.8
290490,202310,1397,979,418,1293625.14,551764.23,1845389.37
290500,202310,903,507,396,669252.39,524043.07,1193295.46
290510,202310,188,153,35,201971.6,46200.35,248171.95
290515,202310,214,140,74,184803.2,97680,282483.2
290520,202310,1554,1039,515,1371493.06,681121.08,2052614.14
290530,202310,292,254,38,335293.78,50160.93,385454.71
290540,202310,157,75,82,99000,108240,207240
290550,202310,197,160,37,211201.48,48840,260041.48
290560,202310,3404,1577,1827,2081692.25,2411652.91,4493345.16
290570,202310,8146,3881,4265,5124448.04,5632533.19,10756981.23
290580,202310,1411,862,549,1137863.57,724680.6,1862544.17
290590,202310,613,491,122,648159.48,161043.52,809203.00
290600,202310,2008,1375,633,1817708.6,835570.07,2653278.67
290610,202310,179,166,13,219127.69,17160,236287.69
290620,202310,419,370,49,488410.8,64680.6,553091.4
290630,202310,2131,920,1211,1214432.7,1598526.46,2812959.16
290640,202310,145,113,32,149166.15,42240,191406.15
290650,202310,2366,1111,1255,1466571.44,1657929.3,3124500.74
290660,202310,297,247,50,326042.01,66000.72,392042.73
290670,202310,1206,613,593,809175.81,784087.62,1593263.43
290680,202310,1369,1093,276,1442782.13,364322.14,1807104.27
290682,202310,386,290,96,382804.33,126720,509524.33
290685,202310,280,165,115,217804.98,151800.2,369605.18
290687,202310,1366,899,467,1186918.64,617762.59,1804681.23
290689,202310,158,79,79,104280,104280,208560
290690,202310,576,276,300,364327.63,396001.82,760329.45
290700,202310,281,148,133,195367.39,175563.32,370930.71
290710,202310,906,641,265,846136.06,349804.01,1195940.07
290720,202310,1234,966,268,1275162.13,353762.52,1628924.65
290730,202310,1350,807,543,1065261.67,716764.72,1782026.39
290740,202310,34,29,5,38280,6600,44880
290750,202310,1634,736,898,971546.47,1186692.97,2158239.44
290755,202310,89,75,14,99000,18480,117480
290760,202310,270,235,35,310213.52,46201.68,356415.20
290770,202310,204,195,9,257404.34,11880,269284.34
290780,202310,1241,997,244,1317387.49,322084.61,1639472.10
290790,202310,449,311,138,410526.53,182162.78,592689.31
290800,202310,2562,1056,1506,1395268.93,1989249.18,3384518.11
290810,202310,530,357,173,473886.71,228361,702247.71
290820,202310,448,260,188,343208,248163.12,591371.12
290830,202310,532,372,160,491045.43,211200.47,702245.90
290840,202310,2059,1313,746,1734528.86,984726.36,2719255.22
290850,202310,1201,622,579,821051.94,764286.45,1585338.39
290860,202310,763,387,376,510846.6,496322.22,1007168.82
290870,202310,682,480,202,634928.74,266640.61,901569.35
290880,202310,134,74,60,97680.17,79200,176880.17
290890,202310,568,345,223,455406.03,294363.08,749769.11
290900,202310,166,126,40,166320.94,52800,219120.94
290910,202310,437,328,109,432961.38,143880,576841.38
290920,202310,232,206,26,271924.75,34320,306244.75
290930,202310,596,454,142,599296.04,187441.7,786737.74
290940,202310,226,193,33,254761,43560,298321
290950,202310,172,99,73,130680,96360,227040
290960,202310,556,401,155,529326.9,204601.67,733928.57
290970,202310,244,214,30,282482.36,39600.2,322082.56
290980,202310,2228,1576,652,2083003.61,861967.66,2944971.27
290990,202310,470,393,77,518781.82,101642.68,620424.50
291000,202310,980,337,643,444842.76,848760,1293602.76
291005,202310,2979,1284,1695,1697587.69,2237430.43,3935018.12
291010,202310,139,121,18,159720,23760,183480
291020,202310,84,69,15,91080,19800,110880
291030,202310,121,89,32,117481.61,42240,159721.61
291040,202310,711,433,278,572881.61,366961.06,939842.67
291050,202310,1695,881,814,1162947.07,1077128.37,2240075.44
291060,202310,1894,1056,838,1393947.69,1106168.31,2500116.00
291070,202310,2156,1630,526,2153014.78,694328.84,2847343.62
291072,202310,7870,3111,4759,4109323.9,6288526.7,10397850.6
291075,202310,290,242,48,319440.8,63360,382800.8
291077,202310,62,46,16,60720,21120,81840
291080,202310,24067,10486,13581,13845977.16,17942990.56,31788967.72
291085,202310,294,242,52,319444.46,69960.65,389405.11
291090,202310,261,105,156,138600.71,205920,344520.71
291100,202310,983,351,632,464640.37,835560,1300200.37
291110,202310,493,373,120,492368.56,158400.67,650769.23
291120,202310,2613,1446,1167,1908751.27,1543089.65,3451840.92
291125,202310,80,44,36,58080.24,47520,105600.24
291130,202310,201,170,31,224403.95,40920,265323.95
291140,202310,172,142,30,187440.81,39600.1,227040.91
291150,202310,367,139,228,183480.61,300960,484440.61
291160,202310,435,334,101,442215.78,133321.57,575537.35
291165,202310,60,45,15,59400,19800.62,79200.62
291170,202310,3807,1915,1892,2527850.28,2498768.1,5026618.38
291180,202310,1303,570,733,752409.68,968882.04,1721291.72
291185,202310,135,126,9,166322.57,11880,178202.57
291190,202310,1454,717,737,946461.82,974169.92,1920631.74
291200,202310,194,143,51,188760.9,67320,256080.9
291210,202310,2651,1114,1537,1471825.92,2031490.01,3503315.93
291220,202310,355,273,82,360363.17,108240.2,468603.37
291230,202310,981,373,608,492369.36,802562.5,1294931.86
291240,202310,410,378,32,498962.79,42240.9,541203.69
291250,202310,421,348,73,459360.69,96360,555720.69
291260,202310,71,59,12,77880.1,15840,93720.1
291270,202310,783,387,396,510858.56,524220.35,1035078.91
291280,202310,365,177,188,233643.07,248160.3,481803.37
291290,202310,1705,919,786,1213129.75,1038855.81,2251985.56
291300,202310,266,196,70,258722.68,92400,351122.68
291310,202310,238,207,31,273246.16,40920.7,314166.86
291320,202310,1346,933,413,1231601.69,545162.37,1776764.06
291330,202310,148,123,25,162363.14,33000.2,195363.34
291340,202310,264,165,99,217805.91,130681.95,348487.86
291345,202310,125,92,33,121440.4,43560,165000.4
291350,202310,1946,781,1165,1030924.86,1537800.4,2568725.26
291360,202310,9568,4574,4994,6041912.35,6597485.39,12639397.74
291370,202310,1309,807,502,1065286.22,663971.34,1729257.56
291380,202310,293,226,67,298322.38,88440,386762.38
291390,202310,4424,1982,2442,2616294.07,3226093.79,5842387.86
291400,202310,2290,1585,705,2092259.36,931934.26,3024193.62
291410,202310,259,213,46,281164.3,60720,341884.3
291420,202310,130,101,29,133320.16,38280,171600.16
291430,202310,189,115,74,151800,97680,249480
291440,202310,593,486,107,641536.11,141240.73,782776.84
291450,202310,1122,751,371,992665.73,491045.05,1483710.78
291460,202310,2365,1830,535,2415671.57,706213.36,3121884.93
291465,202310,2489,1218,1271,1609111.02,1679046.6,3288157.62
291470,202310,3149,1597,1552,2108084.3,2051296.08,4159380.38
291480,202310,13342,5896,7446,7788281.24,9834060.36,17622341.60
291490,202310,762,312,450,411844.3,594000.2,1005844.5
291500,202310,385,235,150,311227.11,198000,509227.11
291510,202310,1187,483,704,637563.29,929280.26,1566843.55
291520,202310,954,445,509,587416.51,671880.4,1259296.91
291530,202310,947,299,648,394682.27,855360,1250042.27
291535,202310,151,125,26,165000.19,34320.75,199320.94
291540,202310,348,122,226,161042.98,298321.27,459364.25
291550,202310,1339,651,688,859505.92,909481.26,1768987.18
291560,202310,5402,2761,2641,3647217.51,3487448.83,7134666.34
291570,202310,266,148,118,195361.39,157081.7,352443.09
291580,202310,1358,880,478,1161624.98,633600.6,1795225.58
291590,202310,125,62,63,81840.76,83160,165000.76
291600,202310,1208,624,584,823696.45,770883.21,1594579.66
291610,202310,1572,753,819,994013.43,1081102.3,2075115.73
291620,202310,597,285,312,376209.59,411842.69,788052.28
291630,202310,496,158,338,208561.55,446160.2,654721.75
291640,202310,4525,2213,2312,2921229.39,3053180.95,5974410.34
291650,202310,500,359,141,473897.95,186121.78,660019.73
291660,202310,371,156,215,205923.68,283802.25,489725.93
291670,202310,162,100,62,132000.84,81840.73,213841.57
291680,202310,689,432,257,571593.63,339243.32,910836.95
291685,202310,683,394,289,520090.74,381483.51,901574.25
291690,202310,553,368,185,485766.2,244201.22,729967.42
291700,202310,1135,871,264,1149746.64,348481.25,1498227.89
291710,202310,1669,813,856,1073178.39,1129924.77,2203103.16
291720,202310,492,335,157,442201.24,207240.9,649442.14
291730,202310,1014,595,419,785423.83,553084.49,1338508.32
291733,202310,346,232,114,307561.45,150480.2,458041.65
291735,202310,103,78,25,102960.29,33000,135960.29
291740,202310,360,276,84,364321.06,110880,475201.06
291750,202310,2663,1680,983,2217695.65,1297577.31,3515272.96
291760,202310,3293,1834,1459,2422214.32,1928522.12,4350736.44
291770,202310,828,562,266,741874.83,353767.82,1095642.65
291780,202310,134,87,47,114841.06,62040.78,176881.84
291790,202310,176,101,75,133320,99000.84,232320.84
291800,202310,11506,5123,6383,6763912.65,8428286.28,15192198.93
291810,202310,1150,859,291,1133906.66,384124.73,1518031.39
291820,202310,316,233,83,307560.87,109560,417120.87
291830,202310,1066,459,607,605898.24,801246.81,1407145.05
291835,202310,593,551,42,727330.98,55440.22,782771.20
291840,202310,6294,3167,3127,4181983.86,4129052.77,8311036.63
291845,202310,307,111,196,146520,258720,405240
291850,202310,344,299,45,394691.07,59401.56,454092.63
291855,202310,280,120,160,158401.43,211200.48,369601.91
291860,202310,163,106,57,139920.52,75240.7,215161.22
291870,202310,95,46,49,62040,64680,126720
291875,202310,161,149,12,196680.1,15840,212520.1
291880,202310,452,375,77,495017.53,101642.73,596660.26
291890,202310,268,92,176,121440.2,232320,353760.2
291900,202310,66,42,24,55440.2,31680,87120.2
291905,202310,121,91,30,120121.15,39600.4,159721.55
291910,202310,158,129,29,170280.92,38280.1,208561.02
291915,202310,498,438,60,579499.72,79200.79,658700.51
291920,202310,7188,3456,3732,4564773.39,4931606.76,9496380.15
291930,202310,185,115,70,151802,92400.25,244202.25
291940,202310,465,281,184,370922.69,242880,613802.69
291950,202310,1309,1014,295,1338487.82,389400,1727887.82
291955,202310,1658,1007,651,1329273.13,859328.12,2188601.25
291960,202310,219,160,59,211200.88,77880,289080.88
291970,202310,842,620,222,818417.98,293042.28,1111460.26
291980,202310,1516,1304,212,1721314.05,279842.66,2001156.71
291990,202310,163,152,11,200643.3,14520,215163.3
291992,202310,252,125,127,165008.65,168963.48,333972.13
291995,202310,217,145,72,191401.09,95040,286441.09
292000,202310,461,330,131,435607.36,172920.76,608528.12
292010,202310,402,274,128,361680.41,168960,530640.41
292020,202310,343,248,95,327364.57,126720,454084.57
292030,202310,168,129,39,170282.25,51480,221762.25
292040,202310,629,349,280,460680,369600,830280
292045,202310,134,117,17,154440.7,22440.49,176881.19
292050,202310,1019,749,270,988689.19,356401.48,1345090.67
292060,202310,1042,849,193,1122038.21,254763.72,1376801.93
292070,202310,85,34,51,44880.2,67320.9,112201.1
292080,202310,192,135,57,178200.12,75240,253440.12
292090,202310,624,235,389,310201.22,516120.9,826322.12
292100,202310,1871,834,1037,1100926.86,1370188.75,2471115.61
292105,202310,180,163,17,215160,22440,237600
292110,202310,2458,936,1522,1235543.81,2009047.02,3244590.83
292120,202310,782,587,195,774873.82,257401.12,1032274.94
292130,202310,538,297,241,392044.29,320760.17,712804.46
292140,202310,236,189,47,249485.84,62041.24,311527.08
292145,202310,192,116,76,153120.44,100320,253440.44
292150,202310,1637,1378,259,1818990.72,341882.93,2160873.65
292160,202310,192,150,42,198000.7,55440.09,253440.79
292170,202310,1245,1048,197,1383409.14,260042.81,1643451.95
292180,202310,274,193,81,254760.57,106920.1,361680.67
292190,202310,165,108,57,142561.14,75240.97,217802.11
292200,202310,1569,597,972,789374.6,1285687.47,2075062.07
292205,202310,142,121,21,159720.72,27720,187440.72
292210,202310,450,288,162,380168.88,213841.23,594010.11
292220,202310,49,35,14,46200.78,18480,64680.78
292225,202310,74,57,17,75242.63,22440.64,97683.27
292230,202310,1080,840,240,1108829.63,316801.56,1425631.19
292240,202310,694,518,176,683782,232320.5,916102.5
292250,202310,1750,1136,614,1499563.04,811806.34,2311369.38
292260,202310,463,279,184,368283.93,242881.35,611165.28
292265,202310,271,209,62,277204.99,81840.56,359045.55
292270,202310,748,392,356,517447.68,469920,987367.68
292273,202310,224,135,89,178200.9,117480.29,295681.19
292275,202310,198,105,93,138600.5,122760,261360.5
292280,202310,161,113,48,149160,63360,212520
292285,202310,107,82,25,108240,33000,141240
292290,202310,703,471,232,623007.71,306240.72,929248.43
292300,202310,2090,836,1254,1103543.97,1655303.17,2758847.14
292303,202310,157,111,46,146522.39,60720.59,207242.98
292305,202310,129,95,34,125401.72,44880,170281.72
292310,202310,1072,727,345,959658.87,456725.44,1416384.31
292320,202310,653,492,161,649449.83,212521.51,861971.34
292330,202310,183,122,61,161040.99,80520,241560.99
292335,202310,352,272,80,359042.69,105600,464642.69
292340,202310,611,431,180,568925.02,237600.55,806525.57
292350,202310,298,153,145,201962.03,191400,393362.03
292360,202310,811,611,200,806522.68,264001.01,1070523.69
292370,202310,749,574,175,757689.73,231001.21,988690.94
292380,202310,653,551,102,728655.79,134640.2,863295.99
292390,202310,384,163,221,215162.34,291720.96,506883.30
292400,202310,4269,2611,1658,3446623.22,2191214.87,5637838.09
292405,202310,301,198,103,261360.44,135960,397320.44
292410,202310,114,74,40,97680.7,52800,150480.7
292420,202310,277,242,35,319440.9,46200,365640.9
292430,202310,574,410,164,542523.89,217800.52,760324.41
292440,202310,731,609,122,803896.32,161042.13,964938.45
292450,202310,254,193,61,254763.15,80520.2,335283.35
292460,202310,541,410,131,541204.83,172920.68,714125.51
292465,202310,221,191,30,252122.9,39600.1,291723.0
292467,202310,194,128,66,168960,87120,256080
292470,202310,346,231,115,304920.59,151800.31,456720.90
292480,202310,445,295,150,389408.85,198002.58,587411.43
292490,202310,276,207,69,273241.97,91081.7,364323.67
292500,202310,1035,538,497,710180.84,656046.82,1366227.66
292510,202310,3976,1978,1998,2611022.5,2637379.19,5248401.69
292520,202310,1364,657,707,867266.13,934571.6,1801837.73
292525,202310,499,376,123,496331.69,162363.24,658694.93
292530,202310,5736,2402,3334,3173352.77,4404873.2,7578225.97
292540,202310,507,294,213,388083.03,281161.42,669244.45
292550,202310,1222,687,535,906853.58,707523.83,1614377.41
292560,202310,354,321,33,425054.31,43560.16,468614.47
292570,202310,388,293,95,388081.01,125400,513481.01
292575,202310,650,485,165,640225.89,219121.48,859347.37
292580,202310,1133,775,358,1024328.43,472563.67,1496892.10
292590,202310,619,546,73,720726.57,96360.8,817087.37
292593,202310,159,127,32,167641.48,43560,211201.48
292595,202310,245,190,55,250803.08,72600,323403.08
292600,202310,1398,992,406,1309490.09,535928.77,1845418.86
292610,202310,109,91,18,120122.45,23761.11,143883.56
292620,202310,567,469,98,619114.73,129361.73,748476.46
292630,202310,1734,951,783,1255345.53,1033565.82,2288911.35
292640,202310,951,662,289,873853.53,382805.59,1256659.12
292650,202310,206,155,51,204608.08,67320,271928.08
292660,202310,2186,1519,667,2005148.7,880452.6,2885601.3
292665,202310,144,102,42,134641.04,55440,190081.04
292670,202310,415,316,99,417122.18,130680.21,547802.39
292680,202310,275,209,66,275881.99,87120,363001.99
292690,202310,221,150,71,198000.7,93720,291720.7
292700,202310,1128,750,378,991350.74,498965.7,1490316.44
292710,202310,121,102,19,134641.11,25080.31,159721.42
292720,202310,1130,652,478,860648.5,630960.78,1491609.28
292730,202310,253,122,131,161041.17,172920.4,333961.57
292740,202310,90226,42783,47443,56499794.78,62678618.99,119178413.77
292750,202310,451,331,120,438250.29,158403.08,596653.37
292760,202310,365,313,52,414481.73,68640.15,483121.88
292770,202310,991,414,577,546488.83,761647.05,1308135.88
292780,202310,68,35,33,46201.79,43560.15,89761.94
292790,202310,825,446,379,590043.11,501600.2,1091643.31
292800,202310,1412,851,561,1123340.72,740526.02,1863866.74
292805,202310,434,171,263,225720.95,347161.37,572882.32
292810,202310,1998,1182,816,1561587.29,1078443.72,2640031.01
292820,202310,759,642,117,847468.93,154442.61,1001911.54
292830,202310,153,115,38,151805.91,50160.83,201966.74
292840,202310,771,616,155,813147.53,204603.03,1017750.56
292850,202310,158,107,51,141241.81,67321.76,208563.57
292860,202310,2287,1330,957,1755660.81,1267211.58,3022872.39
292870,202310,4166,2730,1436,3605004.58,1895530.38,5500534.96
292880,202310,1584,1050,534,1386027.76,706205.28,2092233.04
292890,202310,613,512,101,675859.19,133321.97,809181.16
292895,202310,160,116,44,153120.75,58080,211200.75
292900,202310,370,270,100,356415.43,132003.11,488418.54
292905,202310,553,276,277,364329.06,365644.2,729973.26
292910,202310,593,441,152,582127.18,200640.82,782768.00
292920,202310,686,310,376,409213.65,497648.87,906862.52
292925,202310,504,458,46,604561.62,60721.22,665282.84
292930,202310,831,506,325,667932.7,429004.25,1096936.95
292935,202310,279,122,157,161041.37,207240.82,368282.19
292937,202310,222,151,71,199321.88,93720,293041.88
292940,202310,208,157,51,207241.86,67320,274561.86
292950,202310,1568,750,818,991348.32,1079769.06,2071117.38
292960,202310,533,384,149,506900.2,196681.48,703581.68
292970,202310,276,201,75,265323.6,99003.12,364326.72
292975,202310,111,61,50,80525.26,66001.06,146526.32
292980,202310,384,267,117,352444.39,154441.74,506886.13
292990,202310,1428,1082,346,1429569.54,456720.77,1886290.31
293000,202310,122,86,36,113522.33,47520,161042.33
293010,202310,3390,2010,1380,2654652.74,1821630.95,4476283.69
293015,202310,665,548,117,723375.44,154440,877815.44
293020,202310,393,310,83,409214.57,109561.97,518776.54
293030,202310,591,530,61,699609.05,80520,780129.05
293040,202310,403,323,80,426361.8,105600.68,531962.48
293050,202310,3459,2025,1434,2673066.65,1892901.72,4565968.37
293060,202310,246,198,48,261372.26,63361.43,324733.69
293070,202310,4433,2219,2214,2933160.64,2925153.2,5858313.84
293075,202310,101,70,31,92401.29,40920,133321.29
293076,202310,101,77,24,101642.36,31680,133322.36
293077,202310,700,396,304,522741.49,402605.16,925346.65
293080,202310,451,398,53,526687.14,69960.66,596647.80
293090,202310,143,127,16,167640,21120,188760
293100,202310,604,405,199,535931.5,262680.62,798612.12
293105,202310,376,278,98,366962.21,129360,496322.21
293110,202310,123,80,43,105605.9,56762.42,162368.32
293120,202310,318,230,88,303606.58,116165.29,419771.87
293130,202310,270,179,91,236284.19,120120,356404.19
293135,202310,9229,3804,5425,5024048.15,7170260.26,12194308.41
293140,202310,216,127,89,168964.83,117480.79,286445.62
293150,202310,348,301,47,397328.24,62040.2,459368.44
293160,202310,455,294,161,388082.78,212520,600602.78
293170,202310,290,179,111,236284.82,147842.31,384127.13
293180,202310,663,461,202,608521.78,266640,875161.78
293190,202310,1516,1041,475,1374157.3,627007.05,2001164.35
293200,202310,639,552,87,728658.52,114840.42,843498.94
293210,202310,464,355,109,469929.8,143880,613809.8
293220,202310,2589,1186,1403,1565544.12,1857248.25,3422792.37
293230,202310,2025,768,1257,1015101.49,1660563.89,2675665.38
293240,202310,251,223,28,294370.04,36960.2,331330.24
293245,202310,139,112,27,147842.01,35640,183482.01
293250,202310,831,370,461,488415.05,608531.86,1096946.91
293260,202310,356,278,78,366962.1,102960,469922.1
293270,202310,1247,570,677,752405.74,893640.1,1646045.84
293280,202310,341,234,107,308882.51,141241.42,450123.93
293290,202310,3382,2195,1187,2898802.31,1568171.67,4466973.98
293300,202310,986,681,305,898929.35,402601,1301530.35
293305,202310,212,163,49,215161.71,64680.65,279842.36
293310,202310,185,137,48,180841.31,63360.7,244202.01
293315,202310,197,150,47,198004.44,62041.09,260045.53
293317,202310,106,81,25,106920.2,33000,139920.2
293320,202310,1403,735,668,970260.42,883099.77,1853360.19
293325,202310,218,94,124,124080,163680,287760
293330,202310,16788,7954,8834,10504848.97,11664956.6,22169805.57
293340,202310,304,215,89,283801.4,117480,401281.4
293345,202310,286,242,44,319444.88,58080,377524.88
293350,202310,632,412,220,543852.21,290401.24,834253.45
293360,202310,1608,1125,483,1485039.49,638887.33,2123926.82
310010,202310,152,83,69,109560.77,91080.04,200640.81
310020,202310,1029,558,471,736574.84,621724.45,1358299.29
310030,202310,333,264,69,348484.68,91082.32,439567.00
310040,202310,57,38,19,50160,25080,75240
310050,202310,179,117,62,154440.41,81840,236280.41
310060,202310,312,231,81,304929,106920.67,411849.67
310070,202310,24,17,7,22440.21,9240.2,31680.41
310080,202310,55,37,18,48840,23761.25,72601.25
310090,202310,1220,683,537,901752.66,708845.09,1610597.75
310100,202310,421,291,130,384133.24,171601.41,555734.65
310110,202310,771,417,354,550447.85,467283.17,1017731.02
310120,202310,459,261,198,344520.71,261360.73,605881.44
310130,202310,43,22,21,29040.2,27720,56760.2
310140,202310,24,9,15,11880,19800.76,31680.76
310150,202310,1291,842,449,1112795.66,594009.43,1706805.09
310160,202310,2353,1164,1189,1536524.07,1572129.04,3108653.11
310163,202310,108,61,47,80520,62040,142560
310170,202310,2833,1389,1444,1834846.91,1907414.41,3742261.32
310180,202310,225,110,115,145201.44,151800,297001.44
310190,202310,534,351,183,463326.71,241561.54,704888.25
310200,202310,448,280,168,369602.76,223080,592682.76
310205,202310,94,67,27,88440.93,35640,124080.93
310210,202310,291,235,56,310201.42,73920,384121.42
310220,202310,71,48,23,63361.2,30360,93721.2
310230,202310,318,229,89,303603.59,117480,421083.59
310240,202310,137,110,27,145200,35640,180840
310250,202310,105,85,20,112202.56,26400,138602.56
310260,202310,827,451,376,597978.65,497644.16,1095622.81
310270,202310,319,210,109,277205.49,143880.14,421085.63
310280,202310,445,305,140,402602.73,184800,587402.73
310285,202310,222,173,49,228362.31,64680.86,293043.17
310290,202310,250,132,118,174242.72,157080,331322.72
310300,202310,201,163,38,215162.78,50160,265322.78
310310,202310,20,17,3,22440,3960,26400
310320,202310,31,12,19,15840.18,25080.17,40920.35
310330,202310,51,38,13,50160.24,17160.66,67320.90
310340,202310,2059,1488,571,1964199.85,756362.59,2720562.44
310350,202310,3042,1537,1505,2028910.12,1986610.44,4015520.56
310360,202310,58,43,15,56760.77,19800.14,76560.91
310370,202310,156,130,26,171600,34320,205920
310375,202310,112,41,71,54121.6,93721.96,147843.56
310380,202310,55,36,19,47520,25080,72600
310390,202310,111,70,41,92401.09,54120,146521.09
310400,202310,2869,1928,941,2546379.5,1244770.45,3791149.95
310410,202310,133,80,53,105600.82,69960,175560.82
310420,202310,747,394,353,521412.48,465963.15,987375.63
310430,202310,308,201,107,265321.18,141240,406561.18
310440,202310,90,61,29,80521,38280,118801
310445,202310,92,79,13,104280.94,17160,121440.94
310450,202310,725,491,234,649454.1,308881.29,958335.39
310460,202310,281,192,89,253443.42,117480.56,370923.98
310470,202310,585,379,206,500289.27,273241.82,773531.09
310480,202310,114,75,39,99000,51480,150480
310490,202310,652,323,329,426368.04,434281.11,860649.15
310500,202310,146,64,82,84481.45,108240,192721.45
310510,202310,666,469,197,620412.18,260040.63,880452.81
310520,202310,170,118,52,155762.66,68640,224402.66
310530,202310,140,61,79,80520.7,104280,184800.7
310540,202310,553,309,244,407889.38,323402.05,731291.43
310550,202310,85,58,27,76561.76,35640,112201.76
310560,202310,3556,2438,1118,3219578.94,1475765.05,4695343.99
310570,202310,129,86,43,113520.95,56760,170280.95
310590,202310,451,276,175,364329.05,232321.8,596650.85
310600,202310,154,74,80,97681.4,105600,203281.4
310610,202310,40,14,26,18480.73,34320,52800.73
310620,202310,58249,27763,30486,36671977.83,40290602.22,76962580.05
310630,202310,854,538,316,710177.9,418441.91,1128619.81
310640,202310,181,117,64,154440.2,84480.2,238920.4
310650,202310,190,172,18,228360.39,23760,252120.39
310660,202310,131,89,42,117480.2,55440,172920.2
310665,202310,76,54,22,71280,29040,100320
310670,202310,8487,3684,4803,4865700.99,6343955.29,11209656.28
310680,202310,67,46,21,60720,27720,88440
310690,202310,648,458,190,604571.97,250802.44,855374.41
310700,202310,61,37,24,48840.2,31680.97,80521.17
310710,202310,1403,954,449,1259300.38,594005.69,1853306.07
310720,202310,163,47,116,62040,153120,215160
310730,202310,1762,1196,566,1580097.83,748457.71,2328555.54
310740,202310,1116,605,511,798631.01,674527,1473158.01
310750,202310,278,183,95,241562.55,125400.37,366962.92
310760,202310,82,63,19,83162.67,25080,108242.67
310770,202310,83,40,43,52800.1,56760,109560.1
310780,202310,398,320,78,422407.35,102961,525368.35
310790,202310,140,111,29,146521.38,38280.59,184801.97
310800,202310,521,245,276,323403.62,364320,687723.62
310810,202310,192,126,66,167640.84,87120.59,254761.43
310820,202310,317,255,62,336609.95,81840.04,418449.99
310825,202310,211,179,32,236282.76,42240,278522.76
310830,202310,504,229,275,302283.88,363002.02,665285.90
310840,202310,411,261,150,345842.22,199320.83,545163.05
310850,202310,87,71,16,93720.95,21120,114840.95
310855,202310,493,391,102,516128.52,134640,650768.52
310860,202310,1767,1304,463,1721334.3,611171.75,2332506.05
310870,202310,71,60,11,79200.6,14520,93720.6
310880,202310,104,81,23,106798,30360,137158
310890,202310,324,186,138,245521.87,182160,427681.87
310900,202310,721,342,379,451447.79,501605.02,953052.81
310910,202310,259,172,87,227040.89,114840,341880.89
310920,202310,462,272,190,360371.85,250808.53,611180.38
310925,202310,52,43,9,56760.66,11880,68640.66
310930,202310,1483,1010,473,1333226.17,624365.58,1957591.75
310940,202310,760,368,392,485776.09,517446.11,1003222.20
310945,202310,168,114,54,150480.42,71280,221760.42
310950,202310,229,182,47,240242.55,62040,302282.55
310960,202310,75,27,48,35640.9,63361.57,99002.47
310970,202310,186,107,79,141243.88,104280,245523.88
310980,202310,57,41,16,54126.47,21120,75246.47
310990,202310,176,97,79,128040.9,104281.05,232321.95
311000,202310,974,505,469,667931.62,619083.02,1287014.64
311010,202310,56,43,13,56760.94,17160,73920.94
311020,202310,52,36,16,47520.55,21120,68640.55
311030,202310,431,238,193,314162.42,254760.16,568922.58
311040,202310,37,30,7,39600,9240,48840
311050,202310,569,213,356,281160.84,471240.82,752401.66
311060,202310,918,503,415,663970.8,549124.21,1213095.01
311070,202310,382,174,208,229682.16,274560,504242.16
311080,202310,134,75,59,99000.95,77880.4,176881.35
311090,202310,389,197,192,260048.38,253440.86,513489.24
311100,202310,609,374,235,493687.65,310200.25,803887.90
311110,202310,744,527,217,698298.68,286445.86,984744.54
311115,202310,90,63,27,83160.58,35640.2,118800.78
311120,202310,1213,680,533,898948.14,703565.51,1602513.65
311130,202310,292,169,123,223085.87,162360,385445.87
311140,202310,174,99,75,130683.92,99002.18,229686.10
311150,202310,357,231,126,304924.42,166320,471244.42
311160,202310,837,589,248,777490.92,327361.16,1104852.08
311170,202310,107,86,21,113520.61,27720,141240.61
311180,202310,328,226,102,298327.8,134640.64,432968.44
311190,202310,39,18,21,23760,27720,51480
311200,202310,360,247,113,326042.07,149160.9,475202.97
311205,202310,42,34,8,44881.14,10560,55441.14
311210,202310,43,37,6,48840,7920,56760
311220,202310,33,30,3,39600,3960,43560
311230,202310,1818,1235,583,1632896.83,769569.33,2402466.16
311240,202310,102,69,33,91086.16,43560.5,134646.66
311250,202310,62,29,33,38280,43560,81840
311260,202310,577,352,225,464647.06,298320.14,762967.20
311265,202310,154,101,53,133322.27,69960,203282.27
311270,202310,302,203,99,267964.13,130681.11,398645.24
311280,202310,212,93,119,122761.4,157080,279841.4
311290,202310,118,101,17,133321.67,22440,155761.67
311300,202310,638,417,221,550450.96,291722.77,842173.73
311310,202310,19,16,3,21120,3960,25080
311320,202310,698,516,182,682454.66,240241.53,922696.19
311330,202310,1346,968,378,1277791.75,498970.3,1776762.05
311340,202310,2942,2063,879,2724548.51,1162925.44,3887473.95
311350,202310,281,214,67,282482.38,88440,370922.38
311360,202310,168,102,66,134642.78,87120,221762.78
311370,202310,1320,566,754,747152.05,995289.32,1742441.37
311380,202310,8,6,2,7920,2640,10560
311390,202310,270,158,112,208563.05,147840.2,356403.25
311400,202310,140,85,55,112200.8,72600,184800.8
311410,202310,144,73,71,96360.95,93720,190080.95
311420,202310,344,171,173,225726.75,228361.22,454087.97
311430,202310,942,621,321,819728.7,423720.51,1243449.21
311440,202310,508,336,172,443529.36,227041.87,670571.23
311450,202310,328,189,139,249482.19,183480,432962.19
311455,202310,282,193,89,254768.46,117480.92,372249.38
311460,202310,141,65,76,85800.3,100320,186120.3
311470,202310,41,20,21,26400,27720,54120
311480,202310,74,44,30,58080,39600,97680
311490,202310,12,6,6,7920,7920,15840
311500,202310,35,19,16,25080,21120,46200
311510,202310,880,602,278,794656.95,366960.74,1161617.69
311520,202310,41,35,6,46200,7920,54120
311530,202310,2046,1463,583,1931262.59,769564.2,2700826.79
311535,202310,75,46,29,60721.7,38280.52,99002.22
311540,202310,34,30,4,39600.16,5280,44880.16
311545,202310,198,141,57,186123.04,75240,261363.04
311547,202310,67,52,15,68640,19801.72,88441.72
311550,202310,778,361,417,477849.66,551761.61,1029611.27
311560,202310,43,26,17,34320.83,22440,56760.83
311570,202310,312,210,102,277203.02,134642.27,411845.29
311580,202310,472,310,162,409206.02,213840.75,623046.77
311590,202310,30,25,5,33000.27,7920,40920.27
311600,202310,98,78,20,102963.96,26400.93,129364.89
311610,202310,262,229,33,302283.2,43560,345843.2
311615,202310,210,178,32,234961.56,42240.52,277202.08
311620,202310,35,24,11,31680.8,14520,46200.8
311630,202310,128,112,16,147840.49,21120,168960.49
311640,202310,157,84,73,110882.37,96363.4,207245.77
311650,202310,148,99,49,130680.9,64680.2,195361.1
311660,202310,494,229,265,302283.75,349801.13,652084.88
311670,202310,170,123,47,162172.98,62040.43,224213.41
311680,202310,249,187,62,246840.9,83160.18,330001.08
311690,202310,14,13,1,17160.5,1320,18480.5
311700,202310,213,161,52,212522.44,68640.96,281163.40
311710,202310,191,128,63,168961.32,83160,252121.32
311720,202310,39,29,10,38280.89,13200,51480.89
311730,202310,626,444,182,586097.03,240241.15,826338.18
311740,202310,27,21,6,27720,7920,35640
311750,202310,773,521,252,690365.93,332640.93,1023006.86
311760,202310,86,38,48,50161.47,63360.11,113521.58
311770,202310,420,223,197,295684.12,260040.61,555724.73
311780,202310,251,138,113,182162.3,149160.89,331323.19
311783,202310,109,94,15,124080.7,19800,143880.7
311787,202310,53,23,30,30360,39600.13,69960.13
311790,202310,287,126,161,166321.2,213842.16,380163.36
311800,202310,862,506,356,667937.47,469922.25,1137859.72
311810,202310,62,45,17,59401.61,22440,81841.61
311820,202310,149,110,39,145204.32,51480.58,196684.90
311830,202310,2185,1254,931,1655321.04,1231563.62,2886884.66
311840,202310,1250,741,509,978132.04,673204.39,1651336.43
311850,202310,20,14,6,18480,7920.2,26400.2
311860,202310,11898,5163,6735,6818028.91,8898197.89,15716226.80
311870,202310,125,74,51,97683.38,67320.31,165003.69
311880,202310,1040,747,293,986067.96,386768.47,1372836.43
311890,202310,233,110,123,145093.91,162363.66,307457.57
311900,202310,71,31,40,40920,52800.15,93720.15
311910,202310,1547,975,572,1287027.5,755045.06,2042072.56
311920,202310,269,176,93,232322.02,122760.2,355082.22
311930,202310,1031,582,449,769574.2,592683.05,1362257.25
311940,202310,3104,1762,1342,2327232.77,1772763.15,4099995.92
311950,202310,188,110,78,145202.16,102961.05,248163.21
311960,202310,70,49,21,64680.13,27720,92400.13
311970,202310,28,15,13,19800,17160,36960
311980,202310,44,35,9,46200,11880,58080
311990,202310,44,29,15,38280.08,19800.64,58080.72
311995,202310,56,33,23,43560.7,30360.2,73920.9
312000,202310,23,18,5,23760,6600,30360
312010,202310,74,57,17,75241.68,22440.1,97681.78
312015,202310,94,64,30,84480.69,39600,124080.69
312020,202310,151,114,37,150480.25,48840.57,199320.82
312030,202310,85,65,20,85800,26400,112200
312040,202310,101,59,42,77880,55440,133320
312050,202310,209,125,84,165001.17,110880,275881.17
312060,202310,20,12,8,15840,10560,26400
312070,202310,89,60,29,79200.97,38280,117480.97
312080,202310,537,266,271,351125.28,357720.74,708846.02
312083,202310,93,61,32,80520.37,42240,122760.37
312087,202310,116,84,32,110881.42,42240,153121.42
312090,202310,3882,2421,1461,3195850.65,1928541.97,5124392.62
312100,202310,160,108,52,142563,68640.86,211203.86
312110,202310,142,84,58,110881.95,76561.83,187443.78
312120,202310,135,96,39,128041.51,51480,179521.51
312125,202310,94,65,29,85803.2,38280.88,124084.08
312130,202310,140,96,44,126721.91,58080,184801.91
312140,202310,166,124,42,163681.54,55440,219121.54
312150,202310,40,33,7,43560,9240,52800
312160,202310,1582,1040,542,1374264.94,715446.09,2089711.03
312170,202310,24,14,10,18480,13200,31680
312180,202310,92,67,25,88440.14,33000,121440.14
312190,202310,52,46,6,60720.96,7920,68640.96
312200,202310,807,683,124,901578.32,163681.6,1065259.92
312210,202310,146,80,66,105601.42,87120.48,192721.90
312220,202310,168,126,42,166321.78,56760,223081.78
312230,202310,4331,1912,2419,2526573.11,3201008.85,5727581.96
312235,202310,201,133,68,175560,89760,265320
312240,202310,92,69,23,91082.59,30360.43,121443.02
312245,202310,254,185,69,244205.52,91080.43,335285.95
312247,202310,88,64,24,84480.37,31680.38,116160.75
312250,202310,191,101,90,133322.97,118800,252122.97
312260,202310,116,74,42,97680,55440,153120
312270,202310,151,87,64,116162.32,84480,200642.32
312280,202310,30,15,15,19800,19800,39600
312290,202310,158,109,49,143884.52,64680.3,208564.82
312300,202310,220,145,75,191403.25,99000.35,290403.60
312310,202310,69,61,8,80520,10560,91080
312320,202310,461,283,178,374881.43,236280,611161.43
312330,202310,122,107,15,141240.8,19800.91,161041.71
312340,202310,35,18,17,23760,22440,46200
312350,202310,16,9,7,11880.82,9240,21120.82
312352,202310,98,71,27,93720.97,35640,129360.97
312360,202310,637,287,350,378847.8,463320.37,842168.17
312370,202310,428,245,183,323400.82,241560.89,564961.71
312380,202310,161,108,53,142567.41,69961.52,212528.93
312385,202310,194,153,41,201963.58,54120.2,256083.78
312390,202310,322,203,119,267962.35,157080,425042.35
312400,202310,421,319,102,422402.41,134640.07,557042.48
312410,202310,1395,528,867,698303.64,1147101.29,1845404.93
312420,202310,761,576,185,760328.77,244202.12,1004530.89
312430,202310,928,668,260,881772.19,344521.97,1226294.16
312440,202310,65,49,16,64680,21120,85800
312450,202310,249,147,102,194040,134640,328680
312460,202310,42,18,24,23760,31680,55440
312470,202310,52,36,16,47520,21120,68640
312480,202310,165,104,61,137284.03,80521.19,217805.22
312490,202310,345,235,110,310208.83,145201.6,455410.43
312500,202310,38,27,11,35641.75,14520,50161.75
312510,202310,802,325,477,429011.16,629647.7,1058658.86
312520,202310,28,10,18,13200,23760,36960
312530,202310,42,29,13,39600.9,17160.1,56761.0
312540,202310,89,75,14,99000.53,18480,117480.53
312550,202310,36,29,7,38280,9240,47520
312560,202310,230,179,51,236281.31,67320,303601.31
312570,202310,557,342,215,451452.03,283802.38,735254.41
312580,202310,89,54,35,71280,46200,117480
312590,202310,226,176,50,232323.06,66000,298323.06
312595,202310,175,143,32,188761.02,42240,231001.02
312600,202310,73,34,39,44880,51480,96360
312610,202310,1737,941,796,1242153.41,1053362.76,2295516.17
312620,202310,243,180,63,237601.82,84480,322081.82
312630,202310,82,64,18,84480.26,23760,108240.26
312640,202310,53,17,36,22440,47520,69960
312650,202310,165,141,24,186565.54,31680.1,218245.64
312660,202310,116,81,35,106924.97,46200.39,153125.36
312670,202310,1030,648,382,855391.04,504244.58,1359635.62
312675,202310,53,40,13,52800,17160,69960
312680,202310,82,53,29,69960,38280,108240
312690,202310,307,163,144,215163.04,190080.8,405243.84
312695,202310,41,33,8,43560,10560,54120
312700,202310,287,164,123,216484.32,162360.68,378845.00
312705,202310,92,73,19,96360,25080,121440
312707,202310,137,97,40,128040.24,52800,180840.24
312710,202310,2057,1188,869,1569538.17,1147092.8,2716630.97
312720,202310,50,25,25,33000.56,33000,66000.56
312730,202310,309,182,127,241563.41,167642.42,409205.83
312733,202310,53,43,10,56760.7,13200,69960.7
312735,202310,25,19,6,25080.71,7920.3,33001.01
312737,202310,95,59,36,77880.93,47520,125400.93
312738,202310,97,58,39,76560.91,51480,128040.91
312740,202310,87,52,35,68640.06,46200,114840.06
312750,202310,151,105,46,138600.28,60720,199320.28
312760,202310,285,194,91,257404.4,120120.97,377525.37
312770,202310,10317,5073,5244,6703140.08,6930017.62,13633157.70
312780,202310,475,363,112,479168.52,147843.71,627012.23
312790,202310,23,18,5,23760,6600,30360
312800,202310,1845,1266,579,1672456.7,765603.08,2438059.78
312810,202310,382,268,114,355080.84,150480,505560.84
312820,202310,218,170,48,224401.79,63360,287761.79
312825,202310,46,34,12,44883.02,15840,60723.02
312830,202310,216,119,97,157082.89,128041.14,285124.03
312840,202310,220,153,67,201961.02,88440,290401.02
312850,202310,37,32,5,42241.57,6600,48841.57
312860,202310,171,111,60,146521.17,79200,225721.17
312870,202310,1372,728,644,962308.35,852721.35,1815029.70
312880,202310,140,108,32,142562.76,42240,184802.76
312890,202310,188,134,54,178203.84,71280,249483.84
312900,202310,162,124,38,163682.98,50160,213842.98
312910,202310,196,113,83,149166.17,109561.35,258727.52
312920,202310,122,72,50,95041.16,66000,161041.16
312930,202310,372,244,128,322084.18,168961.3,491045.48
312940,202310,170,114,56,150480.8,73920,224400.8
312950,202310,821,582,239,769581.66,315482.3,1085063.96
312960,202310,151,109,42,143887.75,55440.99,199328.74
312965,202310,127,102,25,134640.28,33000,167640.28
312970,202310,315,252,63,332649.05,83161.72,415810.77
312980,202310,3080,1621,1459,2139791.49,1927211.84,4067003.33
312990,202310,50,20,30,26400.9,39600,66000.9
313000,202310,58,33,25,43560,33000,76560
313005,202310,200,151,49,201960.25,64680.61,266640.86
313010,202310,1104,491,613,648135.34,809168.59,1457303.93
313020,202310,199,102,97,134640,128040,262680
313030,202310,228,152,76,200644.13,100320.76,300964.89
313040,202310,102,29,73,39600.73,97680,137280.73
313050,202310,238,176,62,232320.44,81840,314160.44
313055,202310,47,33,14,43560,18480,62040
313060,202310,161,114,47,150481.05,62040,212521.05
313065,202310,63,48,15,63360,19800,83160
313070,202310,125,66,59,87122.2,77880,165002.2
313080,202310,48,26,22,34320,29040,63360
313090,202310,759,498,261,657365.19,344520.52,1001885.71
313100,202310,237,88,149,116160.2,196680,312840.2
313110,202310,181,104,77,137281.29,101641.43,238922.72
313115,202310,302,170,132,225722.96,174240.28,399963.24
313120,202310,959,552,407,728653.78,537244.1,1265897.88
313130,202310,6952,3914,3038,5166638.92,4011510.16,9178149.08
313140,202310,147,87,60,114843.07,79201.35,194044.42
313150,202310,316,248,68,327364.47,89760,417124.47
313160,202310,194,147,47,194045.39,62040,256085.39
313170,202310,1619,1033,586,1363605.61,773523.24,2137128.85
313180,202310,387,254,133,335284.42,176883.52,512167.94
313190,202310,840,481,359,634935.89,473883.78,1108819.67
313200,202310,38,31,7,40920.78,9240,50160.78
313210,202310,1080,914,166,1206534.66,219125.45,1425660.11
313220,202310,355,214,141,282480,186120,468600
313230,202310,333,257,76,339241.45,100320,439561.45
313240,202310,2570,1301,1269,1717368.24,1677721.05,3395089.29
313250,202310,1318,994,324,1313431.85,427684.1,1741115.95
313260,202310,110,55,55,72601.97,72600,145201.97
313270,202310,1159,698,461,922692.38,608524.41,1531216.79
313280,202310,49,38,11,50160,14520,64680
313290,202310,255,207,48,273247.1,64680.57,337927.67
313300,202310,361,177,184,233645.47,242880.58,476526.05
313310,202310,277,126,151,166322.17,199320.8,365642.97
313320,202310,430,318,112,419762.59,147840.07,567602.66
313330,202310,1577,991,586,1308148.93,773524.75,2081673.68
313340,202310,359,258,101,340566.43,133320.91,473887.34
313350,202310,467,294,173,388084.55,231000.24,619084.79
313360,202310,231,105,126,138600.34,166320,304920.34
313370,202310,251,95,156,125401.42,207240,332641.42
313375,202310,367,234,133,308886.67,175561.2,484447.87
313380,202310,1444,754,690,996631.8,913441.73,1910073.53
313390,202310,55,48,7,63360,9240,72600
313400,202310,438,313,125,413178.8,165002,578180.8
313410,202310,113,73,40,96361.31,52800,149161.31
313420,202310,5209,3082,2127,4069708.65,2812936.31,6882644.96
313430,202310,129,61,68,80520.31,89760.33,170280.64
313440,202310,1467,1050,417,1387382.62,550449.13,1937831.75
313450,202310,80,33,47,43560,62040,105600
313460,202310,443,199,244,262683.3,322081.61,584764.91
313470,202310,542,268,274,353773.1,363006.32,716779.42
313480,202310,174,134,40,178201.42,52800,231001.42
313490,202310,639,291,348,385456.38,459368.52,844824.90
313500,202310,33,19,14,25080.61,18480,43560.61
313505,202310,1193,906,287,1197281.5,378847.12,1576128.62
313507,202310,129,92,37,121441.62,48840,170281.62
313510,202310,3247,2000,1247,2640214.96,1646066.72,4286281.68
313520,202310,3693,2839,854,3748955.7,1128608.8,4877564.5
313530,202310,46,28,18,36960,23760.94,60720.94
313535,202310,108,87,21,114841.27,27720.5,142561.77
313540,202310,71,51,20,67320,26400,93720
313545,202310,142,123,19,162360.56,25080,187440.56
313550,202310,236,200,36,264003.59,47520.1,311523.69
313560,202310,378,182,196,240247.35,258725.64,498972.99
313570,202310,90,31,59,40920,77880,118800
313580,202310,1506,910,596,1202543.69,788046.53,1990590.22
313590,202310,92,59,33,77881.92,43561.3,121443.22
313600,202310,757,467,290,616448.39,382800.36,999248.75
313610,202310,70,55,15,72601.62,19800.35,92401.97
313620,202310,1702,838,864,1107519.17,1141804.12,2249323.29
313630,202310,1867,1417,450,1870488.74,594003.03,2464491.77
313640,202310,120,70,50,92401.61,66000.7,158402.31
313650,202310,259,137,122,180840.48,161042.38,341882.86
313652,202310,37,34,3,44880,3960,48840
313655,202310,110,73,37,96360.34,48840.31,145200.65
313657,202310,57,52,5,68641.87,6600,75241.87
313660,202310,163,110,53,145201.51,69960.14,215161.65
313665,202310,815,381,434,502938.01,572888.44,1075826.45
313670,202310,12854,8926,3928,11790771.86,5190282.02,16981053.88
313680,202310,52,39,13,51480.73,17160,68640.73
313690,202310,149,104,45,137281.02,59400,196681.02
313695,202310,92,72,20,95043.03,26400,121443.03
313700,202310,406,319,87,421086.42,114840.88,535927.30
313710,202310,131,93,38,122763.28,50160,172923.28
313720,202310,1328,632,696,835594.13,920049.93,1755644.06
313730,202310,83,49,34,64682.6,44880,109562.6
313740,202310,168,124,44,163680.66,58080,221760.66
313750,202310,441,309,132,407886.02,175560.79,583446.81
313753,202310,258,202,56,266645.58,75240.1,341885.68
313760,202310,1558,610,948,805220.1,1254012.16,2059232.26
313770,202310,478,321,157,423732.3,207244.61,630976.91
313780,202310,975,547,428,723372.89,564964.28,1288337.17
313790,202310,35,35,0,46200,,46200.0
313800,202310,178,112,66,147844.94,87121.72,234966.66
313810,202310,106,61,45,80520.81,59400.72,139921.53
313820,202310,1580,763,817,1008505.56,1079761.78,2088267.34
313830,202310,62,41,21,54121.34,27720,81841.34
313835,202310,70,61,9,80520.2,11880,92400.2
313840,202310,1940,1190,750,1572176.06,991324.77,2563500.83
313850,202310,247,115,132,151803.16,174240.5,326043.66
313860,202310,533,401,132,529331.1,174240.64,703571.74
313862,202310,190,132,58,174244.97,76560,250804.97
313865,202310,201,141,60,186121.96,79200,265321.96
313867,202310,68,57,11,75240,14520.1,89760.1
313868,202310,65,42,23,55440.36,30360,85800.36
313870,202310,87,50,37,66000.2,48840,114840.2
313880,202310,419,261,158,344524.18,209880.69,554404.87
313890,202310,359,202,157,266644.55,207240.63,473885.18
313900,202310,904,495,409,654734.93,541206.35,1195941.28
313910,202310,151,101,50,133320.07,66000,199320.07
313920,202310,732,496,236,654723.89,311523,966246.89
313925,202310,39,33,6,43560,7920,51480
313930,202310,992,753,239,994004.56,315485.47,1309490.03
313940,202310,2252,1370,882,1809758.78,1166887.91,2976646.69
313950,202310,980,605,375,798616.22,495001.43,1293617.65
313960,202310,1633,951,682,1256797.99,900245.87,2157043.86
313970,202310,211,116,95,153120.1,125400,278520.1
313980,202310,270,169,101,223087.89,133321.06,356408.95
313990,202310,321,188,133,248160.82,175560,423720.82
314000,202310,994,643,351,848774.25,463324.43,1312098.68
314010,202310,133,89,44,117480.15,58080,175560.15
314015,202310,124,44,80,58081.16,105600.9,163682.06
314020,202310,64,42,22,55441.58,29040,84481.58
314030,202310,79,43,36,56760.43,47520,104280.43
314040,202310,52,27,25,35640,33000,68640
314050,202310,319,175,144,231006.52,190080,421086.52
314053,202310,107,70,37,92401.6,48840,141241.6
314055,202310,328,216,112,285126.08,147841.54,432967.62
314060,202310,135,118,17,155760.3,22440,178200.3
314070,202310,1182,593,589,784105.58,777492.38,1561597.96
314080,202310,229,137,92,180842.99,122761.05,303604.04
314085,202310,211,150,61,198000.45,80520,278520.45
314090,202310,467,342,125,451446.27,165000.36,616446.63
314100,202310,577,448,129,591377.15,170282.39,761659.54
314110,202310,840,362,478,477857.49,630963.94,1108821.43
314120,202310,73,45,28,59400,36960,96360
314130,202310,28,20,8,26400,10560,36960
314140,202310,1319,842,477,1112780.99,630964.22,1743745.21
314150,202310,214,137,77,180842.34,101640,282482.34
314160,202310,328,251,77,331323.28,101640.56,432963.84
314170,202310,95,72,23,95041.17,30360,125401.17
314180,202310,833,739,94,975511.81,124081.57,1099593.38
314190,202310,92,58,34,76560.67,44880,121440.67
314200,202310,573,401,172,529336.11,227046.32,756382.43
314210,202310,252,194,58,256086.6,76560,332646.6
314220,202310,339,241,98,318125.94,129361.41,447487.35
314225,202310,43,27,16,35640.81,21120,56760.81
314230,202310,133,58,75,77880.55,99000,176880.55
314240,202310,193,140,53,184802.83,69960,254762.83
314250,202310,60,38,22,50162.41,29040,79202.41
314260,202310,226,119,107,157081.75,141240,298321.75
314270,202310,444,343,101,452776.86,133320.5,586097.36
314280,202310,793,432,361,570190.17,476522.62,1046712.79
314290,202310,603,470,133,620408.28,175560.72,795969.00
314300,202310,346,264,82,348487.05,108240,456727.05
314310,202310,1425,986,439,1304197.64,580800.21,1884997.85
314315,202310,59,45,14,59400.58,18480,77880.58
314320,202310,655,464,191,612492.27,252121.88,864614.15
314330,202310,13303,6531,6772,8622584.9,8945694.26,17568279.16
314340,202310,733,331,402,436930.69,530644.08,967574.77
314345,202310,66,48,18,63360,23760,87120
314350,202310,189,116,73,153121.81,96360.66,249482.47
314360,202310,61,37,24,48842.56,31681.26,80523.82
314370,202310,83,59,24,77880,31680,109560
314380,202310,149,84,65,110880.54,85800,196680.54
314390,202310,3952,2571,1381,3395157.72,1826884.31,5222042.03
314400,202310,776,550,226,726015.6,298321.71,1024337.31
314410,202310,609,410,199,541214,264001.89,805215.89
314420,202310,33,21,12,27720,15840,43560
314430,202310,2643,1027,1616,1357523.25,2133151.8,3490675.05
314435,202310,166,101,65,133321.89,85800,219121.89
314437,202310,59,47,12,62040,15840,77880
314440,202310,111,69,42,92400.5,55440.6,147841.1
314450,202310,185,126,59,166321.34,77881.75,244203.09
314460,202310,659,333,326,439567.58,432963.05,872530.63
314465,202310,139,93,46,122760.62,60720,183480.62
314467,202310,82,66,16,87120,21120,108240
314470,202310,460,234,226,308882.87,298322.4,607205.27
314480,202310,1218,560,658,739214.38,868564.79,1607779.17
314490,202310,42,22,20,29040,26400,55440
314500,202310,294,198,96,261365.24,126720.45,388085.69
314505,202310,124,78,46,102961.51,60720,163681.51
314510,202310,268,218,50,287764.1,66000,353764.1
314520,202310,1582,810,772,1070560.15,1020372.86,2090933.01
314530,202310,841,673,168,888395.5,221764.22,1110159.72
314535,202310,202,131,71,172920,93720,266640
314537,202310,74,45,29,59401.02,38280.98,97682.00
314540,202310,23,14,9,18480,11880,30360
314545,202310,77,51,26,67320,34320,101640
314550,202310,90,51,39,67321.08,51481.7,118802.78
314560,202310,939,499,440,658694.4,580806.12,1239500.52
314570,202310,18,15,3,19800.36,3960,23760.36
314580,202310,10,5,5,6600,6600,13200
314585,202310,34,27,7,35640,9240,44880
314587,202310,85,71,14,93720,18480,112200
314590,202310,680,452,228,597977.04,300961.64,898938.68
314600,202310,1108,723,385,954398.36,508210.39,1462608.75
314610,202310,1111,578,533,765611.28,703564.89,1469176.17
314620,202310,163,125,38,165000.6,51480,216480.6
314625,202310,101,80,21,105601.01,27720,133321.01
314630,202310,1227,710,517,937228.16,682445.75,1619673.91
314640,202310,101,62,39,81841.65,51480,133321.65
314650,202310,164,98,66,129362.76,87120,216482.76
314655,202310,68,49,19,64680,25080,89760
314660,202310,25,20,5,26400,6600,33000
314670,202310,240,184,56,242891.79,73922.39,316814.18
314675,202310,236,148,88,195361.85,116160.23,311522.08
314690,202310,608,324,284,427686.95,374882.08,802569.03
314700,202310,2381,1278,1103,1688337.96,1459926.37,3148264.33
314710,202310,2071,1139,932,1504832.29,1232881.6,2737713.89
314720,202310,464,258,206,340566.08,271921.31,612487.39
314730,202310,578,307,271,405249.17,357722.63,762971.80
314740,202310,890,398,492,525371.06,649444.58,1174815.64
314750,202310,33,25,8,33000,10560,43560
314760,202310,391,156,235,207242.91,310200.88,517443.79
314770,202310,101,67,34,88441.39,44880,133321.39
314780,202310,16,7,9,9240,11880,21120
314790,202310,2826,1827,999,2413040.77,1320001.58,3733042.35
314795,202310,84,72,12,95040.39,15840,110880.39
314800,202310,3246,1927,1319,2543711.45,1742403.71,4286115.16
314810,202310,1668,968,700,1277781.52,925321.02,2203102.54
314820,202310,131,82,49,108240.89,64680,172920.89
314830,202310,244,210,34,278524.8,44880,323404.8
314840,202310,94,58,36,76560,47520,124080
314850,202310,472,232,240,306376.02,316800.05,623176.07
314860,202310,679,519,160,685083.42,212520.08,897603.50
314870,202310,1867,1035,832,1366237.9,1098255.19,2464493.09
314875,202310,75,67,8,88440,10560,99000
314880,202310,50,38,12,50160,15840,66000
314890,202310,58,29,29,38280,38280,76560
314900,202310,27,20,7,26401.1,9240.92,35642.02
314910,202310,248,169,79,224402.29,104280,328682.29
314915,202310,157,130,27,171603.87,35640.68,207244.55
314920,202310,89,57,32,75240.85,42240,117480.85
314930,202310,1194,538,656,710184.29,867243.32,1577427.61
314940,202310,37,31,6,40920,7920,48840
314950,202310,25,19,6,25081.1,7920,33001.1
314960,202310,35,20,15,26400.81,19800.18,46200.99
314970,202310,206,92,114,121441.88,150481.55,271923.43
314980,202310,350,232,118,306244.49,155760.75,462005.24
314990,202310,489,260,229,343206.72,302282.27,645488.99
314995,202310,170,82,88,108241.28,116160,224401.28
315000,202310,119,90,29,118800.49,38280.1,157080.59
315010,202310,42,27,15,35640,19800,55440
315015,202310,176,144,32,190081.89,42240,232321.89
315020,202310,74,62,12,81840.08,15840,97680.08
315030,202310,125,92,33,121440,44880,166320
315040,202310,97,57,40,75240.89,52800,128040.89
315050,202310,221,140,81,184800.37,106920.68,291721.05
315053,202310,77,55,22,72600,29040,101640
315057,202310,141,111,30,146520.65,39600,186120.65
315060,202310,66,54,12,71281.88,15840,87121.88
315070,202310,135,83,52,109563.45,68640,178203.45
315080,202310,424,339,85,447486.7,112201.34,559688.04
315090,202310,112,65,47,85801.39,62040,147841.39
315100,202310,114,57,57,75241.1,75240.38,150481.48
315110,202310,305,159,146,209886.09,192720,402606.09
315120,202310,2081,966,1115,1277814.94,1473152.34,2750967.28
315130,202310,389,275,114,363006.57,150480.42,513486.99
315140,202310,594,319,275,421090.52,363005.11,784095.63
315150,202310,1082,533,549,703581.76,724685.3,1428267.06
315160,202310,210,115,95,151807.28,126724.6,278531.88
315170,202310,314,200,114,264003.06,151800.8,415803.86
315180,202310,3622,1564,2058,2065865.11,2716575.74,4782440.85
315190,202310,312,190,122,250804.54,162360.25,413164.79
315200,202310,1375,855,520,1129946.37,686402.6,1816348.97
315210,202310,2012,1246,766,1644761.91,1012443.48,2657205.39
315213,202310,28,17,11,22441.63,14520,36961.63
315217,202310,248,195,53,258720.58,69960.55,328681.13
315220,202310,1762,1288,474,1702842.34,625689.13,2328531.47
315230,202310,217,169,48,223082.11,63360,286442.11
315240,202310,418,287,131,378850.71,172922.2,551772.91
315250,202310,3029,1466,1563,1936513.11,2065803.59,4002316.70
315260,202310,146,85,61,112200,80520.1,192720.1
315270,202310,172,122,50,161041.25,66000,227041.25
315280,202310,691,454,237,599308.08,312851.37,912159.45
315290,202310,213,137,76,180842.01,100320.11,281162.12
315300,202310,113,87,26,114840.01,34320,149160.01
315310,202310,96,84,12,110880,15840,126720
315320,202310,144,96,48,126723.98,63360,190083.98
315330,202310,65,54,11,71280,14520,85800
315340,202310,406,299,107,394685.26,141240.96,535926.22
315350,202310,185,118,67,155761.48,88440.34,244201.82
315360,202310,125,61,64,80520.15,84480.23,165000.38
315370,202310,61,40,21,52801.28,27720,80521.28
315380,202310,7,5,2,6600,2640,9240
315390,202310,76,28,48,36960,63361.49,100321.49
315400,202310,963,734,229,968898.85,302281.57,1271180.42
315410,202310,344,203,141,267974.74,186123.52,454098.26
315415,202310,64,48,16,63360.27,21120,84480.27
315420,202310,216,155,61,205922.2,80520,286442.2
315430,202310,672,371,301,489724.02,399960.38,889684.40
315440,202310,104,70,34,92400.2,44880,137280.2
315445,202310,255,212,43,279850.47,56760,336610.47
315450,202310,189,137,52,180840,68640,249480
315460,202310,5634,2659,2975,3510026.95,3927047.84,7437074.79
315470,202310,57,23,34,30360.9,44880,75240.9
315480,202310,97,32,65,42242.79,85802.78,128045.57
315490,202310,772,512,260,675850.73,343200.48,1019051.21
315500,202310,24,20,4,26400,5280,31680
315510,202310,174,125,49,165000.54,64680,229680.54
315520,202310,82,67,15,88440.36,19800,108240.36
315530,202310,50,29,21,38280,27720.2,66000.2
315540,202310,292,201,91,265324.73,120120.39,385445.12
315550,202310,204,162,42,215160.52,55440,270600.52
315560,202310,776,614,162,810496.99,213844.35,1024341.34
315570,202310,334,170,164,224405.77,216480.81,440886.58
315580,202310,820,562,258,741849.11,340560.96,1082410.07
315590,202310,212,104,108,137282.65,142560.63,279843.28
315600,202310,399,309,90,409205.11,118800.78,528005.89
315610,202310,109,53,56,69960,73920,143880
315620,202310,48,36,12,47522.37,15840.89,63363.26
315630,202310,146,113,33,149161.03,43560,192721.03
315640,202310,61,40,21,54120.98,27720,81840.98
315645,202310,59,40,19,54120,25080,79200
315650,202310,172,130,42,171601.73,55440,227041.73
315660,202310,465,224,241,295689.42,318125.89,613815.31
315670,202310,2739,1235,1504,1630262.38,1986624.98,3616887.36
315680,202310,802,591,211,780127.42,278520,1058647.42
315690,202310,753,507,246,671896.9,324722.98,996619.88
315700,202310,2223,1161,1062,1535205.77,1404508.94,2939714.71
315710,202310,397,142,255,187441.75,336600.99,524042.74
315720,202310,570,351,219,463326.93,289080.22,752407.15
315725,202310,224,176,48,232320.27,63360,295680.27
315727,202310,129,89,40,117484.24,52800,170284.24
315730,202310,62,56,6,73920,7920,81840
315733,202310,95,55,40,72600.2,52800,125400.2
315737,202310,52,41,11,54121.4,14520,68641.4
315740,202310,38,30,8,39600.35,10560,50160.35
315750,202310,182,129,53,170280.17,69960,240240.17
315760,202310,54,41,13,54120,17160,71280
315765,202310,159,93,66,122762.51,87122.2,209884.71
315770,202310,267,183,84,241562.61,110880.64,352443.25
315780,202310,4644,2303,2341,3042691.41,3090129.6,6132821.01
315790,202310,277,214,63,282485,83160.87,365645.87
315800,202310,360,235,125,310203.35,165000,475203.35
315810,202310,68,39,29,51480.54,38280,89760.54
315820,202310,836,636,200,839548.23,264003.43,1103551.66
315830,202310,132,92,40,121442.35,52800.39,174242.74
315840,202310,90,63,27,83160,35640.66,118800.66
315850,202310,283,186,97,245526.62,128040.8,373567.42
315860,202310,24,10,14,13200,18480,31680
315870,202310,42,33,9,43560.16,11880,55440.16
315880,202310,105,70,35,92400,46200,138600
315890,202310,113,81,32,106922.06,42240,149162.06
315895,202310,429,287,142,378856.64,187442.34,566298.98
315900,202310,95,45,50,59400,66000,125400
315910,202310,55,32,23,42240,30360,72600
315920,202310,168,112,56,147842.36,73920,221762.36
315930,202310,60,24,36,31682.34,47520.91,79203.25
315935,202310,144,113,31,149163.5,40920,190083.5
315940,202310,103,76,27,100320,35640,135960
315950,202310,45,35,10,46200,13200.35,59400.35
315960,202310,646,311,335,410529.27,442205.96,852735.23
315970,202310,41,34,7,44880.74,9240,54120.74
315980,202310,726,389,337,513494.59,444841.43,958336.02
315990,202310,278,159,119,209882.39,157080.27,366962.66
316000,202310,52,32,20,42240,26400,68640
316010,202310,110,94,16,124082.28,21120.9,145203.18
316020,202310,100,91,9,120120.49,11880,132000.49
316030,202310,389,232,157,306247.08,207242.19,513489.27
316040,202310,595,245,350,323403.52,463320.2,786723.72
316045,202310,60,54,6,71280,7920,79200
316050,202310,30,19,11,25080,14520,39600
316060,202310,113,81,32,106921.17,42240,149161.17
316070,202310,1395,946,449,1248758.34,592684.87,1841443.21
316080,202310,100,67,33,88556.76,44880,133436.76
316090,202310,43,21,22,27720,29040.1,56760.1
316095,202310,90,77,13,101641.42,17160.86,118802.28
316100,202310,392,217,175,286445.23,232320.32,518765.55
316105,202310,67,43,24,56760.51,31680,88440.51
316110,202310,2009,1531,478,2020964.14,632288.87,2653253.01
316120,202310,79,53,26,69960.95,34320,104280.95
316130,202310,127,91,36,120122.07,47520.21,167642.28
316140,202310,33,23,10,30360,13200,43560
316150,202310,263,188,75,248162.26,99000.33,347162.59
316160,202310,93,64,29,84481.27,38280.28,122761.55
316165,202310,82,51,31,67320.78,40920,108240.78
316170,202310,197,126,71,166320.05,93720,260040.05
316180,202310,243,96,147,128043.72,194041.65,322085.37
316190,202310,153,111,42,146521.39,55440,201961.39
316200,202310,757,423,334,558375.38,440883.37,999258.75
316210,202310,806,559,247,738124.33,326042.24,1064166.57
316220,202310,142,92,50,121441.79,66000,187441.79
316225,202310,46,29,17,38281.03,22440,60721.03
316230,202310,54,30,24,39600.91,31680,71280.91
316240,202310,733,581,152,766936.58,200644.37,967580.95
316245,202310,180,161,19,212523.95,25080,237603.95
316250,202310,1848,1211,637,1599894.67,840843.02,2440737.69
316255,202310,146,113,33,149160,43560.92,192720.92
316257,202310,189,94,95,124081.37,125401.46,249482.83
316260,202310,225,149,76,196682.18,100320,297002.18
316265,202310,42,32,10,42241.97,13200.67,55442.64
316270,202310,738,518,220,683770.35,290401.58,974171.93
316280,202310,644,417,227,550451.03,299641.2,850092.23
316290,202310,995,702,293,927989.52,388083.97,1316073.49
316292,202310,720,308,412,407889.51,543843.57,951733.08
316294,202310,114,72,42,95041.51,55440,150481.51
316295,202310,456,217,239,286447.72,315486.85,601934.57
316300,202310,51,33,18,43560,23760,67320
316310,202310,24,13,11,17160,14520,31680
316320,202310,77,33,44,43560.75,58080,101640.75
316330,202310,191,137,54,180840.99,71280,252120.99
316340,202310,156,104,52,137280,68640,205920
316350,202310,214,147,67,194040.39,88440,282480.39
316360,202310,34,20,14,26400,18480,44880
316370,202310,1491,736,755,971543.36,996606.4,1968149.76
316380,202310,133,105,28,138600.77,36960,175560.77
316390,202310,105,78,27,102960,35640,138600
316400,202310,199,151,48,199324.11,63360.36,262684.47
316410,202310,338,245,93,323401.38,122760.2,446161.58
316420,202310,242,160,82,211206.62,108241.35,319447.97
316430,202310,176,100,76,132000.46,100320,232320.46
316440,202310,86,48,38,63361,50160.08,113521.08
316443,202310,47,39,8,51480,10560,62040
316447,202310,57,47,10,62042.66,13200,75242.66
316450,202310,272,204,68,269280.2,89760,359040.2
316460,202310,55,20,35,26400.43,46200.34,72600.77
316470,202310,1986,1464,522,1932537.79,689040.63,2621578.42
316480,202310,10,7,3,9240,3960,13200
316490,202310,23,7,16,9240,21120,30360
316500,202310,188,122,66,161040.27,87120.4,248160.67
316510,202310,145,117,28,154441.15,36960,191401.15
316520,202310,194,104,90,137280.75,118800.61,256081.36
316530,202310,198,127,71,167641.41,93720,261361.41
316540,202310,179,95,84,125401.69,110880.65,236282.34
316550,202310,199,130,69,171602.3,91080,262682.3
316553,202310,567,290,277,382810.25,365641.39,748451.64
316555,202310,90,79,11,104280.8,14520,118800.8
316556,202310,19,13,6,17160.41,7920,25080.41
316557,202310,53,36,17,47521.01,22440,69961.01
316560,202310,75,53,22,69960.2,29040,99000.2
316570,202310,250,229,21,303601.47,27720,331321.47
316580,202310,29,18,11,23760,14520,38280
316590,202310,89,76,13,100320.82,17160.72,117481.54
316600,202310,183,152,31,200641.32,40920,241561.32
316610,202310,71,53,18,69960,25080,95040
316620,202310,170,121,49,159720.2,64680.85,224401.05
316630,202310,72,54,18,71280,26400,97680
316640,202310,24,14,10,18480,13200,31680
316650,202310,126,100,26,132000,34320,166320
316660,202310,6,2,4,2640,5280,7920
316670,202310,458,155,303,205792.4,399963.8,605756.2
316680,202310,193,149,44,196683.79,58080,254763.79
316690,202310,154,95,59,125400,77880,203280
316695,202310,64,52,12,68640,15840,84480
316700,202310,36,25,11,33000,14520,47520
316710,202310,892,677,215,893656.06,285123.4,1178779.46
316720,202310,5891,2741,3150,3619557.19,4158011.43,7777568.62
316730,202310,16,15,1,19800,1320,21120
316740,202310,182,113,69,149160.1,91080,240240.1
316750,202310,21,11,10,14520.7,13200,27720.7
316760,202310,379,297,82,392047.66,108240.79,500288.45
316770,202310,193,109,84,143882.55,110880,254762.55
316780,202310,74,43,31,56760,40920,97680
316790,202310,82,57,25,75240.2,33000.5,108240.7
316800,202310,1936,1171,765,1547077.32,1009819.51,2556896.83
316805,202310,38,26,12,34320.08,17160,51480.08
316810,202310,64,37,27,48841.3,35640.35,84481.65
316820,202310,43,26,17,34320,22440,56760
316830,202310,112,54,58,71280.36,76560.2,147840.56
316840,202310,544,336,208,443525.24,275882.12,719407.36
316850,202310,333,234,99,308884.99,130680,439564.99
316860,202310,7093,3287,3806,4341455.3,5025260.44,9366715.74
316870,202310,2011,1311,700,1730598.8,924007.79,2654606.59
316880,202310,173,88,85,116162.89,112201.44,228364.33
316890,202310,240,157,83,207241.29,109560.69,316801.98
316900,202310,477,336,141,443525.73,186120,629645.73
316905,202310,30,15,15,19800,19800,39600
316910,202310,94,38,56,51480,73920,125400
316920,202310,173,134,39,176887.5,51480,228367.5
316930,202310,2275,1169,1106,1544430.97,1461241.39,3005672.36
316935,202310,1084,639,445,844814.52,587408.45,1432222.97
316940,202310,1234,716,518,946463.41,687721.24,1634184.65
316950,202310,235,123,112,162360.37,147840,310200.37
316960,202310,1190,667,523,881788.08,691691.49,1573479.57
316970,202310,721,579,142,764301.92,187443.23,951745.15
316980,202310,92,50,42,66000.82,55440,121440.82
316990,202310,2596,1785,811,2356260.1,1071844.21,3428104.31
317000,202310,372,289,83,381491.93,109562.74,491054.67
317005,202310,244,172,72,227045.43,95040.9,322086.33
317010,202310,7816,4517,3299,5966254.75,4357375.15,10323629.90
317020,202310,17446,7749,9697,10238353.65,12809385.98,23047739.63
317030,202310,105,49,56,64680,73920,138600
317040,202310,3398,2261,1137,2985923.1,1504808.03,4490731.13
317043,202310,82,63,19,83166.29,25081.27,108247.56
317047,202310,45,29,16,38280,21120,59400
317050,202310,173,139,34,183484.61,44880,228364.61
317052,202310,171,142,29,187441.82,38280,225721.82
317057,202310,213,163,50,215163.42,66000,281163.42
317060,202310,66,39,27,51480,35640.8,87120.8
317065,202310,57,45,12,59400,15840,75240
317070,202310,2211,1031,1180,1360972.83,1562881.86,2923854.69
317075,202310,107,61,46,80520.15,60720,141240.15
317080,202310,1051,541,510,714151.01,674522.25,1388673.26
317090,202310,794,609,185,805216.71,245523.63,1050740.34
317100,202310,504,375,129,496327.29,170280.95,666608.24
317103,202310,151,121,30,159722.85,39600,199322.85
317107,202310,66,50,16,66000,21120,87120
317110,202310,83,47,36,62040.2,47521.36,109561.56
317115,202310,60,54,6,71342.04,7920,79262.04
317120,202310,2468,1246,1222,1646109.66,1614372.32,3260481.98
317130,202310,2373,1637,736,2162188.48,971523.41,3133711.89
317140,202310,20,15,5,19801.2,6600,26401.2
317150,202310,317,189,128,249483.76,168960.6,418444.36
317160,202310,390,286,104,377523.86,137280.98,514804.84
317170,202310,264,171,93,225721.56,122760.6,348482.16
317180,202310,454,314,140,414483.81,184802.1,599285.91
317190,202310,267,194,73,257401.44,96360,353761.44
317200,202310,1001,715,286,943844.48,377527.54,1321372.02
317210,202310,195,102,93,134645.11,122760.21,257405.32
317220,202310,25,14,11,18480,14520,33000
320010,202310,617,442,175,583459.64,232327.17,815786.81
320013,202310,158,103,55,135963.85,72602.33,208566.18
320016,202310,290,178,112,234964.96,147840,382804.96
320020,202310,844,507,337,669263.1,444849.89,1114112.99
320030,202310,201,140,61,184803.24,80521.62,265324.86
320035,202310,155,104,51,137280.2,68640.19,205920.39
320040,202310,521,263,258,347171.36,340568.56,687739.92
320050,202310,154,102,52,134648.67,68640.7,203289.37
320060,202310,2184,1037,1147,1371537.65,1514063.53,2885601.18
320070,202310,125,80,45,105600.25,59400,165000.25
320080,202310,927,522,405,689064.08,535927.93,1224992.01
320090,202310,1510,971,539,1283073.56,714132.9,1997206.46
320100,202310,418,235,183,310208.5,241562.72,551771.22
320110,202310,156,103,53,135968.05,69960.6,205928.65
320115,202310,129,110,19,145204.2,25080,170284.2
320120,202310,4448,2384,2064,3149636.64,2727165.75,5876802.39
320130,202310,9556,4115,5441,5437295.16,7183563.43,12620858.59
320140,202310,611,401,210,529344.53,277208.22,806552.75
320150,202310,2516,1405,1111,1854681.33,1467855.71,3322537.04
320160,202310,750,320,430,422410.81,568923.49,991334.30
320170,202310,124,99,25,130682.47,33000,163682.47
320180,202310,62,36,26,47521.35,34320,81841.35
320190,202310,297,174,123,229686.36,162360.1,392046.46
320200,202310,70,57,13,75243.37,17160,92403.37
320210,202310,1029,564,465,744504.64,616448.96,1360953.60
320220,202310,319,115,204,151802.22,270600.2,422402.42
320225,202310,99,80,19,105601.31,25080.2,130681.51
320230,202310,849,545,304,719436.33,401288.65,1120724.98
320240,202310,4093,1828,2265,2415689.97,2992475.62,5408165.59
320245,202310,606,413,193,546493.96,254768.89,801262.85
320250,202310,264,126,138,166326.13,182162.49,348488.62
320255,202310,141,107,34,141242.96,44880.43,186123.39
320260,202310,349,179,170,236283.02,224402.09,460685.11
320265,202310,159,123,36,163683.28,47520.06,211203.34
320270,202310,169,127,42,167642.07,55441.35,223083.42
320280,202310,1642,956,686,1264609.12,905538.91,2170148.03
320290,202310,79,61,18,80520.9,23760,104280.9
320300,202310,717,497,220,656063.61,290403.09,946466.70
320305,202310,875,502,373,662665.73,492371.21,1155036.94
320310,202310,239,148,91,195365.11,120120.9,315486.01
320313,202310,434,188,246,248170.19,324722.24,572892.43
320316,202310,119,89,30,117481.91,39600.3,157082.21
320320,202310,3977,1842,2135,2435479.54,2820871.94,5256351.48
320330,202310,339,246,93,324721.78,122760,447481.78
320332,202310,930,568,362,751126.3,477853.79,1228980.09
320334,202310,323,175,148,231002.01,195361.3,426363.31
320335,202310,175,114,61,150487.74,80522.21,231009.95
320340,202310,685,491,194,648151.4,256087.85,904239.25
320350,202310,1256,529,727,698312.58,959654.9,1657967.48
320360,202310,194,89,105,117481.99,138600,256081.99
320370,202310,266,198,68,261367.13,89760.69,351127.82
320380,202310,392,281,111,370929.84,146520.89,517450.73
320390,202310,1307,767,540,1012475.65,715449.41,1727925.06
320400,202310,370,256,114,339257.11,150481.19,489738.30
320405,202310,1110,448,662,592707.73,875175.95,1467883.68
320410,202310,1054,514,540,678497.91,712806.83,1391304.74
320420,202310,706,325,381,429018.12,504254.44,933272.56
320425,202310,238,126,112,166323.53,147840.2,314163.73
320430,202310,466,255,211,336614.4,278529.61,615144.01
320435,202310,229,155,74,204602.48,97681.61,302284.09
320440,202310,245,142,103,187445,137284.71,324729.71
320450,202310,152,81,71,106922.33,93721.06,200643.39
320455,202310,268,209,59,275884.97,77880.66,353765.63
320460,202310,382,233,149,307564.08,198000.21,505564.29
320465,202310,140,96,44,126727.46,58080.33,184807.79
320470,202310,867,519,348,686429.09,462013.73,1148442.82
320480,202310,275,181,94,238928.85,124080.02,363008.87
320490,202310,3816,1857,1959,2451337.22,2587255.89,5038593.11
320495,202310,143,86,57,113521.65,75240,188761.65
320500,202310,12519,6212,6307,8205482.6,8337253.31,16542735.91
320501,202310,645,336,309,443539.37,407892.06,851431.43
320503,202310,380,271,109,357727.11,143881.08,501608.19
320506,202310,326,221,105,293043.59,139920.38,432963.97
320510,202310,1481,657,824,867266.42,1090340.24,1957606.66
320515,202310,97,75,22,99003.08,29040,128043.08
320517,202310,271,197,74,260048.3,97680.52,357728.82
320520,202310,9711,4135,5576,5461039.3,7367039.24,12828078.54
320530,202310,8742,4184,4558,5534920.51,6024553.67,11559474.18
330010,202310,4296,2073,2223,2736465.33,2934396.4,5670861.73
330015,202310,250,112,138,147841.44,182160.84,330002.28
330020,202310,4991,1884,3107,2488278.97,4106561.75,6594840.72
330022,202310,308,153,155,201966.54,204600.35,406566.89
330023,202310,1057,292,765,385446.77,1011131.2,1396577.97
330025,202310,1193,215,978,283805.35,1297450.2,1581255.55
330030,202310,2235,1351,884,1786037.48,1166894.06,2952931.54
330040,202310,3219,1644,1575,2171484,2082989.59,4254473.59
330045,202310,12632,4192,8440,5537602.73,11150197.91,16687800.64
330050,202310,1067,640,427,844824.02,563647.8,1408471.82
330060,202310,1569,906,663,1195973.46,875170.13,2071143.59
330070,202310,5509,1873,3636,2473761.16,4806169.62,7279930.78
330080,202310,1928,837,1091,1104882.88,1441457.93,2546340.81
330090,202310,447,252,195,332650.32,258720.83,591371.15
330093,202310,262,112,150,147841.79,199320.99,347162.78
330095,202310,85,47,38,62040.9,50160,112200.9
330100,202310,13539,6791,6748,8965822.11,8912784.52,17878606.63
330110,202310,560,257,303,339248.21,399967.23,739215.44
330115,202310,581,290,291,384129.12,384122.15,768251.27
330120,202310,487,249,238,328686.87,314162.27,642849.14
330130,202310,1856,535,1321,706231.34,1743756.99,2449988.33
330140,202310,853,438,415,578171.89,547802.53,1125974.42
330150,202310,616,381,235,502934.17,310204.37,813138.54
330160,202310,174,112,62,147848.43,81841.85,229690.28
330170,202310,32272,11718,20554,15476308.48,27150173.01,42626481.49
330180,202310,305,165,140,217803.33,186121.94,403925.27
330185,202310,1490,615,875,811829.38,1157659.54,1969488.92
330187,202310,828,230,598,303609.69,794646.26,1098255.95
330190,202310,7629,2974,4655,3928447.43,6153909.65,10082357.08
330200,202310,5502,1954,3548,2582015.19,4686084.18,7268099.37
330205,202310,574,316,258,417133.1,340564.06,757697.16
330210,202310,1036,615,421,811828.96,555724.79,1367553.75
330220,202310,3296,1935,1361,2556953.99,1796547.06,4353501.05
330225,202310,745,358,387,472569.74,512162.34,984732.08
330227,202310,2629,963,1666,1272533.99,2203139.45,3475673.44
330230,202310,262,140,122,184803.64,161041.89,345845.53
330240,202310,5443,2563,2880,3387244.79,3805615.7,7192860.49
330245,202310,201,95,106,125403.32,139921.63,265324.95
330250,202310,7978,3817,4161,5039974.26,5497882.19,10537856.45
330260,202310,1005,306,699,403926.91,922685.88,1326612.79
330270,202310,4991,1620,3371,2138475.13,4455069.64,6593544.77
330280,202310,534,317,217,418457.39,286446.19,704903.58
330285,202310,7428,2443,4985,3227559.4,6584292.09,9811851.49
330290,202310,925,321,604,423735.83,798607.03,1222342.86
330300,202310,875,534,341,705720.97,450129.25,1155850.22
330310,202310,556,326,230,430333.41,303601.53,733934.94
330320,202310,9223,3056,6167,4038074.18,8149787.18,12187861.36
330330,202310,12393,4169,8224,5509861.93,10871646.36,16381508.29
330340,202310,3349,1824,1525,2407741.21,2018304.08,4426045.29
330350,202310,24733,8975,15758,11854120.78,20827314.48,32681435.26
330360,202310,2070,975,1095,1287065.38,1448068.07,2735133.45
330370,202310,1125,598,527,789393.63,696970.24,1486363.87
330380,202310,1271,530,741,699624.1,980772.47,1680396.57
330385,202310,796,386,410,509530.81,541204.96,1050735.77
330390,202310,7644,4026,3618,5318562.83,4779843.9,10098406.73
330395,202310,504,330,174,435613.82,229685.9,665299.72
330400,202310,803,414,389,546501.93,513483.73,1059985.66
330410,202310,605,436,169,575538.74,223085.55,798624.29
330411,202310,446,242,204,319443.25,269280,588723.25
330412,202310,268,133,135,176885.8,178200.23,355086.03
330414,202310,6749,2576,4173,3403105.86,5512380.24,8915486.10
330415,202310,737,318,419,419771.44,553085.06,972856.50
330420,202310,3063,1510,1553,1993255.31,2052616.05,4045871.36
330430,202310,2071,888,1183,1174826.91,1561575.56,2736402.47
330440,202310,486,242,244,319446.97,322082.28,641529.25
330450,202310,145,68,77,89760.66,101640,191400.66
330452,202310,3078,1225,1853,1618376.57,2445984.16,4064360.73
330455,202310,156485,56845,99640,75088672.69,131656415.09,206745087.78
330460,202310,298,142,156,187441.75,205920.4,393362.15
330470,202310,1465,793,672,1048109.64,891012.57,1939122.21
330475,202310,2220,703,1517,927974.68,2002454.9,2930429.58
330480,202310,920,510,410,673223.31,541205.96,1214429.27
330490,202310,20546,6463,14083,8552679.74,18701958.98,27254638.72
330500,202310,1940,852,1088,1124667.57,1437490.91,2562158.48
330510,202310,13372,4835,8537,6386430,11276911.91,17663341.91
330513,202310,113,58,55,76560.45,72600,149160.45
330515,202310,747,337,410,444851.65,541213.42,986065.07
330520,202310,3024,1041,1983,1374177.73,2622877.79,3997055.52
330530,202310,212,121,91,159724.04,120120.1,279844.14
330540,202310,423,215,208,283806.23,274563.13,558369.36
330550,202310,3298,1109,2189,1463911.65,2894787.89,4358699.54
330555,202310,1423,529,894,698293.96,1180082.76,1878376.72
330560,202310,912,331,581,436934.55,768247.23,1205181.78
330570,202310,402,277,125,365645.15,165000.09,530645.24
330575,202310,1078,400,678,529335.63,896295.64,1425631.27
330580,202310,4118,2173,1945,2869764.58,2571390.66,5441155.24
330590,202310,275,146,129,192724.21,170281.74,363005.95
330600,202310,1781,1054,727,1391331.99,959650.23,2350982.22
330610,202310,1881,960,921,1267237.45,1215726.64,2482964.09
330615,202310,269,210,59,277205.65,77882.26,355087.91
330620,202310,1118,495,623,653426.18,822373.47,1475799.65
330630,202310,5785,3298,2487,4354842.99,3284205.14,7639048.13
350010,202310,643,417,226,550464.94,300963.11,851428.05
350020,202310,63,23,40,30362.06,52800,83162.06
350030,202310,650,373,277,492390.66,365646.89,858037.55
350040,202310,122,52,70,68642.42,92401.26,161043.68
350050,202310,422,191,231,252125.09,304923.73,557048.82
350055,202310,156,66,90,87123.24,118800.21,205923.45
350060,202310,88,39,49,51482.19,66001.01,117483.20
350070,202310,897,494,403,652119.01,531974.13,1184093.14
350075,202310,92,53,39,69962.47,51480,121442.47
350080,202310,73,36,37,47520.82,48840.2,96361.02
350090,202310,88,46,42,60722.34,55440,116162.34
350100,202310,312,202,110,266644.35,145200,411844.35
350110,202310,47,32,15,42242.2,19800,62042.2
350115,202310,207,105,102,138603.28,134640.37,273243.65
350120,202310,124,81,43,106923.24,56760.97,163684.21
350130,202310,473,206,267,271936.59,352449.53,624386.12
350140,202310,45,28,17,36960.64,22440,59400.64
350150,202310,85,59,26,77882.41,34320.15,112202.56
350160,202310,2730,1090,1640,1438850.42,2167450.58,3606301.00
350170,202310,485,282,203,372253.74,267963.85,640217.59
350180,202310,175,94,81,125402.59,106920.2,232322.79
350190,202310,1115,607,508,801285.83,670562.49,1471848.32
350200,202310,64,26,38,34321.36,50160,84481.36
350210,202310,1470,779,691,1028324.15,912142.08,1940466.23
350220,202310,679,535,144,706219.78,190082.47,896302.25
350230,202310,78,50,28,66000.67,36960.9,102961.57
350240,202310,61,39,22,51480.65,29041.25,80521.90
350250,202310,1211,522,689,690389.88,909492.99,1599882.87
350260,202310,119,82,37,109564.3,48840.87,158405.17
350270,202310,1087,708,379,934568.4,501602.28,1436170.68
350275,202310,388,147,241,194041.65,318123.88,512165.53
350280,202310,4931,2329,2602,3078383.29,3435980.81,6514364.10
350290,202310,563,240,323,318126.23,426363.11,744489.34
350300,202310,54,32,22,42243.32,29040.9,71284.22
350310,202310,88,52,36,68641.43,47520.59,116162.02
350315,202310,20,15,5,19800,6600,26400
350320,202310,3807,1799,2008,2374802.75,2657188.12,5031990.87
350330,202310,1846,895,951,1182765.26,1257964.83,2440730.09
350335,202310,29,19,10,25080.12,13200,38280.12
350340,202310,139,56,83,73921.53,109563.67,183485.20
350350,202310,100,47,53,62040,69960,132000
350360,202310,121,81,40,106924.49,52800.54,159725.03
350370,202310,94,53,41,69962.02,54120.48,124082.50
350380,202310,1023,463,560,611179.49,739206.19,1350385.68
350390,202310,2087,791,1296,1044145.36,1713378.89,2757524.25
350395,202310,21,15,6,19800,7920,27720
350400,202310,2012,957,1055,1263284.78,1395241.04,2658525.82
350410,202310,3613,1419,2194,1873144.57,2898747.02,4771891.59
350420,202310,323,188,135,248164.92,178201.28,426366.20
350430,202310,113,59,54,77884.21,71282.22,149166.43
350440,202310,152,107,45,141250.04,59400.35,200650.39
350450,202310,1947,1054,893,1391337.46,1181401.87,2572739.33
350460,202310,487,172,315,227050.01,415808.67,642858.68
350470,202310,21,11,10,14520,13200,27720
350480,202310,227,117,110,154447.85,145201.26,299649.11
350490,202310,265,125,140,165002.61,184800.76,349803.37
350500,202310,67,21,46,27720,60720,88440
350510,202310,157,89,68,117483.32,89760.37,207243.69
350520,202310,512,280,232,369625.2,308889.67,678514.87
350530,202310,571,274,297,363013.32,392054.26,755067.58
350535,202310,111,71,40,93720.9,52800.56,146521.46
350540,202310,357,189,168,249486.6,221766.7,471253.3
350550,202310,3167,1759,1408,2323313.51,1858567.02,4181880.53
350560,202310,655,443,212,584780.37,279843.93,864624.30
350570,202310,5246,2175,3071,2872417.42,4056388.75,6928806.17
350580,202310,415,201,214,265329.59,282484.63,547814.22
350590,202310,1143,598,545,790705.53,719544.43,1510249.96
350600,202310,7377,3338,4039,4409025.74,5342083.47,9751109.21
350610,202310,1725,915,810,1207849.37,1073167.3,2281016.67
350620,202310,24,14,10,18480,13200,31680
350630,202310,284,143,141,188762.32,186122.28,374884.60
350635,202310,1595,701,894,926672.04,1181418.19,2108090.23
350640,202310,140,94,46,124081.31,60720.7,184802.01
350650,202310,2170,1420,750,1875812.14,991326.28,2867138.42
350660,202310,887,346,541,456727.88,718088.43,1174816.31
350670,202310,325,165,160,217803.21,212520.1,430323.31
350680,202310,172,91,81,120125.05,106920.92,227045.97
350690,202310,234,105,129,138601.82,170280,308881.82
350700,202310,1150,568,582,749787.12,768247.39,1518034.51
350710,202310,485,171,314,225728.06,414484.22,640212.28
350715,202310,62,47,15,62041.35,19800,81841.35
350720,202310,18,13,5,17162.19,6600,23762.19
350730,202310,52,33,19,43562.55,25080.61,68643.16
350740,202310,272,151,121,199324.93,159722.4,359047.33
350745,202310,36,17,19,22440.6,25081.65,47522.25
350750,202310,2992,1750,1242,2311400.92,1639453.05,3950853.97
350760,202310,4563,1897,2666,2505437.18,3521785.96,6027223.14
350770,202310,66,40,26,52800.5,34320,87120.5
350775,202310,83,60,23,79207.78,30361.33,109569.11
350780,202310,533,262,271,345854.71,357723.65,703578.36
350790,202310,401,168,233,221764.93,307564.11,529329.04
350800,202310,607,357,250,471247.73,331321.59,802569.32
350810,202310,564,421,143,557068.47,188760.39,745828.86
350820,202310,100,54,46,71281.35,60720,132001.35
350830,202310,89,45,44,59401.02,58080,117481.02
350840,202310,934,369,565,487094.04,747246.8,1234340.84
350850,202310,2138,1095,1043,1445449.07,1379410.94,2824860.01
350860,202310,807,410,397,541223.37,524052.78,1065276.15
350870,202310,508,349,159,460689.07,209880.56,670569.63
350880,202310,319,165,154,217806.73,203283.44,421090.17
350890,202310,44,25,19,33000,25080.08,58080.08
350900,202310,1857,632,1225,834263.97,1618347.03,2452611.00
350910,202310,28,15,13,19800,17160.36,36960.36
350920,202310,943,474,469,625690.58,620400.3,1246090.88
350925,202310,1315,645,670,852765.48,887058.6,1739824.08
350930,202310,148,80,68,105603.64,89760.28,195363.92
350940,202310,837,428,409,564987.37,539896.13,1104883.50
350945,202310,134,90,44,118803.49,58080.17,176883.66
350950,202310,21230,9997,11233,13201706.79,14846145.24,28047852.03
350960,202310,2051,831,1220,1099580.34,1617019.31,2716599.65
350970,202310,1229,582,647,768130.4,856694.69,1624825.09
350980,202310,110,72,38,95043.52,50160,145203.52
350990,202310,457,169,288,224401.8,380161.44,604563.24
350995,202310,50,21,29,27720.2,38280.84,66001.04
351000,202310,662,414,248,546502.72,327368.69,873871.41
351010,202310,55,36,19,47522.97,25080,72602.97
351015,202310,52,29,23,38280.17,30360,68640.17
351020,202310,1638,988,650,1305521.65,860648.86,2166170.51
351030,202310,375,207,168,275884.79,223080.33,498965.12
351040,202310,1212,693,519,916109.51,685083.19,1601192.70
351050,202310,4337,1949,2388,2575444.85,3152192.97,5727637.82
351060,202310,7286,2668,4618,3524535.08,6102388.06,9626923.14
351070,202310,451,283,168,373574.23,223086.91,596661.14
351080,202310,923,693,230,916111.42,303602.91,1219714.33
351090,202310,53,27,26,35640.75,34320.41,69961.16
351100,202310,464,242,222,319465.07,293051.83,612516.90
351110,202310,2377,1093,1284,1446781.95,1694883.85,3141665.80
351120,202310,66,32,34,42241.46,44880,87121.46
351130,202310,197,64,133,84483.2,175563.85,260047.05
351140,202310,352,210,142,277209.4,187443.12,464652.52
351150,202310,571,286,285,377528.08,376202.4,753730.48
351160,202310,395,211,184,278526.19,242880.85,521407.04
351170,202310,277,162,115,213843.15,151800.05,365643.20
351190,202310,113,70,43,92401.5,56760,149161.5
351200,202310,371,238,133,314170.51,175561.73,489732.24
351210,202310,147,72,75,95043.85,99000.78,194044.63
351220,202310,669,372,297,491057.8,392041.2,883099.0
351230,202310,364,222,142,293046.43,187440.6,480487.03
351240,202310,272,140,132,186123.29,174242.73,360366.02
351250,202310,101,72,29,95051.65,38280.1,133331.75
351260,202310,163,113,50,149162.21,66000.5,215162.71
351270,202310,57,25,32,33001.51,42240,75241.51
351280,202310,1188,590,598,780143.36,789369.03,1569512.39
351290,202310,277,133,144,175562.55,190080.7,365643.25
351300,202310,4842,2004,2838,2646680.35,3748848.86,6395529.21
351310,202310,803,392,411,517468.25,542532.48,1060000.73
351320,202310,132,75,57,99001.89,75240.6,174242.49
351330,202310,44,28,16,36960,21120,58080
351340,202310,1725,926,799,1224997.45,1056005.88,2281003.33
351350,202310,2819,1677,1142,2213756.78,1510088.65,3723845.43
351360,202310,892,412,480,543848.14,633604.02,1177452.16
351370,202310,507,252,255,332651.15,336600.15,669251.30
351380,202310,9811,4340,5471,5730289.79,7228352.83,12958642.62
351385,202310,27,20,7,26401.7,9240,35641.7
351390,202310,306,225,81,297006.84,106920.4,403927.24
351400,202310,62,41,21,54120.83,27720,81840.83
351410,202310,540,312,228,411854.71,300962.32,712817.03
351420,202310,88,62,26,81840.72,35640,117480.72
351430,202310,80,43,37,56761.65,48840.2,105601.85
351440,202310,953,618,335,817117,443524.63,1260641.63
351450,202310,324,161,163,212522.5,216484.61,429007.11
351460,202310,147,61,86,80524.77,113521.29,194046.06
351470,202310,150,79,71,104284.48,93720.89,198005.37
351480,202310,503,290,213,382804.2,281160.2,663964.4
351490,202310,345,135,210,178203.2,277200.72,455403.92
351492,202310,29,18,11,23760.63,14520,38280.63
351495,202310,29,20,9,26400.65,11880,38280.65
351500,202310,3822,1512,2310,1997204.2,3050540.26,5047744.46
351510,202310,2496,901,1595,1189358.54,2105415.47,3294774.01
351512,202310,16,10,6,13200,7920,21120
351515,202310,231,134,97,176885.36,128040.33,304925.69
351518,202310,742,433,309,571591.57,407901.68,979493.25
351519,202310,84,49,35,66001.79,46200,112201.79
351520,202310,188,118,70,155764.31,92400.31,248164.62
351530,202310,30,16,14,21120,18480,39600
351535,202310,149,90,59,118805.37,77882.29,196687.66
351540,202310,539,334,205,442216.84,270604.25,712821.09
351550,202310,1857,1081,776,1426972.99,1025645.52,2452618.51
351560,202310,93,50,43,66001.36,56760,122761.36
351565,202310,15,8,7,10560.32,9240,19800.32
351570,202310,3320,1467,1853,1936510.33,2447303.11,4383813.44
351580,202310,38,34,4,44880.4,5280,50160.4
351590,202310,70,40,30,52801.34,39600.86,92402.20
351600,202310,184,132,52,174247.1,68640.76,242887.86
351610,202310,65,27,38,35641.05,50160,85801.05
351620,202310,6961,3690,3271,4874984.76,4324360.34,9199345.10
351630,202310,3910,1837,2073,2424915.56,2740344.83,5165260.39
351640,202310,3100,1351,1749,1787330.63,2311332.2,4098662.83
351650,202310,43,32,11,42241.03,14520,56761.03
351660,202310,144,87,57,114840.35,75240,190080.35
351670,202310,834,464,370,613822.39,488408.55,1102230.94
351680,202310,102,70,32,92401.13,42240,134641.13
351685,202310,21,14,7,18480.13,9240,27720.13
351690,202310,332,209,123,275889.72,162361.78,438251.50
351700,202310,192,133,59,175855.23,77880.51,253735.74
351710,202310,64,42,22,55442.27,29040,84482.27
351720,202310,132,73,59,96361.98,77880,174241.98
351730,202310,135,91,44,120121.48,58080,178201.48
351740,202310,879,544,335,718120.63,442207.37,1160328.00
351750,202310,426,177,249,233646.21,330001.6,563647.81
351760,202310,753,585,168,772110.17,223080.34,995190.51
351770,202310,348,274,74,361698.98,97680.56,459379.54
351780,202310,160,95,65,125400.81,85800,211200.81
351790,202310,297,145,152,191407.61,200643.24,392050.85
351800,202310,51,33,18,43560.16,23760,67320.16
351810,202310,128,80,48,105607.4,63361.82,168969.22
351820,202310,805,572,233,755087.1,307566.16,1062653.26
351830,202310,777,241,536,318130.28,707528.28,1025658.56
351840,202310,2648,1170,1478,1547093.25,1952285.13,3499378.38
351850,202310,290,196,94,260050.12,124080,384130.12
351860,202310,659,440,219,582150.86,289083.6,871234.46
351870,202310,6823,3015,3808,3982610.89,5031946.7,9014557.59
351880,202310,26866,10360,16506,13683513.1,21807746.24,35491259.34
351885,202310,119,64,55,84481.89,72600.3,157082.19
351890,202310,83,55,28,72601.35,36960,109561.35
351900,202310,269,137,132,180849.01,174240,355089.01
351905,202310,118,58,60,76561.61,79200.24,155761.85
351907,202310,4357,1780,2577,2349689.06,3405630.45,5755319.51
351910,202310,173,76,97,100326.51,128041.08,228367.59
351920,202310,129,67,62,88440,81840,170280
351925,202310,99,59,40,77883.13,54120.75,132003.88
351930,202310,548,333,215,439583.7,283806.95,723390.65
351940,202310,265,108,157,142562.63,207241.88,349804.51
351950,202310,155,81,74,106922.09,99003.62,205925.71
351960,202310,1120,555,565,732634.44,747139.69,1479774.13
351970,202310,2466,1148,1318,1515389.15,1741096.91,3256486.06
351980,202310,167,73,94,96364.09,124082.69,220446.78
351990,202310,264,163,101,215164.47,133322.36,348486.83
352000,202310,292,198,94,261377.48,124084.88,385462.36
352010,202310,500,322,178,425150.9,234972.68,660123.58
352020,202310,229,73,156,96360,205920,302280
352030,202310,1359,621,738,821067.08,974171.42,1795238.50
352040,202310,810,317,493,419765.93,650766.07,1070532.00
352042,202310,399,100,299,132003.64,394682.13,526685.77
352044,202310,402,213,189,281175.71,249488.58,530664.29
352050,202310,3750,1377,2373,1817693.51,3132374.74,4950068.25
352060,202310,112,63,49,83160.18,64680.92,147841.10
352070,202310,117,74,43,97686.26,56760,154446.26
352080,202310,75,46,29,60722.65,38280.48,99003.13
352090,202310,215,129,86,170284.52,113521.61,283806.13
352100,202310,362,179,183,236286.39,241561.73,477848.12
352110,202310,119,36,83,47520.51,109560,157080.51
352115,202310,76,30,46,39600.31,60720.2,100320.51
352120,202310,80,51,29,67320,38280,105600
352130,202310,257,189,68,249493.41,89760.57,339253.98
352140,202310,222,118,104,155763.12,138602.39,294365.51
352150,202310,141,77,64,101641.71,85801.57,187443.28
352160,202310,146,98,48,129363.86,63360.54,192724.40
352170,202310,483,318,165,419763.95,217800,637563.95
352180,202310,786,461,325,608543.35,431646.42,1040189.77
352190,202310,262,109,153,143889.59,201962.62,345852.21
352200,202310,33,15,18,19800.84,23760.1,43560.94
352210,202310,5244,2045,3199,2700856.89,4230630.08,6931486.97
352215,202310,82,41,41,54120.2,54120,108240.2
352220,202310,6715,2499,4216,3298795.54,5570458.52,8869254.06
352230,202310,4157,2571,1586,3397828.73,2094850.16,5492678.89
352240,202310,3173,1766,1407,2331200.11,1862537.36,4193737.47
352250,202310,4497,2006,2491,2648007.12,3289447.71,5937454.83
352260,202310,1166,609,557,805227.67,735252,1540479.67
352265,202310,81,49,32,64680,42240,106920
352270,202310,450,240,210,316826.85,277205.78,594032.63
352280,202310,567,334,233,440891.68,308880,749771.68
352290,202310,195,109,86,143887.13,113522.01,257409.14
352300,202310,106,60,46,79204.76,60720.77,139925.53
352310,202310,9324,4107,5217,5424111.78,6893055.9,12317167.68
352320,202310,1302,679,623,896299.67,825009.18,1721308.85
352330,202310,580,297,283,392044.12,373560.13,765604.25
352340,202310,1569,716,853,945153.13,1127285.29,2072438.42
352350,202310,420,232,188,306247.17,248163.01,554410.18
352360,202310,238,105,133,138601.45,178202.42,316803.87
352370,202310,143,89,54,117484.36,71282.08,188766.44
352380,202310,129,95,34,125404.09,44881.39,170285.48
352390,202310,2924,1219,1705,1609138.08,2250608.14,3859746.22
352400,202310,635,272,363,359043.19,479162.73,838205.92
352410,202310,1051,694,357,916129.31,471259.59,1387388.90
352420,202310,106,80,26,105601.05,34320,139921.05
352430,202310,1906,829,1077,1094338.08,1422990.05,2517328.13
352440,202310,4084,1756,2328,2319330.08,3074292.81,5393622.89
352450,202310,199,154,45,203284.52,59401.27,262685.79
352460,202310,717,360,357,475207.82,471245.07,946452.89
352470,202310,764,303,461,399978.72,609844.93,1009823.65
352480,202310,1847,1047,800,1383405.86,1058659.77,2442065.63
352490,202310,71,31,40,40920,52800.16,93720.16
352500,202310,1781,701,1080,925339.69,1426929.44,2352269.13
352510,202310,814,423,391,558388.97,516125.31,1074514.28
352520,202310,1008,443,565,584775.57,747129.52,1331905.09
352530,202310,2229,1105,1124,1459985.26,1485008.47,2944993.73
352540,202310,75,52,23,68643.29,30360,99003.29
352550,202310,240,132,108,174241.64,142560,316801.64
352560,202310,59,42,17,55440.87,22440,77880.87
352570,202310,887,427,460,563670.84,607215.7,1170886.54
352580,202310,58,43,15,56761.85,19800,76561.85
352585,202310,16,5,11,6600.15,14520,21120.15
352590,202310,5136,2501,2635,3302776.12,3480863.26,6783639.38
352600,202310,417,280,137,369614.93,180847.79,550462.72
352610,202310,995,427,568,563652.88,751085.65,1314738.53
352620,202310,1297,486,811,641531.84,1071851.69,1713383.53
352630,202310,199,73,126,97680,166320.08,264000.08
352640,202310,582,371,211,489747,278524.37,768271.37
352650,202310,96,65,31,85802.61,40920,126722.61
352660,202310,75,38,37,50160.87,48840,99000.87
352670,202310,1974,1052,922,1392675.44,1218361.88,2611037.32
352680,202310,1089,631,458,832955.69,604580.95,1437536.64
352690,202310,5340,2354,2986,3107404.73,3948149.55,7055554.28
352700,202310,101,55,46,72603.39,60721.63,133325.02
352710,202310,1702,882,820,1164290.21,1082403.04,2246693.25
352720,202310,1854,774,1080,1021722.37,1428265.49,2449987.86
352725,202310,31,24,7,31681.29,10560,42241.29
352730,202310,468,227,241,299649.18,318123.49,617772.67
352740,202310,411,264,147,348498.12,195362.67,543860.79
352750,202310,25,16,9,21121.21,11880,33001.21
352760,202310,263,167,96,220446.31,126721.01,347167.32
352770,202310,82,61,21,80521.08,29040,109561.08
352780,202310,81,45,36,59400,47520.78,106920.78
352790,202310,28,18,10,23762.05,13200.18,36962.23
352800,202310,266,200,66,264009.4,87120.87,351130.27
352810,202310,167,108,59,142562.54,77881.88,220444.42
352820,202310,43,34,9,44880.89,11880,56760.89
352830,202310,78,49,29,64681.6,38280.01,102961.61
352840,202310,821,355,466,468621.85,615127.23,1083749.08
352850,202310,2165,655,1510,867255.24,1994529.91,2861785.15
352860,202310,136,84,52,110883.43,68640.49,179523.92
352870,202310,58,35,23,46206.13,30360.82,76566.95
352880,202310,201,110,91,145204.82,120121.88,265326.70
352885,202310,40,27,13,35640.32,17160,52800.32
352890,202310,65,40,25,52800.71,33000,85800.71
352900,202310,5126,2399,2727,3170769.34,3602296.5,6773065.84
352910,202310,40,31,9,40920.88,11880,52800.88
352920,202310,697,393,304,518781.5,401284.41,920065.91
352930,202310,1312,606,706,799953.67,931924.59,1731878.26
352940,202310,7287,2773,4514,3663092.5,5967779,9630871.5
352950,202310,149,74,75,97682.43,99002.61,196685.04
352960,202310,78,53,25,69961.13,33000,102961.13
352965,202310,18,11,7,14520,9240,23760
352970,202310,603,432,171,570264.79,227045.68,797310.47
352980,202310,175,103,72,135970.17,95041.37,231011.54
352990,202310,1047,481,566,634944.17,747130.08,1382074.25
353000,202310,66,33,33,43560.63,43560.98,87121.61
353010,202310,553,329,224,434297.84,295683.02,729980.86
353020,202310,378,246,132,326049.14,174243.56,500292.70
353030,202310,1524,687,837,906874.53,1107500.87,2014375.40
353040,202310,107,54,53,71281.19,69960.47,141241.66
353050,202310,1514,994,520,1312150.96,689043.31,2001194.27
353060,202310,10535,4614,5921,6097332.01,7821062.65,13918394.66
353070,202310,2297,1331,966,1760960.13,1280167.02,3041127.15
353080,202310,1453,767,686,1012484.1,905522.68,1918006.78
353090,202310,81,46,35,60721.83,46200,106921.83
353100,202310,48,37,11,48841.94,14521.54,63363.48
353110,202310,2632,898,1734,1185424.6,2288956.39,3474380.99
353120,202310,160,92,68,121440,89760.56,211200.56
353130,202310,947,452,495,597985.6,654724.59,1252710.19
353140,202310,639,296,343,390742.04,452765.34,843507.38
353150,202310,348,176,172,232327.79,227042.11,459369.90
353160,202310,114,86,28,113526.01,36960,150486.01
353170,202310,216,75,141,99001.84,186120.51,285122.35
353180,202310,1506,692,814,914786.3,1077133.35,1991919.65
353190,202310,559,395,164,521423.8,216485.83,737909.63
353200,202310,327,160,167,211203.2,220440.73,431643.93
353205,202310,25,17,8,22440,10560,33000
353210,202310,83,48,35,63361.8,46200.17,109561.97
353215,202310,50,29,21,38280.2,27720,66000.2
353220,202310,90,49,41,64681.46,54120.68,118802.14
353230,202310,172,78,94,102961.92,124080,227041.92
353240,202310,460,194,266,256081.95,351120.28,607202.23
353250,202310,197,103,94,135964.57,124081.45,260046.02
353260,202310,516,325,191,430337.38,252124.87,682462.25
353270,202310,76,58,18,76563.91,23760,100323.91
353280,202310,128,56,72,73924.48,95045.71,168970.19
353282,202310,139,96,43,126721.64,56760,183481.64
353284,202310,32,26,6,34322.16,7920,42242.16
353286,202310,11,4,7,5280.2,9240,14520.2
353290,202310,89,51,38,67322.34,50160,117482.34
353300,202310,480,234,246,308893.39,324729.9,633623.29
353310,202310,43,33,10,43561.21,13200.95,56762.16
353320,202310,49,25,24,33000.81,31680.2,64681.01
353325,202310,50,26,24,34322.58,31680,66002.58
353330,202310,62,41,21,54120.1,27720.05,81840.15
353340,202310,803,313,490,413172.61,646805.17,1059977.78
353350,202310,1066,540,526,714149.21,695657.92,1409807.13
353360,202310,112,90,22,118802.37,29040.87,147843.24
353370,202310,116,65,51,85802.45,67320.56,153123.01
353380,202310,29,14,15,18480.43,19800,38280.43
353390,202310,1264,603,661,795994.7,872534.61,1668529.31
353400,202310,61,35,26,46202.2,34321.05,80523.25
353410,202310,133,69,64,91083.93,84480.69,175564.62
353420,202310,69,33,36,43560,47520,91080
353430,202310,625,408,217,538588.29,286446.88,825035.17
353440,202310,15399,6802,8597,8982821.15,11357335.06,20340156.21
353450,202310,52,24,28,31680.8,36960.2,68641.0
353460,202310,749,388,361,512183.91,477849.06,990032.97
353470,202310,2567,1215,1352,1605194.61,1784648.88,3389843.49
353475,202310,316,198,118,261366.26,155760.91,417127.17
353480,202310,256,187,69,246845.05,92400,339245.05
353490,202310,238,137,101,180847.85,133320.22,314168.07
353500,202310,235,127,108,167643.18,142561.03,310204.21
353510,202310,86,54,32,71281.53,42240.14,113521.67
353520,202310,280,198,82,261363.25,108240,369603.25
353530,202310,543,269,274,355094.18,361684.83,716779.01
353540,202310,414,259,155,341899.21,204604.49,546503.70
353550,202310,844,517,327,682488.33,432971.58,1115459.91
353560,202310,595,242,353,319441.96,465962,785403.96
353570,202310,67,46,21,60722.31,27720,88442.31
353580,202310,415,247,168,326045.66,221760,547805.66
353590,202310,104,77,27,101642.44,35640,137282.44
353600,202310,312,182,130,240249.36,171600.19,411849.55
353610,202310,158,91,67,120122.1,88440,208562.1
353620,202310,725,355,370,468612.7,489728.9,958341.6
353625,202310,70,36,34,47521.34,44880.16,92401.50
353630,202310,251,173,78,228369.94,102960.78,331330.72
353640,202310,155,95,60,125406.15,79200.26,204606.41
353650,202310,1237,490,747,646817.32,986048.49,1632865.81
353657,202310,31,24,7,31680,9240,40920
353660,202310,325,166,159,219123.88,209883.54,429007.42
353670,202310,820,455,365,600620.81,481806.83,1082427.64
353680,202310,158,99,59,132000.58,77880,209880.58
353690,202310,51,34,17,44880.83,22440.19,67321.02
353700,202310,323,220,103,290407.8,137281.88,427689.68
353710,202310,648,320,328,422423.3,434283.88,856707.18
353715,202310,46,25,21,33000,27720,60720
353720,202310,338,156,182,205928.5,240243.19,446171.69
353730,202310,1296,744,552,982132.43,731283.43,1713415.86
353740,202310,649,351,298,463337.79,394687.6,858025.39
353750,202310,111,60,51,79202.46,67320,146522.46
353760,202310,3794,1501,2293,1981409.31,3028120.29,5009529.60
353770,202310,83,65,18,85800.7,23760.2,109560.9
353780,202310,1581,720,861,950423.51,1137848.05,2088271.56
353790,202310,580,330,250,435617.45,330007.72,765625.17
353800,202310,4465,2018,2447,2666538.65,3232689.19,5899227.84
353810,202310,246,122,124,161051.37,163680.72,324732.09
353820,202310,320,133,187,175562.23,246841.01,422403.24
353830,202310,80,65,15,85803.22,19800.29,105603.51
353850,202310,229,101,128,133325.61,168961.79,302287.40
353860,202310,611,282,329,372250.48,434283.43,806533.91
353870,202310,6756,3461,3295,4568670.3,4354708.4,8923378.7
353880,202310,810,519,291,685108.37,384122.95,1069231.32
353890,202310,666,377,289,497660.61,382804.64,880465.25
353900,202310,149,77,72,101643.46,95042.39,196685.85
353910,202310,228,100,128,132003.22,170280.35,302283.57
353920,202310,538,271,267,357731.58,352443.96,710175.54
353930,202310,1204,700,504,924037.42,665283.26,1589320.68
353940,202310,224,110,114,145202.72,150481.94,295684.66
353950,202310,567,371,196,489741.9,258723.91,748465.81
353960,202310,83,66,17,87122.59,22440,109562.59
353970,202310,38,23,15,30360.34,19801.56,50161.90
353980,202310,2411,1049,1362,1386040.09,1799180.95,3185221.04
353990,202310,94,59,35,77883.38,46200.61,124083.99
354000,202310,420,183,237,241569.26,312842.42,554411.68
354010,202310,90,52,38,68643.13,50160,118803.13
354020,202310,580,356,224,469935.87,295684.67,765620.54
354025,202310,48,39,9,51483.31,11880,63363.31
354030,202310,52,27,25,35642.49,33000.15,68642.64
354040,202310,101,77,24,101643.53,31680,133323.53
354050,202310,170,89,81,117481.92,106921.28,224403.20
354060,202310,950,450,500,594011.77,660002.5,1254014.27
354070,202310,1017,572,445,755062.22,588727.47,1343789.69
354075,202310,236,111,125,146523.06,165002.17,311525.23
354080,202310,334,151,183,199328.09,241561.52,440889.61
354085,202310,29,17,12,22441.71,15840,38281.71
354090,202310,305,176,129,232213.43,170282.18,402495.61
354100,202310,7293,2956,4337,3903379.62,5728876.15,9632255.77
354105,202310,112,61,51,80522.58,67320,147842.58
354110,202310,48,23,25,30360,33000.2,63360.2
354120,202310,175,104,71,138605.65,93720.97,232326.62
354130,202310,911,573,338,757708.22,447481.32,1205189.54
354140,202310,3879,1773,2106,2340464.01,2782579.55,5123043.56
354150,202310,745,437,308,576871.21,406567.47,983438.68
354160,202310,745,446,299,588754.44,396007.47,984761.91
354165,202310,15,9,6,11880,7920,19800
354170,202310,206,135,71,178205.78,93720.2,271925.98
354180,202310,55,33,22,43560.4,29040.57,72600.97
354190,202310,315,113,202,149162.96,266641.26,415804.22
354200,202310,126,63,63,83162.51,83163.09,166325.60
354210,202310,83,41,42,54120,55440,109560
354220,202310,664,400,264,529345,348485.7,877830.7
354230,202310,191,88,103,116162.51,135960.62,252123.13
354240,202310,380,229,151,302293.96,199320.91,501614.87
354250,202310,81,46,35,60720.5,46200,106920.5
354260,202310,2378,1084,1294,1430921.76,1709428.51,3140350.27
354270,202310,104,76,28,100323.13,38280,138603.13
354280,202310,68,40,28,52800.79,36960,89760.79
354290,202310,170,113,57,149166.31,75240,224406.31
354300,202310,345,247,98,326048.69,130681.64,456730.33
354310,202310,109,76,33,100325.08,43560.6,143885.68
354320,202310,243,114,129,150481.96,170280,320761.96
354323,202310,12,9,3,11880,3960,15840
354325,202310,136,76,60,100321.67,79200.42,179522.09
354330,202310,2741,930,1811,1228970.38,2391847.41,3620817.79
354340,202310,12221,5496,6725,7262665.49,8891588.39,16154253.88
354350,202310,177,117,60,154441.12,79200,233641.12
354360,202310,77,47,30,63361.17,39601.05,102962.22
354370,202310,267,131,136,172924.35,179521.7,352446.05
354380,202310,198,112,86,147844,113520,261364
354390,202310,3210,1179,2031,1557653.55,2680946.2,4238599.75
354400,202310,424,233,191,308885.02,252120.59,561005.61
354410,202310,811,354,457,467297.65,603250.4,1070548.05
354420,202310,316,210,106,277209.77,139923.16,417132.93
354425,202310,380,209,171,275949.33,225724,501673.33
354430,202310,143,85,58,112206.44,76560.29,188766.73
354440,202310,31,23,8,30360.92,10560,40920.92
354450,202310,59,41,18,54121.22,23760,77881.22
354460,202310,104,57,47,75246.17,62042.25,137288.42
354470,202310,14,8,6,10560.63,7920.76,18481.39
354480,202310,129,68,61,89760.54,80520.56,170281.10
354490,202310,132,79,53,104285.61,71282.54,175568.15
354500,202310,455,194,261,256083.56,344521.38,600604.94
354510,202310,87,61,26,80524.15,34320.46,114844.61
354515,202310,54,18,36,23761.64,47520.1,71281.74
354520,202310,1898,777,1121,1025493.96,1479721.16,2505215.12
354530,202310,978,472,506,623054.5,667921.8,1290976.3
354540,202310,260,125,135,165006.01,178201.29,343207.30
354550,202310,44,26,18,34320.59,23760,58080.59
354560,202310,179,97,82,128041.99,108240,236281.99
354570,202310,155,102,53,134641.06,69960,204601.06
354580,202310,2157,1022,1135,1349085.93,1499526.96,2848612.89
354600,202310,326,147,179,194047.29,236281.07,430328.36
354610,202310,69,55,14,72601.97,18480.82,91082.79
354620,202310,90,30,60,39600.2,79200.2,118800.4
354625,202310,21,14,7,18482.16,9240.72,27722.88
354630,202310,412,281,131,370940.93,172923.17,543864.10
354640,202310,936,548,388,723627.75,512166.39,1235794.14
354650,202310,71,45,26,59401.12,34320,93721.12
354660,202310,946,682,264,900290.54,348482.75,1248773.29
354670,202310,256,99,157,130680.97,207240.2,337921.17
354680,202310,1561,557,1004,735258.27,1327926.48,2063184.75
354690,202310,81,50,31,66003.06,40920,106923.06
354700,202310,84,58,26,76560,34320,110880
354710,202310,50,34,16,44880.3,21120,66000.3
354720,202310,23,20,3,26400.35,3960,30360.35
354730,202310,2171,875,1296,1155031.26,1710737.49,2865768.75
354740,202310,78,56,22,73921.16,29040,102961.16
354750,202310,449,247,202,327368.81,269282.84,596651.65
354760,202310,592,376,216,496355.69,285127.61,781483.30
354765,202310,7,3,4,3960,5280,9240
354770,202310,395,249,146,328691.64,192722.85,521414.49
354780,202310,9978,3646,6332,4815493.21,8371478.78,13186971.99
354790,202310,98,54,44,71280.82,59401.38,130682.20
354800,202310,493,262,231,345916.7,304925.27,650841.97
354805,202310,82,42,40,55441.21,52800.27,108241.48
354810,202310,106,55,51,72601.67,67320,139921.67
354820,202310,239,100,139,132002.41,183484.24,315486.65
354830,202310,56,32,24,42240,31680,73920
354840,202310,58,37,21,48840.37,27720,76560.37
354850,202310,6255,2533,3722,3347670.97,4921012.3,8268683.27
354860,202310,390,169,221,223080.82,291721.57,514802.39
354870,202310,14692,6424,8268,8483890.46,10925706.47,19409596.93
354880,202310,3099,1155,1944,1525964.32,2567482.8,4093447.12
354890,202310,3617,1935,1682,2554346.01,2225539.71,4779885.72
354900,202310,64,46,18,60720.83,23760.19,84481.02
354910,202310,1487,751,736,993997.89,974161.79,1968159.68
354920,202310,39,34,5,44880.6,6600,51480.6
354925,202310,27,19,8,25080.74,10560,35640.74
354930,202310,42,33,9,43561.29,11880,55441.29
354940,202310,861,602,259,794677.52,341886.63,1136564.15
354950,202310,217,132,85,174244.44,112201.73,286446.17
354960,202310,132,47,85,62042.29,112200.75,174243.04
354970,202310,1423,1022,401,1350419.1,529322.8,1879741.9
354980,202310,11082,4099,6983,5414860.09,9226875.57,14641735.66
354990,202310,12528,5584,6944,7376379.75,9178011.88,16554391.63
354995,202310,685,238,447,314163.62,590048.52,904212.14
355000,202310,468,161,307,212522.75,405240.7,617763.45
355010,202310,795,498,297,657401.05,392047.77,1049448.82
355020,202310,915,553,362,731303.56,477846.92,1209150.48
355030,202310,253864,94385,159479,124663704.2,210687507.97,335351212.17
355040,202310,1234,618,616,815786.61,813130.5,1628917.11
355050,202310,183,101,82,133321.92,108240,241561.92
355060,202310,2157,1001,1156,1321391.77,1525926.13,2847317.90
355070,202310,1937,828,1109,1092990.83,1465217.09,2558207.92
355080,202310,226,132,94,174243.68,124081.83,298325.51
355090,202310,356,218,138,287772.37,183483.13,471255.50
355100,202310,6665,3073,3592,4060401.45,4745446.22,8805847.67
355110,202310,235,153,82,201963,108241.08,310204.08
355120,202310,47,30,17,39600.54,22440,62040.54
355130,202310,64,37,27,48840.72,35640,84480.72
355140,202310,226,128,98,168963.88,129360.51,298324.39
355150,202310,833,491,342,650785.71,451446.52,1102232.23
355160,202310,607,287,320,378858.87,423724.52,802583.39
355170,202310,2346,1209,1137,1595957.15,1500853.45,3096810.60
355180,202310,753,294,459,388085.44,607208.18,995293.62
355190,202310,241,159,82,209888.58,108242.21,318130.79
355200,202310,133,58,75,76561.37,99000,175561.37
355210,202310,818,414,404,546490.81,534603.11,1081093.92
355220,202310,9399,4349,5050,5743543.64,6670020.96,12413564.60
355230,202310,105,55,50,72601.4,66001.11,138602.51
355240,202310,5380,2131,3249,2815591.38,4291343.05,7106934.43
355250,202310,8374,3701,4673,4888181.15,6171033.68,11059214.83
355255,202310,50,30,20,39600.62,26400,66000.62
355260,202310,221,123,98,162366.1,130683.47,293049.57
355270,202310,175,118,57,155767.77,75240.98,231008.75
355280,202310,8622,3226,5396,4262422.09,7125446.09,11387868.18
355290,202310,73,55,18,72601.55,23760.31,96361.86
355300,202310,266,148,118,195366.2,155760.97,351127.17
355310,202310,118,69,49,91081.58,64680,155761.58
355320,202310,121,61,60,80520.6,79200.96,159721.56
355330,202310,380,226,154,298330.05,205922.74,504252.79
355340,202310,1434,547,887,723461.19,1172204.3,1895665.49
355350,202310,196,94,102,124080,134640.2,258720.2
355360,202310,226,147,79,194049.23,104281.87,298331.10
355365,202310,24,18,6,23760,7920,31680
355370,202310,1129,655,474,864646.86,627003,1491649.86
355380,202310,939,551,388,727354.49,513487.98,1240842.47
355385,202310,112,70,42,92400.2,55440,147840.2
355390,202310,124,68,56,89761.02,73920.11,163681.13
355395,202310,224,108,116,142568.32,153123.94,295692.26
355400,202310,2063,1128,935,1488913.95,1238161.95,2727075.90
355410,202310,6126,2751,3375,3635414.66,4455022.32,8090436.98
355420,202310,48,33,15,43560.8,21120,64680.8
355430,202310,541,311,230,410549.54,303608.62,714158.16
355440,202310,100,54,46,71281.1,60721.75,132002.85
355450,202310,524,273,251,361696.4,332642.91,694339.31
355460,202310,66,44,22,58081.1,29040.8,87121.9
355465,202310,58,30,28,39600.51,36960,76560.51
355470,202310,211,90,121,118803.72,159721.49,278525.21
355475,202310,9,5,4,6600.81,5280,11880.81
355480,202310,728,296,432,390739.4,570245.39,960984.79
355490,202310,123,89,34,117485.19,44883.62,162368.81
355495,202310,133,59,74,77880,97681.19,175561.19
355500,202310,1769,961,808,1268558.39,1066563.7,2335122.09
355510,202310,301,205,96,270614.31,126722.13,397336.44
355520,202310,30,20,10,26400.18,13200,39600.18
355530,202310,23,13,10,17160,13200,30360
355535,202310,98,46,52,60723.07,68640,129363.07
355540,202310,3302,1292,2010,1706823.15,2654570.9,4361394.05
355550,202310,73,39,34,52800.52,44880,97680.52
355560,202310,300,130,170,172925.13,224403.01,397328.14
355570,202310,17,13,4,17161.07,5280,22441.07
355580,202310,242,163,79,215170.75,104281.67,319452.42
355590,202310,15,11,4,14520.24,5280,19800.24
355600,202310,299,145,154,191407.1,203281.78,394688.88
355610,202310,276,164,112,216488.37,147843.15,364331.52
355620,202310,1511,627,884,827665.84,1166883.04,1994548.88
355630,202310,450,315,135,415817.2,178201.03,594018.23
355635,202310,141,55,86,72600.2,113520,186120.2
355640,202310,681,351,330,463330.73,435605.55,898936.28
355645,202310,999,348,651,459373.79,859331.02,1318704.81
355650,202310,2045,887,1158,1170887.85,1528561.56,2699449.41
355660,202310,243,125,118,165003.07,155762.11,320765.18
355670,202310,768,320,448,422404.92,591364.12,1013769.04
355680,202310,241,127,114,167654.61,150482.4,318137.01
355690,202310,104,47,57,62042.65,75241.77,137284.42
355695,202310,23,13,10,17160,13200,30360
355700,202310,1486,666,820,879149.36,1082407.08,1961556.44
355710,202310,2536,1408,1128,1861283,1490284.54,3351567.54
355715,202310,16,13,3,17162.28,3960.1,21122.38
355720,202310,280,172,108,227046.93,142561.51,369608.44
355730,202310,115,69,46,91081.83,60720.15,151801.98
410010,202310,111,90,21,118802.9,27720,146522.9
410020,202310,133,92,41,121443.84,54120.2,175564.04
410030,202310,220,115,105,151803.28,138602.86,290406.14
410040,202310,1651,780,871,1030946.71,1149736.25,2180682.96
410045,202310,46,35,11,46200.79,14520,60720.79
410050,202310,590,339,251,447485.31,331320.64,778805.95
410060,202310,229,168,61,221769.69,80521.47,302291.16
410070,202310,276,222,54,293050.82,71281.02,364331.84
410080,202310,208,129,79,170282.91,104280,274562.91
410090,202310,56,48,8,63363.94,10560,73923.94
410100,202310,288,181,107,238923.74,141240.1,380163.84
410105,202310,44,28,16,36960,21120,58080
410110,202310,407,247,160,326057.13,211206.75,537263.88
410115,202310,52,27,25,35640,33000.2,68640.2
410120,202310,507,231,276,304927.81,365642.49,670570.30
410130,202310,75,40,35,52800.58,46200,99000.58
410140,202310,3662,1686,1976,2226893.9,2614941.38,4841835.28
410150,202310,2925,1205,1720,1593139.51,2274376.27,3867515.78
410160,202310,540,311,229,411849.93,302282.57,714132.50
410165,202310,63,40,23,52800.41,30360,83160.41
410170,202310,230,129,101,170283.93,133320,303603.93
410180,202310,2744,1429,1315,1886347.28,1737148.61,3623495.89
410185,202310,38,31,7,40920,9240,50160
410190,202310,530,347,183,458049.97,242880.9,700930.87
410200,202310,1211,844,367,1114139.56,484441.78,1598581.34
410210,202310,741,385,356,508216.53,469924.22,978140.75
410220,202310,55,26,29,34320.84,38280,72600.84
410230,202310,219,96,123,126720.96,162362.19,289083.15
410240,202310,779,498,281,657384.24,370921.4,1028305.64
410250,202310,407,270,137,356403.93,180842.22,537246.15
410260,202310,349,190,159,250807.84,209886.37,460694.21
410270,202310,29,20,9,26400.53,11880,38280.53
410275,202310,68,45,23,59401.97,30360,89761.97
410280,202310,339,206,133,271931.19,175560.2,447491.39
410290,202310,290,164,126,216486.9,166320.5,382807.4
410300,202310,101,62,39,81840,51480,133320
410302,202310,30,17,13,22440.98,17160,39600.98
410304,202310,50,33,17,43561.2,22440,66001.2
410305,202310,231,145,86,191408.16,113520,304928.16
410310,202310,202,120,82,158404.46,108242.23,266646.69
410315,202310,42,34,8,44880.2,10560,55440.2
410320,202310,152,107,45,141241.24,59400,200641.24
410322,202310,42,24,18,31680.7,23760,55440.7
410330,202310,187,122,65,161042.04,85800,246842.04
410335,202310,110,63,47,83160,62084,145244
410337,202310,53,43,10,58080.5,13200,71280.5
410340,202310,38,31,7,40921.21,9240,50161.21
410345,202310,213,135,78,180666.8,104280.2,284947.0
410347,202310,41,31,10,40920.14,13200.16,54120.30
410350,202310,268,155,113,204604.72,149160,353764.72
410360,202310,508,314,194,414494.17,256080.12,670574.29
410370,202310,2540,1110,1430,1465244.52,1890252.28,3355496.80
410380,202310,211,119,92,157082.94,121440.52,278523.46
410390,202310,467,281,186,370925.37,246841.55,617766.92
410395,202310,36,24,12,31681.99,15840,47521.99
410400,202310,1088,465,623,615139.23,822371.28,1437510.51
410405,202310,87,68,19,89764.34,25080.22,114844.56
410410,202310,40,23,17,30362.05,22440.1,52802.15
410420,202310,2107,934,1173,1232792.51,1548377.18,2781169.69
410425,202310,238,110,128,145202.84,168960.2,314163.04
410430,202310,2720,1376,1344,1816360.51,1774096.2,3590456.71
410440,202310,381,278,103,366963.43,135962.19,502925.62
410442,202310,391,236,155,311530.99,205921.82,517452.81
410445,202310,360,253,107,333967.44,141240.85,475208.29
410450,202310,439,213,226,281167.13,298320.1,579487.23
410460,202310,631,348,283,460685.4,373562.01,834247.41
410465,202310,294,166,128,219125.29,168960,388085.29
410470,202310,266,154,112,203286.59,147841.63,351128.22
410480,202310,7625,3744,3881,4943583.52,5128251.07,10071834.59
410490,202310,1550,838,712,1106191.05,942488.71,2048679.76
410500,202310,312,187,125,246842.16,165000.5,411842.66
410510,202310,222,165,57,217809.62,75241.85,293051.47
410520,202310,312,222,90,293040.73,120120,413160.73
410530,202310,278,90,188,118800.59,248160,366960.59
410540,202310,423,304,119,401291.05,157080,558371.05
410550,202310,1913,837,1076,1104860.36,1424287.52,2529147.88
410560,202310,199,126,73,166323.72,96360.94,262684.66
410570,202310,489,320,169,422408.91,223082.22,645491.13
410580,202310,4416,1853,2563,2448673.82,3391130.09,5839803.91
410590,202310,477,303,174,401266.23,229680,630946.23
410600,202310,122,104,18,137280.94,23760,161040.94
410610,202310,72,58,14,76560.56,18480,95040.56
410620,202310,310,176,134,232327.28,176881.37,409208.65
410630,202310,510,278,232,366961.64,306240.38,673202.02
410640,202310,1329,831,498,1096942.61,657405.88,1754348.49
410645,202310,121,93,28,122764,36960.2,159724.2
410650,202310,418,260,158,343207.45,208561.72,551769.17
410655,202310,97,69,28,91080.73,36960.08,128040.81
410657,202310,41,18,23,23760,30360,54120
410660,202310,723,500,223,660063.97,295682.66,955746.63
410670,202310,77,61,16,80522.73,21120.13,101642.86
410680,202310,209,161,48,212524.15,63360.2,275884.35
410685,202310,46,34,12,44880.49,15840,60720.49
410690,202310,33694,13868,19826,18319553.75,26204913.24,44524466.99
410700,202310,364,261,103,344808.18,135960.37,480768.55
410710,202310,123,100,23,132002.21,30360.2,162362.41
410712,202310,48,33,15,43560.65,19800,63360.65
410715,202310,116,85,31,112204.19,40920,153124.19
410720,202310,734,422,312,557052.2,413161.2,970213.4
410725,202310,214,141,73,186124.06,96360,282484.06
410730,202310,114,49,65,64682.12,85800,150482.12
410740,202310,83,63,20,83161.34,26400,109561.34
410750,202310,333,203,130,267965.38,171600.06,439565.44
410752,202310,22,17,5,22440.14,6600,29040.14
410753,202310,62,22,40,29040,52800,81840
410754,202310,71,38,33,50161.28,43560,93721.28
410755,202310,95,46,49,60720.4,64680,125400.4
410760,202310,833,450,383,594007.48,505563.46,1099570.94
410765,202310,2343,1057,1286,1395288.12,1698866.64,3094154.76
410770,202310,132,91,41,120122.54,54120.2,174242.74
410773,202310,73,49,24,64681.73,31680,96361.73
410775,202310,241,157,84,207242.55,110880,318122.55
410780,202310,92,53,39,69961.18,51480,121441.18
410785,202310,57,49,8,64681.61,10560,75241.61
410790,202310,109,50,59,66000.4,77880,143880.4
410800,202310,306,193,113,254775.76,149160.84,403936.60
410810,202310,27,17,10,22440,13200.14,35640.14
410820,202310,151,104,47,137284.25,62040.9,199325.15
410830,202310,10952,4299,6653,5680115.4,8787322.22,14467437.62
410832,202310,132,85,47,112203.48,62040.86,174244.34
410840,202310,1612,889,723,1173548.56,954365.65,2127914.21
410845,202310,67,34,33,44880.2,43560,88440.2
410850,202310,176,132,44,174245,58080,232325
410855,202310,85,79,6,104283.11,7920,112203.11
410860,202310,1007,491,516,649450.55,681123.94,1330574.49
410865,202310,96,66,30,87122.79,39600,126722.79
410870,202310,152,125,27,165002.16,35640.62,200642.78
410880,202310,1314,626,688,826340.53,909487.31,1735827.84
410890,202310,133,78,55,102961,72600,175561
410895,202310,84,62,22,81841.19,29040.95,110882.14
410900,202310,46,34,12,44881.17,15840,60721.17
410910,202310,14,8,6,10560.95,7920,18480.95
410920,202310,50,31,19,40920,25080,66000
410930,202310,599,372,227,491045.31,299642.4,790687.71
410940,202310,5026,2510,2516,3318611.17,3325118.88,6643730.05
410950,202310,101,76,25,100323.88,33000,133323.88
410960,202310,1131,416,715,549130.91,943810.39,1492941.30
410965,202310,71,51,20,67321.91,26400,93721.91
410970,202310,669,436,233,576848.16,307562.63,884410.79
410975,202310,134,84,50,110881.91,66000,176881.91
410980,202310,1737,798,939,1053397.91,1240811.73,2294209.64
410990,202310,288,213,75,281161.56,100320.98,381482.54
411000,202310,71,43,28,56760.77,36960.54,93721.31
411005,202310,42,34,8,44880,10560,55440
411007,202310,307,178,129,234960.47,170280,405240.47
411010,202310,683,414,269,546494.46,355083.3,901577.76
411020,202310,297,189,108,249485.01,142562.02,392047.03
411030,202310,34,21,13,27720,17160,44880
411040,202310,81,47,34,62040.89,44880,106920.89
411050,202310,219,158,61,208561.71,80520.4,289082.11
411060,202310,609,421,188,555727.89,248160.66,803888.55
411065,202310,45,40,5,52800.78,6600,59400.78
411070,202310,1420,800,620,1059980.24,819725.23,1879705.47
411080,202310,277,176,101,232321.33,133320.23,365641.56
411090,202310,85,58,27,76560.4,35640.96,112201.36
411095,202310,378,124,254,163681.9,335280.43,498962.33
411100,202310,114,93,21,122761.46,27720,150481.46
411110,202310,180,93,87,123508.84,114840.49,238349.33
411120,202310,208,139,69,183491.17,91080,274571.17
411125,202310,431,216,215,285128.17,285128.53,570256.70
411130,202310,173,148,25,195363.04,33000,228363.04
411140,202310,229,149,80,196680.8,105600,302280.8
411150,202310,1365,877,488,1160305.88,644164,1804469.88
411155,202310,121,82,39,108240,51480,159720
411160,202310,39,17,22,22440,29040,51480
411170,202310,61,52,9,68640.79,11880,80520.79
411180,202310,1162,779,383,1028311.28,506886.01,1535197.29
411190,202310,399,233,166,307563.94,219120.41,526684.35
411200,202310,746,395,351,522733.47,463324.73,986058.20
411210,202310,732,378,354,500286.16,469921.8,970207.96
411220,202310,164,115,49,151802.85,64681.25,216484.10
411230,202310,40,33,7,43560,9240,52800
411240,202310,114,71,43,93721.08,56760,150481.08
411250,202310,446,318,128,419765.73,168960,588725.73
411260,202310,11,8,3,10560,3960,14520
411270,202310,287,151,136,199330.19,180841.69,380171.88
411275,202310,202,165,37,217802.89,48840,266642.89
411280,202310,314,209,105,275928.85,138600.7,414529.55
411290,202310,73,54,19,71280,25080,96360
411295,202310,140,100,40,132046.47,52801.46,184847.93
411300,202310,94,46,48,60720,63360,124080
411310,202310,102,70,32,92401.4,42240,134641.4
411320,202310,914,547,367,723370.91,487080.88,1210451.79
411325,202310,62,42,20,55440.1,26400,81840.1
411330,202310,1048,665,383,877824.53,505563.13,1383387.66
411340,202310,42,24,18,31680,23760.09,55440.09
411342,202310,69,54,15,71280,19800,91080
411345,202310,105,52,53,68642.99,69960.95,138603.94
411350,202310,607,445,162,588738.36,213842.62,802580.98
411360,202310,63,42,21,55443.25,27722.5,83165.75
411370,202310,14741,6118,8623,8078627.42,11398304.65,19476932.07
411373,202310,191,125,66,165000.45,87120.17,252120.62
411375,202310,98,79,19,104282.89,25080,129362.89
411380,202310,87,60,27,79204.95,35640,114844.95
411390,202310,179,99,80,130681.19,105600,236281.19
411400,202310,396,244,152,322088.01,201960,524048.01
411410,202310,607,292,315,385447.51,415801.13,801248.64
411420,202310,1042,431,611,568929.08,807845.36,1376774.44
411430,202310,661,334,327,440899.12,431650.5,872549.62
411435,202310,30,22,8,29040,10560,39600
411440,202310,529,419,110,553090.26,145200.7,698290.96
411450,202310,416,338,78,446168.34,102960.34,549128.68
411460,202310,892,342,550,451454.06,727322.39,1178776.45
411470,202310,120,83,37,109565.57,48840,158405.57
411480,202310,812,404,408,533302.53,538561.43,1071863.96
411490,202310,315,200,115,264004.4,151800.9,415805.3
411500,202310,120,90,30,118801.18,39600,158401.18
411510,202310,253,190,63,250849.23,83161.19,334010.42
411520,202310,7253,2460,4793,3247275.56,6333397.16,9580672.72
411530,202310,132,84,48,110881.51,63360,174241.51
411535,202310,51,18,33,23760.6,43560,67320.6
411540,202310,425,281,144,370924.84,190082.03,561006.87
411545,202310,56,38,18,50160.77,23760,73920.77
411550,202310,93,68,25,89761.37,33000,122761.37
411560,202310,417,165,252,217801.07,332640.15,550441.22
411570,202310,1195,382,813,505447.34,1073170.15,1578617.49
411573,202310,26,16,10,21120.2,13200,34320.2
411575,202310,353,226,127,298324.6,167640,465964.6
411580,202310,1373,475,898,627010.72,1185364.6,1812375.32
411585,202310,76,37,39,48840,51480,100320
411590,202310,14,9,5,11880,6600,18480
411600,202310,17,9,8,11880.7,10560,22440.7
411605,202310,179,67,112,88442.03,147840,236282.03
411610,202310,275,167,108,220444.85,142560.2,363005.05
411620,202310,434,206,228,271932.25,300967.29,572899.54
411630,202310,55,40,15,52800.53,19800,72600.53
411640,202310,36,25,11,33000.23,14520,47520.23
411650,202310,6,4,2,5280,2640,7920
411660,202310,53,39,14,51480,18480,69960
411670,202310,254,166,88,219122.51,116161.49,335284.00
411680,202310,180,134,46,176881.22,60720,237601.22
411690,202310,749,390,359,516126.12,473882.79,990008.91
411695,202310,68,46,22,60720.2,29040,89760.2
411700,202310,151,114,37,150484.65,48840,199324.65
411705,202310,114,79,35,104282.03,46200.4,150482.43
411710,202310,301,197,104,260045.28,137280.87,397326.15
411720,202310,166,108,58,142562.36,76560.2,219122.56
411721,202310,99,75,24,99000.2,31680,130680.2
411722,202310,111,52,59,68641.53,77880,146521.53
411725,202310,175,126,49,166321.7,64680,231001.7
411727,202310,109,92,17,121444.31,23760.33,145204.64
411729,202310,60,47,13,62041.6,18480,80521.6
411730,202310,614,392,222,517447.65,293042.06,810489.71
411740,202310,28,18,10,23760.24,13200,36960.24
411745,202310,73,57,16,75240,21120,96360
411750,202310,960,402,558,530652.2,736563.57,1267215.77
411760,202310,1440,1048,392,1384728.11,518768.33,1903496.44
411770,202310,455,284,171,374885.34,225721.6,600606.94
411780,202310,414,268,146,353760.69,192720.21,546480.90
411790,202310,645,359,286,473893.57,378840.54,852734.11
411800,202310,180,123,57,162365.43,75240.18,237605.61
411810,202310,199,155,44,204604.52,58080.79,262685.31
411820,202310,3052,1200,1852,1584073.22,2448630.58,4032703.80
411830,202310,21,13,8,17160.19,10560,27720.19
411840,202310,2568,1467,1101,1937857.97,1455988.37,3393846.34
411845,202310,74,22,52,29040.9,68640,97680.9
411850,202310,1424,764,660,1008507.01,873847.22,1882354.23
411860,202310,72,45,27,59400.99,35640,95040.99
411870,202310,79,49,30,64680,39600,104280
411880,202310,451,270,181,356409,238922.08,595331.08
411885,202310,115,77,38,102963,50160.94,153123.94
411890,202310,371,261,110,344528.09,145201.78,489729.87
411900,202310,120,87,33,114841.04,43560,158401.04
411910,202310,246,162,84,213847.65,110881.7,324729.35
411915,202310,2859,1100,1759,1453359.59,2325866.04,3779225.63
411920,202310,116,84,32,110881.7,42240,153121.7
411925,202310,24,16,8,21120,10560,31680
411930,202310,899,598,301,789473.79,398645.03,1188118.82
411940,202310,630,386,244,509533.85,322082.29,831616.14
411950,202310,1474,686,788,905553.83,1042818.92,1948372.75
411960,202310,1247,758,489,1000576.38,646802.67,1647379.05
411965,202310,23,16,7,21120.94,9240,30360.94
411970,202310,100,85,15,112200.79,19800,132000.79
411980,202310,260,132,128,174240,168960,343200
411990,202310,6099,3182,2917,4206442.96,3853226.41,8059669.37
411995,202310,752,235,517,310209.81,682456.83,992666.64
412000,202310,377,253,124,333969.08,163681.74,497650.82
412010,202310,74,40,34,52800.9,44880.72,97681.62
412015,202310,39,29,10,38280,13200,51480
412020,202310,22,16,6,21120,7920,29040
412030,202310,42,35,7,46201.6,9240,55441.6
412033,202310,49,27,22,35641.29,29040,64681.29
412035,202310,73,49,24,64680.91,31680,96360.91
412040,202310,34,16,18,21120.97,23760,44880.97
412050,202310,222,167,55,220445.61,72600,293045.61
412060,202310,874,620,254,819748.07,336604.78,1156352.85
412065,202310,62,30,32,39602.38,42240.15,81842.53
412070,202310,161,111,50,146522.56,66000.07,212522.63
412080,202310,386,187,199,246850.45,262685.69,509536.14
412085,202310,38,14,24,18480.23,31680,50160.23
412090,202310,951,574,377,759019.49,497642.83,1256662.32
412100,202310,283,232,51,306249.31,67320,373569.31
412110,202310,76,55,21,72601.42,27720,100321.42
412120,202310,408,218,190,287767.69,250803.08,538570.77
412125,202310,77,42,35,55440.2,46200,101640.2
412130,202310,59,42,17,55442.82,22440,77882.82
412135,202310,36,21,15,27720.2,19800,47520.2
412140,202310,504,333,171,439283.97,225723.68,665007.65
412150,202310,280,165,115,217802.27,151800.73,369603.00
412160,202310,75,52,23,68642.51,30360,99002.51
412170,202310,741,475,266,627006.6,351122.91,978129.51
412175,202310,42,28,14,36960.74,18480,55440.74
412180,202310,176,132,44,174245.64,59400.2,233645.84
412190,202310,355,271,84,357725.35,110880,468605.35
412200,202310,208,118,90,155761.08,118800,274561.08
412210,202310,103,77,26,101640,34320.73,135960.73
412215,202310,258,167,91,220444.31,120120.99,340565.30
412217,202310,73,60,13,79201.21,17160,96361.21
412220,202310,979,622,357,822390.01,471250.51,1293640.52
412230,202310,322,182,140,240248.95,184806.24,425055.19
412240,202310,1510,744,766,982103,1011129.39,1993232.39
412250,202310,469,281,188,370924.95,248160,619084.95
412260,202310,148,101,47,133322.27,62040.2,195362.47
412265,202310,168,130,38,171600.83,50160,221760.83
412270,202310,99,58,41,76561.41,54120.9,130682.31
412280,202310,86,63,23,83160.2,30360,113520.2
412290,202310,100,59,41,77881.48,54120,132001.48
412300,202310,226,163,63,215161.9,83160,298321.9
412310,202310,61,47,14,62041.5,18480,80521.5
412320,202310,103,80,23,105604.16,30360,135964.16
412330,202310,218,165,53,219123.16,69960,289083.16
412340,202310,207,128,79,168962.64,104280,273242.64
412350,202310,763,340,423,448804.9,559682.52,1008487.42
412360,202310,25,19,6,25080,7920,33000
412370,202310,160,129,31,170283.92,40920.96,211204.88
412380,202310,197,143,54,188764.66,71280.71,260045.37
412382,202310,61,35,26,46200.2,34320,80520.2
412385,202310,179,124,55,163684.78,72600.92,236285.70
412390,202310,353,266,87,351133.99,114840.24,465974.23
412395,202310,74,60,14,79202.19,18480,97682.19
412400,202310,107,73,34,96362.03,44880,141242.03
412402,202310,262,143,119,188762.51,157080,345842.51
412405,202310,1041,353,688,466008.03,908162.38,1374170.41
412410,202310,1091,648,443,855394.49,587405.38,1442799.87
412420,202310,19,18,1,23760,1320,25080
412430,202310,29,26,3,34320.84,3960.2,38281.04
412440,202310,770,384,386,506887.02,509521.33,1016408.35
412450,202310,67,58,9,76560.92,11880.61,88441.53
412460,202310,90,61,29,80565.45,38280.19,118845.64
412470,202310,256,206,50,271924.52,66001.33,337925.85
412480,202310,172,125,47,165004.4,62040.2,227044.6
412490,202310,195,158,37,208561.83,48840,257401.83
412500,202310,437,341,96,450130.55,126722.47,576853.02
412510,202310,183,146,37,192723.99,48840,241563.99
412520,202310,100,67,33,88441.66,43560,132001.66
412530,202310,121,53,68,69961.63,89760,159721.63
412535,202310,58,44,14,58080.78,19800,77880.78
412540,202310,67,40,27,52801.65,35640.67,88442.32
412545,202310,98,70,28,92401.14,36960,129361.14
412550,202310,4847,1980,2867,2617789.26,3789778.91,6407568.17
412555,202310,17,8,9,10560,11880,22440
412560,202310,757,485,272,640217.43,359042.94,999260.37
412570,202310,958,413,545,545172.86,719404.73,1264577.59
412575,202310,100,72,28,95041.66,36960,132001.66
412580,202310,189,127,62,170289.08,81841.31,252130.39
412590,202310,32,29,3,38280.86,3960,42240.86
412600,202310,240,175,65,231006.69,87120.83,318127.52
412610,202310,53,22,31,29041.14,40920,69961.14
412620,202310,130,107,23,142563.04,30360.66,172923.70
412625,202310,2464,1173,1291,1548391.92,1706770.61,3255162.53
412627,202310,66,51,15,67321.87,19800,87121.87
412630,202310,405,271,134,357730.86,178200.55,535931.41
412635,202310,88,27,61,35640.9,80520,116160.9
412640,202310,119,85,34,112201.25,44880,157081.25
412650,202310,346,231,115,304924.79,151800.94,456725.73
412660,202310,603,329,274,435605.65,361680.41,797286.06
412665,202310,42,38,4,50161.04,5280,55441.04
412667,202310,279,176,103,232323.17,135960,368283.17
412670,202310,89,66,23,87120.4,30360,117480.4
412680,202310,359,271,88,359048.98,116161.1,475210.08
412690,202310,138,88,50,116162.52,66000,182162.52
412700,202310,200,123,77,162361,101640.23,264001.23
412710,202310,1512,819,693,1081101.13,916088.24,1997189.37
412720,202310,271,146,125,192723.4,165000.69,357724.09
412730,202310,183,153,30,201968.57,39600,241568.57
412740,202310,443,211,232,278524.64,306240.41,584765.05
412750,202310,428,234,194,308886.25,256080.93,564967.18
412760,202310,411,209,202,275887.91,266643.88,542531.79
412770,202310,2396,1289,1107,1701514.69,1463887.57,3165402.26
412780,202310,152,102,50,135962.48,66000.1,201962.58
412785,202310,337,179,158,236281.88,208560.02,444841.90
412788,202310,57,32,25,42240.92,33000,75240.92
412790,202310,131,104,27,137285.06,35640,172925.06
412795,202310,162,113,49,149162.28,64680,213842.28
412796,202310,321,200,121,265322.55,159720,425042.55
412800,202310,779,434,345,574204.53,456720.81,1030925.34
412810,202310,3511,1960,1551,2587672.52,2048660.12,4636332.64
412820,202310,1181,667,514,880467.73,678492.15,1558959.88
412830,202310,16,15,1,19801.1,1320,21121.1
412840,202310,257,170,87,224403.32,114840.2,339243.52
412850,202310,615,397,218,524050.06,287760.68,811810.74
412853,202310,183,79,104,104280.99,137280,241560.99
412855,202310,222,120,102,158402.05,134640.73,293042.78
412860,202310,105,70,35,92404.17,46200.91,138605.08
412862,202310,85,56,29,73920,38280,112200
412863,202310,11,7,4,9240,5280,14520
412865,202310,43,35,8,46200,10560.6,56760.6
412870,202310,134,91,43,121443.75,56761.8,178205.55
412880,202310,100,72,28,95043.68,36960,132003.68
420005,202310,49,41,8,54120.69,10560,64680.69
420010,202310,381,253,128,333965.81,170280.89,504246.70
420020,202310,103,79,24,104282.17,31680,135962.17
420030,202310,35,26,9,34320.2,11880,46200.2
420040,202310,98,76,22,100323.18,29040.2,129363.38
420050,202310,59,36,23,47520,30360,77880
420055,202310,20,17,3,22440.6,3960,26400.6
420060,202310,37,25,12,33000.41,15840.2,48840.61
420070,202310,120,105,15,138600.8,19800,158400.8
420075,202310,13,13,0,17160,,17160.0
420080,202310,47,40,7,52801.13,9240,62041.13
420090,202310,47,38,9,50160.77,11880.23,62041.00
420100,202310,179,153,26,203282.8,34320,237602.8
420110,202310,28,27,1,35640,1320,36960
420120,202310,67,49,18,64680,23760,88440
420125,202310,87,65,22,85800.83,29040,114840.83
420127,202310,39,33,6,43560,7920,51480
420130,202310,600,365,235,481816.17,310205.83,792022.00
420140,202310,1556,888,668,1172191.23,885740.03,2057931.26
420150,202310,51,38,13,50160,17160,67320
420160,202310,38,33,5,43560.87,6600,50160.87
420165,202310,18,14,4,18480.79,5280,23760.79
420170,202310,81,46,35,60720.83,46200,106920.83
420180,202310,25,23,2,30360,2640,33000
420190,202310,33,28,5,36960.18,6600,43560.18
420195,202310,161,81,80,106924.68,105602.95,212527.63
420200,202310,1569,651,918,859349.32,1214425.72,2073775.04
420205,202310,158,95,63,125403.88,83160.2,208564.08
420207,202310,180,97,83,128044.52,109561.17,237605.69
420208,202310,22,18,4,23760.21,5280,29040.21
420209,202310,15,13,2,17160,2640,19800
420210,202310,695,342,353,451451.2,467282.73,918733.93
420213,202310,54,38,16,50160.69,21120,71280.69
420215,202310,27,23,4,30360.88,5280,35640.88
420220,202310,68,43,25,56760.44,33000,89760.44
420230,202310,1184,736,448,971564.68,592690.63,1564255.31
420240,202310,2722,1802,920,2378685.41,1214410.14,3593095.55
420243,202310,50,41,9,54121.22,11880,66001.22
420245,202310,287,133,154,175567.57,203284.37,378851.94
420250,202310,70,45,25,59400.93,33000,92400.93
420253,202310,24,19,5,25080.49,6600,31680.49
420257,202310,17,10,7,13200.5,9240,22440.5
420260,202310,137,108,29,142562.82,38280.14,180842.96
420270,202310,38,27,11,35640,14520.36,50160.36
420280,202310,318,233,85,307572.77,112200.33,419773.10
420285,202310,26,20,6,26400,7920,34320
420287,202310,50,32,18,42241.42,23760,66001.42
420290,202310,1115,755,360,996616.52,475200,1471816.52
420300,202310,1777,1420,357,1877112.16,471247,2348359.16
420310,202310,48,33,15,43560.9,19800,63360.9
420315,202310,25,21,4,27720.78,5280.74,33001.52
420320,202310,1228,595,633,785423.95,839531.39,1624955.34
420325,202310,7,5,2,6600,2640.3,9240.3
420330,202310,128,86,42,113522.71,55441.03,168963.74
420340,202310,213,140,73,184802.06,96360,281162.06
420350,202310,286,204,82,269286.41,108240.73,377527.14
420360,202310,737,577,160,762985.55,211200.96,974186.51
420370,202310,148,83,65,109563.39,85800.43,195363.82
420380,202310,1402,940,462,1240842.74,609847.41,1850690.15
420390,202310,234,165,69,217804.82,91080.4,308885.22
420395,202310,209,152,57,200658.95,75242.73,275901.68
420400,202310,227,173,54,228364.08,71280,299644.08
420410,202310,60,47,13,62043.25,17160,79203.25
420415,202310,32,24,8,31680.2,10560,42240.2
420417,202310,70,54,16,71280.01,21120,92400.01
420419,202310,15,13,2,17160,2640,19800
420420,202310,3263,2030,1233,2682306.86,1627571.08,4309877.94
420425,202310,75,54,21,71285.8,27720,99005.8
420430,202310,1071,784,287,1034887.86,380162.62,1415050.48
420435,202310,14,11,3,14520,3960,18480
420440,202310,94,67,27,88441.66,35640,124081.66
420445,202310,32,29,3,38280.5,3960,42240.5
420450,202310,98,59,39,77884.99,51480,129364.99
420455,202310,210,169,41,223084.3,54120,277204.3
420460,202310,2692,1662,1030,2195250.57,1360932.55,3556183.12
420470,202310,82,53,29,69960.2,38280,108240.2
420475,202310,10,9,1,11880.46,1320,13200.46
420480,202310,1017,781,236,1030968.07,311521.68,1342489.75
420490,202310,103,75,28,99004.28,36960,135964.28
420500,202310,418,247,171,326050.11,225720.63,551770.74
420510,202310,23,19,4,25080.34,5280,30360.34
420515,202310,31,17,14,22440.29,18480,40920.29
420517,202310,11,8,3,10560.91,3960,14520.91
420519,202310,9,8,1,10560,1320,11880
420520,202310,63,44,19,58081.39,25080.2,83161.59
420530,202310,152,98,54,129361.44,71280.2,200641.64
420535,202310,17,13,4,17160.41,5280,22440.41
420540,202310,8028,4983,3045,6583389.27,4019442.73,10602832.00
420543,202310,31,30,1,39601.34,1320,40921.34
420545,202310,260,180,80,237608.18,105600.6,343208.78
420550,202310,847,718,129,947794.71,170283.35,1118078.06
420555,202310,41,31,10,40920.9,13200,54120.9
420560,202310,64,48,16,63361.34,21120,84481.34
420570,202310,280,134,146,176883.75,192722.86,369606.61
420580,202310,368,196,172,258727.25,227040.93,485768.18
420590,202310,566,355,211,469930.97,278520.62,748451.59
420600,202310,170,92,78,121440.68,102960,224400.68
420610,202310,40,36,4,47520,5280,52800
420620,202310,83,66,17,87122.92,22440.41,109563.33
420630,202310,174,121,53,159722.51,69960,229682.51
420640,202310,80,70,10,92400.8,13200,105600.8
420650,202310,372,192,180,253445.27,237600.83,491046.10
420660,202310,45,31,14,40920.45,18480,59400.45
420665,202310,54,36,18,47521.6,23760,71281.6
420670,202310,245,188,57,248167.95,75240,323407.95
420675,202310,20,15,5,19800,6600,26400
420680,202310,36,29,7,38280.12,9240,47520.12
420690,202310,222,161,61,212522.48,80520.38,293042.86
420700,202310,804,520,284,687744.4,374883.07,1062627.47
420710,202310,165,91,74,120122.35,97681.07,217803.42
420720,202310,111,84,27,110885.46,35640.39,146525.85
420730,202310,830,498,332,657380.48,438247.47,1095627.95
420740,202310,62,59,3,77881.24,3960,81841.24
420750,202310,533,354,179,467285.29,236280.97,703566.26
420757,202310,20,17,3,22440,3960,26400
420760,202310,38,27,11,35640.86,14520,50160.86
420765,202310,70,48,22,63361.14,29040,92401.14
420768,202310,58,47,11,62042.91,14520,76562.91
420770,202310,79,67,12,88441.53,15840,104281.53
420775,202310,38,31,7,40920.26,9240,50160.26
420780,202310,211,163,48,215162.33,63360,278522.33
420785,202310,28,18,10,23760,13200,36960
420790,202310,144,119,25,157082.28,33000,190082.28
420800,202310,66,53,13,69960.62,17160,87120.62
420810,202310,308,233,75,307571.74,99000,406571.74
420820,202310,3077,1730,1347,2286321.87,1782023.93,4068345.80
420830,202310,844,457,387,603266.11,512171.04,1115437.15
420840,202310,137,94,43,124080.95,58080,182160.95
420845,202310,521,232,289,306249.19,381483.94,687733.13
420850,202310,315,242,73,319443.37,96360.3,415803.67
420860,202310,62,53,9,69961.52,11880,81841.52
420870,202310,144,103,41,135960.78,54120,190080.78
420880,202310,217,137,80,180843.98,105600.3,286444.28
420890,202310,1162,601,561,793334.5,743162.01,1536496.51
420895,202310,12,11,1,14520,1320,15840
420900,202310,447,354,93,467288.48,124080.78,591369.26
420910,202310,6842,3820,3022,5046521.51,3993046.92,9039568.43
420915,202310,62,57,5,75240.2,6600,81840.2
420917,202310,27,20,7,26400.31,9240,35640.31
420920,202310,21,15,6,19800,7920,27720
420930,202310,4139,2867,1272,3784524.96,1681712.95,5466237.91
420940,202310,651,449,202,592711.19,266646.71,859357.90
420945,202310,11,8,3,10560,3960,14520
420950,202310,49,37,12,48841.23,15840,64681.23
420960,202310,118,96,22,126725.95,29040,155765.95
420970,202310,302,248,54,327372.9,71280.71,398653.61
420980,202310,24,23,1,30360,1320,31680
420985,202310,52,44,8,58081.58,10560,68641.58
420990,202310,96,72,24,95043.18,31682.76,126725.94
421000,202310,76,37,39,48840,51480,100320
421003,202310,31,22,9,29040.38,11880,40920.38
421005,202310,8,6,2,7920.3,2640,10560.3
421010,202310,968,616,352,813153.93,464645.65,1277799.58
421020,202310,20,18,2,23762.49,2640,26402.49
421030,202310,118,95,23,125401.12,30360,155761.12
421040,202310,73,57,16,75242.18,21121.05,96363.23
421050,202310,343,239,104,315482.84,137280,452762.84
421055,202310,16,13,3,17160.2,3960,21120.2
421060,202310,123,65,58,85801.65,76560,162361.65
421070,202310,34,31,3,40920.86,3960,44880.86
421080,202310,50,40,10,52800.23,13200,66000.23
421085,202310,20,14,6,18480,7920,26400
421090,202310,38,29,9,38280.11,11880,50160.11
421100,202310,127,94,33,124082.48,44880.95,168963.43
421105,202310,212,167,45,220445.73,59400.2,279845.93
421110,202310,145,98,47,129363.46,62040,191403.46
421120,202310,214,149,65,196683.77,85801.09,282484.86
421125,202310,18,11,7,14520,9240.32,23760.32
421130,202310,986,600,386,792021.6,509526.32,1301547.92
421140,202310,35,26,9,34320.32,11880,46200.32
421145,202310,45,37,8,48840.11,10560,59400.11
421150,202310,92,71,21,93722.08,27720,121442.08
421160,202310,69,46,23,60720.7,30360,91080.7
421165,202310,17,14,3,18480,3960,22440
421170,202310,180,152,28,200808.87,36960.1,237768.97
421175,202310,212,147,65,194044.83,85801.76,279846.59
421180,202310,38,22,16,29040.22,21120,50160.22
421185,202310,21,18,3,23760.18,3960,27720.18
421187,202310,5,4,1,5280,1320,6600
421189,202310,45,33,12,43561.19,15840,59401.19
421190,202310,2484,1590,894,2098888.35,1180104.55,3278992.90
421200,202310,99,71,28,93722.36,36960,130682.36
421205,202310,23,16,7,21121.01,9240,30361.01
421210,202310,191,132,59,174242.47,77880,252122.47
421220,202310,273,210,63,277202.6,83160.48,360363.08
421223,202310,51,40,11,52800.83,14520,67320.83
421225,202310,81,56,25,73921.98,33000.6,106922.58
421227,202310,73,59,14,77880.9,18480,96360.9
421230,202310,87,57,30,75242.27,39600.18,114842.45
421240,202310,17,14,3,18480.8,3960,22440.8
421250,202310,478,260,218,343209.86,287766.39,630976.25
421260,202310,23,18,5,23760.59,6600,30360.59
421265,202310,19,13,6,17161.52,7920.1,25081.62
421270,202310,56,50,6,66000,7920,73920
421280,202310,464,243,221,320770.86,291722.44,612493.30
421290,202310,320,211,109,278522.58,143880.2,422402.78
421300,202310,23,20,3,26400,3960,30360
421310,202310,53,36,17,47520,22440,69960
421315,202310,36,21,15,27721.03,19800.08,47521.11
421320,202310,143,98,45,129362.91,59400,188762.91
421330,202310,119,90,29,118801.96,38280,157081.96
421335,202310,49,35,14,46201.63,18480,64681.63
421340,202310,260,174,86,229685.19,113520.41,343205.60
421350,202310,203,124,79,163684.22,104280.33,267964.55
421360,202310,800,551,249,727334.55,330005.17,1057339.72
421370,202310,207,154,53,203283.27,69961.09,273244.36
421380,202310,163,119,44,159722.34,58080,217802.34
421390,202310,19,14,5,18480.58,6600,25080.58
421400,202310,126,99,27,130680,35640,166320
421410,202310,21,18,3,23760,3960,27720
421415,202310,21,19,2,25080,2640,27720
421420,202310,100,85,15,112201.34,19800,132001.34
421430,202310,21,13,8,17160,10560,27720
421440,202310,58,47,11,62041.5,14520.98,76562.48
421450,202310,82,65,17,85800.47,22440,108240.47
421460,202310,53,44,9,58080.66,11880,69960.66
421470,202310,86,46,40,60721.22,52800,113521.22
421480,202310,888,655,233,864617.83,308883.51,1173501.34
421490,202310,25,23,2,30360.78,2640,33000.78
421500,202310,528,302,226,398656.99,298322.55,696979.54
421505,202310,49,40,9,52800.1,11880.2,64680.3
421507,202310,34,27,7,35640.6,9240,44880.6
421510,202310,63,41,22,54122.46,29040,83162.46
421520,202310,49,41,8,54120.98,10560,64680.98
421530,202310,58,49,9,64681.28,11880,76561.28
421535,202310,23,21,2,27721.29,2640,30361.29
421540,202310,49,41,8,54120.2,10560,64680.2
421545,202310,95,63,32,83164.97,42240.63,125405.60
421550,202310,323,234,89,311539.17,117480.99,429020.16
421555,202310,19,17,2,22441.56,2640,25081.56
421560,202310,9,7,2,9240,2640,11880
421565,202310,141,88,53,117483.91,69960.57,187444.48
421567,202310,42,30,12,39600,15840,55440
421568,202310,38,37,1,48840,1320,50160
421569,202310,11,10,1,13200.79,1320,14520.79
421570,202310,294,189,105,250805.33,138601.51,389406.84
421575,202310,28,26,2,34320.48,2640,36960.48
421580,202310,802,472,330,623146.08,436923.13,1060069.21
421590,202310,23,21,2,27720.2,2640,30360.2
421600,202310,189,138,51,182160.73,67320,249480.73
421605,202310,117,79,38,104282.23,50160.21,154442.44
421610,202310,178,127,51,167640.99,67320,234960.99
421620,202310,1195,686,509,906873.99,671886.56,1578760.55
421625,202310,23,20,3,26400,3960,30360
421630,202310,389,239,150,315493.13,198006.61,513499.74
421635,202310,32,18,14,23760.9,18480,42240.9
421640,202310,118,92,26,121443.95,34320,155763.95
421650,202310,359,211,148,279850.12,195363.14,475213.26
421660,202310,3153,1935,1218,2555605.11,1609102.24,4164707.35
421670,202310,163,116,47,153123.62,62040,215163.62
421680,202310,209,185,24,244205.56,31680,275885.56
421690,202310,382,256,126,337929.56,166321.26,504250.82
421700,202310,57,41,16,54120,21120,75240
421710,202310,25,25,0,33000.33,,33000.33
421715,202310,5,4,1,5281.62,1320,6601.62
421720,202310,697,460,237,608535.5,314161.13,922696.63
421725,202310,39,16,23,21120.25,30360.8,51481.05
421730,202310,22,18,4,23760,5280,29040
421740,202310,130,57,73,75240.89,96360,171600.89
421750,202310,202,144,58,190081.26,76560,266641.26
421755,202310,20,19,1,25080,1320,26400
421760,202310,116,83,33,109563.01,43560.19,153123.20
421770,202310,765,491,274,648141.03,361683.1,1009824.13
421775,202310,29,19,10,25080.97,13200.09,38281.06
421780,202310,201,151,50,199321.79,66000,265321.79
421790,202310,156,135,21,178201.54,29040.72,207242.26
421795,202310,17,13,4,17160.33,5280,22440.33
421800,202310,653,394,259,520107.93,341885.29,861993.22
421810,202310,73,61,12,80521.08,15840,96361.08
421820,202310,351,226,125,298326.99,165000,463326.99
421825,202310,182,152,30,201967.77,39600,241567.77
421830,202310,187,119,68,157089.07,89761.14,246850.21
421835,202310,7,3,4,3960.43,5280,9240.43
421840,202310,48,40,8,52801.6,10560.71,63362.31
421850,202310,80,65,15,85800.5,19800,105600.5
421860,202310,39,27,12,35640.73,15840,51480.73
421870,202310,1332,947,385,1251411.47,509530,1760941.47
421875,202310,52,40,12,52800,15840,68640
421880,202310,217,155,62,204603.21,81840.7,286443.91
421885,202310,20,15,5,19800,6600.84,26400.84
421890,202310,187,132,55,175567.07,72601.13,248168.20
421895,202310,55,48,7,63360.52,9240,72600.52
421900,202310,140,104,36,137288.21,47520,184808.21
421910,202310,77,47,30,62040.91,39600,101640.91
421915,202310,33,27,6,35640,7920,43560
421917,202310,56,43,13,56760.91,17160,73920.91
421920,202310,39,34,5,44880,6600,51480
421930,202310,684,546,138,722061.88,182162.07,904223.95
421935,202310,47,37,10,48840,13200,62040
421940,202310,57,49,8,64680,10560,75240
421950,202310,1003,672,331,889693.08,436923.71,1326616.79
421960,202310,45,37,8,48840,10560,59400
421970,202310,340,211,129,278525.64,170281.39,448807.03
421985,202310,20,13,7,17160.2,9240,26400.2
422000,202310,20,12,8,15840.5,10560,26400.5
430003,202310,206,63,143,83160.6,188760,271920.6
430005,202310,31,24,7,31680.53,9240,40920.53
430010,202310,270,199,71,262684.36,93720,356404.36
430020,202310,143,102,41,134641.49,54120.24,188761.73
430030,202310,138,109,29,143881.93,38280,182161.93
430040,202310,3187,1875,1312,2475047.43,1731843.34,4206890.77
430045,202310,83,74,9,97680,11880,109560
430047,202310,6,5,1,6600,1320,7920
430050,202310,93,78,15,102961.28,19800,122761.28
430055,202310,15,13,2,17160,2640,19800
430057,202310,7,5,2,6600,2640,9240
430060,202310,4821,2818,2003,3721235.57,2645307.93,6366543.50
430063,202310,63,49,14,64680,18480,83160
430064,202310,175,141,34,186120.77,44880,231000.77
430066,202310,8,5,3,6600,3960,10560
430070,202310,42,34,8,44880.28,10560,55440.28
430080,202310,85,57,28,75240.45,36960.18,112200.63
430085,202310,29,15,14,19800,18480,38280
430087,202310,45,34,11,44880.4,14520,59400.4
430090,202310,68,57,11,75240.6,14520,89760.6
430100,202310,168,116,52,153121.06,68640,221761.06
430105,202310,208,122,86,161046.53,113520.3,274566.83
430107,202310,23,19,4,25080.31,5280,30360.31
430110,202310,524,284,240,376200.78,316800,693000.78
430120,202310,197,181,16,238920.88,21120,260040.88
430130,202310,874,516,358,681131.79,473882.45,1155014.24
430140,202310,149,135,14,178200,18480,196680
430150,202310,117,74,43,97680.96,58080,155760.96
430155,202310,30,26,4,34320,5280,39600
430160,202310,4144,2316,1828,3057194.01,2414295.63,5471489.64
430163,202310,505,238,267,315488.85,352443.38,667932.23
430165,202310,32,19,13,25080.59,17160,42240.59
430170,202310,86,71,15,93720,19800,113520
430175,202310,91,73,18,96360,23760,120120
430180,202310,113,86,27,113520.26,35640,149160.26
430185,202310,31,23,8,30360,10560,40920
430187,202310,109,43,66,56761.21,87120,143881.21
430190,202310,258,130,128,171603.59,168962.3,340565.89
430192,202310,13,10,3,13200.73,3960,17160.73
430195,202310,19,15,4,19800.9,5280,25080.9
430200,202310,166,138,28,182163.73,36960,219123.73
430205,202310,20,20,0,26400,,26400.0
430210,202310,884,657,227,867300.75,299640.7,1166941.45
430215,202310,13,12,1,15840,1320,17160
430220,202310,80,54,26,71280,34320,105600
430222,202310,15,4,11,5280,14520,19800
430223,202310,18,13,5,17160,6600,23760
430225,202310,5,3,2,3960,2640,6600
430230,202310,385,237,148,312843.1,195360,508203.1
430235,202310,53,35,18,46200.89,23760,69960.89
430237,202310,21,16,5,21120,6600,27720
430240,202310,124,82,42,108241.49,55440,163681.49
430245,202310,72,60,12,79200,15840,95040
430250,202310,192,113,79,149161.67,104280,253441.67
430258,202310,14,11,3,14520.28,3960.2,18480.48
430260,202310,40,37,3,48840.1,3960,52800.1
430265,202310,42,36,6,47520,7920,55440
430270,202310,583,405,178,534617.02,234960,769577.02
430280,202310,1185,679,506,896336.63,667920.3,1564256.93
430290,202310,482,248,234,328687.45,308880,637567.45
430300,202310,2433,1340,1093,1771490.46,1442774.92,3214265.38
430310,202310,2475,1238,1237,1635556.05,1635508.09,3271064.14
430320,202310,69,56,13,73920,17160,91080
430330,202310,98,84,14,110880.1,18480,129360.1
430340,202310,77,62,15,81840,19800,101640
430350,202310,1838,1138,700,1502178.6,925321.75,2427500.35
430355,202310,20,18,2,23760,2640,26400
430360,202310,115,62,53,81840,69960,151800
430367,202310,54,39,15,51480,19800,71280
430370,202310,65,57,8,75240.29,10560,85800.29
430380,202310,112,79,33,104281.54,43560,147841.54
430390,202310,741,448,293,591292.59,386763.79,978056.38
430400,202310,271,185,86,244200.07,113520,357720.07
430410,202310,57,48,9,63360.2,11880,75240.2
430420,202310,593,388,205,512172.57,271921.49,784094.06
430430,202310,50,46,4,59840.88,5280,65120.88
430435,202310,160,113,47,150480.63,62040,212520.63
430440,202310,708,427,281,563650.34,370924.64,934574.98
430450,202310,1374,1129,245,1490299.64,324720.9,1815020.54
430460,202310,6825,3509,3316,4636083.67,4381133.58,9017217.25
430461,202310,20,18,2,23760,2640,26400
430462,202310,8,6,2,7920.1,2640,10560.1
430463,202310,1468,807,661,1065266.79,872526.66,1937793.45
430465,202310,27,17,10,22440,13200,35640
430466,202310,855,597,258,788116.56,340565.26,1128681.82
430467,202310,145,78,67,102960.2,88440,191400.2
430468,202310,179,103,76,135961.5,100320.88,236282.38
430469,202310,22,15,7,19800.2,9240,29040.2
430470,202310,1294,707,587,934969.81,776165.98,1711135.79
430471,202310,87,62,25,81843.5,33000.57,114844.07
430480,202310,160,113,47,149161.83,62040,211201.83
430485,202310,8,8,0,10560,,10560.0
430490,202310,74,58,16,76560,21120,97680
430495,202310,37,26,11,34320.2,14520,48840.2
430500,202310,205,138,67,182160,88440,270600
430510,202310,4434,2839,1595,3750187.37,2108052.09,5858239.46
430511,202310,15,14,1,18480,1320,19800
430512,202310,194,131,63,172922.87,83160.4,256083.27
430513,202310,62,46,16,60720,21120,81840
430515,202310,24,22,2,29040,2640,31680
430517,202310,193,163,30,215160.2,39600,254760.2
430520,202310,357,252,105,332643.96,138600.26,471244.22
430530,202310,89,48,41,63360.7,54120,117480.7
430535,202310,521,323,198,426366.18,261364.37,687730.55
430537,202310,9,9,0,11880,,11880.0
430540,202310,81,57,24,75240,31680,106920
430543,202310,479,153,326,201961.1,430320.71,632281.81
430544,202310,53,48,5,63360.61,6600,69960.61
430545,202310,509,248,261,327378.86,345850.72,673229.58
430550,202310,45,36,9,47520.14,11880,59400.14
430558,202310,2,2,0,2640,,2640.0
430560,202310,51,30,21,39600,27720,67320
430570,202310,124,53,71,69962.18,93720,163682.18
430580,202310,131,106,25,139920.47,33000,172920.47
430583,202310,14,14,0,18480,,18480.0
430585,202310,15,11,4,14520.88,5280,19800.88
430587,202310,15,11,4,14520,5280,19800
430590,202310,211,170,41,224401.55,54120,278521.55
430593,202310,1,1,0,1320,,1320.0
430595,202310,18,14,4,18480,5280,23760
430597,202310,45,27,18,35640.77,23760,59400.77
430600,202310,237,171,66,225720,87120,312840
430605,202310,201,117,84,154440,110880,265320
430607,202310,34,27,7,35640,9240,44880
430610,202310,1963,948,1015,1252696.97,1342442.7,2595139.67
430613,202310,5,5,0,6600,,6600.0
430620,202310,105,74,31,97680.56,40920,138600.56
430630,202310,48,41,7,54121.13,9240,63361.13
430632,202310,32,29,3,39600,3960,43560
430635,202310,38,31,7,40920,9240,50160
430637,202310,74,34,40,44880,52800,97680
430640,202310,180,108,72,142564.23,96360.54,238924.77
430642,202310,18,15,3,19800,3960,23760
430645,202310,34,27,7,35640,9240,44880
430650,202310,248,197,51,260042.28,67321.15,327363.43
430655,202310,18,15,3,19800,3960,23760
430660,202310,1087,534,553,706214.81,729967.3,1436182.11
430670,202310,71,50,21,66000,27720,93720
430673,202310,93,62,31,81840.2,40920,122760.2
430675,202310,9,7,2,9240,2640,11880
430676,202310,759,471,288,621834.48,380162.81,1001997.29
430680,202310,279,186,93,245522.69,124080,369602.69
430690,202310,613,375,238,495008.85,314161.78,809170.63
430692,202310,6,5,1,6600.7,1320,7920.7
430693,202310,145,94,51,124082.39,67320.2,191402.59
430695,202310,74,55,19,72600,25080,97680
430697,202310,71,43,28,58080,36960,95040
430700,202310,1471,993,478,1310779.28,632281,1943060.28
430705,202310,36,30,6,39600.7,7920,47520.7
430710,202310,275,173,102,228360,134640,363000
430720,202310,99,81,18,106920,23760,130680
430730,202310,163,139,24,183480.43,31680,215160.43
430740,202310,92,59,33,77880.3,43560,121440.3
430745,202310,31,18,13,23760,17160,40920
430750,202310,333,212,121,279842.53,159720.6,439563.13
430755,202310,84,48,36,63360.31,47520,110880.31
430760,202310,480,260,220,344527.63,290401.66,634929.29
430770,202310,1959,1088,871,1438850.77,1151046.42,2589897.19
430780,202310,390,247,143,326041.01,190080,516121.01
430781,202310,25,25,0,33000,,33000.0
430783,202310,67,48,19,63360,25080.9,88440.9
430786,202310,8,6,2,7920,2640,10560
430790,202310,594,366,228,483129.96,300962.4,784092.36
430800,202310,171,124,47,165000.2,62040,227040.2
430805,202310,40,30,10,39600,13200,52800
430807,202310,84,51,33,67320,43560,110880
430810,202310,86,57,29,75241.36,38280,113521.36
430820,202310,171,113,58,149163.04,76560,225723.04
430825,202310,11,9,2,11880,2640,14520
430830,202310,295,269,26,355082.98,34320,389402.98
430840,202310,156,105,51,138600.7,67320,205920.7
430843,202310,8,5,3,6600,3960,10560
430845,202310,84,48,36,63360,47520,110880
430850,202310,630,442,188,583446.4,248160,831606.4
430860,202310,198,134,64,176881.64,84480.82,261362.46
430865,202310,83,44,39,58080.5,51480,109560.5
430870,202310,71,58,13,76560.61,18480,95040.61
430880,202310,192,132,60,174243.67,79200.8,253444.47
430885,202310,11,9,2,11880,2640,14520
430890,202310,352,216,136,285122.35,179520,464642.35
430900,202310,568,389,179,513486.63,236280.06,749766.69
430905,202310,169,80,89,105601.04,117480.54,223081.58
430910,202310,330,177,153,233643.04,203280.8,436923.84
430912,202310,5,5,0,6600.03,,6600.03
430915,202310,43,40,3,52800,3960,56760
430920,202310,5542,2891,2651,3817596.84,3499371.88,7316968.72
430925,202310,6,6,0,7920,,7920.0
430930,202310,2452,1388,1064,1832200.77,1407123.79,3239324.56
430940,202310,294,187,107,246840,142560.4,389400.4
430950,202310,168,136,32,179521.21,42240,221761.21
430955,202310,31,20,11,26400.7,14520,40920.7
430957,202310,26,24,2,31680.11,2640,34320.11
430960,202310,293,195,98,257402.89,129360.05,386762.94
430965,202310,119,78,41,102960,54120,157080
430970,202310,96,76,20,101640,26400,128040
430975,202310,57,48,9,63360.6,11880,75240.6
430980,202310,57,35,22,46200.69,29040,75240.69
430990,202310,101,80,21,105600,27720,133320
430995,202310,124,112,12,147840,15840,163680
431000,202310,310,156,154,205921.71,203324,409245.71
431010,202310,407,244,163,322096.53,215162.79,537259.32
431020,202310,2128,1229,899,1623624.24,1186681.96,2810306.20
431030,202310,45,35,10,46200,13200,59400
431033,202310,571,266,305,351142.57,402614.9,753757.47
431036,202310,10,7,3,9240,3960,13200
431040,202310,164,111,53,146520.6,69960,216480.6
431041,202310,48,30,18,39600,23760,63360
431043,202310,42,25,17,33000.42,22440,55440.42
431046,202310,12,9,3,11880,3960,15840
431050,202310,221,142,79,187441.96,104280.2,291722.16
431053,202310,88,51,37,67321.35,50161.26,117482.61
431055,202310,69,44,25,58080,33000,91080
431057,202310,21,21,0,27720,,27720.0
431060,202310,1730,1097,633,1448056.41,835562.44,2283618.85
431065,202310,21,12,9,15840,11880,27720
431070,202310,66,57,9,75240,11880,87120
431075,202310,8,8,0,10560,,10560.0
431080,202310,142,79,63,104282.14,83160,187442.14
431085,202310,39,35,4,46200.2,5280,51480.2
431087,202310,19,15,4,19800,5280,25080
431090,202310,48,37,11,48840.5,14520,63360.5
431100,202310,1408,830,578,1095622.33,762962.98,1858585.31
431110,202310,233,146,87,192723.57,114840,307563.57
431112,202310,33,24,9,31680.67,11880,43560.67
431113,202310,30,17,13,23760.28,17160,40920.28
431115,202310,156,114,42,150481.48,55440,205921.48
431120,202310,653,389,264,513487.35,348480.78,861968.13
431123,202310,5,5,0,6600,,6600.0
431125,202310,101,90,11,118800,14520,133320
431127,202310,7,5,2,6600,2640,9240
431130,202310,762,492,270,649449.81,356404.07,1005853.88
431140,202310,915,647,268,855368.48,355082.47,1210450.95
431142,202310,17,15,2,19800.56,2640,22440.56
431150,202310,216,148,68,195361.86,89760,285121.86
431160,202310,42,37,5,48840.9,6600,55440.9
431162,202310,7,7,0,9240.65,,9240.65
431164,202310,8,6,2,7920,2640,10560
431170,202310,123,85,38,112200.2,50160,162360.2
431171,202310,75,44,31,58080,40920,99000
431173,202310,10,9,1,11880,1320.8,13200.8
431175,202310,215,114,101,150481.66,133320.22,283801.88
431177,202310,124,82,42,108241.5,55440.31,163681.81
431179,202310,19,13,6,17160,7920,25080
431180,202310,440,272,168,359045.4,221760,580805.4
431190,202310,75,55,20,72600.4,26400.7,99001.1
431198,202310,82,59,23,77743.54,30360,108103.54
431200,202310,24,18,6,23760,7920,31680
431205,202310,24,23,1,30361.1,1320,31681.1
431210,202310,116,70,46,92400.7,60720,153120.7
431213,202310,32,27,5,35640,6600.56,42240.56
431215,202310,27,25,2,33000.64,2640,35640.64
431217,202310,7,6,1,7920,1320,9240
431220,202310,71,58,13,76561.05,17160,93721.05
431225,202310,180,108,72,142560.24,95040,237600.24
431230,202310,110,85,25,112203.32,33000,145203.32
431235,202310,6,4,2,5280,2640,7920
431237,202310,22,18,4,23760,5280,29040
431238,202310,16,11,5,14520,6600.2,21120.2
431240,202310,1132,708,424,934589.31,562322.41,1496911.72
431242,202310,45,43,2,56760,2640,59400
431244,202310,44,34,10,44880.82,13200,58080.82
431245,202310,61,46,15,60720.01,19800,80520.01
431247,202310,19,11,8,14520,10560,25080
431250,202310,332,166,166,219122.78,219120,438242.78
431260,202310,55,45,10,59400,13200,72600
431261,202310,24,17,7,22440.84,9240,31680.84
431262,202310,13,11,2,14520,2640,17160
431265,202310,155,93,62,122761.47,81840,204601.47
431267,202310,22,17,5,22440,6600,29040
431270,202310,358,271,87,357723.07,114842.35,472565.42
431275,202310,40,36,4,47520,5280,52800
431280,202310,21,16,5,21120,6600,27720
431290,202310,29,26,3,34320.39,3960,38280.39
431295,202310,4,1,3,1320,3960,5280
431300,202310,25,19,6,25080.6,7920,33000.6
431301,202310,8,8,0,10560,,10560.0
431303,202310,65,40,25,52800,33000,85800
431306,202310,256,128,128,168961.45,168960,337921.45
431308,202310,8,7,1,9240.6,1320,10560.6
431310,202310,62,48,14,63360.16,18480,81840.16
431320,202310,289,178,111,234961.32,146520,381481.32
431330,202310,238,167,71,220443.48,93720,314163.48
431333,202310,29,23,6,30360,7920,38280
431335,202310,11,8,3,10560.39,3960,14520.39
431337,202310,487,240,247,316811.55,326045.18,642856.73
431339,202310,24,20,4,26400,5280,31680
431340,202310,3593,1965,1628,2595122.42,2151612.51,4746734.93
431342,202310,42,27,15,35640,19800,55440
431344,202310,29,29,0,38280,,38280.0
431346,202310,5,4,1,5280,1320,6600
431349,202310,32,30,2,39600,2640,42240
431350,202310,1093,624,469,823711.77,619084.56,1442796.33
431360,202310,61,43,18,56760,23760,80520
431365,202310,409,176,233,233643.16,307560.49,541203.65
431370,202310,1324,752,572,992662.79,757684.66,1750347.45
431380,202310,107,93,14,122761.7,18480,141241.7
431390,202310,536,304,232,401282.86,307561.1,708843.96
431395,202310,342,151,191,199321.37,252120,451441.37
431400,202310,38,23,15,30360,21120,51480
431402,202310,92,67,25,88441.82,33000.71,121442.53
431403,202310,32,22,10,29040,13200,42240
431405,202310,847,509,338,671899.97,446164.92,1118064.89
431406,202310,39,32,7,43560.14,9240,52800.14
431407,202310,52,41,11,54120,14520,68640
431410,202310,3888,2386,1502,3149612.48,1982661.57,5132274.05
431413,202310,15,12,3,15840,3960,19800
431415,202310,81,60,21,79200.6,27720,106920.6
431417,202310,26,15,11,19800,14520,34320
431420,202310,403,264,139,348485.46,183480.9,531966.36
431430,202310,71,33,38,43561.03,50160,93721.03
431440,202310,10588,7120,3468,9405373.73,4583149.94,13988523.67
431442,202310,27,14,13,18480,17160,35640
431445,202310,31,29,2,38280,2640,40920
431446,202310,5,5,0,6600.71,,6600.71
431447,202310,90,68,22,89760.16,29040,118800.16
431449,202310,68,56,12,73920.28,15840,89760.28
431450,202310,449,295,154,389402.61,203280,592682.61
431454,202310,13,8,5,10560,6600,17160
431455,202310,49,37,12,48840.03,15840,64680.03
431460,202310,535,363,172,479211.85,227040,706251.85
431470,202310,143,105,38,138600.25,50160,188760.25
431475,202310,12,10,2,13200,2640,15840
431477,202310,42,26,16,34320.58,21120,55440.58
431478,202310,7,7,0,9240,,9240.0
431480,202310,817,501,316,661335.63,417123.13,1078458.76
431490,202310,35760,20217,15543,26704400.88,20538160.84,47242561.72
431500,202310,80,57,23,75240,30360,105600
431505,202310,32,24,8,31680.85,10560,42240.85
431507,202310,9,8,1,10560,1320,11880
431510,202310,245,177,68,233641.5,89760,323401.5
431513,202310,20,19,1,25082.06,1320,26402.06
431514,202310,8,5,3,6600,3960,10560
431515,202310,90,76,14,100320.17,18480,118800.17
431517,202310,9,7,2,9240,2640,11880
431520,202310,41,33,8,43560.2,10560,54120.2
431530,202310,1498,662,836,875171.9,1104841.13,1980013.03
431531,202310,24,22,2,30360.7,2640,33000.7
431532,202310,42,29,13,38280,17160,55440
431535,202310,31,18,13,23760,17160,40920
431540,202310,150,121,29,159722.88,38280,198002.88
431545,202310,12,9,3,11880,3960,15840
431550,202310,394,201,193,265325.2,254761.9,520087.1
431555,202310,19,16,3,21120.2,3960,25080.2
431560,202310,5660,3791,1869,5010920.07,2473726.96,7484647.03
431570,202310,984,531,453,700930.8,597965.01,1298895.81
431575,202310,61,39,22,51480.45,30360,81840.45
431580,202310,89,66,23,87120,30360,117480
431590,202310,155,130,25,171600,34320,205920
431595,202310,17,15,2,19800.8,2640,22440.8
431600,202310,279,165,114,217806.62,150482.13,368288.75
431610,202310,125,92,33,121441.77,43560.2,165001.97
431620,202310,35,28,7,36960,9240,46200
431630,202310,128,101,27,133320.79,35640,168960.79
431640,202310,1402,864,538,1140495.69,711481.86,1851977.55
431642,202310,34,29,5,38280,6600,44880
431643,202310,45,18,27,23760,35640,59400
431645,202310,358,214,144,282481.09,190080,472561.09
431647,202310,15,14,1,18480,1320,19800
431650,202310,35,20,15,26400,19800,46200
431660,202310,260,165,95,217801.43,125400,343201.43
431670,202310,252,110,142,145201.6,187440.49,332642.09
431673,202310,14,12,2,15840,2640,18480
431675,202310,29,22,7,29040,9240,38280
431680,202310,1343,969,374,1279131.07,493686.73,1772817.80
431690,202310,5686,3295,2391,4350942.8,3158800.74,7509743.54
431695,202310,17,11,6,14520.2,7920,22440.2
431697,202310,7,5,2,6600,2640,9240
431700,202310,208,154,54,203280.55,71280,274560.55
431710,202310,4634,1982,2652,2617598.98,3504616.55,6122215.53
431720,202310,1390,864,526,1139836.26,695640.83,1835477.09
431725,202310,3,1,2,1320,2640,3960
431730,202310,1334,862,472,1137895.12,623049.39,1760944.51
431740,202310,1398,679,719,896294.38,949084.26,1845378.64
431750,202310,1959,1288,671,1700190.06,887044.45,2587234.51
431755,202310,5,4,1,5280,1320,6600
431760,202310,1074,689,385,910822.71,512164.85,1422987.56
431770,202310,438,285,153,376202.57,201960,578162.57
431775,202310,27,19,8,25080,10560,35640
431780,202310,613,368,245,485762.58,323400,809162.58
431790,202310,149,118,31,155762.67,40920.1,196682.77
431795,202310,14,12,2,15840,2640,18480
431800,202310,3372,1760,1612,2323237.54,2127850.09,4451087.63
431805,202310,21,16,5,21120,6600,27720
431810,202310,599,389,210,513488.23,277200,790688.23
431820,202310,385,216,169,285121.68,223080.2,508201.88
431830,202310,2620,1604,1016,2118557.11,1345082.62,3463639.73
431840,202310,553,355,198,468614.51,261360.67,729975.18
431842,202310,37,29,8,38280,10560,48840
431843,202310,9,7,2,9240.9,2640,11880.9
431844,202310,19,14,5,18480,6600,25080
431845,202310,28,26,2,34320,2640,36960
431846,202310,29,24,5,31680.72,6600,38280.72
431848,202310,14,11,3,14520,3960,18480
431849,202310,8,7,1,9240,1320,10560
431850,202310,902,706,196,931945.3,258722.52,1190667.82
431860,202310,122,79,43,104280.48,56760,161040.48
431861,202310,4,0,4,,5280,5280.0
431862,202310,67,47,20,62040.65,26400,88440.65
431870,202310,4396,2602,1794,3441375.26,2370753.47,5812128.73
431880,202310,1090,766,324,1012499.84,427681.29,1440181.13
431890,202310,1329,765,564,1009813.48,745801.08,1755614.56
431900,202310,208,135,73,178200.24,97680,275880.24
431910,202310,50,39,11,52800.1,14520,67320.1
431912,202310,57,40,17,52800.08,22440,75240.08
431915,202310,163,126,37,166320.75,48840,215160.75
431920,202310,165,116,49,154440.35,64680,219120.35
431930,202310,84,68,16,89760,21120,110880
431935,202310,5,4,1,5280,1320,6600
431936,202310,4,4,0,5280,,5280.0
431937,202310,22,17,5,22440.2,6600,29040.2
431940,202310,492,342,150,451448.33,198000.19,649448.52
431950,202310,529,331,198,436933.43,261361.36,698294.79
431960,202310,810,449,361,592692.47,476520,1069212.47
431970,202310,65,59,6,77880,7920,85800
431971,202310,6,5,1,6600,1320,7920
431973,202310,20,17,3,22440.88,3960,26400.88
431975,202310,12,11,1,14520.2,1320,15840.2
431980,202310,227,132,95,174240.28,125400,299640.28
431990,202310,1114,621,493,819746.82,650770.64,1470517.46
432000,202310,2302,1270,1032,1677794.47,1362258.31,3040052.78
432010,202310,266,172,94,227041.29,125400.67,352441.96
432020,202310,209,176,33,232324.12,43560.4,275884.52
432023,202310,17,15,2,19800,2640,22440
432026,202310,69,61,8,80520,10560,91080
432030,202310,57,26,31,34321.09,40920,75241.09
432032,202310,15,12,3,15840,3960,19800
432035,202310,88,66,22,88440,29040,117480
432040,202310,92,66,26,87121.34,34320,121441.34
432045,202310,4,4,0,5280,,5280.0
432050,202310,85,53,32,71280.69,42240,113520.69
432055,202310,147,103,44,135961.56,58080,194041.56
432057,202310,7,4,3,5280,3960,9240
432060,202310,30,25,5,33000,6600,39600
432065,202310,31,26,5,34320,6600,40920
432067,202310,83,74,9,97680.4,11880,109560.4
432070,202310,417,332,85,438244.26,112200,550444.26
432080,202310,909,646,263,852755.15,347163.84,1199918.99
432085,202310,24,20,4,26400,5280,31680
432090,202310,295,196,99,260040.4,132000.33,392040.73
432100,202310,186,121,65,159720.21,85800,245520.21
432110,202310,612,404,208,533286.39,274560.04,807846.43
432120,202310,1190,676,514,895021.54,678482.42,1573503.96
432130,202310,577,407,170,537245.84,224400,761645.84
432132,202310,21,19,2,25080,2640,27720
432135,202310,84,64,20,84480.66,26400,110880.66
432140,202310,292,218,74,287761.89,97680,385441.89
432143,202310,252,155,97,205922.21,128040.24,333962.45
432145,202310,351,249,102,328683.6,134640,463323.6
432146,202310,18,16,2,21120,2640,23760
432147,202310,103,64,39,84480,51480,135960
432149,202310,14,13,1,17160,1320,18480
432150,202310,1267,808,459,1067906.08,605881.91,1673787.99
432160,202310,2316,1184,1132,1564231.38,1494254.43,3058485.81
432162,202310,8,4,4,5280,5280,10560
432163,202310,17,12,5,15840,6600,22440
432166,202310,146,103,43,136294.05,56761.23,193055.28
432170,202310,257,136,121,179527.84,159720.9,339248.74
432180,202310,610,396,214,522720.87,282480,805200.87
432183,202310,22,18,4,23760.85,5280,29040.85
432185,202310,85,71,14,93721.03,18480,112201.03
432190,202310,595,355,240,468603.04,316800.44,785403.48
432195,202310,100,79,21,104281.3,27720,132001.3
432200,202310,498,309,189,407887.3,250801.9,658689.2
432210,202310,124,73,51,96360.52,67320,163680.52
432215,202310,34,32,2,42240,2640,44880
432218,202310,21,21,0,27720,,27720.0
432220,202310,713,354,359,467291.69,473883.29,941174.98
432225,202310,21,16,5,21120.2,6600,27720.2
432230,202310,131,85,46,112200,60720.3,172920.3
432232,202310,36,32,4,43560.2,5280,48840.2
432234,202310,5,3,2,3960,2640,6600
432235,202310,2,2,0,2640,,2640.0
432237,202310,25,18,7,23760,9240,33000
432240,202310,5009,2801,2208,3701379.5,2914588.75,6615968.25
432250,202310,1306,887,419,1170896.47,554400.63,1725297.10
432252,202310,50,45,5,59400,6600,66000
432253,202310,82,62,20,81841.7,26400,108241.7
432254,202310,32,16,16,21120,21120,42240
432255,202310,11,10,1,13200,1320,14520
432260,202310,978,781,197,1030942.6,260040.1,1290982.7
432270,202310,250,188,62,248173.17,81842.83,330016.00
432280,202310,188,142,46,187443.82,60720,248163.82
432285,202310,2,2,0,2640,,2640.0
432290,202310,61,49,12,64680,15840,80520
432300,202310,5887,3208,2679,4243667.79,3540269.79,7783937.58
432310,202310,144,120,24,158401.43,31680,190081.43
432320,202310,24,18,6,23760,7920,31680
432330,202310,17,11,6,14520,7920,22440
432335,202310,10,7,3,9240,3960,13200
432340,202310,36,29,7,38280,9240,47520
432345,202310,137,94,43,124082.32,56760,180842.32
432350,202310,24,23,1,30360,1320,31680
432360,202310,6,5,1,6600.7,1320,7920.7
432370,202310,27,27,0,35640.2,,35640.2
432375,202310,31,29,2,38280,2640,40920
432377,202310,7,7,0,9240.48,,9240.48
432380,202310,263,125,138,165002.59,182163.8,347166.39
500020,202310,333,171,162,227042.54,213840,440882.54
500025,202310,157,75,82,99001.74,108241.12,207242.86
500060,202310,1688,1087,601,1434887.29,794648.64,2229535.93
500070,202310,853,430,423,567614.24,558371,1125985.24
500080,202310,159,131,28,172924.3,38280,211204.3
500085,202310,172,125,47,166323.73,62040,228363.73
500090,202310,430,203,227,267966.56,299642.25,567608.81
500100,202310,751,391,360,516132.7,475200.98,991333.68
500110,202310,2534,1258,1276,1663252.53,1685658.03,3348910.56
500124,202310,310,156,154,205920.58,203280.67,409201.25
500150,202310,338,138,200,182162.16,264000.65,446162.81
500190,202310,638,430,208,567623.57,274562.01,842185.58
500200,202310,223,181,42,238923.46,55440,294363.46
500210,202310,1884,591,1293,780132.38,1708091.22,2488223.60
500215,202310,218,127,91,167646.37,120120.2,287766.57
500220,202310,807,502,305,662665.04,402602.73,1065267.77
500230,202310,271,154,117,203282.97,154441.34,357724.31
500240,202310,719,441,278,582135.37,369602.2,951737.57
500260,202310,645,266,379,351124.87,500280.46,851405.33
500270,202310,35099,15555,19544,20545883.65,25822182.11,46368065.76
500280,202310,218,79,139,104280.98,183480.66,287761.64
500290,202310,1302,818,484,1079788.46,638883.79,1718672.25
500295,202310,551,365,186,483128.8,245521.09,728649.89
500310,202310,126,42,84,55440,110880.5,166320.5
500315,202310,955,522,433,689040.94,571562.56,1260603.50
500320,202310,4239,1985,2254,2620297.76,2975293.18,5595590.94
500325,202310,1048,593,455,782787.91,600603.7,1383391.61
500330,202310,1716,861,855,1140434.85,1132572.6,2273007.45
500345,202310,351,241,110,318125.28,145200.21,463325.49
500348,202310,280,169,111,224403.9,146520,370923.9
500350,202310,110,50,60,66002.17,79201.15,145203.32
500370,202310,6547,3037,3510,4013177.64,4634550.64,8647728.28
500375,202310,400,262,138,345842.69,183480.82,529323.51
500380,202310,750,415,335,547817.3,442202.23,990019.53
500390,202310,89,37,52,48840.1,69960.2,118800.3
500400,202310,247,144,103,190085.9,135960.97,326046.87
500410,202310,467,216,251,285130.52,331324.09,616454.61
500430,202310,678,411,267,543414.79,352442.13,895856.92
500440,202310,218,127,91,167641.36,120120.2,287761.56
500450,202310,490,214,276,282484.41,364321,646805.41
500460,202310,311,169,142,223085.14,187440.96,410526.10
500470,202310,486,344,142,454088.43,187440,641528.43
500480,202310,123,69,54,91082.13,71280.9,162363.03
500490,202310,111,52,59,68640.68,77883.05,146523.73
500500,202310,1671,625,1046,825025.37,1382046.22,2207071.59
500510,202310,43,36,7,47520.31,9240,56760.31
500515,202310,135,88,47,116162.42,62041.47,178203.89
500520,202310,329,168,161,224406.05,213840.16,438246.21
500525,202310,102,52,50,68640.14,66000,134640.14
500540,202310,1014,446,568,588740.88,751086.83,1339827.71
500560,202310,966,539,427,711494.29,563642.85,1275137.14
500568,202310,1296,578,718,764297.06,949087.72,1713384.78
500570,202310,1351,774,577,1021700.49,762962.04,1784662.53
500580,202310,324,178,146,234966.82,192721.02,427687.84
500600,202310,452,210,242,278527.19,319441.76,597968.95
500620,202310,1175,825,350,1089026.59,463327.99,1552354.58
500625,202310,95,70,25,92400.97,33000,125400.97
500627,202310,54,24,30,31680,39600,71280
500630,202310,1761,1041,720,1374918.39,950407.35,2325325.74
500635,202310,540,318,222,419761.79,293040,712801.79
500640,202310,372,199,173,262690.99,228362.7,491053.69
500660,202310,6876,2439,4437,3223518.42,5858195.38,9081713.80
500690,202310,714,257,457,339246.33,605880.26,945126.59
500710,202310,456,222,234,294368.04,308885.26,603253.30
500720,202310,1077,596,481,788059.77,638883.21,1426942.98
500730,202310,144,88,56,116165.7,73920,190085.7
500740,202310,1068,469,599,619095.01,790684.44,1409779.45
500750,202310,233,88,145,116162.04,191401.78,307563.82
500755,202310,122,91,31,120124.65,40920.93,161045.58
500769,202310,837,469,368,619100.55,485762.61,1104863.16
500770,202310,480,259,221,341881.85,294360,636241.85
500780,202310,143,95,48,125407.24,63361.33,188768.57
500790,202310,1216,593,623,782787.53,823684.66,1606472.19
500793,202310,322,168,154,221763.89,204603.26,426367.15
500795,202310,221,140,81,184803.62,106920.7,291724.32
500797,202310,52,37,15,48840.62,19800,68640.62
500800,202310,488,209,279,277205.02,369602.12,646807.14
500830,202310,2683,1378,1305,1819034.09,1723930.39,3542964.48
500840,202310,115,83,32,109564.41,42240.94,151805.35
510010,202310,179,98,81,129360,106920,236280
510020,202310,582,287,295,378856.04,390724.01,769580.05
510025,202310,1982,1134,848,1496925.76,1120690,2617615.76
510030,202310,697,376,321,496337.3,423727.37,920064.67
510035,202310,136,72,64,95040.79,84480,179520.79
510040,202310,438,203,235,267961.85,310201,578162.85
510050,202310,404,209,195,275881.72,257400,533281.72
510060,202310,150,68,82,89763.55,108240,198003.55
510080,202310,266,120,146,158401.28,194040,352441.28
510100,202310,69,29,40,38280.55,52800.67,91081.22
510120,202310,34,20,14,26400.99,18480.04,44881.03
510125,202310,426,271,155,357723.39,204600.21,562323.60
510130,202310,570,339,231,447492.38,304921.49,752413.87
510140,202310,506,177,329,233641.15,434280.33,667921.48
510160,202310,117,49,68,64682.72,89761.32,154444.04
510170,202310,877,514,363,678494.42,479165.31,1157659.73
510180,202310,3288,1490,1798,1968175.12,2376018.92,4344194.04
510185,202310,46,24,22,31680.7,29040,60720.7
510190,202310,296,114,182,150481.77,240241.49,390723.26
510250,202310,3044,1833,1211,2419607.02,1601166.81,4020773.83
510260,202310,182,130,52,171602.5,68640.23,240242.73
510263,202310,527,302,225,398648.56,297003.45,695652.01
510267,202310,706,400,306,529338.46,403922.84,933261.30
510268,202310,90,44,46,58080.01,60720,118800.01
510269,202310,87,39,48,51480,63360.5,114840.5
510270,202310,412,195,217,257402.1,286440.31,543842.41
510279,202310,243,176,67,232322.53,88440,320762.53
510285,202310,199,83,116,109561.3,153120,262681.3
510300,202310,581,310,271,409204.39,357722.33,766926.72
510305,202310,225,99,126,130680.33,166320,297000.33
510310,202310,118,58,60,76560.02,79200.1,155760.12
510320,202310,892,561,331,740537.54,436923.15,1177460.69
510325,202310,484,213,271,282484.79,359043.18,641527.97
510330,202310,511,287,224,378847.82,297000.5,675848.32
510335,202310,740,446,294,588733.87,388083.1,976816.97
510336,202310,60,42,18,55441.13,25080.64,80521.77
510337,202310,114,47,67,62040.03,88440,150480.03
510340,202310,21277,9142,12135,12079755.04,16031639.57,28111394.61
510343,202310,67,52,15,68640,19800,88440
510345,202310,160,98,62,129361.92,81840.68,211202.60
510350,202310,721,384,337,506894.26,444847.67,951741.93
510360,202310,231,142,89,187444.13,117480,304924.13
510370,202310,186,81,105,106920,138600.7,245520.7
510380,202310,81,59,22,77880,29040,106920
510385,202310,58,32,26,42240.2,34320,76560.2
510390,202310,105,49,56,64680.52,73920.6,138601.12
510395,202310,59,42,17,55440,22440,77880
510410,202310,922,592,330,781465.27,435604.6,1217069.87
510420,202310,601,297,304,392043.18,401280.7,793323.88
510450,202310,55,32,23,42240,30360,72600
510452,202310,63,32,31,42240,40920,83160
510454,202310,55,25,30,33000,39600.03,72600.03
510455,202310,121,72,49,95040,64680.97,159720.97
510460,202310,218,97,121,128042.48,159720,287762.48
510480,202310,849,489,360,645501.9,475210.11,1120712.01
510490,202310,354,173,181,228362.31,238920.5,467282.81
510500,202310,255,190,65,250800.43,85800,336600.43
510510,202310,966,564,402,744497.98,530646.36,1275144.34
510515,202310,1439,764,675,1008502.43,892324.91,1900827.34
510517,202310,296,132,164,174243.31,216480,390723.31
510520,202310,255,161,94,212523.61,124080.7,336604.31
510523,202310,125,98,27,129360,35640,165000
510525,202310,975,604,371,797296.65,489722.98,1287019.63
510530,202310,34,15,19,19800,25080,44880
510550,202310,269,124,145,163682.5,194041.82,357724.32
510558,202310,341,169,172,223082.64,227040,450122.64
510560,202310,421,252,169,332645.39,224402.71,557048.10
510562,202310,736,526,210,694345.71,277201.98,971547.69
510590,202310,757,359,398,473891.85,525364.17,999256.02
510600,202310,225,124,101,165005.07,133320.55,298325.62
510610,202310,243,112,131,149163.37,172922.3,322085.67
510615,202310,244,116,128,153120.65,168960.96,322081.61
510617,202310,28,12,16,15840,21120,36960
510618,202310,132,69,63,91080,83162.26,174242.26
510619,202310,87,59,28,77881.67,36960,114841.67
510620,202310,167,90,77,118800.7,101640,220440.7
510621,202310,180,120,60,158400.65,81840.23,240240.88
510622,202310,562,294,268,388094.98,353763.18,741858.16
510623,202310,309,208,101,274563.05,133320.2,407883.25
510624,202310,115,55,60,72601.87,79200.92,151802.79
510625,202310,597,360,237,475214.09,314165.43,789379.52
510626,202310,128,70,58,92402.42,76561.42,168963.84
510627,202310,108,72,36,95041.49,47520,142561.49
510628,202310,179,111,68,146521.87,89760,236281.87
510629,202310,328,203,125,267962,165023.76,432985.76
510630,202310,507,265,242,349814.51,319442.26,669256.77
510631,202310,25,10,15,13200.13,19800,33000.13
510637,202310,385,224,161,295682.1,212521.08,508203.18
510642,202310,1352,732,620,966260.55,821045.6,1787306.15
510645,202310,13,5,8,6600,10560,17160
510650,202310,1315,840,475,1108845.5,628324.01,1737169.51
510665,202310,109,51,58,67320.33,76560.08,143880.41
510670,202310,60,35,25,46200.72,33000,79200.72
510675,202310,1217,779,438,1028356.56,578164.65,1606521.21
510677,202310,383,208,175,274563.89,231000.51,505564.40
510680,202310,97,62,35,81841.85,46200,128041.85
510682,202310,215,102,113,134640.85,149160,283800.85
510685,202310,66,45,21,59400.55,27720.8,87121.35
510700,202310,651,378,273,498975.05,360363.77,859338.82
510704,202310,1461,753,708,994002.23,934574.96,1928577.19
510706,202310,181,92,89,121443.18,117481.66,238924.84
510710,202310,484,347,137,458046.49,180840,638886.49
510715,202310,58,39,19,51480,25080.66,76560.66
510718,202310,268,121,147,159722.65,195363.65,355086.30
510719,202310,58,28,30,36960,39600,76560
510720,202310,197,141,56,186121.85,73920,260041.85
510724,202310,80,31,49,40920,66000,106920
510726,202310,67,36,31,47520.7,40920.62,88441.32
510729,202310,15,5,10,6600,13200.3,19800.3
510730,202310,502,260,242,343202.46,319440.54,662643.00
510735,202310,126,48,78,63360,102960,166320
510740,202310,27,16,11,21121.77,14521.24,35643.01
510757,202310,39,32,7,42240.57,9240.16,51480.73
510760,202310,8589,4373,4216,5775136.82,5570440.36,11345577.18
510770,202310,791,357,434,471249.71,572884.42,1044134.13
510774,202310,19,8,11,10560.69,14520,25080.69
510775,202310,131,106,25,139920,33000,172920
510776,202310,40,14,26,18480,34320.2,52800.2
510777,202310,196,87,109,114840,143880,258720
510779,202310,37,23,14,30360,18480,48840
510780,202310,297,157,140,207249.14,186120,393369.14
510785,202310,364,199,165,262686.39,217800.05,480486.44
510787,202310,238,121,117,159726.96,154441.09,314168.05
510788,202310,11,5,6,6600.9,7920,14520.9
510790,202310,3065,1566,1499,2067237.12,1980007.43,4047244.55
510792,202310,1237,688,549,908302.44,724690.13,1632992.57
510794,202310,128,70,58,92401.71,76560,168961.71
510795,202310,2589,1450,1139,1914043.12,1506127.12,3420170.24
510800,202310,205,111,94,146521.56,124080,270601.56
510805,202310,232,159,73,209880.9,96360,306240.9
510810,202310,111,45,66,59401.25,87120.42,146521.67
510820,202310,274,141,133,187441.74,175562.52,363004.26
510830,202310,87,46,41,60720,54120,114840
510835,202310,29,22,7,29040.7,9240,38280.7
510840,202310,10761,4871,5890,6431471.56,7778835.59,14210307.15
510850,202310,222,89,133,117482.02,175560.26,293042.28
510860,202310,464,238,226,314163.19,298321.69,612484.88
510880,202310,84,60,24,79200.2,31680,110880.2
510885,202310,75,42,33,55441.44,43560,99001.44
510890,202310,85,43,42,56760.94,55440.26,112201.20
510895,202310,201,119,82,157080.73,108240,265320.73
520005,202310,178,78,100,102963.05,132001.86,234964.91
520010,202310,364,165,199,217802.9,262682.97,480485.87
520013,202310,824,578,246,762974.47,324723.56,1087698.03
520015,202310,42,28,14,36960,18480,55440
520017,202310,93,61,32,80520.84,42240,122760.84
520020,202310,12,6,6,7920,7920,15840
520025,202310,3557,1956,1601,2583355.62,2113374.66,4696730.28
520030,202310,1015,531,484,700934.12,638884.56,1339818.68
520050,202310,66,49,17,64680.2,22440.9,87121.1
520055,202310,85,61,24,80520,31680.2,112200.2
520060,202310,209,141,68,186123.71,89761.25,275884.96
520080,202310,636,455,181,600602.02,238920.55,839522.57
520082,202310,20,12,8,15840,10560,26400
520085,202310,125,101,24,133320.18,31680.7,165000.88
520090,202310,91,66,25,87120.75,33000,120120.75
520110,202310,10624,4533,6091,5985032.5,8049427.59,14034460.09
520120,202310,12,9,3,11880,3960,15840
520130,202310,974,691,283,912132.99,373560.65,1285693.64
520140,202310,13962,7604,6358,10045671.92,8400576.8,18446248.72
520145,202310,71,40,31,52800.2,40920,93720.2
520150,202310,144,111,33,146525.57,43560,190085.57
520160,202310,50,33,17,43560,22440,66000
520170,202310,221,123,98,162366.61,129360.55,291727.16
520180,202310,224,109,115,143880.96,151801.16,295682.12
520215,202310,214,158,56,208560.59,73920.2,282480.79
520235,202310,97,72,25,95040,33000,128040
520250,202310,177,87,90,114841.77,118800,233641.77
520260,202310,138,86,52,113524.62,68641.95,182166.57
520280,202310,58,41,17,54120,22440,76560
520310,202310,36,18,18,23762.22,23761.46,47523.68
520320,202310,205,126,79,166322.52,104280.97,270603.49
520330,202310,945,530,415,699616.97,547803.15,1247420.12
520340,202310,320,185,135,244211.99,179523.13,423735.12
520350,202310,518,266,252,351123.7,332642.59,683766.29
520355,202310,115,70,45,93721.79,60720,154441.79
520357,202310,40,29,11,38280,14520,52800
520360,202310,24,10,14,13200.2,18480.28,31680.48
520380,202310,149,83,66,109560,87120,196680
520390,202310,246,109,137,143884.77,180840,324724.77
520393,202310,22,17,5,22440.1,6600,29040.1
520396,202310,82,59,23,77880,30360,108240
520400,202310,227,140,87,184803.96,116161.1,300965.06
520410,202310,219,120,99,159725,130680,290405
520420,202310,26,19,7,25080.65,9240,34320.65
520425,202310,266,124,142,163682.7,187440.18,351122.88
520430,202310,594,278,316,366961.68,418441.17,785402.85
520440,202310,760,555,205,732614.33,270601.33,1003215.66
520450,202310,2491,1097,1394,1448082.35,1841420.91,3289503.26
520455,202310,80,46,34,60722.74,44880.81,105603.55
520460,202310,54,33,21,43560.69,27720.81,71281.50
520465,202310,45,39,6,51480,7920,59400
520470,202310,506,311,195,410523.15,257400,667923.15
520480,202310,77,52,25,68641.47,34320,102961.47
520485,202310,114,47,67,62040.83,88440.1,150480.93
520490,202310,606,447,159,590051.4,209882,799933.4
520495,202310,183,112,71,147840.1,93720,241560.1
520500,202310,276,228,48,300962.73,63360,364322.73
520505,202310,199,117,82,154440,108240,262680
520510,202310,2382,1131,1251,1492948.13,1652650.61,3145598.74
520520,202310,73,47,26,62040.97,34320,96360.97
520530,202310,219,175,44,231006.05,58080,289086.05
520540,202310,882,602,280,794654.54,370922.44,1165576.98
520545,202310,171,103,68,137284.43,89760.6,227045.03
520547,202310,85,48,37,63362.64,48840.1,112202.74
520549,202310,1759,871,888,1149763.82,1172176.27,2321940.09
520551,202310,359,194,165,256081.33,217801.23,473882.56
520552,202310,64,48,16,63361.12,21120,84481.12
520570,202310,17,13,4,17160,5280,22440
520580,202310,305,192,113,253579.82,149160.47,402740.29
520590,202310,167,93,74,122762.23,97680,220442.23
520620,202310,1426,666,760,880453.98,1005849.53,1886303.51
520630,202310,58,30,28,39600,36960.18,76560.18
520640,202310,419,249,170,330005.5,224400.9,554406.4
520650,202310,78,36,42,47520,55440,102960
520660,202310,48,26,22,34320.85,29040.38,63361.23
520670,202310,48,36,12,47520.22,15840,63360.22
520680,202310,27,16,11,21120,14520,35640
520690,202310,43,11,32,14520,42240,56760
520710,202310,39,28,11,36960,14520,51480
520725,202310,213,157,56,207242.83,73920,281162.83
520735,202310,68,39,29,51480.2,38280.2,89760.4
520740,202310,494,248,246,327366.38,324721.22,652087.60
520750,202310,45,26,19,34320,25080,59400
520753,202310,89,65,24,85800.76,31680,117480.76
520760,202310,111,77,34,101641.51,44880,146521.51
520780,202310,285,219,66,289083.93,87122.93,376206.86
520790,202310,149,92,57,121440.4,75240,196680.4
520800,202310,3849,2209,1640,2917278.34,2167461.59,5084739.93
520810,202310,140,109,31,145070.22,40920.89,185991.11
520815,202310,8,6,2,7920.31,2640,10560.31
520830,202310,135,95,40,125403.56,52800.2,178203.76
520840,202310,443,283,160,374880.68,211200,586080.68
520850,202310,117,67,50,88441.86,66000,154441.86
520860,202310,2054,1290,764,1704161.5,1012445.21,2716606.71
520870,202310,38729,17608,21121,23259176.71,27913016.88,51172193.59
520880,202310,1517,805,712,1062641.74,939856.41,2002498.15
520890,202310,924,605,319,799239.68,421081.57,1220321.25
520910,202310,1059,548,511,723383.69,674523.2,1397906.89
520915,202310,97,63,34,83162.29,44880,128042.29
520920,202310,587,283,304,373571.43,402606,776177.43
520929,202310,17,15,2,19800.29,2640,22440.29
520940,202310,69,52,17,68641.01,22440.1,91081.11
520945,202310,22,13,9,17160,11880,29040
520960,202310,48,29,19,38280.57,25080,63360.57
520970,202310,489,286,203,377526.06,267964.1,645490.16
520980,202310,94,68,26,89760,34320,124080
520990,202310,457,321,136,423722.68,179520.63,603243.31
520993,202310,124,64,60,84483.07,79200.09,163683.16
520995,202310,288,162,126,213842.84,166320,380162.84
521000,202310,1782,972,810,1283065.73,1069209.47,2352275.20
521010,202310,691,372,319,491050.93,421082.18,912133.11
521015,202310,17,12,5,15840,6600,22440
521020,202310,1618,1132,486,1494274.53,641526.65,2135801.18
521030,202310,90,64,26,84480.95,34320,118800.95
521040,202310,1127,775,352,1023023.07,464642.13,1487665.20
521056,202310,66,43,23,56760,30360,87120
521060,202310,131,85,46,112201.1,60720,172921.1
521080,202310,313,251,62,331337.67,81840.4,413178.07
521090,202310,655,455,200,603249.93,264000,867249.93
521100,202310,304,211,93,279845.86,122760.97,402606.83
521120,202310,1193,845,348,1116220.69,459363.37,1575584.06
521130,202310,337,242,95,319447.53,125400,444847.53
521140,202310,205,115,90,151803.49,118800.69,270604.18
521150,202310,2788,1171,1617,1545775.44,2137106.06,3682881.50
521160,202310,25,10,15,13200,19800,33000
521170,202310,233,129,104,170281.31,137280,307561.31
521180,202310,1360,849,511,1120711.02,674526.37,1795237.39
521190,202310,2955,1248,1707,1647401.23,2253253.74,3900654.97
521200,202310,68,49,19,64680.1,25080,89760.1
521205,202310,26,18,8,23760.2,10560,34320.2
521210,202310,150,91,59,120122.42,77880,198002.42
521220,202310,819,554,265,731513.98,349803.09,1081317.07
521225,202310,17,12,5,15841.1,6600.84,22441.94
521230,202310,118,80,38,105602.48,50160,155762.48
521250,202310,7220,4013,3207,5302655.3,4237293.21,9539948.51
521260,202310,53,22,31,29040,40920,69960
521270,202310,132,100,32,132000.92,42240,174240.92
521280,202310,437,267,170,352442.13,224400,576842.13
521290,202310,35,19,16,25080.97,21120,46200.97
521295,202310,111,74,37,97680.93,48840,146520.93
521300,202310,273,160,113,211202.03,149160.55,360362.58
521305,202310,51,36,15,47522.33,19800,67322.33
521308,202310,1097,853,244,1128632.6,322083.97,1450716.57
521310,202310,1585,872,713,1151075.51,942493.82,2093569.33
521340,202310,26,19,7,25080,9240,34320
521350,202310,98,74,24,97683.45,31680,129363.45
521370,202310,183,119,64,157081.4,84480,241561.4
521375,202310,222,102,120,134643.57,158401.54,293045.11
521377,202310,51,38,13,50160.57,17160.1,67320.67
521380,202310,1190,694,496,917438.61,657369.24,1574807.85
521385,202310,12,6,6,7920,7920,15840
521390,202310,110,89,21,117482.56,29040.49,146523.05
521400,202310,432,313,119,413173.09,157080.92,570254.01
521405,202310,176,117,59,154443.14,77880,232323.14
521410,202310,87,64,23,84481.27,30360,114841.27
521440,202310,243,163,80,216485.11,105600.64,322085.75
521450,202310,865,473,392,624371.42,517443.13,1141814.55
521460,202310,1243,882,361,1164289.32,476526.93,1640816.25
521470,202310,17,13,4,17160,5280,22440
521480,202310,45,28,17,36961.04,22440,59401.04
521483,202310,362,243,119,321202.85,157081.47,478284.32
521486,202310,341,232,109,306240.5,145200.84,451441.34
521487,202310,26,15,11,19800,14520,34320
521490,202310,30,18,12,23760,15840,39600
521500,202310,170,84,86,110880.27,114840.19,225720.46
521520,202310,49,38,11,50160,14520,64680
521523,202310,1398,773,625,1020381.53,825005.25,1845386.78
521525,202310,67,51,16,67320,21120,88440
521530,202310,264,153,111,201960.25,146520.49,348480.74
521540,202310,46,24,22,33000,29040,62040
521550,202310,140,74,66,97682.09,87120.99,184803.08
521560,202310,1038,705,333,930623.07,439563.29,1370186.36
521565,202310,79,56,23,73921.28,30360.7,104281.98
521570,202310,661,418,243,551769.18,320760.87,872530.05
521580,202310,46,30,16,39600,21120,60720
521590,202310,49,27,22,35640,29040,64680
521600,202310,23,11,12,14520,15840,30360
521630,202310,250,130,120,171605.26,159724.53,331329.79
521640,202310,338,184,154,242882.37,205920.87,448803.24
521645,202310,41,20,21,26400,27720,54120
521680,202310,278,169,109,223083.97,143880.87,366964.84
521690,202310,18,16,2,21120,2640,23760
521710,202310,1231,599,632,790694.14,835565.9,1626260.04
521720,202310,647,439,208,580804.68,275880.76,856685.44
521730,202310,814,376,438,496325.49,578163.95,1074489.44
521740,202310,1007,485,522,640207.28,689044.21,1329251.49
521760,202310,2883,1516,1367,2001286.15,1807112.65,3808398.80
521770,202310,907,555,352,733930.56,464643.35,1198573.91
521800,202310,2151,1477,674,1954007.7,889681.49,2843689.19
521805,202310,43,28,15,36960,19800,56760
521810,202310,93,54,39,71281.41,51480,122761.41
521830,202310,1136,845,291,1116755.7,385446.91,1502202.61
521839,202310,73,41,32,54120,42240.8,96360.8
521850,202310,1329,666,663,879146.56,875169.19,1754315.75
521860,202310,364,232,132,306244.7,174240,480484.7
521870,202310,116,82,34,108240,44880,153120
521878,202310,38,16,22,21120,29040.02,50160.02
521880,202310,5793,2600,3193,3432112.26,4216110.58,7648222.84
521890,202310,711,491,220,648132.16,290401.47,938533.63
521900,202310,302,231,71,304921.11,93720.8,398641.91
521910,202310,201,136,65,179525.27,85801.28,265326.55
521920,202310,36,22,14,29040,18480,47520
521925,202310,63,35,28,46200,36960,83160
521930,202310,1419,811,608,1070558.54,805211.16,1875769.70
521935,202310,43,34,9,44882.08,11880,56762.08
521940,202310,253,113,140,149161.03,184801.16,333962.19
521945,202310,23,15,8,19800,10560,30360
521950,202310,26,15,11,21120,14520,35640
521960,202310,74,57,17,75240,22440,97680
521970,202310,432,283,149,373563.19,196680.89,570244.08
521971,202310,107,61,46,80520.8,60720,141240.8
521973,202310,44,22,22,29040.73,29040,58080.73
521975,202310,1966,1066,900,1407157.18,1188017.67,2595174.85
521980,202310,260,175,85,231003.07,113520,344523.07
521990,202310,99,69,30,91081.65,39600,130681.65
522000,202310,311,213,98,280908.82,129360.35,410269.17
522005,202310,21,12,9,15840,11880,27720
522010,202310,1308,734,574,970229.46,757691.02,1727920.48
522015,202310,66,41,25,54120,33000,87120
522020,202310,1002,630,372,831613.7,491045.33,1322659.03
522026,202310,31,19,12,25080,15840,40920
522028,202310,28,24,4,31680,5280,36960
522040,202310,922,429,493,566295.28,653407.14,1219702.42
522045,202310,3171,1868,1303,2465857.45,1722610.52,4188467.97
522050,202310,168,74,94,97684.38,125400.72,223085.10
522060,202310,578,364,214,480491.32,282480.35,762971.67
522068,202310,129,95,34,125400.89,44880,170280.89
522070,202310,19,17,2,22440,2640,25080
522100,202310,36,23,13,30360,17160,47520
522108,202310,42,32,10,42242.54,13200,55442.54
522119,202310,76,43,33,56761.01,43560,100321.01
522130,202310,89,33,56,43560.51,75240.89,118801.40
522140,202310,4880,2573,2307,3397790.63,3049223.41,6447014.04
522145,202310,58,39,19,51480.2,25080,76560.2
522150,202310,127,90,37,118800.19,48840.84,167641.03
522155,202310,66,44,22,58080.9,29040,87120.9
522157,202310,21,11,10,14520,13200,27720
522160,202310,1807,1071,736,1416402.32,972849.16,2389251.48
522170,202310,390,271,119,357728.2,157080,514808.2
522180,202310,35,16,19,21120,25080,46200
522185,202310,3076,1416,1660,1871831.4,2193887.87,4065719.27
522190,202310,88,51,37,67320.7,48840,116160.7
522200,202310,360,207,153,273242.44,201960.24,475202.68
522205,202310,141,98,43,129363.62,56760,186123.62
522220,202310,143,111,32,146520.2,42240,188760.2
522230,202310,41,35,6,46200.41,7920,54120.41
530010,202310,66289,34112,32177,45055687.38,42510016.47,87565703.85
110001,202311,581,470,111,620471.15,146531.09,767002.24
110002,202311,3411,2210,1201,2918747.88,1588087.65,4506835.53
110003,202311,86,65,21,85811.18,27722.68,113533.86
110004,202311,2392,1671,721,2205887.04,951803.98,3157691.02
110005,202311,479,370,109,488448.6,143885.78,632334.38
110006,202311,489,358,131,473821.42,172931.52,646752.94
110007,202311,81,64,17,84486.4,22440.99,106927.39
110008,202311,305,176,129,233659.16,170291.33,403950.49
110009,202311,1058,829,229,1094335.52,302303.46,1396638.98
110010,202311,1887,1040,847,1374235.17,1119420.83,2493656.00
110011,202311,1839,1423,416,1878563.87,549179.96,2427743.83
110012,202311,4524,2617,1907,3458618.53,2520050.6,5978669.13
110013,202311,838,677,161,895056.24,212539.75,1107595.99
110014,202311,361,323,38,426423.65,51485.55,477909.20
110015,202311,1463,1107,356,1464025.28,469950.37,1933975.65
110018,202311,1108,711,397,938601.79,524081.71,1462683.50
110020,202311,19081,10786,8295,14245536.9,10960820.11,25206357.01
110025,202311,682,505,177,666643.49,233651.15,900294.64
110026,202311,37,26,11,34320.75,14520.74,48841.49
110028,202311,1774,1245,529,1643576.76,698358.43,2341935.19
110029,202311,132,120,12,158427.18,15841.58,174268.76
110030,202311,2638,1695,943,2238694.37,1246160.67,3484855.04
110032,202311,380,297,83,392087.87,109575.45,501663.32
110033,202311,758,538,220,710270.81,290427.26,1000698.07
110034,202311,348,271,77,357751.49,101650.21,459401.70
110037,202311,105,88,17,116164.56,22440.79,138605.35
110040,202311,468,328,140,432988.99,184810.18,617799.17
110045,202311,1090,796,294,1050817.74,388126.12,1438943.86
110050,202311,93,84,9,110899.24,11881.04,122780.28
110060,202311,72,50,22,66014.27,29043.77,95058.04
110070,202311,125,85,40,112206.96,52802.93,165009.89
110080,202311,635,369,266,487091.61,352449.75,839541.36
110090,202311,26,21,5,27720.2,6600.32,34320.52
110092,202311,142,72,70,96361.94,92402.04,188763.98
110094,202311,262,188,74,248168.55,97683.05,345851.60
110100,202311,64,48,16,64682.52,21120.92,85803.44
110110,202311,130,78,52,102965.75,68642.56,171608.31
110120,202311,82,69,13,91091.71,17160.07,108251.78
110130,202311,274,223,51,294418.67,67327.5,361746.17
110140,202311,299,214,85,282493.58,112206.53,394700.11
110143,202311,59,48,11,63361.65,14520,77881.65
110145,202311,52,37,15,48842.94,19801.22,68644.16
110146,202311,35,14,21,18480.94,27720.96,46201.90
110147,202311,44,26,18,34321.29,23761.96,58083.25
110148,202311,42,32,10,42242.32,13200.5,55442.82
110149,202311,339,239,100,315489.28,132004.18,447493.46
110150,202311,153,125,28,165003.97,36961.39,201965.36
110155,202311,14,13,1,17160.87,1320,18480.87
110160,202311,80,61,19,80522.33,25081.96,105604.29
110170,202311,234,180,54,237635.07,71284.97,308920.04
110175,202311,73,59,14,77880.19,18480,96360.19
110180,202311,93,74,19,97684.08,25080.44,122764.52
120001,202311,261,192,69,253469.11,91089.46,344558.57
120005,202311,263,155,108,204611.77,142566.23,347178.00
120010,202311,1287,783,504,1033620.99,665314.43,1698935.42
120013,202311,201,139,62,183485.5,81842.76,265328.26
120017,202311,162,100,62,132004.59,81842.33,213846.92
120020,202311,3668,2962,706,3910010.61,931947.22,4841957.83
120025,202311,649,354,295,467383.58,392129.44,859513.02
120030,202311,1304,1131,173,1493007.92,228374.94,1721382.86
120032,202311,48,42,6,55440.88,7920.17,63361.05
120033,202311,250,215,35,283810.95,46200.83,330011.78
120034,202311,214,163,51,215163.03,67321,282484.03
120035,202311,65,58,7,76561.34,9241.76,85803.10
120038,202311,458,305,153,402639.61,201969.76,604609.37
120039,202311,39,36,3,47521.99,3960,51481.99
120040,202311,16524,11159,5365,14734709.76,7089132.76,21823842.52
120042,202311,61,55,6,72603.8,7920.45,80524.25
120043,202311,19,5,14,6600.34,18480.67,25081.01
120045,202311,621,396,225,522781.5,297020.78,819802.28
120050,202311,1437,1091,346,1440216.3,456738.15,1896954.45
120060,202311,1626,1358,268,1791874.51,353770.87,2145645.38
120070,202311,478,356,122,469960.67,161050.16,631010.83
120080,202311,241,166,75,219127.73,99001.88,318129.61
130002,202311,177,130,47,171601.98,62040.5,233642.48
130006,202311,117,80,37,105600.44,48840,154440.44
130008,202311,135,81,54,106921.23,71281.84,178203.07
130010,202311,186,119,67,157081.65,88440.73,245522.38
130014,202311,352,247,105,326376.04,138604.3,464980.34
130020,202311,165,115,50,151804.25,66000,217804.25
130030,202311,1085,617,468,814450.62,619082.66,1433533.28
130040,202311,443,235,208,310210.46,274566.47,584776.93
130050,202311,592,320,272,422428.39,359068.53,781496.92
130060,202311,921,617,304,814450.64,401286.13,1215736.77
130063,202311,659,431,228,570248.52,300960,871208.52
130068,202311,246,151,95,199325.51,125401.76,324727.27
130070,202311,1466,980,486,1293686.22,641571.98,1935258.20
130080,202311,739,511,228,674531.82,300964.1,975495.92
130083,202311,101,66,35,87122.93,46201.71,133324.64
130090,202311,368,232,136,306244.99,179520.78,485765.77
130100,202311,1466,789,677,1041525.74,893705.96,1935231.70
130110,202311,913,416,497,549132.49,656048.93,1205181.42
130115,202311,185,99,86,130682.28,113525.34,244207.62
130120,202311,1853,1159,694,1531271.29,918741.59,2450012.88
130130,202311,713,493,220,650766.44,290401.66,941168.10
130140,202311,1594,1245,349,1643467.73,460707.28,2104175.01
130150,202311,465,420,45,554403.09,59400,613803.09
130160,202311,485,306,179,403933.45,236283.58,640217.03
130165,202311,153,134,19,176882.76,25080.8,201963.56
130170,202311,1430,983,447,1298873.92,591398.36,1890272.28
130180,202311,309,245,64,323414.97,84481.18,407896.15
130185,202311,2429,1229,1200,1623692.56,1586782.13,3210474.69
130190,202311,3679,2335,1344,3082407.19,1780803.08,4863210.27
130195,202311,308,246,62,324722.29,81840,406562.29
130200,202311,237,153,84,201967.28,110883.02,312850.30
130210,202311,96,43,53,56760,69960.6,126720.6
130220,202311,230,176,54,232321.78,71280.83,303602.61
130230,202311,368,251,117,331320,154440,485760
130240,202311,1485,1014,471,1338529.2,621741.69,1960270.89
130250,202311,5356,3527,1829,4655953.65,2414449.78,7070403.43
130255,202311,461,242,219,319442.29,289094.21,608536.50
130260,202311,75933,35770,40163,47244972.78,53073411.19,100318383.97
130270,202311,1567,1086,481,1433676.61,634946.61,2068623.22
130280,202311,152,89,63,118802.12,84480.41,203282.53
130290,202311,2207,1408,799,1858653.47,1054719.11,2913372.58
130300,202311,444,303,141,399965.2,187444.78,587409.98
130310,202311,1010,576,434,760326.3,572882.87,1333209.17
130320,202311,592,330,262,435604.75,345842.43,781447.18
130330,202311,800,538,262,711493.7,345845.58,1057339.28
130340,202311,3796,2065,1731,2725989.84,2286336.24,5012326.08
130350,202311,495,359,136,473883.22,179520,653403.22
130353,202311,1078,521,557,687774.41,735292.36,1423066.77
130356,202311,957,448,509,591374.7,671895.7,1263270.4
130360,202311,110,87,23,114840.2,30360.89,145201.09
130370,202311,695,555,140,732602.44,184800,917402.44
130380,202311,697,542,155,715457.03,204602.69,920059.72
130390,202311,505,418,87,551760.44,114840,666600.44
130395,202311,176,71,105,93720.57,138600,232320.57
130400,202311,104,76,28,100322.08,36960.84,137282.92
130406,202311,2389,1360,1029,1795267.56,1358342.3,3153609.86
130410,202311,512,296,216,390727.02,285120,675847.02
130420,202311,3045,2483,562,3277790.4,741877.77,4019668.17
130423,202311,221,144,77,190080.42,101640.2,291720.62
130426,202311,207,119,88,157083.21,116160.8,273244.01
130430,202311,459,273,186,360370.85,245520,605890.85
130440,202311,214,81,133,106925.65,175565.6,282491.25
140002,202311,67,22,45,29041.42,59401.63,88443.05
140005,202311,273,157,116,207250.9,153130.16,360381.06
140010,202311,15878,8516,7362,11246351.47,9729173.71,20975525.18
140015,202311,404,89,315,117484.99,415804.8,533289.79
140017,202311,189,103,86,135977.68,113529.62,249507.30
140020,202311,521,353,168,465986.42,221779.68,687766.10
140023,202311,109,62,47,81843.03,62041.63,143884.66
140028,202311,35,19,16,25081.81,21122.71,46204.52
140030,202311,487,310,177,409242.91,233652.9,642895.81
140040,202311,95,62,33,81840.4,43560.2,125400.6
140045,202311,571,134,437,176888.56,576852.17,753740.73
140047,202311,746,469,277,619124.36,365652.26,984776.62
140050,202311,175,107,68,141259.64,89771.24,231030.88
140060,202311,116,81,35,106925.68,46201.3,153126.98
140070,202311,31,28,3,36962.05,3960,40922.05
150010,202311,5899,3607,2292,4761623,3026967.26,7788590.26
150013,202311,199,132,67,174244.46,88443.77,262688.23
150020,202311,1273,741,532,979496.36,703591.67,1683088.03
150030,202311,765,366,399,483164.57,526730.93,1009895.50
150034,202311,235,137,98,180846.39,129363,310209.39
150040,202311,1930,1147,783,1515538.17,1034981.3,2550519.47
150050,202311,890,541,349,715466.34,460688.39,1176154.73
150060,202311,5709,3582,2127,4729826.14,2813668.76,7543494.90
150070,202311,257,200,57,264031.24,75254.57,339285.81
150080,202311,21301,10117,11184,13360024.05,14769720.24,28129744.29
150085,202311,593,361,232,476550.8,306256.55,782807.35
150090,202311,912,731,181,964994.48,238932.01,1203926.49
150095,202311,111,78,33,102968.57,43563.5,146532.07
150100,202311,89,56,33,73921.54,43562.69,117484.23
150110,202311,233,145,88,191400.89,116160.94,307561.83
150120,202311,429,307,122,405281.59,161045.76,566327.35
150125,202311,49,23,26,30361.87,34321.5,64683.37
150130,202311,2916,1436,1480,1895683.53,1953919.32,3849602.85
150140,202311,70358,30375,39983,40105154.57,52803786.32,92908940.89
150145,202311,314,175,139,231010.46,183483.04,414493.50
150150,202311,4204,1873,2331,2472565.92,3078502.56,5551068.48
150157,202311,403,288,115,380204.88,151814.53,532019.41
150160,202311,208,156,52,205922.44,68641.77,274564.21
150170,202311,4745,3388,1357,4472460.69,1792657.43,6265118.12
150172,202311,452,325,127,429028.3,167651.26,596679.56
150175,202311,95,53,42,69963.81,55443.89,125407.70
150178,202311,904,614,290,811873.43,382820.97,1194694.40
150180,202311,4834,2358,2476,3112770.99,3269823.38,6382594.37
150190,202311,487,342,145,451476.05,191417.06,642893.11
150195,202311,160,92,68,121441.69,89761.03,211202.72
150200,202311,237,138,99,182164.24,130681.52,312845.76
150210,202311,3549,2717,832,3586853.84,1098309.43,4685163.27
150215,202311,855,492,363,649511.65,479203.58,1128715.23
150220,202311,3981,2640,1341,3486417.85,1771588.59,5258006.44
150230,202311,1668,1326,342,1750466.8,452793.16,2203259.96
150240,202311,8740,4843,3897,6394739.63,5145849.46,11540589.09
150250,202311,105,66,39,87125.99,51480.62,138606.61
150260,202311,160,110,50,145208.66,66002.48,211211.14
150270,202311,2370,1533,837,2023763.28,1104915.1,3128678.38
150275,202311,635,422,213,557093.94,281180.32,838274.26
150276,202311,138,51,87,67323.05,114845.51,182168.56
150277,202311,981,429,552,566340.24,730029.8,1296370.04
150280,202311,225,217,8,286453.32,10560.62,297013.94
150285,202311,206,120,86,158404.42,113309.47,271713.89
150290,202311,1474,851,623,1123402.12,822400.38,1945802.50
150293,202311,1003,466,537,615168.27,708892.87,1324061.14
150295,202311,677,337,340,444881.29,448849.22,893730.51
150300,202311,130,75,55,99004.55,72601.62,171606.17
150304,202311,248,151,97,199330.85,128048.79,327379.64
150307,202311,498,412,86,543880.45,113526.38,657406.83
150309,202311,684,489,195,645562,257422.14,902984.14
150310,202311,334,229,105,302283.59,138600,440883.59
150320,202311,2148,1490,658,1966895.45,868604.83,2835500.28
150330,202311,2413,1400,1013,1848091.67,1337222.17,3185313.84
150340,202311,227,142,85,187445.97,112201.35,299647.32
150345,202311,744,416,328,549148.83,432967.59,982116.42
150350,202311,487,394,93,520161.06,122775.92,642936.98
150360,202311,5939,3486,2453,4601931.84,3240798.79,7842730.63
150370,202311,966,637,329,842293.25,435632.4,1277925.65
150375,202311,224,91,133,120125.24,175563.08,295688.32
150380,202311,1706,1147,559,1514149.59,737937.13,2252086.72
150390,202311,1059,627,432,827731.9,571602.79,1399334.69
150400,202311,142,122,20,161043.55,26400.53,187444.08
150405,202311,1870,1194,676,1576187.63,892350.45,2468538.08
150410,202311,110,69,41,91081.76,54120.9,145202.66
150420,202311,9027,4908,4119,6479579.6,5441611.33,11921190.93
150430,202311,766,478,288,631041.96,380192.33,1011234.29
150440,202311,528,321,207,423765.81,273262.47,697028.28
150442,202311,2826,1521,1305,2007898.86,1725362.5,3733261.36
150445,202311,638,420,218,554454.08,287774.7,842228.78
150450,202311,82,58,24,76561.72,31681.74,108243.46
150460,202311,769,585,184,772280.87,242896.75,1015177.62
150470,202311,1425,868,557,1145882.67,735303.18,1881185.85
150475,202311,300,225,75,298361.61,99013.97,397375.58
150480,202311,1681,1203,478,1588122.05,632326.57,2220448.62
150490,202311,657,408,249,538575.41,328682.1,867257.51
150495,202311,406,310,96,409203.71,126720,535923.71
150497,202311,321,208,113,274571.04,149163.75,423734.79
150500,202311,317,188,129,248171.24,170282.96,418454.20
150503,202311,1683,845,838,1115473.01,1107537.74,2223010.75
150506,202311,1024,705,319,930683.65,422431.71,1353115.36
150510,202311,1556,891,665,1176205.37,877862.73,2054068.10
150520,202311,372,255,117,336603.14,154440.88,491044.02
150530,202311,2383,1424,959,1879994.83,1267407.85,3147402.68
150540,202311,277,198,79,262697.34,104285.57,366982.91
150543,202311,1051,532,519,702296.46,685119.81,1387416.27
150548,202311,506,360,146,475215.31,192724.4,667939.71
150549,202311,102,71,31,93723.8,40921.21,134645.01
150550,202311,3668,1873,1795,2473878.67,2369535.14,4843413.81
150553,202311,4561,2573,1988,3396721.37,2625714.19,6022435.56
150555,202311,158,88,70,116166.09,92406.35,208572.44
150560,202311,120,64,56,84482.01,73920.69,158402.70
150563,202311,160,87,73,114853.09,96371.8,211224.89
150565,202311,247,150,97,198005.24,128042.96,326048.20
150570,202311,465,311,154,410524.9,203281.86,613806.76
150580,202311,1934,1015,919,1339857.54,1213142.92,2553000.46
150590,202311,980,669,311,883134.01,411862.83,1294996.84
150600,202311,613,409,204,539901.24,269294.45,809195.69
150610,202311,224,167,57,220446.33,75241.41,295687.74
150611,202311,187,129,58,170282.03,76560,246842.03
150613,202311,3971,2220,1751,2932073.68,2311648,5243721.68
150616,202311,674,358,316,472594.33,417137.38,889731.71
150618,202311,1624,828,796,1093020.83,1052082.5,2145103.33
150619,202311,483,369,114,487110.96,150491.38,637602.34
150620,202311,1511,861,650,1137913.35,859355.07,1997268.42
150630,202311,237,158,79,208589.01,104286.98,312875.99
150635,202311,564,271,293,357735.72,386773,744508.72
150640,202311,63,29,34,38283.08,44881.98,83165.06
150650,202311,2779,1608,1171,2122830.39,1545924.08,3668754.47
150655,202311,321,228,93,300971.4,122762.56,423733.96
150658,202311,65,44,21,58087.32,27721.37,85808.69
150660,202311,759,471,288,621777.79,380189.47,1001967.26
150670,202311,1324,501,823,661373.62,1086426.11,1747799.73
150680,202311,13161,7043,6118,9300458.01,8081787.18,17382245.19
150690,202311,56,29,27,38284.24,35640.34,73924.58
150700,202311,665,452,213,596700.28,281190.54,877890.82
150710,202311,348,210,138,277226.53,182169.08,459395.61
150715,202311,936,590,346,778862.64,456754.33,1235616.97
150720,202311,493,374,119,493715.7,157084.83,650800.53
150730,202311,1417,690,727,910882.68,959707.4,1870590.08
150740,202311,307,197,110,260056.57,146524.24,406580.81
150745,202311,938,540,398,712890.15,525417.5,1238307.65
150746,202311,85,42,43,55443.75,56761.14,112204.89
150747,202311,313,215,98,283817.97,129369.28,413187.25
150750,202311,171,94,77,124093.18,101647.32,225740.50
150760,202311,2169,1429,740,1890344.43,978159.43,2868503.86
150770,202311,448,271,177,357723.76,233643.73,591367.49
150775,202311,109,62,47,81849.08,62045.61,143894.69
150780,202311,251,151,100,199326.08,132001.4,331327.48
150790,202311,806,489,317,645512.76,419775.71,1065288.47
150795,202311,2057,1286,771,1698954.5,1017768.11,2716722.61
150796,202311,333,192,141,253442.28,186123.88,439566.16
150797,202311,491,242,249,319471.5,328691.85,648163.35
150800,202311,1883,1042,841,1376819.23,1110140.97,2486960.20
150803,202311,396,306,90,403951.69,118808.77,522760.46
150805,202311,248,152,96,200649.86,126724.98,327374.84
150808,202311,1247,611,636,806550.22,842186.83,1648737.05
150810,202311,3582,2402,1180,3172203.59,1558988.17,4731191.76
150812,202311,617,323,294,426382.32,388101.02,814483.34
150815,202311,1464,922,542,1217113.74,715461.21,1932574.95
150820,202311,2008,1198,810,1581522.2,1071929.65,2653451.85
150830,202311,650,489,161,645535.43,212535.61,858071.04
150835,202311,292,184,108,242885.88,142560.35,385446.23
150840,202311,1646,937,709,1238301.78,937279.82,2175581.60
160005,202311,78,52,26,68643.44,34323.15,102966.59
160010,202311,248,156,92,205934.92,122768.78,328703.70
160015,202311,187,127,60,167658.53,79201.76,246860.29
160020,202311,165,83,82,110884.73,108241.84,219126.57
160021,202311,73,40,33,52808.29,43564.08,96372.37
160023,202311,92,63,29,83169.31,38282.72,121452.03
160025,202311,36,19,17,25082.33,22441.07,47523.40
160027,202311,1676,943,733,1244898.27,967635.38,2212533.65
160030,202311,20580,10944,9636,14451464.77,12724743.35,27176208.12
160040,202311,443,291,152,384143.01,201978.33,586121.34
160050,202311,969,404,565,533326.73,745839.53,1279166.26
160053,202311,353,222,131,293068.72,172932.58,466001.30
160055,202311,30,23,7,30362.76,9242.06,39604.82
160060,202311,7837,4428,3409,5846950.3,4501683.59,10348633.89
160070,202311,221,134,87,176889.77,116162.49,293052.26
160080,202311,170,91,79,120120.37,104280,224400.37
170025,202311,26,17,9,22441.17,11881.34,34322.51
170030,202311,177,143,34,188778.69,46201.18,234979.87
170035,202311,217,110,107,145228.54,141260.1,286488.64
170040,202311,188,141,47,186120.6,62040.29,248160.89
170070,202311,352,227,125,299689.56,165012.68,464702.24
170100,202311,372,268,104,353796.98,137293.77,491090.75
170105,202311,43,37,6,48844.36,7920,56764.36
170110,202311,116,73,43,96362.75,56760.93,153123.68
170130,202311,92,49,43,64680,56760,121440
170190,202311,110,64,46,84480.98,60720.64,145201.62
170200,202311,374,255,119,336630.01,158407.96,495037.97
170210,202311,7719,4366,3353,5764522.89,4427614.28,10192137.17
170215,202311,192,123,69,162367.31,91087.12,253454.43
170220,202311,1413,1014,399,1339904.36,528026.47,1867930.83
170230,202311,166,116,50,153142.07,66009.96,219152.03
170240,202311,522,366,156,483196.65,205948.59,689145.24
170255,202311,1072,829,243,1094339.11,320771.69,1415110.80
170270,202311,58,42,16,55440,21120.02,76560.02
170290,202311,162,103,59,135965.02,77880,213845.02
170300,202311,133,90,43,118803.09,56760.92,175564.01
170305,202311,65,45,20,59401.01,26400.78,85801.79
170307,202311,56,42,14,55447.38,18483.28,73930.66
170310,202311,143,96,47,126726.32,62042,188768.32
170320,202311,53,35,18,46202.97,23760.66,69963.63
170330,202311,43,32,11,42244.22,14521.1,56765.32
170360,202311,41,27,14,35643.18,18483.87,54127.05
170370,202311,87,52,35,68648.8,46205.99,114854.79
170380,202311,101,75,26,99003.59,34320.34,133323.93
170382,202311,44,37,7,48840.34,9241.72,58082.06
170384,202311,163,126,37,166321.16,48840.25,215161.41
170386,202311,81,38,43,50161.24,56761.84,106923.08
170388,202311,48,25,23,33002.31,30362.77,63365.08
170389,202311,28,21,7,27721.11,9240.49,36961.60
170390,202311,93,53,40,69965.87,52801.97,122767.84
170410,202311,27,24,3,31685.86,3961.1,35646.96
170460,202311,13,8,5,10562.32,6601.18,17163.50
170510,202311,36,27,9,35647.62,11881.64,47529.26
170550,202311,1789,1074,715,1417810.85,943892.21,2361703.06
170555,202311,126,92,34,121460.31,44885.82,166346.13
170560,202311,102,77,25,101640.23,33000.79,134641.02
170600,202311,43,18,25,23760.92,33000.22,56761.14
170610,202311,213,122,91,161059.39,120138.67,281198.06
170625,202311,38,23,15,30361.65,19803.26,50164.91
170650,202311,108,78,30,102960.71,39601.31,142562.02
170700,202311,652,478,174,630999.05,229687.52,860686.57
170710,202311,146,88,58,116181.95,76574.49,192756.44
170720,202311,126,96,30,126723.26,39600.7,166323.96
170730,202311,129,80,49,105606.16,64681.63,170287.79
170740,202311,98,70,28,92400,36960.38,129360.38
170755,202311,47,28,19,36964.85,25087.57,62052.42
170765,202311,139,84,55,110900.55,72609.2,183509.75
170770,202311,201,137,64,180849.68,84483.73,265333.41
170820,202311,656,440,216,581951.09,285143.46,867094.55
170825,202311,60,32,28,42241.02,36961.74,79202.76
170830,202311,104,79,25,104285.05,33001.57,137286.62
170900,202311,191,148,43,196686.8,56762.75,253449.55
170930,202311,1141,654,487,863365.84,642905.33,1506271.17
170950,202311,3698,1843,1855,2433385.93,2451485.95,4884871.88
170980,202311,16,11,5,14521.73,6600.55,21122.28
171050,202311,167,128,39,168961.91,52800.41,221762.32
171070,202311,67,54,13,71281.17,17161.42,88442.59
171090,202311,54,43,11,56760.56,14520.44,71281.00
171110,202311,28,22,6,29041.98,7920.19,36962.17
171150,202311,52,37,15,48840.6,19800,68640.6
171180,202311,30,16,14,21122.11,18483.43,39605.54
171190,202311,220,124,96,163693.68,126726.16,290419.84
171195,202311,62,53,9,69965.45,11881.18,81846.63
171200,202311,28,13,15,17161.47,19800.62,36962.09
171215,202311,12,9,3,11880.07,3960.89,15840.96
171240,202311,64,51,13,67320,17161.05,84481.05
171245,202311,57,48,9,63371.25,11880.68,75251.93
171250,202311,87,54,33,71280.88,43560.69,114841.57
171270,202311,14,10,4,13203.3,5281.51,18484.81
171280,202311,55,45,10,59409.71,13201.18,72610.89
171320,202311,1186,709,477,935942.44,630989.32,1566931.76
171330,202311,486,261,225,344533.71,297015.77,641549.48
171360,202311,119,87,32,114840.65,42240.76,157081.41
171370,202311,43,27,16,35641.88,21124.05,56765.93
171380,202311,144,123,21,162363.21,27720.25,190083.46
171395,202311,50,33,17,43561.01,22440,66001.01
171420,202311,278,184,94,242886.71,124083.69,366970.40
171430,202311,82,67,15,88444.13,19800.54,108244.67
171488,202311,241,143,98,188764.31,129361.35,318125.66
171500,202311,74,45,29,59404.07,38282.95,97687.02
171510,202311,82,57,25,75240.8,33001.25,108242.05
171515,202311,46,39,7,51486.12,9241.26,60727.38
171525,202311,28,24,4,31683.82,5280,36963.82
171550,202311,18,12,6,15841.56,7921.35,23762.91
171570,202311,64,34,30,44880.77,39601.02,84481.79
171575,202311,263,182,81,240256.28,106924.67,347180.95
171610,202311,2253,1192,1061,1573566.15,1401952.23,2975518.38
171620,202311,175,127,48,167647.82,63362.63,231010.45
171630,202311,55,30,25,39600.8,33000,72600.8
171650,202311,383,271,112,357763.94,147855.29,505619.23
171660,202311,274,160,114,211238.21,150498.74,361736.95
171665,202311,101,65,36,85804.17,47522.71,133326.88
171670,202311,491,319,172,422437.07,227056.17,649493.24
171700,202311,65,54,11,71285.54,14522.39,85807.93
171720,202311,30,13,17,17160.98,22442.41,39603.39
171750,202311,113,60,53,79201.31,69962.42,149163.73
171780,202311,84,66,18,87122.23,23760,110882.23
171790,202311,113,91,22,120122.14,29040,149162.14
171800,202311,36,28,8,36960,10560,47520
171820,202311,2343,1381,962,1824429.84,1269946.44,3094376.28
171830,202311,36,28,8,36961.04,10560,47521.04
171840,202311,57,38,19,50166.3,25080.44,75246.74
171845,202311,37,27,10,35642.16,13200.82,48842.98
171850,202311,55,44,11,58082.34,14521.04,72603.38
171855,202311,78,60,18,79201.63,23760,102961.63
171865,202311,5,3,2,3960.44,2640.34,6600.78
171870,202311,42,30,12,39603.46,15842.11,55445.57
171875,202311,100,76,24,100321.27,31680,132001.27
171880,202311,50,31,19,40921.38,25081.18,66002.56
171884,202311,57,33,24,43560.85,33000.6,76561.45
171886,202311,151,76,75,100321.57,99003.42,199324.99
171888,202311,30,23,7,30366.15,9242.33,39608.48
171889,202311,18,9,9,11881.28,11882.08,23763.36
171890,202311,73,61,12,80524.64,15840,96364.64
171900,202311,28,19,9,25084.48,11881.12,36965.60
172000,202311,40,37,3,48846.33,3960.2,52806.53
172010,202311,67,45,22,59400.92,29041.63,88442.55
172015,202311,24,19,5,25083.63,6601.65,31685.28
172020,202311,127,79,48,104286.62,63362.11,167648.73
172025,202311,43,28,15,36961.12,19800.25,56761.37
172030,202311,64,41,23,54120.62,30360.89,84481.51
172049,202311,92,63,29,83162.02,38280.3,121442.32
172065,202311,122,81,41,106943.92,54128.87,161072.79
172080,202311,145,92,53,121443.53,69963.44,191406.97
172085,202311,34,18,16,23760,21120.47,44880.47
172090,202311,497,355,142,469960.03,187447.57,657407.60
172093,202311,20,19,1,25080.12,1320,26400.12
172097,202311,19,11,8,14521.16,10560.7,25081.86
172100,202311,7237,4332,2905,5723521.88,3842890.22,9566412.10
172110,202311,91,65,26,85806.97,34321.79,120128.76
172120,202311,1916,1597,319,2109598.6,421112.79,2530711.39
172125,202311,21,14,7,18481.55,9240.17,27721.72
172130,202311,34,21,13,27721.76,17161.4,44883.16
172208,202311,221,142,79,187443.08,104281.7,291724.78
172210,202311,374,191,183,252157.8,241586.48,493744.28
210005,202311,3376,2184,1192,2883218.03,1574921.34,4458139.37
210010,202311,149,103,46,135963.62,60720.6,196684.22
210015,202311,47,33,14,43562.54,18480,62042.54
210020,202311,414,257,157,339262.49,207256.1,546518.59
210030,202311,340,233,107,307612.55,142579.43,450191.98
210040,202311,117,98,19,129366.06,25081.11,154447.17
210043,202311,290,242,48,319450.57,63364.14,382814.71
210047,202311,513,338,175,446163.52,231000.8,677164.32
210050,202311,288,202,86,266641.39,113520.88,380162.27
210055,202311,68,57,11,75244.62,14521.42,89766.04
210060,202311,570,463,107,611231.43,141257.5,752488.93
210070,202311,523,406,117,535923.49,154441.49,690364.98
210080,202311,156,144,12,190084.31,15840.44,205924.75
210083,202311,302,165,137,217801.84,180841.05,398642.89
210087,202311,10,6,4,7920,5280,13200
210090,202311,535,392,143,517502.46,188778.99,706281.45
210095,202311,436,355,81,468639.53,106931,575570.53
210100,202311,746,600,146,792060.15,192734.83,984794.98
210110,202311,124,87,37,114844.67,48841.48,163686.15
210120,202311,4924,4010,914,5296511.55,1206643.41,6503154.96
210125,202311,215,143,72,188768.54,95044.26,283812.80
210130,202311,469,300,169,396047.18,223101.28,619148.46
210135,202311,38,27,11,35649.53,14523.03,50172.56
210140,202311,4982,3795,1187,5009884.58,1566979.14,6576863.72
210150,202311,401,271,130,357780.52,171623.34,529403.86
210160,202311,3380,2894,486,3821773.49,641587.58,4463361.07
210170,202311,1370,1110,260,1465363.88,343217.78,1808581.66
210173,202311,139,129,10,170281.62,13201,183482.62
210177,202311,292,171,121,225728.37,159734.37,385462.74
210180,202311,33,18,15,23760.8,19800.94,43561.74
210190,202311,497,349,148,460693.08,195363.48,656056.56
210193,202311,11,9,2,11880.17,2640,14520.17
210197,202311,68,51,17,67321.96,22442.52,89764.48
210200,202311,651,559,92,737951.14,121454.53,859405.67
210203,202311,252,186,66,245533.81,87123.74,332657.55
210207,202311,331,286,45,377552.73,59406.34,436959.07
210210,202311,751,700,51,924037.34,67324.64,991361.98
210215,202311,85,76,9,100328.29,11880,112208.29
210220,202311,367,318,49,419821.8,64689.64,484511.44
210230,202311,347,282,65,372264.02,85802.29,458066.31
210232,202311,1251,925,326,1221103.64,430351.56,1651455.20
210235,202311,194,146,48,192737.33,63363.47,256100.80
210237,202311,63,34,29,44882.67,38280.51,83163.18
210240,202311,90,80,10,105601.48,13201.39,118802.87
210250,202311,206,181,25,238924.28,33001.66,271925.94
210255,202311,420,313,107,413195.2,141244.41,554439.61
210260,202311,407,300,107,396006.09,141241.48,537247.57
210270,202311,653,479,174,632306.84,229696.46,862003.30
210275,202311,127,101,26,133322.3,34322.44,167644.74
210280,202311,1149,771,378,1019095.06,501618.89,1520713.95
210290,202311,581,396,185,522749.39,244210.55,766959.94
210300,202311,5086,3381,1705,4463204.66,2250758.1,6713962.76
210310,202311,130,89,41,117480.88,54120.44,171601.32
210312,202311,124,94,30,124085.28,39600.2,163685.48
210315,202311,136,119,17,157084.4,22440.88,179525.28
210317,202311,165,129,36,170281.49,47522.25,217803.74
210320,202311,2602,2255,347,2976875.62,458066.95,3434942.57
210325,202311,164,98,66,129366.62,87125.46,216492.08
210330,202311,4244,2577,1667,3401850.33,2201881.7,5603732.03
210340,202311,1246,974,272,1285816.85,359074.18,1644891.03
210350,202311,729,615,114,811863.3,150489.7,962353.0
210355,202311,161,138,23,182163.09,30363.54,212526.63
210360,202311,2092,1555,537,2052755.14,708898.4,2761653.54
210370,202311,1280,702,578,926696.42,763019.48,1689715.90
210375,202311,204,106,98,139938.37,129376.07,269314.44
210380,202311,772,617,155,814487.89,204615.28,1019103.17
210390,202311,205,174,31,229685.29,40920,270605.29
210400,202311,466,418,48,551811.29,63367.26,615178.55
210405,202311,1203,854,349,1127333.79,460693.36,1588027.15
210407,202311,80,68,12,89761.1,15840.44,105601.54
210408,202311,51,48,3,63366.62,3960,67326.62
210409,202311,361,320,41,422425.47,54123.65,476549.12
210410,202311,465,376,89,496328.47,117481.58,613810.05
210420,202311,224,180,44,237608.98,58080.25,295689.23
210430,202311,66,50,16,66000.55,21120,87120.55
210440,202311,382,264,118,348518.1,155774.35,504292.45
210450,202311,114,102,12,134656.31,15840.84,150497.15
210455,202311,267,147,120,194060.84,158413.78,352474.62
210460,202311,330,230,100,303636.65,132017.55,435654.20
210462,202311,81,69,12,91082.48,15840.9,106923.38
210465,202311,133,110,23,145205.48,30361.07,175566.55
210467,202311,627,473,154,624398.1,203291.81,827689.91
210470,202311,44,39,5,51480.67,6600,58080.67
210480,202311,1449,1062,387,1401956.12,510884.96,1912841.08
210490,202311,183,131,52,172928.65,68642.9,241571.55
210500,202311,528,357,171,471282.61,225739.48,697022.09
210510,202311,552,454,98,599285.81,129363.03,728648.84
210515,202311,342,237,105,314171.73,138614.6,452786.33
210520,202311,413,378,35,498999.32,46203.48,545202.80
210530,202311,10522,5385,5137,7109230.08,6784369.8,13893599.88
210535,202311,128,101,27,133325.11,35642.36,168967.47
210540,202311,1670,1170,500,1545835.19,660038.11,2205873.30
210542,202311,1083,576,507,760387.33,669289.11,1429676.44
210545,202311,25,22,3,29041.63,3960,33001.63
210547,202311,129,116,13,153127.4,17161.47,170288.87
210550,202311,621,445,176,587493.57,232341.49,819835.06
210560,202311,173,153,20,201962.33,26400.69,228363.02
210565,202311,33,25,8,33005.5,10562.21,43567.71
210570,202311,1347,1157,190,1527370.86,250834.68,1778205.54
210580,202311,133,117,16,154443.15,21120.39,175563.54
210590,202311,670,571,99,753730.16,130680.64,884410.80
210592,202311,52,46,6,60720.78,7920,68640.78
210594,202311,121,106,15,139924.51,19801.16,159725.67
210596,202311,121,108,13,142561.86,17160.6,159722.46
210598,202311,144,110,34,146525.25,44883.48,191408.73
210600,202311,312,273,39,360403.1,51489.81,411892.91
210610,202311,269,251,18,331354.01,23761.17,355115.18
210620,202311,50,34,16,44880.99,21120.87,66001.86
210630,202311,99,92,7,121440.85,9240,130680.85
210632,202311,1003,730,273,963622.14,360365.7,1323987.84
210635,202311,31,27,4,35647.73,5280.39,40928.12
210637,202311,116,87,29,114841.4,38280,153121.4
210640,202311,586,528,58,696969.32,76560.2,773529.52
210650,202311,424,361,63,476537.46,83164.09,559701.55
210660,202311,401,323,78,426424.48,102972.31,529396.79
210663,202311,95,78,17,102960.93,22440,125400.93
210667,202311,93,53,40,69964.62,52804.88,122769.50
210670,202311,282,249,33,328713.18,43563.75,372276.93
210675,202311,503,314,189,414498.65,249507.25,664005.90
210680,202311,244,164,80,216495.2,105607.91,322103.11
210690,202311,125,113,12,149161.44,15841.46,165002.90
210700,202311,154,117,37,154445.25,48842.18,203287.43
210710,202311,272,175,97,231007.22,128044.66,359051.88
210720,202311,135,123,12,162363.09,15840,178203.09
210725,202311,72,60,12,79220.27,15842.66,95062.93
210730,202311,24,16,8,21122.5,10561.28,31683.78
210735,202311,297,220,77,290402.68,101641.02,392043.70
210740,202311,522,459,63,605979.95,83174.16,689154.11
210745,202311,172,136,36,179525.37,47520.77,227046.14
210750,202311,3018,1711,1307,2258658.92,1725385.28,3984044.20
210760,202311,277,223,54,294371.72,71281.96,365653.68
210770,202311,255,211,44,278574.91,58093.96,336668.87
210780,202311,426,324,102,427731.8,134652.9,562384.7
210790,202311,210,180,30,237625.87,39604.9,277230.77
210800,202311,189,148,41,195387.98,54124.83,249512.81
210805,202311,71,64,7,84480,9240,93720
210810,202311,444,375,69,495062.39,91093.17,586155.56
210820,202311,2029,1741,288,2299532.48,380209.42,2679741.90
210825,202311,158,104,54,137293.48,71291.49,208584.97
210830,202311,731,532,199,702260.78,262688.48,964949.26
210840,202311,210,157,53,207243.81,69961.3,277205.11
210845,202311,239,189,50,249484.33,66000.69,315485.02
210850,202311,734,547,187,722123.18,246862.1,968985.28
210860,202311,3580,2259,1321,2982099.36,1743852.55,4725951.91
210870,202311,402,322,80,425120.84,105618.19,530739.03
210880,202311,101,85,16,112203.81,21120,133323.81
210890,202311,332,296,36,390783.62,47530.04,438313.66
210900,202311,758,494,264,652136.95,351149.94,1003286.89
210905,202311,74,43,31,56761.5,40921.44,97682.94
210910,202311,2175,1653,522,2182165.99,689086.01,2871252.00
210920,202311,146,73,73,96364.8,96360.46,192725.26
210923,202311,79,65,14,85802.05,18480,104282.05
210927,202311,427,235,192,310203.62,253453.29,563656.91
210930,202311,98,87,11,114840.96,14520.34,129361.30
210940,202311,89,71,18,93721.18,23760,117481.18
210945,202311,216,134,82,176883.52,108242.57,285126.09
210950,202311,532,393,139,518790.61,183495.99,702286.60
210955,202311,115,72,43,95044.96,56762.18,151807.14
210960,202311,2607,1390,1217,1834855.69,1606500.32,3441356.01
210970,202311,110,92,18,121442.79,23760.31,145203.10
210975,202311,72,69,3,91086.28,3961.29,95047.57
210980,202311,1072,567,505,748524.66,666656.85,1415181.51
210990,202311,4647,3376,1271,4456677.01,1677857.15,6134534.16
211000,202311,1380,1137,243,1500979,320791.81,1821770.81
211003,202311,982,743,239,980803.76,315492.65,1296296.41
211010,202311,519,466,53,615147.82,69963.71,685111.53
211020,202311,1392,684,708,902945.45,934650.48,1837595.93
211023,202311,47,41,6,54122.11,7920,62042.11
211027,202311,89,69,20,91081.47,26400.37,117481.84
211030,202311,376,277,99,365664.45,130693.77,496358.22
211040,202311,313,269,44,355084.45,58081.04,413165.49
211050,202311,1202,853,349,1126088.06,462040.57,1588128.63
211060,202311,653,578,75,763056.02,100327.07,863383.09
211065,202311,28,24,4,31685.55,5280.65,36966.20
211070,202311,855,725,130,957132.34,171620.24,1128752.58
211080,202311,95,91,4,120120.52,5280,125400.52
211085,202311,70,37,33,48841.38,43562.22,92403.60
211090,202311,106,93,13,122775.47,17163.23,139938.70
211100,202311,478,409,69,539943.38,91092.67,631036.05
211102,202311,233,173,60,228360.6,79200.87,307561.47
211105,202311,234,173,61,228366.01,80523.24,308889.25
211107,202311,133,86,47,113520,62040,175560
211110,202311,1026,703,323,929378.17,426402.87,1355781.04
211120,202311,5655,3199,2456,4223217.89,3242298.81,7465516.70
211125,202311,29,22,7,29043.37,9240.7,38284.07
211130,202311,44969,22820,22149,30131426.22,29248618.27,59380044.49
211140,202311,376,338,38,446219.07,50167.14,496386.21
211150,202311,1277,947,330,1250165.3,435634.2,1685799.5
211153,202311,184,110,74,145200.47,97681.23,242881.70
211157,202311,72,59,13,77883.56,17160.43,95043.99
211160,202311,717,603,114,796014.39,150489.83,946504.22
211163,202311,3,2,1,2640,1320,3960
211167,202311,11,11,0,14520.97,,14520.97
211170,202311,436,337,99,444864.93,130694.21,575559.14
211172,202311,94,72,22,95041.69,29040.55,124082.24
211174,202311,30,17,13,22440,17161.05,39601.05
211176,202311,475,353,122,465988.11,161045.75,627033.86
211178,202311,101,71,30,93724.97,39602.19,133327.16
211180,202311,219,180,39,237612.06,51485.01,289097.07
211190,202311,74,67,7,88441.29,9240,97681.29
211195,202311,50,38,12,50166.36,15842.26,66008.62
211200,202311,156,129,27,170301.06,35643.56,205944.62
211210,202311,406,307,99,405273.25,130699.02,535972.27
211220,202311,4719,2891,1828,3816565.17,2414691.77,6231256.94
211223,202311,156,142,14,187454.29,18480,205934.29
211227,202311,68,53,15,69961.82,21121.01,91082.83
211230,202311,746,624,122,825102.25,161060.5,986162.75
211240,202311,410,350,60,462021.24,79202.32,541223.56
211245,202311,195,110,85,145206.51,112207.43,257413.94
211250,202311,1500,1287,213,1699051.71,281186.64,1980238.35
211260,202311,850,736,114,971538.26,150481.5,1122019.76
211270,202311,1869,1572,297,2075130.82,392051.5,2467182.32
211280,202311,1883,1348,535,1779478.01,706258.49,2485736.50
211285,202311,234,153,81,201965.5,106920.31,308885.81
211290,202311,851,610,241,805218.07,318130.64,1123348.71
211300,202311,796,653,143,862060.36,188778.19,1050838.55
211400,202311,1642,1114,528,1470601.68,697002.16,2167603.84
220005,202311,22,20,2,26403.48,2640.5,29043.98
220010,202311,88,73,15,96360.49,19800,116160.49
220020,202311,807,661,146,872559.98,192732,1065291.98
220025,202311,118,114,4,150483.81,5280,155763.81
220027,202311,68,53,15,69960.2,19800.45,89760.65
220030,202311,142,119,23,157084.85,30360,187444.85
220040,202311,1408,1092,316,1441528.7,417141.36,1858670.06
220045,202311,30,24,6,31688.22,7920.61,39608.83
220050,202311,692,588,104,776138.06,138609.09,914747.15
220060,202311,197,173,24,228388.32,31683.5,260071.82
220070,202311,117,104,13,137292.77,17160.73,154453.50
220080,202311,16,13,3,17160.19,3960,21120.19
220090,202311,44,31,13,40920.57,17160,58080.57
220095,202311,6,5,1,6600.79,1320,7920.79
220100,202311,29,24,5,31682.61,6600.8,38283.41
220105,202311,38,33,5,43563.41,6600.1,50163.51
220110,202311,282,254,28,335286.71,36960.27,372246.98
220115,202311,54,46,8,60720.88,10560,71280.88
220117,202311,24,23,1,30361.54,1320,31681.54
220120,202311,1607,1278,329,1687058.72,434300.62,2121359.34
220130,202311,32,31,1,40922.16,1320,42242.16
220140,202311,95,80,15,105602.03,19800.78,125402.81
220150,202311,522,396,126,525451.14,166345.65,691796.79
220155,202311,33,32,1,42240.37,1320,43560.37
220157,202311,28,24,4,31685.88,5281.07,36966.95
220160,202311,119,104,15,137286.02,19801.22,157087.24
220170,202311,56,43,13,56761.87,17160,73921.87
220173,202311,24,21,3,27720.67,3960,31680.67
220177,202311,23,22,1,29040.24,1320,30360.24
220180,202311,70,67,3,88442.73,3960,92402.73
220190,202311,1300,1112,188,1467930.96,248171.88,1716102.84
220191,202311,41,37,4,48847.42,5280.38,54127.80
220192,202311,97,90,7,118803.18,9240,128043.18
220194,202311,59,52,7,68643.39,9240,77883.39
220196,202311,79,67,12,88453.91,15841.79,104295.70
220198,202311,5,5,0,6600,,6600.0
220200,202311,430,369,61,487174.15,80529.41,567703.56
220202,202311,38,34,4,44887.35,5281.01,50168.36
220205,202311,72,64,8,84481.34,10560,95041.34
220207,202311,16,16,0,21123.24,,21123.24
220208,202311,74,50,24,66005.99,31682.22,97688.21
220209,202311,39,34,5,44883.03,6600.5,51483.53
220210,202311,37,32,5,42241.78,6600.28,48842.06
220211,202311,40,38,2,50165.4,2640.16,52805.56
220213,202311,42,40,2,52809.28,2640,55449.28
220217,202311,46,36,10,47522.65,13200.6,60723.25
220220,202311,2594,1743,851,2300891.16,1123391.34,3424282.50
220225,202311,15,9,6,11880.27,7922.14,19802.41
220230,202311,1074,810,264,1069277.88,349824.34,1419102.22
220240,202311,173,155,18,204607.6,23761.71,228369.31
220245,202311,60,56,4,73922.4,5280.26,79202.66
220250,202311,164,138,26,182170.96,34320.87,216491.83
220253,202311,58,52,6,68641.48,7920.5,76561.98
220255,202311,62,53,9,69961.89,11880.4,81842.29
220260,202311,742,569,173,751131.69,228377.86,979509.55
220265,202311,24,21,3,27720,3960.61,31680.61
220270,202311,942,848,94,1119437.27,124086.35,1243523.62
220271,202311,43,35,8,46203.05,10561.15,56764.20
220272,202311,25,25,0,33000.89,,33000.89
220273,202311,24,22,2,29041.78,2640,31681.78
220275,202311,70,61,9,80520.55,11880,92400.55
220277,202311,40,32,8,42241.86,10560.04,52801.90
220280,202311,28,20,8,26401.7,10560,36961.7
220285,202311,51,47,4,62047.56,5280.4,67327.96
220290,202311,1662,1435,227,1894284.89,299665.74,2193950.63
220300,202311,48,47,1,62046.82,1320.68,63367.50
220310,202311,392,336,56,443585.2,73927.27,517512.47
220320,202311,504,456,48,601992.53,63364.59,665357.12
220323,202311,3,1,2,1320.2,2640,3960.2
220325,202311,16,13,3,17160.69,3960.34,21121.03
220327,202311,21,21,0,27722.72,,27722.72
220330,202311,233,167,66,220445.3,87123.97,307569.27
220335,202311,139,119,20,157082.6,26400.17,183482.77
220340,202311,70,56,14,73922.31,18482.43,92404.74
220342,202311,50,43,7,56771.33,9242.79,66014.12
220345,202311,101,90,11,118804.54,14520.18,133324.72
220350,202311,488,430,58,567622.86,76564.62,644187.48
220360,202311,56,35,21,46201.24,27721.2,73922.44
220370,202311,1470,1229,241,1622418.09,320776.97,1943195.06
220375,202311,23,22,1,29043.78,1320,30363.78
220380,202311,34,23,11,30362.72,14520,44882.72
220385,202311,18,15,3,19802.5,3960.81,23763.31
220390,202311,2663,1490,1173,1967005.3,1549819.38,3516824.68
220400,202311,39,35,4,46200.44,5280.95,51481.39
220410,202311,23,22,1,29044.37,1320.94,30365.31
220415,202311,14,13,1,17163.71,1320.97,18484.68
220420,202311,147,124,23,163701.37,30362.5,194063.87
220430,202311,176,152,24,200661.22,31681.44,232342.66
220435,202311,31,24,7,31683.37,9241.15,40924.52
220440,202311,324,278,46,368329.08,60725.45,429054.53
220450,202311,386,198,188,262711.52,248191.47,510902.99
220455,202311,61,59,2,77885.95,2640,80525.95
220460,202311,25,24,1,31681.98,1320.15,33002.13
220465,202311,68,50,18,66010.72,23763.08,89773.80
220470,202311,263,232,31,306285.43,40925.65,347211.08
220480,202311,67,62,5,81840.52,6600.34,88440.86
220490,202311,94,81,13,106920.37,17160,124080.37
220500,202311,139,117,22,154444.05,29040,183484.05
220510,202311,380,300,80,396052.32,105607.75,501660.07
220515,202311,34,31,3,40926.12,3960.44,44886.56
220520,202311,418,369,49,487149.58,64690.8,551840.38
220525,202311,13,9,4,11880.84,5281.7,17162.54
220527,202311,17,17,0,22444.95,,22444.95
220530,202311,48,24,24,31681.35,31680.27,63361.62
220535,202311,5,4,1,5280.77,1320,6600.77
220540,202311,127,112,15,147842.25,19800.2,167642.45
220545,202311,26,18,8,23763.87,10561.61,34325.48
220550,202311,817,649,168,856771.89,221783.32,1078555.21
220551,202311,17,14,3,18480.9,3960.58,22441.48
220552,202311,16,16,0,21121.52,,21121.52
220553,202311,71,68,3,89765.8,3960,93725.8
220554,202311,5,3,2,3960.24,2640,6600.24
220555,202311,60,47,13,62047.43,17160.94,79208.37
220556,202311,36,32,4,42245.77,5280.1,47525.87
220557,202311,69,63,6,83167.85,7920.58,91088.43
220558,202311,18,10,8,13200.78,10560.9,23761.68
220559,202311,11,11,0,14521.01,,14521.01
220560,202311,91,60,31,79201.73,40920,120121.73
220570,202311,774,498,276,657402.34,364337.76,1021740.10
220580,202311,584,537,47,708980.64,62049.02,771029.66
220585,202311,16,13,3,17161.15,3960.04,21121.19
220590,202311,21,19,2,25084.27,2640,27724.27
220595,202311,87,67,20,88442.3,26401.14,114843.44
220600,202311,26,19,7,25080.68,9241.4,34322.08
220605,202311,39,35,4,46202.56,5280.67,51483.23
220610,202311,110,93,17,122761.4,22440,145201.4
220620,202311,597,515,82,679871.53,108253.6,788125.13
220630,202311,3,2,1,2640,1320,3960
220635,202311,37,33,4,43568.03,5280,48848.03
220640,202311,117,100,17,132001.21,22440,154441.21
220650,202311,126,120,6,159726.77,7920,167646.77
220660,202311,101,76,25,100322.1,33002.67,133324.77
220665,202311,17,17,0,22441.87,,22441.87
220667,202311,34,32,2,42245.03,2640,44885.03
220669,202311,50,44,6,58083.53,7920,66003.53
220670,202311,88,69,19,91085.33,25080.44,116165.77
220672,202311,90,65,25,85806.91,33003.79,118810.70
220675,202311,31,24,7,31687.92,9240.34,40928.26
220680,202311,69,60,9,79200,11880,91080
220690,202311,51,48,3,63361.7,3960,67321.7
220695,202311,31,21,10,27722.37,13201.81,40924.18
220700,202311,2051,1610,441,2125320.61,583470.53,2708791.14
220710,202311,11,9,2,11880.4,2641.25,14521.65
220720,202311,116,102,14,134642.39,18480,153122.39
220730,202311,38,37,1,48840.84,1320,50160.84
220735,202311,14,10,4,13200,5280,18480
220740,202311,72,62,10,81843.1,13200.31,95043.41
220750,202311,152,126,26,166324.94,34321.33,200646.27
220755,202311,26,24,2,31686.07,2640.2,34326.27
220760,202311,83,72,11,95042.23,14520,109562.23
220770,202311,6684,3946,2738,5213351.09,3615920.15,8829271.24
220775,202311,17,13,4,17163.93,5280.91,22444.84
220777,202311,30,29,1,38280.22,1320,39600.22
220779,202311,7,3,4,3960,5280.2,9240.2
220780,202311,1006,853,153,1126048.89,201969.61,1328018.50
220785,202311,7,4,3,5280.8,3961.08,9241.88
220790,202311,1361,1097,264,1448191.93,348510.53,1796702.46
220793,202311,10,7,3,9241.11,3960,13201.11
220795,202311,32,30,2,39603.82,2640,42243.82
220800,202311,4351,3334,1017,4404186.72,1342560.87,5746747.59
220810,202311,95,82,13,108247.94,17160.44,125408.38
220820,202311,277,248,29,327401.08,38287.8,365688.88
220830,202311,1450,1294,156,1709321.46,205939.4,1915260.86
220840,202311,2826,2018,808,2665348.91,1066663.55,3732012.46
220850,202311,95,82,13,108240.6,17160,125400.6
220855,202311,8,4,4,5280.8,5281.2,10562.0
220860,202311,18,14,4,18484.6,5281.52,23766.12
220865,202311,33,30,3,39602.6,3960,43562.6
220870,202311,108,97,11,128043.83,14520,142563.83
220880,202311,368,304,64,401324.35,84488.62,485812.97
220885,202311,35,33,2,43564.62,2640.34,46204.96
220887,202311,6,5,1,6602.41,1320,7922.41
220890,202311,91,78,13,102978.79,17162.03,120140.82
220900,202311,33,20,13,26402.8,17161.45,43564.25
220910,202311,53,40,13,52808.99,17161.26,69970.25
220915,202311,13,11,2,14520.15,2640,17160.15
220920,202311,57,50,7,66006.7,9240.94,75247.64
220930,202311,62,60,2,79202.47,2640,81842.47
220935,202311,19,19,0,25087.46,,25087.46
220937,202311,40,36,4,47526.36,5280,52806.36
220940,202311,73,66,7,87123.02,9240.4,96363.42
220945,202311,6,6,0,7921.08,,7921.08
220950,202311,43,34,9,44883.91,11880.67,56764.58
220955,202311,28,26,2,34322.08,2640,36962.08
220960,202311,50,43,7,56760.96,9240,66000.96
220965,202311,61,56,5,73920,6600,80520
220970,202311,67,56,11,73920.32,14520,88440.32
220975,202311,17,14,3,18485.07,3960.96,22446.03
220980,202311,30,28,2,36961.48,2640.86,39602.34
220985,202311,60,51,9,67322.02,11880.24,79202.26
220987,202311,38,37,1,48847.93,1320.46,50168.39
220990,202311,28,26,2,34320.25,2992.05,37312.30
220995,202311,20,17,3,22440.63,3960.78,26401.41
220997,202311,81,73,8,96369.67,10561.32,106930.99
221000,202311,1416,1252,164,1654088.44,216491.74,1870580.18
221005,202311,60,55,5,72601.8,6600.83,79202.63
221010,202311,34,23,11,30361.13,14520,44881.13
221020,202311,54,48,6,63368.39,7920.78,71289.17
221030,202311,50,41,9,54020.84,11880.78,65901.62
221035,202311,23,21,2,27725.5,2640,30365.5
221037,202311,14,11,3,14521.59,3960.47,18482.06
221038,202311,26,23,3,30360,3960,34320
221039,202311,31,31,0,40920.64,,40920.64
221040,202311,283,241,42,318166.71,55447.08,373613.79
221050,202311,260,218,42,287799.7,55444.22,343243.92
221060,202311,2194,1887,307,2490975.37,405258.08,2896233.45
221062,202311,35,34,1,44884.87,1320,46204.87
221063,202311,22,17,5,22440,6600.67,29040.67
221065,202311,87,71,16,93726.63,21120.12,114846.75
221070,202311,181,161,20,212551.24,26402.28,238953.52
221080,202311,460,386,74,509571.45,99002.96,608574.41
221090,202311,33,26,7,34325.87,9241.12,43566.99
221093,202311,58,48,10,63369.6,13201.37,76570.97
221095,202311,5,5,0,6602.46,,6602.46
221097,202311,14,12,2,15842.53,2641.2,18483.73
221100,202311,30519,18455,12064,24372848.98,15934203.21,40307052.19
221110,202311,1270,997,273,1316176.12,360398.92,1676575.04
221120,202311,641,461,180,608560.81,237611.75,846172.56
221130,202311,1113,897,216,1184121.23,285138.65,1469259.88
221135,202311,41,37,4,48843.59,5280,54123.59
221140,202311,52,46,6,60724.96,7920.07,68645.03
221150,202311,17,14,3,18481.63,3960,22441.63
221160,202311,23,21,2,27726,2640.4,30366.4
221170,202311,26,25,1,33002.64,1320,34322.64
230010,202311,168,147,21,194043.85,29040,223083.85
230015,202311,199,167,32,220440.5,42240,262680.5
230020,202311,2094,1658,436,2188700.65,575560.09,2764260.74
230030,202311,1835,1354,481,1787464.64,634969.09,2422433.73
230040,202311,273,220,53,290403.61,69960.94,360364.55
230050,202311,277,191,86,252126.23,113520.74,365646.97
230060,202311,191,150,41,198001.95,54120.79,252122.74
230070,202311,350,292,58,385447.2,76560.84,462008.04
230075,202311,1052,863,189,1139261.97,249491.14,1388753.11
230080,202311,261,216,45,285131.79,59400.67,344532.46
230090,202311,227,169,58,223085.1,76562.04,299647.14
230100,202311,3173,1797,1376,2373639.31,1817810.31,4191449.62
230110,202311,3391,2156,1235,2848748.98,1631616.2,4480365.18
230120,202311,1385,1065,320,1405895.59,422427.16,1828322.75
230125,202311,215,170,45,224404.97,59401.25,283806.22
230130,202311,584,503,81,663989.58,108243.33,772232.91
230140,202311,253,208,45,274567.04,59400,333967.04
230150,202311,161,125,36,165004.34,47522.11,212526.45
230160,202311,1087,883,204,1165598.65,269284.14,1434882.79
230170,202311,727,616,111,813213.45,146526.51,959739.96
230180,202311,79,72,7,95040.54,9240,104280.54
230185,202311,483,416,67,549164.26,89764.27,638928.53
230190,202311,2876,2149,727,2836880.64,961006.61,3797887.25
230195,202311,593,507,86,669308.06,113528.72,782836.78
230200,202311,523,402,121,530683.34,159724.5,690407.84
230205,202311,478,318,160,419763.42,211200.78,630964.20
230210,202311,1602,1211,391,1598606.74,516139,2114745.74
230220,202311,1835,1215,620,1603948.71,819770.34,2423719.05
230230,202311,1139,909,230,1199970.75,303613.21,1503583.96
230240,202311,2490,2207,283,2914731.85,373586.05,3288317.90
230250,202311,2123,1713,410,2261339.89,541237.2,2802577.09
230260,202311,3746,2351,1395,3106049.11,1841440.67,4947489.78
230270,202311,1542,1186,356,1565627.05,471265.81,2036892.86
230280,202311,3260,2510,750,3314742.03,990048.83,4304790.86
230290,202311,389,338,51,446215.69,67324.12,513539.81
230300,202311,576,428,148,564969.39,195365.27,760334.66
230310,202311,485,375,110,495020.44,146521.39,641541.83
230320,202311,1058,875,183,1155082.52,242886.9,1397969.42
230330,202311,371,300,71,396017.48,93725.56,489743.04
230340,202311,520,418,102,551820.6,134647.63,686468.23
230350,202311,3882,2365,1517,3124686.73,2005190.76,5129877.49
230360,202311,305,248,57,327386.14,75245.15,402631.29
230365,202311,168,133,35,175564.12,46200,221764.12
230370,202311,13595,6918,6677,9140728.99,8817377.84,17958106.83
230380,202311,590,503,87,664017.25,114845.5,778862.75
230390,202311,594,351,243,463339.86,322089.6,785429.46
230393,202311,278,227,51,299643.86,67320.5,366964.36
230395,202311,422,336,86,443591.77,113533.64,557125.41
230400,202311,767,608,159,805240.23,209889.7,1015129.93
230410,202311,3353,2169,1184,2863314.73,1563013.86,4426328.59
230420,202311,7455,4921,2534,6500364.61,3347870.06,9848234.67
230423,202311,407,350,57,462023,75243.35,537266.35
230425,202311,598,477,121,629680.98,159725.77,789406.75
230426,202311,138,113,25,149160.69,33000,182160.69
230427,202311,80,70,10,92407.07,13200,105607.07
230428,202311,2075,1010,1065,1333342.13,1408536.51,2741878.64
230430,202311,524,424,100,559724.08,132011.96,691736.04
230435,202311,1098,791,307,1044177.47,405255.96,1449433.43
230440,202311,114939,53704,61235,70928519.67,80896572.61,151825092.28
230445,202311,371,251,120,331350.12,158407.95,489758.07
230450,202311,664,516,148,681144.11,195363.21,876507.32
230460,202311,119,87,32,114841.73,42241.72,157083.45
230465,202311,355,285,70,376219.17,92407.68,468626.85
230470,202311,2306,1822,484,2405147.69,640228.58,3045376.27
230480,202311,171,152,19,200644.17,25082.29,225726.46
230490,202311,377,297,80,392051.19,105602.27,497653.46
230495,202311,565,407,158,538602.04,208575.87,747177.91
230500,202311,1357,1020,337,1346454.32,444858.78,1791313.10
230510,202311,89,60,29,79200.66,38280,117480.66
230520,202311,475,351,124,463345.97,163687.38,627033.35
230523,202311,3094,1891,1203,2496273.91,1588039.15,4084313.06
230526,202311,278,232,46,306242.59,60720,366962.59
230530,202311,791,559,232,737946.38,306264.97,1044211.35
230533,202311,253,227,26,299647.81,34320.26,333968.07
230535,202311,472,350,122,462038.89,161045.59,623084.48
230540,202311,2011,1794,217,2369601.53,286457.58,2656059.11
230550,202311,4880,3126,1754,4126755.17,2318138.14,6444893.31
230560,202311,659,508,151,670613.58,199333.91,869947.49
230565,202311,256,191,65,252124.47,85803.33,337927.80
230570,202311,351,302,49,398648.71,64682.33,463331.04
230580,202311,1422,968,454,1277821.47,599306.46,1877127.93
230590,202311,1268,980,288,1293552.59,381501.29,1675053.88
230600,202311,348,313,35,413196.35,46202.48,459398.83
230610,202311,570,427,143,563676,190089.37,753765.37
230620,202311,194,162,32,213845.69,42240.79,256086.48
230625,202311,1015,694,321,916130.8,423735.33,1339866.13
230630,202311,1708,1264,444,1668588.21,588748.54,2257336.75
230640,202311,4571,3653,918,4823697.81,1213175,6036872.81
230650,202311,593,504,89,665310.49,117488.57,782799.06
230655,202311,886,683,203,901639.3,267970.8,1169610.1
230660,202311,455,373,82,492370.57,108244.75,600615.32
230670,202311,546,431,115,568981.26,151803.72,720784.98
230680,202311,263,219,44,289103.28,58082.96,347186.24
230690,202311,1094,915,179,1209199.77,237610.41,1446810.18
230700,202311,1216,1004,212,1325355.26,279851.35,1605206.61
230710,202311,755,686,69,905600.6,91084.53,996685.13
230720,202311,164,140,24,184802.85,31682.25,216485.10
230725,202311,357,269,88,355101.16,116164.01,471265.17
230730,202311,14994,7949,7045,10499173.04,9308200.8,19807373.84
230740,202311,839,679,160,896358.95,211211.85,1107570.80
230750,202311,947,775,172,1023072.68,227053.52,1250126.20
230760,202311,1897,1595,302,2105596.4,398657.66,2504254.06
230763,202311,444,376,68,496336.55,89764.34,586100.89
230765,202311,10594,5211,5383,6883350.36,7109093.24,13992443.60
230770,202311,6068,3222,2846,4254712.22,3759602.29,8014314.51
230780,202311,937,801,136,1058694.91,179524.52,1238219.43
230790,202311,369,296,73,390720.95,96360.86,487081.81
230800,202311,1398,990,408,1308190.3,539895.39,1848085.69
230810,202311,1620,1398,222,1846886.89,293068.22,2139955.11
230820,202311,435,285,150,376221.48,198008.74,574230.22
230830,202311,1076,897,179,1184113.75,236293.9,1420407.65
230835,202311,315,262,53,347194.64,69964.93,417159.57
230837,202311,216,172,44,227052.8,58082.52,285135.32
230840,202311,1110,827,283,1093017.74,373574.24,1466591.98
230850,202311,1556,1294,262,1709561.19,345864.99,2055426.18
230860,202311,394,315,79,415819.95,104290.13,520110.08
230870,202311,2074,1742,332,2299604.87,439588.75,2739193.62
230880,202311,99,78,21,102962.06,27720.44,130682.50
230890,202311,679,595,84,785445.25,110884.21,896329.46
230900,202311,360,272,88,359057.75,117485.18,476542.93
230910,202311,258,199,59,262694.97,77881.41,340576.38
230920,202311,590,462,128,609865.05,168966.86,778831.91
230930,202311,1310,926,384,1223719.24,506908.95,1730628.19
230940,202311,979,752,227,992713.62,300972.8,1293686.42
230945,202311,675,525,150,693067.17,198019.1,891086.27
230950,202311,504,435,69,574262.33,91088.12,665350.45
230960,202311,3266,2217,1049,2928047.73,1384815.89,4312863.62
230970,202311,2269,1269,1000,1675203.8,1321411.87,2996615.67
230980,202311,268,195,73,257417.32,96364.85,353782.17
230990,202311,164,129,35,170287.2,46201.77,216488.97
231000,202311,240,221,19,291730.52,25080.34,316810.86
231010,202311,220,152,68,201963.09,89761.58,291724.67
231020,202311,1727,1137,590,1500999.07,778864.47,2279863.54
231025,202311,1317,908,409,1198669.8,539912.77,1738582.57
231030,202311,1196,963,233,1272547.32,307577.81,1580125.13
231040,202311,211,153,58,201967.1,76561.42,278528.52
231050,202311,1079,920,159,1214504.77,209900.17,1424404.94
231060,202311,183,145,38,191408.3,50163.83,241572.13
231070,202311,1764,1230,534,1623756.18,706238.21,2329994.39
231080,202311,296,256,40,337961.19,52801.96,390763.15
231085,202311,828,516,312,681163.83,413176.61,1094340.44
231090,202311,307,248,59,327372.75,77882.64,405255.39
231095,202311,179,134,45,176881.18,59400.1,236281.28
231100,202311,228,185,43,244202.71,56760.81,300963.52
231110,202311,431,357,74,471283.54,97686.68,568970.22
231120,202311,300,244,56,322098.14,73922.7,396020.84
231123,202311,161,153,8,201965.25,10560,212525.25
231126,202311,390,306,84,403929.57,110885.45,514815.02
231130,202311,5771,4534,1237,5986647.96,1635609.1,7622257.06
231135,202311,261,229,32,302290.42,42241.24,344531.66
231140,202311,3534,2550,984,3366253.71,1298952.94,4665206.65
231150,202311,457,420,37,554443.19,48843.76,603286.95
231160,202311,1429,1171,258,1545820.61,340576.61,1886397.22
231170,202311,608,417,191,550474.4,252132.08,802606.48
231180,202311,2298,1982,316,2617768.79,417136.98,3034905.77
231190,202311,271,218,53,287762.43,69961.37,357723.80
231195,202311,281,229,52,302283.52,69960.27,372243.79
231200,202311,1016,812,204,1071927.69,269298.35,1341226.04
231210,202311,591,493,98,650789.93,129362.94,780152.87
231220,202311,1255,878,377,1159055.42,497669.79,1656725.21
231230,202311,1841,1352,489,1786056.05,646816.22,2432872.27
231240,202311,1956,1312,644,1731957.46,850125.73,2582083.19
231250,202311,97,91,6,120125.21,7920,128045.21
231260,202311,292,200,92,264009.35,121445.37,385454.72
231270,202311,1103,844,259,1114170.1,341889.85,1456059.95
231280,202311,102,78,24,102962.02,31680.2,134642.22
231290,202311,9491,5353,4138,7066559.17,5463928.89,12530488.06
231300,202311,672,604,68,797337.94,89761.36,887099.30
231310,202311,981,896,85,1182780.08,112207.84,1294987.92
231320,202311,745,553,192,729994.66,256089.02,986083.68
231325,202311,119,102,17,134648.45,22440.48,157088.93
231330,202311,2224,1684,540,2224430.69,714171.55,2938602.24
231335,202311,285,250,35,330010.05,46200.74,376210.79
231340,202311,2377,1625,752,2145149.03,994006.78,3139155.81
231350,202311,1698,1313,385,1734631.4,508238.52,2242869.92
231355,202311,465,380,85,501629,112203.05,613832.05
231360,202311,707,476,231,629711.27,304939.12,934650.39
231370,202311,107,93,14,122761.79,18480,141241.79
231375,202311,320,240,80,316824.52,105606.92,422431.44
231380,202311,615,485,130,640224.96,171603.74,811828.70
231390,202311,241,182,59,240248.82,77881.78,318130.60
231395,202311,889,522,367,689066.86,484457.5,1173524.36
231400,202311,1430,1197,233,1580135.07,308898.59,1889033.66
231410,202311,1692,1373,319,1813795.33,421107.96,2234903.29
240010,202311,438,201,237,265351.99,312886.66,578238.65
240020,202311,2629,2162,467,2854119.26,616492.84,3470612.10
240030,202311,130,100,30,132002.96,39600.55,171603.51
240040,202311,42,40,2,52800.07,2640.67,55440.74
240050,202311,578,493,85,650829.58,112211.14,763040.72
240060,202311,94,82,12,108244.89,15840.44,124085.33
240070,202311,328,247,81,326050.25,106922.6,432972.85
240080,202311,675,450,225,594049.7,297025.04,891074.74
240090,202311,118,102,16,134641.06,21120.21,155761.27
240100,202311,1739,1618,121,2135940.86,159728.19,2295669.05
240110,202311,1215,836,379,1103667.17,500358.42,1604025.59
240120,202311,177,130,47,171605.98,62041.35,233647.33
240130,202311,296,268,28,353808.75,36964.45,390773.20
240140,202311,107,67,40,88446.94,52802.09,141249.03
240145,202311,842,737,105,972899.16,138601.68,1111500.84
240150,202311,35,26,9,34320.9,11880.2,46201.1
240160,202311,42,35,7,46200.51,9240.02,55440.53
240165,202311,41,34,7,44884.18,9240.8,54124.98
240170,202311,197,138,59,182164.9,77880.63,260045.53
240180,202311,147,104,43,137284.31,56761.11,194045.42
240185,202311,61,51,10,67321.4,13200,80521.4
240190,202311,16,14,2,18482.17,2640.34,21122.51
240200,202311,3507,1864,1643,2464675.37,2174227.95,4638903.32
240210,202311,181,134,47,176881.74,62040.74,238922.48
240220,202311,1316,889,427,1173574.23,563672.84,1737247.07
240230,202311,926,826,100,1090445.48,132009.22,1222454.70
240240,202311,99,65,34,85800.4,44881.38,130681.78
240250,202311,117,101,16,133326.05,21121.22,154447.27
240260,202311,2201,1551,650,2048828.69,858061.86,2906890.55
240270,202311,193,161,32,212525.13,42240,254765.13
240280,202311,77,62,15,81840.2,19800.9,101641.1
240290,202311,49,46,3,60720.88,3960,64680.88
240300,202311,188,104,84,137283.38,110881.88,248165.26
240310,202311,2872,1564,1308,2064636.6,1730639.15,3795275.75
240320,202311,185,171,14,225721.07,18480.5,244201.57
240325,202311,5853,3262,2591,4307640.14,3421777.03,7729417.17
240330,202311,93,88,5,116161.36,6600,122761.36
240340,202311,134,102,32,134641.71,42240.6,176882.31
240350,202311,114,88,26,116161.66,34320.6,150482.26
240360,202311,982,644,338,851473.5,446186.16,1297659.66
240370,202311,75,63,12,83161.5,15840.99,99002.49
240375,202311,49,32,17,42244.78,22440.59,64685.37
240380,202311,242,197,45,260070.25,59403.11,319473.36
240390,202311,20,18,2,23761.08,2640,26401.08
240400,202311,95,83,12,109563.17,15843.37,125406.54
240410,202311,15,11,4,14520,5280,19800
240420,202311,1271,877,394,1157725.16,520107.76,1677832.92
240430,202311,296,263,33,347206.5,43563,390769.5
240440,202311,184,116,68,153125.96,89762.58,242888.54
240450,202311,314,191,123,252139.39,162369.19,414508.58
240460,202311,112,90,22,118802.22,29041.2,147843.42
240470,202311,245,221,24,291762.14,31684.82,323446.96
240480,202311,19,16,3,21120.17,3960.84,25081.01
240485,202311,100,83,17,109562.21,22441.38,132003.59
240490,202311,70,61,9,80522.6,11880.95,92403.55
240500,202311,123,98,25,129361.33,33000,162361.33
240510,202311,39,29,10,38280,13200,51480
240520,202311,102,97,5,128055.35,6600.95,134656.30
240530,202311,82,62,20,81840.03,26400.54,108240.57
240540,202311,111,94,17,124080.8,22440,146520.8
240550,202311,12,10,2,13200.44,2640,15840.44
240560,202311,454,305,149,402628.09,196684.47,599312.56
240570,202311,482,294,188,388129.2,248190.1,636319.3
240580,202311,1557,1103,454,1457391.71,599301.47,2056693.18
240590,202311,33,32,1,42242.01,1320,43562.01
240600,202311,114,106,8,139921.7,10560.5,150482.2
240610,202311,540,443,97,584850.15,128055.35,712905.50
240615,202311,14,13,1,17163.47,1320,18483.47
240620,202311,93,90,3,118803.19,3960,122763.19
240630,202311,54,44,10,58087.54,13201.84,71289.38
240640,202311,46,33,13,43561.31,17160,60721.31
240650,202311,275,216,59,286451.09,79201.41,365652.50
240660,202311,128,107,21,141242.65,27720,168962.65
240670,202311,339,193,146,254787.98,192743.81,447531.79
240680,202311,59,47,12,62042.44,15840,77882.44
240690,202311,55,52,3,68649.04,3960.81,72609.85
240700,202311,194,163,31,215160.3,40920.75,256081.05
240710,202311,2732,1638,1094,2163668.27,1444164.23,3607832.50
240720,202311,1180,809,371,1067960.78,489743.26,1557704.04
240725,202311,80,71,9,93723.45,11880.84,105604.29
240730,202311,158,131,27,172923.54,35640.9,208564.44
240740,202311,267,212,55,279874.45,72610.21,352484.66
240750,202311,58,36,22,47520,29042.27,76562.27
240760,202311,69,55,14,72601.48,18480,91081.48
240770,202311,170,130,40,171603.73,52802.38,224406.11
240780,202311,858,692,166,913504.39,219133.72,1132638.11
240790,202311,43,40,3,52807.33,3960.88,56768.21
240800,202311,11298,7608,3690,10046451.01,4872762.22,14919213.23
240810,202311,25782,13756,12026,18169334.57,15883902.3,34053236.87
240820,202311,320,196,124,258733.88,163697.42,422431.30
240830,202311,1763,1459,304,1927347.48,401311.01,2328658.49
240840,202311,87,74,13,97684.76,17161.37,114846.13
240850,202311,95,79,16,104281.32,21120.78,125402.10
240860,202311,122,118,4,155763.89,5280,161043.89
240870,202311,62,51,11,67326.99,14521.44,81848.43
240880,202311,39,33,6,43560.44,7920,51480.44
240890,202311,1375,775,600,1025742.81,792062.67,1817805.48
240895,202311,78,62,16,81844.3,21121.24,102965.54
240910,202311,206,168,38,221765.24,50160.71,271925.95
240920,202311,13,11,2,14524.57,2640.4,17164.97
240930,202311,474,421,53,555792.3,69968.15,625760.45
240933,202311,72,45,27,59401.45,35641.58,95043.03
240940,202311,2485,2161,324,2852736.05,427716.32,3280452.37
240950,202311,41,36,5,47523.07,6600,54123.07
240960,202311,26,22,4,29045.41,5280.24,34325.65
240970,202311,125,91,34,120121.73,44881.33,165003.06
240980,202311,237,186,51,245528.04,67321.95,312849.99
240990,202311,161,102,59,134643.19,77881.54,212524.73
241000,202311,64,58,6,76566.39,7920.16,84486.55
241010,202311,109,80,29,105600.29,38280,143880.29
241020,202311,125,115,10,151805.52,13201.2,165006.72
241025,202311,27,20,7,26400.94,9242.07,35643.01
241030,202311,135,103,32,135960.44,42240,178200.44
241040,202311,53,42,11,55440.8,14520,69960.8
241050,202311,83,77,6,101642.47,7920,109562.47
241060,202311,33,28,5,36961.76,6600.84,43562.60
241070,202311,26,26,0,34325.05,,34325.05
241080,202311,68,60,8,79203.7,10560.98,89764.68
241090,202311,76,64,12,84482.89,15840.1,100322.99
241100,202311,71,61,10,80525.05,13200.17,93725.22
241105,202311,35,23,12,30364.23,15841.41,46205.64
241110,202311,60,47,13,62041.02,17160.5,79201.52
241120,202311,1976,1473,503,1945781.69,663990.04,2609771.73
241140,202311,224,182,42,240258.44,55442.96,295701.40
241142,202311,54,40,14,52803.04,18481.78,71284.82
241150,202311,1289,1123,166,1483802.45,219138.32,1702940.77
241160,202311,36,23,13,30360,17160,47520
241170,202311,59,49,10,64680.07,13200,77880.07
241180,202311,52,39,13,51486.47,17162.74,68649.21
241190,202311,48,44,4,58084.92,5280.34,63365.26
241200,202311,5778,3031,2747,4002715.98,3630374.05,7633090.03
241210,202311,76,64,12,84482.42,15840,100322.42
241220,202311,1771,1112,659,1467973.75,871257.01,2339230.76
241230,202311,281,228,53,300978.95,69963.6,370942.55
241240,202311,59,45,14,59401.4,18480.78,77882.18
241250,202311,1256,1144,112,1510226.34,147853.51,1658079.85
241255,202311,86,70,16,92401.7,21120.5,113522.2
241260,202311,861,655,206,864657.28,273252.9,1137910.18
241270,202311,88,65,23,85804.08,30360,116164.08
241280,202311,105,91,14,120126.72,18481.31,138608.03
241290,202311,167,128,39,168972.11,51482.31,220454.42
241300,202311,91,57,34,75240.96,44882.18,120123.14
241310,202311,58,39,19,51481.43,25080.1,76561.53
241320,202311,42,25,17,33002.64,22442.66,55445.30
241330,202311,69,57,12,75242.35,15840.8,91083.15
241335,202311,119,107,12,141245.82,15840,157085.82
241340,202311,207,141,66,186125.16,87121.8,273246.96
241350,202311,69,58,11,76561.25,14520,91081.25
241355,202311,63,50,13,66005.73,17162.53,83168.26
241360,202311,74,69,5,91082.48,6600,97682.48
241370,202311,76,60,16,79200,21120.44,100320.44
241380,202311,38,32,6,42242.55,7920,50162.55
241390,202311,97,78,19,102960.64,25080,128040.64
241400,202311,259,192,67,254400.57,88444.13,342844.70
241410,202311,214,194,20,256083.48,26401.26,282484.74
241415,202311,119,94,25,124081.27,33000.71,157081.98
241420,202311,181,108,73,143886.36,96364.87,240251.23
241430,202311,24,19,5,25081.41,6600.2,31681.61
241440,202311,602,513,89,677248.05,117493.13,794741.18
241445,202311,54,48,6,63361.9,7920,71281.9
241450,202311,275,230,45,304948.52,59405.97,364354.49
241460,202311,198,183,15,241568.26,19801.47,261369.73
241470,202311,36,30,6,39604.07,7921.13,47525.20
241475,202311,56,52,4,68641.84,5280,73921.84
241480,202311,184,131,53,172923.74,69962.8,242886.54
241490,202311,17,15,2,19800.74,2640.97,22441.71
241500,202311,56,43,13,58084.68,17161.63,75246.31
250010,202311,117,100,17,132003.4,22440.12,154443.52
250020,202311,37,32,5,42240,6600.4,48840.4
250030,202311,1003,754,249,995363.65,330028.59,1325392.24
250040,202311,452,358,94,472617.1,124088.4,596705.5
250050,202311,312,256,56,337925.41,73922.95,411848.36
250053,202311,71,59,12,77884.64,15840,93724.64
250057,202311,4,3,1,3960,1320,5280
250060,202311,674,487,187,642902.62,246857.99,889760.61
250070,202311,718,577,141,761736.32,186143.23,947879.55
250073,202311,8,8,0,10560.87,,10560.87
250077,202311,206,147,59,194046.23,77881.78,271928.01
250080,202311,426,338,88,446210.74,116170.72,562381.46
250090,202311,231,144,87,190082.35,114840.54,304922.89
250100,202311,666,529,137,698343.22,180850.66,879193.88
250110,202311,772,557,215,735284.88,283805.71,1019090.59
250115,202311,17,7,10,9241.45,13205.29,22446.74
250120,202311,126,91,35,120122.36,46201.99,166324.35
250130,202311,619,514,105,678574.27,138617.57,817191.84
250135,202311,38,17,21,22440.15,27720.18,50160.33
250140,202311,106,86,20,113528.43,26400.8,139929.23
250150,202311,730,502,228,664001.24,300971.21,964972.45
250153,202311,23,18,5,23760.8,6600,30360.8
250157,202311,63,48,15,63360.68,19800,83160.68
250160,202311,279,213,66,282503,87124.28,369627.28
250170,202311,99,66,33,87122,43560.73,130682.73
250180,202311,5765,4038,1727,5332003.65,2279863.06,7611866.71
250190,202311,838,571,267,753753.46,352458.96,1106212.42
250200,202311,91,72,19,95043.26,25080.5,120123.76
250205,202311,29,22,7,29041.56,9240.94,38282.50
250210,202311,92,77,15,101641.92,19800,121441.92
250215,202311,119,75,44,99004.71,58081.77,157086.48
250220,202311,34,22,12,29042.7,15840.94,44883.64
250230,202311,84,74,10,97686.15,13201.13,110887.28
250240,202311,273,202,71,266660.76,93728.57,360389.33
250250,202311,469,399,70,526749.89,92404.38,619154.27
250260,202311,64,52,12,68641.2,15840.12,84481.32
250270,202311,82,60,22,79202.12,29040,108242.12
250280,202311,441,358,83,472575.08,109562.97,582138.05
250290,202311,128,114,14,150483.19,18480.93,168964.12
250300,202311,557,376,181,496362.67,238935.82,735298.49
250310,202311,70,63,7,83165.85,9240,92405.85
250320,202311,2285,1520,765,2006602.92,1009889.13,3016492.05
250330,202311,132,111,21,146528.01,27721.71,174249.72
250340,202311,37,29,8,38281.67,10560.27,48841.94
250350,202311,231,152,79,200647.27,104281.78,304929.05
250355,202311,53,43,10,56760.67,13201.37,69962.04
250360,202311,205,167,38,220458.07,50165.01,270623.08
250370,202311,2652,1703,949,2248189.73,1252806.26,3500995.99
250375,202311,17,11,6,14522.5,7920.78,22443.28
250380,202311,64,55,9,72602.97,11880.67,84483.64
250390,202311,59,48,11,63362.75,14520.44,77883.19
250400,202311,20098,10599,9499,13997456.18,12545366.33,26542822.51
250403,202311,310,239,71,315489.73,93722.08,409211.81
250407,202311,74,59,15,77880.2,19800.64,97680.84
250410,202311,37,32,5,42245.84,6600.27,48846.11
250415,202311,60,37,23,48840,30360,79200
250420,202311,51,42,9,55441.66,11880.44,67322.10
250430,202311,1672,1466,206,1935590.21,274578.41,2210168.62
250435,202311,33,28,5,36961.81,6600,43561.81
250440,202311,712,586,126,773574.64,166329.88,939904.52
250450,202311,97,73,24,96364.85,31680,128044.85
250460,202311,581,385,196,508210.17,260047.52,768257.69
250470,202311,108,78,30,102960.75,39600.14,142560.89
250480,202311,373,294,79,388132.53,104298.34,492430.87
250485,202311,8,7,1,9240,1320,10560
250490,202311,270,216,54,285125.97,71281.54,356407.51
250500,202311,120,91,29,120120.54,38280,158400.54
250510,202311,966,765,201,1009857.71,265329.49,1275187.20
250520,202311,179,123,56,162362.12,73921.52,236283.64
250523,202311,143,114,29,150482.78,38281.29,188764.07
250527,202311,137,92,45,121443.34,59400.91,180844.25
250530,202311,16,12,4,15840.44,5280.34,21120.78
250535,202311,31,25,6,33001.77,7920.44,40922.21
250540,202311,152,122,30,161043.08,39600.54,200643.62
250550,202311,81,78,3,102962.65,3960,106922.65
250560,202311,70,44,26,58081.61,34320.3,92401.91
250570,202311,175,141,34,186123.15,44880.21,231003.36
250580,202311,95,75,20,99087.14,26400,125487.14
250590,202311,25,18,7,23760.44,9241,33001.44
250600,202311,1832,1231,601,1625032.43,793353.04,2418385.47
250610,202311,163,129,34,170308.54,44884.1,215192.64
250620,202311,26,21,5,27721.32,6600.44,34321.76
250625,202311,79,61,18,80536.82,23767.94,104304.76
250630,202311,3429,2126,1303,2809430.57,1721432.65,4530863.22
250640,202311,208,166,42,219145.11,55447.93,274593.04
250650,202311,35,25,10,33000.32,13200,46200.32
250660,202311,69,48,21,63360,27720.77,91080.77
250670,202311,91,74,17,97681.1,22440.59,120121.69
250680,202311,476,380,96,501654.59,126730.11,628384.70
250690,202311,2434,1655,779,2186043.19,1028346.6,3214389.79
250700,202311,1051,872,179,1152424.83,236288.21,1388713.04
250710,202311,572,440,132,580870.53,174261.59,755132.12
250720,202311,146,110,36,145204.45,47520.8,192725.25
250730,202311,449,366,83,483158.76,109569.99,592728.75
250740,202311,87,79,8,104283.05,10560,114843.05
250750,202311,29388,17392,11996,22966145.17,15842882.99,38809028.16
250760,202311,134,105,29,138602.49,38282.24,176884.73
250770,202311,401,269,132,355107.12,174247.37,529354.49
250780,202311,89,59,30,77882.63,39600.26,117482.89
250790,202311,502,318,184,419782.74,242892.88,662675.62
250800,202311,167,149,18,196680.61,23760,220440.61
250810,202311,78,63,15,83160.94,19800.44,102961.38
250820,202311,167,137,30,180853.96,39601.72,220455.68
250830,202311,568,378,190,499026.86,250817.64,749844.50
250840,202311,67,56,11,73924.76,14520.87,88445.63
250850,202311,83,67,16,88442.4,21120,109562.4
250855,202311,21,18,3,23764.55,3961.14,27725.69
250860,202311,259,167,92,220443.67,121440.84,341884.51
250870,202311,41,37,4,48842.18,5280,54122.18
250880,202311,108,80,28,105601.34,36960,142561.34
250890,202311,3552,2597,955,3428242.72,1260665.95,4688908.67
250900,202311,88,73,15,96361.54,19800,116161.54
250905,202311,139,103,36,135960.99,48842.58,184803.57
250910,202311,1058,774,284,1021761.31,374910.55,1396671.86
250915,202311,130,89,41,117484.43,54121.89,171606.32
250920,202311,177,137,40,180840.79,52800.21,233641.00
250930,202311,213,121,92,159721.72,121441.18,281162.90
250933,202311,13,10,3,13200,3961.69,17161.69
250937,202311,25,23,2,30360.5,2641.14,33001.64
250939,202311,51,38,13,50161.83,17160,67321.83
250940,202311,155,114,41,150487.6,54123.5,204611.1
250950,202311,92,67,25,88444.03,33000.98,121445.01
250960,202311,95,57,38,75243.78,50162,125405.78
250970,202311,1457,1037,420,1368940.42,555743.6,1924684.02
250980,202311,105,73,32,96365.05,42240.8,138605.85
250990,202311,182,139,43,183480,56760,240240
251000,202311,100,84,16,110881.24,21120.87,132002.11
251010,202311,167,119,48,157081.34,63361.61,220442.95
251020,202311,103,87,16,114840.59,21120,135960.59
251030,202311,52,37,15,48842.41,19800.49,68642.90
251040,202311,85,63,22,84480.13,29040,113520.13
251050,202311,35,31,4,40920,5280,46200
251060,202311,50,38,12,51484.93,15841.22,67326.15
251065,202311,7,4,3,5280,3961.34,9241.34
251070,202311,19,17,2,22442.66,2640,25082.66
251080,202311,6245,2924,3321,3860042.1,4385390.93,8245433.03
251090,202311,217,181,36,238926.85,47524.54,286451.39
251100,202311,26,23,3,30363,3960,34323
251110,202311,75,49,26,64680,34320.44,99000.44
251120,202311,2177,1377,800,1817849.02,1057429.52,2875278.54
251130,202311,491,406,85,537405.23,112205.82,649611.05
251140,202311,692,458,234,604591.28,310210.42,914801.70
251150,202311,378,312,66,411878.55,87121.55,499000.10
251160,202311,104,86,18,113520.77,23760.16,137280.93
251170,202311,85,70,15,92402.75,19800,112202.75
251180,202311,317,187,130,246862.24,171613.92,418476.16
251190,202311,131,94,37,124089.24,48845.28,172934.52
251200,202311,364,278,86,366993.65,113526.79,480520.44
251203,202311,38,32,6,42244.49,7920.8,50165.29
251207,202311,96,75,21,99003.37,27720.8,126724.17
251210,202311,1745,1270,475,1676510.77,627054.46,2303565.23
251220,202311,60,46,14,60723,18481.55,79204.55
251230,202311,653,550,103,727387.27,135969.87,863357.14
251240,202311,138,97,41,128040.38,54120.98,182161.36
251250,202311,1812,1305,507,1722640.56,669287,2391927.56
251260,202311,16,10,6,13202.5,7921.31,21123.81
251270,202311,367,279,88,368319.59,116167.24,484486.83
251272,202311,69,61,8,80521.92,10560.2,91082.12
251274,202311,22,17,5,22441.78,6601.24,29043.02
251275,202311,46,29,17,38283.44,22440,60723.44
251276,202311,39,29,10,38282.23,13200.15,51482.38
251278,202311,21,17,4,22441.91,5280.98,27722.89
251280,202311,133,128,5,168963.27,6600.8,175564.07
251290,202311,1335,941,394,1242254.91,520134.23,1762389.14
251300,202311,24,19,5,25080.88,6601.04,31681.92
251310,202311,335,235,100,310227.93,132007.66,442235.59
251315,202311,62,55,7,72600,9240,81840
251320,202311,81,63,18,83164.34,23762.03,106926.37
251330,202311,92,81,11,106922.39,14521.14,121443.53
251335,202311,28,21,7,27720,9240.67,36960.67
251340,202311,936,518,418,683802.6,551786.14,1235588.74
251350,202311,45,43,2,56760.39,2640,59400.39
251360,202311,95,81,14,106920.64,18480,125400.64
251365,202311,10,8,2,10563.82,2640.8,13204.62
251370,202311,6778,4645,2133,6135714.5,2817024.36,8952738.86
251380,202311,48,37,11,48843.55,14521.12,63364.67
251385,202311,7,6,1,7921.3,1320,9241.3
251390,202311,1161,858,303,1132668.56,399990.13,1532658.69
251392,202311,57,40,17,52801.24,22440.94,75242.18
251394,202311,26,19,7,25082.05,9240.2,34322.25
251396,202311,11,7,4,9240.41,5281.72,14522.13
251398,202311,20,17,3,22440.31,3960,26400.31
251400,202311,63,49,14,64682.02,18480.6,83162.62
251410,202311,50,40,10,52800.3,13201,66001.3
251420,202311,127,93,34,122763.93,44881.65,167645.58
251430,202311,53,46,7,60720,9240.44,69960.44
251440,202311,56,32,24,42240,31680.67,73920.67
251445,202311,72,62,10,81846.27,13200.53,95046.80
251450,202311,425,360,65,475274.24,87127.9,562402.14
251455,202311,9,8,1,10560,1320.5,11880.5
251460,202311,26,20,6,26400.72,7920.28,34321.00
251465,202311,17,11,6,14520.44,7921.11,22441.55
251470,202311,55,39,16,51480.55,21120.67,72601.22
251480,202311,28,25,3,33000.94,3960.21,36961.15
251490,202311,94,62,32,81854.56,42244.15,124098.71
251500,202311,113,93,20,122763.6,26400.26,149163.86
251510,202311,115,73,42,96362.19,55442.12,151804.31
251520,202311,44,36,8,47520.44,10560,58080.44
251530,202311,4629,3275,1354,4323213.7,1793986.76,6117200.46
251540,202311,108,88,20,116160,26401.03,142561.03
251550,202311,475,361,114,476578.29,150501.82,627080.11
251560,202311,28,21,7,27721.94,9241.58,36963.52
251570,202311,19,18,1,23760,1320,25080
251580,202311,137,108,29,142561.69,38280,180841.69
251590,202311,105,75,30,99000.4,39600.57,138600.97
251593,202311,37,21,16,27720.47,21121.44,48841.91
251597,202311,136,111,25,146522.9,33001.91,179524.81
251600,202311,1179,822,357,1085134.53,471261.35,1556395.88
251610,202311,314,228,86,300982.79,113524.25,414507.04
251615,202311,29,25,4,33000.4,5280,38280.4
251620,202311,4486,2834,1652,3742527.7,2180781.01,5923308.71
251630,202311,530,388,142,512230.44,187463.6,699694.04
251640,202311,108,79,29,104292.87,38287.41,142580.28
251650,202311,346,250,96,330032.44,126729.98,456762.42
251660,202311,235,208,27,274593.89,35643.21,310237.10
251670,202311,466,354,112,468652.68,147851.92,616504.60
251675,202311,16,13,3,17160,3960.37,21120.37
251680,202311,111,99,12,130683.43,15840.89,146524.32
251690,202311,350,284,66,375253.53,87126.05,462379.58
251700,202311,293,249,44,328722.53,58087.04,386809.57
251710,202311,24,17,7,22441.3,9242.03,31683.33
251720,202311,44,31,13,40923.59,17161.93,58085.52
251740,202311,17,11,6,14521.94,7920,22441.94
260005,202311,4268,2194,2074,2897118.55,2739225.01,5636343.56
260010,202311,2019,1518,501,2005159.72,661343.41,2666503.13
260020,202311,476,419,57,553137.09,75244,628381.09
260030,202311,703,476,227,628397.19,299663.76,928060.95
260040,202311,830,539,291,711572.29,384149.59,1095721.88
260050,202311,1238,905,333,1194691.94,439582.08,1634274.02
260060,202311,386,347,39,458080.12,51484.36,509564.48
260070,202311,1450,895,555,1181576.11,732713.62,1914289.73
260080,202311,827,602,225,796073.92,297022.08,1093096.00
260090,202311,514,348,166,459391.05,219142.24,678533.29
260100,202311,246,161,85,212523.6,112201.68,324725.28
260105,202311,309,183,126,241564.81,166322.07,407886.88
260110,202311,3383,2455,928,3240873.55,1226354.54,4467228.09
260120,202311,3036,1630,1406,2154747.02,1856041.16,4010788.18
260130,202311,251,182,69,240245.98,91082.6,331328.58
260140,202311,2492,1616,876,2134616.48,1157714.49,3292330.97
260150,202311,220,145,75,191422.51,99009.55,290432.06
260160,202311,399,315,84,415837.17,110885.24,526722.41
260170,202311,3841,2303,1538,3042917.7,2032962.5,5075880.2
260180,202311,168,147,21,194052.38,27722.34,221774.72
260190,202311,2871,1842,1029,2432930.75,1358361.2,3791291.95
260200,202311,1109,861,248,1136606.97,327371.75,1463978.72
260210,202311,1507,1088,419,1436285.94,553130.3,1989416.24
260220,202311,670,593,77,782847.36,101647.39,884494.75
260230,202311,1469,1072,397,1415145.46,524078.35,1939223.81
260240,202311,226,173,53,228386.01,69965.71,298351.72
260250,202311,115,88,27,116165.97,35640,151805.97
260260,202311,1231,849,382,1120764.14,504276.44,1625040.58
260270,202311,274,198,76,261376.39,100324.47,361700.86
260280,202311,1271,1002,269,1324064,356424.17,1680488.17
260290,202311,8085,4369,3716,5772732.74,4906844.71,10679577.45
260300,202311,1157,969,188,1279202.07,248172.29,1527374.36
260310,202311,577,453,124,599340.08,163693.93,763034.01
260320,202311,869,639,230,843499.76,304925.35,1148425.11
260330,202311,107,82,25,108240.91,33000.94,141241.85
260340,202311,102,78,24,102964.87,31680.91,134645.78
260345,202311,6776,3401,3375,4489788.49,4455405.26,8945193.75
260350,202311,527,381,146,502971.22,192732.46,695703.68
260360,202311,275,165,110,217802.63,145201.29,363003.92
260370,202311,784,514,270,678546.02,356432.21,1034978.23
260380,202311,592,432,160,570300.86,211214.61,781515.47
260390,202311,317,271,46,357753.83,60724.75,418478.58
260392,202311,138,116,22,153125.32,29041.63,182166.95
260400,202311,5136,2951,2185,3895491.19,2886964.87,6782456.06
260410,202311,17401,9016,8385,11903485.81,11079518.31,22983004.12
260415,202311,181,144,37,190087.36,48840,238927.36
260420,202311,1979,1255,724,1658014.99,955732.19,2613747.18
260430,202311,187,168,19,221793.49,25081.84,246875.33
260440,202311,227,152,75,200650.69,99008.68,299659.37
260450,202311,517,397,120,524083.14,158417.81,682500.95
260460,202311,976,510,466,675898.49,615165.67,1291064.16
260470,202311,365,226,139,298353.04,183496.68,481849.72
260480,202311,292,178,114,234963.09,150482.65,385445.74
260490,202311,260,196,64,258738.09,84481.43,343219.52
260500,202311,1283,855,428,1128725.79,565015.16,1693740.95
260510,202311,928,741,187,979492.02,246850.04,1226342.06
260515,202311,289,265,24,349808.43,31681.95,381490.38
260520,202311,3524,2185,1339,2884360,1770254.51,4654614.51
260530,202311,970,781,189,1032352.8,249499.86,1281852.66
260540,202311,609,467,142,616496.86,187456.56,803953.42
260545,202311,45,24,21,31683.53,27722.95,59406.48
260550,202311,409,264,145,348486.35,191402.63,539888.98
260560,202311,543,419,124,553149.64,163693.56,716843.20
260570,202311,1144,915,229,1207929.23,303613.96,1511543.19
260580,202311,412,324,88,427699.12,116162.72,543861.84
260590,202311,676,410,266,541210.85,351129.37,892340.22
260600,202311,8615,5052,3563,6674334.48,4706095.52,11380430.00
260610,202311,575,404,171,533336.03,225740.99,759077.02
260620,202311,4262,2231,2031,2945145.46,2681228.91,5626374.37
260630,202311,92,77,15,101640.01,19800,121440.01
260640,202311,3704,2293,1411,3026949.57,1863968.99,4890918.56
260650,202311,345,253,92,333994.51,121453.13,455447.64
260660,202311,691,473,218,624414.53,287775.73,912190.26
260670,202311,128,91,37,120120,48840,168960
260680,202311,4630,2481,2149,3277921.12,2839660.79,6117581.91
260690,202311,155,120,35,158405.58,46201.84,204607.42
260700,202311,352,248,104,327398.21,137299.17,464697.38
260710,202311,64,54,10,71280,13200.85,84480.85
260720,202311,3105,1800,1305,2376164.54,1727946.96,4104111.50
260730,202311,882,647,235,854075.78,310207.58,1164283.36
260740,202311,80,68,12,89764.09,15840,105604.09
260750,202311,600,447,153,590117.15,201982.37,792099.52
260760,202311,882,438,444,578213.06,586124.58,1164337.64
260765,202311,1135,610,525,805246.16,693054.21,1498300.37
260770,202311,247,177,70,233639.26,92407.13,326046.39
260775,202311,994,491,503,649499.01,664007.06,1313506.07
260780,202311,264,158,106,208565.07,139921.74,348486.81
260790,202311,18710,8900,9810,11755777.55,12955433.45,24711211.00
260795,202311,186,117,69,154440.9,91080.11,245521.01
260800,202311,327,263,64,347188.39,84484.06,431672.45
260805,202311,59,39,20,51484.48,26404.84,77889.32
260810,202311,957,753,204,994038.82,269286.88,1263325.70
260820,202311,353,231,122,305257.23,161043.89,466301.12
260825,202311,234,163,71,215162.73,93720.93,308883.66
260830,202311,319,208,111,274562.18,146521.38,421083.56
260840,202311,311,218,93,287784.63,122766.77,410551.40
260845,202311,246,152,94,200642.44,125402.36,326044.80
260850,202311,465,349,116,460719.53,153126.17,613845.70
260860,202311,273,204,69,269288.11,91082.98,360371.09
260870,202311,365,281,84,370962.9,110889.45,481852.35
260875,202311,835,609,226,803971.15,298339.59,1102310.74
260880,202311,1814,1207,607,1593315.4,801259.9,2394575.3
260890,202311,2916,1987,929,2623030.48,1226352.21,3849382.69
260900,202311,1167,885,282,1168268.14,373598.91,1541867.05
260910,202311,263,212,51,279859.52,67323.65,347183.17
260915,202311,306,234,72,308880,95040.4,403920.4
260920,202311,258,151,107,199320.84,141240.5,340561.34
260930,202311,402,342,60,451494.12,79205.33,530699.45
260940,202311,2816,1508,1308,1990779.41,1729378.44,3720157.85
260950,202311,2203,1251,952,1651455.88,1256759.86,2908215.74
260960,202311,16069,7695,8374,10162702.53,11068112.59,21230815.12
260970,202311,497,398,99,525419.93,130687.4,656107.33
260980,202311,243,226,17,298335.03,22440.44,320775.47
260990,202311,3006,2378,628,3139233.5,829008.81,3968242.31
261000,202311,4692,2924,1768,3859878.63,2333880.66,6193759.29
261010,202311,142,110,32,145202.15,42243.09,187445.24
261020,202311,646,475,171,627073.11,225736.61,852809.72
261030,202311,283,212,71,279843.29,93722.78,373566.07
261040,202311,421,349,72,460728.52,95045.17,555773.69
261050,202311,623,496,127,654789.05,167647.23,822436.28
261060,202311,1900,1169,731,1543165.73,964966.98,2508132.71
261070,202311,11494,5376,6118,7099835.87,8084610.01,15184445.88
261080,202311,398,309,89,407930.26,117486.11,525416.37
261090,202311,2240,1724,516,2275892.47,682486.89,2958379.36
261100,202311,1344,922,422,1217151.41,558393.2,1775544.61
261110,202311,11015,6954,4061,9181515.58,5370177.18,14551692.76
261120,202311,240,204,36,269283.04,47522.47,316805.51
261130,202311,633,383,250,505635.1,330039.78,835674.88
261140,202311,247,156,91,205922.48,120120,326042.48
261150,202311,696,455,241,600640.18,318133.96,918774.14
261153,202311,81,76,5,100323.91,6600,106923.91
261160,202311,88241,42889,45352,56650886.68,59914197.38,116565084.06
261170,202311,549,413,136,545168.19,179526.94,724695.13
261180,202311,2006,1260,746,1664953.19,984781.18,2649734.37
261190,202311,642,437,205,576892.47,270609.58,847502.05
261200,202311,226,179,47,236304.86,62042.6,298347.46
261210,202311,60,43,17,56760.78,22440,79200.78
261220,202311,3229,2241,988,2958308.64,1305572.06,4263880.70
261230,202311,415,306,109,403946.41,145205.31,549151.72
261240,202311,474,404,70,533309.92,92403.64,625713.56
261245,202311,302,258,44,340562.22,58080.27,398642.49
261247,202311,202,153,49,201973.03,64683.28,266656.31
261250,202311,4595,2255,2340,2976842.7,3091697.88,6068540.58
261255,202311,278,245,33,323403.58,43560,366963.58
261260,202311,956,815,141,1075955.1,186133.45,1262088.55
261270,202311,228,160,68,211207.77,89761.68,300969.45
261280,202311,204,168,36,221784.01,48841.77,270625.78
261290,202311,127,90,37,118800,48841.43,167641.43
261300,202311,1626,1222,404,1614470.92,534630.97,2149101.89
261310,202311,934,617,317,814519.42,418469.12,1232988.54
261320,202311,551,390,161,514845.2,212536.95,727382.15
261330,202311,936,744,192,982223.65,253476.05,1235699.70
261340,202311,371,209,162,277216.47,213852.8,491069.27
261350,202311,1049,731,318,965029.18,419802.39,1384831.57
261360,202311,1531,965,566,1276483.46,748469.18,2024952.64
261370,202311,5697,3307,2390,4365510.31,3157588.96,7523099.27
261380,202311,642,514,128,678509.31,168980.75,847490.06
261390,202311,4321,2982,1339,3937968.07,1767677.95,5705646.02
261400,202311,301,269,32,355119.08,42241.61,397360.69
261410,202311,1248,814,434,1075886.99,574222.52,1650109.51
261420,202311,1088,653,435,862031.5,575544.94,1437576.44
261430,202311,345,311,34,410555.7,46203.51,456759.21
261440,202311,115,108,7,142565.35,9240.97,151806.32
261450,202311,2868,2179,689,2877828.84,909523.9,3787352.74
261460,202311,897,688,209,908258.86,275895.87,1184154.73
261470,202311,254,202,52,266647.72,68641.09,335288.81
261480,202311,531,398,133,525407.96,176831.42,702239.38
261485,202311,449,267,182,353786.81,240252.59,594039.40
261500,202311,715,454,261,599361.92,345874.77,945236.69
261510,202311,58,41,17,54122.14,22440.68,76562.82
261520,202311,122,104,18,137289.75,23761.55,161051.30
261530,202311,4863,3150,1713,4159517.07,2262599.56,6422116.63
261540,202311,1749,991,758,1308196.01,1000614.89,2308810.90
261550,202311,311,155,156,204603.92,205924.2,410528.12
261560,202311,1118,747,371,986125,489755.08,1475880.08
261570,202311,446,357,89,471289.52,117493.55,588783.07
261580,202311,438,344,94,454134.15,124088.67,578222.82
261590,202311,216,171,45,225742.22,60723.3,286465.52
261600,202311,361,279,82,368318.68,108242.09,476560.77
261610,202311,124,99,25,130684.48,33000.74,163685.22
261618,202311,97,69,28,91083.86,36961.11,128044.97
261620,202311,231,151,80,199329.45,105603.99,304933.44
261630,202311,732,565,167,745853.22,220461.38,966314.60
261640,202311,7684,4113,3571,5429732.66,4718183.72,10147916.38
261650,202311,466,299,167,394690.16,221766.75,616456.91
270010,202311,548,482,66,636316.57,87133.11,723449.68
270020,202311,257,219,38,289103.9,50163.39,339267.29
270030,202311,10343,6692,3651,8838008.49,4824862.26,13662870.75
270040,202311,2249,1518,731,2004488.95,967630.15,2972119.10
270050,202311,272,214,58,282490.07,76562.27,359052.34
270060,202311,65,48,17,63369.69,22443.31,85813.00
270070,202311,810,605,205,798658.46,270615.04,1069273.50
270080,202311,69,55,14,73922.36,18480,92402.36
270090,202311,23,19,4,25080,5280,30360
270100,202311,1408,970,438,1281792.9,578201.29,1859994.19
270110,202311,65,51,14,67322.99,18480,85802.99
270120,202311,331,275,56,363028.9,73926.1,436955.0
270130,202311,378,298,80,393380.3,105606.92,498987.22
270135,202311,127,94,33,124083.17,43560,167643.17
270140,202311,1528,1032,496,1363646.27,656120.77,2019767.04
270150,202311,280,199,81,262708.92,106925.22,369634.14
270160,202311,507,403,104,532015.99,137299.56,669315.55
270170,202311,857,571,286,755060.29,377528.21,1132588.50
270180,202311,63,50,13,66000.67,17160.9,83161.57
270190,202311,122,108,14,142568.53,18480,161048.53
270200,202311,135,118,17,155763.94,22440.44,178204.38
270210,202311,579,370,209,488424.67,275895.97,764320.64
270220,202311,200,146,54,192725.87,71283.75,264009.62
270230,202311,2405,1577,828,2083064.38,1094331.31,3177395.69
270235,202311,552,440,112,580858.62,147851.48,728710.10
270240,202311,3533,2777,756,3667148.73,997978.02,4665126.75
270250,202311,111,92,19,121444.13,25081.75,146525.88
270255,202311,235,196,39,258724.33,51480.72,310205.05
270260,202311,439,354,85,467338.64,112209.36,579548.00
270270,202311,99,54,45,71280.96,59403.43,130684.39
270280,202311,200,128,72,168960,95040,264000
270290,202311,1216,959,257,1265958.42,340588.8,1606547.22
270300,202311,413,307,106,405243.63,139921.66,545165.29
270310,202311,855,726,129,959193.39,171609.39,1130802.78
270320,202311,797,689,108,910892.38,143891.87,1054784.25
270330,202311,361,311,50,410522.84,66000.32,476523.16
270340,202311,72,58,14,76562.94,18480.04,95042.98
270350,202311,80,47,33,62045.37,43565.22,105610.59
270360,202311,97,55,42,72603.24,55440.78,128044.02
270370,202311,80,61,19,81840,25080,106920
270375,202311,90,59,31,77884.13,40921.82,118805.95
270380,202311,1099,765,334,1009807.44,442204.61,1452012.05
270390,202311,130,79,51,104281.11,67320.59,171601.70
270400,202311,826,643,183,848826.77,241573.69,1090400.46
270410,202311,233,178,55,234990.78,72607.69,307598.47
270420,202311,453,320,133,422426.64,175576.92,598003.56
270430,202311,39088,27825,11263,36750428.23,14888535.52,51638963.75
270440,202311,471,373,98,492410.93,129371.99,621782.92
270450,202311,988,605,383,799968.82,505592.35,1305561.17
270460,202311,184,145,39,192742.64,51489.78,244232.42
270470,202311,1897,1357,540,1791349.33,714169.01,2505518.34
270480,202311,610,490,120,646830.11,158407.81,805237.92
270490,202311,28,21,7,27720.44,9240.44,36960.88
270500,202311,496,414,82,546540.71,110888.57,657429.28
270510,202311,965,664,301,879130.33,397353.9,1276484.23
270520,202311,277,187,90,246842.18,120122.76,366964.94
270530,202311,65,50,15,66002.03,19800,85802.03
270540,202311,82,60,22,79200.81,29040,108240.81
270550,202311,1665,1303,362,1720074,479190.87,2199264.87
270560,202311,267,170,97,224428.36,128058.51,352486.87
270570,202311,643,465,178,613821.51,234974.46,848795.97
270580,202311,22,17,5,22440,6600.67,29040.67
270590,202311,64,54,10,71286.67,13202.38,84489.05
270600,202311,186,152,34,200674.96,44884.21,245559.17
270610,202311,272,215,57,285130.66,75243.41,360374.07
270620,202311,19,19,0,25080.88,,25080.88
270630,202311,3842,2890,952,3816593.42,1258050.29,5074643.71
270640,202311,930,686,244,905596.48,322105.76,1227702.24
270642,202311,230,192,38,253450.23,51484.73,304934.96
270644,202311,266,182,84,241567.52,110886.17,352453.69
270650,202311,369,237,132,312854.32,174244.69,487099.01
270660,202311,178,157,21,207250.1,27723.15,234973.25
270670,202311,3147,2414,733,3188015.98,967617.96,4155633.94
270680,202311,423,288,135,381517.77,178215.6,559733.37
270690,202311,1343,929,414,1227681.27,546508.19,1774189.46
270700,202311,24,19,5,25080.78,6600.8,31681.58
270710,202311,596,473,123,624413.55,162373.6,786787.15
270720,202311,243,203,40,267982.35,52807.88,320790.23
270730,202311,2056,1324,732,1747785.16,967619.12,2715404.28
270740,202311,35,27,8,35640.96,10560,46200.96
270750,202311,643,505,138,666616.16,182165.61,848781.77
270760,202311,297,216,81,285148.85,106926.52,392075.37
270770,202311,3166,2211,955,2918722.88,1262025.42,4180748.30
270780,202311,79,50,29,66000.44,38281.49,104281.93
270790,202311,208,141,67,186134.25,88449.22,274583.47
270800,202311,2140,1729,411,2282454.94,542555.27,2825010.21
270810,202311,217,175,42,231005.59,55443,286448.59
270820,202311,122,86,36,113528.11,47526.27,161054.38
270830,202311,908,703,205,928048.53,270625.41,1198673.94
270840,202311,1353,1067,286,1408520.85,377540.24,1786061.09
270850,202311,1611,1078,533,1425666.22,703600.26,2129266.48
270860,202311,2806,1924,882,2539792.95,1164320.39,3704113.34
270870,202311,140,85,55,112203.07,72602.82,184805.89
270880,202311,922,741,181,978211.24,238938.05,1217149.29
270890,202311,269,210,59,278530.58,77883.4,356413.98
270895,202311,84,79,5,104281.41,6600,110881.41
270900,202311,67,55,12,72605.92,15840.94,88446.86
270910,202311,327,278,49,367017.75,64684.27,431702.02
270915,202311,2028,1383,645,1825656.1,851466.4,2677122.5
270920,202311,403,335,68,442230.87,89768.15,531999.02
270930,202311,5613,4379,1234,5780701.99,1629049.65,7409751.64
270940,202311,2294,1859,435,2455353.42,574238.6,3029592.02
280010,202311,35,30,5,39603.3,6600.11,46203.41
280020,202311,558,473,85,625720.28,112203.48,737923.76
280030,202311,24718,15893,8825,20990697.97,11671451.85,32662149.82
280040,202311,366,234,132,308896.56,174254.97,483151.53
280050,202311,469,359,110,473913.13,145207.05,619120.18
280060,202311,478,317,161,418462.03,212527.63,630989.66
280067,202311,1230,897,333,1184099.96,439586.38,1623686.34
280070,202311,140,120,20,158405.15,26400.64,184805.79
280100,202311,763,588,175,776211,231019.29,1007230.29
280110,202311,104,91,13,120126.22,18480.62,138606.84
280120,202311,777,650,127,858039.94,168966.67,1027006.61
280130,202311,1971,1292,679,1705514.05,896314.42,2601828.47
280140,202311,567,470,97,620435.16,128043.74,748478.90
280150,202311,461,333,128,439585.81,168965.41,608551.22
280160,202311,160,122,38,161047.75,50160.5,211208.25
280170,202311,473,342,131,451475.1,172928.36,624403.46
280190,202311,34,27,7,35641.5,9240.4,44881.9
280200,202311,59,47,12,62050.88,15842.48,77893.36
280210,202311,3382,2422,960,3198485.96,1269899.17,4468385.13
280220,202311,70,58,12,76565.43,15841.27,92406.70
280230,202311,362,292,70,385481.58,92407.92,477889.50
280240,202311,150,140,10,184820.06,13201.38,198021.44
280250,202311,27,10,17,13202.02,22443.17,35645.19
280260,202311,91,75,16,99009.69,21120.11,120129.80
280270,202311,147,117,30,154442.98,39602.75,194045.73
280280,202311,208,143,65,190092.73,85804.5,275897.23
280290,202311,4308,3168,1140,4182091.74,1506233.59,5688325.33
280300,202311,1868,1488,380,1965604.39,502955.29,2468559.68
280310,202311,119,110,9,145208.65,11880,157088.65
280320,202311,763,527,236,697044.08,312867.76,1009911.84
280330,202311,350,259,91,341921.98,121449.73,463371.71
280340,202311,484,401,83,529356.65,109566.36,638923.01
280350,202311,4217,3220,997,4252205.51,1316158.27,5568363.78
280360,202311,511,350,161,462041.4,212538.83,674580.23
280370,202311,102,86,16,113530.97,21123.56,134654.53
280380,202311,52,40,12,52800,15840.78,68640.78
280390,202311,193,165,28,217809.23,36961.91,254771.14
280400,202311,460,294,166,388111.02,219129.45,607240.47
280410,202311,326,274,52,363042.85,68648.92,431691.77
280420,202311,155,135,20,178219.6,26402.01,204621.61
280430,202311,113,91,22,120125.45,29043.17,149168.62
280440,202311,787,655,132,864664.64,174252.07,1038916.71
280445,202311,133,124,9,163691.74,11880.05,175571.79
280450,202311,1488,1274,214,1683127.06,283817.47,1966944.53
280460,202311,769,577,192,763027.6,254790.76,1017818.36
280470,202311,81,78,3,102974.25,3960.88,106935.13
280480,202311,3741,2515,1226,3320185.28,1618468.63,4938653.91
280490,202311,192,177,15,233678.67,19800.61,253479.28
280500,202311,43,40,3,52808.58,3960.86,56769.44
280510,202311,144,111,33,146529.85,43563.43,190093.28
280520,202311,56,39,17,51482.52,22441.33,73923.85
280530,202311,79,52,27,68647.14,35643.06,104290.20
280540,202311,622,536,86,707549.01,113524.29,821073.30
280550,202311,794,733,61,967652.4,80524.98,1048177.38
280560,202311,511,464,47,612524.04,63366.12,675890.16
280570,202311,2680,2126,554,2806450.57,731305.31,3537755.88
280580,202311,632,499,133,658743.82,175577.83,834321.65
280590,202311,246,164,82,216503.52,108255.77,324759.29
280600,202311,459,372,87,491140.28,114845.06,605985.34
280610,202311,136,94,42,124102.69,55445.01,179547.70
280620,202311,585,471,114,621747.16,150480.75,772227.91
280630,202311,162,135,27,178209.31,35641.3,213850.61
280640,202311,180,147,33,194045.75,44880.84,238926.59
280650,202311,88,54,34,71284.81,44881.78,116166.59
280660,202311,132,99,33,130691.33,43567.16,174258.49
280670,202311,2255,1450,805,1915564.26,1062702.38,2978266.64
280680,202311,273,235,38,310209.71,50160.32,360370.03
280690,202311,82,72,10,95042.2,13200.11,108242.31
280700,202311,22,22,0,29041.13,,29041.13
280710,202311,1692,1304,388,1722727.21,512197.35,2234924.56
280720,202311,150,110,40,145209.65,52803.29,198012.94
280730,202311,36,32,4,42241.06,5280.04,47521.10
280740,202311,2830,2138,692,2823684.15,914802.49,3738486.64
280750,202311,221,194,27,256106.93,35642.46,291749.39
280760,202311,1055,714,341,942550.47,450147,1392697.47
290010,202311,205,142,63,187456.35,83163.77,270620.12
290020,202311,221,199,22,262694.2,29042.17,291736.37
290030,202311,676,440,236,580844.23,311537.69,892381.92
290035,202311,159,129,30,170288.78,39602.44,209891.22
290040,202311,284,205,79,270618.94,104284.17,374903.11
290050,202311,103,84,19,110881.12,25080,135961.12
290060,202311,256,109,147,143882.5,194040.95,337923.45
290070,202311,6819,3262,3557,4310262.4,4698340.9,9008603.3
290080,202311,538,245,293,323419.84,386776.33,710196.17
290090,202311,330,158,172,208562.64,228362.73,436925.37
290100,202311,1917,1224,693,1617143.93,916151.11,2533295.04
290110,202311,992,553,439,730048.9,579521.82,1309570.72
290115,202311,187,172,15,227058.23,19800.59,246858.82
290120,202311,912,619,293,817168.98,386782.42,1203951.40
290130,202311,527,328,199,432995.09,262694.71,695689.80
290135,202311,302,224,78,295704.81,102966.99,398671.80
290140,202311,352,295,57,389450.05,75247.73,464697.78
290150,202311,160,112,48,147841.58,63360.25,211201.83
290160,202311,257,204,53,269315.97,69968.4,339284.37
290170,202311,121,90,31,118811.47,40923.21,159734.68
290180,202311,217,156,61,205930.02,80521.75,286451.77
290190,202311,295,228,67,300989.34,88443.43,389432.77
290195,202311,319,223,96,294371.6,126720.4,421092.0
290200,202311,275,221,54,291727.22,71281.6,363008.82
290205,202311,179,110,69,145209.34,91084.03,236293.37
290210,202311,1379,1000,379,1320155.11,500323.95,1820479.06
290220,202311,166,105,61,138629,80532.59,219161.59
290225,202311,313,126,187,166323.66,246844.69,413168.35
290230,202311,113,71,42,93724.36,55442.79,149167.15
290240,202311,421,153,268,201965.84,355084.16,557050.00
290250,202311,254,235,19,310247.14,25080.42,335327.56
290260,202311,388,300,88,396066.76,116176.52,512243.28
290265,202311,207,180,27,237622.33,35643.64,273265.97
290270,202311,1485,1218,267,1607965.71,352466.77,1960432.48
290280,202311,562,395,167,521467.31,220464.95,741932.26
290290,202311,1660,1039,621,1371554.95,819752.82,2191307.77
290300,202311,411,350,61,462071.82,81850.6,543922.42
290310,202311,293,144,149,190084.39,196684.27,386768.66
290320,202311,4797,2874,1923,3795414.54,2539868.87,6335283.41
290323,202311,225,192,33,253476.4,43564.4,297040.8
290327,202311,188,146,42,192740.73,55441.82,248182.55
290330,202311,142,69,73,91081.28,96361.45,187442.73
290340,202311,845,358,487,472623.96,642910.32,1115534.28
290350,202311,769,468,301,617814.03,397342.02,1015156.05
290360,202311,335,264,71,348513.92,93725.45,442239.37
290370,202311,913,440,473,580814.51,624371.09,1205185.60
290380,202311,353,231,122,304949.98,161056.51,466006.49
290390,202311,2621,1625,996,2149203.68,1316152.25,3465355.93
290395,202311,251,151,100,199331.46,132007.78,331339.24
290400,202311,309,230,79,303640.39,105609.8,409250.19
290405,202311,263,225,38,297014.08,50160.8,347174.88
290410,202311,702,583,119,769615.88,158408.36,928024.24
290420,202311,307,254,53,335300.28,69965.06,405265.34
290430,202311,531,340,191,448816.7,252128.08,700944.78
290440,202311,49,49,0,64681.8,,64681.8
290450,202311,207,151,56,199336.02,73925.89,273261.91
290460,202311,2193,1306,887,1724113.01,1174873.07,2898986.08
290470,202311,1425,653,772,862031.39,1019113.44,1881144.83
290475,202311,594,555,39,733956.46,51481.24,785437.70
290480,202311,194,112,82,147843.01,108242.1,256085.11
290485,202311,258,231,27,304928,35640,340568
290490,202311,1407,986,421,1301598.61,557068.76,1858667.37
290500,202311,904,507,397,670619.88,524079.94,1194699.82
290510,202311,189,155,34,204637.14,44887.18,249524.32
290515,202311,219,143,76,188769.77,100323.69,289093.46
290520,202311,1563,1046,517,1380855.98,682487.16,2063343.14
290530,202311,292,254,38,335331.42,50166.44,385497.86
290540,202311,166,82,84,108245.86,110884.84,219130.70
290550,202311,198,161,37,212525.35,48840.94,261366.29
290560,202311,3416,1589,1827,2098956.55,2415747.25,4514703.80
290570,202311,8265,3935,4330,5194846.95,5721480.6,10916327.55
290580,202311,1418,866,552,1143214.84,728687.79,1871902.63
290590,202311,622,499,123,658769.55,162383.18,821152.73
290600,202311,2020,1386,634,1831058.75,836946.05,2668004.80
290610,202311,181,168,13,221792.08,17162.44,238954.52
290620,202311,425,375,50,495048.79,66004.55,561053.34
290630,202311,2157,937,1220,1238277.45,1611814.84,2850092.29
290640,202311,146,113,33,149181.89,43565.68,192747.57
290650,202311,2384,1117,1267,1475922.14,1672596.48,3148518.62
290660,202311,300,249,51,328723.24,67323.96,396047.20
290670,202311,1209,616,593,813225.5,785483.37,1598708.87
290680,202311,1374,1097,277,1448136.15,365664.37,1813800.52
290682,202311,390,293,97,388097.8,128048.97,516146.77
290685,202311,285,170,115,224417.01,151805.35,376222.36
290687,202311,1378,904,474,1194918.74,625717.22,1820635.96
290689,202311,161,82,79,108247.32,104282.96,212530.28
290690,202311,576,280,296,369647.57,390778.74,760426.31
290700,202311,283,151,132,199349.02,174269.72,373618.74
290710,202311,917,649,268,856757.45,353787.23,1210544.68
290720,202311,1239,967,272,1276569.07,359063.22,1635632.29
290730,202311,1362,815,547,1075878.38,722077.8,1797956.18
290740,202311,34,29,5,38281.38,6600,44881.38
290750,202311,1639,740,899,976942.62,1186828.21,2163770.83
290755,202311,90,76,14,100326.18,18480,118806.18
290760,202311,272,236,36,311565.38,47524.4,359089.78
290770,202311,205,196,9,258743.53,11880,270623.53
290780,202311,1249,1008,241,1330668.59,318151.57,1648820.16
290790,202311,456,316,140,417144.62,184813.86,601958.48
290800,202311,2567,1061,1506,1400621.04,1990716.11,3391337.15
290810,202311,533,358,175,472618.51,231016.36,703634.87
290820,202311,453,263,190,347211.4,250824.79,598036.19
290830,202311,535,376,159,497665.15,209886.53,707551.68
290840,202311,2074,1327,747,1751811.43,986106.29,2737917.72
290850,202311,1210,626,584,826394.43,772256.71,1598651.14
290860,202311,766,390,376,514843.26,496367.41,1011210.67
290870,202311,687,486,201,641572.77,265332.3,906905.07
290880,202311,134,75,59,99002.67,77880.78,176883.45
290890,202311,577,350,227,462018.59,299657.07,761675.66
290900,202311,166,125,41,165003.7,54121.55,219125.25
290910,202311,436,328,108,432971.7,142562.85,575534.55
290920,202311,234,209,25,275910.38,33003.6,308913.98
290930,202311,604,457,147,603316.19,194060.26,797376.45
290940,202311,230,197,33,260043.49,43560.87,303604.36
290950,202311,173,99,74,130682.72,97680,228362.72
290960,202311,558,403,155,531998.51,204618.15,736616.66
290970,202311,244,215,29,283812.99,38281.61,322094.60
290980,202311,2255,1594,661,2105539.24,875211.15,2980750.39
290990,202311,476,396,80,522797.62,105612.79,628410.41
291000,202311,984,340,644,448809.63,850086.78,1298896.41
291005,202311,3018,1308,1710,1726739.44,2258702.75,3985442.19
291010,202311,141,123,18,162382.78,23761.39,186144.17
291020,202311,85,70,15,92400.28,19800,112200.28
291030,202311,123,89,34,117483.13,44882.98,162366.11
291040,202311,715,435,280,574207.71,369602.65,943810.36
291050,202311,1698,885,813,1169625.03,1078509.45,2248134.48
291060,202311,1918,1064,854,1404590.02,1127350.88,2531940.90
291070,202311,2174,1645,529,2171598.75,699664.1,2871262.85
291072,202311,7891,3123,4768,4124107.05,6295665.19,10419772.24
291075,202311,294,247,47,326048.5,62041.35,388089.85
291077,202311,62,46,16,60722.79,21120.89,81843.68
291080,202311,24269,10628,13641,14039873.69,18018583.87,32058457.56
291085,202311,296,244,52,322099.06,69964.03,392063.09
291090,202311,261,106,155,139924.88,204609.3,344534.18
291100,202311,987,353,634,467281.99,836881.75,1304163.74
291110,202311,497,377,120,497703.54,158410.21,656113.75
291120,202311,2631,1460,1171,1927378.55,1547165.18,3474543.73
291125,202311,77,42,35,55443.34,46203.87,101647.21
291130,202311,200,168,32,221794.05,42246.79,264040.84
291140,202311,174,143,31,188769.43,40921.79,229691.22
291150,202311,370,139,231,183482.82,304923.26,488406.08
291160,202311,437,333,104,439615.55,137288.5,576904.05
291165,202311,62,46,16,60720.44,21121,81841.44
291170,202311,3823,1924,1899,2542513.9,2506826.48,5049340.38
291180,202311,1300,571,729,753798,963715.7,1717513.7
291185,202311,138,129,9,170285.77,11880.78,182166.55
291190,202311,1455,713,742,942591.85,979556.01,1922147.86
291200,202311,193,142,51,187457.6,67324.8,254782.4
291210,202311,2652,1118,1534,1475864.54,2024991.58,3500856.12
291220,202311,359,276,83,364337.3,110883.45,475220.75
291230,202311,983,376,607,496391.36,801327.15,1297718.51
291240,202311,408,376,32,496350.52,42242.06,538592.58
291250,202311,424,349,75,460700.94,99003.33,559704.27
291260,202311,72,60,12,79201.43,15840,95041.43
291270,202311,793,400,393,528049.53,518795.15,1046844.68
291280,202311,370,179,191,236308.24,253454.76,489763.00
291290,202311,1706,919,787,1214571.06,1040308,2254879.06
291300,202311,268,196,72,258760.97,95048.46,353809.43
291310,202311,238,208,30,274576.23,40920.7,315496.93
291320,202311,1344,932,412,1231733.68,543898.53,1775632.21
291330,202311,147,122,25,161055.96,33001.81,194057.77
291340,202311,267,167,100,220457.34,132015.22,352472.56
291345,202311,126,91,35,120125.9,46200.28,166326.18
291350,202311,1956,789,1167,1041501.1,1541809.62,2583310.72
291360,202311,9651,4632,5019,6121596.5,6633682.98,12755279.48
291370,202311,1320,813,507,1073298.13,669321.11,1742619.24
291380,202311,298,228,70,300969.11,92402.81,393371.92
291390,202311,4455,1996,2459,2634965.98,3246164.43,5881130.41
291400,202311,2305,1598,707,2111025.79,933342.01,3044367.80
291410,202311,263,217,46,286466.82,60720.55,347187.37
291420,202311,130,102,28,134641.21,36960,171601.21
291430,202311,190,115,75,151806.7,99005.75,250812.45
291440,202311,601,493,108,650823.71,142572.6,793396.31
291450,202311,1122,751,371,991423.17,489764.8,1481187.97
291460,202311,2388,1845,543,2438274.29,716823.44,3155097.73
291465,202311,2496,1222,1274,1615821.97,1681793.51,3297615.48
291470,202311,3170,1617,1553,2134645.55,2051453.81,4186099.36
291480,202311,13392,5916,7476,7819140.71,9876908.46,17696049.17
291490,202311,772,314,458,414506.06,605905.12,1020411.18
291500,202311,392,239,153,316527.31,201991.61,518518.92
291510,202311,1189,485,704,640207.55,930609.18,1570816.73
291520,202311,956,448,508,591431.9,670626.66,1262058.56
291530,202311,946,299,647,394691.33,854052.11,1248743.44
291535,202311,150,124,26,163680.29,34320.47,198000.76
291540,202311,342,118,224,155770.16,295691.68,451461.84
291550,202311,1350,656,694,865986.48,917452.46,1783438.94
291560,202311,5426,2775,2651,3664601.58,3502173.62,7166775.20
291570,202311,269,150,119,198004.81,157084.76,355089.57
291580,202311,1366,884,482,1168302.16,637607.95,1805910.11
291590,202311,126,63,63,83162.24,83165.25,166327.49
291600,202311,1216,629,587,830408.79,774947.63,1605356.42
291610,202311,1582,754,828,995413.87,1094393.97,2089807.84
291620,202311,602,289,313,381538.81,413209.68,794748.49
291630,202311,493,157,336,207245.62,443525.49,650771.11
291640,202311,4544,2225,2319,2937252.45,3062627.11,5999879.56
291650,202311,506,365,141,481858.61,186146.15,668004.76
291660,202311,372,159,213,209904.01,281191.76,491095.77
291670,202311,167,106,61,139928.48,80522.47,220450.95
291680,202311,691,434,257,572964.52,339281.8,912246.32
291685,202311,678,392,286,517474.14,377549.38,895023.52
291690,202311,556,370,186,489744.94,245541.82,735286.76
291700,202311,1147,882,265,1164361.82,351136.31,1515498.13
291710,202311,1668,812,856,1071932.67,1132660.32,2204592.99
291720,202311,495,336,159,443532.91,209884.3,653417.21
291730,202311,1025,602,423,794728.23,558408.28,1353136.51
291733,202311,343,232,111,306264.18,147847.93,454112.11
291735,202311,103,79,24,104283.47,31681.78,135965.25
291740,202311,359,274,85,363050.39,112213.54,475263.93
291750,202311,2660,1676,984,2212604.71,1301630.45,3514235.16
291760,202311,3307,1851,1456,2443406.67,1921985.17,4365391.84
291770,202311,843,567,276,748558.78,364363.61,1112922.39
291780,202311,139,91,48,120126.94,63363.95,183490.89
291790,202311,177,102,75,134640.92,99000.91,233641.83
291800,202311,11551,5157,6394,6810465.7,8443443.89,15253909.59
291810,202311,1151,863,288,1139286.59,380198,1519484.59
291820,202311,322,238,84,314175.71,110881.72,425057.43
291830,202311,1072,461,611,608600.08,807934.66,1416534.74
291835,202311,599,556,43,733959.3,56762.6,790721.9
291840,202311,6381,3224,3157,4257501.71,4170248.89,8427750.60
291845,202311,307,110,197,145201.99,260042.83,405244.82
291850,202311,349,304,45,401329.18,59404.03,460733.21
291855,202311,283,124,159,163682.3,209881.42,373563.72
291860,202311,160,104,56,137282.98,73921.19,211204.17
291870,202311,99,49,50,64680.44,66000.32,130680.76
291875,202311,164,152,12,200654.66,15841.98,216496.64
291880,202311,455,377,78,497713.21,102978.72,600691.93
291890,202311,268,92,176,121440.2,232322.8,353763.0
291900,202311,67,44,23,58080.6,30360,88440.6
291905,202311,121,92,29,121448.53,38285.11,159733.64
291910,202311,161,131,30,172925.37,39601.68,212527.05
291915,202311,504,444,60,586149.21,79203.85,665353.06
291920,202311,7253,3500,3753,4621912.06,4961089.3,9583001.36
291930,202311,187,116,71,153136.3,93726.62,246862.92
291940,202311,469,284,185,376229.51,244217.14,620446.65
291950,202311,1319,1020,299,1347805.59,394689.92,1742495.51
291955,202311,1676,1022,654,1350459.43,863343.28,2213802.71
291960,202311,222,162,60,213853.08,79202.28,293055.36
291970,202311,840,620,220,818487.18,290415.7,1108902.88
291980,202311,1519,1307,212,1726879.15,281186.47,2008065.62
291990,202311,164,153,11,201971.88,14520.21,216492.09
291992,202311,257,130,127,171621.03,167658.71,339279.74
291995,202311,217,146,71,192722.92,93720.72,286443.64
292000,202311,460,332,128,438264.52,170286.23,608550.75
292010,202311,402,274,128,363007.84,170284.87,533292.71
292020,202311,347,251,96,331347.32,126725.66,458072.98
292030,202311,169,129,40,170290.52,52801.61,223092.13
292040,202311,637,355,282,468600.6,372242.35,840842.95
292045,202311,136,119,17,157082.52,22440.43,179522.95
292050,202311,1028,758,270,1001964.23,356432.98,1358397.21
292060,202311,1054,857,197,1131358.29,260060.82,1391419.11
292070,202311,86,36,50,47522.12,66001.14,113523.26
292080,202311,192,136,56,179521.22,73921,253442.22
292090,202311,623,232,391,306248.67,517456.97,823705.64
292100,202311,1883,848,1035,1120837.84,1366395.72,2487233.56
292105,202311,181,164,17,216480.34,22440.14,238920.48
292110,202311,2467,944,1523,1247512.57,2010513.22,3258025.79
292120,202311,787,591,196,781563.32,258737.05,1040300.37
292130,202311,542,300,242,396026.34,319462.15,715488.49
292140,202311,238,191,47,252162.71,62043.53,314206.24
292145,202311,196,117,79,154443.45,104283.17,258726.62
292150,202311,1648,1386,262,1831048.36,345875.6,2176923.96
292160,202311,192,151,41,199328.99,54121.76,253450.75
292170,202311,1250,1050,200,1387498.64,264021.62,1651520.26
292180,202311,278,196,82,258744.72,108249.04,366993.76
292190,202311,165,108,57,142580,75248.04,217828.04
292200,202311,1577,606,971,799963.86,1283106.96,2083070.82
292205,202311,144,123,21,162363.29,27720.68,190083.97
292210,202311,451,289,162,381510.42,213847.53,595357.95
292220,202311,48,34,14,44883.6,18480,63363.6
292225,202311,75,58,17,76564.49,22441.35,99005.84
292230,202311,1080,841,239,1110211.78,315496.88,1425708.66
292240,202311,699,524,175,691770.83,231027.34,922798.17
292250,202311,1746,1140,606,1504944.05,802618.42,2307562.47
292260,202311,462,279,183,368307.99,241574.86,609882.85
292265,202311,270,208,62,274584.92,81846.64,356431.56
292270,202311,746,395,351,521440.8,463360.99,984801.79
292273,202311,225,136,89,179524.66,117483.33,297007.99
292275,202311,201,108,93,142562.19,122765.71,265327.90
292280,202311,160,112,48,147840.37,63361.42,211201.79
292285,202311,109,84,25,110880.15,33000,143880.15
292290,202311,708,476,232,628377.18,307578.98,935956.16
292300,202311,2118,852,1266,1124732.08,1671236.44,2795968.52
292303,202311,158,113,45,149161.65,59401.22,208562.87
292305,202311,133,99,34,130688.31,44882.39,175570.70
292310,202311,1079,736,343,971619.8,452794.3,1424414.1
292320,202311,651,491,160,648196.88,211214.3,859411.18
292330,202311,184,124,60,163686.96,79201.1,242888.06
292335,202311,353,271,82,357724.58,108242.62,465967.20
292340,202311,613,433,180,571584.09,237609.57,809193.66
292350,202311,299,153,146,201967.34,192727.87,394695.21
292360,202311,812,611,201,806615.81,265346.88,1071962.69
292370,202311,752,576,176,760400.49,232335.2,992735.69
292380,202311,654,553,101,730056.61,133341.28,863397.89
292390,202311,382,163,219,215173.91,289083.39,504257.30
292400,202311,4287,2621,1666,3462684.86,2200608.82,5663293.68
292405,202311,300,198,102,261363.41,134641.32,396004.73
292410,202311,115,74,41,97682.32,54120.8,151803.12
292420,202311,278,244,34,323425.1,44881.55,368306.65
292430,202311,579,415,164,547820.37,216487.25,764307.62
292440,202311,737,612,125,807904.74,166331.53,974236.27
292450,202311,255,194,61,256099.43,80523.57,336623.00
292460,202311,545,413,132,545190.61,174247.63,719438.24
292465,202311,223,193,30,254766.62,39600.7,294367.32
292467,202311,193,127,66,167642.87,87120.44,254763.31
292470,202311,351,236,115,311527.15,151802.33,463329.48
292480,202311,449,298,151,393403.54,199340.68,592744.22
292490,202311,280,211,69,278531.99,91085.8,369617.79
292500,202311,1040,544,496,718162.92,654815.93,1372978.85
292510,202311,4003,1993,2010,2630982.8,2653382.37,5284365.17
292520,202311,1379,668,711,881867.37,939936.74,1821804.11
292525,202311,500,379,121,500320.57,159730.09,660050.66
292530,202311,5764,2413,3351,3185425.35,4426301.08,7611726.43
292540,202311,508,295,213,389406.89,281164.17,670571.06
292550,202311,1229,690,539,910866.55,711519.67,1622386.22
292560,202311,356,324,32,427759.46,42243.76,470003.22
292570,202311,389,294,95,388094.84,125403.2,513498.04
292575,202311,655,491,164,648183.76,216498.38,864682.14
292580,202311,1135,776,359,1024385.51,473907.58,1498293.09
292590,202311,625,551,74,727358.9,97683.82,825042.72
292593,202311,158,126,32,166324.91,42241.3,208566.21
292595,202311,248,192,56,253465.26,73925.49,327390.75
292600,202311,1402,992,410,1310937.2,541239.13,1852176.33
292610,202311,110,91,19,120135.3,25084.13,145219.43
292620,202311,568,470,98,620495.57,129371.73,749867.30
292630,202311,1741,953,788,1258080.04,1040216.06,2298296.10
292640,202311,956,665,291,877889.54,384150.16,1262039.70
292650,202311,211,158,53,208588.9,69964.45,278553.35
292660,202311,2182,1522,660,2009258.9,871295.89,2880554.79
292665,202311,148,104,44,137280.99,58081,195361.99
292670,202311,424,323,101,426427.72,133325.96,559753.68
292680,202311,275,209,66,275910.53,87132.57,363043.10
292690,202311,223,153,70,201969.99,92400.93,294370.92
292700,202311,1138,757,381,1000670.78,502972.01,1503642.79
292710,202311,122,103,19,135966.24,25081.12,161047.36
292720,202311,1139,657,482,867305.75,636270.76,1503576.51
292730,202311,258,124,134,163695.19,176889.79,340584.98
292740,202311,91369,43325,48044,57234190.8,63500808.09,120734998.89
292750,202311,458,339,119,447533.55,158419.84,605953.39
292760,202311,368,316,52,417137.65,68642.81,485780.46
292770,202311,994,418,576,551815.88,761702.88,1313518.76
292780,202311,71,36,35,47522.49,46200.75,93723.24
292790,202311,836,454,382,599301.25,504248.16,1103549.41
292800,202311,1416,853,563,1126047.05,743200.96,1869248.01
292805,202311,438,176,262,232324.3,347170.61,579494.91
292810,202311,1998,1186,812,1565648.93,1074535.06,2640183.99
292820,202311,1008,837,171,1106259.39,227055.63,1333315.02
292830,202311,157,117,40,154459.22,52805.79,207265.01
292840,202311,774,620,154,818499.14,203290.95,1021790.09
292850,202311,159,108,51,142570.28,67326.96,209897.24
292860,202311,2307,1338,969,1767716.84,1280517.74,3048234.58
292870,202311,4202,2762,1440,3646121.97,1900931.89,5547053.86
292880,202311,1585,1052,533,1388769.41,703619.24,2092388.65
292890,202311,615,512,103,675922.02,135973.13,811895.15
292895,202311,165,119,46,157087.1,60722.39,217809.49
292900,202311,369,271,98,357768.97,129376.35,487145.32
292905,202311,553,275,278,363044.51,366995.03,730039.54
292910,202311,603,447,156,590074.36,205932.27,796006.63
292920,202311,694,311,383,410555,505600.57,916155.57
292925,202311,504,457,47,603250.11,62041.23,665291.34
292930,202311,840,511,329,674561.94,434303.54,1108865.48
292935,202311,279,124,155,163683.96,205922.85,369606.81
292937,202311,225,154,71,203288.44,93723.44,297011.88
292940,202311,208,156,52,205954.59,68647.38,274601.97
292950,202311,1585,758,827,1000683.77,1093044.92,2093728.69
292960,202311,533,383,150,505620.53,198025.13,703645.66
292970,202311,277,202,75,266664.18,99012.05,365676.23
292975,202311,113,62,51,81847.36,67326.11,149173.47
292980,202311,387,269,118,356420.37,155767.89,512188.26
292990,202311,1428,1084,344,1432311.35,454105.71,1886417.06
293000,202311,123,85,38,112205.6,50161.64,162367.24
293010,202311,3414,2021,1393,2668041.26,1840215.53,4508256.79
293015,202311,662,545,117,719478.56,154450.18,873928.74
293020,202311,398,315,83,417172.25,109569.67,526741.92
293030,202311,463,429,34,566350.07,44886.86,611236.93
293040,202311,403,325,78,429018.31,104284.34,533302.65
293050,202311,3486,2044,1442,2699601.47,1903562.76,4603164.23
293060,202311,246,195,51,257445.8,67327.89,324773.69
293070,202311,4478,2244,2234,2962416.71,2949156.17,5911572.88
293075,202311,104,72,32,95042.17,42240.54,137282.71
293076,202311,100,76,24,100323.62,31680.67,132004.29
293077,202311,715,408,307,538616.3,405267.86,943884.16
293080,202311,453,398,55,525384.34,72603.06,597987.40
293090,202311,77,72,5,95050.51,6600.66,101651.17
293100,202311,606,406,200,535991.65,265337.84,801329.49
293105,202311,382,283,99,373570.83,130687.89,504258.72
293110,202311,124,79,45,104297.82,59405.33,163703.15
293120,202311,321,231,90,304954.36,118819.39,423773.75
293130,202311,270,180,90,237616.48,118810.05,356426.53
293135,202311,9296,3848,5448,5085127.26,7194454.79,12279582.05
293140,202311,216,126,90,166346.35,118809.43,285155.78
293150,202311,352,304,48,401312.46,63360.9,464673.36
293160,202311,462,299,163,394693.76,215165.67,609859.43
293170,202311,288,176,112,232341.72,147846.78,380188.50
293180,202311,670,467,203,616462.18,267970.08,884432.26
293190,202311,1529,1051,478,1387475.78,631032.62,2018508.40
293200,202311,642,553,89,731367.34,117490.63,848857.97
293210,202311,463,353,110,466000.26,145205.68,611205.94
293220,202311,2596,1196,1400,1578873.26,1852113.51,3430986.77
293230,202311,2029,773,1256,1020427.1,1658003.51,2678430.61
293240,202311,254,226,28,298371.32,36963.31,335334.63
293245,202311,139,113,26,149164.65,34321.21,183485.86
293250,202311,832,372,460,491105.69,608611.08,1099716.77
293260,202311,361,279,82,368329.39,108247.49,476576.88
293270,202311,1248,572,676,755073.41,893659.59,1648733.00
293280,202311,343,238,105,314171.15,138612.06,452783.21
293290,202311,3413,2220,1193,2930651.56,1576182.45,4506834.01
293300,202311,1007,698,309,922744.6,409212.63,1331957.23
293305,202311,214,165,49,217806.38,64681.98,282488.36
293310,202311,184,137,47,180851.13,62044.33,242895.46
293315,202311,201,154,47,203310.11,62047.11,265357.22
293317,202311,105,80,25,105601.63,33000.74,138602.37
293320,202311,1407,735,672,970352.33,888472.5,1858824.83
293325,202311,220,97,123,128042.66,162361.8,290404.46
293330,202311,16915,8012,8903,10579554.91,11758212.89,22337767.80
293340,202311,305,216,89,285124.2,117481.14,402605.34
293345,202311,288,245,43,323443.65,56764.04,380207.69
293350,202311,635,415,220,550512.36,290433.89,840946.25
293360,202311,1618,1133,485,1495726.27,640263.59,2135989.86
310010,202311,154,84,70,110890.54,92403.44,203293.98
310020,202311,1033,563,470,743237.78,620436.24,1363674.02
310030,202311,334,265,69,349854.78,91091.95,440946.73
310040,202311,58,39,19,51480.47,25080.2,76560.67
310050,202311,184,121,63,159723.57,83166.3,242889.87
310060,202311,313,233,80,307587.12,105609.46,413196.58
310070,202311,26,18,8,23761.91,10560.6,34322.51
310080,202311,54,37,17,48841.98,22442.36,71284.34
310090,202311,1227,690,537,912181.46,708891.58,1621073.04
310100,202311,423,292,131,386808.25,172935.9,559744.15
310110,202311,771,418,353,551815.97,465996.32,1017812.29
310120,202311,461,264,197,348492.45,260053.96,608546.41
310130,202311,43,22,21,29046.55,27723.56,56770.11
310140,202311,25,9,16,11881.22,21124.22,33005.44
310150,202311,1289,842,447,1111563.84,590110.08,1701673.92
310160,202311,2354,1166,1188,1540579.87,1568223.08,3108802.95
310163,202311,111,63,48,83161.3,63360.45,146521.75
310170,202311,2862,1412,1450,1866433.71,1914127.2,3780560.91
310180,202311,227,111,116,146523.71,153124.76,299648.47
310190,202311,536,354,182,467327.8,240260.11,707587.91
310200,202311,453,281,172,370965.48,227061.35,598026.83
310205,202311,93,66,27,87122.06,35640.06,122762.12
310210,202311,296,238,58,314192.71,76570.55,390763.26
310220,202311,72,49,23,64686.96,30362.32,95049.28
310230,202311,320,229,91,302311.57,120129.07,422440.64
310240,202311,139,111,28,146522.48,36960.71,183483.19
310250,202311,105,85,20,112213.38,26402.1,138615.48
310260,202311,838,458,380,605940.05,501643.11,1107583.16
310270,202311,316,210,106,277233.24,139934.47,417167.71
310280,202311,448,308,140,406593.29,187447.17,594040.46
310285,202311,222,174,48,229691.3,63363.58,293054.88
310290,202311,250,132,118,174256.39,155764.19,330020.58
310300,202311,200,162,38,213861.18,50163.59,264024.77
310310,202311,21,17,4,22440,5280.3,27720.3
310320,202311,31,12,19,15840.39,25080.27,40920.66
310330,202311,53,40,13,52803.73,17161.1,69964.83
310340,202311,2078,1504,574,1986755.15,757742.96,2744498.11
310350,202311,3057,1546,1511,2043572.59,1995945.34,4039517.93
310360,202311,58,44,14,58080,18480.58,76560.58
310370,202311,160,134,26,176882.88,34320.64,211203.52
310375,202311,112,41,71,54122.62,93724.15,147846.77
310380,202311,54,35,19,46204.02,25084.08,71288.10
310390,202311,112,70,42,92410.26,55443.1,147853.36
310400,202311,2867,1934,933,2553180.45,1234317.87,3787498.32
310410,202311,137,81,56,106933.71,73927.44,180861.15
310420,202311,757,401,356,530683.46,469953.39,1000636.85
310430,202311,309,200,109,264012.47,143880.43,407892.90
310440,202311,89,60,29,80522.02,38280.48,118802.50
310445,202311,91,79,12,104283.58,15841.21,120124.79
310450,202311,732,496,236,656131.78,311556.37,967688.15
310460,202311,284,195,89,258743.61,117485.27,376228.88
310470,202311,589,383,206,506913.96,273254.43,780168.39
310480,202311,112,74,38,97683.61,50160.64,147844.25
310490,202311,655,327,328,431693.07,434293.41,865986.48
310500,202311,150,67,83,88441.89,109560.76,198002.65
310510,202311,669,472,197,623097.91,260061.66,883159.57
310520,202311,172,121,51,159739.2,67322.7,227061.9
310530,202311,139,62,77,81841.62,101641.22,183482.84
310540,202311,553,306,247,403958.18,326068.82,730027.00
310550,202311,86,59,27,77886.57,35644.11,113530.68
310560,202311,3579,2455,1124,3240926.99,1485056.45,4725983.44
310570,202311,130,88,42,116162.88,55441.82,171604.70
310590,202311,453,275,178,363039.04,236301.74,599340.78
310600,202311,157,75,82,99007.58,108246.71,207254.29
310610,202311,39,14,25,18482.04,33003.4,51485.44
310620,202311,58972,28122,30850,37149768.28,40767736.26,77917504.54
310630,202311,866,548,318,724726.65,419779.43,1144506.08
310640,202311,181,117,64,155763.94,84481.14,240245.08
310650,202311,190,172,18,227076.64,23762.98,250839.62
310660,202311,132,90,42,118802.81,55440.61,174243.42
310665,202311,77,55,22,72600.14,29041.82,101641.96
310670,202311,8566,3728,4838,4925445.95,6387854.52,11313300.47
310680,202311,68,47,21,62042.53,27721.91,89764.44
310690,202311,646,456,190,601960.84,250810.71,852771.55
310700,202311,63,39,24,51484.78,31682.22,83167.00
310710,202311,1416,964,452,1273586.61,596676.8,1870263.41
310720,202311,161,46,115,60722.97,151810.05,212533.02
310730,202311,1771,1207,564,1593422.91,744555.06,2337977.97
310740,202311,1123,609,514,803985.9,678546.61,1482532.51
310750,202311,280,184,96,244223.19,126729.06,370952.25
310760,202311,85,67,18,88455.96,23761.1,112217.06
310770,202311,83,40,43,52800.64,56763.16,109563.80
310780,202311,395,318,77,419811.59,101653.2,521464.79
310790,202311,141,112,29,147855.52,38281.16,186136.68
310800,202311,522,247,275,326070.61,363025,689095.61
310810,202311,195,128,67,168979.59,88451.14,257430.73
310820,202311,314,252,62,332692.34,81849.75,414542.09
310825,202311,214,181,33,238933.2,43560.82,282494.02
310830,202311,505,230,275,303629.36,363012.13,666641.49
310840,202311,418,265,153,349818.46,201979.31,551797.77
310850,202311,88,72,16,95043.02,21120,116163.02
310855,202311,499,397,102,524090.6,134648.03,658738.63
310860,202311,1772,1306,466,1724172.53,616519.94,2340692.47
310870,202311,72,61,11,80522.16,14521.3,95043.46
310880,202311,105,82,23,108118.06,30360.51,138478.57
310890,202311,326,187,139,246864.58,183484.35,430348.93
310900,202311,732,353,379,465997.08,500325.68,966322.76
310910,202311,263,174,89,229710.63,117490.48,347201.11
310920,202311,467,277,190,365694.15,252168.26,617862.41
310925,202311,55,44,11,58083.93,14520,72603.93
310930,202311,1499,1024,475,1354436.97,627068.77,1981505.74
310940,202311,768,370,398,488463.27,526734.02,1015197.29
310945,202311,168,114,54,150482.42,71282.08,221764.50
310950,202311,236,186,50,245547.29,66003.09,311550.38
310960,202311,76,28,48,36963.76,63371.64,100335.40
310970,202311,188,110,78,146542.29,102966.99,249509.28
310980,202311,57,41,16,54123,21121.77,75244.77
310990,202311,176,97,79,128047.22,104284.12,232331.34
311000,202311,981,507,474,670632.4,628372.53,1299004.93
311010,202311,57,44,13,58083.61,17160.97,75244.58
311020,202311,53,37,16,48844.53,21122.25,69966.78
311030,202311,438,240,198,316824.97,261370.97,578195.94
311040,202311,37,30,7,39600.11,9240,48840.11
311050,202311,577,218,359,287778.5,473892.36,761670.86
311060,202311,931,511,420,674584.19,554439.53,1229023.72
311070,202311,385,177,208,233649.49,274562.2,508211.69
311080,202311,135,75,60,99009.79,79214.8,178224.59
311090,202311,393,199,194,262708.38,256094.98,518803.36
311100,202311,617,381,236,502975.86,311541.84,814517.70
311110,202311,748,529,219,698340.46,289110.82,987451.28
311115,202311,93,65,28,85802.29,36964.46,122766.75
311120,202311,1231,692,539,914858.2,711533.82,1626392.02
311130,202311,292,169,123,223121.07,162377.62,385498.69
311140,202311,176,101,75,133331.99,99009,232340.99
311150,202311,358,232,126,306270.45,166338.87,472609.32
311160,202311,836,590,246,778879.48,326069.76,1104949.24
311170,202311,107,87,20,114842.23,26400,141242.23
311180,202311,328,230,98,303625.82,129365.95,432991.77
311190,202311,38,18,20,23760.78,26400.94,50161.72
311200,202311,361,248,113,327390.28,149171.01,476561.29
311205,202311,50,41,9,54122.94,11880,66002.94
311210,202311,41,37,4,48841.57,5280.94,54122.51
311220,202311,32,30,2,39600,2640,42240
311230,202311,1825,1239,586,1635725.35,773612.31,2409337.66
311240,202311,105,73,32,97685.69,42241.59,139927.28
311250,202311,63,29,34,38281.94,44881.74,83163.68
311260,202311,578,353,225,465993.53,298342.07,764335.60
311265,202311,157,103,54,135968.61,71284.13,207252.74
311270,202311,305,207,98,273271.25,129371.68,402642.93
311280,202311,210,93,117,122765.22,157087.52,279852.74
311290,202311,120,102,18,134650.39,23760.55,158410.94
311300,202311,638,421,217,555788.48,286463.93,842252.41
311310,202311,19,16,3,21120.78,3961.56,25082.34
311320,202311,704,519,185,685151.95,245534.77,930686.72
311330,202311,1356,979,377,1292406.63,497685.44,1790092.07
311340,202311,2963,2074,889,2740588.41,1174837.01,3915425.42
311350,202311,283,215,68,283828.93,89766.31,373595.24
311360,202311,169,101,68,134647.48,89761.63,224409.11
311370,202311,1327,569,758,751169.36,1000653.93,1751823.29
311380,202311,8,6,2,7921.06,2640,10561.06
311390,202311,273,161,112,212535.97,147852.99,360388.96
311400,202311,141,85,56,112206.69,73922.01,186128.70
311410,202311,146,73,73,96366.17,96363.96,192730.13
311420,202311,349,175,174,231019.67,229691.11,460710.78
311430,202311,947,628,319,829048.28,422438,1251486.28
311440,202311,511,339,172,448858.95,227058.04,675916.99
311450,202311,331,190,141,250842.51,186133.02,436975.53
311455,202311,282,192,90,253462.56,118812.66,372275.22
311460,202311,143,66,77,87127,101647.76,188774.76
311470,202311,41,20,21,26400.38,27720.51,54120.89
311480,202311,74,43,31,56762.09,40920.87,97682.96
311490,202311,11,6,5,7920.51,6600.87,14521.38
311500,202311,35,19,16,25080.5,21120.94,46201.44
311510,202311,881,602,279,794700.53,368296.88,1162997.41
311520,202311,43,36,7,47520,9240,56760
311530,202311,2058,1473,585,1947227.18,773542.91,2720770.09
311535,202311,76,47,29,62049.11,38284.27,100333.38
311540,202311,34,30,4,39604.27,5280,44884.27
311545,202311,198,141,57,186123.91,75240.6,261364.51
311547,202311,65,51,14,67320.9,18480.75,85801.65
311550,202311,790,371,419,489758.04,553112.18,1042870.22
311560,202311,43,26,17,34321.29,22440.34,56761.63
311570,202311,317,214,103,282513.5,137294.8,419808.3
311580,202311,475,311,164,410538.53,216488.11,627026.64
311590,202311,30,25,5,33003.96,6600.87,39604.83
311600,202311,98,78,20,102979.2,26401.37,129380.57
311610,202311,260,227,33,300990.92,43563.31,344554.23
311615,202311,215,183,32,241562.14,42242.03,283804.17
311620,202311,36,23,13,30360.67,17160.8,47521.47
311630,202311,128,112,16,147842.63,21120,168962.63
311640,202311,158,84,74,110890.68,97692.81,208583.49
311650,202311,150,100,50,132002.12,66003.36,198005.48
311660,202311,497,231,266,304943.9,351136.74,656080.64
311670,202311,173,126,47,166146.76,62045.42,228192.18
311680,202311,253,191,62,252142.35,81847.88,333990.23
311690,202311,15,14,1,18481.45,1320,19801.45
311700,202311,216,163,53,215183.58,69970.02,285153.60
311710,202311,192,130,62,171625.4,81848.29,253473.69
311720,202311,39,29,10,38284.07,13200,51484.07
311730,202311,632,446,186,588768.42,245534.37,834302.79
311740,202311,27,22,5,29041.28,7920,36961.28
311750,202311,785,528,257,697005.92,339264.81,1036270.73
311760,202311,87,39,48,51484.23,63367.32,114851.55
311770,202311,421,223,198,294377.87,261371.56,555749.43
311780,202311,252,140,112,184814.21,147848.27,332662.48
311783,202311,110,95,15,125403.34,19800.67,145204.01
311787,202311,54,23,31,30360.5,40921.19,71281.69
311790,202311,286,125,161,165013.82,213855.62,378869.44
311800,202311,867,509,358,671957.15,472572.81,1144529.96
311810,202311,62,45,17,59402.54,22440,81842.54
311820,202311,154,115,39,151808.05,51486.02,203294.07
311830,202311,2194,1258,936,1660713.56,1239505.88,2900219.44
311840,202311,1270,756,514,997992.53,679857.79,1677850.32
311850,202311,20,14,6,19803.09,7921.67,27724.76
311860,202311,12017,5218,6799,6892559.06,8984529.25,15877088.31
311870,202311,123,73,50,97688.99,66007.55,163696.54
311880,202311,1035,746,289,984873.45,382846.12,1367719.57
311890,202311,229,105,124,138508.04,163709.5,302217.54
311900,202311,71,32,39,42245.4,51485.54,93730.94
311910,202311,1561,984,577,1298972.93,761685.35,2060658.28
311920,202311,257,173,84,228382.37,110890.01,339272.38
311930,202311,1042,590,452,778875.89,596691.03,1375566.92
311940,202311,3131,1782,1349,2353788.9,1784742.6,4138531.5
311950,202311,195,116,79,153139.19,104288.43,257427.62
311960,202311,71,49,22,64688,29040.44,93728.44
311970,202311,29,15,14,19800,18480,38280
311980,202311,44,35,9,46202.55,11880.78,58083.33
311990,202311,45,30,15,39605.95,19801.15,59407.10
311995,202311,59,34,25,44886.04,33003.45,77889.49
312000,202311,24,19,5,25081.54,6600,31681.54
312010,202311,74,58,16,76572.39,21120.68,97693.07
312015,202311,95,65,30,85801.15,39600.2,125401.35
312020,202311,152,115,37,151813.34,48848.14,200661.48
312030,202311,86,66,20,87120.87,26400,113520.87
312040,202311,101,59,42,77881.99,55440.44,133322.43
312050,202311,209,124,85,163697.25,112204.77,275902.02
312060,202311,19,12,7,15841.22,10560.44,26401.66
312070,202311,87,58,29,76569.37,38284.31,114853.68
312080,202311,546,271,275,357740.64,364339.45,722080.09
312083,202311,95,62,33,81842.36,43560.98,125403.34
312087,202311,117,84,33,110887.95,43561.69,154449.64
312090,202311,3912,2447,1465,3231685.73,1935253.67,5166939.40
312100,202311,160,107,53,141257.76,69969.71,211227.47
312110,202311,142,84,58,110897.16,76567.34,187464.50
312120,202311,137,96,41,126729.33,55448.26,182177.59
312125,202311,98,67,31,88445.24,40926.37,129371.61
312130,202311,142,97,45,128055.04,59405.47,187460.51
312140,202311,168,125,43,165019.55,56762.59,221782.14
312150,202311,40,34,6,44881.81,7920,52801.81
312160,202311,1585,1044,541,1378325.95,714195.37,2092521.32
312170,202311,24,15,9,19800.26,11880,31680.26
312180,202311,90,66,24,87124.93,31682.45,118807.38
312190,202311,53,47,6,62042.45,7920.44,69962.89
312200,202311,814,690,124,910925.56,163697.81,1074623.37
312210,202311,150,84,66,110885.31,87128.97,198014.28
312220,202311,171,128,43,168968.19,56761.31,225729.50
312230,202311,4350,1920,2430,2538683.67,3210370.75,5749054.42
312235,202311,201,134,67,176883.11,88443.25,265326.36
312240,202311,94,71,23,93730.59,30363.73,124094.32
312245,202311,259,188,71,249506.26,93732.63,343238.89
312247,202311,90,66,24,87125.32,31682.2,118807.52
312250,202311,190,100,90,133331.98,118808.42,252140.40
312260,202311,117,74,43,97680.99,56760.55,154441.54
312270,202311,150,86,64,113538.24,84490.27,198028.51
312280,202311,29,15,14,19800.71,18481.8,38282.51
312290,202311,158,109,49,143893.84,66002.54,209896.38
312300,202311,223,146,77,192731.62,101642.27,294373.89
312310,202311,69,61,8,80521.49,10560,91081.49
312320,202311,463,287,176,378858.21,232334.19,611192.40
312330,202311,123,108,15,142560.85,19800.57,162361.42
312340,202311,35,18,17,23762.55,22440.61,46203.16
312350,202311,16,9,7,11880.19,9240,21120.19
312352,202311,98,71,27,93723.55,35640.11,129363.66
312360,202311,641,292,349,385480.29,462033.91,847514.20
312370,202311,436,252,184,335282.91,242882.3,578165.21
312380,202311,165,112,53,147855.23,69968.49,217823.72
312385,202311,196,155,41,204625.11,54123.78,258748.89
312390,202311,324,205,119,270625.85,157095.94,427721.79
312400,202311,426,322,104,425096.38,137296.39,562392.77
312410,202311,1402,534,868,704953.05,1148511.67,1853464.72
312420,202311,768,581,187,766986.93,246850.38,1013837.31
312430,202311,932,671,261,885833.42,344559.55,1230392.97
312440,202311,65,49,16,64680,21120,85800
312450,202311,250,148,102,195381.2,134652.15,330033.35
312460,202311,43,18,25,23761.12,33000.74,56761.86
312470,202311,52,36,16,47522.78,21120,68642.78
312480,202311,166,105,61,138624.36,80537.71,219162.07
312490,202311,352,240,112,316841.2,147855.48,464696.68
312500,202311,38,27,11,35642.93,14522.69,50165.62
312510,202311,802,326,476,431684.66,629697.35,1061382.01
312520,202311,28,10,18,13201.41,23763.38,36964.79
312530,202311,43,29,14,38284.82,18481.3,56766.12
312540,202311,90,76,14,100324.76,18480.6,118805.36
312550,202311,35,28,7,36963.56,9240.07,46203.63
312560,202311,232,180,52,237611.95,68645.37,306257.32
312570,202311,558,344,214,454123.47,282502.81,736626.28
312580,202311,89,54,35,71284.44,46204.88,117489.32
312590,202311,228,178,50,234990.85,66008.3,300999.15
312595,202311,174,142,32,187453.61,42242.27,229695.88
312600,202311,73,34,39,44882.4,51482.16,96364.56
312610,202311,1746,953,793,1258106.04,1046830.04,2304936.08
312620,202311,248,184,64,242893.47,84483.78,327377.25
312630,202311,82,64,18,84483.61,23760,108243.61
312640,202311,53,17,36,22440.4,47520.75,69961.15
312650,202311,165,140,25,186600.9,33005.71,219606.61
312660,202311,119,82,37,108250.33,48843.55,157093.88
312670,202311,1038,652,386,860709.32,509554.43,1370263.75
312675,202311,50,37,13,48841.2,17160,66001.2
312680,202311,79,53,26,71281.25,34320,105601.25
312690,202311,308,165,143,217818.11,188766.86,406584.97
312695,202311,45,37,8,48843.06,10560.78,59403.84
312700,202311,292,169,123,223094.88,163689.08,386783.96
312705,202311,93,74,19,97680.17,25082.49,122762.66
312707,202311,140,99,41,130682.54,54121.01,184803.55
312710,202311,2060,1190,870,1572263.85,1148501.63,2720765.48
312720,202311,52,26,26,34324.71,34324.04,68648.75
312730,202311,315,187,128,246865.85,168978.42,415844.27
312733,202311,53,42,11,55440.4,14521.5,69961.9
312735,202311,25,19,6,25083.05,7921.89,33004.94
312737,202311,97,61,36,80522.89,47521.19,128044.08
312738,202311,96,57,39,76561.41,51480.82,128042.23
312740,202311,90,54,36,71288.07,47523.57,118811.64
312750,202311,153,107,46,141241.51,60720,201961.51
312760,202311,289,198,91,261389.14,120134.24,381523.38
312770,202311,10419,5155,5264,6813128.87,6959292.88,13772421.75
312780,202311,476,363,113,479233.24,149176.93,628410.17
312790,202311,21,16,5,21120.44,6600.21,27720.65
312800,202311,1850,1271,579,1677847.86,765657.31,2443505.17
312810,202311,377,265,112,349802.07,147842.47,497644.54
312820,202311,219,170,49,224412.64,64686.09,289098.73
312825,202311,48,36,12,47525.25,15841.66,63366.91
312830,202311,222,124,98,163710.83,129374.49,293085.32
312840,202311,224,158,66,208570.16,87123.94,295694.10
312850,202311,38,33,5,43562.82,6600.44,50163.26
312860,202311,174,111,63,146527.88,83161.78,229689.66
312870,202311,1383,739,644,976874.45,851418.17,1828292.62
312880,202311,138,106,32,139934.11,42243.58,182177.69
312890,202311,189,134,55,176910.18,72608.02,249518.20
312900,202311,162,124,38,163708.91,50169.13,213878.04
312910,202311,200,115,85,151822.2,112222.65,264044.85
312920,202311,122,72,50,95052.32,66004.81,161057.13
312930,202311,372,245,127,323449.49,167659.43,491108.92
312940,202311,172,115,57,151801.98,75240.97,227042.95
312950,202311,827,591,236,780189.28,311555.34,1091744.62
312960,202311,149,107,42,141263.34,55445.66,196709.00
312965,202311,130,103,27,135967.73,35640,171607.73
312970,202311,314,252,62,334263.79,83169.25,417433.04
312980,202311,3116,1648,1468,2176917.03,1943169.46,4120086.49
312990,202311,51,21,30,27721.43,39600.39,67321.82
313000,202311,58,33,25,43562.55,33000,76562.55
313005,202311,200,151,49,199328.91,64684.23,264013.14
313010,202311,1116,497,619,656088.39,817140.09,1473228.48
313020,202311,201,103,98,135961.04,129360.8,265321.84
313030,202311,230,153,77,205936.95,101644.17,307581.12
313040,202311,102,29,73,38282.09,96360.91,134643.00
313050,202311,246,182,64,240245.65,84484.01,324729.66
313055,202311,48,33,15,44880,19800,64680
313060,202311,164,116,48,153124,63360.86,216484.86
313065,202311,62,47,15,62041.55,19801.84,81843.39
313070,202311,125,67,58,88450.24,76571.56,165021.80
313080,202311,48,26,22,34323.48,29040.84,63364.32
313090,202311,764,504,260,665345.43,343228.07,1008573.50
313100,202311,241,90,151,118803.06,199325.44,318128.50
313110,202311,178,102,76,135965.02,100329.78,236294.80
313115,202311,303,171,132,227063.12,174253.72,401316.84
313120,202311,970,563,407,743240.13,537274.66,1280514.79
313130,202311,6999,3958,3041,5230373.09,4017014.75,9247387.84
313140,202311,146,86,60,113528.77,79207.05,192735.82
313150,202311,317,249,68,328725.45,89766.69,418492.14
313160,202311,197,149,48,196715.55,63372.44,260087.99
313170,202311,1636,1037,599,1369007.22,792025.05,2161032.27
313180,202311,392,257,135,339282.02,178226.75,517508.77
313190,202311,850,483,367,637647.68,485812.49,1123460.17
313200,202311,39,32,7,42243.17,9240,51483.17
313210,202311,1081,913,168,1205338.16,221786.67,1427124.83
313220,202311,360,218,142,287785.23,188765.2,476550.43
313230,202311,342,267,75,352460.96,99004.59,451465.55
313240,202311,2594,1315,1279,1735943.9,1689644.62,3425588.52
313250,202311,1321,998,323,1317573.17,426421.33,1743994.50
313260,202311,110,56,54,73923.82,71280.61,145204.43
313270,202311,1167,703,464,931733.27,613852.48,1545585.75
313280,202311,52,40,12,52801.5,15840.67,68642.17
313290,202311,260,212,48,279860.98,63362.72,343223.70
313300,202311,363,178,185,234982.75,245529.36,480512.11
313310,202311,284,129,155,170291.22,204606.73,374897.95
313320,202311,435,323,112,426423.41,149177.56,575600.97
313330,202311,1574,990,584,1309733.68,770944.83,2080678.51
313340,202311,365,263,102,347195.34,134657.24,481852.58
313350,202311,465,294,171,388108.7,227055.07,615163.77
313360,202311,236,106,130,139925.52,171606.47,311531.99
313370,202311,253,96,157,126726.69,207246.35,333973.04
313375,202311,368,236,132,311537.08,175569.13,487106.21
313380,202311,1503,778,725,1027071.57,957025.17,1984096.74
313390,202311,55,48,7,63360.81,9240,72600.81
313400,202311,443,318,125,419832.61,165029.3,584861.91
313410,202311,117,76,41,100327.71,54122.59,154450.30
313420,202311,5222,3089,2133,4079262.42,2818360.45,6897622.87
313430,202311,126,61,65,80530.87,85807.6,166338.47
313440,202311,1465,1048,417,1384851.6,550501.75,1935353.35
313450,202311,81,34,47,44880.34,62040,106920.34
313460,202311,446,201,245,265357.05,323431.98,588789.03
313470,202311,545,271,274,357777.09,361744.74,719521.83
313480,202311,175,135,40,178217.54,52804.99,231022.53
313490,202311,644,295,349,389445.61,460727.43,850173.04
313500,202311,33,19,14,25081.04,18481.21,43562.25
313505,202311,1193,908,285,1198703.88,376237.35,1574941.23
313507,202311,129,93,36,122768.69,47523.08,170291.77
313510,202311,3265,2007,1258,2649655.25,1662050.38,4311705.63
313520,202311,3709,2845,864,3755873.9,1140564.26,4896438.16
313530,202311,48,30,18,39604.47,23761.18,63365.65
313535,202311,111,92,19,121445.42,25081.97,146527.39
313540,202311,72,51,21,67324.73,27721.39,95046.12
313545,202311,145,126,19,166339.43,25080.57,191420.00
313550,202311,237,202,35,266682.24,46203.68,312885.92
313560,202311,381,182,199,240281.83,262730.26,503012.09
313570,202311,93,33,60,43562.03,79201.22,122763.25
313580,202311,1520,917,603,1211844.61,796017.23,2007861.84
313590,202311,92,59,33,77889.05,43565.61,121454.66
313600,202311,763,472,291,623082.59,384143.82,1007226.41
313610,202311,71,56,15,73924.75,19800.61,93725.36
313620,202311,1711,845,866,1115513.61,1144475.78,2259989.39
313630,202311,1882,1428,454,1885191.25,599315.88,2484507.13
313640,202311,119,70,49,92403.56,64683.89,157087.45
313650,202311,263,140,123,184809.06,162376.25,347185.31
313652,202311,37,34,3,44880.67,3960,48840.67
313655,202311,113,76,37,100325.8,48842.99,149168.79
313657,202311,58,52,6,68650.83,7920.94,76571.77
313660,202311,166,113,53,149178.97,69965.06,219144.03
313665,202311,826,382,444,504297.53,586143.43,1090440.96
313670,202311,12987,9044,3943,11945947.2,5210386.92,17156334.12
313680,202311,52,39,13,51484.91,17160.94,68645.85
313690,202311,154,109,45,143899,59402.34,203301.34
313695,202311,94,73,21,96365.88,27720.44,124086.32
313700,202311,411,324,87,427731.66,116168.57,543900.23
313710,202311,131,92,39,121457.99,51485.72,172943.71
313720,202311,1327,635,692,838308.06,914850.35,1753158.41
313730,202311,86,51,35,67325.87,46203.85,113529.72
313740,202311,172,127,45,167655.7,59403.89,227059.59
313750,202311,445,313,132,413207,174249.84,587456.84
313753,202311,257,201,56,265340.99,73931.44,339272.43
313760,202311,1572,617,955,814529.95,1260733.02,2075262.97
313770,202311,483,324,159,427723.16,209898.12,637621.28
313780,202311,980,552,428,728684.91,564987.3,1293672.21
313790,202311,35,35,0,46201.5,,46201.5
313800,202311,185,118,67,155777.33,88447.65,244224.98
313810,202311,106,61,45,81843.37,59401.5,141244.87
313820,202311,1592,770,822,1020467.36,1085070.35,2105537.71
313830,202311,60,41,19,54124.92,25082.25,79207.17
313835,202311,72,63,9,83160.8,11880.8,95041.6
313840,202311,1962,1216,746,1606571.34,984773.5,2591344.84
313850,202311,250,118,132,155767.36,174258.36,330025.72
313860,202311,539,406,133,535978.02,175570.22,711548.24
313862,202311,190,132,58,174257.91,76568.61,250826.52
313865,202311,205,144,61,190081.61,80520,270601.61
313867,202311,68,56,12,73922.24,15840.1,89762.34
313868,202311,65,42,23,55442.38,30360.2,85802.58
313870,202311,89,51,38,67332.15,50167.03,117499.18
313880,202311,420,261,159,345868.03,209895.93,555763.96
313890,202311,362,202,160,266662.95,211214.45,477877.40
313900,202311,976,538,438,710218.13,578195.72,1288413.85
313910,202311,151,101,50,133327.03,66001.82,199328.85
313920,202311,742,504,238,665341.32,314192.41,979533.73
313925,202311,39,33,6,43561.15,7920.03,51481.18
313930,202311,994,755,239,999384.76,316833.07,1316217.83
313940,202311,2289,1400,889,1849505.23,1174881.46,3024386.69
313950,202311,982,606,376,799985.09,496343.62,1296328.71
313960,202311,1649,958,691,1264665.99,912188.81,2176854.80
313970,202311,267,146,121,192722.73,159720.8,352443.53
313980,202311,271,170,101,224419.58,133329.72,357749.30
313990,202311,329,190,139,250819.87,183484.68,434304.55
314000,202311,1007,650,357,858100.48,471286.35,1329386.83
314010,202311,138,93,45,122765.46,59404.21,182169.67
314015,202311,123,44,79,58081.9,104293.45,162375.35
314020,202311,65,43,22,56766.28,29041.99,85808.27
314030,202311,80,43,37,56763.28,48840.8,105604.08
314040,202311,55,29,26,38285.16,34320.11,72605.27
314050,202311,318,173,145,228383.79,192727.05,421110.84
314053,202311,106,70,36,92408.62,47522.21,139930.83
314055,202311,330,218,112,287782.68,147855.23,435637.91
314060,202311,136,119,17,157087.65,22440.5,179528.15
314070,202311,1128,573,555,756445.05,733991.39,1490436.44
314080,202311,229,136,93,179546.84,122766.59,302313.43
314085,202311,211,150,61,198001.97,80520,278521.97
314090,202311,469,347,122,459392.69,161054.87,620447.56
314100,202311,574,445,129,587463.72,170291.69,757755.41
314110,202311,849,367,482,484495.71,637610.11,1122105.82
314120,202311,76,47,29,62040.82,38280.72,100321.54
314130,202311,29,21,8,27720.06,10560,38280.06
314140,202311,1329,850,479,1124737.48,633645.27,1758382.75
314150,202311,214,139,75,183495.49,99011.87,282507.36
314160,202311,328,252,76,332674.41,100330.5,433004.91
314170,202311,98,73,25,96374.28,33002.4,129376.68
314180,202311,843,746,97,984882.63,128056.74,1112939.37
314190,202311,93,58,35,76572.89,46203.82,122776.71
314200,202311,578,406,172,535989.26,227071.02,763060.28
314210,202311,247,191,56,253467.06,75251.12,328718.18
314220,202311,338,242,96,319478.16,126730.64,446208.80
314225,202311,45,29,16,38283.07,21122.47,59405.54
314230,202311,138,58,80,76566.77,105603.31,182170.08
314240,202311,197,141,56,186140.18,73927.28,260067.46
314250,202311,60,38,22,50164.78,29041.33,79206.11
314260,202311,224,120,104,158407.7,138602.71,297010.41
314270,202311,448,344,104,454145.96,137291.04,591437.00
314280,202311,795,433,362,571547.25,477874.75,1049422.00
314290,202311,602,471,131,621809.26,172935.77,794745.03
314300,202311,347,264,83,348533.39,109572.25,458105.64
314310,202311,1434,992,442,1309589.84,584783.68,1894373.52
314315,202311,60,46,14,60721.1,18480,79201.1
314320,202311,658,467,191,617820.64,252141.08,869961.72
314330,202311,13403,6575,6828,8684009.35,9020080.27,17704089.62
314340,202311,744,340,404,448845.33,534628.22,983473.55
314345,202311,67,49,18,64683.98,23760,88443.98
314350,202311,192,117,75,154455.98,99003.52,253459.50
314360,202311,64,40,24,52804.31,31684.26,84488.57
314370,202311,84,59,25,77880.5,33000.34,110880.84
314380,202311,148,83,65,109561.63,85800.98,195362.61
314390,202311,4000,2604,1396,3440246.94,1842794.28,5283041.22
314400,202311,779,553,226,730061.03,298364.56,1028425.59
314410,202311,615,413,202,545198.23,266654.88,811853.11
314420,202311,80,54,26,71280.84,34320.67,105601.51
314430,202311,2643,1035,1608,1366327.73,2125407.41,3491735.14
314435,202311,167,102,65,134645.39,85800.34,220445.73
314437,202311,63,51,12,67320.82,15840.15,83160.97
314440,202311,113,70,43,92404.67,56762.52,149167.19
314450,202311,188,127,61,167656.62,80527.74,248184.36
314460,202311,662,338,324,446210.19,427714.34,873924.53
314465,202311,142,96,46,126724.75,60722.21,187446.96
314467,202311,84,68,16,89760.2,21122.62,110882.82
314470,202311,463,237,226,312872.51,298349.63,611222.14
314480,202311,1228,566,662,747207.31,875215.72,1622423.03
314490,202311,42,22,20,29041.36,26402.57,55443.93
314500,202311,300,203,97,267986.97,128055.05,396042.02
314505,202311,127,79,48,104287.27,63361.32,167648.59
314510,202311,273,223,50,294407.64,66002.86,360410.50
314520,202311,1601,822,779,1085176.66,1029708.26,2114884.92
314530,202311,852,682,170,901712.59,225754.61,1127467.20
314535,202311,202,131,71,173889.26,93720,267609.26
314537,202311,77,47,30,62046.91,39603.06,101649.97
314540,202311,24,15,9,19800,11881.44,31681.44
314545,202311,78,52,26,68640.67,34322.08,102962.75
314550,202311,89,50,39,66006.77,51486.11,117492.88
314560,202311,944,504,440,666656.74,580845.16,1247501.90
314570,202311,18,15,3,19803.45,3960,23763.45
314580,202311,10,5,5,6600.98,6600.5,13201.48
314585,202311,35,28,7,36963.43,9240.31,46203.74
314587,202311,85,72,13,95047.87,18480,113527.87
314590,202311,685,456,229,601977.72,302303.43,904281.15
314600,202311,1118,734,384,970307.09,506924.78,1477231.87
314610,202311,1127,582,545,768315.33,719471.17,1487786.50
314620,202311,166,128,38,168961.96,50160.44,219122.40
314625,202311,102,81,21,106924.38,27720.84,134645.22
314630,202311,1225,710,515,938123.94,679887.5,1618011.44
314640,202311,99,60,39,79208.84,51483.68,130692.52
314650,202311,166,100,66,132016.53,87131.3,219147.83
314655,202311,68,49,19,64681.56,25081.41,89762.97
314660,202311,27,22,5,29041.66,6601.52,35643.18
314670,202311,241,187,54,246878,71289.43,318167.43
314675,202311,234,148,86,195379.89,113532.31,308912.20
314690,202311,563,300,263,396027.64,347184.51,743212.15
314700,202311,2387,1282,1105,1692496.88,1461408.01,3153904.89
314710,202311,2077,1134,943,1498328.25,1244783.09,2743111.34
314720,202311,466,258,208,340596.84,274576.78,615173.62
314730,202311,583,312,271,411873.93,359063.28,770937.21
314740,202311,905,405,500,534651.52,661373.62,1196025.14
314750,202311,36,25,11,33000.83,14520,47520.83
314760,202311,395,156,239,205939.15,316815.12,522754.27
314770,202311,101,68,33,89778.73,43564.21,133342.94
314780,202311,16,7,9,9240.79,11882.07,21122.86
314790,202311,2839,1831,1008,2417562.21,1330581.74,3748143.95
314795,202311,84,72,12,95041.26,15840.67,110881.93
314800,202311,3275,1944,1331,2566341.36,1757004.1,4323345.46
314810,202311,1682,981,701,1295049.25,926689.76,2221739.01
314820,202311,136,86,50,113527.01,66002.13,179529.14
314830,202311,244,210,34,277231.79,44887.6,322119.39
314840,202311,96,59,37,77882.84,48843.39,126726.23
314850,202311,470,231,239,305061.35,316804.24,621865.59
314860,202311,594,470,124,620474.89,163695.89,784170.78
314870,202311,1885,1047,838,1387449.3,1106297.55,2493746.85
314875,202311,77,69,8,91081.5,10560.18,101641.68
314880,202311,53,41,12,54121.82,15841.52,69963.34
314890,202311,57,29,28,38283.89,36964.41,75248.30
314900,202311,27,20,7,26401.8,9242.15,35643.95
314910,202311,248,168,80,221784.9,105604.48,327389.38
314915,202311,157,129,28,170285.71,36960.8,207246.51
314920,202311,90,58,32,76568.6,42244.73,118813.33
314930,202311,1197,542,655,715538.05,864645.07,1580183.12
314940,202311,38,32,6,42241.51,7920.9,50162.41
314950,202311,25,19,6,25083.98,7920.41,33004.39
314960,202311,35,20,15,26404.55,19802.1,46206.65
314970,202311,210,92,118,121454.97,155776.53,277231.50
314980,202311,355,236,119,311549.6,157095.22,468644.82
314990,202311,493,259,234,341916.79,308900.51,650817.30
314995,202311,168,82,86,108243.62,113521.55,221765.17
315000,202311,119,90,29,118815.73,38282.58,157098.31
315010,202311,42,27,15,35642.14,19802.3,55444.44
315015,202311,181,147,34,194045.2,44881.38,238926.58
315020,202311,75,63,12,83160.24,15841.36,99001.60
315030,202311,127,93,34,122766.98,44880.67,167647.65
315040,202311,97,57,40,75241.7,52800.27,128041.97
315050,202311,223,140,83,184805.08,109564.62,294369.70
315053,202311,77,55,22,72600.17,29040,101640.17
315057,202311,145,114,31,150482.58,40920,191402.58
315060,202311,62,53,9,69972.75,11881.93,81854.68
315070,202311,139,87,52,114845.57,69963.95,184809.52
315080,202311,421,338,83,446243.78,109570.97,555814.75
315090,202311,114,65,49,87127.97,64680.77,151808.74
315100,202311,116,59,57,77885.84,75244.07,153129.91
315110,202311,307,160,147,211219.45,194048.82,405268.27
315120,202311,2109,975,1134,1288473.8,1499674.42,2788148.22
315130,202311,391,278,113,366995.22,150494.28,517489.50
315140,202311,594,320,274,422439.81,363029.84,785469.65
315150,202311,1086,542,544,715512.22,720777.48,1436289.70
315160,202311,208,116,92,153146,124100.8,277246.8
315170,202311,273,173,100,228391.82,132018.69,360410.51
315180,202311,3647,1575,2072,2080535.61,2739125.81,4819661.42
315190,202311,313,191,122,252166.35,161060.69,413227.04
315200,202311,1392,866,526,1143209.98,694381.11,1837591.09
315210,202311,2022,1257,765,1660697.44,1011170.86,2671868.30
315213,202311,27,17,10,22442.5,13204.14,35646.64
315217,202311,247,194,53,256085.64,69962.81,326048.45
315220,202311,1765,1288,477,1701691.54,629710.43,2331401.97
315230,202311,218,169,49,223091.67,64682.62,287774.29
315240,202311,426,295,131,389461.39,174272.21,563733.60
315250,202311,3057,1482,1575,1956419.61,2085670.83,4042090.44
315260,202311,148,86,62,113524.93,81841.67,195366.60
315270,202311,174,123,51,162368.64,67320.78,229689.42
315280,202311,696,458,238,604654.56,314215.18,918869.74
315290,202311,217,141,76,186124.6,100320,286444.6
315300,202311,113,87,26,114843.15,34322.24,149165.39
315310,202311,97,86,11,113520.52,14520.67,128041.19
315320,202311,147,97,50,128063.32,66009.28,194072.60
315330,202311,65,54,11,71280.71,14520.11,85800.82
315340,202311,408,302,106,398683.15,139931.57,538614.72
315350,202311,186,118,68,155769.95,89768.88,245538.83
315360,202311,128,63,65,83162.59,85801.99,168964.58
315370,202311,61,40,21,52802.96,27721.32,80524.28
315380,202311,8,5,3,6600,3960,10560
315390,202311,80,29,51,38282.24,67327.73,105609.97
315400,202311,971,742,229,980832.9,302297.7,1283130.6
315410,202311,349,206,143,271961.22,188785.95,460747.17
315415,202311,67,50,17,66008.89,22441.44,88450.33
315420,202311,217,156,61,205940.21,80523.4,286463.61
315430,202311,667,370,297,488453.18,392074.03,880527.21
315440,202311,105,70,35,92403.6,46201.2,138604.8
315445,202311,263,218,45,287810.85,59406.81,347217.66
315450,202311,190,138,52,182160,68641.66,250801.66
315460,202311,5729,2691,3038,3556532.11,4015784.7,7572316.81
315470,202311,58,23,35,30361.92,46201.57,76563.49
315480,202311,96,31,65,40925.59,85810.35,126735.94
315490,202311,780,517,263,682470.04,347177.86,1029647.90
315500,202311,25,20,5,26402.16,6600,33002.16
315510,202311,174,125,49,165010.58,64684.85,229695.43
315520,202311,82,67,15,88442.23,19800,108242.23
315530,202311,50,29,21,38280.76,27720.07,66000.83
315540,202311,291,201,90,265341.53,118804.26,384145.79
315550,202311,207,164,43,216495.01,56763.33,273258.34
315560,202311,783,621,162,819852.52,213875.22,1033727.74
315570,202311,333,170,163,224433.67,216505.41,440939.08
315580,202311,820,559,261,737931.25,344544.34,1082475.59
315590,202311,210,104,106,137306.89,141261.72,278568.61
315600,202311,399,310,89,409241.66,117496.46,526738.12
315610,202311,111,54,57,71280.32,75240.56,146520.88
315620,202311,47,36,11,47525.36,14523.11,62048.47
315630,202311,150,115,35,151814.28,46201.23,198015.51
315640,202311,61,40,21,52801.02,27721.07,80522.09
315645,202311,61,41,20,54124.73,26401.56,80526.29
315650,202311,172,131,41,172938.1,54127.53,227065.63
315660,202311,469,227,242,299679.81,319477.83,619157.64
315670,202311,2769,1250,1519,1654205.78,2006623.8,3660829.58
315680,202311,805,592,213,781496.57,281179.46,1062676.03
315690,202311,754,507,247,669310.36,326069.93,995380.29
315700,202311,2239,1167,1072,1540641.97,1415243.88,2955885.85
315710,202311,399,143,256,189731.93,337930.54,527662.47
315720,202311,575,355,220,468645.38,291738.52,760383.90
315725,202311,225,178,47,234978.27,62042.99,297021.26
315727,202311,127,88,39,116169.84,51486.22,167656.06
315730,202311,63,57,6,75242.71,7920.4,83163.11
315733,202311,96,55,41,72606.86,54120.54,126727.40
315737,202311,54,43,11,56770.03,14520.78,71290.81
315740,202311,39,31,8,40921.08,10560,51481.08
315750,202311,182,129,53,170305.32,69962.16,240267.48
315760,202311,55,43,12,56760.01,15840,72600.01
315765,202311,165,98,67,129374.88,88452.56,217827.44
315770,202311,269,183,86,241577.1,113526.21,355103.31
315780,202311,4701,2341,2360,3094390.26,3115350.86,6209741.12
315790,202311,281,218,63,287788.12,83163.99,370952.11
315800,202311,364,236,128,311553.39,168974.91,480528.30
315810,202311,68,39,29,51481.17,38280.6,89761.77
315820,202311,839,638,201,842285.97,265355.12,1107641.09
315830,202311,133,94,39,124090.58,51488.1,175578.68
315840,202311,92,64,28,84480.57,36960.98,121441.55
315850,202311,286,187,99,246881.64,130697.08,377578.72
315860,202311,25,11,14,14520.88,18480,33000.88
315870,202311,42,33,9,43564.67,11881.51,55446.18
315880,202311,105,70,35,92408.07,46204.1,138612.17
315890,202311,117,84,33,110885.68,43562.8,154448.48
315895,202311,426,285,141,377583.86,186142.47,563726.33
315900,202311,98,46,52,60722.64,68642.08,129364.72
315910,202311,54,31,23,40920,30360,71280
315920,202311,173,114,59,150500.12,77884.37,228384.49
315930,202311,61,26,35,34322.54,47525.47,81848.01
315935,202311,147,116,31,153135.45,40921.36,194056.81
315940,202311,103,75,28,99005.35,36961.2,135966.55
315950,202311,46,36,10,47524.1,13200.99,60725.09
315960,202311,646,311,335,410555.05,443556.16,854111.21
315970,202311,41,34,7,44880.72,9240,54120.72
315980,202311,731,395,336,521449.9,443553.31,965003.21
315990,202311,279,161,118,212547.85,155778.81,368326.66
316000,202311,54,32,22,42243.96,29040.64,71284.60
316010,202311,109,93,16,122775.26,21124.81,143900.07
316020,202311,100,91,9,120122.28,11880,132002.28
316030,202311,391,234,157,308926.32,207265.6,516191.92
316040,202311,599,247,352,326067.8,464669.12,790736.92
316045,202311,60,54,6,71281.27,7920.8,79202.07
316050,202311,29,19,10,25080,13200,38280
316060,202311,112,80,32,105605.44,42242.2,147847.64
316070,202311,1411,958,453,1265979.38,597997.19,1863976.57
316080,202311,99,66,33,87237.6,43560.47,130798.07
316090,202311,43,20,23,26400.11,30361.45,56761.56
316095,202311,90,77,13,101648.73,17161.73,118810.46
316100,202311,402,226,176,298340.69,232328.73,530669.42
316105,202311,69,45,24,59404.23,31682.39,91086.62
316110,202311,2012,1534,478,2026445.41,633659.34,2660104.75
316120,202311,79,53,26,69966.6,34320.34,104286.94
316130,202311,126,90,36,118814.29,47526.29,166340.58
316140,202311,33,24,9,31680.2,11880,43560.2
316150,202311,261,185,76,245535.08,100328.64,345863.72
316160,202311,95,66,29,87130.24,38285.81,125416.05
316165,202311,83,53,30,69963.42,39602.44,109565.86
316170,202311,200,129,71,170300.6,95050.42,265351.02
316180,202311,240,94,146,124096.78,195378.27,319475.05
316190,202311,155,113,42,149167.03,55441.46,204608.49
316200,202311,762,425,337,561051.17,444864.55,1005915.72
316210,202311,810,559,251,739509.88,331364.03,1070873.91
316220,202311,143,92,51,121443.46,67321.35,188764.81
316225,202311,46,29,17,38283,22440.68,60723.68
316230,202311,27,21,6,27721.59,7920,35641.59
316240,202311,740,588,152,776260.1,200662.84,976922.94
316245,202311,179,161,18,212539.28,23762.41,236301.69
316250,202311,1848,1210,638,1597362.88,842186.45,2439549.33
316255,202311,146,113,33,149172.46,43561.4,192733.86
316257,202311,186,92,94,121448.91,124099.28,245548.19
316260,202311,227,152,75,200663.56,100331.04,300994.60
316265,202311,43,33,10,43565.46,13201.74,56767.20
316270,202311,742,523,219,690466.39,289120.77,979587.16
316280,202311,657,429,228,566351.01,300993.35,867344.36
316290,202311,1008,713,295,941223.05,389424.03,1330647.08
316292,202311,723,311,412,410554.26,543892.85,954447.11
316294,202311,114,72,42,95049.68,55446.22,150495.90
316295,202311,457,215,242,285143,319471.45,604614.45
316300,202311,52,34,18,44880.92,23760,68640.92
316310,202311,23,13,10,17160.34,13200.11,30360.45
316320,202311,78,35,43,46201.29,56760.62,102961.91
316330,202311,194,140,54,184815.65,71286.82,256102.47
316340,202311,154,104,50,137282.23,66003.52,203285.75
316350,202311,214,148,66,195379.82,87125.68,282505.50
316360,202311,36,21,15,27721.04,19800,47521.04
316370,202311,1495,740,755,976877.85,999290.39,1976168.24
316380,202311,137,110,27,145211.23,35645.7,180856.93
316390,202311,104,78,26,102973.4,35642.29,138615.69
316400,202311,199,151,48,199344.91,63366.94,262711.85
316410,202311,417,286,131,377530.72,172923.03,550453.75
316420,202311,244,161,83,212542.46,109568.1,322110.56
316430,202311,175,99,76,132006.95,100321.69,232328.64
316440,202311,85,48,37,63367.84,48844.45,112212.29
316443,202311,46,38,8,50165.19,10560,60725.19
316447,202311,58,48,10,63363.59,13200.32,76563.91
316450,202311,274,206,68,271935.43,89766.19,361701.62
316460,202311,58,21,37,27722.39,48844.72,76567.11
316470,202311,1998,1478,520,1952446.51,687738.62,2640185.13
316480,202311,8,6,2,7920.4,2640,10560.4
316490,202311,24,7,17,9240.2,22440.44,31680.64
316500,202311,189,122,67,161056.86,88445.74,249502.60
316510,202311,147,119,28,157093.48,36961.43,194054.91
316520,202311,194,103,91,135967.59,120128.55,256096.14
316530,202311,197,129,68,170302.49,89765.17,260067.66
316540,202311,180,97,83,128057.54,109566.05,237623.59
316550,202311,208,137,71,180853.68,93722.24,274575.92
316553,202311,578,299,279,394697.44,368298.21,762995.65
316555,202311,91,79,12,104721.88,15840,120561.88
316556,202311,20,14,6,18481,7920.44,26401.44
316557,202311,54,37,17,48840.77,22440,71280.77
316560,202311,76,54,22,71281.43,29040,100321.43
316570,202311,249,228,21,300996.41,27723.18,328719.59
316580,202311,26,16,10,21121.01,13200.44,34321.45
316590,202311,89,76,13,100330.95,17163.16,117494.11
316600,202311,185,153,32,201972.1,42241.55,244213.65
316610,202311,71,53,18,69962.3,23760,93722.3
316620,202311,173,123,50,162366.12,66002.22,228368.34
316630,202311,75,56,19,73922.31,25080.11,99002.42
316640,202311,24,14,10,18480,13200,31680
316650,202311,127,101,26,133320,34320,167640
316660,202311,6,2,4,2640,5280.8,7920.8
316670,202311,456,154,302,204618.65,398685.3,603303.95
316680,202311,193,148,45,195374.34,59406.65,254780.99
316690,202311,157,97,60,128046.93,79201.68,207248.61
316695,202311,63,51,12,67320,15840,83160
316700,202311,37,25,12,33000.57,17160.11,50160.68
316710,202311,895,679,216,897696.01,285152.47,1182848.48
316720,202311,5934,2760,3174,3648848.13,4192477.03,7841325.16
316730,202311,16,15,1,19802.87,1320.6,21123.47
316740,202311,183,114,69,150485.4,91082.95,241568.35
316750,202311,20,10,10,13202.84,13200.95,26403.79
316760,202311,382,300,82,396060.73,108251.81,504312.54
316770,202311,196,111,85,146524.97,112203.03,258728.00
316780,202311,75,44,31,58084.03,40922.05,99006.08
316790,202311,82,57,25,75241,33000.52,108241.52
316800,202311,1942,1172,770,1547225.23,1016533.55,2563758.78
316805,202311,40,27,13,35641.85,17160.67,52802.52
316810,202311,66,37,29,48849.92,38283.64,87133.56
316820,202311,42,25,17,33001.22,22440.78,55442.00
316830,202311,114,55,59,72608.9,77890.47,150499.37
316840,202311,545,340,205,448848.49,271943.74,720792.23
316850,202311,332,234,98,308909.82,129371.07,438280.89
316860,202311,7143,3312,3831,4375693.73,5061174.97,9436868.70
316870,202311,2035,1328,707,1755802.2,933288.4,2689090.6
316880,202311,174,89,85,117490.92,112206.48,229697.40
316890,202311,244,160,84,211222.39,110895.98,322118.37
316900,202311,480,339,141,447508.15,187448.77,634956.92
316905,202311,28,14,14,18481.2,18480,36961.2
316910,202311,97,42,55,55442.17,72601.72,128043.89
316920,202311,172,132,40,174257.23,52802.27,227059.50
316930,202311,2287,1175,1112,1551097.73,1469216.74,3020314.47
316935,202311,1085,642,443,848831.72,584807.56,1433639.28
316940,202311,1247,723,524,954433.89,691725.55,1646159.44
316950,202311,236,125,111,165011.6,146534.32,311545.92
316960,202311,1192,671,521,885820.15,687795.27,1573615.42
316970,202311,725,586,139,773617.43,186149.62,959767.05
316980,202311,93,50,43,66002.68,56762.33,122765.01
316990,202311,2610,1793,817,2370908.56,1079833.24,3450741.80
317000,202311,371,288,83,380218.31,109571.42,489789.73
317005,202311,247,173,74,228389.15,97686.76,326075.91
317010,202311,7895,4576,3319,6042303.27,4385382.24,10427685.51
317020,202311,17520,7795,9725,10299815.03,12851067.07,23150882.10
317030,202311,107,49,58,64683.15,76561.78,141244.93
317040,202311,3416,2286,1130,3017837.83,1494412.83,4512250.66
317043,202311,81,63,18,83171.89,23764.98,106936.87
317047,202311,47,31,16,40920.06,21120.42,62040.48
317050,202311,180,144,36,190097.67,47525.05,237622.72
317052,202311,172,143,29,188769.97,38281.19,227051.16
317057,202311,212,163,49,215167.29,66002.15,281169.44
317060,202311,64,39,25,51481,33001.71,84482.71
317065,202311,57,45,12,59402.57,15840,75242.57
317070,202311,2233,1043,1190,1376910.87,1572176.06,2949086.93
317075,202311,113,65,48,85806.65,63364.25,149170.90
317080,202311,1059,546,513,720804.21,678509.18,1399313.39
317090,202311,794,609,185,803985.69,245540.1,1049525.79
317100,202311,506,377,129,497680.01,170292.34,667972.35
317103,202311,151,121,30,159726.67,39600.6,199327.27
317107,202311,66,50,16,66000.96,21120,87120.96
317110,202311,85,48,37,64687,48848.21,113535.21
317115,202311,62,56,6,73982.92,7921.14,81904.06
317120,202311,2479,1252,1227,1654162.16,1621110.66,3275272.82
317130,202311,2404,1661,743,2192677.97,980796.47,3173474.44
317140,202311,19,15,4,19800.78,5280,25080.78
317150,202311,322,194,128,256094.71,168967.79,425062.50
317160,202311,395,290,105,382842.13,138616.4,521458.53
317170,202311,264,172,92,227065.22,121443.61,348508.83
317180,202311,455,316,139,417166.85,183491.83,600658.68
317190,202311,240,171,69,225733.61,91085.69,316819.30
317200,202311,1014,728,286,961067.81,378883.33,1339951.14
317210,202311,197,101,96,133334.65,126725.99,260060.64
317220,202311,26,14,12,18480.5,15840.67,34321.17
320010,202311,622,443,179,584871.6,236317.55,821189.15
320013,202311,164,110,54,145217.42,71291.22,216508.64
320016,202311,297,183,114,241602.05,150498.84,392100.89
320020,202311,847,511,336,674610.79,444900.77,1119511.56
320030,202311,206,143,63,188785.49,83165.49,271950.98
320035,202311,154,104,50,137292.55,66005.44,203297.99
320040,202311,534,270,264,356450.86,348532.27,704983.13
320050,202311,153,104,49,137305.03,64686.52,201991.55
320060,202311,2201,1049,1152,1384872.75,1524823.91,2909696.66
320070,202311,126,81,45,106934.27,59403.44,166337.71
320080,202311,938,529,409,698401.28,539947.93,1238349.21
320090,202311,1513,973,540,1285840.22,712883.04,1998723.26
320100,202311,419,237,182,312888.88,240279.16,553168.04
320110,202311,158,105,53,138624.48,69973.59,208598.07
320115,202311,132,113,19,149179.61,25081.68,174261.29
320120,202311,4493,2423,2070,3200024.92,2735310.32,5935335.24
320130,202311,9672,4187,5485,5531583.64,7249022.7,12780606.34
320140,202311,618,405,213,534660.98,281190.15,815851.13
320150,202311,2546,1428,1118,1885206.32,1477269.09,3362475.41
320160,202311,762,329,433,434329.07,571605.66,1005934.73
320170,202311,128,101,27,133338.16,35644.33,168982.49
320180,202311,65,38,27,50165.49,35646.73,85812.22
320190,202311,294,174,120,229721.23,159737.76,389458.99
320200,202311,75,61,14,80532.36,18482.12,99014.48
320210,202311,1039,567,472,748551.06,623126.86,1371677.92
320220,202311,317,113,204,149170.13,269290.64,418460.77
320225,202311,101,82,19,108256.86,25084.05,133340.91
320230,202311,862,556,306,734036.58,403965.82,1138002.40
320240,202311,4140,1858,2282,2452835.59,3015165.3,5468000.89
320245,202311,609,417,192,550515.21,253473.66,803988.87
320250,202311,267,127,140,167668.43,184825.56,352493.99
320255,202311,146,111,35,146540.67,46206.02,192746.69
320260,202311,348,180,168,237624.2,221768.56,459392.76
320265,202311,159,124,35,163702.28,46204.93,209907.21
320270,202311,168,125,43,166349.56,56767.8,223117.36
320280,202311,1656,970,686,1280533.44,905601.28,2186134.72
320290,202311,79,61,18,80533.76,23762.41,104296.17
320300,202311,718,498,220,657438.44,291752.64,949191.08
320305,202311,887,511,376,675935.14,496386.89,1172322.03
320310,202311,236,147,89,194062.06,117492.29,311554.35
320313,202311,441,192,249,253473.25,330040.92,583514.17
320316,202311,117,89,28,117502.16,36965.87,154468.03
320320,202311,4006,1861,2145,2458164.79,2831766.18,5289930.97
320330,202311,345,250,95,330012,125404.56,455416.56
320332,202311,941,574,367,757827.02,485842.34,1243669.36
320334,202311,330,182,148,240269.98,195381.2,435651.18
320335,202311,178,114,64,150507.53,84493.92,235001.45
320340,202311,695,502,193,662737.41,254791.76,917529.17
320350,202311,1255,532,723,702324.29,954467.67,1656791.96
320360,202311,200,93,107,122772.38,142565.34,265337.72
320370,202311,270,201,69,265352.27,91086.34,356438.61
320380,202311,394,282,112,372275.5,147846.66,520122.16
320390,202311,1320,779,541,1028446.18,715536.07,1743982.25
320400,202311,375,258,117,340621.29,154463.14,495084.43
320405,202311,1110,454,656,599354.48,867314.77,1466669.25
320410,202311,1059,516,543,681223.47,718158.76,1399382.23
320420,202311,712,328,384,433016.91,506940.31,939957.22
320425,202311,241,129,112,170296.55,149165.96,319462.51
320430,202311,483,265,218,349854.29,287804.96,637659.25
320435,202311,233,157,76,207264.26,100330.16,307594.42
320440,202311,249,146,103,192749.31,135981.67,328730.98
320450,202311,156,84,72,110902.3,95052.16,205954.46
320455,202311,273,212,61,279890.93,80531.29,360422.22
320460,202311,389,237,152,312874.4,200653.91,513528.31
320465,202311,142,98,44,129377.3,58089.93,187467.23
320470,202311,875,526,349,695729.82,462065.62,1157795.44
320480,202311,283,188,95,248187.19,125408.26,373595.45
320490,202311,3859,1888,1971,2492475.31,2603392.8,5095868.11
320495,202311,145,89,56,117491.23,75251.07,192742.30
320500,202311,12675,6314,6361,8340994.47,8406969.63,16747964.10
320501,202311,654,344,310,454146.9,410585.78,864732.68
320503,202311,383,276,107,364366.12,142575.44,506941.56
320506,202311,327,221,106,291750.39,139929.65,431680.04
320510,202311,1506,679,827,897715.94,1091781.27,1989497.21
320515,202311,101,77,24,101655.72,31684.46,133340.18
320517,202311,276,202,74,266686.4,97693.45,364379.85
320520,202311,9843,4228,5615,5586884.35,7417900.17,13004784.52
320530,202311,8855,4246,4609,5610527.13,6093721.51,11704248.64
330010,202311,4354,2102,2252,2774938.88,2975513.48,5750452.36
330015,202311,253,113,140,149171.58,184809.48,333981.06
330020,202311,5064,1919,3145,2533378.31,4157046.11,6690424.42
330022,202311,313,155,158,204623.03,208573.36,413196.39
330023,202311,1082,304,778,401312.03,1027024.66,1428336.69
330025,202311,1205,220,985,290416.25,1301519.06,1591935.31
330030,202311,2248,1370,878,1809926,1159073.44,2968999.44
330040,202311,3251,1660,1591,2195390.06,2100329.36,4295719.42
330045,202311,12776,4251,8525,5614506.77,11271179.49,16885686.26
330050,202311,1081,651,430,859412.64,567645.06,1427057.70
330060,202311,1589,917,672,1211886.11,887110.99,2098997.10
330070,202311,5603,1909,3694,2522754.74,4884364.65,7407119.39
330080,202311,1948,844,1104,1114212.51,1460040.81,2574253.32
330090,202311,451,255,196,336650.96,258750.98,595401.94
330093,202311,263,114,149,150497.66,196694.39,347192.05
330095,202311,87,47,40,62045.06,52801.85,114846.91
330100,202311,13685,6879,6806,9082597.69,8992643.84,18075241.53
330110,202311,568,260,308,343229.93,407920.91,751150.84
330115,202311,594,296,298,390760.09,393390.73,784150.82
330120,202311,499,254,245,335316.74,324751.01,660067.75
330130,202311,1865,541,1324,715520.3,1749235.26,2464755.56
330140,202311,865,444,421,586128.67,557074.04,1143202.71
330150,202311,623,385,238,508242.36,314188.79,822431.15
330160,202311,174,110,64,145219.83,84488.12,229707.95
330170,202311,32484,11855,20629,15663631.31,27259474.54,42923105.85
330180,202311,309,167,142,220454.94,188770.67,409225.61
330185,202311,1515,632,883,834307.83,1168330.79,2002638.62
330187,202311,858,242,616,319460.52,814489.86,1133950.38
330190,202311,7699,3010,4689,3974960.37,6199320.63,10174281.00
330200,202311,5548,1981,3567,2616541.65,4715578.21,7332119.86
330205,202311,580,318,262,419806.65,345876.92,765683.57
330210,202311,1042,620,422,818495.22,557110.44,1375605.66
330220,202311,3339,1966,1373,2599425.85,1813866.53,4413292.38
330225,202311,756,363,393,479199.13,518810.38,998009.51
330227,202311,2650,977,1673,1289777.37,2209912.98,3499690.35
330230,202311,262,140,122,184815.88,161051.93,345867.81
330240,202311,5535,2608,2927,3442960.52,3866649.79,7309610.31
330245,202311,209,102,107,134646.41,141250.91,275897.32
330250,202311,8053,3849,4204,5086656.29,5555045.12,10641701.41
330260,202311,1018,308,710,406582.86,937251.93,1343834.79
330270,202311,5073,1660,3413,2192793.1,4510909.02,6703702.12
330280,202311,545,323,222,427737.15,293063.89,720801.04
330285,202311,7473,2470,5003,3260924.1,6614004.24,9874928.34
330290,202311,936,329,607,434314.46,802617.6,1236932.06
330300,202311,881,539,342,712370.09,451497.02,1163867.11
330310,202311,557,326,231,430370.38,306271.39,736641.77
330320,202311,9278,3093,6185,4087341.95,8170215.75,12257557.70
330330,202311,12401,4198,8203,5543312.71,10843423.5,16386736.21
330340,202311,3375,1838,1537,2426423.97,2031636.58,4458060.55
330350,202311,24910,9082,15828,11998958.3,20916050.17,32915008.47
330360,202311,2073,977,1096,1291176.12,1450880.33,2742056.45
330370,202311,1121,599,522,792093.44,691761.28,1483854.72
330380,202311,1294,536,758,707588.32,1001953.11,1709541.43
330385,202311,802,391,411,516164.56,542559.18,1058723.74
330390,202311,7743,4070,3673,5372982.77,4848779.79,10221762.56
330395,202311,517,334,183,440916.91,241574.78,682491.69
330400,202311,806,416,390,549180.26,514842.85,1064023.11
330410,202311,614,439,175,579550.89,232349.69,811900.58
330411,202311,453,248,205,327375.67,270613.77,597989.44
330412,202311,272,135,137,178214.88,180855.41,359070.29
330414,202311,6793,2598,4195,3429868.95,5544517.86,8974386.81
330415,202311,739,319,420,421133.95,554456.09,975590.04
330420,202311,3324,1519,1805,2005231.77,2384099.36,4389331.13
330430,202311,2077,892,1185,1178922.82,1566973.33,2745896.15
330440,202311,498,248,250,327378.44,330015.46,657393.90
330450,202311,147,71,76,93724.28,101647.64,195371.92
330452,202311,3132,1246,1886,1644871.19,2492327.47,4137198.66
330455,202311,158765,57956,100809,76573597.24,133241034.85,209814632.09
330460,202311,297,141,156,186137.17,205944.46,392081.63
330470,202311,1488,807,681,1065341.94,901631.44,1966973.38
330475,202311,2249,722,1527,955756.95,2015813.13,2971570.08
330480,202311,931,517,414,683824.59,546541.56,1230366.15
330490,202311,20714,6526,14188,8620576.31,18751964.84,27372541.15
330500,202311,1972,868,1104,1145894.68,1457417.39,2603312.07
330510,202311,13478,4905,8573,6480669.71,11330556.92,17811226.63
330513,202311,115,58,57,76562.93,76562.89,153125.82
330515,202311,752,341,411,450176.81,542612.21,992789.02
330520,202311,3052,1055,1997,1392768.21,2637650.93,4030419.14
330530,202311,211,121,90,159737.86,118812.51,278550.37
330540,202311,429,217,212,286472.99,281186.37,567659.36
330550,202311,3328,1125,2203,1486508.16,2910869.89,4397378.05
330555,202311,1451,538,913,710205.63,1206560.2,1916765.83
330560,202311,918,337,581,444892.46,767008.81,1211901.27
330570,202311,408,281,127,370954.1,167648.49,538602.59
330575,202311,1096,415,681,547862.43,899019.32,1446881.75
330580,202311,4149,2201,1948,2906960.3,2578176.55,5485136.85
330590,202311,278,148,130,195382.67,171617.96,367000.63
330600,202311,1796,1058,738,1396693.85,975534.1,2372227.95
330610,202311,1891,968,923,1280542.6,1218454.79,2498997.39
330615,202311,277,217,60,286470.76,79209.02,365679.78
330620,202311,1119,499,620,658764.88,819825.68,1478590.56
330630,202311,5853,3337,2516,4406550.56,3325292.23,7731842.79
350010,202311,648,421,227,555785.66,299664.14,855449.80
350020,202311,63,22,41,29044.15,54123.32,83167.47
350030,202311,656,375,281,497705.3,370951.92,868657.22
350040,202311,122,53,69,69969.42,91087.26,161056.68
350050,202311,429,193,236,254785.96,311538.33,566324.29
350055,202311,157,67,90,88448.35,118802.97,207251.32
350060,202311,90,41,49,54124.43,64683.06,118807.49
350070,202311,907,501,406,662737.16,536001.37,1198738.53
350075,202311,93,54,39,71284.37,51480.9,122765.27
350080,202311,72,35,37,46207.22,48844.79,95052.01
350090,202311,88,46,42,60728.96,55442.25,116171.21
350100,202311,314,203,111,267976.66,146528.87,414505.53
350110,202311,46,32,14,42247.84,18480.71,60728.55
350115,202311,208,107,101,141249.58,133325.27,274574.85
350120,202311,124,80,44,105611.98,58086.96,163698.94
350130,202311,474,210,264,277240.41,349841.01,627081.42
350140,202311,45,28,17,36962.45,22441.83,59404.28
350150,202311,86,59,27,77887.19,35643.43,113530.62
350160,202311,2750,1101,1649,1454792.1,2180754.6,3635546.7
350170,202311,490,284,206,374917.67,271942.52,646860.19
350180,202311,178,95,83,125408.66,109567.11,234975.77
350190,202311,1125,616,509,813226.84,674550.78,1487777.62
350200,202311,63,25,38,33001.48,50161.13,83162.61
350210,202311,1482,779,703,1028412.05,928053.58,1956465.63
350220,202311,686,540,146,714192.46,192733.11,906925.57
350230,202311,78,50,28,66001.58,36960.47,102962.05
350240,202311,61,40,21,52804.82,29043.13,81847.95
350250,202311,1223,524,699,691779.32,922789.09,1614568.41
350260,202311,120,83,37,109570.45,48841.54,158411.99
350270,202311,1089,710,379,938596.29,501641.46,1440237.75
350275,202311,394,152,242,201977.86,319474.67,521452.53
350280,202311,4942,2337,2605,3087827.04,3442753.19,6530580.23
350290,202311,565,240,325,316832.94,429036.35,745869.29
350300,202311,54,32,22,42246.98,29043.41,71290.39
350310,202311,93,54,39,71286.64,51482.12,122768.76
350315,202311,20,15,5,19801.35,6600,26401.35
350320,202311,3829,1808,2021,2388155.83,2669213.26,5057369.09
350330,202311,1848,903,945,1193403.27,1247447.23,2440850.50
350335,202311,28,19,9,25081.35,11880.78,36962.13
350340,202311,137,56,81,73934.27,106933.68,180867.95
350350,202311,98,46,52,60726.42,68643.46,129369.88
350360,202311,121,81,40,106936.16,52805.23,159741.39
350370,202311,93,53,40,69969.67,52804.56,122774.23
350380,202311,1040,470,570,621784.01,752462.66,1374246.67
350390,202311,2101,804,1297,1061391.25,1714845.86,2776237.11
350395,202311,21,15,6,19804.2,7921.2,27725.4
350400,202311,2005,948,1057,1252814,1397918.04,2650732.04
350410,202311,3646,1433,2213,1893093.64,2922679.93,4815773.57
350420,202311,327,188,139,248179.56,183488.74,431668.30
350430,202311,113,58,55,76568.53,72610.3,149178.83
350440,202311,153,107,46,141262.35,60725.9,201988.25
350450,202311,1965,1062,903,1403325.74,1191995.86,2595321.60
350460,202311,493,175,318,231031.99,422456.67,653488.66
350470,202311,21,11,10,14520,13200.6,27720.6
350480,202311,223,115,108,151822.03,142573.41,294395.44
350490,202311,269,126,143,166347.41,188781.91,355129.32
350500,202311,70,22,48,29040.34,63361.4,92401.74
350510,202311,159,89,70,117491.72,92401.31,209893.03
350520,202311,521,285,236,376256.26,311553.75,687810.01
350530,202311,580,282,298,372279.29,393403.79,765683.08
350535,202311,109,71,38,93731.12,51485.98,145217.10
350540,202311,357,188,169,248195.24,224430.87,472626.11
350550,202311,3191,1777,1414,2347234.22,1869203.66,4216437.88
350560,202311,658,443,215,586146.63,283824.62,869971.25
350570,202311,5288,2200,3088,2904333.96,4084409.27,6988743.23
350580,202311,415,202,213,266668.49,281184.89,547853.38
350590,202311,1158,602,556,796021.61,734116.12,1530137.73
350600,202311,7414,3360,4054,4440989.3,5356832.33,9797821.63
350610,202311,1717,911,806,1205271.55,1065296.38,2270567.93
350620,202311,23,14,9,18480.44,11880,30360.44
350630,202311,283,142,141,187455.91,186134.33,373590.24
350635,202311,1628,724,904,955773.93,1194704.98,2150478.91
350640,202311,138,93,45,122769.64,59401.66,182171.30
350650,202311,2194,1432,762,1890442.19,1007209.06,2897651.25
350660,202311,892,350,542,462051.37,715511.49,1177562.86
350670,202311,326,166,160,219130.89,211202.97,430333.86
350680,202311,174,92,82,121458.8,108251.58,229710.38
350690,202311,238,108,130,142572.76,171608,314180.76
350700,202311,1156,572,584,755108.6,772248.66,1527357.26
350710,202311,490,174,316,229704.7,417154.18,646858.88
350715,202311,65,49,16,64684.67,21120,85804.67
350720,202311,18,12,6,15843.39,7922.11,23765.50
350730,202311,56,36,20,47522.75,26400.71,73923.46
350740,202311,278,155,123,204619.72,162369.75,366989.47
350745,202311,40,20,20,26403.01,26402.39,52805.40
350750,202311,3031,1778,1253,2347197.89,1655376.07,4002573.96
350760,202311,4584,1911,2673,2525494.69,3531239.34,6056734.03
350770,202311,67,41,26,54121.61,34320.62,88442.23
350775,202311,84,60,24,79211.04,31682.63,110893.67
350780,202311,535,263,272,347194.93,359076.1,706271.03
350790,202311,403,168,235,223102.01,310229.93,533331.94
350800,202311,608,358,250,472601.84,331336.59,803938.43
350810,202311,567,421,146,555793.21,192733.2,748526.41
350820,202311,101,56,45,73921.78,59402.25,133324.03
350830,202311,90,46,44,60725.18,58083.52,118808.70
350840,202311,946,376,570,497699.95,753907.51,1251607.46
350850,202311,2160,1107,1053,1465366.88,1390050.8,2855417.68
350860,202311,812,416,396,549187.5,525421.54,1074609.04
350870,202311,515,354,161,467315.26,212535.23,679850.49
350880,202311,320,167,153,220472.41,201987.69,422460.10
350890,202311,44,25,19,33002.74,25083.68,58086.42
350900,202311,1878,643,1235,848842.47,1630367.25,2479209.72
350910,202311,28,15,13,19802.04,17161.06,36963.10
350920,202311,956,478,478,631008.58,630997.64,1262006.22
350925,202311,1328,653,675,862066.86,891098.96,1753165.82
350930,202311,148,80,68,105613.11,89764.03,195377.14
350940,202311,842,431,411,568993.75,542578.16,1111571.91
350945,202311,137,94,43,124091.38,56765.8,180857.18
350950,202311,21478,10143,11335,13400542.81,14977586.87,28378129.68
350960,202311,2092,847,1245,1118136.45,1644841.26,2762977.71
350970,202311,1238,587,651,776120.15,859426.83,1635546.98
350980,202311,114,74,40,97688.36,52802.1,150490.46
350990,202311,457,170,287,224415.54,378860.69,603276.23
350995,202311,48,21,27,27720.81,35642.97,63363.78
351000,202311,667,414,253,546548.44,335315.85,881864.29
351010,202311,53,33,20,43563.97,26401.78,69965.75
351015,202311,59,33,26,43561.75,35640,79201.75
351020,202311,1645,990,655,1306922.1,864673.36,2171595.46
351030,202311,377,207,170,273259.46,224405.11,497664.57
351040,202311,1277,720,557,951796.76,735290.16,1687086.92
351050,202311,4388,1970,2418,2602072.97,3194622.71,5796695.68
351060,202311,7331,2692,4639,3553899.03,6125089.38,9678988.41
351070,202311,455,285,170,376251.9,224427.47,600679.37
351080,202311,941,709,232,935960.76,306262.12,1242222.88
351090,202311,53,26,27,34324.27,35643.63,69967.90
351100,202311,463,242,221,320809.37,291758.41,612567.78
351110,202311,2396,1107,1289,1462704.92,1706831.24,3169536.16
351120,202311,67,32,35,42244.31,46201.26,88445.57
351130,202311,203,65,138,85809.93,182179.41,267989.34
351140,202311,354,211,143,278554.57,188771.1,467325.67
351150,202311,577,289,288,381516.83,381495.98,763012.81
351160,202311,393,209,184,275903.98,242885.29,518789.27
351170,202311,279,164,115,216486.56,151806.2,368292.76
351190,202311,113,72,41,95043.45,54121.14,149164.59
351200,202311,374,241,133,318148.79,175579.23,493728.02
351210,202311,149,74,75,99010.18,99007.13,198017.31
351220,202311,671,375,296,495047.61,390739.72,885787.33
351230,202311,371,225,146,297023.75,192726.1,489749.85
351240,202311,274,143,131,188771.04,172935.75,361706.79
351250,202311,100,71,29,93737.88,38284.94,132022.82
351260,202311,165,113,52,149164.24,68641.51,217805.75
351270,202311,56,25,31,33001.99,42241.65,75243.64
351280,202311,1190,592,598,781507.64,792068.37,1573576.01
351290,202311,282,138,144,182167.39,190089.09,372256.48
351300,202311,4899,2030,2869,2679946.8,3791428.73,6471375.53
351310,202311,804,395,409,522791.38,539962.02,1062753.40
351320,202311,134,77,57,101651.34,75245.99,176897.33
351330,202311,43,27,16,36961.46,21121.24,58082.70
351340,202311,1750,938,812,1238280.13,1074521.86,2312801.99
351350,202311,2845,1695,1150,2237719.2,1518085.14,3755804.34
351360,202311,899,414,485,546554.75,640274.64,1186829.39
351370,202311,508,255,253,336631.44,333977.06,670608.50
351380,202311,9856,4355,5501,5750642.28,7268421.32,13019063.60
351385,202311,26,20,6,26405.41,7921.5,34326.91
351390,202311,311,227,84,299670.53,110885.15,410555.68
351400,202311,63,41,22,54121,29041.83,83162.83
351410,202311,538,310,228,409246.64,300981.51,710228.15
351420,202311,87,61,26,80523.48,34320,114843.48
351430,202311,79,43,36,56767.01,48843.75,105610.76
351440,202311,953,618,335,817165.71,443548.06,1260713.77
351450,202311,326,163,163,215182.45,215180.99,430363.44
351460,202311,148,62,86,81850.88,113529.18,195380.06
351470,202311,148,76,72,101651.67,95046.85,196698.52
351480,202311,505,290,215,382822.94,283812.26,666635.20
351490,202311,350,136,214,179525.14,283815.45,463340.59
351492,202311,30,19,11,25085.35,14520,39605.35
351495,202311,28,20,8,26401.78,10560.32,36962.10
351500,202311,3834,1514,2320,2003988.79,3063981.76,5067970.55
351510,202311,2516,908,1608,1198671.06,2124034.66,3322705.72
351512,202311,17,10,7,13200.44,9240,22440.44
351515,202311,231,132,99,174260.14,130689.34,304949.48
351518,202311,742,429,313,566391.28,413221.69,979612.97
351519,202311,85,50,35,66004.1,46201.32,112205.42
351520,202311,189,119,70,157092.48,92402.51,249494.99
351530,202311,29,15,14,19800.4,18480.8,38281.2
351535,202311,150,91,59,120136.48,77890.23,198026.71
351540,202311,539,333,206,440933.08,273260.2,714193.28
351550,202311,1881,1091,790,1440244.32,1044166.43,2484410.75
351560,202311,92,49,43,64683.9,56761.97,121445.87
351565,202311,15,8,7,10561.04,9241.24,19802.28
351570,202311,3354,1492,1862,1969728.52,2462078.57,4431807.09
351580,202311,37,34,3,44883.41,3960,48843.41
351590,202311,70,40,30,52806.09,39602.13,92408.22
351600,202311,185,132,53,174258.97,69967.45,244226.42
351610,202311,64,26,38,34323.14,50164.2,84487.34
351620,202311,7036,3734,3302,4932085.22,4366809.28,9298894.50
351630,202311,3937,1849,2088,2442282.44,2760373.59,5202656.03
351640,202311,3134,1376,1758,1819125.4,2322030.39,4141155.79
351650,202311,41,30,11,39604.07,14520.74,54124.81
351660,202311,147,89,58,117489.48,76562.54,194052.02
351670,202311,848,473,375,624425.11,495040.47,1119465.58
351680,202311,103,71,32,93722.96,42240,135962.96
351685,202311,21,14,7,18480.77,9240,27720.77
351690,202311,333,209,124,275920.86,163694.03,439614.89
351700,202311,191,132,59,174548.51,77883.36,252431.87
351710,202311,61,40,21,52805.99,27722.37,80528.36
351720,202311,132,73,59,96363.13,79202.13,175565.26
351730,202311,136,93,43,122762.36,56760,179522.36
351740,202311,885,548,337,723436.75,446202.63,1169639.38
351750,202311,426,179,247,236307.63,326079.38,562387.01
351760,202311,760,589,171,777463.37,225734.09,1003197.46
351770,202311,354,277,77,365675.23,101649.98,467325.21
351780,202311,162,95,67,125408.63,88442.71,213851.34
351790,202311,298,143,155,188780.7,204617.29,393397.99
351800,202311,51,32,19,42241.6,25080.44,67322.04
351810,202311,128,81,47,106933.55,62047.24,168980.79
351820,202311,816,580,236,765702.45,311551.59,1077254.04
351830,202311,787,246,541,324756.56,714186.92,1038943.48
351840,202311,2671,1178,1493,1556445.93,1970822.8,3527268.73
351850,202311,292,197,95,260074.47,126724.64,386799.11
351860,202311,654,437,217,576922.85,287788.91,864711.76
351870,202311,6884,3050,3834,4029186.46,5065347.73,9094534.19
351880,202311,27103,10464,16639,13823014.03,21977957.73,35800971.76
351885,202311,118,63,55,83167.89,72603.58,155771.47
351890,202311,83,54,29,71283.8,38280,109563.8
351900,202311,269,138,131,182178.25,172930.45,355108.70
351905,202311,120,58,62,76562.58,81844.41,158406.99
351907,202311,4375,1790,2585,2364369.24,3416364.89,5780734.13
351910,202311,175,77,98,101655.1,129378.75,231033.85
351920,202311,131,69,62,91083.94,81843.06,172927.00
351925,202311,102,59,43,77890.4,56765.12,134655.52
351930,202311,556,336,220,443582.34,290426.32,734008.66
351940,202311,266,109,157,143892.43,207254.61,351147.04
351950,202311,155,81,74,106931.2,97688.31,204619.51
351960,202311,1132,563,569,743245.28,751160.48,1494405.76
351970,202311,2486,1155,1331,1527379.68,1758387.39,3285767.07
351980,202311,168,75,93,99009.65,122775.66,221785.31
351990,202311,264,163,101,215176,133333.27,348509.27
352000,202311,297,203,94,267998,124100.33,392098.33
352010,202311,507,329,178,434415.34,234996.25,669411.59
352020,202311,234,76,158,100323.55,208564.61,308888.16
352030,202311,1360,618,742,815848.28,980824.39,1796672.67
352040,202311,815,321,494,423757.51,653462.1,1077219.61
352042,202311,405,102,303,134650.89,399986.17,534637.06
352044,202311,405,213,192,281211.04,253470.58,534681.62
352050,202311,3773,1383,2390,1828402.6,3158951.12,4987353.72
352060,202311,115,63,52,83163.16,68642.73,151805.89
352070,202311,116,73,43,96374.11,58081.82,154455.93
352080,202311,74,46,28,60728.21,36965.57,97693.78
352090,202311,215,130,85,171617.54,112206.3,283823.84
352100,202311,371,184,187,242902.85,246852.39,489755.24
352110,202311,120,35,85,46202.41,112205.67,158408.08
352115,202311,76,31,45,40921.68,59404.32,100326.00
352120,202311,79,51,28,67322.11,36963.05,104285.16
352130,202311,258,190,68,252147.68,89762.38,341910.06
352140,202311,227,121,106,159726.63,139933.3,299659.93
352150,202311,142,78,64,102973.49,84492.17,187465.66
352160,202311,151,102,49,134653.18,64684.29,199337.47
352170,202311,495,329,166,435630.01,219128.43,654758.44
352180,202311,793,467,326,616515.64,431687.44,1048203.08
352190,202311,265,110,155,145219.91,204614.92,349834.83
352200,202311,32,15,17,19802.6,22442.83,42245.43
352210,202311,5279,2053,3226,2712918.04,4266480.37,6979398.41
352215,202311,83,42,41,55441.81,54120.2,109562.01
352220,202311,6765,2520,4245,3326904.16,5606819.86,8933724.02
352230,202311,4167,2577,1590,3403366.58,2102843.65,5506210.23
352240,202311,3201,1783,1418,2353801.18,1871913.68,4225714.86
352250,202311,4528,2024,2504,2673281.49,3313320.75,5986602.24
352260,202311,1176,614,562,811899.38,743250.93,1555150.31
352265,202311,81,49,32,64681.75,42241.01,106922.76
352270,202311,451,241,210,318168.77,278549.37,596718.14
352280,202311,569,337,232,444876.88,306249.55,751126.43
352290,202311,199,110,89,145220.29,117490.97,262711.26
352300,202311,107,60,47,79208.91,62048.8,141257.71
352310,202311,9418,4153,5265,5485254.38,6955340.34,12440594.72
352320,202311,1317,685,632,904282.76,834292.51,1738575.27
352330,202311,581,299,282,394693.6,372246.72,766940.32
352340,202311,1574,712,862,941278.65,1137939.14,2079217.79
352350,202311,421,233,188,308914.93,248185.71,557100.64
352360,202311,242,106,136,139931.32,179528.87,319460.19
352370,202311,143,90,53,118812.48,69965.97,188778.45
352380,202311,131,97,34,128055.42,44886.87,172942.29
352390,202311,2941,1226,1715,1618520.76,2269199.37,3887720.13
352400,202311,638,273,365,360384.05,483154.36,843538.41
352410,202311,1059,700,359,924093.22,473932.69,1398025.91
352420,202311,111,85,26,112205.81,34323.02,146528.83
352430,202311,1904,829,1075,1095717.15,1421759.43,2517476.58
352440,202311,4118,1779,2339,2352487.63,3087623.77,5440111.40
352450,202311,202,155,47,204614.9,62048.49,266663.39
352460,202311,716,360,356,475246.58,469963.85,945210.43
352470,202311,771,307,464,406599.54,612527.58,1019127.12
352480,202311,1859,1056,803,1396682.29,1060062.73,2456745.02
352490,202311,75,32,43,42244.68,56764.2,99008.88
352500,202311,1794,707,1087,934645.41,1434930.5,2369575.91
352510,202311,820,425,395,562391.85,521453.97,1083845.82
352520,202311,1020,453,567,598024.54,748517.23,1346541.77
352530,202311,2231,1118,1113,1477260.89,1470554.74,2947815.63
352540,202311,75,52,23,68649.59,30364.5,99014.09
352550,202311,244,135,109,178213.86,143886.6,322100.46
352560,202311,63,45,18,59405.16,23760.34,83165.50
352570,202311,895,433,462,571620.69,609887.28,1181507.97
352580,202311,57,43,14,56767.01,18481.77,75248.78
352585,202311,18,7,11,9241.19,14522.13,23763.32
352590,202311,5177,2512,2665,3317576,3520704.74,6838280.74
352600,202311,416,279,137,368326.47,182179.16,550505.63
352610,202311,998,426,572,562380.93,755109.58,1317490.51
352620,202311,1301,492,809,650834.3,1070618.01,1721452.31
352630,202311,197,74,123,97687.37,162372.28,260059.65
352640,202311,579,369,210,487138.68,277229.51,764368.19
352650,202311,96,64,32,84487.39,42241.13,126728.52
352660,202311,79,41,38,54125.97,50160.27,104286.24
352670,202311,1985,1062,923,1402001.7,1219716.62,2621718.32
352680,202311,1099,638,461,842260.87,608601.73,1450862.60
352690,202311,5380,2378,3002,3139320.91,3964217.72,7103538.63
352700,202311,101,55,46,72612.39,60725.16,133337.55
352710,202311,1710,886,824,1170950.63,1089026.82,2259977.45
352720,202311,1888,791,1097,1045564.69,1450821.84,2496386.53
352725,202311,31,24,7,31683.78,9240.5,40924.28
352730,202311,473,228,245,300992.35,323427.33,624419.68
352740,202311,410,264,146,348527.85,192742.75,541270.60
352750,202311,25,16,9,21123.86,11880.8,33004.66
352760,202311,267,169,98,223093.4,129366.12,352459.52
352770,202311,81,60,21,80527.08,27721.08,108248.16
352780,202311,84,47,37,62042.06,48841.94,110884.00
352790,202311,28,18,10,23762.42,13200.9,36963.32
352800,202311,265,200,65,265342.32,87127.6,352469.92
352810,202311,169,110,59,145223.65,77888.24,223111.89
352820,202311,48,38,10,50161.73,13201.29,63363.02
352830,202311,77,49,28,64692.13,36963.06,101655.19
352840,202311,829,361,468,476593.03,617827.45,1094420.48
352850,202311,2179,657,1522,868619.24,2013123.23,2881742.47
352860,202311,137,85,52,112217.91,68648.2,180866.11
352870,202311,60,37,23,48847.31,30365.29,79212.60
352880,202311,206,111,95,147857.29,125413.19,273270.48
352885,202311,39,26,13,34323.61,17160.75,51484.36
352890,202311,62,39,23,51487.03,30362.52,81849.55
352900,202311,5174,2427,2747,3207941.09,3628871.48,6836812.57
352910,202311,41,32,9,42241.4,11880.44,54121.84
352920,202311,703,396,307,522784.46,405279.91,928064.37
352930,202311,1321,609,712,805285.01,941217.97,1746502.98
352940,202311,7347,2802,4545,3702970.98,6005148.79,9708119.77
352950,202311,146,73,73,96363.52,96367.45,192730.97
352960,202311,79,54,25,71283.56,33000.67,104284.23
352965,202311,19,12,7,15842.01,9240.5,25082.51
352970,202311,608,434,174,572947.17,229709.48,802656.65
352980,202311,173,101,72,133341.63,95048.63,228390.26
352990,202311,1055,489,566,645561.1,747217.08,1392778.18
353000,202311,66,34,32,44882.19,42244.75,87126.94
353010,202311,562,335,227,442269.97,302314.3,744584.27
353020,202311,381,250,131,330028.58,172932.1,502960.68
353030,202311,1528,685,843,904299.96,1115501.29,2019801.25
353040,202311,107,54,53,71288.39,71286.06,142574.45
353050,202311,1518,1000,518,1321472.62,685119.56,2006592.18
353060,202311,10590,4637,5953,6121628.76,7868961.06,13990589.82
353070,202311,2320,1346,974,1778217.91,1288121.85,3066339.76
353080,202311,1468,776,692,1025744.22,914801.04,1940545.26
353090,202311,28,25,3,33003.24,3960.71,36963.95
353100,202311,48,37,11,48844.34,14522.26,63366.60
353110,202311,2651,903,1748,1193414.26,2307682.18,3501096.44
353120,202311,162,94,68,124085.08,89762.64,213847.72
353130,202311,946,452,494,596701.33,652133.11,1248834.44
353140,202311,645,298,347,393399.58,458087.18,851486.76
353150,202311,354,180,174,237624.35,229700.5,467324.85
353160,202311,116,86,30,113536.13,39604.41,153140.54
353170,202311,219,78,141,102970.04,186139.97,289110.01
353180,202311,1526,705,821,930674.74,1083808.74,2014483.48
353190,202311,565,402,163,530701.45,215181.22,745882.67
353200,202311,331,163,168,215173.61,221772.52,436946.13
353205,202311,25,17,8,22440.76,10560,33000.76
353210,202311,81,48,33,63365.71,43562.74,106928.45
353215,202311,49,29,20,38282.73,26400.44,64683.17
353220,202311,89,48,41,63365.57,54123.33,117488.90
353230,202311,173,78,95,102966.75,125409.8,228376.55
353240,202311,463,194,269,256093.12,357730.74,613823.86
353250,202311,200,103,97,135973.73,128059.17,264032.90
353260,202311,513,321,192,423801.36,253466.15,677267.51
353270,202311,76,58,18,76569.84,23760.78,100330.62
353280,202311,131,56,75,73929.8,99014.41,172944.21
353282,202311,142,99,43,130687.52,58081.67,188769.19
353284,202311,32,26,6,34322.83,7920.45,42243.28
353286,202311,11,4,7,5280.8,9240,14520.8
353290,202311,89,50,39,66005.59,51482.16,117487.75
353300,202311,478,234,244,308922.56,323441.66,632364.22
353310,202311,44,34,10,44883.63,13201.6,58085.23
353320,202311,49,25,24,33003.44,31681.59,64685.03
353325,202311,50,25,25,33003,33003.36,66006.36
353330,202311,62,41,21,54124.58,27720.74,81845.32
353340,202311,821,323,498,426393.76,658732.28,1085126.04
353350,202311,1062,541,521,715517.21,687799.42,1403316.63
353360,202311,110,88,22,116167.25,29043.72,145210.97
353370,202311,118,67,51,88449.7,67329.47,155779.17
353380,202311,30,15,15,19801.38,19800,39601.38
353390,202311,1273,609,664,803965.48,877879.4,1681844.88
353400,202311,66,39,27,51485.63,35644.47,87130.10
353410,202311,136,70,66,92409.13,87123.69,179532.82
353420,202311,70,34,36,44880.44,47520.11,92400.55
353430,202311,627,410,217,541251.95,286472.19,827724.14
353440,202311,15483,6855,8628,9053375.27,11400120.81,20453496.08
353450,202311,49,23,26,30365.02,34325.51,64690.53
353460,202311,751,390,361,514850.54,476553.49,991404.03
353470,202311,2579,1222,1357,1614547.27,1792624.27,3407171.54
353475,202311,315,196,119,258738.25,157091.53,415829.78
353480,202311,257,188,69,248174.75,92402.25,340577.00
353490,202311,238,137,101,180856.54,133331.83,314188.37
353500,202311,238,130,108,171617.74,142570.85,314188.59
353510,202311,87,56,31,73926.08,40921.4,114847.48
353520,202311,280,200,80,264016.28,105605.2,369621.48
353530,202311,547,268,279,355132.65,368324.41,723457.06
353540,202311,427,267,160,352481.91,211228.03,563709.94
353550,202311,842,513,329,678569.46,434320.91,1112890.37
353560,202311,598,244,354,322118.52,467326.46,789444.98
353570,202311,67,46,21,60724.47,27724.96,88449.43
353580,202311,418,250,168,330030.22,221766.5,551796.72
353590,202311,103,76,27,100326.21,35640.99,135967.20
353600,202311,312,180,132,237621.19,174248.13,411869.32
353610,202311,158,92,66,121446.75,87126.88,208573.63
353620,202311,729,361,368,477887.37,487123.53,965010.90
353625,202311,70,36,34,47525.03,44882.92,92407.95
353630,202311,253,175,78,231021.19,102963.7,333984.89
353640,202311,158,95,63,126731.4,83163.77,209895.17
353650,202311,1245,497,748,656085.79,987416.45,1643502.24
353657,202311,30,24,6,31681.31,7922.18,39603.49
353660,202311,328,168,160,221777.55,211216.34,432993.89
353670,202311,822,456,366,601990.11,487135.32,1089125.43
353680,202311,156,97,59,128046.68,77881.58,205928.26
353690,202311,52,34,18,44884.62,23762.87,68647.49
353700,202311,331,227,104,299671.77,137289.93,436961.70
353710,202311,669,331,338,436965.12,447513.52,884478.64
353715,202311,48,25,23,33005.1,30363.31,63368.41
353720,202311,338,157,181,207274.45,238953.31,446227.76
353730,202311,1308,750,558,992747.2,740553.65,1733300.85
353740,202311,655,353,302,467331.89,398673.23,866005.12
353750,202311,114,63,51,83166.69,67323.99,150490.68
353760,202311,3824,1506,2318,1989472.71,3061357.88,5050830.59
353770,202311,85,67,18,88446.19,23761.22,112207.41
353780,202311,1593,723,870,954445.03,1148475.07,2102920.10
353790,202311,587,332,255,438305.04,336639.97,774945.01
353800,202311,4507,2046,2461,2702325.55,3253904.97,5956230.52
353810,202311,253,124,129,163705.96,170291.46,333997.42
353820,202311,327,137,190,180847.67,250806.29,431653.96
353830,202311,84,68,16,89767.17,21120.59,110887.76
353850,202311,237,104,133,137293.6,175576.31,312869.91
353860,202311,615,283,332,374918.32,438267.42,813185.74
353870,202311,6806,3493,3313,4613817.7,4378666.43,8992484.13
353880,202311,813,522,291,689116.31,385458.19,1074574.50
353890,202311,670,381,289,502999.68,384159.43,887159.11
353900,202311,149,76,73,100331.25,96367.17,196698.42
353910,202311,229,99,130,130693.94,171612.13,302306.07
353920,202311,540,270,270,356428.13,356420.23,712848.36
353930,202311,1221,708,513,935979.24,678512.61,1614491.85
353940,202311,227,110,117,145211.59,154451.45,299663.04
353950,202311,573,376,197,497686.76,260063.34,757750.10
353960,202311,85,68,17,89766.16,22442.3,112208.46
353970,202311,40,23,17,30366.44,22445.76,52812.20
353980,202311,2433,1058,1375,1398033.72,1819141.32,3217175.04
353990,202311,93,59,34,77886.87,44884.14,122771.01
354000,202311,428,184,244,242899.3,322102.85,565002.15
354010,202311,91,53,38,69975.95,50166.24,120142.19
354020,202311,586,358,228,472614.81,300990.51,773605.32
354025,202311,48,40,8,52807.97,10560.84,63368.81
354030,202311,50,25,25,33006.07,33001.92,66007.99
354040,202311,102,77,25,101649.41,33001.72,134651.13
354050,202311,172,89,83,117492.09,109568.48,227060.57
354060,202311,959,453,506,598010.65,667973.45,1265984.10
354070,202311,1023,577,446,761709.16,590083.35,1351792.51
354075,202311,244,111,133,146529.37,175572.46,322101.83
354080,202311,334,152,182,200664.14,240267.44,440931.58
354085,202311,30,17,13,22442.54,17161.24,39603.78
354090,202311,306,176,130,232236.44,171613.88,403850.32
354100,202311,7350,2988,4362,3947232.95,5763597.24,9710830.19
354105,202311,112,62,50,81844.03,66002.07,147846.10
354110,202311,50,25,25,33002.81,33005.04,66007.85
354120,202311,176,104,72,137293.66,96363.65,233657.31
354130,202311,920,579,341,764364.9,450157.93,1214522.83
354140,202311,3920,1799,2121,2376252.5,2803822.15,5180074.65
354150,202311,758,444,314,586156.29,414511.36,1000667.65
354160,202311,745,446,299,588787.81,394712.27,983500.08
354165,202311,13,8,5,10560.44,6600,17160.44
354170,202311,208,137,71,180855.78,93726.52,274582.30
354180,202311,55,33,22,43563.38,29043.51,72606.89
354190,202311,316,113,203,149168.69,267971.37,417140.06
354200,202311,128,64,64,84488.58,84497.08,168985.66
354210,202311,83,40,43,52803.87,56760.61,109564.48
354220,202311,672,405,267,534672.35,352473.65,887146.00
354230,202311,193,89,104,117495.09,138617.35,256112.44
354240,202311,374,224,150,295706.74,199332.29,495039.03
354250,202311,81,46,35,60729.3,46201.89,106931.19
354260,202311,2396,1096,1300,1446886.79,1720112.6,3166999.39
354270,202311,108,79,29,104284.22,38280,142564.22
354280,202311,68,40,28,52802.3,36963.23,89765.53
354290,202311,171,114,57,150501.36,75245.99,225747.35
354300,202311,348,249,99,328735.29,130697.87,459433.16
354310,202311,108,75,33,99010.39,43564.33,142574.72
354320,202311,244,116,128,153133.83,168967.45,322101.28
354323,202311,12,9,3,11881.35,3960,15841.35
354325,202311,137,78,59,102963.15,77880.68,180843.83
354330,202311,2733,932,1801,1231747.19,2380104.09,3611851.28
354340,202311,12309,5525,6784,7296224.47,8956760.27,16252984.74
354350,202311,176,115,61,153123.36,80520.85,233644.21
354360,202311,77,47,30,62046.21,39604.66,101650.87
354370,202311,265,128,137,168974.43,180854.13,349828.56
354380,202311,200,113,87,149178.25,114850.23,264028.48
354390,202311,3231,1186,2045,1568306.82,2702225.18,4270532.00
354400,202311,429,239,190,315497.33,250814.03,566311.36
354410,202311,815,356,459,469979.46,605940.36,1075919.82
354420,202311,317,211,106,278552.32,139935.27,418487.59
354425,202311,382,211,171,279932.4,225737.15,505669.55
354430,202311,147,89,58,117495.76,76568.26,194064.02
354440,202311,31,23,8,30362.49,10560,40922.49
354450,202311,59,41,18,54123.36,23760.92,77884.28
354460,202311,102,57,45,75251.63,59405.63,134657.26
354470,202311,15,9,6,11880.38,7921.37,19801.75
354480,202311,130,69,61,91085.56,80522.01,171607.57
354490,202311,132,78,54,102973.43,71285.03,174258.46
354500,202311,451,193,258,254775.91,341894.77,596670.68
354510,202311,87,60,27,79207.26,35643.7,114850.96
354515,202311,55,19,36,25083.45,47524.66,72608.11
354520,202311,1900,785,1115,1036136.91,1474517.23,2510654.14
354530,202311,982,474,508,625723,670584.93,1296307.93
354540,202311,262,127,135,167663.21,179537.48,347200.69
354550,202311,44,26,18,34321.12,23760.52,58081.64
354560,202311,181,99,82,130687.81,108241.99,238929.80
354570,202311,157,103,54,135969.66,71282.48,207252.14
354580,202311,2159,1026,1133,1354475.36,1499618.84,2854094.20
354600,202311,327,146,181,192749.33,238935.44,431684.77
354610,202311,69,55,14,72610.74,18483.57,91094.31
354620,202311,90,29,61,39602.7,80522.88,120125.58
354625,202311,21,14,7,18482.57,9241.22,27723.79
354630,202311,412,280,132,369643.06,174258.34,543901.40
354640,202311,946,549,397,726306.57,524080.81,1250387.38
354650,202311,73,46,27,60724.23,35641.72,96365.95
354660,202311,946,683,263,901682.43,347200.89,1248883.32
354670,202311,256,98,158,129372.95,208573.97,337946.92
354680,202311,1574,566,1008,747192.97,1333294.67,2080487.64
354690,202311,82,51,31,67328.32,40921.56,108249.88
354700,202311,85,60,25,79203.06,33001.22,112204.28
354710,202311,51,35,16,46202.26,21121.58,67323.84
354720,202311,23,20,3,26400.68,3960,30360.68
354730,202311,2180,881,1299,1164385.75,1714884.94,2879270.69
354740,202311,78,56,22,73922.84,29040,102962.84
354750,202311,451,247,204,327384.57,269295.5,596680.07
354760,202311,600,382,218,504312.28,289111.76,793424.04
354765,202311,7,3,4,3960.78,5281.82,9242.60
354770,202311,403,252,151,332675.25,200653.35,533328.60
354780,202311,10059,3684,6375,4864704.81,8422069.2,13286774.01
354790,202311,98,54,44,71284.19,58082.18,129366.37
354800,202311,495,262,233,345937.84,307600.36,653538.20
354805,202311,83,43,40,56764.89,52809.37,109574.26
354810,202311,106,55,51,72605.74,67322.5,139928.24
354820,202311,239,100,139,132021.97,183510.76,315532.73
354830,202311,57,35,22,46200.4,29042.16,75242.56
354840,202311,59,37,22,48842.27,29040.44,77882.71
354850,202311,6313,2574,3739,3399367.88,4942495.8,8341863.68
354860,202311,393,171,222,225735.99,293066.07,518802.06
354870,202311,14807,6468,8339,8542625.22,11012062.17,19554687.39
354880,202311,3112,1165,1947,1539303.37,2570329.17,4109632.54
354890,202311,3673,1969,1704,2599371.47,2249406.03,4848777.50
354900,202311,66,47,19,62043.76,25082.04,87125.80
354910,202311,1503,761,742,1004627.48,979461.68,1984089.16
354920,202311,39,34,5,44882.19,6600,51482.19
354925,202311,27,19,8,25080.31,10560,35640.31
354930,202311,42,33,9,43566,11881.24,55447.24
354940,202311,866,607,259,801323.23,341921.67,1143244.90
354950,202311,216,132,84,174256.7,110889.37,285146.07
354960,202311,134,47,87,62051.25,114855.91,176907.16
354970,202311,1431,1025,406,1354436.33,537255.46,1891691.79
354980,202311,11160,4139,7021,5470583.08,9281475.69,14752058.77
354990,202311,12635,5642,6993,7449479.59,9244467.38,16693946.97
354995,202311,694,240,454,316835.79,599352.62,916188.41
355000,202311,468,162,306,213861.75,405293.21,619154.96
355010,202311,800,504,296,666691.08,390765.23,1057456.31
355020,202311,916,555,361,734004.66,476563.02,1210567.68
355030,202311,255933,95370,160563,125964261.04,212163327.49,338127588.53
355040,202311,1243,623,620,822424.92,819767.96,1642192.88
355050,202311,183,101,82,133326.45,109565.9,242892.35
355060,202311,2171,1010,1161,1333364.87,1532575.2,2865940.07
355070,202311,1958,838,1120,1106272.36,1479846.85,2586119.21
355080,202311,225,131,94,172939.03,124089.26,297028.29
355090,202311,350,215,135,283827.94,179535.45,463363.39
355100,202311,6698,3092,3606,4081797.65,4764132.11,8845929.76
355110,202311,235,152,83,201981.92,109566.78,311548.70
355120,202311,48,30,18,39604.82,23761.37,63366.19
355130,202311,63,37,26,48848.05,34324.14,83172.19
355140,202311,228,130,98,171609.61,129363.79,300973.40
355150,202311,846,502,344,662718.23,455444.8,1118163.03
355160,202311,614,290,324,382841.64,427715.1,810556.74
355170,202311,2364,1222,1142,1613226.76,1510178.79,3123405.55
355180,202311,757,296,461,390766.34,608585.77,999352.11
355190,202311,238,156,82,205939.81,108249.51,314189.32
355200,202311,135,59,76,77882.16,100322.21,178204.37
355210,202311,820,417,403,550502.68,532003.45,1082506.13
355220,202311,9488,4378,5110,5786243.84,6756133.92,12542377.76
355230,202311,105,54,51,71285.81,67324.5,138610.31
355240,202311,5411,2151,3260,2840909.84,4308708.44,7149618.28
355250,202311,8436,3732,4704,4933408.64,6216155.29,11149563.93
355255,202311,50,30,20,39603.06,26400.8,66003.86
355260,202311,219,121,98,161057.65,129370.32,290427.97
355270,202311,177,122,55,161056.39,72607.61,233664.00
355280,202311,8733,3276,5457,4327508.56,7205392.76,11532901.32
355290,202311,73,56,17,73922.99,22442.86,96365.85
355300,202311,266,149,117,196697.9,154445.92,351143.82
355310,202311,117,66,51,88446.88,67324.62,155771.50
355320,202311,123,62,61,81844.45,80523.11,162367.56
355330,202311,389,232,157,306267.42,207258.37,513525.79
355340,202311,1429,548,881,723517.17,1164497.03,1888014.20
355350,202311,195,93,102,122763.28,134641.58,257404.86
355360,202311,232,152,80,200662.97,105613.01,306275.98
355365,202311,24,18,6,23762.48,7920.88,31683.36
355370,202311,1126,655,471,864698.89,623066.1,1487764.99
355380,202311,955,561,394,740620.58,521461.42,1262082.00
355385,202311,114,71,43,93723.98,56760.68,150484.66
355390,202311,125,68,57,89768.06,75245.57,165013.63
355395,202311,224,108,116,142576.31,154455.61,297031.92
355400,202311,2076,1135,941,1498270.14,1243472.04,2741742.18
355410,202311,6193,2791,3402,3684499.56,4494781.37,8179280.93
355420,202311,48,33,15,43563.06,19802.81,63365.87
355430,202311,541,310,231,409246.16,304947.86,714194.02
355440,202311,102,56,46,73923.7,60722.55,134646.25
355450,202311,522,275,247,363035.73,327384.6,690420.33
355460,202311,66,44,22,58085.94,29041.61,87127.55
355465,202311,58,31,27,40921.91,35640,76561.91
355470,202311,209,91,118,120130.74,157091.57,277222.31
355475,202311,10,6,4,7920.34,5280,13200.34
355480,202311,735,301,434,397358.05,572924.08,970282.13
355490,202311,124,90,34,118817.54,44888.86,163706.40
355495,202311,136,62,74,81840.85,97683.03,179523.88
355500,202311,1788,969,819,1279179.74,1082456.06,2361635.80
355510,202311,305,207,98,273276.44,130689.42,403965.86
355520,202311,30,20,10,26402.1,13200,39602.1
355530,202311,25,13,12,17160,15840,33000
355535,202311,102,47,55,62046.2,72604.76,134650.96
355540,202311,3331,1309,2022,1729422.54,2673332.55,4402755.09
355550,202311,74,39,35,51482.09,46203.88,97685.97
355560,202311,302,131,171,172939.55,225740.68,398680.23
355570,202311,17,13,4,17163.07,5280,22443.07
355580,202311,241,163,78,215193.11,102971.38,318164.49
355590,202311,15,11,4,14522.43,5280.44,19802.87
355600,202311,299,145,154,191427.1,203294.12,394721.22
355610,202311,274,163,111,215190.5,146532.1,361722.6
355620,202311,1522,634,888,838288.94,1172215.7,2010504.64
355630,202311,454,316,138,417165.56,182172.29,599337.85
355635,202311,141,54,87,71285.39,114845.65,186131.04
355640,202311,684,351,333,463361.68,442229.74,905591.42
355645,202311,1001,349,652,460735.66,862034.02,1322769.68
355650,202311,2050,888,1162,1173643.46,1533900.78,2707544.24
355660,202311,246,126,120,166332.23,158416.93,324749.16
355670,202311,771,321,450,423743.93,594030.84,1017774.77
355680,202311,241,128,113,168980.92,149175.03,318155.95
355690,202311,105,47,58,62050.85,76572.32,138623.17
355695,202311,24,14,10,18480.34,13200,31680.34
355700,202311,1492,676,816,892421.54,1078492.19,1970913.73
355710,202311,2563,1424,1139,1881196.18,1503549.37,3384745.55
355715,202311,17,14,3,18483.69,3960.2,22443.89
355720,202311,286,176,110,232344.06,145209.79,377553.85
355730,202311,117,68,49,89768.48,64686.17,154454.65
410010,202311,111,90,21,118815.5,27722.4,146537.9
410020,202311,134,92,42,121468.2,55442.98,176911.18
410030,202311,225,119,106,157097.52,139935.94,297033.46
410040,202311,1674,790,884,1042869.58,1166938.92,2209808.50
410045,202311,45,34,11,44884.16,14520.33,59404.49
410050,202311,590,340,250,448829.67,331339.07,780168.74
410060,202311,235,172,63,227062.75,83165,310227.75
410070,202311,277,224,53,295707.24,69966.53,365673.77
410080,202311,207,128,79,168970.37,104283.04,273253.41
410090,202311,57,49,8,64687.11,10561.58,75248.69
410100,202311,290,182,108,240253.97,142564.28,382818.25
410105,202311,41,25,16,33000.99,21120.87,54121.86
410110,202311,415,256,159,339259.83,209896.6,549156.43
410115,202311,52,27,25,35640,33000.67,68640.67
410120,202311,507,230,277,303626.68,366985.55,670612.23
410130,202311,75,39,36,51486.39,47521.21,99007.60
410140,202311,3677,1694,1983,2236254.14,2621706.53,4857960.67
410150,202311,2944,1219,1725,1610331.85,2282435.8,3892767.65
410160,202311,543,312,231,411874.26,304933.5,716807.76
410165,202311,63,40,23,52801.45,30361.78,83163.23
410170,202311,232,128,104,168970.22,137284.33,306254.55
410180,202311,2775,1443,1332,1904962.88,1761012.03,3665974.91
410185,202311,40,33,7,43563.49,9240,52803.49
410190,202311,527,345,182,455427.03,241570.5,696997.53
410200,202311,1208,845,363,1115474.3,479180.6,1594654.9
410210,202311,745,388,357,513524.19,471269.63,984793.82
410220,202311,55,26,29,34320.71,38280,72600.71
410230,202311,223,99,124,130687.98,163689.1,294377.08
410240,202311,784,501,283,661399.71,373584.92,1034984.63
410250,202311,406,270,136,356428.69,180846.83,537275.52
410260,202311,355,191,164,252152.77,216493.92,468646.69
410270,202311,30,21,9,27720.86,11880,39600.86
410275,202311,70,46,24,60723.5,31680,92403.5
410280,202311,340,207,133,273270.64,175572.13,448842.77
410290,202311,295,167,128,220453.08,168966.93,389420.01
410300,202311,103,64,39,84489.25,51481.02,135970.27
410302,202311,30,17,13,22441.41,17160,39601.41
410304,202311,53,34,19,44884.15,25080.8,69964.95
410305,202311,234,148,86,195370.54,113522.26,308892.80
410310,202311,204,121,83,159735.39,109563.53,269298.92
410315,202311,42,34,8,44884.02,10560,55444.02
410320,202311,155,108,47,142565.23,62042.7,204607.93
410322,202311,43,24,19,31681.9,25080,56761.9
410330,202311,191,126,65,166347.13,85811.49,252158.62
410335,202311,110,63,47,83160.74,62040.54,145201.28
410337,202311,52,42,10,55441.82,13200.2,68642.02
410340,202311,40,33,7,43562.66,9240.46,52803.12
410345,202311,215,137,78,182173.95,104284.98,286458.93
410347,202311,41,31,10,40923.15,13201.28,54124.43
410350,202311,272,157,115,207255.46,151803.75,359059.21
410360,202311,516,319,197,421119.78,260051.05,681170.83
410370,202311,2544,1112,1432,1470615.88,1893040.71,3363656.59
410380,202311,218,125,93,165020.17,122770.81,287790.98
410390,202311,474,284,190,374905.42,250806.53,625711.95
410395,202311,38,25,13,33005.45,17164.57,50170.02
410400,202311,1088,466,622,615173.35,822431.82,1437605.17
410405,202311,88,69,19,91094.79,25085.08,116179.87
410410,202311,40,23,17,30363.95,22442.73,52806.68
410420,202311,2119,943,1176,1246089.01,1553765.12,2799854.13
410425,202311,246,116,130,153138.56,171615.84,324754.40
410430,202311,2726,1385,1341,1828349.75,1776884.67,3605234.42
410440,202311,387,284,103,374918.47,135971.64,510890.11
410442,202311,387,234,153,308908.43,201969.38,510877.81
410445,202311,366,255,111,336621.84,146528.94,483150.78
410450,202311,444,216,228,285140.88,300974.15,586115.03
410460,202311,637,353,284,465977.24,376216.52,842193.76
410465,202311,296,167,129,220450.85,170288.51,390739.36
410470,202311,263,154,109,203303.65,143885.89,347189.54
410480,202311,7683,3782,3901,4996606.03,5153749.5,10150355.53
410490,202311,1551,842,709,1111582.57,941232.41,2052814.98
410500,202311,312,188,124,248176.47,163686.91,411863.38
410510,202311,227,168,59,221775.15,77888,299663.15
410520,202311,316,225,91,297023.72,120127.33,417151.05
410530,202311,278,92,186,121445.7,245525.97,366971.67
410540,202311,425,306,119,403946.46,157085.93,561032.39
410550,202311,1923,844,1079,1115492.12,1424382.62,2539874.74
410560,202311,200,128,72,168973.44,95041.85,264015.29
410570,202311,486,321,165,423742.59,217807.6,641550.19
410580,202311,4468,1875,2593,2476580.47,3428342.41,5904922.88
410590,202311,477,302,175,398646.8,231013.22,629660.02
410600,202311,128,108,20,142565.93,26400.73,168966.66
410610,202311,71,57,14,75241.88,18480,93721.88
410620,202311,318,180,138,237629.16,182168.05,419797.21
410630,202311,515,283,232,373573.71,306253.59,679827.30
410640,202311,1337,837,500,1104901.9,661345.73,1766247.63
410645,202311,123,95,28,125416.55,36965.45,162382.00
410650,202311,419,261,158,344544.36,209889.96,554434.32
410655,202311,98,69,29,91083.78,38281.19,129364.97
410657,202311,43,20,23,26401.49,30360,56761.49
410660,202311,733,510,223,674565.21,297013.94,971579.15
410670,202311,77,61,16,80532.4,22442.23,102974.63
410680,202311,211,163,48,215186.99,63365.74,278552.73
410685,202311,46,34,12,44882.41,15840.41,60722.82
410690,202311,33966,13990,19976,18477851.08,26395476.72,44873327.80
410700,202311,369,265,104,350112.25,137287.86,487400.11
410710,202311,122,99,23,130691.34,30362.42,161053.76
410712,202311,48,33,15,43561.23,19800.97,63362.20
410715,202311,116,85,31,112208.95,40921.07,153130.02
410720,202311,739,424,315,559717.87,415811.08,975528.95
410725,202311,215,142,73,187452.64,96361.65,283814.29
410730,202311,116,51,65,67325.41,85803.02,153128.43
410740,202311,82,62,20,83161.98,26400.76,109562.74
410750,202311,339,208,131,274576.87,172926.13,447503.00
410752,202311,24,17,7,22442.37,9240,31682.37
410753,202311,65,23,42,30362.08,55443.84,85805.92
410754,202311,74,42,32,55444.45,42240.31,97684.76
410755,202311,94,46,48,60722.53,63361.07,124083.60
410760,202311,829,450,379,594050.2,500322.75,1094372.95
410765,202311,2348,1052,1296,1390108.68,1712206.66,3102315.34
410770,202311,129,91,38,120131.75,50163.64,170295.39
410773,202311,71,47,24,62043.58,31680.5,93724.08
410775,202311,242,158,84,208584.16,112204.85,320789.01
410780,202311,91,52,39,68644.15,51480.83,120124.98
410785,202311,60,52,8,68642.98,10560.2,79203.18
410790,202311,112,53,59,69962.37,77881.95,147844.32
410800,202311,311,196,115,258753.46,151813.71,410567.17
410810,202311,27,17,10,22440,13200.52,35640.52
410820,202311,150,103,47,135973.97,62047.42,198021.39
410830,202311,11045,4335,6710,5726718.73,8868524.27,14595243.00
410832,202311,129,82,47,108247.48,62045.03,170292.51
410840,202311,1625,897,728,1184128.71,961010.09,2145138.80
410845,202311,68,34,34,44881.35,44881.56,89762.91
410850,202311,180,135,45,178220.5,59402.95,237623.45
410855,202311,87,80,7,105606.66,9241.34,114848.00
410860,202311,1018,500,518,663999.43,683781.43,1347780.86
410865,202311,96,66,30,87135.28,39602.66,126737.94
410870,202311,153,125,28,165022.15,36961.3,201983.45
410880,202311,1317,629,688,830352.84,909555.14,1739907.98
410890,202311,136,80,56,105603.05,73920,179523.05
410895,202311,85,63,22,83169.62,29043.02,112212.64
410900,202311,46,35,11,46203.55,14520,60723.55
410910,202311,15,9,6,11881.75,7920.17,19801.92
410920,202311,51,32,19,42242.89,25081.14,67324.03
410930,202311,599,373,226,492388.74,298331.41,790720.15
410940,202311,5038,2523,2515,3332051.56,3321335.8,6653387.36
410950,202311,104,76,28,100330.14,36962.65,137292.79
410960,202311,1142,418,724,551820.27,955745.67,1507565.94
410965,202311,72,52,20,68644.97,26401.77,95046.74
410970,202311,677,441,236,582172.81,312862.45,895035.26
410975,202311,137,85,52,113525.56,68646.1,182171.66
410980,202311,1744,808,936,1066653.47,1238257.07,2304910.54
410990,202311,288,212,76,279855.05,100326.49,380181.54
411000,202311,73,44,29,58084.51,38285.04,96369.55
411005,202311,45,37,8,48840,10560.44,59400.44
411007,202311,305,177,128,233644.33,170281.72,403926.05
411010,202311,684,417,267,550488.44,352455.03,902943.47
411020,202311,297,190,107,250822.85,142574.18,393397.03
411030,202311,35,22,13,29041.97,17160.74,46202.71
411040,202311,81,46,35,62041.94,46202.69,108244.63
411050,202311,220,159,61,209911.45,80527.79,290439.24
411060,202311,623,433,190,571596.84,250813.26,822410.10
411065,202311,45,39,6,51482.42,7920.6,59403.02
411070,202311,1432,803,629,1061349.31,830325.64,1891674.95
411080,202311,280,176,104,232334.48,137280.65,369615.13
411090,202311,85,58,27,76570.78,35641.82,112212.60
411095,202311,376,123,253,162372.89,333983.91,496356.80
411100,202311,113,92,21,121450.82,27720.44,149171.26
411110,202311,179,93,86,122768.56,114845.17,237613.73
411120,202311,208,140,68,184820.54,89765.89,274586.43
411125,202311,433,217,216,286459.69,285147.03,571606.72
411130,202311,173,148,25,195369.29,33000,228369.29
411140,202311,229,149,80,196684.62,105600.57,302285.19
411150,202311,1370,882,488,1164316.23,645505.39,1809821.62
411155,202311,127,88,39,116160.96,51480,167640.96
411160,202311,39,17,22,22440.05,29040.34,51480.39
411170,202311,62,53,9,69962.76,11880.2,81842.96
411180,202311,1159,777,382,1027040.76,504272.94,1531313.70
411190,202311,399,233,166,307579.86,220448.86,528028.72
411200,202311,748,396,352,522778.67,465986.01,988764.68
411210,202311,741,383,358,505585.94,472578.19,978164.13
411220,202311,165,116,49,153137.44,64686.87,217824.31
411230,202311,41,34,7,44881.5,9240.6,54122.1
411240,202311,113,70,43,92410.58,56765.61,149176.19
411250,202311,453,323,130,426380.39,171606.89,597987.28
411260,202311,11,8,3,10560.85,3960.8,14521.65
411270,202311,289,153,136,201989.21,179541.22,381530.43
411275,202311,204,167,37,220462.03,48841.36,269303.39
411280,202311,321,213,108,281181.46,142566.77,423748.23
411290,202311,75,56,19,73921.17,25080.8,99001.97
411295,202311,143,102,41,134660.38,54124.43,188784.81
411300,202311,93,46,47,60720.91,63361.16,124082.07
411310,202311,102,69,33,91085.37,43560,134645.37
411320,202311,922,552,370,728703.52,489743.06,1218446.58
411325,202311,61,41,20,54123.32,26400.84,80524.16
411330,202311,1061,672,389,887107.15,513505.69,1400612.84
411340,202311,42,24,18,31681.4,23761.49,55442.89
411342,202311,71,56,15,73925.36,19802.86,93728.22
411345,202311,106,53,53,69969.07,69966.55,139935.62
411350,202311,611,444,167,587454.03,220453.74,807907.77
411360,202311,62,41,21,54128.7,27723.11,81851.81
411370,202311,14816,6165,8651,8143968.07,11433446.53,19577414.60
411373,202311,195,127,68,167651.73,89765.17,257416.90
411375,202311,97,79,18,104288.18,23760.55,128048.73
411380,202311,87,60,27,79215.85,35645.89,114861.74
411390,202311,180,100,80,132009.13,105601.84,237610.97
411400,202311,398,248,150,327391.35,198006.83,525398.18
411410,202311,605,292,313,385470.42,413178.49,798648.91
411420,202311,1051,435,616,574247.77,813190.83,1387438.60
411430,202311,673,341,332,450186.85,440918.06,891104.91
411435,202311,30,22,8,29042.2,10560.99,39603.19
411440,202311,536,422,114,557068.01,150487.3,707555.31
411450,202311,415,338,77,446192.93,102963.91,549156.84
411460,202311,891,340,551,448839.21,728686.63,1177525.84
411470,202311,120,83,37,109567.96,48841.51,158409.47
411480,202311,815,411,404,542578.82,534632.45,1077211.27
411490,202311,313,198,115,261387.48,151817.46,413204.94
411500,202311,122,90,32,118810.11,42240.19,161050.30
411510,202311,256,196,60,258729.7,80522.91,339252.61
411520,202311,7301,2488,4813,3289710.28,6357562.05,9647272.33
411530,202311,131,82,49,108244.11,64681.86,172925.97
411535,202311,52,18,34,23763.18,44883.15,68646.33
411540,202311,426,282,144,372253.76,190082.79,562336.55
411545,202311,55,37,18,48841.32,23760,72601.32
411550,202311,92,67,25,89762.28,33001.34,122763.62
411560,202311,418,167,251,220451.78,331330.43,551782.21
411570,202311,1207,387,820,510761.9,1083791.33,1594553.23
411573,202311,26,16,10,21123.34,13200.8,34324.14
411575,202311,356,228,128,300976.31,168964.06,469940.37
411580,202311,1372,478,894,631011.47,1185437.42,1816448.89
411585,202311,77,38,39,50165.37,51483.27,101648.64
411590,202311,16,11,5,14520.61,6601.48,21122.09
411600,202311,17,9,8,11883.15,10562.17,22445.32
411605,202311,180,67,113,88451.55,149177.39,237628.94
411610,202311,278,169,109,223102.48,143888.96,366991.44
411620,202311,430,206,224,271945.87,295694.3,567640.17
411630,202311,54,39,15,51481.42,19800.12,71281.54
411640,202311,36,25,11,33000.34,14520,47520.34
411650,202311,6,4,2,5280,2640,7920
411660,202311,56,42,14,55440,18480.52,73920.52
411670,202311,256,167,89,220458.49,117492.93,337951.42
411680,202311,181,134,47,176892.12,62040.55,238932.67
411690,202311,750,392,358,518793.3,473894.63,992687.93
411695,202311,67,46,21,60723.13,27720.17,88443.30
411700,202311,153,115,38,151819.35,50163.9,201983.25
411705,202311,114,79,35,104292.98,46204.44,150497.42
411710,202311,302,197,105,260055.11,138609.19,398664.30
411720,202311,168,111,57,146526.66,75244.93,221771.59
411721,202311,101,77,24,101643.69,31680,133323.69
411722,202311,111,51,60,68645.12,79208.32,147853.44
411725,202311,177,129,48,170286.94,63360.51,233647.45
411727,202311,111,93,18,122766.22,23761.24,146527.46
411729,202311,62,49,13,64683.75,17160,81843.75
411730,202311,618,395,223,521443.86,294377.99,815821.85
411740,202311,28,18,10,23762.71,13200,36962.71
411745,202311,73,57,16,75240.86,21120.6,96361.46
411750,202311,972,405,567,535966.66,748487.23,1284453.89
411760,202311,1453,1057,396,1395345.8,522753.41,1918099.21
411770,202311,460,288,172,380204.08,227058.3,607262.38
411780,202311,416,268,148,353781.38,195370,549151.38
411790,202311,646,360,286,475238.81,377539.46,852778.27
411800,202311,180,123,57,162380.93,75242.82,237623.75
411810,202311,203,158,45,208575.03,60724.17,269299.20
411820,202311,3089,1216,1873,1605304.77,2477799.16,4083103.93
411830,202311,23,15,8,19801.05,10560,30361.05
411840,202311,2589,1482,1107,1956382.65,1462664.81,3419047.46
411845,202311,76,24,52,31681.39,68641.92,100323.31
411850,202311,1435,772,663,1019111.35,875222.82,1894334.17
411860,202311,74,46,28,60725.53,36962.4,97687.93
411870,202311,81,50,31,66001.74,40920.34,106922.08
411880,202311,454,271,183,357747.84,241570.16,599318.00
411885,202311,117,78,39,102964.68,51481.59,154446.27
411890,202311,371,261,110,345861.49,145210.18,491071.67
411900,202311,120,87,33,114850.14,43561.65,158411.79
411910,202311,247,163,84,215183.85,112204.93,327388.78
411915,202311,2873,1107,1766,1465319,2335256.19,3800575.19
411920,202311,119,87,32,114854.99,42241.85,157096.84
411925,202311,23,16,7,21120.64,9240.8,30361.44
411930,202311,903,602,301,794833.06,397359.3,1192192.36
411940,202311,628,383,245,505626.13,323415.45,829041.58
411950,202311,1496,697,799,920149.33,1054774.71,1974924.04
411960,202311,1248,761,487,1004570.54,642858.79,1647429.33
411965,202311,21,14,7,18482.75,9240.16,27722.91
411970,202311,99,84,15,110888.84,19800.84,130689.68
411980,202311,259,133,126,175576.64,166325.66,341902.30
411990,202311,6180,3229,2951,4264712.74,3897044.85,8161757.59
411995,202311,758,240,518,316836.7,683812.9,1000649.6
412000,202311,380,255,125,336626.69,165015,501641.69
412010,202311,75,41,34,54122.83,44884.65,99007.48
412015,202311,39,29,10,38285.57,13201.04,51486.61
412020,202311,22,16,6,21123.55,7920.67,29044.22
412030,202311,45,36,9,47528.18,11880,59408.18
412033,202311,49,28,21,36961.29,27721.57,64682.86
412035,202311,72,49,23,64682.63,30361.61,95044.24
412040,202311,34,17,17,22440.79,22441.18,44881.97
412050,202311,222,167,55,221776.1,72600.57,294376.67
412060,202311,884,626,258,826423.93,340582.11,1167006.04
412065,202311,62,30,32,39602.56,42243.05,81845.61
412070,202311,164,114,50,150488.81,66003.62,216492.43
412080,202311,390,188,202,248179.96,266660.71,514840.67
412085,202311,38,15,23,19801.01,30360.85,50161.86
412090,202311,961,583,378,770928.2,498984.31,1269912.51
412100,202311,285,235,50,310231.4,66003.88,376235.28
412110,202311,76,55,21,72604.32,27721.93,100326.25
412120,202311,411,217,194,286472.41,256094.92,542567.33
412125,202311,77,42,35,55440.85,46200,101640.85
412130,202311,58,43,15,56764.2,21120,77884.2
412135,202311,36,20,16,26401.37,21121.46,47522.83
412140,202311,504,335,169,443255.63,224406.72,667662.35
412150,202311,282,165,117,217818.89,154446.39,372265.28
412160,202311,75,52,23,68646.83,30360.78,99007.61
412170,202311,743,477,266,631037.33,352462.03,983499.36
412175,202311,48,32,16,42243.33,21120.67,63364.00
412180,202311,187,139,48,184810.26,63363.72,248173.98
412190,202311,353,267,86,352470.86,113522.84,465993.70
412200,202311,208,118,90,155766.72,118803.08,274569.80
412210,202311,104,77,27,101645.3,35641.91,137287.21
412215,202311,257,166,91,219140.16,120127.67,339267.83
412217,202311,73,60,13,79203.82,17160.91,96364.73
412220,202311,984,627,357,827756.06,471285.2,1299041.26
412230,202311,324,183,141,241587.05,186149.19,427736.24
412240,202311,1520,757,763,1000657.22,1008570.33,2009227.55
412250,202311,472,281,191,370952.11,252136.51,623088.62
412260,202311,151,102,49,134651,64681.87,199332.87
412265,202311,168,130,38,171608.13,50161.11,221769.24
412270,202311,101,60,41,79208.71,54123.28,133331.99
412280,202311,87,64,23,84481.3,30360.34,114841.64
412290,202311,100,60,40,79205.64,52801.28,132006.92
412300,202311,228,166,62,219132.5,83163.78,302296.28
412310,202311,64,50,14,66006.42,18480.28,84486.70
412320,202311,103,79,24,104298.39,31682.24,135980.63
412330,202311,218,165,53,217817.89,69961.9,287779.79
412340,202311,209,130,79,171609.67,104283.1,275892.77
412350,202311,772,343,429,452783.29,566308.3,1019091.59
412360,202311,25,19,6,25081.01,7920,33001.01
412370,202311,159,129,30,170300.3,39601.65,209901.95
412380,202311,195,141,54,186144.03,71284.73,257428.76
412382,202311,64,37,27,48842.08,35641.53,84483.61
412385,202311,181,124,57,163691.25,75244.86,238936.11
412390,202311,357,270,87,356430.68,114845.86,471276.54
412395,202311,75,61,14,80522.11,18480.68,99002.79
412400,202311,110,74,36,97688.37,47521.44,145209.81
412402,202311,262,144,118,190088.98,155773.68,345862.66
412405,202311,1045,357,688,471258.48,908186.94,1379445.42
412410,202311,1096,655,441,864701.89,584799.75,1449501.64
412420,202311,19,18,1,23760.42,1320,25080.42
412430,202311,29,27,2,35643.19,2641.28,38284.47
412440,202311,771,383,388,505595.71,512175.31,1017771.02
412450,202311,68,59,9,77887.26,11880.91,89768.17
412460,202311,90,61,29,80527.06,38280.76,118807.82
412470,202311,255,206,49,273261.17,64682.07,337943.24
412480,202311,176,126,50,166332.64,66004.06,232336.70
412490,202311,195,158,37,208568.09,48840.88,257408.97
412500,202311,435,338,97,447530.82,128046.49,575577.31
412510,202311,182,147,35,194072.91,46207.85,240280.76
412520,202311,99,66,33,87127.89,43562.01,130689.90
412530,202311,123,55,68,72605.36,89761.43,162366.79
412535,202311,58,44,14,58084.17,18481.48,76565.65
412540,202311,67,41,26,54122.59,34321.78,88444.37
412545,202311,97,69,28,91091.9,36961.37,128053.27
412550,202311,4903,2002,2901,2644361.74,3833659.19,6478020.93
412555,202311,17,8,9,10560.4,11880,22440.4
412560,202311,760,486,274,642896.11,363017.02,1005913.13
412570,202311,965,417,548,551807.83,723395.32,1275203.15
412575,202311,102,73,29,96371.32,38280.84,134652.16
412580,202311,189,126,63,167669.89,83168.75,250838.64
412590,202311,32,29,3,38285.11,3960.37,42245.48
412600,202311,243,175,68,231009.22,89763.83,320773.05
412610,202311,54,22,32,29042.24,42240.57,71282.81
412620,202311,131,107,24,141255.45,31683.09,172938.54
412625,202311,2496,1193,1303,1577541.45,1721374.16,3298915.61
412627,202311,68,52,16,68646.76,21120.51,89767.27
412630,202311,408,276,132,364324.03,174259.07,538583.10
412635,202311,89,27,62,35642.42,81841.12,117483.54
412640,202311,116,85,31,112213.96,40922.58,153136.54
412650,202311,345,231,114,304944.57,150487.61,455432.18
412660,202311,605,331,274,436951.3,361696.17,798647.47
412665,202311,42,38,4,50162.1,5280,55442.1
412667,202311,283,177,106,233667.89,139928.32,373596.21
412670,202311,87,65,22,85802.83,29040.5,114843.33
412680,202311,358,268,90,353793.35,118809.7,472603.05
412690,202311,142,91,51,120130.05,67322.08,187452.13
412700,202311,200,122,78,161047.29,102962.69,264009.98
412710,202311,1525,825,700,1089112.51,924055.48,2013167.99
412720,202311,275,148,127,195375.49,167648.79,363024.28
412730,202311,183,153,30,201976.17,39601.65,241577.82
412740,202311,448,215,233,283827.77,307585.27,591413.04
412750,202311,426,234,192,308916.64,253454.08,562370.72
412760,202311,421,214,207,282505.46,273261.88,555767.34
412770,202311,2410,1291,1119,1705577.75,1479816.41,3185394.16
412780,202311,150,100,50,132018.92,66007.13,198026.05
412785,202311,340,181,159,238931.91,209887.91,448819.82
412788,202311,57,32,25,42245.58,33002.1,75247.68
412790,202311,133,106,27,139935.81,35643.82,175579.63
412795,202311,163,114,49,150493.65,64691.01,215184.66
412796,202311,325,201,124,265328.94,163682.67,429011.61
412800,202311,779,434,345,575551.3,455420.48,1030971.78
412810,202311,3533,1981,1552,2616425.96,2050086.54,4666512.50
412820,202311,1190,675,515,893743,679853.96,1573596.96
412830,202311,16,15,1,19802.49,1320,21122.49
412840,202311,259,173,86,228375.68,114845.5,343221.18
412850,202311,621,403,218,532014.15,287771.12,819785.27
412853,202311,185,81,104,106927.87,137283.45,244211.32
412855,202311,227,124,103,163695.91,135970.55,299666.46
412860,202311,106,72,34,95056.67,44884.97,139941.64
412862,202311,89,58,31,76563.31,40920,117483.31
412863,202311,14,9,5,11880.63,6600.96,18481.59
412865,202311,43,35,8,46203.34,10561.15,56764.49
412870,202311,135,92,43,121448.66,56765.42,178214.08
412880,202311,101,72,29,95050.18,38281.2,133331.38
420005,202311,50,42,8,55442,10560,66002
420010,202311,383,255,128,336621.74,168964.37,505586.11
420020,202311,104,80,24,105607.52,31680.67,137288.19
420030,202311,34,25,9,33002.49,11880,44882.49
420040,202311,94,73,21,96374.23,27721.87,124096.10
420050,202311,60,36,24,47524.03,31682.47,79206.50
420055,202311,20,17,3,22444.94,3960,26404.94
420060,202311,37,25,12,33006.67,15843.88,48850.55
420070,202311,124,109,15,143893.17,19802.08,163695.25
420075,202311,12,12,0,15840,,15840.0
420080,202311,48,40,8,52804.45,10560.54,63364.99
420090,202311,49,38,11,50164.6,14520.82,64685.42
420100,202311,177,152,25,200664.47,33002.38,233666.85
420110,202311,30,28,2,36961.81,2640,39601.81
420120,202311,67,49,18,64686.57,23763.38,88449.95
420125,202311,87,66,21,87124.35,27720,114844.35
420127,202311,39,33,6,43560.44,7920,51480.44
420130,202311,606,367,239,485795.92,315503.08,801299.00
420140,202311,1574,900,674,1189431.45,891089.19,2080520.64
420150,202311,54,39,15,51484.82,19800.74,71285.56
420160,202311,38,33,5,43564.45,6600.84,50165.29
420165,202311,18,14,4,18481.44,5280.42,23761.86
420170,202311,82,47,35,62043.61,46200.55,108244.16
420180,202311,25,23,2,30361.04,2640.8,33001.84
420190,202311,35,30,5,39605.25,6600.47,46205.72
420195,202311,165,85,80,112218.45,105617.27,217835.72
420200,202311,1587,665,922,877896.43,1219786.14,2097682.57
420205,202311,164,97,67,128051.43,88444.26,216495.69
420207,202311,185,100,85,132013.1,112212.23,244225.33
420208,202311,22,18,4,23761.03,5280,29041.03
420209,202311,16,14,2,18480.56,2640.07,21120.63
420210,202311,701,345,356,455431.35,469942.88,925374.23
420213,202311,57,39,18,51483.54,23760.8,75244.34
420215,202311,28,24,4,31682.59,5280.22,36962.81
420220,202311,65,41,24,54124.11,31682.96,85807.07
420230,202311,1200,747,453,986149.93,599341.76,1585491.69
420240,202311,2752,1830,922,2417078.88,1218424.26,3635503.14
420243,202311,51,42,9,55442.09,11881.08,67323.17
420245,202311,295,138,157,182172.3,207255.09,389427.39
420250,202311,70,45,25,59406.56,33003.65,92410.21
420253,202311,25,19,6,25082.46,7921.44,33003.90
420257,202311,17,10,7,13200.37,9240.4,22440.77
420260,202311,138,110,28,145210.67,36962.55,182173.22
420270,202311,41,29,12,38281.73,15840.98,54122.71
420280,202311,321,233,88,307602.48,116169.75,423772.23
420285,202311,26,20,6,26402.13,7920.87,34323.00
420287,202311,50,32,18,42245.12,23762.64,66007.76
420290,202311,1119,759,360,1001938.02,476541.45,1478479.47
420300,202311,1790,1431,359,1889115.31,473916.27,2363031.58
420310,202311,48,33,15,43563.31,19800.61,63363.92
420315,202311,25,20,5,26404.85,6600.66,33005.51
420320,202311,1248,605,643,798676.52,848822.97,1647499.49
420325,202311,10,7,3,9240,3960.8,13200.8
420330,202311,127,85,42,112217.31,55446.22,167663.53
420340,202311,211,140,71,184818.49,93725.41,278543.90
420350,202311,286,204,82,269304.74,108247.62,377552.36
420360,202311,737,581,156,767005.2,207256.67,974261.87
420370,202311,150,84,66,110889.36,87126.36,198015.72
420380,202311,1408,941,467,1243557.03,617815.46,1861372.49
420390,202311,234,164,70,216499.57,92405.33,308904.90
420395,202311,215,157,58,207268.97,76570.86,283839.83
420400,202311,229,174,55,229696.8,72603.88,302300.68
420410,202311,62,48,14,63368.44,18480.88,81849.32
420415,202311,32,24,8,31680.2,10560.86,42241.06
420417,202311,76,59,17,77886.36,22441.11,100327.47
420419,202311,14,12,2,15841.77,2640,18481.77
420420,202311,3292,2050,1242,2707540.2,1642186.14,4349726.34
420425,202311,76,54,22,71288.47,29041.65,100330.12
420430,202311,1075,789,286,1042853.75,377529.96,1420383.71
420435,202311,14,11,3,14524,3960.11,18484.11
420440,202311,94,67,27,88448.62,35642.84,124091.46
420445,202311,34,31,3,40926.55,3960,44886.55
420450,202311,99,59,40,77886.37,52802.25,130688.62
420455,202311,214,171,43,225737.97,56762.67,282500.64
420460,202311,2700,1669,1031,2204609.72,1363666.11,3568275.83
420470,202311,82,52,30,68646.74,39601.07,108247.81
420475,202311,9,8,1,10560.33,1320,11880.33
420480,202311,1028,789,239,1041560.93,315496.92,1357057.85
420490,202311,104,75,29,99013.48,38281.15,137294.63
420500,202311,422,250,172,330028.39,227053.37,557081.76
420510,202311,22,18,4,23760.44,5280,29040.44
420515,202311,31,17,14,22442.55,18480.54,40923.09
420517,202311,12,9,3,11881.61,3960,15841.61
420519,202311,9,8,1,10560.6,1320.4,11881.0
420520,202311,63,44,19,58090.71,25084.15,83174.86
420530,202311,151,96,55,126723.77,72601.44,199325.21
420535,202311,16,13,3,17160.33,3960,21120.33
420540,202311,8149,5074,3075,6702550.87,4060628.58,10763179.45
420543,202311,33,31,2,40924.14,2640,43564.14
420545,202311,259,179,80,236301.99,105605.5,341907.49
420550,202311,862,732,130,966320.02,171609.34,1137929.36
420555,202311,41,31,10,40924.42,13201.4,54125.82
420560,202311,66,50,16,66005.08,21121.46,87126.54
420570,202311,288,141,147,186143.27,194055.65,380198.92
420580,202311,375,200,175,265340.59,231025.76,496366.35
420590,202311,568,359,209,473904.01,278530.72,752434.73
420600,202311,173,95,78,125408.15,102966.09,228374.24
420610,202311,40,36,4,47523.77,5280,52803.77
420620,202311,84,68,16,89771.83,21122.79,110894.62
420630,202311,178,123,55,162373.83,72604.43,234978.26
420640,202311,80,70,10,92404.56,13200.51,105605.07
420650,202311,378,195,183,257415.63,241577.72,498993.35
420660,202311,45,31,14,40923.06,18482.1,59405.16
420665,202311,54,37,17,48843.04,22440.99,71284.03
420670,202311,244,186,58,245555.92,76569.65,322125.57
420675,202311,20,15,5,19800,6600,26400
420680,202311,36,29,7,38282.36,9241.31,47523.67
420690,202311,228,165,63,217817.25,83163.38,300980.63
420700,202311,810,523,287,690435.53,378867.42,1069302.95
420710,202311,167,92,75,122769.59,99008.24,221777.83
420720,202311,111,83,28,109575.77,36960.88,146536.65
420730,202311,844,508,336,670640.14,443552.47,1114192.61
420740,202311,62,59,3,77886.16,3960,81846.16
420750,202311,540,359,181,473910.22,238931.88,712842.10
420757,202311,20,17,3,22440,3960,26400
420760,202311,39,28,11,36963.52,14520.88,51484.40
420765,202311,69,48,21,63362.93,27720.78,91083.71
420768,202311,60,47,13,62048.01,17160.47,79208.48
420770,202311,80,68,12,89767.72,15840.11,105607.83
420775,202311,38,31,7,40922.04,9240,50162.04
420780,202311,213,164,49,216505.1,64685.05,281190.15
420785,202311,28,17,11,22441.95,14520.44,36962.39
420790,202311,145,120,25,158414.55,33003.28,191417.83
420800,202311,68,55,13,72605.58,17160.34,89765.92
420810,202311,312,236,76,311557.19,100325,411882.19
420820,202311,3126,1762,1364,2327342.17,1800612.47,4127954.64
420830,202311,855,465,390,613863.53,514840.1,1128703.63
420840,202311,137,94,43,124087.57,56760.79,180848.36
420845,202311,531,241,290,319464.33,385471.3,704935.63
420850,202311,320,245,75,323413.59,99004.4,422417.99
420860,202311,62,53,9,69965.07,11880.14,81845.21
420870,202311,147,105,42,138609.17,55443.98,194053.15
420880,202311,222,140,82,184819.19,108244.13,293063.32
420890,202311,1172,611,561,808071.89,740553.1,1548624.99
420895,202311,12,11,1,14521.5,1320,15841.5
420900,202311,443,351,92,463362.2,121444.87,584807.07
420910,202311,6898,3868,3030,5108865.38,4005173.49,9114038.87
420915,202311,61,55,6,72609.61,7920,80529.61
420917,202311,27,20,7,26402.76,9240.78,35643.54
420920,202311,21,15,6,19802.58,7920.61,27723.19
420930,202311,4211,2931,1280,3870492.27,1689769.57,5560261.84
420940,202311,661,456,205,602010.23,270647.7,872657.93
420945,202311,11,8,3,10561.06,3960,14521.06
420950,202311,48,36,12,47524.46,15840.94,63365.40
420960,202311,118,97,21,128054.68,27723.23,155777.91
420970,202311,302,249,53,328733.6,69968.81,398702.41
420980,202311,24,23,1,30361.82,1320,31681.82
420985,202311,53,45,8,59404.17,10560.32,69964.49
420990,202311,99,75,24,99008.74,31683.86,130692.60
421000,202311,74,37,37,48841.45,48841.38,97682.83
421003,202311,32,22,10,29045.27,13201.32,42246.59
421005,202311,8,6,2,7921.95,2640.67,10562.62
421010,202311,971,619,352,817172.86,467312.47,1284485.33
421020,202311,20,18,2,23766.42,2640.6,26407.02
421030,202311,118,94,24,124099.57,31683.04,155782.61
421040,202311,74,57,17,75248.67,22443.57,97692.24
421050,202311,345,242,103,320771.2,135962.99,456734.19
421055,202311,16,13,3,17162.37,3960,21122.37
421060,202311,125,65,60,85805.61,79201.26,165006.87
421070,202311,34,31,3,40923.94,3960.44,44884.38
421080,202311,50,40,10,52805.43,13200.69,66006.12
421085,202311,21,15,6,19803.21,7921.14,27724.35
421090,202311,38,29,9,38285.34,11881.01,50166.35
421100,202311,126,94,32,125415.24,43562.59,168977.83
421105,202311,211,166,45,219136.2,59405.96,278542.16
421110,202311,144,98,46,129374.41,62043.42,191417.83
421120,202311,216,150,66,198011.91,87126.05,285137.96
421125,202311,18,11,7,14521.18,9240.27,23761.45
421130,202311,1003,608,395,802627.35,521432.32,1324059.67
421140,202311,35,26,9,34321.56,11882.11,46203.67
421145,202311,45,37,8,48843.88,10560,59403.88
421150,202311,92,72,20,95056.68,26403.24,121459.92
421160,202311,69,45,24,59404.65,31680.34,91084.99
421165,202311,17,14,3,18480,3960,22440
421170,202311,183,154,29,203472.93,38284.36,241757.29
421175,202311,215,148,67,195376.14,88447.6,283823.74
421180,202311,38,22,16,29044.13,21122.89,50167.02
421185,202311,23,19,4,25084.42,5280,30364.42
421187,202311,5,4,1,5280.64,1320,6600.64
421189,202311,47,35,12,46203.84,15840.34,62044.18
421190,202311,2507,1614,893,2130715.4,1180193.12,3310908.52
421200,202311,99,71,28,93726.55,36962.93,130689.48
421205,202311,21,14,7,18484.48,9240.85,27725.33
421210,202311,193,134,59,176896.76,77887.56,254784.32
421220,202311,269,206,63,271943.16,83165.53,355108.69
421223,202311,52,41,11,54125,14520,68645
421225,202311,87,60,27,79209.72,35645.46,114855.18
421227,202311,75,60,15,79203.86,19800,99003.86
421230,202311,88,59,29,77885.91,38284.28,116170.19
421240,202311,22,18,4,23762.75,5280,29042.75
421250,202311,482,269,213,355112.99,281185.11,636298.10
421260,202311,24,19,5,25081.9,6600.49,31682.39
421265,202311,20,14,6,18481.98,7920.9,26402.88
421270,202311,56,50,6,66005.65,7920.71,73926.36
421280,202311,473,250,223,331351.35,295703.2,627054.55
421290,202311,321,213,108,281175.94,142567.64,423743.58
421300,202311,23,20,3,26402.76,3960,30362.76
421310,202311,52,35,17,46202.87,22442.91,68645.78
421315,202311,36,21,15,27723.11,19801.24,47524.35
421320,202311,146,100,46,132008.03,60723.26,192731.29
421330,202311,118,90,28,118808.2,38282.39,157090.59
421335,202311,50,36,14,47524.7,18480.34,66005.04
421340,202311,262,174,88,229697.89,116168.15,345866.04
421350,202311,205,126,79,166343.52,104289.82,270633.34
421360,202311,803,556,247,735307.51,327384.17,1062691.68
421370,202311,212,158,54,208582.1,71284.33,279866.43
421380,202311,166,121,45,159738.97,59405.93,219144.90
421390,202311,19,14,5,18480.51,6600,25080.51
421400,202311,127,100,27,132004.5,35640.18,167644.68
421410,202311,21,18,3,23761.95,3960,27721.95
421415,202311,21,19,2,25083.17,2640,27723.17
421420,202311,102,86,16,113525.04,21121.08,134646.12
421430,202311,22,14,8,18484.53,10560,29044.53
421440,202311,59,49,10,64688.42,13200.68,77889.10
421450,202311,83,66,17,87127.64,22442.2,109569.84
421460,202311,54,45,9,59405.23,11881.43,71286.66
421470,202311,86,46,40,60729.89,52804.01,113533.90
421480,202311,903,663,240,875209.24,316812.46,1192021.70
421490,202311,25,23,2,30363.44,2640,33003.44
421500,202311,533,305,228,402638.91,300976.28,703615.19
421505,202311,50,41,9,54122.23,11881.6,66003.83
421507,202311,34,27,7,35643.2,9240,44883.2
421510,202311,65,41,24,54129.82,31681.77,85811.59
421520,202311,49,41,8,54127.38,10561.44,64688.82
421530,202311,58,48,10,63367.16,13200.39,76567.55
421535,202311,24,21,3,27725.05,3960,31685.05
421540,202311,50,42,8,55443.9,10560,66003.9
421545,202311,95,64,31,84492.56,42242.45,126735.01
421550,202311,326,236,90,311563.68,118814.2,430377.88
421555,202311,19,17,2,22445.1,2640.87,25085.97
421560,202311,8,7,1,9241.07,1320.4,10561.47
421565,202311,142,90,52,118813.75,69966.6,188780.35
421567,202311,39,30,9,39604.05,11880,51484.05
421568,202311,38,37,1,48840.84,1320,50160.84
421569,202311,11,10,1,13200.93,1320,14520.93
421570,202311,297,190,107,250826.82,141248.84,392075.66
421575,202311,28,26,2,34321.55,2640,36961.55
421580,202311,811,482,329,636376.07,435627.81,1072003.88
421590,202311,23,21,2,27723.86,2640,30363.86
421600,202311,191,139,52,183486.5,68641.61,252128.11
421605,202311,119,81,38,106925.61,50163.52,157089.13
421610,202311,177,126,51,166331.19,67323.57,233654.76
421620,202311,1205,696,509,918822.35,673265.68,1592088.03
421625,202311,24,21,3,27721.87,3960.23,31682.10
421630,202311,388,238,150,314199.23,198014.74,512213.97
421635,202311,36,22,14,29042.69,18481.57,47524.26
421640,202311,119,93,26,124099.98,34322.55,158422.53
421650,202311,361,213,148,281190.82,195381.75,476572.57
421660,202311,3183,1957,1226,2583488.53,1619785.94,4203274.47
421670,202311,162,117,45,154444.92,59400.71,213845.63
421680,202311,214,189,25,249505.89,33002.25,282508.14
421690,202311,381,258,123,341914.61,163693.65,505608.26
421700,202311,59,43,16,56762.52,21121.38,77883.90
421710,202311,25,25,0,33001.54,,33001.54
421715,202311,5,5,0,6601,,6601.0
421720,202311,697,460,237,607237.02,312849.61,920086.63
421725,202311,41,18,23,23761.63,30362.43,54124.06
421730,202311,22,18,4,23762.26,5280.67,29042.93
421740,202311,130,56,74,75245.6,97683.46,172929.06
421750,202311,199,142,57,187450.8,75243.97,262694.77
421755,202311,20,19,1,25081.89,1320,26401.89
421760,202311,117,84,33,110890.24,44885.32,155775.56
421770,202311,761,487,274,644232.53,361714.14,1005946.67
421775,202311,28,18,10,23762.6,13202.22,36964.82
421780,202311,200,150,50,198014.27,66000.79,264015.06
421790,202311,157,136,21,179533.19,27721.8,207254.99
421795,202311,17,13,4,17162.77,5280,22442.77
421800,202311,663,401,262,529393.61,345871.05,875264.66
421810,202311,74,61,13,80529.75,17160.67,97690.42
421820,202311,362,235,127,310225.64,168968.28,479193.92
421825,202311,184,153,31,201977.83,40923.19,242901.02
421830,202311,193,122,71,161060.05,93727.57,254787.62
421835,202311,6,2,4,2641.05,5280,7921.05
421840,202311,53,43,10,56768.47,13202.28,69970.75
421850,202311,79,64,15,84488.69,19802.72,104291.41
421860,202311,43,30,13,39603.36,17160.31,56763.67
421870,202311,1341,953,388,1260739.78,514841.16,1775580.94
421875,202311,52,40,12,52806.44,15840,68646.44
421880,202311,216,155,61,204613.42,80523.55,285136.97
421885,202311,20,15,5,19800.54,6600.08,26400.62
421890,202311,188,133,55,175578.57,72608.68,248187.25
421895,202311,56,49,7,64685.43,9241.41,73926.84
421900,202311,144,106,38,139946.38,50163.69,190110.07
421910,202311,77,47,30,62044.46,39603.55,101648.01
421915,202311,34,28,6,38282.89,7920.8,46203.69
421917,202311,56,43,13,56761.71,17160.44,73922.15
421920,202311,40,35,5,46207.34,6600,52807.34
421930,202311,688,550,138,726068.96,182175.48,908244.44
421935,202311,48,37,11,48843.18,14521.8,63364.98
421940,202311,56,49,7,64682.97,9240.2,73923.17
421950,202311,1005,675,330,891043.12,435628.92,1326672.04
421960,202311,45,37,8,48844.13,10560,59404.13
421970,202311,339,209,130,275904.29,171607.57,447511.86
421985,202311,21,13,8,17162.68,10562.08,27724.76
422000,202311,27,16,11,21123.1,14521.45,35644.55
430003,202311,208,65,143,85801.31,188760.6,274561.91
430005,202311,33,25,8,33001.91,10560,43561.91
430010,202311,270,199,71,262691.6,93722.67,356414.27
430020,202311,144,103,41,135971.65,54124.72,190096.37
430030,202311,137,108,29,142570.33,38280,180850.33
430040,202311,3202,1885,1317,2488316.89,1739827.99,4228144.88
430045,202311,84,75,9,99000,11880,110880
430047,202311,6,5,1,6600,1320,7920
430050,202311,92,78,14,102964.02,18480,121444.02
430055,202311,15,13,2,17160,2640,19800
430057,202311,6,5,1,6600,1320,7920
430060,202311,4862,2843,2019,3753104.63,2669228.4,6422333.03
430063,202311,64,50,14,66001.3,18481.14,84482.44
430064,202311,177,142,35,187442.65,46200,233642.65
430066,202311,8,5,3,6600.4,3960.6,10561.0
430070,202311,40,34,6,44881,9240.2,54121.2
430080,202311,86,58,28,76563.3,36961.37,113524.67
430085,202311,31,16,15,21121,19801.19,40922.19
430087,202311,44,33,11,43564.41,14522.56,58086.97
430090,202311,68,57,11,75242.28,14520,89762.28
430100,202311,169,117,52,154449.14,68642.12,223091.26
430105,202311,211,126,85,166337.22,112209.99,278547.21
430107,202311,23,19,4,25083.82,5280.98,30364.80
430110,202311,520,281,239,370933.2,315487.22,686420.42
430120,202311,199,183,16,242885.93,21120,264005.93
430130,202311,876,519,357,685118.48,473897.97,1159016.45
430140,202311,149,135,14,178209.66,18480.74,196690.40
430150,202311,117,75,42,99006.08,55440.6,154446.68
430155,202311,30,26,4,34323.15,5280,39603.15
430160,202311,4184,2343,1841,3094294.21,2434196.99,5528491.20
430163,202311,513,242,271,319453.95,357731.42,677185.37
430165,202311,33,19,14,25080.94,18480,43560.94
430170,202311,88,72,16,95043.57,21120,116163.57
430175,202311,91,73,18,96361.19,23761.21,120122.40
430180,202311,113,86,27,113523.57,35640,149163.57
430185,202311,31,23,8,30360,10560,40920
430187,202311,111,43,68,56761.73,89765.08,146526.81
430190,202311,257,127,130,167650.51,171609.08,339259.59
430192,202311,13,10,3,13200.37,3960,17160.37
430195,202311,20,16,4,21120.55,5280,26400.55
430200,202311,169,140,29,184816.61,38282.84,223099.45
430205,202311,20,20,0,26400.6,,26400.6
430210,202311,891,661,230,872554.03,303610.09,1176164.12
430215,202311,12,11,1,14520,1320,15840
430220,202311,80,54,26,71282.96,34320,105602.96
430222,202311,14,4,10,5280,13200.67,18480.67
430223,202311,20,15,5,19800,6600,26400
430225,202311,5,3,2,3960.34,2640,6600.34
430230,202311,393,242,151,319454.66,199324.19,518778.85
430235,202311,55,35,20,46200.88,26400,72600.88
430237,202311,21,16,5,21120.71,6600,27720.71
430240,202311,129,87,42,114843.33,55440.06,170283.39
430245,202311,74,62,12,81842.79,15840.4,97683.19
430250,202311,192,113,79,149166.43,104280,253446.43
430258,202311,14,11,3,14521.37,3960.6,18481.97
430260,202311,38,35,3,46201.79,3960,50161.79
430265,202311,43,37,6,48841.91,7920,56761.91
430270,202311,585,404,181,534642.21,238926.82,773569.03
430280,202311,1198,685,513,905557.9,677170.41,1582728.31
430290,202311,487,251,236,331335.65,311528.03,642863.68
430300,202311,2445,1350,1095,1782142.58,1446804.73,3228947.31
430310,202311,2502,1252,1250,1654126.08,1651446.01,3305572.09
430320,202311,69,56,13,73920.2,17160,91080.2
430330,202311,97,83,14,110886.09,18480,129366.09
430340,202311,76,62,14,81844.21,18480.34,100324.55
430350,202311,1856,1145,711,1512789.65,939864.62,2452654.27
430355,202311,21,19,2,25080.44,2640,27720.44
430360,202311,116,63,53,83160.3,69960,153120.3
430367,202311,54,39,15,51481.38,19800,71281.38
430370,202311,66,58,8,76561.9,10560,87121.9
430380,202311,111,79,32,104283.68,43560,147843.68
430390,202311,739,447,292,590004.12,385467.6,975471.72
430400,202311,269,184,85,242883.04,112201.19,355084.23
430410,202311,57,48,9,63360.87,11880.17,75241.04
430420,202311,592,387,205,510867.23,270605.78,781473.01
430430,202311,52,47,5,61166.18,6600,67766.18
430435,202311,161,114,47,150486.57,62043.36,212529.93
430440,202311,706,427,279,564996.4,369616.04,934612.44
430450,202311,1396,1149,247,1518089.66,326055.53,1844145.19
430460,202311,6861,3531,3330,4669184.18,4401111.01,9070295.19
430461,202311,20,18,2,23760,2640,26400
430462,202311,8,6,2,7921.39,2640.99,10562.38
430463,202311,1487,822,665,1090398.89,877848.57,1968247.46
430465,202311,28,18,10,23761.43,13200.08,36961.51
430466,202311,869,608,261,802623.93,344539.07,1147163.00
430467,202311,144,77,67,101642.53,88440.44,190082.97
430468,202311,181,104,77,137285.23,101643.39,238928.62
430469,202311,22,15,7,19805.57,9241.01,29046.58
430470,202311,1299,717,582,949521.15,769587.09,1719108.24
430471,202311,90,63,27,84487.06,35642.59,120129.65
430480,202311,166,118,48,155761.48,63360,219121.48
430485,202311,8,8,0,10561.07,,10561.07
430490,202311,72,57,15,75242.17,19800.34,95042.51
430495,202311,38,27,11,35641.67,14520,50161.67
430500,202311,206,139,67,183484.49,88441.82,271926.31
430510,202311,4473,2854,1619,3770086.94,2138462.2,5908549.14
430511,202311,15,14,1,18481.38,1320,19801.38
430512,202311,201,139,62,183488.9,81844.95,265333.85
430513,202311,61,46,15,60722.15,19800,80522.15
430515,202311,23,21,2,27720.34,2640,30360.34
430517,202311,194,165,29,217806.06,39601.17,257407.23
430520,202311,361,254,107,335295.7,141244.39,476540.09
430530,202311,89,48,41,63361.62,54122.73,117484.35
430535,202311,525,325,200,429022.7,264011.03,693033.73
430537,202311,9,9,0,11880.67,,11880.67
430540,202311,83,59,24,77880,31680,109560
430543,202311,485,154,331,203284.03,436944.25,640228.28
430544,202311,53,48,5,63371.33,6601.07,69972.40
430545,202311,515,252,263,333991.32,347194.44,681185.76
430550,202311,44,35,9,46203.58,11881.49,58085.07
430558,202311,2,2,0,2640,,2640.0
430560,202311,51,30,21,39600,27720,67320
430570,202311,127,54,73,71284.67,96360.2,167644.87
430580,202311,132,106,26,139923.19,34320,174243.19
430583,202311,14,14,0,18481.29,,18481.29
430585,202311,14,11,3,14520.04,5280,19800.04
430587,202311,14,11,3,14520,3960,18480
430590,202311,214,173,41,228365.75,54121.01,282486.76
430593,202311,1,1,0,1320,,1320.0
430595,202311,18,14,4,18480,5280,23760
430597,202311,45,27,18,35641.16,23762.75,59403.91
430600,202311,242,175,67,231005.85,88440,319445.85
430605,202311,202,117,85,154442.14,112200.67,266642.81
430607,202311,34,27,7,35642.26,9240.5,44882.76
430610,202311,1974,958,1016,1264607.47,1342464.34,2607071.81
430613,202311,5,5,0,6600.67,,6600.67
430620,202311,107,75,32,99000.78,42240.44,141241.22
430630,202311,48,41,7,54123.47,9240,63363.47
430632,202311,32,28,4,36960,5280,42240
430635,202311,39,32,7,42240.68,9240,51480.68
430637,202311,76,34,42,44880.74,55440,100320.74
430640,202311,184,110,74,145206.21,97685.42,242891.63
430642,202311,18,15,3,19800.17,3960,23760.17
430645,202311,34,27,7,35640,9240,44880
430650,202311,252,201,51,265351.67,67323.46,332675.13
430655,202311,18,15,3,19800.43,3960.34,23760.77
430660,202311,1089,537,552,708879.46,729995.51,1438874.97
430670,202311,71,49,22,64680.78,29040,93720.78
430673,202311,93,62,31,81842.72,40920.27,122762.99
430675,202311,10,7,3,9240.4,3960,13200.4
430676,202311,769,477,292,629773.61,385460.76,1015234.37
430680,202311,280,188,92,248172.57,121444.02,369616.59
430690,202311,617,379,238,500315.26,314172.72,814487.98
430692,202311,6,5,1,6601.18,1320,7921.18
430693,202311,145,93,52,122765.1,68642.3,191407.4
430695,202311,74,55,19,72600.12,25080,97680.12
430697,202311,68,42,26,55440.58,34320.44,89761.02
430700,202311,1472,991,481,1308192.17,634947.53,1943139.70
430705,202311,36,30,6,39600.51,7920,47520.51
430710,202311,275,172,103,227044.12,135960,363004.12
430720,202311,101,83,18,109561.86,23760,133321.86
430730,202311,164,140,24,184804.15,31680,216484.15
430740,202311,93,60,33,79203.69,43560,122763.69
430745,202311,31,18,13,23760.93,17160,40920.93
430750,202311,335,214,121,282486.26,159722.11,442208.37
430755,202311,86,50,36,66002.43,47520.99,113523.42
430760,202311,484,262,222,345867.69,293056.14,638923.83
430770,202311,1967,1094,873,1444202.84,1152411.76,2596614.60
430780,202311,395,250,145,330004,191400.34,521404.34
430781,202311,25,25,0,33003.78,,33003.78
430783,202311,67,48,19,63360,25080,88440
430786,202311,8,6,2,7920,2640,10560
430790,202311,600,370,230,488421.72,303610.05,792031.77
430800,202311,170,123,47,162364.92,62040.67,224405.59
430805,202311,39,30,9,39602.89,11880,51482.89
430807,202311,82,49,33,64680.34,43560,108240.34
430810,202311,84,56,28,73922.14,38280.54,112202.68
430820,202311,171,112,59,147845.99,77881.24,225727.23
430825,202311,11,8,3,10560,3960,14520
430830,202311,294,269,25,355092.04,34320,389412.04
430840,202311,162,109,53,143886.48,69961.53,213848.01
430843,202311,8,5,3,6600,3960,10560
430845,202311,82,47,35,62040.86,46200,108240.86
430850,202311,636,446,190,590057.9,250803.41,840861.31
430860,202311,199,133,66,175565.82,87123.3,262689.12
430865,202311,84,45,39,59400.55,51480.64,110881.19
430870,202311,73,59,14,77886.87,18480.45,96367.32
430880,202311,192,132,60,174249.13,79202.59,253451.72
430885,202311,11,9,2,11880.45,2640,14520.45
430890,202311,359,220,139,290406.12,183481.18,473887.30
430900,202311,567,388,179,512177.53,236281.22,748458.75
430905,202311,170,81,89,106921.53,117482.85,224404.38
430910,202311,330,177,153,234972.91,201970.62,436943.53
430912,202311,7,6,1,7920.23,1320,9240.23
430915,202311,43,40,3,52800.34,3960,56760.34
430920,202311,5611,2926,2685,3865331.97,3545769.11,7411101.08
430925,202311,6,6,0,7920,,7920.0
430930,202311,2482,1403,1079,1852097.74,1425674.19,3277771.93
430940,202311,300,190,110,250809.54,146525.43,397334.97
430950,202311,169,137,32,180844.99,42240.55,223085.54
430955,202311,31,20,11,26400.84,14520,40920.84
430957,202311,26,24,2,31681.78,2640,34321.78
430960,202311,294,195,99,257406.48,130681.01,388087.49
430965,202311,117,77,40,101640.89,52800.94,154441.83
430970,202311,95,76,19,101640.85,25080,126720.85
430975,202311,58,48,10,63363.85,13200,76563.85
430980,202311,56,34,22,44882.08,29040.44,73922.52
430990,202311,101,80,21,105601.55,27720,133321.55
430995,202311,125,112,13,147841.78,17160.4,165002.18
431000,202311,310,155,155,205929.99,204602.93,410532.92
431010,202311,412,248,164,327388.72,216498.34,543887.06
431020,202311,2144,1239,905,1635549.87,1194624.7,2830174.57
431030,202311,44,34,10,44881.7,13200,58081.7
431033,202311,575,274,301,361722.46,397360.19,759082.65
431036,202311,10,7,3,9240.73,3960,13200.73
431040,202311,163,110,53,145204.85,69963.19,215168.04
431041,202311,47,30,17,39600,22440.53,62040.53
431043,202311,42,25,17,33002.72,22440.32,55443.04
431046,202311,12,9,3,11880.78,3960.44,15841.22
431050,202311,222,142,80,187445.67,105600.44,293046.11
431053,202311,89,50,39,66005.19,51485.18,117490.37
431055,202311,70,45,25,59400,33000.08,92400.08
431057,202311,21,21,0,27720,,27720.0
431060,202311,1741,1104,637,1457323.04,843497.59,2300820.63
431065,202311,23,13,10,17160,13200,30360
431070,202311,67,58,9,76561.97,11880.67,88442.64
431075,202311,10,9,1,11881.79,1320,13201.79
431080,202311,142,80,62,105609.01,81842.21,187451.22
431085,202311,40,36,4,47521.45,5280,52801.45
431087,202311,20,16,4,21120.27,5280.8,26401.07
431090,202311,47,36,11,47520.42,14520,62040.42
431100,202311,1417,833,584,1100938.75,770917.32,1871856.07
431110,202311,233,146,87,192732.55,114843.06,307575.61
431112,202311,33,23,10,30362.51,13200.78,43563.29
431113,202311,29,17,12,22440.91,15840.8,38281.71
431115,202311,156,113,43,149167.54,56760,205927.54
431120,202311,661,394,267,520103.51,352448.97,872552.48
431123,202311,5,5,0,6600.74,,6600.74
431125,202311,102,91,11,120120.34,14520,134640.34
431127,202311,7,5,2,6600,2640,9240
431130,202311,765,496,269,654748.34,356408.71,1011157.05
431140,202311,926,653,273,861991.81,360367.37,1222359.18
431142,202311,17,15,2,19801.98,2640,22441.98
431150,202311,219,151,68,199331.61,89761.51,289093.12
431160,202311,42,37,5,48840.54,6600.6,55441.14
431162,202311,5,5,0,6601.09,,6601.09
431164,202311,8,6,2,7920,2640,10560
431170,202311,123,85,38,112203.85,50160,162363.85
431171,202311,80,44,36,58080,47520,105600
431173,202311,9,8,1,11881.71,1320.8,13202.51
431175,202311,217,115,102,151805.38,134644.21,286449.59
431177,202311,128,85,43,112210.26,56763.38,168973.64
431179,202311,21,15,6,19800.11,7920,27720.11
431180,202311,441,273,168,361691.46,223081.48,584772.94
431190,202311,75,55,20,72603.64,26400.2,99003.84
431198,202311,84,61,23,80385.81,30360.67,110746.48
431200,202311,24,18,6,23760,7920,31680
431205,202311,24,23,1,30361.67,1320,31681.67
431210,202311,117,71,46,93723.43,60722.38,154445.81
431213,202311,31,26,5,34322.86,6602.92,40925.78
431215,202311,27,25,2,33000.53,2640,35640.53
431217,202311,7,6,1,7921.15,1320,9241.15
431220,202311,72,59,13,77881.73,17160.34,95042.07
431225,202311,182,109,73,143880.05,96360,240240.05
431230,202311,109,84,25,110886.39,33001.2,143887.59
431235,202311,6,4,2,5280,2640,7920
431237,202311,22,18,4,23760.67,5280.2,29040.87
431238,202311,17,12,5,15840.86,6601.14,22442.00
431240,202311,1143,713,430,941242.38,567630.76,1508873.14
431242,202311,46,44,2,58082.07,2640,60722.07
431244,202311,44,34,10,44882.62,13200.47,58083.09
431245,202311,60,45,15,59401.5,19801.47,79202.97
431247,202311,19,11,8,14520,10561.3,25081.3
431250,202311,338,172,166,227057.22,219131.81,446189.03
431260,202311,55,45,10,59400.46,13200,72600.46
431261,202311,25,18,7,23760.37,9240.34,33000.71
431262,202311,13,11,2,14520.07,2640,17160.07
431265,202311,154,92,62,121442.18,81840.44,203282.62
431267,202311,21,16,5,21120.88,6600.5,27721.38
431270,202311,357,271,86,357735.98,113524.89,471260.87
431275,202311,40,36,4,47521.45,5280,52801.45
431280,202311,21,16,5,21120,6600,27720
431290,202311,30,27,3,35642.12,3960,39602.12
431295,202311,4,1,3,1320,3960,5280
431300,202311,26,20,6,26400.7,7920,34320.7
431301,202311,8,8,0,10560.34,,10560.34
431303,202311,65,40,25,52801.7,33000.2,85801.9
431306,202311,260,131,129,172926.78,171603.77,344530.55
431308,202311,8,7,1,9240.6,1320,10560.6
431310,202311,62,48,14,63362.3,18480,81842.3
431320,202311,290,180,110,237603.73,146520.82,384124.55
431330,202311,235,165,70,217806.73,92402.14,310208.87
431333,202311,30,24,6,31680.34,7920.33,39600.67
431335,202311,11,8,3,10560.18,3960,14520.18
431337,202311,491,239,252,315496.32,332656.48,648152.80
431339,202311,25,20,5,26401.44,6600,33001.44
431340,202311,3626,1989,1637,2629389.88,2164900.6,4794290.48
431342,202311,42,27,15,35641.54,19800.26,55441.80
431344,202311,30,30,0,39601.09,,39601.09
431346,202311,5,4,1,5280,1320,6600
431349,202311,32,30,2,39600,2640,42240
431350,202311,1119,641,478,846205.64,633647.16,1479852.80
431360,202311,61,43,18,56760,23760.67,80520.67
431365,202311,411,180,231,237615.55,307566.12,545181.67
431370,202311,1337,763,574,1007210.71,757697.74,1764908.45
431380,202311,109,95,14,125405.02,18480,143885.02
431390,202311,543,308,235,406572.01,310203.98,716775.99
431395,202311,346,154,192,203294.01,253450.57,456744.58
431400,202311,38,23,15,30361.35,19800,50161.35
431402,202311,92,66,26,87124.77,34321.32,121446.09
431403,202311,33,23,10,30360,13200.84,43560.84
431405,202311,859,518,341,683803.79,450143.66,1133947.45
431406,202311,39,32,7,42242.92,9240,51482.92
431407,202311,51,40,11,52800.55,14520.44,67320.99
431410,202311,3910,2395,1515,3161632.83,2002550.12,5164182.95
431413,202311,15,12,3,17161.61,3960.36,21121.97
431415,202311,81,61,20,80527.12,26402.19,106929.31
431417,202311,25,14,11,18480,14520,33000
431420,202311,407,267,140,352460.01,184806.24,537266.25
431430,202311,71,33,38,43561.61,50160,93721.61
431440,202311,10675,7188,3487,9492883.22,4607119.78,14100003.00
431442,202311,27,14,13,18480,17160.43,35640.43
431445,202311,31,29,2,38280,2640,40920
431446,202311,5,5,0,6600.62,,6600.62
431447,202311,91,69,22,91082.34,29040,120122.34
431449,202311,68,56,12,73921.31,15840,89761.31
431450,202311,449,293,156,386769.96,205920.9,592690.86
431454,202311,13,8,5,10560,6601.43,17161.43
431455,202311,49,37,12,48845.23,15841.55,64686.78
431460,202311,539,365,174,483161.94,229690.2,712852.14
431470,202311,147,109,38,143884.07,50161.12,194045.19
431475,202311,12,10,2,13200,2640.35,15840.35
431477,202311,42,26,16,34321.3,21120,55441.3
431478,202311,7,7,0,9240.96,,9240.96
431480,202311,821,503,318,663997.07,419778.74,1083775.81
431490,202311,36205,20557,15648,27150483.59,20683093.83,47833577.42
431500,202311,79,56,23,75243.49,30361.08,105604.57
431505,202311,32,24,8,31680.74,10560.43,42241.17
431507,202311,9,8,1,10562.53,1320,11882.53
431510,202311,248,180,68,237608.48,89760.55,327369.03
431513,202311,20,19,1,25081.14,1320,26401.14
431514,202311,8,5,3,6600,3960,10560
431515,202311,96,81,15,106922.46,19800,126722.46
431517,202311,10,8,2,10560.84,2640,13200.84
431520,202311,42,33,9,43561.55,11880,55441.55
431530,202311,1506,665,841,879152.54,1110145.03,1989297.57
431531,202311,24,22,2,29041.57,2640,31681.57
431532,202311,41,29,12,38280,15840,54120
431535,202311,31,18,13,23763.1,17160.4,40923.5
431540,202311,152,122,30,161042.48,39601.35,200643.83
431545,202311,12,9,3,11880.41,3960,15840.41
431550,202311,396,205,191,270621.26,253450.97,524072.23
431555,202311,19,16,3,21120,3960,25080
431560,202311,5700,3817,1883,5044108.93,2492320.88,7536429.81
431570,202311,990,535,455,706238.69,600624.51,1306863.20
431575,202311,60,38,22,50161.17,29041.28,79202.45
431580,202311,88,66,22,87120.44,29040,116160.44
431590,202311,159,134,25,176881.47,33000.5,209881.97
431595,202311,17,15,2,19803.7,2640,22443.7
431600,202311,279,164,115,216496.56,151807.61,368304.17
431610,202311,123,91,32,120128.07,42240.07,162368.14
431620,202311,35,28,7,36961.44,9240,46201.44
431630,202311,131,103,28,135962.97,36960,172922.97
431640,202311,1410,870,540,1148448.99,712819.66,1861268.65
431642,202311,34,29,5,38280,6600,44880
431643,202311,46,19,27,25080.71,35643.45,60724.16
431645,202311,361,216,145,285123.89,191401.9,476525.79
431647,202311,15,14,1,18480.34,1320,19800.34
431650,202311,34,20,14,26400,19800,46200
431660,202311,263,168,95,221764.66,125400.44,347165.10
431670,202311,251,110,141,145204.1,186123.48,331327.58
431673,202311,14,12,2,15840,2640,18480
431675,202311,29,22,7,29040.94,9240,38280.94
431680,202311,1350,974,376,1288422.96,496346.47,1784769.43
431690,202311,5735,3332,2403,4400940.04,3173450.25,7574390.29
431695,202311,15,10,5,13201.34,6600,19801.34
431697,202311,7,4,3,5280.8,3960.44,9241.24
431700,202311,210,156,54,205923.44,71280.58,277204.02
431710,202311,4652,1984,2668,2624326.63,3521950.82,6146277.45
431720,202311,1398,868,530,1145145.81,699621.21,1844767.02
431725,202311,3,1,2,1320,2640,3960
431730,202311,1347,871,476,1151155.96,629687.73,1780843.69
431740,202311,1392,677,715,896327.3,945158.39,1841485.69
431750,202311,1968,1301,667,1717419.97,880470.67,2597890.64
431755,202311,5,4,1,5280.2,1320.49,6600.69
431760,202311,1083,694,389,917481.41,514764.91,1432246.32
431770,202311,437,284,153,374891.63,201960.71,576852.34
431775,202311,27,19,8,25082.66,10560.34,35643.00
431780,202311,613,370,243,488403.54,320761.46,809165.00
431790,202311,148,117,31,154445.46,40921.59,195367.05
431795,202311,14,12,2,15840,2640,18480
431800,202311,3399,1780,1619,2352362.98,2139840.87,4492203.85
431805,202311,20,16,4,21120,5280,26400
431810,202311,608,395,213,521432.8,282483.98,803916.78
431820,202311,389,217,172,286450.18,227041.15,513491.33
431830,202311,2628,1612,1016,2127836.83,1341163.68,3469000.51
431840,202311,558,360,198,475239.94,262689.06,737929.00
431842,202311,39,31,8,40920,10560,51480
431843,202311,9,7,2,9240.99,2640,11880.99
431844,202311,19,14,5,18480.2,6600,25080.2
431845,202311,27,25,2,33000,2640.44,35640.44
431846,202311,30,25,5,33001.14,6600,39601.14
431848,202311,14,11,3,14520.79,3960,18480.79
431849,202311,8,7,1,9240.8,1320,10560.8
431850,202311,905,709,196,937269.34,260055.33,1197324.67
431860,202311,124,80,44,105603.71,58080.44,163684.15
431861,202311,5,1,4,1320,5280.78,6600.78
431862,202311,68,48,20,63360.91,26400.86,89761.77
431870,202311,4440,2638,1802,3486437.45,2381454.18,5867891.63
431880,202311,1098,771,327,1017762.26,432970.03,1450732.29
431890,202311,1328,765,563,1011158.98,745812.24,1756971.22
431900,202311,209,135,74,178204.05,97680,275884.05
431910,202311,51,40,11,52800.8,14521.34,67322.14
431912,202311,58,41,17,54219.1,22442.07,76661.17
431915,202311,163,126,37,166322.27,48840,215162.27
431920,202311,169,119,50,157086.09,66000.44,223086.53
431930,202311,87,71,16,93722.64,21120.4,114843.04
431935,202311,6,5,1,6600,1320,7920
431936,202311,4,4,0,5280.5,,5280.5
431937,202311,23,18,5,23760,6600.17,30360.17
431940,202311,493,341,152,450146.03,200644.37,650790.40
431950,202311,530,332,198,438281.9,261381.71,699663.61
431960,202311,820,454,366,599317.43,483128.19,1082445.62
431970,202311,65,59,6,77884.03,7920.44,85804.47
431971,202311,6,5,1,6600,1320,7920
431973,202311,21,17,4,22441.1,5280,27721.1
431975,202311,12,11,1,14520,1320,15840
431980,202311,225,131,94,172925.65,124081.65,297007.30
431990,202311,1116,625,491,825088.76,649502.64,1474591.40
432000,202311,2328,1287,1041,1700313.62,1374223.08,3074536.70
432010,202311,269,175,94,231005.13,124081.45,355086.58
432020,202311,210,177,33,233650.19,43560.22,277210.41
432023,202311,19,16,3,21120,3960,25080
432026,202311,68,60,8,80521.83,10560,91081.83
432030,202311,56,26,30,34320.98,39600,73920.98
432032,202311,16,13,3,17160.47,3960.67,21121.14
432035,202311,92,70,22,92401.91,29040.4,121442.31
432040,202311,91,65,26,85804.58,34320.78,120125.36
432045,202311,4,4,0,5280.34,,5280.34
432050,202311,85,53,32,69964.24,42240,112204.24
432055,202311,148,104,44,137285,58081.43,195366.43
432057,202311,7,4,3,5280.13,3960,9240.13
432060,202311,30,25,5,33001.36,6600,39601.36
432065,202311,33,28,5,36960,6600,43560
432067,202311,85,75,10,99002.11,13200,112202.11
432070,202311,418,335,83,442222.61,110882.55,553105.16
432080,202311,918,650,268,858070.64,355096.73,1213167.37
432085,202311,26,22,4,29040.21,5280,34320.21
432090,202311,295,197,98,260049,129360.6,389409.6
432100,202311,186,121,65,159724.29,85800.75,245525.04
432110,202311,614,405,209,534627.06,275886.58,810513.64
432120,202311,1196,687,509,906883.1,673224.58,1580107.68
432130,202311,582,412,170,543864.04,224405.17,768269.21
432132,202311,21,19,2,25080.17,2640,27720.17
432135,202311,85,65,20,85803.08,26400,112203.08
432140,202311,292,218,74,287769.91,97681.52,385451.43
432143,202311,252,155,97,204610.78,128045.71,332656.49
432145,202311,355,253,102,333971.98,134641.1,468613.08
432146,202311,19,16,3,21121.55,3960,25081.55
432147,202311,104,64,40,84480,52800,137280
432149,202311,13,12,1,15840.86,1320,17160.86
432150,202311,1298,831,467,1098323.34,616474.34,1714797.68
432160,202311,2330,1193,1137,1577492.96,1500904.93,3078397.89
432162,202311,8,4,4,5280,5280,10560
432163,202311,17,12,5,15840,6600,22440
432166,202311,145,102,43,134988.55,56765.91,191754.46
432170,202311,262,139,123,183495.12,162364.81,345859.93
432180,202311,609,397,212,525367.3,281161.67,806528.97
432183,202311,23,20,3,26403.94,3960.34,30364.28
432185,202311,84,70,14,92405.08,18480.81,110885.89
432190,202311,593,354,239,467286.06,316802.77,784088.83
432195,202311,101,80,21,105601.74,27720.4,133322.14
432200,202311,495,309,186,407902.2,245529.39,653431.59
432210,202311,127,74,53,97684.6,69960.44,167645.04
432215,202311,33,31,2,40921.83,2640,43561.83
432218,202311,21,21,0,27720.84,,27720.84
432220,202311,714,352,362,464665.72,477853.47,942519.19
432225,202311,21,16,5,21122.81,6600,27722.81
432230,202311,134,88,46,116165.01,60720.44,176885.45
432232,202311,35,31,4,40920.4,5280,46200.4
432234,202311,5,3,2,3960,2640.8,6600.8
432235,202311,2,2,0,2640,,2640.0
432237,202311,26,19,7,25081.9,9240,34321.9
432240,202311,5019,2809,2210,3709421.29,2919961.58,6629382.87
432250,202311,1322,900,422,1188034.77,557047.07,1745081.84
432252,202311,51,46,5,60720,6600,67320
432253,202311,81,60,21,79205.6,27721.49,106927.09
432254,202311,33,17,16,22440,21120.8,43560.8
432255,202311,11,10,1,13200,1320,14520
432260,202311,984,786,198,1038889.12,262685.09,1301574.21
432270,202311,252,190,62,250834.06,81852.26,332686.32
432280,202311,189,141,48,186130.97,63363.03,249494.00
432285,202311,2,2,0,2640,,2640.0
432290,202311,61,49,12,64681.66,15840,80521.66
432300,202311,5920,3229,2691,4265018.82,3553653.18,7818672.00
432310,202311,146,122,24,161044.11,31680.44,192724.55
432320,202311,24,18,6,23760,7920,31680
432330,202311,17,11,6,14520,7920,22440
432335,202311,10,7,3,9240.67,3960,13200.67
432340,202311,36,29,7,38281.04,9240,47521.04
432345,202311,138,94,44,124083.54,58080,182163.54
432350,202311,23,22,1,30360,1320,31680
432360,202311,6,5,1,6601.04,1320,7921.04
432370,202311,26,26,0,34322.6,,34322.6
432375,202311,32,30,2,39600.87,2640,42240.87
432377,202311,7,7,0,9240.28,,9240.28
432380,202311,264,127,137,167648.36,182166.66,349815.02
500020,202311,339,173,166,228376.42,219128.32,447504.74
500025,202311,162,77,85,101645.59,112203.21,213848.80
500060,202311,1706,1103,603,1456092.55,797348.51,2253441.06
500070,202311,854,431,423,568967.97,558405.88,1127373.85
500080,202311,160,133,27,175576.07,36964.35,212540.42
500085,202311,174,127,47,167648.3,62041.61,229689.91
500090,202311,433,204,229,269292.78,302296.32,571589.10
500100,202311,753,391,362,516165.07,477862.16,994027.23
500110,202311,2545,1271,1274,1679165.57,1687096.39,3366261.96
500124,202311,314,158,156,208574.12,205929.87,414503.99
500150,202311,335,137,198,180855.94,262708.96,443564.90
500190,202311,640,430,210,568977.35,277217.27,846194.62
500200,202311,226,183,43,241584.3,56762.39,298346.69
500210,202311,1902,603,1299,797337.63,1716113.63,2513451.26
500215,202311,218,124,94,163698.73,124088.9,287787.63
500220,202311,815,506,309,667987.1,407917.24,1075904.34
500230,202311,278,159,119,209900.06,157090.38,366990.44
500240,202311,725,448,277,591408.4,365663.97,957072.37
500260,202311,644,264,380,349829.06,501636.35,851465.41
500270,202311,35267,15668,19599,20693477.17,25900422.43,46593899.60
500280,202311,218,80,138,105604.25,182162.3,287766.55
500290,202311,1308,825,483,1089084.81,641566.11,1730650.92
500295,202311,553,366,187,483154.91,246858.25,730013.16
500310,202311,126,41,85,54121.52,112203.86,166325.38
500315,202311,959,524,435,691686.29,574206.91,1265893.20
500320,202311,4217,1985,2232,2621784.37,2947746.65,5569531.02
500325,202311,1048,593,455,784161.69,600666.55,1384828.24
500330,202311,1717,861,856,1136543.73,1131331.14,2267874.87
500345,202311,352,243,109,320791.66,143888.3,464679.96
500348,202311,287,175,112,231017.22,147847.88,378865.10
500350,202311,111,52,59,68647.94,77889.07,146537.01
500370,202311,6589,3077,3512,4066208.95,4640157.36,8706366.31
500375,202311,402,263,139,347185.36,183491.85,530677.21
500380,202311,756,417,339,550485.9,447504.28,997990.18
500390,202311,92,38,54,50161.93,71283.61,121445.54
500400,202311,248,144,104,190097.19,137285.52,327382.71
500410,202311,469,215,254,283830.2,335317.93,619148.13
500430,202311,677,412,265,543875.4,349817.35,893692.75
500440,202311,219,128,91,168966.78,120123.93,289090.71
500450,202311,489,213,276,281174.55,364333.39,645507.94
500460,202311,316,171,145,225740.87,191414.74,417155.61
500470,202311,492,345,147,456747.5,195365.27,652112.77
500480,202311,128,74,54,97686.86,71286.73,168973.59
500490,202311,110,52,58,68642.47,76563.59,145206.06
500500,202311,1680,631,1049,834299.8,1386104.89,2220404.69
500510,202311,42,36,6,47529.6,7921.45,55451.05
500515,202311,135,89,46,117492.21,60726.11,178218.32
500520,202311,340,171,169,225738.22,223093.63,448831.85
500525,202311,103,53,50,69966.7,66002.57,135969.27
500540,202311,1017,448,569,592744.8,752475.89,1345220.69
500560,202311,963,541,422,714180.83,557077.57,1271258.40
500568,202311,1305,581,724,768304.72,955737.98,1724042.70
500570,202311,1361,779,582,1028342.33,773559.37,1801901.70
500580,202311,321,177,144,233666.98,190098.43,423765.41
500600,202311,456,213,243,281189.94,320779.34,601969.28
500620,202311,1180,834,346,1100960.38,459390.34,1560350.72
500625,202311,96,70,26,92401.47,34320.79,126722.26
500627,202311,56,26,30,34321.99,39602.55,73924.54
500630,202311,1764,1047,717,1382913.48,946504.25,2329417.73
500635,202311,541,318,223,419765.71,294362.93,714128.64
500640,202311,381,206,175,271954.94,231029.98,502984.92
500660,202311,6904,2452,4452,3238225.35,5877080.81,9115306.16
500690,202311,718,259,459,341908.49,605910.76,947819.25
500710,202311,458,223,235,294381.68,311544,605925.68
500720,202311,1080,599,481,793373.65,634941.18,1428314.83
500730,202311,143,89,54,117504.56,71291.95,188796.51
500740,202311,1069,471,598,621772.61,790744.99,1412517.60
500750,202311,230,86,144,113524.4,190087.7,303612.1
500755,202311,125,93,32,122782.48,42244.85,165027.33
500769,202311,837,468,369,617801.6,487107.42,1104909.02
500770,202311,484,261,223,344547.71,295696.45,640244.16
500780,202311,143,94,49,124108.41,64688.21,188796.62
500790,202311,1237,600,637,792072.08,842198.16,1634270.24
500793,202311,323,169,154,223101.82,204624.29,427726.11
500795,202311,223,142,81,187452.47,106927.66,294380.13
500797,202311,50,37,13,48842.71,17160.05,66002.76
500800,202311,486,206,280,271942.34,369619.33,641561.67
500830,202311,2693,1379,1314,1821784.22,1734591.78,3556376.00
500840,202311,116,84,32,110902.37,42244.89,153147.26
510010,202311,178,100,78,132000.44,104281.26,236281.70
510020,202311,585,291,294,384161.65,389429.69,773591.34
510025,202311,2021,1163,858,1535303.89,1132661.19,2667965.08
510030,202311,697,375,322,497713.3,426420.93,924134.23
510035,202311,136,72,64,95041.53,84484.8,179526.33
510040,202311,440,206,234,271941.59,308898.74,580840.33
510050,202311,402,208,194,274574.81,257409.55,531984.36
510060,202311,151,71,80,93726.6,106923.85,200650.45
510080,202311,267,119,148,157087.46,195363.2,352450.66
510100,202311,69,29,40,38283.85,52803.87,91087.72
510120,202311,34,20,14,26406.28,18481.36,44887.64
510125,202311,429,274,155,361707.52,204612.78,566320.30
510130,202311,570,338,232,447510.87,307578.8,755089.67
510140,202311,507,177,330,234977.27,435624.61,670601.88
510160,202311,116,50,66,66006.13,87131.67,153137.80
510170,202311,875,515,360,679853.2,475241.32,1155094.52
510180,202311,3300,1502,1798,1982825.44,2376121.68,4358947.12
510185,202311,46,24,22,31682.65,29040.71,60723.36
510190,202311,294,113,181,149166.82,240250.61,389417.43
510250,202311,3078,1857,1221,2452716.75,1614440.41,4067157.16
510260,202311,184,132,52,175587.63,68649.78,244237.41
510263,202311,536,303,233,399995.64,307583.85,707579.49
510267,202311,708,402,306,530701.25,403957.71,934658.96
510268,202311,89,44,45,58082.99,59403.82,117486.81
510269,202311,87,40,47,52801.74,62041.76,114843.50
510270,202311,409,195,214,257419.64,283810.95,541230.59
510279,202311,245,177,68,233652.82,89766.28,323419.10
510285,202311,201,84,117,110885.76,154445.09,265330.85
510300,202311,582,311,271,410568.3,359082.33,769650.63
510305,202311,229,99,130,130685.91,171603.22,302289.13
510310,202311,118,58,60,76562.49,79201.99,155764.48
510320,202311,905,573,332,756451.21,438290.75,1194741.96
510325,202311,486,213,273,281174.66,360372.61,641547.27
510330,202311,517,290,227,382836.47,299655.96,682492.43
510335,202311,752,453,299,598014.72,396030.55,994045.27
510336,202311,60,42,18,55442.99,23762.15,79205.14
510337,202311,115,48,67,63361.28,88442.98,151804.26
510340,202311,21422,9236,12186,12198279.76,16099017.73,28297297.49
510343,202311,67,53,14,69960.05,18480,88440.05
510345,202311,165,100,65,132011.95,85807.07,217819.02
510350,202311,727,389,338,513527.6,447513.98,961041.58
510360,202311,233,144,89,190099.67,118813.74,308913.41
510370,202311,185,82,103,108240.07,135962.49,244202.56
510380,202311,82,60,22,79200,29040,108240
510385,202311,58,32,26,42241.52,34320.33,76561.85
510390,202311,102,49,53,64682.28,69963.52,134645.80
510395,202311,60,43,17,56760.96,22440,79200.96
510410,202311,944,611,333,806602.69,439599.42,1246202.11
510420,202311,601,298,303,393384.31,402616.7,796001.01
510450,202311,57,34,23,44880.44,30360.44,75240.88
510452,202311,65,34,31,44881.68,40922.27,85803.95
510454,202311,58,26,32,34320.67,42241.95,76562.62
510455,202311,124,74,50,97687.01,66004.26,163691.27
510460,202311,221,102,119,134653.34,157088.97,291742.31
510480,202311,846,488,358,644232.33,472612.86,1116845.19
510490,202311,356,175,181,231010.03,238927.21,469937.24
510500,202311,255,190,65,250808.57,85802.78,336611.35
510510,202311,967,563,404,743234.92,534636.51,1277871.43
510515,202311,1452,775,677,1023058.92,893692.15,1916751.07
510517,202311,295,132,163,174250.47,215169.05,389419.52
510520,202311,254,160,94,211222.16,124093.29,335315.45
510523,202311,129,102,27,134641.53,35640,170281.53
510525,202311,972,604,368,798650.11,485793.77,1284443.88
510530,202311,34,15,19,19800,25080.84,44880.84
510550,202311,267,123,144,162379.88,191420.46,353800.34
510558,202311,343,171,172,225727.72,227042.16,452769.88
510560,202311,427,257,170,339270.11,225734.85,565004.96
510562,202311,746,532,214,702338.77,282502.57,984841.34
510590,202311,759,359,400,473921.94,528043.7,1001965.64
510600,202311,224,123,101,162377.76,133329.47,295707.23
510610,202311,245,112,133,147845.11,175566.07,323411.18
510615,202311,245,117,128,155769.53,168968.35,324737.88
510617,202311,28,12,16,15840.27,21122.28,36962.55
510618,202311,133,71,62,93722.3,81843.81,175566.11
510619,202311,88,59,29,77886.46,38281.34,116167.80
510620,202311,168,91,77,120122.97,101642.04,221765.01
510621,202311,183,123,60,162369.47,79201.54,241571.01
510622,202311,565,297,268,392095.5,353787.12,745882.62
510623,202311,313,210,103,277222.23,135967.09,413189.32
510624,202311,119,56,63,73924.96,83165.06,157090.02
510625,202311,599,362,237,477918.58,312875.77,790794.35
510626,202311,131,75,56,99006.32,75243.65,174249.97
510627,202311,110,74,36,97684.07,47521.31,145205.38
510628,202311,181,113,68,149166.3,89760,238926.3
510629,202311,332,208,124,274564.88,163706.08,438270.96
510630,202311,514,269,245,355113.53,323425.02,678538.55
510631,202311,25,10,15,13200.86,19801.16,33002.02
510637,202311,386,224,162,295701.39,215178.91,510880.30
510642,202311,1369,749,620,990075.49,821080.28,1811155.77
510645,202311,13,5,8,6600,10560.67,17160.67
510650,202311,1313,842,471,1111641.3,621781.84,1733423.14
510665,202311,110,51,59,67330.74,77887.05,145217.79
510670,202311,60,36,24,47523.98,33000.55,80524.53
510675,202311,1223,783,440,1034994.72,580850.52,1615845.24
510677,202311,384,211,173,278542.93,228376.01,506918.94
510680,202311,98,63,35,83173.35,46205.33,129378.68
510682,202311,217,104,113,137282.27,149162.93,286445.20
510685,202311,66,45,21,59403.73,27720.86,87124.59
510700,202311,648,376,272,496406.4,359091.48,855497.88
510704,202311,1511,775,736,1025756.09,972922.96,1998679.05
510706,202311,183,93,90,122768.15,118807.2,241575.35
510710,202311,485,348,137,459394.17,180848.68,640242.85
510715,202311,59,40,19,52801.42,25080.76,77882.18
510718,202311,269,121,148,159734.92,195375.43,355110.35
510719,202311,60,30,30,39600.71,39601.91,79202.62
510720,202311,200,142,58,187456.18,76567.86,264024.04
510724,202311,80,31,49,40921.11,64680.95,105602.06
510726,202311,68,36,32,47522.82,42245.11,89767.93
510729,202311,15,5,10,6601.95,13202.04,19803.99
510730,202311,503,258,245,340579.54,323416.34,663995.88
510735,202311,127,48,79,63362.36,104283.5,167645.86
510740,202311,28,17,11,22443.69,14523.07,36966.76
510757,202311,37,30,7,39602.46,9240.9,48843.36
510760,202311,8639,4403,4236,5816443.24,5597234.14,11413677.38
510770,202311,793,359,434,473919.85,574242.86,1048162.71
510774,202311,19,8,11,10560.96,14520.67,25081.63
510775,202311,132,107,25,141242.79,33000,174242.79
510776,202311,42,16,26,21121.46,34321.03,55442.49
510777,202311,197,87,110,114840,145200,260040
510779,202311,38,24,14,31683.52,18482.55,50166.07
510780,202311,303,161,142,212551.1,187457.67,400008.77
510785,202311,364,199,165,264030.43,217811.7,481842.13
510787,202311,237,119,118,157095.82,155771.43,312867.25
510788,202311,12,5,7,6600.8,9240,15840.8
510790,202311,3113,1605,1508,2118842.07,1991985.1,4110827.17
510792,202311,1234,686,548,907092.21,723426.22,1630518.43
510794,202311,129,70,59,92408.46,77885.3,170293.76
510795,202311,2598,1456,1142,1922020.03,1512784.57,3434804.60
510800,202311,208,112,96,147851.58,126725.44,274577.02
510805,202311,234,160,74,211207.76,97682.5,308890.26
510810,202311,110,44,66,58083.54,87124.12,145207.66
510820,202311,273,140,133,184828.5,175584.11,360412.61
510830,202311,92,50,42,66001.48,55440,121441.48
510835,202311,28,21,7,27720.4,9240,36960.4
510840,202311,10818,4907,5911,6484671.67,7815119.93,14299791.60
510850,202311,221,88,133,116164.31,176885.66,293049.97
510860,202311,464,236,228,311529.96,300969.18,612499.14
510880,202311,84,61,23,80522.82,30360,110882.82
510885,202311,75,41,34,54123.06,44881.6,99004.66
510890,202311,84,43,41,56762.22,54122.31,110884.53
510895,202311,203,121,82,159732.25,108243.09,267975.34
520005,202311,184,81,103,106924.47,135966.48,242890.95
520010,202311,373,171,202,225743.07,266678.61,492421.68
520013,202311,830,584,246,770928.24,324741.82,1095670.06
520015,202311,41,27,14,35640.92,18481,54121.92
520017,202311,95,62,33,81847.7,43565.13,125412.83
520020,202311,12,6,6,7921.08,7920.89,15841.97
520025,202311,3619,2003,1616,2644268.88,2136026.18,4780295.06
520030,202311,1023,537,486,709038.85,644203.1,1353241.95
520050,202311,65,49,16,64681.55,21121.01,85802.56
520055,202311,88,62,26,81840.2,34320.8,116161.0
520060,202311,214,144,70,190105.25,92410.65,282515.90
520080,202311,640,459,181,605895.34,238926.39,844821.73
520082,202311,20,12,8,15841.03,10560.78,26401.81
520085,202311,131,107,24,141240.52,31680.12,172920.64
520090,202311,92,67,25,88442.97,33001.49,121444.46
520110,202311,10710,4585,6125,6052895.04,8089708.02,14142603.06
520120,202311,12,9,3,11880,3960,15840
520130,202311,994,706,288,931971.4,380185.46,1312156.86
520140,202311,14091,7690,6401,10157552.91,8460798.92,18618351.83
520145,202311,73,40,33,52801.54,43561.33,96362.87
520150,202311,142,110,32,145221.52,42246.97,187468.49
520160,202311,49,32,17,42240.63,22440,64680.63
520170,202311,217,122,95,161061.09,125419.19,286480.28
520180,202311,227,112,115,149165.15,151805.5,300970.65
520215,202311,224,164,60,216487.82,79203.66,295691.48
520235,202311,98,73,25,96362.09,33000,129362.09
520250,202311,181,91,90,120127.3,118802.91,238930.21
520260,202311,143,91,52,120133.78,68651.19,188784.97
520280,202311,57,41,16,54121.19,21121.64,75242.83
520310,202311,41,20,21,26402.48,27721.98,54124.46
520320,202311,214,132,82,174254.9,108244.36,282499.26
520330,202311,946,531,415,700987.43,547863.41,1248850.84
520340,202311,319,184,135,242916.46,178221.23,421137.69
520350,202311,520,270,250,356428.12,331347.57,687775.69
520355,202311,116,71,45,93726.47,59404.31,153130.78
520357,202311,43,32,11,42240,14520.2,56760.2
520360,202311,26,9,17,11880.89,22440.56,34321.45
520380,202311,153,86,67,113524.27,88442.58,201966.85
520390,202311,246,111,135,146547.3,179546.8,326094.1
520393,202311,22,17,5,22440.56,6600.67,29041.23
520396,202311,83,60,23,79200.56,30360.34,109560.90
520400,202311,226,141,85,186135.18,112207.2,298342.38
520410,202311,224,123,101,162374.63,133328.24,295702.87
520420,202311,26,19,7,25080.87,9240.64,34321.51
520425,202311,266,124,142,163697.93,188780.62,352478.55
520430,202311,599,283,316,373581.88,417132.5,790714.38
520440,202311,771,567,204,749825.15,269306.05,1019131.20
520450,202311,2508,1118,1390,1475896.24,1834937,3310833.24
520455,202311,82,48,34,63365.52,44889.43,108254.95
520460,202311,53,35,18,46204.85,23761.57,69966.42
520465,202311,46,40,6,52801.31,7920,60721.31
520470,202311,513,313,200,413192.06,264012.11,677204.17
520480,202311,78,52,26,68650.03,34326.46,102976.49
520485,202311,115,47,68,63367.17,89769.06,153136.23
520490,202311,612,452,160,596692.99,211217.47,807910.46
520495,202311,184,112,72,147844.17,95040.88,242885.05
520500,202311,274,225,49,297012.74,64683.38,361696.12
520505,202311,196,115,81,153123.81,106920.88,260044.69
520510,202311,2390,1135,1255,1499664.76,1658037.82,3157702.58
520520,202311,75,49,26,64682.05,34320,99002.05
520530,202311,220,176,44,232368.32,58089.08,290457.40
520540,202311,900,618,282,815804.55,372259.85,1188064.40
520545,202311,175,106,69,139936.69,91090.66,231027.35
520547,202311,88,49,39,64685.72,51486.27,116171.99
520549,202311,1788,898,890,1186780.64,1174905.92,2361686.56
520551,202311,364,197,167,260048.83,220444.4,480493.23
520552,202311,66,50,16,66003.78,21122.23,87126.01
520570,202311,17,13,4,17160,5280,22440
520580,202311,307,193,114,254925.17,150495.16,405420.33
520590,202311,165,92,73,121449.65,96366.72,217816.37
520620,202311,1430,668,762,884480.57,1005921.15,1890401.72
520630,202311,57,30,27,39600,35642,75242
520640,202311,420,250,170,331354.11,225736.54,557090.65
520650,202311,81,37,44,48840.88,58081.35,106922.23
520660,202311,48,26,22,34321.75,29041.08,63362.83
520670,202311,46,34,12,44880.74,15840,60720.74
520680,202311,29,17,12,22442.76,15841.17,38283.93
520690,202311,42,11,31,14522.17,40921.86,55444.03
520710,202311,38,27,11,35640,14520,50160
520725,202311,212,157,55,207264.35,72609.47,279873.82
520735,202311,69,42,27,55441.17,35642.35,91083.52
520740,202311,493,249,244,328707.92,322105.24,650813.16
520750,202311,46,27,19,35640,25080,60720
520753,202311,87,64,23,84481.72,30360,114841.72
520760,202311,113,78,35,102967.09,46203.21,149170.30
520780,202311,287,220,67,290434.47,88448.05,378882.52
520790,202311,152,94,58,124080.83,76561.61,200642.44
520800,202311,3864,2227,1637,2939928.52,2163676.94,5103605.46
520810,202311,143,111,32,146532.27,42244.58,188776.85
520815,202311,8,6,2,7921.92,2640,10561.92
520830,202311,137,96,41,128058.05,54128.44,182186.49
520840,202311,447,287,160,378845.34,211200.78,590046.12
520850,202311,119,68,51,89772.12,67324.44,157096.56
520860,202311,2063,1299,764,1714825.44,1008544.89,2723370.33
520870,202311,39099,17800,21299,23510469.24,28131632.91,51642102.15
520880,202311,1529,817,712,1079875.19,941233.89,2021109.08
520890,202311,926,607,319,801303.38,421115.75,1222419.13
520910,202311,1062,545,517,722119.37,682513.13,1404632.50
520915,202311,97,63,34,83172.98,44884.22,128057.20
520920,202311,591,284,307,374912.43,405270.89,780183.32
520929,202311,18,16,2,21120.95,2640.44,23761.39
520940,202311,69,52,17,68644.92,22442.16,91087.08
520945,202311,21,13,8,17160,10560.84,27720.84
520960,202311,52,31,21,40921.79,27720,68641.79
520970,202311,500,291,209,385464.85,275904.7,661369.55
520980,202311,94,68,26,89760,34320,124080
520990,202311,464,328,136,432979.22,179526.75,612505.97
520993,202311,124,64,60,84491.36,79213.65,163705.01
520995,202311,294,167,127,220465.95,167657.54,388123.49
521000,202311,1801,978,823,1292400.55,1087761.38,2380161.93
521010,202311,699,377,322,497681.21,425091.37,922772.58
521015,202311,18,13,5,17160,6600.11,23760.11
521020,202311,1630,1144,486,1510219.75,642901.86,2153121.61
521030,202311,91,65,26,85801.95,34320.44,120122.39
521040,202311,1145,789,356,1041553.8,469955.63,1511509.43
521056,202311,63,41,22,54122.69,29040.22,83162.91
521060,202311,134,86,48,113528.57,63365.03,176893.60
521080,202311,312,250,62,330043.14,81854.86,411898.00
521090,202311,670,471,199,621751.32,262703.49,884454.81
521100,202311,307,213,94,281180.55,124087.47,405268.02
521120,202311,1209,859,350,1133963.78,462027.14,1595990.92
521130,202311,332,239,93,315514.88,122774.78,438289.66
521140,202311,202,114,88,150496.35,117488.46,267984.81
521150,202311,2803,1176,1627,1553825.21,2147856.78,3701681.99
521160,202311,26,11,15,14520.99,19803.26,34324.25
521170,202311,234,129,105,170288.47,138607.87,308896.34
521180,202311,1365,853,512,1131342.18,677229.33,1808571.51
521190,202311,2972,1257,1715,1659411.85,2266636.15,3926048.00
521200,202311,69,49,20,64680.98,26400,91080.98
521205,202311,26,18,8,23760.8,10560,34320.8
521210,202311,151,93,58,122778.51,76571.04,199349.55
521220,202311,815,554,261,731344.88,344538.63,1075883.51
521225,202311,17,12,5,15845.93,6601.51,22447.44
521230,202311,117,82,35,108255.62,47523.82,155779.44
521250,202311,7248,4030,3218,5325667.69,4256217.99,9581885.68
521260,202311,53,23,30,30360.2,39600.5,69960.7
521270,202311,133,101,32,133322.1,42240.11,175562.21
521280,202311,442,269,173,355108.83,228382.46,583491.29
521290,202311,34,19,15,25081.69,19801.05,44882.74
521295,202311,111,74,37,97691.36,48842.95,146534.31
521300,202311,280,167,113,220459.35,149257.75,369717.10
521305,202311,52,36,16,47524.83,21122.22,68647.05
521308,202311,1103,856,247,1130038.99,326074.18,1456113.17
521310,202311,1595,879,716,1161786.32,946550.89,2108337.21
521340,202311,26,19,7,25081.32,9240.44,34321.76
521350,202311,96,72,24,95048.51,31682.79,126731.30
521370,202311,184,120,64,158409.22,84483.58,242892.80
521375,202311,228,106,122,139933.39,161055.29,300988.68
521377,202311,52,39,13,51486.47,17161.63,68648.10
521380,202311,1206,703,503,928068.13,665337.45,1593405.58
521385,202311,12,6,6,7920,7920,15840
521390,202311,111,91,20,120128.36,26402.64,146531.00
521400,202311,438,317,121,418469.07,159728.63,578197.70
521405,202311,173,114,59,151809.64,77884.78,229694.42
521410,202311,89,66,23,87123.67,30361,117484.67
521440,202311,244,163,81,215189.27,106932.7,322121.97
521450,202311,875,480,395,633649.26,521446.03,1155095.29
521460,202311,1256,893,363,1180219.44,479220.38,1659439.82
521470,202311,18,14,4,18480.44,5280.44,23760.88
521480,202311,47,30,17,39604.76,22443.25,62048.01
521483,202311,359,241,118,318144.04,155776.41,473920.45
521486,202311,342,235,107,310204.02,142563.15,452767.17
521487,202311,26,15,11,19801.32,14520,34321.32
521490,202311,30,18,12,23760.44,15840.51,39600.95
521500,202311,173,84,89,110889.86,117486.64,228376.50
521520,202311,49,38,11,50160,14520,64680
521523,202311,1431,789,642,1044170.83,847468.81,1891639.64
521525,202311,69,52,17,68640,22440.34,91080.34
521530,202311,263,153,110,201976.39,146531.3,348507.69
521540,202311,47,26,21,34320.28,27720.98,62041.26
521550,202311,141,75,66,99005.75,87124.81,186130.56
521560,202311,1046,712,334,939937.88,442231.97,1382169.85
521565,202311,78,56,22,73921.15,29040,102961.15
521570,202311,674,426,248,562375.82,328705.46,891081.28
521580,202311,47,30,17,39602.55,22440.74,62043.29
521590,202311,48,26,22,34320.03,29041.18,63361.21
521600,202311,22,10,12,13200,15840.78,29040.78
521630,202311,250,130,120,171619.79,158418.51,330038.30
521640,202311,340,185,155,244214.67,204612.26,448826.93
521645,202311,41,20,21,26402.39,27721.16,54123.55
521680,202311,279,170,109,224422.23,143891.89,368314.12
521690,202311,20,18,2,23760,2640,26400
521710,202311,1240,604,636,797341.47,839588.8,1636930.27
521720,202311,653,445,208,588763.24,275897.15,864660.39
521730,202311,824,387,437,510876.21,576883.06,1087759.27
521740,202311,1013,496,517,656080.22,685138.23,1341218.45
521760,202311,2929,1555,1374,2052891.35,1815187.67,3868079.02
521770,202311,917,562,355,741894.47,468635.2,1210529.67
521800,202311,2203,1528,675,2018447.23,892398.5,2910845.73
521805,202311,45,28,17,36961.45,22441.07,59402.52
521810,202311,94,55,39,72611.97,51487.88,124099.85
521830,202311,1151,860,291,1135305.37,384162.98,1519468.35
521839,202311,74,42,32,55442.44,42240.96,97683.40
521850,202311,1339,673,666,888469.94,879209.11,1767679.05
521860,202311,373,237,136,312864.98,179533.31,492398.29
521870,202311,120,84,36,110880,47520,158400
521878,202311,37,16,21,21120.44,27721,48841.44
521880,202311,5831,2631,3200,3473303.82,4227043.73,7700347.55
521890,202311,725,505,220,666646.29,290413.01,957059.30
521900,202311,305,232,73,306256.18,96364.17,402620.35
521910,202311,202,136,66,179549.01,87135.13,266684.14
521920,202311,37,23,14,30360.55,18483.42,48843.97
521925,202311,64,36,28,47520.37,36960,84480.37
521930,202311,1450,831,619,1098349.55,817156.64,1915506.19
521935,202311,49,39,10,51483.94,13200.11,64684.05
521940,202311,256,116,140,153133.1,184811.31,337944.41
521945,202311,22,16,6,21121,9240,30361
521950,202311,27,16,11,21120,14520,35640
521960,202311,75,57,18,75240,23760.44,99000.44
521970,202311,432,284,148,374896.51,195368.32,570264.83
521971,202311,107,61,46,80521.82,60724.56,141246.38
521973,202311,44,22,22,29041.6,29041.99,58083.59
521975,202311,1999,1089,910,1438943.77,1202651.08,2641594.85
521980,202311,261,176,85,232343.78,112209.01,344552.79
521990,202311,104,71,33,93727.23,43562.39,137289.62
522000,202311,309,211,98,278288.89,129375.74,407664.63
522005,202311,21,12,9,15840.48,11880.61,27721.09
522010,202311,1319,743,576,982183.39,761712.98,1743896.37
522015,202311,67,42,25,55441.65,33000.89,88442.54
522020,202311,1011,639,372,843524.15,491063.01,1334587.16
522026,202311,30,19,11,25080.84,14520.44,39601.28
522028,202311,28,24,4,31680,5280,36960
522040,202311,933,438,495,578219.64,653465.78,1231685.42
522045,202311,3209,1898,1311,2505636.71,1730678.09,4236314.80
522050,202311,135,66,69,87136.66,91090.35,178227.01
522060,202311,580,364,216,480518.73,285137.9,765656.63
522068,202311,130,95,35,125400.71,46200,171600.71
522070,202311,20,18,2,23760,2640,26400
522100,202311,36,24,12,31680,15840,47520
522108,202311,42,32,10,42245.35,13201.29,55446.64
522119,202311,78,46,32,60721.57,42240,102961.57
522130,202311,90,34,56,44887.26,73933.05,118820.31
522140,202311,4922,2607,2315,3442913.63,3060003.26,6502916.89
522145,202311,57,39,18,51482.25,23763.5,75245.75
522150,202311,127,91,36,120125.49,47521.61,167647.10
522155,202311,68,46,22,60720.78,29041.62,89762.40
522157,202311,20,11,9,14520,11880,26400
522160,202311,1812,1077,735,1423108.3,970287.05,2393395.35
522170,202311,396,275,121,363029.43,159729.77,522759.20
522180,202311,37,18,19,23762.16,25081.28,48843.44
522185,202311,3121,1450,1671,1915499.35,2205999.02,4121498.37
522190,202311,89,52,37,69963.49,48842.32,118805.81
522200,202311,362,209,153,275898.68,203290.02,479188.70
522205,202311,145,98,47,129380.23,62047.58,191427.81
522220,202311,143,111,32,146524.98,42241.3,188766.28
522230,202311,41,33,8,43563.14,10560.67,54123.81
530010,202311,67113,34678,32435,45803978.19,42856738.57,88660716.76
110001,202312,582,470,112,620407.98,147840,768247.98
110002,202312,3453,2239,1214,2955552.03,1602488.17,4558040.20
110003,202312,87,65,22,85801.7,29040,114841.7
110004,202312,2419,1703,716,2248011.17,946446.29,3194457.46
110005,202312,483,372,111,491047.19,146520.2,637567.39
110006,202312,493,362,131,477846.43,172920,650766.43
110007,202312,81,64,17,84480,22440,106920
110008,202312,309,177,132,233643.2,174241.39,407884.59
110009,202312,1065,834,231,1100888.85,304920,1405808.85
110010,202312,1903,1052,851,1389986.38,1124642.47,2514628.85
110011,202312,1860,1438,422,1899540.68,557048.88,2456589.56
110012,202312,4574,2652,1922,3500714.89,2541026.15,6041741.04
110013,202312,851,687,164,906865.89,216483.11,1123349.00
110014,202312,364,325,39,429402.6,51480,480882.6
110015,202312,1480,1122,358,1481059,472563.41,1953622.41
110018,202312,1117,718,399,947780.97,526680.2,1474461.17
110020,202312,19448,11063,8385,14605151.2,11074925.57,25680076.77
110025,202312,686,506,180,667925.02,237600.2,905525.22
110026,202312,38,27,11,35640.57,14520,50160.57
110028,202312,1793,1262,531,1665887.8,700925.55,2366813.35
110029,202312,134,121,13,159722.34,17160,176882.34
110030,202312,2662,1714,948,2263629.11,1251368.7,3514997.81
110032,202312,389,304,85,401293.66,112203.8,513497.46
110033,202312,772,548,224,723389.9,295687.24,1019077.14
110034,202312,354,274,80,361681.77,105600,467281.77
110037,202312,109,92,17,121441.1,22440,143881.1
110040,202312,476,332,144,438242.7,190080,628322.7
110045,202312,1095,801,294,1059991.55,388082.38,1448073.93
110050,202312,94,85,9,112200.2,11880,124080.2
110060,202312,71,50,21,66004.64,27720,93724.64
110070,202312,129,88,41,116161.16,54120,170281.16
110080,202312,651,381,270,502925.74,356400.37,859326.11
110090,202312,22,20,2,26400,2640.32,29040.32
110092,202312,147,75,72,99000.2,95040,194040.2
110094,202312,268,192,76,253443.49,100320,353763.49
110100,202312,63,49,14,64681.02,18480.06,83161.08
110110,202312,132,81,51,106922.59,67320,174242.59
110120,202312,83,71,12,93721.91,15840,109561.91
110130,202312,280,227,53,299645,69960.3,369605.3
110140,202312,296,212,84,279845.47,110880.1,390725.57
110143,202312,61,49,12,64680.93,15840,80520.93
110145,202312,53,38,15,50160,19800,69960
110146,202312,34,14,20,18480,26400,44880
110147,202312,44,27,17,35640.51,22440,58080.51
110148,202312,44,33,11,43560.7,14520,58080.7
110149,202312,336,236,100,311521.49,132000,443521.49
110150,202312,157,128,29,168961.09,38280,207241.09
110155,202312,16,14,2,18480,2640,21120
110160,202312,81,63,18,83161.21,23760,106921.21
110170,202312,239,185,54,244204.39,71280,315484.39
110175,202312,74,60,14,79200,18480,97680
110180,202312,92,74,18,97681.16,23760,121441.16
120001,202312,258,190,68,250812.07,89760,340572.07
120005,202312,269,159,110,209883.7,145200,355083.7
120010,202312,1312,803,509,1059975.12,673201.97,1733177.09
120013,202312,206,143,63,188762.76,83160.1,271922.86
120017,202312,166,103,63,135960.68,83161.15,219121.83
120020,202312,3678,2970,708,3920490.78,937210.17,4857700.95
120025,202312,663,358,305,472604.72,402618.7,875223.42
120030,202312,1322,1145,177,1511464.49,233648.65,1745113.14
120032,202312,50,43,7,56760,9240,66000
120033,202312,253,218,35,287769.86,46200.55,333970.41
120034,202312,222,169,53,223080.9,69960,293040.9
120035,202312,63,57,6,75240.1,9240,84480.1
120038,202312,469,314,155,414498.14,204601.75,619099.89
120039,202312,41,37,4,48841.1,5280,54121.1
120040,202312,16777,11362,5415,14999357.92,7148092.46,22147450.38
120042,202312,63,57,6,75243.24,7920.65,83163.89
120043,202312,19,5,14,6600,18480,25080
120045,202312,635,408,227,538581.36,299643,838224.36
120050,202312,1455,1107,348,1462623.98,459370.14,1921994.12
120060,202312,1638,1364,274,1801108.54,361686.64,2162795.18
120070,202312,488,364,124,480497.96,163680.65,644178.61
120080,202312,244,168,76,221766.34,100320.55,322086.89
130002,202312,176,129,47,170281.85,62040,232321.85
130006,202312,118,80,38,105600,50160,155760
130008,202312,136,83,53,109560.7,69960,179520.7
130010,202312,197,129,68,171600.2,89760.69,261360.89
130014,202312,355,250,105,330332.5,138602.42,468934.92
130020,202312,165,115,50,151801.1,66000,217801.1
130030,202312,1096,629,467,830289.78,616442.69,1446732.47
130040,202312,434,229,205,302283.67,270600,572883.67
130050,202312,592,323,269,426373.95,355089.63,781463.58
130060,202312,928,623,305,822361.79,402600.7,1224962.49
130063,202312,656,426,230,562325.3,303600,865925.3
130068,202312,245,152,93,200641.81,122760.44,323402.25
130070,202312,1471,983,488,1297588.7,644169.17,1941757.87
130080,202312,736,508,228,670567.74,302281.77,972849.51
130083,202312,102,68,34,89760.96,44880,134640.96
130090,202312,368,233,135,308882.38,178200,487082.38
130100,202312,1464,786,678,1037532.4,894969.83,1932502.23
130110,202312,929,430,499,567604.31,658681.02,1226285.33
130115,202312,207,120,87,158400,114840.7,273240.7
130120,202312,1974,1274,700,1681701.41,924001.06,2605702.47
130130,202312,724,502,222,662643.23,293040.95,955684.18
130140,202312,1588,1241,347,1638132.2,458040.96,2096173.16
130150,202312,465,421,44,555721.57,58080,613801.57
130160,202312,486,306,180,403921.4,237600,641521.4
130165,202312,153,134,19,176880,25080,201960
130170,202312,1471,1011,460,1335797.48,607212,1943009.48
130180,202312,310,246,64,324728.43,84480.1,409208.53
130185,202312,2438,1242,1196,1639483.14,1580059.41,3219542.55
130190,202312,3732,2382,1350,3144333.47,1782021.45,4926354.92
130195,202312,307,246,61,324720.2,80520,405240.2
130200,202312,240,155,85,204602.17,112200,316802.17
130210,202312,97,44,53,58080,69960,128040
130220,202312,229,176,53,232320.97,69960,302280.97
130230,202312,372,252,120,332640,158400,491040
130240,202312,1501,1028,473,1356971.84,624360.58,1981332.42
130250,202312,5513,3677,1836,4853742.79,2423544.57,7277287.36
130255,202312,469,250,219,330000.72,289080.46,619081.18
130260,202312,77337,36667,40670,48422684.97,53714676.64,102137361.61
130270,202312,1567,1090,477,1438936.82,629642.05,2068578.87
130280,202312,153,89,64,117480.9,84480,201960.9
130290,202312,2218,1411,807,1862559.03,1065248.89,2927807.92
130300,202312,448,306,142,403921.5,187441,591362.5
130310,202312,1020,582,438,768244.03,579480.89,1347724.92
130320,202312,594,333,261,439561.73,344520.15,784081.88
130330,202312,805,538,267,710166.86,352441.5,1062608.36
130340,202312,3810,2080,1730,2745698,2284945.92,5030643.92
130350,202312,494,358,136,472560,179520,652080
130353,202312,1085,532,553,702265.12,729967.69,1432232.81
130356,202312,974,459,515,607209.21,679805.35,1287014.56
130360,202312,112,90,22,118800.34,29040,147840.34
130370,202312,726,586,140,773523.39,184800,958323.39
130380,202312,700,542,158,715445.08,208560.06,924005.14
130390,202312,517,430,87,567600,114840,682440
130395,202312,177,73,104,96360.61,137280.1,233640.71
130400,202312,109,81,28,106921.35,36960,143881.35
130406,202312,2451,1413,1038,1865177.7,1370163.6,3235341.3
130410,202312,511,296,215,390720,283800,674520
130420,202312,3086,2517,569,3322540.74,751082.47,4073623.21
130423,202312,229,152,77,200641.01,101640,302281.01
130426,202312,207,119,88,157080.9,116160,273240.9
130430,202312,458,273,185,360364.97,244200,604564.97
130440,202312,212,80,132,105604.47,174242.09,279846.56
140002,202312,78,27,51,35640.2,67320.6,102960.8
140005,202312,277,159,118,209885.35,155761.4,365646.75
140010,202312,16280,8674,7606,11452827.49,10041421.36,21494248.85
140015,202312,407,92,315,121443.12,415801.72,537244.84
140017,202312,196,113,83,149167.65,109563.55,258731.20
140020,202312,526,356,170,469936.12,224404.93,694341.05
140023,202312,114,63,51,83160,67320.28,150480.28
140028,202312,37,21,16,27720.77,21120.71,48841.48
140030,202312,500,320,180,422413.43,237601.13,660014.56
140040,202312,98,64,34,84480.6,44880,129360.6
140045,202312,626,144,482,190081.84,637563.4,827645.24
140047,202312,761,481,280,636255.04,370921.81,1007176.85
140050,202312,176,109,67,143883.7,88441.79,232325.49
140060,202312,120,83,37,109561.19,48840.2,158401.39
140070,202312,29,28,1,36960.2,1320,38280.2
150010,202312,5977,3669,2308,4843228.82,3046592.65,7889821.47
150013,202312,201,133,68,175560.99,89760.99,265321.98
150020,202312,1281,748,533,988699.46,703562.36,1692261.82
150030,202312,770,367,403,484465.83,531963.41,1016429.24
150034,202312,237,137,100,180842.36,132000.3,312842.66
150040,202312,1956,1168,788,1541855.43,1040190.76,2582046.19
150050,202312,910,557,353,735252.15,465962.16,1201214.31
150060,202312,5771,3634,2137,4798234.55,2822751.84,7620986.39
150070,202312,268,205,63,270620.77,83162.62,353783.39
150080,202312,21623,10307,11316,13608524.2,14946687.95,28555212.15
150085,202312,608,375,233,495014.65,307563.36,802578.01
150090,202312,948,757,191,999271.84,252123.61,1251395.45
150095,202312,116,83,33,109561.1,43560.93,153122.03
150100,202312,91,58,33,76562.77,44881.25,121444.02
150110,202312,234,148,86,195361.2,113520.1,308881.3
150120,202312,432,312,120,411850.58,158400.7,570251.28
150125,202312,48,23,25,30360,33000,63360
150130,202312,2958,1458,1500,1924630.23,1980246.89,3904877.12
150140,202312,71348,30860,40488,40750159.19,53464991.41,94215150.60
150145,202312,321,182,139,240245.01,184800,425045.01
150150,202312,4218,1877,2341,2480358.48,3090168.01,5570526.49
150157,202312,404,289,115,381490.38,151800.2,533290.58
150160,202312,216,164,52,216480.44,68641.12,285121.56
150170,202312,4824,3451,1373,4555454.34,1812381.11,6367835.45
150172,202312,457,330,127,435607.26,167641.1,603248.36
150175,202312,96,53,43,69960.3,56760.7,126721.0
150178,202312,923,629,294,830304.42,388086,1218390.42
150180,202312,4858,2374,2484,3133756.47,3278892.54,6412649.01
150190,202312,493,349,144,460691.78,190083.01,650774.79
150195,202312,164,94,70,124080.2,92400.55,216480.75
150200,202312,244,141,103,186121.39,135960.2,322081.59
150210,202312,3566,2728,838,3601099.97,1107492.47,4708592.44
150215,202312,875,501,374,661343.1,493690.86,1155033.96
150220,202312,4026,2659,1367,3509990.98,1804476.59,5314467.57
150230,202312,1689,1344,345,1775461.29,455408.11,2230869.40
150240,202312,8867,4926,3941,6502579.86,5203543.79,11706123.65
150250,202312,110,70,40,92402.32,52800.08,145202.40
150260,202312,162,110,52,145204.07,68640.8,213844.87
150270,202312,2381,1544,837,2039443.34,1104844.92,3144288.26
150275,202312,647,432,215,570256.4,283802.63,854059.03
150276,202312,142,52,90,68640.2,118801.32,187441.52
150277,202312,986,435,551,574215.41,727332.66,1301548.07
150280,202312,229,221,8,291731.65,10560,302291.65
150285,202312,209,122,87,161042.3,114628.8,275671.1
150290,202312,1484,854,630,1127312.33,831606.76,1958919.09
150293,202312,1013,474,539,625698.68,712806.56,1338505.24
150295,202312,682,341,341,450136.97,451442.59,901579.56
150300,202312,128,74,54,97681.55,71280,168961.55
150304,202312,262,164,98,216486.01,129363.67,345849.68
150307,202312,510,423,87,558374.16,114840.5,673214.66
150309,202312,698,497,201,656075.38,265324.92,921400.30
150310,202312,338,232,106,306245.03,139920,446165.03
150320,202312,2170,1505,665,1986637.79,879126.54,2865764.33
150330,202312,2421,1404,1017,1853306.74,1342446.26,3195753.00
150340,202312,226,140,86,184802.74,113520.42,298323.16
150345,202312,760,434,326,572890.72,430320.08,1003210.80
150350,202312,497,404,93,533311.06,122763.34,656074.40
150360,202312,6151,3669,2482,4844522.29,3276272.46,8120794.75
150370,202312,979,648,331,855397.57,436928.92,1292326.49
150375,202312,230,94,136,124080.98,179520.68,303601.66
150380,202312,1730,1167,563,1540475.53,743165.11,2283640.64
150390,202312,1074,633,441,835607.89,582125.77,1417733.66
150400,202312,145,124,21,163681.7,27720,191401.7
150405,202312,1887,1207,680,1593275.1,897602.38,2490877.48
150410,202312,114,73,41,96360.77,54120.2,150480.97
150420,202312,9106,4958,4148,6546389.81,5478125,12024514.81
150430,202312,770,480,290,633647.73,382811.51,1016459.24
150440,202312,539,332,207,438253.77,273241.95,711495.72
150442,202312,2835,1527,1308,2015716.36,1726585.03,3742301.39
150445,202312,657,434,223,572887.4,294360.79,867248.19
150450,202312,83,58,25,76564.48,33002.8,109567.28
150460,202312,770,584,186,770908.76,245522.2,1016430.96
150470,202312,1446,886,560,1169563.51,739204.89,1908768.40
150475,202312,311,234,77,308893.59,101643.08,410536.67
150480,202312,1713,1230,483,1623676.4,637570.91,2261247.31
150490,202312,657,410,247,541212.02,326041.8,867253.82
150495,202312,406,311,95,410521.58,125400,535921.58
150497,202312,323,209,114,275882.46,150480.1,426362.56
150500,202312,326,193,133,254762.46,175560,430322.46
150503,202312,1729,884,845,1166911.59,1115411.16,2282322.75
150506,202312,1053,723,330,954379.47,435601.98,1389981.45
150510,202312,1586,913,673,1205199.11,889688.28,2094887.39
150520,202312,386,268,118,353760.87,155760.4,509521.27
150530,202312,2408,1439,969,1900982.01,1281784.72,3182766.73
150540,202312,277,200,77,264002.13,102960.34,366962.47
150543,202312,1059,541,518,714139.16,685089.32,1399228.48
150548,202312,524,372,152,491044.53,200641.88,691686.41
150549,202312,104,72,32,95043.68,42240.26,137283.94
150550,202312,3728,1909,1819,2519970.46,2401109.73,4921080.19
150553,202312,4630,2620,2010,3459850.8,2657191.32,6117042.12
150555,202312,155,85,70,113520.4,92401.19,205921.59
150560,202312,125,68,57,89761.07,75240,165001.07
150563,202312,161,91,70,120125.22,93722.25,213847.47
150565,202312,255,155,100,204602.49,132000.93,336603.42
150570,202312,467,315,152,415801.72,200640,616441.72
150580,202312,1949,1026,923,1354337.23,1218361.31,2572698.54
150590,202312,991,682,309,900274.27,407881.09,1308155.36
150600,202312,621,415,206,547817.21,271926.08,819743.29
150610,202312,232,171,61,225722.72,80520,306242.72
150611,202312,190,127,63,167640,83160,250800
150613,202312,4016,2240,1776,2958208.16,2345757.97,5303966.13
150616,202312,673,359,314,473886.09,415803.74,889689.83
150618,202312,1650,833,817,1099569.83,1078441.76,2178011.59
150619,202312,489,376,113,496330.97,149165.08,645496.05
150620,202312,1532,872,660,1151076.28,871205.01,2022281.29
150630,202312,240,161,79,212534.31,104281.66,316815.97
150635,202312,567,278,289,366970.47,382804.05,749774.52
150640,202312,60,29,31,38281.51,40920,79201.51
150650,202312,2796,1621,1175,2141136.15,1552361.27,3693497.42
150655,202312,325,232,93,306242.08,122760,429002.08
150658,202312,72,48,24,63360,31680,95040
150660,202312,764,476,288,628335.09,380165.76,1008500.85
150670,202312,1344,514,830,678492.49,1095609.28,1774101.77
150680,202312,13379,7205,6174,9513704.98,8155138.53,17668843.51
150690,202312,58,31,27,40920.47,35640,76560.47
150700,202312,679,461,218,608553.43,287766.54,896319.97
150710,202312,357,217,140,286448.09,184801.62,471249.71
150715,202312,939,593,346,782781.85,456724.16,1239506.01
150720,202312,503,383,120,505571.07,158401.31,663972.38
150730,202312,1425,691,734,912141.23,968887.57,1881028.80
150740,202312,316,202,114,266643.7,150480,417123.7
150745,202312,942,544,398,718114.25,525368.36,1243482.61
150746,202312,84,41,43,54121.32,56760,110881.32
150747,202312,325,221,104,291728.41,137282.1,429010.51
150750,202312,173,97,76,128045.34,100322.75,228368.09
150760,202312,2190,1440,750,1900839.05,990006.67,2890845.72
150770,202312,447,272,175,359043.57,231000.2,590043.77
150775,202312,112,64,48,84480.48,63360.1,147840.58
150780,202312,261,159,102,209881.96,134640.18,344522.14
150790,202312,810,487,323,642852.19,426363.7,1069215.89
150795,202312,2092,1315,777,1735832.22,1025651.38,2761483.60
150796,202312,333,192,141,253440.91,186121.94,439562.85
150797,202312,494,243,251,320769.66,332641.99,653411.65
150800,202312,1887,1047,840,1382059.51,1110120.9,2492180.41
150803,202312,408,316,92,417135.02,121440.54,538575.56
150805,202312,252,155,97,204602.85,128040.96,332643.81
150808,202312,1264,621,643,819727.12,848763.45,1668490.57
150810,202312,3625,2434,1191,3212982.1,1572129.34,4785111.44
150812,202312,629,329,300,434289.29,396001.9,830291.19
150815,202312,1495,936,559,1235535.82,737883.46,1973419.28
150820,202312,2047,1224,823,1615741.33,1086375.32,2702116.65
150830,202312,660,500,160,660018.88,211201.83,871220.71
150835,202312,300,190,110,250803.58,145200,396003.58
150840,202312,1669,949,720,1254037.08,950410.41,2204447.49
160005,202312,76,51,25,67321.76,33000.02,100321.78
160010,202312,260,164,96,216486.34,126721.17,343207.51
160015,202312,192,130,62,171610.35,81840.83,253451.18
160020,202312,166,83,83,109562.61,109560,219122.61
160021,202312,73,40,33,52803.96,43561.05,96365.01
160023,202312,91,62,29,81846.23,38280.14,120126.37
160025,202312,36,18,18,23762.6,23760.12,47522.72
160027,202312,1680,946,734,1250108.83,968887.3,2218996.13
160030,202312,20835,11131,9704,14696255.53,12810824.99,27507080.52
160040,202312,446,294,152,388103.6,200645.32,588748.92
160050,202312,990,410,580,541222.54,765612.14,1306834.68
160053,202312,356,224,132,295695.62,174242.91,469938.53
160055,202312,33,25,8,33000.59,10561.41,43562.00
160060,202312,7893,4474,3419,5907338.94,4514513.94,10421852.88
160070,202312,223,136,87,179525.59,114840.77,294366.36
160080,202312,172,92,80,121440.96,105600,227040.96
170025,202312,25,16,9,21120,11880.2,33000.2
170030,202312,184,150,34,198006.34,44880,242886.34
170035,202312,215,111,104,146526.16,137281.86,283808.02
170040,202312,191,144,47,190080.2,62040,252120.2
170070,202312,356,230,126,303610.65,166320.59,469931.24
170100,202312,379,274,105,361690.94,138600.2,500291.14
170105,202312,44,38,6,50160.15,7920,58080.15
170110,202312,116,72,44,95041.01,58081.06,153122.07
170130,202312,92,48,44,63360,58080,121440
170190,202312,112,66,46,87120,60720,147840
170200,202312,375,255,120,336603.24,158400,495003.24
170210,202312,7846,4458,3388,5884419.35,4472200.81,10356620.16
170215,202312,203,130,73,171604.03,96362.57,267966.60
170220,202312,1423,1024,399,1351710.47,526684.5,1878394.97
170230,202312,166,117,49,154443.94,64680.3,219124.24
170240,202312,528,371,157,489746.37,207242.02,696988.39
170255,202312,1078,833,245,1099580.65,323401.92,1422982.57
170270,202312,58,42,16,55440,21120,76560
170290,202312,167,108,59,142562.67,77880,220442.67
170300,202312,133,91,42,120120.21,55440.12,175560.33
170305,202312,67,45,22,59400.8,29040,88440.8
170307,202312,57,42,15,55441.26,19800.9,75242.16
170310,202312,143,98,45,129361.85,59400,188761.85
170320,202312,56,37,19,48840.2,25080,73920.2
170330,202312,42,31,11,40921.58,14520.1,55441.68
170360,202312,41,27,14,35640.29,18480.75,54121.04
170370,202312,86,52,34,68641.7,44880.38,113522.08
170380,202312,101,75,26,99001.34,34320,133321.34
170382,202312,44,37,7,48840,9240,58080
170384,202312,163,126,37,166320,48840.44,215160.44
170386,202312,83,38,45,50160.61,59400,109560.61
170388,202312,49,26,23,34320.96,30360,64680.96
170389,202312,28,20,8,26400.4,10560,36960.4
170390,202312,95,55,40,72601.19,52800.57,125401.76
170410,202312,27,24,3,31682.54,3960,35642.54
170460,202312,15,8,7,10560.91,9240,19800.91
170510,202312,37,28,9,36962.79,11880,48842.79
170550,202312,1798,1082,716,1429591.12,945130.75,2374721.87
170555,202312,127,93,34,122764.19,44880,167644.19
170560,202312,101,75,26,99000.42,34320.33,133320.75
170600,202312,43,18,25,23761.09,33000.7,56761.79
170610,202312,209,121,88,160780.98,116160.1,276941.08
170625,202312,38,23,15,30360,19800,50160
170650,202312,112,82,30,108240.35,39600.2,147840.55
170700,202312,654,480,174,633609.92,229680,863289.92
170710,202312,146,87,59,114844.55,77882.34,192726.89
170720,202312,126,95,31,125400.81,40920,166320.81
170730,202312,129,80,49,105601.86,64680,170281.86
170740,202312,99,70,29,92400.2,38280,130680.2
170755,202312,47,28,19,36960.75,25080.76,62041.51
170765,202312,138,83,55,109563.73,72600.6,182164.33
170770,202312,203,138,65,182161.69,85800.73,267962.42
170820,202312,663,445,218,587408.62,287760.32,875168.94
170825,202312,61,33,28,43560.3,36960,80520.3
170830,202312,105,79,26,104280.79,34320.33,138601.12
170900,202312,189,147,42,194042.47,55440.77,249483.24
170930,202312,1146,655,491,867269.32,649445.08,1516714.40
170950,202312,3719,1859,1860,2455260.2,2455221.33,4910481.53
170980,202312,16,11,5,14521.63,6600.21,21121.84
171050,202312,171,132,39,174240,51480.2,225720.2
171070,202312,75,61,14,80520.38,18480.6,99000.98
171090,202312,56,44,12,58080,15840,73920
171110,202312,28,22,6,29040.97,7920,36960.97
171150,202312,53,38,15,50160,19800,69960
171180,202312,30,16,14,21120,18480.87,39600.87
171190,202312,225,124,101,163684.14,133320,297004.14
171195,202312,62,53,9,69961.07,11880,81841.07
171200,202312,30,15,15,19800,19800,39600
171215,202312,13,10,3,13200,3960,17160
171240,202312,64,51,13,67320,17160,84480
171245,202312,59,50,9,66001.96,11880,77881.96
171250,202312,89,56,33,73920.2,43560,117480.2
171270,202312,14,10,4,13200.9,5280.22,18481.12
171280,202312,58,47,11,62041.8,14520.1,76561.9
171320,202312,1188,713,475,941173.55,627002.92,1568176.47
171330,202312,487,263,224,347162.62,295680.21,642842.83
171360,202312,120,88,32,116160.26,42240,158400.26
171370,202312,42,26,16,34320,21120.44,55440.44
171380,202312,143,122,21,161042.35,27720,188762.35
171395,202312,51,34,17,44880.68,22440,67320.68
171420,202312,280,183,97,241561.39,128040,369601.39
171430,202312,88,73,15,96360.2,19800.6,116160.8
171488,202312,246,148,98,195360.24,129360,324720.24
171500,202312,78,46,32,60720.2,42240,102960.2
171510,202312,82,57,25,75240,33000.52,108240.52
171515,202312,47,40,7,52801.99,9240,62041.99
171525,202312,29,25,4,33002.05,5280,38282.05
171550,202312,19,12,7,15840.9,9240,25080.9
171570,202312,64,34,30,44880,39600.1,84480.1
171575,202312,265,181,84,238921.5,110880,349801.5
171610,202312,2272,1199,1073,1582725.71,1416387.06,2999112.77
171620,202312,176,127,49,167641.25,64680.61,232321.86
171630,202312,56,31,25,40920,33000,73920
171650,202312,386,274,112,361692.13,147841.94,509534.07
171660,202312,276,160,116,211208.56,153121.12,364329.68
171665,202312,102,65,37,85801.17,48840.33,134641.50
171670,202312,492,324,168,427687.85,221762.93,649450.78
171700,202312,67,56,11,73920.95,14520,88440.95
171720,202312,29,13,16,17160.7,21120.2,38280.9
171750,202312,116,62,54,81840,71280,153120
171780,202312,84,66,18,87120.33,23760,110880.33
171790,202312,113,91,22,120120,29040,149160
171800,202312,36,28,8,36960,10560,47520
171820,202312,2354,1396,958,1845423.66,1267207.38,3112631.04
171830,202312,41,32,9,42240.2,11880,54120.2
171840,202312,60,39,21,51480.3,27720,79200.3
171845,202312,38,27,11,35640.78,14520,50160.78
171850,202312,57,46,11,60720.4,14520.2,75240.6
171855,202312,77,60,17,79200.1,22440,101640.1
171865,202312,5,3,2,3960,2640,6600
171870,202312,42,31,11,40920.2,14520.45,55440.65
171875,202312,102,78,24,102960,31680,134640
171880,202312,49,30,19,39600,25080,64680
171884,202312,59,35,24,46200.85,31680,77880.85
171886,202312,154,79,75,104281.07,99000,203281.07
171888,202312,31,24,7,31682.77,9240.5,40923.27
171889,202312,19,9,10,11880,13200,25080
171890,202312,76,64,12,84480.89,15840,100320.89
171900,202312,29,19,10,25080.2,13200,38280.2
172000,202312,38,34,4,46200.2,5280.2,51480.4
172010,202312,70,47,23,62040.44,30360.62,92401.06
172015,202312,24,19,5,25081.52,6600,31681.52
172020,202312,126,78,48,102961.2,63360,166321.2
172025,202312,43,28,15,36960.46,19800,56760.46
172030,202312,63,41,22,54120.75,29040,83160.75
172049,202312,94,64,30,84481.22,39600.2,124081.42
172065,202312,122,82,40,108242.14,52800.46,161042.60
172080,202312,146,93,53,124081.41,69961.17,194042.58
172085,202312,35,19,16,25080,21120,46200
172090,202312,497,354,143,467290.33,188760.94,656051.27
172093,202312,23,21,2,27720,2640,30360
172097,202312,20,11,9,14520,11880.7,26400.7
172100,202312,7390,4447,2943,5872810.2,3887452.31,9760262.51
172110,202312,91,65,26,85801.43,34320,120121.43
172120,202312,1953,1634,319,2156954.66,421085.5,2578040.16
172125,202312,20,14,6,18480,7920,26400
172130,202312,34,21,13,27721.29,17160,44881.29
172208,202312,221,143,78,188760,102961.38,291721.38
172210,202312,372,191,181,252127.67,238920.45,491048.12
210005,202312,3435,2224,1211,2935799.23,1598539.03,4534338.26
210010,202312,151,105,46,138600.82,60720,199320.82
210015,202312,47,33,14,43560.39,18480,62040.39
210020,202312,421,266,155,351128.41,205922.05,557050.46
210030,202312,353,243,110,320787.62,145205.67,465993.29
210040,202312,116,98,18,129360.1,23760,153120.1
210043,202312,297,247,50,326045.27,66000.97,392046.24
210047,202312,519,343,176,452762.69,232320,685082.69
210050,202312,292,204,88,269280.2,116160.2,385440.4
210055,202312,70,59,11,77880.27,14520,92400.27
210060,202312,572,466,106,615152.39,139922.62,755075.01
210070,202312,535,419,116,553081.44,153120.63,706202.07
210080,202312,158,146,12,192721.6,15840,208561.6
210083,202312,308,170,138,224400.77,182160.19,406560.96
210087,202312,10,6,4,7920,5280,13200
210090,202312,543,402,141,530665.02,186122.26,716787.28
210095,202312,440,359,81,473889.29,106920.62,580809.91
210100,202312,752,606,146,799934.98,192720.2,992655.18
210110,202312,126,89,37,117483.15,48840.9,166324.05
210120,202312,4950,4042,908,5336988.88,1198574.72,6535563.60
210125,202312,219,148,71,195363.21,93720.66,289083.87
210130,202312,474,304,170,401291.64,224401.64,625693.28
210135,202312,41,29,12,38281.39,15840.35,54121.74
210140,202312,5046,3849,1197,5084793.11,1582702.15,6667495.26
210150,202312,410,277,133,365653.86,175562.84,541216.70
210160,202312,3399,2908,491,3838652.58,648124.94,4486777.52
210170,202312,1392,1131,261,1492977.75,344520.2,1837497.95
210173,202312,143,133,10,175561.48,13200,188761.48
210177,202312,294,174,120,229681.27,158400,388081.27
210180,202312,37,22,15,29040.2,19800,48840.2
210190,202312,502,356,146,469921.45,192720.7,662642.15
210193,202312,11,9,2,11880.59,2640,14520.59
210197,202312,69,51,18,67320.3,23760.2,91080.5
210200,202312,649,557,92,735273.5,121440.39,856713.89
210203,202312,254,189,65,249483.61,85801.12,335284.73
210207,202312,330,286,44,377525.27,58080,435605.27
210210,202312,752,701,51,925331.26,67320.6,992651.86
210215,202312,88,80,8,105603.52,10560,116163.52
210220,202312,371,322,49,425055.63,64680.39,489736.02
210230,202312,353,289,64,381485.74,84480,465965.74
210232,202312,1269,942,327,1243473.93,431641.57,1675115.50
210235,202312,192,145,47,191404.84,62040.4,253445.24
210237,202312,64,35,29,46202.63,38280,84482.63
210240,202312,88,78,10,102960.7,13200.21,116160.91
210250,202312,209,183,26,241560.61,34320.2,275880.81
210255,202312,425,316,109,417134.2,143881.2,561015.4
210260,202312,409,303,106,399963.02,139920,539883.02
210270,202312,656,483,173,637570.67,228361.71,865932.38
210275,202312,129,102,27,134640.51,35640,170280.51
210280,202312,1161,780,381,1029616.52,504242.11,1533858.63
210290,202312,590,405,185,534610.31,244201.39,778811.70
210300,202312,5119,3412,1707,4505252.55,2254564.78,6759817.33
210310,202312,131,90,41,118800.2,54120,172920.2
210312,202312,123,94,29,124081.36,38280,162361.36
210315,202312,137,120,17,158400.97,22440,180840.97
210317,202312,171,134,37,176880.27,48840,225720.27
210320,202312,2613,2264,349,2988567.52,460681.04,3449248.56
210325,202312,166,99,67,130681.27,88440.94,219122.21
210330,202312,4263,2598,1665,3429433.49,2199124.39,5628557.88
210340,202312,1254,983,271,1297611.06,357721.68,1655332.74
210350,202312,739,623,116,822374.87,153120.2,975495.07
210355,202312,166,142,24,187440,31680,219120
210360,202312,2096,1560,536,2059254.43,708843,2768097.43
210370,202312,1290,710,580,937217.91,765604.72,1702822.63
210375,202312,206,108,98,142570.38,129361.46,271931.84
210380,202312,778,625,153,825010.28,201960.42,1026970.70
210390,202312,205,174,31,229681.23,40920,270601.23
210400,202312,473,424,49,559693.01,64680,624373.01
210405,202312,1221,869,352,1147109.82,465961.55,1613071.37
210407,202312,82,69,13,91080,17160,108240
210408,202312,51,48,3,63361.53,3960,67321.53
210409,202312,368,327,41,431643.47,54120,485763.47
210410,202312,472,383,89,505562.39,117480,623042.39
210420,202312,228,184,44,242882.04,58080.12,300962.16
210430,202312,69,51,18,67320.5,23760,91080.5
210440,202312,391,271,120,357730.99,158400,516130.99
210450,202312,113,100,13,132002.34,17160,149162.34
210455,202312,269,148,121,195367.64,159723.2,355090.84
210460,202312,336,235,101,310208.25,133320.25,443528.50
210462,202312,82,69,13,91081.64,17160,108241.64
210465,202312,133,109,24,143882.63,31680,175562.63
210467,202312,645,484,161,638897.26,212521.93,851419.19
210470,202312,44,39,5,51480.15,6600,58080.15
210480,202312,1470,1080,390,1425639.59,514804.13,1940443.72
210490,202312,185,133,52,175562.43,68640,244202.43
210500,202312,541,366,175,483138.32,231001.99,714140.31
210510,202312,556,459,97,605883.09,128041.71,733924.80
210515,202312,341,238,103,314163.55,135960.2,450123.75
210520,202312,416,381,35,502928.35,46200.93,549129.28
210530,202312,10622,5458,5164,7204910.09,6816655.9,14021565.99
210535,202312,129,101,28,133321.96,36960,170281.96
210540,202312,1678,1182,496,1560292.29,654725.35,2215017.64
210542,202312,1087,579,508,764300.41,670569.26,1434869.67
210545,202312,25,22,3,29040.71,3960,33000.71
210547,202312,131,118,13,155762.88,17160.31,172923.19
210550,202312,626,449,177,592705.69,233641.99,826347.68
210560,202312,176,156,20,205922.05,26400.97,232323.02
210565,202312,37,29,8,38281.62,10560.29,48841.91
210570,202312,1360,1169,191,1543117.03,252121.5,1795238.53
210580,202312,134,118,16,155760.78,21120.16,176880.94
210590,202312,670,571,99,755044.41,130680,885724.41
210592,202312,54,48,6,63360,7920,71280
210594,202312,124,109,15,143881.1,19800,163681.1
210596,202312,124,110,14,145200.7,18480,163680.7
210598,202312,147,112,35,147840.9,46200.2,194041.1
210600,202312,316,278,38,366970.22,50160.92,417131.14
210610,202312,276,257,19,339248.94,25080.54,364329.48
210620,202312,47,33,14,43560,18480,62040
210630,202312,101,94,7,124082.01,9240,133322.01
210632,202312,1001,731,270,964923.99,356400,1321323.99
210635,202312,36,32,4,42240.9,5280.2,47521.1
210637,202312,117,88,29,116160.2,38280,154440.2
210640,202312,595,537,58,708843.61,76560,785403.61
210650,202312,429,366,63,483128.51,83160.89,566289.40
210660,202312,404,327,77,431662.14,101641.9,533304.04
210663,202312,97,80,17,105600.71,22440,128040.71
210667,202312,97,57,40,75242.48,52800.57,128043.05
210670,202312,283,249,34,328686.64,44880,373566.64
210675,202312,508,319,189,421089.24,249482.72,670571.96
210680,202312,249,165,84,217802.53,110880,328682.53
210690,202312,129,118,11,155761.11,14520.99,170282.10
210700,202312,155,117,38,154440.4,50160.2,204600.6
210710,202312,279,179,100,236281.3,132000.6,368281.9
210720,202312,135,123,12,162360.08,15840,178200.08
210725,202312,72,60,12,79204.15,15840,95044.15
210730,202312,22,16,6,21120,7920,29040
210735,202312,302,225,77,297002.24,101640,398642.24
210740,202312,527,464,63,612506.68,83160,695666.68
210745,202312,178,141,37,186120.33,48840,234960.33
210750,202312,3089,1768,1321,2335136,1743737.55,4078873.55
210760,202312,274,221,53,291721.64,69960.19,361681.83
210770,202312,253,211,42,278538.2,55441.25,333979.45
210780,202312,433,329,104,434292.96,137281.97,571574.93
210790,202312,211,181,30,238923.87,39600,278523.87
210800,202312,193,152,41,200649.06,54120.35,254769.41
210805,202312,74,67,7,88440,9240,97680
210810,202312,453,384,69,506899.36,91080,597979.36
210820,202312,2035,1745,290,2303478.26,382803.27,2686281.53
210825,202312,162,107,55,141241.76,72600.2,213841.96
210830,202312,745,548,197,723368.11,260040.6,983408.71
210840,202312,215,162,53,213840.2,69960,283800.2
210845,202312,244,194,50,256082.9,66000,322082.9
210850,202312,735,550,185,726029.07,244202.11,970231.18
210860,202312,3614,2293,1321,3026819.1,1743726.82,4770545.92
210870,202312,408,327,81,431657.84,106920.2,538578.04
210880,202312,102,85,17,112202.58,22440,134642.58
210890,202312,330,294,36,388094.81,47520,435614.81
210900,202312,767,500,267,660023.24,352444.62,1012467.86
210905,202312,76,44,32,58080.2,42240,100320.2
210910,202312,2201,1676,525,2212377.36,693006.9,2905384.26
210920,202312,149,73,76,96362.23,100320,196682.23
210923,202312,81,67,14,88442.26,18480,106922.26
210927,202312,431,240,191,316803.18,252120.2,568923.38
210930,202312,103,92,11,121440.4,14520,135960.4
210940,202312,93,76,17,100320.91,22440,122760.91
210945,202312,220,137,83,180842.89,109560,290402.89
210950,202312,540,397,143,524045.24,188760.65,712805.89
210955,202312,116,72,44,95041.85,58080.9,153122.75
210960,202312,2647,1418,1229,1871772.18,1622283.09,3494055.27
210970,202312,110,92,18,121441.56,23760.9,145202.46
210975,202312,73,70,3,92400.51,3960.36,96360.87
210980,202312,1079,575,504,759018.43,666602.73,1425621.16
210990,202312,4685,3412,1273,4505278.2,1680378.06,6185656.26
211000,202312,1385,1145,240,1511446.11,316802.81,1828248.92
211003,202312,985,745,240,983415.79,316800.56,1300216.35
211010,202312,522,470,52,620407.64,69960.59,690368.23
211020,202312,1415,704,711,929302.79,938537.42,1867840.21
211023,202312,47,41,6,54121.2,7920,62041.2
211027,202312,91,70,21,92400.54,27720.2,120120.74
211030,202312,379,280,99,369602.01,130680.5,500282.51
211040,202312,319,274,45,361682.84,59400,421082.84
211050,202312,1214,869,345,1147116.86,455401.73,1602518.59
211060,202312,649,574,75,759033.65,99000.4,858034.05
211065,202312,28,24,4,31682.94,5280.66,36963.60
211070,202312,859,729,130,962323.35,171602.27,1133925.62
211080,202312,100,96,4,126720.75,5280,132000.75
211085,202312,75,41,34,54120,44880,99000
211090,202312,108,94,14,124085.95,18480,142565.95
211100,202312,481,410,71,541216.44,93720.2,634936.64
211102,202312,236,176,60,232320.4,79200.2,311520.6
211105,202312,235,174,61,229681.68,80520.96,310202.64
211107,202312,134,87,47,114840.2,62040,176880.2
211110,202312,1039,713,326,941183,430323.31,1371506.31
211120,202312,5699,3254,2445,4296803.5,3228756.58,7525560.08
211125,202312,31,24,7,31680,9240,40920
211130,202312,45449,23240,22209,30686033.24,29326824.88,60012858.12
211140,202312,376,336,40,443535.79,52800.47,496336.26
211150,202312,1291,962,329,1269880.35,434284.01,1704164.36
211153,202312,187,110,77,145200,101640,246840
211157,202312,72,59,13,77880.96,17160,95040.96
211160,202312,734,617,117,814451.19,155760.9,970212.09
211163,202312,4,3,1,3960,1320,5280
211167,202312,11,11,0,14520,0,14520
211170,202312,440,340,100,450123.37,132001.35,582124.72
211172,202312,95,73,22,96360.99,29040,125400.99
211174,202312,31,18,13,23760,17160.92,40920.92
211176,202312,472,350,122,462007.18,161041.77,623048.95
211178,202312,105,74,31,97681.82,40920,138601.82
211180,202312,222,181,41,238921.95,54120,293041.95
211190,202312,76,70,6,92400,7920,100320
211195,202312,52,39,13,51483.51,17160,68643.51
211200,202312,156,130,26,171601.57,34320.46,205922.03
211210,202312,407,308,99,406566.45,130680.27,537246.72
211220,202312,4765,2923,1842,3858538.13,2432966.86,6291504.99
211223,202312,158,145,13,191404.67,17160,208564.67
211227,202312,68,53,15,69960.2,19800,89760.2
211230,202312,755,633,122,835593.53,161041.97,996635.50
211240,202312,414,355,59,468604.71,79200,547804.71
211245,202312,195,111,84,146522.64,112200.4,258723.04
211250,202312,1514,1300,214,1717398.41,282483.39,1999881.80
211260,202312,865,751,114,991329.38,151801.08,1143130.46
211270,202312,1882,1587,295,2094880.68,389401.63,2484282.31
211280,202312,1907,1372,535,1811073.69,706200.75,2517274.44
211285,202312,235,155,80,204600.8,105600,310200.8
211290,202312,861,613,248,810485.24,327360.54,1137845.78
211300,202312,808,664,144,876499.16,190081.16,1066580.32
211400,202312,1665,1138,527,1502195.31,695642.25,2197837.56
220005,202312,20,18,2,23760,2640,26400
220010,202312,90,76,14,100320.91,18480,118800.91
220020,202312,814,665,149,877813.03,196681.29,1074494.32
220025,202312,120,116,4,153121.76,5280,158401.76
220027,202312,70,54,16,71281.16,21120.2,92401.36
220030,202312,148,124,24,163682.26,31680,195362.26
220040,202312,1430,1113,317,1469191.27,418442.84,1887634.11
220045,202312,30,25,5,33003.04,6600.4,39603.44
220050,202312,696,591,105,780062.28,138600.94,918663.22
220060,202312,202,177,25,233646.87,33000.35,266647.22
220070,202312,117,104,13,137282.28,17160.7,154442.98
220080,202312,15,13,2,17160.22,2640,19800.22
220090,202312,44,31,13,40920.5,17160,58080.5
220095,202312,6,5,1,6600,1320,7920
220100,202312,31,26,5,34321.02,6600,40921.02
220105,202312,38,33,5,43560.95,6600,50160.95
220110,202312,282,256,26,337922.12,34320,372242.12
220115,202312,60,52,8,68640,10560,79200
220117,202312,24,23,1,30360,1320,31680
220120,202312,1616,1288,328,1700191.41,432960.58,2133151.99
220130,202312,32,31,1,40920.16,1320,42240.16
220140,202312,98,83,15,109561.93,19800.96,129362.89
220150,202312,533,406,127,535945.86,167643.98,703589.84
220155,202312,32,31,1,40920.93,1320,42240.93
220157,202312,27,24,3,31681.49,3960,35641.49
220160,202312,124,109,15,143882.13,19800,163682.13
220170,202312,59,45,14,59400,18480,77880
220173,202312,25,22,3,29040,3960,33000
220177,202312,22,22,0,29040.4,0,29040.4
220180,202312,72,69,3,91081.92,3960,95041.92
220190,202312,1305,1117,188,1474469.27,248164.34,1722633.61
220191,202312,43,39,4,51481.11,5280,56761.11
220192,202312,98,91,7,120121.98,9240,129361.98
220194,202312,61,53,8,69960.65,10560,80520.65
220196,202312,80,67,13,88443.85,17160.2,105604.05
220198,202312,5,5,0,6600,0,6600
220200,202312,439,378,61,498984.84,80520.84,579505.68
220202,202312,39,35,4,46201.17,5280,51481.17
220205,202312,74,66,8,87120.2,10560,97680.2
220207,202312,16,16,0,21120,0,21120
220208,202312,75,51,24,67320.27,31680.78,99001.05
220209,202312,39,34,5,44880,6600,51480
220210,202312,39,34,5,44880.87,6600,51480.87
220211,202312,45,42,3,55444.88,3960,59404.88
220213,202312,45,43,2,56761.9,2640,59401.9
220217,202312,47,36,11,47520.3,14520.8,62041.1
220220,202312,2624,1770,854,2336437.25,1127290.51,3463727.76
220225,202312,17,10,7,13200.58,9240,22440.58
220230,202312,1088,818,270,1079782.08,356407,1436189.08
220240,202312,175,156,19,205921.24,25080.31,231001.55
220245,202312,66,62,4,81841.4,5280,87121.4
220250,202312,166,140,26,184804.56,34320,219124.56
220253,202312,61,56,5,73920.45,6600,80520.45
220255,202312,63,54,9,71280.2,11880,83160.2
220260,202312,743,572,171,755056.98,225721.03,980778.01
220265,202312,25,22,3,29040,3960,33000
220270,202312,962,868,94,1145775.4,124080,1269855.4
220271,202312,45,37,8,48841.48,10560,59401.48
220272,202312,30,30,0,39600.7,0,39600.7
220273,202312,26,24,2,33000.2,2640,35640.2
220275,202312,74,63,11,83160,14520,97680
220277,202312,42,33,9,43560.63,11880.7,55441.33
220280,202312,30,22,8,29040,10560,39600
220285,202312,52,48,4,63362.19,5280,68642.19
220290,202312,1669,1441,228,1902097.77,300963.47,2203061.24
220300,202312,49,48,1,63361.74,1320,64681.74
220310,202312,396,340,56,448815.11,73922.87,522737.98
220320,202312,510,461,49,608544.4,64681,673225.4
220323,202312,5,3,2,3960.8,2640,6600.8
220325,202312,14,13,1,17160,1320,18480
220327,202312,22,22,0,29040.53,0,29040.53
220330,202312,235,170,65,224401.66,85800,310201.66
220335,202312,139,119,20,157080.82,26400,183480.82
220340,202312,71,57,14,75240.21,18480.69,93720.90
220342,202312,50,43,7,56764.49,9240,66004.49
220345,202312,101,90,11,118800.21,14520.48,133320.69
220350,202312,492,435,57,574205.86,75240.05,649445.91
220360,202312,56,36,20,47520.5,26400,73920.5
220370,202312,1485,1241,244,1638157.63,322080.4,1960238.03
220375,202312,25,23,2,30361.39,2640,33001.39
220380,202312,35,26,9,34320.6,11880,46200.6
220385,202312,18,15,3,19800,3960.66,23760.66
220390,202312,2695,1519,1176,2005157.23,1553664.09,3558821.32
220400,202312,41,36,5,47520,6600,54120
220410,202312,24,23,1,30360.86,1320,31680.86
220415,202312,14,13,1,17161.49,1320,18481.49
220420,202312,150,126,24,166321.83,31680,198001.83
220430,202312,177,154,23,203287.01,30360.2,233647.21
220435,202312,32,25,7,33000.72,9240,42240.72
220440,202312,327,281,46,370937.5,60720,431657.5
220450,202312,395,202,193,266648.25,254766.8,521415.05
220455,202312,62,60,2,79201.39,2640,81841.39
220460,202312,27,25,2,33001.76,2640.98,35642.74
220465,202312,70,53,17,69961.67,22440.41,92402.08
220470,202312,262,234,28,308888.41,36960,345848.41
220480,202312,67,62,5,81840.36,6600,88440.36
220490,202312,97,83,14,109560,18480,128040
220500,202312,144,122,22,161042.27,29040,190082.27
220510,202312,377,297,80,393373.23,105601.22,498974.45
220515,202312,35,32,3,42240.58,3960,46200.58
220520,202312,421,372,49,491050.99,64681.48,555732.47
220525,202312,15,11,4,14520.46,5280,19800.46
220527,202312,16,16,0,21121.22,0,21121.22
220530,202312,51,27,24,35640,31680,67320
220535,202312,6,5,1,6600.85,1320,7920.85
220540,202312,134,118,16,155760.72,21120.2,176880.92
220545,202312,27,19,8,25080.81,10560.8,35641.61
220550,202312,826,661,165,872549.41,217802,1090351.41
220551,202312,16,14,2,18480,2640,21120
220552,202312,18,18,0,23760,0,23760
220553,202312,77,74,3,97681.64,3960,101641.64
220554,202312,5,4,1,5280.73,1320,6600.73
220555,202312,66,52,14,68641.74,18480,87121.74
220556,202312,36,32,4,42242.76,5280,47522.76
220557,202312,72,66,6,87122.17,7920,95042.17
220558,202312,19,11,8,14520,10560.54,25080.54
220559,202312,13,13,0,17160.07,0,17160.07
220560,202312,93,61,32,80520.84,42240,122760.84
220570,202312,787,517,270,682452.98,356402.87,1038855.85
220580,202312,597,548,49,724723.7,64681.33,789405.03
220585,202312,17,14,3,18480.2,3960.67,22440.87
220590,202312,21,19,2,25081.68,2640,27721.68
220595,202312,88,69,19,91080.33,25080,116160.33
220600,202312,26,20,6,26400.2,7920,34320.2
220605,202312,40,36,4,47520.2,5280,52800.2
220610,202312,112,94,18,124080.45,23760,147840.45
220620,202312,605,524,81,691695.3,106922.78,798618.08
220630,202312,3,2,1,2640,1320,3960
220635,202312,37,33,4,43562.23,5280,48842.23
220640,202312,117,100,17,132000,22440,154440
220650,202312,127,121,6,159721.87,7920,167641.87
220660,202312,104,80,24,105601.07,31680.6,137281.67
220665,202312,17,17,0,22440,0,22440
220667,202312,35,33,2,43561.12,2640,46201.12
220669,202312,51,45,6,59400.2,7920,67320.2
220670,202312,88,70,18,92400.7,23760,116160.7
220672,202312,92,68,24,89765.18,31681.92,121447.10
220675,202312,30,24,6,31681.63,7920,39601.63
220680,202312,74,65,9,85800.2,11880,97680.2
220690,202312,51,48,3,63360,3960,67320
220695,202312,30,20,10,26400.95,13200,39600.95
220700,202312,2068,1629,439,2150312.26,580804.62,2731116.88
220710,202312,12,10,2,13200.2,2640.7,15840.9
220720,202312,116,102,14,134640,18480,153120
220730,202312,43,42,1,55440.01,1320,56760.01
220735,202312,15,11,4,14520,5280,19800
220740,202312,71,62,9,81840.62,11880.91,93721.53
220750,202312,157,128,29,168962.65,38280.18,207242.83
220755,202312,26,24,2,31681.92,2640,34321.92
220760,202312,83,72,11,95041.57,14520,109561.57
220770,202312,6816,4060,2756,5359462.72,3641958.78,9001421.50
220775,202312,16,12,4,15840.7,5280.89,21121.59
220777,202312,31,30,1,39600,1320,40920
220779,202312,7,3,4,3960,5280,9240
220780,202312,1014,861,153,1137853.26,201961.01,1339814.27
220785,202312,7,4,3,5280,3960.2,9240.2
220790,202312,1378,1112,266,1467874.47,351128.36,1819002.83
220793,202312,13,9,4,11880,5280,17160
220795,202312,33,31,2,40921.63,2640,43561.63
220800,202312,4389,3366,1023,4443460.34,1351693.49,5795153.83
220810,202312,98,84,14,110880.95,18480,129360.95
220820,202312,281,251,30,331329.18,39601.5,370930.68
220830,202312,1473,1317,156,1738262.17,205921.77,1944183.94
220840,202312,2861,2042,819,2695527.33,1083744.66,3779271.99
220850,202312,96,83,13,109560.2,17160,126720.2
220855,202312,8,4,4,5280,5280,10560
220860,202312,21,16,5,21122.22,6600,27722.22
220865,202312,34,31,3,40920.1,3960,44880.1
220870,202312,109,98,11,129361.8,14520,143881.8
220880,202312,369,305,64,402610.97,84481.92,487092.89
220885,202312,34,32,2,42242.73,2640,44882.73
220887,202312,6,5,1,6600.2,1320,7920.2
220890,202312,92,79,13,104281.33,17160,121441.33
220900,202312,32,20,12,26400,15840,42240
220910,202312,57,44,13,58082.68,17160.19,75242.87
220915,202312,13,11,2,14520,2640,17160
220920,202312,57,49,8,64681.13,10560,75241.13
220930,202312,65,63,2,83160.41,2640,85800.41
220935,202312,20,20,0,26400.97,0,26400.97
220937,202312,39,35,4,46200.41,5280,51480.41
220940,202312,73,66,7,87120.2,9240,96360.2
220945,202312,5,5,0,6600,0,6600
220950,202312,43,34,9,44880.88,11880,56760.88
220955,202312,30,28,2,36960.41,2640,39600.41
220960,202312,50,44,6,58080.95,7920,66000.95
220965,202312,62,57,5,75240,6600,81840
220970,202312,67,56,11,73920,14520,88440
220975,202312,16,14,2,18480.9,2640.96,21121.86
220980,202312,30,28,2,36960.96,2640,39600.96
220985,202312,61,52,9,68640,11880,80520
220987,202312,43,41,2,54122.7,2640.97,56763.67
220990,202312,30,28,2,36960,2992,39952
220995,202312,20,17,3,22440,3960,26400
220997,202312,83,75,8,99002.75,10560,109562.75
221000,202312,1436,1270,166,1676442.15,219121.76,1895563.91
221005,202312,61,56,5,73920,6600.57,80520.57
221010,202312,35,25,10,33000,13200,46200
221020,202312,55,49,6,64680.69,7920,72600.69
221030,202312,50,41,9,54016.43,11880,65896.43
221035,202312,22,20,2,26401.61,2640,29041.61
221037,202312,14,11,3,14520,3960,18480
221038,202312,26,23,3,30360,3960,34320
221039,202312,32,32,0,42240.94,0,42240.94
221040,202312,286,243,43,320766.13,56761,377527.13
221050,202312,262,220,42,290410.48,55440.58,345851.06
221060,202312,2206,1901,305,2510689.29,402605.23,2913294.52
221062,202312,37,36,1,47521.49,1320,48841.49
221063,202312,23,18,5,23760,6600,30360
221065,202312,86,70,16,92402.58,21120,113522.58
221070,202312,184,164,20,216486.41,26400,242886.41
221080,202312,465,390,75,514815.4,99000,613815.4
221090,202312,33,26,7,34321.74,9240,43561.74
221093,202312,58,48,10,63363.76,13200.08,76563.84
221095,202312,5,5,0,6600,0,6600
221097,202312,15,13,2,17160,2640,19800
221100,202312,30994,18834,12160,24873816.31,16059436.98,40933253.29
221110,202312,1278,1006,272,1327966.37,359048.56,1687014.93
221120,202312,649,466,183,615133.67,241560.84,856694.51
221130,202312,1120,906,214,1195938.45,283804.92,1479743.37
221135,202312,41,37,4,48841.09,5280,54121.09
221140,202312,55,48,7,63360.54,9240,72600.54
221150,202312,18,15,3,19800.18,3960,23760.18
221160,202312,24,22,2,29042.34,2640,31682.34
221170,202312,27,26,1,34320,1320,35640
230010,202312,166,145,21,191402.23,27720,219122.23
230015,202312,205,173,32,228360.9,42240,270600.9
230020,202312,2129,1686,443,2225570.57,586092.64,2811663.21
230030,202312,1854,1375,479,1815062.56,632286.72,2447349.28
230040,202312,281,229,52,302282.03,68640,370922.03
230050,202312,286,196,90,258721.46,118800.13,377521.59
230060,202312,195,152,43,200640.69,56760.94,257401.63
230070,202312,355,296,59,390724.55,77880,468604.55
230075,202312,1070,878,192,1158992.71,253444.23,1412436.94
230080,202312,265,220,45,290402.62,59400,349802.62
230090,202312,233,173,60,228361.14,79200,307561.14
230100,202312,3223,1828,1395,2413057.88,1842744.03,4255801.91
230110,202312,3420,2173,1247,2868441.51,1646057.87,4514499.38
230120,202312,1418,1093,325,1442800.33,430325.4,1873125.73
230125,202312,221,177,44,233640.83,58080.34,291721.17
230130,202312,604,519,85,685090.87,112201.02,797291.89
230140,202312,258,213,45,281163.12,59400,340563.12
230150,202312,161,125,36,165002.97,47520.6,212523.57
230160,202312,1093,889,204,1173490.81,269281.04,1442771.85
230170,202312,738,624,114,823706.12,150482.95,974189.07
230180,202312,81,74,7,97680.39,9240,106920.39
230185,202312,491,424,67,559692.23,88440.98,648133.21
230190,202312,2924,2179,745,2876368.4,983410.29,3859778.69
230195,202312,611,525,86,693021.08,113520,806541.08
230200,202312,529,408,121,538566.92,159720.2,698287.12
230205,202312,487,326,161,430320.2,212520,642840.2
230210,202312,1630,1237,393,1632875.01,518760.89,2151635.90
230220,202312,1852,1230,622,1623636.33,822364.4,2446000.73
230230,202312,1156,923,233,1218390.91,307563.21,1525954.12
230240,202312,2537,2250,287,2970061.88,378847.34,3348909.22
230250,202312,2154,1738,416,2294243.99,549128.92,2843372.91
230260,202312,3790,2388,1402,3152197.83,1854605.3,5006803.13
230270,202312,1555,1195,360,1577425.71,475205.48,2052631.19
230280,202312,3316,2557,759,3375352.28,1001891.87,4377244.15
230290,202312,396,345,51,455417.64,67320.57,522738.21
230300,202312,578,429,149,566284.83,196680.1,762964.93
230310,202312,489,379,110,500280.97,145200.26,645481.23
230320,202312,1061,876,185,1156345.12,244202.15,1400547.27
230330,202312,386,313,73,413163.96,96360,509523.96
230340,202312,527,425,102,561011.18,134640.4,695651.58
230350,202312,3924,2398,1526,3166782.91,2014334.2,5181117.11
230360,202312,308,248,60,327365.07,79201.31,406566.38
230365,202312,172,137,35,180841.43,46200,227041.43
230370,202312,13840,7092,6748,9361936.76,8910257.2,18272193.96
230380,202312,594,506,88,667937.43,117484,785421.43
230390,202312,606,359,247,473882.5,326040,799922.5
230393,202312,284,234,50,308882.28,66000.5,374882.78
230395,202312,432,345,87,455427.98,114844.5,570272.48
230400,202312,783,621,162,819731.17,213840.2,1033571.37
230410,202312,3402,2209,1193,2917287.18,1574777.88,4492065.06
230420,202312,7567,5003,2564,6604282.34,3384579.94,9988862.28
230423,202312,414,357,57,471244.02,76560,547804.02
230425,202312,605,485,120,640209.31,161042.47,801251.78
230426,202312,139,115,24,151800.2,31680,183480.2
230427,202312,82,71,11,93720.8,14520,108240.8
230428,202312,2108,1027,1081,1355689.26,1428255.43,2783944.69
230430,202312,535,433,102,571571.14,134641.98,706213.12
230435,202312,1123,814,309,1075826.16,407881.63,1483707.79
230440,202312,116496,54824,61672,72381719.26,81440165.77,153821885.03
230445,202312,375,254,121,335289.51,159720,495009.51
230450,202312,664,518,146,685085.03,192720.7,877805.73
230460,202312,124,92,32,122760.26,42240,165000.26
230465,202312,359,289,70,381484.83,92400,473884.83
230470,202312,2328,1839,489,2428827.08,645483.69,3074310.77
230480,202312,167,149,18,196680.5,23761.37,220441.87
230490,202312,376,296,80,390723.85,105600.46,496324.31
230495,202312,583,424,159,559691.11,209882.71,769573.82
230500,202312,1380,1040,340,1372819.99,448803.65,1821623.64
230510,202312,92,62,30,81840.67,39600,121440.67
230520,202312,481,357,124,471246.51,163681.23,634927.74
230523,202312,3129,1924,1205,2541089.96,1591937.34,4133027.30
230526,202312,281,235,46,310202.03,60720,370922.03
230530,202312,798,566,232,747133.23,306244.77,1053378.00
230533,202312,258,232,26,306242.18,34320.2,340562.38
230535,202312,480,357,123,471253.61,162361.79,633615.40
230540,202312,2035,1814,221,2395871.89,291725.01,2687596.90
230550,202312,4947,3187,1760,4207050.47,2323244.65,6530295.12
230560,202312,664,511,153,674531.84,201960.57,876492.41
230565,202312,260,195,65,257401.31,85800.2,343201.51
230570,202312,350,301,49,397322.18,64680.45,462002.63
230580,202312,1449,988,461,1304177.76,608526.59,1912704.35
230590,202312,1281,997,284,1315953.56,374881.53,1690835.09
230600,202312,356,321,35,423728.7,46200.93,469929.63
230610,202312,580,438,142,579496.49,187441.87,766938.36
230620,202312,197,164,33,216481.94,43560.52,260042.46
230625,202312,1036,713,323,942498.38,426361.41,1368859.79
230630,202312,1739,1293,446,1706800.93,588724.79,2295525.72
230640,202312,4642,3714,928,4902661.64,1224993.18,6127654.82
230650,202312,609,519,90,685087.35,118802.28,803889.63
230655,202312,904,698,206,921395.73,271921.4,1193317.13
230660,202312,463,380,83,502924.77,109560.2,612484.97
230670,202312,546,430,116,567622.66,153121.52,720744.18
230680,202312,264,220,44,290408.38,58081.06,348489.44
230690,202312,1110,928,182,1224993.51,240242.44,1465235.95
230700,202312,1236,1023,213,1350393.42,281162.62,1631556.04
230710,202312,771,698,73,921391.49,96360.8,1017752.29
230720,202312,165,141,24,186120.47,31680.2,217800.67
230725,202312,368,282,86,372244.54,114841.03,487085.57
230730,202312,15127,8044,7083,10624046.93,9353676.76,19977723.69
230740,202312,854,695,159,917421.03,209881.79,1127302.82
230750,202312,957,785,172,1036227.62,227041.43,1263269.05
230760,202312,1924,1620,304,2138478.27,401283.46,2539761.73
230763,202312,449,381,68,502925.3,89760,592685.3
230765,202312,10798,5376,5422,7098103.98,7159906.24,14258010.22
230770,202312,6147,3293,2854,4346915.37,3769956.13,8116871.50
230780,202312,954,818,136,1079773.42,180840.1,1260613.52
230790,202312,379,302,77,398640.12,101640.41,500280.53
230800,202312,1415,1006,409,1327941.52,539881.83,1867823.35
230810,202312,1613,1393,220,1840169.36,290405.38,2130574.74
230820,202312,440,290,150,382805.63,198002.27,580807.90
230830,202312,1077,897,180,1184062.82,237601.83,1421664.65
230835,202312,323,267,56,352445.27,73920.68,426365.95
230837,202312,223,179,44,236281.7,58080.43,294362.13
230840,202312,1129,844,285,1114094.49,376203,1490297.49
230850,202312,1566,1301,265,1717362.89,349806.24,2067169.13
230860,202312,405,324,81,427683.03,106926.6,534609.63
230870,202312,2094,1762,332,2325878.75,439560.47,2765439.22
230880,202312,101,80,21,105600,27720,133320
230890,202312,697,613,84,809167.74,110881.49,920049.23
230900,202312,369,281,88,370922.61,116160.24,487082.85
230910,202312,261,202,59,266643.04,77880,344523.04
230920,202312,597,468,129,617767.12,170280.99,788048.11
230930,202312,1324,932,392,1230268.62,517441.51,1747710.13
230940,202312,994,766,228,1011141.4,300960.73,1312102.13
230945,202312,684,528,156,698303.15,205925.45,904228.60
230950,202312,513,444,69,586103.47,91080.32,677183.79
230960,202312,3300,2242,1058,2959580.33,1396589.97,4356170.30
230970,202312,2324,1307,1017,1725307.64,1343777.62,3069085.26
230980,202312,274,199,75,262683.1,99000,361683.1
230990,202312,169,133,36,175560.5,47520,223080.5
231000,202312,246,227,19,299644.06,25080,324724.06
231010,202312,223,155,68,204601.68,89760,294361.68
231020,202312,1773,1168,605,1541823.98,798615.8,2340439.78
231025,202312,1330,923,407,1218407.58,537251.05,1755658.63
231030,202312,1205,970,235,1281735.98,310202.36,1591938.34
231040,202312,217,159,58,209883.26,76560,286443.26
231050,202312,1084,924,160,1219704.97,211207.81,1430912.78
231060,202312,182,144,38,190083.69,50161.15,240244.84
231070,202312,1796,1257,539,1659277.05,711487.66,2370764.71
231080,202312,301,260,41,343206.65,54120,397326.65
231085,202312,843,525,318,693024.73,419760.26,1112784.99
231090,202312,314,255,59,336606.54,77882.42,414488.96
231095,202312,178,133,45,175560,59400.7,234960.7
231100,202312,229,187,42,246843.39,55440,302283.39
231110,202312,439,365,74,481810.12,97681.88,579492.00
231120,202312,304,246,58,324724.06,76560.53,401284.59
231123,202312,163,155,8,204604.44,10560,215164.44
231126,202312,397,314,83,414481.93,109560,524041.93
231130,202312,5842,4602,1240,6078849.96,1636828.9,7715678.86
231135,202312,263,231,32,304925.78,42241.23,347167.01
231140,202312,3583,2583,1000,3410978.06,1320012,4730990.06
231150,202312,462,425,37,561012.66,48841.29,609853.95
231160,202312,1451,1191,260,1572150.26,343202.38,1915352.64
231170,202312,608,421,187,555725.1,248160,803885.1
231180,202312,2317,2001,316,2641410.81,417126.22,3058537.03
231190,202312,277,223,54,294361.14,71280,365641.14
231195,202312,285,233,52,307563.15,69960.15,377523.30
231200,202312,1027,821,206,1083748.97,271922.58,1355671.55
231210,202312,604,503,101,663970.52,133321.39,797291.91
231220,202312,1272,893,379,1181431.36,500283.53,1681714.89
231230,202312,1861,1366,495,1803152.52,653400.72,2456553.24
231240,202312,1999,1345,654,1775445.4,863292.41,2638737.81
231250,202312,101,94,7,124080.2,9240,133320.2
231260,202312,302,210,92,277202.59,121441.91,398644.50
231270,202312,1104,845,259,1115431.47,341881.26,1457312.73
231280,202312,105,80,25,105602.48,33000,138602.48
231290,202312,9626,5450,4176,7195621.95,5517704.63,12713326.58
231300,202312,677,610,67,806529.8,88440,894969.8
231310,202312,989,905,84,1194620.99,110880.91,1305501.90
231320,202312,759,565,194,745810,256082.72,1001892.72
231325,202312,120,103,17,135961.37,22440.54,158401.91
231330,202312,2238,1694,544,2236157.19,718091.11,2954248.30
231335,202312,294,259,35,341887.6,46200.26,388087.86
231340,202312,2461,1688,773,2228210.6,1020368.51,3248579.11
231350,202312,1714,1325,389,1749064.5,513494.97,2262559.47
231355,202312,474,390,84,514807.69,110880.64,625688.33
231360,202312,719,489,230,645498.6,303602.23,949100.83
231370,202312,109,95,14,125400,18480,143880
231375,202312,324,243,81,322085.09,106920,429005.09
231380,202312,628,496,132,654725.37,174240,828965.37
231390,202312,257,196,61,258721.57,80520,339241.57
231395,202312,902,530,372,699608.07,491041.25,1190649.32
231400,202312,1449,1212,237,1599878.8,312844.35,1912723.15
231410,202312,1746,1426,320,1882353.17,422402.52,2304755.69
240010,202312,438,202,236,266650.76,311529.14,578179.90
240020,202312,2669,2197,472,2901481.21,623052.32,3524533.53
240030,202312,133,102,31,134642.06,40920,175562.06
240040,202312,44,42,2,55440.2,2640,58080.2
240050,202312,585,498,87,657392.05,114840.3,772232.35
240060,202312,94,82,12,108241.41,15840,124081.41
240070,202312,337,253,84,333964.42,110880.52,444844.94
240080,202312,683,455,228,600627.09,300967.93,901595.02
240090,202312,124,107,17,141240.89,22440,163680.89
240100,202312,1761,1638,123,2162234.29,162362.23,2324596.52
240110,202312,1232,845,387,1116801.82,510859.56,1627661.38
240120,202312,179,131,48,172923.14,63360.19,236283.33
240130,202312,295,268,27,353777.56,35642.68,389420.24
240140,202312,104,65,39,85801.79,51481.54,137283.33
240145,202312,848,747,101,986076.62,133320.92,1119397.54
240150,202312,39,29,10,38280,13200.9,51480.9
240160,202312,43,36,7,47520,9240,56760
240165,202312,43,36,7,47524.16,9240.1,56764.26
240170,202312,201,142,59,187443.39,77880,265323.39
240180,202312,151,108,43,142563.16,56761.87,199325.03
240185,202312,63,51,12,67320.16,15840,83160.16
240190,202312,17,15,2,19800.43,2640,22440.43
240200,202312,3542,1892,1650,2497513.18,2179344.02,4676857.20
240210,202312,184,137,47,180840.93,62040,242880.93
240220,202312,1334,899,435,1186727.96,574205.42,1760933.38
240230,202312,936,835,101,1103569.38,133320.76,1236890.14
240240,202312,101,65,36,85800.2,47520.43,133320.63
240250,202312,119,103,16,135960.33,21120,157080.33
240260,202312,2239,1580,659,2086995.51,869893.47,2956888.98
240270,202312,195,162,33,213841,43560,257401
240280,202312,78,63,15,83161.03,19800.1,102961.13
240290,202312,48,46,2,60720.63,2640,63360.63
240300,202312,188,104,84,137282.11,110880,248162.11
240310,202312,2897,1577,1320,2081708.35,1742423.11,3824131.46
240320,202312,187,173,14,228360.07,18480,246840.07
240325,202312,5958,3327,2631,4394509.84,3473013.38,7867523.22
240330,202312,92,87,5,114840.23,6600,121440.23
240340,202312,137,104,33,137280.03,43560,180840.03
240350,202312,116,90,26,118800.4,34320,153120.4
240360,202312,1022,677,345,895006.19,455406.91,1350413.10
240370,202312,78,66,12,87121.5,15841.6,102963.1
240375,202312,52,35,17,46201.6,22440.91,68642.51
240380,202312,245,201,44,265335.14,58080.75,323415.89
240390,202312,21,19,2,25080,2640,27720
240400,202312,95,83,12,109561.84,15840,125401.84
240410,202312,15,11,4,14520,5280,19800
240420,202312,1276,885,391,1168237.7,516129.51,1684367.21
240430,202312,300,268,32,353773.11,42240.9,396014.01
240440,202312,193,125,68,165007.52,89760.71,254768.23
240450,202312,318,195,123,257411.71,162364.09,419775.80
240460,202312,115,92,23,121441.46,30360,151801.46
240470,202312,248,224,24,295703.83,31681.3,327385.13
240480,202312,20,17,3,22440,3960,26400
240485,202312,102,86,16,113521,21120,134641
240490,202312,72,63,9,83162.66,11880,95042.66
240500,202312,124,99,25,130680.49,33000,163680.49
240510,202312,37,29,8,38280,10560,48840
240520,202312,104,98,6,129363.79,7920.63,137284.42
240530,202312,84,62,22,81840,29040,110880
240540,202312,116,98,18,129360.1,23760,153120.1
240550,202312,12,10,2,13200,2640,15840
240560,202312,458,310,148,409213.93,195360.83,604574.76
240570,202312,482,296,186,390727.94,245520.49,636248.43
240580,202312,1570,1115,455,1471843.85,601921.38,2073765.23
240590,202312,34,33,1,43561.72,1320,44881.72
240600,202312,116,108,8,142561.95,10560,153121.95
240610,202312,547,449,98,592707.63,129364.83,722072.46
240615,202312,15,13,2,17161.5,2640,19801.5
240620,202312,95,92,3,121441.86,3960,125401.86
240630,202312,53,43,10,56760.97,13200.09,69961.06
240640,202312,49,36,13,47520,17160,64680
240650,202312,280,221,59,291726.71,77880,369606.71
240660,202312,133,111,22,146521.73,29040,175561.73
240670,202312,342,193,149,257417.56,196688.03,454105.59
240680,202312,61,49,12,64680.98,15840,80520.98
240690,202312,55,52,3,68641.66,3960,72601.66
240700,202312,196,165,31,217801.2,40921.02,258722.22
240710,202312,2780,1671,1109,2207138.38,1463901,3671039.38
240720,202312,1176,807,369,1065275.97,487087.59,1552363.56
240725,202312,82,73,9,96362.24,11880.88,108243.12
240730,202312,161,134,27,176880.87,35640.9,212521.77
240740,202312,273,216,57,285132.87,75240.62,360373.49
240750,202312,61,38,23,50160,30360,80520
240760,202312,69,54,15,71280,19800,91080
240770,202312,175,132,43,174242.42,56760.94,231003.36
240780,202312,871,698,173,922706.09,228361.78,1151067.87
240790,202312,45,42,3,55442.18,3960,59402.18
240800,202312,11439,7713,3726,10184512.64,4918521.51,15103034.15
240810,202312,26198,14037,12161,18533809.13,16056850.42,34590659.55
240820,202312,333,208,125,274570.03,165002.86,439572.89
240830,202312,1778,1475,303,1947062.17,399965.98,2347028.15
240840,202312,88,75,13,99000.13,17160,116160.13
240850,202312,95,79,16,104280,21120,125400
240860,202312,123,119,4,157082.09,5280,162362.09
240870,202312,63,52,11,68642.46,14520,83162.46
240880,202312,40,34,6,44880,7920,52800
240890,202312,1384,779,605,1028315.36,798611.81,1826927.17
240895,202312,82,66,16,87123.27,21120.44,108243.71
240910,202312,214,175,39,231001.81,51480.2,282482.01
240920,202312,14,11,3,14521.68,3960,18481.68
240930,202312,485,432,53,570266.28,69961.91,640228.19
240933,202312,74,48,26,63360.95,34320,97680.95
240940,202312,2494,2165,329,2857886.22,435606.35,3293492.57
240950,202312,41,36,5,47520.6,6600,54120.6
240960,202312,23,19,4,25082.01,5280.3,30362.31
240970,202312,124,90,34,118800.53,44880,163680.53
240980,202312,245,192,53,253444.41,69960.9,323405.31
240990,202312,164,105,59,138602.31,77880,216482.31
241000,202312,64,58,6,76561.81,7920.82,84482.63
241010,202312,112,83,29,109560.59,38280,147840.59
241020,202312,127,117,10,154440.86,13200.82,167641.68
241025,202312,24,18,6,23761.18,7920.5,31681.68
241030,202312,138,104,34,137280,44880,182160
241040,202312,55,44,11,58080.3,14520,72600.3
241050,202312,86,80,6,105601.83,7920,113521.83
241060,202312,34,29,5,38280.78,6600,44880.78
241070,202312,28,26,2,34322.04,2640,36962.04
241080,202312,67,59,8,77880.2,10560,88440.2
241090,202312,78,67,11,88443.7,14520,102963.7
241100,202312,73,63,10,83163.06,13200.08,96363.14
241105,202312,36,24,12,31684,15840.64,47524.64
241110,202312,66,50,16,66000.15,21120,87120.15
241120,202312,2014,1507,507,1989292.94,669244.69,2658537.63
241140,202312,226,183,43,241564.1,56760,298324.1
241142,202312,56,42,14,55441.3,18480,73921.3
241150,202312,1305,1137,168,1500891.12,223083.07,1723974.19
241160,202312,37,23,14,30360,18480,48840
241170,202312,61,51,10,67320.07,13200,80520.07
241180,202312,52,39,13,51480,17160,68640
241190,202312,44,40,4,52801.03,5280,58081.03
241200,202312,5847,3083,2764,4071121.75,3649904.94,7721026.69
241210,202312,79,66,13,87120.1,17160,104280.1
241220,202312,1792,1127,665,1487708.21,877812.13,2365520.34
241230,202312,291,236,55,311525.91,72600.91,384126.82
241240,202312,58,44,14,59400.7,18480,77880.7
241250,202312,1261,1150,111,1518045.93,146523.07,1664569.00
241255,202312,87,70,17,92401.44,22440,114841.44
241260,202312,874,663,211,875185.68,278522.47,1153708.15
241270,202312,87,66,21,87123.03,27720,114843.03
241280,202312,106,92,14,121442.02,18480,139922.02
241290,202312,182,140,42,184803.9,55440,240243.9
241300,202312,91,58,33,76560.7,43560.98,120121.68
241310,202312,62,43,19,56762.76,25080.1,81842.86
241320,202312,44,27,17,35642.66,22440,58082.66
241330,202312,69,57,12,75240.02,15840,91080.02
241335,202312,125,113,12,149165.34,15840,165005.34
241340,202312,211,142,69,187440.84,91080,278520.84
241350,202312,71,60,11,79201.77,14520,93721.77
241355,202312,66,51,15,67322.72,19800,87122.72
241360,202312,76,71,5,93720.49,6600,100320.49
241370,202312,80,63,17,83160,22440,105600
241380,202312,38,33,5,43561.3,6600,50161.3
241390,202312,100,81,19,106920.66,25080,132000.66
241400,202312,263,196,67,259679.97,88443.35,348123.32
241410,202312,218,199,19,262681.14,25080.85,287761.99
241415,202312,121,95,26,125400.1,34320.8,159720.9
241420,202312,186,112,74,147843.8,97680.8,245524.6
241430,202312,26,22,4,29040,5280,34320
241440,202312,606,515,91,679833.31,120123.77,799957.08
241445,202312,54,49,5,64680.2,6600,71280.2
241450,202312,278,232,46,306251.55,60720.44,366971.99
241460,202312,210,193,17,254765.36,22440.4,277205.76
241470,202312,34,28,6,36960.8,7920,44880.8
241475,202312,55,51,4,67320,5280,72600
241480,202312,188,137,51,180842.39,68640.2,249482.59
241490,202312,17,15,2,19800.84,2640.1,22440.94
241500,202312,56,42,14,55443.26,18480.02,73923.28
250010,202312,119,102,17,134641.18,22440.02,157081.20
250020,202312,36,32,4,42240,5280,47520
250030,202312,1021,772,249,1019071.41,328685.41,1347756.82
250040,202312,469,373,96,492380.35,126721.77,619102.12
250050,202312,323,265,58,349802.28,76560.5,426362.78
250053,202312,72,61,11,80521.18,14520,95041.18
250057,202312,4,3,1,3960.2,1320,5280.2
250060,202312,680,491,189,648138.03,249481.25,897619.28
250070,202312,719,579,140,764300.22,184800.44,949100.66
250073,202312,8,8,0,10560,0,10560
250077,202312,208,148,60,195363.12,79200.2,274563.32
250080,202312,430,344,86,454094.23,113520.38,567614.61
250090,202312,233,146,87,192720.99,114840,307560.99
250100,202312,676,538,138,710169.44,182161,892330.44
250110,202312,783,564,219,744495.42,289081.68,1033577.10
250115,202312,17,7,10,9240.18,13200.26,22440.44
250120,202312,128,92,36,121440.98,47521.68,168962.66
250130,202312,626,520,106,686421.6,139922.06,826343.66
250135,202312,39,18,21,23760.84,27720,51480.84
250140,202312,106,86,20,113523.3,26400,139923.3
250150,202312,744,516,228,681134.33,300961.99,982096.32
250153,202312,25,19,6,25080.1,7920,33000.1
250157,202312,66,51,15,67320.89,19800,87120.89
250160,202312,278,214,64,282483.46,84480,366963.46
250170,202312,102,69,33,91080.2,43560,134640.2
250180,202312,5861,4120,1741,5441337.64,2298181.17,7739518.81
250190,202312,838,574,264,757688.35,348482.15,1106170.50
250200,202312,92,72,20,95041.08,26400.7,121441.78
250205,202312,30,22,8,29040,10560.18,39600.18
250210,202312,93,78,15,102962.32,19800,122762.32
250215,202312,123,78,45,102961.65,59400.21,162361.86
250220,202312,33,22,11,29040.41,14520,43560.41
250230,202312,82,72,10,95040.3,13200.2,108240.5
250240,202312,272,203,69,267965.74,91080.2,359045.94
250250,202312,481,410,71,541217.14,93720,634937.14
250260,202312,62,51,11,67320.93,14520.12,81841.05
250270,202312,85,63,22,83160.8,29040,112200.8
250280,202312,450,367,83,484445.01,109560,594005.01
250290,202312,129,115,14,151800.3,18480.62,170280.92
250300,202312,567,384,183,506893.78,241560.4,748454.18
250310,202312,71,64,7,84481.58,9240,93721.58
250320,202312,2295,1533,762,2023659.85,1007180.1,3030839.95
250330,202312,134,115,19,151802.94,25080.1,176883.04
250340,202312,38,30,8,39600.55,10560,50160.55
250350,202312,233,153,80,201962,105600,307562
250355,202312,55,45,10,59400,13200.25,72600.25
250360,202312,207,169,38,223084,50160.89,273244.89
250370,202312,2668,1710,958,2257289.99,1267223.36,3524513.35
250375,202312,17,11,6,14521.35,7920.65,22442.00
250380,202312,63,55,8,72600.89,10560,83160.89
250390,202312,59,48,11,63361.3,14520,77881.3
250400,202312,20384,10837,9547,14309441,12606268.91,26915709.91
250403,202312,306,235,71,310202.52,93720,403922.52
250407,202312,78,61,17,80520.1,22440.85,102960.95
250410,202312,37,32,5,42240.31,6600.8,48841.11
250415,202312,61,37,24,48840,31680,80520
250420,202312,52,42,10,55440.3,13200,68640.3
250430,202312,1683,1481,202,1955306.41,266641.39,2221947.80
250435,202312,34,28,6,36961.09,7920,44881.09
250440,202312,719,593,126,782773.63,166321,949094.63
250450,202312,97,73,24,96361.44,31680,128041.44
250460,202312,586,390,196,514804.49,258722.24,773526.73
250470,202312,109,79,30,104281.5,39600,143881.5
250480,202312,375,296,79,390731.07,104280.98,495012.05
250485,202312,8,7,1,9240,1320,10560
250490,202312,279,224,55,295684.63,72600.96,368285.59
250500,202312,125,95,30,125400,39600,165000
250510,202312,977,776,201,1024337.19,265320.78,1289657.97
250520,202312,182,125,57,165000,75240.7,240240.7
250523,202312,144,115,29,151801.02,38280.12,190081.14
250527,202312,144,93,51,122760.98,67320.2,190081.18
250530,202312,16,12,4,15840.6,5280,21120.6
250535,202312,33,27,6,35640.15,7920,43560.15
250540,202312,150,121,29,159720.25,38280,198000.25
250550,202312,83,80,3,105601.19,3960,109561.19
250560,202312,69,43,26,56761.11,34320.07,91081.18
250570,202312,178,143,35,188761.55,46200.7,234962.25
250580,202312,97,76,21,100405.2,27720,128125.2
250590,202312,26,19,7,25080,9240,34320
250600,202312,1856,1247,609,1646075.78,803884.11,2449959.89
250610,202312,162,128,34,168968.45,44880.22,213848.67
250620,202312,26,21,5,27720.81,6600,34320.81
250625,202312,80,63,17,83162.33,22440.24,105602.57
250630,202312,3457,2143,1314,2829099.69,1734503.91,4563603.60
250640,202312,210,169,41,223085.57,54120.15,277205.72
250650,202312,36,26,10,34321.49,13200,47521.49
250660,202312,70,49,21,64680.52,27720,92400.52
250670,202312,93,76,17,100320.99,22440,122760.99
250680,202312,471,376,95,496332.29,125400.59,621732.88
250690,202312,2453,1667,786,2200493.38,1037530.5,3238023.88
250700,202312,1063,883,180,1165576.92,237600.83,1403177.75
250710,202312,573,440,133,580842.84,175565.93,756408.77
250720,202312,147,112,35,147841.98,46200,194041.98
250730,202312,451,367,84,484448.18,110882.53,595330.71
250740,202312,90,82,8,108242.24,10560,118802.24
250750,202312,29863,17725,12138,23405881.54,16026475.65,39432357.19
250760,202312,138,109,29,143880.87,38281.96,182162.83
250770,202312,404,272,132,359046.85,174240.7,533287.55
250780,202312,89,61,28,80521.51,36960,117481.51
250790,202312,509,326,183,430326.04,241562.48,671888.52
250800,202312,169,151,18,199320,23760,223080
250810,202312,77,64,13,84480.04,17160,101640.04
250820,202312,169,139,30,183482.55,39600.26,223082.81
250830,202312,574,382,192,504258.26,253440.9,757699.16
250840,202312,66,55,11,72600.98,14520.2,87121.18
250850,202312,84,69,15,91081.61,19800,110881.61
250855,202312,22,18,4,23760.2,5280,29040.2
250860,202312,264,173,91,228363.22,120120,348483.22
250870,202312,43,39,4,51480,5280,56760
250880,202312,112,82,30,108240.08,39600,147840.08
250890,202312,3580,2618,962,3457174,1269856.01,4727030.01
250900,202312,96,79,17,104281.47,22440,126721.47
250905,202312,141,106,35,139920.9,46200,186120.9
250910,202312,1064,779,285,1028308.73,376206.23,1404514.96
250915,202312,133,90,43,118801.86,56761.77,175563.63
250920,202312,182,141,41,186120,54120.7,240240.7
250930,202312,216,123,93,162361.48,122761.1,285122.58
250933,202312,16,13,3,17160,3960.46,21120.46
250937,202312,26,24,2,31680,2640,34320
250939,202312,51,38,13,50160.73,17160,67320.73
250940,202312,158,117,41,154441.93,54120.73,208562.66
250950,202312,95,70,25,92401.47,33000,125401.47
250960,202312,98,60,38,79203.99,50160.2,129364.19
250970,202312,1463,1044,419,1380750.6,554404.84,1935155.44
250980,202312,107,75,32,99000.99,42240,141240.99
250990,202312,183,140,43,184800,56760,241560
251000,202312,98,84,14,110880.9,18480,129360.9
251010,202312,173,124,49,163680,64680,228360
251020,202312,103,87,16,114841.27,21120,135961.27
251030,202312,53,37,16,48840.91,21120,69960.91
251040,202312,84,63,21,83160,29040,112200
251050,202312,38,31,7,40920,9240,50160
251060,202312,50,38,12,50161,15840.64,66001.64
251065,202312,8,5,3,6600,3960,10560
251070,202312,20,18,2,23761.53,2640,26401.53
251080,202312,6315,2965,3350,3913968.45,4423397.11,8337365.56
251090,202312,223,185,38,244202.18,50160,294362.18
251100,202312,27,24,3,31681.23,3960,35641.23
251110,202312,77,50,27,66000,35640,101640
251120,202312,2182,1373,809,1812442.02,1067899.43,2880341.45
251130,202312,499,413,86,545291.96,113520.05,658812.01
251140,202312,702,467,235,616444.53,310202.53,926647.06
251150,202312,384,319,65,421085.84,85800,506885.84
251160,202312,103,84,19,110880,25080.58,135960.58
251170,202312,85,70,15,92400.26,19800,112200.26
251180,202312,325,192,133,253443.99,175561.85,429005.84
251190,202312,133,93,40,122765.36,52800.58,175565.94
251200,202312,371,282,89,372251.12,117480.44,489731.56
251203,202312,40,33,7,43560.69,9240,52800.69
251207,202312,97,75,22,99000.61,29040,128040.61
251210,202312,1770,1289,481,1701516.61,634927.59,2336444.20
251220,202312,60,46,14,60720.74,18480,79200.74
251230,202312,664,558,106,736571.87,139921.02,876492.89
251240,202312,138,96,42,126720.5,55440,182160.5
251250,202312,1839,1324,515,1747625.79,679810.83,2427436.62
251260,202312,15,9,6,11880.41,7920.48,19800.89
251270,202312,373,282,91,372248.3,120120.69,492368.99
251272,202312,70,60,10,79201.1,13200,92401.1
251274,202312,22,17,5,22440.25,6600,29040.25
251275,202312,49,31,18,40920.62,23760,64680.62
251276,202312,40,31,9,40921.84,11880,52801.84
251278,202312,22,17,5,22442.26,6600,29042.26
251280,202312,137,132,5,174240.4,6600,180840.4
251290,202312,1334,939,395,1239564.05,521425.51,1760989.56
251300,202312,24,19,5,25080,6600,31680
251310,202312,335,235,100,310208.22,133321.73,443529.95
251315,202312,62,54,8,71280,10560,81840
251320,202312,81,63,18,83160.84,23760,106920.84
251330,202312,95,83,12,109560,15840,125400
251335,202312,27,20,7,26400,9240,35640
251340,202312,946,525,421,693019.45,555722.23,1248741.68
251350,202312,47,45,2,59400,2640,62040
251360,202312,97,83,14,109560.2,18480,128040.2
251365,202312,11,9,2,11881.28,2640.9,14522.18
251370,202312,6843,4694,2149,6196284.53,2836724.97,9033009.50
251380,202312,52,40,12,52800.54,15840,68640.54
251385,202312,7,6,1,7920.9,1320,9240.9
251390,202312,1177,871,306,1149748.69,403926.36,1553675.05
251392,202312,55,39,16,51480.5,21120,72600.5
251394,202312,27,20,7,26400.6,9240,35640.6
251396,202312,13,8,5,10560,6600.2,17160.2
251398,202312,21,18,3,23760.75,3960,27720.75
251400,202312,63,49,14,64680,18480,83160
251410,202312,50,40,10,52801.6,13200,66001.6
251420,202312,125,91,34,120121.81,44880,165001.81
251430,202312,54,47,7,62040.84,9240,71280.84
251440,202312,55,32,23,42240,30360,72600
251445,202312,72,62,10,81842.84,13200,95042.84
251450,202312,432,367,65,484454.97,85801.19,570256.16
251455,202312,10,9,1,11880,1320,13200
251460,202312,25,19,6,25080,7920.02,33000.02
251465,202312,18,12,6,15840,7920,23760
251470,202312,55,40,15,52801.74,19800,72601.74
251480,202312,28,25,3,33000.72,3960.92,36961.64
251490,202312,93,61,32,80522.54,42240.3,122762.84
251500,202312,117,96,21,126721.59,27720,154441.59
251510,202312,119,75,44,99000.7,58080.62,157081.32
251520,202312,44,36,8,47520,10560,58080
251530,202312,4649,3290,1359,4344205.19,1793889.75,6138094.94
251540,202312,112,92,20,121440,26401.38,147841.38
251550,202312,479,363,116,479180.31,153122.33,632302.64
251560,202312,28,21,7,27720.43,9240,36960.43
251570,202312,19,18,1,23760,1320,25080
251580,202312,139,110,29,145202.37,38280,183482.37
251590,202312,105,74,31,97680.2,40920.8,138601.0
251593,202312,38,22,16,29040.5,21120,50160.5
251597,202312,137,110,27,145200.8,35640.85,180841.65
251600,202312,1190,826,364,1090345.1,480482.72,1570827.82
251610,202312,316,231,85,304927.64,112200.22,417127.86
251615,202312,30,26,4,34320,5280,39600
251620,202312,4498,2837,1661,3746274.36,2193863.41,5940137.77
251630,202312,527,387,140,510861.01,184805,695666.01
251640,202312,111,81,30,106925.69,39600,146525.69
251650,202312,349,253,96,333965.66,126720.63,460686.29
251660,202312,241,211,30,278525.27,39600.3,318125.57
251670,202312,473,359,114,473889.74,150481.4,624371.14
251675,202312,16,13,3,17160,3960,21120
251680,202312,112,99,13,130681.09,17160,147841.09
251690,202312,352,287,65,379179.42,85800.2,464979.62
251700,202312,296,250,46,330002.65,60720,390722.65
251710,202312,24,17,7,22440.41,9240.6,31681.01
251720,202312,45,32,13,42240.9,17160,59400.9
251740,202312,18,12,6,15840.3,7920,23760.3
260005,202312,4306,2205,2101,2911472.18,2776008.42,5687480.60
260010,202312,2053,1542,511,2035473.58,674524.23,2709997.81
260020,202312,477,421,56,555731.1,73920.9,629652.0
260030,202312,713,487,226,644176.88,298321.7,942498.58
260040,202312,836,544,292,718103.1,385443.01,1103546.11
260050,202312,1247,915,332,1207829.32,439563.04,1647392.36
260060,202312,387,345,42,455410.87,55440,510850.87
260070,202312,1446,897,549,1184102.31,724703.88,1908806.19
260080,202312,833,607,226,802577.88,298320,1100897.88
260090,202312,517,348,169,459361.95,223081.5,682443.45
260100,202312,251,165,86,217802.67,113520,331322.67
260105,202312,317,187,130,246842.11,171600.5,418442.61
260110,202312,3396,2462,934,3251221.88,1232892.93,4484114.81
260120,202312,3062,1655,1407,2185013.12,1859899.45,4044912.57
260130,202312,262,191,71,252123.08,93720,345843.08
260140,202312,2527,1637,890,2160891.3,1174814.23,3335705.53
260150,202312,224,148,76,195360.93,100320,295680.93
260160,202312,403,320,83,422414.62,109560.58,531975.20
260170,202312,3876,2328,1548,3074384.23,2046030.82,5120415.05
260180,202312,174,152,22,200645.44,29040.2,229685.64
260190,202312,2918,1877,1041,2477682.3,1376765.57,3854447.87
260200,202312,1122,870,252,1148423.28,332640.62,1481063.90
260210,202312,1513,1098,415,1449401.25,547803.53,1997204.78
260220,202312,679,597,82,788061.63,108241.79,896303.42
260230,202312,1492,1085,407,1432249.19,538567.3,1970816.49
260240,202312,226,173,53,228368.44,69962.14,298330.58
260250,202312,116,88,28,116160.16,36960,153120.16
260260,202312,1250,865,385,1141816.03,508203.56,1650019.59
260270,202312,275,198,77,261366.37,101640,363006.37
260280,202312,1293,1024,269,1351709.96,355084.95,1706794.91
260290,202312,8160,4423,3737,5839849.61,4939468.6,10779318.21
260300,202312,1161,972,189,1283091.35,249482.33,1532573.68
260310,202312,583,459,124,605890.49,163682.52,769573.01
260320,202312,872,643,229,848763.44,303601.46,1152364.90
260330,202312,112,86,26,113520.3,34320.3,147840.6
260340,202312,102,78,24,102960.65,31680,134640.65
260345,202312,6819,3432,3387,4530403.41,4474860.73,9005264.14
260350,202312,532,384,148,506891.2,195360,702251.2
260360,202312,280,169,111,223081.8,146520.33,369602.13
260370,202312,791,520,271,686414.32,357722.5,1044136.82
260380,202312,596,432,164,570252.59,216482.05,786734.64
260390,202312,319,273,46,360365.58,60720,421085.58
260392,202312,139,118,21,155761.85,27720.94,183482.79
260400,202312,5202,2998,2204,3957432.26,2909299.44,6866731.70
260410,202312,17561,9141,8420,12067815.94,11118449.7,23186265.64
260415,202312,188,150,38,198001.42,50160,248161.42
260420,202312,1989,1266,723,1673797.22,954362.45,2628159.67
260430,202312,188,169,19,223087.78,25080.2,248167.98
260440,202312,230,154,76,203285.82,100320.63,303606.45
260450,202312,534,410,124,541214.2,163681.61,704895.81
260460,202312,987,512,475,675855.73,627006.23,1302861.96
260470,202312,367,228,139,300967.17,183481.99,484449.16
260480,202312,300,182,118,240240.2,155760.93,396001.13
260490,202312,263,198,65,261361.9,85800,347161.9
260500,202312,1298,860,438,1135230.91,578166.23,1713397.14
260510,202312,942,755,187,996621.34,246840.38,1243461.72
260515,202312,296,272,24,359042.41,31680.91,390723.32
260520,202312,3556,2203,1353,2907970.58,1788616.69,4696587.27
260530,202312,978,789,189,1041519.39,249480.91,1291000.30
260540,202312,614,472,142,623052.49,187441.4,810493.89
260545,202312,52,24,28,31680.63,36960.47,68641.10
260550,202312,416,270,146,356402.54,192720.87,549123.41
260560,202312,555,432,123,570253.52,162360.35,732613.87
260570,202312,1160,930,230,1227635.82,304921.42,1532557.24
260580,202312,423,334,89,440881.93,117480,558361.93
260590,202312,685,414,271,546485.36,357721.8,904207.16
260600,202312,8673,5092,3581,6722923.56,4729604.37,11452527.93
260610,202312,582,412,170,543857.12,224404.97,768262.09
260620,202312,4317,2259,2058,2981980.67,2716731.66,5698712.33
260630,202312,93,78,15,102960.3,19800,122760.3
260640,202312,3751,2324,1427,3067740.5,1883653.73,4951394.23
260650,202312,349,257,92,339247.02,121440.4,460687.42
260660,202312,701,480,221,633619.16,291724.97,925344.13
260670,202312,129,92,37,121440,48840,170280
260680,202312,4682,2506,2176,3313346.41,2875010.34,6188356.75
260690,202312,159,123,36,162361.9,47520,209881.9
260700,202312,355,254,101,335289.09,133320.69,468609.78
260710,202312,67,57,10,75240,13200,88440
260720,202312,3147,1824,1323,2407715.41,1746369.14,4154084.55
260730,202312,893,658,235,868573.84,311521.65,1180095.49
260740,202312,78,68,10,89761.9,13200,102961.9
260750,202312,604,450,154,594015.06,204600.2,798615.26
260760,202312,897,445,452,587426.75,596652.67,1184079.42
260765,202312,1152,621,531,819737.27,700931.27,1520668.54
260770,202312,248,180,68,237582.11,89760.99,327343.10
260775,202312,1015,505,510,666621.3,673211.1,1339832.4
260780,202312,263,158,105,208562.96,138600,347162.96
260790,202312,18966,9041,9925,11939831.22,13109034.2,25048865.42
260795,202312,191,122,69,161041.48,91080,252121.48
260800,202312,335,268,67,353766.7,88440.46,442207.16
260805,202312,60,40,20,52803.14,26400.26,79203.40
260810,202312,961,758,203,1000573.04,267960.02,1268533.06
260820,202312,357,234,123,309214.29,162360,471574.29
260825,202312,236,165,71,217801.92,93720,311521.92
260830,202312,317,207,110,273240,145200,418440
260840,202312,317,226,91,298324.44,120120.32,418444.76
260845,202312,252,158,94,208561.39,124081.73,332643.12
260850,202312,475,356,119,469926.66,157080,627006.66
260860,202312,270,202,68,266644.37,89760,356404.37
260870,202312,373,287,86,378848.34,113520,492368.34
260875,202312,841,616,225,813163.31,297000.81,1110164.12
260880,202312,1830,1220,610,1611754.37,805202.79,2416957.16
260890,202312,2915,1986,929,2621589.59,1226287.36,3847876.95
260900,202312,1168,888,280,1172177.36,369600.66,1541778.02
260910,202312,266,214,52,282484.23,68640.6,351124.83
260915,202312,307,237,70,312840.7,92400,405240.7
260920,202312,266,157,109,207240.2,143880,351120.2
260930,202312,407,346,61,456737.67,80520.37,537258.04
260940,202312,2834,1514,1320,1998562.78,1742424.67,3740987.45
260950,202312,2211,1262,949,1665894.34,1252699.86,2918594.20
260960,202312,16197,7756,8441,10239776.8,11147626.21,21387403.01
260970,202312,501,403,98,531967.86,129360,661327.86
260980,202312,247,230,17,303605.84,22440,326045.84
260990,202312,3032,2395,637,3162826.76,844808.33,4007635.09
261000,202312,4732,2956,1776,3901988.49,2344338.67,6246327.16
261010,202312,143,111,32,146521.69,42240,188761.69
261020,202312,654,483,171,637571.62,225720.1,863291.72
261030,202312,285,214,71,282482.56,93720,376202.56
261040,202312,421,347,74,458050.42,97680,555730.42
261050,202312,627,501,126,661333.79,166321.69,827655.48
261060,202312,1934,1193,741,1574773.16,978123.58,2552896.74
261070,202312,11611,5432,6179,7173299.75,8160459.92,15333759.67
261080,202312,404,314,90,414486.84,118800,533286.84
261090,202312,2253,1740,513,2296890.27,678484.73,2975375.00
261100,202312,1358,933,425,1231594.74,561006.23,1792600.97
261110,202312,11173,7084,4089,9351350.39,5397578.66,14748929.05
261120,202312,242,205,37,270600.81,48840,319440.81
261130,202312,643,393,250,518776.51,330008.89,848785.40
261140,202312,248,155,93,204600.89,122760,327360.89
261150,202312,700,458,242,604565.19,319440.1,924005.29
261153,202312,82,78,4,102960.2,5280,108240.2
261160,202312,89180,43405,45775,57316306.16,60450473.76,117766779.92
261170,202312,555,418,137,551761.68,180840.92,732602.60
261180,202312,2034,1280,754,1689935.67,995289.33,2685225.00
261190,202312,642,439,203,579490.23,267961.88,847452.11
261200,202312,227,178,49,234966.4,64680,299646.4
261210,202312,63,46,17,60720.44,22440,83160.44
261220,202312,3263,2269,994,2995164.01,1313417.59,4308581.60
261230,202312,421,310,111,409207.95,146521.69,555729.64
261240,202312,479,409,70,539892.35,92400.97,632293.32
261245,202312,313,268,45,353761.21,59400,413161.21
261247,202312,208,159,49,209885.02,64680,274565.02
261250,202312,4684,2330,2354,3075666.63,3108623.27,6184289.90
261255,202312,280,247,33,326040.52,43560,369600.52
261260,202312,964,825,139,1089066.32,183483.5,1272549.82
261270,202312,228,160,68,211200.83,89760,300960.83
261280,202312,209,173,36,228362.85,47520.55,275883.40
261290,202312,130,92,38,121440.24,50160.2,171600.44
261300,202312,1650,1239,411,1635520.54,542526.01,2178046.55
261310,202312,953,633,320,835577.87,422402.06,1257979.93
261320,202312,547,387,160,510853.68,211202.79,722056.47
261330,202312,933,745,188,983443.04,248168.97,1231612.01
261340,202312,380,215,165,283803.91,217803.52,501607.43
261350,202312,1062,748,314,987403.97,414490.8,1401894.77
261360,202312,1537,967,570,1276448.84,752405.8,2028854.64
261370,202312,5733,3326,2407,4390414.4,3177277.74,7567692.14
261380,202312,646,520,126,686407.72,166320.96,852728.68
261390,202312,4402,3055,1347,4035376.39,1778079.07,5813455.46
261400,202312,305,273,32,360369.85,42240.04,402609.89
261410,202312,1265,824,441,1087711.75,582125.99,1669837.74
261420,202312,1105,666,439,879142.74,579483.54,1458626.28
261430,202312,345,310,35,409207.96,46200,455407.96
261440,202312,112,105,7,138601.44,9240,147841.44
261450,202312,2871,2182,689,2880290.08,909485.87,3789775.95
261460,202312,902,695,207,917425.48,273241.7,1190667.18
261470,202312,257,205,52,270604.6,68640.4,339245.0
261480,202312,538,402,136,530653.98,179462.58,710116.56
261485,202312,460,276,184,364329.93,242880.1,607210.03
261500,202312,721,457,264,603252.47,348481.9,951734.37
261510,202312,59,42,17,55440.98,22440.1,77881.08
261520,202312,123,105,18,138602.81,23760.2,162363.01
261530,202312,4916,3193,1723,4214841.39,2275692.95,6490534.34
261540,202312,1775,1009,766,1331906.39,1011129.09,2343035.48
261550,202312,316,159,157,209882.77,207240,417122.77
261560,202312,1137,765,372,1009828.91,491043.22,1500872.13
261570,202312,456,364,92,480487.76,121440.95,601928.71
261580,202312,444,348,96,459368.21,126720.9,586089.11
261590,202312,218,173,45,228366.67,59400.75,287767.42
261600,202312,363,280,83,369609.37,109560.2,479169.57
261610,202312,130,105,25,138602.69,33000,171602.69
261618,202312,98,71,27,93720.86,35640,129360.86
261620,202312,233,153,80,201964.23,105601.28,307565.51
261630,202312,736,569,167,751090.69,220443.81,971534.50
261640,202312,7746,4151,3595,5479502.79,4748114.38,10227617.17
261650,202312,470,302,168,399962.82,221760.1,621722.92
270010,202312,550,484,66,638899.75,87120.52,726020.27
270020,202312,260,222,38,293045.56,50160,343205.56
270030,202312,10451,6773,3678,8945905.22,4858928.49,13804833.71
270040,202312,2263,1528,735,2018344.83,971530.21,2989875.04
270050,202312,275,217,58,286443.61,76560,363003.61
270060,202312,65,47,18,62042.84,23760.33,85803.17
270070,202312,816,610,206,805213.67,271920.3,1077133.97
270080,202312,70,56,14,73920.1,18480,92400.1
270090,202312,24,20,4,26400,5280,31680
270100,202312,1419,976,443,1288347.64,584762.44,1873110.08
270110,202312,67,53,14,69960,18480,88440
270120,202312,336,280,56,370932.6,73920,444852.6
270130,202312,377,298,79,394688.42,104280.96,498969.38
270135,202312,126,93,33,122762.57,43560,166322.57
270140,202312,1541,1046,495,1382083.86,656052.37,2038136.23
270150,202312,283,202,81,266645.44,106920.63,373566.07
270160,202312,510,407,103,537282.3,135962.7,673245.0
270170,202312,862,576,286,760327.36,377520.8,1137848.16
270180,202312,64,50,14,66000.7,18480.22,84480.92
270190,202312,124,110,14,145204.44,18480,163684.44
270200,202312,135,118,17,155760.9,22440,178200.9
270210,202312,587,374,213,493682.8,281160.4,774843.2
270220,202312,199,146,53,192721.05,71280.6,264001.65
270230,202312,2423,1588,835,2098842.37,1103523.52,3202365.89
270235,202312,561,447,114,590066.04,150480.84,740546.88
270240,202312,3563,2796,767,3692098.51,1012444.14,4704542.65
270250,202312,109,92,17,121440.41,22440,143880.41
270255,202312,237,198,39,261361.76,51480.44,312842.20
270260,202312,444,359,85,473896.26,112200.6,586096.86
270270,202312,97,55,42,72601.73,56760,129361.73
270280,202312,202,130,72,171600.97,95040,266640.97
270290,202312,1225,963,262,1271183.19,345843.83,1617027.02
270300,202312,416,308,108,406562.05,142560.36,549122.41
270310,202312,858,729,129,963627.6,170281.96,1133909.56
270320,202312,802,694,108,916099.11,142560,1058659.11
270330,202312,369,316,53,417120.62,69960,487080.62
270340,202312,78,63,15,83160,19800,102960
270350,202312,77,45,32,59403.04,42240,101643.04
270360,202312,101,58,43,77880.2,56760,134640.2
270370,202312,77,60,17,79200,22440,101640
270375,202312,91,61,30,80521.1,39600,120121.1
270380,202312,1102,767,335,1012442.39,442200,1454642.39
270390,202312,129,79,50,104281.1,66000.5,170281.6
270400,202312,834,651,183,859341.83,241560.92,1100902.75
270410,202312,237,179,58,236288.39,76560,312848.39
270420,202312,456,325,131,429007.16,172921.7,601928.86
270430,202312,39519,28196,11323,37232846.27,14957268,52190114.27
270440,202312,469,371,98,489735.57,129360.95,619096.52
270450,202312,991,606,385,799927.49,508202.03,1308129.52
270460,202312,191,152,39,200644.6,51480,252124.6
270470,202312,1921,1387,534,1830873.22,704884.25,2535757.47
270480,202312,614,496,118,654731.86,155760,810491.86
270490,202312,29,22,7,29040,9240,38280
270500,202312,502,418,84,551767.76,110880,662647.76
270510,202312,976,675,301,890997.54,397324.74,1288322.28
270520,202312,278,189,89,249481.13,117480,366961.13
270530,202312,65,50,15,66000.1,19800,85800.1
270540,202312,81,59,22,77880,29040,106920
270550,202312,1674,1313,361,1733202.12,476522.29,2209724.41
270560,202312,270,173,97,228367.01,128040,356407.01
270570,202312,649,472,177,623046.47,233640,856686.47
270580,202312,22,18,4,23760,5280,29040
270590,202312,62,52,10,68640.3,13200.08,81840.38
270600,202312,190,156,34,205928.41,44880.1,250808.51
270610,202312,271,214,57,282485.54,75240.1,357725.64
270620,202312,19,19,0,25080,0,25080
270630,202312,3848,2893,955,3819311.26,1260612.88,5079924.14
270640,202312,935,688,247,908178.99,326040.97,1234219.96
270642,202312,233,195,38,257402.88,50160,307562.88
270644,202312,267,184,83,242882.58,109561.45,352444.03
270650,202312,370,238,132,314164.32,174242.15,488406.47
270660,202312,175,154,21,203283.7,27720,231003.7
270670,202312,3168,2431,737,3211638.82,972842.42,4184481.24
270680,202312,423,289,134,381487.72,176880,558367.72
270690,202312,1353,938,415,1238194.07,547803.88,1785997.95
270700,202312,24,19,5,25080.19,6600,31680.19
270710,202312,597,472,125,623046.82,165000,788046.82
270720,202312,249,210,39,277205.94,51480.41,328686.35
270730,202312,2071,1339,732,1767509.58,966243.98,2733753.56
270740,202312,35,27,8,35640.36,10560,46200.36
270750,202312,654,515,139,679810.5,183480.9,863291.4
270760,202312,298,217,81,286446.78,106920,393366.78
270770,202312,3179,2224,955,2938536.02,1260609.58,4199145.60
270780,202312,77,49,28,64680,36960.06,101640.06
270790,202312,208,141,67,186123.95,88441.32,274565.27
270800,202312,2147,1740,407,2296845.88,537240,2834085.88
270810,202312,214,173,41,228361.44,54120,282481.44
270820,202312,122,86,36,113526.26,47520.9,161047.16
270830,202312,920,712,208,941188.48,274561.45,1215749.93
270840,202312,1357,1069,288,1411100.47,380161.4,1791261.87
270850,202312,1619,1084,535,1430900.12,706204.06,2137104.18
270860,202312,2817,1932,885,2550279.9,1168208.43,3718488.33
270870,202312,141,86,55,113520.2,73920.2,187440.4
270880,202312,930,750,180,990038.42,237600.98,1227639.40
270890,202312,273,213,60,281162.93,79200.8,360363.73
270895,202312,90,85,5,112200,6600,118800
270900,202312,67,55,12,72601.23,15840,88441.23
270910,202312,333,283,50,373575.65,66001.54,439577.19
270915,202312,2038,1392,646,1838794.09,852721.43,2691515.52
270920,202312,403,334,69,440886.22,91080,531966.22
270930,202312,5626,4397,1229,5804169.28,1622285.1,7426454.38
270940,202312,2305,1872,433,2471089.04,571561.68,3042650.72
280010,202312,36,30,6,39601.1,7920,47521.1
280020,202312,574,488,86,644177.02,113520.97,757697.99
280030,202312,25092,16186,8906,21371946.35,11758877.73,33130824.08
280040,202312,370,234,136,308883.43,179520.4,488403.83
280050,202312,480,368,112,485767.62,147840,633607.62
280060,202312,495,333,162,439570.84,213840.95,653411.79
280067,202312,1242,910,332,1201220.78,438240.73,1639461.51
280070,202312,136,116,20,153122.61,26400,179522.61
280100,202312,780,606,174,799929.07,229680.2,1029609.27
280110,202312,104,91,13,120121.86,17160,137281.86
280120,202312,794,665,129,879131.04,170281.26,1049412.30
280130,202312,2001,1321,680,1743746.73,897602.7,2641349.43
280140,202312,575,476,99,628327.34,130680.2,759007.54
280150,202312,473,342,131,451447.64,172920,624367.64
280160,202312,164,126,38,166322.42,51480,217802.42
280170,202312,481,348,133,459372.74,175561.43,634934.17
280190,202312,34,27,7,35640,9240,44880
280200,202312,66,53,13,69967.73,17161.2,87128.93
280210,202312,3434,2471,963,3263026.33,1271168.4,4534194.73
280220,202312,72,60,12,79201.86,15840,95041.86
280230,202312,370,298,72,393381,95042.19,488423.19
280240,202312,151,141,10,186122.49,13200,199322.49
280250,202312,31,12,19,15840.82,25082.06,40922.88
280260,202312,93,78,15,102964.16,19800,122764.16
280270,202312,150,120,30,158400.58,39600.53,198001.11
280280,202312,209,144,65,190082.99,85800.09,275883.08
280290,202312,4388,3236,1152,4271601.75,1520656.66,5792258.41
280300,202312,1901,1520,381,2006433.18,502924.59,2509357.77
280310,202312,121,112,9,147842.4,11880,159722.4
280320,202312,784,538,246,710182.67,324722.64,1034905.31
280330,202312,355,262,93,345849.26,122760.2,468609.46
280340,202312,491,409,82,539889.67,108242.8,648132.47
280350,202312,4287,3290,997,4342986.11,1316057.32,5659043.43
280360,202312,516,355,161,468617.7,212521.49,681139.19
280370,202312,106,90,16,118801.09,21120.9,139921.99
280380,202312,52,41,11,54120,14520,68640
280390,202312,199,171,28,225724.33,36960,262684.33
280400,202312,470,302,168,398655.7,221762.45,620418.15
280410,202312,328,276,52,364327.53,68640,432967.53
280420,202312,161,142,19,187449.84,25080.95,212530.79
280430,202312,113,92,21,121441.89,27720,149161.89
280440,202312,795,663,132,875182,174243.16,1049425.16
280445,202312,139,128,11,168961.93,14520.8,183482.73
280450,202312,1498,1282,216,1692273.88,285123.56,1977397.44
280460,202312,776,585,191,772219.78,252121.58,1024341.36
280470,202312,82,77,5,101643.36,6600,108243.36
280480,202312,3871,2615,1256,3452028.53,1659282.5,5111311.03
280490,202312,194,181,13,238928.9,17160,256088.9
280500,202312,43,40,3,52802.07,3960.84,56762.91
280510,202312,145,112,33,147841.31,43561.12,191402.43
280520,202312,57,39,18,51481.19,23760,75241.19
280530,202312,86,57,29,75242.66,38280.66,113523.32
280540,202312,629,543,86,716769.77,113520,830289.77
280550,202312,798,735,63,970223.73,83160,1053383.73
280560,202312,518,468,50,617768.25,66001.84,683770.09
280570,202312,2717,2159,558,2849939.07,736565.18,3586504.25
280580,202312,636,501,135,661328.41,178200.96,839529.37
280590,202312,253,174,79,229694.19,105608.09,335302.28
280600,202312,466,378,88,499028.4,116160.47,615188.87
280610,202312,140,98,42,129368.8,55442.88,184811.68
280620,202312,588,475,113,627010.52,149160,776170.52
280630,202312,162,135,27,178203.89,35640,213843.89
280640,202312,181,148,33,195360.3,43560,238920.3
280650,202312,91,59,32,77883.04,42240.79,120123.83
280660,202312,134,104,30,137286.3,39600.1,176886.4
280670,202312,2286,1476,810,1948457.98,1069229.48,3017687.46
280680,202312,277,238,39,314163.07,51480,365643.07
280690,202312,84,74,10,97680,13200,110880
280700,202312,23,23,0,30360,0,30360
280710,202312,1717,1328,389,1752994.79,513482.67,2266477.46
280720,202312,151,112,39,147842.24,51480.2,199322.44
280730,202312,37,34,3,44881.33,3960.05,48841.38
280740,202312,2865,2168,697,2861806.26,920045.27,3781851.53
280750,202312,224,198,26,261365.71,34320.8,295686.51
280760,202312,1077,732,345,966264.68,456721.82,1422986.50
290010,202312,204,142,62,187440.75,81840,269280.75
290020,202312,226,204,22,269283.18,29040.9,298324.08
290030,202312,676,444,232,586087.76,306241.04,892328.80
290035,202312,161,130,31,171601.37,40920.93,212522.30
290040,202312,293,211,82,278526.67,108240.9,386767.57
290050,202312,106,87,19,114840,25080,139920
290060,202312,256,109,147,143881.41,194040,337921.41
290070,202312,6889,3302,3587,4362738.43,4736211.99,9098950.42
290080,202312,541,248,293,327362.79,386760.09,714122.88
290090,202312,328,159,169,209880.2,223080.12,432960.32
290100,202312,1931,1237,694,1635518.46,916083.74,2551602.20
290110,202312,1007,555,452,732629.94,596649.69,1329279.63
290115,202312,190,175,15,231005.05,19800,250805.05
290120,202312,921,625,296,825011.87,390720.65,1215732.52
290130,202312,534,333,201,439565.3,265320.6,704885.9
290135,202312,305,227,78,299644.94,104280.1,403925.04
290140,202312,352,295,57,389407.17,75240.86,464648.03
290150,202312,159,110,49,145200.1,64680.01,209880.11
290160,202312,261,207,54,273248.85,71281.11,344529.96
290170,202312,124,93,31,122762.16,40920,163682.16
290180,202312,221,159,62,209882.13,81840.44,291722.57
290190,202312,294,227,67,299643.89,88441.1,388084.99
290195,202312,322,225,97,298323.25,128040.1,426363.35
290200,202312,275,222,53,293040.17,69960.63,363000.80
290205,202312,181,110,71,145201.02,93720,238921.02
290210,202312,1387,1007,380,1329275.66,501603.81,1830879.47
290220,202312,164,104,60,137288.6,79201.7,216490.3
290225,202312,321,130,191,171601.52,252121.31,423722.83
290230,202312,120,75,45,99001.13,59400,158401.13
290240,202312,429,158,271,208561.4,357720.81,566282.21
290250,202312,251,231,20,304926.15,26400,331326.15
290260,202312,393,302,91,398658.04,120124.44,518782.48
290265,202312,209,180,29,238925.73,38280.2,277205.93
290270,202312,1488,1220,268,1610458.22,355080.4,1965538.62
290280,202312,567,401,166,529329.18,220440.79,749769.97
290290,202312,1680,1056,624,1393946.57,823680.83,2217627.40
290300,202312,409,347,62,458049.42,83162.25,541211.67
290310,202312,298,147,151,194041.91,199320,393361.91
290320,202312,4839,2913,1926,3845316.3,2542342.5,6387658.8
290323,202312,229,196,33,258727.76,43560.2,302287.96
290327,202312,192,149,43,196686.31,56760,253446.31
290330,202312,141,68,73,89760.02,96360,186120.02
290340,202312,853,364,489,480496.37,645484.22,1125980.59
290350,202312,773,469,304,619085.97,401281.11,1020367.08
290360,202312,340,271,69,357726.07,91080,448806.07
290370,202312,915,444,471,586081.7,621720,1207801.7
290380,202312,356,233,123,307562.92,162361.7,469924.62
290390,202312,2631,1631,1000,2152984.94,1320006.71,3472991.65
290395,202312,253,151,102,199320.84,134640,333960.84
290400,202312,309,229,80,302281.79,105600,407881.79
290405,202312,267,228,39,300963.59,51480,352443.59
290410,202312,700,581,119,766925.09,157080.01,924005.10
290420,202312,308,254,54,336602.73,71280,407882.73
290430,202312,531,342,189,451442.58,249480,700922.58
290440,202312,55,55,0,72600.51,0,72600.51
290450,202312,210,152,58,200640,76560,277200
290460,202312,2210,1315,895,1737154.76,1182721.57,2919876.33
290470,202312,1433,657,776,868585.45,1024326.03,1892911.48
290475,202312,597,556,41,733930.75,54120,788050.75
290480,202312,193,112,81,147840.07,106920,254760.07
290485,202312,264,236,28,311522.33,36960,348482.33
290490,202312,1416,989,427,1305505.73,563645.18,1869150.91
290500,202312,912,514,398,678490.56,525363.07,1203853.63
290510,202312,189,155,34,204611.17,44880.35,249491.52
290515,202312,217,143,74,188763.12,97680,286443.12
290520,202312,1575,1054,521,1392615.41,687722.32,2080337.73
290530,202312,298,260,38,344534.65,50160.93,394695.58
290540,202312,164,82,82,108240,108240,216480
290550,202312,199,163,36,215162.78,47520,262682.78
290560,202312,3435,1601,1834,2114693.1,2420892.91,4535586.01
290570,202312,8385,4009,4376,5292107.47,5781699.19,11073806.66
290580,202312,1433,874,559,1155024.12,737880.4,1892904.52
290590,202312,630,505,125,666640.92,165003.64,831644.56
290600,202312,2034,1399,635,1848072.71,838209.65,2686282.36
290610,202312,181,168,13,221766.7,17160,238926.7
290620,202312,430,380,50,501611.3,66000.8,567612.1
290630,202312,2158,937,1221,1236875.68,1611725.59,2848601.27
290640,202312,149,116,33,153125.98,43560,196685.98
290650,202312,2410,1132,1278,1494287.73,1686969.28,3181257.01
290660,202312,305,253,52,336602.04,68640.72,405242.76
290670,202312,1219,621,598,819736.39,789367.81,1609104.20
290680,202312,1379,1102,277,1455981.94,366962.14,1822944.08
290682,202312,392,294,98,388084.37,129360,517444.37
290685,202312,281,168,113,221764.11,149160.2,370924.31
290687,202312,1396,916,480,1209146.16,633602.73,1842748.89
290689,202312,167,89,78,117480,102960.5,220440.5
290690,202312,576,283,293,373569.58,388081.45,761651.03
290700,202312,288,153,135,201966.79,178203.32,380170.11
290710,202312,925,658,267,868578.53,352443.71,1221022.24
290720,202312,1246,970,276,1280442.76,364322.49,1644765.25
290730,202312,1371,820,551,1082423.58,727325.08,1809748.66
290740,202312,35,29,6,38280,7920,46200
290750,202312,1648,746,902,984748.52,1190652.22,2175400.74
290755,202312,92,76,16,100320,21120,121440
290760,202312,276,240,36,316814.13,47521.74,364335.87
290770,202312,204,194,10,256085.41,13200,269285.41
290780,202312,1264,1024,240,1351708.97,316805.52,1668514.49
290790,202312,456,316,140,417126.36,184802.93,601929.29
290800,202312,2579,1073,1506,1416391.22,1991888.61,3408279.83
290810,202312,539,360,179,475209.05,236281.51,711490.56
290820,202312,456,265,191,349809.25,253442.68,603251.93
290830,202312,533,378,155,498965.92,204600.68,703566.60
290840,202312,2094,1346,748,1776767.51,987366.19,2764133.70
290850,202312,1229,636,593,839534.19,786727.15,1626261.34
290860,202312,770,393,377,518767.34,497642.22,1016409.56
290870,202312,693,492,201,649450.53,266641.23,916091.76
290880,202312,138,80,58,105600.17,76560,182160.17
290890,202312,580,356,224,469925.98,295683.92,765609.90
290900,202312,167,125,42,165000.94,55440,220440.94
290910,202312,435,329,106,434283.02,139920,574203.02
290920,202312,244,220,24,290404.02,31680,322084.02
290930,202312,600,453,147,597978.3,194041.7,792020.0
290940,202312,231,198,33,261361,43560,304921
290950,202312,171,98,73,129360,96360,225720
290960,202312,563,407,156,537248.21,205921.52,743169.73
290970,202312,246,218,28,287762.91,36960.2,324723.11
290980,202312,2267,1597,670,2110730.61,884409.41,2995140.02
290990,202312,487,406,81,535941.78,106923.51,642865.29
291000,202312,990,343,647,452762.63,854040,1306802.63
291005,202312,3053,1332,1721,1759634.95,2271752.81,4031387.76
291010,202312,140,122,18,161041.07,23760,184801.07
291020,202312,84,69,15,91080,19800,110880
291030,202312,124,89,35,117483.03,46200,163683.03
291040,202312,721,442,279,584761.61,368281.6,953043.21
291050,202312,1708,888,820,1173511.54,1083730.03,2257241.57
291060,202312,1925,1078,847,1422990.8,1118048.7,2541039.5
291070,202312,2195,1663,532,2195212.84,702248.4,2897461.24
291072,202312,7934,3169,4765,4183252.74,6293800.97,10477053.71
291075,202312,303,256,47,337920.8,62040,399960.8
291077,202312,64,48,16,63360,21120,84480
291080,202312,24494,10782,13712,14239365.36,18105352.55,32344717.91
291085,202312,297,245,52,323406.63,68640.65,392047.28
291090,202312,261,107,154,141240.71,203280,344520.71
291100,202312,983,351,632,463321.03,834240,1297561.03
291110,202312,495,378,117,498970.16,154440.67,653410.83
291120,202312,2642,1473,1169,1945713.24,1544630.73,3490343.97
291125,202312,76,42,34,55440.24,44880,100320.24
291130,202312,198,166,32,219124.08,42240,261364.08
291140,202312,180,149,31,196681.7,40920.1,237601.8
291150,202312,370,142,228,187440.61,300960,488400.61
291160,202312,438,336,102,443535.26,135961.57,579496.83
291165,202312,63,46,17,60720,22441.22,83161.22
291170,202312,3860,1956,1904,2581971.17,2514607.44,5096578.61
291180,202312,1303,575,728,759009.85,960961.8,1719971.65
291185,202312,142,131,11,172923.28,14520,187443.28
291190,202312,1458,716,742,945141.88,979450.67,1924592.55
291200,202312,194,144,50,190080.9,66000,256080.9
291210,202312,2678,1137,1541,1500866.79,2035449.37,3536316.16
291220,202312,363,276,87,364323.17,114840.2,479163.37
291230,202312,987,380,607,501610.17,801242.68,1302852.85
291240,202312,408,378,30,498962.66,39600.9,538563.56
291250,202312,426,352,74,464640.69,97680,562320.69
291260,202312,75,63,12,83160.1,15840,99000.1
291270,202312,800,405,395,534617.72,521403.85,1056021.57
291280,202312,371,181,190,238924.54,250800.48,489725.02
291290,202312,1709,922,787,1218407.35,1040174.66,2258582.01
291300,202312,269,198,71,261362.68,93720,355082.68
291310,202312,240,210,30,277205.56,39600.7,316806.26
291320,202312,1353,936,417,1235562.56,550443.66,1786006.22
291330,202312,145,121,24,159722.95,31680.2,191403.15
291340,202312,272,170,102,224405.96,134641.61,359047.57
291345,202312,126,91,35,120120.4,46200,166320.4
291350,202312,1962,794,1168,1048085.91,1541760.4,2589846.31
291360,202312,9718,4685,5033,6187131.29,6650291.4,12837422.69
291370,202312,1326,820,506,1082451.69,669253.08,1751704.77
291380,202312,299,229,70,302283.31,92400,394683.31
291390,202312,4483,2008,2475,2653259.12,3269654.7,5922913.82
291400,202312,2320,1612,708,2127899.95,934576.08,3062476.03
291410,202312,265,216,49,285123.98,64680,349803.98
291420,202312,129,101,28,133320.16,36960,170280.16
291430,202312,201,124,77,163680,101640,265320
291440,202312,607,500,107,660017.2,141240.2,801257.4
291450,202312,1134,764,370,1008508.28,488408.34,1496916.62
291460,202312,2416,1868,548,2465830.47,723373.71,3189204.18
291465,202312,2507,1220,1287,1610432.41,1700167.33,3310599.74
291470,202312,3199,1641,1558,2167484.09,2057896.38,4225380.47
291480,202312,13501,6003,7498,7926899.86,9901384.23,17828284.09
291490,202312,780,322,458,425045.78,607200.2,1032245.98
291500,202312,398,243,155,321788.68,204600.59,526389.27
291510,202312,1196,491,705,648123.95,930600.66,1578724.61
291520,202312,962,453,509,597976.75,671882.28,1269859.03
291530,202312,950,305,645,402603.04,851400,1254003.04
291535,202312,151,125,26,165000.19,34320.75,199320.94
291540,202312,347,120,227,158402.97,299641.27,458044.24
291550,202312,1358,665,693,877809.12,914761.26,1792570.38
291560,202312,5450,2779,2671,3669665.69,3528370.08,7198035.77
291570,202312,275,156,119,205921.39,157080.99,363002.38
291580,202312,1379,892,487,1177469.93,642840.6,1820310.53
291590,202312,129,66,63,88440.96,83160,171600.96
291600,202312,1226,637,589,840856.21,778804.03,1619660.24
291610,202312,1603,767,836,1013809.71,1103542.21,2117351.92
291620,202312,601,293,308,386772.27,406563.08,793335.35
291630,202312,499,160,339,211201.55,447480.2,658681.75
291640,202312,4581,2249,2332,2968756.43,3078262.93,6047019.36
291650,202312,520,372,148,491059.11,195362.43,686421.54
291660,202312,373,159,214,209884.19,282481.77,492365.96
291670,202312,171,108,63,142560.65,83160.84,225721.49
291680,202312,702,444,258,586113.97,340564.3,926678.27
291685,202312,688,400,288,528010.62,380163.51,908174.13
291690,202312,562,377,185,498965.41,245520.91,744486.32
291700,202312,1164,893,271,1178784.63,357720.65,1536505.28
291710,202312,1675,817,858,1078458.11,1132564.72,2211022.83
291720,202312,502,341,161,450121.26,212520.9,662642.16
291730,202312,1038,610,428,806544.66,564963.43,1371508.09
291733,202312,352,241,111,318122.31,146520,464642.31
291735,202312,101,77,24,101640.5,31680,133320.5
291740,202312,362,276,86,364321.06,113520,477841.06
291750,202312,2680,1682,998,2220342.77,1317378.07,3537720.84
291760,202312,3321,1861,1460,2456535.8,1927202.12,4383737.92
291770,202312,844,566,278,747157.07,368288.52,1115445.59
291780,202312,140,92,48,121441,63360.78,184801.78
291790,202312,180,105,75,138600,99000.84,237600.84
291800,202312,11622,5228,6394,6901226.93,8444126.87,15345353.80
291810,202312,1161,874,287,1153705.44,378843.83,1532549.27
291820,202312,323,241,82,318121.79,108240,426361.79
291830,202312,1072,462,610,609860.35,805207.3,1415067.65
291835,202312,605,559,46,737890.58,60720.22,798610.80
291840,202312,6468,3280,3188,4332488.69,4210901.2,8543389.89
291845,202312,308,114,194,150480,257400,407880
291850,202312,353,308,45,406570.49,59401.1,465971.59
291855,202312,285,124,161,163681.43,212520.38,376201.81
291860,202312,164,107,57,141240.52,75240.7,216481.22
291870,202312,103,54,49,71280,64680,135960
291875,202312,166,154,12,203280.81,15840,219120.81
291880,202312,462,382,80,504260.37,105601.78,609862.15
291890,202312,268,92,176,121440.2,232320,353760.2
291900,202312,69,45,24,59400.2,31680,91080.2
291905,202312,122,94,28,124081.25,36960.4,161041.65
291910,202312,159,130,29,171601.81,38280.1,209881.91
291915,202312,499,440,59,580820.69,77880.96,658701.65
291920,202312,7363,3566,3797,4707353.71,5016098.51,9723452.22
291930,202312,188,117,71,154442,93720.25,248162.25
291940,202312,474,287,187,378843.16,246840,625683.16
291950,202312,1324,1025,299,1353009.49,394680,1747689.49
291955,202312,1682,1031,651,1360956.55,859327.65,2220284.20
291960,202312,227,165,62,217801.7,81840,299641.7
291970,202312,853,627,226,827658.72,298322.28,1125981.00
291980,202312,1531,1320,211,1742437.51,278522.87,2020960.38
291990,202312,168,157,11,207244.46,14520,221764.46
291992,202312,258,129,129,170290.85,170283.59,340574.44
291995,202312,218,147,71,194041.09,93720,287761.09
292000,202312,468,338,130,446167.16,171600.76,617767.92
292010,202312,409,279,130,368280.7,171600,539880.7
292020,202312,349,255,94,336605.24,125400,462005.24
292030,202312,174,134,40,176882.25,52800.17,229682.42
292040,202312,644,361,283,476520,373560,850080
292045,202312,137,119,18,157080.7,23760.12,180840.82
292050,202312,1040,766,274,1011130.05,361680.6,1372810.65
292060,202312,1064,867,197,1144477.77,260043.8,1404521.57
292070,202312,93,44,49,58080.2,64680,122760.2
292080,202312,197,140,57,184801.01,75240,260041.01
292090,202312,628,232,396,308882.6,522720.9,831603.5
292100,202312,1903,855,1048,1128650.8,1383392.23,2512043.03
292105,202312,180,163,17,215160,22440,237600
292110,202312,2487,960,1527,1267222.57,2015646.76,3282869.33
292120,202312,794,597,197,788079.3,260041.12,1048120.42
292130,202312,542,297,245,392045.11,323400.5,715445.61
292140,202312,241,194,47,256086.04,62041.4,318127.44
292145,202312,199,119,80,157080.44,105600,262680.44
292150,202312,1651,1392,259,1837473.66,343202.93,2180676.59
292160,202312,195,153,42,201960.7,55440.92,257401.62
292170,202312,1256,1056,200,1393974.28,264003.17,1657977.45
292180,202312,278,195,83,257400.57,109560.81,366961.38
292190,202312,168,109,59,143882.09,77880.97,221763.06
292200,202312,1594,626,968,826338.29,1279088.35,2105426.64
292205,202312,147,124,23,163680,30360,194040
292210,202312,455,291,164,384128.79,216480.66,600609.45
292220,202312,47,33,14,43560.51,18480,62040.51
292225,202312,74,57,17,75242.63,22440.11,97682.74
292230,202312,1094,850,244,1122033.87,322080.86,1444114.73
292240,202312,693,520,173,686423.97,228360.5,914784.47
292250,202312,1752,1150,602,1518043.88,795967.72,2314011.60
292260,202312,467,282,185,372244.24,244201.35,616445.59
292265,202312,276,211,65,278526.27,85800.56,364326.83
292270,202312,745,395,350,521408.53,462000,983408.53
292273,202312,225,137,88,180840.9,116160.42,297001.32
292275,202312,200,108,92,142560.7,121440,264000.7
292280,202312,161,113,48,149160,63360,212520
292285,202312,110,85,25,112200,33000,145200
292290,202312,720,485,235,640211,310200.72,950411.72
292300,202312,2127,857,1270,1131263.86,1677743.46,2809007.32
292303,202312,160,117,43,154443.24,56760.49,211203.73
292305,202312,137,102,35,134642.53,46200,180842.53
292310,202312,1086,743,343,980780.39,452764.32,1433544.71
292320,202312,654,492,162,650769.74,213841.18,864610.92
292330,202312,186,125,61,165001.52,80520,245521.52
292335,202312,351,273,78,360363.31,104280,464643.31
292340,202312,616,437,179,576845.86,236280.55,813126.41
292350,202312,304,157,147,207242.64,194040,401282.64
292360,202312,819,618,201,815762.85,265321.01,1081083.86
292370,202312,755,581,174,766929.74,229681.21,996610.95
292380,202312,664,563,101,743177.32,133321.17,876498.49
292390,202312,385,166,219,219122.34,289080.96,508203.30
292400,202312,4315,2642,1673,3487547.69,2208375.58,5695923.27
292405,202312,302,199,103,262680.44,135960,398640.44
292410,202312,119,78,41,102960.7,54120,157080.7
292420,202312,279,246,33,324720.9,43560,368280.9
292430,202312,580,416,164,549123.54,216480.52,765604.06
292440,202312,739,614,125,810496.79,165002.13,975498.92
292450,202312,252,192,60,253444.47,79200.2,332644.67
292460,202312,549,416,133,549125.03,175560.74,724685.77
292465,202312,226,196,30,258722.32,39600.1,298322.42
292467,202312,200,133,67,175560.2,88440,264000.2
292470,202312,357,241,116,318120.59,153120.31,471240.90
292480,202312,451,299,152,394688.96,200642.58,595331.54
292490,202312,286,217,69,286442.5,91081.7,377524.2
292500,202312,1053,555,498,732620.59,657367.19,1389987.78
292510,202312,4012,1995,2017,2633465.54,2662458.76,5295924.30
292520,202312,1398,677,721,893667.79,951731.1,1845398.89
292525,202312,504,382,122,504252,161043.1,665295.1
292530,202312,5823,2452,3371,3236719.84,4451080.2,7687800.04
292540,202312,514,300,214,396003.17,282480.77,678483.94
292550,202312,1246,703,543,927972.77,718082.93,1646055.70
292560,202312,360,328,32,432975.5,42240.26,475215.76
292570,202312,391,298,93,393361.58,124080,517441.58
292575,202312,664,501,163,661345.25,215161.48,876506.73
292580,202312,1140,781,359,1032248.74,473882.7,1506131.44
292590,202312,631,556,75,733926.8,99000.8,832927.6
292593,202312,158,127,31,168960.68,40920,209880.68
292595,202312,256,194,62,256083.28,81840,337923.28
292600,202312,1420,1004,416,1325332,549128.75,1874460.75
292610,202312,117,96,21,126722.33,27721.11,154443.44
292620,202312,577,479,98,632314.52,129361.73,761676.25
292630,202312,1747,954,793,1259307.5,1046766.97,2306074.47
292640,202312,961,669,292,883093.99,385445.59,1268539.58
292650,202312,211,160,51,211207.63,67320,278527.63
292660,202312,2214,1548,666,2043432.41,880453.74,2923886.15
292665,202312,147,103,44,135961.04,58080,194041.04
292670,202312,425,322,103,425042.18,135960.21,561002.39
292680,202312,276,210,66,277201.73,87120.86,364322.59
292690,202312,225,153,72,201960.5,95040,297000.5
292700,202312,1143,762,381,1005871.73,504245.92,1510117.65
292710,202312,120,101,19,133321.11,25080.31,158401.42
292720,202312,1150,668,482,881769.27,636240.78,1518010.05
292730,202312,266,127,139,167641.58,184800.4,352441.98
292740,202312,92811,44077,48734,58213302.99,64372236.6,122585539.59
292750,202312,460,336,124,443530.18,163682.16,607212.34
292760,202312,365,314,51,415801.82,67320.15,483121.97
292770,202312,1000,422,578,557050.52,762967.9,1320018.42
292780,202312,74,36,38,47521.67,50160.15,97681.82
292790,202312,845,462,383,609846.77,505560.2,1115406.97
292800,202312,1424,861,563,1136543.24,743166.47,1879709.71
292805,202312,438,179,259,236280.95,341881.36,578162.31
292810,202312,2002,1187,815,1566869.16,1075802.74,2642671.90
292820,202312,1001,835,166,1102228.22,219123.03,1321351.25
292830,202312,162,121,41,159725.68,54121.47,213847.15
292840,202312,776,621,155,819751.79,204602.08,1024353.87
292850,202312,158,107,51,141242.79,67321.15,208563.94
292860,202312,2321,1348,973,1779424.07,1284370.71,3063794.78
292870,202312,4237,2778,1459,3672331.42,1925890.44,5598221.86
292880,202312,1616,1081,535,1426954.53,706207.39,2133161.92
292890,202312,622,516,106,681139.66,139922.55,821062.21
292895,202312,167,121,46,159720.04,60720,220440.04
292900,202312,381,278,103,366976.89,135962.68,502939.57
292905,202312,556,275,281,364328.85,370925.8,735254.65
292910,202312,612,457,155,603247.71,204601.38,807849.09
292920,202312,705,321,384,423733.48,506887.56,930621.04
292925,202312,511,463,48,611162.47,63361.22,674523.69
292930,202312,846,512,334,675853.72,440885.69,1116739.41
292935,202312,283,129,154,170280.43,203280.12,373560.55
292937,202312,222,153,69,201961.68,91080,293041.68
292940,202312,213,160,53,211201.94,69960,281161.94
292950,202312,1616,776,840,1024351.41,1108809.73,2133161.14
292960,202312,540,388,152,512183.08,200640.68,712823.76
292970,202312,278,205,73,270603.87,97681.47,368285.34
292975,202312,116,65,51,85805.23,67320.2,153125.43
292980,202312,392,273,119,360365.18,157081.8,517446.98
292990,202312,1444,1096,348,1446730.8,459360.77,1906091.57
293000,202312,127,89,38,117482.33,50160,167642.33
293010,202312,3444,2044,1400,2699546.69,1849352.46,4548899.15
293015,202312,669,551,118,727334.84,155760.9,883095.74
293020,202312,402,319,83,421095.85,109562.77,530658.62
293030,202312,466,431,35,568932.73,46200,615132.73
293040,202312,405,325,80,431641.54,105600.88,537242.42
293050,202312,3506,2058,1448,2716634.7,1911379.18,4628013.88
293060,202312,248,197,51,260055.86,67321.78,327377.64
293070,202312,4535,2282,2253,3012363.92,2973996.93,5986360.85
293075,202312,104,72,32,95040.81,43560,138600.81
293076,202312,104,80,24,105601.94,31680,137281.94
293077,202312,722,413,309,545182.93,407888.61,953071.54
293080,202312,454,398,56,525366.05,73920.66,599286.71
293090,202312,78,73,5,96360.26,6600,102960.26
293100,202312,611,410,201,541207.42,265320.63,806528.05
293105,202312,388,289,99,381482.21,130680,512162.21
293110,202312,129,83,46,109565.8,60722.42,170288.22
293120,202312,322,232,90,306245.57,118805.29,425050.86
293130,202312,270,181,89,238924.3,117480,356404.3
293135,202312,9344,3878,5466,5119095.36,7216461.47,12335556.83
293140,202312,217,127,90,167643.53,118801.19,286444.72
293150,202312,359,307,52,405248.37,68640,473888.37
293160,202312,471,305,166,402602.54,219120,621722.54
293170,202312,290,177,113,233645.48,149161.47,382806.95
293180,202312,677,470,207,620401.78,273240,893641.78
293190,202312,1538,1058,480,1396597.04,634927.17,2031524.21
293200,202312,649,559,90,737900.33,118800.42,856700.75
293210,202312,481,368,113,485768.89,149160,634928.89
293220,202312,2620,1212,1408,1601182.96,1858568.21,3459751.17
293230,202312,2032,783,1249,1033581.68,1651323.35,2684905.03
293240,202312,253,223,30,294371.56,39600.2,333971.76
293245,202312,138,112,26,147841.75,34320,182161.75
293250,202312,841,377,464,497655.52,612493.98,1110149.50
293260,202312,367,283,84,373562.08,110880,484442.08
293270,202312,1254,579,675,764286.49,891000.1,1655286.59
293280,202312,345,242,103,319442.51,135960.93,455403.44
293290,202312,3458,2244,1214,2963489.23,1602489.82,4565979.05
293300,202312,1012,704,308,929290.92,406560.21,1335851.13
293305,202312,215,166,49,219121.71,64680.65,283802.36
293310,202312,186,138,48,182160.98,63360.7,245521.68
293315,202312,206,158,48,208565.24,63361.09,271926.33
293317,202312,106,81,25,106920.2,33000,139920.2
293320,202312,1416,743,673,980820.16,888382.93,1869203.09
293325,202312,221,96,125,126720,165000,291720
293330,202312,17132,8161,8971,10775507.31,11845789.91,22621297.22
293340,202312,308,218,90,287761.79,118800,406561.79
293345,202312,288,245,43,323404.38,56760,380164.38
293350,202312,635,417,218,550454.33,287761.24,838215.57
293360,202312,1630,1140,490,1506161.94,646808.92,2152970.86
310010,202312,155,84,71,110880.77,93720.04,204600.81
310020,202312,1027,562,465,743180.24,613803.69,1356983.93
310030,202312,332,263,69,347165.05,92401.88,439566.93
310040,202312,61,41,20,54120,26400,80520
310050,202312,184,121,63,159720.41,83160,242880.41
310060,202312,320,239,81,315488.79,106921.07,422409.86
310070,202312,25,18,7,23760.21,9240.2,33000.41
310080,202312,56,37,19,48840,25080.83,73920.83
310090,202312,1241,704,537,929297.85,708845.49,1638143.34
310100,202312,427,297,130,392052.71,171601.15,563653.86
310110,202312,777,424,353,559688.37,467282.54,1026970.91
310120,202312,464,265,199,349801.49,262680.89,612482.38
310130,202312,42,24,18,31680.2,23760,55440.2
310140,202312,23,9,14,11880,18481.09,30361.09
310150,202312,1296,841,455,1110162.5,600609.58,1710772.08
310160,202312,2356,1170,1186,1545763.92,1566851.5,3112615.42
310163,202312,112,64,48,84480,63360,147840
310170,202312,2886,1435,1451,1894249.72,1915334.08,3809583.80
310180,202312,229,113,116,149161.24,153120,302281.24
310190,202312,536,355,181,468607.61,238922.48,707530.09
310200,202312,450,280,170,369605.05,224400.2,594005.25
310205,202312,94,67,27,88441.12,35640,124081.12
310210,202312,298,238,60,314162.27,79200,393362.27
310220,202312,72,47,25,62040.1,33000,95040.1
310230,202312,322,230,92,303603.41,121440,425043.41
310240,202312,142,112,30,147840,39600,187440
310250,202312,107,87,20,114843.76,26400,141243.76
310260,202312,843,462,381,609860.07,502923.36,1112783.43
310270,202312,324,214,110,282485.86,145200.14,427686.00
310280,202312,451,309,142,407883.77,187440,595323.77
310285,202312,222,174,48,229682.31,63360,293042.31
310290,202312,250,134,116,176882.28,153120,330002.28
310300,202312,201,163,38,215162.13,50160.33,265322.46
310310,202312,21,17,4,22440.95,5280,27720.95
310320,202312,32,12,20,15840.18,26400.25,42240.43
310330,202312,56,43,13,56761.14,17160.66,73921.80
310340,202312,2072,1503,569,1984009.56,751082.84,2735092.40
310350,202312,3065,1547,1518,2042115.89,2005088.71,4047204.60
310360,202312,57,44,13,58080,17160.6,75240.6
310370,202312,165,139,26,183480.9,34320,217800.9
310375,202312,112,42,70,55441.79,92400.97,147842.76
310380,202312,56,36,20,47520,27720,75240
310390,202312,112,69,43,91081.09,56760,147841.09
310400,202312,2896,1957,939,2583352.15,1239491.58,3822843.73
310410,202312,138,82,56,108240.82,73920,182160.82
310420,202312,766,411,355,542531.25,468604.51,1011135.76
310430,202312,307,199,108,262681.56,142560,405241.56
310440,202312,91,61,30,81841.9,39600,121441.9
310445,202312,93,81,12,106920.94,15840,122760.94
310450,202312,747,511,236,674535.38,311520.93,986056.31
310460,202312,291,200,91,264003.2,120120.56,384123.76
310470,202312,588,382,206,504253.04,271921.21,776174.25
310480,202312,115,76,39,100320,51480,151800
310490,202312,662,333,329,439569.48,434281.11,873850.59
310500,202312,153,68,85,89761.55,112200,201961.55
310510,202312,686,482,204,637577.11,269281.34,906858.45
310520,202312,171,120,51,159723.14,67320,227043.14
310530,202312,141,63,78,83160.7,102960,186120.7
310540,202312,553,305,248,402610.8,327362.28,729973.08
310550,202312,91,64,27,84482.38,35640,120122.38
310560,202312,3610,2477,1133,3271059.83,1498205.42,4769265.25
310570,202312,126,85,41,112200.95,54120,166320.95
310590,202312,454,276,178,364330.53,234961.8,599292.33
310600,202312,155,75,80,99001.4,105600,204601.4
310610,202312,41,15,26,19800.73,34320,54120.73
310620,202312,59957,28633,31324,37819128.77,41378303.38,79197432.15
310630,202312,878,558,320,736579.57,422402.54,1158982.11
310640,202312,181,118,63,155760.2,83160.2,238920.4
310650,202312,190,172,18,227040.39,23760,250800.39
310660,202312,133,91,42,120120.2,55440,175560.2
310665,202312,78,56,22,73920,29040,102960
310670,202312,8622,3764,4858,4971326.74,6415238.4,11386565.14
310680,202312,69,47,22,62040.2,29040,91080.2
310690,202312,653,458,195,604573.67,257402.8,861976.47
310700,202312,66,40,26,52800.2,34320.97,87121.17
310710,202312,1421,971,450,1281739.11,594005.32,1875744.43
310720,202312,162,47,115,62040,151800.17,213840.17
310730,202312,1786,1213,573,1601220.74,757695.79,2358916.53
310740,202312,1134,616,518,814472.72,685088.09,1499560.81
310750,202312,277,182,95,240244.41,125400.37,365644.78
310760,202312,80,64,16,84482.45,21120,105602.45
310770,202312,84,40,44,52800.1,58080,110880.1
310780,202312,395,320,75,422409.34,99001.5,521410.84
310790,202312,145,114,31,150481.24,40920.69,191401.93
310800,202312,518,243,275,320763.25,363000,683763.25
310810,202312,195,128,67,168961.04,88440.21,257401.25
310820,202312,316,254,62,335290.26,81840.04,417130.30
310825,202312,217,182,35,240243.35,46200,286443.35
310830,202312,512,234,278,308883.03,366961.21,675844.24
310840,202312,417,264,153,348483.43,203280.32,551763.75
310850,202312,88,73,15,96360.95,19800,116160.95
310855,202312,501,398,103,526690.75,135960,662650.75
310860,202312,1792,1320,472,1742458.76,623053.13,2365511.89
310870,202312,73,62,11,81840.6,14520,96360.6
310880,202312,108,85,23,112077.24,30360,142437.24
310890,202312,324,186,138,245522.46,182160,427682.46
310900,202312,735,351,384,463329.04,506885.01,970214.05
310910,202312,262,173,89,229680.89,117480,347160.89
310920,202312,469,278,191,366970.82,252128.47,619099.29
310925,202312,57,46,11,60720.66,14520,75240.66
310930,202312,1515,1041,474,1375469.98,627005.61,2002475.59
310940,202312,766,374,392,493695.68,517446.35,1011142.03
310945,202312,174,119,55,157080.42,72600,229680.42
310950,202312,236,187,49,246842.55,64680,311522.55
310960,202312,76,29,47,38280.5,63360.88,101641.38
310970,202312,189,109,80,145203.23,106920,252123.23
310980,202312,58,41,17,54124.95,22440,76564.95
310990,202312,178,99,79,130680.02,104281.59,234961.61
311000,202312,996,517,479,682454.64,633605.82,1316060.46
311010,202312,59,45,14,59400.84,18480,77880.84
311020,202312,55,39,16,51481.46,21120,72601.46
311030,202312,436,241,195,318123.01,257401.15,575524.16
311040,202312,40,32,8,42240,10560,52800
311050,202312,583,220,363,290401.84,479160.82,769562.66
311060,202312,935,516,419,681133.91,553084.32,1234218.23
311070,202312,390,180,210,237602.16,277200,514802.16
311080,202312,139,78,61,102961.19,80521.32,183482.51
311090,202312,395,200,195,264007.1,257401.56,521408.66
311100,202312,617,381,236,502930.08,311521.23,814451.31
311110,202312,756,535,221,706220.24,291725.71,997945.95
311115,202312,94,66,28,87120,36960.2,124080.2
311120,202312,1239,696,543,918751.47,716765.17,1635516.64
311130,202312,290,169,121,223086.41,159720.59,382807.00
311140,202312,181,104,77,137284.99,101643.01,238928.00
311150,202312,353,226,127,298324.09,167640,465964.09
311160,202312,843,592,251,781451.92,331323.02,1112774.94
311170,202312,111,91,20,120123.47,26400,146523.47
311180,202312,338,237,101,312849.45,133320.64,446170.09
311190,202312,41,19,22,25080,29040,54120
311200,202312,363,248,115,327362.07,151800.9,479162.97
311205,202312,46,39,7,51480.74,9240,60720.74
311210,202312,43,39,4,51480,5280,56760
311220,202312,32,30,2,39600,2640,42240
311230,202312,1842,1253,589,1654024.11,777489.5,2431513.61
311240,202312,104,73,31,96365.69,40920.5,137286.19
311250,202312,63,28,35,36960,46200,83160
311260,202312,583,356,227,469927.62,299640.14,769567.76
311265,202312,159,105,54,138602.67,71280,209882.67
311270,202312,308,211,97,278524.8,128041.11,406565.91
311280,202312,214,94,120,125401.4,158400,283801.4
311290,202312,123,104,19,137281.67,25080,162361.67
311300,202312,641,423,218,558725.88,287762.87,846488.75
311310,202312,19,16,3,21120,3960,25080
311320,202312,704,519,185,686417.91,244200.7,930618.61
311330,202312,1370,986,384,1304199.6,506894.44,1811094.04
311340,202312,2992,2105,887,2779998.63,1170845.44,3950844.07
311350,202312,287,218,69,287762.88,91080,378842.88
311360,202312,170,102,68,134642.78,89760,224402.78
311370,202312,1325,570,755,752433.32,996610.43,1749043.75
311380,202312,8,6,2,7920,2640,10560
311390,202312,271,160,111,211203.06,146520,357723.06
311400,202312,144,86,58,113520.8,76560,190080.8
311410,202312,151,77,74,101641.39,97680.17,199321.56
311420,202312,357,180,177,237607.29,233641.76,471249.05
311430,202312,960,640,320,844808.19,423720.69,1268528.88
311440,202312,513,340,173,448810.58,228362.37,677172.95
311450,202312,333,192,141,253442.19,186120,439562.19
311455,202312,287,195,92,257408.81,121440.4,378849.21
311460,202312,141,66,75,87120.3,99000,186120.3
311470,202312,41,21,20,27720,26400,54120
311480,202312,80,46,34,60720,44880,105600
311490,202312,11,6,5,7920,6600,14520
311500,202312,36,19,17,25080,22440,47520
311510,202312,891,610,281,805216.77,370921.15,1176137.92
311520,202312,42,35,7,46200,9240,55440
311530,202312,2093,1504,589,1985385.08,778804.3,2764189.38
311535,202312,76,47,29,62041.7,38280.52,100322.22
311540,202312,35,30,5,39600.1,6600,46200.1
311545,202312,198,140,58,184802.69,76560,261362.69
311547,202312,68,54,14,71280,18481.72,89761.72
311550,202312,791,372,419,491050.7,553082.58,1044133.28
311560,202312,43,26,17,34320.83,22440,56760.83
311570,202312,320,216,104,285122.42,137281.22,422403.64
311580,202312,482,314,168,414485.88,221760.75,636246.63
311590,202312,28,24,4,31681.17,5280,36961.17
311600,202312,98,78,20,102963.76,26401,129364.76
311610,202312,259,224,35,295682.7,46200,341882.7
311615,202312,222,190,32,250801.16,42240.52,293041.68
311620,202312,33,23,10,30360.2,13200,43560.2
311630,202312,131,115,16,151800.49,21120,172920.49
311640,202312,160,84,76,110884.3,100322.28,211206.58
311650,202312,151,100,51,132000.9,67320.2,199321.1
311660,202312,495,229,266,302285,351121.24,653406.24
311670,202312,180,131,49,172734.19,64680.43,237414.62
311680,202312,260,195,65,257401.9,85800.18,343202.08
311690,202312,17,16,1,21120.5,1320,22440.5
311700,202312,219,165,54,217802.6,71280.96,289083.56
311710,202312,191,131,60,172922.44,79200,252122.44
311720,202312,40,29,11,38280.89,14520,52800.89
311730,202312,640,451,189,595338.08,249481.55,844819.63
311740,202312,28,23,5,30360,6600,36960
311750,202312,792,533,259,703566.73,341881,1045447.73
311760,202312,83,38,45,50161.47,59400.44,109561.91
311770,202312,419,225,194,297003.81,257400.61,554404.42
311780,202312,255,142,113,187441.54,149160.89,336602.43
311783,202312,112,96,16,126720.7,21120,147840.7
311787,202312,57,24,33,31680,43560.28,75240.28
311790,202312,291,127,164,167641.2,216482.13,384123.33
311800,202312,889,523,366,690380.61,483122.17,1173502.78
311810,202312,62,45,17,59401.61,22440,81841.61
311820,202312,152,117,35,154444.94,46200.58,200645.52
311830,202312,2208,1260,948,1663247.84,1251364.07,2914611.91
311840,202312,1287,768,519,1013773.83,685083.01,1698856.84
311850,202312,20,14,6,18480.6,7920.2,26400.8
311860,202312,12140,5286,6854,6979096.07,9051328.48,16030424.55
311870,202312,125,76,49,100322.71,64680.31,165003.02
311880,202312,1041,747,294,986069.6,388088.32,1374157.92
311890,202312,229,104,125,137173.1,165005,302178.1
311900,202312,71,33,38,43560.21,50160.15,93720.36
311910,202312,1567,989,578,1305513.26,762966.22,2068479.48
311920,202312,255,172,83,227042.74,109560.2,336602.94
311930,202312,1055,602,453,794656.26,599282.98,1393939.24
311940,202312,3157,1805,1352,2382674.91,1785964.6,4168639.51
311950,202312,202,120,82,158402.94,108241.05,266643.99
311960,202312,72,51,21,67320.13,27720.52,95040.65
311970,202312,30,16,14,21120,18480,39600
311980,202312,44,35,9,46200,11880,58080
311990,202312,44,29,15,38280.08,19800.64,58080.72
311995,202312,61,36,25,47520.7,33000.2,80520.9
312000,202312,24,19,5,25080,6600,31680
312010,202312,74,57,17,75242.58,22440,97682.58
312015,202312,94,64,30,84480.49,39600,124080.49
312020,202312,147,112,35,147840.53,46200,194040.53
312030,202312,89,69,20,91080,26400,117480
312040,202312,103,60,43,79200,56760,135960
312050,202312,215,129,86,170281.17,113520,283801.17
312060,202312,19,12,7,15840,9240,25080
312070,202312,87,58,29,76561.03,38280.21,114841.24
312080,202312,546,272,274,360364.58,361680.3,722044.88
312083,202312,97,64,33,84480.7,43560,128040.7
312087,202312,119,84,35,110881.42,46200,157081.42
312090,202312,3939,2476,1463,3268461.05,1937785.01,5206246.06
312100,202312,160,108,52,142562.7,68641.51,211204.21
312110,202312,142,83,59,109562.74,77880.88,187443.62
312120,202312,136,95,41,126720.9,54120.2,180841.1
312125,202312,96,65,31,85804,40920.88,126724.88
312130,202312,145,101,44,133322.81,58080,191402.81
312140,202312,169,126,43,166320.98,56760,223080.98
312150,202312,39,32,7,42240,9240,51480
312160,202312,1587,1044,543,1378225.14,716765.82,2094990.96
312170,202312,26,17,9,22440,11880,34320
312180,202312,91,67,24,88440,31680,120120
312190,202312,58,51,7,67320.96,9240,76560.96
312200,202312,821,696,125,918741.02,165001.6,1083742.62
312210,202312,150,85,65,112201.52,85800.48,198002.00
312220,202312,176,134,42,176881.86,55440,232321.86
312230,202312,4395,1936,2459,2555632.3,3247207.82,5802840.12
312235,202312,204,138,66,182160.99,87120,269280.99
312240,202312,99,76,23,100322.82,30360.43,130683.25
312245,202312,264,193,71,254767.09,93721.16,348488.25
312247,202312,94,70,24,92400,31680.38,124080.38
312250,202312,191,102,89,134643.27,117480.28,252123.55
312260,202312,119,76,43,100320,56760,157080
312270,202312,148,85,63,112202.46,84480,196682.46
312280,202312,29,15,14,19800,18480,38280
312290,202312,158,108,50,142563.67,66000.86,208564.53
312300,202312,221,146,75,192722.85,99000.34,291723.19
312310,202312,71,61,10,80520,13200,93720
312320,202312,467,288,179,380163.05,236280.54,616443.59
312330,202312,126,109,17,143880.8,22440.19,166320.99
312340,202312,35,18,17,23760,22440,46200
312350,202312,16,9,7,11880.82,9240,21120.82
312352,202312,102,75,27,99001.76,35640,134641.76
312360,202312,646,295,351,389408.86,463320.2,852729.06
312370,202312,446,257,189,339240.1,249480.89,588720.99
312380,202312,166,113,53,149166.96,69962.45,219129.41
312385,202312,201,161,40,212524.77,52800.2,265324.97
312390,202312,325,206,119,271922.13,157080,429002.13
312400,202312,432,329,103,434283.43,135960.07,570243.50
312410,202312,1423,547,876,722066.52,1157662.57,1879729.09
312420,202312,775,588,187,776168.69,246843.02,1023011.71
312430,202312,936,673,263,888375.37,347161.97,1235537.34
312440,202312,67,50,17,66000,22440,88440
312450,202312,254,150,104,198000.25,137280,335280.25
312460,202312,42,18,24,23760,31680,55440
312470,202312,52,36,16,47520.57,21120,68640.57
312480,202312,163,105,58,138603.5,76561.19,215164.69
312490,202312,355,245,110,323409.22,145202.34,468611.56
312500,202312,38,28,10,36961.91,13200,50161.91
312510,202312,809,333,476,439572.67,628329.83,1067902.50
312520,202312,26,10,16,13200,21120,34320
312530,202312,42,29,13,38281.8,17160.1,55441.9
312540,202312,91,77,14,101640.53,18480,120120.53
312550,202312,35,28,7,36960,9240,46200
312560,202312,237,186,51,245521.35,67320,312841.35
312570,202312,567,350,217,463333.31,286442.2,749775.51
312580,202312,90,55,35,72600,46200,118800
312590,202312,233,181,52,238922.85,68640,307562.85
312595,202312,174,144,30,190081.38,39600.9,229682.28
312600,202312,76,36,40,47520,52800,100320
312610,202312,1765,970,795,1280437.48,1049401.49,2329838.97
312620,202312,251,187,64,246842.65,84480,331322.65
312630,202312,84,65,19,85800.91,25080,110880.91
312640,202312,53,17,36,22440,47520,69960
312650,202312,166,141,25,186565.54,33000.1,219565.64
312660,202312,120,83,37,109565.15,48840.39,158405.54
312670,202312,1048,659,389,869910.43,516124.94,1386035.37
312675,202312,50,37,13,48840,17160,66000
312680,202312,82,53,29,69960.78,38280,108240.78
312690,202312,313,169,144,223083.87,191401.22,414485.09
312695,202312,46,38,8,50160,10560,60720
312700,202312,296,173,123,228365.17,162361.58,390726.75
312705,202312,96,75,21,99000,27720,126720
312707,202312,138,98,40,129360.49,52800,182160.49
312710,202312,2076,1202,874,1586707.17,1153694.47,2740401.64
312720,202312,52,27,25,35640.86,33000,68640.86
312730,202312,312,187,125,248162.65,165002.42,413165.07
312733,202312,55,43,12,56760.7,15840,72600.7
312735,202312,25,20,5,26400.71,6600.3,33001.01
312737,202312,96,61,35,80520.72,46200,126720.72
312738,202312,97,59,38,77880.17,50160,128040.17
312740,202312,94,57,37,75240.06,48840,124080.06
312750,202312,156,108,48,142560.28,63360,205920.28
312760,202312,287,198,89,261366.01,117480.97,378846.98
312770,202312,10552,5246,5306,6930194.47,7010539.48,13940733.95
312780,202312,481,369,112,487090.41,147843.71,634934.12
312790,202312,22,16,6,21120,7920,29040
312800,202312,1861,1280,581,1690938.71,766922.76,2457861.47
312810,202312,378,266,112,351120.1,147840,498960.1
312820,202312,220,170,50,225722.23,66000,291722.23
312825,202312,46,35,11,46202.08,14520,60722.08
312830,202312,220,122,98,161043.87,130681.14,291725.01
312840,202312,227,161,66,212521.62,87120,299641.62
312850,202312,37,32,5,42241.57,6600,48841.57
312860,202312,179,117,62,154440.34,81840,236280.34
312870,202312,1400,745,655,983428.68,864600.44,1848029.12
312880,202312,141,109,32,143882.99,42240,186122.99
312890,202312,190,136,54,179523.67,71280,250803.67
312900,202312,163,125,38,165002.98,50160,215162.98
312910,202312,202,118,84,155767.19,110881.66,266648.85
312920,202312,122,72,50,95042.96,66000,161042.96
312930,202312,377,248,129,327365.41,170281.03,497646.44
312940,202312,170,115,55,151800.8,72600,224400.8
312950,202312,844,602,242,794664.75,319442.2,1114106.95
312960,202312,151,107,44,141247.78,58080.99,199328.77
312965,202312,133,105,28,138600.38,36960,175560.38
312970,202312,318,255,63,336609.83,83161.47,419771.30
312980,202312,3157,1677,1480,2215047.29,1953616.28,4168663.57
312990,202312,50,20,30,26400.9,39600,66000.9
313000,202312,59,33,26,43560,34320,77880
313005,202312,202,152,50,200640.05,66000.61,266640.66
313010,202312,1122,501,621,661337.24,819728.25,1481065.49
313020,202312,200,103,97,135960,129360,265320
313030,202312,229,153,76,201964.13,100320.76,302284.89
313040,202312,105,30,75,39600.25,99000,138600.25
313050,202312,250,187,63,248160,84480,332640
313055,202312,47,33,14,43560,18480,62040
313060,202312,167,117,50,154441.15,66000,220441.15
313065,202312,63,48,15,63360,19800,83160
313070,202312,124,67,57,88442.22,75240,163682.22
313080,202312,47,25,22,33000,29040,62040
313090,202312,777,515,262,679808.81,345841.42,1025650.23
313100,202312,240,90,150,118800.2,198000.93,316801.13
313110,202312,180,104,76,138602.11,100321.12,238923.23
313115,202312,306,177,129,233643.36,170280.28,403923.64
313120,202312,978,569,409,751095.36,539884.95,1290980.31
313130,202312,7073,4016,3057,5306574.91,4036589.24,9343164.15
313140,202312,146,86,60,113526.1,79200.86,192726.96
313150,202312,315,247,68,327365.81,89760,417125.81
313160,202312,202,153,49,201966.63,64680,266646.63
313170,202312,1643,1040,603,1372846.45,795963.24,2168809.69
313180,202312,402,265,137,349803.93,180843.27,530647.20
313190,202312,860,487,373,642857.6,492363.92,1135221.52
313200,202312,39,32,7,42240.78,9240,51480.78
313210,202312,1083,911,172,1202578.54,227046.88,1429625.42
313220,202312,362,219,143,289080,188760,477840
313230,202312,342,266,76,351121.34,100320,451441.34
313240,202312,2616,1329,1287,1756973.34,1700162.27,3457135.61
313250,202312,1321,998,323,1317392.45,426363.66,1743756.11
313260,202312,114,60,54,79203.47,71280,150483.47
313270,202312,1171,707,464,933253.24,612484.41,1545737.65
313280,202312,50,38,12,50160,15840,66000
313290,202312,263,215,48,283809.32,63360.57,347169.89
313300,202312,368,182,186,240245.67,246840.58,487086.25
313310,202312,283,129,154,170281.86,203280.8,373562.66
313320,202312,437,327,110,431643.83,146520.07,578163.90
313330,202312,1586,1003,583,1323991.09,770884.75,2094875.84
313340,202312,371,266,105,351126.58,138600.91,489727.49
313350,202312,464,292,172,386766.97,227040.24,613807.21
313360,202312,240,106,134,139921.16,176880,316801.16
313370,202312,256,98,158,129361.22,208560.69,337921.91
313375,202312,380,244,136,323408.66,180842.06,504250.72
313380,202312,1502,777,725,1025673.18,957001.73,1982674.91
313390,202312,56,49,7,64680.2,9240,73920.2
313400,202312,441,316,125,417138.95,165002,582140.95
313410,202312,123,82,41,108241.53,54120.38,162361.91
313420,202312,5302,3167,2135,4180597.24,2819535.71,7000132.95
313430,202312,126,61,65,80520.31,85800.33,166320.64
313440,202312,1472,1052,420,1390023.93,554407.47,1944431.40
313450,202312,83,34,49,44880,64680,109560
313460,202312,437,200,237,264003.87,312840.66,576844.53
313470,202312,557,280,277,369614.5,365646.65,735261.15
313480,202312,172,132,40,175562.26,52800,228362.26
313490,202312,654,302,352,399978.93,464649.21,864628.14
313500,202312,34,20,14,26400.53,18480,44880.53
313505,202312,1207,918,289,1211802.39,381486.94,1593289.33
313507,202312,125,90,35,120121.82,46200,166321.82
313510,202312,3293,2027,1266,2675865.85,1671148.71,4347014.56
313520,202312,3725,2858,867,3772727.12,1144449.93,4917177.05
313530,202312,48,30,18,39600.31,23760.94,63361.25
313535,202312,112,94,18,124081.27,25080,149161.27
313540,202312,73,53,20,69960,26400,96360
313545,202312,145,126,19,166321.52,25080,191401.52
313550,202312,235,199,36,262683.73,47520.95,310204.68
313560,202312,389,184,205,242889.54,270607.84,513497.38
313570,202312,95,34,61,44880,80520,125400
313580,202312,1538,928,610,1224988.24,806527.3,2031515.54
313590,202312,94,61,33,80524.39,43561.3,124085.69
313600,202312,768,473,295,625690.93,389401.11,1015092.04
313610,202312,73,58,15,76562.44,19800.35,96362.79
313620,202312,1730,856,874,1129957.26,1153684.49,2283641.75
313630,202312,1910,1455,455,1921973.81,600603.15,2522576.96
313640,202312,119,72,47,95041.61,63360,158401.61
313650,202312,269,145,124,191400.62,163681.51,355082.13
313652,202312,38,35,3,46200.9,3960,50160.9
313655,202312,111,74,37,97681.16,48840.31,146521.47
313657,202312,59,53,6,69961.56,7920,77881.56
313660,202312,171,116,55,153122.26,72600.04,225722.30
313665,202312,833,382,451,504257.15,595328.05,1099585.20
313670,202312,13187,9214,3973,12164411.84,5247046.4,17411458.24
313680,202312,54,41,13,54120.73,17160,71280.73
313690,202312,163,116,47,153120.12,62040,215160.12
313695,202312,94,73,21,96363.07,27720,124083.07
313700,202312,415,328,87,432966.67,114840.69,547807.36
313710,202312,135,95,40,125402.87,52800,178202.87
313720,202312,1333,642,691,847474.22,912128.69,1759602.91
313730,202312,87,51,36,67322.6,47520,114842.6
313740,202312,172,127,45,167640.66,59400,227040.66
313750,202312,455,321,134,423727.2,176880.79,600607.99
313753,202312,257,202,55,266646.78,72600.1,339246.88
313760,202312,1583,621,962,819741.39,1269853.18,2089594.57
313770,202312,489,327,162,431652.89,213844.6,645497.49
313780,202312,984,558,426,736574.67,562324.57,1298899.24
313790,202312,37,37,0,48840,0,48840
313800,202312,187,120,67,158404.05,88441.55,246845.60
313810,202312,109,65,44,85801.71,58080.72,143882.43
313820,202312,1612,780,832,1029632.19,1098241.97,2127874.16
313830,202312,62,41,21,54121.95,27720,81841.95
313835,202312,74,64,10,84480.2,13200,97680.2
313840,202312,1973,1227,746,1621024.21,984725.98,2605750.19
313850,202312,252,121,131,159723.18,172920.5,332643.68
313860,202312,547,411,136,542534.6,179520.64,722055.24
313862,202312,190,133,57,175566.25,75240,250806.25
313865,202312,209,148,61,195360.35,80520,275880.35
313867,202312,72,61,11,80520,14520,95040
313868,202312,68,44,24,58081.53,31680,89761.53
313870,202312,89,51,38,67320.2,50160,117480.2
313880,202312,425,264,161,348484.18,212520.71,561004.89
313890,202312,368,205,163,270604.35,215161.01,485765.36
313900,202312,981,539,442,711495.82,583448.77,1294944.59
313910,202312,151,101,50,133320.27,66000.69,199320.96
313920,202312,745,507,238,669244.29,314162.04,983406.33
313925,202312,37,31,6,40920,7920,48840
313930,202312,1003,759,244,1001932.35,322089.13,1324021.48
313940,202312,2330,1425,905,1881043.35,1194609.23,3075652.58
313950,202312,988,611,377,806541.61,497641.55,1304183.16
313960,202312,1655,968,687,1277784.56,908165.92,2185950.48
313970,202312,258,142,116,187440.3,153120,340560.3
313980,202312,278,176,102,232326.64,134640.02,366966.66
313990,202312,335,196,139,258720.82,183480,442200.82
314000,202312,1015,654,361,864617.42,476524.18,1341141.60
314010,202312,138,91,47,120120.15,62040,182160.15
314015,202312,132,50,82,66001.15,108240.9,174242.05
314020,202312,65,43,22,56761.02,29040.98,85802.00
314030,202312,82,45,37,59401.34,48840,108241.34
314040,202312,56,29,27,38280,35640,73920
314050,202312,326,173,153,228365.83,203280,431645.83
314053,202312,112,75,37,99001.6,48840,147841.6
314055,202312,327,218,109,289087.45,145201.54,434288.99
314060,202312,134,116,18,153120.3,23760,176880.3
314070,202312,1133,574,559,757710.22,737892.05,1495602.27
314080,202312,231,136,95,179523.14,125401.05,304924.19
314085,202312,218,156,62,205920.65,81840,287760.65
314090,202312,475,355,120,468607.86,159720.36,628328.22
314100,202312,582,452,130,596657.77,171603.01,768260.78
314110,202312,863,371,492,489736.08,649443.33,1139179.41
314120,202312,77,48,29,63360,38280,101640
314130,202312,30,21,9,27720,11880,39600
314140,202312,1335,857,478,1131263.05,630965.27,1762228.32
314150,202312,216,141,75,186122.34,99000,285122.34
314160,202312,329,251,78,331322.95,102960.56,434283.51
314170,202312,99,74,25,97681.31,33000,130681.31
314180,202312,846,749,97,990032.96,128041.57,1118074.53
314190,202312,90,56,34,73921.69,44880.65,118802.34
314200,202312,584,409,175,539896.51,231006.74,770903.25
314210,202312,249,191,58,252127.04,76560,328687.04
314220,202312,338,244,94,322086.91,125401.41,447488.32
314225,202312,45,29,16,38280.46,21120,59400.46
314230,202312,140,58,82,76560.55,108240,184800.55
314240,202312,197,142,55,187441.37,72600.1,260041.47
314250,202312,60,38,22,50163.38,29040,79203.38
314260,202312,224,120,104,158401.75,137280,295681.75
314270,202312,455,350,105,462018.81,138600.5,600619.31
314280,202312,799,436,363,575473.81,479162.43,1054636.24
314290,202312,605,472,133,624368.96,175560.72,799929.68
314300,202312,342,259,83,341888.24,109560,451448.24
314310,202312,1449,1005,444,1326644.54,586080.21,1912724.75
314315,202312,63,49,14,64680,18480,83160
314320,202312,658,467,191,616453.65,252121.88,868575.53
314330,202312,13500,6635,6865,8762540.45,9068453.03,17830993.48
314340,202312,749,340,409,450130.25,539882.26,990012.51
314345,202312,71,51,20,67320,26400,93720
314350,202312,194,120,74,158400.98,97680.46,256081.44
314360,202312,64,40,24,52801.66,31680.99,84482.65
314370,202312,80,55,25,72600,33000,105600
314380,202312,150,84,66,110880.54,87120,198000.54
314390,202312,4053,2646,1407,3492843.67,1857245.02,5350088.69
314400,202312,779,556,223,733932.68,294360.85,1028293.53
314410,202312,622,420,202,554414.28,266641.71,821055.99
314420,202312,83,57,26,75240,34320,109560
314430,202312,2652,1045,1607,1379437.11,2121271.72,3500708.83
314435,202312,174,106,68,139922.65,89760.34,229682.99
314437,202312,66,54,12,71280,15840,87120
314440,202312,115,71,44,93720.5,58080.6,151801.1
314450,202312,191,129,62,170281.34,81843.33,252124.67
314460,202312,665,340,325,448811.7,429002.72,877814.42
314465,202312,144,97,47,128040.77,62040,190080.77
314467,202312,84,67,17,88440,22440,110880
314470,202312,462,237,225,312842.28,297002.4,609844.68
314480,202312,1242,572,670,756376.21,884404.86,1640781.07
314490,202312,41,22,19,29040,25080,54120
314500,202312,301,203,98,267965.83,129360.45,397326.28
314505,202312,130,81,49,108241.65,64680,172921.65
314510,202312,273,223,50,294364.5,66000,360364.5
314520,202312,1613,828,785,1093000.32,1036216.5,2129216.82
314530,202312,858,685,173,905555.26,228364.9,1133920.16
314535,202312,209,137,72,180840.2,95040,275880.2
314537,202312,78,48,30,63361.88,39600.98,102962.86
314540,202312,24,15,9,19800,11880,31680
314545,202312,79,53,26,69960,34320,104280
314550,202312,91,50,41,66001.4,54121.16,120122.56
314560,202312,953,505,448,667937.97,591365.39,1259303.36
314570,202312,18,15,3,19801.31,3960,23761.31
314580,202312,8,4,4,5280,5280,10560
314585,202312,36,28,8,36960,10560.52,47520.52
314587,202312,86,72,14,95040,18480,113520
314590,202312,695,461,234,608536.24,308882.61,917418.85
314600,202312,1128,740,388,976841.59,512172.39,1489013.98
314610,202312,1137,587,550,776174.04,726006.92,1502180.96
314620,202312,168,129,39,170280.39,51480,221760.39
314625,202312,102,81,21,106921.01,27720,134641.01
314630,202312,1228,711,517,939120.6,682447.06,1621567.66
314640,202312,99,60,39,79202.16,51480,130682.16
314650,202312,166,100,66,132001.99,87120,219121.99
314655,202312,70,51,19,67320,25080,92400
314660,202312,26,21,5,27720,6600,34320
314670,202312,245,193,52,254772.08,68642.84,323414.92
314675,202312,236,151,85,199321.3,112200.23,311521.53
314690,202312,572,303,269,399971.32,356402.54,756373.86
314700,202312,2435,1325,1110,1749064.63,1467846.37,3216911.00
314710,202312,2088,1134,954,1496913.31,1259281.72,2756195.03
314720,202312,470,264,206,348485.74,271921.93,620407.67
314730,202312,590,318,272,419769.43,360362.35,780131.78
314740,202312,910,407,503,537251.98,663964.79,1201216.77
314750,202312,35,25,10,33000,13200,46200
314760,202312,398,158,240,208563.91,316800.88,525364.79
314770,202312,100,67,33,88441.39,43560,132001.39
314780,202312,14,7,7,9240,9240,18480
314790,202312,2854,1842,1012,2434167.31,1335841.58,3770008.89
314795,202312,87,74,13,97680.2,17160,114840.2
314800,202312,3311,1977,1334,2609723.4,1763524.37,4373247.77
314810,202312,1695,990,705,1306823.33,930601.48,2237424.81
314820,202312,134,86,48,113521.87,63360,176881.87
314830,202312,251,217,34,286445.72,44880,331325.72
314840,202312,99,61,38,80520,50160.68,130680.68
314850,202312,474,234,240,309016.02,316800.67,625816.69
314860,202312,612,478,134,630963.81,176881.07,807844.88
314870,202312,1904,1061,843,1401878.36,1112776.85,2514655.21
314875,202312,79,71,8,93720,10560,104280
314880,202312,52,40,12,52800.1,15840,68640.1
314890,202312,56,29,27,38280,35640,73920
314900,202312,29,21,8,27721.1,10561.84,38282.94
314910,202312,251,170,81,224401.93,106920,331321.93
314915,202312,158,129,29,170284.08,38280.68,208564.76
314920,202312,87,55,32,72600.85,42240,114840.85
314930,202312,1214,551,663,727345.57,875161.61,1602507.18
314940,202312,37,31,6,40920,7920,48840
314950,202312,25,19,6,25081.1,7920,33001.1
314960,202312,34,20,14,26401.21,18480.18,44881.39
314970,202312,212,92,120,121441.85,158402.15,279844.00
314980,202312,358,242,116,319446.02,154440,473886.02
314990,202312,498,262,236,345846.57,311523.74,657370.31
314995,202312,170,83,87,109561.83,114840,224401.83
315000,202312,119,91,28,120120.49,36960.1,157080.59
315010,202312,43,28,15,36960,19800,56760
315015,202312,182,148,34,195361.3,44880,240241.3
315020,202312,75,63,12,83160.28,15840,99000.28
315030,202312,127,93,34,122760,44880,167640
315040,202312,100,59,41,77880.89,54120,132000.89
315050,202312,224,141,83,186120.37,109560.68,295681.05
315053,202312,78,57,21,75240,27720,102960
315057,202312,149,117,32,154441.61,42240,196681.61
315060,202312,63,53,10,69961.88,13200,83161.88
315070,202312,145,93,52,122763.45,68640.98,191404.43
315080,202312,416,333,83,440889.23,109562.45,550451.68
315090,202312,117,66,51,87121.39,67320.26,154441.65
315100,202312,118,60,58,79202.31,76560.38,155762.69
315110,202312,309,162,147,213846.77,195360,409206.77
315120,202312,2135,981,1154,1294975.36,1523315.95,2818291.31
315130,202312,396,283,113,373566.48,149160.42,522726.90
315140,202312,602,323,279,426370.58,368284.45,794655.03
315150,202312,1099,553,546,729986.59,720725.11,1450711.70
315160,202312,208,116,92,154449.62,121445.25,275894.87
315170,202312,270,173,97,228365.08,128040,356405.08
315180,202312,3689,1603,2086,2116029.25,2754853.23,4870882.48
315190,202312,316,193,123,254764.2,162360.2,417124.4
315200,202312,1400,874,526,1155026.96,695643.22,1850670.18
315210,202312,2050,1278,772,1688325.64,1019044.06,2707369.70
315213,202312,26,16,10,21120.7,13200,34320.7
315217,202312,251,197,54,260041.48,71280.96,331322.44
315220,202312,1778,1299,479,1714729.48,632288.31,2347017.79
315230,202312,220,171,49,225721.51,64680,290401.51
315240,202312,451,309,142,407890.62,187443.31,595333.93
315250,202312,3078,1489,1589,1965557.24,2098803.43,4064360.67
315260,202312,150,86,64,113520,84480.1,198000.1
315270,202312,173,122,51,161041.25,67320,228361.25
315280,202312,706,461,245,608546.53,324730.96,933277.49
315290,202312,211,136,75,179521.25,99000.62,278521.87
315300,202312,112,88,24,116160.01,31680,147840.01
315310,202312,97,86,11,113520,14520,128040
315320,202312,146,95,51,125403.01,67320,192723.01
315330,202312,65,54,11,71280,14520,85800
315340,202312,408,305,103,402604.95,135961.15,538566.10
315350,202312,191,121,70,159721.32,92400,252121.32
315360,202312,126,63,63,83160.9,84480,167640.9
315370,202312,62,41,21,54121.41,27720,81841.41
315380,202312,7,5,2,6600,2640,9240
315390,202312,77,28,49,36960.19,64681.68,101641.87
315400,202312,982,750,232,990021.57,306241.2,1296262.77
315410,202312,352,207,145,273255.26,191403.08,464658.34
315415,202312,70,53,17,69961.11,22440,92401.11
315420,202312,220,159,61,209881.95,80520,290401.95
315430,202312,671,373,298,492364.23,393360.98,885725.21
315440,202312,108,75,33,99001.48,43560,142561.48
315445,202312,269,224,45,295691.53,59400,355091.53
315450,202312,188,138,50,182160,66000,248160
315460,202312,5800,2732,3068,3607725.99,4049807.98,7657533.97
315470,202312,58,22,36,29041.1,47520,76561.1
315480,202312,95,31,64,40922.86,84482.78,125405.64
315490,202312,778,519,259,686411.42,341881.88,1028293.30
315500,202312,26,21,5,27720,6600,34320
315510,202312,178,129,49,170280.74,64680,234960.74
315520,202312,84,69,15,91080.36,19800,110880.36
315530,202312,50,29,21,38280,27720.2,66000.2
315540,202312,292,203,89,267964.74,117480.11,385444.85
315550,202312,205,164,41,216694.65,54120,270814.65
315560,202312,792,628,164,828978.33,216483.85,1045462.18
315570,202312,332,171,161,225725.94,212520.81,438246.75
315580,202312,825,563,262,744490.13,345841.76,1090331.89
315590,202312,210,104,106,137282.55,139920.63,277203.18
315600,202312,399,309,90,407885.98,118800.78,526686.76
315610,202312,111,54,57,71280,75240,146520
315620,202312,49,36,13,47523.17,17160.23,64683.40
315630,202312,152,118,34,155761.82,44880,200641.82
315640,202312,60,40,20,52800.98,26400,79200.98
315645,202312,59,41,18,54120,23760,77880
315650,202312,172,131,41,172922.9,54120,227042.9
315660,202312,471,232,239,306249.36,315485.11,621734.47
315670,202312,2802,1268,1534,1677786.4,2026225.37,3704011.77
315680,202312,809,597,212,788047.81,279840.81,1067888.62
315690,202312,769,518,251,683778.84,331323.64,1015102.48
315700,202312,2246,1171,1075,1545763.21,1420347.87,2966111.08
315710,202312,403,147,256,194042.49,337920.99,531963.48
315720,202312,588,364,224,480488.61,295680.22,776168.83
315725,202312,228,182,46,240240.88,60720,300960.88
315727,202312,134,95,39,125405.85,51480.33,176886.18
315730,202312,64,57,7,75240,9240,84480
315733,202312,95,53,42,71280.94,55440.9,126721.84
315737,202312,57,46,11,60721.86,14520,75241.86
315740,202312,41,32,9,42240.35,11880,54120.35
315750,202312,183,130,53,171600.27,69960,241560.27
315760,202312,59,46,13,60720,17160,77880
315765,202312,167,101,66,133323.45,87122.85,220446.30
315770,202312,273,186,87,245523.04,114840.64,360363.68
315780,202312,4751,2375,2376,3136421.78,3138971.48,6275393.26
315790,202312,287,223,64,294365.52,84480.87,378846.39
315800,202312,362,236,126,311523.66,167640,479163.66
315810,202312,71,41,30,55440.54,39600,95040.54
315820,202312,843,642,201,847468.58,265323.06,1112791.64
315830,202312,132,93,39,122762.08,51481.13,174243.21
315840,202312,93,65,28,85800,36960.66,122760.66
315850,202312,286,186,100,245525.98,132000.8,377526.78
315860,202312,26,11,15,14520.77,19800,34320.77
315870,202312,43,33,10,43560.16,13200,56760.16
315880,202312,103,69,34,91080,44880,135960
315890,202312,121,87,34,114842.28,44880,159722.28
315895,202312,428,287,141,378857.83,186122.34,564980.17
315900,202312,100,45,55,59400,72600,132000
315910,202312,56,31,25,40920,33000,73920
315920,202312,176,117,59,154442.36,77880,232322.36
315930,202312,61,27,34,35642.35,44881.19,80523.54
315935,202312,149,117,32,154443.7,42240,196683.7
315940,202312,104,76,28,100320,36960,137280
315950,202312,45,36,9,47520,11880.15,59400.15
315960,202312,646,311,335,411849.89,442206.34,854056.23
315970,202312,41,34,7,44881.63,9240,54121.63
315980,202312,737,401,336,529339.76,443521.3,972861.06
315990,202312,283,164,119,216482.39,157080.27,373562.66
316000,202312,53,32,21,42240,27720,69960
316010,202312,113,97,16,128043.6,21120.9,149164.5
316020,202312,101,92,9,121441.07,11880,133321.07
316030,202312,394,237,157,312847.53,207242.19,520089.72
316040,202312,607,252,355,332643.9,468600.2,801244.1
316045,202312,62,56,6,73920,7920,81840
316050,202312,29,19,10,25080,13200,38280
316060,202312,114,82,32,108241.17,42240,150481.17
316070,202312,1434,978,456,1291001.19,601924.97,1892926.16
316080,202312,99,67,32,88556.76,42240,130796.76
316090,202312,42,20,22,26400.2,29040.92,55441.12
316095,202312,94,80,14,105601.42,18480.47,124081.89
316100,202312,406,227,179,299645.15,236280.32,535925.47
316105,202312,73,50,23,66000.62,30360,96360.62
316110,202312,2020,1541,479,2035486.53,632288.93,2667775.46
316120,202312,80,54,26,71280.74,34320,105600.74
316130,202312,125,90,35,118802.74,46200.21,165002.95
316140,202312,33,24,9,31680.56,11880,43560.56
316150,202312,261,186,75,245523.61,99000.33,344523.94
316160,202312,97,68,29,89760.8,38280.28,128041.08
316165,202312,83,53,30,69961.56,39600,109561.56
316170,202312,200,130,70,171600.05,92400,264000.05
316180,202312,240,94,146,124083.18,192721.71,316804.89
316190,202312,156,114,42,150482.19,55440,205922.19
316200,202312,765,427,338,563657.61,446163.76,1009821.37
316210,202312,819,564,255,746046.09,337923.38,1083969.47
316220,202312,141,91,50,120122.43,66000.57,186123.00
316225,202312,47,30,17,39601.44,22440,62041.44
316230,202312,26,20,6,26401.07,7920,34321.07
316240,202312,738,586,152,774858.46,200644.07,975502.53
316245,202312,185,167,18,220444.8,23760.99,244205.79
316250,202312,1869,1222,647,1613092.55,854043.46,2467136.01
316255,202312,148,115,33,151800.2,43560.46,195360.66
316257,202312,193,97,96,128041.37,126721.46,254762.83
316260,202312,231,151,80,199322.8,105600,304922.8
316265,202312,43,33,10,43561.97,13200.67,56762.64
316270,202312,744,527,217,695651.67,286441.7,982093.37
316280,202312,669,442,227,583451.08,299641.61,883092.69
316290,202312,1035,731,304,964950.32,401284.46,1366234.78
316292,202312,739,320,419,422408.33,553084.9,975493.23
316294,202312,115,73,42,96361.55,55440,151801.55
316295,202312,466,217,249,286448.74,328684.78,615133.52
316300,202312,55,36,19,47520,25080,72600
316310,202312,22,13,9,17160,11880,29040
316320,202312,79,35,44,46200.26,58080,104280.26
316330,202312,199,143,56,188760.79,73920,262680.79
316340,202312,158,107,51,141240,67320,208560
316350,202312,214,149,65,196680.39,85800,282480.39
316360,202312,36,21,15,27720,19800,47520
316370,202312,1518,757,761,1000585.97,1007163.95,2007749.92
316380,202312,138,110,28,145200.77,36960,182160.77
316390,202312,105,78,27,102961.55,35640,138601.55
316400,202312,207,157,50,207246.73,66000.52,273247.25
316410,202312,414,290,124,382801.26,163680.2,546481.46
316420,202312,245,163,82,215167.98,108242.03,323410.01
316430,202312,179,100,79,132000.46,104280,236280.46
316440,202312,85,47,38,62041.2,50160.08,112201.28
316443,202312,46,38,8,50160,10560,60720
316447,202312,60,50,10,66002.17,13200,79202.17
316450,202312,281,210,71,277200.2,93720,370920.2
316460,202312,58,21,37,27720.28,48840.34,76560.62
316470,202312,2033,1506,527,1989298.15,695641.12,2684939.27
316480,202312,9,7,2,9240,2640,11880
316490,202312,24,7,17,9240,22440,31680
316500,202312,193,124,69,163680.27,91080.4,254760.67
316510,202312,149,121,28,159721.72,36960,196681.72
316520,202312,196,103,93,135960.75,122760.61,258721.36
316530,202312,196,128,68,168962.25,89760,258722.25
316540,202312,178,94,84,124082.48,110880.65,234963.13
316550,202312,214,142,72,187442.5,95040,282482.5
316553,202312,586,304,282,401293.16,372241.95,773535.11
316555,202312,94,82,12,108240.92,15840,124080.92
316556,202312,20,14,6,18480.41,7920,26400.41
316557,202312,53,36,17,47521.01,22440,69961.01
316560,202312,77,54,23,71280.2,30360,101640.2
316570,202312,249,231,18,304921.57,23760,328681.57
316580,202312,27,17,10,22440,13200,35640
316590,202312,87,74,13,97680.82,17160.72,114841.54
316600,202312,184,155,29,204601.01,38280,242881.01
316610,202312,72,54,18,71280,23760,95040
316620,202312,173,124,49,163680.2,66000,229680.2
316630,202312,79,60,19,79200,25080,104280
316640,202312,24,14,10,18480,13200,31680
316650,202312,130,104,26,137280,34320,171600
316660,202312,6,2,4,2640,5280,7920
316670,202312,457,154,303,203284.36,399962.46,603246.82
316680,202312,195,149,46,196685.37,60720,257405.37
316690,202312,158,98,60,129360.9,79200,208560.9
316695,202312,64,51,13,67320,17160,84480
316700,202312,37,26,11,34320,14520,48840
316710,202312,902,681,221,898935.89,291723.4,1190659.29
316720,202312,6003,2783,3220,3675005.5,4250413.27,7925418.77
316730,202312,17,16,1,21120,1320,22440
316740,202312,182,113,69,149160.3,91080,240240.3
316750,202312,20,10,10,13201.02,13200,26401.02
316760,202312,388,305,83,402607.31,109560.79,512168.10
316770,202312,200,114,86,150482.38,113520,264002.38
316780,202312,76,45,31,59400,40920,100320
316790,202312,85,61,24,80521,31680.5,112201.5
316800,202312,1948,1174,774,1549720.73,1021700.32,2571421.05
316805,202312,40,27,13,35640.08,17160,52800.08
316810,202312,64,37,27,48841.3,35640.85,84482.15
316820,202312,36,25,11,33000.44,14520,47520.44
316830,202312,115,56,59,73921.19,77880.2,151801.39
316840,202312,548,342,206,451447.28,274562,726009.28
316850,202312,334,239,95,315484.08,125400.93,440885.01
316860,202312,7181,3342,3839,4414322.58,5070144.84,9484467.42
316870,202312,2069,1354,715,1787364.32,943809.68,2731174.00
316880,202312,173,90,83,118803.35,109561.44,228364.79
316890,202312,243,160,83,211201.29,109560.69,320761.98
316900,202312,480,342,138,451448.81,182160,633608.81
316905,202312,28,14,14,18480,18480,36960
316910,202312,101,46,55,60720,72600.6,133320.6
316920,202312,173,133,40,175567.34,52800,228367.34
316930,202312,2307,1192,1115,1573474.6,1471800.81,3045275.41
316935,202312,1094,651,443,861977.39,584768.2,1446745.59
316940,202312,1252,726,526,960987.15,694321.03,1655308.18
316950,202312,232,124,108,163681.09,142560,306241.09
316960,202312,1198,675,523,891031.45,691693.31,1582724.76
316970,202312,728,590,138,778823.71,182163.23,960986.94
316980,202312,94,51,43,67320.82,56760,124080.82
316990,202312,2642,1821,821,2405107.27,1085043.74,3490151.01
317000,202312,371,289,82,381492.21,108242.49,489734.70
317005,202312,248,174,74,229685.46,97680.9,327366.36
317010,202312,8031,4685,3346,6187150.93,4418099.92,10605250.85
317020,202312,17660,7887,9773,10417908.81,12903110.47,23321019.28
317030,202312,110,53,57,69960,75240,145200
317040,202312,3438,2313,1125,3053251.26,1487650.28,4540901.54
317043,202312,85,67,18,88445.91,23761.07,112206.98
317047,202312,49,34,15,44880,19800,64680
317050,202312,181,146,35,194044.03,46200.2,240244.23
317052,202312,177,148,29,195361.82,38280,233641.82
317057,202312,214,166,48,219122.42,64680,283802.42
317060,202312,67,41,26,54120,34320.8,88440.8
317065,202312,57,45,12,59400,15840,75240
317070,202312,2251,1053,1198,1390013.89,1582682.83,2972696.72
317075,202312,115,66,49,87120.15,64680,151800.15
317080,202312,1066,551,515,727354.43,679801.39,1407155.82
317090,202312,794,610,184,805219.12,242884.49,1048103.61
317100,202312,510,379,131,500287.67,172920.95,673208.62
317103,202312,151,121,30,159723.69,39600,199323.69
317107,202312,68,52,16,68640.96,21120,89760.96
317110,202312,87,49,38,64680.61,50161.61,114842.22
317115,202312,66,60,6,79262.04,7920,87182.04
317120,202312,2515,1274,1241,1681752.7,1638132.52,3319885.22
317130,202312,2447,1698,749,2242713.58,988682.47,3231396.05
317140,202312,22,18,4,23761.3,5280,29041.3
317150,202312,324,196,128,258724.33,168960.31,427684.64
317160,202312,389,286,103,378843.36,135960.25,514803.61
317170,202312,267,174,93,229681.32,122760.6,352441.92
317180,202312,458,317,141,418443.88,186121.22,604565.10
317190,202312,236,169,67,223081.44,88440,311521.44
317200,202312,1041,752,289,994015.7,381493.01,1375508.71
317210,202312,199,102,97,134645.65,128040.21,262685.86
317220,202312,26,14,12,18480,15840,34320
320010,202312,625,446,179,588744.45,236289.14,825033.59
320013,202312,169,113,56,149164.37,73923.64,223088.01
320016,202312,298,185,113,244205.9,149160,393365.9
320020,202312,858,522,336,689064.09,444849.25,1133913.34
320030,202312,209,144,65,190083.24,85801.35,275884.59
320035,202312,153,103,50,135960.2,66000.06,201960.26
320040,202312,539,272,267,359051.85,352450.05,711501.90
320050,202312,159,109,50,143888.88,66000.7,209889.58
320060,202312,2233,1066,1167,1407183.01,1541788.18,2948971.19
320070,202312,131,87,44,114840.25,58080,172920.25
320080,202312,952,539,413,711504.12,545169.11,1256673.23
320090,202312,1530,983,547,1297597.92,722054.96,2019652.88
320100,202312,422,239,183,315491.26,242882.8,558374.06
320110,202312,158,104,54,137290.86,71280.2,208571.06
320115,202312,132,113,19,149163.66,25080,174243.66
320120,202312,4568,2481,2087,3276365.54,2754890.16,6031255.70
320130,202312,9835,4291,5544,5666992.05,7328765.45,12995757.50
320140,202312,633,415,218,547822.82,287769.16,835591.98
320150,202312,2565,1442,1123,1906170.39,1482373.51,3388543.90
320160,202312,782,339,443,447490.68,584763.03,1032253.71
320170,202312,130,104,26,137283.26,34320,171603.26
320180,202312,65,38,27,50161.75,35640,85801.75
320190,202312,291,172,119,227046.36,157080.1,384126.46
320200,202312,76,62,14,81843.55,18480,100323.55
320210,202312,1041,569,472,753743.88,624368.77,1378112.65
320220,202312,321,118,203,155762.42,267960.2,423722.62
320225,202312,104,86,18,113521.31,23760.14,137281.45
320230,202312,872,565,307,748483.24,405248.56,1153731.80
320240,202312,4167,1881,2286,2483017.41,3017562.31,5500579.72
320245,202312,613,419,194,553098.09,256088.59,809186.68
320250,202312,271,130,141,171605.9,186123.33,357729.23
320255,202312,146,111,35,146522.01,46200.65,192722.66
320260,202312,354,184,170,242883.02,224402.09,467285.11
320265,202312,161,126,35,166322.58,46200.06,212522.64
320270,202312,168,125,43,165002.27,56761.22,221763.49
320280,202312,1695,1007,688,1329295.06,909499.83,2238794.89
320290,202312,80,62,18,81840.9,23760,105600.9
320300,202312,725,505,220,667944.03,291723.16,959667.19
320305,202312,903,526,377,694346.69,497652.74,1191999.43
320310,202312,238,152,86,200646.76,113520.9,314167.66
320313,202312,437,189,248,249489.41,327363.61,576853.02
320316,202312,117,88,29,116162.2,38280.3,154442.5
320320,202312,4036,1881,2155,2484339.2,2845953.4,5330292.6
320330,202312,355,257,98,339242.93,129360,468602.93
320332,202312,957,592,365,781491.28,481816.6,1263307.88
320334,202312,327,178,149,234962.63,196681.1,431643.73
320335,202312,183,119,64,157086.5,84481.85,241568.35
320340,202312,708,513,195,677193.47,257405.5,934598.97
320350,202312,1251,532,719,702273.17,949095.07,1651368.24
320360,202312,206,96,110,126722.11,145200,271922.11
320370,202312,280,209,71,275886.41,93720.59,369607.00
320380,202312,398,286,112,377530.46,147840.89,525371.35
320390,202312,1340,797,543,1053398.66,716773.12,1770171.78
320400,202312,380,259,121,341898.77,159723.14,501621.91
320405,202312,1132,468,664,617787.91,876493.42,1494281.33
320410,202312,1065,521,544,687740.15,718086.33,1405826.48
320420,202312,724,333,391,439578.32,516130.48,955708.80
320425,202312,244,132,112,174244.28,147840.49,322084.77
320430,202312,485,265,220,349816.2,290409.41,640225.61
320435,202312,234,158,76,208563.38,100322.19,308885.57
320440,202312,249,144,105,190085.82,138605.2,328691.02
320450,202312,156,84,72,110882.33,95040.96,205923.29
320455,202312,277,215,62,283805.14,83161.62,366966.76
320460,202312,398,243,155,320764.24,204601.09,525365.33
320465,202312,144,99,45,130686.48,59400.62,190087.10
320470,202312,898,543,355,716791.11,468612.83,1185403.94
320480,202312,287,194,93,256089.51,122760.02,378849.53
320490,202312,3924,1935,1989,2554308.85,2626860.64,5181169.49
320495,202312,145,88,57,116161.65,75240,191401.65
320500,202312,12853,6420,6433,8476145.14,8494344.2,16970489.34
320501,202312,668,351,317,463340.76,418450.96,881791.72
320503,202312,384,278,106,366967.14,139920.92,506888.06
320506,202312,327,224,103,295684.67,135960.38,431645.05
320510,202312,1548,706,842,931951.32,1111461.69,2043413.01
320515,202312,106,82,24,109562.65,31680.24,141242.89
320517,202312,278,203,75,267967.31,99000.52,366967.83
320520,202312,10008,4332,5676,5722432.89,7496404.8,13218837.69
320530,202312,9028,4344,4684,5736886.08,6188237.59,11925123.67
330010,202312,4446,2148,2298,2838108.67,3033392.2,5871500.87
330015,202312,254,115,139,153125.6,183480.59,336606.19
330020,202312,5323,1942,3381,2566164.12,4469561.28,7035725.40
330022,202312,319,159,160,209886.29,211201.05,421087.34
330023,202312,1102,310,792,410528.91,1046772.54,1457301.45
330025,202312,1221,228,993,300966.08,1310650.19,1611616.27
330030,202312,2273,1396,877,1842804.6,1161618.95,3004423.55
330040,202312,3299,1690,1609,2232213.23,2126554.13,4358767.36
330045,202312,12987,4373,8614,5775237.75,11379888.28,17155126.03
330050,202312,1099,666,433,879147.72,571567.17,1450714.89
330060,202312,1774,939,835,1239543.72,1102210.21,2341753.93
330070,202312,5756,1962,3794,2592569.93,5008136.16,7600706.09
330080,202312,1973,860,1113,1135250.96,1470501.86,2605752.82
330090,202312,459,262,197,345850.72,261361.08,607211.80
330093,202312,265,115,150,151802.6,198001.98,349804.58
330095,202312,88,47,41,62041.8,54120.24,116162.04
330100,202312,13946,7058,6888,9319605.77,9098912.99,18418518.76
330110,202312,578,268,310,353768.06,409205.05,762973.11
330115,202312,606,303,303,399968.41,399962.98,799931.39
330120,202312,503,252,251,333966.64,331322.24,665288.88
330130,202312,1884,556,1328,733952.73,1752996.88,2486949.61
330140,202312,890,457,433,603249.98,572881.67,1176131.65
330150,202312,633,390,243,514816.11,320764.82,835580.93
330160,202312,175,112,63,147847.11,83161.46,231008.57
330170,202312,32811,12042,20769,15901413.89,27437955.37,43339369.26
330180,202312,317,169,148,224404.45,195361.66,419766.11
330185,202312,1549,658,891,868594.94,1176144.88,2044739.82
330187,202312,897,252,645,332651.79,851405.98,1184057.77
330190,202312,7836,3072,4764,4057835.06,6292518.24,10350353.30
330200,202312,5610,2010,3600,2654621.57,4754720.5,7409342.07
330205,202312,580,319,261,421095.32,344526.17,765621.49
330210,202312,1045,619,426,817111.16,562324.66,1379435.82
330220,202312,3382,2002,1380,2644090.13,1821630.01,4465720.14
330225,202312,784,377,407,497650.84,537243.21,1034894.05
330227,202312,2687,1000,1687,1321382.89,2226897.13,3548280.02
330230,202312,263,140,123,184805.9,162361.84,347167.74
330240,202312,5648,2665,2983,3519256.15,3938935.19,7458191.34
330245,202312,216,108,108,142562.6,142561.63,285124.23
330250,202312,8174,3904,4270,5158786.77,5639124.8,10797911.57
330260,202312,1033,317,716,419765.63,945124.92,1364890.55
330270,202312,5152,1680,3472,2221643.99,4585758.07,6807402.06
330280,202312,549,321,228,423739.6,302284.86,726024.46
330285,202312,7564,2521,5043,3330522.71,6658209.61,9988732.32
330290,202312,941,330,611,436936.58,806527.86,1243464.44
330300,202312,895,546,349,721566.24,460690.37,1182256.61
330310,202312,573,338,235,446173.23,310202.96,756376.19
330320,202312,9394,3125,6269,4126525.25,8281796.42,12408321.67
330330,202312,12317,4256,8061,5619443.42,10649892.51,16269335.93
330340,202312,3450,1894,1556,2501471.85,2053944.14,4555415.99
330350,202312,25211,9292,15919,12268646.47,21026639.69,33295286.16
330360,202312,2088,982,1106,1296307.23,1461264.29,2757571.52
330370,202312,1139,610,529,805237.56,699610.55,1504848.11
330380,202312,1318,546,772,720749.24,1019054.52,1739803.76
330385,202312,814,396,418,522733.42,551764.67,1074498.09
330390,202312,7887,4157,3730,5495462.6,4927681.6,10423144.2
330395,202312,544,337,207,444859.12,273244.25,718103.37
330400,202312,809,411,398,542545.02,528004.57,1070549.59
330410,202312,621,448,173,591377.42,229685.78,821063.20
330411,202312,465,257,208,339248.13,274560,613808.13
330412,202312,277,137,140,180847.71,184801.27,365648.98
330414,202312,6908,2658,4250,3510035.23,5614023.93,9124059.16
330415,202312,746,324,422,427693.87,557046.9,984740.77
330420,202312,3515,1529,1986,2020978.85,2621534.57,4642513.42
330430,202312,2094,906,1188,1195954.59,1569498.42,2765453.01
330440,202312,507,255,252,336650.52,332640.63,669291.15
330450,202312,151,75,76,99000.66,100320,199320.66
330452,202312,3188,1269,1919,1676465.22,2533105.63,4209570.85
330455,202312,162160,59572,102588,78668739.83,135508336.98,214177076.81
330460,202312,300,144,156,190082.29,205920.4,396002.69
330470,202312,1510,818,692,1081110.48,913455.26,1994565.74
330475,202312,2290,745,1545,983417.21,2040733.55,3024150.76
330480,202312,937,521,416,687748.93,549125.8,1236874.73
330490,202312,21104,6694,14410,8843105.63,19034614.19,27877719.82
330500,202312,1993,882,1111,1164272.78,1466530.93,2630803.71
330510,202312,13643,5006,8637,6613499.28,11407588.63,18021087.91
330513,202312,117,60,57,79200.16,75240,154440.16
330515,202312,756,345,411,456733.29,542530.9,999264.19
330520,202312,3086,1072,2014,1415096.09,2659837.54,4074933.63
330530,202312,209,119,90,158403.68,118800.1,277203.78
330540,202312,440,228,212,300968.87,279845.97,580814.84
330550,202312,3373,1144,2229,1510115.5,2943625.62,4453741.12
330555,202312,1486,552,934,729976.23,1232883.94,1962860.17
330560,202312,934,348,586,459376.21,773525.74,1232901.95
330570,202312,412,285,127,376206,167640.66,543846.66
330575,202312,1116,427,689,563660.1,909496.91,1473157.01
330580,202312,4195,2236,1959,2951621.51,2589872.68,5541494.19
330590,202312,277,148,129,195365.42,170281.58,365647.00
330600,202312,1825,1071,754,1413773.42,995291.63,2409065.05
330610,202312,1910,983,927,1297600.38,1226289.38,2523889.76
330615,202312,280,218,62,287765.23,81841.97,369607.20
330620,202312,1130,498,632,657390.74,834254.74,1491645.48
330630,202312,5923,3381,2542,4464414.09,3359446.96,7823861.05
350010,202312,651,422,229,559703.32,302284.92,861988.24
350020,202312,64,23,41,30362.06,54120,84482.06
350030,202312,663,380,283,501634.32,373566.22,875200.54
350040,202312,122,53,69,69963.15,91080.3,161043.45
350050,202312,437,199,238,262688.77,314162.82,576851.59
350055,202312,159,68,91,89763.38,120120.21,209883.59
350060,202312,91,42,49,55442.59,64681.01,120123.60
350070,202312,913,506,407,669280.12,537258.33,1206538.45
350075,202312,95,55,40,72602.47,52800.5,125402.97
350080,202312,74,37,37,48840.5,48840.2,97680.7
350090,202312,87,46,41,60721.91,54120,114841.91
350100,202312,316,205,111,270604.11,146520,417124.11
350110,202312,48,32,16,42242.86,21120,63362.86
350115,202312,212,107,105,141242.87,138600.48,279843.35
350120,202312,121,77,44,101642.09,58080.87,159722.96
350130,202312,487,219,268,289097.6,353769.62,642867.22
350140,202312,43,27,16,35640.64,21120,56760.64
350150,202312,85,58,27,76562.24,35640.24,112202.48
350160,202312,2788,1128,1660,1489026.08,2192530.7,3681556.78
350170,202312,493,285,208,377535.44,274563.35,652098.79
350180,202312,180,95,85,125402.51,112200.52,237603.03
350190,202312,1141,629,512,830327.34,675841.32,1506168.66
350200,202312,64,26,38,34321.33,50160,84481.33
350210,202312,1495,785,710,1036246.62,939861.72,1976108.34
350220,202312,687,544,143,718099.99,188762.47,906862.46
350230,202312,81,52,29,68640,38280.9,106920.9
350240,202312,61,40,21,52800.65,27721.25,80521.90
350250,202312,1221,528,693,696990.48,914774.02,1611764.50
350260,202312,121,84,37,110885.21,48840.87,159726.08
350270,202312,1087,709,378,938528.78,498962.9,1437491.68
350275,202312,403,158,245,208561.59,323404.45,531966.04
350280,202312,4965,2340,2625,3092912.28,3466343.81,6559256.09
350290,202312,573,245,328,323405.87,434283.41,757689.28
350300,202312,57,34,23,44883,30360.9,75243.9
350310,202312,93,54,39,71280.82,51480.59,122761.41
350315,202312,22,15,7,19800,9240,29040
350320,202312,3868,1833,2035,2421007.82,2690185.55,5111193.37
350330,202312,1856,910,946,1202567.62,1251363.83,2453931.45
350335,202312,27,18,9,23760.68,11880,35640.68
350340,202312,137,55,82,72602.01,108243.67,180845.68
350350,202312,100,47,53,62040,69960,132000
350360,202312,124,83,41,109564.1,54120.54,163684.64
350370,202312,93,54,39,71282.7,51480.73,122763.43
350380,202312,1038,477,561,630983.46,741847.58,1372831.04
350390,202312,2126,817,1309,1078470.95,1729220.54,2807691.49
350395,202312,22,16,6,21120,7920.09,29040.09
350400,202312,2020,952,1068,1256693.95,1409761.86,2666455.81
350410,202312,3688,1442,2246,1906144.06,2964748.59,4870892.65
350420,202312,331,189,142,249484.82,187441.28,436926.10
350430,202312,113,58,55,76565.2,72602.7,149167.9
350440,202312,154,108,46,142569.12,60721.05,203290.17
350450,202312,1990,1079,911,1424340.59,1202522.3,2626862.89
350460,202312,494,177,317,233652.97,418448.77,652101.74
350470,202312,22,12,10,15840,13200,29040
350480,202312,229,119,110,157088.95,145200.9,302289.85
350490,202312,269,126,143,166322.74,188760.76,355083.50
350500,202312,69,23,46,30360,60720,91080
350510,202312,161,91,70,120123.26,92400.37,212523.63
350520,202312,522,288,234,380188.57,308891.15,689079.72
350530,202312,585,286,299,377533.09,396012.83,773545.92
350535,202312,111,73,38,96360.4,50160.36,146520.76
350540,202312,357,189,168,249485.42,221767.16,471252.58
350550,202312,3230,1803,1427,2382718.33,1887605.73,4270324.06
350560,202312,664,451,213,596664.8,281165.07,877829.87
350570,202312,5348,2233,3115,2948991.93,4117112.82,7066104.75
350580,202312,420,203,217,267969.92,286444.64,554414.56
350590,202312,1167,611,556,806548.42,735385.93,1541934.35
350600,202312,7482,3386,4096,4471080.08,5410725.64,9881805.72
350610,202312,1719,917,802,1211806.85,1063928.92,2275735.77
350620,202312,24,15,9,19800,11880,31680
350630,202312,288,146,142,192722.33,187442.28,380164.61
350635,202312,1661,745,916,983437.43,1209138.13,2192575.56
350640,202312,139,94,45,124082.25,59401.54,183483.79
350650,202312,2223,1459,764,1927300.83,1009804.87,2937105.70
350660,202312,893,349,544,462009.64,718090.59,1180100.23
350670,202312,325,167,158,220443.21,208560.96,429004.17
350680,202312,176,94,82,124086.05,108240.19,232326.24
350690,202312,242,112,130,147842.41,171600,319442.41
350700,202312,1175,588,587,776191.65,776168.61,1552360.26
350710,202312,495,178,317,234969.11,418444.52,653413.63
350715,202312,68,51,17,67321.35,22440,89761.35
350720,202312,16,11,5,14521.66,6600,21121.66
350730,202312,58,38,20,50162.55,26400,76562.55
350740,202312,276,155,121,204605.79,159721.47,364327.26
350745,202312,40,21,19,27720.63,25081.65,52802.28
350750,202312,3062,1798,1264,2373454.49,1669815.6,4043270.09
350760,202312,4627,1936,2691,2555612.57,3556107.46,6111720.03
350770,202312,65,39,26,51480.5,34320,85800.5
350775,202312,87,61,26,80527.78,34321.33,114849.11
350780,202312,539,266,273,351136.06,360365.25,711501.31
350790,202312,408,171,237,225725.74,312843.45,538569.19
350800,202312,615,364,251,480487.24,331321.59,811808.83
350810,202312,570,423,147,558386.14,194040.46,752426.60
350820,202312,104,59,45,77882.08,59400,137282.08
350830,202312,90,45,45,59400.67,59400,118800.67
350840,202312,964,386,578,509535.94,763086.65,1272622.59
350850,202312,2170,1110,1060,1466572.95,1399209.62,2865782.57
350860,202312,823,418,405,553104.97,535935.2,1089040.17
350870,202312,514,354,160,467291.87,211200.14,678492.01
350880,202312,321,170,151,224407.09,199322.06,423729.15
350890,202312,44,25,19,33000,25081.14,58081.14
350900,202312,1887,645,1242,852743.78,1639466.86,2492210.64
350910,202312,31,17,14,22440.3,18480.42,40920.72
350920,202312,967,483,484,637572.81,638880.3,1276453.11
350925,202312,1340,656,684,865966.57,904216.93,1770183.50
350930,202312,150,80,70,105604.54,92400.28,198004.82
350940,202312,850,436,414,575545.59,546497.08,1122042.67
350945,202312,142,96,46,126724.02,60720.12,187444.14
350950,202312,21792,10352,11440,13671670.27,15112784.74,28784455.01
350960,202312,2128,869,1259,1147110.17,1661901.37,2809011.54
350970,202312,1245,588,657,776053.84,868574.24,1644628.08
350980,202312,116,76,40,100322.96,52800,153122.96
350990,202312,458,173,285,228361.1,376201.83,604562.93
350995,202312,48,22,26,29040.79,34320.84,63361.63
351000,202312,671,417,254,551784.33,335290.13,887074.46
351010,202312,52,32,20,42242.78,26400,68642.78
351015,202312,61,34,27,44880.17,35640,80520.17
351020,202312,1649,995,654,1313443.67,863287.64,2176731.31
351030,202312,381,211,170,278524.79,224400.32,502925.11
351040,202312,1297,740,557,976831.52,736563.13,1713394.65
351050,202312,4421,1974,2447,2605820.73,3230074.79,5835895.52
351060,202312,7407,2738,4669,3614317.29,6165754.67,9780071.96
351070,202312,459,287,172,378855.77,227047.55,605903.32
351080,202312,956,724,232,955721.15,306243.33,1261964.48
351090,202312,53,26,27,34320.66,35640.41,69961.07
351100,202312,459,241,218,318145.22,290412.29,608557.51
351110,202312,2422,1121,1301,1479781.75,1717324.72,3197106.47
351120,202312,69,33,36,43561.46,47520,91081.46
351130,202312,204,66,138,87123.69,182163.34,269287.03
351140,202312,355,212,143,279848.61,188763.27,468611.88
351150,202312,575,289,286,381491.75,377521.63,759013.38
351160,202312,393,210,183,277207.42,241561.08,518768.50
351170,202312,281,168,113,221763.56,149160.05,370923.61
351190,202312,113,72,41,95041.06,54120,149161.06
351200,202312,379,245,134,323410,176881.4,500291.4
351210,202312,149,75,74,99004.05,97681.52,196685.57
351220,202312,677,375,302,495018.17,398640.7,893658.87
351230,202312,373,228,145,300966.86,192720.93,493687.79
351240,202312,279,147,132,194042.79,174242.37,368285.16
351250,202312,104,74,30,97692.01,39600.1,137292.11
351260,202312,170,116,54,153123.02,71280.5,224403.52
351270,202312,58,26,32,34321.51,42240,76561.51
351280,202312,1204,604,600,797308.78,793331.05,1590639.83
351290,202312,288,142,146,187442.16,192720.77,380162.93
351300,202312,4965,2069,2896,2731171.38,3825410.19,6556581.57
351310,202312,812,397,415,525390.99,547812.43,1073203.42
351320,202312,138,79,59,104281.52,77880.6,182162.12
351330,202312,41,27,14,35640,18480,54120
351340,202312,1779,952,827,1258002.66,1091646.65,2349649.31
351350,202312,2884,1729,1155,2283728.52,1527248.22,3810976.74
351360,202312,908,418,490,551769.17,646806.08,1198575.25
351370,202312,510,258,252,340572.33,333960.63,674532.96
351380,202312,9955,4411,5544,5825350.76,7323394.12,13148744.88
351385,202312,26,20,6,26401.79,7920,34321.79
351390,202312,316,231,85,304927.81,112200.39,417128.20
351400,202312,64,42,22,55440.83,29040,84480.83
351410,202312,541,312,229,411855.49,302283.56,714139.05
351420,202312,89,63,26,83161.57,34320,117481.57
351430,202312,81,45,36,59401.65,47520.2,106921.85
351440,202312,957,624,333,823717.13,439566.15,1263283.28
351450,202312,328,164,164,216483.45,216483.79,432967.24
351460,202312,149,62,87,81845.19,114841.21,196686.40
351470,202312,152,79,73,104284.25,96360.89,200645.14
351480,202312,500,288,212,380164.25,279840.2,660004.45
351490,202312,352,137,215,180844.18,283800.72,464644.90
351492,202312,29,19,10,25081.43,13200,38281.43
351495,202312,29,21,8,27720.65,10560,38280.65
351500,202312,3851,1526,2325,2014367.27,3070341.27,5084708.54
351510,202312,2541,906,1635,1195960.26,2160856.5,3356816.76
351512,202312,19,10,9,13200,11880,25080
351515,202312,239,140,99,184804.64,130680.53,315485.17
351518,202312,742,429,313,566316.04,413181.78,979497.82
351519,202312,87,51,36,67321.79,47520,114841.79
351520,202312,194,121,73,159724.06,96360.31,256084.37
351530,202312,32,17,15,22440.9,19800,42240.9
351535,202312,152,92,60,122768.39,79201.32,201969.71
351540,202312,547,338,209,446175,275884.68,722059.68
351550,202312,1900,1105,795,1458660.53,1050726.28,2509386.81
351560,202312,90,48,42,63361.45,55440,118801.45
351565,202312,15,8,7,10560.43,9240,19800.43
351570,202312,3386,1514,1872,1998556.31,2471068.3,4469624.61
351580,202312,36,32,4,42240.8,5280,47520.8
351590,202312,70,40,30,52802.13,39601.76,92403.89
351600,202312,189,135,54,178207.07,71280.76,249487.83
351610,202312,66,29,37,38281.05,48840,87121.05
351620,202312,7109,3795,3314,5009634.73,4378477.57,9388112.30
351630,202312,3973,1874,2099,2473762.14,2774666.98,5248429.12
351640,202312,3176,1408,1768,1858619.07,2333774.73,4192393.80
351650,202312,41,30,11,39601.12,14520,54121.12
351660,202312,150,91,59,120120.35,77880,198000.35
351670,202312,855,479,376,632304.82,496328.62,1128633.44
351680,202312,103,71,32,93721.13,42240,135961.13
351685,202312,22,14,8,18480.13,10560,29040.13
351690,202312,337,215,122,283810.66,161042.43,444853.09
351700,202312,192,134,58,177176.5,76560.51,253737.01
351710,202312,60,39,21,51482.27,27720,79202.27
351720,202312,132,74,58,97681.68,76560,174241.68
351730,202312,139,95,44,125401.48,58080,183481.48
351740,202312,901,564,337,744523.27,446167.59,1190690.86
351750,202312,425,177,248,233645.66,327363.4,561009.06
351760,202312,756,585,171,773433.25,225720.76,999154.01
351770,202312,358,281,77,370941.37,101640.56,472581.93
351780,202312,162,96,66,126720.2,87120,213840.2
351790,202312,300,144,156,190088.96,205923.24,396012.20
351800,202312,52,33,19,43560.16,25080,68640.16
351810,202312,132,83,49,109567.61,64683.03,174250.64
351820,202312,814,579,235,764330.01,310207.31,1074537.32
351830,202312,796,249,547,328690.17,722047.32,1050737.49
351840,202312,2702,1196,1506,1578777.27,1987923.69,3566700.96
351850,202312,292,195,97,258730.94,128040,386770.94
351860,202312,661,445,216,587430.69,285122.54,872553.23
351870,202312,6937,3089,3848,4080311.67,5082111.56,9162423.23
351880,202312,27590,10712,16878,14144229.85,22294955.48,36439185.33
351885,202312,124,69,55,91081.91,72600.3,163682.21
351890,202312,84,55,29,72601.38,38280,110881.38
351900,202312,269,139,130,183490.03,171600.68,355090.71
351905,202312,121,58,63,76561.61,83160.24,159721.85
351907,202312,4416,1822,2594,2406454.44,3428073.12,5834527.56
351910,202312,176,78,98,102967.16,129361.08,232328.24
351920,202312,131,70,61,92400.46,80520,172920.46
351925,202312,101,60,41,79203.32,54120.15,133323.47
351930,202312,561,341,220,451468.3,290408.55,741876.85
351940,202312,270,109,161,143883.03,212522.05,356405.08
351950,202312,160,84,76,110882.12,100323.26,211205.38
351960,202312,1141,566,575,747154.49,759020.73,1506175.22
351970,202312,2527,1176,1351,1552346.85,1783339.03,3335685.88
351980,202312,169,74,95,97683.51,125402.89,223086.40
351990,202312,265,164,101,216483.66,134641.9,351125.56
352000,202312,300,203,97,267980.11,128045.24,396025.35
352010,202312,509,329,180,434393.25,238933.23,673326.48
352020,202312,235,74,161,97680,212520,310200
352030,202312,1375,624,751,823704,991329.53,1815033.53
352040,202312,826,329,497,434287.08,656048.22,1090335.30
352042,202312,414,102,312,134645.64,411843.13,546488.77
352044,202312,410,213,197,281175.83,260049.6,541225.43
352050,202312,3810,1393,2417,1838826.53,3190458.57,5029285.10
352060,202312,118,65,53,85801.81,69960.89,155762.70
352070,202312,116,73,43,96366.3,56760,153126.3
352080,202312,72,44,28,58083.35,36960.48,95043.83
352090,202312,213,128,85,168963.76,112202.45,281166.21
352100,202312,380,192,188,253446.77,248161.73,501608.50
352110,202312,120,35,85,46200,112200,158400
352115,202312,78,33,45,43560.98,59400.2,102961.18
352120,202312,79,53,26,69960,34320,104280
352130,202312,261,190,71,250816.37,93720.57,344536.94
352140,202312,226,121,105,159723.12,138603.09,298326.21
352150,202312,141,78,63,102961.35,83161.8,186123.15
352160,202312,149,101,48,133324.85,63360.54,196685.39
352170,202312,503,333,170,439565.92,224400,663965.92
352180,202312,807,476,331,628347.88,436927.08,1065274.96
352190,202312,270,112,158,147852.09,209882.62,357734.71
352200,202312,31,15,16,19801.84,21120,40921.84
352210,202312,5354,2079,3275,2744413.4,4323026.35,7067439.75
352215,202312,83,42,41,55440.2,54120,109560.2
352220,202312,6803,2527,4276,3337087.05,5645699.54,8982786.59
352230,202312,4224,2619,1605,3457256.69,2118611.24,5575867.93
352240,202312,3218,1788,1430,2360250.27,1887618.24,4247868.51
352250,202312,4577,2054,2523,2712705.07,3330366.65,6043071.72
352260,202312,1184,615,569,813149.69,751098.07,1564247.76
352265,202312,80,48,32,63360,42240,105600
352270,202312,454,242,212,319467.53,279847.04,599314.57
352280,202312,570,338,232,446174.66,306241.03,752415.69
352290,202312,202,111,91,146528.06,120122.77,266650.83
352300,202312,105,61,44,80523.49,58082.27,138605.76
352310,202312,9566,4254,5312,5615536.37,7013185.64,12628722.01
352320,202312,1326,692,634,913460.35,838207.4,1751667.75
352330,202312,585,308,277,406564.74,365640.34,772205.08
352340,202312,1597,724,873,955719.26,1155006.46,2110725.72
352350,202312,428,241,187,318127.93,246843.32,564971.25
352360,202312,245,108,137,142564.31,180841.65,323405.96
352370,202312,141,89,52,117484.75,68641.74,186126.49
352380,202312,133,98,35,129363.03,46201.58,175564.61
352390,202312,2949,1229,1720,1622340.72,2271731.3,3894072.02
352400,202312,646,280,366,369605.09,483122.73,852727.82
352410,202312,1077,716,361,945170.59,476535.01,1421705.60
352420,202312,112,86,26,113521.94,34320,147841.94
352430,202312,1908,834,1074,1100937.61,1419031.79,2519969.40
352440,202312,4155,1799,2356,2376092.48,3109935.45,5486027.93
352450,202312,198,151,47,199323.97,62041.27,261365.24
352460,202312,717,360,357,475207.32,471244.05,946451.37
352470,202312,782,316,466,417139.74,615124.93,1032264.67
352480,202312,1890,1075,815,1419051.82,1075818.49,2494870.31
352490,202312,76,32,44,42240.2,58080.36,100320.56
352500,202312,1810,716,1094,945141.33,1446730.54,2391871.87
352510,202312,835,436,399,575548.8,526685.54,1102234.34
352520,202312,1036,457,579,603255.35,764292.63,1367547.98
352530,202312,2252,1138,1114,1502230.06,1471807.16,2974037.22
352540,202312,74,50,24,66003.63,31680.14,97683.77
352550,202312,253,138,115,182162.22,151800,333962.22
352560,202312,62,44,18,58080.87,23760,81840.87
352570,202312,899,433,466,571596.78,615132.61,1186729.39
352580,202312,56,43,13,56763.05,17160,73923.05
352585,202312,18,7,11,9240,14520,23760
352590,202312,5231,2547,2684,3362179.1,3545544.54,6907723.64
352600,202312,420,282,138,372255.93,182166.74,554422.67
352610,202312,1000,424,576,559695.88,761645.11,1321340.99
352620,202312,1305,496,809,654733.31,1067894.96,1722628.27
352630,202312,199,75,124,99000,163680.08,262680.08
352640,202312,585,375,210,495028.32,277204.11,772232.43
352650,202312,97,64,33,84482.61,43560,128042.61
352660,202312,80,41,39,54121.72,51480,105601.72
352670,202312,1995,1075,920,1419082.33,1214400.92,2633483.25
352680,202312,1113,650,463,858035.03,611182.78,1469217.81
352690,202312,5409,2403,3006,3172099.46,3971912.55,7144012.01
352700,202312,106,58,48,76564.5,63361.4,139925.9
352710,202312,1709,892,817,1177494.01,1082402.39,2259896.40
352720,202312,1911,806,1105,1065283.82,1458625.78,2523909.60
352725,202312,32,24,8,31681.29,10560,42241.29
352730,202312,474,229,245,302289.25,323403.71,625692.96
352740,202312,406,259,147,343220.1,194042.67,537262.77
352750,202312,28,16,12,21121.5,15840,36961.5
352760,202312,270,171,99,227046.31,130681.82,357728.13
352770,202312,84,62,22,81841.04,29040,110881.04
352780,202312,84,47,37,62040.42,48840.78,110881.20
352790,202312,28,18,10,23762.09,13200.18,36962.27
352800,202312,270,206,64,271929.2,84480.86,356410.06
352810,202312,169,109,60,143884.43,79201.88,223086.31
352820,202312,48,38,10,50161.09,13200,63361.09
352830,202312,79,50,29,66002.64,39600.01,105602.65
352840,202312,841,367,474,484465.06,627007.72,1111472.78
352850,202312,2214,672,1542,887056.74,2035449.88,2922506.62
352860,202312,137,84,53,110883.13,69960,180843.13
352870,202312,60,38,22,50165.48,29040.5,79205.98
352880,202312,210,111,99,146525.74,132001.15,278526.89
352885,202312,37,25,12,33000.07,15840,48840.07
352890,202312,62,39,23,51481.24,30360.21,81841.45
352900,202312,5212,2435,2777,3215661.93,3670936.65,6886598.58
352910,202312,42,33,9,43560.88,11880,55440.88
352920,202312,703,400,303,528021.82,399966.31,927988.13
352930,202312,1327,609,718,803915.57,947762.83,1751678.40
352940,202312,7446,2849,4597,3760781.08,6076019.19,9836800.27
352950,202312,145,73,72,96362.33,95042.6,191404.93
352960,202312,79,54,25,71280.93,33000,104280.93
352965,202312,20,13,7,17160.3,9240,26400.3
352970,202312,612,434,178,572902.64,234966.03,807868.67
352980,202312,177,103,74,135972.16,97681.84,233654.00
352990,202312,1057,490,567,646825.28,748452.37,1395277.65
353000,202312,66,34,32,44881.04,42240.01,87121.05
353010,202312,571,340,231,448819.15,304922.58,753741.73
353020,202312,386,254,132,335288.93,174242.04,509530.97
353030,202312,1541,695,846,917441.07,1119378.97,2036820.04
353040,202312,109,54,55,71281.64,72601.79,143883.43
353050,202312,1540,1020,520,1346477.96,686402.93,2032880.89
353060,202312,10692,4693,5999,6196367.45,7922706.45,14119073.90
353070,202312,2382,1386,996,1830923.67,1314486.97,3145410.64
353080,202312,1479,786,693,1037569.52,916082.36,1953651.88
353090,202312,26,23,3,30363.23,3960,34323.23
353100,202312,48,37,11,48842.14,14521.66,63363.80
353110,202312,2689,921,1768,1217105.51,2333836.03,3550941.54
353120,202312,165,95,70,125400,92400.69,217800.69
353130,202312,958,459,499,605907.45,660007.61,1265915.06
353140,202312,647,301,346,397342.24,458044.89,855387.13
353150,202312,360,182,178,240249.87,234964.02,475213.89
353160,202312,119,86,33,113527.62,43560,157087.62
353170,202312,223,82,141,108241.84,186120.51,294362.35
353180,202312,1526,709,817,937223.7,1079773.93,2016997.63
353190,202312,579,412,167,543867.92,220442.38,764310.30
353200,202312,341,168,173,221762.5,228361.39,450123.89
353205,202312,27,18,9,23760.9,11880,35640.9
353210,202312,80,46,34,62041.8,44880.33,106922.13
353215,202312,49,29,20,38280.2,26400,64680.2
353220,202312,91,51,40,67321.46,52801.37,120122.83
353230,202312,176,81,95,106922.12,126720,233642.12
353240,202312,472,201,271,265321.95,357720.12,623042.07
353250,202312,201,103,98,135963.66,129361.08,265324.74
353260,202312,516,323,193,426375.34,256084.64,682459.98
353270,202312,77,59,18,77883.91,23760,101643.91
353280,202312,132,57,75,75245.79,99004.66,174250.45
353282,202312,154,103,51,135961.61,67320,203281.61
353284,202312,35,29,6,38282.16,7920,46202.16
353286,202312,11,4,7,5280.2,9240,14520.2
353290,202312,89,50,39,66001.21,51480,117481.21
353300,202312,482,237,245,312858.96,323409.06,636268.02
353310,202312,45,34,11,44881.21,14520.95,59402.16
353320,202312,51,26,25,34321.11,33000.2,67321.31
353325,202312,51,25,26,33003.33,34320,67323.33
353330,202312,63,42,21,55440.1,27720.05,83160.15
353340,202312,828,329,499,434296.76,660004.11,1094300.87
353350,202312,1064,543,521,716791.73,690378.88,1407170.61
353360,202312,111,88,23,116162.33,30360.01,146522.34
353370,202312,117,67,50,88443.06,66000.56,154443.62
353380,202312,30,15,15,19801.04,19800,39601.04
353390,202312,1283,620,663,818439.78,876497.21,1694936.99
353400,202312,68,41,27,54122.28,35641.54,89763.82
353410,202312,139,72,67,95045.02,88441.27,183486.29
353420,202312,73,36,37,47520,48840,96360
353430,202312,629,414,215,546513.04,283809.02,830322.06
353440,202312,15640,6928,8712,9146535.3,11505173.38,20651708.68
353450,202312,51,25,26,33000.8,34320,67320.8
353460,202312,754,397,357,524063.26,471247.4,995310.66
353470,202312,2585,1228,1357,1621039.27,1791248.54,3412287.81
353475,202312,319,199,120,262685.75,158401.11,421086.86
353480,202312,257,188,69,249485.6,91080,340565.6
353490,202312,241,141,100,186126.54,133320.22,319446.76
353500,202312,240,131,109,172923.85,143881.02,316804.87
353510,202312,90,57,33,75241.82,43560.14,118801.96
353520,202312,286,206,80,271922.43,105600,377522.43
353530,202312,555,274,281,361694.47,370925.9,732620.37
353540,202312,433,271,162,357742.32,213844.34,571586.66
353550,202312,844,516,328,682488.53,432971.95,1115460.48
353560,202312,600,244,356,322083.67,469921.66,792005.33
353570,202312,68,47,21,62042.31,27720.2,89762.51
353580,202312,423,255,168,336606.14,221760.28,558366.42
353590,202312,107,78,29,102963.05,38280,141243.05
353600,202312,314,182,132,241568.43,174240.19,415808.62
353610,202312,160,94,66,124081.9,87120,211201.9
353620,202312,732,360,372,475212.55,491048.02,966260.57
353625,202312,72,38,34,50161.27,44880.62,95041.89
353630,202312,256,175,81,231009.24,106920.78,337930.02
353640,202312,159,96,63,126725.56,83160.26,209885.82
353650,202312,1258,506,752,667938.19,992649.58,1660587.77
353657,202312,29,23,6,30360,7920,38280
353660,202312,331,171,160,225724.2,211204.04,436928.24
353670,202312,828,459,369,605906.75,487090.77,1092997.52
353680,202312,154,95,59,125400.58,79200,204600.58
353690,202312,51,34,17,44880.92,22440.19,67321.11
353700,202312,342,236,106,311528.21,139921.58,451449.79
353710,202312,683,341,342,450146.47,451445.5,901591.97
353715,202312,49,26,23,34320,30360,64680
353720,202312,345,162,183,213848.54,241565.68,455414.22
353730,202312,1325,761,564,1005891.27,745801.88,1751693.15
353740,202312,658,354,304,467297.7,401288.3,868586.0
353750,202312,116,62,54,81840.5,71280,153120.5
353760,202312,3848,1523,2325,2011771.27,3069039.75,5080811.02
353770,202312,86,66,20,87120.7,26400.2,113520.9
353780,202312,1607,731,876,964944.49,1156329.32,2121273.81
353790,202312,595,336,259,443539.51,343207.77,786747.28
353800,202312,4532,2066,2466,2727259.12,3259092.57,5986351.69
353810,202312,256,127,129,168971.16,171600.45,340571.61
353820,202312,335,140,195,184804.75,257401.01,442205.76
353830,202312,85,70,15,92402.47,19800.29,112202.76
353850,202312,239,104,135,137285.5,178201.15,315486.65
353860,202312,618,286,332,377529.82,439564.78,817094.60
353870,202312,6882,3554,3328,4691439.37,4399591.77,9091031.14
353880,202312,819,530,289,699633.58,381482.55,1081116.13
353890,202312,675,385,290,508223.27,382804.5,891027.77
353900,202312,149,77,72,101643.54,95042.21,196685.75
353910,202312,233,100,133,132002.52,175561.75,307564.27
353920,202312,545,272,273,359051.21,360363.5,719414.71
353930,202312,1236,719,517,950445.43,682443.8,1632889.23
353940,202312,226,109,117,145202.04,155761.8,300963.84
353950,202312,583,387,196,510863.79,258725.17,769588.96
353960,202312,83,67,16,88442.99,21120,109562.99
353970,202312,39,23,16,30360.58,21122.47,51483.05
353980,202312,2474,1079,1395,1424329.74,1842747.91,3267077.65
353990,202312,93,59,34,77884.82,44880.61,122765.43
354000,202312,438,189,249,249488.7,328682.31,578171.01
354010,202312,92,52,40,68642.78,52800,121442.78
354020,202312,595,362,233,477858.08,307567.46,785425.54
354025,202312,49,42,7,55445.13,9240,64685.13
354030,202312,50,25,25,33003.01,33000.15,66003.16
354040,202312,100,76,24,100324.38,31680,132004.38
354050,202312,169,88,81,116163.11,106922,223085.11
354060,202312,967,462,505,611176.43,666602.48,1277778.91
354070,202312,1030,584,446,772231.6,588725.56,1360957.16
354075,202312,249,117,132,154442.57,174242.17,328684.74
354080,202312,336,153,183,201966.74,241561.52,443528.26
354085,202312,30,17,13,22441.1,17160,39601.1
354090,202312,308,176,132,232213.07,174242.31,406455.38
354100,202312,7417,3030,4387,4005049.43,5792242.47,9797291.90
354105,202312,113,63,50,83162.58,66000,149162.58
354110,202312,51,25,26,33000.2,34320.2,67320.4
354120,202312,185,107,78,141244.77,102960.31,244205.08
354130,202312,943,593,350,782793.24,462003.15,1244796.39
354140,202312,3957,1829,2128,2414398.55,2811622.21,5226020.76
354150,202312,772,451,321,595355.95,423724.39,1019080.34
354160,202312,751,450,301,594032.62,397327.87,991360.49
354165,202312,12,7,5,9240,6600,15840
354170,202312,206,134,72,176885.78,95040.69,271926.47
354180,202312,55,35,20,46200.99,26400.36,72601.35
354190,202312,315,112,203,147842.13,267961.54,415803.67
354200,202312,127,64,63,84482.51,83162.76,167645.27
354210,202312,84,41,43,54120,56760,110880
354220,202312,679,410,269,541223.32,355086.21,896309.53
354230,202312,194,90,104,118803.01,137280.57,256083.58
354240,202312,377,226,151,298335.58,199320.93,497656.51
354250,202312,80,45,35,59400.5,46200,105600.5
354260,202312,2417,1106,1311,1459964.14,1734504.3,3194468.44
354270,202312,111,81,30,106922.6,39600,146522.6
354280,202312,66,39,27,51480.79,35640,87120.79
354290,202312,172,112,60,147846.01,79200,227046.01
354300,202312,353,254,99,335288.69,130680.73,465969.42
354310,202312,108,74,34,97684.44,44881.5,142565.94
354320,202312,247,120,127,158401.7,167640,326041.7
354323,202312,14,10,4,13200,5280,18480
354325,202312,140,80,60,105602.09,79201.09,184803.18
354330,202312,2732,941,1791,1243494.14,2364127.19,3607621.33
354340,202312,12458,5614,6844,7413167.85,9042068.41,16455236.26
354350,202312,185,122,63,161041.26,83160,244201.26
354360,202312,77,48,29,63362.11,38280.69,101642.80
354370,202312,269,131,138,172923.46,182162.23,355085.69
354380,202312,199,114,85,150485.37,113520.98,264006.35
354390,202312,3273,1216,2057,1605174.75,2716588.52,4321763.27
354400,202312,435,243,192,320767.03,253440.79,574207.82
354410,202312,822,362,460,477861.87,607213.29,1085075.16
354420,202312,317,212,105,279849.59,138604.11,418453.70
354425,202312,382,213,169,281227.48,223081.7,504309.18
354430,202312,150,92,58,121446.2,76561.09,198007.29
354440,202312,32,24,8,31681.1,10560,42241.1
354450,202312,58,40,18,52801.08,23760,76561.08
354460,202312,100,55,45,72604.94,59401.2,132006.14
354470,202312,16,9,7,11880.63,9240.76,21121.39
354480,202312,131,70,61,92400.54,80520.69,172921.23
354490,202312,131,77,54,101646.17,71282.54,172928.71
354500,202312,455,196,259,258723.43,341881.11,600604.54
354510,202312,90,62,28,81843.46,36960.25,118803.71
354515,202312,55,18,37,23761.91,48840.1,72602.01
354520,202312,1887,795,1092,1049255.95,1441441.43,2490697.38
354530,202312,992,473,519,624374.08,685082.7,1309456.78
354540,202312,265,130,135,171606.19,178201.29,349807.48
354550,202312,45,27,18,35640.87,23760,59400.87
354560,202312,185,103,82,135963.09,108240,244203.09
354570,202312,159,104,55,137281.71,72600,209881.71
354580,202312,2180,1036,1144,1367570.51,1510087.05,2877657.56
354600,202312,329,148,181,195366.84,238920.5,434287.34
354610,202312,70,56,14,73922.17,18481.6,92403.77
354620,202312,95,34,61,44880.4,80520.77,125401.17
354625,202312,23,15,8,19802.7,10560.42,30363.12
354630,202312,416,284,132,374902.07,174244.59,549146.66
354640,202312,954,553,401,730228.27,530646.49,1260874.76
354650,202312,72,44,28,58081.12,36960,95041.12
354660,202312,956,690,266,910850.46,352445.43,1263295.89
354670,202312,254,99,155,130681.07,205920.4,336601.47
354680,202312,1591,570,1021,752420.78,1347729.58,2100150.36
354690,202312,85,52,33,68643,43560,112203
354700,202312,86,61,25,80520.04,33000,113520.04
354710,202312,53,36,17,47520.3,22440,69960.3
354720,202312,23,20,3,26400.1,3960,30360.1
354730,202312,2210,908,1302,1198594,1718656.7,2917250.7
354740,202312,77,55,22,72601.22,29040,101641.22
354750,202312,456,251,205,331330.64,270602.42,601933.06
354760,202312,608,388,220,512196.21,291726.29,803922.50
354765,202312,8,3,5,3960,6600,10560
354770,202312,408,257,151,339254.15,199322.44,538576.59
354780,202312,10166,3730,6436,4925062.92,8499525.22,13424588.14
354790,202312,101,56,45,73920.61,59400.2,133320.81
354800,202312,498,266,232,351197.23,306246.47,657443.70
354805,202312,85,44,41,58080.77,54120.27,112201.04
354810,202312,107,55,52,72601.23,68640,141241.23
354820,202312,242,100,142,132002.41,187444.88,319447.29
354830,202312,55,34,21,44880,27720,72600
354840,202312,60,37,23,48840.37,30360,79200.37
354850,202312,6363,2618,3745,3455923.46,4947418.48,8403341.94
354860,202312,395,172,223,227041.35,294361.57,521402.92
354870,202312,14957,6533,8424,8626477.55,11126349.67,19752827.22
354880,202312,3148,1189,1959,1570856.29,2585961.83,4156818.12
354890,202312,3721,2007,1714,2649397.68,2262500.17,4911897.85
354900,202312,66,46,20,60720.83,26400.19,87121.02
354910,202312,1509,764,745,1008522.92,984721.63,1993244.55
354920,202312,40,36,4,47520.64,5280,52800.64
354925,202312,27,19,8,25080.37,10560,35640.37
354930,202312,42,33,9,43561.98,11880,55441.98
354940,202312,872,609,263,803918.49,348487.58,1152406.07
354950,202312,218,133,85,176884.44,112201.73,289086.17
354960,202312,132,46,86,60721.58,113520.89,174242.47
354970,202312,1437,1035,402,1366263.27,530642.1,1896905.37
354980,202312,11259,4189,7070,5535000.08,9344364.35,14879364.43
354990,202312,12747,5687,7060,7511042.92,9320578.46,16831621.38
354995,202312,694,238,456,315482.87,601929.01,917411.88
355000,202312,470,164,306,216483.57,403920.7,620404.27
355010,202312,804,507,297,669286.08,392048.9,1061334.98
355020,202312,925,561,364,740546.54,480487.26,1221033.80
355030,202312,258664,96597,162067,127571895.16,214021950.31,341593845.47
355040,202312,1256,632,624,835586.67,826331.01,1661917.68
355050,202312,184,102,82,134642.49,108240,242882.49
355060,202312,2207,1030,1177,1361004.46,1553646.21,2914650.67
355070,202312,1989,851,1138,1123353.03,1502177.48,2625530.51
355080,202312,225,132,93,174245.33,122761.59,297006.92
355090,202312,352,216,136,285130.57,179523.43,464654.00
355100,202312,6792,3133,3659,4138295.64,4829922.94,8968218.58
355110,202312,235,154,81,203282.41,106920.1,310202.51
355120,202312,47,30,17,39600.72,22440,62040.72
355130,202312,62,35,27,46200.39,35640,81840.39
355140,202312,223,127,96,167643.42,126720.84,294364.26
355150,202312,857,513,344,677187.18,454086.45,1131273.63
355160,202312,615,293,322,386779.24,425046.04,811825.28
355170,202312,2384,1229,1155,1623687.32,1524613.63,3148300.95
355180,202312,754,293,461,386765.91,608528.9,995294.81
355190,202312,240,158,82,208570.12,108241.96,316812.08
355200,202312,134,59,75,77882.52,99000,176882.52
355210,202312,829,421,408,557052.05,539882.47,1096934.52
355220,202312,9600,4430,5170,5847854.24,6829741.51,12677595.75
355230,202312,101,51,50,67320.35,66001.11,133321.46
355240,202312,5447,2172,3275,2868416.63,4326984.05,7195400.68
355250,202312,8543,3794,4749,5010970.77,6272676.99,11283647.76
355255,202312,50,30,20,39600.62,26400,66000.62
355260,202312,222,123,99,162366.07,130683.09,293049.16
355270,202312,178,124,54,163688.01,71281.88,234969.89
355280,202312,8824,3337,5487,4406328.17,7245578.3,11651906.47
355290,202312,81,63,18,83161.15,23760.31,106921.46
355300,202312,269,153,116,201965.78,153120.97,355086.75
355310,202312,119,67,52,88442.5,68640,157082.5
355320,202312,124,63,61,83161.24,80520.96,163682.20
355330,202312,397,238,159,314169.97,209882.35,524052.32
355340,202312,1434,551,883,728749.75,1165606.69,1894356.44
355350,202312,192,93,99,122760.5,130680.2,253440.7
355360,202312,237,156,81,205931.42,106921.45,312852.87
355365,202312,23,17,6,22440,7920,30360
355370,202312,1139,662,477,873890.28,629642.43,1503532.71
355380,202312,954,560,394,740553.42,520087.79,1260641.21
355385,202312,116,72,44,95040.2,58080,153120.2
355390,202312,125,69,56,91081.8,73920.11,165001.91
355395,202312,229,110,119,145207.45,157083.94,302291.39
355400,202312,2094,1146,948,1512683.52,1254002.23,2766685.75
355410,202312,6232,2815,3417,3715943.1,4517062.17,8233005.27
355420,202312,48,33,15,43560.8,19800,63360.8
355430,202312,554,319,235,421107.23,310208.18,731315.41
355440,202312,105,57,48,75241.1,63361.85,138602.95
355450,202312,531,279,252,368295.86,333964.15,702260.01
355460,202312,67,44,23,58081.1,30360.8,88441.9
355465,202312,58,31,27,40920.2,35640,76560.2
355470,202312,212,92,120,121444.32,158401.8,279846.12
355475,202312,11,6,5,7920.56,6600,14520.56
355480,202312,745,304,441,401299.6,582125.09,983424.69
355490,202312,125,92,33,121444.61,43563.89,165008.50
355495,202312,143,63,80,83160,105601.29,188761.29
355500,202312,1798,977,821,1291000.72,1086363.51,2377364.23
355510,202312,311,209,102,275893.55,134643,410536.55
355520,202312,31,20,11,26400.2,14520,40920.2
355530,202312,26,14,12,18480,15840,34320
355535,202312,103,50,53,66002.39,69960,135962.39
355540,202312,3370,1334,2036,1760945.06,2688890.94,4449836.00
355550,202312,72,38,34,50160,44880,95040
355560,202312,304,131,173,172926.03,228363.97,401290.00
355570,202312,16,12,4,15841.07,5280,21121.07
355580,202312,240,161,79,212529.62,104281.73,316811.35
355590,202312,17,11,6,14520.57,7920,22440.57
355600,202312,307,151,156,199327.37,205921.38,405248.75
355610,202312,277,164,113,216490.54,149163.15,365653.69
355620,202312,1539,648,891,855392.22,1176125.03,2031517.25
355630,202312,455,316,139,417142.29,183481.88,600624.17
355635,202312,141,54,87,72600.2,114840,187440.2
355640,202312,683,351,332,463329.62,438246.67,901576.29
355645,202312,1010,356,654,469935.51,865928.81,1335864.32
355650,202312,2073,899,1174,1188051.38,1549683.49,2737734.87
355660,202312,244,126,118,166322.86,157082.4,323405.26
355670,202312,778,325,453,429005.76,599283.73,1028289.49
355680,202312,246,132,114,174253.52,150482.98,324736.50
355690,202312,103,46,57,60723.15,75242.27,135965.42
355695,202312,23,14,9,18480,11880,30360
355700,202312,1466,676,790,892354.51,1042804.76,1935159.27
355710,202312,2580,1436,1144,1898254.83,1511404.75,3409659.58
355715,202312,19,14,5,18483.18,6600.1,25083.28
355720,202312,289,179,110,236288.75,145201.51,381490.26
355730,202312,120,71,49,93722.03,64680.15,158402.18
410010,202312,112,91,21,120122.38,27720,147842.38
410020,202312,135,92,43,121444.03,56760.2,178204.23
410030,202312,232,121,111,159726.58,146523.77,306250.35
410040,202312,1689,796,893,1053390.18,1178777,2232167.18
410045,202312,45,34,11,44880.79,14520,59400.79
410050,202312,593,343,250,452765.61,330000.71,782766.32
410060,202312,237,171,66,225730.44,87121.27,312851.71
410070,202312,281,228,53,300970.71,69960.45,370931.16
410080,202312,209,129,80,170282.21,105600.16,275882.37
410090,202312,59,51,8,67324.15,10560,77884.15
410100,202312,293,184,109,242883.54,143880.1,386763.64
410105,202312,44,27,17,35640,22440,58080
410110,202312,417,258,159,340576.88,209884.86,550461.74
410115,202312,54,29,25,38280,33000.2,71280.2
410120,202312,521,238,283,314169.24,373563.1,687732.34
410130,202312,76,39,37,51480.58,48840,100320.58
410140,202312,3723,1729,1994,2282335.88,2634741.09,4917076.97
410150,202312,2964,1230,1734,1623457.51,2292859.23,3916316.74
410160,202312,548,313,235,413166.86,310203.01,723369.87
410165,202312,65,41,24,54120.41,31680,85800.41
410170,202312,233,128,105,168962.94,138600,307562.94
410180,202312,2805,1454,1351,1920673.09,1783347.08,3704020.17
410185,202312,42,36,6,47520,7920,55440
410190,202312,545,359,186,473890.08,245520.9,719410.98
410200,202312,1212,846,366,1118059.58,483122.67,1601182.25
410210,202312,755,395,360,521419.42,476525.22,997944.64
410220,202312,59,28,31,36960.84,40920,77880.84
410230,202312,225,101,124,133323.03,165002.6,298325.63
410240,202312,804,517,287,682464.32,378841.6,1061305.92
410250,202312,413,270,143,356403.34,188762.06,545165.40
410260,202312,357,193,164,254767.62,217804.84,472572.46
410270,202312,30,21,9,27720.53,11880,39600.53
410275,202312,67,46,21,60721.4,27720,88441.4
410280,202312,343,212,131,281174.33,172920.2,454094.53
410290,202312,301,169,132,223086.89,174240.5,397327.39
410300,202312,108,66,42,87120,55440.53,142560.53
410302,202312,30,17,13,22440.98,17160,39600.98
410304,202312,52,33,19,43561.21,25080,68641.21
410305,202312,238,152,86,200648.33,113520,314168.33
410310,202312,208,124,84,163684.04,110882.42,274566.46
410315,202312,43,35,8,46200.2,10560,56760.2
410320,202312,157,111,46,146521.44,62040,208561.44
410322,202312,45,26,19,34320.7,25080,59400.7
410330,202312,191,126,65,166323.14,85800,252123.14
410335,202312,112,64,48,84480,63360,147840
410337,202312,56,44,12,58080.5,15840,73920.5
410340,202312,40,32,8,42241.21,10560,52801.21
410345,202312,217,139,78,183482.8,102960.2,286443.0
410347,202312,41,31,10,40920.14,13200.7,54120.84
410350,202312,277,161,116,212524.73,153120,365644.73
410360,202312,529,326,203,430335.16,269280.41,699615.57
410370,202312,2565,1122,1443,1481086.32,1904776.11,3385862.43
410380,202312,221,127,94,167643.97,124081.28,291725.25
410390,202312,477,284,193,374888.73,254761.55,629650.28
410395,202312,39,24,15,33001.47,19800,52801.47
410400,202312,1101,471,630,621737.4,832930.38,1454667.78
410405,202312,90,70,20,92405.34,26401.15,118806.49
410410,202312,42,24,18,31682.65,23760.1,55442.75
410420,202312,2154,965,1189,1273718.11,1570820.42,2844538.53
410425,202312,250,116,134,154211.59,176880,331091.59
410430,202312,2757,1400,1357,1848046.35,1791259.15,3639305.50
410440,202312,385,281,104,370923.43,137280.25,508203.68
410442,202312,393,239,154,315491.46,203281.58,518773.04
410445,202312,372,259,113,341888.07,149161.22,491049.29
410450,202312,447,217,230,286447.57,304920.82,591368.39
410460,202312,642,354,288,468607.41,380163.43,848770.84
410465,202312,298,168,130,221766.18,171600,393366.18
410470,202312,266,158,108,208566.62,143881.63,352448.25
410480,202312,7759,3816,3943,5039907.74,5207450,10247357.74
410490,202312,1568,844,724,1114109.84,955688.21,2069798.05
410500,202312,317,191,126,252123.06,166320.5,418443.56
410510,202312,228,167,61,220450.08,80521.27,300971.35
410520,202312,318,229,89,302281.62,117480.2,419761.82
410530,202312,277,92,185,121440.59,244200,365640.59
410540,202312,426,307,119,405249.53,158400,563649.53
410550,202312,1940,857,1083,1132584.52,1429569.53,2562154.05
410560,202312,199,128,71,168964.38,93720.94,262685.32
410570,202312,491,325,166,429010.49,219122.34,648132.83
410580,202312,4502,1887,2615,2496195.83,3455807.82,5952003.65
410590,202312,481,304,177,401266.69,233641.04,634907.73
410600,202312,128,108,20,143881.42,26400,170281.42
410610,202312,72,59,13,77881.99,17160,95041.99
410620,202312,325,179,146,236288.68,192721.91,429010.59
410630,202312,519,284,235,374882.34,311520.28,686402.62
410640,202312,1348,845,503,1118066.57,663961.35,1782027.92
410645,202312,127,97,30,128044,39600.2,167644.2
410650,202312,425,265,160,349807.06,211201.96,561009.02
410655,202312,99,69,30,91080.73,39600.08,130680.81
410657,202312,45,22,23,29040,30360,59400
410660,202312,741,517,224,682458.23,295681.33,978139.56
410670,202312,78,62,16,81842.8,21120.95,102963.75
410680,202312,211,165,46,217805.1,60720.2,278525.3
410685,202312,46,34,12,44880.49,15840,60720.49
410690,202312,34508,14189,20319,18736576.13,26838650.86,45575226.99
410700,202312,376,268,108,354049.22,142560.37,496609.59
410710,202312,120,97,23,128042.21,30360.2,158402.41
410712,202312,50,35,15,46200.65,19800,66000.65
410715,202312,117,85,32,112203.85,42240,154443.85
410720,202312,747,429,318,566293.41,419760.65,986054.06
410725,202312,218,144,74,190083.58,97680,287763.58
410730,202312,117,51,66,67321.35,87120,154441.35
410740,202312,84,63,21,83161.91,27720,110881.91
410750,202312,344,206,138,271925.75,182160.98,454086.73
410752,202312,25,18,7,23760.14,9240,33000.14
410753,202312,64,21,43,27720,56760,84480
410754,202312,75,44,31,58081.6,40920,99001.6
410755,202312,96,48,48,63360.74,63360,126720.74
410760,202312,832,451,381,595328.55,502922.81,1098251.36
410765,202312,2384,1054,1330,1391336.35,1756946.4,3148282.75
410770,202312,130,89,41,117484.98,54120.72,171605.70
410773,202312,70,47,23,62041.73,30360,92401.73
410775,202312,245,161,84,212523.45,110880,323403.45
410780,202312,90,51,39,67320.64,51480,118800.64
410785,202312,62,54,8,71281.61,10560,81841.61
410790,202312,115,53,62,69960.2,81840.2,151800.4
410800,202312,316,198,118,261374.78,155760.84,417135.62
410810,202312,30,20,10,26400,13200.14,39600.14
410820,202312,154,106,48,139922.11,63360.9,203283.01
410830,202312,11200,4364,6836,5765920.14,9026245.01,14792165.15
410832,202312,127,83,44,109563.48,58080.86,167644.34
410840,202312,1624,903,721,1191987.58,951725.6,2143713.18
410845,202312,67,33,34,43560,44880,88440
410850,202312,185,139,46,183484.58,60720,244204.58
410855,202312,88,81,7,106924.01,9240,116164.01
410860,202312,1031,504,527,666610.88,695643.96,1362254.84
410865,202312,99,69,30,91082.58,39600,130682.58
410870,202312,155,127,28,167641.38,36960.62,204602.00
410880,202312,1330,634,696,836900.29,921367.9,1758268.19
410890,202312,137,80,57,105601,75240,180841
410895,202312,86,64,22,84481.82,29040.95,113522.77
410900,202312,48,37,11,48841.53,14520,63361.53
410910,202312,15,9,6,11880.95,7920,19800.95
410920,202312,53,32,21,42240.34,27720,69960.34
410930,202312,598,373,225,492366.98,297001.83,789368.81
410940,202312,5097,2558,2539,3378006.49,3352839.52,6730846.01
410950,202312,109,78,31,102963.88,40920,143883.88
410960,202312,1170,431,739,568936.39,975490.78,1544427.17
410965,202312,75,55,20,72602.11,26400,99002.11
410970,202312,679,442,237,583450.69,314162.63,897613.32
410975,202312,136,87,49,114841.71,64680,179521.71
410980,202312,1751,806,945,1063959.24,1250054.46,2314013.70
410990,202312,283,207,76,273241.56,100320.98,373562.54
411000,202312,75,45,30,59401.74,39600.44,99002.18
411005,202312,45,37,8,48840,10560,59400
411007,202312,308,178,130,234960.47,171600,406560.47
411010,202312,691,419,272,553093.34,360362.55,913455.89
411020,202312,303,193,110,254764.96,145202.4,399967.36
411030,202312,36,23,13,30360,17160,47520
411040,202312,82,46,36,60720.89,47520,108240.89
411050,202312,220,158,62,208563.96,81840.38,290404.34
411060,202312,634,438,196,578168.52,258721.1,836889.62
411065,202312,46,40,6,52800.78,7920,60720.78
411070,202312,1448,814,634,1074500.33,838205.5,1912705.83
411080,202312,276,174,102,229681.68,134640.23,364321.91
411090,202312,85,58,27,76560.4,35640.96,112201.36
411095,202312,378,125,253,165002.1,333962.11,498964.21
411100,202312,116,94,22,124081.67,29040,153121.67
411110,202312,184,96,88,126720.74,116160,242880.74
411120,202312,205,137,68,180851.39,89760,270611.39
411125,202312,441,224,217,295691.17,286447.01,582138.18
411130,202312,170,145,25,191403.78,33000,224403.78
411140,202312,229,149,80,196680.8,105600,302280.8
411150,202312,1384,889,495,1173507.78,653407.07,1826914.85
411155,202312,128,88,40,117480,52800,170280
411160,202312,41,17,24,22440,31680,54120
411170,202312,62,53,9,69960.79,11880,81840.79
411180,202312,1168,789,379,1041515.4,501606.06,1543121.46
411190,202312,411,237,174,312843.94,229680.98,542524.92
411200,202312,753,396,357,524052.85,471244.85,995297.70
411210,202312,737,383,354,505567.26,468601.63,974168.89
411220,202312,167,118,49,155762.58,64681.49,220444.07
411230,202312,43,36,7,47520.2,9240,56760.2
411240,202312,118,73,45,96361.08,59400,155761.08
411250,202312,452,322,130,425048.21,171600.7,596648.91
411260,202312,11,8,3,10560,3960,14520
411270,202312,294,154,140,203289.74,184801.69,388091.43
411275,202312,206,168,38,221764.08,50160,271924.08
411280,202312,321,213,108,281166.65,142561.4,423728.05
411290,202312,78,58,20,76560.1,26400,102960.1
411295,202312,145,103,42,135963.4,55440.83,191404.23
411300,202312,93,46,47,60720,62040,122760
411310,202312,104,70,34,92401.4,44880,137281.4
411320,202312,923,556,367,733933.52,484441.29,1218374.81
411325,202312,63,43,20,56760.3,26400,83160.3
411330,202312,1062,672,390,887064.96,514801.78,1401866.74
411340,202312,42,23,19,30360,25080.09,55440.09
411342,202312,70,56,14,73920,18480,92400
411345,202312,104,52,52,68641.9,68640.95,137282.85
411350,202312,618,451,167,595339.15,220442.62,815781.77
411360,202312,60,40,20,52802.47,26401.58,79204.05
411370,202312,14922,6230,8692,8230585.23,11482784.97,19713370.20
411373,202312,199,130,69,171601.09,91080.58,262681.67
411375,202312,98,80,18,105603.81,23760,129363.81
411380,202312,89,62,27,81844.95,36960,118804.95
411390,202312,182,101,81,133321.19,106920,240241.19
411400,202312,402,251,151,331326.77,200640,531966.77
411410,202312,612,298,314,393367.32,417121.92,810489.24
411420,202312,1056,437,619,576850.12,818405.08,1395255.20
411430,202312,684,346,338,456740.75,446167.95,902908.70
411435,202312,29,21,8,27720,10560,38280
411440,202312,539,426,113,562330.69,149160.7,711491.39
411450,202312,417,339,78,447489.13,102960.34,550449.47
411460,202312,905,348,557,459375.11,735242.19,1194617.30
411470,202312,121,84,37,110884.67,48840,159724.67
411480,202312,825,413,412,545183.41,543842.33,1089025.74
411490,202312,312,197,115,260045.79,151800.9,411846.69
411500,202312,125,92,33,121441.98,43560,165001.98
411510,202312,259,198,61,261366.19,80521.19,341887.38
411520,202312,7389,2513,4876,3318561.82,6437679.36,9756241.18
411530,202312,133,84,49,110881.17,64680,175561.17
411535,202312,55,19,36,25080.6,47520.63,72601.23
411540,202312,427,284,143,374884.56,188762.03,563646.59
411545,202312,56,39,17,51480.57,22440,73920.57
411550,202312,94,68,26,89761.37,34320,124081.37
411560,202312,416,165,251,219122.57,331320.95,550443.52
411570,202312,1239,405,834,534491.94,1100889.38,1635381.32
411573,202312,28,18,10,23760.2,13200,36960.2
411575,202312,362,233,129,307565.65,170280,477845.65
411580,202312,1377,479,898,632293.08,1186685.36,1818978.44
411585,202312,78,38,40,50160,54120,104280
411590,202312,16,11,5,14520.2,6600,21120.2
411600,202312,16,9,7,11880.7,9240,21120.7
411605,202312,185,68,117,89762.88,154440,244202.88
411610,202312,282,173,109,228364.89,143880.55,372245.44
411620,202312,443,210,233,277214.64,307567.11,584781.75
411630,202312,53,38,15,50160.5,19800.99,69961.49
411640,202312,37,26,11,34320.23,14520,48840.23
411650,202312,8,5,3,6600,3960,10560
411660,202312,55,42,13,55440,17160,72600
411670,202312,259,168,91,221761.78,120121.98,341883.76
411680,202312,186,138,48,182161.22,63360,245521.22
411690,202312,756,393,363,520085.13,479162.79,999247.92
411695,202312,67,46,21,60720.2,27720,88440.2
411700,202312,151,115,36,151804.96,47520,199324.96
411705,202312,113,77,36,101642.57,47521.11,149163.68
411710,202312,309,201,108,265325.7,142560.87,407886.57
411720,202312,171,111,60,146523.52,79200.93,225724.45
411721,202312,103,78,25,102960.2,33000,135960.2
411722,202312,112,53,59,69961.07,77880,147841.07
411725,202312,184,131,53,172921.7,69960,242881.7
411727,202312,111,93,18,122763.25,23760.5,146523.75
411729,202312,61,48,13,63362.57,17160,80522.57
411730,202312,623,396,227,522727.55,302281.83,825009.38
411740,202312,28,17,11,22440.24,14520,36960.24
411745,202312,75,58,17,76560,22440,99000
411750,202312,980,409,571,539895.04,755045.35,1294940.39
411760,202312,1472,1071,401,1413770.59,529328.46,1943099.05
411770,202312,470,295,175,389405.24,231002.24,620407.48
411780,202312,420,271,149,357723.04,196680.21,554403.25
411790,202312,649,362,287,479175.79,378841.5,858017.29
411800,202312,181,125,56,165006.4,73920.65,238927.05
411810,202312,208,163,45,215164.54,59400.74,274565.28
411820,202312,3150,1258,1892,1661958.34,2498790.32,4160748.66
411830,202312,22,14,8,18480.19,10560,29040.19
411840,202312,2625,1507,1118,1989297.73,1475785.4,3465083.13
411845,202312,74,23,51,30361.59,67320,97681.59
411850,202312,1435,773,662,1020388.02,873849.03,1894237.05
411860,202312,76,47,29,62040.99,38280,100320.99
411870,202312,81,50,31,66000,40920,106920
411880,202312,454,272,182,359051.45,240240.51,599291.96
411885,202312,116,78,38,102962.2,50160.28,153122.48
411890,202312,381,267,114,352450.16,150481.78,502931.94
411900,202312,119,88,31,116160.88,40920,157080.88
411910,202312,252,165,87,217807.42,114843.21,332650.63
411915,202312,2904,1125,1779,1485045.19,2350946.86,3835992.05
411920,202312,121,87,34,114841.7,44880,159721.7
411925,202312,24,17,7,22440.2,9240,31680.2
411930,202312,911,608,303,802671.99,399964.94,1202636.93
411940,202312,629,381,248,502935.78,327362.62,830298.40
411950,202312,1524,706,818,931959.33,1079775.21,2011734.54
411960,202312,1258,768,490,1013776.6,648123.46,1661900.06
411965,202312,23,16,7,21120.18,9240.16,30360.34
411970,202312,91,80,11,105603.19,14520,120123.19
411980,202312,263,134,129,176880,170280,347160
411990,202312,6269,3267,3002,4316200.49,3964118.68,8280319.17
411995,202312,778,250,528,330011.22,698298.54,1028309.76
412000,202312,384,259,125,341889.17,165003.31,506892.48
412010,202312,75,43,32,56761.8,42241.27,99003.07
412015,202312,39,29,10,38280,13200,51480
412020,202312,22,16,6,21120,7920,29040
412030,202312,43,36,7,47521.13,9240,56761.13
412033,202312,48,28,20,36961.29,26400,63361.29
412035,202312,70,48,22,63360.91,29040,92400.91
412040,202312,34,16,18,21120.97,23760,44880.97
412050,202312,222,167,55,220445.53,72600,293045.53
412060,202312,896,631,265,832949.53,349803.1,1182752.63
412065,202312,62,30,32,39602.13,42240.27,81842.40
412070,202312,168,116,52,153122.56,68640.49,221763.05
412080,202312,400,192,208,253450.07,274567.01,528017.08
412085,202312,39,16,23,21120.23,30360,51480.23
412090,202312,971,589,382,777500.43,505562.03,1283062.46
412100,202312,285,235,50,310210.36,66000,376210.36
412110,202312,76,56,20,73921.42,26400.1,100321.52
412120,202312,418,222,196,293047.27,258721.7,551768.97
412125,202312,76,43,33,56760.2,44880,101640.2
412130,202312,60,45,15,60722.82,19800,80522.82
412135,202312,36,20,16,26400.8,21120,47520.8
412140,202312,513,338,175,445885.32,231003.47,676888.79
412150,202312,280,166,114,219122.27,150480.73,369603.00
412160,202312,75,52,23,68643.13,30360,99003.13
412170,202312,749,480,269,633608.65,355082.3,988690.95
412175,202312,49,32,17,42241.65,22440,64681.65
412180,202312,195,144,51,190085.39,67320.2,257405.59
412190,202312,356,270,86,356405.76,113520,469925.76
412200,202312,209,118,91,155761.08,120120,275881.08
412210,202312,106,78,28,102960,36960.21,139920.21
412215,202312,259,167,92,220443.94,121440.99,341884.93
412217,202312,73,60,13,79200.63,17160,96360.63
412220,202312,985,627,358,827667.72,472571.79,1300239.51
412230,202312,325,189,136,249489.82,179524.39,429014.21
412240,202312,1536,758,778,1000584.08,1026972.1,2027556.18
412250,202312,471,279,192,368286.57,253440,621726.57
412260,202312,153,103,50,135961.7,66000.2,201961.9
412265,202312,170,131,39,172920.83,51480,224400.83
412270,202312,104,62,42,81841.41,55440,137281.41
412280,202312,90,66,24,87120.2,31680,118800.2
412290,202312,101,61,40,81841.48,52800,134641.48
412300,202312,234,171,63,227042.07,83160,310202.07
412310,202312,63,49,14,64681.26,18480,83161.26
412320,202312,103,77,26,101644.24,34320,135964.24
412330,202312,222,169,53,223083.11,69960.02,293043.13
412340,202312,210,131,79,172922.83,104280,277202.83
412350,202312,781,347,434,458046.68,572883.41,1030930.09
412360,202312,26,20,6,26400,7920,34320
412370,202312,162,129,33,170283.92,43560.96,213844.88
412380,202312,193,141,52,186125.19,68640.28,254765.47
412382,202312,65,37,28,48840.2,36960,85800.2
412385,202312,182,124,58,163684.89,76560.92,240245.81
412390,202312,356,271,85,357733.18,112200.24,469933.42
412395,202312,74,60,14,79202.19,18480,97682.19
412400,202312,113,76,37,100321.68,48840,149161.68
412402,202312,269,153,116,201962.92,153120,355082.92
412405,202312,1050,359,691,473884.56,912123.2,1386007.76
412410,202312,1113,669,444,883113.78,586086.11,1469199.89
412420,202312,19,18,1,23760,1320,25080
412430,202312,29,27,2,35640.84,2640.2,38281.04
412440,202312,776,385,391,508208.35,516121.13,1024329.48
412450,202312,72,61,11,80521.32,14520.59,95041.91
412460,202312,93,63,30,83161.04,39600.19,122761.23
412470,202312,260,210,50,277204.12,66001.33,343205.45
412480,202312,178,127,51,167646.23,67320.2,234966.43
412490,202312,199,162,37,213841.51,48840,262681.51
412500,202312,437,340,97,448811.45,128040.69,576852.14
412510,202312,186,150,36,198003.29,47520,245523.29
412520,202312,98,68,30,89761.87,39600,129361.87
412530,202312,123,56,67,73921.63,88440,162361.63
412535,202312,58,45,13,59400.78,18480,77880.78
412540,202312,69,41,28,54121.65,36960.05,91081.70
412545,202312,96,67,29,88440.87,38280,126720.87
412550,202312,4969,2024,2945,2674556.7,3888783.12,6563339.82
412555,202312,16,8,8,10560.61,10560,21120.61
412560,202312,767,489,278,645497.27,366962.94,1012460.21
412570,202312,967,416,551,549135.15,727324.43,1276459.58
412575,202312,104,75,29,99002.45,38280,137282.45
412580,202312,189,126,63,166328.41,83162.14,249490.55
412590,202312,30,27,3,35640.97,3960,39600.97
412600,202312,250,182,68,240245.95,89760.83,330006.78
412610,202312,54,23,31,30361.14,40920,71281.14
412620,202312,131,106,25,139921.42,33000.66,172922.08
412625,202312,2544,1209,1335,1595912.27,1762209.3,3358121.57
412627,202312,68,52,16,68641.05,21120,89761.05
412630,202312,413,280,133,369552.89,175560.64,545113.53
412635,202312,89,27,62,35640.9,81840,117480.9
412640,202312,111,82,29,108242.49,38280.56,146523.05
412650,202312,352,235,117,310207.58,154441.15,464648.73
412660,202312,613,339,274,447485.08,363001.4,810486.48
412665,202312,44,40,4,52801.04,5280,58081.04
412667,202312,285,180,105,237604.13,138600,376204.13
412670,202312,89,66,23,87120.96,30360,117480.96
412680,202312,362,269,93,355089.42,122761.15,477850.57
412690,202312,144,94,50,124083.16,66000,190083.16
412700,202312,201,121,80,159721.26,105600.23,265321.49
412710,202312,1539,835,704,1102224.67,929288.33,2031513.00
412720,202312,281,151,130,199324.25,171600.37,370924.62
412730,202312,184,154,30,203286.93,39600,242886.93
412740,202312,453,217,236,286444.34,311520.41,597964.75
412750,202312,435,242,193,319447.74,256080.93,575528.67
412760,202312,425,215,210,283807.35,277203.86,561011.21
412770,202312,2433,1299,1134,1716035.84,1500848.6,3216884.44
412780,202312,149,99,50,130682.01,66000,196682.01
412785,202312,344,184,160,242882.86,212520.02,455402.88
412788,202312,59,33,26,43560.92,34320,77880.92
412790,202312,134,105,29,138604.27,38280,176884.27
412795,202312,163,114,49,150481.68,64680,215161.68
412796,202312,323,200,123,264002.44,162360,426362.44
412800,202312,784,436,348,575525.38,459360.81,1034886.19
412810,202312,3572,2002,1570,2644036.24,2075060.21,4719096.45
412820,202312,1206,680,526,897631.26,694333.38,1591964.64
412830,202312,16,15,1,19801.1,1320,21121.1
412840,202312,265,176,89,232324.04,117480.2,349804.24
412850,202312,619,400,219,528009.27,289081.31,817090.58
412853,202312,188,82,106,108240.99,139920,248160.99
412855,202312,230,124,106,163681.83,139920.73,303602.56
412860,202312,107,73,34,96365.37,44880.87,141246.24
412862,202312,92,60,32,79200.19,42240,121440.19
412863,202312,15,10,5,13200,6600,19800
412865,202312,42,34,8,44880,10560.6,55440.6
412870,202312,137,94,43,124083.36,56762.37,180845.73
412880,202312,104,72,32,95043.38,42240,137283.38
420005,202312,50,42,8,55440.48,10560,66000.48
420010,202312,382,255,127,336605.81,167640.89,504246.70
420020,202312,108,84,24,110882.5,31680,142562.5
420030,202312,35,26,9,34320.2,11880,46200.2
420040,202312,94,73,21,96364.03,27720.2,124084.23
420050,202312,55,35,20,46200,26400,72600
420055,202312,20,17,3,22440.21,3960,26400.21
420060,202312,38,26,12,34321.05,15840.76,50161.81
420070,202312,126,111,15,146520.8,19800,166320.8
420075,202312,13,13,0,17160,0,17160
420080,202312,48,40,8,52801.13,10560,63361.13
420090,202312,50,40,10,52801.71,13200.23,66001.94
420100,202312,178,153,25,201962.3,33000,234962.3
420110,202312,30,28,2,36960.93,2640,39600.93
420120,202312,69,50,19,66000,25080,91080
420125,202312,87,65,22,85800.63,29040,114840.63
420127,202312,40,33,7,43560.51,9240,52800.51
420130,202312,617,374,243,493696.58,320766.47,814463.05
420140,202312,1577,907,670,1197279.83,888380.43,2085660.26
420150,202312,55,41,14,54120,18480,72600
420160,202312,39,34,5,44880.87,6600,51480.87
420165,202312,17,13,4,17160.1,5280,22440.1
420170,202312,84,47,37,62040.83,48840,110880.83
420180,202312,26,24,2,31680,2640,34320
420190,202312,35,30,5,39600.18,6600,46200.18
420195,202312,167,88,79,116165.07,104284.03,220449.10
420200,202312,1610,678,932,894991.41,1231584.56,2126575.97
420205,202312,167,101,66,133324.19,87120.2,220444.39
420207,202312,190,104,86,137284.94,113522.89,250807.83
420208,202312,22,18,4,23760.21,5280,29040.21
420209,202312,16,14,2,18480,2640,21120
420210,202312,709,344,365,454092.21,481803.15,935895.36
420213,202312,60,40,20,52800.69,26400,79200.69
420215,202312,28,24,4,31680.88,5280,36960.88
420220,202312,65,40,25,52800.44,33000,85800.44
420230,202312,1221,764,457,1008529.76,604571.15,1613100.91
420240,202312,2808,1871,937,2471098.7,1236849.68,3707948.38
420243,202312,49,41,8,54121.22,10560,64681.22
420245,202312,297,138,159,182169.07,209884.4,392053.47
420250,202312,69,45,24,59400.93,31680,91080.93
420253,202312,26,20,6,26400.49,7920,34320.49
420257,202312,17,10,7,13200.5,9240,22440.5
420260,202312,137,110,27,145202.92,35640.14,180843.06
420270,202312,44,31,13,40920,17160.36,58080.36
420280,202312,324,236,88,311533.25,116160.33,427693.58
420285,202312,25,19,6,25080,7920,33000
420287,202312,50,32,18,42241.42,23760,66001.42
420290,202312,1133,767,366,1012455.12,483120,1495575.12
420300,202312,1800,1440,360,1900871.55,475207.82,2376079.37
420310,202312,49,34,15,44880.9,19800,64680.9
420315,202312,25,21,4,27720.78,5280.74,33001.52
420320,202312,1256,611,645,809187.24,851411.51,1660598.75
420325,202312,10,8,2,10560,2640.3,13200.3
420330,202312,126,85,41,112202.37,54121.03,166323.40
420340,202312,214,141,73,186123.4,96360,282483.4
420350,202312,293,208,85,274566.62,112200.73,386767.35
420360,202312,742,584,158,770908.58,209880.69,980789.27
420370,202312,152,87,65,114843.79,85800.43,200644.22
420380,202312,1431,959,472,1267244.75,623047.8,1890292.55
420390,202312,238,167,71,220444.6,93720.4,314165.0
420395,202312,215,157,58,207260.11,76562.23,283822.34
420400,202312,230,173,57,228363.38,75240,303603.38
420410,202312,61,47,14,62041.83,18480,80521.83
420415,202312,35,26,9,34320.2,11880,46200.2
420417,202312,75,59,16,77880.62,21120,99000.62
420419,202312,15,13,2,17160,2640,19800
420420,202312,3310,2063,1247,2723231.44,1647372.48,4370603.92
420425,202312,79,57,22,75245.8,29040,104285.8
420430,202312,1075,791,284,1044129.34,374882.62,1419011.96
420435,202312,14,11,3,14520,3960,18480
420440,202312,92,67,25,88441.66,34320,122761.66
420445,202312,33,30,3,39601.48,3960,43561.48
420450,202312,102,58,44,76564.16,58080.83,134644.99
420455,202312,216,173,43,228365.59,56760.4,285125.99
420460,202312,2731,1691,1040,2233540.95,1372816.88,3606357.83
420470,202312,82,52,30,68640.2,39600,108240.2
420475,202312,10,9,1,11880.46,1320,13200.46
420480,202312,1033,795,238,1050771.67,314161.64,1364933.31
420490,202312,104,75,29,99003.97,38280,137283.97
420500,202312,424,249,175,328691.49,232320.63,561012.12
420510,202312,22,18,4,23760,5280,29040
420515,202312,31,17,14,22440.29,18480,40920.29
420517,202312,12,9,3,11880.91,3960,15840.91
420519,202312,9,8,1,10560,1320,11880
420520,202312,66,47,19,62041.39,25080.2,87121.59
420530,202312,149,95,54,125401.44,71280.2,196681.64
420535,202312,16,13,3,17160.41,3960,21120.41
420540,202312,8397,5233,3164,6908126.89,4177845.32,11085972.21
420543,202312,33,31,2,40920.94,2640,43560.94
420545,202312,264,183,81,241567.54,106920.6,348488.14
420550,202312,877,748,129,987394.65,170282.46,1157677.11
420555,202312,41,31,10,40920.9,13200,54120.9
420560,202312,66,50,16,66001.34,21120,87121.34
420570,202312,297,145,152,191407.51,200644.06,392051.57
420580,202312,384,204,180,269287.34,237600.93,506888.27
420590,202312,580,367,213,484451.72,281161.08,765612.80
420600,202312,176,97,79,128040.6,104280,232320.6
420610,202312,41,37,4,48840.63,5280,54120.63
420620,202312,86,70,16,92403.72,21120.41,113524.13
420630,202312,180,125,55,165002.61,72600,237602.61
420640,202312,79,69,10,91080.8,13200,104280.8
420650,202312,383,199,184,262686.23,242880.61,505566.84
420660,202312,44,30,14,39600.45,18480,58080.45
420665,202312,55,36,19,47521.6,25080,72601.6
420670,202312,245,186,59,245528.74,77880,323408.74
420675,202312,20,15,5,19800,6600,26400
420680,202312,36,29,7,38280.32,9240,47520.32
420690,202312,234,166,68,219122.78,89760.38,308883.16
420700,202312,830,533,297,703587.21,392044.44,1095631.65
420710,202312,169,92,77,121442.92,101641.07,223083.99
420720,202312,112,83,29,109566.14,38280.39,147846.53
420730,202312,862,518,344,683783.34,454087.16,1137870.50
420740,202312,63,59,4,77881.24,5280,83161.24
420750,202312,554,369,185,488405.51,244201.69,732607.20
420757,202312,20,17,3,22440,3960,26400
420760,202312,39,28,11,36960.86,14520.55,51481.41
420765,202312,69,48,21,63361.14,27720,91081.14
420768,202312,59,45,14,62043.31,18480,80523.31
420770,202312,78,67,11,88441.52,14520,102961.52
420775,202312,37,30,7,39600.26,9240,48840.26
420780,202312,214,164,50,216482.69,66000,282482.69
420785,202312,29,18,11,23760,14520,38280
420790,202312,146,120,26,158402.28,34320,192722.28
420800,202312,67,54,13,71280.62,17160,88440.62
420810,202312,317,240,77,316811.62,101640,418451.62
420820,202312,3183,1800,1383,2377414.02,1830868.14,4208282.16
420830,202312,886,480,406,633629,535932.47,1169561.47
420840,202312,139,96,43,126721.55,56760,183481.55
420845,202312,547,252,295,332649.34,389404.2,722053.54
420850,202312,318,242,76,319444.27,100320.3,419764.57
420860,202312,62,53,9,69961.52,11880,81841.52
420870,202312,147,103,44,135961.49,58080,194041.49
420880,202312,225,142,83,187443.61,109560.3,297003.91
420890,202312,1192,621,571,819918.25,753722.35,1573640.60
420895,202312,11,10,1,13200,1320,14520
420900,202312,439,348,91,459369.5,120120.78,579490.28
420910,202312,7010,3946,3064,5209081.21,4047166.8,9256248.01
420915,202312,61,55,6,72600.2,7920,80520.2
420917,202312,27,20,7,26401.21,9240,35641.21
420920,202312,22,16,6,21120,7920,29040
420930,202312,4281,2995,1286,3954815.33,1698874.34,5653689.67
420940,202312,674,464,210,612516.17,278527.16,891043.33
420945,202312,11,8,3,10560,3960,14520
420950,202312,49,37,12,48840.75,15840,64680.75
420960,202312,118,97,21,128046.05,27720,155766.05
420970,202312,305,252,53,332654.01,69960.71,402614.72
420980,202312,25,23,2,30360,2640,33000
420985,202312,55,47,8,62041.58,10560,72601.58
420990,202312,100,76,24,100323.27,31683.45,132006.72
421000,202312,76,36,40,47520,52800,100320
421003,202312,32,22,10,29040.38,13200,42240.38
421005,202312,9,7,2,9240.3,2640,11880.3
421010,202312,984,620,364,818438.84,480484.94,1298923.78
421020,202312,20,18,2,23762.49,2640,26402.49
421030,202312,117,92,25,121440.95,33000.58,154441.53
421040,202312,77,59,18,77881.28,23761.05,101642.33
421050,202312,346,243,103,322083.73,135960,458043.73
421055,202312,14,11,3,14520.2,3960,18480.2
421060,202312,132,68,64,89761.11,84480.69,174241.80
421070,202312,34,31,3,40920.86,3960,44880.86
421080,202312,52,41,11,54120.23,14520,68640.23
421085,202312,22,15,7,19800.2,9240,29040.2
421090,202312,39,29,10,38280.31,13200,51480.31
421100,202312,127,95,32,125402.48,42240,167642.48
421105,202312,213,168,45,223087,59400.2,282487.2
421110,202312,146,100,46,132002.64,60720,192722.64
421120,202312,214,148,66,195363.97,87121.09,282485.06
421125,202312,19,11,8,14520,10560.32,25080.32
421130,202312,1023,625,398,826346.68,526685.88,1353032.56
421140,202312,35,26,9,34320.32,11880,46200.32
421145,202312,43,37,6,48840.11,7920,56760.11
421150,202312,90,70,20,92401.01,26400,118801.01
421160,202312,72,47,25,62041.52,33000,95041.52
421165,202312,17,14,3,18480,3960,22440
421170,202312,185,156,29,206088.87,38280.1,244368.97
421175,202312,216,147,69,194045.15,91081.76,285126.91
421180,202312,38,22,16,29040.22,21120,50160.22
421185,202312,23,19,4,25080.18,5280,30360.18
421187,202312,5,4,1,5280.2,1320,6600.2
421189,202312,46,33,13,43562.67,17160,60722.67
421190,202312,2551,1645,906,2171501.59,1197263.69,3368765.28
421200,202312,101,73,28,96362.36,36960,133322.36
421205,202312,21,14,7,18480.95,9240,27720.95
421210,202312,194,133,61,175563.37,80520.48,256083.85
421220,202312,270,208,62,274563.98,81840.48,356404.46
421223,202312,53,42,11,55440.83,14520,69960.83
421225,202312,90,60,30,79201.98,39601.11,118803.09
421227,202312,75,60,15,79200.9,19800,99000.9
421230,202312,91,63,28,83162.12,36960.18,120122.30
421240,202312,23,19,4,25080.8,5280,30360.8
421250,202312,486,273,213,360372.56,281166.2,641538.76
421260,202312,26,21,5,27720.59,6600,34320.59
421265,202312,22,15,7,19801.72,9240.1,29041.82
421270,202312,57,50,7,66000,9240,75240
421280,202312,485,257,228,339253.51,300962.23,640215.74
421290,202312,322,213,109,282482.67,143881,426363.67
421300,202312,24,20,4,26400,5280,31680
421310,202312,52,35,17,46200,22440,68640
421315,202312,37,22,15,29041.03,19800.08,48841.11
421320,202312,153,105,48,138603.11,63360,201963.11
421330,202312,120,93,27,122761.88,35640,158401.88
421335,202312,49,35,14,46201.83,18480,64681.83
421340,202312,266,177,89,233644.09,117480.41,351124.50
421350,202312,203,129,74,170287.85,97680.33,267968.18
421360,202312,807,557,250,735252.36,330005.92,1065258.28
421370,202312,214,159,55,209883.13,72601.29,282484.42
421380,202312,167,123,44,163683.03,58080,221763.03
421390,202312,18,13,5,17160.58,6600,23760.58
421400,202312,127,99,28,130680.61,36960,167640.61
421410,202312,20,17,3,22440,3960,26400
421415,202312,21,19,2,25080,2640,27720
421420,202312,100,84,16,110880.82,21120,132000.82
421430,202312,22,14,8,18480,10560,29040
421440,202312,62,52,10,68641.5,13200.98,81842.48
421450,202312,84,67,17,88440.47,22440,110880.47
421460,202312,55,46,9,60720.66,11880,72600.66
421470,202312,87,47,40,62041.22,52800,114841.22
421480,202312,902,661,241,872539.24,318123.72,1190662.96
421490,202312,25,23,2,30360.78,2640,33000.78
421500,202312,542,311,231,411856.6,304922.44,716779.04
421505,202312,51,42,9,55440.1,11880.2,67320.3
421507,202312,34,27,7,35640.6,9240,44880.6
421510,202312,67,41,26,54122.46,34320,88442.46
421520,202312,48,41,7,54120.98,9240,63360.98
421530,202312,59,49,10,64681.28,13200,77881.28
421535,202312,25,22,3,29041.29,3960,33001.29
421540,202312,50,42,8,55440.2,10560,66000.2
421545,202312,97,65,32,85805.72,42240.63,128046.35
421550,202312,323,231,92,304938.07,121440.99,426379.06
421555,202312,20,18,2,23762.47,2640,26402.47
421560,202312,8,7,1,9240,1320,10560
421565,202312,143,91,52,120123.96,68640.15,188764.11
421567,202312,37,30,7,39600,9240,48840
421568,202312,38,36,2,47520,2640,50160
421569,202312,11,10,1,13200.79,1320,14520.79
421570,202312,309,200,109,264005.07,143881.55,407886.62
421575,202312,29,27,2,35640.48,2640,38280.48
421580,202312,829,493,336,652188.77,443522.23,1095711.00
421590,202312,25,22,3,29040.2,3960.2,33000.4
421600,202312,192,141,51,186120.73,67320,253440.73
421605,202312,121,83,38,109562.39,50161.01,159723.40
421610,202312,175,125,50,165000.99,66000,231000.99
421620,202312,1224,709,515,935917.87,679807.15,1615725.02
421625,202312,24,20,4,26400,5280,31680
421630,202312,394,244,150,322094.1,198006.14,520100.24
421635,202312,36,23,13,30361.78,17160,47521.78
421640,202312,124,95,29,125403.95,38280,163683.95
421650,202312,365,213,152,281169.73,200643.78,481813.51
421660,202312,3269,2013,1256,2659895.76,1657946.04,4317841.80
421670,202312,163,118,45,155762.75,60720,216482.75
421680,202312,221,194,27,256086.77,35640,291726.77
421690,202312,384,260,124,343208.86,163681.26,506890.12
421700,202312,60,43,17,56760,22440,79200
421710,202312,25,25,0,33000.53,0,33000.53
421715,202312,5,5,0,6601.62,0,6601.62
421720,202312,702,465,237,613816.53,312841.13,926657.66
421725,202312,41,18,23,23760.25,30360.8,54121.05
421730,202312,22,18,4,23760,5280,29040
421740,202312,131,56,75,73921.33,99000,172921.33
421750,202312,203,145,58,191401.28,76560,267961.28
421755,202312,20,19,1,25080,1320,26400
421760,202312,117,83,34,109563.79,44880.39,154444.18
421770,202312,771,493,278,650784.27,366961.91,1017746.18
421775,202312,28,18,10,23760.87,13200.09,36960.96
421780,202312,201,151,50,199321.33,66000,265321.33
421790,202312,157,136,21,179522.27,27720.72,207242.99
421795,202312,19,13,6,17160.33,7920,25080.33
421800,202312,674,407,267,537267.97,353766.21,891034.18
421810,202312,76,63,13,83161.38,17160,100321.38
421820,202312,366,239,127,315488.43,167640,483128.43
421825,202312,191,157,34,207247.24,44880,252127.24
421830,202312,196,123,73,162369.89,96360.15,258730.04
421835,202312,6,2,4,2640.43,5280,7920.43
421840,202312,54,43,11,56761.51,14520.82,71282.33
421850,202312,80,65,15,85800.5,19800,105600.5
421860,202312,41,29,12,38280.73,15840,54120.73
421870,202312,1364,966,398,1275176.04,525370.71,1800546.75
421875,202312,51,39,12,51480,15840,67320
421880,202312,214,152,62,200642.53,81840.7,282483.23
421885,202312,20,15,5,19800,6600.84,26400.84
421890,202312,190,135,55,178208.98,72601.33,250810.31
421895,202312,54,48,6,63361.42,7920,71281.42
421900,202312,144,106,38,139929.08,50160,190089.08
421910,202312,77,47,30,62040.91,39600,101640.91
421915,202312,35,29,6,38280,7920,46200
421917,202312,55,42,13,55440.91,17160,72600.91
421920,202312,41,36,5,47520,6600,54120
421930,202312,692,556,136,733943.07,179521.25,913464.32
421935,202312,47,37,10,48840,13200,62040
421940,202312,58,50,8,66000,10560,76560
421950,202312,1000,672,328,887052.43,432963.61,1320016.04
421960,202312,45,37,8,48840,10560,59400
421970,202312,349,217,132,286445.95,174241.31,460687.26
421985,202312,22,14,8,18480.2,10560,29040.2
422000,202312,27,19,8,25083.11,10560,35643.11
430003,202312,212,66,146,87120.8,192720,279840.8
430005,202312,32,24,8,31680.53,10560,42240.53
430010,202312,273,198,75,262685.36,99000,361685.36
430020,202312,147,104,43,137281.54,56760.24,194041.78
430030,202312,140,111,29,146523.4,38280,184803.4
430040,202312,3221,1895,1326,2501451.35,1750326.37,4251777.72
430045,202312,87,78,9,102960.2,11880,114840.2
430047,202312,6,5,1,6600,1320,7920
430050,202312,93,79,14,104281.28,18480,122761.28
430055,202312,16,14,2,18480,2640,21120
430057,202312,6,5,1,6600,1320,7920
430060,202312,4937,2885,2052,3811009.18,2711316.71,6522325.89
430063,202312,66,52,14,68640,18480,87120
430064,202312,177,142,35,188760.97,46200,234960.97
430066,202312,8,5,3,6600,3960,10560
430070,202312,40,34,6,44880.28,7920,52800.28
430080,202312,87,59,28,77880.45,36960.18,114840.63
430085,202312,29,14,15,18480,19800,38280
430087,202312,46,35,11,46201.25,14520,60721.25
430090,202312,67,56,11,73920.6,14520,88440.6
430100,202312,171,119,52,157081.88,68640,225721.88
430105,202312,223,136,87,179527.43,114840.72,294368.15
430107,202312,24,20,4,26401.01,5280,31681.01
430110,202312,521,284,237,374880.37,312840.41,687720.78
430120,202312,204,188,16,248160.3,21120,269280.3
430130,202312,882,523,359,690372.02,473882.83,1164254.85
430140,202312,152,138,14,182160,18480,200640
430150,202312,114,72,42,95040.96,55440,150480.96
430155,202312,31,27,4,35640,5280,40920
430160,202312,4252,2385,1867,3149603.89,2464466.9,5614070.79
430163,202312,527,253,274,333969.04,361684.08,695653.12
430165,202312,33,19,14,25080.59,18480,43560.59
430170,202312,89,72,17,95040.89,22440,117480.89
430175,202312,94,75,19,99000,25080,124080
430180,202312,115,89,26,117480.26,34320,151800.26
430185,202312,31,23,8,30360,10560,40920
430187,202312,115,45,70,59401.03,92400,151801.03
430190,202312,266,133,133,175564.15,175561.92,351126.07
430192,202312,13,10,3,13200.73,3960,17160.73
430195,202312,20,16,4,21120.9,5280,26400.9
430200,202312,170,141,29,186123.63,38280,224403.63
430205,202312,20,20,0,26400,0,26400
430210,202312,904,665,239,877819.41,315480,1193299.41
430215,202312,12,12,0,15840,0,15840
430220,202312,79,53,26,69960,34320,104280
430222,202312,14,5,9,6600,11880,18480
430223,202312,22,17,5,22440,6600,29040
430225,202312,5,3,2,3960,2640,6600
430230,202312,403,250,153,330003.06,201960,531963.06
430235,202312,55,35,20,46201.41,26400,72601.41
430237,202312,21,16,5,21120,6600,27720
430240,202312,134,88,46,116161.49,60720.41,176881.90
430245,202312,75,63,12,83160,15840,99000
430250,202312,195,114,81,150482.9,106920,257402.9
430258,202312,14,11,3,14520.28,3960.2,18480.48
430260,202312,39,36,3,48840.1,3960,52800.1
430265,202312,43,37,6,48840,7920,56760
430270,202312,593,403,190,531977.79,250800,782777.79
430280,202312,1218,698,520,921374.93,686400.3,1607775.23
430290,202312,495,254,241,335287.99,318120.2,653408.19
430300,202312,2472,1370,1102,1808465.41,1454654.89,3263120.30
430310,202312,2538,1270,1268,1677801.81,1673790.15,3351591.96
430320,202312,69,56,13,73920,17160,91080
430330,202312,97,83,14,109560.1,18480,128040.1
430340,202312,79,64,15,84480,19800,104280
430350,202312,1877,1159,718,1529898.72,947763.41,2477662.13
430355,202312,21,19,2,25080,2640,27720
430360,202312,120,66,54,87120.3,71280,158400.3
430367,202312,54,39,15,51480,19800,71280
430370,202312,66,58,8,76560.29,10560,87120.29
430380,202312,111,79,32,104281.75,42240,146521.75
430390,202312,756,459,297,605814.48,392044.01,997858.49
430400,202312,270,185,85,244200.07,112200,356400.07
430410,202312,58,48,10,63668.2,13200,76868.2
430420,202312,597,387,210,510852.23,277201.49,788053.72
430430,202312,51,46,5,59840.88,6600,66440.88
430435,202312,163,115,48,151800.83,63360,215160.83
430440,202312,712,429,283,566291.41,373565.4,939856.81
430450,202312,1420,1167,253,1540466.98,333960.9,1874427.88
430460,202312,6922,3564,3358,4707290.91,4435259.18,9142550.09
430461,202312,20,18,2,23760,2640,26400
430462,202312,7,6,1,7921.08,1320,9241.08
430463,202312,1527,845,682,1115432.56,901568.84,2017001.40
430465,202312,28,18,10,23760,13200,36960
430466,202312,879,613,266,809194.96,352447.39,1161642.35
430467,202312,148,79,69,105600.2,91080,196680.2
430468,202312,190,108,82,142561.5,108240.66,250802.16
430469,202312,22,15,7,19800.2,9240,29040.2
430470,202312,1310,731,579,966653.92,765628.57,1732282.49
430471,202312,89,63,26,83164.09,34320.57,117484.66
430480,202312,166,120,46,158401.72,60720,219121.72
430485,202312,9,9,0,11880,0,11880
430490,202312,71,55,16,72600,21120,93720
430495,202312,36,25,11,33000.2,14520,47520.2
430500,202312,209,143,66,190080,87120,277200
430510,202312,4517,2877,1640,3799039.93,2166130.88,5965170.81
430511,202312,15,14,1,18480,1320,19800
430512,202312,203,140,63,184803.54,84480.4,269283.94
430513,202312,63,48,15,63360,19800,83160
430515,202312,24,21,3,27720,3960,31680
430517,202312,191,162,29,215160.2,38280,253440.2
430520,202312,361,256,105,337925.72,139920.26,477845.98
430530,202312,90,49,41,64680.7,54120,118800.7
430535,202312,526,323,203,427685.17,269283.91,696969.08
430537,202312,11,11,0,14520,0,14520
430540,202312,84,59,25,77880,33000,110880
430543,202312,491,152,339,200641.1,447480.6,648121.7
430544,202312,53,48,5,63363.07,6600,69963.07
430545,202312,534,263,271,347182.65,357731.91,704914.56
430550,202312,45,36,9,47520.14,11880.18,59400.32
430558,202312,2,2,0,2640,0,2640
430560,202312,50,29,21,38280,27720,66000
430570,202312,124,51,73,69962.11,96360,166322.11
430580,202312,130,105,25,138600.78,33000,171600.78
430583,202312,15,15,0,19800,0,19800
430585,202312,14,11,3,14520.88,3960,18480.88
430587,202312,13,10,3,13200,3960,17160
430590,202312,218,177,41,233642.84,54120,287762.84
430593,202312,1,1,0,1320,0,1320
430595,202312,18,14,4,18480,5280,23760
430597,202312,44,26,18,34321.17,23760,58081.17
430600,202312,245,177,68,233640,89760,323400
430605,202312,205,119,86,157080,113520,270600
430607,202312,35,27,8,35640,10560,46200
430610,202312,1997,973,1024,1285697.19,1355643.44,2641340.63
430613,202312,5,5,0,6600,0,6600
430620,202312,106,74,32,97680.58,42240,139920.58
430630,202312,48,41,7,54121.13,9240,63361.13
430632,202312,32,28,4,36960,5280,42240
430635,202312,39,32,7,42240,9240,51480
430637,202312,79,35,44,46200,58080,104280
430640,202312,188,114,74,150484.68,97680.54,248165.22
430642,202312,17,15,2,19800,2640,22440
430645,202312,34,27,7,35640,9240,44880
430650,202312,252,201,51,265323.09,67321.15,332644.24
430655,202312,20,16,4,21120.43,5280,26400.43
430660,202312,1099,543,556,716775.53,736565.4,1453340.93
430670,202312,72,50,22,66000,29040,95040
430673,202312,96,65,31,85800.2,40920,126720.2
430675,202312,9,7,2,9240,2640,11880
430676,202312,791,491,300,648237,397323.66,1045560.66
430680,202312,283,188,95,248162.29,126720,374882.29
430690,202312,622,386,236,509530.71,311521.78,821052.49
430692,202312,6,5,1,6600.7,1320,7920.7
430693,202312,151,97,54,128041.64,71280.2,199321.84
430695,202312,74,55,19,72600,25080,97680
430697,202312,69,43,26,56760,34320,91080
430700,202312,1499,1006,493,1329261.51,652081.9,1981343.41
430705,202312,38,31,7,40920.7,9240,50160.7
430710,202312,273,171,102,225720.5,135960,361680.5
430720,202312,102,83,19,109560.4,25080,134640.4
430730,202312,166,141,25,186120,33000,219120
430740,202312,95,61,34,80520.3,44880,125400.3
430745,202312,29,17,12,22440,15840,38280
430750,202312,338,216,122,285122.6,161040.78,446163.38
430755,202312,86,50,36,66000.31,47520,113520.31
430760,202312,488,264,224,348488.96,297001.27,645490.23
430770,202312,2020,1132,888,1494299.3,1172167.2,2666466.5
430780,202312,398,255,143,336601.48,188760,525361.48
430781,202312,26,26,0,34320,0,34320
430783,202312,67,48,19,63360.2,25080,88440.2
430786,202312,8,6,2,7920,2640,10560
430790,202312,610,383,227,505570.18,300962.4,806532.58
430800,202312,171,123,48,162361.1,63360,225721.1
430805,202312,38,30,8,39600,10560,50160
430807,202312,83,49,34,64680,44880,109560
430810,202312,84,56,28,73920.2,36960,110880.2
430820,202312,179,117,62,154445.7,81840,236285.7
430825,202312,11,8,3,10560,3960,14520
430830,202312,297,271,26,357722.98,34320,392042.98
430840,202312,162,108,54,142560.7,71280,213840.7
430843,202312,7,4,3,5280,3960,9240
430845,202312,84,49,35,64680,46200,110880
430850,202312,643,452,191,596647.09,252120,848767.09
430860,202312,201,136,65,179521.64,85800.82,265322.46
430865,202312,86,46,40,60720,52800,113520
430870,202312,72,58,14,76562.29,18480,95042.29
430880,202312,196,136,60,179523.12,79200.8,258723.92
430885,202312,12,10,2,13200,2640,15840
430890,202312,359,221,138,291721.56,183480,475201.56
430900,202312,569,388,181,513488.63,238920.06,752408.69
430905,202312,172,84,88,110881.04,116160.36,227041.40
430910,202312,334,180,154,237603.24,203280.8,440884.04
430912,202312,7,5,2,6600.03,2640,9240.03
430915,202312,42,39,3,51480,3960,55440
430920,202312,5713,2983,2730,3940368.11,3607615.59,7547983.70
430925,202312,6,6,0,7920,0,7920
430930,202312,2531,1436,1095,1895567.2,1445402.36,3340969.56
430940,202312,300,191,109,252121.03,143880.4,396001.43
430950,202312,171,138,33,182161.19,43560,225721.19
430955,202312,32,21,11,27720.7,14520,42240.7
430957,202312,27,25,2,33000.11,2640,35640.11
430960,202312,293,192,101,253442.2,133320.25,386762.45
430965,202312,119,78,41,102960,54120,157080
430970,202312,97,78,19,102960,25080,128040
430975,202312,59,49,10,64681.4,13200,77881.4
430980,202312,57,35,22,46200.33,29040,75240.33
430990,202312,103,82,21,108240,27720,135960
430995,202312,128,115,13,151800,17160,168960
431000,202312,314,157,157,207241.5,207240,414481.5
431010,202312,422,256,166,337937.53,219123.18,557060.71
431020,202312,2164,1254,910,1655307.84,1201202.1,2856509.94
431030,202312,45,35,10,46200.56,13200,59400.56
431033,202312,578,279,299,369624.48,396017.94,765642.42
431036,202312,10,7,3,9240,3960,13200
431040,202312,164,111,53,146520.6,69960.91,216481.51
431041,202312,49,31,18,40920,23760,64680
431043,202312,41,24,17,31680.42,22440,54120.42
431046,202312,12,9,3,11880,3960,15840
431050,202312,227,146,81,192721.96,106920,299641.96
431053,202312,89,49,40,64680.84,52801.11,117481.95
431055,202312,70,44,26,58080,34320,92400
431057,202312,21,21,0,27720,0,27720
431060,202312,1751,1111,640,1466536.51,846122.12,2312658.63
431065,202312,25,13,12,17160,15840,33000
431070,202312,67,58,9,76560,11880,88440
431075,202312,10,9,1,11880,1320,13200
431080,202312,143,81,62,106922.5,81840,188762.5
431085,202312,41,37,4,48840.2,5280,54120.2
431087,202312,21,17,4,22440,5280,27720
431090,202312,50,39,11,51480.5,14520,66000.5
431100,202312,1445,849,596,1120706.18,786723.88,1907430.06
431110,202312,235,146,89,192725,117480.9,310205.9
431112,202312,33,24,9,31680.67,11880,43560.67
431113,202312,30,18,12,23760,15840,39600
431115,202312,158,115,43,151801.48,56760,208561.48
431120,202312,673,397,276,524051,364320.78,888371.78
431123,202312,7,7,0,9240,0,9240
431125,202312,104,93,11,122760,14520,137280
431127,202312,7,5,2,6600,2640,9240
431130,202312,770,501,269,661332.28,355085.6,1016417.88
431140,202312,942,665,277,880450.48,365642.03,1246092.51
431142,202312,18,16,2,21120.56,2640,23760.56
431150,202312,225,154,71,203282.65,93720,297002.65
431160,202312,42,37,5,48840.9,6600,55440.9
431162,202312,6,6,0,7920.65,0,7920.65
431164,202312,8,6,2,7920,2640,10560
431170,202312,127,87,40,114840.2,52800,167640.2
431171,202312,79,43,36,56760,47520,104280
431173,202312,11,10,1,13200,1320.8,14520.8
431175,202312,218,116,102,153122.62,134640.22,287762.84
431177,202312,134,89,45,117481.98,59400.97,176882.95
431179,202312,21,15,6,19800,7920,27720
431180,202312,449,278,171,366965.19,225720,592685.19
431190,202312,73,53,20,69960.4,26400.7,96361.1
431198,202312,86,63,23,83023.78,30360,113383.78
431200,202312,24,18,6,23760,7920,31680
431205,202312,24,23,1,30361.1,1320,31681.1
431210,202312,118,71,47,93720.7,62040,155760.7
431213,202312,32,27,5,35640.62,6600.56,42241.18
431215,202312,27,25,2,33001.54,2640,35641.54
431217,202312,8,7,1,9240.2,1320,10560.2
431220,202312,73,59,14,77881.43,18480,96361.43
431225,202312,187,113,74,149160.24,97680,246840.24
431230,202312,106,82,24,108243.96,31680,139923.96
431235,202312,6,4,2,5280,2640,7920
431237,202312,24,19,5,25080,6600,31680
431238,202312,17,13,4,17160,5280,22440
431240,202312,1163,736,427,971550.11,563642.24,1535192.35
431242,202312,47,44,3,58080,3960,62040
431244,202312,46,36,10,47521.09,13200,60721.09
431245,202312,63,48,15,63360.11,19800,83160.11
431247,202312,22,13,9,17160,11880,29040
431250,202312,343,175,168,231004.33,221760,452764.33
431260,202312,55,45,10,59400,13200,72600
431261,202312,26,19,7,25080.84,9240,34320.84
431262,202312,13,11,2,14520,2640,17160
431265,202312,156,91,65,120121.25,85800,205921.25
431267,202312,21,16,5,21120,6600,27720
431270,202312,367,280,87,369603.52,114842.14,484445.66
431275,202312,40,35,5,46200,6600,52800
431280,202312,22,17,5,22440,6600,29040
431290,202312,29,26,3,34320.39,3960,38280.39
431295,202312,4,1,3,1320,3960,5280
431300,202312,26,20,6,26400.6,7920,34320.6
431301,202312,8,8,0,10560,0,10560
431303,202312,65,40,25,52800,33000,85800
431306,202312,256,130,126,171601.45,168960,340561.45
431308,202312,8,7,1,9240.8,1320,10560.8
431310,202312,61,47,14,62040.48,18480,80520.48
431320,202312,290,182,108,240241.32,142560,382801.32
431330,202312,235,164,71,216484.13,93720,310204.13
431333,202312,30,24,6,31680,7920,39600
431335,202312,12,8,4,10560.39,5280,15840.39
431337,202312,506,249,257,328691.37,340566.11,669257.48
431339,202312,25,19,6,26400.02,7920,34320.02
431340,202312,3694,2024,1670,2671530.42,2207053.05,4878583.47
431342,202312,42,27,15,35640,19800,55440
431344,202312,30,30,0,39600.2,0,39600.2
431346,202312,5,4,1,5280,1320,6600
431349,202312,34,32,2,42240,2640,44880
431350,202312,1147,660,487,871238.44,642847.21,1514085.65
431360,202312,61,43,18,56760,23760,80520
431365,202312,420,184,236,242883.16,311520.49,554403.65
431370,202312,1349,776,573,1024476.09,756364.41,1780840.50
431380,202312,111,96,15,126721.7,19800,146521.7
431390,202312,545,312,233,411844.61,310200,722044.61
431395,202312,350,158,192,208561.37,253440,462001.37
431400,202312,40,23,17,30360,22440,52800
431402,202312,93,66,27,87121.82,35640.81,122762.63
431403,202312,34,24,10,31680,13200,44880
431405,202312,878,535,343,706223.13,452764.47,1158987.60
431406,202312,39,32,7,42240.14,9240,51480.14
431407,202312,51,40,11,52800,14520,67320
431410,202312,3972,2440,1532,3222225.23,2023582.56,5245807.79
431413,202312,15,12,3,15840,3960,19800
431415,202312,84,64,20,84480.6,26400,110880.6
431417,202312,24,14,10,18480,13200,31680
431420,202312,412,270,142,356406.1,187440.9,543847.0
431430,202312,72,33,39,43560.99,51480,95040.99
431440,202312,10848,7308,3540,9653519.04,4674233.78,14327752.82
431442,202312,28,15,13,19800,17160,36960
431445,202312,31,29,2,38280,2640,40920
431446,202312,6,6,0,7920.71,0,7920.71
431447,202312,91,70,21,92400.16,27720,120120.16
431449,202312,70,58,12,76560.28,15840,92400.28
431450,202312,451,293,158,386762.68,208560,595322.68
431454,202312,14,8,6,10560,7920,18480
431455,202312,49,37,12,48840.03,15840,64680.03
431460,202312,544,371,173,489729.56,228360,718089.56
431470,202312,145,109,36,143880.25,47520,191400.25
431475,202312,12,10,2,13200,2640,15840
431477,202312,44,28,16,36960.58,21120,58080.58
431478,202312,7,7,0,9240,0,9240
431480,202312,837,521,316,687735.52,418442.59,1106178.11
431490,202312,36833,20975,15858,27706661.95,20960533.5,48667195.45
431500,202312,79,56,23,73920,30360,104280
431505,202312,33,25,8,33000.85,10560,43560.85
431507,202312,9,8,1,10560,1320,11880
431510,202312,251,183,68,241561.78,89760,331321.78
431513,202312,19,18,1,23762.06,1320,25082.06
431514,202312,9,5,4,6600,5280,11880
431515,202312,95,80,15,106920.05,19800,126720.05
431517,202312,9,7,2,9240,2640,11880
431520,202312,42,33,9,43560.2,11880,55440.2
431530,202312,1518,670,848,884414.95,1119361.45,2003776.40
431531,202312,24,22,2,29040.7,2640,31680.7
431532,202312,38,27,11,35640,14520,50160
431535,202312,31,18,13,23760,17160,40920
431540,202312,153,123,30,162362.88,39600,201962.88
431545,202312,12,9,3,11880,3960,15840
431550,202312,400,206,194,271927.29,256081.7,528008.99
431555,202312,18,15,3,19800.2,3960,23760.2
431560,202312,5770,3864,1906,5102014.99,2515972.87,7617987.86
431570,202312,999,543,456,716772.97,601925.62,1318698.59
431575,202312,61,39,22,51480.45,29040,80520.45
431580,202312,90,67,23,88440,30360,118800
431590,202312,160,134,26,176880.2,34320,211200.2
431595,202312,18,16,2,21120.8,2640,23760.8
431600,202312,282,166,116,219128.28,153122.13,372250.41
431610,202312,121,90,31,118801.4,40920.2,159721.6
431620,202312,36,28,8,36960,10560,47520
431630,202312,132,104,28,137280.79,36960,174240.79
431640,202312,1429,883,546,1165580.66,720722.38,1886303.04
431642,202312,34,29,5,38280,6600,44880
431643,202312,47,20,27,26400,35640,62040
431645,202312,359,215,144,283801.36,190080,473881.36
431647,202312,16,15,1,19800,1320,21120
431650,202312,35,20,15,26400,19800,46200
431660,202312,259,166,93,219121.43,122760,341881.43
431670,202312,254,112,142,147841.85,187440.49,335282.34
431673,202312,14,12,2,15840,2640,18480
431675,202312,30,22,8,29040,10560,39600
431680,202312,1369,989,380,1305539.24,501607.72,1807146.96
431690,202312,5798,3370,2428,4451226.58,3208963.67,7660190.25
431695,202312,15,10,5,13200.2,6600,19800.2
431697,202312,7,5,2,6600,2640,9240
431700,202312,211,157,54,207240.75,71280,278520.75
431710,202312,4698,2003,2695,2645321.76,3558736.11,6204057.87
431720,202312,1410,880,530,1162275.64,700920.83,1863196.47
431725,202312,3,1,2,1320,2640,3960
431730,202312,1362,875,487,1155058.74,642849.12,1797907.86
431740,202312,1406,680,726,897615.17,958324.3,1855939.47
431750,202312,1993,1321,672,1745071.9,887044.32,2632116.22
431755,202312,5,4,1,5280,1320,6600
431760,202312,1092,697,395,920062.38,521404.42,1441466.80
431770,202312,441,286,155,377524.15,204600,582124.15
431775,202312,27,19,8,25080,10560,35640
431780,202312,616,373,243,492362.91,320760,813122.91
431790,202312,149,117,32,154442.01,42240.1,196682.11
431795,202312,14,12,2,15840,2640,18480
431800,202312,3422,1788,1634,2361518.94,2159531.07,4521050.01
431805,202312,20,16,4,21120,5280,26400
431810,202312,604,391,213,516128.23,281160,797288.23
431820,202312,395,221,174,291721.86,229680.2,521402.06
431830,202312,2640,1617,1023,2134402.09,1350363.49,3484765.58
431840,202312,564,360,204,476537.09,269282.47,745819.56
431842,202312,39,31,8,40920,10560,51480
431843,202312,9,7,2,9240.9,2640,11880.9
431844,202312,19,14,5,18480,6600,25080
431845,202312,28,26,2,35640,2640,38280
431846,202312,31,26,5,34320.72,6600,40920.72
431848,202312,14,11,3,14520,3960,18480
431849,202312,8,7,1,9240,1320,10560
431850,202312,912,715,197,945148.43,260042.52,1205190.95
431860,202312,124,80,44,105600.31,58080,163680.31
431861,202312,5,1,4,1320,5280,6600
431862,202312,69,48,21,63360.65,27720,91080.65
431870,202312,4500,2669,1831,3524547.78,2418275.36,5942823.14
431880,202312,1117,784,333,1034898.27,439561.75,1474460.02
431890,202312,1346,769,577,1016417.14,762960.78,1779377.92
431900,202312,210,135,75,178200.24,99000,277200.24
431910,202312,50,39,11,51480.1,14520,66000.1
431912,202312,59,42,17,55537.76,22440,77977.76
431915,202312,167,132,35,174240.73,46200,220440.73
431920,202312,171,121,50,159720.35,66000,225720.35
431930,202312,84,67,17,88440,22440,110880
431935,202312,6,5,1,6600,1320,7920
431936,202312,5,5,0,6600.66,0,6600.66
431937,202312,25,19,6,25080,7920,33000
431940,202312,497,343,154,452767.88,203280.19,656048.07
431950,202312,534,333,201,439574.31,265322.31,704896.62
431960,202312,822,457,365,603252.59,481800,1085052.59
431970,202312,65,59,6,77880,7920,85800
431971,202312,7,6,1,7920,1320,9240
431973,202312,21,17,4,22440.88,5280,27720.88
431975,202312,12,11,1,14520.2,1320,15840.2
431980,202312,234,138,96,182160.47,126720,308880.47
431990,202312,1135,635,500,839554.18,661330.03,1500884.21
432000,202312,2382,1317,1065,1741158.6,1409780.57,3150939.17
432010,202312,269,176,93,232321.75,122760.2,355081.95
432020,202312,212,179,33,236284.08,43560.4,279844.48
432023,202312,20,17,3,22440,3960,26400
432026,202312,69,61,8,80520.75,10560,91080.75
432030,202312,55,25,30,33000.67,39600,72600.67
432032,202312,16,13,3,17160,3960,21120
432035,202312,95,74,21,97680,27720,125400
432040,202312,93,66,27,87121.34,35640,122761.34
432045,202312,4,4,0,5280,0,5280
432050,202312,84,52,32,68640,42240,110880
432055,202312,150,105,45,138601.56,59400,198001.56
432057,202312,7,4,3,5280,3960,9240
432060,202312,30,25,5,33000,6600,39600
432065,202312,33,28,5,36960,6600,43560
432067,202312,87,75,12,99000.4,15840,114840.4
432070,202312,425,341,84,450125.36,110880,561005.36
432080,202312,926,655,271,865960.06,359043.06,1225003.12
432085,202312,27,23,4,30360.36,5280,35640.36
432090,202312,296,197,99,260040.4,130680,390720.4
432100,202312,185,119,66,157081.11,87120,244201.11
432110,202312,622,410,212,542526.69,279840.67,822367.36
432120,202312,1216,701,515,925338.87,681124.31,1606463.18
432130,202312,593,421,172,555725.41,227040,782765.41
432132,202312,21,19,2,25080,2640,27720
432135,202312,85,64,21,84481.49,27720,112201.49
432140,202312,289,215,74,283805.13,97680.9,381486.03
432143,202312,263,162,101,213842.66,133320.93,347163.59
432145,202312,352,251,101,331323.6,133320,464643.6
432146,202312,19,16,3,21120,3960,25080
432147,202312,105,65,40,85800,52800,138600
432149,202312,13,12,1,15840,1320,17160
432150,202312,1324,853,471,1125985.17,621722.78,1747707.95
432160,202312,2372,1226,1146,1618360.52,1515376.34,3133736.86
432162,202312,8,4,4,5280,5280,10560
432163,202312,17,12,5,15840,6600,22440
432166,202312,147,104,43,137614.91,56761.23,194376.14
432170,202312,266,143,123,188768.58,162360.9,351129.48
432180,202312,609,399,210,526680.63,277200,803880.63
432183,202312,23,20,3,26401.22,3960,30361.22
432185,202312,85,71,14,93720.23,18480,112200.23
432190,202312,603,359,244,475203.44,322080.44,797283.88
432195,202312,101,79,22,104281.5,29040,133321.5
432200,202312,504,315,189,415807.77,249481.9,665289.67
432210,202312,132,79,53,104280.72,69960,174240.72
432215,202312,33,30,3,39600,3960,43560
432218,202312,21,21,0,27720,0,27720
432220,202312,720,357,363,471252,480484.39,951736.39
432225,202312,20,15,5,19800.1,6600,26400.1
432230,202312,133,87,46,114840,60720.3,175560.3
432232,202312,37,33,4,43560.4,5280,48840.4
432234,202312,5,3,2,3960,2640,6600
432235,202312,2,2,0,2640,0,2640
432237,202312,26,19,7,25080,9240,34320
432240,202312,5081,2850,2231,3766066.63,2944947.13,6711013.76
432250,202312,1342,915,427,1207817.52,564960.63,1772778.15
432252,202312,51,46,5,60720.2,6600,67320.2
432253,202312,81,61,20,80521.9,26400,106921.9
432254,202312,33,17,16,22440,21120,43560
432255,202312,11,10,1,13200,1320,14520
432260,202312,1004,799,205,1058401.85,270600.1,1329001.95
432270,202312,261,199,62,262693.01,81844.25,344537.26
432280,202312,190,142,48,187444.2,63360,250804.2
432285,202312,3,3,0,3960,0,3960
432290,202312,62,50,12,66000,15840,81840
432300,202312,6011,3288,2723,4342682.96,3597037.41,7939720.37
432310,202312,149,123,26,162360.97,34320,196680.97
432320,202312,25,18,7,23760,9240,33000
432330,202312,18,11,7,14520,9240,23760
432335,202312,11,7,4,9240,5280,14520
432340,202312,36,29,7,38280,9240,47520
432345,202312,140,94,46,124082.32,60720,184802.32
432350,202312,23,22,1,29040,1320,30360
432360,202312,6,5,1,6600.7,1320,7920.7
432370,202312,26,26,0,34320.68,0,34320.68
432375,202312,31,29,2,38280,2640,40920
432377,202312,8,8,0,10560.48,0,10560.48
432380,202312,269,131,138,172921.54,182163.71,355085.25
500020,202312,343,172,171,227042.8,225720,452762.8
500025,202312,161,78,83,102962.21,109561.12,212523.33
500060,202312,1721,1115,606,1471848.54,799928.66,2271777.20
500070,202312,855,430,425,568935.31,561008.83,1129944.14
500080,202312,160,133,27,175565.12,35640,211205.12
500085,202312,174,126,48,166322.25,63360,229682.25
500090,202312,431,202,229,266646.46,302282.62,568929.08
500100,202312,760,393,367,520094.14,484442.22,1004536.36
500110,202312,2571,1285,1286,1696249.42,1697535.88,3393785.30
500124,202312,318,161,157,212521.99,207241.66,419763.65
500150,202312,335,137,198,180841.86,261360.65,442202.51
500190,202312,637,431,206,568944.21,271922.19,840866.40
500200,202312,228,184,44,242885.21,58080,300965.21
500210,202312,1922,608,1314,802572.24,1734492.43,2537064.67
500215,202312,220,126,94,167645.72,124080.2,291725.92
500220,202312,818,509,309,671909.16,407882.05,1079791.21
500230,202312,281,161,120,212523.77,158401.14,370924.91
500240,202312,726,451,275,595336.03,363001.76,958337.79
500260,202312,645,268,377,353765.08,497640.46,851405.54
500270,202312,35539,15853,19686,20931718.18,25999070.23,46930788.41
500280,202312,220,81,139,106920.67,183480.66,290401.33
500290,202312,1311,827,484,1094307.78,638884.62,1733192.40
500295,202312,556,369,187,487089.63,246840.34,733929.97
500310,202312,132,42,90,55440,118800.5,174240.5
500315,202312,972,530,442,699601.76,583442.56,1283044.32
500320,202312,4267,2008,2259,2651977.98,2981890.99,5633868.97
500325,202312,1056,602,454,794669.3,599283.66,1393952.96
500330,202312,1720,863,857,1140435.47,1131252.88,2271688.35
500345,202312,346,239,107,315488.26,141240.21,456728.47
500348,202312,292,179,113,236283.9,149160,385443.9
500350,202312,109,49,60,64682.17,79201.14,143883.31
500370,202312,6648,3121,3527,4121667.24,4656989.1,8778656.34
500375,202312,405,264,141,348485.1,186120.9,534606.0
500380,202312,752,413,339,545177.97,447483.81,992661.78
500390,202312,92,39,53,51480.1,69960.2,121440.3
500400,202312,252,147,105,195366.01,138600.97,333966.98
500410,202312,472,215,257,283810.4,339244.09,623054.49
500430,202312,677,412,265,543855.27,349802.14,893657.41
500440,202312,220,130,90,171601.36,120120.2,291721.56
500450,202312,489,214,275,282484.58,363001,645485.58
500460,202312,313,169,144,223086.1,190080.96,413167.06
500470,202312,496,346,150,456730.26,198000.49,654730.75
500480,202312,131,76,55,100323.06,73920.8,174243.86
500490,202312,112,53,59,69960.68,77883.02,147843.70
500500,202312,1685,635,1050,839547.62,1387327.42,2226875.04
500510,202312,44,36,8,47520.31,10560,58080.31
500515,202312,137,92,45,121442.74,59401.53,180844.27
500520,202312,343,174,169,229686.64,223080.16,452766.80
500525,202312,102,51,51,67320.14,67320,134640.14
500540,202312,1023,454,569,599304.84,751086.69,1350391.53
500560,202312,976,550,426,726015.6,563642.86,1289658.46
500568,202312,1336,591,745,780140.92,984725.76,1764866.68
500570,202312,1366,780,586,1030940.53,774842.4,1805782.93
500580,202312,323,177,146,233647.07,192721.02,426368.09
500600,202312,460,216,244,285126.34,322081.04,607207.38
500620,202312,1197,849,348,1120715.74,459368.3,1580084.04
500625,202312,94,69,25,91080.56,33000,124080.56
500627,202312,56,26,30,34320,39600,73920
500630,202312,1783,1058,725,1397358.84,958323.28,2355682.12
500635,202312,551,325,226,429001.26,298320,727321.26
500640,202312,384,208,176,274571.46,232322.5,506893.96
500660,202312,6958,2477,4481,3269724.54,5917597.68,9187322.22
500690,202312,716,257,459,339246.62,605880.26,945126.88
500710,202312,457,224,233,295689.47,310205.89,605895.36
500720,202312,1089,606,483,799939.84,637562.69,1437502.53
500730,202312,145,91,54,120124.81,71280,191404.81
500740,202312,1071,473,598,624376.31,789365.24,1413741.55
500750,202312,241,96,145,126722.7,191402.81,318125.51
500755,202312,124,92,32,121444.31,42240.93,163685.24
500769,202312,834,467,367,616459.61,484443.27,1100902.88
500770,202312,490,264,226,348482.06,298320,646802.06
500780,202312,145,96,49,126725.19,64681.33,191406.52
500790,202312,1252,607,645,801268.19,851403.71,1652671.90
500793,202312,334,179,155,236284.55,204602.83,440887.38
500795,202312,229,144,85,190083.82,112200.7,302284.52
500797,202312,52,39,13,51480.29,17160,68640.29
500800,202312,488,207,281,273246.45,370922.48,644168.93
500830,202312,2718,1390,1328,1837518.63,1754290.49,3591809.12
500840,202312,117,85,32,112204.57,42240.59,154445.16
510010,202312,179,100,79,132000,104280,236280
510020,202312,582,290,292,382815.51,386765.96,769581.47
510025,202312,2037,1186,851,1565566.16,1124651.17,2690217.33
510030,202312,699,377,322,497657.9,425046.71,922704.61
510035,202312,137,72,65,95040.78,85800,180840.78
510040,202312,441,206,235,271922.03,310201.63,582123.66
510050,202312,406,211,195,278522.41,257400,535922.41
510060,202312,151,71,80,93723.61,105600,199323.61
510080,202312,268,118,150,155761.28,198000,353761.28
510100,202312,69,29,40,38281.43,54121.08,92402.51
510120,202312,34,20,14,26400.99,18480.78,44881.77
510125,202312,431,277,154,365645.27,203280.21,568925.48
510130,202312,575,338,237,446171.88,312842.8,759014.68
510140,202312,508,178,330,234961.15,435600.46,670561.61
510160,202312,118,50,68,66001.92,89761.31,155763.23
510170,202312,876,516,360,681134.27,475205.57,1156339.84
510180,202312,3307,1501,1806,1981385.84,2385260.19,4366646.03
510185,202312,46,24,22,31680.7,29040,60720.7
510190,202312,300,116,184,153121.92,242881.49,396003.41
510250,202312,3089,1874,1215,2473732.49,1606445.1,4080177.59
510260,202312,186,134,52,176882.26,68640.91,245523.17
510263,202312,547,312,235,411848.98,310205.07,722054.05
510267,202312,717,407,310,537262.64,409202.52,946465.16
510268,202312,85,43,42,56760.55,55440,112200.55
510269,202312,87,40,47,52800,62040.5,114840.5
510270,202312,409,194,215,256081.65,283800.6,539882.25
510279,202312,250,182,68,240241.72,89760.42,330002.14
510285,202312,201,87,114,114841.3,150480,265321.3
510300,202312,586,312,274,411846.17,363004.03,774850.20
510305,202312,232,101,131,133320.33,174240,307560.33
510310,202312,121,59,62,77881.36,81840.1,159721.46
510320,202312,922,583,339,769576.2,447482.85,1217059.05
510325,202312,492,215,277,283804.6,365643.47,649448.07
510330,202312,516,290,226,382809.02,298322.05,681131.07
510335,202312,761,465,296,613814.34,390725.22,1004539.56
510336,202312,59,42,17,55441.84,22440,77881.84
510337,202312,114,48,66,63360,87120,150480
510340,202312,21631,9352,12279,12350361.03,16215112.81,28565473.84
510343,202312,66,53,13,69960,17160,87120
510345,202312,164,100,64,132002.82,84480.68,216483.50
510350,202312,734,397,337,524053.05,444846.45,968899.50
510360,202312,234,143,91,188764.5,120120,308884.5
510370,202312,184,83,101,109560,133320.7,242880.7
510380,202312,83,60,23,79200,30360,109560
510385,202312,62,33,29,43560.2,38280,81840.2
510390,202312,100,48,52,63360.4,68640.6,132001.0
510395,202312,60,43,17,56760.9,22440,79200.9
510410,202312,955,619,336,817108.24,443524.37,1260632.61
510420,202312,597,299,298,394684.7,393360.7,788045.4
510450,202312,56,33,23,43560,30360,73920
510452,202312,64,32,32,42240,42240,84480
510454,202312,59,27,32,35640,42240.03,77880.03
510455,202312,127,76,51,100320.82,67320.97,167641.79
510460,202312,228,108,120,142562.79,158400,300962.79
510480,202312,848,491,357,648144.83,471252.09,1119396.92
510490,202312,362,177,185,233642.57,244200.5,477843.07
510500,202312,252,189,63,249480.43,83160,332640.43
510510,202312,967,570,397,752420.12,524046.36,1276466.48
510515,202312,1458,782,676,1033583.88,892325.73,1925909.61
510517,202312,300,134,166,176883.9,219120,396003.9
510520,202312,258,163,95,215164.87,125401.32,340566.19
510523,202312,132,105,27,138600,35640,174240
510525,202312,982,608,374,802579.81,493681.9,1296261.71
510530,202312,34,15,19,19800,25080,44880
510550,202312,270,125,145,165002.5,191401.62,356404.12
510558,202312,346,175,171,231002.34,225720,456722.34
510560,202312,428,255,173,336605.75,228362.9,564968.65
510562,202312,753,536,217,707546.34,286441.98,993988.32
510590,202312,763,357,406,471252.59,535924.34,1007176.93
510600,202312,222,121,101,159726.01,133320.47,293046.48
510610,202312,243,113,130,149164.72,171601.4,320766.12
510615,202312,252,120,132,158400.65,174241.35,332642.00
510617,202312,27,11,16,14520,21120,35640
510618,202312,134,71,63,93720,83161.86,176881.86
510619,202312,88,60,28,79201.47,36960,116161.47
510620,202312,167,91,76,120120.7,100320,220440.7
510621,202312,184,123,61,162360.32,80520.23,242880.55
510622,202312,569,295,274,389418.09,361683.28,751101.37
510623,202312,315,211,104,278524.31,137280.2,415804.51
510624,202312,124,58,66,76561.62,87120.92,163682.54
510625,202312,608,368,240,485774.52,316805.19,802579.71
510626,202312,136,80,56,105602.07,73921.42,179523.49
510627,202312,111,75,36,99001.43,47520,146521.43
510628,202312,184,114,70,150481.87,92400,242881.87
510629,202312,335,210,125,277202,165023.76,442225.76
510630,202312,525,274,251,361695.16,331322.11,693017.27
510631,202312,24,10,14,13200.13,18480,31680.13
510637,202312,389,225,164,297002.46,216481.08,513483.54
510642,202312,1383,762,621,1005858.37,819725.68,1825584.05
510645,202312,14,5,9,6600,11880,18480
510650,202312,1316,841,475,1110167.52,627003.51,1737171.03
510665,202312,110,51,59,67320.14,77880.08,145200.22
510670,202312,60,36,24,47520.72,31680,79200.72
510675,202312,1230,792,438,1045472.1,578164.46,1623636.56
510677,202312,389,212,177,279843.16,233640.42,513483.58
510680,202312,96,61,35,80521.87,46200,126721.87
510682,202312,215,104,111,137280.9,146520,283800.9
510685,202312,65,45,20,59400.97,26400.8,85801.77
510700,202312,656,381,275,502937.75,363005.16,865942.91
510704,202312,1519,781,738,1030961.04,974173.23,2005134.27
510706,202312,180,92,88,121443.37,116161.26,237604.63
510710,202312,488,352,136,464646.94,179520,644166.94
510715,202312,60,40,20,52800,26400.2,79200.2
510718,202312,269,124,145,163683.38,191403.65,355087.03
510719,202312,60,30,30,39600,39600,79200
510720,202312,200,143,57,188893.85,75240,264133.85
510724,202312,80,31,49,40920,64680,105600
510726,202312,69,37,32,48840.7,42240.62,91081.32
510729,202312,14,5,9,6600,11880.3,18480.3
510730,202312,506,255,251,336602.46,331320.54,667923.00
510735,202312,127,48,79,63360,104280,167640
510740,202312,29,18,11,23760.98,14521.24,38282.22
510757,202312,44,37,7,48840.35,9240.16,58080.51
510760,202312,8696,4445,4251,5868862.76,5612685.58,11481548.34
510770,202312,797,361,436,476529.26,575525,1052054.26
510774,202312,19,8,11,10560.69,14520,25080.69
510775,202312,130,105,25,139920,33000,172920
510776,202312,42,16,26,21120.84,34320.2,55441.04
510777,202312,197,87,110,114840,145200,260040
510779,202312,38,24,14,31680,18480,50160
510780,202312,317,166,151,219129.26,199320,418449.26
510785,202312,369,204,165,270605.97,217801.71,488407.68
510787,202312,245,125,120,165006.3,158400.9,323407.2
510788,202312,13,5,8,6600.9,10560,17160.9
510790,202312,3172,1639,1533,2163603.75,2023565.62,4187169.37
510792,202312,1241,692,549,913581.17,727328.25,1640909.42
510794,202312,132,74,58,97681.71,76560,174241.71
510795,202312,2623,1468,1155,1937804.13,1524606.22,3462410.35
510800,202312,206,110,96,145201.56,126720,271921.56
510805,202312,236,162,74,213840.9,97680,311520.9
510810,202312,109,43,66,56762.15,87120.42,143882.57
510820,202312,271,138,133,182162.54,175562.26,357724.80
510830,202312,93,51,42,67320.5,55440,122760.5
510835,202312,28,21,7,27720.7,9240,36960.7
510840,202312,10889,4952,5937,6538218.64,7842195.54,14380414.18
510850,202312,221,87,134,114840.54,176880.26,291720.80
510860,202312,468,236,232,311523.54,306242.35,617765.89
510880,202312,84,60,24,79200.2,31680,110880.2
510885,202312,74,41,33,54121.16,43560.16,97681.32
510890,202312,87,45,42,59400.94,55440.26,114841.20
510895,202312,205,121,84,159720.73,110880,270600.73
520005,202312,188,80,108,105604.06,142562.54,248166.60
520010,202312,376,174,202,229683.25,266642.47,496325.72
520013,202312,841,594,247,784755.06,327363.76,1112118.82
520015,202312,44,29,15,38280,19800,58080
520017,202312,93,59,34,77880.84,44880,122760.84
520020,202312,12,6,6,7920,7920,15840
520025,202312,3742,2094,1648,2765521.5,2178060.45,4943581.95
520030,202312,1042,550,492,726013.82,650765.08,1376778.90
520050,202312,67,50,17,66000.2,22440.9,88441.1
520055,202312,90,64,26,84480,34320.2,118800.2
520060,202312,214,144,70,191405,92401.25,283806.25
520080,202312,647,467,180,616441.47,238920.55,855362.02
520082,202312,21,12,9,15840,11880,27720
520085,202312,135,111,24,146520.18,31680,178200.18
520090,202312,92,67,25,88440,33000,121440
520110,202312,10879,4685,6194,6187013.18,8181427.79,14368440.97
520120,202312,13,9,4,11880,5280,17160
520130,202312,1005,718,287,947775.4,378840.98,1326616.38
520140,202312,14234,7769,6465,10257031.8,8539181.68,18796213.48
520145,202312,74,40,34,52800.2,44880,97680.2
520150,202312,141,109,32,143885.16,42240,186125.16
520160,202312,50,33,17,43560,22440,66000
520170,202312,223,122,101,161045.93,133320.83,294366.76
520180,202312,232,112,120,147841.81,158401.16,306242.97
520215,202312,222,162,60,213840.37,79200.2,293040.57
520235,202312,99,74,25,97680,33000,130680
520250,202312,185,92,93,121442.23,122760,244202.23
520260,202312,145,93,52,122765.53,68642.48,191408.01
520280,202312,60,43,17,56760,22440,79200
520310,202312,43,20,23,26402.22,30361.46,56763.68
520320,202312,218,133,85,175562.96,112200.97,287763.93
520330,202312,961,539,422,711499.03,557043.98,1268543.01
520340,202312,320,184,136,242893.08,179522.74,422415.82
520350,202312,524,272,252,359043.7,332643.8,691687.5
520355,202312,115,70,45,92401.4,59400,151801.4
520357,202312,46,35,11,46200,14520,60720
520360,202312,25,11,14,14520.4,18480.2,33000.6
520380,202312,156,89,67,117480.9,88440,205920.9
520390,202312,250,114,136,150484.5,179520.59,330005.09
520393,202312,22,17,5,22440.1,6600,29040.1
520396,202312,84,60,24,79200,31680,110880
520400,202312,227,143,84,188763.27,110881.1,299644.37
520410,202312,224,123,101,162365.53,133320,295685.53
520420,202312,26,19,7,25080.65,9240,34320.65
520425,202312,265,125,140,165002.01,184800.18,349802.19
520430,202312,609,289,320,381481.74,422400.9,803882.64
520440,202312,802,587,215,774853.03,283801.33,1058654.36
520450,202312,2529,1124,1405,1485052.16,1854619.81,3339671.97
520455,202312,86,50,36,66003.43,47520.71,113524.14
520460,202312,53,34,19,44881.68,25081.13,69962.81
520465,202312,48,42,6,55440,7920,63360
520470,202312,519,315,204,415803.94,269280,685083.94
520480,202312,79,52,27,68640.67,35640,104280.67
520485,202312,119,49,70,64680.83,92400.1,157080.93
520490,202312,620,457,163,603251.07,215163.98,818415.05
520495,202312,186,114,72,150480.3,95040.9,245521.2
520500,202312,281,230,51,303602.11,67320,370922.11
520505,202312,197,116,81,153120,106920,260040
520510,202312,2440,1163,1277,1536513.1,1685649.14,3222162.24
520520,202312,74,49,25,64681.67,33000,97681.67
520530,202312,223,178,45,234966.93,59400,294366.93
520540,202312,913,634,279,836897.22,368282.44,1205179.66
520545,202312,181,111,70,146523.97,92400.6,238924.57
520547,202312,89,50,39,66003.01,51480.1,117483.11
520549,202312,1803,915,888,1207851.5,1172176.2,2380027.7
520551,202312,374,206,168,271921.33,221761.23,493682.56
520552,202312,67,50,17,66002.82,22440,88442.82
520570,202312,20,15,5,19800,6600,26400
520580,202312,310,195,115,257539.68,151800.79,409340.47
520590,202312,169,96,73,126722.37,96360,223082.37
520620,202312,1449,679,770,898935.15,1016407.96,1915343.11
520630,202312,60,32,28,42240,36960.18,79200.18
520640,202312,430,257,173,339245.86,228360.9,567606.76
520650,202312,83,39,44,51480,58080,109560
520660,202312,48,25,23,33000.55,30360.38,63360.93
520670,202312,47,34,13,44880.22,17160,62040.22
520680,202312,29,18,11,23760,14520,38280
520690,202312,43,12,31,15840,40920,56760
520710,202312,39,28,11,36960,14520,51480
520725,202312,212,155,57,204603.56,75240,279843.56
520735,202312,70,43,27,56760.2,35640.2,92400.4
520740,202312,504,256,248,337925.8,327361.22,665287.02
520750,202312,42,26,16,34320,21120,55440
520753,202312,88,65,23,85800.76,30360,116160.76
520760,202312,117,84,33,110881.51,43560,154441.51
520780,202312,290,224,66,295684,87121.63,382805.63
520790,202312,154,97,57,128040.4,75240,203280.4
520800,202312,3922,2266,1656,2992515.59,2185935.01,5178450.60
520810,202312,143,110,33,145643.52,43560.89,189204.41
520815,202312,10,8,2,10560.91,2640,13200.91
520830,202312,135,96,39,126724.25,51480.2,178204.45
520840,202312,457,293,164,388081.27,217800,605881.27
520850,202312,116,65,51,85802.06,67320,153122.06
520860,202312,2099,1325,774,1749042.36,1021686.32,2770728.68
520870,202312,39659,18114,21545,23925716.86,28464787.71,52390504.57
520880,202312,1563,843,720,1115443.73,950417.16,2065860.89
520890,202312,941,620,321,819738.99,423722.63,1243461.62
520910,202312,1071,547,524,722062.84,691683.2,1413746.04
520915,202312,103,69,34,91081.31,44880,135961.31
520920,202312,608,297,311,392051.69,413166.84,805218.53
520929,202312,18,16,2,21120.24,2640,23760.24
520940,202312,68,51,17,68641.93,22440.1,91082.03
520945,202312,19,11,8,14520,10560,25080
520960,202312,53,31,22,40920,29040,69960
520970,202312,517,298,219,393367.79,289085.17,682452.96
520980,202312,99,72,27,95040,35640,130680
520990,202312,472,337,135,444842.6,178200.24,623042.84
520993,202312,123,65,58,85802.89,76560.09,162362.98
520995,202312,298,169,129,223083.55,170280,393363.55
521000,202312,1833,998,835,1318705.95,1102209.65,2420915.60
521010,202312,708,388,320,512172.44,422402.22,934574.66
521015,202312,19,14,5,18480,6600,25080
521020,202312,1642,1156,486,1525957.96,641527.69,2167485.65
521030,202312,95,68,27,89760.95,35640,125400.95
521040,202312,1157,800,357,1056023.41,471241.35,1527264.76
521056,202312,64,42,22,55440,29040,84480
521060,202312,134,86,48,113520.9,63360,176880.9
521080,202312,313,251,62,331336.76,81840.4,413177.16
521090,202312,682,481,201,634930.2,266640,901570.2
521100,202312,319,223,96,294365.98,128041.3,422407.28
521120,202312,1213,867,346,1144469.11,456723.61,1601192.72
521130,202312,332,239,93,315486.59,122760,438246.59
521140,202312,202,114,88,150484.34,116160.69,266645.03
521150,202312,2829,1196,1633,1581422.51,2155584.78,3737007.29
521160,202312,25,10,15,13200,19800,33000
521170,202312,237,132,105,174241.03,138600,312841.03
521180,202312,1386,867,519,1147111.73,685085.63,1832197.36
521190,202312,2990,1268,1722,1677761.44,2273052.39,3950813.83
521200,202312,75,50,25,66001,33000,99001
521205,202312,26,19,7,25080.2,9240,34320.2
521210,202312,156,95,61,125401.88,80520,205921.88
521220,202312,824,558,266,736575.27,351122.49,1087697.76
521225,202312,18,12,6,15841.1,7920.84,23761.94
521230,202312,123,84,39,110882.1,51480,162362.1
521250,202312,7359,4104,3255,5418831.66,4299290.21,9718121.87
521260,202312,56,24,32,31680,42240,73920
521270,202312,132,100,32,132001.35,42240,174241.35
521280,202312,449,275,174,363002.43,232320,595322.43
521290,202312,36,19,17,25080.38,22440,47520.38
521295,202312,115,76,39,100320.35,51480,151800.35
521300,202312,281,168,113,221762.03,149160.55,370922.58
521305,202312,54,37,17,48842.33,22440,71282.33
521308,202312,1116,869,247,1147115.6,326043.58,1473159.18
521310,202312,1620,897,723,1184078.35,955696.16,2139774.51
521340,202312,29,22,7,29040,9240,38280
521350,202312,94,70,24,92402.7,31680,124082.7
521370,202312,182,119,63,157081.4,83160,240241.4
521375,202312,240,109,131,143884.49,172921.99,316806.48
521377,202312,54,41,13,54120.57,17160.1,71280.67
521380,202312,1220,713,507,942519.56,669249.79,1611769.35
521385,202312,12,6,6,7920,7920,15840
521390,202312,113,93,20,122762.56,26400.49,149163.05
521400,202312,440,318,122,419773.89,161040.91,580814.80
521405,202312,173,114,59,150482.8,77880,228362.8
521410,202312,90,66,24,87121.27,31680,118801.27
521440,202312,246,164,82,216486.31,108240.64,324726.95
521450,202312,883,484,399,638893.1,526683.21,1165576.31
521460,202312,1260,896,364,1182769.21,480487.51,1663256.72
521470,202312,19,15,4,19800,5280,25080
521480,202312,45,29,16,38281.04,21120,59401.04
521483,202312,361,244,117,322083.05,154441.47,476524.52
521486,202312,344,237,107,312840.5,141240.84,454081.34
521487,202312,28,16,12,21120,15840,36960
521490,202312,34,21,13,27720,17160,44880
521500,202312,175,87,88,114840.27,117480.89,232321.16
521520,202312,53,42,11,55440,14520,69960
521523,202312,1497,834,663,1100903.46,875167.54,1976071.00
521525,202312,71,54,17,71280,22440,93720
521530,202312,265,156,109,205920,143880,349800
521540,202312,51,29,22,38280,29040,67320
521550,202312,142,78,64,102962.59,84480.99,187443.58
521560,202312,1057,725,332,957021.29,438244.4,1395265.69
521565,202312,83,60,23,79201.28,30360,109561.28
521570,202312,689,435,254,574206.97,335281.74,909488.71
521580,202312,47,30,17,39600,22440,62040
521590,202312,48,26,22,34320,29040,63360
521600,202312,24,11,13,14520,17160,31680
521630,202312,251,132,119,174244.63,157083.41,331328.04
521640,202312,347,188,159,248162.37,209882.36,458044.73
521645,202312,41,20,21,26400,27720,54120
521680,202312,281,172,109,227043.2,143880.87,370924.07
521690,202312,21,18,3,23760,3960,27720
521710,202312,1252,610,642,805214.85,847447.68,1652662.53
521720,202312,655,446,209,588725.9,275880,864605.9
521730,202312,836,398,438,525365.09,578166.51,1103531.60
521740,202312,1030,510,520,673206.97,686403.94,1359610.91
521760,202312,2977,1596,1381,2108211.23,1825593.68,3933804.91
521770,202312,926,565,361,745810.37,476523.35,1222333.72
521800,202312,2244,1566,678,2067184.83,894963.57,2962148.40
521805,202312,47,31,16,40920,21120,62040
521810,202312,92,54,38,71281.28,50160.9,121442.18
521830,202312,1177,881,296,1162955.44,390726.43,1553681.87
521839,202312,73,42,31,55440,40920.8,96360.8
521850,202312,1368,684,684,902903.69,902889.62,1805793.31
521860,202312,384,246,138,324725.43,182160,506885.43
521870,202312,122,85,37,112200,48840,161040
521878,202312,37,16,21,21120.2,27720.52,48840.72
521880,202312,5882,2658,3224,3508679.87,4255712.47,7764392.34
521890,202312,741,518,223,683772.54,294361.84,978134.38
521900,202312,304,232,72,306241.11,95040,401281.11
521910,202312,218,137,81,180847.24,106921.8,287769.04
521920,202312,39,25,14,33000,18480,51480
521925,202312,64,37,27,48840,35640,84480
521930,202312,1460,839,621,1108838.83,819730.01,1928568.84
521935,202312,51,39,12,51482.08,15840,67322.08
521940,202312,252,114,138,150481.03,182160.78,332641.81
521945,202312,26,19,7,25080,9240,34320
521950,202312,26,15,11,19800,14520,34320
521960,202312,79,59,20,77880,26400,104280
521970,202312,437,285,152,376202.34,200640.89,576843.23
521971,202312,109,63,46,83160.8,60720,143880.8
521973,202312,46,23,23,30360.6,30360,60720.6
521975,202312,2043,1128,915,1488999.22,1210456.04,2699455.26
521980,202312,260,176,84,232323.38,110880,343203.38
521990,202312,105,70,35,92401.65,46200,138601.65
522000,202312,312,213,99,280909.36,130680,411589.36
522005,202312,20,11,9,14520,11880,26400
522010,202312,1331,747,584,986070.4,770889.45,1756959.85
522015,202312,72,47,25,62040,33000,95040
522020,202312,1018,644,374,850095.75,493684.9,1343780.65
522026,202312,30,19,11,25080,14520,39600
522028,202312,28,24,4,31680,5280,36960
522040,202312,937,443,494,584774.27,652087.17,1236861.44
522045,202312,3253,1932,1321,2550342.26,1743733.8,4294076.06
522050,202312,134,64,70,84483.79,92400.72,176884.51
522060,202312,587,368,219,487091.45,289080.35,776171.80
522068,202312,131,96,35,126720.89,46200,172920.89
522070,202312,19,17,2,22440,2640,25080
522100,202312,37,24,13,31680,17160,48840
522108,202312,50,37,13,48842.54,17160,66002.54
522119,202312,85,49,36,64681.29,47520,112201.29
522130,202312,89,35,54,46200.51,71280.89,117481.40
522140,202312,4995,2650,2345,3499436.02,3096748.11,6596184.13
522145,202312,59,41,18,54120.2,23760,77880.2
522150,202312,127,91,36,120120.39,47520.84,167641.23
522155,202312,69,47,22,62040.9,29040,91080.9
522157,202312,20,12,8,15840,10560,26400
522160,202312,1846,1098,748,1449404.41,987368.21,2436772.62
522170,202312,410,289,121,381489.03,159720,541209.03
522180,202312,37,18,19,23760,25080,48840
522185,202312,3193,1509,1684,1991962.24,2222925.29,4214887.53
522190,202312,94,55,39,72600.89,51480,124080.89
522200,202312,362,208,154,274563.5,203280.24,477843.74
522205,202312,145,98,47,129364.82,62040,191404.82
522220,202312,140,109,31,143880.2,40920,184800.2
522230,202312,38,32,6,42240,7920,50160
530010,202312,68260,35548,32712,46946189.43,43204369.55,90150558.98
