ibge,anomes,bpc_ben,bpc_pcd_ben,bpc_idoso_ben,bpc_pcd_val,bpc_idoso_val,bpc_val
110001,201901,516,411,105,410178,104790,514968
110002,201901,2783,1709,1074,1706581.38,1071853.36,2778434.74
110003,201901,92,77,15,76846.18,14970,91816.18
110004,201901,2004,1303,701,1300396.36,699598,1999994.36
110005,201901,436,355,81,355288.4,80838,436126.4
110006,201901,457,352,105,351296,104790,456086
110007,201901,78,64,14,63872,13972,77844
110008,201901,234,133,101,132734,100798,233532
110009,201901,819,576,243,576844.82,242515.58,819360.40
110010,201901,1809,1116,693,1113769.96,692615.44,1806385.40
110011,201901,1869,1450,419,1447100.1,419160,1866260.1
110012,201901,4175,2439,1736,2435120.8,1734526.36,4169647.16
110013,201901,768,593,175,591814,174650,766464
110014,201901,373,320,53,319360.4,52894,372254.4
110015,201901,1432,1159,273,1156683.13,272454,1429137.13
110018,201901,1129,692,437,690616.34,436127.98,1126744.32
110020,201901,15571,9121,6450,9104796.03,6448132.15,15552928.18
110025,201901,650,479,171,478042.4,170658.98,648701.38
110026,201901,40,28,12,27944,11976,39920
110028,201901,1646,1191,455,1188618.98,454091.2,1642710.18
110029,201901,140,126,14,125748,13972,139720
110030,201901,2454,1664,790,1661513.1,789419.8,2450932.9
110032,201901,393,309,84,308383.35,84830.99,393214.34
110033,201901,676,502,174,500996.8,173652,674648.8
110034,201901,368,272,96,271457.15,95808,367265.15
110037,201901,104,87,17,86826,16966,103792
110040,201901,358,244,114,243512,113772,357284
110045,201901,957,653,304,651695.2,303392.64,955087.84
110050,201901,93,80,13,79840.4,12974,92814.4
110060,201901,85,48,37,47904,36926,84830
110070,201901,116,71,45,70858,44910.4,115768.4
110080,201901,410,245,165,244510,165668,410178
110090,201901,34,28,6,27944,5988,33932
110092,201901,103,56,47,55888,46906,102794
110094,201901,195,142,53,141716,52894,194610
110100,201901,30,25,5,24950,4990,29940
110110,201901,66,40,26,39920,25948,65868
110120,201901,72,60,12,59880,11976,71856
110130,201901,302,247,55,246506.4,54890,301396.4
110140,201901,246,163,83,162674,82834,245508
110143,201901,50,41,9,40918,8982,49900
110145,201901,24,18,6,17964,5988,23952
110146,201901,24,12,12,11976,11976,23952
110147,201901,39,30,9,29940,8982,38922
110148,201901,38,27,11,26946,10978,37924
110149,201901,317,226,91,225548,90818,316366
110150,201901,92,65,27,64870,26946,91816
110155,201901,7,6,1,5988,998,6986
110160,201901,68,57,11,56886,10978,67864
110170,201901,205,164,41,163672,40918,204590
110175,201901,52,39,13,38922,12974,51896
110180,201901,96,83,13,82834,12974,95808
120001,201901,145,99,46,98802,45909.98,144711.98
120005,201901,194,121,73,120758,72854,193612
120010,201901,1034,664,370,662673.27,369260.98,1031934.25
120013,201901,145,99,46,98802,45908,144710
120017,201901,93,56,37,55888,36926,92814
120020,201901,3618,2902,716,2898193.83,714568,3612761.83
120025,201901,573,328,245,327344.98,244510,571854.98
120030,201901,1042,879,163,877243,162674,1039917
120032,201901,47,40,7,40918,6986,47904
120033,201901,223,196,27,196606,26946,223552
120034,201901,160,115,45,114770,44910,159680
120035,201901,34,26,8,25948,7984,33932
120038,201901,393,253,140,252494,139720,392214
120039,201901,24,23,1,22954,998,23952
120040,201901,14113,9758,4355,9742838.43,4347311.74,14090150.17
120042,201901,50,44,6,43912,5988,49900
120043,201901,11,3,8,2994,7984,10978
120045,201901,546,354,192,353292.98,191617.95,544910.93
120050,201901,1268,972,296,970057.68,295408,1265465.68
120060,201901,1443,1176,267,1174646,266466,1441112
120070,201901,497,355,142,354291.2,141716,496007.2
120080,201901,169,106,63,105788,62874,168662
130002,201901,148,106,42,105788,41916,147704
130006,201901,76,44,32,43912,31936,75848
130008,201901,143,75,68,74850,67864,142714
130010,201901,144,80,64,79840,63872,143712
130014,201901,255,185,70,184630,70858,255488
130020,201901,95,54,41,53892,41916,95808
130030,201901,921,552,369,550896,368262,919158
130040,201901,311,159,152,158682,151696.36,310378.36
130050,201901,590,316,274,315368,273452,588820
130060,201901,882,603,279,601794,278442,880236
130063,201901,573,322,251,321356,250498,571854
130068,201901,186,122,64,121756,63872,185628
130070,201901,1327,913,414,911174,413172,1324346
130080,201901,683,451,232,450098,231536.98,681634.98
130083,201901,71,39,32,38922,31936,70858
130090,201901,370,188,182,187624,181636,369260
130100,201901,1129,509,620,508980,619758,1128738
130110,201901,706,305,401,304390,400198,704588
130115,201901,177,73,104,72854,103792,176646
130120,201901,1636,1041,595,1038918,596804,1635722
130130,201901,610,424,186,423152,185628,608780
130140,201901,1535,1160,375,1157680,374250.4,1531930.4
130150,201901,421,362,59,362274,58882,421156
130160,201901,466,268,198,267464,197604,465068
130165,201901,27,20,7,19960,7984,27944
130170,201901,969,699,270,697538.12,270458,967996.12
130180,201901,148,89,59,88822,58882,147704
130185,201901,2384,1180,1204,1178638,1201592.8,2380230.8
130190,201901,3561,2249,1312,2244502.98,1309376,3553878.98
130195,201901,288,232,56,231536,55888,287424
130200,201901,171,81,90,80838,89820,170658
130210,201901,78,40,38,39920,37924,77844
130220,201901,179,125,54,124750,53892,178642
130230,201901,328,207,121,206586,120758,327344
130240,201901,1417,901,516,901194.99,516964,1418158.99
130250,201901,4829,3126,1703,3121744.4,1700592,4822336.4
130255,201901,434,211,223,210578,222554,433132
130260,201901,54976,26604,28372,26562695.19,28321248.95,54883944.14
130270,201901,1594,1057,537,1054975.82,535926,1590901.82
130280,201901,120,73,47,72854,46906,119760
130290,201901,2128,1535,593,1532928,591814,2124742
130300,201901,435,312,123,311376,122754,434130
130310,201901,883,463,420,462074,419160,881234
130320,201901,462,247,215,246506,214570,461076
130330,201901,738,452,286,452094,285428,737522
130340,201901,3427,2025,1402,2022946.8,1399196.8,3422143.6
130350,201901,460,297,163,296406,162674,459080
130353,201901,840,354,486,354290.4,486026,840316.4
130356,201901,823,376,447,375248,446106,821354
130360,201901,66,42,24,41916,23952,65868
130370,201901,678,513,165,511974,164670,676644
130380,201901,599,419,180,419160,179640,598800
130390,201901,494,392,102,391216,101796,493012
130395,201901,176,39,137,38922,136726,175648
130400,201901,67,45,22,44910,21956,66866
130406,201901,2077,1294,783,1291412.8,782433.28,2073846.08
130410,201901,473,205,268,204590,267464,472054
130420,201901,3172,2574,598,2569851.3,596804,3166655.3
130423,201901,158,76,82,75848,81836,157684
130426,201901,153,88,65,87824,64870,152694
130430,201901,403,266,137,265468,136726,402194
130440,201901,204,69,135,68862,134730,203592
140002,201901,35,12,23,11976,22954,34930
140005,201901,205,129,76,128742,75848,204590
140010,201901,10586,7064,3522,7050882.54,3517953.46,10568836.00
140015,201901,147,68,79,67864,78842,146706
140017,201901,122,84,38,83832,37924,121756
140020,201901,475,320,155,319360,154690,474050
140023,201901,41,21,20,20958.54,19960,40918.54
140028,201901,18,11,7,10978,6986,17964
140030,201901,348,251,97,250498,97804,348302
140040,201901,56,39,17,38922,16966,55888
140045,201901,247,109,138,108782,138722,247504
140047,201901,627,432,195,431136,194610,625746
140050,201901,147,95,52,94810,51896,146706
140060,201901,42,31,11,30938,10978,41916
140070,201901,33,30,3,29940,2994,32934
150010,201901,4716,2962,1754,2956076,1751490.4,4707566.4
150013,201901,158,112,46,111776,45908,157684
150020,201901,1066,584,482,582832,481036,1063868
150030,201901,713,295,418,294410,417164,711574
150034,201901,198,131,67,130738,66866,197604
150040,201901,1421,855,566,853290,564868,1418158
150050,201901,651,382,269,381236,268462,649698
150060,201901,4765,3087,1678,3082739.68,1676640.98,4759380.66
150070,201901,315,143,172,142714,171656,314370
150080,201901,14303,7191,7112,7176627.25,7101780.29,14278407.54
150085,201901,403,255,148,254490,147704,402194
150090,201901,750,641,109,639718,108782,748500
150095,201901,348,219,129,218562,128742,347304
150100,201901,58,40,18,39920,17964,57884
150110,201901,171,84,87,83832,86826,170658
150120,201901,428,316,112,315368,111776,427144
150125,201901,54,22,32,21956,31936,53892
150130,201901,1942,1048,894,1045904,893210,1939114
150140,201901,54374,25514,28860,25476957.25,28816275.74,54293232.99
150145,201901,189,105,84,104790,83832,188622
150150,201901,2807,1290,1517,1287420,1513966.8,2801386.8
150157,201901,420,297,123,296406,122754,419160
150160,201901,122,96,26,95808,25948,121756
150170,201901,3674,2735,939,2731526,937122,3668648
150172,201901,327,223,104,222554,103792,326346
150175,201901,82,49,33,48902,32934,81836
150178,201901,781,519,262,517962,261476,779438
150180,201901,3117,1523,1594,1519954.5,1590812.4,3110766.9
150190,201901,334,215,119,214570,118762,333332
150195,201901,122,62,60,61876,59880,121756
150200,201901,200,96,104,95808,103792,199600
150210,201901,3154,2567,587,2561866,586824.99,3148690.99
150215,201901,536,347,189,346306,188622.4,534928.4
150220,201901,3810,2602,1208,2596797.52,1206583.4,3803380.92
150230,201901,1150,932,218,930136.45,217564,1147700.45
150240,201901,5919,3484,2435,3477034.49,2430130.98,5907165.47
150250,201901,33,16,17,15968,16966,32934
150260,201901,79,49,30,48902,29940,78842
150270,201901,2336,1525,811,1521950,809378.8,2331328.8
150275,201901,557,347,210,346306,209580,555886
150276,201901,109,49,60,48902,59880,108782
150277,201901,764,330,434,329340.98,433132,762472.98
150280,201901,335,211,124,210578,123752,334330
150285,201901,84,42,42,41916,41916,83832
150290,201901,963,591,372,589818,371256.4,961074.4
150293,201901,660,314,346,313372,345308,658680
150295,201901,473,215,258,214570,257484,472054
150300,201901,75,39,36,38922,35928,74850
150304,201901,163,109,54,108782,53892,162674
150307,201901,388,322,66,321356,65868,387224
150309,201901,570,418,152,418162.98,151699.6,569862.58
150310,201901,251,169,82,168662,81836,250498
150320,201901,1756,1221,535,1218558,533930,1752488
150330,201901,2087,1207,880,1205584,879238,2084822
150340,201901,201,135,66,134730,65868,200598
150345,201901,619,341,278,341316,277444,618760
150350,201901,407,321,86,320358,85828,406186
150360,201901,4595,2953,1642,2949091.49,1640712,4589803.49
150370,201901,783,550,233,548900.98,232534.98,781435.96
150375,201901,196,103,93,102794,93812,196606
150380,201901,1397,947,450,946104.98,449100.39,1395205.37
150390,201901,741,429,312,428142.99,311376,739518.99
150400,201901,101,85,16,84830,15968,100798
150405,201901,1263,823,440,821354.92,439120,1260474.92
150410,201901,133,89,44,88822,43912,132734
150420,201901,7416,4087,3329,4079998.18,3323386.86,7403385.04
150430,201901,541,356,185,356286,184630,540916
150440,201901,572,344,228,343312,227544,570856
150442,201901,2217,1198,1019,1196602.58,1016962,2213564.58
150445,201901,526,337,189,336326,188622,524948
150450,201901,250,122,128,121756,127744,249500
150460,201901,742,562,180,560876,179640,740516
150470,201901,1336,811,525,809378,524948,1334326
150475,201901,224,176,48,175648,47904,223552
150480,201901,1270,891,379,889218,379240,1268458
150490,201901,604,330,274,329340,273452,602792
150495,201901,329,236,93,235528,92814,328342
150497,201901,303,204,99,203592,98802,302394
150500,201901,424,294,130,293412,129740,423152
150503,201901,899,447,452,448102.4,451097.96,899200.36
150506,201901,1003,661,342,659678,341316,1000994
150510,201901,1231,702,529,701594.4,527942,1229536.4
150520,201901,270,181,89,180638,88822,269460
150530,201901,1606,884,722,882232.5,720556,1602788.5
150540,201901,235,164,71,163672,70858,234530
150543,201901,760,427,333,426146,332334,758480
150548,201901,494,347,147,346306,146706,493012
150549,201901,60,43,17,42914,16966,59880
150550,201901,2871,1518,1353,1514964.5,1350294.4,2865258.9
150553,201901,3178,1881,1297,1879234.8,1294406,3173640.8
150555,201901,142,76,66,75848,65868,141716
150560,201901,62,46,16,45908,15968,61876
150563,201901,82,42,40,41916,39920,81836
150565,201901,171,104,67,103792,66866,170658
150570,201901,416,279,137,279440,137724,417164
150580,201901,1586,717,869,715566,867262,1582828
150590,201901,803,515,288,513970,287424,801394
150600,201901,459,282,177,281436,176646,458082
150610,201901,143,123,20,122754,19960,142714
150611,201901,125,87,38,86826,37924,124750
150613,201901,3210,1982,1228,1980032,1227540.98,3207572.98
150616,201901,502,300,202,299400.5,201596,500996.5
150618,201901,1247,677,570,675646.98,568860,1244506.98
150619,201901,402,307,95,306386,94810,401196
150620,201901,1278,753,525,751494,524948,1276442
150630,201901,305,199,106,198602,105788,304390
150635,201901,494,212,282,211576,281436,493012
150640,201901,57,28,29,27944,28942,56886
150650,201901,2368,1391,977,1389466.4,977043.39,2366509.79
150655,201901,249,184,65,183632,64870,248502
150658,201901,103,58,45,57884,44910,102794
150660,201901,495,348,147,347304,147704,495008
150670,201901,1019,375,644,374250.98,642712.98,1016963.96
150680,201901,9688,5313,4375,5304372.7,4370243.96,9674616.66
150690,201901,55,34,21,33932,20958,54890
150700,201901,507,334,173,333332,172654,505986
150710,201901,284,166,118,165668,117764,283432
150715,201901,842,516,326,514968.98,325348,840316.98
150720,201901,420,329,91,328342,90818,419160
150730,201901,961,520,441,519958.98,440118,960076.98
150740,201901,219,154,65,153692,64870,218562
150745,201901,809,446,363,446106,362274,808380
150746,201901,50,30,20,29940,19960,49900
150747,201901,263,205,58,204590,57884,262474
150750,201901,131,75,56,74850,55888,130738
150760,201901,1739,1143,596,1140714,595806,1736520
150770,201901,376,204,172,203592,171656,375248
150775,201901,95,44,51,43912,50898,94810
150780,201901,196,108,88,107784,87824,195608
150790,201901,849,466,383,465068,382234,847302
150795,201901,1492,881,611,880236,610776,1491012
150796,201901,381,220,161,219560,160678,380238
150797,201901,292,164,128,163672,127744,291416
150800,201901,1436,865,571,863270,569859.37,1433129.37
150803,201901,587,483,104,483032,103792,586824
150805,201901,192,123,69,122754,68862.99,191616.99
150808,201901,1008,557,451,555886,451096,1006982
150810,201901,3376,2340,1036,2337318.21,1034926.4,3372244.61
150812,201901,440,239,201,238522,200598,439120
150815,201901,971,642,329,640716,328342,969058
150820,201901,1564,954,610,952092,608780,1560872
150830,201901,806,575,231,575846,230538,806384
150835,201901,192,116,76,115768,75848,191616
150840,201901,1343,867,476,866264.6,475048,1341312.6
160005,201901,53,32,21,31936,20958,52894
160010,201901,193,122,71,121756,70858.99,192614.99
160015,201901,115,67,48,67864,47904,115768
160020,201901,131,76,55,75848,54890,130738
160021,201901,42,22,20,21956,19960,41916
160023,201901,119,73,46,72854,45908,118762
160025,201901,29,13,16,12974,15968,28942
160027,201901,1501,860,641,860276.5,640716,1500992.5
160030,201901,15635,8124,7511,8111754.18,7501976.53,15613730.71
160040,201901,302,175,127,174650,126746,301396
160050,201901,709,362,347,361276,346306,707582
160053,201901,325,188,137,187624.4,136726,324350.4
160055,201901,30,22,8,21956,7984,29940
160060,201901,6504,3449,3055,3443101.99,3052883.39,6495985.38
160070,201901,173,108,65,107784,64870,172654
160080,201901,87,45,42,44910,41916,86826
170025,201901,25,14,11,13972,10978,24950
170030,201901,223,183,40,182634.88,39920,222554.88
170035,201901,227,107,120,106786,119760,226546
170040,201901,180,139,41,139720,40918,180638
170070,201901,329,202,127,201596,126746,328342
170100,201901,363,265,98,264470,97804,362274
170105,201901,60,49,11,49900,10978,60878
170110,201901,109,68,41,67864,40918,108782
170130,201901,64,32,32,31936,31936.4,63872.4
170190,201901,99,66,33,65868,32934,98802
170200,201901,389,262,127,261476.98,126746.9,388223.88
170210,201901,5979,3155,2824,3148692.9,2819352.58,5968045.48
170215,201901,105,48,57,48902,56886,105788
170220,201901,1420,1043,377,1040914,376246.4,1417160.4
170230,201901,154,103,51,102794,50898,153692
170240,201901,537,356,181,355288,180638,535926
170255,201901,1111,895,216,894208,215568,1109776
170270,201901,39,28,11,27944,10978,38922
170290,201901,97,72,25,71856,24950,96806
170300,201901,85,57,28,56886,27944,84830
170305,201901,49,38,11,37924,10978,48902
170307,201901,62,46,16,45908,15968,61876
170310,201901,108,61,47,60878,46906,107784
170320,201901,21,17,4,16966,3992,20958
170330,201901,24,22,2,21956,1996,23952
170360,201901,27,16,11,15968,10978,26946
170370,201901,120,63,57,62874,56886,119760
170380,201901,81,62,19,61876,19960,81836
170382,201901,46,40,6,39920,5988,45908
170384,201901,140,106,34,105788,33932,139720
170386,201901,62,27,35,26946,34930,61876
170388,201901,51,20,31,19960,30938,50898
170389,201901,26,21,5,20958,4990,25948
170390,201901,59,34,25,33932.98,24950,58882.98
170410,201901,33,24,9,23952,8982,32934
170460,201901,17,13,4,12974,3992,16966
170510,201901,34,27,7,26946,6986,33932
170550,201901,1527,889,638,888220,636724,1524944
170555,201901,111,79,32,78842,31936,110778
170560,201901,95,70,25,69860,25948,95808
170600,201901,37,18,19,17964,18962,36926
170610,201901,190,101,89,100798,88824.36,189622.36
170625,201901,36,20,16,19960,15968,35928
170650,201901,80,59,21,58882,20958,79840
170700,201901,568,432,136,432134.5,135728,567862.5
170710,201901,164,100,64,99800,63873.96,163673.96
170720,201901,86,69,17,68862,16966,85828
170730,201901,73,44,29,43912,28942,72854
170740,201901,89,67,22,66866,21956,88822
170755,201901,66,35,31,34930,30938,65868
170765,201901,136,69,67,68862.4,66866,135728.4
170770,201901,224,135,89,134730,88822,223552
170820,201901,601,396,205,395208,204590.8,599798.8
170825,201901,32,19,13,18962,12974,31936
170830,201901,84,66,18,65868,17964,83832
170900,201901,193,150,43,149700,42914,192614
170930,201901,850,451,399,450098,398202.8,848300.8
170950,201901,3070,1365,1705,1362271.38,1704586.05,3066857.43
170980,201901,16,9,7,8982,6986,15968
171050,201901,146,114,32,113772,31936,145708
171070,201901,38,32,6,31936,5988,37924
171090,201901,44,33,11,32934,10978,43912
171110,201901,20,13,7,12974,6986,19960
171150,201901,43,22,21,21956,20958,42914
171180,201901,24,12,12,11976,11976,23952
171190,201901,151,86,65,85828,64870,150698
171195,201901,64,51,13,50898,12974,63872
171200,201901,49,25,24,24950,23952,48902
171215,201901,4,3,1,2994,998,3992
171240,201901,55,45,10,44910,9980,54890
171245,201901,56,51,5,50898,4990,55888
171250,201901,71,39,32,38922,31936,70858
171270,201901,16,12,4,11976,3992,15968
171280,201901,40,36,4,35928.7,3992,39920.7
171320,201901,988,571,417,569858,416166,986024
171330,201901,425,208,217,207584,216566,424150
171360,201901,90,64,26,63872,25948,89820
171370,201901,27,15,12,14970,11976,26946
171380,201901,135,110,25,109780,24950,134730
171395,201901,55,35,20,34930,19960,54890
171420,201901,302,198,104,197604,104790,302394
171430,201901,67,54,13,53892,12974,66866
171488,201901,192,105,87,104790,86826,191616
171500,201901,57,32,25,31936,24950,56886
171510,201901,68,45,23,44910,22954,67864
171515,201901,42,35,7,34930,6986.4,41916.4
171525,201901,31,27,4,26946,3992,30938
171550,201901,11,7,4,6986,3992,10978
171570,201901,59,31,28,30938,27944,58882
171575,201901,328,209,119,208582,118762,327344
171610,201901,1720,874,846,873256.84,846315.72,1719572.56
171620,201901,133,94,39,93812,38922,132734
171630,201901,56,29,27,28942,26946,55888
171650,201901,269,180,89,180638,88822,269460
171660,201901,268,146,122,145708,121757.39,267465.39
171665,201901,54,38,16,37924,15968,53892
171670,201901,428,246,182,245508.5,181636,427144.5
171700,201901,66,59,7,58882,6986,65868
171720,201901,26,10,16,9980,15968,25948
171750,201901,102,55,47,54890,46906,101796
171780,201901,78,62,16,61876,15968,77844
171790,201901,76,65,11,64870,10978,75848
171800,201901,37,29,8,28942,7984,36926
171820,201901,2076,1195,881,1193608.84,880236.98,2073845.82
171830,201901,34,27,7,26946,6986,33932
171840,201901,65,40,25,39920,24950,64870
171845,201901,31,19,12,18962,11976,30938
171850,201901,39,29,10,28942,9980,38922
171855,201901,77,61,16,60878,16966,77844
171865,201901,10,8,2,7984,1996,9980
171870,201901,31,22,9,21956,8982,30938
171875,201901,82,56,26,55888,25948,81836
171880,201901,31,21,10,20958,9980,30938
171884,201901,47,24,23,23952,22954,46906
171886,201901,122,46,76,45908,75848,121756
171888,201901,26,20,6,19960,5988,25948
171889,201901,19,15,4,14970,3992,18962
171890,201901,57,47,10,46906,9980,56886
171900,201901,43,30,13,29940,12974,42914
172000,201901,41,34,7,33932,6986,40918
172010,201901,43,35,8,34930,7984,42914
172015,201901,26,16,10,15968.58,9980,25948.58
172020,201901,139,90,49,89820,48902,138722
172025,201901,32,21,11,20958,10978,31936
172030,201901,42,25,17,24950,16966,41916
172049,201901,77,49,28,48902,27944,76846
172065,201901,147,96,51,95808,50898,146706
172080,201901,94,63,31,62874,30938,93812
172085,201901,24,12,12,11976,11976,23952
172090,201901,410,319,91,318362,91816,410178
172093,201901,26,20,6,19960,5988,25948
172097,201901,18,10,8,9980,7984.4,17964.4
172100,201901,4862,2755,2107,2749491.86,2105782.08,4855273.94
172110,201901,82,56,26,55888,25948,81836
172120,201901,1682,1443,239,1440115.86,238522.96,1678638.82
172125,201901,3,3,0,2994,,2994.0
172130,201901,16,12,4,11976,3992,15968
172208,201901,193,122,71,121756,70858,192614
172210,201901,396,196,200,196606,199600.4,396206.4
210005,201901,2922,1832,1090,1828336.75,1087824.4,2916161.15
210010,201901,181,92,89,91816,88822,180638
210015,201901,34,24,10,23952,9980,33932
210020,201901,349,190,159,189620,158682,348302
210030,201901,343,219,124,218562,123752.98,342314.98
210040,201901,144,113,31,112774,30938,143712
210043,201901,265,191,74,190618,73852,264470
210047,201901,584,323,261,322354,260478,582832
210050,201901,297,219,78,218562,77844,296406
210055,201901,44,33,11,32934,10978,43912
210060,201901,557,442,115,441116,114770,555886
210070,201901,416,312,104,312374,103792,416166
210080,201901,112,102,10,101796,9980,111776
210083,201901,304,143,161,142714,161676,304390
210087,201901,40,30,10,29940,9980,39920
210090,201901,476,333,143,332334,142714,475048
210095,201901,476,354,122,353292,121756,475048
210100,201901,699,541,158,540916,157684,698600
210110,201901,144,84,60,83832,59880,143712
210120,201901,5368,4112,1256,4104782.12,1254487.48,5359269.60
210125,201901,209,123,86,122754,85828,208582
210130,201901,519,285,234,284430,233532,517962
210135,201901,33,20,13,19960,12974,32934
210140,201901,4401,3457,944,3450086.6,943110,4393196.6
210150,201901,376,240,136,239520,135728,375248
210160,201901,3407,2876,531,2871246.55,530936.4,3402182.95
210170,201901,1163,920,243,918160,242514,1160674
210173,201901,128,109,19,108782,18962,127744
210177,201901,431,222,209,222554,209580,432134
210180,201901,33,18,15,17964,14970,32934
210190,201901,416,277,139,276446,138722,415168
210193,201901,1,1,0,998,,998.0
210197,201901,79,54,25,53892,24950,78842
210200,201901,638,512,126,511974.4,126746,638720.4
210203,201901,255,172,83,171656,82834,254490
210207,201901,389,306,83,305388,82834,388222
210210,201901,782,719,63,717562,62874,780436
210215,201901,76,66,10,65868,9980,75848
210220,201901,398,330,68,329340,67864,397204
210230,201901,304,237,67,236526,66866,303392
210232,201901,1468,955,513,953090.99,511974,1465064.99
210235,201901,156,124,32,125748.6,31936,157684.6
210237,201901,43,25,18,24950,17964,42914
210240,201901,90,75,15,74850,14970,89820
210250,201901,186,153,33,152694,32934,185628
210255,201901,355,265,90,264470,89820,354290
210260,201901,412,267,145,266466,144710,411176
210270,201901,688,443,245,442114,244510,686624
210275,201901,54,41,13,40918,12974,53892
210280,201901,1065,690,375,688620.48,374250,1062870.48
210290,201901,513,344,169,343312,168662,511974
210300,201901,5878,3538,2340,3531922.39,2336318.97,5868241.36
210310,201901,108,77,31,76846,30938,107784
210312,201901,118,79,39,78842,38922,117764
210315,201901,116,89,27,88822,26946,115768
210317,201901,124,92,32,91816,31936,123752
210320,201901,2377,1984,393,1980032.96,393212,2373244.96
210325,201901,132,93,39,92814,38922.4,131736.4
210330,201901,5219,2818,2401,2813362.7,2397196,5210558.7
210340,201901,1348,981,367,979038.96,366267.94,1345306.90
210350,201901,625,519,106,517962,105788,623750
210355,201901,144,117,27,116766,26946,143712
210360,201901,2576,1656,920,1652688.06,918160.4,2570848.46
210370,201901,1256,570,686,568860,685626,1254486
210375,201901,190,98,92,97804,91816,189620
210380,201901,724,546,178,546904,177644,724548
210390,201901,202,169,33,168662,32934,201596
210400,201901,425,363,62,362274,61876.96,424150.96
210405,201901,1017,696,321,695606,320358,1015964
210407,201901,56,45,11,44910,10978,55888
210408,201901,64,57,7,56886,6986,63872
210409,201901,333,281,52,281436,51896,333332
210410,201901,440,343,97,343312,97804.98,441116.98
210420,201901,200,165,35,164670,34930,199600
210430,201901,41,28,13,27944,12974,40918
210440,201901,360,226,134,225548,135728,361276
210450,201901,154,119,35,118762,34930,153692
210455,201901,227,126,101,125748,100798,226546
210460,201901,337,215,122,215568,121756,337324
210462,201901,69,57,12,56886,11976,68862
210465,201901,167,121,46,120758,45908,166666
210467,201901,537,387,150,386226,149700,535926
210470,201901,43,36,7,35928,6986,42914
210480,201901,1304,924,380,922152,379240,1301392
210490,201901,216,136,80,135728,79840,215568
210500,201901,566,317,249,316366,248502,564868
210510,201901,574,452,122,451096,121756,572852
210515,201901,425,244,181,243512,181636,425148
210520,201901,412,360,52,359280,51896,411176
210530,201901,9413,5061,4352,5054874.82,4348290.6,9403165.42
210535,201901,128,95,33,94810,32934,127744
210540,201901,1529,959,570,957082.2,569858,1526940.2
210542,201901,1219,600,619,598800,617762.4,1216562.4
210545,201901,13,12,1,11976,998,12974
210547,201901,133,114,19,113772,18962,132734
210550,201901,727,518,209,516965.36,208582,725547.36
210560,201901,176,149,27,148702,26946,175648
210565,201901,30,22,8,21956,7984,29940
210570,201901,1356,1073,283,1072850.44,284430,1357280.44
210580,201901,111,97,14,96806,13972,110778
210590,201901,774,622,152,620756,151696,772452
210592,201901,33,29,4,28942,3992,32934
210594,201901,107,88,19,87824,18962,106786
210596,201901,93,78,15,77844,14970,92814
210598,201901,129,93,36,92814,35928,128742
210600,201901,335,284,51,283432,50898,334330
210610,201901,257,238,19,237524,18962,256486
210620,201901,45,27,18,26946,17964,44910
210630,201901,70,67,3,66866,2994,69860
210632,201901,1064,719,345,717562,345308,1062870
210635,201901,20,17,3,16966,2994,19960
210637,201901,103,72,31,71856,30938,102794
210640,201901,592,520,72,518960,71856,590816
210650,201901,413,338,75,337324,74850,412174
210660,201901,398,293,105,292414,105788,398202
210663,201901,23,13,10,12974,10978,23952
210667,201901,112,36,76,35928,75848,111776
210670,201901,267,235,32,234530,31936,266466
210675,201901,563,301,262,300398,261476,561874
210680,201901,215,139,76,138722,75848,214570
210690,201901,640,516,124,514968,123752,638720
210700,201901,182,136,46,135728,45908,181636
210710,201901,282,165,117,164670,116766,281436
210720,201901,137,118,19,117764,18962,136726
210725,201901,68,59,9,58882,8982,67864
210730,201901,25,18,7,17964,6986,24950
210735,201901,400,276,124,275448,123752.4,399200.4
210740,201901,562,475,87,474050,86826,560876
210745,201901,156,116,40,116766,39920,156686
210750,201901,2433,1159,1274,1156682.5,1274446,2431128.5
210760,201901,264,198,66,197604,65868,263472
210770,201901,403,314,89,313372,88822,402194
210780,201901,423,310,113,309380,112774,422154
210790,201901,189,146,43,145708,42914,188622
210800,201901,161,119,42,118762,41916,160678
210805,201901,50,46,4,45908,3992,49900
210810,201901,487,382,105,381236,104790,486026
210820,201901,2331,1877,454,1874245.76,455088,2329333.76
210825,201901,166,89,77,88822,76846,165668
210830,201901,774,495,279,495008,278442,773450
210840,201901,206,141,65,140718,64870,205588
210845,201901,259,168,91,167664,90818,258482
210850,201901,815,532,283,533930,282434,816364
210860,201901,4040,2157,1883,2153684.9,1880232,4033916.9
210870,201901,480,366,114,366266,113772,480038
210880,201901,69,51,18,50898,17964,68862
210890,201901,346,294,52,293412,51896,345308
210900,201901,605,391,214,390218,213572,603790
210905,201901,67,34,33,33932,32934,66866
210910,201901,2028,1515,513,1511970.8,511974,2023944.8
210920,201901,206,69,137,68862,136726,205588
210923,201901,81,58,23,57884,22954,80838
210927,201901,432,189,243,188622,242514,431136
210930,201901,69,55,14,54890,13972,68862
210940,201901,93,73,20,72854,19960,92814
210945,201901,203,97,106,96806,105788,202594
210950,201901,523,384,139,384230,138722,522952
210955,201901,75,50,25,49900,24950,74850
210960,201901,2360,1076,1284,1073848,1283428,2357276
210970,201901,116,102,14,101796,13972,115768
210975,201901,92,83,9,82834,8982,91816
210980,201901,1176,531,645,529938,643710.4,1173648.4
210990,201901,4276,2705,1571,2700589,1572848,4273437
211000,201901,1376,1099,277,1096802.4,276446,1373248.4
211003,201901,908,631,277,629738,276446.98,906184.98
211010,201901,500,443,57,442114,56886,499000
211020,201901,1589,604,985,603790,983030,1586820
211023,201901,32,27,5,26946,4990,31936
211027,201901,73,50,23,49900,22954,72854
211030,201901,389,267,122,266466,121756,388222
211040,201901,322,256,66,255488.4,65868,321356.4
211050,201901,1177,770,407,768460,406186.4,1174646.4
211060,201901,683,583,100,581834,99800,681634
211065,201901,21,17,4,16966,3992,20958
211070,201901,930,763,167,761474.66,166666,928140.66
211080,201901,88,84,4,83832,3992,87824
211085,201901,60,31,29,30938.4,28942,59880.4
211090,201901,92,74,18,73852,17964,91816
211100,201901,499,402,97,401196,96806,498002
211102,201901,263,178,85,177644,84830,262474
211105,201901,225,157,68,156686,68862,225548
211107,201901,134,78,56,77844,56886,134730
211110,201901,844,554,290,552892,289420.98,842312.98
211120,201901,5765,2661,3104,2657676.6,3100787.72,5758464.32
211125,201901,33,26,7,25948,6986,32934
211130,201901,45111,19578,25533,19542846.18,25503897.53,45046743.71
211140,201901,431,368,63,367264.99,62874,430138.99
211150,201901,1292,827,465,826344,464071.39,1290415.39
211153,201901,166,98,68,97804,67864,165668
211157,201901,63,49,14,48902,13972,62874
211160,201901,715,599,116,597802,115768,713570
211163,201901,0,0,0,0,0,0
211167,201901,10,9,1,8982,998,9980
211170,201901,442,314,128,313372,128742,442114
211172,201901,121,86,35,85828,34930,120758
211174,201901,271,165,106,164670,105788,270458
211176,201901,504,368,136,368262,136726,504988
211178,201901,96,64,32,63872,31936,95808
211180,201901,209,165,44,164670,43912,208582
211190,201901,69,64,5,63872,4990,68862
211195,201901,28,18,10,17964,9980,27944
211200,201901,153,132,21,131736,20958,152694
211210,201901,512,330,182,329340,182634,511974
211220,201901,4078,2324,1754,2320352.53,1752489.99,4072842.52
211223,201901,96,91,5,90818,4990,95808
211227,201901,69,51,18,50898,17964,68862
211230,201901,784,639,145,637722,144710,782432
211240,201901,409,309,100,309380,99800,409180
211245,201901,192,90,102,89820,101796,191616
211250,201901,1639,1407,232,1404187.59,232534,1636721.59
211260,201901,835,668,167,666664,166666,833330
211270,201901,2057,1645,412,1642708,411176.4,2053884.4
211280,201901,1869,1142,727,1140714,727542,1868256
211285,201901,205,122,83,121756,82834,204590
211290,201901,694,475,219,474050,218562,692612
211300,201901,817,636,181,635726.96,180638,816364.96
211400,201901,1586,929,657,927142,655686,1582828
220005,201901,17,16,1,15968,998,16966
220010,201901,89,67,22,66866,21956,88822
220020,201901,635,510,125,509978,125748,635726
220025,201901,109,106,3,105788,2994,108782
220027,201901,38,31,7,30938,6986,37924
220030,201901,102,84,18,83832,17964,101796
220040,201901,1170,885,285,883230.6,284430,1167660.6
220045,201901,42,30,12,29940,11976,41916
220050,201901,677,567,110,565867.08,110778,676645.08
220060,201901,174,149,25,148702,24950,173652
220070,201901,107,97,10,96806,9980,106786
220080,201901,14,13,1,12974,998,13972
220090,201901,34,28,6,27944,5988,33932
220095,201901,2,1,1,998,998,1996
220100,201901,25,20,5,19960,4990,24950
220105,201901,25,24,1,23952.4,998,24950.4
220110,201901,218,199,19,198602,18962,217564
220115,201901,50,47,3,46906,2994,49900
220117,201901,22,20,2,19960,1996,21956
220120,201901,1487,1095,392,1092810,392214,1485024
220130,201901,29,29,0,28942,,28942.0
220140,201901,98,77,21,76846,20958,97804
220150,201901,482,347,135,346306,134730,481036
220155,201901,5,5,0,4990,,4990.0
220157,201901,18,15,3,14970,2994,17964
220160,201901,81,70,11,69860,10978,80838
220170,201901,36,34,2,33932,1996,35928
220173,201901,6,6,0,5988,,5988.0
220177,201901,5,5,0,4990,,4990.0
220180,201901,64,64,0,63872,,63872.0
220190,201901,1066,954,112,952092,111776,1063868
220191,201901,43,38,5,37924,4990,42914
220192,201901,70,67,3,66866,2994,69860
220194,201901,47,44,3,43912,2994,46906
220196,201901,101,85,16,84830,15968,100798
220198,201901,4,3,1,2994,998,3992
220200,201901,427,354,73,353293.3,73852,427145.3
220202,201901,38,34,4,33932,3992,37924
220205,201901,41,37,4,36926,3992,40918
220207,201901,14,13,1,12974,998,13972
220208,201901,82,44,38,43912,37924,81836
220209,201901,31,28,3,27944,2994,30938
220210,201901,15,13,2,12974,1996,14970
220211,201901,27,26,1,25948,998,26946
220213,201901,41,37,4,36926,3992.4,40918.4
220217,201901,38,30,8,29940,7984,37924
220220,201901,2077,1347,730,1346302,730537.1,2076839.1
220225,201901,11,5,6,4990,5988,10978
220230,201901,957,756,201,754488,200598,955086
220240,201901,156,143,13,142714,12974,155688
220245,201901,33,30,3,29940.99,2994,32934.99
220250,201901,116,104,12,103792,11976,115768
220253,201901,42,36,6,35928,5988,41916
220255,201901,29,26,3,25948,2994,28942
220260,201901,691,502,189,500996,188622,689618
220265,201901,12,9,3,8982,2994,11976
220270,201901,717,640,77,638720,76846,715566
220271,201901,43,36,7,35928,6986,42914
220272,201901,27,27,0,26946,,26946.0
220273,201901,13,11,2,10978,1996,12974
220275,201901,55,45,10,44910,9980,54890
220277,201901,11,9,2,8982,1996,10978
220280,201901,14,11,3,10978,2994,13972
220285,201901,46,43,3,42914,2994,45908
220290,201901,1452,1242,210,1239516.7,209580.9,1449097.6
220300,201901,51,49,2,48902,1996,50898
220310,201901,318,270,48,269460.99,47904.98,317365.97
220320,201901,434,400,34,399200.4,33932,433132.4
220323,201901,0,0,0,0,0,0
220325,201901,15,10,5,9980,4990,14970
220327,201901,12,11,1,10978,998,11976
220330,201901,211,147,64,146706,63872,210578
220335,201901,133,115,18,114770,17964,132734
220340,201901,30,19,11,18962,10978,29940
220342,201901,60,52,8,51896,7984,59880
220345,201901,85,78,7,77844,6986,84830
220350,201901,429,376,53,375248,52894,428142
220360,201901,43,31,12,30938,11976,42914
220370,201901,1160,945,215,943110,214570,1157680
220375,201901,27,25,2,24950,1996,26946
220380,201901,41,34,7,33932,6986,40918
220385,201901,17,15,2,14970,1996,16966
220390,201901,2313,1332,981,1331332.84,980037.2,2311370.04
220400,201901,30,27,3,26946,2994,29940
220410,201901,19,18,1,17964,998,18962
220415,201901,14,13,1,12974,998,13972
220420,201901,131,108,23,107784,22954,130738
220430,201901,131,119,12,118762.5,11976,130738.5
220435,201901,20,14,6,13972,5988,19960
220440,201901,296,251,45,251496,44910,296406
220450,201901,340,174,166,173652,165668,339320
220455,201901,55,53,2,52894,1996,54890
220460,201901,18,18,0,17964,,17964.0
220465,201901,106,70,36,69860,35928,105788
220470,201901,242,212,30,211576,29940,241516
220480,201901,76,67,9,66866,8982,75848
220490,201901,88,76,12,75848,11976,87824
220500,201901,95,80,15,79840,14970,94810
220510,201901,383,307,76,306386,75848,382234
220515,201901,20,18,2,17964,1996,19960
220520,201901,375,337,38,336326.34,38922,375248.34
220525,201901,19,14,5,13972,4990,18962
220527,201901,35,28,7,27944,6986,34930
220530,201901,37,16,21,15968,20958,36926
220535,201901,6,6,0,5988,,5988.0
220540,201901,61,51,10,50898,9980,60878
220545,201901,54,37,17,36926,16966,53892
220550,201901,649,498,151,498002,150698,648700
220551,201901,25,20,5,19960,4990,24950
220552,201901,13,13,0,12974,,12974.0
220553,201901,50,46,4,45908,3992,49900
220554,201901,10,7,3,6986,2994,9980
220555,201901,28,25,3,24950,2994,27944
220556,201901,53,49,4,48902,3992,52894
220557,201901,55,50,5,49900,4990,54890
220558,201901,6,2,4,1996,3992,5988
220559,201901,5,5,0,4990,,4990.0
220560,201901,67,44,23,43912,22954,66866
220570,201901,793,485,308,484030.4,309380,793410.4
220580,201901,560,517,43,515966,42914,558880
220585,201901,6,5,1,4990,998,5988
220590,201901,14,14,0,13972,,13972.0
220595,201901,62,47,15,46906,14970,61876
220600,201901,22,14,8,13972,7984,21956
220605,201901,20,19,1,18962,998,19960
220610,201901,69,61,8,60878,7984,68862
220620,201901,561,449,112,448102,111776,559878
220630,201901,5,4,1,3992,998,4990
220635,201901,38,34,4,33932,3992,37924
220640,201901,99,78,21,77844,20958,98802
220650,201901,113,106,7,105788,6986,112774
220660,201901,38,30,8,29940,7984,37924
220665,201901,4,4,0,3992,,3992.0
220667,201901,15,13,2,12974,1996,14970
220669,201901,29,26,3,25948,2994,28942
220670,201901,68,54,14,53892,13972,67864
220672,201901,68,47,21,46906,20958,67864
220675,201901,37,29,8,28942,7984,36926
220680,201901,39,33,6,32934,5988,38922
220690,201901,45,43,2,42914,1996,44910
220695,201901,50,23,27,22954,26946,49900
220700,201901,1654,1279,375,1276442,374250,1650692
220710,201901,5,3,2,2994,1996,4990
220720,201901,108,88,20,87824,19960,107784
220730,201901,19,18,1,17964,998,18962
220735,201901,3,1,2,998,1996,2994
220740,201901,49,45,4,44910,3992,48902
220750,201901,102,86,16,85828,15968,101796
220755,201901,15,15,0,14970,,14970.0
220760,201901,57,54,3,53892,2994,56886
220770,201901,5718,3019,2699,3013962.26,2695601.32,5709563.58
220775,201901,21,10,11,9980,10978,20958
220777,201901,17,16,1,15968,998,16966
220779,201901,13,11,2,10978,1996,12974
220780,201901,893,764,129,762472,128742.4,891214.4
220785,201901,17,11,6,10978,5988,16966
220790,201901,1043,835,208,833330.64,207584,1040914.64
220793,201901,12,12,0,11976,,11976.0
220795,201901,23,22,1,21956,998,22954
220800,201901,3999,3062,937,3057874.88,936125.98,3994000.86
220810,201901,65,57,8,56886,7984,64870
220820,201901,246,225,21,224550,20958,245508
220830,201901,1219,1043,176,1040914,175648,1216562
220840,201901,2374,1658,716,1654687.81,716565.38,2371253.19
220850,201901,54,46,8,45908,7984,53892
220855,201901,13,9,4,8982,3992,12974
220860,201901,10,9,1,8982,998,9980
220865,201901,24,22,2,21956,1996,23952
220870,201901,69,64,5,63872,4990,68862
220880,201901,327,252,75,251496,74850.4,326346.4
220885,201901,39,36,3,35928,2994,38922
220887,201901,16,16,0,15968,,15968.0
220890,201901,103,91,12,90818,11976,102794
220900,201901,54,31,23,30938,22954,53892
220910,201901,57,48,9,47904,8982,56886
220915,201901,10,9,1,8982,998,9980
220920,201901,44,40,4,39920,3992,43912
220930,201901,42,41,1,40918,998,41916
220935,201901,18,18,0,17964,,17964.0
220937,201901,39,37,2,36926,1996,38922
220940,201901,56,51,5,50898,4990,55888
220945,201901,0,0,0,0,0,0
220950,201901,46,42,4,41916,3992,45908
220955,201901,40,37,3,36926,2994,39920
220960,201901,4,4,0,3992,,3992.0
220965,201901,35,32,3,31936,2994,34930
220970,201901,55,46,9,45908,8982,54890
220975,201901,12,11,1,10978,998,11976
220980,201901,32,30,2,29940,1996,31936
220985,201901,68,60,8,59880,7984,67864
220987,201901,32,30,2,29940,1996,31936
220990,201901,17,16,1,15968,998,16966
220995,201901,29,24,5,23952,4990,28942
220997,201901,54,44,10,43912,9980,53892
221000,201901,1136,1024,112,1022950,111776,1134726
221005,201901,64,58,6,57884,5988,63872
221010,201901,17,13,4,12974,3992,16966
221020,201901,46,44,2,43912,1996,45908
221030,201901,32,26,6,25948,5988,31936
221035,201901,24,24,0,23952,,23952.0
221037,201901,11,6,5,5988,4990,10978
221038,201901,28,25,3,24950,2994,27944
221039,201901,22,22,0,21956,,21956.0
221040,201901,257,221,36,220558,35928,256486
221050,201901,233,198,35,197604,34930,232534
221060,201901,1804,1593,211,1589814,210578,1800392
221062,201901,34,33,1,32934,998,33932
221063,201901,12,8,4,7984,3992,11976
221065,201901,52,45,7,44910,6986,51896
221070,201901,142,123,19,122754.1,18962,141716.1
221080,201901,375,332,43,331336,42914,374250
221090,201901,32,31,1,30938,998,31936
221093,201901,54,36,18,35928,18962,54890
221095,201901,10,9,1,8982,998,9980
221097,201901,17,14,3,13972,2994,16966
221100,201901,25201,14711,10490,14686575.92,10474013.29,25160589.21
221110,201901,1054,783,271,782432.4,270458,1052890.4
221120,201901,530,398,132,398202.4,131736,529938.4
221130,201901,957,783,174,781434,173652,955086
221135,201901,37,34,3,33932,2994,36926
221140,201901,42,35,7,34930,6986,41916
221150,201901,13,10,3,9980,2994,12974
221160,201901,13,13,0,12974,,12974.0
221170,201901,14,14,0,13972,,13972.0
230010,201901,169,153,16,152694,15968,168662
230015,201901,125,105,20,104790,19960,124750
230020,201901,1618,1369,249,1366262.4,248508.79,1614771.19
230030,201901,1666,1201,465,1198600.78,465068,1663668.78
230040,201901,207,180,27,179640.4,26946,206586.4
230050,201901,213,155,58,154690,57884,212574
230060,201901,158,129,29,128742,28942,157684
230070,201901,292,261,31,260478,30938,291416
230075,201901,852,745,107,743510.8,106786,850296.8
230080,201901,190,164,26,163672,25948,189620
230090,201901,110,78,32,77844,31936,109780
230100,201901,1981,1179,802,1177641.34,800397.88,1978039.22
230110,201901,2737,1766,971,1763466.4,971054.4,2734520.8
230120,201901,966,774,192,773450.6,191616,965066.6
230125,201901,144,121,23,120758,22954,143712
230130,201901,475,423,52,422154,51896,474050
230140,201901,209,182,27,181636,26946,208582
230150,201901,160,121,39,120758,38922,159680
230160,201901,926,798,128,796404,127744,924148
230170,201901,585,538,47,536925,46906,583831
230180,201901,79,74,5,73852,4990,78842
230185,201901,411,355,56,354290,55888,410178
230190,201901,2248,1816,432,1815363.74,431136.63,2246500.37
230195,201901,494,429,65,428142,64870,493012
230200,201901,383,331,52,330338,51896,382234
230205,201901,372,240,132,239520,131736,371256
230210,201901,1275,1015,260,1013970.22,260478.94,1274449.16
230220,201901,1533,1051,482,1049896,481037.88,1530933.88
230230,201901,885,770,115,768460,114770,883230
230240,201901,1688,1453,235,1450344.16,234530,1684874.16
230250,201901,1794,1482,312,1479037.58,311376,1790413.58
230260,201901,3042,1884,1158,1881230.4,1157680,3038910.4
230270,201901,1374,1105,269,1104788.17,269460,1374248.17
230280,201901,2739,2046,693,2044902.8,692612,2737514.8
230290,201901,405,362,43,361278.67,42914,404192.67
230300,201901,513,383,130,382234,129740,511974
230310,201901,421,317,104,316366,103792,420158
230320,201901,946,807,139,805387.4,138722,944109.4
230330,201901,302,241,61,240518,60878.6,301396.6
230340,201901,454,365,89,365268.6,88822,454090.6
230350,201901,3099,1972,1127,1970052,1125744,3095796
230360,201901,277,215,62,214570,61876,276446
230365,201901,139,111,28,110778,27944,138722
230370,201901,9787,4863,4924,4857297.32,4917189.23,9774486.55
230380,201901,480,411,69,410178.4,68862.2,479040.6
230390,201901,516,292,224,291416,223552,514968
230393,201901,265,220,45,220558,44910,265468
230395,201901,350,282,68,281436.48,67864,349300.48
230400,201901,607,482,125,481036,124750,605786
230410,201901,2659,1666,993,1662669.09,991015,2653684.09
230420,201901,6249,4140,2109,4131723.84,2104784.56,6236508.40
230423,201901,318,277,41,276446,40918,317364
230425,201901,376,309,67,308382.34,66866,375248.34
230426,201901,122,100,22,99800,21956,121756
230427,201901,80,77,3,76846,2994,79840
230428,201901,1421,730,691,728540,689618.94,1418158.94
230430,201901,463,378,85,377244.99,84830,462074.99
230435,201901,841,594,247,592812.31,246506.98,839319.29
230440,201901,85311,38087,47224,38024982.12,47175697.17,85200679.29
230445,201901,279,193,86,192614,85828,278442
230450,201901,547,437,110,436126,109780,545906
230460,201901,59,49,10,48902,9980,58882
230465,201901,309,254,55,253492,55888,309380
230470,201901,1952,1532,420,1528936,419160.5,1948096.5
230480,201901,157,148,9,147704,8982,156686
230490,201901,289,231,58,230538,57884,288422
230495,201901,454,340,114,339320,113772,453092
230500,201901,975,731,244,731534,243512,975046
230510,201901,51,41,10,40918,9980,50898
230520,201901,391,306,85,305388.18,84830,390218.18
230523,201901,2192,1388,804,1385224.96,802393.06,2187618.02
230526,201901,295,249,46,248502,46906,295408
230530,201901,677,506,171,504988,170658,675646
230533,201901,195,184,11,183632,10978,194610
230535,201901,351,262,89,261476,88822.4,350298.4
230540,201901,1852,1632,220,1629734,219560,1849294
230550,201901,3713,2387,1326,2383226.92,1324346,3707572.92
230560,201901,582,443,139,442114.8,138722,580836.8
230565,201901,211,152,59,151696,58882,210578
230570,201901,301,266,35,265468,34930,300398
230580,201901,1117,831,286,830336.94,286426,1116762.94
230590,201901,967,755,212,754488.5,211576,966064.5
230600,201901,254,232,22,231536,21956,253492
230610,201901,350,278,72,277444.6,71856,349300.6
230620,201901,172,141,31,140718,30938,171656
230625,201901,725,526,199,524948.6,198602.94,723551.54
230630,201901,1297,1026,271,1023948,270458,1294406
230640,201901,3697,3206,491,3199589,490020.61,3689609.61
230650,201901,420,367,53,366267.91,52894,419161.91
230655,201901,666,578,88,577843.54,87828.86,665672.40
230660,201901,360,304,56,304390,55888,360278
230670,201901,430,379,51,379240,50898,430138
230680,201901,199,181,18,180638,17964,198602
230690,201901,883,765,118,763470,117764,881234
230700,201901,739,627,112,625746.94,111776.94,737523.88
230710,201901,736,698,38,697602.6,37924,735526.6
230720,201901,150,129,21,128742,20958,149700
230725,201901,256,204,52,204590,51896.98,256486.98
230730,201901,11973,6495,5478,6486005,5469045.69,11955050.69
230740,201901,660,537,123,535926.4,122754,658680.4
230750,201901,836,717,119,715566.6,119760,835326.6
230760,201901,1371,1181,190,1178638.2,189620,1368258.2
230763,201901,315,264,51,263472,50898,314370
230765,201901,7171,3402,3769,3398201.36,3761482.01,7159683.37
230770,201901,5000,2580,2420,2574842.28,2417156,4991998.28
230780,201901,687,605,82,603790.96,81836,685626.96
230790,201901,229,190,39,189620,38922,228542
230800,201901,1131,830,301,830336,300398,1130734
230810,201901,1311,1168,143,1165664,142714,1308378
230820,201901,347,245,102,245508.4,101796,347304.4
230830,201901,950,820,130,819358,129740,949098
230835,201901,282,245,37,245508,36926,282434
230837,201901,164,138,26,137724,25948,163672
230840,201901,928,741,187,739518.4,186626.4,926144.8
230850,201901,1520,1321,199,1319356,198603.34,1517959.34
230860,201901,301,226,75,225548,74850,300398
230870,201901,1823,1557,266,1553886.94,265468,1819354.94
230880,201901,48,33,15,32934,14970,47904
230890,201901,560,513,47,511974,46906.97,558880.97
230900,201901,280,208,72,207584,71856.58,279440.58
230910,201901,207,169,38,168662,37924,206586
230920,201901,410,324,86,323352,85828,409180
230930,201901,936,664,272,662672.68,271456,934128.68
230940,201901,848,674,174,673650.94,173652.6,847303.54
230945,201901,497,414,83,413173,82834,496007
230950,201901,396,338,58,337324,57884,395208
230960,201901,2577,1758,819,1754485.92,818362.28,2572848.20
230970,201901,1754,990,764,990024.46,764473.64,1754498.10
230980,201901,210,178,32,177644,31936,209580
230990,201901,140,113,27,112774,26946,139720
231000,201901,204,185,19,184630,18962,203592
231010,201901,148,113,35,112774,34930,147704
231020,201901,1329,927,402,925147.84,402194.94,1327342.78
231025,201901,1025,770,255,769458.6,254490.4,1023949.0
231030,201901,1125,945,180,943111.35,180638,1123749.35
231040,201901,140,96,44,95808,43912,139720
231050,201901,984,878,106,877242,105788,983030
231060,201901,147,128,19,127744,18962,146706
231070,201901,1466,1036,430,1033929.3,429140.94,1463070.24
231080,201901,259,242,17,243512,16966,260478
231085,201901,583,363,220,362274.6,219560,581834.6
231090,201901,245,203,42,202594,41916,244510
231095,201901,163,130,33,129740,32934,162674
231100,201901,135,114,21,113772,20958,134730
231110,201901,360,310,50,309380,49900,359280
231120,201901,296,253,43,252494,42914,295408
231123,201901,144,138,6,137724,5988,143712
231126,201901,317,253,64,252494,63872,316366
231130,201901,4600,3589,1011,3581822.97,1008979.91,4590802.88
231135,201901,212,184,28,183632,27944,211576
231140,201901,3114,2288,826,2285420,824348,3109768
231150,201901,368,350,18,349300,17964,367264
231160,201901,1198,954,244,953090.94,243512.94,1196603.88
231170,201901,532,363,169,363272,168662,531934
231180,201901,1648,1404,244,1401192,243512,1644704
231190,201901,202,176,26,175648,25948,201596
231195,201901,219,188,31,187624,30938,218562
231200,201901,829,676,153,674648,152694.6,827342.6
231210,201901,604,508,96,506984,95808,602792
231220,201901,1037,752,285,750496.9,284430,1034926.9
231230,201901,1418,1134,284,1132730,284430,1417160
231240,201901,1413,1026,387,1023948.94,386226.4,1410175.34
231250,201901,112,104,8,103792,7984,111776
231260,201901,291,192,99,191616,98802.4,290418.4
231270,201901,1009,840,169,838321.79,168662,1006983.79
231280,201901,62,47,15,46906,14970,61876
231290,201901,7380,4124,3256,4115752,3250487.8,7366239.8
231300,201901,641,590,51,588820,50898,639718
231310,201901,733,679,54,677642.74,53892,731534.74
231320,201901,581,442,139,441118,138722,579840
231325,201901,92,82,10,81836,9980,91816
231330,201901,2047,1582,465,1579087.93,466066.7,2045154.63
231335,201901,252,224,28,223552,27944,251496
231340,201901,1660,1226,434,1224546,433132,1657678
231350,201901,1255,1033,222,1030934,221556.8,1252490.8
231355,201901,427,371,56,370258,56886,427144
231360,201901,498,386,112,385228.4,111776,497004.4
231370,201901,90,76,14,75848,13972,89820
231375,201901,292,212,80,211576,79840,291416
231380,201901,465,380,85,381236,84830,466066
231390,201901,203,166,37,165668,36926,202594
231395,201901,733,460,273,459080,272454,731534
231400,201901,1091,901,190,899201.04,189622.34,1088823.38
231410,201901,1335,1089,246,1086822.2,245509.74,1332331.94
240010,201901,392,177,215,176646.43,215569.38,392215.81
240020,201901,2243,1777,466,1774445.67,465068.99,2239514.66
240030,201901,130,111,19,110778,18962,129740
240040,201901,30,30,0,29940,,29940.0
240050,201901,517,446,71,445108,70858,515966
240060,201901,65,61,4,60878,3992,64870
240070,201901,199,156,43,155688,42914,198602
240080,201901,466,312,154,312374.99,153692.46,466067.45
240090,201901,101,91,10,90818,9980,100798
240100,201901,1466,1385,81,1382231.5,80838,1463069.5
240110,201901,1045,676,369,674649.58,368262.7,1042912.28
240120,201901,140,119,21,118762,20958,139720
240130,201901,285,267,18,266466,17964,284430
240140,201901,84,65,19,64870,18962,83832
240145,201901,718,636,82,634728,81836,716564
240150,201901,20,16,4,15968,3992,19960
240160,201901,43,37,6,36926,5988,42914
240165,201901,38,32,6,31936.5,5988,37924.5
240170,201901,95,71,24,70858,23952,94810
240180,201901,82,67,15,66866,14970,81836
240185,201901,44,40,4,39920,3992,43912
240190,201901,13,11,2,10978,1996,12974
240200,201901,3033,1706,1327,1703588.4,1325345.4,3028933.8
240210,201901,168,130,38,129740,37924,167664
240220,201901,1102,798,304,796404.7,303392,1099796.7
240230,201901,844,782,62,780436.77,61876,842312.77
240240,201901,122,86,36,85828,35928,121756
240250,201901,88,79,9,78842,8982,87824
240260,201901,1807,1345,462,1342310,461076,1803386
240270,201901,190,168,22,167664,21956,189620
240280,201901,41,31,10,30938,9980,40918
240290,201901,50,49,1,48902,998,49900
240300,201901,179,101,78,100798,77844,178642
240310,201901,2041,1118,923,1115766.27,921155.7,2036921.97
240320,201901,203,192,11,191616,10978,202594
240325,201901,4302,2622,1680,2616760.27,1676642.07,4293402.34
240330,201901,67,63,4,62874,3992,66866
240340,201901,111,79,32,78842,31936,110778
240350,201901,90,80,10,79840,9980,89820
240360,201901,464,317,147,318362,146706,465068
240370,201901,43,41,2,40918,1996,42914
240375,201901,70,42,28,41916,27944,69860
240380,201901,228,186,42,185628,41916.8,227544.8
240390,201901,14,12,2,11976,1996,13972
240400,201901,77,74,3,73852,2994,76846
240410,201901,11,7,4,6986,3992,10978
240420,201901,919,703,216,702592.2,216566,919158.2
240430,201901,265,249,16,248502,15968,264470
240440,201901,84,48,36,47904,35928,83832
240450,201901,208,141,67,141716.4,66866,208582.4
240460,201901,64,50,14,49900,13972,63872
240470,201901,237,205,32,204590,31936,236526
240480,201901,14,13,1,12974,998,13972
240485,201901,81,70,11,69860,10978,80838
240490,201901,47,47,0,46906,,46906.0
240500,201901,87,70,17,69860,16966,86826
240510,201901,51,36,15,35928,14970,50898
240520,201901,119,114,5,113772,4990,118762
240530,201901,56,50,6,49900,5988,55888
240540,201901,79,69,10,68862,9980,78842
240550,201901,14,13,1,12974,998,13972
240560,201901,376,276,100,276446,99800,376246
240570,201901,470,295,175,294410,174650,469060
240580,201901,1251,1009,242,1006983.4,241516.99,1248500.39
240590,201901,28,26,2,25948,1996,27944
240600,201901,111,108,3,107784,2994,110778
240610,201901,512,428,84,428142.4,83832,511974.4
240615,201901,20,19,1,18962,998,19960
240620,201901,95,91,4,90818,3992,94810
240630,201901,36,34,2,33932,1996,35928
240640,201901,26,21,5,20958,4990,25948
240650,201901,234,197,37,196606,36926,233532
240660,201901,102,88,14,87824,13972,101796
240670,201901,298,177,121,176646.7,120758,297404.7
240680,201901,50,39,11,38922,10978,49900
240690,201901,47,45,2,44910,1996,46906
240700,201901,191,156,35,155688,34930,190618
240710,201901,1930,1223,707,1220555.3,705586,1926141.3
240720,201901,1074,787,287,786424,286426,1072850
240725,201901,65,61,4,60878,3992,64870
240730,201901,138,119,19,118762,18962,137724
240740,201901,236,201,35,200598,35928.74,236526.74
240750,201901,41,27,14,26946,13972,40918
240760,201901,41,38,3,37924,2994,40918
240770,201901,148,115,33,114770,32934,147704
240780,201901,677,560,117,559878,116766,676644
240790,201901,37,36,1,35928,998,36926
240800,201901,9010,6152,2858,6139704.87,2855281.68,8994986.55
240810,201901,20186,11162,9024,11143692.84,9010973.67,20154666.51
240820,201901,213,133,80,132734,79840,212574
240830,201901,1640,1347,293,1344306.7,292414,1636720.7
240840,201901,83,73,10,72854,9980,82834
240850,201901,83,73,10,72854,9980,82834
240860,201901,111,108,3,107784,2994,110778
240870,201901,61,53,8,52894,7984,60878
240880,201901,30,27,3,26946,2994,29940
240890,201901,1188,698,490,696606.26,489020.99,1185627.25
240895,201901,52,37,15,36926,14970,51896
240910,201901,161,146,15,145708,14970,160678
240920,201901,15,12,3,11976,2994,14970
240930,201901,398,359,39,359280,38922,398202
240933,201901,34,26,8,25948,7984,33932
240940,201901,2439,2152,287,2149693.28,286426,2436119.28
240950,201901,52,49,3,48902,2994,51896
240960,201901,32,26,6,25948,5988,31936
240970,201901,121,87,34,86826,33932,120758
240980,201901,194,155,39,154690,38922,193612
240990,201901,125,83,42,82834,41916,124750
241000,201901,66,61,5,60878,4990,65868
241010,201901,61,50,11,49900,10978,60878
241020,201901,113,106,7,105788,6986,112774
241025,201901,9,3,6,2994,5988,8982
241030,201901,119,97,22,96806,21956,118762
241040,201901,36,30,6,29940,5988,35928
241050,201901,89,79,10,78842,9980,88822
241060,201901,29,24,5,23952,4990,28942
241070,201901,17,17,0,16966,,16966.0
241080,201901,60,54,6,53892,5988,59880
241090,201901,49,40,9,39920,8982,48902
241100,201901,73,63,10,62874,9980,72854
241105,201901,6,2,4,1996,3992,5988
241110,201901,48,45,3,44910,2994,47904
241120,201901,1450,1113,337,1111772,336326,1448098
241140,201901,224,186,38,185628.4,37924,223552.4
241142,201901,43,40,3,39920,2994,42914
241150,201901,1206,1061,145,1059876,144710,1204586
241160,201901,23,22,1,21956,998,22954
241170,201901,44,40,4,39920,3992,43912
241180,201901,47,40,7,39920,6986,46906
241190,201901,38,37,1,36926,998,37924
241200,201901,3861,2096,1765,2091811.83,1762471.36,3854283.19
241210,201901,68,59,9,58882,8982,67864
241220,201901,1415,957,458,956084.71,459080.97,1415165.68
241230,201901,243,203,40,202594,39920.9,242514.9
241240,201901,55,42,13,41916,12974,54890
241250,201901,1112,1022,90,1019956.4,89820,1109776.4
241255,201901,49,40,9,39920,8982,48902
241260,201901,640,503,137,501994,136726,638720
241270,201901,50,37,13,36926,12974,49900
241280,201901,100,87,13,86826,12974,99800
241290,201901,109,83,26,82834,25948,108782
241300,201901,77,57,20,56886,19960,76846
241310,201901,49,38,11,37924.7,10978,48902.7
241320,201901,28,14,14,13972,13972,27944
241330,201901,62,57,5,56886,4990,61876
241335,201901,65,58,7,57884,6986,64870
241340,201901,187,140,47,139720,46906,186626
241350,201901,63,58,5,57884,4990,62874
241355,201901,43,38,5,37924,4990,42914
241360,201901,49,48,1,47904,998,48902
241370,201901,48,39,9,38922,8982,47904
241380,201901,41,37,4,36926,3992,40918
241390,201901,77,62,15,61876,14970,76846
241400,201901,206,166,40,165668,39920,205588
241410,201901,185,168,17,167664,16966,184630
241415,201901,99,78,21,78842,20958,99800
241420,201901,99,74,25,73852,24950.64,98802.64
241430,201901,28,27,1,26946,998,27944
241440,201901,505,417,88,416166.97,87824,503990.97
241445,201901,37,35,2,34930,1996,36926
241450,201901,281,230,51,229540,50898,280438
241460,201901,140,129,11,128742.5,10978,139720.5
241470,201901,42,35,7,34930,6986,41916
241475,201901,61,58,3,57884,2994,60878
241480,201901,99,71,28,70858,27944,98802
241490,201901,8,7,1,6986,998,7984
241500,201901,47,34,13,33932,12974,46906
250010,201901,104,89,15,88822,14970,103792
250020,201901,34,30,4,29940,3992,33932
250030,201901,823,617,206,615766,207584.6,823350.6
250040,201901,345,287,58,286426,57884,344310
250050,201901,234,194,40,193612.99,39920,233532.99
250053,201901,57,43,14,42914,13972,56886
250057,201901,0,0,0,0,0,0
250060,201901,469,361,108,360278,107784,468062
250070,201901,700,578,122,576844.75,121756,698600.75
250073,201901,8,8,0,7984,,7984.0
250077,201901,195,147,48,147704,47904,195608
250080,201901,419,329,90,328342.72,90818,419160.72
250090,201901,201,132,69,131736,68862,200598
250100,201901,512,426,86,425148,85828.2,510976.2
250110,201901,569,432,137,431136,136726,567862
250115,201901,24,7,17,6986,16966,23952
250120,201901,113,84,29,83832,28942,112774
250130,201901,569,461,108,461076,107784.6,568860.6
250135,201901,14,8,6,7984,5988,13972
250140,201901,84,77,7,76846,6986,83832
250150,201901,572,418,154,417164,153692,570856
250153,201901,8,7,1,6986,998,7984
250157,201901,27,22,5,21956,4990,26946
250160,201901,214,170,44,169660,43912,213572
250170,201901,64,44,20,43912,19960,63872
250180,201901,4094,2803,1291,2798395.06,1290418.55,4088813.61
250190,201901,865,573,292,571854,293412.5,865266.5
250200,201901,52,44,8,43912,7984,51896
250205,201901,23,20,3,19960,2994,22954
250210,201901,88,77,11,76846,10978,87824
250215,201901,63,55,8,54890,7984,62874
250220,201901,27,21,6,20958,5988,26946
250230,201901,78,71,7,70858.99,6986,77844.99
250240,201901,242,200,42,199600,41916,241516
250250,201901,401,342,59,341316,58882,400198
250260,201901,35,31,4,30938,3992,34930
250270,201901,62,48,14,47904,13972,61876
250280,201901,381,316,65,315368,64870,380238
250290,201901,92,85,7,84830,6986,91816
250300,201901,552,380,172,379240,172655.97,551895.97
250310,201901,45,41,4,40918,3992,44910
250320,201901,1989,1355,634,1352293.68,633731.38,1986025.06
250330,201901,93,82,11,81836,10978,92814
250340,201901,23,20,3,19960,2994,22954
250350,201901,145,96,49,95808,48902,144710
250355,201901,36,28,8,27944,7984,35928
250360,201901,200,163,37,162674,36926,199600
250370,201901,2406,1620,786,1616760.4,784428,2401188.4
250375,201901,8,3,5,2994,4990,7984
250380,201901,54,39,15,38922,14970,53892
250390,201901,42,34,8,33932,7984,41916
250400,201901,16198,8242,7956,8232510.12,7948077.72,16180587.84
250403,201901,382,311,71,310378,70858,381236
250407,201901,60,52,8,51896,7984,59880
250410,201901,30,26,4,25948,3992,29940
250415,201901,42,28,14,27944,13972,41916
250420,201901,46,38,8,37924,7984,45908
250430,201901,1503,1275,228,1272699.5,227544,1500243.5
250435,201901,15,12,3,11976,2994,14970
250440,201901,689,588,101,587822.6,100798,688620.6
250450,201901,86,70,16,69860,15968,85828
250460,201901,428,296,132,295408,131736,427144
250470,201901,86,64,22,63872,21956,85828
250480,201901,331,265,66,264470,66866,331336
250485,201901,1,1,0,998,,998.0
250490,201901,229,192,37,191616,36926,228542
250500,201901,80,60,20,59880,20958,80838
250510,201901,726,574,152,572852,151696,724548
250520,201901,175,122,53,121756,52894,174650
250523,201901,115,97,18,96806,17964,114770
250527,201901,100,80,20,79840,19960,99800
250530,201901,7,4,3,3992,2994,6986
250535,201901,24,20,4,19960,3992,23952
250540,201901,130,100,30,99800,29940,129740
250550,201901,70,67,3,66866,2994,69860
250560,201901,40,30,10,29940,9980,39920
250570,201901,155,125,30,124750,29940,154690
250580,201901,122,98,24,97868,23952,121820
250590,201901,21,15,6,14970,5988,20958
250600,201901,1253,843,410,842312.64,410178,1252490.64
250610,201901,155,134,21,133732,20958,154690
250620,201901,24,20,4,19960,3992,23952
250625,201901,67,50,17,49900,16966,66866
250630,201901,3030,1961,1069,1957093.68,1070861.92,3027955.60
250640,201901,209,173,36,172654,35928,208582
250650,201901,28,20,8,19960,7984,27944
250660,201901,44,33,11,32934,10978,43912
250670,201901,61,41,20,40918,19960,60878
250680,201901,392,321,71,320358,70858,391216
250690,201901,1884,1311,573,1308382.15,571854.8,1880236.95
250700,201901,932,817,115,815367.1,114770,930137.1
250710,201901,442,346,96,345308,95808,441116
250720,201901,114,88,26,87824,25948,113772
250730,201901,382,324,58,323352,57884,381236
250740,201901,52,48,4,47904,3992,51896
250750,201901,20977,12723,8254,12706448.07,8246482.38,20952930.45
250760,201901,77,58,19,57884,18962,76846
250770,201901,350,230,120,229540.44,119760,349300.44
250780,201901,56,43,13,42914,12974,55888
250790,201901,466,301,165,300398,164670,465068
250800,201901,153,140,13,139720,12974,152694
250810,201901,82,63,19,62874,18962,81836
250820,201901,158,130,28,129740,27944,157684
250830,201901,422,292,130,291416.4,129740,421156.4
250840,201901,52,50,2,49900,1996,51896
250850,201901,56,44,12,43912,11976,55888
250855,201901,13,11,2,10978,1996,12974
250860,201901,202,144,58,143712,57884,201596
250870,201901,35,32,3,31936,2994,34930
250880,201901,82,61,21,60878,20958,81836
250890,201901,2598,1937,661,1933126,659678,2592804
250900,201901,126,110,16,109780,15968,125748
250905,201901,125,98,27,97804,26946,124750
250910,201901,1176,838,338,836324.99,337324,1173648.99
250915,201901,111,78,33,77844,32934,110778
250920,201901,141,106,35,105788,34930,140718
250930,201901,165,103,62,102794,61876,164670
250933,201901,1,1,0,998,,998.0
250937,201901,8,7,1,6986,998,7984
250939,201901,31,24,7,23952,6986,30938
250940,201901,112,85,27,84830,26946,111776
250950,201901,69,46,23,45908,22954,68862
250960,201901,90,49,41,48902,41916,90818
250970,201901,1224,865,359,863270,359280,1222550
250980,201901,89,62,27,61876,26946,88822
250990,201901,169,130,39,129740,38922,168662
251000,201901,76,67,9,66866,8982,75848
251010,201901,102,81,21,80838.99,20958,101796.99
251020,201901,81,71,10,70858,9980,80838
251030,201901,44,33,11,32934,10978,43912
251040,201901,53,39,14,38922,13972,52894
251050,201901,23,21,2,20958,1996,22954
251060,201901,50,39,11,38922,10978,49900
251065,201901,3,3,0,2994,,2994.0
251070,201901,23,19,4,18962.98,3992,22954.98
251080,201901,4814,2329,2485,2325362.86,2481032.63,4806395.49
251090,201901,195,166,29,165668,28942,194610
251100,201901,18,18,0,17964,,17964.0
251110,201901,44,35,9,34930,8982,43912
251120,201901,1828,1111,717,1109777.2,716564.4,1826341.6
251130,201901,391,318,73,317364,72854,390218
251140,201901,534,349,185,348303.2,184630,532933.2
251150,201901,306,266,40,265468.98,39920,305388.98
251160,201901,97,81,16,81836,15968,97804
251170,201901,101,80,21,79840,20958,100798
251180,201901,291,184,107,183632.99,106786.99,290419.98
251190,201901,191,132,59,131736,58882,190618
251200,201901,253,206,47,205588,46906,252494
251203,201901,38,36,2,35928,1996,37924
251207,201901,95,78,17,77844,16966,94810
251210,201901,1454,1054,400,1051892,399200,1451092
251220,201901,48,39,9,38922,8982,47904
251230,201901,461,388,73,387224,72854,460078
251240,201901,101,73,28,72854,27944,100798
251250,201901,1353,965,388,963070.9,387224.7,1350295.6
251260,201901,14,7,7,6986,6986,13972
251270,201901,334,251,83,251496,82834.7,334330.7
251272,201901,66,60,6,59880,5988,65868
251274,201901,28,22,6,21956,5988,27944
251275,201901,29,18,11,17964,10978,28942
251276,201901,11,9,2,8982,1996,10978
251278,201901,8,7,1,6986,998,7984
251280,201901,103,98,5,97804,4990,102794
251290,201901,716,543,173,541914,172654,714568
251300,201901,16,13,3,12974,2994,15968
251310,201901,373,268,105,267464.99,104790,372254.99
251315,201901,20,19,1,18962,998,19960
251320,201901,61,49,12,48902,11976,60878
251330,201901,82,73,9,72854,8982,81836
251335,201901,12,7,5,6986,4990,11976
251340,201901,712,417,295,416166,294410,710576
251350,201901,37,35,2,34930,1996,36926
251360,201901,74,64,10,63872,9980,73852
251365,201901,14,14,0,13972,,13972.0
251370,201901,5420,3692,1728,3684619.14,1724544.6,5409163.74
251380,201901,48,38,10,37924,9980,47904
251385,201901,3,3,0,2994,,2994.0
251390,201901,712,560,152,558880.7,151696.4,710577.1
251392,201901,11,5,6,4990,5988,10978
251394,201901,9,9,0,8982,,8982.0
251396,201901,15,10,5,9980,4990,14970
251398,201901,19,16,3,15968,2994,18962
251400,201901,43,36,7,35928,6986,42914
251410,201901,37,31,6,30938,5988,36926
251420,201901,103,76,27,75848,26946,102794
251430,201901,42,39,3,38922,2994,41916
251440,201901,35,21,14,20958,13972,34930
251445,201901,56,52,4,51896,3992,55888
251450,201901,408,358,50,357284.2,49900,407184.2
251455,201901,2,1,1,998,998,1996
251460,201901,15,13,2,12974,1996,14970
251465,201901,5,2,3,1996,2994,4990
251470,201901,48,38,10,37924,9980,47904
251480,201901,26,23,3,22954,2994,25948
251490,201901,119,83,36,82834,35928.4,118762.4
251500,201901,129,105,24,104790,23952,128742
251510,201901,38,29,9,28942,8982,37924
251520,201901,26,26,0,25948,,25948.0
251530,201901,4512,3177,1335,3170646.8,1332330,4502976.8
251540,201901,75,65,10,64870,9980,74850
251550,201901,409,315,94,314370,94810.9,409180.9
251560,201901,23,16,7,15968,6986,22954
251570,201901,20,20,0,19960,,19960.0
251580,201901,124,102,22,101796,21956,123752
251590,201901,120,88,32,88013,31936,119949
251593,201901,26,17,9,16966,8982,25948
251597,201901,58,49,9,48902,8982,57884
251600,201901,1093,780,313,779445.71,312375.36,1091821.07
251610,201901,219,168,51,167664,50898,218562
251615,201901,3,3,0,2994,,2994.0
251620,201901,4276,2845,1431,2839312.84,1429138.2,4268451.04
251630,201901,444,325,119,324350,118762.98,443112.98
251640,201901,147,105,42,104790,41916,146706
251650,201901,269,196,73,195608.7,72854,268462.7
251660,201901,230,205,25,204590,24950,229540
251670,201901,363,283,80,282434,79840,362274
251675,201901,4,4,0,3992,,3992.0
251680,201901,96,86,10,85828,9980,95808
251690,201901,343,286,57,285428,56886,342314
251700,201901,283,242,41,241516,40918,282434
251710,201901,23,15,8,14970,7984,22954
251720,201901,31,21,10,20958,9980.4,30938.4
251740,201901,10,8,2,7984,1996,9980
260005,201901,3178,1810,1368,1808379.21,1365266.88,3173646.09
260010,201901,1564,1129,435,1126742.14,434131.04,1560873.18
260020,201901,421,372,49,371256,48902,420158
260030,201901,580,418,162,417164,161676,578840
260040,201901,854,533,321,531934,320358,852292
260050,201901,1158,838,320,836324.5,319360.8,1155685.3
260060,201901,405,368,37,367264,36926,404190
260070,201901,1436,904,532,902196.25,530936.69,1433132.94
260080,201901,726,573,153,571854,152694,724548
260090,201901,565,351,214,350299.96,213572,563871.96
260100,201901,231,164,67,163672,66866,230538
260105,201901,228,128,100,127744,99800,227544
260110,201901,2779,2059,720,2054882.98,718560.4,2773443.38
260120,201901,2921,1466,1455,1463069.62,1457081.3,2920150.92
260130,201901,159,112,47,111776,46906,158682
260140,201901,2156,1422,734,1419167.46,733530.98,2152698.44
260150,201901,226,147,79,146706,78842,225548
260160,201901,306,255,51,254490,50898,305388
260170,201901,3387,2077,1310,2072846.4,1309376.4,3382222.8
260180,201901,153,129,24,128742,23952,152694
260190,201901,2294,1614,680,1611770,678640,2290410
260200,201901,939,764,175,762472.63,174650.4,937123.03
260210,201901,1429,1019,410,1016962,409180.98,1426142.98
260220,201901,728,661,67,659678,66866,726544
260230,201901,1213,918,295,916164,294410,1210574
260240,201901,230,175,55,174650,54890,229540
260250,201901,87,65,22,64870,21956,86826
260260,201901,1004,719,285,717562,284430,1001992
260270,201901,429,346,83,345308,82834,428142
260280,201901,1371,936,435,934128,438122.4,1372250.4
260290,201901,6430,3483,2947,3482028.28,2946102.47,6428130.75
260300,201901,900,791,109,790416.6,108782.4,899199.0
260310,201901,521,416,105,415168,104790,519958
260320,201901,885,668,217,666664,217564,884228
260330,201901,42,32,10,31936,9980,41916
260340,201901,75,54,21,53892,20958,74850
260345,201901,5621,3158,2463,3155680.27,2461071.9,5616752.17
260350,201901,489,354,135,353292.4,134730,488022.4
260360,201901,277,145,132,144710,131736,276446
260370,201901,678,451,227,450099.24,226546.99,676646.23
260380,201901,615,444,171,443112,170658.66,613770.66
260390,201901,298,253,45,252494,44910,297404
260392,201901,103,91,12,90818,11976,102794
260400,201901,4057,2352,1705,2348297.33,1701591.38,4049888.71
260410,201901,14661,7763,6898,7750471.75,6896181.28,14646653.03
260415,201901,123,112,11,111776,10978,122754
260420,201901,1803,1093,710,1090815.12,709578,1800393.12
260430,201901,191,173,18,172655.25,17964,190619.25
260440,201901,222,161,61,160678.98,60878,221556.98
260450,201901,465,337,128,336327.2,127744,464071.2
260460,201901,835,444,391,443113.2,390218,833331.2
260470,201901,367,227,140,226546,139720.8,366266.8
260480,201901,216,138,78,137724,77844,215568
260490,201901,218,178,40,177644,39920,217564
260500,201901,1126,761,365,759478,365268,1124746
260510,201901,757,604,153,602792,152694,755486
260515,201901,243,219,24,218562,23952,242514
260520,201901,3311,1991,1320,1989015.93,1320355.32,3309371.25
260530,201901,806,656,150,656684,149700,806384
260540,201901,560,430,130,429140,129740,558880
260545,201901,13,10,3,9980,2994,12974
260550,201901,348,219,129,218562,128742,347304
260560,201901,528,400,128,400198.4,127744,527942.4
260570,201901,1001,822,179,820356,178642,998998
260580,201901,257,229,28,228542,27944,256486
260590,201901,641,373,268,372254,267464,639718
260600,201901,8058,4221,3837,4213558.33,3841302,8054860.33
260610,201901,496,336,160,335328,159680,495008
260620,201901,3700,1934,1766,1930134.66,1765463.11,3695597.77
260630,201901,81,78,3,77844,2994,80838
260640,201901,3698,2027,1671,2023945.9,1667658.98,3691604.88
260650,201901,320,232,88,231536,87824,319360
260660,201901,528,356,172,355288,171656,526944
260670,201901,102,75,27,74850,26946,101796
260680,201901,3660,2064,1596,2060873.64,1593807.36,3654681.00
260690,201901,123,94,29,93812,28942,122754
260700,201901,336,210,126,209580,125748,335328
260710,201901,36,33,3,32934,2994,35928
260720,201901,2289,1384,905,1381233.6,904188,2285421.6
260730,201901,638,485,153,484030,152694,636724
260740,201901,58,54,4,53892,3992,57884
260750,201901,637,448,189,447104,188622,635726
260760,201901,627,339,288,338322,287424,625746
260765,201901,980,514,466,513970.99,465068,979038.99
260770,201901,226,171,55,170658,54890,225548
260775,201901,816,485,331,484031.3,330338.98,814370.28
260780,201901,277,182,95,181636,94810,276446
260790,201901,12159,6716,5443,6710563.28,5439105.91,12149669.19
260795,201901,164,113,51,112774,50898,163672
260800,201901,293,245,48,244510,47904,292414
260805,201901,175,112,63,111776,62874,174650
260810,201901,736,645,91,644708,91816,736524
260820,201901,314,210,104,210578,103792,314370
260825,201901,203,141,62,140718,62874,203592
260830,201901,271,171,100,170658,99800,270458
260840,201901,236,173,63,172654,62874,235528
260845,201901,200,133,67,132734,67864,200598
260850,201901,488,361,127,362274,127744,490018
260860,201901,252,188,64,187624,64870,252494
260870,201901,370,274,96,273452.54,95808,369260.54
260875,201901,730,521,209,519958,209580,729538
260880,201901,1613,1008,605,1005984.2,606784,1612768.2
260890,201901,2417,1707,710,1703587,709578.8,2413165.8
260900,201901,1025,708,317,706584,316366,1022950
260910,201901,275,216,59,215568,58882,274450
260915,201901,313,217,96,216566,95808,312374
260920,201901,177,98,79,97804,78842,176646
260930,201901,396,342,54,341316.97,53892.97,395209.94
260940,201901,2885,1589,1296,1588551.06,1294406.4,2882957.46
260950,201901,2043,1195,848,1193609.66,847302,2040911.66
260960,201901,13991,7285,6706,7274433.95,6700583.29,13975017.24
260970,201901,437,378,59,378242,58882,437124
260980,201901,195,172,23,171656,22954,194610
260990,201901,2604,2134,470,2130731.34,469060,2599791.34
261000,201901,4365,2584,1781,2579689.01,1779434.6,4359123.61
261010,201901,179,135,44,134730,43912,178642
261020,201901,615,460,155,461076.7,154690,615766.7
261030,201901,226,168,58,167664,57884,225548
261040,201901,367,325,42,324350,41916,366266
261050,201901,488,428,60,427144,59880,487024
261060,201901,1353,896,457,894208.5,457084,1351292.5
261070,201901,8888,4538,4350,4531945.23,4344347.71,8876292.94
261080,201901,388,295,93,294410,92814,387224
261090,201901,2269,1734,535,1730536.31,533931.45,2264467.76
261100,201901,1094,764,330,763471.3,329340,1092811.3
261110,201901,8371,5154,3217,5146688.79,3212566.64,8359255.43
261120,201901,269,227,42,226546,41916,268462
261130,201901,575,341,234,340318.6,233532.62,573851.22
261140,201901,191,125,66,124750,65868,190618
261150,201901,689,419,270,419160.18,269460,688620.18
261153,201901,73,69,4,68862,3992,72854
261160,201901,77640,39167,38473,39113248.61,38439011.16,77552259.77
261170,201901,453,343,110,342314,109780,452094
261180,201901,1800,1114,686,1112770,685626,1798396
261190,201901,616,433,183,432136.52,182634.98,614771.50
261200,201901,221,190,31,189620,30938,220558
261210,201901,33,29,4,28942,3992,32934
261220,201901,2658,1872,786,1870254.18,784429.37,2654683.55
261230,201901,336,249,87,248502,86826,335328
261240,201901,456,393,63,392214,62874,455088
261245,201901,234,195,39,194610,38922,233532
261247,201901,168,132,36,131736,35928,167664
261250,201901,2911,1485,1426,1482030.9,1423148,2905178.9
261255,201901,259,232,27,231536,26946,258482
261260,201901,865,750,115,749498,114770,864268
261270,201901,183,140,43,139720,42914,182634
261280,201901,175,147,28,146706,27944,174650
261290,201901,129,91,38,90818,37924,128742
261300,201901,1258,905,353,904188,353292,1257480
261310,201901,774,519,255,517962.8,254490,772452.8
261320,201901,558,377,181,376246,180638,556884
261330,201901,970,753,217,751494,216566,968060
261340,201901,297,168,129,167664,128742,296406
261350,201901,822,587,235,587822.4,234530,822352.4
261360,201901,1261,828,433,826344,433132,1259476
261370,201901,4942,3037,1905,3033923.36,1904187.49,4938110.85
261380,201901,564,420,144,420158.7,144710.4,564869.1
261390,201901,3517,2361,1156,2359272,1156683.9,3515955.9
261400,201901,281,255,26,255488,25948,281436
261410,201901,1106,746,360,744508,360278,1104786
261420,201901,882,556,326,554890.36,325348.98,880239.34
261430,201901,331,298,33,297404,32934,330338
261440,201901,124,113,11,113772,10978,124750
261450,201901,2540,2092,448,2088815.91,447104.96,2535920.87
261460,201901,735,590,145,589818.74,145708,735526.74
261470,201901,257,197,60,196606,59880,256486
261480,201901,381,300,81,299400.6,80838.99,380239.59
261485,201901,345,213,132,212574,131736,344310
261500,201901,624,421,203,420158,202594,622752
261510,201901,48,32,16,31936,15968,47904
261520,201901,110,98,12,97804,11976,109780
261530,201901,4146,2633,1513,2628733.19,1509975.84,4138709.03
261540,201901,1140,696,444,694608,443112,1137720
261550,201901,281,140,141,139720.4,140718,280438.4
261560,201901,818,545,273,543910.7,272455.78,816366.48
261570,201901,387,304,83,303392,82834,386226
261580,201901,386,300,86,299400,85828,385228
261590,201901,201,164,37,164670,36926,201596
261600,201901,300,240,60,239520,59880,299400
261610,201901,105,92,13,91816,12974,104790
261618,201901,65,51,14,50898,13972,64870
261620,201901,208,130,78,129740,77844,207584
261630,201901,576,446,130,445108,129740,574848
261640,201901,6398,3417,2981,3412166.31,2982024.9,6394191.21
261650,201901,499,319,180,318362,179640,498002
270010,201901,534,474,60,473052.4,59880,532932.4
270020,201901,299,236,63,235528.99,62874,298402.99
270030,201901,9225,5960,3265,5948174.28,3259508.54,9207682.82
270040,201901,2027,1260,767,1257480,765466,2022946
270050,201901,172,126,46,125748,45908,171656
270060,201901,114,65,49,64870,48902,113772
270070,201901,896,652,244,650696,243512.98,894208.98
270080,201901,37,31,6,30938,5988,36926
270090,201901,20,16,4,15968,3992,19960
270100,201901,1229,821,408,819358.98,407184,1226542.98
270110,201901,142,107,35,106786,34930,141716
270120,201901,229,188,41,187624,40918,228542
270130,201901,246,170,76,169660,75848,245508
270135,201901,101,61,40,60878,39920,100798
270140,201901,1347,831,516,829340.95,514968.98,1344309.93
270150,201901,265,210,55,209580,54890,264470
270160,201901,528,395,133,394210,132734,526944
270170,201901,779,509,270,508980,269460,778440
270180,201901,73,56,17,56886,16966,73852
270190,201901,99,88,11,87824,10978,98802
270200,201901,108,97,11,96806,10978,107784
270210,201901,481,254,227,254490,226546,481036
270220,201901,184,143,41,142714,40918,183632
270230,201901,2119,1287,832,1284429.12,831335.94,2115765.06
270235,201901,730,558,172,556889.78,172658.88,729548.66
270240,201901,3124,2454,670,2449094.94,668662.54,3117757.48
270250,201901,171,122,49,121756,48902,170658
270255,201901,223,192,31,191616,30938,222554
270260,201901,355,284,71,283432,70858.37,354290.37
270270,201901,106,45,61,44910.98,60878,105788.98
270280,201901,246,142,104,141716,103792,245508
270290,201901,1205,922,283,921154.6,282434.98,1203589.58
270300,201901,296,195,101,194610,100798,295408
270310,201901,901,727,174,726548.88,173653.96,900202.84
270320,201901,883,756,127,754489.61,126746,881235.61
270330,201901,279,235,44,234530,43912,278442
270340,201901,63,50,13,49900,12974,62874
270350,201901,91,46,45,45908,44910,90818
270360,201901,66,38,28,37924,27944,65868
270370,201901,56,44,12,43912,11976,55888
270375,201901,74,47,27,46906,26946,73852
270380,201901,1027,604,423,602792,422154,1024946
270390,201901,189,109,80,108782,79840,188622
270400,201901,710,522,188,520959.81,187624,708583.81
270410,201901,695,503,192,501994,191616,693610
270420,201901,407,270,137,269460,136729.88,406189.88
270430,201901,33201,23866,9335,23831242.1,9319336.9,33150579.0
270440,201901,489,384,105,383232,104790,488022
270450,201901,789,425,364,424150,363272.42,787422.42
270460,201901,195,152,43,151696,42914,194610
270470,201901,1427,957,470,956084.79,471056,1427140.79
270480,201901,537,439,98,439520,97804,537324
270490,201901,25,20,5,19960,4990,24950
270500,201901,516,427,89,426146,88822,514968
270510,201901,752,465,287,464070,286426,750496
270520,201901,344,215,129,214570,128742,343312
270530,201901,65,58,7,57884,6986,64870
270540,201901,122,93,29,92814,28942,121756
270550,201901,1735,1321,414,1318359.98,413172,1731531.98
270560,201901,299,145,154,144710,153692,298402
270570,201901,485,333,152,332334,151696,484030
270580,201901,88,67,21,66866,20958,87824
270590,201901,73,58,15,57884,14970,72854
270600,201901,178,145,33,144710,32934,177644
270610,201901,206,173,33,172654.98,32934,205588.98
270620,201901,30,29,1,28942,998,29940
270630,201901,3896,2980,916,2974045.14,914168,3888213.14
270640,201901,908,668,240,666664,239521.94,906185.94
270642,201901,220,185,35,184630,34930,219560
270644,201901,260,178,82,177644.98,81836,259480.98
270650,201901,298,177,121,176646,120758,297404
270660,201901,256,210,46,210578,45908,256486
270670,201901,3133,2388,745,2384226.88,745507.38,3129734.26
270680,201901,472,275,197,274450.98,196606,471056.98
270690,201901,1145,733,412,731534,415168,1146702
270700,201901,36,27,9,26946,8982,35928
270710,201901,898,682,216,680636,215568,896204
270720,201901,257,197,60,196606,59880,256486
270730,201901,1955,1153,802,1150694.8,800398.08,1951092.88
270740,201901,44,27,17,26946,16966,43912
270750,201901,673,494,179,493012.6,178642,671654.6
270760,201901,302,217,85,216566,84830,301396
270770,201901,2831,1818,1013,1815998.06,1011972.96,2827971.02
270780,201901,85,53,32,52894,31937.98,84831.98
270790,201901,254,169,85,168662,84830,253492
270800,201901,1984,1600,384,1596834.25,383232,1980066.25
270810,201901,295,239,56,238522,55888.99,294410.99
270820,201901,157,103,54,102794,53892.8,156686.8
270830,201901,878,641,237,639718.99,239521.39,879240.38
270840,201901,1426,1066,360,1063868,359280.74,1423148.74
270850,201901,1621,996,625,994009,624748.98,1618757.98
270860,201901,2528,1653,875,1649729.23,873252.67,2522981.90
270870,201901,126,70,56,69860,55888,125748
270880,201901,915,692,223,690627.7,222559.84,913187.54
270890,201901,333,242,91,241516,90818,332334
270895,201901,68,59,9,58882,8982,67864
270900,201901,100,77,23,76846,22954,99800
270910,201901,322,253,69,252494,69860,322354
270915,201901,1910,1171,739,1169185.7,737533.4,1906719.1
270920,201901,490,415,75,414170,74850,489020
270930,201901,6203,4551,1652,4542912.22,1652702.27,6195614.49
270940,201901,2385,1819,566,1816360,564868.4,2381228.4
280010,201901,42,37,5,36926,4990,41916
280020,201901,732,632,100,630736.96,99800,730536.96
280030,201901,20153,13081,7072,13060867.07,7067850.36,20128717.43
280040,201901,337,220,117,219560,116766,336326
280050,201901,387,301,86,300398,85828,386226
280060,201901,337,228,109,227545.18,108782,336327.18
280067,201901,984,696,288,695606.49,287424.75,983031.24
280070,201901,130,108,22,107784,21956,129740
280100,201901,614,485,129,485029.16,128742.6,613771.76
280110,201901,76,71,5,70858,4990,75848
280120,201901,628,504,124,502992,123752,626744
280130,201901,1439,915,524,914168.6,522952,1437120.6
280140,201901,478,391,87,390218,86826,477044
280150,201901,359,263,96,263472,95808,359280
280160,201901,96,84,12,83832,11976,95808
280170,201901,423,277,146,276446.49,145708,422154.49
280190,201901,27,25,2,24950,1996,26946
280200,201901,29,23,6,22954,5988,28942
280210,201901,2814,2008,806,2004985.68,805386.4,2810372.08
280220,201901,43,33,10,32934,9980,42914
280230,201901,325,270,55,269460,54890,324350
280240,201901,117,111,6,110778,5988,116766
280250,201901,18,12,6,11976,5988,17964
280260,201901,83,73,10,72854,9980,82834
280270,201901,159,123,36,122754,35928,158682
280280,201901,193,125,68,124750,67864,192614
280290,201901,3208,2329,879,2324280.64,877242.64,3201523.28
280300,201901,1614,1233,381,1230534.4,381236,1611770.4
280310,201901,106,102,4,101796.6,3992,105788.6
280320,201901,663,459,204,460078,204590,664668
280330,201901,363,261,102,260478,101796,362274
280340,201901,413,334,79,333332,78842,412174
280350,201901,3578,2781,797,2777437.74,795406.7,3572844.44
280360,201901,445,285,160,284430,159680,444110
280370,201901,102,90,12,89820,11976,101796
280380,201901,54,41,13,40918,12974,53892
280390,201901,182,156,26,155688,25948,181636
280400,201901,345,240,105,240519.76,104790,345309.76
280410,201901,289,235,54,234530.6,53892,288422.6
280420,201901,172,144,28,143712,27944,171656
280430,201901,112,86,26,85828,25948,111776
280440,201901,693,534,159,532933.46,158682,691615.46
280445,201901,118,110,8,109780,7984,117764
280450,201901,1158,995,163,993010,163672,1156682
280460,201901,756,556,200,554888.7,199600,754488.7
280470,201901,192,179,13,178642,13972.7,192614.7
280480,201901,2388,1701,687,1697601.36,685627.62,2383228.98
280490,201901,346,318,28,318362.15,27944,346306.15
280500,201901,41,37,4,36926,3992,40918
280510,201901,143,111,32,110778,31936.4,142714.4
280520,201901,57,43,14,42914,13972,56886
280530,201901,76,50,26,49900,25948,75848
280540,201901,528,429,99,428142.7,98802,526944.7
280550,201901,735,676,59,674650.4,58882,733532.4
280560,201901,501,437,64,436126,63872,499998
280570,201901,1811,1387,424,1384228.38,423152,1807380.38
280580,201901,608,469,139,468064.19,138722.8,606786.99
280590,201901,171,111,60,110778,59880,170658
280600,201901,380,319,61,318362,60878,379240
280610,201901,134,100,34,99800,33932,133732
280620,201901,545,455,90,454090,89820,543910
280630,201901,166,138,28,137724,27944,165668
280640,201901,200,161,39,160678.96,38922,199600.96
280650,201901,76,53,23,52894,22954,75848
280660,201901,141,102,39,101796,38922,140718
280670,201901,1758,1120,638,1117764.65,636725.26,1754489.91
280680,201901,179,152,27,151697.09,26946,178643.09
280690,201901,56,47,9,46906,8982,55888
280700,201901,22,22,0,21956,,21956.0
280710,201901,1446,1111,335,1108778.6,334330,1443108.6
280720,201901,114,77,37,76846,36926,113772
280730,201901,26,22,4,21956,3992,25948
280740,201901,2481,1841,640,1837318.8,638720,2476038.8
280750,201901,225,199,26,198602,25948,224550
280760,201901,688,476,212,475048,211576,686624
290010,201901,205,140,65,139720,64870,204590
290020,201901,174,160,14,160678,13972,174650
290030,201901,602,394,208,393212,207584,600796
290035,201901,133,109,24,108782,23952,132734
290040,201901,285,184,101,183632,100798,284430
290050,201901,81,63,18,62874,17964,80838
290060,201901,264,120,144,119760,143712,263472
290070,201901,5631,2798,2833,2793403.86,2827339.81,5620743.67
290080,201901,497,224,273,223553.92,272455.92,496009.84
290090,201901,391,173,218,172654,217564,390218
290100,201901,1630,1081,549,1079837.7,547902.4,1627740.1
290110,201901,804,489,315,488023.12,314370.99,802394.11
290115,201901,204,187,17,186626,16966,203592
290120,201901,772,506,266,505986,265468,771454
290130,201901,424,254,170,253492,169660,423152
290135,201901,303,226,77,225548,76846,302394
290140,201901,304,256,48,255488,47904,303392
290150,201901,132,98,34,97804,33932,131736
290160,201901,248,187,61,186626.62,60878,247504.62
290170,201901,90,66,24,65868,23952,89820
290180,201901,168,131,37,130738,36926,167664
290190,201901,439,363,76,363272,75848,439120
290195,201901,305,187,118,186626,117764,304390
290200,201901,280,231,49,230538,48902,279440
290205,201901,146,90,56,89820,55888,145708
290210,201901,1154,839,315,837322.4,314370,1151692.4
290220,201901,225,126,99,125748,98802,224550
290225,201901,290,113,177,112774,176646,289420
290230,201901,62,41,21,40918,20958,61876
290240,201901,312,121,191,120758,190618,311376
290250,201901,265,244,21,243512,20958,264470
290260,201901,300,242,58,241516.4,57884,299400.4
290265,201901,188,157,31,156686,30938,187624
290270,201901,1412,1170,242,1169656.9,241517.36,1411174.26
290280,201901,470,342,128,341316,127744,469060
290290,201901,1260,742,518,741514.94,516964.4,1258479.34
290300,201901,454,384,70,384230.4,69860,454090.4
290310,201901,312,139,173,138722,172654,311376
290320,201901,4041,2519,1522,2513962.57,1520953,4034915.57
290323,201901,185,161,24,161676,23952,185628
290327,201901,164,129,35,128742,34930,163672
290330,201901,88,48,40,47904,39920,87824
290340,201901,909,367,542,366266.96,540916.5,907183.46
290350,201901,606,364,242,363272,241516,604788
290360,201901,370,277,93,276446.41,92814,369260.41
290370,201901,911,376,535,375248,534928.97,910176.97
290380,201901,315,193,122,192614,121756,314370
290390,201901,2485,1560,925,1558878.5,924148,2483026.5
290395,201901,249,141,108,140718.5,107784,248502.5
290400,201901,287,211,76,210578.4,75848,286426.4
290405,201901,250,220,30,219560,29940,249500
290410,201901,595,509,86,507982.55,85828,593810.55
290420,201901,242,191,51,190618,50898,241516
290430,201901,488,310,178,309380,177644,487024
290440,201901,74,65,9,64870,8982,73852
290450,201901,238,184,54,183632,53892,237524
290460,201901,1910,1148,762,1145714.78,762474.24,1908189.02
290470,201901,1425,604,821,602802.78,819375.64,1422178.42
290475,201901,586,548,38,546904.68,37924,584828.68
290480,201901,289,164,125,164670,124750,289420
290485,201901,240,225,15,224550,14970,239520
290490,201901,1201,867,334,865266,333332,1198598
290500,201901,712,362,350,361276.4,349300,710576.4
290510,201901,224,172,52,171656,51896,223552
290515,201901,143,87,56,86826,55888,142714
290520,201901,1428,941,487,939118.54,486027.13,1425145.67
290530,201901,314,287,27,286426,26946,313372
290540,201901,102,55,47,54890,46906,101796
290550,201901,151,126,25,125748,24950,150698
290560,201901,3288,1382,1906,1379236,1903189.32,3282425.32
290570,201901,6116,3118,2998,3112769.29,2994006.54,6106775.83
290580,201901,1268,760,508,758480,506984,1265464
290590,201901,560,462,98,461076,97804,558880
290600,201901,1768,1217,551,1214568.02,549898,1764466.02
290610,201901,221,198,23,197604.54,22954,220558.54
290620,201901,346,308,38,307384,37924,345308
290630,201901,2042,884,1158,882232,1155684.4,2037916.4
290640,201901,151,124,27,123752,26946,150698
290650,201901,1714,818,896,816365.67,894208,1710573.67
290660,201901,283,230,53,229540,52894,282434
290670,201901,1027,525,502,523950.8,500997.03,1024947.83
290680,201901,1234,992,242,990016,241516,1231532
290682,201901,290,214,76,213573.24,75848.98,289422.22
290685,201901,235,152,83,151696,82834,234530
290687,201901,973,629,344,627904.4,343312,971216.4
290689,201901,138,75,63,74850.97,62874,137724.97
290690,201901,629,262,367,261476.98,366271.16,627748.14
290700,201901,243,120,123,119760,122754,242514
290710,201901,706,477,229,476046,228542,704588
290720,201901,1042,846,196,844308.5,195608.4,1039916.9
290730,201901,1161,671,490,670656.6,489020,1159676.6
290740,201901,15,13,2,12974,1996,14970
290750,201901,1379,642,737,641714,738522.86,1380236.86
290755,201901,71,63,8,62874,7984,70858
290760,201901,305,263,42,263472,41916,305388
290770,201901,190,178,12,177644,11976.4,189620.4
290780,201901,1034,817,217,815369.34,216566,1031935.34
290790,201901,374,265,109,264470,108782,373252
290800,201901,2620,1062,1558,1059876,1554884,2614760
290810,201901,449,315,134,315368.4,133732,449100.4
290820,201901,394,239,155,238522.97,154690,393212.97
290830,201901,410,288,122,287424,122754,410178
290840,201901,1732,1075,657,1072850.4,655686.8,1728537.2
290850,201901,782,433,349,432134,348302,780436
290860,201901,641,295,346,294410,345308.4,639718.4
290870,201901,655,466,189,465068.64,188622.84,653691.48
290880,201901,124,70,54,69860,53892,123752
290890,201901,340,242,98,242514,97804,340318
290900,201901,170,129,41,128742,40918,169660
290910,201901,376,284,92,283432,91816,375248
290920,201901,230,194,36,193612,35928,229540
290930,201901,850,645,205,643710.4,204590.96,848301.36
290940,201901,247,205,42,205588,41916,247504
290950,201901,171,101,70,100798,69860,170658
290960,201901,459,313,146,312374,145708,458082
290970,201901,253,224,29,223552,28942,252494
290980,201901,1534,1089,445,1086822.68,444111.2,1530933.88
290990,201901,400,334,66,334331.96,65870.94,400202.90
291000,201901,859,250,609,249500,607782,857282
291005,201901,2256,994,1262,992012.4,1260474.98,2252487.38
291010,201901,153,138,15,137724,14970,152694
291020,201901,101,79,22,78842,21956,100798
291030,201901,97,70,27,69860,26946,96806
291040,201901,573,301,272,300398,271456,571854
291050,201901,1371,766,605,764468.96,603790,1368258.96
291060,201901,1513,839,674,837322,672652,1509974
291070,201901,1932,1433,499,1430135.58,499001.78,1929137.36
291072,201901,7393,2751,4642,2747495.82,4635713.76,7383209.58
291075,201901,218,177,41,176646,40918,217564
291077,201901,52,35,17,34930,16966,51896
291080,201901,19986,8875,11111,8860251.93,11093776.66,19954028.59
291085,201901,300,242,58,241516,57884,299400
291090,201901,300,117,183,116766.4,182634,299400.4
291100,201901,657,190,467,189620,466066,655686
291110,201901,406,307,99,306386,98802,405188
291120,201901,2511,1229,1282,1226542.7,1279437.49,2505980.19
291125,201901,60,31,29,30938,28942,59880
291130,201901,214,190,24,189620,23952,213572
291140,201901,141,108,33,107784,32934.4,140718.4
291150,201901,372,151,221,150698,220558,371256
291160,201901,372,309,63,308382.5,62874,371256.5
291165,201901,28,24,4,23952,3992,27944
291170,201901,3044,1538,1506,1534925.67,1503987.6,3038913.27
291180,201901,1311,514,797,512975.74,795408.88,1308384.62
291185,201901,79,77,2,76846,1996,78842
291190,201901,1295,572,723,570857.24,721554.86,1292412.10
291200,201901,169,128,41,127744,40918,168662
291210,201901,2227,890,1337,888220.4,1334327.38,2222547.78
291220,201901,271,202,69,201596,68862,270458
291230,201901,1022,356,666,355288.4,664668,1019956.4
291240,201901,434,410,24,409180.4,23952,433132.4
291250,201901,441,361,80,360278,79840,440118
291260,201901,53,40,13,39920,12974,52894
291270,201901,1211,497,714,496006,712572,1208578
291280,201901,372,174,198,173652.4,197604,371256.4
291290,201901,1765,917,848,915166.4,846305.4,1761471.8
291300,201901,230,180,50,179640,49900,229540
291310,201901,233,209,24,208582,23952,232534
291320,201901,1397,999,398,997002,397204.8,1394206.8
291330,201901,130,110,20,110778,19960,130738
291340,201901,175,98,77,97804,76846,174650
291345,201901,135,92,43,91816,42914,134730
291350,201901,1594,539,1055,537922,1053888.7,1591810.7
291360,201901,8542,4251,4291,4243501.74,4284417.86,8527919.60
291370,201901,1136,636,500,634728.4,499998.98,1134727.38
291380,201901,262,205,57,204590,56886,261476
291390,201901,3854,1717,2137,1713567.54,2132727.2,3846294.74
291400,201901,2091,1498,593,1495004,592812.21,2087816.21
291410,201901,156,136,20,135728,19960,155688
291420,201901,118,87,31,86826,30938,117764
291430,201901,164,92,72,91816,71856.11,163672.11
291440,201901,510,412,98,411176.4,97804,508980.4
291450,201901,908,571,337,569858.5,336326,906184.5
291460,201901,1805,1467,338,1465064,337324,1802388
291465,201901,2217,1043,1174,1040928.86,1171665.58,2212594.44
291470,201901,2824,1435,1389,1432130.71,1386223.06,2818353.77
291480,201901,11805,5257,6548,5246511.03,6535036.98,11781548.01
291490,201901,562,239,323,238522,322354,560876
291500,201901,373,209,164,208582,163672,372254
291510,201901,1227,473,754,472054,752492,1224546
291520,201901,964,443,521,442114,519958,962072
291530,201901,995,277,718,276446,716564,993010
291535,201901,119,102,17,101796,16966,118762
291540,201901,357,106,251,105788,250498.2,356286.2
291550,201901,1200,568,632,566865.2,630737.38,1197602.58
291560,201901,5451,2781,2670,2775537.16,2665833.61,5441370.77
291570,201901,201,102,99,101796,98802,200598
291580,201901,1249,766,483,764469.81,483032,1247501.81
291590,201901,89,38,51,37924,50898,88822
291600,201901,1371,652,719,650696,717563.96,1368259.96
291610,201901,1455,684,771,682632,769459.94,1452091.94
291620,201901,573,267,306,266466,305388,571854
291630,201901,489,163,326,162674,325348,488022
291640,201901,3908,1967,1941,1963070.6,1939127.76,3902198.36
291650,201901,420,284,136,283432.53,135728,419160.53
291660,201901,417,169,248,168662,248502,417164
291670,201901,225,144,81,143712,80838,224550
291680,201901,685,389,296,388222,295408.8,683630.8
291685,201901,601,333,268,332334.5,268462,600796.5
291690,201901,569,302,267,301396,266467.06,567863.06
291700,201901,953,751,202,749498,201596,951094
291710,201901,1698,798,900,796404.5,898200.98,1694605.48
291720,201901,405,268,137,267464,136726,404190
291730,201901,943,555,388,553890,387224,941114
291733,201901,267,186,81,185628,81836,267464
291735,201901,70,54,16,53892,15968,69860
291740,201901,350,271,79,270458,78842,349300
291750,201901,2032,1338,694,1335325.45,692612,2027937.45
291760,201901,3066,1690,1376,1686620,1373248,3059868
291770,201901,802,539,263,537928.91,262474,800402.91
291780,201901,46,28,18,27944,17964,45908
291790,201901,167,81,86,80838,85828,166666
291800,201901,10084,4151,5933,4142701.31,5922135.08,10064836.39
291810,201901,1133,823,310,821354.4,309380,1130734.4
291820,201901,273,195,78,194610,77844,272454
291830,201901,1106,434,672,433132.98,670656.98,1103789.96
291835,201901,595,551,44,549898,43912,593810
291840,201901,4808,2487,2321,2483025.35,2318354.98,4801380.33
291845,201901,281,95,186,94810,186626,281436
291850,201901,330,293,37,293412,36926,330338
291855,201901,262,108,154,107784,153692,261476
291860,201901,173,108,65,107784,64870,172654
291870,201901,80,31,49,30938,48902,79840
291875,201901,190,175,15,174650,14970,189620
291880,201901,488,383,105,382234,104790,487024
291890,201901,246,83,163,82834,162674.4,245508.4
291900,201901,55,31,24,30938,23952,54890
291905,201901,131,94,37,93812.4,36926,130738.4
291910,201901,173,141,32,140718,31936,172654
291915,201901,411,367,44,366266.5,43912,410178.5
291920,201901,5007,2601,2406,2596796.6,2401189.98,4997986.58
291930,201901,183,107,76,106786,75848,182634
291940,201901,332,186,146,185628,145708,331336
291950,201901,1152,939,213,937122.4,212574,1149696.4
291955,201901,1143,686,457,684628,456086.7,1140714.7
291960,201901,184,130,54,129740,53892,183632
291970,201901,776,587,189,585826,188622,774448
291980,201901,1516,1340,176,1337321.38,175649.2,1512970.58
291990,201901,131,121,10,120758,9980,130738
291992,201901,177,91,86,90818,85828,176646
291995,201901,151,102,49,101796,48902,150698
292000,201901,388,298,90,297404.4,89820,387224.4
292010,201901,292,206,86,206586,85828,292414
292020,201901,284,207,77,206586,76846,283432
292030,201901,141,110,31,109780,30938,140718
292040,201901,634,324,310,323352,310378,633730
292045,201901,97,88,9,87824,8982,96806
292050,201901,932,668,264,666664,263472.4,930136.4
292060,201901,939,777,162,776444.86,161676,938120.86
292070,201901,47,20,27,19960,26946,46906
292080,201901,133,90,43,89820,42914,132734
292090,201901,505,184,321,183632,320358,503990
292100,201901,1427,629,798,627742.6,796404.98,1424147.58
292105,201901,209,180,29,179640,28942,208582
292110,201901,2122,793,1329,791414,1326348.84,2117762.84
292120,201901,668,526,142,524948,141716,666664
292130,201901,449,261,188,260478,187624,448102
292140,201901,199,157,42,156686,41916,198602
292145,201901,167,87,80,86826.4,79840,166666.4
292150,201901,1459,1178,281,1175644,281436,1457080
292160,201901,175,143,32,142714,31936,174650
292170,201901,1208,1058,150,1055884,149700,1205584
292180,201901,213,153,60,152694,59880,212574
292190,201901,159,96,63,95808,62874,158682
292200,201901,1299,475,824,474051.36,822353.36,1296404.72
292205,201901,126,112,14,111776,13972,125748
292210,201901,368,259,109,258482.1,108782,367264.1
292220,201901,21,16,5,15968,4990,20958
292225,201901,39,34,5,33932,4990,38922
292230,201901,952,764,188,763470.75,187624,951094.75
292240,201901,619,454,165,454090.7,164670,618760.7
292250,201901,1721,1108,613,1106782,611774.4,1718556.4
292260,201901,439,257,182,256486,181636,438122
292265,201901,256,179,77,178642,76846,255488
292270,201901,750,340,410,339320,409180.6,748500.6
292273,201901,205,116,89,115768,88822,204590
292275,201901,176,91,85,90818,84830,175648
292280,201901,142,102,40,101796,39920,141716
292285,201901,68,57,11,56886,10978,67864
292290,201901,580,391,189,390218.09,188622.4,578840.49
292300,201901,1645,637,1008,635726.4,1005985.71,1641712.11
292303,201901,100,69,31,68862,30938,99800
292305,201901,114,82,32,81836,31936,113772
292310,201901,838,547,291,545907.24,290418.56,836325.80
292320,201901,670,506,164,504988,163672,668660
292330,201901,184,102,82,101796,81836,183632
292335,201901,282,221,61,220558,60878,281436
292340,201901,583,408,175,407184.4,174650,581834.4
292350,201901,270,145,125,144710,125748,270458
292360,201901,706,537,169,535926.96,168662,704588.96
292370,201901,758,581,177,579838,176646,756484
292380,201901,651,510,141,508980.54,140718,649698.54
292390,201901,502,198,304,197604,303392.8,500996.8
292400,201901,3428,2128,1300,2124743.75,1297401,3422144.75
292405,201901,267,176,91,175648,90818,266466
292410,201901,146,88,58,87824,57884,145708
292420,201901,298,256,42,255488,42914,298402
292430,201901,533,415,118,415168,117764,532932
292440,201901,594,510,84,509978.44,84830,594808.44
292450,201901,261,200,61,200598,60878,261476
292460,201901,580,430,150,429140.98,149700,578840.98
292465,201901,219,180,39,179640,38922,218562
292467,201901,110,66,44,65868,43912,109780
292470,201901,272,187,85,186626,84830,271456
292480,201901,347,234,113,233532,112774.4,346306.4
292490,201901,231,155,76,154690,75848,230538
292500,201901,1134,498,636,497004.75,635726,1132730.75
292510,201901,3390,1550,1840,1547898.44,1836321.18,3384219.62
292520,201901,1090,523,567,522952.99,565866.98,1088819.97
292525,201901,386,274,112,273452,111776,385228
292530,201901,4240,1737,2503,1733529.73,2497999.88,4231529.61
292540,201901,463,249,214,248502,213572,462074
292550,201901,1053,573,480,572866.84,479051.54,1051918.38
292560,201901,321,302,19,301396,18962,320358
292570,201901,302,232,70,231536,69860,301396
292575,201901,477,308,169,307384.4,168662,476046.4
292580,201901,960,627,333,625746,332334.4,958080.4
292590,201901,542,466,76,465068,75848,540916
292593,201901,142,112,30,111776,29940,141716
292595,201901,183,141,42,140718,41916,182634
292600,201901,1265,934,331,933130.63,330338,1263468.63
292610,201901,129,101,28,100798,27944,128742
292620,201901,531,443,88,443113.38,87824,530937.38
292630,201901,1396,800,596,798400.67,594808.27,1393208.94
292640,201901,802,558,244,556884,243512,800396
292650,201901,186,155,31,154690.4,30938,185628.4
292660,201901,2025,1457,568,1455085.15,568860.41,2023945.56
292665,201901,147,107,40,106786,39920,146706
292670,201901,404,325,79,324350.99,78842,403192.99
292680,201901,256,197,59,196606,58882,255488
292690,201901,194,148,46,147704,45908,193612
292700,201901,953,636,317,634728,316366,951094
292710,201901,106,93,13,92814,12974,105788
292720,201901,879,497,382,496006,382234,878240
292730,201901,202,94,108,93812,107784,201596
292740,201901,67957,33645,34312,33584731.21,34265374.86,67850106.07
292750,201901,380,271,109,270458.78,108782,379240.78
292760,201901,327,269,58,268462.38,58882,327344.38
292770,201901,788,331,457,330338.4,456086,786424.4
292780,201901,416,159,257,158682,256486,415168
292790,201901,742,370,372,369260,371256,740516
292800,201901,1185,720,465,718560,464070,1182630
292805,201901,415,123,292,122754,291416,414170
292810,201901,1479,847,632,845306.8,630736,1476042.8
292820,201901,733,601,132,599798.7,131736.98,731535.68
292830,201901,102,84,18,83832,17964,101796
292840,201901,679,561,118,559878.6,117764,677642.6
292850,201901,135,91,44,90818,43912,134730
292860,201901,2255,1320,935,1317360.4,933130,2250490.4
292870,201901,3474,2345,1129,2340313.53,1127740,3468053.53
292880,201901,1480,969,511,967063.42,509978,1477041.42
292890,201901,503,432,71,431137.94,70858,501995.94
292895,201901,134,89,45,88822,44910,133732
292900,201901,388,285,103,284430,102794,387224
292905,201901,458,234,224,233532,223552,457084
292910,201901,429,328,101,327344.3,100798,428142.3
292920,201901,545,246,299,245508,298402,543910
292925,201901,501,463,38,462074,37924.96,499998.96
292930,201901,572,355,217,354290,216566,570856
292935,201901,290,125,165,124750,164670.98,289420.98
292937,201901,246,166,80,165668,79840,245508
292940,201901,197,154,43,153692,42914,196606
292950,201901,1140,590,550,588821.3,549898,1138719.3
292960,201901,602,413,189,413172,188622,601794
292970,201901,252,179,73,178642,72854,251496
292975,201901,141,81,60,80838,59880.6,140718.6
292980,201901,270,183,87,182634.76,86826,269460.76
292990,201901,1323,985,338,983030.8,337324.26,1320355.06
293000,201901,106,76,30,75848,29940,105788
293010,201901,2760,1657,1103,1653686.3,1100794.99,2754481.29
293015,201901,661,531,130,530936,129740,660676
293020,201901,341,279,62,278442,61876,340318
293030,201901,615,538,77,536924.8,76846,613770.8
293040,201901,349,275,74,274450,73852,348302
293050,201901,2756,1629,1127,1625742.4,1124747.98,2750490.38
293060,201901,251,203,48,202595.48,47904,250499.48
293070,201901,3478,1796,1682,1792410.49,1679636.88,3472047.37
293075,201901,93,62,31,61876,30938,92814
293076,201901,70,47,23,46906,22954,69860
293077,201901,467,279,188,278442.4,187624,466066.4
293080,201901,455,409,46,408182.4,45908,454090.4
293090,201901,132,116,16,115768,15968,131736
293100,201901,526,369,157,368262,156686,524948
293105,201901,342,240,102,239520.4,101796,341316.4
293110,201901,173,123,50,122754,49900,172654
293120,201901,324,219,105,218562.45,105788,324350.45
293130,201901,241,163,78,162674,77844,240518
293135,201901,8008,3199,4809,3192622.3,4802428.98,7995051.28
293140,201901,185,122,63,121756.57,62874,184630.57
293150,201901,335,286,49,285428,48902,334330
293160,201901,431,249,182,248502,181636,430138
293170,201901,152,104,48,103792,47904,151696
293180,201901,476,330,146,329340.4,145708,475048.4
293190,201901,1337,930,407,928140.7,406186.4,1334327.1
293200,201901,539,476,63,475048,62874,537922
293210,201901,376,289,87,288422.68,86826,375248.68
293220,201901,2649,1098,1551,1095804,1547898.58,2643702.58
293230,201901,1750,647,1103,645706.75,1100794,1746500.75
293240,201901,226,206,20,205588,19960,225548
293245,201901,111,93,18,92814,17964,110778
293250,201901,724,270,454,269460.67,453092,722552.67
293260,201901,312,261,51,260478,50898,311376
293270,201901,1158,554,604,552892.68,602792,1155684.68
293280,201901,253,143,110,142714,109780,252494
293290,201901,3052,2008,1044,2004982,1043909.97,3048891.97
293300,201901,719,512,207,510977.67,206586,717563.67
293305,201901,156,133,23,132734,22954,155688
293310,201901,141,108,33,107784,32934,140718
293315,201901,159,123,36,122754,35928,158682
293317,201901,91,64,27,63872,26946,90818
293320,201901,979,569,410,567862.5,409180,977042.5
293325,201901,191,68,123,67864,122754,190618
293330,201901,13064,6174,6890,6164649.12,6876226.92,13040876.04
293340,201901,258,189,69,188622,68862,257484
293345,201901,246,195,51,194610,50898,245508
293350,201901,643,359,284,358282,283432,641714
293360,201901,1579,1131,448,1129736,447104.4,1576840.4
310010,201901,147,76,71,75848,70858.4,146706.4
310020,201901,1076,599,477,597802.4,476046.44,1073848.84
310030,201901,333,270,63,269460.2,62874,332334.2
310040,201901,46,29,17,28942,16966,45908
310050,201901,188,122,66,121756,65868.64,187624.64
310060,201901,247,173,74,172654,73852,246506
310070,201901,16,8,8,7984,7984,15968
310080,201901,44,24,20,23952,19960,43912
310090,201901,977,518,459,516966.56,458082.8,975049.36
310100,201901,304,232,72,231536,71856,303392
310110,201901,729,393,336,392214,335328.4,727542.4
310120,201901,389,215,174,214570.4,174650,389220.4
310130,201901,33,21,12,20958,11976,32934
310140,201901,23,12,11,11976,10978,22954
310150,201901,1272,874,398,874249.9,397204.8,1271454.7
310160,201901,2095,1066,1029,1063869.17,1026942.8,2090811.97
310163,201901,94,54,40,53892,40918,94810
310170,201901,2601,1129,1472,1126742.74,1469058.2,2595800.94
310180,201901,133,50,83,49900,82834,132734
310190,201901,498,342,156,341316,155688,497004
310200,201901,496,317,179,316366,179640,496006
310205,201901,55,41,14,40918,13972,54890
310210,201901,286,232,54,231536,53892,285428
310220,201901,59,36,23,35928,22954,58882
310230,201901,271,189,82,188622,81836,270458
310240,201901,109,95,14,94810,13972,108782
310250,201901,104,84,20,83832,19960,103792
310260,201901,774,420,354,420160.04,353292,773452.04
310270,201901,277,185,92,184630.84,91816,276446.84
310280,201901,362,273,89,272454,88822,361276
310285,201901,218,155,63,154690,62874,217564
310290,201901,256,147,109,146706,108782,255488
310300,201901,151,124,27,123752,26946,150698
310310,201901,10,8,2,7984,1996,9980
310320,201901,29,15,14,14970,13972,28942
310330,201901,33,25,8,24950,7984,32934
310340,201901,1756,1157,599,1154687.4,597802.4,1752489.8
310350,201901,2887,1584,1303,1581832.18,1301393.38,2883225.56
310360,201901,41,34,7,33932,6986,40918
310370,201901,126,105,21,104790,20958.4,125748.4
310375,201901,111,42,69,41916,68862.96,110778.96
310380,201901,50,29,21,28942,20958,49900
310390,201901,98,65,33,64870,32934,97804
310400,201901,2392,1586,806,1583826.8,804388,2388214.8
310410,201901,125,69,56,68862,55888,124750
310420,201901,682,363,319,362274.6,318362.2,680636.8
310430,201901,322,214,108,213572,107784,321356
310440,201901,71,43,28,42914,27944,70858
310445,201901,80,67,13,66866,12974,79840
310450,201901,854,542,312,540916,311376,852292
310460,201901,260,189,71,188622,71856,260478
310470,201901,506,327,179,326346,178642,504988
310480,201901,81,60,21,59880,20958,80838
310490,201901,534,257,277,256486,276446,532932
310500,201901,128,53,75,52894,74850,127744
310510,201901,600,405,195,404190,194610.98,598800.98
310520,201901,131,92,39,91816,38922,130738
310530,201901,96,40,56,39920,55888,95808
310540,201901,465,284,181,283433.2,180638,464071.2
310550,201901,84,55,29,54890,29940,84830
310560,201901,2972,2054,918,2051890.8,917162,2969052.8
310570,201901,111,76,35,75848,34930,110778
310590,201901,361,238,123,237524.5,122754,360278.5
310600,201901,161,90,71,89820.4,70858,160678.4
310610,201901,61,24,37,23952,36926,60878
310620,201901,47353,22831,24522,22790281.78,24495927.03,47286208.81
310630,201901,622,398,224,397204,223552.4,620756.4
310640,201901,147,120,27,119760,26946,146706
310650,201901,164,144,20,143712,19960,163672
310660,201901,88,57,31,56886,30938,87824
310665,201901,59,42,17,41916,17964,59880
310670,201901,6596,2952,3644,2949096.68,3645721.48,6594818.16
310680,201901,60,38,22,37924,21956,59880
310690,201901,592,420,172,419160.1,171656,590816.1
310700,201901,58,39,19,38922,18962,57884
310710,201901,1263,856,407,854289.38,406186.4,1260475.78
310720,201901,96,29,67,28942,66866,95808
310730,201901,1381,971,410,970056.9,409180.4,1379237.3
310740,201901,980,554,426,552893.2,425148.5,978041.7
310750,201901,245,144,101,143712.66,100798,244510.66
310760,201901,64,46,18,45908,17964.4,63872.4
310770,201901,94,43,51,42914,50898,93812
310780,201901,397,323,74,322354.98,73852,396206.98
310790,201901,98,81,17,80838,16966,97804
310800,201901,452,220,232,219560.9,231536,451096.9
310810,201901,169,120,49,120758.18,48902,169660.18
310820,201901,352,281,71,280438,70858,351296
310825,201901,204,167,37,166666,36926,203592
310830,201901,467,228,239,227544.4,238522,466066.4
310840,201901,375,214,161,214570,160678,375248
310850,201901,110,87,23,86826,22954,109780
310855,201901,396,315,81,314370,80838,395208
310860,201901,1444,1080,364,1077843.16,363272.7,1441115.86
310870,201901,51,41,10,40918,9980,50898
310880,201901,83,65,18,64870,17964,82834
310890,201901,307,184,123,183632,122754,306386
310900,201901,641,296,345,295408.6,344310.96,639719.56
310910,201901,244,170,74,169660.6,73852,243512.6
310920,201901,474,282,192,281436.9,191616,473052.9
310925,201901,35,27,8,26946,7984.4,34930.4
310930,201901,1081,661,420,659693.84,419171.88,1078865.72
310940,201901,673,348,325,347304,324350,671654
310945,201901,118,71,47,70858,46906,117764
310950,201901,246,198,48,197604,47904,245508
310960,201901,83,28,55,27944,54890.99,82834.99
310970,201901,164,105,59,104790,58882,163672
310980,201901,47,26,21,25948,20958,46906
310990,201901,149,81,68,80838,67864,148702
311000,201901,846,425,421,424151.77,420158.98,844310.75
311010,201901,41,34,7,33932,6986,40918
311020,201901,44,28,16,27944,15968,43912
311030,201901,395,237,158,237524,157685.2,395209.2
311040,201901,40,35,5,34930,4990,39920
311050,201901,467,196,271,195608.8,270458,466066.8
311060,201901,766,434,332,433132.8,332334.4,765467.2
311070,201901,349,167,182,166666,181636,348302
311080,201901,108,58,50,57884,50898,108782
311090,201901,386,184,202,183632,201596,385228
311100,201901,601,359,242,358282,241516,599798
311110,201901,699,489,210,489020,209580.98,698600.98
311115,201901,74,53,21,52894,20958,73852
311120,201901,1095,585,510,583830.4,510976,1094806.4
311130,201901,399,236,163,235528,162674,398202
311140,201901,164,89,75,88822,74850,163672
311150,201901,364,240,124,239520,123752,363272
311160,201901,726,524,202,522952.4,202594,725546.4
311170,201901,79,60,19,59880,18962,78842
311180,201901,346,231,115,232534,114770.4,347304.4
311190,201901,35,16,19,15968,18962,34930
311200,201901,334,237,97,236526,96806,333332
311205,201901,32,22,10,21956,9980,31936
311210,201901,49,41,8,40918,7984,48902
311220,201901,20,18,2,17964,1996,19960
311230,201901,1632,1071,561,1068858.6,559878,1628736.6
311240,201901,179,114,65,113772,64870,178642
311250,201901,98,28,70,27944,69860,97804
311260,201901,561,354,207,353292,207584,560876
311265,201901,113,80,33,79840,32934,112774
311270,201901,292,207,85,206586,84830,291416
311280,201901,210,98,112,97804,111776,209580
311290,201901,112,91,21,90818,20958.4,111776.4
311300,201901,575,367,208,366266,207584.4,573850.4
311310,201901,25,19,6,18962,5988,24950
311320,201901,672,499,173,498002,173652,671654
311330,201901,1057,783,274,783430,273452.8,1056882.8
311340,201901,2657,1881,776,1879234.8,775446.98,2654681.78
311350,201901,272,209,63,208582,62874,271456
311360,201901,178,109,69,108782,68862,177644
311370,201901,1210,498,712,498002.5,711574,1209576.5
311380,201901,7,6,1,5988,998,6986
311390,201901,266,144,122,143712,121756,265468
311400,201901,157,106,51,105788,50898,156686
311410,201901,100,57,43,57884.4,42914,100798.4
311420,201901,304,171,133,171657.4,132734,304391.4
311430,201901,869,571,298,570857.3,297404.4,868261.7
311440,201901,486,343,143,342314,142714,485028
311450,201901,329,207,122,206586,121756,328342
311455,201901,297,205,92,204590.98,91816,296406.98
311460,201901,135,57,78,56886,77844.8,134730.8
311470,201901,23,14,9,13972,8982,22954
311480,201901,37,17,20,16966,19960,36926
311490,201901,17,11,6,10978,5988,16966
311500,201901,20,10,10,9980,9980,19960
311510,201901,642,453,189,453092,188622,641714
311520,201901,42,33,9,32934,8982,41916
311530,201901,1784,1336,448,1333330.26,448102,1781432.26
311535,201901,72,51,21,50898,20958,71856
311540,201901,36,31,5,30938,4990,35928
311545,201901,196,144,52,143712,51896,195608
311547,201901,33,24,9,23952,8982,32934
311550,201901,678,319,359,318362,360278.98,678640.98
311560,201901,44,29,15,28942,14970,43912
311570,201901,296,201,95,200598,94810,295408
311580,201901,329,196,133,195608,132734,328342
311590,201901,34,30,4,29940,3992,33932
311600,201901,97,78,19,77844,18962,96806
311610,201901,259,227,32,226546.5,31936,258482.5
311615,201901,111,92,19,91816,18962,110778
311620,201901,22,12,10,11976,9980,21956
311630,201901,86,72,14,71856,13972,85828
311640,201901,135,72,63,71856,62874,134730
311650,201901,135,96,39,95808,38922,134730
311660,201901,421,206,215,205588,214570,420158
311670,201901,162,106,56,105788.58,55888,161676.58
311680,201901,221,163,58,162674,57884,220558
311690,201901,18,11,7,10978,6986,17964
311700,201901,200,142,58,141716,57884,199600
311710,201901,212,132,80,132734.4,79840,212574.4
311720,201901,38,27,11,26946.4,10978,37924.4
311730,201901,601,400,201,399200,200598,599798
311740,201901,38,28,10,27944,9980,37924
311750,201901,705,475,230,474051.76,229540,703591.76
311760,201901,60,32,28,31936,27944,59880
311770,201901,392,194,198,193613.34,197604,391217.34
311780,201901,177,98,79,97804.4,78842,176646.4
311783,201901,85,75,10,74850,9980,84830
311787,201901,35,14,21,13972,20958,34930
311790,201901,266,125,141,124750,140718,265468
311800,201901,664,449,215,448102.9,214570,662672.9
311810,201901,46,39,7,38922,6986,45908
311820,201901,112,95,17,94810,16966,111776
311830,201901,1972,1252,720,1249497.5,718560,1968057.5
311840,201901,1037,570,467,568861.7,466066.9,1034928.6
311850,201901,10,6,4,5988,3992,9980
311860,201901,9586,4382,5204,4374237.5,5197590.25,9571827.75
311870,201901,140,77,63,76846,62874,139720
311880,201901,926,683,243,681635.38,242514,924149.38
311890,201901,218,109,109,108782,108782,217564
311900,201901,79,33,46,32934,45908,78842
311910,201901,1430,893,537,891215.5,536924.4,1428139.9
311920,201901,229,152,77,151696,77844,229540
311930,201901,916,518,398,516964.4,398202.5,915166.9
311940,201901,2577,1375,1202,1372250.4,1199596,2571846.4
311950,201901,52,38,14,38922,13972,52894
311960,201901,66,48,18,47904,17964,65868
311970,201901,25,15,10,14970,9980,24950
311980,201901,45,35,10,34930,9980,44910
311990,201901,52,38,14,37924,13972,51896
311995,201901,61,41,20,40918,19960,60878
312000,201901,34,25,9,24950,8982,33932
312010,201901,85,64,21,63872,20958,84830
312015,201901,100,74,26,73852.4,25948,99800.4
312020,201901,138,91,47,90818.4,48902,139720.4
312030,201901,47,37,10,36926,9980,46906
312040,201901,86,54,32,53892,31936,85828
312050,201901,205,115,90,114770,90818,205588
312060,201901,64,39,25,38922,24950,63872
312070,201901,73,46,27,45908,26946,72854
312080,201901,550,255,295,254490,294410,548900
312083,201901,57,40,17,39920,16966,56886
312087,201901,113,91,22,90818,21956,112774
312090,201901,3062,1811,1251,1807382.5,1249496.96,3056879.46
312100,201901,157,108,49,107554.46,48902,156456.46
312110,201901,114,71,43,70858,42914,113772
312120,201901,147,111,36,110778.37,35928,146706.37
312125,201901,98,54,44,53892,43912,97804
312130,201901,125,84,41,83832,40918,124750
312140,201901,142,110,32,109780.4,31936,141716.4
312150,201901,46,36,10,35928,9980,45908
312160,201901,1554,1024,530,1021954.4,528940.4,1550894.8
312170,201901,11,10,1,9980,998,10978
312180,201901,103,64,39,63872,38922.8,102794.8
312190,201901,31,27,4,26946,3992,30938
312200,201901,754,649,105,647702.4,104790,752492.4
312210,201901,93,61,32,60878,31936,92814
312220,201901,133,96,37,95808.5,36926,132734.5
312230,201901,3650,1790,1860,1787421.12,1859282.06,3646703.18
312235,201901,160,108,52,108782,51896,160678
312240,201901,105,72,33,71856,32934,104790
312245,201901,173,120,53,119760.99,52894,172654.99
312247,201901,59,41,18,40918,17964,58882
312250,201901,178,85,93,84830,92814,177644
312260,201901,109,71,38,70858,37924,108782
312270,201901,138,86,52,85828,51896,137724
312280,201901,27,16,11,15968,10978,26946
312290,201901,156,107,49,106786,48902.6,155688.6
312300,201901,199,132,67,131736,66866,198602
312310,201901,57,53,4,52894,3992,56886
312320,201901,440,280,160,279440,160678.84,440118.84
312330,201901,90,81,9,80838,8982,89820
312340,201901,38,17,21,16966,20958,37924
312350,201901,18,11,7,10978,6986,17964
312352,201901,101,71,30,70858,29940,100798
312360,201901,559,251,308,250498,307384,557882
312370,201901,305,177,128,176646,127744.52,304390.52
312380,201901,139,95,44,94810,43912,138722
312385,201901,174,140,34,139720,33932,173652
312390,201901,304,190,114,189620,113772,303392
312400,201901,381,295,86,294410,85829,380239
312410,201901,923,302,621,301396,621755.39,923151.39
312420,201901,621,485,136,484030.4,135728,619758.4
312430,201901,858,636,222,634729.89,221556,856285.89
312440,201901,46,34,12,33932,11976,45908
312450,201901,205,127,78,126746,77844,204590
312460,201901,62,32,30,31936,29940,61876
312470,201901,55,35,20,34930,19960,54890
312480,201901,200,123,77,122754,76846,199600
312490,201901,271,190,81,189620,80838,270458
312500,201901,35,20,15,19960,14970,34930
312510,201901,471,183,288,182634,287424.96,470058.96
312520,201901,42,14,28,13972,27944,41916
312530,201901,50,36,14,35928,13972,49900
312540,201901,100,87,13,86826,12974,99800
312550,201901,39,30,9,29940,8982,38922
312560,201901,217,165,52,164670.4,51896,216566.4
312570,201901,453,269,184,268462,183632,452094
312580,201901,89,47,42,46906,41916,88822
312590,201901,264,212,52,212574,52894,265468
312595,201901,139,124,15,123752,14970,138722
312600,201901,72,43,29,42914.1,28942,71856.1
312610,201901,1629,854,775,855288.06,776444.6,1631732.66
312620,201901,194,140,54,139720,53892,193612
312630,201901,71,58,13,57884,12974,70858
312640,201901,45,12,33,11976,32934,44910
312650,201901,155,130,25,129740.4,24950,154690.4
312660,201901,74,55,19,54890.7,18962,73852.7
312670,201901,879,582,297,580836,297404.65,878240.65
312675,201901,38,30,8,29940,7984,37924
312680,201901,83,55,28,54890,27944,82834
312690,201901,236,126,110,125748,110778,236526
312695,201901,38,31,7,30938,6986,37924
312700,201901,222,129,93,128742,93812,222554
312705,201901,78,63,15,62874,14970,77844
312707,201901,129,94,35,93812.3,34930,128742.3
312710,201901,1930,1039,891,1036923.36,889218.58,1926141.94
312720,201901,64,32,32,31936,32934,64870
312730,201901,284,166,118,165668,117764,283432
312733,201901,54,45,9,44910,8982,53892
312735,201901,24,17,7,16966,6986,23952
312737,201901,73,38,35,37924,34930,72854
312738,201901,56,40,16,39920,15968,55888
312740,201901,76,49,27,48902.4,26946,75848.4
312750,201901,71,52,19,51896,18962,70858
312760,201901,277,202,75,201596,74850,276446
312770,201901,7612,3518,4094,3511970.42,4087812.53,7599782.95
312780,201901,429,330,99,329340,98802,428142
312790,201901,23,18,5,17964,4990,22954
312800,201901,1618,1132,486,1130734.9,486026.97,1616761.87
312810,201901,373,240,133,239520,132734,372254
312820,201901,192,145,47,144710,47904,192614
312825,201901,26,17,9,16966,8982,25948
312830,201901,271,162,109,161676.46,108782,270458.46
312840,201901,153,111,42,110778,41916,152694
312850,201901,53,48,5,47904,4990,52894
312860,201901,166,102,64,101796,63872,165668
312870,201901,992,526,466,524948.9,467064,992012.9
312880,201901,151,103,48,102794,47904,150698
312890,201901,168,118,50,117764,49900,167664
312900,201901,206,156,50,155688,49900,205588
312910,201901,185,97,88,96806,87824,184630
312920,201901,157,89,68,88822,67864,156686
312930,201901,328,235,93,234530,92814,327344
312940,201901,116,81,35,80838,34930,115768
312950,201901,718,477,241,477044,240518,717562
312960,201901,170,130,40,129740.96,39920,169660.96
312965,201901,59,52,7,51896,6986,58882
312970,201901,283,226,57,225548.4,56886,282434.4
312980,201901,2379,1235,1144,1233530.58,1141712.99,2375243.57
312990,201901,46,26,20,25948,19960,45908
313000,201901,44,26,18,25948,17964,43912
313005,201901,175,137,38,137724,38922.4,176646.4
313010,201901,934,385,549,384230,547902.98,932132.98
313020,201901,188,99,89,98802,89820,188622
313030,201901,210,137,73,136726.54,72854,209580.54
313040,201901,69,26,43,25948,42914,68862
313050,201901,284,197,87,196606,86826,283432
313055,201901,46,35,11,34930,10978,45908
313060,201901,124,89,35,88822,34930,123752
313065,201901,60,41,19,40918,18962,59880
313070,201901,147,78,69,77844,69860,147704
313080,201901,42,18,24,17964,23952,41916
313090,201901,719,499,220,498002.4,219560,717562.4
313100,201901,167,65,102,65868,101796,167664
313110,201901,135,74,61,73852,60878,134730
313115,201901,180,97,83,96806,82834,179640
313120,201901,795,448,347,447104.4,346306.4,793410.8
313130,201901,5497,3021,2476,3016960.18,2472047.6,5489007.78
313140,201901,152,82,70,81836,69860,151696
313150,201901,311,249,62,248502,61876,310378
313160,201901,197,145,52,144710.4,51896,196606.4
313170,201901,1400,971,429,970057.6,428142.98,1398200.58
313180,201901,308,184,124,183632,123752,307384
313190,201901,752,460,292,459080,292414.1,751494.1
313200,201901,27,25,2,24950,1996,26946
313210,201901,1038,878,160,876245.62,159680,1035925.62
313220,201901,252,170,82,169660,81836,251496
313230,201901,273,202,71,201596.65,70858,272454.65
313240,201901,1950,1044,906,1042914.29,904188,1947102.29
313250,201901,1290,974,316,972053.8,315369.12,1287422.92
313260,201901,94,53,41,52894,40918,93812
313270,201901,958,563,395,562872.3,394210,957082.3
313280,201901,61,51,10,50898,9980,60878
313290,201901,220,179,41,178642.4,40918,219560.4
313300,201901,356,183,173,183633.4,172654,356287.4
313310,201901,244,127,117,127744,116766,244510
313320,201901,376,284,92,283432.6,91816,375248.6
313330,201901,1383,863,520,861274.6,518960.6,1380235.2
313340,201901,337,236,101,235528,102794,338322
313350,201901,512,346,166,345308,165668,510976
313360,201901,113,67,46,66866,45908.4,112774.4
313370,201901,194,73,121,72854,120758,193612
313375,201901,275,164,111,165668,110778,276446
313380,201901,1339,702,637,700596,637722.99,1338318.99
313390,201901,53,47,6,46906.6,5988,52894.6
313400,201901,418,285,133,284430,132734.8,417164.8
313410,201901,24,14,10,13972,9980,23952
313420,201901,4696,2480,2216,2477037.6,2213564.7,4690602.3
313430,201901,144,67,77,66866,76846,143712
313440,201901,1495,1025,470,1023949.11,469062,1493011.11
313450,201901,64,27,37,26946,36926,63872
313460,201901,381,177,204,176646.4,203592,380238.4
313470,201901,527,244,283,243512,283432,526944
313480,201901,151,105,46,104790.4,45908,150698.4
313490,201901,513,248,265,247504.4,264470.9,511975.3
313500,201901,22,13,9,12974,8982,21956
313505,201901,1027,813,214,811374,213572,1024946
313507,201901,97,59,38,58882,37924,96806
313510,201901,2828,1817,1011,1813367.4,1008978,2822345.4
313520,201901,3580,2803,777,2798395.74,775446.99,3573842.73
313530,201901,44,29,15,28942,14970,43912
313535,201901,112,88,24,87824,23952,111776
313540,201901,75,57,18,56886,17964,74850
313545,201901,110,93,17,92814,16966,109780
313550,201901,234,197,37,196606,36926.4,233532.4
313560,201901,329,168,161,167664,160678,328342
313570,201901,58,29,29,28942,28942,57884
313580,201901,1344,751,593,749498,591815.2,1341313.2
313590,201901,77,46,31,45908,30938,76846
313600,201901,694,424,270,423152.4,269460.4,692612.8
313610,201901,62,48,14,47904,13972,61876
313620,201901,1376,724,652,722552.8,650696,1373248.8
313630,201901,1650,1264,386,1262471.35,385228,1647699.35
313640,201901,130,77,53,76846,52894,129740
313650,201901,241,112,129,111776,128742.4,240518.4
313652,201901,19,19,0,18962,,18962.0
313655,201901,58,34,24,33932,23952,57884
313657,201901,47,44,3,43912,2994,46906
313660,201901,137,93,44,92814,43929.96,136743.96
313665,201901,655,318,337,317364,336326,653690
313670,201901,10254,7098,3156,7088801.93,3155677.6,10244479.53
313680,201901,44,33,11,32934,10978.78,43912.78
313690,201901,155,115,40,114770,39920,154690
313695,201901,78,60,18,59880,17964,77844
313700,201901,315,251,64,250498.4,63872,314370.4
313710,201901,136,94,42,93812,41916,135728
313720,201901,1142,551,591,549898.8,589819.4,1139718.2
313730,201901,63,43,20,42914,19960,62874
313740,201901,160,130,30,129740,29940,159680
313750,201901,440,322,118,322354,117764,440118
313753,201901,243,178,65,177644,65868,243512
313760,201901,1275,466,809,466066.4,807384.1,1273450.5
313770,201901,361,267,94,266466.5,93812,360278.5
313780,201901,762,398,364,398202,363272,761474
313790,201901,31,30,1,29940,998,30938
313800,201901,151,96,55,95808,54890,150698
313810,201901,69,40,29,39920,28942,68862
313820,201901,1302,650,652,648701.2,650697.35,1299398.55
313830,201901,65,47,18,46906,17964,64870
313835,201901,61,51,10,50898,9980,60878
313840,201901,1719,1075,644,1072851.2,643710.8,1716562.0
313850,201901,187,66,121,65868,121756,187624
313860,201901,474,363,111,363272.4,110778,474050.4
313862,201901,176,117,59,116766,58882,175648
313865,201901,96,76,20,75848,19960,95808
313867,201901,48,37,11,36926,10978,47904
313868,201901,29,18,11,17964,10978,28942
313870,201901,127,67,60,66866,59880,126746
313880,201901,372,236,136,235528,135728.4,371256.4
313890,201901,336,180,156,179641,155688,335329
313900,201901,909,502,407,500996.5,406186.9,907183.4
313910,201901,137,100,37,99800,36926,136726
313920,201901,630,447,183,446106,182634.9,628740.9
313925,201901,33,29,4,28942,3992,32934
313930,201901,828,641,187,639718,187624.95,827342.95
313940,201901,1813,1140,673,1137720,672652.4,1810372.4
313950,201901,938,602,336,601794.8,335328,937122.8
313960,201901,1396,811,585,810377.16,583831.8,1394208.96
313970,201901,127,86,41,85828,40918,126746
313980,201901,213,139,74,138722.5,73852,212574.5
313990,201901,377,224,153,223552,152694,376246
314000,201901,928,624,304,623751.74,303392,927143.74
314010,201901,80,53,27,53892,27944,81836
314015,201901,54,17,37,16966,36926,53892
314020,201901,55,39,16,38922,15968,54890
314030,201901,79,38,41,37924,40918,78842
314040,201901,44,29,15,28942,14970,43912
314050,201901,308,183,125,182634.4,124750,307384.4
314053,201901,95,62,33,61876,32934,94810
314055,201901,301,183,118,182634,117764,300398
314060,201901,146,123,23,122754,22954,145708
314070,201901,1058,555,503,554888,501994,1056882
314080,201901,213,140,73,139720,72854.36,212574.36
314085,201901,150,101,49,100798,48902,149700
314090,201901,368,267,101,266466.9,100798,367264.9
314100,201901,477,395,82,394210.3,81836,476046.3
314110,201901,740,404,336,404190,336326,740516
314120,201901,92,54,38,53892,37924,91816
314130,201901,22,11,11,11976,10978,22954
314140,201901,1109,683,426,681634.4,426146,1107780.4
314150,201901,163,104,59,103792,59880,163672
314160,201901,347,260,87,259480.6,86826.6,346307.2
314170,201901,80,62,18,61876,17964,79840
314180,201901,738,653,85,652692.4,85828.5,738520.9
314190,201901,101,61,40,60878,39920,100798
314200,201901,584,407,177,406186,177644,583830
314210,201901,278,213,65,212574,64870.4,277444.4
314220,201901,310,235,75,234530.4,74850.4,309380.8
314225,201901,67,49,18,48902,17964,66866
314230,201901,113,50,63,49900,62874,112774
314240,201901,140,110,30,109780,29940,139720
314250,201901,60,38,22,37924,21956,59880
314260,201901,196,96,100,95808,99800,195608
314270,201901,336,268,68,267464,67864,335328
314280,201901,697,395,302,394210.98,302394,696604.98
314290,201901,554,456,98,455088.9,97804,552892.9
314300,201901,394,283,111,282437,110778.9,393215.9
314310,201901,1431,969,462,968060,461076,1429136
314315,201901,39,31,8,30938,7984,38922
314320,201901,605,397,208,396206.4,210578,606784.4
314330,201901,10763,5414,5349,5405172.36,5342297.53,10747469.89
314340,201901,588,273,315,272454,314370.8,586824.8
314345,201901,39,30,9,29940,8982,38922
314350,201901,190,119,71,118762,70858,189620
314360,201901,79,50,29,49900,28942,78842
314370,201901,57,47,10,46906,9980,56886
314380,201901,94,66,28,65868,27944,93812
314390,201901,3306,2115,1191,2113765.5,1189616.6,3303382.1
314400,201901,698,502,196,500997.5,195608,696605.5
314410,201901,460,303,157,303392,156686,460078
314420,201901,19,10,9,9980,8982,18962
314430,201901,2471,903,1568,901196.2,1567858,2469054.2
314435,201901,267,160,107,159680,106786,266466
314437,201901,29,23,6,22954,5988,28942
314440,201901,100,74,26,73852,25948,99800
314450,201901,154,111,43,110778,42914,153692
314460,201901,654,310,344,310378,344310,654688
314465,201901,90,60,30,59880,29940,89820
314467,201901,69,57,12,56886,11976,68862
314470,201901,405,208,197,207584.1,196606,404190.1
314480,201901,1093,531,562,530936,560876,1091812
314490,201901,85,62,23,61876,22954,84830
314500,201901,307,205,102,204590,101796,306386
314505,201901,131,87,44,86826,43912,130738
314510,201901,236,197,39,196606,38922,235528
314520,201901,1268,668,600,666672.9,598801.2,1265474.1
314530,201901,764,611,153,609779.66,152694,762473.66
314535,201901,216,133,83,132734,82834,215568
314537,201901,67,40,27,39920,26946,66866
314540,201901,13,8,5,7984,4990,12974
314545,201901,49,31,18,30938,17964,48902
314550,201901,83,45,38,44910,37924,82834
314560,201901,843,456,387,455089.2,386226,841315.2
314570,201901,21,17,4,16966,3992,20958
314580,201901,15,8,7,7984,6986,14970
314585,201901,22,17,5,16966,4990,21956
314587,201901,80,71,9,70858,8982,79840
314590,201901,596,439,157,438123.3,157684,595807.3
314600,201901,957,628,329,626745,328342.43,955087.43
314610,201901,961,519,442,517962.9,441116,959078.9
314620,201901,144,105,39,104790,38922,143712
314625,201901,95,70,25,69860,24950,94810
314630,201901,1216,629,587,627742,585826,1213568
314640,201901,85,58,27,57884,26946,84830
314650,201901,190,110,80,109780,79840,189620
314655,201901,68,50,18,49900,17964,67864
314660,201901,19,15,4,14970,3992,18962
314670,201901,204,159,45,158682.4,44910,203592.4
314675,201901,215,128,87,127744,86826,214570
314690,201901,558,305,253,304390,253492,557882
314700,201901,2391,1301,1090,1299397.6,1087820,2387217.6
314710,201901,1622,952,670,954090.1,671654.4,1625744.5
314720,201901,397,237,160,236526,161676,398202
314730,201901,514,266,248,265469.4,247504.98,512974.38
314740,201901,697,343,354,343312,353292,696604
314750,201901,20,17,3,16966,2994,19960
314760,201901,331,159,172,158682,172654,331336
314770,201901,120,84,36,83832.4,35928,119760.4
314780,201901,20,6,14,5988,13972,19960
314790,201901,2402,1523,879,1521953.17,878240,2400193.17
314795,201901,61,52,9,51896.5,8982,60878.5
314800,201901,2952,1743,1209,1740513.48,1207580,2948093.48
314810,201901,1543,872,671,871254,669658.6,1540912.6
314820,201901,96,54,42,53892,41916,95808
314830,201901,216,177,39,176646,38922.4,215568.4
314840,201901,85,48,37,47904,36926,84830
314850,201901,349,172,177,171656,177644,349300
314860,201901,710,536,174,534929.13,173652.7,708581.83
314870,201901,1510,799,711,797402,709578,1506980
314875,201901,58,50,8,49900,7984,57884
314880,201901,46,31,15,30938,14970,45908
314890,201901,55,32,23,31936,22954,54890
314900,201901,32,25,7,24950,6986,31936
314910,201901,254,172,82,171656,81836,253492
314915,201901,156,136,20,136726,19960,156686
314920,201901,119,73,46,72854,45908.4,118762.4
314930,201901,1084,549,535,547902.8,533930,1081832.8
314940,201901,49,39,10,38922,9980,48902
314950,201901,38,27,11,26946,10978,37924
314960,201901,54,40,14,39920,13972,53892
314970,201901,147,75,72,74850,71856,146706
314980,201901,298,190,108,189620,107784,297404
314990,201901,460,255,205,254490,205588,460078
314995,201901,214,63,151,62874,150698,213572
315000,201901,91,76,15,75848,14970,90818
315010,201901,44,29,15,28942,14970,43912
315015,201901,174,143,31,142714,30938,173652
315020,201901,73,63,10,62874,9980,72854
315030,201901,116,90,26,89820,25948,115768
315040,201901,73,53,20,52894,19960,72854
315050,201901,197,116,81,115768,80838.4,196606.4
315053,201901,45,39,6,38922,5988,44910
315057,201901,97,80,17,79840,16966,96806
315060,201901,71,61,10,60878.92,9980,70858.92
315070,201901,105,60,45,59880,44910,104790
315080,201901,384,314,70,313372,69860,383232
315090,201901,110,65,45,64870,44910,109780
315100,201901,82,42,40,41916,39920,81836
315110,201901,287,158,129,157684,128742,286426
315120,201901,1645,832,813,830336,811374.68,1641710.68
315130,201901,348,252,96,251496,95808,347304
315140,201901,528,311,217,310378,216566,526944
315150,201901,983,471,512,471056.8,510976.4,982033.2
315160,201901,221,112,109,111776,108782,220558
315170,201901,325,214,111,213572.4,110778,324350.4
315180,201901,3272,1389,1883,1386224,1881232.3,3267456.3
315190,201901,329,194,135,193612.2,134730,328342.2
315200,201901,1246,722,524,720556,524948,1245504
315210,201901,1592,907,685,905186.6,684628,1589814.6
315213,201901,42,25,17,24950,16966,41916
315217,201901,216,174,42,173652,41916,215568
315220,201901,1572,1205,367,1202591.58,366266.4,1568857.98
315230,201901,168,122,46,121756.4,45908,167664.4
315240,201901,431,277,154,276446,153692.98,430138.98
315250,201901,2527,1256,1271,1253488.4,1270454.8,2523943.2
315260,201901,149,90,59,89820,58882,148702
315270,201901,126,89,37,88822,36926,125748
315280,201901,686,448,238,447104.6,237524,684628.6
315290,201901,206,125,81,124750,80838,205588
315300,201901,72,52,20,51896,19960,71856
315310,201901,69,63,6,63872,5988,69860
315320,201901,169,98,71,97804,70858,168662
315330,201901,60,51,9,50898,8982,59880
315340,201901,403,288,115,287424,114770,402194
315350,201901,152,90,62,89820,61876,151696
315360,201901,94,48,46,47904,45908,93812
315370,201901,58,34,24,33932,23952,57884
315380,201901,11,7,4,6986,3992,10978
315390,201901,73,19,54,18962,53892,72854
315400,201901,839,633,206,631734.7,205588,837322.7
315410,201901,357,219,138,218562.4,137725.4,356287.8
315415,201901,61,46,15,45908,14970,60878
315420,201901,203,154,49,153692.7,48902,202594.7
315430,201901,680,395,285,394210.4,284430,678640.4
315440,201901,91,63,28,62874,27944,90818
315445,201901,252,203,49,202594,48902,251496
315450,201901,186,140,46,139720,45908,185628
315460,201901,3528,1787,1741,1783426.98,1738517.38,3521944.36
315470,201901,42,19,23,18962,22954,41916
315480,201901,65,24,41,23952,40918,64870
315490,201901,640,398,242,397204,241516,638720
315500,201901,24,16,8,15968,7984,23952
315510,201901,151,101,50,100798,50898,151696
315520,201901,74,65,9,64870,8982,73852
315530,201901,54,29,25,28942,24950,53892
315540,201901,239,161,78,160678,77844,238522
315550,201901,184,145,39,144710,38922,183632
315560,201901,738,593,145,591814.4,144710,736524.4
315570,201901,315,161,154,160679.8,153692.6,314372.4
315580,201901,690,455,235,454090,234530,688620
315590,201901,205,109,96,108782,95808,204590
315600,201901,300,228,72,227544,71856,299400
315610,201901,96,49,47,48902,46906,95808
315620,201901,36,28,8,27944,7984,35928
315630,201901,136,91,45,90818,44910,135728
315640,201901,67,41,26,40918,25948,66866
315645,201901,62,45,17,44910,16966,61876
315650,201901,169,124,45,123752.8,44910,168662.8
315660,201901,475,212,263,211576,263472,475048
315670,201901,2443,1215,1228,1212571.57,1226543.96,2439115.53
315680,201901,855,586,269,584828,268462,853290
315690,201901,684,475,209,474051.33,208582,682633.33
315700,201901,1912,1010,902,1008979.27,900196.8,1909176.07
315710,201901,332,94,238,93812,237524,331336
315720,201901,449,287,162,286426,161676,448102
315725,201901,204,163,41,162674.4,40918,203592.4
315727,201901,39,21,18,20958,17964,38922
315730,201901,49,47,2,46906,1996,48902
315733,201901,86,57,29,56886,28942,85828
315737,201901,49,38,11,37924,10978,48902
315740,201901,43,35,8,34930,7984,42914
315750,201901,156,120,36,119760,35928,155688
315760,201901,44,34,10,33932,9980,43912
315765,201901,123,78,45,77844,44910,122754
315770,201901,236,147,89,146706,88822.4,235528.4
315780,201901,3432,1787,1645,1785423,1641711.15,3427134.15
315790,201901,206,159,47,158682,46906,205588
315800,201901,293,213,80,212574,79840,292414
315810,201901,96,57,39,56886,38922.4,95808.4
315820,201901,792,578,214,576845.08,213572,790417.08
315830,201901,135,78,57,77844,56886,134730
315840,201901,90,63,27,62874,26946,89820
315850,201901,264,196,68,195608,67864,263472
315860,201901,11,3,8,2994,7984,10978
315870,201901,37,30,7,29940,6986,36926
315880,201901,109,72,37,71856,36926,108782
315890,201901,86,64,22,63872,21956,85828
315895,201901,480,331,149,330338.5,149700.8,480039.3
315900,201901,75,38,37,37924,36926,74850
315910,201901,41,28,13,28942,12974,41916
315920,201901,181,116,65,115768,64870.3,180638.3
315930,201901,45,16,29,15968,28942,44910
315935,201901,147,113,34,112774,33932.98,146706.98
315940,201901,93,69,24,68862,23952,92814
315950,201901,46,33,13,32934,12974,45908
315960,201901,552,261,291,260478.4,290418.4,550896.8
315970,201901,36,29,7,28942,6986,35928
315980,201901,699,334,365,334330.1,364270,698600.1
315990,201901,259,151,108,151696.5,107785.38,259481.88
316000,201901,53,35,18,34930,17964,52894
316010,201901,79,67,12,66866,11976,78842
316020,201901,116,97,19,96806,18962,115768
316030,201901,407,220,187,219560.8,186626.9,406187.7
316040,201901,515,219,296,218562.4,295408.4,513970.8
316045,201901,63,56,7,55888,6986,62874
316050,201901,16,14,2,13972,1996,15968
316060,201901,102,65,37,64870,36926,101796
316070,201901,1104,708,396,706584.1,395208,1101792.1
316080,201901,105,68,37,67864,36926,104790
316090,201901,40,23,17,22954,16966,39920
316095,201901,75,63,12,62874,11976,74850
316100,201901,319,187,132,186626.5,131736,318362.5
316105,201901,36,24,12,23952,11976,35928
316110,201901,1909,1537,372,1533926.95,371256,1905182.95
316120,201901,80,60,20,59880,19960,79840
316130,201901,132,102,30,102794.4,29940,132734.4
316140,201901,29,21,8,20958,7984,28942
316150,201901,212,149,63,148702,63872,212574
316160,201901,79,49,30,48902,29940,78842
316165,201901,70,53,17,52894.6,16966,69860.6
316170,201901,198,134,64,133732,63872,197604
316180,201901,205,89,116,88822,115768.4,204590.4
316190,201901,142,103,39,102794,38922,141716
316200,201901,689,391,298,390218,297404,687622
316210,201901,773,520,253,519131.65,252494,771625.65
316220,201901,113,77,36,76846,35928,112774
316225,201901,26,15,11,14970,10978,25948
316230,201901,31,19,12,18962,11976,30938
316240,201901,646,522,124,520956,123752,644708
316245,201901,121,102,19,101796,18962,120758
316250,201901,1511,1043,468,1041913.66,468062,1509975.66
316255,201901,122,98,24,98802,23952,122754
316257,201901,180,93,87,93812,86826,180638
316260,201901,194,137,57,136726.5,57884.8,194611.3
316265,201901,28,19,9,18962,8982,27944
316270,201901,674,472,202,471057,201596.84,672653.84
316280,201901,543,335,208,334331.23,207584.8,541916.03
316290,201901,709,469,240,469060.66,239520,708580.66
316292,201901,524,210,314,209580,313372.5,522952.5
316294,201901,103,61,42,60878,41916,102794
316295,201901,297,136,161,135729.36,160678,296407.36
316300,201901,101,72,29,71856,28942,100798
316310,201901,37,20,17,19960,16966,36926
316320,201901,43,26,17,25948,16966,42914
316330,201901,133,88,45,87824.5,44910,132734.5
316340,201901,144,100,44,99800,43912,143712
316350,201901,190,140,50,139720.7,49900,189620.7
316360,201901,25,18,7,17964,6986,24950
316370,201901,1086,571,515,569859.5,514968,1084827.5
316380,201901,127,98,29,97804,29940,127744
316390,201901,123,88,35,87824,34930,122754
316400,201901,137,105,32,104790,31936,136726
316410,201901,302,221,81,220558,80838,301396
316420,201901,208,146,62,145708,61876,207584
316430,201901,153,80,73,80838,72854,153692
316440,201901,99,48,51,47904,51896,99800
316443,201901,38,36,2,35928,1996,37924
316447,201901,67,52,15,51896,14970,66866
316450,201901,234,175,59,174650,58882,233532
316460,201901,73,29,44,28942,43912,72854
316470,201901,1637,1196,441,1195597.37,441116.4,1636713.77
316480,201901,13,10,3,9980,2994,12974
316490,201901,18,7,11,6986,10978,17964
316500,201901,155,102,53,101796,52894,154690
316510,201901,164,124,40,124750,39920,164670
316520,201901,194,119,75,118762,74850,193612
316530,201901,159,111,48,110778,47904,158682
316540,201901,140,79,61,78842,60878,139720
316550,201901,136,93,43,92814,42914,135728
316553,201901,259,123,136,122754,135728,258482
316555,201901,34,28,6,27944,5988,33932
316556,201901,11,8,3,7984,2994,10978
316557,201901,20,14,6,13972,5988,19960
316560,201901,66,51,15,50898,14970,65868
316570,201901,241,220,21,219560,20958,240518
316580,201901,21,16,5,15968,4990,20958
316590,201901,115,99,16,98802,15968,114770
316600,201901,180,148,32,147704.74,31936,179640.74
316610,201901,67,48,19,47904,18962,66866
316620,201901,137,106,31,105788,30938,136726
316630,201901,42,32,10,31936,9980,41916
316640,201901,17,10,7,9980,6986,16966
316650,201901,71,55,16,54890,15968,70858
316660,201901,8,3,5,2994,4990,7984
316670,201901,440,153,287,152694.96,286426,439120.96
316680,201901,162,112,50,111776,49900.6,161676.6
316690,201901,190,122,68,121756,67864,189620
316695,201901,64,56,8,55888,7984,63872
316700,201901,16,9,7,8982,6986,15968
316710,201901,748,552,196,551229.16,196606,747835.16
316720,201901,4957,2524,2433,2518957.25,2431130.74,4950087.99
316730,201901,18,17,1,16966,998,17964
316740,201901,122,79,43,78842,42914,121756
316750,201901,20,13,7,12974,6986,19960
316760,201901,321,260,61,259480,61876,321356
316770,201901,139,76,63,75848,62874,138722
316780,201901,77,48,29,47904,28942,76846
316790,201901,56,43,13,42914,12974,55888
316800,201901,1761,1103,658,1100794.89,657683,1758477.89
316805,201901,19,11,8,10978,7984,18962
316810,201901,72,48,24,47904,23952,71856
316820,201901,43,20,23,19960,22954,42914
316830,201901,93,42,51,41916,50898,92814
316840,201901,515,311,204,310378.4,203592,513970.4
316850,201901,349,229,120,228542,120758,349300
316860,201901,6037,2686,3351,2683625.76,3347292.3,6030918.06
316870,201901,1492,980,512,978042.5,510977.2,1489019.7
316880,201901,127,65,62,64870,61876,126746
316890,201901,246,167,79,166666,78842,245508
316900,201901,429,295,134,294410.36,133732,428142.36
316905,201901,19,9,10,8982,9980,18962
316910,201901,53,24,29,23952,28942,52894
316920,201901,134,106,28,105788,27944,133732
316930,201901,1914,983,931,983030.8,931134.3,1914165.1
316935,201901,898,550,348,548900.64,347304.4,896205.04
316940,201901,1095,632,463,630736.8,462074.4,1092811.2
316950,201901,182,93,89,92814,88822,181636
316960,201901,1118,627,491,626744.4,490018.4,1116762.8
316970,201901,664,521,143,519958,142714,662672
316980,201901,112,68,44,67864,43912,111776
316990,201901,2243,1494,749,1491012.34,747502.9,2238515.24
317000,201901,340,261,79,260478,78842,339320
317005,201901,248,175,73,174650,72854,247504
317010,201901,6463,3622,2841,3619750.19,2837314.4,6457064.59
317020,201901,16496,7408,9088,7397192.45,9081818.55,16479011.00
317030,201901,81,32,49,31936,48902,80838
317040,201901,3106,1964,1142,1960073.8,1140715.27,3100789.07
317043,201901,79,57,22,56886,21956,78842
317047,201901,35,17,18,16966,17964.99,34930.99
317050,201901,179,138,41,137724,40918,178642
317052,201901,129,98,31,97804,30938,128742
317057,201901,194,146,48,145708,47904,193612
317060,201901,60,40,20,39920,19960,59880
317065,201901,61,49,12,48902,11976,60878
317070,201901,2000,948,1052,946105.5,1050894.8,1997000.3
317075,201901,110,59,51,58882,50898,109780
317080,201901,857,450,407,449100.5,406186.6,855287.1
317090,201901,653,525,128,524948.06,128742,653690.06
317100,201901,436,330,106,329340,105788,435128
317103,201901,114,97,17,96806,16966,113772
317107,201901,39,34,5,33932,4990,38922
317110,201901,110,46,64,45908,63872,109780
317115,201901,43,38,5,37924,4990,42914
317120,201901,1888,962,926,960076.8,924149.04,1884225.84
317130,201901,1971,1294,677,1293409.6,676644,1970053.6
317140,201901,11,9,2,8982,1996,10978
317150,201901,267,159,108,159680.4,107784,267464.4
317160,201901,315,228,87,228542.63,86826,315368.63
317170,201901,212,144,68,143712,67864,211576
317180,201901,436,316,120,315368,120758,436126
317190,201901,262,178,84,177644,83832,261476
317200,201901,804,565,239,563873.36,238522.5,802395.86
317210,201901,155,86,69,85828,68862,154690
317220,201901,21,13,8,12974,7984,20958
320010,201901,624,462,162,462074.9,161676,623750.9
320013,201901,135,100,35,99800,34930,134730
320016,201901,287,182,105,181636,104790,286426
320020,201901,736,440,296,439121.1,295408,734529.1
320030,201901,152,111,41,110778,40918,151696
320035,201901,148,110,38,109780,37924,147704
320040,201901,506,263,243,262474,242514.4,504988.4
320050,201901,111,84,27,83832,26946,110778
320060,201901,1618,772,846,770456.9,845307.78,1615764.68
320070,201901,107,71,36,70858,36926,107784
320080,201901,792,456,336,455089.89,335328,790417.89
320090,201901,1235,864,371,863270.4,370258.4,1233528.8
320100,201901,337,193,144,193612,143712,337324
320110,201901,127,82,45,81837.1,44910.4,126747.5
320115,201901,114,94,20,93812,19960,113772
320120,201901,3395,1895,1500,1891212.36,1497001.77,3388214.13
320130,201901,7542,3560,3982,3555894.07,3978059.37,7533953.44
320140,201901,430,283,147,283432.6,146707.58,430140.18
320150,201901,2004,1161,843,1159677.57,841314,2000991.57
320160,201901,677,304,373,303392.99,372255.79,675648.78
320170,201901,111,88,23,87824,22954,110778
320180,201901,54,32,22,31936,21956,53892
320190,201901,240,161,79,160678,78842.4,239520.4
320200,201901,57,45,12,44910,11976,56886
320210,201901,879,491,388,490018.8,388223.76,878242.56
320220,201901,314,118,196,117764,197604,315368
320225,201901,85,70,15,69860,14970,84830
320230,201901,592,383,209,382234.6,208582,590816.6
320240,201901,3170,1608,1562,1605784,1561871.78,3167655.78
320245,201901,476,328,148,328342.4,147704,476046.4
320250,201901,232,120,112,119760,111776,231536
320255,201901,140,112,28,111776,27944.7,139720.7
320260,201901,186,133,53,132734,52894,185628
320265,201901,162,129,33,128742,32934,161676
320270,201901,158,128,30,128742,29940,158682
320280,201901,1007,600,407,599799.75,406186,1005985.75
320290,201901,65,56,9,55888,8982,64870
320300,201901,555,391,164,391217.34,163673.57,554890.91
320305,201901,673,366,307,366266,306386.6,672652.6
320310,201901,218,122,96,121756.76,95808,217564.76
320313,201901,316,159,157,158682.9,156686.4,315369.3
320316,201901,109,88,21,87824,20958,108782
320320,201901,3404,1554,1850,1550893.56,1847299.95,3398193.51
320330,201901,263,200,63,199600,62874,262474
320332,201901,890,537,353,535928.7,352294.9,888223.6
320334,201901,249,154,95,153692.4,94810,248502.4
320335,201901,144,101,43,100798,42914,143712
320340,201901,583,405,178,405189.3,177644,582833.3
320350,201901,1001,433,568,432135.69,566865.2,999000.89
320360,201901,171,94,77,93812,76846,170658
320370,201901,246,189,57,188622.56,56886.4,245508.96
320380,201901,292,202,90,201596,89820,291416
320390,201901,1152,707,445,705588.24,444110.8,1149699.04
320400,201901,319,232,87,231537.4,86826,318363.4
320405,201901,939,407,532,406186.99,532935.38,939122.37
320410,201901,984,505,479,504988.8,478043.3,983032.1
320420,201901,486,251,235,251497.7,234530,486027.7
320425,201901,199,107,92,106786,91816,198602
320430,201901,398,225,173,224550.5,172654,397204.5
320435,201901,172,117,55,116766,54890,171656
320440,201901,205,122,83,121756,82834,204590
320450,201901,128,73,55,72854,54890,127744
320455,201901,245,201,44,200598.4,43912,244510.4
320460,201901,253,154,99,153692,98802.4,252494.4
320465,201901,115,77,38,76846,37924,114770
320470,201901,667,429,238,428142.99,237524.99,665667.98
320480,201901,185,121,64,120758,63872,184630
320490,201901,3085,1542,1543,1541913.85,1541916.61,3083830.46
320495,201901,99,62,37,61876.96,36926.8,98803.76
320500,201901,9675,4851,4824,4843310.49,4817361.33,9660671.82
320501,201901,544,272,272,272454,272454,544908
320503,201901,291,206,85,205588,84830,290418
320506,201901,261,193,68,192614,67864,260478
320510,201901,984,459,525,459080,523950.98,983030.98
320515,201901,80,67,13,66866,12974,79840
320517,201901,212,152,60,151696,59880,211576
320520,201901,7040,3141,3899,3136717.51,3895201.55,7031919.06
320530,201901,5655,2857,2798,2852291.32,2796401.49,5648692.81
330010,201901,3152,1640,1512,1639717.19,1508976,3148693.19
330015,201901,157,66,91,65868.56,90818,156686.56
330020,201901,3652,1607,2045,1604819.06,2041908.4,3646727.46
330022,201901,245,133,112,133732,111776,245508
330023,201901,557,193,364,192614,364270,556884
330025,201901,601,124,477,123752,477044,600796
330030,201901,1971,1289,682,1287422.66,682633.5,1970056.16
330040,201901,2434,1272,1162,1270456.7,1161675.1,2432131.8
330045,201901,8524,2743,5781,2738512.8,5778421.6,8516934.4
330050,201901,874,565,309,566864,308382,875246
330060,201901,939,586,353,584828.9,352294,937122.9
330070,201901,3464,1331,2133,1328339.52,2130731.94,3459071.46
330080,201901,1482,696,786,694610.44,784428,1479038.44
330090,201901,376,218,158,217564,157684,375248
330093,201901,284,128,156,127744,155689.88,283433.88
330095,201901,99,53,46,53892,45908,99800
330100,201901,9620,4974,4646,4966051.53,4638704.4,9604755.93
330110,201901,500,215,285,214570.7,284430,499000.7
330115,201901,575,309,266,308382,265468,573850
330120,201901,377,191,186,190618,185629.6,376247.6
330130,201901,1550,412,1138,412174.58,1135725.9,1547900.48
330140,201901,597,315,282,314370.94,282434.6,596805.54
330150,201901,470,271,199,271456,198602,470058
330160,201901,209,129,80,128742,79840,208582
330170,201901,27082,9559,17523,9553863.24,17505931.58,27059794.82
330180,201901,230,145,85,144710,84830,229540
330185,201901,871,323,548,323352.98,546905.92,870258.90
330187,201901,322,99,223,98802,222554,321356
330190,201901,5620,2264,3356,2262468.56,3357274.08,5619742.64
330200,201901,4781,1492,3289,1491013.44,3286415.85,4777429.29
330205,201901,428,253,175,253492,174650.4,428142.4
330210,201901,1011,627,384,626746.4,383233.2,1009979.6
330220,201901,2606,1580,1026,1576841,1023948.4,2600789.4
330225,201901,561,304,257,303392.9,256486,559878.9
330227,201901,2407,763,1644,762472.4,1641713.26,2404185.66
330230,201901,218,126,92,125748,91816,217564
330240,201901,3712,1970,1742,1968063.98,1739550,3707613.98
330245,201901,157,72,85,71856.76,84830,156686.76
330250,201901,6736,3493,3243,3488013.87,3237516.28,6725530.15
330260,201901,575,165,410,164670,411176,575846
330270,201901,3475,1271,2204,1269456.6,2200591,3470047.6
330280,201901,459,294,165,293413.2,164670.98,458084.18
330285,201901,7215,2378,4837,2375242.1,4831323.32,7206565.42
330290,201901,601,233,368,232534,369260,601794
330300,201901,801,538,263,536925.25,262474.94,799400.19
330310,201901,446,248,198,247504.9,198602,446106.9
330320,201901,8274,3189,5085,3185619.6,5079821.6,8265441.2
330330,201901,9027,3601,5426,3597793.66,5424141.66,9021935.32
330340,201901,2684,1600,1084,1596800.6,1083828,2680628.6
330350,201901,18159,7218,10941,7211556.97,10930108.58,18141665.55
330360,201901,2389,1201,1188,1198600.16,1187620.98,2386221.14
330370,201901,1067,562,505,560876.4,503990.6,1064867.0
330380,201901,861,370,491,369260,491017.2,860277.2
330385,201901,607,318,289,317364.5,288422,605786.5
330390,201901,5295,2916,2379,2914163.67,2378235.34,5292399.01
330395,201901,293,183,110,182634.1,109780.7,292414.8
330400,201901,713,385,328,384231,327344,711575
330410,201901,504,359,145,358283.31,144710.4,502993.71
330411,201901,234,131,103,131736.62,102794,234530.62
330412,201901,248,103,145,102794.4,144710,247504.4
330414,201901,6022,2488,3534,2485021.68,3531923.2,6016944.88
330415,201901,584,268,316,267464,315368.6,582832.6
330420,201901,2258,1182,1076,1181633.42,1073849.38,2255482.80
330430,201901,1811,875,936,873252,937125.2,1810377.2
330440,201901,275,131,144,130738,143712,274450
330450,201901,117,51,66,50898,65868,116766
330452,201901,1817,867,950,865268.52,949098.4,1814366.92
330455,201901,111014,40246,70768,40198558.14,70713343,110911901.14
330460,201901,261,110,151,109780,150698.94,260478.94
330470,201901,1254,684,570,682633.3,569858.4,1252491.7
330475,201901,1401,380,1021,379240.6,1018958,1398198.6
330480,201901,812,433,379,432134,378242.6,810376.6
330490,201901,13840,4839,9001,4835311.1,8996977.66,13832288.76
330500,201901,1349,611,738,610776,736524.46,1347300.46
330510,201901,11205,3864,7341,3860266.16,7328317,11188583.16
330513,201901,102,50,52,49900,51896,101796
330515,201901,827,340,487,339321.26,486027.2,825348.46
330520,201901,2548,948,1600,948100.54,1598796,2546896.54
330530,201901,218,116,102,115768.5,101796.6,217565.1
330540,201901,357,179,178,178642,177644,356286
330550,201901,2975,1080,1895,1077840.8,1891210.8,2969051.6
330555,201901,805,307,498,306386.96,498002.6,804389.56
330560,201901,650,215,435,214570,435128.94,649698.94
330570,201901,256,182,74,181636,73852,255488
330575,201901,789,330,459,329340,458083.78,787423.78
330580,201901,3411,1916,1495,1912170.6,1495004.8,3407175.4
330590,201901,320,161,159,160678,158682.98,319360.98
330600,201901,1111,718,393,717562.4,392214,1109776.4
330610,201901,1545,852,693,851295.8,691617,1542912.8
330615,201901,197,148,49,147704,48902,196606
330620,201901,1049,436,613,435128.6,612772,1047900.6
330630,201901,4010,2556,1454,2551889.16,1454087.1,4005976.26
350010,201901,601,401,200,400198.82,199600,599798.82
350020,201901,44,20,24,19960,23952,43912
350030,201901,522,335,187,335328.4,186626.8,521955.2
350040,201901,125,49,76,48902,75848,124750
350050,201901,298,159,139,158682,138722.98,297404.98
350055,201901,86,50,36,49900,35928,85828
350060,201901,73,27,46,26946,45908,72854
350070,201901,817,487,330,486059.95,330355.08,816415.03
350075,201901,73,48,25,47904,24950,72854
350080,201901,49,31,18,30938,17964,48902
350090,201901,91,51,40,50898,39920,90818
350100,201901,293,181,112,180638,111776,292414
350110,201901,55,36,19,35928,18962,54890
350115,201901,160,97,63,96806,62874,159680
350120,201901,108,72,36,71856,35928,107784
350130,201901,346,164,182,163672.58,181636,345308.58
350140,201901,35,21,14,20958,13972,34930
350150,201901,68,53,15,52894,14970,67864
350160,201901,2596,1030,1566,1027944.27,1564871.92,2592816.19
350170,201901,402,244,158,243512.4,157684.4,401196.8
350180,201901,186,98,88,97804,87824,185628
350190,201901,1028,551,477,549899.59,477044.4,1026943.99
350200,201901,69,25,44,24950,43912,68862
350210,201901,1325,747,578,746506.99,576844.63,1323351.62
350220,201901,679,577,102,576844.63,101796,678640.63
350230,201901,80,54,26,54890,25948,80838
350240,201901,62,45,17,44910,16966,61876
350250,201901,1200,594,606,592813.4,604789.1,1197602.5
350260,201901,89,63,26,62874,25948,88822
350270,201901,844,557,287,555886.6,286426.4,842313.0
350275,201901,308,128,180,127744.2,179640,307384.2
350280,201901,4703,2411,2292,2409188.54,2290414.95,4699603.49
350290,201901,420,200,220,199600,219560.4,419160.4
350300,201901,59,33,26,32934,25948,58882
350310,201901,103,66,37,65868,36926,102794
350315,201901,40,25,15,24950,14970,39920
350320,201901,3300,1635,1665,1634724.9,1661671,3296395.9
350330,201901,1690,902,788,900198.83,789419.2,1689618.03
350335,201901,21,14,7,13972,6986,20958
350340,201901,134,62,72,61876,71856.3,133732.3
350350,201901,94,48,46,47904,45908,93812
350360,201901,128,84,44,83832.99,43912,127744.99
350370,201901,87,51,36,50898.63,35928,86826.63
350380,201901,762,322,440,321356.4,440118,761474.4
350390,201901,1520,617,903,615767.43,901194.4,1516961.83
350395,201901,26,21,5,20958,4990,25948
350400,201901,1699,883,816,881236.07,815367.62,1696603.69
350410,201901,2331,1037,1294,1034926.4,1291413.59,2326339.99
350420,201901,241,147,94,147705.03,94810,242515.03
350430,201901,76,45,31,44910,30938,75848
350440,201901,148,109,39,108782.4,38922,147704.4
350450,201901,1657,1018,639,1015966.67,637723.2,1653689.87
350460,201901,333,125,208,124750,207584,332334
350470,201901,17,11,6,10978,5988,16966
350480,201901,168,92,76,91816,75848,167664
350490,201901,231,118,113,117764,113772,231536
350500,201901,43,19,24,18962,24950,43912
350510,201901,165,109,56,108782,55888,164670
350520,201901,453,217,236,216566,235528,452094
350530,201901,446,206,240,205588,239520,445108
350535,201901,78,62,16,61876,15968,77844
350540,201901,383,196,187,195608,186626,382234
350550,201901,2714,1596,1118,1594806.91,1117765.39,2712572.30
350560,201901,653,458,195,457084.03,194610,651694.03
350570,201901,4120,1744,2376,1742509.63,2376242.31,4118751.94
350580,201901,385,188,197,187624.63,197604.99,385229.62
350590,201901,896,500,396,499000.4,396206,895206.4
350600,201901,6213,3128,3085,3123746.36,3079831.37,6203577.73
350610,201901,1532,800,732,798401.26,733530.98,1531932.24
350620,201901,34,22,12,21956,11976,33932
350630,201901,235,136,99,135728.63,98802.63,234531.26
350635,201901,904,372,532,371256.4,531934.8,903191.2
350640,201901,120,90,30,89820,29940,119760
350650,201901,1915,1264,651,1261473.18,649698.98,1911172.16
350660,201901,755,331,424,330338,423152.99,753490.99
350670,201901,321,165,156,164670.5,155688,320358.5
350680,201901,184,96,88,95808,87824,183632
350690,201901,203,105,98,104790,97804,202594
350700,201901,765,370,395,370258.4,395208,765466.4
350710,201901,346,130,216,130738,215568,346306
350715,201901,55,44,11,43912,10978,54890
350720,201901,17,10,7,9980,6986,16966
350730,201901,45,28,17,27944,16966,44910
350740,201901,210,116,94,115768,93812,209580
350745,201901,18,9,9,8982.44,8982,17964.44
350750,201901,2171,1376,795,1374248.2,793410.98,2167659.18
350760,201901,3734,1648,2086,1647698.66,2083824.4,3731523.06
350770,201901,60,41,19,40918,18962,59880
350775,201901,49,35,14,34930,13972.98,48902.98
350780,201901,424,215,209,214570,209769,424339
350790,201901,367,153,214,152694,214570,367264
350800,201901,450,259,191,258482,191616,450098
350810,201901,523,416,107,415168.63,106786.4,521955.03
350820,201901,87,53,34,52894,33932,86826
350830,201901,82,45,37,44910,36926,81836
350840,201901,771,330,441,329340.4,441117.78,770458.18
350850,201901,1783,1034,749,1031933.2,749501.93,1781435.13
350860,201901,594,344,250,343314.46,249500,592814.46
350870,201901,441,301,140,300398,139720,440118
350880,201901,282,153,129,152694,129740,282434
350890,201901,39,26,13,25948,12974,38922
350900,201901,1474,475,999,474051.36,997002,1471053.36
350910,201901,24,14,10,13972,9980,23952
350920,201901,627,341,286,340318,287424,627742
350925,201901,1215,649,566,647702.78,566865.2,1214567.98
350930,201901,98,60,38,61876,37924,99800
350940,201901,733,410,323,409180,322354.36,731534.36
350945,201901,109,80,29,79840,28942,108782
350950,201901,16008,7733,8275,7725525.54,8269435.61,15994961.15
350960,201901,1277,590,687,589818.4,685626.99,1275445.39
350970,201901,1151,594,557,592706.03,555886.8,1148592.83
350980,201901,94,65,29,64870,28942,93812
350990,201901,369,133,236,132734,236526,369260
350995,201901,34,16,18,15968,17964,33932
351000,201901,626,436,190,435129.26,190618,625747.26
351010,201901,49,30,19,29940,18962,48902
351015,201901,55,38,17,37924,16966,54890
351020,201901,1656,983,673,982032.99,673650.84,1655683.83
351030,201901,354,242,112,241516,111776,353292
351040,201901,849,451,398,451096.5,399200.11,850296.61
351050,201901,3356,1557,1799,1556886.23,1799402.88,3356289.11
351060,201901,5061,2071,2990,2067858.36,2984024.56,5051882.92
351070,201901,414,263,151,262474.97,150698,413172.97
351080,201901,791,571,220,570856,219560,790416
351090,201901,59,26,33,25948,32934,58882
351100,201901,450,259,191,258483.46,190618,449101.46
351110,201901,2090,1001,1089,999009.96,1086839.06,2085849.02
351120,201901,70,34,36,33932,35928,69860
351130,201901,172,59,113,58882,112774,171656
351140,201901,343,235,108,234530,107784,342314
351150,201901,428,231,197,230538.7,196606,427144.7
351160,201901,261,173,88,172654.4,87824,260478.4
351170,201901,187,105,82,104790,81836,186626
351190,201901,87,59,28,58882,27944,86826
351200,201901,372,247,125,246506.4,124750,371256.4
351210,201901,124,60,64,59880,63872,123752
351220,201901,536,320,216,319362.16,215568,534930.16
351230,201901,284,203,81,203592,80838,284430
351240,201901,233,101,132,100798,131736,232534
351250,201901,74,52,22,51896.53,21956,73852.53
351260,201901,153,113,40,113772,39920,153692
351270,201901,51,21,30,20958,29940,50898
351280,201901,1088,494,594,494011.26,593811.61,1087822.87
351290,201901,233,109,124,108782,123752.4,232534.4
351300,201901,3721,1736,1985,1733449.15,1984025.62,3717474.77
351310,201901,770,393,377,392214,376246,768460
351320,201901,113,68,45,67864,44910,112774
351330,201901,40,27,13,26946,12974,39920
351340,201901,1238,759,479,759479.4,478044.95,1237524.35
351350,201901,2557,1483,1074,1480035.7,1073848,2553883.7
351360,201901,785,392,393,391216,392214,783430
351370,201901,377,192,185,191616,184630,376246
351380,201901,9054,4108,4946,4102784.93,4938111.18,9040896.11
351385,201901,29,18,11,17964,10978,28942
351390,201901,286,215,71,214570,70858,285428
351400,201901,65,41,24,40918,23954.94,64872.94
351410,201901,443,276,167,276446.6,167664,444110.6
351420,201901,60,48,12,47904,11976,59880
351430,201901,69,39,30,38922,29940,68862
351440,201901,800,558,242,557884.56,241516.99,799401.55
351450,201901,260,134,126,133732,125748,259480
351460,201901,116,54,62,53892,61876,115768
351470,201901,136,71,65,70858,64870,135728
351480,201901,526,297,229,296407.36,229540,525947.36
351490,201901,285,103,182,102794,181636,284430
351492,201901,31,22,9,21956,8982,30938
351495,201901,27,19,8,18962,7984,26946
351500,201901,3571,1528,2043,1526941,2040911.36,3567852.36
351510,201901,1836,759,1077,757482.4,1075844.4,1833326.8
351512,201901,21,17,4,16966,3992,20958
351515,201901,193,113,80,112774,79840,192614
351518,201901,804,502,302,500996.99,301396,802392.99
351519,201901,72,46,26,45908,25948,71856
351520,201901,142,87,55,86826,54890,141716
351530,201901,22,15,7,14970,6986,21956
351535,201901,126,72,54,71856,53892,125748
351540,201901,450,322,128,321357.05,127744,449101.05
351550,201901,1356,821,535,819359.66,535926.8,1355286.46
351560,201901,73,40,33,39920,32934.96,72854.96
351565,201901,9,6,3,5988,2994,8982
351570,201901,2657,1380,1277,1377242.38,1274449.96,2651692.34
351580,201901,40,36,4,35928,3992,39920
351590,201901,68,45,23,44910,22954,67864
351600,201901,192,141,51,140718,50898,191616
351610,201901,61,29,32,28942,31936,60878
351620,201901,5896,3358,2538,3358274.51,2535919.66,5894194.17
351630,201901,2633,1348,1285,1345304.9,1284426.4,2629731.3
351640,201901,1734,839,895,837322.49,894208.4,1731530.89
351650,201901,35,30,5,29940,4990,34930
351660,201901,148,94,54,93812,53892,147704
351670,201901,718,443,275,443113.1,275448,718561.1
351680,201901,73,59,14,58882,13972,72854
351685,201901,36,21,15,20958,14970,35928
351690,201901,302,209,93,208582.45,92814,301396.45
351700,201901,156,111,45,110778,44910,155688
351710,201901,77,52,25,51896,24950,76846
351720,201901,134,67,67,66866,66866,133732
351730,201901,95,65,30,64870.63,29940.03,94810.66
351740,201901,717,471,246,470059.26,245508,715567.26
351750,201901,358,149,209,148702,208582,357284
351760,201901,797,612,185,610776,185628,796404
351770,201901,307,261,46,260478,45908,306386
351780,201901,163,93,70,92814.98,69860,162674.98
351790,201901,251,131,120,130738,119760,250498
351800,201901,46,30,16,29940,15968,45908
351810,201901,120,80,40,79840,39920,119760
351820,201901,871,627,244,627743.6,243512.4,871256.0
351830,201901,519,187,332,186626,332334,518960
351840,201901,1854,937,917,935127.44,916167.96,1851295.40
351850,201901,236,173,63,172654.3,63872,236526.3
351860,201901,727,497,230,496008.41,229540.4,725548.81
351870,201901,5580,2673,2907,2668654.74,2903184.63,5571839.37
351880,201901,18989,8147,10842,8137701.67,10834395.66,18972097.33
351885,201901,91,61,30,60878,29940,90818
351890,201901,69,57,12,56886,11976,68862
351900,201901,222,131,91,130738,90818,221556
351905,201901,80,34,46,33932,45908,79840
351907,201901,3232,1415,1817,1413169.34,1816363.56,3229532.90
351910,201901,179,74,105,73852,105788,179640
351920,201901,126,70,56,69860,55889.98,125749.98
351925,201901,90,60,30,59880,29940,89820
351930,201901,396,259,137,258482,136726,395208
351940,201901,243,112,131,111776,130738,242514
351950,201901,141,81,60,80838,59880,140718
351960,201901,888,412,476,411489,475048.4,886537.4
351970,201901,1926,1045,881,1043908.4,880237.78,1924146.18
351980,201901,150,76,74,75848,73852,149700
351990,201901,271,177,94,176646.8,93812,270458.8
352000,201901,361,222,139,221556.8,139720,361276.8
352010,201901,388,240,148,240518,147704,388222
352020,201901,195,68,127,67864,127744,195608
352030,201901,1071,550,521,548900,519958,1068858
352040,201901,588,253,335,252494,335328,587822
352042,201901,295,93,202,92814,201596.8,294410.8
352044,201901,374,222,152,222554,151696,374250
352050,201901,3342,1326,2016,1326345.16,2013964.4,3340309.56
352060,201901,106,67,39,66866,38922.4,105788.4
352070,201901,99,72,27,71857.26,26946,98803.26
352080,201901,66,40,26,39920,25948,65868
352090,201901,169,114,55,113772,54890,168662
352100,201901,265,126,139,125749.39,138724.38,264473.77
352110,201901,114,35,79,34930,78842,113772
352115,201901,69,27,42,26946,41916,68862
352120,201901,94,66,28,65868.03,28942,94810.03
352130,201901,226,188,38,187624,37924,225548
352140,201901,189,80,109,79840,108782.4,188622.4
352150,201901,118,64,54,63872,53892,117764
352160,201901,133,85,48,84830,47904,132734
352170,201901,371,260,111,259480,110778,370258
352180,201901,615,410,205,409180,204590.99,613770.99
352190,201901,260,103,157,102794,156686,259480
352200,201901,32,17,15,16966,14970,31936
352210,201901,3908,1657,2251,1653689.71,2247499.62,3901189.33
352215,201901,55,31,24,30938,23952,54890
352220,201901,7043,2705,4338,2702586.65,4335317.19,7037903.84
352230,201901,3287,2115,1172,2110787.67,1171663.61,3282451.28
352240,201901,2292,1332,960,1331332.4,961074.9,2292407.3
352250,201901,2625,1346,1279,1343311.95,1276443.97,2619755.92
352260,201901,1043,559,484,557882.8,483032.4,1040915.2
352265,201901,59,26,33,25948,32934,58882
352270,201901,425,255,170,254490,169661.88,424151.88
352280,201901,423,268,155,267464.63,154690,422154.63
352290,201901,174,107,67,106786,66866,173652
352300,201901,96,73,23,72854,22954,95808
352310,201901,5876,2823,3053,2821351.97,3053884.29,5875236.26
352320,201901,959,504,455,503990.4,457084,961074.4
352330,201901,521,254,267,253492,267464.4,520956.4
352340,201901,1384,674,710,672652.8,709579.6,1382232.4
352350,201901,334,206,128,205588,127744.4,333332.4
352360,201901,227,96,131,95808,130738.2,226546.2
352370,201901,102,67,35,66866,34930,101796
352380,201901,119,72,47,71856,46906,118762
352390,201901,2466,1109,1357,1106783.2,1354288.18,2461071.38
352400,201901,485,209,276,208582,275448.4,484030.4
352410,201901,812,580,232,578841.26,232534,811375.26
352420,201901,108,71,37,70858,36926,107784
352430,201901,1791,811,980,813373.26,979040.21,1792413.47
352440,201901,3161,1607,1554,1605782.94,1553890.72,3159673.66
352450,201901,200,166,34,165668,33932,199600
352460,201901,597,303,294,302394.99,293412,595806.99
352470,201901,643,226,417,225548,416166.98,641714.98
352480,201901,1363,767,596,765466,594808.4,1360274.4
352490,201901,67,25,42,24950,41916,66866
352500,201901,1207,540,667,540916.34,666665.38,1207581.72
352510,201901,751,409,342,408182.66,341316,749498.66
352520,201901,597,269,328,268462,328342,596804
352530,201901,1707,905,802,903190,803390.4,1706580.4
352540,201901,73,49,24,49900,23952,73852
352550,201901,185,106,79,105788,78842,184630
352560,201901,50,40,10,39920,9980,49900
352570,201901,688,352,336,351297.03,336326,687623.03
352580,201901,58,40,18,39920,17964,57884
352585,201901,17,7,10,6986,9980,16966
352590,201901,4429,2258,2171,2254482,2167657.78,4422139.78
352600,201901,351,245,106,245508.63,105788,351296.63
352610,201901,972,437,535,436126.97,533930.53,970057.50
352620,201901,981,403,578,403192,576844,980036
352630,201901,169,63,106,62874,105788,168662
352640,201901,560,387,173,386226,172654,558880
352650,201901,89,59,30,58882,29940,88822
352660,201901,79,47,32,46906,31936,78842
352670,201901,1660,904,756,902193.59,757492.89,1659686.48
352680,201901,906,581,325,579839.83,325348.6,905188.43
352690,201901,4449,2052,2397,2047899.15,2393204.63,4441103.78
352700,201901,116,72,44,72854,43912,116766
352710,201901,1362,738,624,736524,623750.99,1360274.99
352720,201901,1342,643,699,641714,698600.4,1340314.4
352725,201901,24,22,2,21956,1996,23952
352730,201901,381,192,189,192614,188622,381236
352740,201901,426,274,152,273452.56,151696.68,425149.24
352750,201901,22,14,8,13972,7984,21956
352760,201901,191,130,61,129740,60878,190618
352770,201901,82,65,17,64870,16966,81836
352780,201901,77,42,35,41916,34930,76846
352790,201901,30,24,6,23952.03,5988,29940.03
352800,201901,248,173,75,173652,74850,248502
352810,201901,167,108,59,107785.26,58882,166667.26
352820,201901,62,49,13,48902,12974,61876
352830,201901,89,63,26,62874,25948,88822
352840,201901,652,343,309,342314.5,308382,650696.5
352850,201901,1389,484,905,483032,904188,1387220
352860,201901,135,88,47,87824,46906,134730
352870,201901,46,28,18,27944,17964,45908
352880,201901,187,125,62,124750,61876,186626
352885,201901,29,22,7,21956,6986,28942
352890,201901,57,40,17,39920,16966.4,56886.4
352900,201901,4810,2334,2476,2330337.45,2478042.81,4808380.26
352910,201901,39,32,7,31936,6986,38922
352920,201901,689,423,266,422154,266466,688620
352930,201901,1230,596,634,595817.76,635771.98,1231589.74
352940,201901,6494,2745,3749,2743506.01,3745502.47,6489008.48
352950,201901,95,38,57,38922,56886,95808
352960,201901,61,41,20,40918,19960,60878
352965,201901,18,8,10,7984,9980,17964
352970,201901,488,369,119,368262.02,119760.63,488022.65
352980,201901,171,91,80,90818,79840,170658
352990,201901,975,435,540,435128,539919.16,975047.16
353000,201901,65,29,36,28942,35928,64870
353010,201901,554,344,210,344310,211576,555886
353020,201901,286,210,76,209580,75848,285428
353030,201901,1260,572,688,571854.98,686624.98,1258479.96
353040,201901,93,58,35,57884,34930,92814
353050,201901,1337,856,481,854289.42,480038,1334327.42
353060,201901,8465,3769,4696,3766460.86,4691609.62,8458070.48
353070,201901,1683,1076,607,1074848.96,605608.35,1680457.31
353080,201901,1320,703,617,702593.16,616764,1319357.16
353090,201901,58,33,25,32934,24950,57884
353100,201901,60,50,10,49900,9980,59880
353110,201901,2056,643,1413,642712.4,1415165.59,2057877.99
353120,201901,88,49,39,49900,38922,88822
353130,201901,867,424,443,423154.36,443114.94,866269.30
353140,201901,575,232,343,231536,342314,573850
353150,201901,360,202,158,201596,157684,359280
353160,201901,97,79,18,78842,17964,96806
353170,201901,192,63,129,62874,128743.96,191617.96
353180,201901,973,456,517,455088.4,515966.7,971055.1
353190,201901,494,358,136,357284.3,137724.4,495008.7
353200,201901,210,112,98,111776,97804,209580
353205,201901,25,19,6,18962,5988,24950
353210,201901,85,51,34,50898,33932,84830
353215,201901,54,31,23,30938,22954,53892
353220,201901,82,47,35,46906,34930,81836
353230,201901,157,64,93,63872,92814,156686
353240,201901,303,166,137,165668,136726,302394
353250,201901,199,104,95,103792,94810,198602
353260,201901,462,331,131,330339.1,131736,462075.1
353270,201901,65,49,16,48902,15968,64870
353280,201901,97,53,44,52894.6,43912,96806.6
353282,201901,128,91,37,90818,36926,127744
353284,201901,25,20,5,19960,4990,24950
353286,201901,0,0,0,0,0,0
353290,201901,77,43,34,42914,33932,76846
353300,201901,418,231,187,230540.69,186626,417166.69
353310,201901,49,43,6,42914,5988,48902
353320,201901,61,38,23,37924,23952,61876
353325,201901,56,33,23,32934,22955.36,55889.36
353330,201901,67,49,18,48902.7,17964,66866.7
353340,201901,621,211,410,210578,410179.39,620757.39
353350,201901,921,431,490,431138.6,489022.76,920161.36
353360,201901,105,85,20,84830,19960.4,104790.4
353370,201901,122,68,54,68862,53892,122754
353380,201901,29,20,9,19960.99,8982,28942.99
353390,201901,1109,528,581,526944,579838,1106782
353400,201901,47,30,17,29940,16966,46906
353410,201901,114,71,43,70858,42914.9,113772.9
353420,201901,59,24,35,23952,34930,58882
353430,201901,573,385,188,384231.38,187624,571855.38
353440,201901,10527,4630,5897,4622742,5892204.42,10514946.42
353450,201901,56,32,24,31936,23952,55888
353460,201901,593,327,266,326346.1,266466,592812.1
353470,201901,2141,1158,983,1156686.19,982035.96,2138722.15
353475,201901,234,153,81,153693.38,80838,234531.38
353480,201901,187,154,33,153692,32934,186626
353490,201901,237,140,97,139720,96806,236526
353500,201901,189,109,80,108782.63,80838,189620.63
353510,201901,99,72,27,71856.98,26946,98802.98
353520,201901,200,136,64,135728,63872,199600
353530,201901,472,250,222,250498,222554,473052
353540,201901,369,248,121,247504.4,120758,368262.4
353550,201901,746,491,255,490019.24,254490,744509.24
353560,201901,628,265,363,265468,364270.98,629738.98
353570,201901,62,32,30,31936.4,29940,61876.4
353580,201901,357,272,85,271456.74,84830,356286.74
353590,201901,87,59,28,58882,27944,86826
353600,201901,273,155,118,154690.63,117764,272454.63
353610,201901,118,62,56,61876,55888,117764
353620,201901,598,313,285,312374,284430,596804
353625,201901,52,31,21,30938,20958,51896
353630,201901,240,173,67,172654.58,67864,240518.58
353640,201901,127,87,40,86826,39920,126746
353650,201901,896,355,541,354290,539918,894208
353657,201901,26,20,6,19960,5988,25948
353660,201901,258,142,116,141716,115768,257484
353670,201901,779,472,307,471056.4,306386,777442.4
353680,201901,107,75,32,74850.5,31936,106786.5
353690,201901,46,37,9,36926.52,8982,45908.52
353700,201901,272,195,77,194610,76846,271456
353710,201901,465,221,244,220558.6,243512.4,464071.0
353715,201901,48,34,14,33932,13972,47904
353720,201901,352,162,190,161676.98,189620,351296.98
353730,201901,1108,681,427,679639.6,426146,1105785.6
353740,201901,652,356,296,355288,295408,650696
353750,201901,89,56,33,55888,32934,88822
353760,201901,2814,1083,1731,1080836.25,1728538.18,2809374.43
353770,201901,95,78,17,77844,16966,94810
353780,201901,1245,596,649,594808.63,647702,1242510.63
353790,201901,513,301,212,300398.96,211576.4,511975.36
353800,201901,3303,1670,1633,1666663.29,1631801.22,3298464.51
353810,201901,233,135,98,134730.98,97804.98,232535.96
353820,201901,201,98,103,97804,102794,200598
353830,201901,47,40,7,39920,6986,46906
353850,201901,170,87,83,86826,82834,169660
353860,201901,488,220,268,219560,268462,488022
353870,201901,5271,2669,2602,2668658.9,2605781.63,5274440.53
353880,201901,681,485,196,485028.8,195608,680636.8
353890,201901,581,335,246,334330.4,245508.84,579839.24
353900,201901,133,68,65,67864,64870,132734
353910,201901,172,84,88,83832,87824,171656
353920,201901,448,245,203,245508.3,202594.99,448103.29
353930,201901,1015,604,411,603790,410180.14,1013970.14
353940,201901,188,101,87,100798,86826,187624
353950,201901,532,321,211,320358,211576.98,531934.98
353960,201901,71,58,13,57884,12974,70858
353970,201901,72,40,32,39920,31936,71856
353980,201901,1591,770,821,768460,819361.96,1587821.96
353990,201901,74,42,32,41916,31936,73852
354000,201901,366,183,183,183632.6,182634.99,366267.59
354010,201901,91,50,41,49900,40918,90818
354020,201901,539,345,194,344310,194610,538920
354025,201901,49,39,10,38922,9980,48902
354030,201901,63,37,26,36926,25948,62874
354040,201901,95,68,27,67864,26946,94810
354050,201901,194,103,91,102794.4,90818,193612.4
354060,201901,757,368,389,368262,390218.4,758480.4
354070,201901,912,544,368,542913.03,368262,911175.03
354075,201901,222,116,106,115768.4,105788,221556.4
354080,201901,295,126,169,125748,168662,294410
354085,201901,20,13,7,12974,6986,19960
354090,201901,308,170,138,169576,137724,307300
354100,201901,5615,2414,3201,2412168.23,3201586.92,5613755.15
354105,201901,87,43,44,42914,43912,86826
354110,201901,47,20,27,19960,26946,46906
354120,201901,136,95,41,94810.98,40918,135728.98
354130,201901,704,461,243,460078,242515.39,702593.39
354140,201901,3143,1469,1674,1466062.6,1674645.97,3140708.57
354150,201901,640,400,240,400199.76,240518,640717.76
354160,201901,708,449,259,448102,259480.4,707582.4
354165,201901,24,15,9,14970,8982,23952
354170,201901,181,124,57,123752,56886,180638
354180,201901,65,40,25,39920.51,24950,64870.51
354190,201901,203,92,111,92814,112774,205588
354200,201901,123,67,56,66866,55888,122754
354210,201901,64,30,34,29940,33932,63872
354220,201901,641,400,241,399200,240518.4,639718.4
354230,201901,158,65,93,64870,92814,157684
354240,201901,323,211,112,210578.64,111776,322354.64
354250,201901,87,53,34,52894,33932,86826
354260,201901,2018,946,1072,945109.78,1070854.87,2015964.65
354270,201901,96,71,25,70858,24950,95808
354280,201901,43,23,20,22954,19960,42914
354290,201901,136,93,43,92814,42914,135728
354300,201901,425,290,135,289420.63,135728.26,425148.89
354310,201901,99,72,27,71856.4,26946,98802.4
354320,201901,186,98,88,97804,87824.4,185628.4
354323,201901,15,14,1,13972,998,14970
354325,201901,109,64,45,63872,44910,108782
354330,201901,2629,872,1757,874106.8,1755484.81,2629591.61
354340,201901,10615,5229,5386,5221558.03,5382221.68,10603779.71
354350,201901,127,83,44,82834,43912,126746
354360,201901,88,48,40,47904,39920,87824
354370,201901,262,145,117,144710,117764,262474
354380,201901,206,122,84,121756,83832,205588
354390,201901,2763,1004,1759,1004986.99,1757479.97,2762466.96
354400,201901,325,172,153,171656,152695.2,324351.2
354410,201901,613,296,317,295408.4,316366.4,611774.8
354420,201901,279,174,105,174650,104790,279440
354425,201901,316,185,131,184630,130738,315368
354430,201901,182,111,71,110778,70858,181636
354440,201901,34,25,9,24950,8982,33932
354450,201901,48,35,13,34930,12974,47904
354460,201901,102,59,43,58882,42914,101796
354470,201901,42,27,15,26946,14970,41916
354480,201901,115,58,57,57884.98,56886,114770.98
354490,201901,145,89,56,88822,55888,144710
354500,201901,401,197,204,196606,204590,401196
354510,201901,99,72,27,71856,26946,98802
354515,201901,38,14,24,13972,23952,37924
354520,201901,1614,706,908,704446.4,907182.8,1611629.2
354530,201901,689,346,343,345308.99,342314.6,687623.59
354540,201901,279,157,122,156686,121756,278442
354550,201901,43,26,17,25948,16966,42914
354560,201901,161,89,72,88822,71856,160678
354570,201901,136,88,48,87824.5,47904,135728.5
354580,201901,1960,940,1020,938121.89,1019957.39,1958079.28
354600,201901,258,148,110,147704.2,109780,257484.2
354610,201901,72,63,9,62874.46,8982.98,71857.44
354620,201901,62,19,43,18962,42914,61876
354625,201901,18,12,6,11976,5988.99,17964.99
354630,201901,325,218,107,217564.98,106786,324350.98
354640,201901,802,521,281,519958.3,280438,800396.3
354650,201901,76,43,33,42914,32934.98,75848.98
354660,201901,816,608,208,606785.03,207584,814369.03
354670,201901,267,93,174,92814.62,173652.6,266467.22
354680,201901,1280,480,800,479040,800396,1279436
354690,201901,82,53,29,52894.4,28942,81836.4
354700,201901,77,56,21,55888,20958,76846
354710,201901,52,35,17,34930,16966,51896
354720,201901,21,20,1,19960,998,20958
354730,201901,1811,779,1032,777443.78,1031932,1809375.78
354740,201901,62,43,19,42914,18962,61876
354750,201901,432,252,180,251496.98,179640.4,431137.38
354760,201901,502,307,195,306387.8,194610.4,500998.2
354765,201901,10,5,5,4990,4990,9980
354770,201901,343,222,121,221556,122754,344310
354780,201901,8086,3297,4789,3291416.4,4784439.72,8075856.12
354790,201901,110,64,46,63872,45908,109780
354800,201901,443,242,201,241516,200598.4,442114.4
354805,201901,107,53,54,52894,53892,106786
354810,201901,125,73,52,72854,51896,124750
354820,201901,191,81,110,80838.56,109780,190618.56
354830,201901,40,22,18,21956,17964,39920
354840,201901,61,40,21,39920,20958,60878
354850,201901,4605,2097,2508,2094803.67,2509970.4,4604774.07
354860,201901,332,160,172,159680,171656.93,331336.93
354870,201901,12480,5607,6873,5600789.26,6869242.79,12470032.05
354880,201901,3089,1167,1922,1164666.4,1920156.94,3084823.34
354890,201901,2898,1607,1291,1605785.87,1289416,2895201.87
354900,201901,60,39,21,38922,20958,59880
354910,201901,1253,667,586,665666.77,585826,1251492.77
354920,201901,51,42,9,41916,8982,50898
354925,201901,14,8,6,7984,5988,13972
354930,201901,31,28,3,27944.43,2994,30938.43
354940,201901,835,611,224,613022.69,224550,837572.69
354950,201901,210,139,71,138722.6,70858,209580.6
354960,201901,159,62,97,61876,97804.4,159680.4
354970,201901,899,596,303,595806.97,302394.4,898201.37
354980,201901,8514,3140,5374,3137715.29,5368250.87,8505966.16
354990,201901,9020,4290,4730,4281427.89,4721591.96,9003019.85
354995,201901,548,194,354,193612,353292,546904
355000,201901,489,169,320,168662,319360,488022
355010,201901,610,382,228,381236,227545.23,608781.23
355020,201901,733,456,277,455088.32,276447.98,731536.30
355030,201901,209763,81771,127992,81660882.66,127848986.97,209509869.63
355040,201901,743,347,396,346306.9,396206,742512.9
355050,201901,150,100,50,100799.4,49900,150699.4
355060,201901,1606,817,789,815367.2,788420.6,1603787.8
355070,201901,1449,704,745,704589.81,743511.61,1448101.42
355080,201901,204,118,86,117764,85828,203592
355090,201901,289,183,106,182634,105788.32,288422.32
355100,201901,4837,2392,2445,2387122.18,2441110.19,4828232.37
355110,201901,267,174,93,173653.39,92814,266467.39
355120,201901,87,64,23,63872,22954.98,86826.98
355130,201901,58,33,25,32934,24950,57884
355140,201901,185,121,64,120758,63872,184630
355150,201901,692,419,273,418163.39,272454,690617.39
355160,201901,473,229,244,228542.63,244510,473052.63
355170,201901,2080,1095,985,1094806,984028,2078834
355180,201901,645,277,368,276446,367264,643710
355190,201901,222,154,68,153692,67864,221556
355200,201901,117,67,50,67864,49900,117764
355210,201901,701,400,301,399200.4,301396.98,700597.38
355220,201901,6984,3728,3256,3725541.07,3253482.39,6979023.46
355230,201901,106,62,44,61876,43912,105788
355240,201901,4388,1891,2497,1888220.96,2494005,4382225.96
355250,201901,5554,2647,2907,2642705.89,2907179.65,5549885.54
355255,201901,50,31,19,30938,18962,49900
355260,201901,181,107,74,106786.4,73853.96,180640.36
355270,201901,166,103,63,102794,63872,166666
355280,201901,6305,2641,3664,2635720,3662662.76,6298382.76
355290,201901,75,58,17,57884,16966,74850
355300,201901,189,121,68,120758,67864.4,188622.4
355310,201901,109,60,49,59880,48902,108782
355320,201901,89,47,42,46906,41916,88822
355330,201901,286,162,124,161676,123752,285428
355340,201901,1585,529,1056,528940.4,1053888,1582828.4
355350,201901,133,70,63,69860,62874,132734
355360,201901,180,116,64,115768,63872,179640
355365,201901,25,20,5,19960,4990,24950
355370,201901,1033,597,436,595821.56,435139.16,1030960.72
355380,201901,793,521,272,519958,271456,791414
355385,201901,65,47,18,46906,17964,64870
355390,201901,107,64,43,63872,42914,106786
355395,201901,186,110,76,109780.47,75848,185628.47
355400,201901,1605,979,626,978958.13,626744.43,1605702.56
355410,201901,4878,2318,2560,2313369.28,2559877.13,4873246.41
355420,201901,50,36,14,35928,13972,49900
355430,201901,350,211,139,210578,139720,350298
355440,201901,81,48,33,47904,32934,80838
355450,201901,447,220,227,219560.48,226546.4,446106.88
355460,201901,65,50,15,49900.54,14970,64870.54
355465,201901,49,31,18,30938,17964,48902
355470,201901,180,73,107,72854.7,106786,179640.7
355475,201901,15,10,5,9980,4990,14970
355480,201901,467,209,258,208582.6,257484,466066.6
355490,201901,115,81,34,80838,33932,114770
355495,201901,59,30,29,29940,28942,58882
355500,201901,1649,929,720,927145.58,721556.96,1648702.54
355510,201901,271,197,74,196607.26,73852,270459.26
355520,201901,30,22,8,21956.4,7984,29940.4
355530,201901,23,16,7,15968,6986,22954
355535,201901,80,39,41,38922,40918,79840
355540,201901,2372,944,1428,943251.11,1428139.61,2371390.72
355550,201901,63,37,26,36926,25948,62874
355560,201901,244,117,127,116766,126746,243512
355570,201901,28,19,9,18962,8982,27944
355580,201901,260,177,83,177644,82835.39,260479.39
355590,201901,23,15,8,14970,8982,23952
355600,201901,271,139,132,138722,131736.4,270458.4
355610,201901,229,152,77,152694,76846,229540
355620,201901,1331,634,697,634728.4,695606.99,1330335.39
355630,201901,428,315,113,315368,112774.63,428142.63
355635,201901,125,61,64,60878,63873.97,124751.97
355640,201901,569,323,246,322354,246506,568860
355645,201901,836,356,480,355288,480038.4,835326.4
355650,201901,2103,886,1217,886225.74,1217560.98,2103786.72
355660,201901,257,141,116,140718,115768,256486
355670,201901,527,211,316,210578,315368,525946
355680,201901,205,118,87,117764.97,86826,204590.97
355690,201901,88,40,48,39920,47904.67,87824.67
355695,201901,12,10,2,9980,1996,11976
355700,201901,1137,590,547,588820.66,546904.8,1135725.46
355710,201901,2249,1236,1013,1234528.63,1013968,2248496.63
355715,201901,19,16,3,15968,2994,18962
355720,201901,196,117,79,116766.44,78842,195608.44
355730,201901,100,59,41,58882,40918,99800
410010,201901,131,112,19,111776,18962,130738
410020,201901,106,91,15,90818,14970,105788
410030,201901,164,105,59,104790.6,58882,163672.6
410040,201901,1030,558,472,556884,472054.6,1028938.6
410045,201901,31,26,5,25948,4990,30938
410050,201901,469,265,204,264470,203592,468062
410060,201901,270,204,66,203592,66866,270458
410070,201901,310,256,54,255488,53892,309380
410080,201901,166,105,61,104790,60878,165668
410090,201901,78,70,8,69860.56,7984,77844.56
410100,201901,298,214,84,213572,83832,297404
410105,201901,47,28,19,27944,18962,46906
410110,201901,328,198,130,198602,130738,329340
410115,201901,31,21,10,20958,9980,30938
410120,201901,407,215,192,214570,191616,406186
410130,201901,45,30,15,29940,14970,44910
410140,201901,3165,1536,1629,1534926.5,1626742.6,3161669.1
410150,201901,2723,1106,1617,1104786.74,1615762.4,2720549.14
410160,201901,501,316,185,315368,184630,499998
410165,201901,68,45,23,44910,22954,67864
410170,201901,168,122,46,121756,45908,167664
410180,201901,2174,1269,905,1267460.4,903191.59,2170651.99
410185,201901,35,31,4,30938,3992,34930
410190,201901,493,324,169,323352,169660,493012
410200,201901,956,722,234,720556,233532,954088
410210,201901,572,298,274,297404,273452.4,570856.4
410220,201901,42,21,21,20958,20958,41916
410230,201901,131,71,60,70858,59880,130738
410240,201901,745,492,253,492014.4,252494,744508.4
410250,201901,372,275,97,274450,96806,371256
410260,201901,296,171,125,170658,124750,295408
410270,201901,28,18,10,17964,9980,27944
410275,201901,62,46,16,45908,15968,61876
410280,201901,327,190,137,189620,136726,326346
410290,201901,239,151,88,150698,87824,238522
410300,201901,81,63,18,62874,17964,80838
410302,201901,25,16,9,15968,8982,24950
410304,201901,44,30,14,29940,13972,43912
410305,201901,215,119,96,118762,95808,214570
410310,201901,266,170,96,170658,95808,266466
410315,201901,51,37,14,36926.44,13972,50898.44
410320,201901,136,94,42,93812,41916,135728
410322,201901,35,24,11,23952,10978,34930
410330,201901,172,124,48,123752,47904.6,171656.6
410335,201901,100,59,41,58882,40918,99800
410337,201901,40,34,6,33932,5988,39920
410340,201901,32,30,2,29940,1996,31936
410345,201901,223,138,85,137724,84830,222554
410347,201901,51,38,13,37924,12974,50898
410350,201901,233,140,93,139720,92814,232534
410360,201901,471,291,180,290418.8,179641.2,470060.0
410370,201901,2389,1022,1367,1019957.08,1368259.64,2388216.72
410380,201901,225,141,84,140718,83832,224550
410390,201901,371,272,99,271456.99,98802,370258.99
410395,201901,34,23,11,22954,10978,33932
410400,201901,839,425,414,424151.61,412609.44,836761.05
410405,201901,95,72,23,71856,22954,94810
410410,201901,36,28,8,27944,7984,35928
410420,201901,1656,818,838,816277.16,836324.34,1652601.50
410425,201901,171,81,90,80838.6,89820,170658.6
410430,201901,2203,1284,919,1281432.74,918160.96,2199593.70
410440,201901,384,283,101,282434,101796,384230
410442,201901,358,243,115,242514.7,114770,357284.7
410445,201901,415,294,121,293412,120758,414170
410450,201901,397,208,189,207584,188622,396206
410460,201901,460,246,214,245508,214570,460078
410465,201901,203,129,74,128742,73852,202594
410470,201901,230,148,82,147704,82834,230538
410480,201901,5993,2977,3016,2976047.3,3012973.6,5989020.9
410490,201901,1429,923,506,921155.2,504988.4,1426143.6
410500,201901,269,159,110,158682,109780,268462
410510,201901,172,129,43,129740,42914.98,172654.98
410520,201901,254,190,64,189620,63872,253492
410530,201901,230,83,147,82834,146706.99,229540.99
410540,201901,320,230,90,229540.99,89820,319360.99
410550,201901,1670,749,921,749498,919158.7,1668656.7
410560,201901,137,105,32,104790,31936,136726
410570,201901,431,294,137,293413.32,136726,430139.32
410580,201901,3187,1434,1753,1433129.32,1752489,3185618.32
410590,201901,398,282,116,281436,115768,397204
410600,201901,188,162,26,161676,25948,187624
410610,201901,59,50,9,49900,8982,58882
410620,201901,247,178,69,177644,68862,246506
410630,201901,444,261,183,261476,182634,444110
410640,201901,1034,650,384,648701.3,384230.99,1032932.29
410645,201901,104,78,26,77844.6,25948,103792.6
410650,201901,362,247,115,246506,114770,361276
410655,201901,78,59,19,58882,18962,77844
410657,201901,46,19,27,18962,26946,45908
410660,201901,614,435,179,434131.7,178642,612773.7
410670,201901,74,63,11,62874,10978,73852
410680,201901,201,168,33,167664,32934,200598
410685,201901,17,11,6,10978,5988,16966
410690,201901,28131,12237,15894,12219432.73,15868924.45,28088357.18
410700,201901,325,243,82,242514.4,81836,324350.4
410710,201901,130,107,23,106786,22954,129740
410712,201901,21,15,6,14970,5988,20958
410715,201901,90,68,22,67864,21956,89820
410720,201901,624,374,250,373252,249500.98,622752.98
410725,201901,180,134,46,133732,45908,179640
410730,201901,87,52,35,51896,34930,86826
410740,201901,114,84,30,83832,29940,113772
410750,201901,227,162,65,161676,64870,226546
410752,201901,24,15,9,14970,8982,23952
410753,201901,49,21,28,20958,27944,48902
410754,201901,39,24,15,23952.4,14970,38922.4
410755,201901,82,54,28,53892,27944,81836
410760,201901,737,417,320,416166.4,319360,735526.4
410765,201901,1681,817,864,816366.76,864269.2,1680635.96
410770,201901,105,82,23,81836,22954,104790
410773,201901,53,39,14,38922,13972,52894
410775,201901,171,129,42,129740,41916,171656
410780,201901,81,45,36,44910,35928,80838
410785,201901,56,45,11,44910,10978,55888
410790,201901,74,36,38,35928,37924,73852
410800,201901,287,180,107,179640.52,106786,286426.52
410810,201901,23,20,3,19960,2994.4,22954.4
410820,201901,181,132,49,132734,48902,181636
410830,201901,8521,3821,4700,3816358.42,4694602.17,8510960.59
410832,201901,105,76,29,75848,28942,104790
410840,201901,1430,804,626,802394.97,624751.44,1427146.41
410845,201901,66,43,23,42914.4,22954,65868.4
410850,201901,199,143,56,142714,56886,199600
410855,201901,52,45,7,44910,6986,51896
410860,201901,682,395,287,394210.94,287424,681634.94
410865,201901,104,80,24,79840,23952,103792
410870,201901,154,130,24,129740,23952,153692
410880,201901,1127,574,553,572857.34,551898.88,1124756.22
410890,201901,84,59,25,58882,24950,83832
410895,201901,71,55,16,54890,15968,70858
410900,201901,21,13,8,12974,7984,20958
410910,201901,15,13,2,12974,1996,14970
410920,201901,34,23,11,22954,10978,33932
410930,201901,504,322,182,323352,181636,504988
410940,201901,4361,2548,1813,2546898.24,1811370.8,4358269.04
410950,201901,112,84,28,83832,27944,111776
410960,201901,769,348,421,347304,421156,768460
410965,201901,70,54,16,53892,15968,69860
410970,201901,634,456,178,457084,178642,635726
410975,201901,111,66,45,65868.72,44910,110778.72
410980,201901,1622,733,889,731534.4,887222.99,1618757.39
410990,201901,267,186,81,185628,81836,267464
411000,201901,65,40,25,39920,24950.4,64870.4
411005,201901,26,20,6,19960,5988,25948
411007,201901,250,143,107,142714,106786,249500
411010,201901,585,409,176,409180,175648,584828
411020,201901,297,206,91,205588,90818,296406
411030,201901,16,9,7,8982,6986,15968
411040,201901,53,38,15,37924,14970,52894
411050,201901,219,169,50,169678.48,49904.4,219582.88
411060,201901,516,349,167,348302.98,166666,514968.98
411065,201901,66,57,9,57884,8982,66866
411070,201901,1217,793,424,793411.54,423152,1216563.54
411080,201901,230,161,69,161676,68862,230538
411090,201901,107,79,28,78842,27944,106786
411095,201901,285,116,169,115768,168662,284430
411100,201901,114,95,19,94810,18962,113772
411110,201901,122,85,37,84830,36926,121756
411120,201901,195,141,54,141716,53892,195608
411125,201901,199,91,108,90818,107784,198602
411130,201901,124,106,18,105788,17964,123752
411140,201901,195,131,64,130738,63872,194610
411150,201901,1235,822,413,821354,412175.03,1233529.03
411155,201901,124,83,41,82834,40918,123752
411160,201901,25,12,13,11976,12974,24950
411170,201901,53,48,5,47904,4990,52894
411180,201901,970,650,320,648700.83,319360,968060.83
411190,201901,341,195,146,194610,145708,340318
411200,201901,677,442,235,441116.63,235528,676644.63
411210,201901,701,378,323,377244,322354.98,699598.98
411220,201901,149,111,38,110778,37924,148702
411230,201901,43,36,7,35928,6986,42914
411240,201901,126,86,40,85828,39920,125748
411250,201901,435,322,113,322354,112774,435128
411260,201901,20,13,7,12974,6986,19960
411270,201901,293,159,134,158682,133732,292414
411275,201901,202,178,24,177644.7,23952,201596.7
411280,201901,223,158,65,157684.63,64870,222554.63
411290,201901,57,42,15,41916,14970,56886
411295,201901,151,119,32,118762,31936,150698
411300,201901,69,36,33,35928,32934,68862
411310,201901,90,69,21,68862,20958,89820
411320,201901,744,531,213,530936.8,212574,743510.8
411325,201901,60,37,23,36926,22954,59880
411330,201901,919,596,323,594808.5,323352.16,918160.66
411340,201901,25,17,8,16966,7984.34,24950.34
411342,201901,70,53,17,52894,16966,69860
411345,201901,121,62,59,61876,58882,120758
411350,201901,497,394,103,393212.58,102794.4,496006.98
411360,201901,55,35,20,34930,19960,54890
411370,201901,14369,5874,8495,5863255.4,8489007.6,14352263.0
411373,201901,183,135,48,134730,47904,182634
411375,201901,71,59,12,58882,11976,70858
411380,201901,95,73,22,72854,21956,94810
411390,201901,134,89,45,88822,44910,133732
411400,201901,367,278,89,277444.98,88822,366266.98
411410,201901,441,228,213,227544,212574.4,440118.4
411420,201901,1047,475,572,474050,572852,1046902
411430,201901,418,264,154,264470,154690.98,419160.98
411435,201901,35,25,10,24950,9980,34930
411440,201901,474,382,92,381236,91816,473052
411450,201901,428,360,68,359280,67864,427144
411460,201901,765,306,459,305394.23,458092.44,763486.67
411470,201901,82,60,22,59880,21956,81836
411480,201901,659,378,281,377244,280438,657682
411490,201901,303,195,108,194610,107784,302394
411500,201901,108,92,16,91816,15968,107784
411510,201901,220,179,41,178642,40918,219560
411520,201901,6020,2346,3674,2343306.79,3669650.73,6012957.52
411530,201901,115,80,35,79840,34930,114770
411535,201901,50,22,28,21956,27944,49900
411540,201901,360,249,111,248502,110778,359280
411545,201901,55,39,16,38922,15968,54890
411550,201901,79,61,18,60878,17964,78842
411560,201901,387,177,210,176646.44,209580,386226.44
411570,201901,785,302,483,301397.66,482034.6,783432.26
411573,201901,30,18,12,17964,11976,29940
411575,201901,282,177,105,176646,104790,281436
411580,201901,1254,500,754,499000.6,753490,1252490.6
411585,201901,75,37,38,36926,37924,74850
411590,201901,23,16,7,15968,6986,22954
411600,201901,26,12,14,11976,13972,25948
411605,201901,242,103,139,103792,138722,242514
411610,201901,243,164,79,163672,78842,242514
411620,201901,343,201,142,200598,141716,342314
411630,201901,56,40,16,39920,15968,55888
411640,201901,35,29,6,28942,5988,34930
411650,201901,13,8,5,7984,4990,12974
411660,201901,35,27,8,26946,7984,34930
411670,201901,247,185,62,184630,61876,246506
411680,201901,157,136,21,136726,20958,157684
411690,201901,588,313,275,312386.32,274454.4,586840.72
411695,201901,63,46,17,45908,16966,62874
411700,201901,156,134,22,133732,21956,155688
411705,201901,104,68,36,67864,35928,103792
411710,201901,306,204,102,203592,101796,305388
411720,201901,138,91,47,90818,46906,137724
411721,201901,60,51,9,50898,8982,59880
411722,201901,100,43,57,42914,56886,99800
411725,201901,151,117,34,116766.4,34930,151696.4
411727,201901,77,62,15,61876,14970,76846
411729,201901,35,27,8,26946,7984,34930
411730,201901,534,344,190,344310,189620,533930
411740,201901,41,25,16,24950,15968,40918
411745,201901,71,47,24,46906,23952,70858
411750,201901,881,410,471,409180.4,470058.4,879238.8
411760,201901,1209,916,293,914168.4,292414.98,1206583.38
411770,201901,447,296,151,295408,150698,446106
411780,201901,333,215,118,214570,117764,332334
411790,201901,530,302,228,301399.23,227545.96,528945.19
411800,201901,170,135,35,134730,34930,169660
411810,201901,163,124,39,123752,38922,162674
411820,201901,2122,1013,1109,1010975,1106783.58,2117758.58
411830,201901,12,12,0,11976,,11976.0
411840,201901,1940,1205,735,1203588,735527.53,1939115.53
411845,201901,51,21,30,20958,29940,50898
411850,201901,1224,695,529,693610.99,527945,1221555.99
411860,201901,47,33,14,32934,14970,47904
411870,201901,76,54,22,53892,21956,75848
411880,201901,424,273,151,272454.25,150698,423152.25
411885,201901,107,70,37,69860,36926,106786
411890,201901,320,203,117,202595.39,116766,319361.39
411900,201901,70,51,19,50898,18962,69860
411910,201901,184,144,40,143712,39920,183632
411915,201901,2096,909,1187,908180,1188620.22,2096800.22
411920,201901,124,102,22,101796,21956,123752
411925,201901,10,7,3,6986,2994,9980
411930,201901,802,590,212,588820.74,211576,800396.74
411940,201901,595,415,180,414170,180638,594808
411950,201901,902,479,423,478042,424150,902192
411960,201901,1053,725,328,723551.3,328342,1051893.3
411965,201901,26,18,8,17964,7984,25948
411970,201901,80,73,7,72854,6986,79840
411980,201901,171,119,52,118762,51896,170658
411990,201901,5175,3009,2166,3005981.7,2163666.01,5169647.71
411995,201901,454,170,284,169660,284430,454090
412000,201901,312,194,118,193612,117764,311376
412010,201901,53,31,22,30938,21956,52894
412015,201901,46,33,13,32934,12974,45908
412020,201901,27,23,4,22954,3992,26946
412030,201901,58,50,8,49900,7984,57884
412033,201901,56,37,19,36926.44,18962,55888.44
412035,201901,69,45,24,44910,23952,68862
412040,201901,35,23,12,22954.4,12974,35928.4
412050,201901,199,148,51,147704,50898,198602
412060,201901,765,587,178,586824.74,177644,764468.74
412065,201901,50,34,16,33932,15968,49900
412070,201901,158,106,52,105788,51896,157684
412080,201901,283,152,131,151696,130738,282434
412085,201901,34,16,18,15968,17964,33932
412090,201901,776,492,284,491016.9,283432,774448.9
412100,201901,243,205,38,204590.4,38922,243512.4
412110,201901,66,52,14,51896,13972,65868
412120,201901,313,203,110,202594,109780,312374
412125,201901,82,48,34,47904,33932,81836
412130,201901,40,29,11,28942.36,10978,39920.36
412135,201901,27,16,11,15968,10978,26946
412140,201901,321,229,92,228542,91816,320358
412150,201901,245,172,73,171656.48,73852,245508.48
412160,201901,86,52,34,51896,33932,85828
412170,201901,679,477,202,476046,201596,677642
412175,201901,36,27,9,26946,8982,35928
412180,201901,200,158,42,157684.6,41916,199600.6
412190,201901,332,263,69,263472,68862,332334
412200,201901,200,123,77,122754,76846,199600
412210,201901,76,59,17,58882,16966,75848
412215,201901,230,162,68,161676,67864,229540
412217,201901,74,58,16,57884,15968,73852
412220,201901,820,614,206,612772,206586,819358
412230,201901,337,202,135,201596,134732.94,336328.94
412240,201901,1341,661,680,659699.56,680652.68,1340352.24
412250,201901,377,241,136,240518,136726,377244
412260,201901,106,78,28,77844,27944,105788
412265,201901,177,139,38,138722,37924,176646
412270,201901,77,50,27,49900,26946,76846
412280,201901,90,73,17,72854,16966,89820
412290,201901,98,66,32,65868,31936,97804
412300,201901,215,139,76,138722,76846,215568
412310,201901,46,40,6,39920,5988,45908
412320,201901,93,80,13,79840,13972,93812
412330,201901,180,157,23,156686,22954,179640
412340,201901,154,108,46,107784,45908.4,153692.4
412350,201901,602,305,297,305388,296406,601794
412360,201901,29,25,4,24950,3992,28942
412370,201901,164,143,21,142714.2,20958,163672.2
412380,201901,261,194,67,193612,66867.78,260479.78
412382,201901,53,28,25,27944,24950,52894
412385,201901,145,107,38,106786,37924,144710
412390,201901,288,219,69,218562,68862,287424
412395,201901,73,59,14,58882,13972,72854
412400,201901,74,51,23,50898,22954,73852
412402,201901,249,123,126,122754,125748,248502
412405,201901,831,321,510,320358,509978.94,830336.94
412410,201901,962,599,363,597802.4,362274,960076.4
412420,201901,14,12,2,11976,1996,13972
412430,201901,21,15,6,14970,5988,20958
412440,201901,607,334,273,333347.4,272462.76,605810.16
412450,201901,82,70,12,70858,11976,82834
412460,201901,82,61,21,60878,20958,81836
412470,201901,227,181,46,180638,45908,226546
412480,201901,162,120,42,119760.3,41916,161676.3
412490,201901,159,138,21,137724,20958,158682
412500,201901,451,370,81,370258.85,80838,451096.85
412510,201901,188,156,32,155688.4,31936,187624.4
412520,201901,141,76,65,75848,64870,140718
412530,201901,108,56,52,55888,51896,107784
412535,201901,112,82,30,81837.96,29940,111777.96
412540,201901,74,36,38,35928,37924,73852
412545,201901,96,71,25,70858,24950,95808
412550,201901,3569,1629,1940,1625742,1936121.2,3561863.2
412555,201901,14,10,4,9980,3992,13972
412560,201901,592,437,155,437124,154690,591814
412570,201901,743,411,332,410178,331336,741514
412575,201901,88,62,26,61876,25948,87824
412580,201901,166,110,56,109780,55888,165668
412590,201901,34,31,3,30938,2994,33932
412600,201901,171,129,42,128742,41916,170658
412610,201901,32,20,12,19960,11976,31936
412620,201901,150,129,21,128742,20958,149700
412625,201901,2211,1174,1037,1171653.03,1035926.39,2207579.42
412627,201901,70,56,14,55888,13972,69860
412630,201901,417,278,139,277444.47,138722,416166.47
412635,201901,65,19,46,18962,45908,64870
412640,201901,119,78,41,77844,40918,118762
412650,201901,349,222,127,221556,126746,348302
412660,201901,473,293,180,292414,179640,472054
412665,201901,51,45,6,44910,5988,50898
412667,201901,294,204,90,203597.28,89822.2,293419.48
412670,201901,61,51,10,50898,9980,60878
412680,201901,299,239,60,238522,59880,298402
412690,201901,101,64,37,63872,36926.4,100798.4
412700,201901,153,104,49,103792,48902.4,152694.4
412710,201901,1388,856,532,855288.2,531934,1387222.2
412720,201901,235,157,78,157684,77844,235528
412730,201901,188,155,33,154956.13,32934,187890.13
412740,201901,427,238,189,237524,188622,426146
412750,201901,462,269,193,270458,192614,463072
412760,201901,267,139,128,138722,127744,266466
412770,201901,2128,1202,926,1200595.23,926145.78,2126741.01
412780,201901,155,122,33,121756,32934,154690
412785,201901,259,130,129,129740,128742,258482
412788,201901,37,22,15,21956,14970,36926
412790,201901,131,108,23,107784,22954,130738
412795,201901,155,116,39,115768,38922,154690
412796,201901,311,216,95,215568,94810,310378
412800,201901,579,375,204,374250,203592,577842
412810,201901,2978,1638,1340,1637721.27,1339316,2977037.27
412820,201901,940,605,335,603790.5,334330.98,938121.48
412830,201901,14,11,3,10978,2994,13972
412840,201901,224,159,65,158682.4,64870,223552.4
412850,201901,775,523,252,521954,252494,774448
412853,201901,174,90,84,89820,83832.4,173652.4
412855,201901,220,119,101,119760.26,100798,220558.26
412860,201901,97,69,28,68862,27944,96806
412862,201901,59,44,15,43912,14970,58882
412863,201901,6,5,1,4990,998,5988
412865,201901,40,30,10,29940,9980,39920
412870,201901,109,71,38,70858,37924,108782
412880,201901,100,73,27,72854.4,26946,99800.4
420005,201901,43,38,5,37924,4990,42914
420010,201901,375,248,127,247504.7,126746.4,374251.1
420020,201901,86,72,14,71856,13972,85828
420030,201901,29,27,2,26946,1996,28942
420040,201901,111,86,25,85828,24950,110778
420050,201901,52,32,20,31936,19960,51896
420055,201901,19,18,1,17964,998,18962
420060,201901,32,24,8,23952,7984,31936
420070,201901,110,93,17,92814,16966,109780
420075,201901,11,10,1,9980,998,10978
420080,201901,47,42,5,41916,4990,46906
420090,201901,34,32,2,31936,1996,33932
420100,201901,165,140,25,140718.4,24950,165668.4
420110,201901,20,20,0,19960,,19960.0
420120,201901,55,43,12,42914,11976,54890
420125,201901,87,70,17,69860,16966,86826
420127,201901,33,29,4,28942,3992,32934
420130,201901,397,249,148,248502,148702,397204
420140,201901,1311,749,562,749500.68,560877.86,1310378.54
420150,201901,45,40,5,39920,4990,44910
420160,201901,36,34,2,33932,1996,35928
420165,201901,19,14,5,13972,4990,18962
420170,201901,73,46,27,45908,26946,72854
420180,201901,22,21,1,20958,998,21956
420190,201901,31,27,4,27944,3992,31936
420195,201901,128,62,66,61876,65868,127744
420200,201901,1271,569,702,567864.6,700601.84,1268466.44
420205,201901,67,40,27,39920,26946,66866
420207,201901,111,62,49,61876.5,48902,110778.5
420208,201901,21,17,4,16966,3992,20958
420209,201901,20,16,4,15968,3992,19960
420210,201901,460,227,233,226546,233532.98,460078.98
420213,201901,46,37,9,36926,8982,45908
420215,201901,28,24,4,23952,3992,27944
420220,201901,67,44,23,43912,22954,66866
420230,201901,806,458,348,458082,347304.98,805386.98
420240,201901,2278,1523,755,1522951.14,754488,2277439.14
420243,201901,41,33,8,32934,7984,40918
420245,201901,129,66,63,65868,62874,128742
420250,201901,59,36,23,35928,22954,58882
420253,201901,43,34,9,33932,8982,42914
420257,201901,13,11,2,10978,1996,12974
420260,201901,105,91,14,90818,13972,104790
420270,201901,40,32,8,31936.99,7984,39920.99
420280,201901,278,209,69,208587.6,68864.66,277452.26
420285,201901,20,11,9,10978,8982,19960
420287,201901,56,36,20,35928,19960,55888
420290,201901,963,678,285,678640,284433.96,963073.96
420300,201901,1403,1121,282,1119758.54,281436.98,1401195.52
420310,201901,57,44,13,43912,12974,56886
420315,201901,32,28,4,27944,3992,31936
420320,201901,858,439,419,438122,418162.99,856284.99
420325,201901,0,0,0,0,0,0
420330,201901,127,87,40,86826,39920,126746
420340,201901,163,109,54,108783.18,53892,162675.18
420350,201901,258,191,67,190618,66866,257484
420360,201901,764,578,186,578840.98,185630.46,764471.44
420370,201901,118,73,45,72854,44910.4,117764.4
420380,201901,1145,815,330,813372.08,329344.9,1142716.98
420390,201901,260,177,83,176646,83832,260478
420395,201901,184,132,52,131736,51896,183632
420400,201901,249,189,60,188623.15,59880,248503.15
420410,201901,62,47,15,46906,14970,61876
420415,201901,34,31,3,30938,2994,33932
420417,201901,55,41,14,40918,13972,54890
420419,201901,12,12,0,11976,,11976.0
420420,201901,2829,1748,1081,1744509.95,1079839.74,2824349.69
420425,201901,75,62,13,61876.98,12974.98,74851.96
420430,201901,1271,892,379,890217.64,379240,1269457.64
420435,201901,17,15,2,14970,1996,16966
420440,201901,105,73,32,72855.28,31936,104791.28
420445,201901,23,21,2,20958,1996,22954
420450,201901,72,37,35,36926,34930,71856
420455,201901,222,169,53,168664.94,52896.94,221561.88
420460,201901,2354,1552,802,1548903.7,800404.82,2349308.52
420470,201901,117,87,30,86826,29940,116766
420475,201901,6,6,0,5988,,5988.0
420480,201901,872,657,215,655687.2,216566.8,872254.0
420490,201901,113,85,28,84830,27944,112774
420500,201901,631,286,345,286426.86,344310,630736.86
420510,201901,18,15,3,14970,2994,17964
420515,201901,26,20,6,20958,5988,26946
420517,201901,10,10,0,9980,,9980.0
420519,201901,0,0,0,0,0,0
420520,201901,74,55,19,54890,18962,73852
420530,201901,163,109,54,109780.3,53892,163672.3
420535,201901,20,19,1,18962,998,19960
420540,201901,5118,3027,2091,3026193.62,2087817.56,5114011.18
420543,201901,27,27,0,26946,,26946.0
420545,201901,201,143,58,142714,57884,200598
420550,201901,876,709,167,707584.16,166669.92,874254.08
420555,201901,39,28,11,27944,10978,38922
420560,201901,69,56,13,55888,12974,68862
420570,201901,158,95,63,94810,62874,157684
420580,201901,296,133,163,132734,162674.4,295408.4
420590,201901,511,359,152,360278,151696,511974
420600,201901,106,59,47,58882.4,46906,105788.4
420610,201901,41,38,3,37924,2994,40918
420620,201901,75,62,13,61876,12974,74850
420630,201901,161,118,43,117764.99,42915.98,160680.97
420640,201901,90,81,9,80838,8982,89820
420650,201901,232,121,111,120758,110778,231536
420660,201901,56,44,12,43912,11976,55888
420665,201901,37,27,10,26946,9980,36926
420670,201901,322,246,76,245508,76846.98,322354.98
420675,201901,16,15,1,14970,998,15968
420680,201901,37,27,10,26946,9980,36926
420690,201901,177,149,28,148702,27944,176646
420700,201901,681,476,205,476052.32,205595.84,681648.16
420710,201901,156,90,66,89820,65868,155688
420720,201901,112,91,21,90818,20958,111776
420730,201901,580,379,201,378246.26,201600.32,579846.58
420740,201901,47,46,1,45908,998,46906
420750,201901,512,345,167,344310,166666,510976
420757,201901,19,16,3,15968,2994,18962
420760,201901,36,30,6,29940,5988,35928
420765,201901,71,57,14,56886,13972,70858
420768,201901,65,57,8,56886,7984,64870
420770,201901,82,69,13,68862,12974,81836
420775,201901,45,41,4,40918,3992,44910
420780,201901,246,195,51,194610,50898,245508
420785,201901,12,9,3,8982,2994,11976
420790,201901,175,148,27,148706.9,26947.96,175654.86
420800,201901,70,53,17,52894,16966,69860
420810,201901,250,220,30,219560.98,29940,249500.98
420820,201901,2341,1374,967,1373249.6,965068.77,2338318.37
420830,201901,611,341,270,340319.2,269460.6,609779.8
420840,201901,152,114,38,113772,37924,151696
420845,201901,437,193,244,192614,243512.4,436126.4
420850,201901,242,194,48,193612,47904,241516
420860,201901,64,54,10,53892,9980,63872
420870,201901,122,89,33,88822,32934,121756
420880,201901,178,123,55,122754,54890,177644
420890,201901,899,450,449,449101.77,448102.98,897204.75
420895,201901,9,9,0,8982,,8982.0
420900,201901,419,331,88,330338.4,87824.98,418163.38
420910,201901,5839,3291,2548,3286422.73,2543907.34,5830330.07
420915,201901,77,72,5,71856,4990,76846
420917,201901,20,15,5,14970,4990,19960
420920,201901,23,16,7,15968,6986,22954
420930,201901,2799,1735,1064,1733520.36,1063045.2,2796565.56
420940,201901,611,446,165,445108.4,164674.49,609782.89
420945,201901,10,8,2,7984,1996,9980
420950,201901,56,51,5,50898,4990,55888
420960,201901,117,94,23,93813.96,22954.98,116768.94
420970,201901,301,241,60,240521.54,59881.96,300403.50
420980,201901,22,22,0,21956,,21956.0
420985,201901,64,57,7,56886,6986,63872
420990,201901,75,59,16,58882,15968,74850
421000,201901,31,20,11,19960,10978,30938
421003,201901,69,48,21,47904,20958.98,68862.98
421005,201901,7,4,3,3992,2994,6986
421010,201901,760,535,225,533931.38,224552.08,758483.46
421020,201901,27,22,5,22954,4990,27944
421030,201901,128,108,20,107784.3,19960,127744.3
421040,201901,72,59,13,58882,12974,71856
421050,201901,323,228,95,227544.4,94810,322354.4
421055,201901,25,21,4,20958,3992,24950
421060,201901,80,54,26,53892,26946,80838
421070,201901,48,44,4,43912.4,3992,47904.4
421080,201901,34,32,2,31936,1996,33932
421085,201901,24,19,5,18962,4990,23952
421090,201901,41,30,11,29940,10978,40918
421100,201901,131,96,35,95808,34930,130738
421105,201901,218,177,41,176646,40918.98,217564.98
421110,201901,114,92,22,91816,21956,113772
421120,201901,161,124,37,123752.98,36926,160678.98
421125,201901,17,12,5,11976,4990,16966
421130,201901,795,520,275,518960.98,274450.4,793411.38
421140,201901,30,22,8,21956,7984,29940
421145,201901,41,33,8,32934,7984,40918
421150,201901,108,78,30,77844,29940,107784
421160,201901,69,45,24,44910,23952,68862
421165,201901,16,15,1,14970,998,15968
421170,201901,195,166,29,165792.32,28942.98,194735.30
421175,201901,155,103,52,102794,51896.96,154690.96
421180,201901,61,40,21,39920.24,20958,60878.24
421185,201901,17,14,3,13972,2994,16966
421187,201901,0,0,0,0,0,0
421189,201901,40,30,10,29940,9980,39920
421190,201901,1615,1022,593,1023948.6,591814.8,1615763.4
421200,201901,89,67,22,66866,21956,88822
421205,201901,27,17,10,16966,9980,26946
421210,201901,171,121,50,120758,49900,170658
421220,201901,286,225,61,224550,60878,285428
421223,201901,52,44,8,43912.6,7984,51896.6
421225,201901,68,43,25,42914.6,24950,67864.6
421227,201901,98,74,24,73852,23952,97804
421230,201901,52,39,13,38922,12974,51896
421240,201901,19,19,0,18962,,18962.0
421250,201901,360,226,134,225549,133732,359281
421260,201901,25,21,4,20958,3992,24950
421265,201901,1,1,0,998,,998.0
421270,201901,52,46,6,45908,5988,51896
421280,201901,346,202,144,201596,144710,346306
421290,201901,325,220,105,220558.5,104790.98,325349.48
421300,201901,27,22,5,21956,4990,26946
421310,201901,52,39,13,38922,12974,51896
421315,201901,28,18,10,17964,9980,27944
421320,201901,135,94,41,93812,40918,134730
421330,201901,103,78,25,77844,24950.98,102794.98
421335,201901,39,27,12,26946,11976,38922
421340,201901,293,203,90,202594.54,89820,292414.54
421350,201901,196,114,82,114770.97,81836,196606.97
421360,201901,675,499,176,498003.88,175648.98,673652.86
421370,201901,194,151,43,150698,42914,193612
421380,201901,134,107,27,106786,26946,133732
421390,201901,17,12,5,11976,4990,16966
421400,201901,119,102,17,101796,16966,118762
421410,201901,21,19,2,18962,1996,20958
421415,201901,21,20,1,19960,998,20958
421420,201901,152,126,26,125748,25948,151696
421430,201901,15,11,4,10978,3992,14970
421440,201901,59,47,12,46906,11976,58882
421450,201901,92,78,14,77844,13972,91816
421460,201901,58,48,10,47904,9980,57884
421470,201901,68,45,23,44910,22954,67864
421480,201901,644,485,159,485028,158682.98,643710.98
421490,201901,22,21,1,20958.98,998,21956.98
421500,201901,511,333,178,332337.34,177660.58,509997.92
421505,201901,25,18,7,17964,6986,24950
421507,201901,35,29,6,28942,5988,34930
421510,201901,76,50,26,49900,25948,75848
421520,201901,63,54,9,53892,8982,62874
421530,201901,53,47,6,46906,5988,52894
421535,201901,27,26,1,25948.44,998,26946.44
421540,201901,57,49,8,48902,7984,56886
421545,201901,100,76,24,75848.98,23952,99800.98
421550,201901,297,218,79,217564,78842,296406
421555,201901,26,20,6,19960,5988.8,25948.8
421560,201901,8,7,1,6986,998,7984
421565,201901,125,88,37,87824,36926,124750
421567,201901,30,26,4,25948,3992,29940
421568,201901,32,30,2,30938,1996,32934
421569,201901,8,8,0,7984,,7984.0
421570,201901,174,117,57,116766,56886,173652
421575,201901,29,24,5,23952,4990,28942
421580,201901,711,430,281,431136,280438,711574
421590,201901,22,21,1,20958,998,21956
421600,201901,129,80,49,79840,48902.8,128742.8
421605,201901,111,79,32,78842.3,31936,110778.3
421610,201901,185,147,38,146706.4,37924,184630.4
421620,201901,1087,641,446,640717.38,445108,1085825.38
421625,201901,24,21,3,20958,2994,23952
421630,201901,293,184,109,183632.9,108783.2,292416.1
421635,201901,17,7,10,6986,9980,16966
421640,201901,99,85,14,84830.6,13972,98802.6
421650,201901,295,171,124,170658,123752,294410
421660,201901,2189,1326,863,1325345.78,862274.76,2187620.54
421670,201901,196,140,56,139720,55888,195608
421680,201901,173,157,16,156686,15968,172654
421690,201901,346,246,100,245510.94,99800.44,345311.38
421700,201901,62,40,22,39920,21956.2,61876.2
421710,201901,27,26,1,25948,998,26946
421715,201901,7,6,1,5988,998,6986
421720,201901,589,433,156,432134,155688,587822
421725,201901,14,6,8,5988,7984,13972
421730,201901,38,26,12,25948.88,11976,37924.88
421740,201901,87,42,45,41916,44910,86826
421750,201901,221,165,56,164670.69,55888,220558.69
421755,201901,26,24,2,23952,1996,25948
421760,201901,108,77,31,76846,30938,107784
421770,201901,597,395,202,394221.32,201601.12,595822.44
421775,201901,32,20,12,19960,11976,31936
421780,201901,197,154,43,153692,42914,196606
421790,201901,157,132,25,131736,24950,156686
421795,201901,19,15,4,14970,3992,18962
421800,201901,509,325,184,324350,183632,507982
421810,201901,76,60,16,59880,15968,75848
421820,201901,320,215,105,214570.4,104790,319360.4
421825,201901,132,111,21,110778,20958,131736
421830,201901,136,102,34,101796,33932,135728
421835,201901,3,3,0,2994,,2994.0
421840,201901,54,46,8,45908.98,7984,53892.98
421850,201901,80,69,11,68862,10978.99,79840.99
421860,201901,39,32,7,31936,6986,38922
421870,201901,975,747,228,746536.18,227550.6,974086.78
421875,201901,54,46,8,45908,7984,53892
421880,201901,167,120,47,119760,46906.4,166666.4
421885,201901,28,22,6,21956,5988,27944
421890,201901,125,89,36,88822,35929.64,124751.64
421895,201901,48,44,4,43912,3992,47904
421900,201901,162,129,33,128744.94,32937.92,161682.86
421910,201901,69,44,25,43912,24950,68862
421915,201901,31,26,5,25948,4990,30938
421917,201901,46,35,11,34930,10978,45908
421920,201901,34,31,3,30938,2994,33932
421930,201901,740,575,165,573850,164672.94,738522.94
421935,201901,53,46,7,45908,6986,52894
421940,201901,41,37,4,36926,3992,40918
421950,201901,841,562,279,560876,279441.58,840317.58
421960,201901,40,33,7,32934.4,6986,39920.4
421970,201901,364,230,134,229540.2,133732.98,363273.18
421985,201901,31,20,11,19960,10978,30938
422000,201901,0,0,0,0,0,0
430003,201901,199,51,148,50898,147704,198602
430005,201901,39,30,9,29940,8982,38922
430010,201901,275,194,81,193612,80838,274450
430020,201901,154,100,54,99800.4,53892,153692.4
430030,201901,129,103,26,102794,25948,128742
430040,201901,2966,1731,1235,1727539.7,1232532.34,2960072.04
430045,201901,69,59,10,58882,9980,68862
430047,201901,6,5,1,4990,998,5988
430050,201901,79,67,12,66866,11976,78842
430055,201901,15,13,2,12974,1996,14970
430057,201901,6,4,2,3992,1996,5988
430060,201901,3671,2176,1495,2172654.3,1494011.66,3666665.96
430063,201901,59,54,5,53892,4990,58882
430064,201901,155,129,26,128742,25948,154690
430066,201901,7,6,1,5988,998,6986
430070,201901,46,35,11,34930,10978,45908
430080,201901,67,45,22,44910,21956,66866
430085,201901,35,13,22,12974,21956,34930
430087,201901,29,21,8,20958.7,7984,28942.7
430090,201901,72,65,7,64870,6986,71856
430100,201901,127,87,40,86826,39920,126746
430105,201901,144,75,69,74850.6,68862,143712.6
430107,201901,21,16,5,15968,4990,20958
430110,201901,416,246,170,246506,169660,416166
430120,201901,143,132,11,131736,10978,142714
430130,201901,799,497,302,496006.89,301396,797402.89
430140,201901,119,112,7,111776,6986,118762
430150,201901,111,72,39,71856,38922,110778
430155,201901,32,29,3,28942,2994,31936
430160,201901,3716,2218,1498,2213566.5,1495004.4,3708570.9
430163,201901,331,151,180,150698,179640,330338
430165,201901,29,19,10,18962,9980,28942
430170,201901,92,78,14,77844,13972,91816
430175,201901,84,67,17,66866,16966,83832
430180,201901,103,84,19,83832,18962,102794
430185,201901,34,26,8,25948,7984,33932
430187,201901,94,40,54,39920,53892,93812
430190,201901,220,126,94,125748,93812,219560
430192,201901,14,13,1,12974,998,13972
430195,201901,16,11,5,10978,4990,15968
430200,201901,172,151,21,150698,20958,171656
430205,201901,20,19,1,18962,998,19960
430210,201901,658,510,148,508980,147704.4,656684.4
430215,201901,15,13,2,12974,2994,15968
430220,201901,70,49,21,48902,20958,69860
430222,201901,13,7,6,6986,5988,12974
430223,201901,13,7,6,6986,5988,12974
430225,201901,2,1,1,998,998,1996
430230,201901,307,183,124,182634,123752,306386
430235,201901,53,39,14,38922,13972,52894
430237,201901,30,22,8,21956,7984,29940
430240,201901,138,89,49,88822,48902,137724
430245,201901,70,58,12,57884,11976,69860
430250,201901,196,116,80,115768,79840,195608
430258,201901,11,9,2,8982,1996,10978
430260,201901,33,29,4,28942,3992,32934
430265,201901,36,30,6,29940,5988,35928
430270,201901,546,410,136,410178.3,135731.92,545910.22
430280,201901,1031,635,396,633730,396207.9,1029937.9
430290,201901,380,219,161,218562.6,160678,379240.6
430300,201901,2129,1185,944,1184629.39,943116.05,2127745.44
430310,201901,1956,1019,937,1018959.96,936130.94,1955090.90
430320,201901,53,45,8,44910,7984,52894
430330,201901,95,85,10,85828,9980,95808
430340,201901,68,60,8,59880,7984,67864
430350,201901,1643,1147,496,1145704.6,495008.98,1640713.58
430355,201901,24,22,2,21956,1996,23952
430360,201901,87,44,43,43912,42914,86826
430367,201901,29,20,9,19960,8982,28942
430370,201901,57,49,8,48902,7984,56886
430380,201901,139,105,34,104790,33932,138722
430390,201901,612,388,224,387224,223552.4,610776.4
430400,201901,142,108,34,107784,33932,141716
430410,201901,59,46,13,45908,12974,58882
430420,201901,494,329,165,329340.94,165668.98,495009.92
430430,201901,53,52,1,51231.33,998,52229.33
430435,201901,152,116,36,115768,35928,151696
430440,201901,509,330,179,330338.6,178642,508980.6
430450,201901,1174,969,205,967062,205588,1172650
430460,201901,5021,2776,2245,2770452.2,2245526.22,5015978.42
430461,201901,17,15,2,14970,1996,16966
430462,201901,9,6,3,5988,2994,8982
430463,201901,1046,559,487,557883.56,487025.96,1044909.52
430465,201901,24,14,10,13972,9980,23952
430466,201901,662,475,187,475048.4,186626,661674.4
430467,201901,97,54,43,53892.6,42914,96806.6
430468,201901,109,66,43,65868,42914,108782
430469,201901,23,18,5,17964,4990,22954
430470,201901,1160,649,511,647702.95,509978,1157680.95
430471,201901,51,38,13,37924,12974,50898
430480,201901,102,63,39,62874,38922,101796
430485,201901,6,6,0,5988.4,,5988.4
430490,201901,88,71,17,70858,16966,87824
430495,201901,39,28,11,27944,10978,38922
430500,201901,194,128,66,127744,65868.63,193612.63
430510,201901,3321,2185,1136,2185621.24,1133728,3319349.24
430511,201901,17,16,1,15968,998,16966
430512,201901,139,99,40,98802,39920,138722
430513,201901,51,41,10,40918,9980,50898
430515,201901,33,31,2,30938,1996,32934
430517,201901,167,150,17,149700,16966,166666
430520,201901,369,256,113,255488,112774,368262
430530,201901,91,53,38,52894,37924,90818
430535,201901,467,318,149,317364,148702.99,466066.99
430537,201901,10,10,0,9980,,9980.0
430540,201901,76,52,24,51896,23952,75848
430543,201901,362,115,247,114770,247504,362274
430544,201901,43,40,3,39920,2994,42914
430545,201901,359,179,180,179640.96,179640,359280.96
430550,201901,42,36,6,35928,5988,41916
430558,201901,5,3,2,2994,1996,4990
430560,201901,54,25,29,24950,28942,53892
430570,201901,109,44,65,43912,64870,108782
430580,201901,125,101,24,100798,23952.6,124750.6
430583,201901,14,14,0,13972,,13972.0
430585,201901,9,4,5,3992,4990,8982
430587,201901,15,7,8,6986,7984,14970
430590,201901,148,121,27,121756,26946,148702
430593,201901,2,2,0,1996,,1996.0
430595,201901,17,14,3,13972,2994,16966
430597,201901,50,28,22,27944,21956,49900
430600,201901,220,154,66,153692,65868,219560
430605,201901,159,101,58,100798,57884,158682
430607,201901,26,22,4,21956,3992,25948
430610,201901,1631,774,857,772452.9,855287.78,1627740.68
430613,201901,3,3,0,2994,,2994.0
430620,201901,116,85,31,84830,30938,115768
430630,201901,47,41,6,40918,5988,46906
430632,201901,32,27,5,26946,4990,31936
430635,201901,40,37,3,36926,2994,39920
430637,201901,52,29,23,28942,22954,51896
430640,201901,193,109,84,108782,83832,192614
430642,201901,23,21,2,20958,1996,22954
430645,201901,36,29,7,28942,6986,35928
430650,201901,254,206,48,205588.4,47904,253492.4
430655,201901,4,4,0,3992,,3992.0
430660,201901,974,480,494,479040,493012.4,972052.4
430670,201901,74,52,22,51896,21956,73852
430673,201901,76,41,35,40918,34930,75848
430675,201901,14,11,3,10978,2994,13972
430676,201901,505,312,193,311376.94,192614.94,503991.88
430680,201901,243,171,72,170658.4,71856,242514.4
430690,201901,534,331,203,330338.98,202594.63,532933.61
430692,201901,7,5,2,4990,1996,6986
430693,201901,144,97,47,96806,46906,143712
430695,201901,72,60,12,59880,11976,71856
430697,201901,60,38,22,37924,21956,59880
430700,201901,1555,1089,466,1087820.76,467064,1554884.76
430705,201901,22,20,2,19960,1996,21956
430710,201901,255,168,87,167664,86826,254490
430720,201901,106,91,15,90818,14970,105788
430730,201901,132,114,18,113772,17964,131736
430740,201901,71,47,24,46906,23952,70858
430745,201901,35,28,7,27944,6986,34930
430750,201901,342,227,115,226546,114770,341316
430755,201901,87,52,35,51896,34930,86826
430760,201901,354,212,142,211577.04,141716.98,353294.02
430770,201901,1429,753,676,752494.24,676648.88,1429143.12
430780,201901,318,203,115,202594.98,114770.98,317365.96
430781,201901,29,25,4,24950,3992,28942
430783,201901,56,46,10,45908,9980,55888
430786,201901,6,3,3,2994,2994,5988
430790,201901,536,345,191,344310,190618.4,534928.4
430800,201901,160,133,27,132734.51,26946,159680.51
430805,201901,41,37,4,36926,3992,40918
430807,201901,43,25,18,24950,17964,42914
430810,201901,77,51,26,50898,25948,76846
430820,201901,143,84,59,83832,58882,142714
430825,201901,12,10,2,9980,1996,11976
430830,201901,233,217,16,216566.4,15968,232534.4
430840,201901,129,85,44,84830,43912,128742
430843,201901,5,3,2,2994,1996,4990
430845,201901,71,41,30,40918,29940,70858
430850,201901,575,404,171,403192,170661.9,573853.9
430860,201901,165,104,61,103792,60878,164670
430865,201901,73,42,31,41916,30938,72854
430870,201901,83,67,16,66866,15968,82834
430880,201901,155,116,39,115768,38922,154690
430885,201901,10,8,2,7984,1996,9980
430890,201901,340,207,133,207584,132734,340318
430900,201901,531,371,160,369759,159680,529439
430905,201901,108,46,62,45908,61876,107784
430910,201901,268,149,119,148702,118762.98,267464.98
430912,201901,5,5,0,4990,,4990.0
430915,201901,34,28,6,27944,5988,33932
430920,201901,4218,2351,1867,2348299.38,1865265.94,4213565.32
430925,201901,4,3,1,2994,998,3992
430930,201901,2085,1233,852,1230536.26,850299.88,2080836.14
430940,201901,262,170,92,169660,91816,261476
430950,201901,153,122,31,121756,30938,152694
430955,201901,23,14,9,13972,8982,22954
430957,201901,19,18,1,17964,998,18962
430960,201901,248,163,85,162674,84830,247504
430965,201901,111,70,41,69860,40918,110778
430970,201901,84,69,15,68862,14970,83832
430975,201901,38,34,4,33932,3992,37924
430980,201901,45,29,16,28942,15968,44910
430990,201901,119,90,29,89820,28942,118762
430995,201901,117,112,5,111776,4990,116766
431000,201901,312,140,172,139721,171656,311377
431010,201901,345,207,138,206586,137724,344310
431020,201901,1939,1132,807,1129736.6,806384,1936120.6
431030,201901,41,32,9,31936,8982,40918
431033,201901,380,192,188,191616,187624,379240
431036,201901,14,9,5,8982,4990,13972
431040,201901,131,80,51,79840,50898,130738
431041,201901,40,28,12,27944,11976,39920
431043,201901,51,31,20,30938,19960,50898
431046,201901,11,7,4,6986,3992,10978
431050,201901,200,129,71,128742,70858,199600
431053,201901,79,48,31,47904.96,30938,78842.96
431055,201901,63,43,20,42914,19960,62874
431057,201901,18,18,0,17964,,17964.0
431060,201901,1645,1040,605,1037922.35,603805.4,1641727.75
431065,201901,18,11,7,10978,6986,17964
431070,201901,70,64,6,63872,5988,69860
431075,201901,6,6,0,5988,,5988.0
431080,201901,137,85,52,84830,51896,136726
431085,201901,32,29,3,28942,2994,31936
431087,201901,14,11,3,10978,2994,13972
431090,201901,54,43,11,42914,11976,54890
431100,201901,1210,725,485,723551.34,485028,1208579.34
431110,201901,249,153,96,152694,95808.4,248502.4
431112,201901,28,17,11,16966,10978,27944
431113,201901,33,24,9,23952,8982,32934
431115,201901,158,110,48,109780,47904,157684
431120,201901,607,362,245,362274.6,244511.92,606786.52
431123,201901,4,3,1,2994,998,3992
431125,201901,100,90,10,89820,9980,99800
431127,201901,9,4,5,3992,4990,8982
431130,201901,682,438,244,437124,243512,680636
431140,201901,756,524,232,523950.4,231536,755486.4
431142,201901,32,26,6,25948.95,5988,31936.95
431150,201901,201,150,51,149700,50898,200598
431160,201901,56,50,6,49900,5988,55888
431162,201901,19,14,5,13972,4990,18962
431164,201901,5,5,0,4990,,4990.0
431170,201901,105,85,20,84830,19960,104790
431171,201901,65,38,27,37924,26946,64870
431173,201901,2,2,0,1996,,1996.0
431175,201901,199,101,98,100798.4,98802,199600.4
431177,201901,72,54,18,53892,17964,71856
431179,201901,14,12,2,11976,1996,13972
431180,201901,448,275,173,274450,172654.98,447104.98
431190,201901,88,67,21,66866,20958,87824
431198,201901,69,48,21,47904,20958,68862
431200,201901,20,16,4,15968,3992,19960
431205,201901,23,23,0,22954,,22954.0
431210,201901,84,51,33,50898,32934,83832
431213,201901,30,25,5,24950,4990,29940
431215,201901,26,23,3,22954,2994,25948
431217,201901,5,4,1,3992,998,4990
431220,201901,68,59,9,58882,8982,67864
431225,201901,149,100,49,99800.98,48902,148702.98
431230,201901,100,90,10,89820,9980,99800
431235,201901,8,8,0,7984,,7984.0
431237,201901,24,17,7,16966,6986,23952
431238,201901,10,7,3,6986.4,2994,9980.4
431240,201901,1002,656,346,655686.2,346306,1001992.2
431242,201901,38,37,1,37924,998,38922
431244,201901,11,8,3,7984,2994,10978
431245,201901,54,41,13,40918,12974,53892
431247,201901,12,10,2,9980,1996,11976
431250,201901,277,147,130,146706,129740,276446
431260,201901,61,46,15,45908,14970,60878
431261,201901,19,13,6,12974,5988,18962
431262,201901,18,17,1,16966,998,17964
431265,201901,161,90,71,90818,70858,161676
431267,201901,15,14,1,13972,998,14970
431270,201901,326,269,57,268462,56886,325348
431275,201901,39,36,3,35928,2994,38922
431280,201901,17,13,4,12974,3992,16966
431290,201901,25,20,5,19960,4990,24950
431295,201901,5,4,1,3992,998,4990
431300,201901,24,21,3,20958,2994,23952
431301,201901,7,7,0,6986,,6986.0
431303,201901,53,35,18,34930,17964,52894
431306,201901,235,124,111,123574.35,110778,234352.35
431308,201901,7,5,2,4990,1996,6986
431310,201901,67,58,9,57884,8982,66866
431320,201901,138,85,53,84830,52894,137724
431330,201901,176,114,62,113772,62874,176646
431333,201901,32,26,6,25948,5988,31936
431335,201901,9,5,4,4990,3992,8982
431337,201901,330,154,176,153692,175648,329340
431339,201901,23,20,3,19960,2994,22954
431340,201901,2992,1722,1270,1720476.51,1268477.28,2988953.79
431342,201901,38,23,15,22954,14970,37924
431344,201901,18,18,0,17964,,17964.0
431346,201901,4,4,0,3992,,3992.0
431349,201901,35,32,3,31936,2994,34930
431350,201901,918,546,372,544909.58,371256,916165.58
431360,201901,49,44,5,43912,4990,48902
431365,201901,320,154,166,153692,165668,319360
431370,201901,1329,798,531,796404.4,529944.86,1326349.26
431380,201901,100,86,14,85828,13972,99800
431390,201901,522,290,232,289420,231536,520956
431395,201901,292,133,159,132734,159680.96,292414.96
431400,201901,41,31,10,30938,9980,40918
431402,201901,99,69,30,68862,29940,98802
431403,201901,20,12,8,11976,7984,19960
431405,201901,645,352,293,351296.9,292416.94,643713.84
431406,201901,31,27,4,26946,3992,30938
431407,201901,54,42,12,41916,11976,53892
431410,201901,3419,2096,1323,2091810.06,1321352,3413162.06
431413,201901,17,14,3,13972,2994,16966
431415,201901,72,54,18,53892,17964,71856
431417,201901,22,12,10,11976,9980,21956
431420,201901,314,218,96,217564,95808,313372
431430,201901,47,23,24,22954,23952,46906
431440,201901,8866,6297,2569,6285414.02,2563863.4,8849277.42
431442,201901,28,15,13,14970,13972,28942
431445,201901,23,20,3,19960,2994,22954
431446,201901,2,2,0,1996,,1996.0
431447,201901,84,61,23,60878,22954,83832
431449,201901,54,47,7,46906,6986,53892
431450,201901,418,285,133,284430,132734,417164
431454,201901,0,0,0,0,0,0
431455,201901,50,39,11,38922,10978,49900
431460,201901,516,358,158,357284,157684,514968
431470,201901,125,97,28,96806,27944,124750
431475,201901,11,10,1,9980,998,10978
431477,201901,36,24,12,23952,11976,35928
431478,201901,8,7,1,6986,998,7984
431480,201901,493,311,182,310378,182634,493012
431490,201901,28119,16043,12076,16027005.18,12062969.93,28089975.11
431500,201901,82,59,23,58882,22954,81836
431505,201901,33,19,14,18962,13972,32934
431507,201901,12,10,2,9980,1996,11976
431510,201901,264,184,80,184630.1,80838,265468.1
431513,201901,24,20,4,19960,3992,23952
431514,201901,7,6,1,5988,998,6986
431515,201901,80,67,13,66866,12974,79840
431517,201901,5,4,1,3992,998,4990
431520,201901,38,34,4,33932,3992,37924
431530,201901,1571,708,863,706586.88,861274.94,1567861.82
431531,201901,24,22,2,21956,1996,23952
431532,201901,27,19,8,18962,7984,26946
431535,201901,25,15,10,14970,9980,24950
431540,201901,144,127,17,126746,16966,143712
431545,201901,15,13,2,12974,1996,14970
431550,201901,359,202,157,201596,156686,358282
431555,201901,13,12,1,11976,998,12974
431560,201901,4482,3162,1320,3158675.17,1317360,4476035.17
431570,201901,812,440,372,439120.8,371256,810376.8
431575,201901,38,24,14,23952,13972,37924
431580,201901,99,70,29,69860,28942,98802
431590,201901,148,125,23,124750,22954,147704
431595,201901,11,10,1,9980,998,10978
431600,201901,219,123,96,122754,95808,218562
431610,201901,126,93,33,92814,32934,125748
431620,201901,45,37,8,36926,7984,44910
431630,201901,136,114,22,113772,21956,135728
431640,201901,1354,852,502,850296.4,501995.36,1352291.76
431642,201901,36,33,3,32934,2994,35928
431643,201901,43,19,24,18962,23952,42914
431645,201901,306,179,127,178642,126746,305388
431647,201901,10,10,0,9980,,9980.0
431650,201901,36,26,10,26946,9980,36926
431660,201901,308,196,112,195608,111776,307384
431670,201901,229,109,120,108782,119760,228542
431673,201901,5,5,0,4990,,4990.0
431675,201901,30,25,5,24950,4990,29940
431680,201901,1123,813,310,812372,309380.98,1121752.98
431690,201901,4778,2909,1869,2908175.68,1868259.9,4776435.58
431695,201901,24,19,5,18962,4990,23952
431697,201901,0,0,0,0,0,0
431700,201901,176,138,38,137724,37924,175648
431710,201901,4031,1770,2261,1766462.29,2257487.76,4023950.05
431720,201901,1364,832,532,832332.6,530936.99,1363269.59
431725,201901,1,1,0,998,,998.0
431730,201901,1200,817,383,815369.12,384230,1199599.12
431740,201901,1368,674,694,672652.96,692617.3,1365270.26
431750,201901,1856,1217,639,1215565.71,640716.98,1856282.69
431755,201901,6,5,1,4990,998,5988
431760,201901,1025,668,357,666664,356286,1022950
431770,201901,392,291,101,290418,100798,391216
431775,201901,30,22,8,21956,7984,29940
431780,201901,566,356,210,355288,209580,564868
431790,201901,168,129,39,128742,38922,167664
431795,201901,13,12,1,11976,998,12974
431800,201901,3346,1764,1582,1762480.2,1579937.28,3342417.48
431805,201901,19,17,2,16966,1996,18962
431810,201901,610,408,202,407184,201596.98,608780.98
431820,201901,326,185,141,184630,140718,325348
431830,201901,2325,1415,910,1413168,908184.92,2321352.92
431840,201901,493,330,163,329340.6,163672.4,493013.0
431842,201901,33,27,6,26946,5988,32934
431843,201901,12,9,3,8982,2994,11976
431844,201901,16,14,2,13972,1996,15968
431845,201901,29,26,3,25948,2994,28942
431846,201901,29,24,5,23952,4990,28942
431848,201901,15,13,2,12974,1996,14970
431849,201901,10,7,3,6986,2994,9980
431850,201901,810,666,144,664668.4,143712,808380.4
431860,201901,108,78,30,77844,29940,107784
431861,201901,3,2,1,1996,998,2994
431862,201901,51,34,17,33932,16966,50898
431870,201901,3427,2044,1383,2042910.3,1383235.33,3426145.63
431880,201901,941,692,249,692612.94,248502,941114.94
431890,201901,1312,817,495,815366.4,494010,1309376.4
431900,201901,179,130,49,129740,48902,178642
431910,201901,53,40,13,39920,13972,53892
431912,201901,39,22,17,21956,16966,38922
431915,201901,133,106,27,106786,26946,133732
431920,201901,152,111,41,110778,40918,151696
431930,201901,81,66,15,65868,14970,80838
431935,201901,3,3,0,2994,,2994.0
431936,201901,12,11,1,10978,998,11976
431937,201901,19,14,5,13972,4990,18962
431940,201901,471,316,155,315368,154690.5,470058.5
431950,201901,504,314,190,313373.38,189621.96,502995.34
431960,201901,730,410,320,412176.36,319361.96,731538.32
431970,201901,73,65,8,64870,7984,72854
431971,201901,3,3,0,2994,,2994.0
431973,201901,25,20,5,19960,4990,24950
431975,201901,8,7,1,6986,998,7984
431980,201901,206,129,77,128742,76846,205588
431990,201901,1220,654,566,652627.13,566866.9,1219494.03
432000,201901,1668,913,755,911176.5,753495,1664671.5
432010,201901,282,187,95,186626,94810,281436
432020,201901,175,144,31,144710,30938,175648
432023,201901,17,14,3,13972,2994,16966
432026,201901,70,65,5,64870,4990,69860
432030,201901,66,31,35,30938,34930,65868
432032,201901,19,16,3,15968,2994,18962
432035,201901,52,40,12,39920,11976,51896
432040,201901,104,70,34,69860,33932,103792
432045,201901,8,7,1,6986,998,7984
432050,201901,76,45,31,44910,30938,75848
432055,201901,110,81,29,80838,28942,109780
432057,201901,3,2,1,1996,998,2994
432060,201901,35,32,3,31936,2994,34930
432065,201901,32,28,4,27944,3992,31936
432067,201901,89,80,9,79840,8982,88822
432070,201901,401,301,100,300648.8,99800.98,400449.78
432080,201901,820,570,250,568860,250498,819358
432085,201901,17,13,4,12974,3992,16966
432090,201901,265,170,95,169660,94810,264470
432100,201901,171,113,58,112774,57884,170658
432110,201901,592,407,185,407184,184630,591814
432120,201901,946,579,367,577842,366266,944108
432130,201901,508,370,138,370258,137724,507982
432132,201901,24,21,3,20958,2994,23952
432135,201901,79,66,13,65868,12974,78842
432140,201901,271,218,53,217564,52894,270458
432143,201901,198,124,74,123752,73852,197604
432145,201901,277,189,88,188622,87824,276446
432146,201901,14,13,1,12974,998,13972
432147,201901,128,62,66,61876,65868,127744
432149,201901,15,11,4,10978,3992,14970
432150,201901,842,523,319,521954,319361.55,841315.55
432160,201901,1404,738,666,736525.57,664669.94,1401195.51
432162,201901,4,3,1,2994,998,3992
432163,201901,18,14,4,13972,3992,17964
432166,201901,117,87,30,87326,29940,117266
432170,201901,233,124,109,123752,108782,232534
432180,201901,542,337,205,336326,204590.4,540916.4
432183,201901,8,7,1,6986,998,7984
432185,201901,80,70,10,69860,9980,79840
432190,201901,460,268,192,268462,193612.98,462074.98
432195,201901,85,73,12,72854,11976,84830
432200,201901,402,259,143,258482,142714.98,401196.98
432210,201901,119,75,44,74850,43912,118762
432215,201901,56,52,4,51896,3992,55888
432218,201901,20,19,1,18962,998,19960
432220,201901,681,353,328,352294,327345.61,679639.61
432225,201901,12,7,5,6986,4990,11976
432230,201901,149,96,53,95808,52894,148702
432232,201901,13,12,1,11976,998,12974
432234,201901,4,3,1,2994,998,3992
432235,201901,2,2,0,1996,,1996.0
432237,201901,28,17,11,16966,10978,27944
432240,201901,4331,2442,1889,2438119.08,1892209.78,4330328.86
432250,201901,1078,689,389,688620,388222,1076842
432252,201901,44,39,5,38922,5988,44910
432253,201901,59,47,12,46906,11976,58882
432254,201901,26,13,13,12974,12974,25948
432255,201901,14,13,1,12974,998,13972
432260,201901,883,703,180,703590.4,179640,883230.4
432270,201901,241,176,65,175648,64870,240518
432280,201901,133,100,33,99800.6,32934,132734.6
432285,201901,1,1,0,998,,998.0
432290,201901,67,59,8,58882,7984,66866
432300,201901,4572,2622,1950,2617693.35,1949106.6,4566799.95
432310,201901,119,99,20,98802,19960,118762
432320,201901,21,18,3,17964,2994,20958
432330,201901,18,13,5,12974,4990,17964
432335,201901,8,7,1,6986,998,7984
432340,201901,40,36,4,35928,3992,39920
432345,201901,98,71,27,70858,26946,97804
432350,201901,23,22,1,21956,998,22954
432360,201901,7,5,2,4990,1996,6986
432370,201901,26,26,0,25948,,25948.0
432375,201901,34,31,3,30938,2994,33932
432377,201901,8,8,0,7984,,7984.0
432380,201901,166,74,92,73852,91816,165668
500020,201901,248,142,106,141716,105788,247504
500025,201901,119,57,62,56886,61876,118762
500060,201901,1472,917,555,915166,553891.38,1469057.38
500070,201901,799,381,418,381236.96,418162.98,799399.94
500080,201901,134,107,27,106786,27944,134730
500085,201901,134,108,26,108782.4,25948,134730.4
500090,201901,328,159,169,158682,169660,328342
500100,201901,740,393,347,395208,346306.8,741514.8
500110,201901,2262,1040,1222,1037925.31,1221563.1,2259488.41
500124,201901,266,155,111,154690,110778,265468
500150,201901,326,138,188,137724.98,187626.94,325351.92
500190,201901,534,373,161,373252,160678.4,533930.4
500200,201901,192,164,28,163672.28,27944,191616.28
500210,201901,1467,527,940,525948.94,938144.42,1464093.36
500215,201901,250,148,102,147704,101796,249500
500220,201901,784,508,276,506986.66,275448,782434.66
500230,201901,254,173,81,172654,80838,253492
500240,201901,697,486,211,486026.36,210578,696604.36
500260,201901,596,226,370,225548,369260,594808
500270,201901,29079,12479,16600,12457085.9,16572979.53,29030065.43
500280,201901,195,71,124,70858,123752,194610
500290,201901,1188,712,476,711574.6,475048.98,1186623.58
500295,201901,422,265,157,264470.4,156686,421156.4
500310,201901,63,19,44,18962,43912,62874
500315,201901,736,444,292,443112,291416,734528
500320,201901,3661,1855,1806,1852289.75,1803390.9,3655680.65
500325,201901,909,503,406,501994,405188.4,907182.4
500330,201901,1471,688,783,688620.4,783430.98,1472051.38
500345,201901,318,242,76,241517.38,75848,317365.38
500348,201901,246,149,97,148702,96806.98,245508.98
500350,201901,129,64,65,63872,64870,128742
500370,201901,5451,2462,2989,2457079.28,2985025.3,5442104.58
500375,201901,350,259,91,258482,90818,349300
500380,201901,601,346,255,345308,255488,600796
500390,201901,71,34,37,33932,36926,70858
500400,201901,210,146,64,145708,63872.98,209580.98
500410,201901,562,227,335,226549.89,334336.85,560886.74
500430,201901,533,374,159,373252,158682,531934
500440,201901,203,104,99,103792,98802,202594
500450,201901,408,177,231,176646,230538,407184
500460,201901,297,151,146,150698,146706,297404
500470,201901,442,349,93,348303.39,93812.98,442116.37
500480,201901,109,64,45,63872,45908,109780
500490,201901,107,43,64,42914,63872,106786
500500,201901,1441,524,917,522962.81,915200.47,1438163.28
500510,201901,48,37,11,36926,10978.98,47904.98
500515,201901,106,74,32,73852,31936,105788
500520,201901,350,195,155,194610.8,154691.39,349302.19
500525,201901,88,49,39,48902,38922,87824
500540,201901,914,390,524,389220.98,522953.96,912174.94
500560,201901,907,523,384,522952,383232.4,906184.4
500568,201901,983,579,404,577842.98,403193.39,981036.37
500570,201901,1205,684,521,682652.2,520020.52,1202672.72
500580,201901,335,175,160,174650,160680.91,335330.91
500600,201901,312,164,148,163672,147705.96,311377.96
500620,201901,926,657,269,655686.4,268462,924148.4
500625,201901,79,67,12,66866,11976,78842
500627,201901,27,12,15,11976,14970,26946
500630,201901,1577,847,730,845306.7,731534,1576840.7
500635,201901,529,304,225,303392,224550,527942
500640,201901,425,224,201,223553,200598,424151
500660,201901,5500,2113,3387,2108774.4,3382224.98,5490999.38
500690,201901,579,208,371,207594.76,370283.48,577878.24
500710,201901,377,188,189,187624,189621.96,377245.96
500720,201901,973,577,396,575846,395208,971054
500730,201901,201,122,79,121756,78842,200598
500740,201901,838,367,471,366272.34,470090.65,836362.99
500750,201901,145,46,99,45908,98802.98,144710.98
500755,201901,122,88,34,87824.4,33932,121756.4
500769,201901,754,423,331,422156.37,330340.95,752497.32
500770,201901,430,228,202,227544,201596,429140
500780,201901,166,109,57,108782,56886,165668
500790,201901,1060,543,517,541914,515970.91,1057884.91
500793,201901,268,149,119,148702,118763.38,267465.38
500795,201901,176,128,48,127744,47904.98,175648.98
500797,201901,46,33,13,32934,12974,45908
500800,201901,419,186,233,185628.98,232534,418162.98
500830,201901,2251,1270,981,1268459.78,980036.98,2248496.76
500840,201901,143,106,37,105788,36926.98,142714.98
510010,201901,168,93,75,92814,74850,167664
510020,201901,487,232,255,231556.58,254520.38,486076.96
510025,201901,1688,967,721,965074.19,719574.08,1684648.27
510030,201901,679,353,326,352297.9,325349.96,677647.86
510035,201901,132,60,72,59881.96,71856.98,131738.94
510040,201901,387,174,213,173652,212576.68,386228.68
510050,201901,410,226,184,225555.82,183639.28,409195.10
510060,201901,114,59,55,58882,54890,113772
510080,201901,226,92,134,91816.98,133732.98,225549.96
510100,201901,74,34,40,33932,39920,73852
510120,201901,38,23,15,22954,14970,37924
510125,201901,392,243,149,243512,148703.97,392215.97
510130,201901,571,336,235,335336.82,234541.76,569878.58
510140,201901,407,133,274,132734.98,273452,406186.98
510160,201901,98,41,57,40918,56886.99,97804.99
510170,201901,852,523,329,521966.74,328356.68,850323.42
510180,201901,2882,1396,1486,1394250.81,1484062.48,2878313.29
510185,201901,12,6,6,5988,5988,11976
510190,201901,221,76,145,75848,144710,220558
510250,201901,2590,1545,1045,1541917.26,1043912.32,2585829.58
510260,201901,196,144,52,143728.66,51898.94,195627.60
510263,201901,462,264,198,263475.74,197604.98,461080.72
510267,201901,669,379,290,378256.32,290440.52,668696.84
510268,201901,59,29,30,28942,29940,58882
510269,201901,71,34,37,33932.98,36926,70858.98
510270,201901,402,204,198,203595.92,197609.88,401205.80
510279,201901,223,168,55,167666.94,54890.4,222557.34
510285,201901,179,77,102,77844.98,101796,179640.98
510300,201901,519,288,231,287427.93,230542.9,517970.83
510305,201901,209,98,111,97805.97,111776.98,209582.95
510310,201901,109,57,52,56886,51896,108782
510320,201901,855,542,313,540922.86,312387.73,853310.59
510325,201901,410,167,243,166666,243512,410178
510330,201901,439,249,190,248503.97,189620,438123.97
510335,201901,609,348,261,347306.95,260482.9,607789.85
510336,201901,49,35,14,34930,13972,48902
510337,201901,116,50,66,49900,65868,115768
510340,201901,17198,8196,9002,8189815.5,8990298.53,17180114.03
510343,201901,68,49,19,48902,18962,67864
510345,201901,162,111,51,110778,50898.4,161676.4
510350,201901,661,372,289,371259.92,288425.92,659685.84
510360,201901,194,122,72,121756.98,71861.88,193618.86
510370,201901,143,75,68,74850,67866.94,142716.94
510380,201901,91,64,27,63872,26946.98,90818.98
510385,201901,57,27,30,26946,29940.98,56886.98
510390,201901,115,49,66,48902,65868,114770
510395,201901,47,36,11,35928,10978,46906
510410,201901,701,466,235,466066.99,234530.98,700597.97
510420,201901,572,277,295,276461.64,294442.24,570903.88
510450,201901,53,29,24,28942,23952,52894
510452,201901,43,24,19,23952,18962,42914
510454,201901,52,26,26,25948,26946,52894
510455,201901,128,77,51,77844,50898,128742
510460,201901,182,96,86,96808.66,85828.98,182637.64
510480,201901,747,444,303,444118.5,304405.58,748524.08
510490,201901,347,180,167,179645.84,166668.9,346314.74
510500,201901,249,191,58,190618,57884,248502
510510,201901,794,460,334,460079.38,333332,793411.38
510515,201901,1161,613,548,611778.9,546905.96,1158684.86
510517,201901,260,111,149,110778,148702.98,259480.98
510520,201901,236,154,82,153695.92,81840.88,235536.80
510523,201901,95,70,25,69860,24950,94810
510525,201901,756,436,320,436131.89,321360.9,757492.79
510530,201901,17,13,4,12974,3992,16966
510550,201901,262,119,143,118762.98,142714,261476.98
510558,201901,280,138,142,137724.98,141716,279440.98
510560,201901,405,237,168,238522.4,167665.96,406188.36
510562,201901,652,462,190,461076,189620,650696
510590,201901,790,410,380,409181.96,379241.97,788423.93
510600,201901,252,139,113,138722,112775.96,251497.96
510610,201901,170,83,87,82834,86826.4,169660.4
510615,201901,195,82,113,81836,113772,195608
510617,201901,19,11,8,10978,7984,18962
510618,201901,117,56,61,55888,60878,116766
510619,201901,102,71,31,70858.98,30938.98,101797.96
510620,201901,180,99,81,98802,80838,179640
510621,201901,192,123,69,122754.98,68863.96,191618.94
510622,201901,468,299,169,298407.88,169660.98,468068.86
510623,201901,348,234,114,233533.96,113772,347305.96
510624,201901,93,46,47,45908.98,47904,93812.98
510625,201901,542,331,211,330353.68,210592.33,540946.01
510626,201901,113,71,42,70858,41916,112774
510627,201901,62,44,18,43912,17964,61876
510628,201901,155,93,62,92815.96,61876,154691.96
510629,201901,260,169,91,168662,90818,259480
510630,201901,457,234,223,233533.96,222557.34,456091.30
510631,201901,10,3,7,2994,6986.4,9980.4
510637,201901,357,207,150,206589.93,149710.78,356300.71
510642,201901,968,542,426,540918.94,426146.98,967065.92
510645,201901,0,0,0,0,0,0
510650,201901,1456,977,479,975060.72,478046.87,1453107.59
510665,201901,82,42,40,41919.88,39920,81839.88
510670,201901,66,38,28,37924,27944,65868
510675,201901,1161,721,440,719561.34,440119.96,1159681.30
510677,201901,353,180,173,179645.88,172660.86,352306.74
510680,201901,102,58,44,57885.96,43912.98,101798.94
510682,201901,213,110,103,109780.62,102794,212574.62
510685,201901,51,38,13,37924,12974,50898
510700,201901,613,359,254,358292.78,253502.79,611795.57
510704,201901,1111,603,508,601914.51,507090.8,1109005.31
510706,201901,128,66,62,65868,61877.96,127745.96
510710,201901,400,274,126,273457.84,125749.92,399207.76
510715,201901,63,47,16,46906,15968,62874
510718,201901,209,116,93,115770.94,92814,208584.94
510719,201901,35,17,18,16966,17964,34930
510720,201901,195,134,61,133732.98,60878,194610.98
510724,201901,88,34,54,33932,53892,87824
510726,201901,54,27,27,26946,26947.96,53893.96
510729,201901,74,35,39,34930,38922,73852
510730,201901,474,267,207,267465.96,207585.97,475051.93
510735,201901,108,43,65,42914,64870,107784
510740,201901,27,16,11,15968,10978,26946
510757,201901,17,13,4,12974,3992,16966
510760,201901,7095,3774,3321,3769514.19,3319570.75,7089084.94
510770,201901,703,332,371,331340.88,371266.74,702607.62
510774,201901,15,5,10,4990,9980,14970
510775,201901,116,87,29,86826,28942,115768
510776,201901,27,7,20,6986,19960,26946
510777,201901,185,81,104,80838,104790,185628
510779,201901,49,24,25,23952.98,24951.96,48904.94
510780,201901,288,161,127,160684.88,126750.86,287435.74
510785,201901,425,228,197,227544,196606,424150
510787,201901,193,94,99,93812.98,98803.97,192616.95
510788,201901,0,0,0,0,0,0
510790,201901,2391,1264,1127,1262519.9,1128831.1,2391351.0
510792,201901,1118,646,472,646711.84,472069.69,1118781.53
510794,201901,118,59,59,58882,58882.98,117764.98
510795,201901,2375,1401,974,1399200.78,972059.66,2371260.44
510800,201901,182,113,69,113772.83,68862.98,182635.81
510805,201901,175,121,54,120758,53892,174650
510810,201901,98,41,57,40923.88,56886,97809.88
510820,201901,254,121,133,120762.12,132736.51,253498.63
510830,201901,67,41,26,40918,25948.98,66866.98
510835,201901,10,8,2,7984,1996,9980
510840,201901,9170,4527,4643,4525148.76,4639934.57,9165083.33
510850,201901,205,82,123,82834,122754.98,205588.98
510860,201901,393,175,218,174656.86,217574.18,392231.04
510880,201901,65,49,16,48902.98,15968,64870.98
510885,201901,70,44,26,43912.98,25948,69860.98
510890,201901,70,42,28,41916,27944,69860
510895,201901,186,107,79,106786,78844.37,185630.37
520005,201901,45,32,13,31936,12974,44910
520010,201901,277,128,149,127744,148702.8,276446.8
520013,201901,681,424,257,423152.98,256486,679638.98
520015,201901,53,39,14,38922,13972,52894
520017,201901,94,54,40,53892.4,39920,93812.4
520020,201901,23,13,10,12974,9980,22954
520025,201901,2030,1113,917,1111772.4,915166,2026938.4
520030,201901,810,425,385,424150.98,385228,809378.98
520050,201901,77,52,25,51896,24950,76846
520055,201901,46,30,16,29940,15968,45908
520060,201901,187,124,63,124750,62874,187624
520080,201901,585,419,166,418162,166666,584828
520082,201901,19,14,5,13972,4990,18962
520085,201901,100,75,25,74850,24950,99800
520090,201901,91,60,31,59880,30938,90818
520110,201901,9194,4040,5154,4032926.08,5146692.1,9179618.18
520120,201901,14,8,6,7984,5988,13972
520130,201901,783,542,241,541914.98,240519.38,782434.36
520140,201901,11951,6772,5179,6762461.6,5173651.78,11936113.38
520145,201901,47,34,13,33932,12974,46906
520150,201901,189,147,42,146706,41916,188622
520160,201901,32,24,8,23952,7984,31936
520170,201901,248,153,95,152696.93,94812.92,247509.85
520180,201901,142,74,68,73852,67864,141716
520215,201901,217,140,77,139720,76846,216566
520235,201901,71,53,18,52894,17964,70858
520250,201901,131,80,51,79840,50898,130738
520260,201901,112,70,42,69860,41916,111776
520280,201901,47,33,14,32934,13972,46906
520310,201901,39,27,12,26946,11976,38922
520320,201901,166,105,61,104790,60878,165668
520330,201901,791,420,371,419162.94,370258.98,789421.92
520340,201901,349,200,149,199600,148702.98,348302.98
520350,201901,529,245,284,244510,283432,527942
520355,201901,90,55,35,54890,34930,89820
520357,201901,28,21,7,20958,6986,27944
520360,201901,1,1,0,998,,998.0
520380,201901,145,75,70,74850,69860,144710
520390,201901,275,119,156,118762.83,155688,274450.83
520393,201901,15,11,4,10978,3992,14970
520396,201901,94,59,35,58882,34930,93812
520400,201901,217,126,91,125748.4,90818,216566.4
520410,201901,193,98,95,97804.98,94810.98,192615.96
520420,201901,20,14,6,13972,5988,19960
520425,201901,312,144,168,143712,167665.4,311377.4
520430,201901,464,240,224,239520,223553.88,463073.88
520440,201901,618,422,196,421156,195608,616764
520450,201901,1932,868,1064,866264.98,1063872.9,1930137.88
520455,201901,58,41,17,40918,16966,57884
520460,201901,32,16,16,15968,15968,31936
520465,201901,25,22,3,21956,2994,24950
520470,201901,415,259,156,258482,155688,414170
520480,201901,82,48,34,48902,33936.9,82838.9
520485,201901,122,45,77,44910,76846.4,121756.4
520490,201901,431,315,116,315368,116766,432134
520495,201901,171,103,68,102794,67864,170658
520500,201901,176,133,43,132734,43912,176646
520505,201901,175,91,84,90818,83832,174650
520510,201901,1776,878,898,876275.76,896283.34,1772559.10
520520,201901,36,28,8,27944,7984,35928
520530,201901,231,175,56,174650,55888,230538
520540,201901,540,367,173,366266,172654,538920
520545,201901,144,84,60,83832,59880,143712
520547,201901,47,28,19,27944,19960,47904
520549,201901,1155,566,589,565866.72,587825.73,1153692.45
520551,201901,295,154,141,153692,140718.4,294410.4
520552,201901,47,28,19,27944,18962,46906
520570,201901,16,9,7,8982,6986,15968
520580,201901,294,179,115,178642,114770,293412
520590,201901,162,99,63,98802.98,62874,161676.98
520620,201901,1158,546,612,545907.96,610776,1156683.96
520630,201901,41,25,16,24950,15968,40918
520640,201901,406,232,174,231536,173652.98,405188.98
520650,201901,62,40,22,39920,21956,61876
520660,201901,35,19,16,18962.98,15968,34930.98
520670,201901,36,31,5,30938,4990,35928
520680,201901,55,36,19,35928,18962,54890
520690,201901,35,12,23,11976,22954.98,34930.98
520710,201901,38,34,4,33932,3992,37924
520725,201901,190,124,66,123752,65868,189620
520735,201901,59,41,18,40918,17964,58882
520740,201901,411,203,208,203592.3,207584.98,411177.28
520750,201901,36,28,8,27944,7984,35928
520753,201901,57,39,18,38922,17964,56886
520760,201901,119,81,38,80838,37924,118762
520780,201901,298,224,74,223552,73852.96,297404.96
520790,201901,158,80,78,80838,77844,158682
520800,201901,3432,1847,1585,1843309.15,1582828.88,3426138.03
520810,201901,172,126,46,125748,45908,171656
520815,201901,4,4,0,3992,,3992.0
520830,201901,149,105,44,104790,43912,148702
520840,201901,355,236,119,236526,119760,356286
520850,201901,110,72,38,71856.98,38922,110778.98
520860,201901,1708,1095,613,1092810.4,612772.4,1705582.8
520870,201901,31532,15449,16083,15424108.99,16061841.39,31485950.38
520880,201901,1109,602,507,600796.4,505986,1106782.4
520890,201901,799,471,328,470059.38,327344.8,797404.18
520910,201901,1024,548,476,546904.88,475048,1021952.88
520915,201901,101,76,25,75848,24950,100798
520920,201901,405,193,212,192614,211576,404190
520929,201901,16,15,1,14970,998,15968
520940,201901,75,49,26,48902,25948,74850
520945,201901,20,12,8,11976,7984,19960
520960,201901,49,31,18,30938,17964,48902
520970,201901,329,206,123,205588.98,122754,328342.98
520980,201901,86,66,20,65868,19960,85828
520990,201901,476,321,155,320358,154690,475048
520993,201901,123,58,65,57884,64870,122754
520995,201901,244,136,108,135728.66,107784.8,243513.46
521000,201901,1581,925,656,924148.6,656684.8,1580833.4
521010,201901,668,315,353,314374.12,352295.96,666670.08
521015,201901,18,11,7,10978,6986,17964
521020,201901,1464,1026,438,1023948.98,437126.36,1461075.34
521030,201901,49,34,15,33932,14970,48902
521040,201901,948,592,356,590816.9,356286.4,947103.3
521056,201901,41,30,11,29940,10978,40918
521060,201901,136,86,50,85828,49900,135728
521080,201901,464,350,114,349301.38,113772,463073.38
521090,201901,538,333,205,332334,205588,537922
521100,201901,276,208,68,207584.98,67864,275448.98
521120,201901,1041,735,306,734528.4,305388.98,1039917.38
521130,201901,364,263,101,262474,100801.34,363275.34
521140,201901,176,95,81,94810,80838,175648
521150,201901,2765,1207,1558,1206585.84,1554885.96,2761471.80
521160,201901,33,18,15,17964,14970,32934
521170,201901,195,113,82,112774,81836,194610
521180,201901,1149,732,417,730536.2,417164.9,1147701.1
521190,201901,2537,1073,1464,1071852,1462070,2533922
521200,201901,51,37,14,36926,13972,50898
521205,201901,12,9,3,8982,2994,11976
521210,201901,142,80,62,79840,61876,141716
521220,201901,818,562,256,561874,255488.9,817362.9
521225,201901,33,22,11,21956,10978,32934
521230,201901,111,76,35,75848,34930,110778
521250,201901,6190,3582,2608,3575836.46,2602785.98,6178622.44
521260,201901,23,15,8,14970,7984,22954
521270,201901,141,111,30,110778,29940,140718
521280,201901,437,258,179,257484,178642,436126
521290,201901,29,12,17,11976,16966,28942
521295,201901,100,68,32,67864,31936,99800
521300,201901,220,114,106,113773.96,105791.34,219565.30
521305,201901,35,24,11,23952,10978,34930
521308,201901,1085,808,277,806643.8,276447.38,1083091.18
521310,201901,1337,794,543,793414.9,541915.34,1335330.24
521340,201901,20,16,4,15968,3992,19960
521350,201901,131,97,34,96806,33932,130738
521370,201901,188,126,62,125748,62874,188622
521375,201901,184,101,83,100798,82834,183632
521377,201901,53,37,16,36926,15968,52894
521380,201901,1073,699,374,697603.72,374250,1071853.72
521385,201901,15,8,7,7984,6986,14970
521390,201901,101,81,20,80838,19960,100798
521400,201901,335,215,120,214570,119760,334330
521405,201901,145,78,67,77844,66866,144710
521410,201901,60,39,21,38922,20958,59880
521440,201901,197,142,55,141716,54890,196606
521450,201901,737,409,328,408182,327344,735526
521460,201901,1188,744,444,742512,443112,1185624
521470,201901,12,8,4,7984,3992,11976
521480,201901,45,31,14,30940.94,13974.86,44915.80
521483,201901,315,174,141,173652.4,140718,314370.4
521486,201901,293,188,105,187624,105788.6,293412.6
521487,201901,21,11,10,10978,9980,20958
521490,201901,25,14,11,13972,10978,24950
521500,201901,116,78,38,77844,37924,115768
521520,201901,41,29,12,28942,11976,40918
521523,201901,646,397,249,396206,248502,644708
521525,201901,46,30,16,29940,15968,45908
521530,201901,258,138,120,137724,119760,257484
521540,201901,30,16,14,15968,13972,29940
521550,201901,90,41,49,40921.34,48905.92,89827.26
521560,201901,803,555,248,553890.4,248502.7,802393.1
521565,201901,54,36,18,35928,17964,53892
521570,201901,502,331,171,330338,170658.9,500996.9
521580,201901,59,37,22,36926,21956,58882
521590,201901,37,20,17,19960,16966,36926
521600,201901,27,16,11,15968,10978,26946
521630,201901,244,131,113,130738,113775.44,244513.44
521640,201901,299,157,142,156686,141716,298402
521645,201901,28,15,13,14970,12974,27944
521680,201901,221,140,81,139720,80838,220558
521690,201901,2,2,0,1996,,1996.0
521710,201901,1165,561,604,559878,602792.98,1162670.98
521720,201901,549,377,172,376246,172654.94,548900.94
521730,201901,639,307,332,306386.8,331336.4,637723.2
521740,201901,898,369,529,368262.98,527945.34,896208.32
521760,201901,1652,916,736,914401.45,737524.34,1651925.79
521770,201901,823,524,299,522952,300398,823350
521800,201901,2035,1279,756,1276454.99,756493.8,2032948.79
521805,201901,33,20,13,19960,12974,32934
521810,201901,89,58,31,57884,30938,88822
521830,201901,948,676,272,675646.13,272454.98,948101.11
521839,201901,86,57,29,56886,28942,85828
521850,201901,1105,585,520,584832.99,518976.48,1103809.47
521860,201901,355,225,130,224550,129740,354290
521870,201901,75,44,31,43912,30938,74850
521878,201901,38,18,20,17964,19960,37924
521880,201901,4687,2112,2575,2107778.16,2569856.15,4677634.31
521890,201901,585,416,169,416166,168662,584828
521900,201901,294,236,58,235528,57884,293412
521910,201901,151,105,46,104790,45908,150698
521920,201901,52,26,26,25948,25948,51896
521925,201901,37,23,14,22954,13972,36926
521930,201901,1129,642,487,640723.84,487036.74,1127760.58
521935,201901,35,26,9,25948,8982,34930
521940,201901,193,100,93,99800,92814,192614
521945,201901,15,13,2,12974,1996,14970
521950,201901,9,5,4,4990,3992,8982
521960,201901,75,57,18,56886,17964,74850
521970,201901,415,268,147,268462,147704,416166
521971,201901,93,46,47,45908,46906,92814
521973,201901,30,15,15,14970,14970,29940
521975,201901,1229,638,591,636724.4,589818.7,1226543.1
521980,201901,248,172,76,171656,75848,247504
521990,201901,74,53,21,52894,20958,73852
522000,201901,289,186,103,185628,103792,289420
522005,201901,19,11,8,10978,7984,18962
522010,201901,1144,650,494,648700.98,494010,1142710.98
522015,201901,58,38,20,37924.98,19960,57884.98
522020,201901,877,488,389,487024.4,388222.8,875247.2
522026,201901,29,20,9,19960,8982,28942
522028,201901,15,11,4,10978,3992,14970
522040,201901,757,300,457,301397.96,457088.9,758486.86
522045,201901,2298,1428,870,1425145.69,868261.48,2293407.17
522050,201901,165,81,84,81836,83832,165668
522060,201901,546,352,194,351296,194610,545906
522068,201901,129,88,41,87824,40918,128742
522070,201901,10,10,0,9980,,9980.0
522100,201901,44,25,19,24950,18962,43912
522108,201901,40,31,9,30938,8982,39920
522119,201901,57,31,26,30938,25948,56886
522130,201901,78,32,46,31936.98,45909.96,77846.94
522140,201901,3841,1939,1902,1935123.32,1899195.76,3834319.08
522145,201901,52,33,19,32934,18962,51896
522150,201901,62,47,15,46906,14970,61876
522155,201901,52,34,18,33932.98,17964,51896.98
522157,201901,4,3,1,2994,998,3992
522160,201901,1734,1028,706,1026942,705586.98,1732528.98
522170,201901,399,268,131,267464,130738,398202
522180,201901,38,20,18,19960,17964,37924
522185,201901,1970,773,1197,772453.78,1194606.99,1967060.77
522190,201901,45,26,19,25948,18962,44910
522200,201901,304,184,120,183632,119760,303392
522205,201901,159,109,50,108782,49900,158682
522220,201901,160,115,45,114770,44910,159680
522230,201901,32,27,5,26946,4990,31936
530010,201901,55083,28413,26670,28373209.74,26648651.56,55021861.30
110001,201902,518,411,107,410178,106786,516964
110002,201902,2777,1711,1066,1707579.38,1064867.36,2772446.74
110003,201902,91,76,15,75848.18,14970,90818.18
110004,201902,2010,1308,702,1305386.36,700596,2005982.36
110005,201902,440,357,83,356286.4,82834,439120.4
110006,201902,453,349,104,348302,103792,452094
110007,201902,77,63,14,62874,13972,76846
110008,201902,234,134,100,133732,99800,233532
110009,201902,819,575,244,573851.15,243513.58,817364.73
110010,201902,1794,1109,685,1106783.96,684631.44,1791415.40
110011,201902,1855,1440,415,1437120.1,415168,1852288.1
110012,201902,4161,2427,1734,2422146.8,1730534.36,4152681.16
110013,201902,766,594,172,592812,171656,764468
110014,201902,371,318,53,317364.4,52894,370258.4
110015,201902,1423,1153,270,1151693.13,269460,1421153.13
110018,201902,1119,691,428,689618.34,427145.98,1116764.32
110020,201902,15593,9147,6446,9129745.93,6433162.14,15562908.07
110025,201902,649,478,171,477044.4,170658.98,647703.38
110026,201902,39,28,11,27944,10978,38922
110028,201902,1645,1194,451,1191614.06,450099.2,1641713.26
110029,201902,140,126,14,125748,13972,139720
110030,201902,2448,1662,786,1658519.1,785427.8,2443946.9
110032,201902,393,310,83,309381.35,82834.99,392216.34
110033,201902,673,502,171,500996.8,170658,671654.8
110034,201902,368,271,97,270459.15,96806,367265.15
110037,201902,105,88,17,87824,16966,104790
110040,201902,360,246,114,245508,113772,359280
110045,201902,953,649,304,647703.2,303392.64,951095.84
110050,201902,93,80,13,79840.4,12974,92814.4
110060,201902,85,48,37,47904,36926,84830
110070,201902,115,71,44,70858,44910.4,115768.4
110080,201902,410,244,166,243512,166666,410178
110090,201902,34,28,6,27944,5988,33932
110092,201902,102,56,46,55888,45908,101796
110094,201902,197,143,54,142714,53892,196606
110100,201902,30,25,5,24950,4990,29940
110110,201902,65,39,26,38922,25948,64870
110120,201902,71,60,11,59880,10978,70858
110130,201902,302,247,55,247504.4,54890,302394.4
110140,201902,244,164,80,163672,79840,243512
110143,201902,50,41,9,40918,8982,49900
110145,201902,25,18,7,17964,6986,24950
110146,201902,23,12,11,11976,10978,22954
110147,201902,40,30,10,29940,9980,39920
110148,201902,37,26,11,25948,10978,36926
110149,201902,316,225,91,224550,90818,315368
110150,201902,93,66,27,65868,26946,92814
110155,201902,7,6,1,5988,998,6986
110160,201902,67,56,11,55888,10978,66866
110170,201902,202,162,40,161676,39920,201596
110175,201902,53,39,14,38922,13972,52894
110180,201902,96,83,13,82834,12974,95808
120001,201902,144,99,45,98802,44911.98,143713.98
120005,201902,195,121,74,120758,73852,194610
120010,201902,1043,668,375,666665.27,374250.98,1040916.25
120013,201902,146,100,46,99800,45908,145708
120017,201902,94,57,37,56886,36926,93812
120020,201902,3587,2876,711,2870249.83,710576,3580825.83
120025,201902,573,328,245,327344.98,244510,571854.98
120030,201902,1056,889,167,887223,166666,1053889
120032,201902,49,42,7,41916,6986,48902
120033,201902,220,193,27,192614,26946,219560
120034,201902,165,119,46,118762,45908,164670
120035,201902,37,28,9,27944,8982,36926
120038,201902,395,253,142,252494,141716,394210
120039,201902,25,24,1,23952,998,24950
120040,201902,14086,9734,4352,9717887.43,4345314.49,14063201.92
120042,201902,46,41,5,40918,4990,45908
120043,201902,11,3,8,2994,8982,11976
120045,201902,547,355,192,354290.98,191617.95,545908.93
120050,201902,1268,973,295,972053.68,294410,1266463.68
120060,201902,1451,1184,267,1181632,266466,1448098
120070,201902,495,355,140,354291.2,140718,495009.2
120080,201902,168,105,63,104790,62874,167664
130002,201902,148,106,42,105788,41916,147704
130006,201902,76,44,32,43912,31936,75848
130008,201902,142,75,67,74850,66866,141716
130010,201902,144,80,64,79840,63872,143712
130014,201902,254,185,69,184630,68862,253492
130020,201902,94,53,41,52894,40918,93812
130030,201902,927,551,376,549898,375248,925146
130040,201902,310,159,151,158682,150698.36,309380.36
130050,201902,593,318,275,317364,274450,591814
130060,201902,878,599,279,598800,279440,878240
130063,201902,578,324,254,323352,253492,576844
130068,201902,186,122,64,121756,63872,185628
130070,201902,1323,912,411,910176,410178,1320354
130080,201902,686,452,234,451096,233532.98,684628.98
130083,201902,72,40,32,39920,31936,71856
130090,201902,367,187,180,186626,179640,366266
130100,201902,1128,506,622,504988,620756,1125744
130110,201902,712,306,406,305388,406186,711574
130115,201902,173,72,101,71856,100798,172654
130120,201902,1626,1039,587,1036922,586824,1623746
130130,201902,608,422,186,421156,185628,606784
130140,201902,1522,1155,367,1152690,366266.4,1518956.4
130150,201902,420,362,58,361276,57884,419160
130160,201902,466,269,197,268462,197604,466066
130165,201902,26,19,7,18962,6986,25948
130170,201902,976,699,277,697538.12,276446,973984.12
130180,201902,147,88,59,87824,58882,146706
130185,201902,2417,1173,1244,1170654,1242510.8,2413164.8
130190,201902,3560,2251,1309,2246499.28,1306382,3552881.28
130195,201902,286,230,56,229540,55888,285428
130200,201902,172,82,90,81836,89820,171656
130210,201902,78,40,38,39920,37924,77844
130220,201902,179,124,55,123752,54890,178642
130230,201902,328,207,121,206586,120758,327344
130240,201902,1413,897,516,895206.99,514968,1410174.99
130250,201902,4831,3124,1707,3118750.4,1703586,4822336.4
130255,201902,432,212,220,211576,219560,431136
130260,201902,54977,26590,28387,26540739.73,28344202.75,54884942.48
130270,201902,1593,1060,533,1057969.82,531934,1589903.82
130280,201902,119,73,46,72854,45908,118762
130290,201902,2127,1527,600,1523946,598800,2122746
130300,201902,438,313,125,312374,124750,437124
130310,201902,881,461,420,460078,419160,879238
130320,201902,462,250,212,249500,211576,461076
130330,201902,737,453,284,452094,283432,735526
130340,201902,3456,2044,1412,2039912.8,1409176.8,3449089.6
130350,201902,460,296,164,295408,163672,459080
130353,201902,839,354,485,353292.4,484030,837322.4
130356,201902,823,377,446,376246,445108,821354
130360,201902,65,41,24,40918,23952,64870
130370,201902,676,510,166,508980,165668,674648
130380,201902,677,495,182,494010,181636.73,675646.73
130390,201902,491,392,99,391216,98802,490018
130395,201902,176,39,137,38922,136726,175648
130400,201902,66,45,21,44910,20958,65868
130406,201902,2064,1289,775,1287420.8,775447.28,2062868.08
130410,201902,470,205,265,204590,264470,469060
130420,201902,3166,2571,595,2565858.8,593810,3159668.8
130423,201902,158,76,82,75848,81836,157684
130426,201902,151,86,65,86826,64870,151696
130430,201902,405,265,140,264470,139720,404190
130440,201902,201,69,132,68862,131736,200598
140002,201902,35,12,23,11976,22954,34930
140005,201902,205,127,78,126746,77844,204590
140010,201902,10522,7020,3502,7008966.44,3494999.64,10503966.08
140015,201902,143,66,77,65868,76846,142714
140017,201902,121,84,37,83832,36926,120758
140020,201902,469,316,153,315368,152694,468062
140023,201902,42,21,21,20958.54,20958,41916.54
140028,201902,18,11,7,10978,6986,17964
140030,201902,351,252,99,251496,98802,350298
140040,201902,55,38,17,37924,16966,54890
140045,201902,245,109,136,108782,135728,244510
140047,201902,627,431,196,430138,195608,625746
140050,201902,145,93,52,92814,51896,144710
140060,201902,41,30,11,29940,10978,40918
140070,201902,33,30,3,29940,2994,32934
150010,201902,4715,2964,1751,2958072,1747498.4,4705570.4
150013,201902,158,111,47,110778,46906,157684
150020,201902,1066,585,481,583830,480038,1063868
150030,201902,711,294,417,293412,416166,709578
150034,201902,195,130,65,129740,65868,195608
150040,201902,1421,854,567,852292,565866,1418158
150050,201902,644,379,265,378242,264470,642712
150060,201902,4748,3083,1665,3077749.68,1665662.98,4743412.66
150070,201902,314,143,171,142714,170658,313372
150080,201902,14292,7182,7110,7183613.25,7115752.29,14299365.54
150085,201902,408,260,148,259480,147704,407184
150090,201902,751,642,109,640716,108782,749498
150095,201902,346,217,129,216566,128742,345308
150100,201902,58,39,19,38922,18962,57884
150110,201902,175,87,88,86826,87824,174650
150120,201902,427,314,113,313372,112774,426146
150125,201902,54,22,32,21956,31936,53892
150130,201902,1955,1059,896,1056882,896204,1953086
150140,201902,54253,25473,28780,25464981.07,28800308.79,54265289.86
150145,201902,187,104,83,103792,82834,186626
150150,201902,2818,1297,1521,1294406,1520952.8,2815358.8
150157,201902,417,295,122,294410,121756,416166
150160,201902,124,96,28,95808,27944,123752
150170,201902,3686,2750,936,2744500,934128,3678628
150172,201902,328,223,105,222554,104790,327344
150175,201902,79,49,30,48902,30938,79840
150178,201902,782,520,262,518960,261476,780436
150180,201902,3111,1521,1590,1517958.5,1586820.4,3104778.9
150190,201902,333,215,118,214570,117764,332334
150195,201902,122,62,60,61876,59880,121756
150200,201902,201,98,103,97804,102794,200598
150210,201902,3156,2572,584,2566856,585826.99,3152682.99
150215,201902,537,349,188,348302,187624.4,535926.4
150220,201902,3781,2576,1205,2571847.52,1202591.4,3774438.92
150230,201902,1157,935,222,933130.45,221556,1154686.45
150240,201902,5942,3500,2442,3494998.49,2438114.98,5933113.47
150250,201902,33,16,17,15968,16966,32934
150260,201902,78,47,31,46906,30938,77844
150270,201902,2328,1518,810,1514964,809378.8,2324342.8
150275,201902,550,344,206,343312,205588,548900
150276,201902,108,49,59,48902,58882,107784
150277,201902,764,330,434,329340.98,434130,763470.98
150280,201902,333,211,122,210578,121756,332334
150285,201902,86,43,43,42914,42914,85828
150290,201902,956,587,369,585826,369260.4,955086.4
150293,201902,656,313,343,312374,342314,654688
150295,201902,473,215,258,214570,257484,472054
150300,201902,76,40,36,39920,35928,75848
150304,201902,164,108,56,107784,55888,163672
150307,201902,389,324,65,323352,64870,388222
150309,201902,571,418,153,417164.98,152697.6,569862.58
150310,201902,251,169,82,168662,81836,250498
150320,201902,1737,1206,531,1203588,530936,1734524
150330,201902,2087,1208,879,1206582,878240,2084822
150340,201902,201,135,66,134730,65868,200598
150345,201902,611,341,270,341316,270458,611774
150350,201902,407,321,86,320358,85828,406186
150360,201902,4591,2963,1628,2958073.49,1628736,4586809.49
150370,201902,782,551,231,549898.98,230538.98,780437.96
150375,201902,195,101,94,100798,93812,194610
150380,201902,1405,953,452,951094.98,451096,1402190.98
150390,201902,742,429,313,428142.99,312374,740516.99
150400,201902,103,86,17,85828,16966,102794
150405,201902,1255,820,435,819358.92,435128,1254486.92
150410,201902,129,86,43,85828,42914,128742
150420,201902,7422,4086,3336,4079000.18,3330371.88,7409372.06
150430,201902,543,359,184,358282,183632,541914
150440,201902,571,344,227,343312,226546,569858
150442,201902,2225,1201,1024,1198598.58,1025944,2224542.58
150445,201902,519,334,185,333332,185628,518960
150450,201902,250,122,128,121756,127744,249500
150460,201902,745,566,179,564868.4,178642,743510.4
150470,201902,1331,810,521,808380,519958,1328338
150475,201902,222,175,47,174650,46906,221556
150480,201902,1270,893,377,891214,376246,1267460
150490,201902,603,329,274,328342,273452,601794
150495,201902,329,237,92,236526,91816,328342
150497,201902,302,203,99,202594,98802,301396
150500,201902,420,292,128,291416,127744,419160
150503,201902,902,451,451,450098.4,450100.36,900198.76
150506,201902,997,656,341,654688,340318,995006
150510,201902,1229,703,526,701594.4,524948,1226542.4
150520,201902,272,183,89,182634,88822,271456
150530,201902,1606,887,719,885226.5,717562,1602788.5
150540,201902,238,167,71,166666,70858,237524
150543,201902,761,425,336,425148,335328,760476
150548,201902,494,346,148,345308,147704,493012
150549,201902,60,43,17,42914,16966,59880
150550,201902,2859,1512,1347,1508976.5,1345304.4,2854280.9
150553,201902,3201,1903,1298,1899194.8,1297400,3196594.8
150555,201902,145,79,66,78842,65868,144710
150560,201902,61,45,16,44910,15968,60878
150563,201902,83,43,40,42914,39920,82834
150565,201902,170,104,66,103792,66866,170658
150570,201902,412,277,135,276446,135728,412174
150580,201902,1584,720,864,718560,863270,1581830
150590,201902,792,507,285,505986,285428,791414
150600,201902,458,282,176,281436,175648,457084
150610,201902,141,121,20,120758,19960,140718
150611,201902,121,84,37,83832,36926,120758
150613,201902,3203,1976,1227,1973046,1224546.98,3197592.98
150616,201902,497,299,198,298402.5,197604,496006.5
150618,201902,1251,680,571,678640.98,570856,1249496.98
150619,201902,402,308,94,307384,93812,401196
150620,201902,1270,751,519,749498,517962.99,1267460.99
150630,201902,300,196,104,195608,104790,300398
150635,201902,491,214,277,213572,278442,492014
150640,201902,57,28,29,27944,28942,56886
150650,201902,2368,1394,974,1391462.4,972053.39,2363515.79
150655,201902,246,182,64,182634,64870,247504
150658,201902,102,58,44,57884,43912,101796
150660,201902,495,347,148,346306,147704,494010
150670,201902,1023,378,645,377244.98,643710.98,1020955.96
150680,201902,9661,5297,4364,5287406.01,4359265.96,9646671.97
150690,201902,56,35,21,34930,20958,55888
150700,201902,502,332,170,331336,169660,500996
150710,201902,282,165,117,164670,116766,281436
150715,201902,842,516,326,514968.98,325348,840316.98
150720,201902,420,329,91,329340,90818,420158
150730,201902,962,522,440,520956.98,440118,961074.98
150740,201902,219,153,66,152694,65868,218562
150745,201902,804,445,359,444110,358282,802392
150746,201902,51,30,21,29940,20958,50898
150747,201902,261,203,58,202594,57884,260478
150750,201902,132,76,56,75848,55888,131736
150760,201902,1752,1151,601,1148698,599798,1748496
150770,201902,377,204,173,204590,172654,377244
150775,201902,96,45,51,44910,50898,95808
150780,201902,195,108,87,107784,87824,195608
150790,201902,855,470,385,469060,384230,853290
150795,201902,1496,883,613,881234,611774,1493008
150796,201902,378,220,158,219560,157684,377244
150797,201902,288,161,127,160678,126746,287424
150800,201902,1432,864,568,863270,566864.97,1430134.97
150803,201902,587,483,104,482034,103792,585826
150805,201902,191,121,70,120758,69860.99,190618.99
150808,201902,1014,561,453,559878,454090,1013968
150810,201902,3372,2342,1030,2338315.81,1029936.4,3368252.21
150812,201902,442,241,201,240518,200598,441116
150815,201902,968,643,325,641714,326346,968060
150820,201902,1559,949,610,947102,609778,1556880
150830,201902,802,576,226,574848,226546,801394
150835,201902,193,117,76,116766,75848,192614
150840,201902,1347,869,478,867262.6,477044,1344306.6
160005,201902,52,31,21,30938,20958,51896
160010,201902,191,121,70,120758,69860.99,190618.99
160015,201902,116,69,47,68862,47904,116766
160020,201902,133,77,56,76846,55888,132734
160021,201902,41,21,20,20958,19960,40918
160023,201902,119,73,46,73852,45908,119760
160025,201902,29,13,16,12974,15968,28942
160027,201902,1497,859,638,858280.5,637722,1496002.5
160030,201902,15642,8133,7509,8120736.68,7494990.05,15615726.73
160040,201902,299,176,123,175648,122754,298402
160050,201902,710,364,346,363272,345308,708580
160053,201902,323,187,136,186626.4,135728,322354.4
160055,201902,30,22,8,21956,7984,29940
160060,201902,6506,3458,3048,3452083.99,3042903.39,6494987.38
160070,201902,171,106,65,105788,64870,170658
160080,201902,87,45,42,44910,41916,86826
170025,201902,25,14,11,13972,10978,24950
170030,201902,224,183,41,182634.88,40918,223552.88
170035,201902,225,106,119,105788,118762,224550
170040,201902,180,138,42,137724,41916,179640
170070,201902,326,199,127,199600,126746,326346
170100,201902,363,265,98,264470,97804,362274
170105,201902,59,48,11,47904,10978,58882
170110,201902,112,71,41,70858,40918,111776
170130,201902,64,32,32,31936,31936.4,63872.4
170190,201902,98,65,33,64870,32934,97804
170200,201902,391,264,127,263472.98,127744.9,391217.88
170210,201902,5988,3160,2828,3153682.9,2823344.58,5977027.48
170215,201902,105,48,57,47904,56886,104790
170220,201902,1414,1040,374,1037920,373252.4,1411172.4
170230,201902,152,102,50,101796,49900,151696
170240,201902,532,354,178,353292.8,177644,530936.8
170255,201902,1110,896,214,894208,214570,1108778
170270,201902,40,29,11,28942,10978,39920
170290,201902,101,75,26,74850,25948,100798
170300,201902,85,57,28,56886,27944,84830
170305,201902,49,38,11,37924,10978,48902
170307,201902,63,47,16,46906,15968,62874
170310,201902,107,60,47,59880,46906,106786
170320,201902,22,18,4,17964,3992,21956
170330,201902,24,22,2,21956,1996,23952
170360,201902,27,16,11,15968,10978,26946
170370,201902,121,64,57,63872,56886,120758
170380,201902,82,63,19,62874,18962,81836
170382,201902,44,39,5,38922,4990,43912
170384,201902,140,106,34,105788,33932,139720
170386,201902,63,27,36,26946,35928,62874
170388,201902,50,20,30,19960,29940,49900
170389,201902,26,21,5,20958,4990,25948
170390,201902,58,35,23,34930.98,22954,57884.98
170410,201902,32,23,9,22954,8982,31936
170460,201902,17,13,4,12974,3992,16966
170510,201902,34,27,7,26946,6986,33932
170550,201902,1527,889,638,888220,637722,1525942
170555,201902,112,80,32,79840,31936,111776
170560,201902,94,70,24,69860,23952,93812
170600,201902,37,18,19,17964,18962,36926
170610,201902,192,102,90,101796,89822.36,191618.36
170625,201902,36,19,17,18962,16966,35928
170650,201902,76,58,18,57884,17964,75848
170700,201902,568,432,136,431136.5,135728,566864.5
170710,201902,161,98,63,97804,62875.96,160679.96
170720,201902,85,68,17,67864,16966,84830
170730,201902,73,44,29,43912,28942,72854
170740,201902,87,65,22,64870,21956,86826
170755,201902,65,35,30,34930,29940,64870
170765,201902,135,69,66,68862.4,65868,134730.4
170770,201902,224,135,89,134730,88822,223552
170820,201902,601,396,205,395208,204590.4,599798.4
170825,201902,33,19,14,18962,13972,32934
170830,201902,85,66,19,65868,18962,84830
170900,201902,193,150,43,149700,42914,192614
170930,201902,861,460,401,459080,401196.4,860276.4
170950,201902,3075,1376,1699,1373249.38,1696602.05,3069851.43
170980,201902,16,9,7,8982,6986,15968
171050,201902,145,114,31,113772,30938,144710
171070,201902,38,32,6,31936,5988,37924
171090,201902,45,34,11,33932,10978,44910
171110,201902,20,13,7,12974,6986,19960
171150,201902,44,23,21,22954,20958,43912
171180,201902,24,12,12,11976,11976,23952
171190,201902,151,86,65,85828,64870,150698
171195,201902,63,51,12,50898,11976,62874
171200,201902,50,25,25,24950,24950,49900
171215,201902,4,3,1,2994,998,3992
171240,201902,56,45,11,44910,10978,55888
171245,201902,56,51,5,50898,4990,55888
171250,201902,71,39,32,38922,31936,70858
171270,201902,16,12,4,11976,3992,15968
171280,201902,40,36,4,35928.7,3992,39920.7
171320,201902,984,571,413,569858,413172,983030
171330,201902,427,210,217,209580,217564,427144
171360,201902,91,65,26,64870,25948,90818
171370,201902,28,15,13,14970,12974,27944
171380,201902,134,110,24,109780,23952,133732
171395,201902,55,35,20,34930,19960,54890
171420,201902,301,198,103,197604,102794,300398
171430,201902,66,54,12,53892,11976,65868
171488,201902,191,104,87,103792,86826,190618
171500,201902,57,32,25,31936,24950,56886
171510,201902,68,45,23,44910,22954,67864
171515,201902,42,35,7,34930,6986.4,41916.4
171525,201902,31,27,4,26946,3992,30938
171550,201902,11,8,3,7984,2994,10978
171570,201902,59,31,28,30938,27944,58882
171575,201902,329,210,119,209580,118762,328342
171610,201902,1726,873,853,873256.84,852302.78,1725559.62
171620,201902,134,95,39,94810,38922,133732
171630,201902,55,28,27,27944,26946,54890
171650,201902,269,180,89,179640,88822,268462
171660,201902,270,148,122,147704,121757.39,269461.39
171665,201902,54,38,16,37924,15968,53892
171670,201902,430,248,182,247504.5,181636,429140.5
171700,201902,68,61,7,60878,6986,67864
171720,201902,25,10,15,9980,14970,24950
171750,201902,102,55,47,54890,46906,101796
171780,201902,78,62,16,61876,15968,77844
171790,201902,77,66,11,65868,10978,76846
171800,201902,37,29,8,28942,7984,36926
171820,201902,2078,1199,879,1196602.5,878240.98,2074843.48
171830,201902,34,27,7,26946,6986,33932
171840,201902,64,40,24,39920,23952,63872
171845,201902,32,20,12,19960,11976,31936
171850,201902,40,30,10,29940,9980,39920
171855,201902,78,62,16,61876,15968,77844
171865,201902,10,8,2,7984,1996,9980
171870,201902,32,23,9,22954,8982,31936
171875,201902,80,56,24,55888,23952,79840
171880,201902,31,21,10,20958,9980,30938
171884,201902,46,23,23,22954,22954,45908
171886,201902,120,46,74,46906,73852,120758
171888,201902,27,21,6,20958,5988,26946
171889,201902,18,14,4,13972,3992,17964
171890,201902,57,47,10,46906,9980,56886
171900,201902,43,30,13,29940,12974,42914
172000,201902,41,34,7,33932,6986,40918
172010,201902,43,35,8,34930,7984,42914
172015,201902,26,16,10,15968.58,9980,25948.58
172020,201902,139,90,49,89820,48902,138722
172025,201902,32,21,11,20958,10978,31936
172030,201902,40,24,16,23952,15968,39920
172049,201902,77,49,28,48902,27944,76846
172065,201902,150,98,52,97804,51896,149700
172080,201902,96,64,32,63872,31936,95808
172085,201902,24,12,12,11976,11976,23952
172090,201902,418,327,91,326346,90818,417164
172093,201902,26,20,6,19960,5988,25948
172097,201902,17,9,8,8982,7984.4,16966.4
172100,201902,4876,2774,2102,2770450.84,2099794.93,4870245.77
172110,201902,82,56,26,55888,25948,81836
172120,201902,1676,1436,240,1433129.5,239520.96,1672650.46
172125,201902,3,3,0,2994,,2994.0
172130,201902,17,13,4,12974,3992,16966
172208,201902,194,123,71,122754,70858,193612
172210,201902,394,195,199,194610,198602.4,393212.4
210005,201902,2927,1837,1090,1833326.75,1087824,2921150.75
210010,201902,181,93,88,92814,87824,180638
210015,201902,37,27,10,26946,9980,36926
210020,201902,350,190,160,189620,159680,349300
210030,201902,341,217,124,216566,123752.98,340318.98
210040,201902,142,111,31,110778,30938,141716
210043,201902,264,192,72,191616,71856,263472
210047,201902,586,325,261,324350,260478,584828
210050,201902,295,218,77,217564,76846,294410
210055,201902,44,33,11,32934,10978,43912
210060,201902,558,443,115,442114,114770,556884
210070,201902,417,314,103,313372,102794,416166
210080,201902,112,101,11,100798,10978,111776
210083,201902,304,144,160,143712,159680,303392
210087,201902,40,30,10,29940,9980,39920
210090,201902,476,334,142,333332,141716,475048
210095,201902,472,352,120,351296,119760,471056
210100,201902,698,540,158,538920,157684,696604
210110,201902,144,83,61,82834,60878,143712
210120,201902,5367,4118,1249,4110770.12,1247501.53,5358271.65
210125,201902,208,123,85,122754,84830,207584
210130,201902,515,285,230,284430,229540,513970
210135,201902,32,19,13,18962,12974,31936
210140,201902,4396,3454,942,3448090.6,940116,4388206.6
210150,201902,377,241,136,240518,135728,376246
210160,201902,3401,2872,529,2868252.55,527942,3396194.55
210170,201902,1174,931,243,929138,242514,1171652
210173,201902,130,111,19,110778,18962,129740
210177,201902,429,220,209,219560,208582,428142
210180,201902,33,18,15,17964,14970,32934
210190,201902,417,276,141,275448,140718,416166
210193,201902,1,1,0,998,,998.0
210197,201902,78,54,24,53892,23952,77844
210200,201902,644,516,128,514968.71,127744,642712.71
210203,201902,254,172,82,171656,81836,253492
210207,201902,388,306,82,305388,81836,387224
210210,201902,778,718,60,717562,60878,778440
210215,201902,77,67,10,66866,9980,76846
210220,201902,403,335,68,334330,67864,402194
210230,201902,303,237,66,236526,65868,302394
210232,201902,1464,955,509,953090,507982,1461072
210235,201902,157,124,33,123752.6,32934,156686.6
210237,201902,43,25,18,24950,17964,42914
210240,201902,90,75,15,74850,14970,89820
210250,201902,184,151,33,150698,32934,183632
210255,201902,358,268,90,267464,89820,357284
210260,201902,414,270,144,269460,143712,413172
210270,201902,682,441,241,440118,240518,680636
210275,201902,57,44,13,43912,12974,56886
210280,201902,1065,691,374,689618.48,373252,1062870.48
210290,201902,513,343,170,343312,169660,512972
210300,201902,5858,3537,2321,3529926.39,2316358.97,5846285.36
210310,201902,111,77,34,76846,33932,110778
210312,201902,118,80,38,79840,37924,117764
210315,201902,116,89,27,88822,26946,115768
210317,201902,123,91,32,90818,31936,122754
210320,201902,2374,1982,392,1978036.96,392214,2370250.96
210325,201902,131,92,39,91816,38922.4,130738.4
210330,201902,5177,2805,2372,2799390.7,2367256,5166646.7
210340,201902,1339,973,366,971054.96,366267.94,1337322.90
210350,201902,626,521,105,519958,105788,625746
210355,201902,147,120,27,119760,26946,146706
210360,201902,2557,1650,907,1646700.06,906184.4,2552884.46
210370,201902,1251,570,681,568860,679638,1248498
210375,201902,191,99,92,98802,91816,190618
210380,201902,722,546,176,544908,175648,720556
210390,201902,201,168,33,167664,32934,200598
210400,201902,425,364,61,363272,60878.96,424150.96
210405,201902,1015,696,319,694608,318362,1012970
210407,201902,54,43,11,42914,10978,53892
210408,201902,64,57,7,56886,6986,63872
210409,201902,331,280,51,279440,50898,330338
210410,201902,443,346,97,346306,96806.98,443112.98
210420,201902,201,166,35,165668,34930,200598
210430,201902,41,28,13,27944,12974,40918
210440,201902,357,227,130,226546,129740,356286
210450,201902,156,121,35,120758,34930,155688
210455,201902,227,126,101,125748,100798,226546
210460,201902,337,215,122,214570,121756,336326
210462,201902,69,57,12,56886,11976,68862
210465,201902,166,120,46,119760,45908,165668
210467,201902,535,386,149,385228,148702,533930
210470,201902,44,37,7,36926,6986,43912
210480,201902,1310,926,384,925146,383232,1308378
210490,201902,212,135,77,134730,76846,211576
210500,201902,564,316,248,315368,248502,563870
210510,201902,571,451,120,450098,119760,569858
210515,201902,423,243,180,242514,179640,422154
210520,201902,416,363,53,362274,52894,415168
210530,201902,9405,5052,4353,5044895.52,4345296.6,9390192.12
210535,201902,128,94,34,93812,33932,127744
210540,201902,1533,968,565,966064.2,563870,1529934.2
210542,201902,1212,601,611,599798,609778.4,1209576.4
210545,201902,15,14,1,13972,998,14970
210547,201902,133,114,19,113772,18962,132734
210550,201902,727,519,208,517963.4,207584,725547.4
210560,201902,176,149,27,148702,26946,175648
210565,201902,30,22,8,21956,7984,29940
210570,201902,1349,1072,277,1069856.44,276446,1346302.44
210580,201902,113,98,15,97804,14970,112774
210590,201902,776,625,151,623750,150698,774448
210592,201902,33,29,4,28942,3992,32934
210594,201902,105,86,19,85828,18962,104790
210596,201902,96,81,15,80838,14970,95808
210598,201902,129,95,34,94810,33932,128742
210600,201902,337,287,50,286426,49900,336326
210610,201902,258,239,19,238522,18962,257484
210620,201902,45,27,18,26946,17964,44910
210630,201902,68,65,3,64870,2994,67864
210632,201902,1062,724,338,722552,337324,1059876
210635,201902,20,17,3,16966,2994,19960
210637,201902,101,71,30,70858,29940,100798
210640,201902,589,516,73,514968,72854,587822
210650,201902,414,341,73,341316,72854,414170
210660,201902,398,296,102,295408,101796,397204
210663,201902,24,15,9,14970,8982,23952
210667,201902,111,35,76,34930,75848,110778
210670,201902,267,235,32,234530,31936,266466
210675,201902,561,300,261,299400,260478,559878
210680,201902,216,140,76,139720,75848,215568
210690,201902,640,517,123,515966,122754,638720
210700,201902,182,135,47,134730,46906,181636
210710,201902,282,166,116,165668,115768,281436
210720,201902,133,117,16,116766,15968,132734
210725,201902,68,60,8,59880,7984,67864
210730,201902,25,18,7,17964,6986,24950
210735,201902,401,277,124,276446,123752.4,400198.4
210740,201902,561,475,86,474050,85828,559878
210745,201902,155,115,40,114770,39920,154690
210750,201902,2432,1166,1266,1163668.5,1264466.4,2428134.9
210760,201902,264,198,66,197604,65868,263472
210770,201902,404,315,89,314370,88822,403192
210780,201902,424,311,113,310378,112774,423152
210790,201902,189,146,43,145708,42914,188622
210800,201902,163,121,42,120758,41916,162674
210805,201902,51,47,4,46906,3992,50898
210810,201902,488,383,105,382234,104790,487024
210820,201902,2317,1868,449,1864265.76,448102,2312367.76
210825,201902,167,89,78,88822,77844,166666
210830,201902,774,495,279,495008,278442,773450
210840,201902,206,140,66,140718,65868,206586
210845,201902,257,169,88,168662,87824,256486
210850,201902,817,535,282,533930,281436,815366
210860,201902,4025,2155,1870,2151688.9,1869254,4020942.9
210870,201902,479,366,113,365268,112774,478042
210880,201902,69,52,17,51896,16966,68862
210890,201902,347,295,52,294410,51896,346306
210900,201902,606,391,215,390218,215568,605786
210905,201902,66,33,33,32934,32934,65868
210910,201902,2016,1506,510,1502988.88,508980,2011968.88
210920,201902,202,67,135,66866,135728,202594
210923,201902,80,57,23,56886,22954,79840
210927,201902,427,187,240,186626,239520,426146
210930,201902,71,56,15,55888,14970,70858
210940,201902,92,73,19,72854,18962,91816
210945,201902,201,97,104,96806,103792,200598
210950,201902,524,387,137,386226,137724,523950
210955,201902,74,48,26,48902,25948,74850
210960,201902,2349,1077,1272,1074846,1270454,2345300
210970,201902,116,102,14,101796,13972,115768
210975,201902,91,82,9,81836,8982,90818
210980,201902,1164,529,635,527942,633730.4,1161672.4
210990,201902,4275,2705,1570,2700589,1566860,4267449
211000,201902,1370,1095,275,1092810.4,274450,1367260.4
211003,201902,900,625,275,623750,274450.98,898200.98
211010,201902,498,441,57,440118,56886,497004
211020,201902,1585,605,980,603790,979038,1582828
211023,201902,32,27,5,26946,4990,31936
211027,201902,72,50,22,49900,21956,71856
211030,201902,391,268,123,267464,122754,390218
211040,201902,319,256,63,255488.4,62874,318362.4
211050,201902,1179,771,408,769458,407184.4,1176642.4
211060,201902,681,581,100,579838.96,99800,679638.96
211065,201902,21,17,4,16966,3992,20958
211070,201902,931,764,167,762472.66,166666,929138.66
211080,201902,89,85,4,84830,3992,88822
211085,201902,60,31,29,30938.4,28942,59880.4
211090,201902,92,74,18,73852,17964,91816
211100,201902,499,402,97,401196,96806,498002
211102,201902,263,178,85,177644,84830,262474
211105,201902,222,156,66,155688,65868,221556
211107,201902,132,78,54,77844,53892,131736
211110,201902,845,556,289,554888,288422.98,843310.98
211120,201902,5755,2673,3082,2668654.6,3077833.72,5746488.32
211125,201902,34,27,7,26946,6986,33932
211130,201902,44979,19576,25403,19544842.62,25361183.53,44906026.15
211140,201902,433,370,63,369260.99,62874,432134.99
211150,201902,1298,830,468,828340,467065.39,1295405.39
211153,201902,166,98,68,97804,67864,165668
211157,201902,64,50,14,49900,13972,63872
211160,201902,719,604,115,602792,114770,717562
211163,201902,0,0,0,0,0,0
211167,201902,10,9,1,8982,998,9980
211170,201902,442,315,127,314370,126746,441116
211172,201902,122,86,36,85828,35928,121756
211174,201902,267,162,105,161676,104790,266466
211176,201902,503,369,134,368262,133732,501994
211178,201902,95,63,32,62874,31936,94810
211180,201902,209,166,43,165668,42914,208582
211190,201902,68,63,5,62874,4990,67864
211195,201902,29,19,10,18962,9980,28942
211200,201902,153,132,21,131736,20958,152694
211210,201902,507,330,177,329340,176646,505986
211220,201902,4082,2335,1747,2331330.53,1746501.99,4077832.52
211223,201902,96,91,5,90818,4990,95808
211227,201902,69,51,18,50898,17964,68862
211230,201902,780,637,143,635726,142714,778440
211240,201902,413,312,101,311376,100798,412174
211245,201902,190,90,100,89820,99800,189620
211250,201902,1643,1412,231,1409177.59,230538.98,1639716.57
211260,201902,835,669,166,667662,165668,833330
211270,201902,2056,1651,405,1647698,405188.4,2052886.4
211280,201902,1862,1148,714,1146702,717562,1864264
211285,201902,203,122,81,121756,80838,202594
211290,201902,690,473,217,472054,218562,690616
211300,201902,814,636,178,634728.96,177644,812372.96
211400,201902,1575,925,650,924148,648700,1572848
220005,201902,17,16,1,15968,998,16966
220010,201902,89,67,22,66866,21956,88822
220020,201902,643,517,126,515966,125748,641714
220025,201902,109,106,3,105788,2994,108782
220027,201902,38,31,7,30938,6986,37924
220030,201902,103,84,19,83832,18962,102794
220040,201902,1176,891,285,889218.6,285428,1174646.6
220045,201902,40,29,11,28942,10978,39920
220050,201902,680,568,112,566865.08,111776,678641.08
220060,201902,172,149,23,148702,23952,172654
220070,201902,105,96,9,95808,8982,104790
220080,201902,14,13,1,12974,998,13972
220090,201902,34,28,6,27944,5988,33932
220095,201902,2,1,1,998,998,1996
220100,201902,24,19,5,18962,4990,23952
220105,201902,25,24,1,23952.4,998,24950.4
220110,201902,219,200,19,199600,18962,218562
220115,201902,49,46,3,45908,2994,48902
220117,201902,22,20,2,19960,1996,21956
220120,201902,1487,1098,389,1095804,388222,1484026
220130,201902,29,29,0,28942,,28942.0
220140,201902,97,76,21,75848,20958,96806
220150,201902,484,349,135,348302,134730,483032
220155,201902,5,5,0,4990,,4990.0
220157,201902,19,16,3,15968,2994,18962
220160,201902,82,71,11,70858,10978,81836
220170,201902,34,32,2,31936,1996,33932
220173,201902,6,6,0,5988,,5988.0
220177,201902,5,5,0,4990,,4990.0
220180,201902,64,64,0,63872,,63872.0
220190,201902,1065,953,112,951094,111776,1062870
220191,201902,44,39,5,38922,4990,43912
220192,201902,70,67,3,66866,2994,69860
220194,201902,46,44,2,43912,1996,45908
220196,201902,100,85,15,84830,14970,99800
220198,201902,4,3,1,2994,998,3992
220200,201902,428,355,73,354290.5,73852,428142.5
220202,201902,37,33,4,32934,3992,36926
220205,201902,41,37,4,36926,3992,40918
220207,201902,13,12,1,11976,998,12974
220208,201902,81,43,38,42914,37924,80838
220209,201902,31,28,3,27944,2994,30938
220210,201902,15,13,2,12974,1996,14970
220211,201902,26,25,1,24950,998,25948
220213,201902,42,38,4,37924,3992.4,41916.4
220217,201902,39,31,8,30938,7984,38922
220220,201902,2084,1351,733,1349296,732533.1,2081829.1
220225,201902,11,5,6,4990,5988,10978
220230,201902,966,764,202,762472,201596,964068
220240,201902,158,145,13,144710,12974,157684
220245,201902,33,30,3,29940.99,2994,32934.99
220250,201902,117,105,12,104790,11976,116766
220253,201902,42,37,5,36926,4990,41916
220255,201902,29,26,3,25948,2994,28942
220260,201902,692,503,189,501994,188622,690616
220265,201902,11,8,3,7984,2994,10978
220270,201902,719,642,77,640716,76846,717562
220271,201902,42,35,7,34930,6986,41916
220272,201902,27,27,0,26946,,26946.0
220273,201902,14,12,2,11976,1996,13972
220275,201902,55,44,11,43912,10978,54890
220277,201902,11,9,2,8982,1996,10978
220280,201902,14,11,3,10978,2994,13972
220285,201902,45,42,3,41916,2994,44910
220290,201902,1453,1244,209,1241512.8,208582.9,1450095.7
220300,201902,51,49,2,48902,1996,50898
220310,201902,316,268,48,267464.99,47904.98,315369.97
220320,201902,436,401,35,400198.4,34930,435128.4
220323,201902,0,0,0,0,0,0
220325,201902,15,10,5,9980,4990,14970
220327,201902,12,11,1,10978,998,11976
220330,201902,210,147,63,146706,62874,209580
220335,201902,133,115,18,114770,17964,132734
220340,201902,32,20,12,19960,11976,31936
220342,201902,60,52,8,51896,7984,59880
220345,201902,84,77,7,76846,6986,83832
220350,201902,433,379,54,378242,53892,432134
220360,201902,42,30,12,29940,11976,41916
220370,201902,1162,947,215,947102,214570,1161672
220375,201902,22,20,2,19960,1996,21956
220380,201902,41,34,7,33932,6986,40918
220385,201902,17,15,2,14970,1996,16966
220390,201902,2313,1329,984,1327340.84,982033.2,2309374.04
220400,201902,30,27,3,26946,2994,29940
220410,201902,19,18,1,17964,998,18962
220415,201902,14,13,1,12974,998,13972
220420,201902,129,106,23,105788,22954,128742
220430,201902,132,120,12,119760.5,11976,131736.5
220435,201902,21,14,7,13972,6986,20958
220440,201902,301,256,45,255488,44910,300398
220450,201902,339,174,165,173652,164670,338322
220455,201902,55,53,2,52894,1996,54890
220460,201902,20,20,0,19960,,19960.0
220465,201902,106,70,36,69860,35928,105788
220470,201902,241,211,30,210578,29940,240518
220480,201902,74,65,9,64870,8982,73852
220490,201902,89,76,13,75848,12974,88822
220500,201902,95,81,14,80838,13972,94810
220510,201902,382,306,76,305388,75848,381236
220515,201902,20,18,2,17964,1996,19960
220520,201902,376,338,38,337324.34,37924,375248.34
220525,201902,17,12,5,11976,4990,16966
220527,201902,33,26,7,25948,6986,32934
220530,201902,36,15,21,14970,20958,35928
220535,201902,7,7,0,6986,,6986.0
220540,201902,61,51,10,50898,9980,60878
220545,201902,53,37,16,36926,15968,52894
220550,201902,649,499,150,498002,149700,647702
220551,201902,25,20,5,19960,4990,24950
220552,201902,13,13,0,12974,,12974.0
220553,201902,47,43,4,42914,3992,46906
220554,201902,10,7,3,6986,2994,9980
220555,201902,30,27,3,26946,2994,29940
220556,201902,51,47,4,46906,3992,50898
220557,201902,56,51,5,50898,4990,55888
220558,201902,6,2,4,1996,3992,5988
220559,201902,5,5,0,4990,,4990.0
220560,201902,66,44,22,43912,21956,65868
220570,201902,787,479,308,478042.4,307384,785426.4
220580,201902,559,516,43,514968,42914,557882
220585,201902,6,5,1,4990,998,5988
220590,201902,14,14,0,13972,,13972.0
220595,201902,61,46,15,45908,14970,60878
220600,201902,22,14,8,13972,7984,21956
220605,201902,20,19,1,18962,998,19960
220610,201902,69,61,8,60878,7984,68862
220620,201902,566,452,114,451096,113772,564868
220630,201902,5,4,1,3992,998,4990
220635,201902,36,32,4,31936,3992,35928
220640,201902,99,78,21,77844,20958,98802
220650,201902,112,105,7,104790,6986,111776
220660,201902,39,31,8,30938,7984,38922
220665,201902,4,4,0,3992,,3992.0
220667,201902,18,16,2,15968,1996,17964
220669,201902,30,27,3,26946,2994,29940
220670,201902,67,54,13,53892,12974,66866
220672,201902,67,46,21,45908,20958,66866
220675,201902,37,29,8,28942,7984,36926
220680,201902,39,33,6,32934,5988,38922
220690,201902,45,43,2,42914,1996,44910
220695,201902,50,23,27,22954,26946,49900
220700,201902,1659,1284,375,1282430,374250,1656680
220710,201902,4,3,1,2994,998,3992
220720,201902,108,88,20,87824,19960,107784
220730,201902,19,18,1,17964,998,18962
220735,201902,3,1,2,998,1996,2994
220740,201902,49,45,4,44910,3992,48902
220750,201902,102,87,15,86826,14970,101796
220755,201902,15,15,0,14970,,14970.0
220760,201902,58,55,3,54890,2994,57884
220770,201902,5711,3018,2693,3011965.52,2687617.32,5699582.84
220775,201902,20,9,11,8982,10978,19960
220777,201902,17,16,1,15968,998,16966
220779,201902,2,2,0,1996,,1996.0
220780,201902,895,765,130,763470,129740.4,893210.4
220785,201902,16,10,6,9980,5988,15968
220790,201902,1048,841,207,840316.64,207584,1047900.64
220793,201902,8,8,0,7984,,7984.0
220795,201902,20,19,1,18962,998,19960
220800,201902,4008,3080,928,3074840.88,927142.99,4001983.87
220810,201902,65,57,8,56886,7984,64870
220820,201902,246,225,21,224550,20958,245508
220830,201902,1227,1050,177,1047900.8,176646,1224546.8
220840,201902,2381,1663,718,1659677.81,717562.78,2377240.59
220850,201902,54,46,8,45908,7984,53892
220855,201902,12,8,4,7984,3992,11976
220860,201902,10,9,1,8982,998,9980
220865,201902,25,23,2,22954,1996,24950
220870,201902,68,63,5,62874,4990,67864
220880,201902,327,252,75,251496,74850.4,326346.4
220885,201902,37,34,3,33932,2994,36926
220887,201902,16,16,0,15968,,15968.0
220890,201902,103,91,12,90818,11976,102794
220900,201902,55,30,25,29940,24950,54890
220910,201902,55,46,9,45908,8982,54890
220915,201902,10,9,1,8982,998,9980
220920,201902,43,39,4,38922,3992,42914
220930,201902,42,41,1,40918,998,41916
220935,201902,18,18,0,17964,,17964.0
220937,201902,39,37,2,36926,1996,38922
220940,201902,57,52,5,51896,4990,56886
220945,201902,0,0,0,0,0,0
220950,201902,46,42,4,41916,3992,45908
220955,201902,31,27,4,26946,3992,30938
220960,201902,4,4,0,3992,,3992.0
220965,201902,35,32,3,31936,2994,34930
220970,201902,55,46,9,45908,8982,54890
220975,201902,13,12,1,11976,998,12974
220980,201902,31,29,2,28942,1996,30938
220985,201902,69,60,9,59880,8982,68862
220987,201902,32,30,2,29940,1996,31936
220990,201902,17,16,1,15968,998,16966
220995,201902,26,21,5,20958,4990,25948
220997,201902,55,45,10,44910,9980,54890
221000,201902,1135,1024,111,1021952,110778,1132730
221005,201902,62,56,6,55888,5988,61876
221010,201902,17,13,4,12974,3992,16966
221020,201902,45,43,2,42914,1996,44910
221030,201902,32,26,6,25948,5988,31936
221035,201902,24,24,0,23952,,23952.0
221037,201902,10,6,4,5988,3992,9980
221038,201902,28,25,3,24950,2994,27944
221039,201902,22,22,0,21956,,21956.0
221040,201902,259,223,36,222554,35928,258482
221050,201902,237,202,35,201596,34930,236526
221060,201902,1839,1625,214,1621750,213572,1835322
221062,201902,34,33,1,32934,998,33932
221063,201902,13,9,4,8982,3992,12974
221065,201902,52,45,7,44910,6986,51896
221070,201902,141,123,18,122754,17964,140718
221080,201902,377,333,44,332334,43912,376246
221090,201902,32,31,1,30938,998,31936
221093,201902,54,37,17,36926,17964,54890
221095,201902,9,9,0,8982,,8982.0
221097,201902,16,13,3,12974,2994,15968
221100,201902,25269,14766,10503,14739470.36,10484991.45,25224461.81
221110,201902,1053,784,269,782432.4,268462,1050894.4
221120,201902,531,400,131,399200.4,132734,531934.4
221130,201902,954,782,172,780436,172654,953090
221135,201902,34,31,3,30938,2994,33932
221140,201902,43,36,7,35928,6986,42914
221150,201902,12,9,3,9980,2994,12974
221160,201902,14,13,1,12974,998,13972
221170,201902,15,15,0,14970,,14970.0
230010,201902,168,152,16,151696,15968,167664
230015,201902,125,105,20,104790,19960,124750
230020,201902,1627,1374,253,1372250.4,252501.76,1624752.16
230030,201902,1677,1209,468,1206583.78,468062,1674645.78
230040,201902,205,178,27,177644.4,26946,204590.4
230050,201902,216,158,58,157684,57884,215568
230060,201902,157,127,30,126746,29940,156686
230070,201902,296,265,31,264470,30938,295408
230075,201902,851,744,107,743510.8,106786,850296.8
230080,201902,192,165,27,164670,26946,191616
230090,201902,111,78,33,77844,32934,110778
230100,201902,1985,1184,801,1181633.34,800398.82,1982032.16
230110,201902,2742,1772,970,1771450.4,971054.1,2742504.5
230120,201902,967,776,191,775446.6,191616,967062.6
230125,201902,146,122,24,121756,23952,145708
230130,201902,477,423,54,422154,53892,476046
230140,201902,212,184,28,183632,27944,211576
230150,201902,160,121,39,120758,38922,159680
230160,201902,931,802,129,801394,128742,930136
230170,201902,590,542,48,540917,47904,588821
230180,201902,79,74,5,73852,4990,78842
230185,201902,411,356,55,355288,54890,410178
230190,201902,2246,1814,432,1811371.74,432134,2243505.74
230195,201902,493,428,65,427144,64870,492014
230200,201902,384,332,52,331336,51896,383232
230205,201902,374,242,132,241516,131736,373252
230210,201902,1281,1022,259,1020956.22,259480.94,1280437.16
230220,201902,1546,1056,490,1054886,489021.9,1543907.9
230230,201902,892,775,117,774448,116766,891214
230240,201902,1700,1463,237,1461787.89,237524,1699311.89
230250,201902,1796,1485,311,1482031.58,310378,1792409.58
230260,201902,3049,1892,1157,1888216,1155684,3043900
230270,201902,1377,1105,272,1103790.17,271456,1375246.17
230280,201902,2743,2052,691,2049892.8,690616,2740508.8
230290,201902,408,364,44,363274.67,43912,407186.67
230300,201902,513,383,130,382234,129740,511974
230310,201902,423,321,102,320358,102794,423152
230320,201902,946,807,139,805387.4,138722,944109.4
230330,201902,304,242,62,241516,61876.6,303392.6
230340,201902,457,368,89,367264.6,89820,457084.6
230350,201902,3102,1975,1127,1972048,1124746,3096794
230360,201902,275,214,61,213572,60878,274450
230365,201902,138,111,27,110778,26946,137724
230370,201902,9805,4869,4936,4861291.17,4926179.91,9787471.08
230380,201902,477,408,69,407184.4,68862.2,476046.6
230390,201902,515,291,224,290418,223552,513970
230393,201902,263,218,45,217564,44910,262474
230395,201902,353,284,69,283432.48,68862,352294.48
230400,201902,611,486,125,485028,124750,609778
230410,201902,2653,1666,987,1664665.09,985027,2649692.09
230420,201902,6271,4160,2111,4154677.84,2110772.56,6265450.40
230423,201902,319,277,42,276446,41916,318362
230425,201902,374,310,64,309380.34,64870,374250.34
230426,201902,122,100,22,99800,21956,121756
230427,201902,80,77,3,76846,2994,79840
230428,201902,1422,730,692,728540,690616.94,1419156.94
230430,201902,461,377,84,376246.99,83832,460078.99
230435,201902,836,588,248,587822.31,248502.98,836325.29
230440,201902,85347,38142,47205,38076892.55,47127816.82,85204709.37
230445,201902,283,195,88,195608,87824,283432
230450,201902,542,434,108,433132,107784,540916
230460,201902,59,49,10,48902,9980,58882
230465,201902,310,254,56,253492,55888,309380
230470,201902,1970,1548,422,1544904,421156.5,1966060.5
230480,201902,157,148,9,147704,8982,156686
230490,201902,296,238,58,237524,57884,295408
230495,201902,459,343,116,342314,115768,458082
230500,201902,981,735,246,733530,245508,979038
230510,201902,52,41,11,40918,10978,51896
230520,201902,390,304,86,303392.18,85828,389220.18
230523,201902,2203,1404,799,1401192.96,797403.46,2198596.42
230526,201902,291,245,46,245508,45908,291416
230530,201902,676,506,170,504988.94,169660,674648.94
230533,201902,192,182,10,181636,9980,191616
230535,201902,353,264,89,263472,88822.05,352294.05
230540,201902,1847,1633,214,1629734,213572,1843306
230550,201902,3724,2395,1329,2392209.32,1329336,3721545.32
230560,201902,580,442,138,441116.8,137724.94,578841.74
230565,201902,212,154,58,153692,57884,211576
230570,201902,301,266,35,266466,34930,301396
230580,201902,1128,840,288,838320.94,287424,1125744.94
230590,201902,977,763,214,761474.5,213572,975046.5
230600,201902,255,232,23,231536,22954,254490
230610,201902,349,278,71,277444.6,70858,348302.6
230620,201902,169,138,31,138722,30938,169660
230625,201902,727,526,201,524948.6,200598.94,725547.54
230630,201902,1302,1026,276,1023948,275448,1299396
230640,201902,3701,3207,494,3203581,494012.61,3697593.61
230650,201902,422,370,52,369261.91,51896,421157.91
230655,201902,667,579,88,577842.6,87828.86,665671.46
230660,201902,361,305,56,304390,55888,360278
230670,201902,430,378,52,377244,51896,429140
230680,201902,202,183,19,182634,18962,201596
230690,201902,885,767,118,765466,117764,883230
230700,201902,745,632,113,632732.94,112774.94,745507.88
230710,201902,736,700,36,698600.6,35928,734528.6
230720,201902,150,129,21,128742,20958,149700
230725,201902,259,206,53,205588,52894.98,258482.98
230730,201902,11960,6497,5463,6488999,5462059.69,11951058.69
230740,201902,663,538,125,536924.4,124750,661674.4
230750,201902,838,719,119,718560.6,118762,837322.6
230760,201902,1378,1186,192,1183628,191616,1375244
230763,201902,312,262,50,262474,49900,312374
230765,201902,7175,3407,3768,3403210.46,3765481.57,7168692.03
230770,201902,5005,2580,2425,2575842.18,2422146.94,4997989.12
230780,201902,688,604,84,603790.96,83832,687622.96
230790,201902,228,190,38,189620,37924,227544
230800,201902,1132,830,302,828340,301396,1129736
230810,201902,1320,1177,143,1174646,142714,1317360
230820,201902,348,245,103,244510.4,102794.34,347304.74
230830,201902,948,818,130,816364,129740,946104
230835,201902,283,247,36,246506,35928,282434
230837,201902,165,139,26,138722,25948,164670
230840,201902,925,739,186,738520.4,185628.4,924148.8
230850,201902,1513,1318,195,1315364,194611.34,1509975.34
230860,201902,301,226,75,225548,74850,300398
230870,201902,1823,1558,265,1555882.94,264470,1820352.94
230880,201902,52,37,15,36926,14970,51896
230890,201902,555,510,45,508980,44910.97,553890.97
230900,201902,284,212,72,211576,71856.58,283432.58
230910,201902,207,168,39,167664,38922,206586
230920,201902,410,324,86,324350,85828,410178
230930,201902,939,666,273,664668.68,272454,937122.68
230940,201902,847,674,173,673650.94,172654.6,846305.54
230945,201902,498,414,84,413173,83832,497005
230950,201902,395,338,57,338322,56886,395208
230960,201902,2594,1764,830,1760473.92,828342.28,2588816.20
230970,201902,1753,994,759,992020.46,757489.52,1749509.98
230980,201902,211,179,32,178642,31936,210578
230990,201902,142,115,27,114770,26946,141716
231000,201902,206,187,19,186626,18962,205588
231010,201902,146,112,34,111776,33932,145708
231020,201902,1330,930,400,928144.72,400200.86,1328345.58
231025,201902,1030,776,254,774448.6,253492.4,1027941.0
231030,201902,1124,944,180,942113.35,180638,1122751.35
231040,201902,141,96,45,95808,44910,140718
231050,201902,984,879,105,877242,104790,982032
231060,201902,145,126,19,125748,18962,144710
231070,201902,1459,1031,428,1028939.3,427144.94,1456084.24
231080,201902,260,242,18,241516,17964,259480
231085,201902,585,364,221,363272.6,220558,583830.6
231090,201902,246,204,42,203592,41916,245508
231095,201902,166,133,33,132734,32934,165668
231100,201902,131,111,20,110778,19960,130738
231110,201902,360,311,49,310378,48902,359280
231120,201902,291,249,42,248502,41916,290418
231123,201902,145,139,6,138722,5988,144710
231126,201902,318,252,66,251496,65868,317364
231130,201902,4612,3602,1010,3595794.97,1008979.91,4604774.88
231135,201902,212,184,28,183632,27944,211576
231140,201902,3100,2280,820,2276438,818360,3094798
231150,201902,365,349,16,349300,15968,365268
231160,201902,1200,958,242,956084.94,242514.94,1198599.88
231170,201902,534,366,168,365268,167664,532932
231180,201902,1645,1401,244,1398198,243512,1641710
231190,201902,202,176,26,175648,25948,201596
231195,201902,220,189,31,188622,30938,219560
231200,201902,830,678,152,676644,151696.6,828340.6
231210,201902,601,506,95,504988,94810,599798
231220,201902,1038,752,286,750496.9,285428,1035924.9
231230,201902,1422,1141,281,1138718,280438,1419156
231240,201902,1411,1026,385,1023948.94,385228.4,1409177.34
231250,201902,114,104,10,103792,9980,113772
231260,201902,292,192,100,191616,99800.4,291416.4
231270,201902,1011,842,169,840317.79,168662,1008979.79
231280,201902,64,49,15,48902,14970,63872
231290,201902,7405,4144,3261,4139704.8,3254479.8,7394184.6
231300,201902,642,591,51,589818,50898,640716
231310,201902,735,681,54,679638.74,53892,733530.74
231320,201902,581,441,140,441118,139720,580838
231325,201902,92,82,10,81836,9980,91816
231330,201902,2044,1584,460,1581083.93,459080.7,2040164.63
231335,201902,253,225,28,224550,27944,252494
231340,201902,1657,1221,436,1218558,435128,1653686
231350,201902,1259,1037,222,1034926,221556.8,1256482.8
231355,201902,427,373,54,372254,53892,426146
231360,201902,496,383,113,382234.4,112774,495008.4
231370,201902,90,76,14,76846,13972,90818
231375,201902,295,213,82,212574,81836,294410
231380,201902,470,386,84,385228,83832,469060
231390,201902,202,165,37,164670,36926,201596
231395,201902,729,456,273,455088,272454,727542
231400,201902,1099,906,193,904191.04,192616.34,1096807.38
231410,201902,1332,1087,245,1084826.2,244511.74,1329337.94
240010,201902,393,178,215,177644.43,214571.18,392215.61
240020,201902,2243,1777,466,1773447.5,465069.97,2238517.47
240030,201902,128,110,18,109780,18962,128742
240040,201902,30,30,0,29940,,29940.0
240050,201902,516,445,71,444110,70858,514968
240060,201902,64,60,4,59880,3992,63872
240070,201902,198,155,43,154690,42914,197604
240080,201902,468,313,155,312374.99,154690.46,467065.45
240090,201902,100,90,10,89820,9980,99800
240100,201902,1466,1384,82,1381233.5,81836,1463069.5
240110,201902,1045,676,369,674649.58,368262.7,1042912.28
240120,201902,139,118,21,117764,20958,138722
240130,201902,286,267,19,266466,18962,285428
240140,201902,84,65,19,64870,18962,83832
240145,201902,715,634,81,632732,80838,713570
240150,201902,20,16,4,15968,3992,19960
240160,201902,42,37,5,36926,4990,41916
240165,201902,38,32,6,31936.5,5988,37924.5
240170,201902,94,70,24,69860,23952,93812
240180,201902,82,67,15,66866,14970,81836
240185,201902,44,40,4,39920,3992,43912
240190,201902,13,11,2,10978,1996,12974
240200,201902,3045,1709,1336,1706582.4,1335325.4,3041907.8
240210,201902,168,130,38,129740,37924,167664
240220,201902,1099,798,301,796404.7,300398,1096802.7
240230,201902,843,781,62,779438.77,61876,841314.77
240240,201902,122,85,37,84830,36926,121756
240250,201902,88,79,9,78842,8982,87824
240260,201902,1803,1344,459,1342310,458082,1800392
240270,201902,191,168,23,167664,22954,190618
240280,201902,40,30,10,29940,9980,39920
240290,201902,52,51,1,50898,998,51896
240300,201902,179,101,78,100798,77844,178642
240310,201902,2037,1117,920,1114768.27,918161.7,2032929.97
240320,201902,204,193,11,192614,10978,203592
240325,201902,4306,2634,1672,2628736.27,1669656.07,4298392.34
240330,201902,67,63,4,62874,3992,66866
240340,201902,112,78,34,77844,33932,111776
240350,201902,90,80,10,79840,9980,89820
240360,201902,463,319,144,318362,143712,462074
240370,201902,44,42,2,41916,1996,43912
240375,201902,69,41,28,40918,27944,68862
240380,201902,229,187,42,186626,41916.8,228542.8
240390,201902,14,12,2,11976,1996,13972
240400,201902,80,76,4,75848,3992,79840
240410,201902,11,7,4,6986,3992,10978
240420,201902,925,702,223,700596.2,222554,923150.2
240430,201902,263,247,16,246506,15968,262474
240440,201902,85,48,37,47904,36926,84830
240450,201902,210,141,69,140718.4,68862,209580.4
240460,201902,60,47,13,46906,12974,59880
240470,201902,238,205,33,204590,32934,237524
240480,201902,14,13,1,12974,998,13972
240485,201902,80,69,11,68862,10978,79840
240490,201902,47,47,0,46906,,46906.0
240500,201902,87,70,17,69860,16966,86826
240510,201902,51,36,15,35928,14970,50898
240520,201902,119,114,5,113772,4990,118762
240530,201902,56,50,6,49900,5988,55888
240540,201902,79,69,10,68862,9980,78842
240550,201902,14,13,1,12974,998,13972
240560,201902,375,276,99,275448,98802,374250
240570,201902,469,295,174,294410,174650,469060
240580,201902,1256,1014,242,1011973.4,241516.99,1253490.39
240590,201902,27,25,2,24950,1996,26946
240600,201902,111,108,3,107784,2994,110778
240610,201902,513,432,81,431136.4,80838,511974.4
240615,201902,19,18,1,17964,998,18962
240620,201902,95,91,4,90818,3992,94810
240630,201902,36,34,2,33932,1996,35928
240640,201902,27,22,5,21956,4990,26946
240650,201902,235,197,38,196606,37924,234530
240660,201902,102,88,14,87824,13972,101796
240670,201902,297,176,121,175648.7,120758,296406.7
240680,201902,50,39,11,38922,10978,49900
240690,201902,47,45,2,44910,1996,46906
240700,201902,189,156,33,155688,32934,188622
240710,201902,1926,1225,701,1222551.3,701594,1924145.3
240720,201902,1069,786,283,784428,284430,1068858
240725,201902,62,58,4,57884,3992,61876
240730,201902,140,121,19,120758,18962,139720
240740,201902,236,201,35,200598,34930.74,235528.74
240750,201902,43,27,16,26946,15968,42914
240760,201902,41,38,3,37924,2994,40918
240770,201902,147,114,33,113772,32934,146706
240780,201902,681,563,118,561874,117764,679638
240790,201902,37,36,1,35928,998,36926
240800,201902,9026,6159,2867,6148688.11,2866260.66,9014948.77
240810,201902,20201,11175,9026,11155668.08,9009974.89,20165642.97
240820,201902,216,136,80,135728,79840,215568
240830,201902,1636,1346,290,1343308.7,289420,1632728.7
240840,201902,83,73,10,72854,9980,82834
240850,201902,84,74,10,73852,9980,83832
240860,201902,111,108,3,107784,2994,110778
240870,201902,61,53,8,52894,7984,60878
240880,201902,29,26,3,25948,2994,28942
240890,201902,1186,695,491,693612.26,491016.99,1184629.25
240895,201902,50,36,14,35928,13972,49900
240910,201902,161,146,15,145708,14970,160678
240920,201902,15,12,3,11976,2994,14970
240930,201902,402,364,38,363272,37924,401196
240933,201902,35,26,9,25948,8982,34930
240940,201902,2441,2155,286,2150691.28,286426,2437117.28
240950,201902,51,48,3,47904,2994,50898
240960,201902,32,26,6,25948,5988,31936
240970,201902,120,87,33,86826,33932,120758
240980,201902,193,154,39,153692,38922,192614
240990,201902,125,83,42,82834,41916,124750
241000,201902,65,60,5,59880,4990,64870
241010,201902,59,48,11,47904,10978,58882
241020,201902,113,105,8,105788,7984,113772
241025,201902,9,3,6,2994,5988,8982
241030,201902,119,97,22,96806,21956,118762
241040,201902,35,29,6,29940,5988,35928
241050,201902,88,78,10,77844,9980,87824
241060,201902,29,24,5,23952,4990,28942
241070,201902,17,17,0,16966,,16966.0
241080,201902,60,54,6,53892,5988,59880
241090,201902,50,41,9,40918,8982,49900
241100,201902,73,63,10,62874,9980,72854
241105,201902,6,2,4,1996,3992,5988
241110,201902,48,45,3,44910,2994,47904
241120,201902,1445,1111,334,1108778,333332,1442110
241140,201902,222,184,38,184630.4,37924,222554.4
241142,201902,42,39,3,38922,2994,41916
241150,201902,1201,1056,145,1053888,144710,1198598
241160,201902,23,22,1,21956,998,22954
241170,201902,44,40,4,39920,3992,43912
241180,201902,46,39,7,38922,6986,45908
241190,201902,38,37,1,36926,998,37924
241200,201902,3860,2088,1772,2083827.83,1768458.49,3852286.32
241210,201902,68,59,9,58882,8982,67864
241220,201902,1411,952,459,951094.71,458082.97,1409177.68
241230,201902,242,202,40,201596,39920.9,241516.9
241240,201902,55,42,13,41916,12974,54890
241250,201902,1112,1023,89,1020954.4,88822,1109776.4
241255,201902,50,41,9,40918,8982,49900
241260,201902,636,499,137,498002,136726,634728
241270,201902,50,37,13,36926,12974,49900
241280,201902,100,87,13,86826,12974,99800
241290,201902,110,84,26,83832,25948,109780
241300,201902,77,57,20,56886,19960,76846
241310,201902,51,38,13,37924.7,12974,50898.7
241320,201902,27,14,13,13972,12974,26946
241330,201902,62,57,5,56886,4990,61876
241335,201902,65,58,7,57884,6986,64870
241340,201902,187,140,47,139720,46906,186626
241350,201902,64,59,5,58882,4990,63872
241355,201902,43,38,5,37924,4990,42914
241360,201902,50,49,1,48902,998,49900
241370,201902,49,40,9,39920,8982,48902
241380,201902,41,37,4,36926,3992,40918
241390,201902,77,62,15,61876,14970,76846
241400,201902,206,166,40,165668,39920,205588
241410,201902,184,167,17,166666,16966,183632
241415,201902,100,79,21,78842,20958,99800
241420,201902,99,74,25,73852,24950.64,98802.64
241430,201902,29,27,2,26946,1996,28942
241440,201902,506,413,93,412174.97,92814,504988.97
241445,201902,37,35,2,34930,1996,36926
241450,201902,280,229,51,228542,50898,279440
241460,201902,141,130,11,129740.5,10978,140718.5
241470,201902,42,35,7,34930,6986,41916
241475,201902,61,58,3,57884,2994,60878
241480,201902,97,71,26,70858,25948,96806
241490,201902,8,7,1,6986,998,7984
241500,201902,47,34,13,33932,12974,46906
250010,201902,102,87,15,86826,14970,101796
250020,201902,34,30,4,29940,3992,33932
250030,201902,821,618,203,616764,202594.6,819358.6
250040,201902,346,288,58,287424,57884,345308
250050,201902,234,194,40,193612.99,39920,233532.99
250053,201902,58,44,14,43912,13972,57884
250057,201902,0,0,0,0,0,0
250060,201902,473,365,108,364270,107784,472054
250070,201902,704,579,125,577842.75,124750,702592.75
250073,201902,8,8,0,7984,,7984.0
250077,201902,194,146,48,145708,47904,193612
250080,201902,419,329,90,328342.72,89820,418162.72
250090,201902,200,132,68,131736,67864,199600
250100,201902,510,424,86,423152,85828.2,508980.2
250110,201902,567,430,137,429140,136726,565866
250115,201902,24,8,16,7984,15968,23952
250120,201902,112,83,29,82834,28942,111776
250130,201902,572,463,109,462074,108782.6,570856.6
250135,201902,14,8,6,7984,5988,13972
250140,201902,83,76,7,76846,6986,83832
250150,201902,570,416,154,415168,154690,569858
250153,201902,8,7,1,6986,998,7984
250157,201902,27,22,5,21956,4990,26946
250160,201902,215,170,45,169660,44910,214570
250170,201902,63,43,20,42914,19960,62874
250180,201902,4082,2794,1288,2790411.06,1286426.87,4076837.93
250190,201902,857,569,288,567862,287424.5,855286.5
250200,201902,52,44,8,43912,7984,51896
250205,201902,22,19,3,18962,2994,21956
250210,201902,88,77,11,76846,10978,87824
250215,201902,63,55,8,54890,7984,62874
250220,201902,27,21,6,20958,5988,26946
250230,201902,78,71,7,70858.99,6986,77844.99
250240,201902,240,198,42,197604,41916,239520
250250,201902,402,344,58,343312,57884,401196
250260,201902,35,31,4,30938,3992,34930
250270,201902,62,48,14,47904,13972,61876
250280,201902,380,315,65,315368,64870,380238
250290,201902,92,85,7,84830,6986,91816
250300,201902,552,377,175,376246,175649.97,551895.97
250310,201902,46,42,4,41916,3992,45908
250320,201902,1984,1358,626,1355287.68,624749.38,1980037.06
250330,201902,93,82,11,81836,10978,92814
250340,201902,23,20,3,19960,2994,22954
250350,201902,143,95,48,94810,47904,142714
250355,201902,36,28,8,27944,7984,35928
250360,201902,200,163,37,162674,36926,199600
250370,201902,2401,1617,784,1613766.21,782432,2396198.21
250375,201902,8,3,5,2994,4990,7984
250380,201902,55,40,15,39920,14970,54890
250390,201902,42,34,8,33932,7984,41916
250400,201902,16225,8266,7959,8251472.85,7951071.72,16202544.57
250403,201902,378,308,70,307384,69860,377244
250407,201902,60,52,8,51896,7984,59880
250410,201902,30,26,4,25948,3992,29940
250415,201902,42,28,14,27944,13972,41916
250420,201902,47,39,8,38922,7984,46906
250430,201902,1492,1267,225,1264715.5,224550,1489265.5
250435,201902,15,12,3,11976,2994,14970
250440,201902,688,588,100,586824.6,99800,686624.6
250450,201902,86,70,16,69860,15968,85828
250460,201902,429,296,133,295408,132734,428142
250470,201902,86,64,22,63872,21956,85828
250480,201902,329,263,66,262474,65868,328342
250485,201902,1,1,0,998,,998.0
250490,201902,228,192,36,191616,35928,227544
250500,201902,80,60,20,59880,19960,79840
250510,201902,725,575,150,573850,149700,723550
250520,201902,174,121,53,120758,52894,173652
250523,201902,116,98,18,97804,17964,115768
250527,201902,100,80,20,79840,19960,99800
250530,201902,8,5,3,4990,2994,7984
250535,201902,25,21,4,20958,3992,24950
250540,201902,129,100,29,99800,28942,128742
250550,201902,70,67,3,66866,2994,69860
250560,201902,40,30,10,29940,9980,39920
250570,201902,155,125,30,124750,29940,154690
250580,201902,120,96,24,95872,23952,119824
250590,201902,21,15,6,14970,5988,20958
250600,201902,1261,849,412,847302.64,412174,1259476.64
250610,201902,155,134,21,133732,20958,154690
250620,201902,23,19,4,18962,3992,22954
250625,201902,67,49,18,48902,17964,66866
250630,201902,3037,1966,1071,1963083.27,1068865.92,3031949.19
250640,201902,207,170,37,169660,36926,206586
250650,201902,28,20,8,19960,7984,27944
250660,201902,44,33,11,32934,10978,43912
250670,201902,62,42,20,41916,19960,61876
250680,201902,391,320,71,319360,70858,390218
250690,201902,1884,1311,573,1309380.15,571854.8,1881234.95
250700,201902,927,812,115,810376.5,114770,925146.5
250710,201902,444,348,96,347304,95808,443112
250720,201902,113,87,26,86826,25948,112774
250730,201902,378,322,56,321356,55888,377244
250740,201902,52,48,4,47904,3992,51896
250750,201902,21016,12742,8274,12722415.57,8265446.3,20987861.87
250760,201902,76,58,18,57884,17964,75848
250770,201902,351,231,120,230538.44,119760,350298.44
250780,201902,56,43,13,42914,12974,55888
250790,201902,467,303,164,302394,163672,466066
250800,201902,152,139,13,138722,12974,151696
250810,201902,81,62,19,61876,18962,80838
250820,201902,158,130,28,129740,27944,157684
250830,201902,421,292,129,291416.4,128742,420158.4
250840,201902,52,50,2,49900,1996,51896
250850,201902,55,44,11,43912,10978,54890
250855,201902,13,11,2,10978,1996,12974
250860,201902,199,140,59,139720,58882,198602
250870,201902,34,31,3,30938,2994,33932
250880,201902,80,59,21,58882,20958,79840
250890,201902,2621,1956,665,1952088,663670,2615758
250900,201902,125,109,16,108782,15968,124750
250905,201902,123,97,26,96806,25948,122754
250910,201902,1166,833,333,831334.99,333332,1164666.99
250915,201902,113,79,34,78842,33932,112774
250920,201902,140,106,34,105788,33932,139720
250930,201902,165,103,62,102794,61876,164670
250933,201902,2,1,1,998,998,1996
250937,201902,8,7,1,6986,998,7984
250939,201902,31,24,7,23952,6986,30938
250940,201902,114,85,29,84830,28942,113772
250950,201902,70,47,23,46906,22954,69860
250960,201902,90,49,41,48902,40918,89820
250970,201902,1222,865,357,864268,357284,1221552
250980,201902,89,62,27,61876,26946,88822
250990,201902,169,131,38,130738,38922,169660
251000,201902,75,66,9,65868,8982,74850
251010,201902,104,83,21,82834.99,20958,103792.99
251020,201902,81,71,10,70858,9980,80838
251030,201902,44,33,11,32934,10978,43912
251040,201902,53,39,14,38922,13972,52894
251050,201902,23,21,2,20958,1996,22954
251060,201902,50,39,11,38922,10978,49900
251065,201902,3,3,0,2994,,2994.0
251070,201902,23,19,4,18962.98,3992,22954.98
251080,201902,4821,2331,2490,2327358.26,2491013.03,4818371.29
251090,201902,196,166,30,165668,29940,195608
251100,201902,17,17,0,16966,,16966.0
251110,201902,44,35,9,34930,8982,43912
251120,201902,1828,1108,720,1106783.2,718560.4,1825343.6
251130,201902,392,319,73,318362,72854,391216
251140,201902,532,350,182,349301.2,181636,530937.2
251150,201902,308,266,42,265468.98,41916,307384.98
251160,201902,99,83,16,82834.99,15968,98802.99
251170,201902,101,80,21,79840,20958,100798
251180,201902,290,183,107,182634.99,106786.99,289421.98
251190,201902,189,129,60,128742,59880,188622
251200,201902,255,207,48,206586,47904,254490
251203,201902,40,37,3,36926,2994,39920
251207,201902,96,79,17,78842,16966,95808
251210,201902,1456,1057,399,1054886,398202,1453088
251220,201902,48,38,10,37924,9980,47904
251230,201902,462,387,75,386226,74850.4,461076.4
251240,201902,100,72,28,71856,27944,99800
251250,201902,1351,962,389,960076.9,388222.7,1348299.6
251260,201902,12,6,6,5988,5988,11976
251270,201902,332,249,83,248502,82834.7,331336.7
251272,201902,66,60,6,59880,5988,65868
251274,201902,28,22,6,21956,5988,27944
251275,201902,30,18,12,17964,11976,29940
251276,201902,10,8,2,7984,1996,9980
251278,201902,8,7,1,6986,998,7984
251280,201902,101,96,5,95808,4990,100798
251290,201902,716,539,177,537922,177644,715566
251300,201902,16,13,3,12974,2994,15968
251310,201902,373,268,105,267464.99,104790,372254.99
251315,201902,20,19,1,18962,998,19960
251320,201902,62,49,13,48902,12974,61876
251330,201902,82,73,9,72854,8982,81836
251335,201902,12,7,5,6986,4990,11976
251340,201902,717,421,296,420158,295408,715566
251350,201902,36,35,1,34930,998,35928
251360,201902,75,65,10,64870,9980,74850
251365,201902,14,14,0,13972,,13972.0
251370,201902,5414,3692,1722,3684619.14,1718556.6,5403175.74
251380,201902,48,38,10,37924,9980,47904
251385,201902,3,3,0,2994,,2994.0
251390,201902,724,565,159,563870.7,158682.4,722553.1
251392,201902,11,5,6,4990,5988,10978
251394,201902,9,9,0,8982,,8982.0
251396,201902,15,10,5,9980,4990,14970
251398,201902,19,16,3,15968,2994,18962
251400,201902,43,36,7,35928,6986,42914
251410,201902,37,31,6,30938,5988,36926
251420,201902,101,76,25,75848,24950,100798
251430,201902,41,38,3,37924,2994,40918
251440,201902,33,21,12,20958,11976,32934
251445,201902,57,52,5,51896,4990,56886
251450,201902,411,360,51,359280.2,50898,410178.2
251455,201902,2,1,1,998,998,1996
251460,201902,15,13,2,12974,1996,14970
251465,201902,5,2,3,1996,2994,4990
251470,201902,48,38,10,37924,9980,47904
251480,201902,26,23,3,22954,2994,25948
251490,201902,119,83,36,82834,35928.4,118762.4
251500,201902,127,105,22,104790,21956,126746
251510,201902,38,29,9,28942,8982,37924
251520,201902,26,26,0,25948,,25948.0
251530,201902,4496,3170,1326,3165656.8,1324346,4490002.8
251540,201902,75,65,10,64870,9980,74850
251550,201902,409,316,93,315368,93812.9,409180.9
251560,201902,22,15,7,14970,6986,21956
251570,201902,19,19,0,18962,,18962.0
251580,201902,124,102,22,101796,21956,123752
251590,201902,119,87,32,87015,31936,118951
251593,201902,26,17,9,16966,8982,25948
251597,201902,60,50,10,49900,9980,59880
251600,201902,1093,779,314,777449.71,313373.36,1090823.07
251610,201902,221,169,52,168662,51896,220558
251615,201902,3,3,0,2994,,2994.0
251620,201902,4274,2847,1427,2841308.84,1427141.4,4268450.24
251630,201902,443,325,118,325348,117764.98,443112.98
251640,201902,146,104,42,103792,41916,145708
251650,201902,267,194,73,193612.7,72854,266466.7
251660,201902,231,206,25,205588,24950,230538
251670,201902,364,284,80,284430,79840,364270
251675,201902,4,4,0,3992,,3992.0
251680,201902,95,85,10,84830,9980,94810
251690,201902,346,286,60,285428,59880,345308
251700,201902,284,243,41,242514,40918,283432
251710,201902,23,15,8,14970,7984,22954
251720,201902,30,21,9,20958,8982.4,29940.4
251740,201902,10,8,2,7984,1996,9980
260005,201902,3181,1807,1374,1803389.21,1372252.88,3175642.09
260010,201902,1567,1131,436,1128738.14,435129.04,1563867.18
260020,201902,418,370,48,369260,47904,417164
260030,201902,581,420,161,419160,160678,579838
260040,201902,850,529,321,527942,320358,848300
260050,201902,1155,839,316,838320.5,315368.8,1153689.3
260060,201902,401,366,35,365268,34930,400198
260070,201902,1431,903,528,901197.75,527942.69,1429140.44
260080,201902,724,571,153,570856,152694,723550
260090,201902,549,345,204,344311.96,203592,547903.96
260100,201902,232,164,68,163672,67864,231536
260105,201902,226,127,99,126746,99800,226546
260110,201902,2782,2060,722,2056878.98,720556.4,2777435.38
260120,201902,2904,1466,1438,1463069.62,1435125.3,2898194.92
260130,201902,159,112,47,111776,46906,158682
260140,201902,2154,1422,732,1419167.46,730536.98,2149704.44
260150,201902,223,145,78,144710,77844,222554
260160,201902,310,259,51,258482,50898,309380
260170,201902,3384,2080,1304,2075841.28,1302390.4,3378231.68
260180,201902,153,128,25,127744,24950,152694
260190,201902,2288,1613,675,1609774,674648,2284422
260200,201902,935,764,171,762472.63,170658.4,933131.03
260210,201902,1433,1018,415,1015964,414170.98,1430134.98
260220,201902,730,662,68,660676,67864,728540
260230,201902,1201,906,295,905186,294410,1199596
260240,201902,227,172,55,171656,54890,226546
260250,201902,87,65,22,64870,21956,86826
260260,201902,1004,719,285,717562,284430,1001992
260270,201902,428,346,82,345308,81836,427144
260280,201902,1365,935,430,933130,430138.4,1363268.4
260290,201902,6430,3488,2942,3482028.28,2938118.47,6420146.75
260300,201902,901,793,108,791414.6,108782.4,900197.0
260310,201902,522,417,105,416166,104790,520956
260320,201902,883,664,219,662672,218562,881234
260330,201902,40,30,10,29940,9980,39920
260340,201902,74,53,21,52894,20958,73852
260345,201902,5602,3142,2460,3136718.27,2455083.9,5591802.17
260350,201902,490,356,134,355288.4,133732,489020.4
260360,201902,276,144,132,143712,131736,275448
260370,201902,674,448,226,447104.5,225548.99,672653.49
260380,201902,612,442,170,441116,169660.66,610776.66
260390,201902,297,252,45,251496,44910,296406
260392,201902,102,89,13,88822,12974,101796
260400,201902,4059,2360,1699,2355283.09,1698597.38,4053880.47
260410,201902,14658,7783,6875,7771429.75,6866241.28,14637671.03
260415,201902,124,112,12,111776,11976,123752
260420,201902,1802,1091,711,1088819.21,709578,1798397.21
260430,201902,191,173,18,172655.25,17964,190619.25
260440,201902,223,161,62,160678.98,61876,222554.98
260450,201902,462,335,127,334331.2,126746,461077.2
260460,201902,832,443,389,442115.2,388222,830337.2
260470,201902,367,227,140,226546,139720.8,366266.8
260480,201902,214,136,78,135728,77844,213572
260490,201902,216,178,38,177644,37924,215568
260500,201902,1131,766,365,764468,364270,1128738
260510,201902,759,608,151,606784,151696,758480
260515,201902,245,221,24,220558,23952,244510
260520,201902,3287,1976,1311,1973047.93,1310375.32,3283423.25
260530,201902,802,654,148,653690,149700,803390
260540,201902,565,433,132,432134,131736,563870
260545,201902,13,10,3,9980,2994,12974
260550,201902,346,216,130,215568,129740,345308
260560,201902,529,400,129,399200.4,128742,527942.4
260570,201902,995,816,179,814368.4,178642,993010.4
260580,201902,258,230,28,229540,27944,257484
260590,201902,639,371,268,370258,269460,639718
260600,201902,8069,4227,3842,4220544.33,3837310,8057854.33
260610,201902,493,336,157,335328,157684,493012
260620,201902,3699,1939,1760,1936122.66,1757479.11,3693601.77
260630,201902,83,80,3,79840,2994,82834
260640,201902,3681,2022,1659,2019953.9,1659674.98,3679628.88
260650,201902,321,232,89,231536,88822,320358
260660,201902,532,359,173,358282,172654,530936
260670,201902,103,76,27,75848,26946,102794
260680,201902,3669,2074,1595,2071851.64,1591811.36,3663663.00
260690,201902,122,93,29,92814,28942,121756
260700,201902,335,210,125,209580,124750,334330
260710,201902,36,33,3,32934,2994,35928
260720,201902,2301,1387,914,1385225.6,912172,2297397.6
260730,201902,645,493,152,492014,151696,643710
260740,201902,59,55,4,54890,3992,58882
260750,201902,632,446,186,445108,185628,630736
260760,201902,630,341,289,340318,288422,628740
260765,201902,979,515,464,513970.99,464070,978040.99
260770,201902,227,171,56,170658,55888,226546
260775,201902,810,484,326,483033.3,328342.98,811376.28
260780,201902,274,179,95,178642,94810,273452
260790,201902,12164,6725,5439,6715553.28,5432119.91,12147673.19
260795,201902,165,113,52,112774,51896,164670
260800,201902,294,246,48,245508,47904,293412
260805,201902,174,113,61,112774,60878,173652
260810,201902,739,647,92,645706,91816,737522
260820,201902,315,209,106,208582.74,105788,314370.74
260825,201902,202,141,61,140718,60878,201596
260830,201902,271,171,100,170658,99800,270458
260840,201902,236,173,63,172654,62874,235528
260845,201902,189,127,62,126746,61876,188622
260850,201902,484,359,125,358282,124750,483032
260860,201902,252,188,64,187624,63872,251496
260870,201902,368,272,96,271456.54,95808,367264.54
260875,201902,729,523,206,522952,207584,730536
260880,201902,1604,1007,597,1006982.2,596804,1603786.2
260890,201902,2403,1698,705,1694605,706584.8,2401189.8
260900,201902,1020,707,313,705586,313372,1018958
260910,201902,272,213,59,212574,58882,271456
260915,201902,312,218,94,217564,93812,311376
260920,201902,177,98,79,97804,78842,176646
260930,201902,396,342,54,341316.97,53892.97,395209.94
260940,201902,2866,1580,1286,1576841.2,1283428.4,2860269.6
260950,201902,2030,1189,841,1188619.66,839318,2027937.66
260960,201902,13930,7253,6677,7244494.15,6667648.33,13912142.48
260970,201902,435,376,59,375248,58882,434130
260980,201902,195,172,23,171656,22954,194610
260990,201902,2593,2125,468,2120751.34,467064,2587815.34
261000,201902,4358,2577,1781,2574698.86,1780432.6,4355131.46
261010,201902,178,134,44,133732,43912,177644
261020,201902,611,460,151,460078.7,150698,610776.7
261030,201902,226,168,58,167664,57884,225548
261040,201902,367,325,42,325348,41916,367264
261050,201902,489,430,59,429140,58882,488022
261060,201902,1353,896,457,894208.5,456086,1350294.5
261070,201902,8855,4526,4329,4518970.13,4325384.35,8844354.48
261080,201902,385,296,89,295408,88822,384230
261090,201902,2267,1739,528,1735526.31,526945.45,2262471.76
261100,201902,1091,759,332,757483.3,331336,1088819.3
261110,201902,8393,5173,3220,5162656.79,3213563.66,8376220.45
261120,201902,269,227,42,226546,41916,268462
261130,201902,571,339,232,338322.6,232534.62,570857.22
261140,201902,190,125,65,124750,65868,190618
261150,201902,686,417,269,416166.18,268462,684628.18
261153,201902,73,69,4,68862,3992,72854
261160,201902,77433,39072,38361,39008890.04,38316255.75,77325145.79
261170,201902,455,344,111,343312,110778,454090
261180,201902,1787,1109,678,1106782,676644,1783426
261190,201902,615,434,181,433134.52,180638.98,613773.50
261200,201902,220,190,30,189620,29940,219560
261210,201902,34,30,4,29940,3992,33932
261220,201902,2665,1881,784,1877240.18,782433.37,2659673.55
261230,201902,337,250,87,249500,86826,336326
261240,201902,457,396,61,395208,60878,456086
261245,201902,234,195,39,194610,38922,233532
261247,201902,169,133,36,132734,35928,168662
261250,201902,2918,1492,1426,1489016.9,1425144,2914160.9
261255,201902,256,231,25,230538,24950,255488
261260,201902,866,751,115,749498,114770,864268
261270,201902,183,140,43,139720,42914,182634
261280,201902,173,145,28,144710,27944,172654
261290,201902,128,91,37,90818,36926,127744
261300,201902,1263,908,355,906184,354290,1260474
261310,201902,776,521,255,519958.8,254490,774448.8
261320,201902,551,377,174,376246,173652,549898
261330,201902,979,757,222,755486,221556,977042
261340,201902,294,167,127,166666,126746,293412
261350,201902,824,588,236,586824.4,235528,822352.4
261360,201902,1266,831,435,829338,434130,1263468
261370,201902,4914,3021,1893,3014961.36,1889217.49,4904178.85
261380,201902,564,421,143,420158,142714.4,562872.4
261390,201902,3524,2366,1158,2361268.8,1155685.9,3516954.7
261400,201902,280,256,24,255488,23952,279440
261410,201902,1098,745,353,743510,353292,1096802
261420,201902,882,557,325,556886.36,324350.98,881237.34
261430,201902,330,296,34,295408,33932,329340
261440,201902,127,116,11,115768,10978,126746
261450,201902,2548,2095,453,2090811.3,453092.96,2543904.26
261460,201902,743,598,145,596804.74,144710,741514.74
261470,201902,259,198,61,197604,60878,258482
261480,201902,387,305,82,304390.6,81836.99,386227.59
261485,201902,341,212,129,211576,128742,340318
261500,201902,622,421,201,420158,200598,620756
261510,201902,48,32,16,31936,15968,47904
261520,201902,110,98,12,97804,11976,109780
261530,201902,4125,2617,1508,2614761.19,1507979.84,4122741.03
261540,201902,1159,707,452,705586,451096,1156682
261550,201902,282,142,140,141716.4,139720,281436.4
261560,201902,818,545,273,543910.7,272455.78,816366.48
261570,201902,387,304,83,303392,82834,386226
261580,201902,389,304,85,303392,84830,388222
261590,201902,203,166,37,165668,36926,202594
261600,201902,302,243,59,242514,58882,301396
261610,201902,103,90,13,89820,12974,102794
261618,201902,65,51,14,50898,13972,64870
261620,201902,203,127,76,126746,75848,202594
261630,201902,576,446,130,445108,129740,574848
261640,201902,6384,3411,2973,3404182.31,2968052.9,6372235.21
261650,201902,498,319,179,318362,178642,497004
270010,201902,534,474,60,473052.4,59880,532932.4
270020,201902,299,236,63,235528.99,62874,298402.99
270030,201902,9219,5951,3268,5942186.28,3261503.4,9203689.68
270040,201902,2027,1264,763,1261472,762472,2023944
270050,201902,168,125,43,124750,42914,167664
270060,201902,114,65,49,64870,48902,113772
270070,201902,894,651,243,650696,242514.98,893210.98
270080,201902,37,31,6,30938,5988,36926
270090,201902,20,16,4,15968,3992,19960
270100,201902,1226,820,406,818360.98,405188,1223548.98
270110,201902,141,106,35,105788,34930,140718
270120,201902,225,185,40,185628,39920,225548
270130,201902,250,172,78,171656,77844,249500
270135,201902,102,62,40,61876,39920,101796
270140,201902,1347,832,515,830339.91,513971.38,1344311.29
270150,201902,266,211,55,210578,54890,265468
270160,201902,531,401,130,400198,129740,529938
270170,201902,779,510,269,508980,268462,777442
270180,201902,74,57,17,56886,16966,73852
270190,201902,99,88,11,87824,10978,98802
270200,201902,109,98,11,97804,10978,108782
270210,201902,476,251,225,250498,224550,475048
270220,201902,182,143,39,142714,38922,181636
270230,201902,2115,1292,823,1289418.14,821355.94,2110774.08
270235,201902,730,560,170,558885.78,170662.88,729548.66
270240,201902,3134,2465,669,2460072.78,667664.54,3127737.32
270250,201902,171,122,49,121756,48902,170658
270255,201902,222,191,31,190618,30938,221556
270260,201902,356,284,72,283432,71856,355288
270270,201902,105,45,60,44910.98,59880,104790.98
270280,201902,252,146,106,145708,105788,251496
270290,201902,1198,917,281,915166,280438.98,1195604.98
270300,201902,295,194,101,193612,100798,294410
270310,201902,903,730,173,728544.88,172655.96,901200.84
270320,201902,889,761,128,759479.61,127744,887223.61
270330,201902,279,235,44,234530,43912,278442
270340,201902,62,50,12,49900,11976,61876
270350,201902,92,47,45,46906,44910,91816
270360,201902,64,38,26,37924,25948,63872
270370,201902,57,45,12,44910,11976,56886
270375,201902,75,48,27,47904,26946,74850
270380,201902,1019,600,419,598800,419160,1017960
270390,201902,190,109,81,108782,80838,189620
270400,201902,712,523,189,521957.21,188622,710579.21
270410,201902,693,502,191,500996,190618,691614
270420,201902,414,277,137,276446,136729.88,413175.88
270430,201902,33191,23874,9317,23840023.89,9303368.9,33143392.79
270440,201902,489,384,105,383232,104790,488022
270450,201902,790,426,364,425148,363272.42,788420.42
270460,201902,195,152,43,151696,42914,194610
270470,201902,1439,969,470,967062.79,470058,1437120.79
270480,201902,537,440,97,439120.8,96806,535926.8
270490,201902,25,20,5,19960,4990,24950
270500,201902,512,424,88,423152,87824,510976
270510,201902,766,475,291,474050,291416,765466
270520,201902,343,214,129,213572,128742,342314
270530,201902,67,59,8,58882,7984,66866
270540,201902,121,92,29,92814,28942,121756
270550,201902,1751,1335,416,1332331.98,415168,1747499.98
270560,201902,293,141,152,140718,152694,293412
270570,201902,488,337,151,337324,150698,488022
270580,201902,88,67,21,66866,20958,87824
270590,201902,72,58,14,57884,13972,71856
270600,201902,180,147,33,146706,32934,179640
270610,201902,208,175,33,174650.98,32934,207584.98
270620,201902,30,29,1,28942,998,29940
270630,201902,3895,2982,913,2977803.29,911174,3888977.29
270640,201902,909,669,240,667662,239521.94,907183.94
270642,201902,223,189,34,188622,33932,222554
270644,201902,259,177,82,176646.98,81836,258482.98
270650,201902,307,185,122,185628,121756,307384
270660,201902,252,207,45,206586,44910,251496
270670,201902,3111,2372,739,2369256.88,738521.38,3107778.26
270680,201902,474,275,199,274450.98,198602,473052.98
270690,201902,1139,735,404,734528,403192,1137720
270700,201902,36,27,9,26946,8982,35928
270710,201902,900,687,213,685626,212574,898200
270720,201902,257,197,60,197604,59880,257484
270730,201902,1938,1143,795,1140714.8,793412.08,1934126.88
270740,201902,44,27,17,26946,16966,43912
270750,201902,672,496,176,495008.6,175648,670656.6
270760,201902,300,216,84,215568,83832,299400
270770,201902,2818,1811,1007,1810375.02,1006982.96,2817357.98
270780,201902,84,53,31,52894,30939.98,83833.98
270790,201902,256,170,86,169660,85828,255488
270800,201902,1986,1602,384,1600792.99,383232,1984024.99
270810,201902,292,235,57,234530,56886.99,291416.99
270820,201902,157,103,54,102794,53892.8,156686.8
270830,201902,859,628,231,626744.99,230539.39,857284.38
270840,201902,1428,1072,356,1069856,355288.74,1425144.74
270850,201902,1612,985,627,983031,626744,1609775
270860,201902,2519,1648,871,1644706.81,869260.67,2513967.48
270870,201902,124,68,56,67864,55888,123752
270880,201902,906,686,220,684638.72,219565.84,904204.56
270890,201902,331,242,89,241516,88822,330338
270895,201902,69,60,9,59880,8982,68862
270900,201902,101,78,23,77844,22954,100798
270910,201902,323,254,69,253492,68862,322354
270915,201902,1906,1169,737,1166689.72,736535.4,1903225.12
270920,201902,495,419,76,418162,75848,494010
270930,201902,6196,4551,1645,4544642.08,1643487,6188129.08
270940,201902,2366,1806,560,1803386,558880.4,2362266.4
280010,201902,41,36,5,35928,4990,40918
280020,201902,733,632,101,630736.96,100798,731534.96
280030,201902,20166,13082,7084,13059870.39,7071844.16,20131714.55
280040,201902,340,221,119,220558,118762,339320
280050,201902,388,301,87,300398,86826,387224
280060,201902,339,229,110,228543.18,109780,338323.18
280067,201902,988,699,289,697602.49,289420.75,987023.24
280070,201902,129,107,22,106786,21956,128742
280100,201902,614,486,128,485029.16,127744.6,612773.76
280110,201902,76,71,5,70858,4990,75848
280120,201902,629,505,124,503990,123752,627742
280130,201902,1441,913,528,911174.6,526944,1438118.6
280140,201902,480,394,86,393212,85828,479040
280150,201902,360,264,96,263472,95808,359280
280160,201902,96,84,12,83832,11976,95808
280170,201902,423,278,145,277444.49,144710,422154.49
280190,201902,27,25,2,24950,1996,26946
280200,201902,29,23,6,22954,5988,28942
280210,201902,2822,2017,805,2012970.82,803390.4,2816361.22
280220,201902,45,35,10,34930,9980,44910
280230,201902,325,270,55,269460.93,54890,324350.93
280240,201902,117,111,6,110778,5988,116766
280250,201902,18,12,6,11976,5988,17964
280260,201902,82,72,10,71856,9980,81836
280270,201902,158,122,36,121756,35928,157684
280280,201902,193,125,68,124750,67864,192614
280290,201902,3215,2336,879,2333262.64,877242.64,3210505.28
280300,201902,1609,1233,376,1230534.4,376246,1606780.4
280310,201902,104,100,4,99800.6,3992,103792.6
280320,201902,664,460,204,459080,205588,664668
280330,201902,363,262,101,261476,100798,362274
280340,201902,414,334,80,333332,79840,413172
280350,201902,3582,2788,794,2784423.69,792412.7,3576836.39
280360,201902,446,286,160,285428,159680,445108
280370,201902,101,89,12,89820,11976,101796
280380,201902,54,41,13,40918,12974,53892
280390,201902,181,156,25,155688,24950,180638
280400,201902,346,242,104,241517.44,103792,345309.44
280410,201902,289,235,54,234530.6,53892,288422.6
280420,201902,173,146,27,145708,26946,172654
280430,201902,112,86,26,85828,25948,111776
280440,201902,693,535,158,533931.46,157684,691615.46
280445,201902,118,110,8,109780,7984,117764
280450,201902,1158,994,164,992012,163672,1155684
280460,201902,760,557,203,555886.7,202594,758480.7
280470,201902,192,179,13,178642,12974.7,191616.7
280480,201902,2416,1729,687,1725545.36,687623.62,2413168.98
280490,201902,346,319,27,318362.15,26946,345308.15
280500,201902,41,37,4,36926,3992,40918
280510,201902,144,112,32,111776,31936.4,143712.4
280520,201902,56,42,14,42914,13972,56886
280530,201902,76,50,26,49900,25948,75848
280540,201902,527,429,98,428142.7,97804,525946.7
280550,201902,736,679,57,677644.4,56886,734530.4
280560,201902,505,440,65,439120,64870,503990
280570,201902,1811,1384,427,1381234.38,426146,1807380.38
280580,201902,605,468,137,467066.19,136726.8,603792.99
280590,201902,171,110,61,109780,60878,170658
280600,201902,380,319,61,318362,60878,379240
280610,201902,133,101,32,100798,31936,132734
280620,201902,548,457,91,456086,90818,546904
280630,201902,164,136,28,135728,27944,163672
280640,201902,200,161,39,160678.96,38922,199600.96
280650,201902,77,54,23,53892,22954,76846
280660,201902,143,103,40,102794,39920,142714
280670,201902,1769,1130,639,1127744.65,638721.66,1766466.31
280680,201902,180,154,26,153693.09,25948,179641.09
280690,201902,56,47,9,46906,8982,55888
280700,201902,22,22,0,21956,,21956.0
280710,201902,1448,1111,337,1109776.6,336326,1446102.6
280720,201902,114,77,37,76846,36926,113772
280730,201902,26,22,4,21956,3992,25948
280740,201902,2498,1861,637,1857278.8,636724,2494002.8
280750,201902,225,199,26,198602,25948,224550
280760,201902,695,481,214,480038,213572,693610
290010,201902,205,141,64,140718,63872,204590
290020,201902,177,162,15,161676,14970,176646
290030,201902,602,394,208,393212,207584,600796
290035,201902,133,109,24,108782,23952,132734
290040,201902,288,188,100,187624,99800,287424
290050,201902,82,64,18,63872,17964,81836
290060,201902,258,116,142,115768,141716,257484
290070,201902,5633,2802,2831,2797395.86,2826341.87,5623737.73
290080,201902,493,224,269,223553.92,268463.92,492017.84
290090,201902,393,175,218,174650,217564,392214
290100,201902,1624,1078,546,1075845.7,544908.4,1620754.1
290110,201902,803,488,315,487025.12,314370.99,801396.11
290115,201902,205,189,16,188622,15968,204590
290120,201902,771,506,265,504988,264470,769458
290130,201902,422,253,169,252494,168662,421156
290135,201902,300,226,74,225548,73852,299400
290140,201902,308,260,48,259480,47904,307384
290150,201902,131,97,34,96806,33932,130738
290160,201902,247,186,61,185628.62,60878,246506.62
290170,201902,90,66,24,65868,23952,89820
290180,201902,167,131,36,130738,35928,166666
290190,201902,437,363,74,362274,73852,436126
290195,201902,300,186,114,185628,113772,299400
290200,201902,280,229,51,228542,50898,279440
290205,201902,147,92,55,91816,54890,146706
290210,201902,1153,835,318,833330.4,317364,1150694.4
290220,201902,224,125,99,124750,98802,223552
290225,201902,289,114,175,113772,174650,288422
290230,201902,62,41,21,40918,20958,61876
290240,201902,317,125,192,124750,191616,316366
290250,201902,263,242,21,241516,20958,262474
290260,201902,299,241,58,241516.4,57884,299400.4
290265,201902,188,157,31,156686,30938,187624
290270,201902,1423,1180,243,1177641.11,242515.36,1420156.47
290280,201902,473,343,130,342314,129740,472054
290290,201902,1262,746,516,744508.94,515966.4,1260475.34
290300,201902,455,384,71,384230.4,70858,455088.4
290310,201902,309,136,173,136726,172654,309380
290320,201902,4057,2524,1533,2522944.57,1530933,4053877.57
290323,201902,188,164,24,163672,23952,187624
290327,201902,163,129,34,128742,33932,162674
290330,201902,89,48,41,47904,40918,88822
290340,201902,904,367,537,366266.96,536924,903190.96
290350,201902,609,369,240,368262,239520,607782
290360,201902,367,276,91,275448.41,90818,366266.41
290370,201902,911,378,533,377244,531934.97,909178.97
290380,201902,316,194,122,193612,121756,315368
290390,201902,2478,1553,925,1549896.5,923150,2473046.5
290395,201902,250,142,108,141716.5,107784,249500.5
290400,201902,286,210,76,209580.4,75848,285428.4
290405,201902,251,221,30,220558,29940,250498
290410,201902,597,510,87,508980.55,86826,595806.55
290420,201902,243,192,51,191616,50898,242514
290430,201902,488,309,179,308382,178642,487024
290440,201902,73,65,8,64870,7984,72854
290450,201902,234,181,53,182634,53892,236526
290460,201902,1909,1147,762,1145714.78,760478.24,1906193.02
290470,201902,1417,599,818,597811.8,816381.64,1414193.44
290475,201902,586,549,37,547902.68,36926,584828.68
290480,201902,289,163,126,162674,125748,288422
290485,201902,240,225,15,224550,14970,239520
290490,201902,1204,872,332,870256,331336,1201592
290500,201902,709,360,349,359280.26,348302,707582.26
290510,201902,227,173,54,172654,53892,226546
290515,201902,144,88,56,87824,55888,143712
290520,201902,1427,941,486,939118.54,486027.13,1425145.67
290530,201902,313,288,25,287424,24950,312374
290540,201902,100,55,45,54890,45908,100798
290550,201902,152,126,26,125748,25948,151696
290560,201902,3278,1382,1896,1379236.4,1893209.32,3272445.72
290570,201902,6075,3096,2979,3089815.29,2973047.56,6062862.85
290580,201902,1275,765,510,763470,508980,1272450
290590,201902,562,463,99,463072,98802,561874
290600,201902,1761,1217,544,1214568.02,542912,1757480.02
290610,201902,222,199,23,198602.54,22954,221556.54
290620,201902,349,311,38,310378,37924,348302
290630,201902,2042,883,1159,881234,1156682.4,2037916.4
290640,201902,153,125,28,124750,27944,152694
290650,201902,1719,823,896,821355.67,894208,1715563.67
290660,201902,284,231,53,230538,52894,283432
290670,201902,1033,529,504,527942.8,502993.11,1030935.91
290680,201902,1234,993,241,991014,240518,1231532
290682,201902,294,219,75,218563.24,74850.98,293414.22
290685,201902,237,154,83,153692,82834,236526
290687,201902,982,635,347,633892.4,346306,980198.4
290689,201902,140,77,63,76846.97,62874,139720.97
290690,201902,630,264,366,263472.98,365272.84,628745.82
290700,201902,244,120,124,119760,123752,243512
290710,201902,707,479,228,478042,227544,705586
290720,201902,1043,846,197,844308.5,196606.4,1040914.9
290730,201902,1168,676,492,674648,491016,1165664
290740,201902,16,14,2,13972,1996,15968
290750,201902,1367,637,730,635726,728542.69,1364268.69
290755,201902,71,63,8,62874,7984,70858
290760,201902,302,261,41,260478,40918,301396
290770,201902,188,177,11,176646,10978.4,187624.4
290780,201902,1037,818,219,817366,218562,1035928
290790,201902,371,263,108,262474,107784,370258
290800,201902,2590,1050,1540,1047900,1538916,2586816
290810,201902,453,317,136,316366.4,135728,452094.4
290820,201902,392,235,157,234530.97,156686,391216.97
290830,201902,408,286,122,285428,121756,407184
290840,201902,1732,1078,654,1075844.8,652692.8,1728537.6
290850,201902,782,434,348,433132,347304,780436
290860,201902,637,294,343,293412,342314.4,635726.4
290870,201902,652,464,188,463072.64,187624.84,650697.48
290880,201902,123,69,54,68862,53892,122754
290890,201902,344,246,98,245508,97804,343312
290900,201902,170,129,41,128742,40918,169660
290910,201902,379,289,90,288422,90019.6,378441.6
290920,201902,229,193,36,192614,35928,228542
290930,201902,852,647,205,645706.4,204590.96,850297.36
290940,201902,248,206,42,205588,41916,247504
290950,201902,170,100,70,99800,69860,169660
290960,201902,459,313,146,312374,145708,458082
290970,201902,255,227,28,226546,27944,254490
290980,201902,1544,1101,443,1098798.68,442115.2,1540913.88
290990,201902,401,337,64,336328.36,63874.94,400203.30
291000,201902,860,251,609,250498,608780,859278
291005,201902,2257,994,1263,992012.4,1261472.98,2253485.38
291010,201902,155,140,15,139720,14970,154690
291020,201902,101,79,22,78842,21956,100798
291030,201902,97,71,26,70858,25948,96806
291040,201902,577,303,274,302394,273452,575846
291050,201902,1376,771,605,769458.96,604788,1374246.96
291060,201902,1518,844,674,842312,673650,1515962
291070,201902,1947,1451,496,1448099.62,496007.78,1944107.40
291072,201902,7384,2767,4617,2761467.82,4610763.76,7372231.58
291075,201902,220,181,39,180638,38922,219560
291077,201902,52,35,17,34930,16966,51896
291080,201902,19970,8878,11092,8865241.93,11072818.64,19938060.57
291085,201902,300,243,57,242514,56886,299400
291090,201902,300,118,182,117764.4,181636,299400.4
291100,201902,653,190,463,189620,462074,651694
291110,201902,403,307,96,306386.96,95808,402194.96
291120,201902,2503,1222,1281,1221552.7,1281433.49,2502986.19
291125,201902,61,31,30,30938,29940,60878
291130,201902,214,190,24,189620,23952,213572
291140,201902,143,112,31,112774,30938.4,143712.4
291150,201902,379,156,223,155688,222554,378242
291160,201902,375,311,64,310378.5,63872,374250.5
291165,201902,28,24,4,23952,3992,27944
291170,201902,3060,1545,1515,1541911.67,1512969.6,3054881.27
291180,201902,1308,514,794,512975.74,792414.88,1305390.62
291185,201902,80,78,2,77844,1996,79840
291190,201902,1298,574,724,572853.24,722552.86,1295406.10
291200,201902,168,126,42,125748,41916,167664
291210,201902,2225,886,1339,884228.4,1337321.38,2221549.78
291220,201902,274,206,68,205588,67864,273452
291230,201902,1018,356,662,355288.4,660676,1015964.4
291240,201902,436,412,24,411176.4,23952,435128.4
291250,201902,442,361,81,360278,80838,441116
291260,201902,54,41,13,40918,12974,53892
291270,201902,1206,496,710,495008,708580,1203588
291280,201902,373,177,196,176646.4,195608,372254.4
291290,201902,1754,911,843,909178.4,842313.4,1751491.8
291300,201902,233,181,52,180638,51896,232534
291310,201902,239,214,25,213572,24950,238522
291320,201902,1399,1000,399,998998,398202.8,1397200.8
291330,201902,132,112,20,111776,19960,131736
291340,201902,175,97,78,96806,77844,174650
291345,201902,135,92,43,91816,42914,134730
291350,201902,1597,542,1055,540916,1053888.7,1594804.7
291360,201902,8542,4242,4300,4233521.26,4291403.86,8524925.12
291370,201902,1139,640,499,639718.4,498002.98,1137721.38
291380,201902,264,207,57,206586,57884,264470
291390,201902,3848,1718,2130,1714565.54,2125741.2,3840306.74
291400,201902,2084,1489,595,1486022,593810.21,2079832.21
291410,201902,158,139,19,138722,18962,157684
291420,201902,120,90,30,89820,29940,119760
291430,201902,162,90,72,89820,71856.11,161676.11
291440,201902,513,415,98,414170.4,97804,511974.4
291450,201902,907,571,336,570856.5,335328,906184.5
291460,201902,1820,1479,341,1477040.4,340318,1817358.4
291465,201902,2220,1052,1168,1049910.86,1165677.58,2215588.44
291470,201902,2812,1428,1384,1425144.71,1381233.06,2806377.77
291480,201902,11808,5264,6544,5253498.72,6532042.4,11785541.12
291490,201902,562,239,323,238522,322354,560876
291500,201902,373,210,163,209580,162674,372254
291510,201902,1233,478,755,477044,753490,1230534
291520,201902,966,442,524,441116,522952,964068
291530,201902,990,275,715,274450,713570,988020
291535,201902,119,102,17,101796,16966,118762
291540,201902,354,106,248,105788,248502.2,354290.2
291550,201902,1198,572,626,570857.2,624749.38,1195606.58
291560,201902,5430,2775,2655,2770542.34,2649864.61,5420406.95
291570,201902,204,105,99,104790,98802,203592
291580,201902,1246,764,482,762473.81,481036,1243509.81
291590,201902,91,38,53,37924,52894,90818
291600,201902,1369,648,721,646704,719559.96,1366263.96
291610,201902,1447,685,762,683630,762473.94,1446103.94
291620,201902,568,265,303,264470,302394,566864
291630,201902,483,161,322,160678,321356,482034
291640,201902,3897,1961,1936,1957082.28,1934137.36,3891219.64
291650,201902,419,284,135,283432.53,134730,418162.53
291660,201902,412,168,244,167664,243512,411176
291670,201902,224,144,80,143712,79840,223552
291680,201902,688,391,297,390218,296406.8,686624.8
291685,201902,599,332,267,331336.5,266466,597802.5
291690,201902,565,307,258,306386,258483.86,564869.86
291700,201902,954,753,201,751494,200598,952092
291710,201902,1696,797,899,795406.5,897202.98,1692609.48
291720,201902,406,269,137,268462,136726,405188
291730,201902,941,557,384,555886,384230,940116
291733,201902,269,186,83,185628,82834,268462
291735,201902,71,54,17,53892,16966,70858
291740,201902,351,273,78,272454,77844,350298
291750,201902,2060,1352,708,1349297.45,706584,2055881.45
291760,201902,3060,1689,1371,1685622,1368258,3053880
291770,201902,798,540,258,538926.91,257484,796410.91
291780,201902,46,28,18,27944,17964,45908
291790,201902,167,81,86,80838,85828,166666
291800,201902,10056,4134,5922,4125735.31,5912155.08,10037890.39
291810,201902,1134,827,307,825346.4,306386,1131732.4
291820,201902,274,196,78,195608,77844,273452
291830,201902,1105,436,669,435128.98,667662.98,1102791.96
291835,201902,593,551,42,550896,41916,592812
291840,201902,4802,2492,2310,2487017.35,2305380.98,4792398.33
291845,201902,280,94,186,93812,185628,279440
291850,201902,331,295,36,294410,35928,330338
291855,201902,260,106,154,105788,153692,259480
291860,201902,173,109,64,108782,63872,172654
291870,201902,81,31,50,30938,49900,80838
291875,201902,189,174,15,173652,14970,188622
291880,201902,486,382,104,381236,103792,485028
291890,201902,247,84,163,83832,162674.4,246506.4
291900,201902,56,31,25,30938,24950,55888
291905,201902,129,92,37,91816.4,36926,128742.4
291910,201902,170,138,32,137724,31936,169660
291915,201902,414,368,46,367264.5,45908,413172.5
291920,201902,5003,2598,2405,2592804.6,2400191.98,4992996.58
291930,201902,184,108,76,107784,75848,183632
291940,201902,333,187,146,186626,145708,332334
291950,201902,1151,939,212,938120.4,211576,1149696.4
291955,201902,1148,691,457,689618,457084,1146702
291960,201902,184,131,53,130738,52894,183632
291970,201902,769,581,188,579838,187624,767462
291980,201902,1519,1343,176,1340315.38,175648.4,1515963.78
291990,201902,130,120,10,119760,9980,129740
291992,201902,176,90,86,89820,85828,175648
291995,201902,153,104,49,103792,48902,152694
292000,201902,389,298,91,297404.4,90818,388222.4
292010,201902,288,204,84,203592,83832,287424
292020,201902,285,207,78,206586,77844,284430
292030,201902,143,112,31,111776,30938,142714
292040,201902,633,324,309,323352,308382,631734
292045,201902,98,90,8,89820,7984,97804
292050,201902,940,674,266,672652,265468.4,938120.4
292060,201902,938,776,162,774448.86,161676,936124.86
292070,201902,48,20,28,19960,27944,47904
292080,201902,137,94,43,93812,42914,136726
292090,201902,500,183,317,182634,316366,499000
292100,201902,1415,627,788,625746.6,786424.98,1412171.58
292105,201902,211,182,29,181636,28942,210578
292110,201902,2100,785,1315,783430,1312376.84,2095806.84
292120,201902,674,533,141,531934,140718,672652
292130,201902,448,262,186,261476,185628,447104
292140,201902,200,159,41,158682,40918,199600
292145,201902,167,87,80,86826.4,79840,166666.4
292150,201902,1462,1181,281,1178638,280438,1459076
292160,201902,175,143,32,142714,31936,174650
292170,201902,1216,1066,150,1064866,149700,1214566
292180,201902,215,155,60,154690,59880,214570
292190,201902,161,98,63,97804,62874,160678
292200,201902,1291,474,817,473053.36,817363.36,1290416.72
292205,201902,126,112,14,111776,13972,125748
292210,201902,370,261,109,261476.1,108782,370258.1
292220,201902,20,16,4,15968,3992,19960
292225,201902,40,35,5,34930,4990,39920
292230,201902,953,765,188,763470.75,187624,951094.75
292240,201902,624,456,168,455088.7,167664,622752.7
292250,201902,1731,1120,611,1117760,609778.4,1727538.4
292260,201902,434,256,178,255488,178642.94,434130.94
292265,201902,256,179,77,178642,76846,255488
292270,201902,742,335,407,335328,407184.6,742512.6
292273,201902,204,115,89,114770,88822,203592
292275,201902,178,92,86,91816,85828,177644
292280,201902,142,101,41,100798,40918,141716
292285,201902,70,58,12,57884,11976,69860
292290,201902,580,392,188,391216.09,188622.4,579838.49
292300,201902,1645,639,1006,637722.4,1003989.71,1641712.11
292303,201902,101,71,30,70858,29940,100798
292305,201902,115,83,32,82834,31936,114770
292310,201902,851,560,291,558881.24,290418.56,849299.80
292320,201902,668,504,164,502992,163672,666664
292330,201902,182,101,81,100798,80838,181636
292335,201902,285,223,62,222554,61876,284430
292340,201902,581,409,172,408182.4,171656,579838.4
292350,201902,270,145,125,144710,124750,269460
292360,201902,706,537,169,536924.96,168662,705586.96
292370,201902,756,582,174,580836,173652,754488
292380,201902,653,512,141,510976.54,141716,652692.54
292390,201902,501,201,300,200598,299400,499998
292400,201902,3440,2143,1297,2138716.14,1295405,3434121.14
292405,201902,268,177,91,176646,90818,267464
292410,201902,143,86,57,85828,56886,142714
292420,201902,297,254,43,253492,42914,296406
292430,201902,530,414,116,414170,115768,529938
292440,201902,592,508,84,506984.44,83832,590816.44
292450,201902,261,201,60,200598,59880,260478
292460,201902,574,424,150,423152.98,149700,572852.98
292465,201902,223,183,40,182634,39920,222554
292467,201902,111,68,43,67864,42914,110778
292470,201902,274,189,85,188622,84830,273452
292480,201902,341,228,113,227544,112774.4,340318.4
292490,201902,230,154,76,153692,75848,229540
292500,201902,1134,500,634,499998.75,632732,1132730.75
292510,201902,3388,1550,1838,1546900.44,1834325.18,3381225.62
292520,201902,1086,517,569,515966.99,567862.98,1083829.97
292525,201902,382,273,109,272454,108782,381236
292530,201902,4246,1742,2504,1738519.73,2498997.48,4237517.21
292540,201902,462,249,213,248502,212574,461076
292550,201902,1054,572,482,570870.84,481047.54,1051918.38
292560,201902,324,305,19,304390,18962,323352
292570,201902,301,230,71,229540,70858,300398
292575,201902,479,309,170,308382.4,169660,478042.4
292580,201902,964,630,334,628740,333332.4,962072.4
292590,201902,547,472,75,471056,74850,545906
292593,201902,143,113,30,112774,29940,142714
292595,201902,183,141,42,140718,41916,182634
292600,201902,1264,932,332,930136.63,331336,1261472.63
292610,201902,129,101,28,100798,27944,128742
292620,201902,536,448,88,447105.38,87824,534929.38
292630,201902,1397,801,596,799398.67,594808.27,1394206.94
292640,201902,808,562,246,560876,245508,806384
292650,201902,183,154,29,153692.4,28942,182634.4
292660,201902,2027,1457,570,1454087.15,568860.41,2022947.56
292665,201902,146,106,40,105788,39920,145708
292670,201902,405,326,79,325348.99,78842,404190.99
292680,201902,258,199,59,198602,58882,257484
292690,201902,191,145,46,144710,45908,190618
292700,201902,950,633,317,631734,316366,948100
292710,201902,107,94,13,93812,12974,106786
292720,201902,890,500,390,499000,389220,888220
292730,201902,200,95,105,94810,104790,199600
292740,201902,67896,33664,34232,33600698.25,34172561.26,67773259.51
292750,201902,384,275,109,274450.78,108782,383232.78
292760,201902,329,272,57,271456.38,57884,329340.38
292770,201902,788,333,455,332335.38,454090,786425.38
292780,201902,412,159,253,158682,252494,411176
292790,201902,741,370,371,369260,370258,739518
292800,201902,1188,725,463,723550,462074,1185624
292805,201902,408,117,291,116766,290418,407184
292810,201902,1471,843,628,842312.8,626744.98,1469057.78
292820,201902,733,601,132,601794.7,131736.98,733531.68
292830,201902,101,83,18,82834,17964,100798
292840,201902,677,559,118,557882.6,117764,675646.6
292850,201902,137,91,46,90818,45908,136726
292860,201902,2236,1312,924,1310374.4,922152,2232526.4
292870,201902,3479,2346,1133,2342309.53,1130734,3473043.53
292880,201902,1485,972,513,970057.42,511974,1482031.42
292890,201902,496,428,68,427145.94,67864,495009.94
292895,201902,135,89,46,88822,45908,134730
292900,201902,386,282,104,281436,103792,385228
292905,201902,457,234,223,233532,222554,456086
292910,201902,428,327,101,326346.3,100798,427144.3
292920,201902,544,246,298,245508,298402,543910
292925,201902,501,463,38,462074,37924.96,499998.96
292930,201902,574,356,218,355288,217564,572852
292935,201902,289,124,165,123752,164670.98,288422.98
292937,201902,247,166,81,165668,80838,246506
292940,201902,199,155,44,154690,43912,198602
292950,201902,1141,591,550,589819.3,548900,1138719.3
292960,201902,611,420,191,419160,190618,609778
292970,201902,251,179,72,178642,71856,250498
292975,201902,138,79,59,78842,58882.6,137724.6
292980,201902,272,186,86,185628.76,85828,271456.76
292990,201902,1323,988,335,986024.8,334330,1320354.8
293000,201902,105,76,29,75848,28942,104790
293010,201902,2758,1659,1099,1655682.3,1097800.99,2753483.29
293015,201902,660,530,130,528940,129740,658680
293020,201902,342,280,62,279440,61876,341316
293030,201902,614,537,77,535926.8,76846,612772.8
293040,201902,350,278,72,277444,71856,349300
293050,201902,2761,1635,1126,1631730.4,1123749.98,2755480.38
293060,201902,255,205,50,204591.48,49900,254491.48
293070,201902,3480,1798,1682,1794406.89,1678638.88,3473045.77
293075,201902,92,61,31,60878,30938,91816
293076,201902,71,48,23,47904,22954,70858
293077,201902,468,279,189,278442.4,188622,467064.4
293080,201902,456,410,46,409181.14,45908,455089.14
293090,201902,133,117,16,116766,15968,132734
293100,201902,527,369,158,368262,157684,525946
293105,201902,340,238,102,237524.4,101796,339320.4
293110,201902,173,123,50,122754,49900,172654
293120,201902,327,222,105,221556.45,104790,326346.45
293130,201902,244,166,78,166666,77844,244510
293135,201902,8018,3198,4820,3191624.3,4811410.98,8003035.28
293140,201902,186,123,63,122754.6,62874,185628.6
293150,201902,336,288,48,287424,47904,335328
293160,201902,428,246,182,245508,181636,427144
293170,201902,152,105,47,104790,46906,151696
293180,201902,476,328,148,327344.4,147704,475048.4
293190,201902,1344,935,409,934128.7,408182.4,1342311.1
293200,201902,538,476,62,475048,61876,536924
293210,201902,378,290,88,289420.68,87824,377244.68
293220,201902,2636,1093,1543,1090814,1539914.58,2630728.58
293230,201902,1743,644,1099,642712.1,1096802,1739514.1
293240,201902,225,205,20,205588,19960,225548
293245,201902,115,95,20,94810,19960,114770
293250,201902,720,269,451,268462.67,450098,718560.67
293260,201902,313,262,51,261476,50898,312374
293270,201902,1160,555,605,553890.68,604788,1158678.68
293280,201902,256,145,111,144710,110778,255488
293290,201902,3045,2002,1043,1997996,1040915.97,3038911.97
293300,201902,722,516,206,514969.67,205588,720557.67
293305,201902,161,138,23,137724,22954,160678
293310,201902,143,108,35,107784,34930,142714
293315,201902,161,125,36,124750,35928,160678
293317,201902,90,64,26,63872,25948,89820
293320,201902,973,564,409,562872.5,408182,971054.5
293325,201902,192,70,122,69860,121756,191616
293330,201902,13071,6181,6890,6169639.12,6877224.92,13046864.04
293340,201902,257,189,68,188622,67864,256486
293345,201902,246,195,51,194610,50898,245508
293350,201902,641,357,284,356286,283432,639718
293360,201902,1570,1121,449,1118758,449100.46,1567858.46
310010,201902,146,77,69,76846,68862.4,145708.4
310020,201902,1076,601,475,599798.4,475048.44,1074846.84
310030,201902,334,271,63,270458.2,62874,333332.2
310040,201902,48,31,17,30938,16966,47904
310050,201902,187,121,66,120758,65868,186626
310060,201902,247,173,74,172654,73852,246506
310070,201902,15,8,7,7984,6986,14970
310080,201902,45,24,21,23952,20958,44910
310090,201902,977,517,460,516965.6,459080.8,976046.4
310100,201902,309,236,73,235528,72854,308382
310110,201902,731,395,336,394210,335328.4,729538.4
310120,201902,383,211,172,210578,171656,382234
310130,201902,33,21,12,20958,11976,32934
310140,201902,23,12,11,11976,10978,22954
310150,201902,1275,876,399,875247.4,398202.8,1273450.2
310160,201902,2096,1069,1027,1066863.17,1024946.8,2091809.97
310163,201902,95,55,40,54890,39920,94810
310170,201902,2599,1135,1464,1132730.74,1461074.6,2593805.34
310180,201902,130,49,81,48902,80838,129740
310190,201902,494,340,154,339320,153692,493012
310200,201902,492,316,176,315368.4,175648,491016.4
310205,201902,53,40,13,39920,12974,52894
310210,201902,288,232,56,231536,55888,287424
310220,201902,59,36,23,35928,22954,58882
310230,201902,274,191,83,190618,82834,273452
310240,201902,110,96,14,95808,13972,109780
310250,201902,104,84,20,83832,19960,103792
310260,201902,771,419,352,418164.04,352294,770458.04
310270,201902,277,185,92,184630.84,91816,276446.84
310280,201902,362,273,89,272454,88822,361276
310285,201902,216,155,61,154690,60878,215568
310290,201902,255,146,109,145708,108782,254490
310300,201902,152,124,28,123752,27944,151696
310310,201902,10,8,2,7984,1996,9980
310320,201902,29,15,14,14970,13972,28942
310330,201902,34,26,8,25948,7984,33932
310340,201902,1762,1163,599,1160675.4,599798.4,1760473.8
310350,201902,2884,1583,1301,1581832.18,1298399.38,2880231.56
310360,201902,40,33,7,32934,6986,39920
310370,201902,123,102,21,101796,20958.4,122754.4
310375,201902,114,42,72,41916,71856.96,113772.96
310380,201902,48,27,21,26946,20958,47904
310390,201902,97,64,33,63872,32934,96806
310400,201902,2385,1582,803,1581830.8,805386,2387216.8
310410,201902,126,70,56,69860,55888,125748
310420,201902,684,364,320,363272.6,319360.2,682632.8
310430,201902,323,216,107,215568,106786,322354
310440,201902,71,43,28,42914,27944,70858
310445,201902,80,67,13,66866,12974,79840
310450,201902,848,539,309,537922,308382,846304
310460,201902,257,186,71,185628,70858,256486
310470,201902,510,331,179,330338,178642,508980
310480,201902,80,60,20,59880,19960,79840
310490,201902,528,254,274,254490,273452,527942
310500,201902,126,52,74,51896,73852,125748
310510,201902,601,404,197,403192,196606.98,599798.98
310520,201902,133,93,40,92814,39920,132734
310530,201902,97,40,57,39920,56886,96806
310540,201902,466,285,181,284431.2,181636,466067.2
310550,201902,84,55,29,54890,28942,83832
310560,201902,2968,2053,915,2048896.8,916164,2965060.8
310570,201902,111,75,36,74850,35928,110778
310590,201902,359,235,124,234530.5,123752,358282.5
310600,201902,159,90,69,89820.4,68862,158682.4
310610,201902,60,24,36,23952,35928,59880
310620,201902,47291,22832,24459,22794806.86,24422074.63,47216881.49
310630,201902,624,401,223,400198,222554.4,622752.4
310640,201902,150,122,28,121756,27944,149700
310650,201902,163,143,20,142714,19960,162674
310660,201902,89,59,30,58882,29940,88822
310665,201902,59,42,17,41916,16966,58882
310670,201902,6594,2948,3646,2944106.68,3641729.8,6585836.48
310680,201902,59,37,22,36926,21956,58882
310690,201902,590,418,172,417164.1,172654,589818.1
310700,201902,57,38,19,37924,18962,56886
310710,201902,1277,868,409,866265.38,408182.4,1274447.78
310720,201902,98,29,69,28942,68862,97804
310730,201902,1384,978,406,976044.9,405188,1381232.9
310740,201902,977,552,425,550897.2,424150.5,975047.7
310750,201902,244,144,100,143712.66,99800,243512.66
310760,201902,64,45,19,44910,18962.4,63872.4
310770,201902,93,42,51,41916,50898,92814
310780,201902,396,322,74,321356.98,73852,395208.98
310790,201902,98,81,17,80838,16966,97804
310800,201902,453,223,230,222554.7,230538,453092.7
310810,201902,169,118,51,117764.18,50898,168662.18
310820,201902,352,279,73,278442,72854,351296
310825,201902,205,168,37,167664,36926,204590
310830,201902,463,228,235,227544.4,234530,462074.4
310840,201902,374,215,159,214570,158682,373252
310850,201902,109,86,23,85828,22954,108782
310855,201902,395,315,80,314370,79840,394210
310860,201902,1443,1079,364,1077843.16,363272.7,1441115.86
310870,201902,52,42,10,41916,9980,51896
310880,201902,83,65,18,64870,17964,82834
310890,201902,305,182,123,181636,122754,304390
310900,201902,639,299,340,298402.6,340318.96,638721.56
310910,201902,244,169,75,169660.6,74850,244510.6
310920,201902,472,283,189,282434.9,188622,471056.9
310925,201902,37,29,8,28942,7984.4,36926.4
310930,201902,1078,659,419,657697.84,420169.88,1077867.72
310940,201902,671,347,324,346306,323352,669658
310945,201902,121,73,48,72854,47904,120758
310950,201902,247,198,49,197604,48902,246506
310960,201902,83,28,55,27944,54890.99,82834.99
310970,201902,166,105,61,104790,60878,165668
310980,201902,48,27,21,26946,20958,47904
310990,201902,147,80,67,79840,66866,146706
311000,201902,849,428,421,427145.77,420158.98,847304.75
311010,201902,41,34,7,33932,6986,40918
311020,201902,43,27,16,27944,15968,43912
311030,201902,393,237,156,236526,155689.2,392215.2
311040,201902,40,35,5,34930,4990,39920
311050,201902,465,194,271,193612.8,270458,464070.8
311060,201902,767,436,331,435128.8,330338.4,765467.2
311070,201902,351,166,185,165668,184630,350298
311080,201902,107,58,49,57884,48902,106786
311090,201902,385,182,203,181636,202594,384230
311100,201902,605,361,244,360278,243512,603790
311110,201902,696,487,209,489020,209580.98,698600.98
311115,201902,76,54,22,53892,21956,75848
311120,201902,1095,582,513,580836.4,511974,1092810.4
311130,201902,386,229,157,229540,157684,387224
311140,201902,163,88,75,87824,74850,162674
311150,201902,363,241,122,240518,121756,362274
311160,201902,723,522,201,520956.4,201596,722552.4
311170,201902,77,59,18,58882,17964,76846
311180,201902,343,229,114,228542,113772.4,342314.4
311190,201902,35,16,19,15968,18962,34930
311200,201902,332,235,97,234530,97804,332334
311205,201902,33,23,10,22954,9980,32934
311210,201902,49,41,8,40918,7984,48902
311220,201902,19,17,2,16966,1996,18962
311230,201902,1631,1071,560,1068858.6,559878,1628736.6
311240,201902,176,113,63,112774,62874,175648
311250,201902,97,29,68,28942,67864,96806
311260,201902,556,351,205,350298,204590,554888
311265,201902,114,80,34,79840,33932,113772
311270,201902,291,206,85,205588,84830,290418
311280,201902,211,99,112,98802,111776,210578
311290,201902,113,92,21,91816,20958.4,112774.4
311300,201902,574,365,209,364270,208582,572852
311310,201902,26,20,6,19960,5988,25948
311320,201902,672,500,172,499000,171656,670656
311330,201902,1052,778,274,778440,273452.8,1051892.8
311340,201902,2641,1870,771,1867258.8,769458.98,2636717.78
311350,201902,272,209,63,208582,62874,271456
311360,201902,178,110,68,109780,67864,177644
311370,201902,1204,497,707,496006.5,705586,1201592.5
311380,201902,7,6,1,5988,998,6986
311390,201902,265,145,120,144710,119760,264470
311400,201902,157,106,51,105788,50898,156686
311410,201902,101,57,44,56886.4,43912,100798.4
311420,201902,304,171,133,170659.4,132734,303393.4
311430,201902,868,572,296,570856.9,296406.4,867263.3
311440,201902,487,342,145,341316,144710,486026
311450,201902,329,207,122,206586,121756,328342
311455,201902,301,206,95,205588.98,94810,300398.98
311460,201902,135,57,78,56886,77844,134730
311470,201902,22,13,9,12974,8982,21956
311480,201902,40,18,22,17964,21956,39920
311490,201902,16,10,6,9980,5988,15968
311500,201902,21,10,11,9980,10978,20958
311510,201902,637,451,186,450098,185628,635726
311520,201902,42,33,9,32934,8982,41916
311530,201902,1789,1336,453,1333329.28,455088,1788417.28
311535,201902,72,51,21,50898,20958,71856
311540,201902,36,31,5,30938,4990,35928
311545,201902,195,143,52,142714,51896,194610
311547,201902,33,24,9,23952,8982,32934
311550,201902,681,323,358,322354,357284.98,679638.98
311560,201902,43,29,14,28942,13972,42914
311570,201902,294,199,95,198602,94810,293412
311580,201902,329,196,133,195608,132734,328342
311590,201902,33,30,3,29940,3992,33932
311600,201902,97,78,19,77844,18962,96806
311610,201902,258,225,33,224550.5,32934,257484.5
311615,201902,112,93,19,92814,18962,111776
311620,201902,22,12,10,11976,9980,21956
311630,201902,85,71,14,70858,13972,84830
311640,201902,135,71,64,70858,63872,134730
311650,201902,135,97,38,96806,37924,134730
311660,201902,416,203,213,203592,212574,416166
311670,201902,162,105,57,104790.58,56886,161676.58
311680,201902,221,163,58,162674,57884,220558
311690,201902,17,11,6,10978,5988,16966
311700,201902,199,141,58,140718,57884,198602
311710,201902,210,132,78,131736.4,77844,209580.4
311720,201902,39,28,11,27944.4,10978,38922.4
311730,201902,600,396,204,396206,203592,599798
311740,201902,38,28,10,27944,9980,37924
311750,201902,705,478,227,477045.76,226546,703591.76
311760,201902,58,32,26,31936,25948,57884
311770,201902,392,196,196,195609.34,195608,391217.34
311780,201902,178,98,80,97804.4,79840,177644.4
311783,201902,86,76,10,75848,9980,85828
311787,201902,35,14,21,13972,20958,34930
311790,201902,264,123,141,122754,140718,263472
311800,201902,664,448,216,447104.66,215568,662672.66
311810,201902,48,41,7,40918,6986,47904
311820,201902,112,95,17,94810,16966,111776
311830,201902,1958,1243,715,1240515.5,714568,1955083.5
311840,201902,1025,568,457,566865.95,457084.9,1023950.85
311850,201902,10,6,4,5988,3992,9980
311860,201902,9549,4360,5189,4354276.7,5189606.25,9543882.95
311870,201902,139,77,62,76846,61876,138722
311880,201902,943,698,245,696605.38,244510,941115.38
311890,201902,219,110,109,109780,108782,218562
311900,201902,79,33,46,32934,45908,78842
311910,201902,1425,889,536,887223.17,534928.4,1422151.57
311920,201902,227,150,77,149700,76846,226546
311930,201902,911,516,395,514968.4,394210.5,909178.9
311940,201902,2554,1360,1194,1360274,1195604,2555878
311950,201902,52,38,14,37924,13972,51896
311960,201902,66,48,18,47904,17964,65868
311970,201902,24,14,10,13972,9980,23952
311980,201902,46,36,10,35928,9980,45908
311990,201902,48,36,12,35928,11976,47904
311995,201902,60,41,19,40918,18962,59880
312000,201902,34,25,9,24950,8982,33932
312010,201902,85,64,21,63872,20958,84830
312015,201902,100,75,25,74850.4,24950,99800.4
312020,201902,135,91,44,90818.4,43912,134730.4
312030,201902,47,37,10,36926,9980,46906
312040,201902,86,54,32,53892,31936,85828
312050,201902,205,115,90,114770,89820,204590
312060,201902,64,39,25,38922,24950,63872
312070,201902,73,46,27,45908,26946,72854
312080,201902,549,253,296,253492,295408,548900
312083,201902,57,40,17,39920,16966,56886
312087,201902,111,89,22,88822,21956,110778
312090,201902,3058,1814,1244,1812372.5,1242510.96,3054883.46
312100,201902,155,106,49,105558.46,48902,154460.46
312110,201902,115,72,43,71856,42914,114770
312120,201902,148,111,37,112774.67,36926,149700.67
312125,201902,96,52,44,51896,43912,95808
312130,201902,123,85,38,84830,37924,122754
312140,201902,142,110,32,109780.4,31936,141716.4
312150,201902,45,35,10,35928,9980,45908
312160,201902,1555,1026,529,1024040.4,529938.4,1553978.8
312170,201902,11,10,1,9980,998,10978
312180,201902,104,64,40,63872,39920.8,103792.8
312190,201902,31,27,4,26946,3992,30938
312200,201902,756,650,106,648700.4,105788,754488.4
312210,201902,93,62,31,61876,30938,92814
312220,201902,134,97,37,96806.5,36926,133732.5
312230,201902,3620,1775,1845,1771453.12,1844312.06,3615765.18
312235,201902,161,109,52,108782,51896,160678
312240,201902,103,70,33,69860,32934,102794
312245,201902,173,120,53,119760.99,52894,172654.99
312247,201902,63,43,20,42914,19960,62874
312250,201902,175,84,91,84830,91816,176646
312260,201902,115,75,40,74850,39920,114770
312270,201902,139,85,54,84830,53892,138722
312280,201902,27,16,11,15968,10978,26946
312290,201902,155,107,48,106786,47904.6,154690.6
312300,201902,199,132,67,131736,66866,198602
312310,201902,56,52,4,51896,3992,55888
312320,201902,441,280,161,279440,160678,440118
312330,201902,91,82,9,81836,8982,90818
312340,201902,38,17,21,16966,20958,37924
312350,201902,18,11,7,10978,6986,17964
312352,201902,99,70,29,69860,28942,98802
312360,201902,557,250,307,249500,307384,556884
312370,201902,305,176,129,175648,128742.4,304390.4
312380,201902,140,96,44,95808,43912,139720
312385,201902,173,139,34,138722,33932,172654
312390,201902,303,190,113,189620,112774,302394
312400,201902,378,293,85,293046.06,84831,377877.06
312410,201902,926,303,623,302394,622753.39,925147.39
312420,201902,618,483,135,482034.4,135728,617762.4
312430,201902,860,638,222,636725.89,221556,858281.89
312440,201902,46,34,12,33932,11976,45908
312450,201902,204,126,78,125748,77844,203592
312460,201902,62,32,30,31936,29940,61876
312470,201902,55,35,20,34930,19960,54890
312480,201902,201,124,77,123752,76846,200598
312490,201902,272,191,81,190618,80838,271456
312500,201902,35,20,15,19960,14970,34930
312510,201902,473,186,287,185628,287424,473052
312520,201902,41,13,28,12974,27944,40918
312530,201902,52,37,15,36926,14970,51896
312540,201902,101,88,13,87824,12974,100798
312550,201902,39,30,9,29940,8982,38922
312560,201902,217,165,52,164670.4,51896,216566.4
312570,201902,446,267,179,266466,178642,445108
312580,201902,89,47,42,46906,41916,88822
312590,201902,257,205,52,205588,52894,258482
312595,201902,137,122,15,121756,14970,136726
312600,201902,71,43,28,42914.1,27944,70858.1
312610,201902,1616,848,768,846306.06,768460.6,1614766.66
312620,201902,193,141,52,140718,52894,193612
312630,201902,72,59,13,58882,12974,71856
312640,201902,44,12,32,11976,31936,43912
312650,201902,155,130,25,129740.4,24950,154690.4
312660,201902,76,57,19,56886.7,18962,75848.7
312670,201902,883,584,299,582832,299400.5,882232.5
312675,201902,37,29,8,28942,7984,36926
312680,201902,84,56,28,55888,27944,83832
312690,201902,240,130,110,129740,109780,239520
312695,201902,38,31,7,30938,6986,37924
312700,201902,221,128,93,127744,92814,220558
312705,201902,80,66,14,65868,13972,79840
312707,201902,131,95,36,95808.3,35928,131736.3
312710,201902,1921,1035,886,1033929.36,886224.58,1920153.94
312720,201902,65,32,33,31936,32934,64870
312730,201902,284,165,119,164670,118762,283432
312733,201902,54,45,9,44910,8982,53892
312735,201902,25,17,8,16966,7984,24950
312737,201902,72,37,35,36926,34930,71856
312738,201902,54,39,15,38922,14970,53892
312740,201902,76,50,26,49900.4,25948,75848.4
312750,201902,71,52,19,51896,18962,70858
312760,201902,277,203,74,202594,73852,276446
312770,201902,7638,3533,4105,3525941.82,4100786.53,7626728.35
312780,201902,424,327,97,326346,96806,423152
312790,201902,23,18,5,17964,4990,22954
312800,201902,1620,1133,487,1131732.9,488022.46,1619755.36
312810,201902,373,240,133,239520,132734,372254
312820,201902,191,144,47,143712,46906,190618
312825,201902,26,18,8,17964,7984,25948
312830,201902,272,162,110,161676.46,109780,271456.46
312840,201902,156,113,43,112774,42914,155688
312850,201902,51,46,5,45908,4990,50898
312860,201902,167,103,64,102794,63872,166666
312870,201902,989,523,466,521954.9,465068,987022.9
312880,201902,151,103,48,102794,47904,150698
312890,201902,168,119,49,118762,48902,167664
312900,201902,205,156,49,155688,48902,204590
312910,201902,186,99,87,98802,86826,185628
312920,201902,158,90,68,89820,67864,157684
312930,201902,329,237,92,236526,91816,328342
312940,201902,115,81,34,80838,33932,114770
312950,201902,713,475,238,475048,237524,712572
312960,201902,171,131,40,130738.96,39920,170658.96
312965,201902,59,52,7,51896,6986,58882
312970,201902,282,225,57,224550,56886,281436
312980,201902,2398,1246,1152,1243510.18,1149696.99,2393207.17
312990,201902,46,26,20,25948,19960,45908
313000,201902,44,26,18,25948,17964,43912
313005,201902,173,136,37,135728,36926.4,172654.4
313010,201902,936,387,549,386226,547902.98,934128.98
313020,201902,188,101,87,100798,86826,187624
313030,201902,209,136,73,135728.54,72854,208582.54
313040,201902,68,25,43,24950,42914,67864
313050,201902,273,185,88,184630,87824,272454
313055,201902,47,36,11,35928,10978,46906
313060,201902,124,90,34,89820,33932,123752
313065,201902,60,41,19,40918,18962,59880
313070,201902,144,77,67,77844,67864,145708
313080,201902,42,18,24,17964,23952,41916
313090,201902,713,496,217,496006.4,216566,712572.4
313100,201902,164,62,102,62874,101796,164670
313110,201902,135,74,61,73852,60878,134730
313115,201902,185,101,84,100798,83832,184630
313120,201902,797,450,347,450098.4,346306.4,796404.8
313130,201902,5513,3046,2467,3041910.21,2463065.2,5504975.41
313140,201902,152,82,70,81836,69860,151696
313150,201902,310,247,63,246506,62874,309380
313160,201902,197,145,52,144710.4,51896,196606.4
313170,201902,1396,969,427,967063.1,426146.98,1393210.08
313180,201902,309,185,124,184630,123752,308382
313190,201902,756,464,292,463072,291416.2,754488.2
313200,201902,28,25,3,24950,2994,27944
313210,201902,1031,873,158,872253.62,158682,1030935.62
313220,201902,253,171,82,170658,82834,253492
313230,201902,271,201,70,200598.65,69860,270458.65
313240,201902,1949,1043,906,1040918.29,906184,1947102.29
313250,201902,1291,976,315,974049.2,314371.12,1288420.32
313260,201902,92,52,40,51896,39920,91816
313270,201902,951,558,393,558880.3,392214.4,951094.7
313280,201902,61,51,10,50898,9980,60878
313290,201902,220,178,42,178642.4,41916,220558.4
313300,201902,356,184,172,183633.17,171656,355289.17
313310,201902,245,127,118,126746,118762,245508
313320,201902,376,284,92,283433,91816,375249
313330,201902,1380,863,517,863270.6,515966,1379236.6
313340,201902,334,234,100,234530,99800,334330
313350,201902,512,347,165,346306,164670,510976
313360,201902,113,67,46,66866,45908.4,112774.4
313370,201902,195,73,122,73852,121756,195608
313375,201902,280,167,113,166666,112774,279440
313380,201902,1330,698,632,696604.6,630736.99,1327341.59
313390,201902,53,47,6,46906.6,5988,52894.6
313400,201902,418,285,133,284430.6,133732.8,418163.4
313410,201902,23,13,10,12974,9980,22954
313420,201902,4679,2477,2202,2472047.6,2198595.1,4670642.7
313430,201902,144,70,74,69860,74850,144710
313440,201902,1484,1019,465,1016962.71,465070,1482032.71
313450,201902,63,27,36,26946,35928,62874
313460,201902,385,181,204,180638.4,203592,384230.4
313470,201902,529,244,285,243512,284430,527942
313480,201902,152,106,46,105788.4,45908,151696.4
313490,201902,510,246,264,245508.4,263472.9,508981.3
313500,201902,21,13,8,12974,7984,20958
313505,201902,1031,817,214,815366,213572,1028938
313507,201902,97,60,37,59880,37924,97804
313510,201902,2810,1810,1000,1810373.4,1000994,2811367.4
313520,201902,3555,2785,770,2781430.65,768460.99,3549891.64
313530,201902,42,28,14,27944,13972,41916
313535,201902,111,87,24,86826,23952,110778
313540,201902,75,57,18,56886,17964,74850
313545,201902,111,94,17,93812,16966,110778
313550,201902,234,197,37,196606,36926.4,233532.4
313560,201902,328,167,161,166666,160678,327344
313570,201902,58,29,29,28942,28942,57884
313580,201902,1344,750,594,749498,592813.2,1342311.2
313590,201902,77,45,32,44910,31936,76846
313600,201902,688,419,269,418162.4,268462.4,686624.8
313610,201902,62,48,14,48902,13972,62874
313620,201902,1371,722,649,721554.8,650696,1372250.8
313630,201902,1649,1264,385,1262471.35,384230,1646701.35
313640,201902,130,77,53,76846,52894,129740
313650,201902,243,115,128,114770,127744.4,242514.4
313652,201902,18,18,0,17964,,17964.0
313655,201902,59,35,24,34930,23952,58882
313657,201902,47,44,3,43912,2994,46906
313660,201902,138,94,44,93812,43929.96,137741.96
313665,201902,661,322,339,321356,339320,660676
313670,201902,10231,7081,3150,7067843.93,3146695.69,10214539.62
313680,201902,45,33,12,32934,11976.78,44910.78
313690,201902,155,116,39,115768,38922,154690
313695,201902,77,60,17,59880,16966,76846
313700,201902,316,251,65,250498.4,64870,315368.4
313710,201902,142,97,45,96806,44910,141716
313720,201902,1135,547,588,546904.8,587823.4,1134728.2
313730,201902,62,43,19,42914,18962,61876
313740,201902,160,130,30,129740,29940,159680
313750,201902,436,320,116,319360,115768,435128
313753,201902,242,178,64,177644,63872,241516
313760,201902,1281,469,812,468062.4,811376.1,1279438.5
313770,201902,361,268,93,267464.5,92814,360278.5
313780,201902,761,398,363,397204,362274,759478
313790,201902,30,29,1,28942,998,29940
313800,201902,151,96,55,95808,54890,150698
313810,201902,70,40,30,39920,29940,69860
313820,201902,1301,646,655,645707.2,658681.35,1304388.55
313830,201902,64,47,17,46906,17964,64870
313835,201902,60,50,10,49900,9980,59880
313840,201902,1708,1063,645,1060875.2,643710.8,1704586.0
313850,201902,186,67,119,66866,118762,185628
313860,201902,472,362,110,361276.4,109780,471056.4
313862,201902,173,115,58,114770,58882,173652
313865,201902,97,77,20,76846,19960,96806
313867,201902,47,36,11,35928,10978,46906
313868,201902,29,18,11,17964,10978,28942
313870,201902,126,67,59,66866,58882,125748
313880,201902,372,235,137,234530,136726.4,371256.4
313890,201902,336,180,156,179641,155688,335329
313900,201902,904,499,405,499000.5,406186.9,905187.4
313910,201902,138,101,37,100798,36926,137724
313920,201902,634,451,183,450098,182634.9,632732.9
313925,201902,32,28,4,27944,3992,31936
313930,201902,831,645,186,643710,186626.95,830336.95
313940,201902,1813,1145,668,1142710,666664.4,1809374.4
313950,201902,939,603,336,601794.93,335328,937122.93
313960,201902,1394,815,579,813371.16,578841.8,1392212.96
313970,201902,128,85,43,84830,42914,127744
313980,201902,214,139,75,138722.5,74850,213572.5
313990,201902,375,224,151,224550,150698,375248
314000,201902,926,622,304,620757.74,303392,924149.74
314010,201902,80,53,27,52894,26946,79840
314015,201902,56,18,38,17964,37924,55888
314020,201902,54,38,16,37924,15968,53892
314030,201902,78,38,40,37924,39920,77844
314040,201902,45,30,15,29940,14970,44910
314050,201902,305,181,124,180638.4,123752,304390.4
314053,201902,95,62,33,61876.4,32934,94810.4
314055,201902,301,183,118,182634,117764,300398
314060,201902,144,123,21,122754,20958,143712
314070,201902,1050,555,495,553890,496006,1049896
314080,201902,214,140,74,139720,73852.36,213572.36
314085,201902,148,99,49,98802,48902,147704
314090,201902,368,266,102,265468.9,101796,367264.9
314100,201902,478,396,82,395208.3,81836,477044.3
314110,201902,729,397,332,397204,332334,729538
314120,201902,92,54,38,53892,37924,91816
314130,201902,21,11,10,10978,9980,20958
314140,201902,1112,683,429,681634.4,428142,1109776.4
314150,201902,166,106,60,105788,59880,165668
314160,201902,347,262,85,261476.6,84830.6,346307.2
314170,201902,80,62,18,61876,17964,79840
314180,201902,730,647,83,646704.4,82834.5,729538.9
314190,201902,101,62,39,61876,38922,100798
314200,201902,582,406,176,405188,175648,580836
314210,201902,277,212,65,211576,64870.4,276446.4
314220,201902,310,234,76,233532.4,75848.4,309380.8
314225,201902,67,49,18,48902,17964,66866
314230,201902,115,52,63,51896,62874,114770
314240,201902,140,110,30,109780,29940,139720
314250,201902,60,38,22,37924,21956,59880
314260,201902,195,95,100,94810,99800,194610
314270,201902,336,267,69,266466,68862,335328
314280,201902,697,397,300,396206.98,299400,695606.98
314290,201902,559,460,99,459080.9,98802,557882.9
314300,201902,389,281,108,280440.5,107784.9,388225.4
314310,201902,1425,965,460,963070.93,461076,1424146.93
314315,201902,38,30,8,29940,7984,37924
314320,201902,606,399,207,399200.4,206586,605786.4
314330,201902,10795,5428,5367,5420142.36,5360261.53,10780403.89
314340,201902,586,273,313,272454,312374.8,584828.8
314345,201902,40,30,10,29940,9980,39920
314350,201902,190,120,70,119760,70858,190618
314360,201902,76,47,29,46906,28942,75848
314370,201902,57,47,10,46906,9980,56886
314380,201902,93,65,28,64870,27944,92814
314390,201902,3302,2114,1188,2110771.5,1186755.66,3297527.16
314400,201902,691,496,195,495009.5,194610,689619.5
314410,201902,464,307,157,306386,157684,464070
314420,201902,18,9,9,8982,8982,17964
314430,201902,2468,901,1567,899199.9,1563866,2463065.9
314435,201902,266,158,108,157684,107784,265468
314437,201902,26,20,6,19960,5988,25948
314440,201902,100,74,26,73852,25948,99800
314450,201902,154,111,43,110778,42914,153692
314460,201902,652,309,343,309380,342314,651694
314465,201902,90,60,30,59880,29940,89820
314467,201902,69,57,12,56886,11976,68862
314470,201902,406,208,198,207584.98,197604,405188.98
314480,201902,1098,537,561,535926,559878,1095804
314490,201902,85,62,23,61876,22954,84830
314500,201902,306,205,101,204590,100798,305388
314505,201902,132,88,44,87824,43912,131736
314510,201902,238,198,40,197604,39920,237524
314520,201902,1265,669,596,667669.6,594809.2,1262478.8
314530,201902,765,612,153,610777.66,152694,763471.66
314535,201902,213,132,81,131736,80838,212574
314537,201902,66,40,26,39920,25948,65868
314540,201902,15,9,6,8982,5988,14970
314545,201902,50,33,17,32934,16966,49900
314550,201902,83,45,38,44910,37924,82834
314560,201902,846,459,387,459081.2,387224,846305.2
314570,201902,21,17,4,16966,3992,20958
314580,201902,15,8,7,7984,6986,14970
314585,201902,23,18,5,17964,4990,22954
314587,201902,81,72,9,71856,8982,80838
314590,201902,591,434,157,433133.7,156686,589819.7
314600,201902,956,625,331,624749,330339.07,955088.07
314610,201902,963,517,446,515966.9,445108,961074.9
314620,201902,143,104,39,103792,38922,142714
314625,201902,95,70,25,69860,24950,94810
314630,201902,1213,630,583,629738,581834,1211572
314640,201902,83,57,26,56886,25948,82834
314650,201902,189,110,79,109780,78842,188622
314655,201902,66,49,17,48902,16966,65868
314660,201902,19,15,4,14970,3992,18962
314670,201902,204,158,46,157684.4,45908,203592.4
314675,201902,216,128,88,128742,87824,216566
314690,201902,556,305,251,304390,250498,554888
314700,201902,2387,1302,1085,1299397.6,1083828,2383225.6
314710,201902,1626,956,670,956086.1,668660.4,1624746.5
314720,201902,394,235,159,234530,159680,394210
314730,201902,515,266,249,265469.4,248502.98,513972.38
314740,201902,700,347,353,346306,352294,698600
314750,201902,20,18,2,17964,1996,19960
314760,201902,331,157,174,157684,173652,331336
314770,201902,120,84,36,83832.4,35928,119760.4
314780,201902,20,6,14,5988,13972,19960
314790,201902,2389,1514,875,1512971.17,874248,2387219.17
314795,201902,61,52,9,51896.5,8982,60878.5
314800,201902,2923,1719,1204,1715563.48,1201592,2917155.48
314810,201902,1547,876,671,874248,669658.6,1543906.6
314820,201902,95,52,43,51896,42914,94810
314830,201902,216,177,39,176646,38922.4,215568.4
314840,201902,86,49,37,48902,36926,85828
314850,201902,343,168,175,167664,174650,342314
314860,201902,707,534,173,532933.13,172654.7,705587.83
314870,201902,1504,797,707,795406,706584,1501990
314875,201902,58,50,8,49900,7984,57884
314880,201902,47,32,15,31936,14970,46906
314890,201902,55,32,23,31936,22954,54890
314900,201902,33,26,7,25948,6986,32934
314910,201902,254,172,82,171656,81836,253492
314915,201902,157,137,20,136726,19960,156686
314920,201902,119,73,46,73852,45908,119760
314930,201902,1078,543,535,541914.8,533930,1075844.8
314940,201902,49,39,10,38922,9980,48902
314950,201902,36,26,10,25948,10978,36926
314960,201902,53,39,14,38922,13972,52894
314970,201902,146,75,71,74850,70858,145708
314980,201902,300,192,108,191616,107784,299400
314990,201902,464,258,206,257484,205588,463072
314995,201902,214,64,150,63872,149700,213572
315000,201902,93,76,17,75848,16966,92814
315010,201902,45,29,16,28942,15968,44910
315015,201902,174,144,30,143712,29940,173652
315020,201902,75,65,10,64870,9980,74850
315030,201902,116,90,26,89820,25948.4,115768.4
315040,201902,71,52,19,51896,18962,70858
315050,201902,193,115,78,114770,77844.4,192614.4
315053,201902,45,39,6,38922,5988,44910
315057,201902,97,80,17,79840,16966,96806
315060,201902,70,61,9,60878.92,8982,69860.92
315070,201902,107,60,47,59880,46906,106786
315080,201902,384,314,70,313372,69860,383232
315090,201902,109,65,44,64870,43912,108782
315100,201902,83,43,40,42914,39920,82834
315110,201902,286,156,130,155688,129740,285428
315120,201902,1640,828,812,826344,812372.68,1638716.68
315130,201902,348,253,95,252494,94810,347304
315140,201902,531,312,219,311376,218562.2,529938.2
315150,201902,974,466,508,466066.4,508980.4,975046.8
315160,201902,219,112,107,111776,107784,219560
315170,201902,326,214,112,213572.4,111776,325348.4
315180,201902,3276,1387,1889,1385226,1885224.3,3270450.3
315190,201902,326,194,132,194610.2,131736,326346.2
315200,201902,1246,723,523,721554,521954,1243508
315210,201902,1600,913,687,911174.6,685626.2,1596800.8
315213,201902,41,24,17,23952,16966,40918
315217,201902,216,174,42,173652,41916,215568
315220,201902,1569,1203,366,1200595.58,365268.4,1565863.98
315230,201902,167,122,45,121756.4,44910,166666.4
315240,201902,432,278,154,277444,153692.98,431136.98
315250,201902,2522,1256,1266,1254486.5,1265464.8,2519951.3
315260,201902,148,90,58,89820,57884,147704
315270,201902,126,89,37,89820,36926,126746
315280,201902,680,444,236,444110.6,235528,679638.6
315290,201902,207,126,81,125748,80838,206586
315300,201902,72,52,20,51896,19960,71856
315310,201902,70,64,6,63872,5988,69860
315320,201902,168,97,71,96806,70858,167664
315330,201902,59,50,9,49900,8982,58882
315340,201902,405,291,114,290418,113772,404190
315350,201902,152,91,61,90818,60878,151696
315360,201902,94,49,45,48902,44910,93812
315370,201902,58,34,24,33932,23952,57884
315380,201902,11,7,4,6986,3992,10978
315390,201902,70,19,51,18962,50898,69860
315400,201902,834,627,207,625746.7,206586,832332.7
315410,201902,355,217,138,216566.4,137725.4,354291.8
315415,201902,63,47,16,46906,15968,62874
315420,201902,203,155,48,154690.7,47904,202594.7
315430,201902,672,389,283,388222.4,282434.91,670657.31
315440,201902,89,61,28,60878,27944,88822
315445,201902,250,202,48,201596,47904,249500
315450,201902,186,140,46,139720,45908,185628
315460,201902,3533,1787,1746,1783426.98,1742509.38,3525936.36
315470,201902,42,19,23,18962,22954,41916
315480,201902,65,24,41,23952,40918,64870
315490,201902,641,401,240,400198,240518,640716
315500,201902,24,16,8,15968,7984,23952
315510,201902,152,102,50,101796,49900,151696
315520,201902,75,66,9,65868,8982,74850
315530,201902,54,29,25,28942,24950,53892
315540,201902,237,160,77,159680,76846,236526
315550,201902,182,145,37,144710,36926,181636
315560,201902,735,591,144,589818.4,143712,733530.4
315570,201902,312,162,150,161677.8,149700.6,311378.4
315580,201902,694,461,233,460078,232534,692612
315590,201902,205,109,96,108782,95808,204590
315600,201902,303,229,74,228542,73852,302394
315610,201902,97,50,47,49900,46906,96806
315620,201902,35,27,8,26946,7984,34930
315630,201902,136,90,46,89820,45908,135728
315640,201902,67,41,26,40918,25948,66866
315645,201902,61,44,17,43912,16966,60878
315650,201902,170,125,45,124750.8,44910,169660.8
315660,201902,474,213,261,212574,260478,473052
315670,201902,2437,1213,1224,1211573,1221553.96,2433126.96
315680,201902,859,588,271,586824,270458,857282
315690,201902,683,474,209,473053.33,208582,681635.33
315700,201902,1904,1006,898,1004987.27,896204.8,1901192.07
315710,201902,330,92,238,91816,238522,330338
315720,201902,446,285,161,284430,160678,445108
315725,201902,203,162,41,161676.4,40918,202594.4
315727,201902,37,19,18,18962,17964,36926
315730,201902,49,47,2,46906,1996,48902
315733,201902,87,58,29,57884,28942,86826
315737,201902,50,39,11,38922,10978,49900
315740,201902,40,33,7,32934,6986,39920
315750,201902,156,120,36,119760,35928,155688
315760,201902,44,34,10,33932,9980,43912
315765,201902,123,78,45,77844,44910,122754
315770,201902,233,143,90,142714,89820.4,232534.4
315780,201902,3414,1777,1637,1774445,1633727.15,3408172.15
315790,201902,209,161,48,160678,47904,208582
315800,201902,295,215,80,214570,79840,294410
315810,201902,96,57,39,56886,38922.4,95808.4
315820,201902,793,579,214,578841.6,214570,793411.6
315830,201902,136,79,57,78842,56886,135728
315840,201902,88,61,27,60878,26946,87824
315850,201902,266,197,69,196606.38,68862,265468.38
315860,201902,12,4,8,3992,7984,11976
315870,201902,38,30,8,29940,7984,37924
315880,201902,111,73,38,72854,37924,110778
315890,201902,86,64,22,63872,21956,85828
315895,201902,469,321,148,320358.5,147704.8,468063.3
315900,201902,73,37,36,36926,35928,72854
315910,201902,42,28,14,27944,13972,41916
315920,201902,179,114,65,113772,64870.3,178642.3
315930,201902,45,16,29,15968,28942,44910
315935,201902,148,114,34,113772,33932.98,147704.98
315940,201902,94,70,24,69860,23952,93812
315950,201902,46,33,13,32934,12974,45908
315960,201902,550,260,290,259480.4,290418.4,549898.8
315970,201902,35,28,7,27944,6986,34930
315980,201902,697,336,361,335328.1,360278,695606.1
315990,201902,257,150,107,150698.5,106787.38,257485.88
316000,201902,53,35,18,34930,17964,52894
316010,201902,79,67,12,66866,11976,78842
316020,201902,115,98,17,97804,17964,115768
316030,201902,406,219,187,219560.8,186626.9,406187.7
316040,201902,516,219,297,218562.4,296406.4,514968.8
316045,201902,63,56,7,55888,6986,62874
316050,201902,15,13,2,12974,1996,14970
316060,201902,103,66,37,65868,36926,102794
316070,201902,1099,702,397,700596.1,396206,1096802.1
316080,201902,105,68,37,67864,36926,104790
316090,201902,39,22,17,21956,16966,38922
316095,201902,75,64,11,63872,10978,74850
316100,201902,317,185,132,184630.5,131736,316366.5
316105,201902,37,25,12,24950,11976,36926
316110,201902,1904,1533,371,1529934.95,370258,1900192.95
316120,201902,80,60,20,59880,19960,79840
316130,201902,132,102,30,101796.4,29940,131736.4
316140,201902,29,21,8,20958,7984,28942
316150,201902,211,148,63,147704,62874,210578
316160,201902,79,49,30,48902,29940,78842
316165,201902,72,55,17,54890.6,16966,71856.6
316170,201902,198,133,65,132734,64870,197604
316180,201902,203,88,115,87824,114770.4,202594.4
316190,201902,143,104,39,103792,38922,142714
316200,201902,690,390,300,389220,300398,689618
316210,201902,773,517,256,517135.65,255488,772623.65
316220,201902,113,77,36,76846,35928,112774
316225,201902,26,15,11,14970,10978,25948
316230,201902,31,19,12,18962,11976,30938
316240,201902,647,521,126,519958,125748,645706
316245,201902,122,103,19,102794,18962,121756
316250,201902,1518,1047,471,1044907.69,470058,1514965.69
316255,201902,123,98,25,97804,24950,122754
316257,201902,182,96,86,95808,85828,181636
316260,201902,190,134,56,133732.5,55888.8,189621.3
316265,201902,28,19,9,18962,8982,27944
316270,201902,674,472,202,471057,201596.84,672653.84
316280,201902,546,337,209,336327.23,208582.8,544910.03
316290,201902,712,472,240,472054.66,239520,711574.66
316292,201902,517,206,311,205588,310378.5,515966.5
316294,201902,103,61,42,60878,41916,102794
316295,201902,298,136,162,135729.36,161676,297405.36
316300,201902,100,71,29,70858,28942,99800
316310,201902,36,19,17,18962,16966,35928
316320,201902,43,27,16,26946,15968,42914
316330,201902,132,87,45,86826.5,44910,131736.5
316340,201902,143,98,45,97804,44910,142714
316350,201902,193,141,52,140718.7,51896,192614.7
316360,201902,24,17,7,16966,6986,23952
316370,201902,1088,572,516,570857.5,514968,1085825.5
316380,201902,126,97,29,96806,28942,125748
316390,201902,125,90,35,89820,34930,124750
316400,201902,137,105,32,104790,31936,136726
316410,201902,299,219,80,218562,79840,298402
316420,201902,207,146,61,145708,60878,206586
316430,201902,152,79,73,78842,72854,151696
316440,201902,98,48,50,47904,49900,97804
316443,201902,39,37,2,36926,1996,38922
316447,201902,65,50,15,49900,14970,64870
316450,201902,236,177,59,176646,58882,235528
316460,201902,73,29,44,28942,43912,72854
316470,201902,1634,1194,440,1194599.37,439120.4,1633719.77
316480,201902,13,10,3,9980,2994,12974
316490,201902,18,7,11,6986,10978,17964
316500,201902,154,101,53,100798,52894,153692
316510,201902,163,124,39,123752,38922,162674
316520,201902,194,121,73,120758,73852,194610
316530,201902,158,111,47,110778,46906,157684
316540,201902,139,79,60,78842,59880,138722
316550,201902,135,93,42,92814,41916,134730
316553,201902,259,122,137,121756,136726,258482
316555,201902,34,29,5,28942,4990,33932
316556,201902,11,8,3,7984,2994,10978
316557,201902,19,13,6,12974,5988,18962
316560,201902,67,51,16,50898,15968,66866
316570,201902,241,221,20,220558,19960,240518
316580,201902,20,16,4,15968,3992,19960
316590,201902,113,97,16,96806,15968,112774
316600,201902,183,151,32,150698,31936,182634
316610,201902,67,48,19,47904,18962,66866
316620,201902,137,105,32,104790,31936,136726
316630,201902,42,32,10,31936,9980,41916
316640,201902,17,10,7,9980,6986,16966
316650,201902,73,57,16,56886,15968,72854
316660,201902,8,3,5,2994,4990,7984
316670,201902,440,153,287,152694.96,286426,439120.96
316680,201902,161,112,49,111776,48902.6,160678.6
316690,201902,188,122,66,121756,65868,187624
316695,201902,62,54,8,54890,7984,62874
316700,201902,16,9,7,8982,6986,15968
316710,201902,751,556,195,554888.5,194610,749498.5
316720,201902,4966,2536,2430,2530933.25,2426140.74,4957073.99
316730,201902,18,17,1,16966,998,17964
316740,201902,123,80,43,79840,42914,122754
316750,201902,19,13,6,12974,5988,18962
316760,201902,322,260,62,259480,61876,321356
316770,201902,140,77,63,76846,62874,139720
316780,201902,79,50,29,49900,28942,78842
316790,201902,56,43,13,42914,12974,55888
316800,201902,1755,1098,657,1095804,655687,1751491
316805,201902,19,11,8,10978,7984,18962
316810,201902,72,48,24,47904,23952,71856
316820,201902,43,20,23,19960,22954,42914
316830,201902,92,42,50,41916,49900,91816
316840,201902,510,307,203,306386.4,202594,508980.4
316850,201902,344,226,118,225548,117764,343312
316860,201902,6046,2703,3343,2699592.56,3337312.3,6036904.86
316870,201902,1505,991,514,989020.5,512973.2,1501993.7
316880,201902,126,65,61,64870,60878,125748
316890,201902,248,169,79,168662,78842,247504
316900,201902,433,299,134,298402.36,133732,432134.36
316905,201902,19,9,10,8982,9980,18962
316910,201902,54,24,30,23952,29940,53892
316920,201902,135,106,29,105788,28942,134730
316930,201902,1908,983,925,981034.8,924148.3,1905183.1
316935,201902,899,549,350,547902.64,350298.4,898201.04
316940,201902,1091,629,462,627742.8,461076.4,1088819.2
316950,201902,183,93,90,92814,89820,182634
316960,201902,1117,626,491,625746.4,491016.4,1116762.8
316970,201902,659,518,141,517962,140718,658680
316980,201902,112,68,44,67864,43912,111776
316990,201902,2243,1500,743,1497000.34,741514.9,2238515.24
317000,201902,337,258,79,258482,78842,337324
317005,201902,246,174,72,173652,71856,245508
317010,201902,6444,3611,2833,3605778.19,2830328.4,6436106.59
317020,201902,16451,7387,9064,7374239.55,9053875.15,16428114.70
317030,201902,81,32,49,31936,48902,80838
317040,201902,3121,1953,1168,1949095.8,1166663.27,3115759.07
317043,201902,79,57,22,56886,21956,78842
317047,201902,35,17,18,16966,17964.99,34930.99
317050,201902,178,138,40,137724,39920,177644
317052,201902,131,99,32,98802,31936,130738
317057,201902,193,145,48,144710,47904,192614
317060,201902,60,40,20,39920,19960,59880
317065,201902,61,49,12,48902,11976,60878
317070,201902,1998,948,1050,948101.5,1048898.8,1997000.3
317075,201902,110,59,51,58882,50898,109780
317080,201902,857,453,404,453092.5,403192.6,856285.1
317090,201902,655,527,128,525946,127744,653690
317100,201902,432,328,104,327344,103792,431136
317103,201902,112,95,17,94810,16966,111776
317107,201902,39,34,5,33932,4990,38922
317110,201902,111,47,64,46906,63872,110778
317115,201902,42,37,5,36926,4990,41916
317120,201902,1903,982,921,980036.8,919159.04,1899195.84
317130,201902,1976,1300,676,1297401.6,674648,1972049.6
317140,201902,11,9,2,8982,1996,10978
317150,201902,267,159,108,158682.4,107784,266466.4
317160,201902,317,230,87,229540.63,86826,316366.63
317170,201902,212,145,67,145708,66866,212574
317180,201902,440,318,122,317364,121756,439120
317190,201902,263,179,84,178642,83832,262474
317200,201902,802,564,238,563507.02,237524,801031.02
317210,201902,154,86,68,85828,67864,153692
317220,201902,21,13,8,12974,7984,20958
320010,201902,612,452,160,452094.9,159680,611774.9
320013,201902,133,98,35,97804,34930,132734
320016,201902,287,182,105,182634,104790,287424
320020,201902,733,438,295,437125.1,295408,732533.1
320030,201902,149,109,40,108782,40918,149700
320035,201902,144,108,36,107784,35928,143712
320040,201902,503,261,242,260478,241516.4,501994.4
320050,201902,109,84,25,83832,24950,108782
320060,201902,1607,769,838,767462.1,837323.78,1604785.88
320070,201902,106,71,35,70858,34930,105788
320080,201902,790,456,334,455089.89,333332.5,788422.39
320090,201902,1242,867,375,865266.4,374250.4,1239516.8
320100,201902,340,194,146,193612,145708,339320
320110,201902,125,81,44,80839.1,43912.4,124751.5
320115,201902,114,94,20,93812,19960,113772
320120,201902,3393,1892,1501,1890214.36,1497999.77,3388214.13
320130,201902,7521,3557,3964,3551902.45,3958098.39,7510000.84
320140,201902,429,283,146,282434.6,145709.58,428144.18
320150,201902,2017,1166,851,1163669.07,849298,2012967.07
320160,201902,668,299,369,298402.99,368263.79,666666.78
320170,201902,113,90,23,89820,22954,112774
320180,201902,53,31,22,30938,21956,52894
320190,201902,242,161,81,160678,80838.4,241516.4
320200,201902,59,47,12,46906,11976,58882
320210,201902,873,488,385,487024.8,384231.76,871256.56
320220,201902,313,118,195,117764,194610,312374
320225,201902,87,72,15,71856,14970,86826
320230,201902,589,381,208,380238.6,207584,587822.6
320240,201902,3166,1603,1563,1599796,1561871.78,3161667.78
320245,201902,475,327,148,326346.4,147704,474050.4
320250,201902,228,119,109,118762,108782,227544
320255,201902,140,112,28,111776,27944.7,139720.7
320260,201902,189,135,54,134730,53892,188622
320265,201902,160,127,33,126746,32934,159680
320270,201902,158,128,30,127744,29940,157684
320280,201902,1008,602,406,600797.75,405188,1005985.75
320290,201902,65,56,9,55888,8982,64870
320300,201902,559,394,165,393213.34,164672.04,557885.38
320305,201902,677,371,306,370258.96,305388.6,675647.56
320310,201902,214,121,93,120758.76,93812,214570.76
320313,201902,317,159,158,158682.9,157684.4,316367.3
320316,201902,109,88,21,87824,20958,108782
320320,201902,3413,1559,1854,1559877.12,1853287.95,3413165.07
320330,201902,261,198,63,197604,62874,260478
320332,201902,882,531,351,530938.7,350298.9,881237.6
320334,201902,249,155,94,154690.4,93812,248502.4
320335,201902,145,102,43,101796,42914,144710
320340,201902,571,396,175,395209.3,174650,569859.3
320350,201902,998,433,565,432135.69,564869.2,997004.89
320360,201902,170,92,78,91816,77844,169660
320370,201902,246,188,58,187624.56,57884.4,245508.96
320380,201902,292,203,89,202594,88822,291416
320390,201902,1149,703,446,702594.12,446106.8,1148700.92
320400,201902,317,232,85,231537.4,84830,316367.4
320405,201902,944,411,533,410178.99,531937.38,942116.37
320410,201902,981,504,477,502992.8,476047.3,979040.1
320420,201902,491,254,237,253493.7,237524,491017.7
320425,201902,199,108,91,107784,90818,198602
320430,201902,399,227,172,226546.5,171656,398202.5
320435,201902,170,116,54,115768,53892,169660
320440,201902,201,119,82,119760,81836,201596
320450,201902,128,73,55,72854,54890,127744
320455,201902,248,204,44,203592.4,43912,247504.4
320460,201902,254,153,101,152694,100798.4,253492.4
320465,201902,117,79,38,78842,37924,116766
320470,201902,668,428,240,427144.99,239520.99,666665.98
320480,201902,184,121,63,120758,62874,183632
320490,201902,3085,1538,1547,1536922.89,1544911.51,3081834.40
320495,201902,99,61,38,60878.96,37924.8,98803.76
320500,201902,9671,4835,4836,4829337.49,4827341.17,9656678.66
320501,201902,538,270,268,269460,268462,537922
320503,201902,290,206,84,205588,83832,289420
320506,201902,260,192,68,191616,67864,259480
320510,201902,990,464,526,463072.4,524948.98,988021.38
320515,201902,81,68,13,67864,12974,80838
320517,201902,211,151,60,150698,59880,210578
320520,201902,7017,3139,3878,3134722.5,3872247.55,7006970.05
320530,201902,5680,2876,2804,2870255.32,2800394.47,5670649.79
330010,201902,3130,1629,1501,1625744.2,1498996,3124740.2
330015,201902,159,67,92,66866,91816,158682
330020,201902,3663,1620,2043,1617759.8,2038914.4,3656674.2
330022,201902,246,134,112,133732,111776,245508
330023,201902,554,192,362,191616,361276,552892
330025,201902,594,124,470,123752,469060,592812
330030,201902,1959,1279,680,1277442.66,678641.5,1956084.16
330040,201902,2426,1273,1153,1271453.6,1155686.2,2427139.8
330045,201902,8467,2736,5731,2732524.8,5725527.84,8458052.64
330050,201902,877,567,310,565866,309380,875246
330060,201902,941,587,354,585826.9,354290,940116.9
330070,201902,3457,1322,2135,1323348.98,2134723.94,3458072.92
330080,201902,1482,694,788,692614.44,788420,1481034.44
330090,201902,373,218,155,217564,155688,373252
330093,201902,283,128,155,127744,155689.88,283433.88
330095,201902,96,50,46,49900,45908,95808
330100,201902,9616,4974,4642,4970043.53,4634712.4,9604755.93
330110,201902,498,214,284,213572.7,283432,497004.7
330115,201902,566,303,263,302394,262474,564868
330120,201902,376,190,186,190618,186627.6,377245.6
330130,201902,1535,408,1127,408182.6,1125744.96,1533927.56
330140,201902,602,317,285,317364.94,284430.6,601795.54
330150,201902,476,275,201,274450,200598,475048
330160,201902,208,128,80,127744,79840,207584
330170,201902,26936,9505,17431,9494979.94,17422099.98,26917079.92
330180,201902,229,143,86,142714,85828,228542
330185,201902,880,328,552,327344.98,550897.92,878242.90
330187,201902,321,98,223,97804,222554,320358
330190,201902,5600,2267,3333,2263466.56,3332324.08,5595790.64
330200,201902,4789,1491,3298,1490015.44,3294399.46,4784414.90
330205,201902,426,251,175,250498,174650.4,425148.4
330210,201902,1006,623,383,621756.4,382235.2,1003991.6
330220,201902,2599,1575,1024,1571851,1021952.4,2593803.4
330225,201902,561,305,256,304390.61,255488,559878.61
330227,201902,2396,762,1634,762472.4,1630735.26,2393207.66
330230,201902,217,126,91,125748,90818,216566
330240,201902,3694,1957,1737,1955089.98,1735558,3690647.98
330245,201902,159,72,87,71856.74,86826,158682.74
330250,201902,6741,3497,3244,3492005.45,3239512.11,6731517.56
330260,201902,571,162,409,161676,408182,569858
330270,201902,3457,1266,2191,1264466.6,2190612.63,3455079.23
330280,201902,455,295,160,294411.2,159680.98,454092.18
330285,201902,7195,2362,4833,2360271.5,4830325.32,7190596.82
330290,201902,608,232,376,232534,376246,608780
330300,201902,795,535,260,534929.5,260478.94,795408.44
330310,201902,441,249,192,248502.9,192614,441116.9
330320,201902,8193,3159,5034,3155679.6,5029922,8185601.6
330330,201902,8996,3581,5415,3573840.68,5412165.66,8986006.34
330340,201902,2694,1609,1085,1606780.6,1082830,2689610.6
330350,201902,18109,7194,10915,7184610.5,10909150.58,18093761.08
330360,201902,2373,1194,1179,1191614.16,1179637.94,2371252.10
330370,201902,1062,558,504,556884.4,504988.6,1061873.0
330380,201902,860,371,489,370258,488022.6,858280.6
330385,201902,611,318,293,317364.5,292414,609778.5
330390,201902,5297,2919,2378,2916159.41,2376238.8,5292398.21
330395,201902,294,181,113,181636,112774.7,294410.7
330400,201902,707,382,325,381237,324350,705587
330410,201902,501,360,141,359281.1,141716.4,500997.5
330411,201902,234,133,101,132734.62,100798,233532.62
330412,201902,249,104,145,103792.4,144710,248502.4
330414,201902,5988,2478,3510,2476039.68,3507971.2,5984010.88
330415,201902,585,269,316,268462,315368.6,583830.6
330420,201902,2245,1172,1073,1169657.42,1071853.38,2241510.80
330430,201902,1807,874,933,873252,932134.8,1805386.8
330440,201902,277,133,144,132734,143712,276446
330450,201902,117,51,66,50898,65868,116766
330452,201902,1812,861,951,860278.52,950096.4,1810374.92
330455,201902,110484,40148,70336,40108733.71,70301154.59,110409888.30
330460,201902,260,108,152,107784,151696.94,259480.94
330470,201902,1244,678,566,676645.3,565866.4,1242511.7
330475,201902,1397,380,1017,379240.6,1015964,1395204.6
330480,201902,810,430,380,430138,380238.6,810376.6
330490,201902,13787,4824,8963,4815351.1,8954063.66,13769414.76
330500,201902,1347,611,736,609778,736524.46,1346302.46
330510,201902,11141,3854,7287,3850285.46,7285403,11135688.46
330513,201902,104,51,53,50898,52894,103792
330515,201902,822,340,482,340319.26,482035.2,822354.46
330520,201902,2533,937,1596,935126.54,1592808,2527934.54
330530,201902,217,115,102,114770.5,101796.6,216567.1
330540,201902,361,181,180,180638,179640,360278
330550,201902,2949,1074,1875,1071852.8,1875242.8,2947095.6
330555,201902,803,308,495,308382.96,496006.6,804389.56
330560,201902,649,216,433,215568,432134.94,647702.94
330570,201902,258,183,75,182634,74850,257484
330575,201902,785,328,457,327344,457085.78,784429.78
330580,201902,3414,1921,1493,1919156.6,1490014.8,3409171.4
330590,201902,318,160,158,159680,157684.98,317364.98
330600,201902,1116,720,396,719558.4,396206,1115764.4
330610,201902,1541,848,693,848634.46,693613,1542247.46
330615,201902,197,148,49,147704,48902,196606
330620,201902,1055,443,612,442114.6,610776,1052890.6
330630,201902,3985,2537,1448,2534922.76,1447101.1,3982023.86
350010,201902,603,403,200,402194.82,199600,601794.82
350020,201902,44,20,24,19960,23952,43912
350030,201902,515,328,187,327344.4,186626.8,513971.2
350040,201902,124,48,76,47904,75848,123752
350050,201902,298,159,139,159680,139720.98,299400.98
350055,201902,84,48,36,47904,35928,83832
350060,201902,74,27,47,26946,46906,73852
350070,201902,811,482,329,482067.95,330355.08,812423.03
350075,201902,73,48,25,47904,24950,72854
350080,201902,49,31,18,30938,17964,48902
350090,201902,88,48,40,47904,39920,87824
350100,201902,294,182,112,181636,111776,293412
350110,201902,57,38,19,37924,18962,56886
350115,201902,159,95,64,94810,63872,158682
350120,201902,107,72,35,71856,34930,106786
350130,201902,345,164,181,163672.58,180638.9,344311.48
350140,201902,37,23,14,22954,13972,36926
350150,201902,68,53,15,52894,14970,67864
350160,201902,2581,1024,1557,1021956.27,1556887.92,2578844.19
350170,201902,399,240,159,240518.4,158682.4,399200.8
350180,201902,183,98,85,97804,84830,182634
350190,201902,1036,555,481,555887.59,481036.4,1036923.99
350200,201902,68,25,43,24950,42914,67864
350210,201902,1315,743,572,742514.99,571854.63,1314369.62
350220,201902,670,568,102,566864.63,101796,668660.63
350230,201902,79,53,26,52894,25948,78842
350240,201902,63,45,18,44910,17964,62874
350250,201902,1194,590,604,588821.4,602793.1,1191614.5
350260,201902,86,62,24,61876,23952,85828
350270,201902,836,552,284,550896.6,283432.4,834329.0
350275,201902,308,128,180,127744.2,179640,307384.2
350280,201902,4683,2398,2285,2394219.34,2281432.95,4675652.29
350290,201902,417,197,220,196606,221556.4,418162.4
350300,201902,60,33,27,32934,26946,59880
350310,201902,101,65,36,64870,35928,100798
350315,201902,40,25,15,24950,14970,39920
350320,201902,3284,1627,1657,1626740.9,1655683,3282423.9
350330,201902,1673,894,779,894210.2,778441.2,1672651.4
350335,201902,21,14,7,13972,6986,20958
350340,201902,134,63,71,62874,71856.3,134730.3
350350,201902,95,48,47,47904,46906,94810
350360,201902,127,83,44,82834.99,43912,126746.99
350370,201902,87,52,35,51896.63,35928,87824.63
350380,201902,763,326,437,325349.02,436126,761475.02
350390,201902,1517,614,903,612773.43,902192.4,1514965.83
350395,201902,27,22,5,21956,4990,26946
350400,201902,1702,881,821,879240.56,819359.62,1698600.18
350410,201902,2340,1043,1297,1040914.4,1295405.59,2336319.99
350420,201902,239,147,92,146707.03,92814,239521.03
350430,201902,75,46,29,45908,28942,74850
350440,201902,147,107,40,106786.4,39920,146706.4
350450,201902,1648,1015,633,1014968.67,632733.2,1647701.87
350460,201902,333,124,209,123752,208582,332334
350470,201902,17,11,6,10978,5988,16966
350480,201902,171,94,77,93812,76846,170658
350490,201902,231,118,113,117764,112774,230538
350500,201902,42,18,24,17964,23952,41916
350510,201902,164,110,54,109780,53892,163672
350520,201902,450,216,234,216566,233532,450098
350530,201902,439,204,235,203592,235528,439120
350535,201902,78,63,15,62874,14970,77844
350540,201902,386,194,192,193612,191616,385228
350550,201902,2709,1594,1115,1592810.91,1112775.39,2705586.30
350560,201902,649,454,195,453092.21,194610,647702.21
350570,201902,4110,1748,2362,1744505.63,2358277.5,4102783.13
350580,201902,384,184,200,184630.63,199600.99,384231.62
350590,201902,919,503,416,501994.4,415168.4,917162.8
350600,201902,6203,3117,3086,3112767.72,3085819.37,6198587.09
350610,201902,1533,805,728,803391.26,727542.98,1530934.24
350620,201902,35,23,12,22954,11976,34930
350630,201902,235,137,98,136726.63,97804.63,234531.26
350635,201902,908,374,534,373252.4,534928.8,908181.2
350640,201902,121,91,30,90818,29940,120758
350650,201902,1919,1268,651,1267461.18,652692.98,1920154.16
350660,201902,758,335,423,334330,422154.99,756484.99
350670,201902,317,162,155,161676.5,154690,316366.5
350680,201902,185,97,88,96806,87824,184630
350690,201902,200,102,98,101796,97804,199600
350700,201902,764,365,399,364270.4,398202,762472.4
350710,201902,344,129,215,128742,214570,343312
350715,201902,55,44,11,43912,10978,54890
350720,201902,18,11,7,10978,6986,17964
350730,201902,45,28,17,27944,16966,44910
350740,201902,209,115,94,114770,93812,208582
350745,201902,18,9,9,8982.44,8982,17964.44
350750,201902,2165,1371,794,1368260.2,794408,2162668.2
350760,201902,3731,1650,2081,1647698.66,2076838.4,3724537.06
350770,201902,60,42,18,41916,17964,59880
350775,201902,49,35,14,34930,13972.98,48902.98
350780,201902,429,214,215,213572,214759,428331
350790,201902,370,154,216,153692,215568,369260
350800,201902,454,264,190,263472,190618,454090
350810,201902,518,414,104,414170.63,103792.28,517962.91
350820,201902,87,53,34,52894,33932,86826
350830,201902,82,45,37,44910,36926,81836
350840,201902,775,330,445,329340.4,445109.78,774450.18
350850,201902,1763,1020,743,1017960.5,741517.93,1759478.43
350860,201902,591,343,248,342316.46,247504,589820.46
350870,201902,436,295,141,294410,140718,435128
350880,201902,281,154,127,154690,127744,282434
350890,201902,41,27,14,26946,13972,40918
350900,201902,1464,471,993,470059.36,991014,1461073.36
350910,201902,23,13,10,12974,9980,22954
350920,201902,629,339,290,339320,289420,628740
350925,201902,1212,648,564,648700.78,562873.2,1211573.98
350930,201902,98,61,37,60878,37924,98802
350940,201902,737,408,329,407184,328342.36,735526.36
350945,201902,107,78,29,77844,28942,106786
350950,201902,16021,7740,8281,7729515.71,8272429.79,16001945.50
350960,201902,1280,591,689,589818.4,688620.99,1278439.39
350970,201902,1144,591,553,591708.03,551894.8,1143602.83
350980,201902,94,65,29,64870,28942,93812
350990,201902,369,132,237,131736,236526,368262
350995,201902,34,16,18,15968,17964,33932
351000,201902,629,438,191,437125.26,190618,627743.26
351010,201902,50,31,19,30938,18962,49900
351015,201902,55,38,17,37924,16966,54890
351020,201902,1646,981,665,979038.99,665666,1644704.99
351030,201902,356,240,116,240518,115768,356286
351040,201902,852,451,401,450098.1,400198.11,850296.21
351050,201902,3358,1551,1807,1548901.64,1803394.88,3352296.52
351060,201902,5069,2082,2987,2078836.36,2982028.56,5060864.92
351070,201902,413,261,152,260478.97,151696,412174.97
351080,201902,789,569,220,567862,219560,787422
351090,201902,59,26,33,25948,32934,58882
351100,201902,447,260,187,259481.46,187624,447105.46
351110,201902,2078,998,1080,996014.98,1077857.06,2073872.04
351120,201902,72,36,36,35928,35928,71856
351130,201902,173,60,113,59880,112774,172654
351140,201902,335,231,104,230538,103792,334330
351150,201902,428,229,199,228542.7,198602,427144.7
351160,201902,261,175,86,174650.4,85828,260478.4
351170,201902,186,105,81,104790,80838,185628
351190,201902,85,58,27,57884,26946,84830
351200,201902,370,246,124,245508.4,123752,369260.4
351210,201902,123,59,64,58882,63872,122754
351220,201902,533,317,216,317366.16,215568,532934.16
351230,201902,286,203,83,203592,82834,286426
351240,201902,231,101,130,100798,129740,230538
351250,201902,75,53,22,52894.53,21956,74850.53
351260,201902,154,114,40,113772,39920,153692
351270,201902,50,20,30,19960,29940,49900
351280,201902,1079,492,587,493013.26,587823.61,1080836.87
351290,201902,232,107,125,106786,124750.4,231536.4
351300,201902,3706,1724,1982,1721473.15,1979035.62,3700508.77
351310,201902,763,391,372,391216,374250,765466
351320,201902,114,68,46,67864,45908,113772
351330,201902,39,26,13,25948,12974,38922
351340,201902,1237,754,483,752493.4,482036.95,1234530.35
351350,201902,2540,1478,1062,1475045.7,1059876,2534921.7
351360,201902,783,390,393,389220,392214,781434
351370,201902,375,188,187,187624,186626,374250
351380,201902,9084,4129,4955,4122744.93,4949088.78,9071833.71
351385,201902,30,18,12,17964,11976,29940
351390,201902,285,213,72,212574,71856,284430
351400,201902,65,41,24,40918,23954.94,64872.94
351410,201902,445,277,168,276446.6,167664,444110.6
351420,201902,62,50,12,49900,11976,61876
351430,201902,70,39,31,38922,30938,69860
351440,201902,794,558,236,556886.96,236526.99,793413.95
351450,201902,259,132,127,131736,126746,258482
351460,201902,114,52,62,51896,61876,113772
351470,201902,134,71,63,70858,62874,133732
351480,201902,525,295,230,295409.36,230538,525947.36
351490,201902,282,104,178,103792,177644,281436
351492,201902,31,22,9,21956,8982,30938
351495,201902,27,19,8,18962,7984,26946
351500,201902,3574,1533,2041,1531931,2039913.36,3571844.36
351510,201902,1853,766,1087,764468.4,1085824.4,1850292.8
351512,201902,20,16,4,15968,3992,19960
351515,201902,193,113,80,112774,79840,192614
351518,201902,798,499,299,498002.99,299400,797402.99
351519,201902,71,45,26,44910,25948,70858
351520,201902,143,88,55,87824,54890,142714
351530,201902,22,15,7,14970,6986,21956
351535,201902,126,71,55,70858,54890,125748
351540,201902,451,323,128,323353.05,127744,451097.05
351550,201902,1365,830,535,828341.66,536924.8,1365266.46
351560,201902,71,38,33,37924,32934.96,70858.96
351565,201902,9,6,3,5988,2994,8982
351570,201902,2665,1389,1276,1388220.38,1277443.96,2665664.34
351580,201902,39,36,3,35928,2994,38922
351590,201902,66,44,22,44910,21956,66866
351600,201902,195,145,50,144710,50898,195608
351610,201902,60,28,32,27944,31936,59880
351620,201902,5887,3350,2537,3347296.2,2536917.66,5884213.86
351630,201902,2653,1363,1290,1361272.9,1291412.4,2652685.3
351640,201902,1742,838,904,836324.49,902193.03,1738517.52
351650,201902,35,30,5,29940,4990,34930
351660,201902,147,93,54,92814,53892,146706
351670,201902,714,439,275,439121.1,274450,713571.1
351680,201902,73,58,15,57884,14970,72854
351685,201902,37,21,16,20958,15968,36926
351690,201902,300,209,91,208582.45,90818,299400.45
351700,201902,156,113,43,112774,42914,155688
351710,201902,74,50,24,50898,23952,74850
351720,201902,132,66,66,65868,65868,131736
351730,201902,97,66,31,65868.63,30938.03,96806.66
351740,201902,718,471,247,470059.26,246506,716565.26
351750,201902,358,151,207,150698,206586,357284
351760,201902,784,598,186,596804,185628,782432
351770,201902,303,258,45,257484,44910,302394
351780,201902,165,95,70,94810.98,69860,164670.98
351790,201902,249,129,120,128742,119760,248502
351800,201902,46,30,16,29940,15968,45908
351810,201902,120,80,40,79840,39920,119760
351820,201902,859,619,240,617763.6,239521.39,857284.99
351830,201902,521,189,332,188622,331336,519958
351840,201902,1863,942,921,940117.44,919161.96,1859279.40
351850,201902,238,174,64,173652.3,63872,237524.3
351860,201902,714,487,227,487026.41,226546.9,713573.31
351870,201902,5565,2666,2899,2660670.74,2894203.13,5554873.87
351880,201902,18944,8105,10839,8088799.27,10821357.49,18910156.76
351885,201902,91,61,30,60878,29940,90818
351890,201902,70,59,11,58882,10978,69860
351900,201902,220,130,90,129740,89820,219560
351905,201902,79,33,46,32934,45908,78842
351907,201902,3248,1420,1828,1418159.34,1824347.56,3242506.90
351910,201902,181,76,105,75848,104790,180638
351920,201902,124,69,55,68862,55889.98,124751.98
351925,201902,90,60,30,59880,29940,89820
351930,201902,396,258,138,257484,137724,395208
351940,201902,245,113,132,112774,131736,244510
351950,201902,141,80,61,79840,60878,140718
351960,201902,890,418,472,417477,471056.4,888533.4
351970,201902,1930,1049,881,1048898.4,880237.78,1929136.18
351980,201902,150,77,73,76846,72854,149700
351990,201902,272,178,94,177644.96,93812,271456.96
352000,201902,356,217,139,216566.8,138722,355288.8
352010,201902,388,240,148,239520,147704,387224
352020,201902,192,68,124,67864,123752,191616
352030,201902,1073,553,520,551894,518960,1070854
352040,201902,587,252,335,252494,334330,586824
352042,201902,287,91,196,90818,195608.8,286426.8
352044,201902,371,220,151,219560,150698,370258
352050,201902,3336,1321,2015,1320357.56,2012966.4,3333323.96
352060,201902,103,64,39,63872,38922.4,102794.4
352070,201902,98,72,26,71857.26,25948,97805.26
352080,201902,66,40,26,39920,25948,65868
352090,201902,168,112,56,111776,55888,167664
352100,201902,264,125,139,124751.39,138724.38,263475.77
352110,201902,117,36,81,35928,80838,116766
352115,201902,67,25,42,24950,41916,66866
352120,201902,95,67,28,66866.67,27944,94810.67
352130,201902,221,183,38,182634,37924,220558
352140,201902,190,81,109,80838,108782.4,189620.4
352150,201902,117,63,54,62874,53892,116766
352160,201902,134,85,49,84830,48902,133732
352170,201902,372,261,111,260478,111776,372254
352180,201902,607,400,207,399200,207584.99,606784.99
352190,201902,258,100,158,99800,157684,257484
352200,201902,32,17,15,16966,14970,31936
352210,201902,3896,1660,2236,1656683.31,2232529.62,3889212.93
352215,201902,54,31,23,30938,22954,53892
352220,201902,7011,2691,4320,2691608.65,4313361.15,7004969.80
352230,201902,3277,2114,1163,2109788.28,1161682.62,3271470.90
352240,201902,2287,1325,962,1323348.4,960076.9,2283425.3
352250,201902,2635,1344,1291,1342313.72,1289417.97,2631731.69
352260,201902,1032,551,481,553890.8,481036.4,1034927.2
352265,201902,59,25,34,24950,33932,58882
352270,201902,425,254,171,253492,170659.88,424151.88
352280,201902,420,266,154,265468.63,154690,420158.63
352290,201902,175,108,67,107784,66866,174650
352300,201902,95,72,23,71856,22954,94810
352310,201902,5894,2818,3076,2814364.67,3072846.29,5887210.96
352320,201902,963,506,457,504988.4,456086,961074.4
352330,201902,519,252,267,251496,266466.4,517962.4
352340,201902,1377,671,706,669658.8,704589.6,1374248.4
352350,201902,334,205,129,204590,128742.4,333332.4
352360,201902,226,95,131,94810,130738.2,225548.2
352370,201902,106,70,36,69860,35928,105788
352380,201902,119,72,47,72854,46906,119760
352390,201902,2457,1102,1355,1100794.96,1352292.18,2453087.14
352400,201902,490,214,276,213572,275448.4,489020.4
352410,201902,824,589,235,588821.26,234530,823351.26
352420,201902,107,69,38,68862,37924,106786
352430,201902,1790,811,979,810378.69,977044.21,1787422.90
352440,201902,3154,1595,1559,1591811.52,1556884.72,3148696.24
352450,201902,201,167,34,166666,33932,200598
352460,201902,599,306,293,305389.39,292414,597803.39
352470,201902,638,223,415,223552,414170.98,637722.98
352480,201902,1367,770,597,769458,595806.4,1365264.4
352490,201902,66,24,42,23952,41916,65868
352500,201902,1211,543,668,541914.34,666665.38,1208579.72
352510,201902,753,411,342,410179.32,341316,751495.32
352520,201902,601,271,330,270458,329340,599798
352530,201902,1710,903,807,901194,805386.4,1706580.4
352540,201902,73,49,24,48902,23952,72854
352550,201902,182,105,77,104790,76846,181636
352560,201902,51,40,11,39920,10978,50898
352570,201902,683,353,330,352295.03,330338,682633.03
352580,201902,57,40,17,39920,16966,56886
352585,201902,19,7,12,6986,11976,18962
352590,201902,4411,2240,2171,2235520,2168655.78,4404175.78
352600,201902,351,245,106,244510.63,105788,350298.63
352610,201902,971,435,536,434130.97,534928,969058.97
352620,201902,976,398,578,397204,577842,975046
352630,201902,170,63,107,62874,106786,169660
352640,201902,551,383,168,382234,167664,549898
352650,201902,90,60,30,59880,29940,89820
352660,201902,78,47,31,46906,30938,77844
352670,201902,1658,902,756,901195.59,755496.89,1656692.48
352680,201902,904,578,326,576845.83,326346.6,903192.43
352690,201902,4442,2040,2402,2035923.15,2399192.63,4435115.78
352700,201902,116,71,45,70858,44910,115768
352710,201902,1373,747,626,745506,624748.99,1370254.99
352720,201902,1341,643,698,641714,698600.4,1340314.4
352725,201902,24,22,2,21956,1996,23952
352730,201902,384,196,188,195608,188622,384230
352740,201902,425,275,150,274450.56,149700.68,424151.24
352750,201902,22,14,8,13972,7984,21956
352760,201902,191,129,62,128742,61876,190618
352770,201902,79,62,17,61876,16966,78842
352780,201902,75,40,35,39920,34930,74850
352790,201902,30,24,6,23952.69,5988,29940.69
352800,201902,247,173,74,172654,73852,246506
352810,201902,165,106,59,105789.26,58882,164671.26
352820,201902,63,51,12,50898,11976,62874
352830,201902,90,63,27,62874,26946,89820
352840,201902,655,344,311,343312.5,310378,653690.5
352850,201902,1400,489,911,488022,909178,1397200
352860,201902,131,84,47,84830,46906,131736
352870,201902,45,27,18,26946,17964,44910
352880,201902,187,125,62,124750.9,61876,186626.9
352885,201902,29,22,7,21956,6986,28942
352890,201902,57,40,17,39920,16966.4,56886.4
352900,201902,4800,2334,2466,2329339.45,2461075.82,4790415.27
352910,201902,37,30,7,29940,6986,36926
352920,201902,683,417,266,416166,265468,681634
352930,201902,1224,589,635,587833.76,633775.98,1221609.74
352940,201902,6472,2731,3741,2726540.01,3738516.07,6465056.08
352950,201902,95,38,57,37924,56886,94810
352960,201902,61,41,20,40918,19960,60878
352965,201902,18,8,10,7984,9980,17964
352970,201902,497,373,124,372254.02,123753.61,496007.63
352980,201902,170,91,79,90818,78842,169660
352990,201902,975,439,536,438122,534928.4,973050.4
353000,201902,63,28,35,27944,34930,62874
353010,201902,555,343,212,342314,212574,554888
353020,201902,282,206,76,205588,75848,281436
353030,201902,1266,580,686,579838.98,685626.98,1265465.96
353040,201902,92,58,34,57884,33932,91816
353050,201902,1319,844,475,842313.42,475048,1317361.42
353060,201902,8469,3792,4677,3786420.66,4670650.88,8457071.54
353070,201902,1687,1080,607,1077842.96,605608.35,1683451.31
353080,201902,1308,694,614,694609.16,612772,1307381.16
353090,201902,57,32,25,31936,24950,56886
353100,201902,59,49,10,48902,9980,58882
353110,201902,2051,641,1410,640716.4,1409177.18,2049893.58
353120,201902,88,49,39,48902,38922,87824
353130,201902,865,420,445,419162.36,444112.94,863275.30
353140,201902,573,231,342,230538,341316,571854
353150,201902,359,201,158,200598,157684,358282
353160,201902,96,78,18,77844,17964,95808
353170,201902,192,64,128,63872,127745.96,191617.96
353180,201902,974,455,519,454090.4,517962.7,972053.1
353190,201902,490,353,137,352294.3,136726.4,489020.7
353200,201902,207,109,98,108782,97804,206586
353205,201902,26,20,6,19960,5988,25948
353210,201902,84,50,34,49900,33932,83832
353215,201902,53,30,23,29940,22954,52894
353220,201902,82,47,35,46906,34930,81836
353230,201902,158,64,94,63872,93812,157684
353240,201902,298,165,133,164670,132734,297404
353250,201902,200,105,95,104790,94810,199600
353260,201902,458,327,131,326347.1,130738,457085.1
353270,201902,66,50,16,49900,15968,65868
353280,201902,97,53,44,52894.6,43912,96806.6
353282,201902,129,91,38,90818,37924,128742
353284,201902,25,20,5,19960,4990,24950
353286,201902,0,0,0,,,0.0
353290,201902,75,44,31,43912,31936,75848
353300,201902,424,234,190,233533.26,189620,423153.26
353310,201902,49,43,6,42914,5988,48902
353320,201902,61,39,22,38922,21956,60878
353325,201902,57,34,23,33932,22955.36,56887.36
353330,201902,66,48,18,47904.7,17964,65868.7
353340,201902,615,211,404,210578,405189.39,615767.39
353350,201902,917,434,483,433134.6,485030.76,918165.36
353360,201902,107,87,20,86826,19960.4,106786.4
353370,201902,122,68,54,67864,53892,121756
353380,201902,29,20,9,19960.99,8982,28942.99
353390,201902,1117,536,581,534928,579838,1114766
353400,201902,47,30,17,29940,16966,46906
353410,201902,113,69,44,69860,43912.9,113772.9
353420,201902,59,24,35,23952,34930,58882
353430,201902,577,386,191,385229.38,190618,575847.38
353440,201902,10676,4741,5935,4731524.58,5929130.92,10660655.50
353450,201902,56,32,24,31936,23952,55888
353460,201902,592,330,262,330338.1,261476,591814.1
353470,201902,2141,1154,987,1151696.19,986027.96,2137724.15
353475,201902,232,152,80,151697.38,79840,231537.38
353480,201902,185,152,33,151696,32934,184630
353490,201902,239,142,97,141716,96806,238522
353500,201902,193,111,82,110778.63,81836,192614.63
353510,201902,99,72,27,71856.98,26946,98802.98
353520,201902,206,140,66,139720,65868,205588
353530,201902,469,250,219,249500,220558,470058
353540,201902,371,251,120,250498,119760,370258
353550,201902,741,489,252,488023.24,251496,739519.24
353560,201902,626,262,364,261476,363272.98,624748.98
353570,201902,62,32,30,31936.4,29940,61876.4
353580,201902,358,273,85,272454.74,84830,357284.74
353590,201902,86,57,29,56886,28942,85828
353600,201902,270,153,117,152694.63,117764,270458.63
353610,201902,118,62,56,61876,55888,117764
353620,201902,601,314,287,313372,286426,599798
353625,201902,52,31,21,30938,20958,51896
353630,201902,239,174,65,173652.58,64870,238522.58
353640,201902,128,87,41,86826,40918,127744
353650,201902,905,358,547,357284,545906,903190
353657,201902,26,20,6,19960,5988,25948
353660,201902,257,141,116,140718,115768,256486
353670,201902,782,472,310,471057.03,310378.4,781435.43
353680,201902,109,77,32,76846.5,31936,108782.5
353690,201902,46,37,9,36926.52,8982,45908.52
353700,201902,275,197,78,196606,77844,274450
353710,201902,463,220,243,219560.6,242514.4,462075.0
353715,201902,48,34,14,33932,13972,47904
353720,201902,354,164,190,163672.98,189620,353292.98
353730,201902,1119,690,429,688621.6,429140,1117761.6
353740,201902,641,353,288,352294.4,287424,639718.4
353750,201902,87,55,32,54890,31936,86826
353760,201902,2820,1088,1732,1085826.25,1728538.18,2814364.43
353770,201902,94,77,17,76846,16966,93812
353780,201902,1240,595,645,594808.63,644708,1239516.63
353790,201902,513,302,211,301396.96,211576.4,512973.36
353800,201902,3294,1657,1637,1655685.89,1633797.22,3289483.11
353810,201902,235,135,100,134730.98,99800.98,234531.96
353820,201902,201,98,103,97804,102794,200598
353830,201902,47,40,7,39920,6986,46906
353850,201902,171,87,84,86826,83832,170658
353860,201902,490,221,269,220558,268462,489020
353870,201902,5269,2677,2592,2672650.79,2587817.63,5260468.42
353880,201902,682,483,199,482034.52,198602,680636.52
353890,201902,581,334,247,334330.4,246506.84,580837.24
353900,201902,134,69,65,68862,64870,133732
353910,201902,172,84,88,83832,87824,171656
353920,201902,445,244,201,243512.3,200598.99,444111.29
353930,201902,1008,601,407,599798,406188.14,1005986.14
353940,201902,186,99,87,99800,86826,186626
353950,201902,529,320,209,319360,208582.98,527942.98
353960,201902,71,58,13,57884,12974,70858
353970,201902,71,40,31,39920,30938,70858
353980,201902,1592,774,818,772452,816367.96,1588819.96
353990,201902,73,41,32,40918,31936,72854
354000,201902,366,183,183,182634.6,182634.99,365269.59
354010,201902,90,50,40,49900,39920,89820
354020,201902,534,341,193,341316,192614,533930
354025,201902,49,39,10,38922,9980,48902
354030,201902,64,38,26,37924,25948,63872
354040,201902,96,69,27,68862,26946,95808
354050,201902,193,102,91,101796.4,90818,192614.4
354060,201902,755,367,388,366266.4,387224.4,753490.8
354070,201902,924,550,374,548901.51,373252,922153.51
354075,201902,220,114,106,113772.4,105788,219560.4
354080,201902,296,126,170,125748,169660,295408
354085,201902,21,13,8,12974,7984,20958
354090,201902,307,169,138,168578,137724,306302
354100,201902,5581,2411,3170,2406180.23,3164660.92,5570841.15
354105,201902,86,41,45,40918,44910,85828
354110,201902,46,20,26,19960,25948,45908
354120,201902,135,95,40,94810.98,39920.4,134731.38
354130,201902,704,461,243,461076,242515.39,703591.39
354140,201902,3143,1466,1677,1463068.6,1675642.99,3138711.59
354150,201902,634,395,239,394211.76,239520,633731.76
354160,201902,701,446,255,446106,254490.4,700596.4
354165,201902,24,15,9,14970,8982,23952
354170,201902,176,121,55,120758,54890,175648
354180,201902,65,40,25,39920.51,24950,64870.51
354190,201902,205,92,113,91816,112774,204590
354200,201902,120,66,54,65868,53892,119760
354210,201902,64,30,34,29940,33932,63872
354220,201902,641,398,243,398202,242514.4,640716.4
354230,201902,160,66,94,65868,93812,159680
354240,201902,324,213,111,212574.64,111776,324350.64
354250,201902,87,53,34,52894,33932,86826
354260,201902,2027,945,1082,945110.03,1079836.87,2024946.90
354270,201902,96,71,25,70858,24950,95808
354280,201902,43,23,20,22954,19960,42914
354290,201902,134,90,44,89820,43912,133732
354300,201902,423,289,134,288422.63,133732.26,422154.89
354310,201902,98,71,27,70858.4,26946,97804.4
354320,201902,190,100,90,99800,89820.4,189620.4
354323,201902,15,14,1,13972,998,14970
354325,201902,111,66,45,65868.6,44910,110778.6
354330,201902,2622,868,1754,866122.8,1752490.01,2618612.81
354340,201902,10641,5212,5429,5204592.03,5422140.7,10626732.73
354350,201902,128,83,45,82834,44910,127744
354360,201902,87,48,39,47904,38922,86826
354370,201902,263,147,116,146706,115768,262474
354380,201902,204,120,84,120758,83832,204590
354390,201902,2737,995,1742,993010.99,1739515.97,2732526.96
354400,201902,320,170,150,169660,149700.8,319360.8
354410,201902,612,292,320,291416.4,319360.4,610776.8
354420,201902,277,175,102,174650,101796,276446
354425,201902,315,183,132,182634,131736,314370
354430,201902,182,111,71,110778,70858,181636
354440,201902,34,25,9,24950,8982,33932
354450,201902,48,35,13,34930,12974,47904
354460,201902,104,61,43,60878,42914,103792
354470,201902,41,26,15,25948,14970,40918
354480,201902,116,60,56,59880.98,55888,115768.98
354490,201902,144,88,56,87824,55888,143712
354500,201902,398,196,202,195608,201596,397204
354510,201902,97,71,26,71856,25948,97804
354515,201902,38,14,24,13972,23952,37924
354520,201902,1617,709,908,707440.4,906184.8,1613625.2
354530,201902,694,351,343,350298.99,342314,692612.99
354540,201902,277,154,123,154690,122754,277444
354550,201902,43,26,17,25948,16966,42914
354560,201902,161,88,73,87824,72854,160678
354570,201902,135,88,47,87824.5,47138.86,134963.36
354580,201902,1948,938,1010,938122.29,1008979.39,1947101.68
354600,201902,257,147,110,146706.2,109780,256486.2
354610,201902,72,63,9,62874.46,8982.98,71857.44
354620,201902,61,18,43,17964,42914,60878
354625,201902,18,12,6,11976,5988.99,17964.99
354630,201902,318,214,104,213572.98,103792,317364.98
354640,201902,805,524,281,522952.3,280438,803390.3
354650,201902,73,40,33,39920,32934.98,72854.98
354660,201902,810,599,211,597803.03,211576,809379.03
354670,201902,266,93,173,92814.76,172654.6,265469.36
354680,201902,1286,482,804,481036,803390,1284426
354690,201902,81,52,29,51896.4,28942,80838.4
354700,201902,75,55,20,54890,19960,74850
354710,201902,51,34,17,33932,16966,50898
354720,201902,21,20,1,19960,998,20958
354730,201902,1791,770,1021,768461.78,1019956.4,1788418.18
354740,201902,61,43,18,42914,17964,60878
354750,201902,435,256,179,256486.98,178642.4,435129.38
354760,201902,499,305,194,304391.8,194610.4,499002.2
354765,201902,11,5,6,4990,5988,10978
354770,201902,339,221,118,221556,118762,340318
354780,201902,8052,3281,4771,3276446.4,4767473.49,8043919.89
354790,201902,108,63,45,62874,44910,107784
354800,201902,443,243,200,242514,200598.4,443112.4
354805,201902,103,51,52,51896,51896,103792
354810,201902,121,71,50,70858,49900,120758
354820,201902,190,80,110,79840.56,109780,189620.56
354830,201902,41,21,20,20958,19960,40918
354840,201902,60,40,20,39920,19960,59880
354850,201902,4577,2080,2497,2076838.8,2493004.4,4569843.2
354860,201902,334,161,173,160678,172654.93,333332.93
354870,201902,12542,5638,6904,5628733.26,6899183.45,12527916.71
354880,201902,3063,1153,1910,1151692.4,1906184.94,3057877.34
354890,201902,2903,1602,1301,1599798.09,1299396,2899194.09
354900,201902,59,38,21,37924,20958,58882
354910,201902,1251,667,584,665667.03,582832,1248499.03
354920,201902,51,42,9,41916,8982,50898
354925,201902,14,8,6,7984,5988,13972
354930,201902,31,28,3,27944,2994,30938
354940,201902,847,622,225,624000.63,225548,849548.63
354950,201902,209,138,71,137724.6,70858,208582.6
354960,201902,160,63,97,62874,96806.4,159680.4
354970,201902,917,613,304,612772.97,304390.4,917163.37
354980,201902,8505,3137,5368,3131727.96,5361264.87,8492992.83
354990,201902,8994,4267,4727,4259471.89,4719596.94,8979068.83
354995,201902,551,194,357,193612,357284,550896
355000,201902,486,169,317,168662,316366,485028
355010,201902,608,381,227,380238.4,226547.23,606785.63
355020,201902,742,461,281,460078.32,280439.98,740518.30
355030,201902,209328,81612,127716,81485348.71,127590505.93,209075854.64
355040,201902,737,345,392,346306.84,391216,737522.84
355050,201902,146,97,49,96807.4,48902,145709.4
355060,201902,1603,815,788,813371.2,786424.6,1599795.8
355070,201902,1441,700,741,698601.81,740517.61,1439119.42
355080,201902,207,120,87,119760,86826,206586
355090,201902,288,181,107,180638.78,107784.32,288423.10
355100,201902,4811,2376,2435,2372151.66,2431130.19,4803281.85
355110,201902,266,173,93,172655.39,92814,265469.39
355120,201902,86,63,23,62874,22954.98,85828.98
355130,201902,58,33,25,32934,24950,57884
355140,201902,185,120,65,119760,64870,184630
355150,201902,689,415,274,414171.39,273452,687623.39
355160,201902,472,228,244,227544.63,243512,471056.63
355170,201902,2086,1095,991,1095804,990016,2085820
355180,201902,646,275,371,274450,372254,646704
355190,201902,222,154,68,153692,67864,221556
355200,201902,117,67,50,66866,49900,116766
355210,201902,692,396,296,395208.8,296406.98,691615.78
355220,201902,6979,3718,3261,3713564.27,3255478.2,6969042.47
355230,201902,108,64,44,63872,43912,107784
355240,201902,4390,1889,2501,1887222.96,2496999,4384221.96
355250,201902,5554,2650,2904,2645700.87,2902189.65,5547890.52
355255,201902,49,31,18,30938,17964,48902
355260,201902,181,107,74,106786.4,73853.96,180640.36
355270,201902,165,101,64,100798,64870,165668
355280,201902,6272,2623,3649,2619752.8,3643700.76,6263453.56
355290,201902,73,56,17,55888,16966,72854
355300,201902,189,122,67,121756.63,66866.4,188623.03
355310,201902,110,61,49,60878,48902,109780
355320,201902,89,47,42,46906,41916,88822
355330,201902,285,162,123,161676,122754,284430
355340,201902,1566,520,1046,518960.4,1043908,1562868.4
355350,201902,130,68,62,67864,61876,129740
355360,201902,177,114,63,113772,63872,177644
355365,201902,25,20,5,19960,4990,24950
355370,201902,1038,600,438,599813.56,437135.16,1036948.72
355380,201902,791,521,270,519958,269460,789418
355385,201902,65,47,18,46906,17964,64870
355390,201902,107,64,43,63872,42914,106786
355395,201902,187,111,76,110778.47,76846,187624.47
355400,201902,1609,982,627,981952.13,625748.27,1607700.40
355410,201902,4897,2325,2572,2321353.28,2567860.14,4889213.42
355420,201902,49,35,14,34930,13972,48902
355430,201902,350,210,140,209580,139720,349300
355440,201902,80,48,32,47904,31936,79840
355450,201902,449,220,229,219560.48,228542.4,448102.88
355460,201902,65,50,15,49900.54,14970,64870.54
355465,201902,50,31,19,30938,18962,49900
355470,201902,180,72,108,71856.7,107784,179640.7
355475,201902,15,10,5,9980,4990,14970
355480,201902,466,208,258,207584.6,257484,465068.6
355490,201902,116,82,34,81836,33932,115768
355495,201902,58,29,29,28942,28942,57884
355500,201902,1652,931,721,929141.69,719560.96,1648702.65
355510,201902,270,198,72,197605.26,71856,269461.26
355520,201902,31,23,8,22954.4,7984,30938.4
355530,201902,22,15,7,15968,6986,22954
355535,201902,77,37,40,36926,39920,76846
355540,201902,2376,943,1433,942253.11,1430135.61,2372388.72
355550,201902,63,37,26,36926,25948,62874
355560,201902,248,118,130,117764,129740,247504
355570,201902,27,18,9,17964,8982,26946
355580,201902,258,175,83,174650,82835.39,257485.39
355590,201902,22,14,8,13972,7984,21956
355600,201902,272,141,131,140718,131736.4,272454.4
355610,201902,231,154,77,153692,76846,230538
355620,201902,1336,645,691,644708.4,691614.99,1336323.39
355630,201902,434,319,115,318362,114770.63,433132.63
355635,201902,125,62,63,61876,62875.97,124751.97
355640,201902,565,321,244,320358,244510,564868
355645,201902,833,352,481,351296,480038.4,831334.4
355650,201902,2087,884,1203,882233.74,1201592.98,2083826.72
355660,201902,253,140,113,139720,112774,252494
355670,201902,527,210,317,211576,316366,527942
355680,201902,207,119,88,118762.97,87824.4,206587.37
355690,201902,90,42,48,41916,47904.67,89820.67
355695,201902,12,9,3,8982,2994,11976
355700,201902,1137,590,547,589818.66,545906.8,1135725.46
355710,201902,2245,1236,1009,1233530.63,1008978,2242508.63
355715,201902,19,16,3,15968,2994,18962
355720,201902,198,116,82,115768.44,81836,197604.44
355730,201902,99,58,41,57884,40918,98802
410010,201902,132,112,20,111776,19960,131736
410020,201902,105,90,15,89820,14970,104790
410030,201902,164,106,58,105788.6,57884,163672.6
410040,201902,1036,561,475,559878,474050.6,1033928.6
410045,201902,31,26,5,25948,4990,30938
410050,201902,470,266,204,265468,203592,469060
410060,201902,268,201,67,200598,66866,267464
410070,201902,310,256,54,255488,53892,309380
410080,201902,165,104,61,103792,60878,164670
410090,201902,79,71,8,70858.56,7984,78842.56
410100,201902,299,215,84,214570,83832,298402
410105,201902,46,27,19,26946,18962,45908
410110,201902,329,200,129,199600,128742,328342
410115,201902,31,21,10,20958,9980,30938
410120,201902,405,213,192,213572,191616,405188
410130,201902,46,30,16,29940,15968,45908
410140,201902,3151,1536,1615,1532930.5,1614766.6,3147697.1
410150,201902,2726,1108,1618,1105785.14,1614764.4,2720549.54
410160,201902,499,315,184,314370,183632,498002
410165,201902,69,45,24,44910,23952,68862
410170,201902,170,122,48,121756,47904,169660
410180,201902,2170,1260,910,1257480.4,908181.59,2165661.99
410185,201902,36,32,4,31936,3992,35928
410190,201902,494,325,169,324350,168662,493012
410200,201902,949,715,234,714568,233532,948100
410210,201902,570,298,272,297404,271456.4,568860.4
410220,201902,43,21,22,20958,21956,42914
410230,201902,133,71,62,70858,61876,132734
410240,201902,750,494,256,493012.8,255488.4,748501.2
410250,201902,372,275,97,274450,96806,371256
410260,201902,291,167,124,166666.86,123752,290418.86
410270,201902,29,19,10,18962,9980,28942
410275,201902,62,46,16,45908,15968,61876
410280,201902,322,185,137,184630,136726,321356
410290,201902,239,150,89,149700,88822,238522
410300,201902,80,62,18,61909.26,17964,79873.26
410302,201902,25,16,9,15968,8982,24950
410304,201902,43,29,14,28942,13972,42914
410305,201902,214,117,97,116766,96806,213572
410310,201902,273,173,100,172654,99800,272454
410315,201902,50,36,14,35928.44,13972,49900.44
410320,201902,138,96,42,95808,41916,137724
410322,201902,34,23,11,22954,10978,33932
410330,201902,171,123,48,122754,47904.6,170658.6
410335,201902,100,59,41,58882,40918,99800
410337,201902,41,35,6,34930,5988,40918
410340,201902,33,31,2,30938,1996,32934
410345,201902,224,139,85,138722,84830,223552
410347,201902,51,38,13,37924,12974,50898
410350,201902,235,142,93,141716,92814,234530
410360,201902,466,287,179,286426.8,179641.2,466068.0
410370,201902,2379,1023,1356,1020955.08,1353289.64,2374244.72
410380,201902,225,140,85,139720,84830,224550
410390,201902,375,273,102,272454.99,101796,374250.99
410395,201902,33,22,11,21956,10978,32934
410400,201902,849,425,424,424151.61,422589.5,846741.11
410405,201902,94,71,23,70858,22954,93812
410410,201902,36,28,8,27944,7984,35928
410420,201902,1650,810,840,808293.16,838320.34,1646613.50
410425,201902,172,81,91,80838.6,90818,171656.6
410430,201902,2193,1279,914,1277440.74,913170.93,2190611.67
410440,201902,383,281,102,280438,101796,382234
410442,201902,359,240,119,239520.7,118762,358282.7
410445,201902,413,292,121,291416,120758,412174
410450,201902,393,206,187,205588,187624,393212
410460,201902,463,247,216,246506,215568,462074
410465,201902,202,129,73,128742,72854,201596
410470,201902,228,147,81,146706,80838,227544
410480,201902,5982,2963,3019,2960079.3,3012974.4,5973053.7
410490,201902,1420,915,505,914169.2,504988.4,1419157.6
410500,201902,269,157,112,156686,111776,268462
410510,201902,170,127,43,126746,42914.98,169660.98
410520,201902,255,191,64,190618,63872,254490
410530,201902,228,83,145,82834,144710.99,227544.99
410540,201902,316,228,88,227544.99,87824,315368.99
410550,201902,1673,753,920,752492,919158.7,1671650.7
410560,201902,138,104,34,104790,33932,138722
410570,201902,431,292,139,291417.32,138722,430139.32
410580,201902,3215,1443,1772,1440115.32,1768457,3208572.32
410590,201902,399,282,117,281436,117764,399200
410600,201902,192,165,27,165668,26946,192614
410610,201902,59,50,9,49900,8982,58882
410620,201902,244,176,68,175648,67864,243512
410630,201902,443,260,183,259480,182634,442114
410640,201902,1040,652,388,650697.3,388222.99,1038920.29
410645,201902,104,78,26,77844.22,25948,103792.22
410650,201902,361,246,115,246506,114770,361276
410655,201902,78,59,19,58882,18962,77844
410657,201902,46,19,27,18962,26946,45908
410660,201902,608,430,178,429141.7,177644,606785.7
410670,201902,74,63,11,62874,10978,73852
410680,201902,199,166,33,165668,32934,198602
410685,201902,16,10,6,9980,5988,15968
410690,201902,28158,12197,15961,12172526.75,15937785.68,28110312.43
410700,201902,321,240,81,239520.4,80838,320358.4
410710,201902,129,107,22,106786,21956,128742
410712,201902,22,15,7,14970,6986,21956
410715,201902,90,68,22,67864,21956,89820
410720,201902,624,374,250,373252,249500.98,622752.98
410725,201902,180,134,46,133732,45908,179640
410730,201902,89,52,37,51896,36926,88822
410740,201902,116,85,31,84830,30938,115768
410750,201902,230,163,67,162674,66866,229540
410752,201902,24,15,9,14970,8982,23952
410753,201902,48,21,27,20958,27944,48902
410754,201902,40,25,15,24950.4,14970,39920.4
410755,201902,81,53,28,52894,27944,80838
410760,201902,737,419,318,418162.4,317364,735526.4
410765,201902,1694,820,874,818362.36,872253.2,1690615.56
410770,201902,105,82,23,81836,22954,104790
410773,201902,55,41,14,40918,13972,54890
410775,201902,181,133,48,132734,47904,180638
410780,201902,82,45,37,44910,36926,81836
410785,201902,55,44,11,43912,10978,54890
410790,201902,73,35,38,34930,37924,72854
410800,201902,287,180,107,179640.52,106786,286426.52
410810,201902,23,20,3,19960,2994.4,22954.4
410820,201902,179,130,49,129740,48902,178642
410830,201902,8500,3804,4696,3797397.02,4687616.47,8485013.49
410832,201902,105,76,29,75848,28942,104790
410840,201902,1415,792,623,790418.97,621757.44,1412176.41
410845,201902,65,43,22,42914.4,21956,64870.4
410850,201902,198,141,57,140718,56886,197604
410855,201902,50,43,7,42914,6986,49900
410860,201902,678,391,287,391216.94,286426,677642.94
410865,201902,103,79,24,78842,23952,102794
410870,201902,155,130,25,129740,24950,154690
410880,201902,1122,572,550,570861.34,548904.88,1119766.22
410890,201902,83,58,25,57884,24950,82834
410895,201902,72,56,16,55888,15968,71856
410900,201902,21,13,8,12974,7984,20958
410910,201902,14,12,2,11976,1996,13972
410920,201902,36,24,12,23952,11976,35928
410930,201902,500,319,181,318362,180638,499000
410940,201902,4348,2520,1828,2515593.9,1824344.8,4339938.7
410950,201902,111,84,27,83832,26946,110778
410960,201902,776,350,426,349300,425148,774448
410965,201902,69,54,15,53892,14970,68862
410970,201902,629,446,183,445108,182634,627742
410975,201902,110,64,46,63872.72,45908,109780.72
410980,201902,1629,738,891,736524.4,889218.99,1625743.39
410990,201902,267,186,81,185628,80838,266466
411000,201902,66,41,25,40918,24950.4,65868.4
411005,201902,26,20,6,19960,5988,25948
411007,201902,252,144,108,143712,108782,252494
411010,201902,589,410,179,409180,178642,587822
411020,201902,298,207,91,206586,90818,297404
411030,201902,16,9,7,8982,6986,15968
411040,201902,53,38,15,37924,14970,52894
411050,201902,218,167,51,166683.6,50902.4,217586.0
411060,201902,516,349,167,348302.98,166666,514968.98
411065,201902,66,57,9,56886,8982,65868
411070,201902,1206,781,425,780437.54,425148,1205585.54
411080,201902,232,162,70,161676,69860,231536
411090,201902,107,80,27,79840,26946,106786
411095,201902,284,114,170,113772,169660,283432
411100,201902,113,94,19,93812,18962,112774
411110,201902,121,84,37,83832,36926,120758
411120,201902,194,141,53,140718,52894,193612
411125,201902,195,92,103,91816,102794,194610
411130,201902,122,104,18,103792,17964,121756
411140,201902,199,133,66,132734,65868,198602
411150,201902,1230,819,411,817362,410179.03,1227541.03
411155,201902,125,83,42,82834,41916,124750
411160,201902,26,12,14,11976,13972,25948
411170,201902,53,48,5,47904,4990,52894
411180,201902,973,656,317,654688.83,316366,971054.83
411190,201902,340,194,146,194610,145708,340318
411200,201902,676,442,234,441116.63,233532,674648.63
411210,201902,702,380,322,379240,322354.98,701594.98
411220,201902,149,111,38,110778,37924,148702
411230,201902,42,36,6,35928,5988,41916
411240,201902,125,85,40,84830,39920,124750
411250,201902,433,320,113,319360,112774,432134
411260,201902,20,13,7,12974,6986,19960
411270,201902,292,157,135,156686,134730,291416
411275,201902,201,178,23,177644,22954,200598
411280,201902,221,157,64,156686.63,63872,220558.63
411290,201902,58,44,14,43912,13972,57884
411295,201902,150,118,32,117764,31936,149700
411300,201902,67,34,33,33932,32934,66866
411310,201902,92,71,21,70858,20958,91816
411320,201902,747,528,219,526944.8,218562.6,745507.4
411325,201902,61,38,23,37924,22954,60878
411330,201902,919,594,325,592812.5,324350.16,917162.66
411340,201902,26,18,8,17964,7984.34,25948.34
411342,201902,70,53,17,52894,16966,69860
411345,201902,121,63,58,62874,57884,120758
411350,201902,497,393,104,392214.58,103792.4,496006.98
411360,201902,56,35,21,34930,20958,55888
411370,201902,14327,5864,8463,5854273.1,8450085.01,14304358.11
411373,201902,184,135,49,134730,48902,183632
411375,201902,72,60,12,59880,11976,71856
411380,201902,94,72,22,71856,21956,93812
411390,201902,134,89,45,88822,44910,133732
411400,201902,367,277,90,276446.98,89820,366266.98
411410,201902,441,229,212,228542,211576.4,440118.4
411420,201902,1037,470,567,469060,565866,1034926
411430,201902,416,261,155,260478,154690.98,415168.98
411435,201902,36,25,11,24950,10978,35928
411440,201902,466,373,93,372254,92814,465068
411450,201902,429,361,68,360278,67864,428142
411460,201902,759,299,460,298407.48,459090.66,757498.14
411470,201902,82,60,22,59880,21956,81836
411480,201902,659,375,284,374250,283432,657682
411490,201902,300,192,108,191616,107784,299400
411500,201902,107,91,16,91816,15968,107784
411510,201902,219,177,42,176646,41916,218562
411520,201902,5999,2338,3661,2334325.69,3660668.92,5994994.61
411530,201902,118,83,35,82834,34930,117764
411535,201902,50,22,28,21956,27944,49900
411540,201902,362,251,111,250498,110778,361276
411545,201902,54,38,16,37924,15968,53892
411550,201902,77,59,18,58882,17964,76846
411560,201902,385,177,208,176646.44,207584,384230.44
411570,201902,792,301,491,300399.66,490018.6,790418.26
411573,201902,30,19,11,18962,10978,29940
411575,201902,285,181,104,180638,103792,284430
411580,201902,1246,497,749,496006.6,747502,1243508.6
411585,201902,75,37,38,36926,37924,74850
411590,201902,22,15,7,14970,6986,21956
411600,201902,25,11,14,10978,13972,24950
411605,201902,241,102,139,101796,138722,240518
411610,201902,241,162,79,162674,78842,241516
411620,201902,346,199,147,198602,146706,345308
411630,201902,57,41,16,40918,15968,56886
411640,201902,33,27,6,26946,5988,32934
411650,201902,13,8,5,7984,4990,12974
411660,201902,35,27,8,26946,7984,34930
411670,201902,249,186,63,185628,62874,248502
411680,201902,157,136,21,135728,20958,156686
411690,201902,585,309,276,308393.44,275452.4,583845.84
411695,201902,62,45,17,44910,16966,61876
411700,201902,152,131,21,130738,20958,151696
411705,201902,105,69,36,68862,35928,104790
411710,201902,307,205,102,204590,101796,306386
411720,201902,137,90,47,89820,46906,136726
411721,201902,62,53,9,52894,8982,61876
411722,201902,99,42,57,41916,56886,98802
411725,201902,153,120,33,119760.4,32934,152694.4
411727,201902,77,62,15,61876,14970,76846
411729,201902,34,26,8,25948,7984,33932
411730,201902,539,344,195,343312,194610,537922
411740,201902,41,25,16,24950,15968,40918
411745,201902,69,46,23,45908,22954,68862
411750,201902,865,398,467,397204.4,466066.4,863270.8
411760,201902,1203,911,292,909178.4,291416.98,1200595.38
411770,201902,445,293,152,292414,151696,444110
411780,201902,329,214,115,213572,114770,328342
411790,201902,525,299,226,299401.27,226547.96,525949.23
411800,201902,170,135,35,134730,34930,169660
411810,201902,165,125,40,124750,39920,164670
411820,201902,2128,1007,1121,1004987,1118758.6,2123745.6
411830,201902,12,12,0,11976,,11976.0
411840,201902,1948,1211,737,1209576,736525.53,1946101.53
411845,201902,51,21,30,20958,29940,50898
411850,201902,1225,696,529,694609.97,528943,1223552.97
411860,201902,44,31,13,30938.8,12974,43912.8
411870,201902,77,54,23,53892,22954,76846
411880,201902,429,276,153,275082.31,152694,427776.31
411885,201902,107,70,37,69860,36926,106786
411890,201902,322,205,117,204591.39,116766,321357.39
411900,201902,69,50,19,49900,18962,68862
411910,201902,182,144,38,143712,37924,181636
411915,201902,2083,900,1183,898200,1180636.22,2078836.22
411920,201902,123,101,22,100798,21956,122754
411925,201902,10,7,3,6986,2994,9980
411930,201902,804,592,212,590816.74,211576,802392.74
411940,201902,596,413,183,413172,182634,595806
411950,201902,903,475,428,474050.8,427144,901194.8
411960,201902,1041,720,321,718561.3,320358,1038919.3
411965,201902,24,16,8,15968,7984,23952
411970,201902,81,74,7,73852,6986,80838
411980,201902,168,117,51,116766,50898,167664
411990,201902,5171,3003,2168,2999993.7,2165661.79,5165655.49
411995,201902,458,171,287,170658,286426,457084
412000,201902,313,196,117,196606,116766,313372
412010,201902,51,31,20,30938,20958,51896
412015,201902,46,33,13,33932,12974,46906
412020,201902,28,24,4,23952,3992,27944
412030,201902,57,50,7,49900,6986,56886
412033,201902,54,35,19,34930.44,18962,53892.44
412035,201902,69,45,24,44910,23952,68862
412040,201902,38,25,13,24950.4,12974,37924.4
412050,201902,197,148,49,148702,48902,197604
412060,201902,767,587,180,586824.88,179640,766464.88
412065,201902,49,33,16,32934,15968,48902
412070,201902,158,106,52,105788,51896,157684
412080,201902,278,148,130,147704,129740,277444
412085,201902,34,16,18,15968,17964,33932
412090,201902,775,492,283,491016.9,283432,774448.9
412100,201902,245,207,38,206586.8,37924,244510.8
412110,201902,70,54,16,53892,15968,69860
412120,201902,312,198,114,197604,113772,311376
412125,201902,82,48,34,47904,33932,81836
412130,201902,40,29,11,28942.36,10978,39920.36
412135,201902,27,16,11,15968,10978,26946
412140,201902,323,228,95,227544,94810,322354
412150,201902,247,174,73,173652.48,72854,246506.48
412160,201902,86,52,34,51896,33932,85828
412170,201902,678,476,202,475048.4,201596,676644.4
412175,201902,36,27,9,26946,8982,35928
412180,201902,197,156,41,155689.11,40918,196607.11
412190,201902,333,264,69,263472,68862,332334
412200,201902,202,125,77,124750,76846,201596
412210,201902,76,59,17,58882,16966,75848
412215,201902,228,162,66,161676,65868,227544
412217,201902,72,56,16,55888,15968,71856
412220,201902,822,615,207,613770,206586,820356
412230,201902,334,201,133,200598,133734.94,334332.94
412240,201902,1349,669,680,667683.56,679654.68,1347338.24
412250,201902,382,243,139,242514,138722,381236
412260,201902,107,79,28,78842,27944,106786
412265,201902,175,138,37,137724,36926,174650
412270,201902,75,49,26,48902,25948,74850
412280,201902,90,73,17,72854,16966,89820
412290,201902,98,66,32,65868,31936,97804
412300,201902,218,141,77,140718,76846,217564
412310,201902,45,39,6,38922,5988,44910
412320,201902,93,80,13,79840,12974,92814
412330,201902,179,156,23,155688,22954,178642
412340,201902,152,107,45,106786,44910.4,151696.4
412350,201902,599,300,299,299400,298402,597802
412360,201902,29,25,4,24950,3992,28942
412370,201902,163,142,21,141716.2,20958,162674.2
412380,201902,261,193,68,192614,67865.78,260479.78
412382,201902,52,27,25,26946,24950,51896
412385,201902,144,106,38,105788,37924,143712
412390,201902,282,214,68,213572,67864,281436
412395,201902,71,57,14,56886,13972,70858
412400,201902,76,52,24,51896,23952,75848
412402,201902,248,123,125,122754,125748,248502
412405,201902,832,321,511,320358,509978,830336
412410,201902,956,596,360,594808.4,359280,954088.4
412420,201902,14,12,2,11976,1996,13972
412430,201902,21,15,6,14970,5988,20958
412440,201902,603,330,273,329355.4,272462.76,601818.16
412450,201902,82,70,12,69860,11976,81836
412460,201902,83,61,22,60878,21956,82834
412470,201902,226,181,45,180638,44910,225548
412480,201902,161,118,43,117764,42914,160678
412490,201902,160,139,21,138722,20958,159680
412500,201902,452,372,80,371256.85,79840,451096.85
412510,201902,187,156,31,155688.4,30938,186626.4
412520,201902,136,76,60,75848,59880,135728
412530,201902,108,56,52,55888,51896,107784
412535,201902,111,80,31,79841.96,30938,110779.96
412540,201902,76,36,40,35928,39920,75848
412545,201902,96,71,25,70858,24950,95808
412550,201902,3578,1625,1953,1621750,1949095.2,3570845.2
412555,201902,13,9,4,8982,3992,12974
412560,201902,589,429,160,428142,160678,588820
412570,201902,737,404,333,403192,332334,735526
412575,201902,91,62,29,61876,28942,90818
412580,201902,166,110,56,109780,55888,165668
412590,201902,36,32,4,31936,3992,35928
412600,201902,169,128,41,127744,40918,168662
412610,201902,32,20,12,19960,11976,31936
412620,201902,149,129,20,128742,19960,148702
412625,201902,2209,1177,1032,1175645.03,1032932.39,2208577.42
412627,201902,70,56,14,55888,13972,69860
412630,201902,415,278,137,277444.6,136726,414170.6
412635,201902,65,19,46,18962,45908,64870
412640,201902,119,78,41,77844,40918,118762
412650,201902,347,222,125,221556,124750,346306
412660,201902,471,293,178,292414,177644,470058
412665,201902,51,45,6,44910,5988,50898
412667,201902,294,203,91,202598.84,90820.2,293419.04
412670,201902,61,51,10,50898,9980,60878
412680,201902,301,239,62,238522,61876,300398
412690,201902,101,65,36,64870,35928.4,100798.4
412700,201902,154,104,50,103792,49900.4,153692.4
412710,201902,1392,855,537,853292.2,536924,1390216.2
412720,201902,234,156,78,155688,77844,233532
412730,201902,185,153,32,152694,31936,184630
412740,201902,421,233,188,232534,188622,421156
412750,201902,464,269,195,268462,194610,463072
412760,201902,269,141,128,140718,127744,268462
412770,201902,2129,1202,927,1199597.23,925147.78,2124745.01
412780,201902,154,119,35,118762,34930,153692
412785,201902,260,131,129,130738,128742,259480
412788,201902,35,20,15,19960,14970,34930
412790,201902,129,107,22,106786,21956,128742
412795,201902,153,114,39,113772,38922,152694
412796,201902,316,217,99,216566,98802,315368
412800,201902,584,376,208,376246,208582,584828
412810,201902,2980,1639,1341,1637720.89,1338318,2976038.89
412820,201902,931,598,333,596804.5,332334.98,929139.48
412830,201902,14,11,3,10978,2994,13972
412840,201902,223,157,66,157684.4,65868,223552.4
412850,201902,786,523,263,521954,262474,784428
412853,201902,170,89,81,88822,80838.4,169660.4
412855,201902,218,119,99,118762.26,99800,218562.26
412860,201902,97,69,28,68862,27944,96806
412862,201902,58,43,15,42914,14970,57884
412863,201902,6,5,1,4990,998,5988
412865,201902,41,31,10,30938,9980,40918
412870,201902,109,71,38,70858,37924,108782
412880,201902,100,73,27,72854.4,26946,99800.4
420005,201902,45,40,5,39920,4990,44910
420010,201902,371,245,126,244510.38,125748.4,370258.78
420020,201902,86,71,15,70858,14970,85828
420030,201902,29,27,2,26946,1996,28942
420040,201902,112,87,25,86826,24950,111776
420050,201902,51,31,20,30938,19960,50898
420055,201902,19,18,1,17964,998,18962
420060,201902,32,24,8,23952,7984,31936
420070,201902,108,91,17,90818,16966,107784
420075,201902,11,10,1,9980,998,10978
420080,201902,48,43,5,42914,4990,47904
420090,201902,34,32,2,31936,1996,33932
420100,201902,162,137,25,136726.4,24950,161676.4
420110,201902,20,20,0,19960,,19960.0
420120,201902,55,43,12,42914,11976,54890
420125,201902,87,70,17,69860,16966,86826
420127,201902,30,26,4,25948,3992,29940
420130,201902,398,249,149,248502,148702,397204
420140,201902,1310,748,562,747504.68,561875.86,1309380.54
420150,201902,44,39,5,38922,4990,43912
420160,201902,36,34,2,33932,1996,35928
420165,201902,19,14,5,13972,4990,18962
420170,201902,74,48,26,47904,25948,73852
420180,201902,23,22,1,21956,998,22954
420190,201902,30,26,4,25948,3992,29940
420195,201902,129,62,67,61876,66866,128742
420200,201902,1260,560,700,558881.99,698605.84,1257487.83
420205,201902,69,41,28,40918,27944,68862
420207,201902,113,64,49,63872.5,48902,112774.5
420208,201902,21,17,4,16966,3992,20958
420209,201902,20,16,4,15968,3992,19960
420210,201902,465,227,238,226546,237524.98,464070.98
420213,201902,46,37,9,36926,8982,45908
420215,201902,28,24,4,23952,3992,27944
420220,201902,67,44,23,43912,22954,66866
420230,201902,805,455,350,454090,349300.98,803390.98
420240,201902,2267,1512,755,1509977.14,753490,2263467.14
420243,201902,41,33,8,32934,7984,40918
420245,201902,130,67,63,66866,62874,129740
420250,201902,59,36,23,35928,22954,58882
420253,201902,42,33,9,32934,8982,41916
420257,201902,13,11,2,10978,1996,12974
420260,201902,105,91,14,90818,13972,104790
420270,201902,39,30,9,29940.99,8982,38922.99
420280,201902,277,206,71,205593.6,70860.66,276454.26
420285,201902,20,11,9,10978,8982,19960
420287,201902,56,36,20,35928,19960,55888
420290,201902,966,678,288,676644.99,288426.95,965071.94
420300,201902,1419,1132,287,1129737.65,286426.98,1416164.63
420310,201902,57,44,13,43912,12974,56886
420315,201902,32,28,4,27944,3992,31936
420320,201902,866,444,422,444110,421156.99,865266.99
420325,201902,0,0,0,0,0,0
420330,201902,126,86,40,85828,39920,125748
420340,201902,163,110,53,109781.18,52894,162675.18
420350,201902,257,191,66,190618,65868,256486
420360,201902,760,575,185,574848.98,184632.46,759481.44
420370,201902,117,73,44,72854,43912.4,116766.4
420380,201902,1142,812,330,811376.08,329344.72,1140720.80
420390,201902,257,176,81,175648,80838,256486
420395,201902,184,132,52,131736,51896,183632
420400,201902,249,189,60,188622.75,59880,248502.75
420410,201902,62,47,15,46906,14970,61876
420415,201902,35,31,4,30938,3992,34930
420417,201902,55,41,14,40918,13972,54890
420419,201902,12,12,0,11976,,11976.0
420420,201902,2823,1746,1077,1747503.95,1076845.74,2824349.69
420425,201902,75,62,13,61876.98,12974.98,74851.96
420430,201902,1260,882,378,881235.64,377244,1258479.64
420435,201902,18,16,2,15968,1996,17964
420440,201902,104,73,31,72854.4,30938,103792.4
420445,201902,23,21,2,20958,1996,22954
420450,201902,73,37,36,36926,35928,72854
420455,201902,216,165,51,164672.94,50900.94,215573.88
420460,201902,2329,1527,802,1526947.7,801402.82,2328350.52
420470,201902,118,87,31,86826,30938,117764
420475,201902,6,6,0,5988,,5988.0
420480,201902,870,659,211,657683.2,210578.8,868262.0
420490,201902,110,82,28,81836,27944,109780
420500,201902,624,284,340,284430.86,339320,623750.86
420510,201902,18,15,3,14970,2994,17964
420515,201902,27,20,7,19960,6986,26946
420517,201902,10,10,0,9980,,9980.0
420519,201902,0,0,0,0,0,0
420520,201902,74,55,19,54890,18962,73852
420530,201902,163,109,54,108782.3,53892,162674.3
420535,201902,20,19,1,18962,998,19960
420540,201902,5163,3059,2104,3056133.62,2099794.46,5155928.08
420543,201902,27,27,0,26946,,26946.0
420545,201902,197,139,58,138722,57884,196606
420550,201902,878,711,167,709580.16,166669.92,876250.08
420555,201902,40,29,11,28942,10978,39920
420560,201902,69,56,13,55888,12974,68862
420570,201902,160,96,64,95808,63872,159680
420580,201902,296,133,163,132734,162674.4,295408.4
420590,201902,512,359,153,358282,152694,510976
420600,201902,107,60,47,59880.4,46906,106786.4
420610,201902,41,38,3,37924,2994,40918
420620,201902,75,61,14,60878,13972,74850
420630,201902,159,116,43,116766.99,42915.98,159682.97
420640,201902,90,81,9,80838,8982,89820
420650,201902,234,122,112,121756,111776,233532
420660,201902,56,44,12,43912,11976,55888
420665,201902,38,28,10,27944,9980,37924
420670,201902,322,246,76,245508,75848.98,321356.98
420675,201902,16,15,1,14970,998,15968
420680,201902,36,26,10,25948,9980,35928
420690,201902,173,145,28,144710,27944,172654
420700,201902,686,484,202,483038.32,201604.82,684643.14
420710,201902,155,89,66,88822,65868,154690
420720,201902,113,91,22,90818,21956,112774
420730,201902,580,372,208,371260.26,207588.32,578848.58
420740,201902,47,46,1,45908,998,46906
420750,201902,517,347,170,346306,170658,516964
420757,201902,19,16,3,15968,2994,18962
420760,201902,36,30,6,29940,5988,35928
420765,201902,72,58,14,57884,13972,71856
420768,201902,64,56,8,55888,7984,63872
420770,201902,81,68,13,67864,12974,80838
420775,201902,45,41,4,40918,3992,44910
420780,201902,244,192,52,191616,51896,243512
420785,201902,12,9,3,8982,2994,11976
420790,201902,173,145,28,145712.9,27945.96,173658.86
420800,201902,71,54,17,53892,16966,70858
420810,201902,253,222,31,221556.4,30938,252494.4
420820,201902,2341,1377,964,1375245.6,962074.77,2337320.37
420830,201902,602,334,268,334331.2,267464,601795.2
420840,201902,150,112,38,111776,37924,149700
420845,201902,434,193,241,192614,241516.4,434130.4
420850,201902,240,192,48,191616,47904,239520
420860,201902,63,53,10,52894,9980,62874
420870,201902,119,86,33,85828,32934,118762
420880,201902,180,125,55,124750,54890,179640
420890,201902,901,452,449,451097.77,449100.98,900198.75
420895,201902,9,9,0,8982,,8982.0
420900,201902,416,330,86,330338.29,85828.98,416167.27
420910,201902,5834,3282,2552,3276442.53,2546900.94,5823343.47
420915,201902,77,72,5,71856,4990,76846
420917,201902,20,15,5,14970,4990,19960
420920,201902,23,16,7,15968,6986,22954
420930,201902,2794,1727,1067,1723541.14,1065039.24,2788580.38
420940,201902,606,442,164,441116.4,163676.49,604792.89
420945,201902,10,8,2,7984,1996,9980
420950,201902,58,52,6,51896,5988,57884
420960,201902,118,94,24,93813.96,23952.98,117766.94
420970,201902,301,241,60,240521.54,59881.96,300403.50
420980,201902,22,22,0,21956,,21956.0
420985,201902,64,57,7,56886,6986,63872
420990,201902,74,57,17,56886,16966,73852
421000,201902,33,22,11,21956,10978,32934
421003,201902,67,46,21,45908,20958.98,66866.98
421005,201902,7,4,3,3992,2994,6986
421010,201902,760,531,229,529939.38,229541.1,759480.48
421020,201902,27,22,5,21956,4990,26946
421030,201902,126,107,19,106786.3,18962,125748.3
421040,201902,70,58,12,57884,11976,69860
421050,201902,319,226,93,225548.4,92814,318362.4
421055,201902,25,21,4,20958,3992,24950
421060,201902,81,54,27,53892,26946,80838
421070,201902,48,44,4,43912.4,3992,47904.4
421080,201902,34,32,2,31936,1996,33932
421085,201902,24,19,5,18962,4990,23952
421090,201902,40,30,10,29940,9980,39920
421100,201902,131,97,34,96806,33932,130738
421105,201902,218,177,41,176646,40918.98,217564.98
421110,201902,113,92,21,91816,20958,112774
421120,201902,160,123,37,122754.98,36926,159680.98
421125,201902,17,12,5,11976,4990,16966
421130,201902,798,522,276,520956,275448.4,796404.4
421140,201902,31,23,8,22954,7984,30938
421145,201902,41,33,8,32934,7984,40918
421150,201902,107,77,30,76846,29940.8,106786.8
421160,201902,69,45,24,44910,23952,68862
421165,201902,17,16,1,15968,998,16966
421170,201902,193,164,29,163796.32,28942.98,192739.30
421175,201902,154,103,51,102794,50898,153692
421180,201902,60,40,20,39920.24,19960,59880.24
421185,201902,18,15,3,14970,2994,17964
421187,201902,0,0,0,0,0,0
421189,201902,43,32,11,31936,10978,42914
421190,201902,1618,1033,585,1030934.6,584828.8,1615763.4
421200,201902,90,68,22,67864,21956,89820
421205,201902,27,17,10,16966,9980,26946
421210,201902,170,122,48,121756,47904,169660
421220,201902,287,223,64,222554,63872,286426
421223,201902,52,44,8,43912.6,7984,51896.6
421225,201902,70,45,25,44910.6,24950,69860.6
421227,201902,98,74,24,73852,23952,97804
421230,201902,52,39,13,38922,12974,51896
421240,201902,19,19,0,18962,,18962.0
421250,201902,359,224,135,223553,134730,358283
421260,201902,25,21,4,20958,3992,24950
421265,201902,1,1,0,998,,998.0
421270,201902,54,48,6,47904,5988,53892
421280,201902,340,198,142,197604,141716,339320
421290,201902,325,222,103,221556,102794,324350
421300,201902,26,21,5,20958,4990,25948
421310,201902,51,38,13,37924,12974,50898
421315,201902,28,18,10,17964,9980,27944
421320,201902,135,92,43,92814,42914,135728
421330,201902,103,77,26,77844,25948.98,103792.98
421335,201902,39,27,12,26946,11976,38922
421340,201902,294,203,91,202594.82,90818,293412.82
421350,201902,195,113,82,112774.97,81836,194610.97
421360,201902,675,503,172,501995.88,171656.98,673652.86
421370,201902,194,151,43,150698,42914,193612
421380,201902,133,107,26,106786,25948,132734
421390,201902,17,12,5,11976,4990,16966
421400,201902,119,102,17,101796,16966,118762
421410,201902,21,19,2,18962,1996,20958
421415,201902,21,20,1,19960,998,20958
421420,201902,152,126,26,125748,25948,151696
421430,201902,14,10,4,9980,3992,13972
421440,201902,59,47,12,46906,11976,58882
421450,201902,93,79,14,78842,13972,92814
421460,201902,59,49,10,48902,9980,58882
421470,201902,67,45,22,44910,21956,66866
421480,201902,651,490,161,489020,160678.98,649698.98
421490,201902,22,21,1,20958.98,998,21956.98
421500,201902,505,330,175,329344.32,174665.68,504010.00
421505,201902,23,16,7,15968,6986,22954
421507,201902,35,30,5,29940,5988,35928
421510,201902,74,49,25,48902,24950,73852
421520,201902,63,54,9,53892,8982,62874
421530,201902,51,45,6,44910,5988,50898
421535,201902,26,25,1,24950.44,998,25948.44
421540,201902,57,49,8,48902,7984,56886
421545,201902,100,75,25,74850.98,24950,99800.98
421550,201902,296,217,79,216566,78842,295408
421555,201902,25,20,5,19960,5988.8,25948.8
421560,201902,8,7,1,6986,998,7984
421565,201902,122,85,37,84830,36926,121756
421567,201902,30,26,4,25948,3992,29940
421568,201902,32,30,2,29940,1996,31936
421569,201902,8,8,0,7984,,7984.0
421570,201902,174,116,58,115768,57884,173652
421575,201902,28,23,5,22954,4990,27944
421580,201902,705,422,283,422154,283432,705586
421590,201902,22,21,1,20958,998,21956
421600,201902,128,78,50,78842,49900.8,128742.8
421605,201902,110,78,32,78842.3,31936,110778.3
421610,201902,188,149,39,148702.4,38922,187624.4
421620,201902,1081,636,445,635727.38,444110,1079837.38
421625,201902,24,21,3,20958,2994,23952
421630,201902,294,185,109,184630.9,108783.2,293414.1
421635,201902,17,7,10,6986,9980,16966
421640,201902,96,82,14,81836.6,13972,95808.6
421650,201902,294,172,122,171656,121756,293412
421660,201902,2202,1333,869,1331332.8,868262.76,2199595.56
421670,201902,197,139,58,138722,57884,196606
421680,201902,170,154,16,153692,15968,169660
421690,201902,344,244,100,243514.94,99800.44,343315.38
421700,201902,62,40,22,39920,21956.2,61876.2
421710,201902,28,27,1,26946,998,27944
421715,201902,7,6,1,5988,998,6986
421720,201902,583,427,156,427144,155688,582832
421725,201902,13,5,8,4990,7984,12974
421730,201902,38,26,12,25948,11976,37924
421740,201902,89,43,46,42914,45908,88822
421750,201902,222,166,56,165668.69,55888,221556.69
421755,201902,26,24,2,23952,1996,25948
421760,201902,108,77,31,76846,30938,107784
421770,201902,605,404,201,403202.74,200603.12,603805.86
421775,201902,31,20,11,19960,10978,30938
421780,201902,191,149,42,148702,41916,190618
421790,201902,160,135,25,134730,24950,159680
421795,201902,20,15,5,14970,4990,19960
421800,201902,504,322,182,321356,181636.89,502992.89
421810,201902,76,61,15,60878,14970,75848
421820,201902,320,217,103,216566.4,102794,319360.4
421825,201902,132,110,22,109780,21956,131736
421830,201902,136,103,33,102794,32934,135728
421835,201902,3,3,0,2994,,2994.0
421840,201902,54,46,8,45908.98,7984,53892.98
421850,201902,81,70,11,69860,10978.99,80838.99
421860,201902,39,32,7,31936,6986,38922
421870,201902,971,745,226,743541.3,225554.16,969095.46
421875,201902,53,45,8,45908,7984,53892
421880,201902,169,121,48,120758,47904.4,168662.4
421885,201902,28,22,6,21956,5988,27944
421890,201902,122,87,35,86826,34930.98,121756.98
421895,201902,48,44,4,43912,3992,47904
421900,201902,160,128,32,127746.94,31939.92,159686.86
421910,201902,68,43,25,42914,24950,67864
421915,201902,31,26,5,25948,4990,30938
421917,201902,46,35,11,34930,10978,45908
421920,201902,34,31,3,30938,2994,33932
421930,201902,739,576,163,574848,162676.94,737524.94
421935,201902,53,46,7,45908,6986,52894
421940,201902,40,36,4,35928,3992,39920
421950,201902,830,554,276,554888.55,275449.58,830338.13
421960,201902,40,33,7,32934.4,6986,39920.4
421970,201902,361,229,132,228542.2,131736.98,360279.18
421985,201902,30,19,11,18962,10978,29940
422000,201902,0,0,0,0,0,0
430003,201902,198,52,146,51896,145708,197604
430005,201902,39,30,9,29940,8982,38922
430010,201902,273,192,81,191616,80838,272454
430020,201902,155,101,54,100798.4,53892,154690.4
430030,201902,128,103,25,102794,24950,127744
430040,201902,2959,1731,1228,1727539.7,1227543.32,2955083.02
430045,201902,69,59,10,58882,9980,68862
430047,201902,6,5,1,4990,998,5988
430050,201902,79,67,12,66866,11976,78842
430055,201902,15,13,2,12974,1996,14970
430057,201902,6,4,2,3992,1996,5988
430060,201902,3666,2173,1493,2168662.8,1490019.66,3658682.46
430063,201902,60,55,5,54890,4990,59880
430064,201902,159,133,26,132734,25948,158682
430066,201902,7,6,1,5988,998,6986
430070,201902,46,35,11,34930,10978,45908
430080,201902,67,45,22,44910,21956,66866
430085,201902,34,13,21,12974,20958,33932
430087,201902,30,23,7,22954.7,6986,29940.7
430090,201902,72,65,7,64870,6986,71856
430100,201902,128,87,41,86826,40918,127744
430105,201902,143,74,69,73852.6,68862,142714.6
430107,201902,21,16,5,15968,4990,20958
430110,201902,417,248,169,247504,168662,416166
430120,201902,142,132,10,131736,9980,141716
430130,201902,801,498,303,497004.4,302394,799398.4
430140,201902,119,112,7,111776,6986,118762
430150,201902,111,72,39,71856,38922,110778
430155,201902,32,29,3,28942,2994,31936
430160,201902,3706,2206,1500,2202588.5,1497000.4,3699588.9
430163,201902,331,150,181,149700,180638,330338
430165,201902,29,19,10,18962,9980,28942
430170,201902,91,77,14,76846,13972,90818
430175,201902,85,67,18,66866,17964.4,84830.4
430180,201902,100,81,19,80838,18962,99800
430185,201902,34,26,8,25948,7984,33932
430187,201902,94,41,53,40918,52894,93812
430190,201902,219,125,94,124750,93812,218562
430192,201902,15,13,2,12974,1996,14970
430195,201902,16,11,5,10978,4990,15968
430200,201902,172,151,21,150698,20958,171656
430205,201902,20,19,1,18962,998,19960
430210,201902,655,509,146,507982,145708.4,653690.4
430215,201902,15,13,2,12974,1996,14970
430220,201902,71,50,21,49900,20958,70858
430222,201902,14,8,6,7984,5988,13972
430223,201902,13,7,6,6986,5988,12974
430225,201902,2,1,1,998,998,1996
430230,201902,309,183,126,182634,125748,308382
430235,201902,54,40,14,39920,13972,53892
430237,201902,29,22,7,21956,6986,28942
430240,201902,138,89,49,88822,48902,137724
430245,201902,69,57,12,56886,11976,68862
430250,201902,193,115,78,114770,77844,192614
430258,201902,11,9,2,8982,1996,10978
430260,201902,33,29,4,28942,3992,32934
430265,201902,36,30,6,29940,5988,35928
430270,201902,546,411,135,410178.3,134733.92,544912.22
430280,201902,1028,636,392,634728,391217.9,1025945.9
430290,201902,382,220,162,219560.6,161676,381236.6
430300,201902,2123,1184,939,1182633.34,939124.05,2121757.39
430310,201902,1948,1012,936,1009977.96,935132.94,1945110.90
430320,201902,55,46,9,45908,8982,54890
430330,201902,94,85,9,84830,8982,93812
430340,201902,71,61,10,60878,9980,70858
430350,201902,1650,1152,498,1149696.6,497004.98,1646701.58
430355,201902,23,21,2,20958,1996,22954
430360,201902,88,45,43,44910,42914,87824
430367,201902,29,20,9,19960,8982,28942
430370,201902,58,50,8,49900,7984,57884
430380,201902,138,104,34,103792,33932,137724
430390,201902,605,383,222,382234,221556,603790
430400,201902,139,106,33,106786,33932,140718
430410,201902,60,46,14,45908,13972,59880
430420,201902,494,329,165,328342.94,164670.98,493013.92
430430,201902,53,52,1,51231.33,998,52229.33
430435,201902,154,117,37,116766,36926,153692
430440,201902,514,333,181,332334.6,180638,512972.6
430450,201902,1169,964,205,963070,204590,1167660
430460,201902,5018,2769,2249,2764465.66,2248519.26,5012984.92
430461,201902,17,15,2,14970,1996,16966
430462,201902,9,6,3,5988,2994,8982
430463,201902,1047,561,486,559878.6,485029.96,1044908.56
430465,201902,24,14,10,13972,9980,23952
430466,201902,656,472,184,471056.4,183632,654688.4
430467,201902,96,54,42,53892.6,42914,96806.6
430468,201902,108,65,43,64870,42914,107784
430469,201902,23,18,5,17964,4990,22954
430470,201902,1164,656,508,655686.95,506984,1162670.95
430471,201902,53,39,14,38922,13972,52894
430480,201902,101,63,38,62874,37924,100798
430485,201902,6,6,0,5988.4,,5988.4
430490,201902,85,69,16,68862,15968,84830
430495,201902,39,28,11,27944,10978,38922
430500,201902,192,128,64,127744,64870.63,192614.63
430510,201902,3321,2176,1145,2173645.24,1142710,3316355.24
430511,201902,17,16,1,15968,998,16966
430512,201902,140,100,40,99800,39920,139720
430513,201902,50,40,10,40918,9980,50898
430515,201902,33,31,2,30938,1996,32934
430517,201902,167,150,17,149700,16966,166666
430520,201902,368,257,111,256486,110778,367264
430530,201902,91,53,38,52894,37924,90818
430535,201902,466,317,149,316366,148702.99,465068.99
430537,201902,10,10,0,9980,,9980.0
430540,201902,78,53,25,52894,24950,77844
430543,201902,359,113,246,113772,245508,359280
430544,201902,43,40,3,39920,2994,42914
430545,201902,357,180,177,179640.96,176646,356286.96
430550,201902,43,36,7,35928,6986,42914
430558,201902,5,3,2,2994,1996,4990
430560,201902,50,22,28,21956,27944,49900
430570,201902,107,43,64,42914,63872,106786
430580,201902,125,101,24,100798,23952.6,124750.6
430583,201902,14,14,0,14970,,14970.0
430585,201902,9,4,5,3992,4990,8982
430587,201902,15,7,8,6986,7984,14970
430590,201902,148,121,27,120758,26946,147704
430593,201902,2,2,0,1996,,1996.0
430595,201902,17,14,3,13972,2994,16966
430597,201902,49,27,22,27944,21956,49900
430600,201902,221,156,65,155688,65868,221556
430605,201902,159,100,59,99800,58882,158682
430607,201902,26,22,4,21956,3992,25948
430610,201902,1626,772,854,771454.9,854289.38,1625744.28
430613,201902,3,3,0,2994,,2994.0
430620,201902,115,85,30,84830,29940,114770
430630,201902,48,41,7,40918,6986,47904
430632,201902,33,28,5,27944,4990,32934
430635,201902,40,37,3,36926,2994,39920
430637,201902,54,29,25,28942,24950,53892
430640,201902,191,107,84,106786,83832,190618
430642,201902,23,21,2,20958,1996,22954
430645,201902,36,29,7,28942,6986,35928
430650,201902,255,207,48,206586.4,47904,254490.4
430655,201902,4,4,0,3992,,3992.0
430660,201902,974,478,496,477044,495008.8,972052.8
430670,201902,75,52,23,51896,23952,75848
430673,201902,75,40,35,39920,34930,74850
430675,201902,14,11,3,10978,2994,13972
430676,201902,506,311,195,311376.94,194610.94,505987.88
430680,201902,247,173,74,172654.4,73852,246506.4
430690,201902,533,331,202,330338.98,201596.63,531935.61
430692,201902,7,5,2,4990,1996,6986
430693,201902,143,96,47,95808,46906,142714
430695,201902,73,61,12,60878,11976,72854
430697,201902,59,37,22,36926,21956,58882
430700,201902,1552,1091,461,1090814.76,461076,1551890.76
430705,201902,22,20,2,19960,1996,21956
430710,201902,255,168,87,167664,86826,254490
430720,201902,106,91,15,90818,14970,105788
430730,201902,131,113,18,112774,17964,130738
430740,201902,71,47,24,46906,23952,70858
430745,201902,35,28,7,27944,6986,34930
430750,201902,340,225,115,224550,114770,339320
430755,201902,88,52,36,51896,35928,87824
430760,201902,356,213,143,212575.04,142714.98,355290.02
430770,201902,1433,756,677,754490.24,677646.88,1432137.12
430780,201902,312,197,115,196606.98,114770.98,311377.96
430781,201902,28,25,3,24950,2994,27944
430783,201902,55,46,9,45908,8982,54890
430786,201902,6,3,3,2994,2994,5988
430790,201902,534,346,188,345308,188622.4,533930.4
430800,201902,161,134,27,133732.51,26946,160678.51
430805,201902,41,37,4,36926,3992,40918
430807,201902,43,25,18,24950,17964,42914
430810,201902,76,50,26,49900,25948,75848
430820,201902,143,84,59,83832,58882,142714
430825,201902,11,9,2,8982,1996,10978
430830,201902,230,214,16,213572.4,15968,229540.4
430840,201902,126,83,43,82834,42914,125748
430843,201902,5,3,2,2994,1996,4990
430845,201902,71,41,30,40918,29940,70858
430850,201902,569,398,171,397204,171659.9,568863.9
430860,201902,164,102,62,101796,61876,163672
430865,201902,72,40,32,40918,31936,72854
430870,201902,80,65,15,64870,14970,79840
430880,201902,155,115,40,115768,39920,155688
430885,201902,10,8,2,7984,1996,9980
430890,201902,344,208,136,207584,135728,343312
430900,201902,530,369,161,368761,160678,529439
430905,201902,109,47,62,46906,61876,108782
430910,201902,272,151,121,150698,120758.98,271456.98
430912,201902,5,5,0,4990,,4990.0
430915,201902,34,28,6,27944,5988,33932
430920,201902,4210,2340,1870,2336324.94,1867261.94,4203586.88
430925,201902,4,3,1,2994,998,3992
430930,201902,2079,1229,850,1226544.86,849301.88,2075846.74
430940,201902,262,169,93,168662,92814,261476
430950,201902,152,122,30,123752,29940,153692
430955,201902,22,13,9,12974,8982,21956
430957,201902,19,18,1,17964,998,18962
430960,201902,244,160,84,159680,83832,243512
430965,201902,113,72,41,71856,40918,112774
430970,201902,84,69,15,68862,14970,83832
430975,201902,38,34,4,33932,3992,37924
430980,201902,45,29,16,28942,15968,44910
430990,201902,116,88,28,88822,27944,116766
430995,201902,118,113,5,112774,4990,117764
431000,201902,308,137,171,136727,170658,307385
431010,201902,347,206,141,205588,140718,346306
431020,201902,1937,1129,808,1126742.6,806384,1933126.6
431030,201902,42,33,9,32934,8982,41916
431033,201902,378,190,188,189620,187624,377244
431036,201902,14,9,5,8982,4990,13972
431040,201902,132,81,51,80838,50898,131736
431041,201902,39,27,12,27944,11976,39920
431043,201902,51,31,20,30938,19960,50898
431046,201902,11,7,4,6986,3992,10978
431050,201902,200,128,72,127744,71856,199600
431053,201902,79,48,31,47904.96,30938,78842.96
431055,201902,64,44,20,43912,19960,63872
431057,201902,18,18,0,17964,,17964.0
431060,201902,1640,1038,602,1035926.35,600811.8,1636738.15
431065,201902,19,11,8,10978,7984,18962
431070,201902,69,63,6,62874,5988,68862
431075,201902,6,6,0,5988,,5988.0
431080,201902,133,81,52,80838,51896,132734
431085,201902,32,29,3,28942,2994,31936
431087,201902,14,11,3,10978,2994,13972
431090,201902,54,43,11,42914,10978,53892
431100,201902,1202,723,479,721555.34,481036,1202591.34
431110,201902,248,152,96,152694,95808.4,248502.4
431112,201902,28,17,11,16966,10978,27944
431113,201902,33,24,9,23952,8982,32934
431115,201902,159,110,49,109780,48902,158682
431120,201902,603,357,246,356286.6,245509.92,601796.52
431123,201902,4,3,1,2994,998,3992
431125,201902,100,91,9,90818,8982,99800
431127,201902,9,4,5,3992,4990,8982
431130,201902,680,437,243,436126,244510,680636
431140,201902,755,524,231,522952.4,230538,753490.4
431142,201902,32,26,6,25948.95,5988,31936.95
431150,201902,199,148,51,147704,50898,198602
431160,201902,56,50,6,49900,5988,55888
431162,201902,19,14,5,13972,4990,18962
431164,201902,6,6,0,5988,,5988.0
431170,201902,106,85,21,84830,20958,105788
431171,201902,66,39,27,38922,26946,65868
431173,201902,2,2,0,1996,,1996.0
431175,201902,198,101,97,100798.4,96806,197604.4
431177,201902,72,55,17,54890,16966,71856
431179,201902,14,12,2,11976,1996,13972
431180,201902,452,277,175,276446.4,174650.98,451097.38
431190,201902,88,67,21,66866,20958,87824
431198,201902,70,49,21,48902,20958,69860
431200,201902,20,16,4,15968,3992,19960
431205,201902,23,23,0,22954,,22954.0
431210,201902,86,51,35,50898,34930,85828
431213,201902,30,25,5,24950,4990,29940
431215,201902,24,21,3,20958,2994,23952
431217,201902,5,4,1,3992,998,4990
431220,201902,68,59,9,58882,8982,67864
431225,201902,150,101,49,100798.98,48902,149700.98
431230,201902,103,93,10,92814,9980,102794
431235,201902,8,8,0,7984,,7984.0
431237,201902,24,17,7,16966,6986,23952
431238,201902,10,7,3,6986.4,2994,9980.4
431240,201902,982,643,339,641714.2,338322,980036.2
431242,201902,38,37,1,36926,998,37924
431244,201902,11,8,3,7984,2994,10978
431245,201902,51,38,13,37924,12974,50898
431247,201902,12,10,2,9980,1996,11976
431250,201902,278,148,130,148702,129740,278442
431260,201902,61,46,15,45908,14970,60878
431261,201902,19,13,6,12974,5988,18962
431262,201902,18,17,1,16966,998,17964
431265,201902,157,87,70,86826,70858,157684
431267,201902,15,14,1,13972,998,14970
431270,201902,326,269,57,268462,56886,325348
431275,201902,39,36,3,35928,2994,38922
431280,201902,17,13,4,12974,3992,16966
431290,201902,25,20,5,19960,4990,24950
431295,201902,5,4,1,3992,998,4990
431300,201902,22,19,3,18962,2994,21956
431301,201902,7,7,0,6986,,6986.0
431303,201902,53,35,18,34930,17964,52894
431306,201902,237,126,111,125570.35,110778,236348.35
431308,201902,6,5,1,4990,998,5988
431310,201902,68,58,10,57884,9980,67864
431320,201902,139,84,55,83832,54890,138722
431330,201902,172,111,61,110778,60878,171656
431333,201902,32,26,6,25948,5988,31936
431335,201902,9,5,4,4990,3992,8982
431337,201902,329,153,176,152694,175648,328342
431339,201902,23,20,3,19960,2994,22954
431340,201902,2977,1717,1260,1715486.51,1257499.28,2972985.79
431342,201902,37,23,14,22954,13972,36926
431344,201902,18,18,0,17964,,17964.0
431346,201902,4,4,0,3992,,3992.0
431349,201902,35,32,3,31936,2994,34930
431350,201902,912,543,369,541915.58,369260,911175.58
431360,201902,49,44,5,43912,4990,48902
431365,201902,319,153,166,152694,167664,320358
431370,201902,1319,787,532,785426.4,531940.86,1317367.26
431380,201902,100,86,14,85828,13972,99800
431390,201902,519,288,231,287424,230538,517962
431395,201902,293,134,159,133732,158682.96,292414.96
431400,201902,42,31,11,30938,10978,41916
431402,201902,99,70,29,69860,28942,98802
431403,201902,22,12,10,11976,9980,21956
431405,201902,652,357,295,356286.9,294412.94,650699.84
431406,201902,31,27,4,26946,3992,30938
431407,201902,52,40,12,39920,11976,51896
431410,201902,3420,2101,1319,2098796.06,1318358,3417154.06
431413,201902,17,14,3,13972,2994,16966
431415,201902,72,54,18,53892,18962,72854
431417,201902,22,12,10,11976,9980,21956
431420,201902,313,218,95,217564,95808,313372
431430,201902,47,23,24,22954,23952,46906
431440,201902,8886,6313,2573,6302380.57,2568853.4,8871233.97
431442,201902,28,15,13,14970,12974,27944
431445,201902,23,20,3,19960,2994,22954
431446,201902,2,2,0,1996,,1996.0
431447,201902,84,61,23,60878,22954,83832
431449,201902,55,48,7,47904,6986,54890
431450,201902,416,284,132,283432,131736,415168
431454,201902,0,0,0,0,0,0
431455,201902,50,39,11,38922,10978,49900
431460,201902,516,358,158,358282,157684,515966
431470,201902,124,96,28,95808,27944,123752
431475,201902,11,10,1,9980,998,10978
431477,201902,35,24,11,23952,10978,34930
431478,201902,8,7,1,6986,998,7984
431480,201902,491,311,180,310378,181636,492014
431490,201902,28136,16027,12109,16005046.68,12094903.37,28099950.05
431500,201902,81,59,22,58882,21956,80838
431505,201902,33,19,14,18962,13972,32934
431507,201902,13,10,3,9980,2994,12974
431510,201902,257,181,76,180638.1,76846,257484.1
431513,201902,24,20,4,19960,3992,23952
431514,201902,7,6,1,5988,998,6986
431515,201902,81,68,13,67864,12974,80838
431517,201902,5,4,1,3992,998,4990
431520,201902,38,34,4,33932,3992,37924
431530,201902,1569,706,863,704590.88,861274.94,1565865.82
431531,201902,24,22,2,21956,1996,23952
431532,201902,28,19,9,18962,8982,27944
431535,201902,26,16,10,15968,9980,25948
431540,201902,143,126,17,125748,16966,142714
431545,201902,15,13,2,12974,1996,14970
431550,201902,359,203,156,202594,155688,358282
431555,201902,13,12,1,11976,998,12974
431560,201902,4452,3144,1308,3142973.3,1309376,4452349.3
431570,201902,802,432,370,432134.8,369260,801394.8
431575,201902,38,24,14,23952,13972,37924
431580,201902,98,68,30,67864,29940,97804
431590,201902,149,126,23,125748,22954,148702
431595,201902,11,10,1,9980,998,10978
431600,201902,222,126,96,125748,95808,221556
431610,201902,125,93,32,92814,32934,125748
431620,201902,45,37,8,36926,7984,44910
431630,201902,134,112,22,111776,21956,133732
431640,201902,1346,845,501,843310.4,499999.36,1343309.76
431642,201902,36,33,3,32934,2994,35928
431643,201902,43,19,24,18962,23952,42914
431645,201902,309,179,130,178642,129740,308382
431647,201902,10,10,0,9980,,9980.0
431650,201902,36,26,10,25948,9980,35928
431660,201902,309,197,112,196606,111776,308382
431670,201902,231,111,120,110778,119760,230538
431673,201902,5,5,0,4990,,4990.0
431675,201902,29,24,5,23952,4990,28942
431680,201902,1129,821,308,820356,308382,1128738
431690,201902,4774,2909,1865,2903185.28,1863270.3,4766455.58
431695,201902,24,20,4,19960,4990,24950
431697,201902,0,0,0,0,0,0
431700,201902,175,137,38,136726,37924,174650
431710,201902,4018,1761,2257,1757479.58,2256488.78,4013968.36
431720,201902,1367,831,536,829338.6,534928.99,1364267.59
431725,201902,1,1,0,998,,998.0
431730,201902,1192,811,381,810379.12,380238,1190617.12
431740,201902,1365,669,696,668660.96,695611.3,1364272.26
431750,201902,1853,1212,641,1209577.71,639718.98,1849296.69
431755,201902,5,4,1,3992,998,4990
431760,201902,1013,656,357,655686,356286,1011972
431770,201902,394,290,104,289420,103792,393212
431775,201902,31,22,9,21956,8982,30938
431780,201902,564,353,211,352294,210578,562872
431790,201902,168,130,38,129740,37924,167664
431795,201902,13,12,1,11976,998,12974
431800,201902,3346,1765,1581,1761482.2,1578940.26,3340422.46
431805,201902,19,17,2,16966,1996,18962
431810,201902,611,408,203,407184,202594.98,609778.98
431820,201902,325,186,139,185628,138722,324350
431830,201902,2324,1415,909,1413168,909182.92,2322350.92
431840,201902,488,326,162,325348.6,161676,487024.6
431842,201902,34,28,6,27944,5988,33932
431843,201902,12,9,3,8982,2994,11976
431844,201902,16,14,2,13972,1996,15968
431845,201902,29,26,3,25948,2994,28942
431846,201902,29,24,5,23952,4990,28942
431848,201902,15,13,2,12974,1996,14970
431849,201902,10,7,3,6986,2994,9980
431850,201902,802,662,140,660676,140718,801394
431860,201902,113,80,33,79840,32934,112774
431861,201902,4,2,2,1996,1996,3992
431862,201902,51,34,17,33932,16966,50898
431870,201902,3407,2034,1373,2031932.3,1373256.31,3405188.61
431880,201902,931,685,246,684628.94,247504,932132.94
431890,201902,1306,816,490,815366.4,489020,1304386.4
431900,201902,177,127,50,127744,49900,177644
431910,201902,52,39,13,38922,12974,51896
431912,201902,38,22,16,21956,15968,37924
431915,201902,131,105,26,104790,25948,130738
431920,201902,150,109,41,108782,40918,149700
431930,201902,82,67,15,66866,14970,81836
431935,201902,3,3,0,2994,,2994.0
431936,201902,12,11,1,10978,998,11976
431937,201902,19,14,5,13972,4990,18962
431940,201902,471,319,152,318362,151696.5,470058.5
431950,201902,503,314,189,313373.38,188623.96,501997.34
431960,201902,732,408,324,408184.36,323353.96,731538.32
431970,201902,73,65,8,64870,7984,72854
431971,201902,3,3,0,2994,,2994.0
431973,201902,25,20,5,19960,4990,24950
431975,201902,8,7,1,6986,998,7984
431980,201902,206,129,77,129740,76846,206586
431990,201902,1217,653,564,651629.13,562874.9,1214504.03
432000,201902,1666,913,753,911176.5,752497,1663673.5
432010,201902,279,185,94,184630,93812,278442
432020,201902,174,144,30,143712,29940,173652
432023,201902,16,14,2,13972,1996,15968
432026,201902,71,66,5,65868,4990,70858
432030,201902,65,31,34,30938,33932,64870
432032,201902,19,16,3,15968,2994,18962
432035,201902,50,40,10,39920,9980,49900
432040,201902,102,69,33,68862,32934,101796
432045,201902,8,7,1,6986,998,7984
432050,201902,74,44,30,43912,29940,73852
432055,201902,113,84,29,83832,28942,112774
432057,201902,3,2,1,1996,998,2994
432060,201902,35,32,3,31936,2994,34930
432065,201902,32,28,4,27944,3992,31936
432067,201902,89,80,9,79840,8982,88822
432070,201902,403,304,99,303642.8,98802.98,402445.78
432080,201902,816,567,249,565866,248502,814368
432085,201902,17,13,4,12974,3992,16966
432090,201902,267,173,94,172654,93812,266466
432100,201902,169,111,58,110778,57884,168662
432110,201902,587,402,185,401196.4,184630,585826.4
432120,201902,948,580,368,578840,367264,946104
432130,201902,498,361,137,360278,136726,497004
432132,201902,24,21,3,20958,2994,23952
432135,201902,78,65,13,64870,12974,77844
432140,201902,269,217,52,216566,52894,269460
432143,201902,202,127,75,126746,74850,201596
432145,201902,275,188,87,187624,86826,274450
432146,201902,14,13,1,12974,998,13972
432147,201902,127,61,66,60878,65868,126746
432149,201902,14,10,4,9980,3992,13972
432150,201902,838,520,318,518960,317365.55,836325.55
432160,201902,1414,740,674,739519.57,672653.94,1412173.51
432162,201902,4,3,1,2994,998,3992
432163,201902,18,14,4,13972,3992,17964
432166,201902,116,86,30,86328,29940,116268
432170,201902,231,123,108,122754,107784,230538
432180,201902,537,334,203,333332,202594.4,535926.4
432183,201902,8,7,1,6986,998,7984
432185,201902,79,69,10,68862,9980,78842
432190,201902,459,268,191,267464,192614.98,460078.98
432195,201902,85,73,12,72854,11976,84830
432200,201902,405,260,145,260478,144710.98,405188.98
432210,201902,119,75,44,74850,43912,118762
432215,201902,57,53,4,52894,3992,56886
432218,201902,20,19,1,18962,998,19960
432220,201902,679,353,326,352294,325349.61,677643.61
432225,201902,13,8,5,7984,4990,12974
432230,201902,148,95,53,94810,52894,147704
432232,201902,13,12,1,11976,998,12974
432234,201902,4,3,1,2994,998,3992
432235,201902,2,2,0,1996,,1996.0
432237,201902,28,17,11,16966,10978,27944
432240,201902,4328,2437,1891,2432131.08,1888217.78,4320348.86
432250,201902,1076,690,386,688620,386226,1074846
432252,201902,43,38,5,38922,4990,43912
432253,201902,60,48,12,47904,11976,59880
432254,201902,26,13,13,12974,12974,25948
432255,201902,14,13,1,12974,998,13972
432260,201902,885,703,182,702592.4,181636,884228.4
432270,201902,240,175,65,174650,64870,239520
432280,201902,132,99,33,98802.6,32934,131736.6
432285,201902,1,1,0,998,,998.0
432290,201902,67,59,8,58882,7984,66866
432300,201902,4537,2590,1947,2585756.79,1946112.6,4531869.39
432310,201902,118,98,20,97804,19960,117764
432320,201902,21,18,3,17964,2994,20958
432330,201902,16,12,4,11976,3992,15968
432335,201902,7,6,1,5988,998,6986
432340,201902,40,36,4,35928,3992,39920
432345,201902,98,71,27,70858,26946,97804
432350,201902,23,22,1,21956,998,22954
432360,201902,7,5,2,4990,1996,6986
432370,201902,26,26,0,25948,,25948.0
432375,201902,33,30,3,29940,2994,32934
432377,201902,8,8,0,7984,,7984.0
432380,201902,166,74,92,73852,91816,165668
500020,201902,244,139,105,138722,104790,243512
500025,201902,119,57,62,56886,61876,118762
500060,201902,1454,908,546,908180,545907.38,1454087.38
500070,201902,796,381,415,380238.96,414170.98,794409.94
500080,201902,132,106,26,105788,25948,131736
500085,201902,133,107,26,107784.4,25948,133732.4
500090,201902,327,157,170,157684,169660,327344
500100,201902,735,388,347,387224,346306.8,733530.8
500110,201902,2246,1030,1216,1028943.31,1214577.1,2243520.41
500124,201902,266,155,111,154690,110778,265468
500150,201902,326,136,190,135728.98,189622.94,325351.92
500190,201902,527,369,158,368262,157684.4,525946.4
500200,201902,191,164,27,163672.28,26946,190618.28
500210,201902,1463,524,939,522954.94,937146.42,1460101.36
500215,201902,248,147,101,146706,100798,247504
500220,201902,774,502,272,500998.66,271456,772454.66
500230,201902,253,171,82,170658,81836,252494
500240,201902,689,482,207,482034.36,206586,688620.36
500260,201902,599,230,369,229540,368262,597802
500270,201902,29113,12507,16606,12485026.65,16581962.12,29066988.77
500280,201902,196,71,125,70858,124750,195608
500290,201902,1178,706,472,704588,471056.98,1175644.98
500295,201902,428,270,158,269460.4,157684,427144.4
500310,201902,61,18,43,17964,42914,60878
500315,201902,732,444,288,444110,287424,731534
500320,201902,3640,1839,1801,1835323.75,1797403.88,3632727.63
500325,201902,911,507,404,505986,404190.4,910176.4
500330,201902,1456,683,773,681634.4,771454.98,1453089.38
500345,201902,315,241,74,240519.38,73852,314371.38
500348,201902,248,153,95,152694,94810.98,247504.98
500350,201902,129,64,65,63872,64870,128742
500370,201902,5448,2459,2989,2457079.6,2986023.3,5443102.9
500375,201902,348,257,91,256486,90818,347304
500380,201902,598,345,253,344310,253492,597802
500390,201902,70,34,36,33932,36926,70858
500400,201902,213,148,65,147704,64870.98,212574.98
500410,201902,562,226,336,225551.89,335334.85,560886.74
500430,201902,526,372,154,371256,154690,525946
500440,201902,203,104,99,103792,98802,202594
500450,201902,409,178,231,177644,230538,408182
500460,201902,299,153,146,152694,145708,298402
500470,201902,436,344,92,344311.39,91816.98,436128.37
500480,201902,111,64,47,63872,46906,110778
500490,201902,105,42,63,41916,62874,104790
500500,201902,1437,521,916,519969.8,915198.51,1435168.31
500510,201902,48,37,11,36926,10978.98,47904.98
500515,201902,106,74,32,73852,31936,105788
500520,201902,344,189,155,188622.8,154691.39,343314.19
500525,201902,86,48,38,47904,37924,85828
500540,201902,907,388,519,388222.98,517963.96,906186.94
500560,201902,899,515,384,513970,383232.4,897202.4
500568,201902,980,577,403,575846.98,402195.39,978042.37
500570,201902,1201,684,517,682651.22,517023.58,1199674.80
500580,201902,335,176,159,175648,158684.91,334332.91
500600,201902,313,167,146,166666,145709.96,312375.96
500620,201902,925,659,266,657683.18,265468,923151.18
500625,201902,78,66,12,65868,11976,77844
500627,201902,26,12,14,11976,13972,25948
500630,201902,1580,849,731,847303.3,729538,1576841.3
500635,201902,528,306,222,305388,221556,526944
500640,201902,421,220,201,219561,200598,420159
500660,201902,5489,2113,3376,2109772.4,3370248.98,5480021.38
500690,201902,581,208,373,207594.76,372279.48,579874.24
500710,201902,385,192,193,191616,192615.96,384231.96
500720,201902,969,570,399,568860,398202,967062
500730,201902,200,122,78,121756,77844,199600
500740,201902,842,366,476,365274.34,475080.65,840354.99
500750,201902,148,48,100,47904,99800.98,147704.98
500755,201902,122,87,35,86826.4,34930,121756.4
500769,201902,748,421,327,420160.37,326348.95,746509.32
500770,201902,425,226,199,226546.98,198602,425148.98
500780,201902,168,112,56,111776,55888,167664
500790,201902,1059,541,518,539918,516968.91,1056886.91
500793,201902,271,151,120,150698,119761.38,270459.38
500795,201902,175,127,48,126746,47904.98,174650.98
500797,201902,47,34,13,33932,12974,46906
500800,201902,418,185,233,184630.98,232534,417164.98
500830,201902,2234,1260,974,1257482.18,972052.98,2229535.16
500840,201902,143,106,37,105788,36926.98,142714.98
510010,201902,169,93,76,92814,75848,168662
510020,201902,488,231,257,231556.58,256516.38,488072.96
510025,201902,1682,961,721,959088.15,719573.1,1678661.25
510030,201902,679,356,323,355291.9,322355.96,677647.86
510035,201902,131,59,72,58883.96,71856.98,130740.94
510040,201902,388,174,214,173652,213574.68,387226.68
510050,201902,403,222,181,221561.86,181643.28,403205.14
510060,201902,113,58,55,57884,54890,112774
510080,201902,227,92,135,91816.98,134730.98,226547.96
510100,201902,75,35,40,34930,39920,74850
510120,201902,37,23,14,22954,13972,36926
510125,201902,395,245,150,244510,150699.97,395209.97
510130,201902,572,334,238,334338.82,237535.76,571874.58
510140,201902,409,131,278,130738.98,277444,408182.98
510160,201902,97,42,55,41916,54890.99,96806.99
510170,201902,851,522,329,521967.72,330352.68,852320.40
510180,201902,2888,1399,1489,1396245.83,1487056.48,2883302.31
510185,201902,14,7,7,6986,6986,13972
510190,201902,219,74,145,73852,144710,218562
510250,201902,2583,1543,1040,1540919.26,1038922.32,2579841.58
510260,201902,196,144,52,143727.68,51898.94,195626.62
510263,201902,460,261,199,260481.74,198602.98,459084.72
510267,201902,670,382,288,381250.32,287446.52,668696.84
510268,201902,61,30,31,29940,30938,60878
510269,201902,72,34,38,33932.98,37924,71856.98
510270,201902,404,206,198,205591.92,197608.9,403200.82
510279,201902,225,169,56,168664.94,55888.4,224553.34
510285,201902,178,75,103,74850.98,103792,178642.98
510300,201902,517,287,230,286429.93,229544.9,515974.83
510305,201902,211,99,112,98803.97,111776.98,210580.95
510310,201902,106,56,50,55888,49900,105788
510320,201902,854,541,313,539924.86,313385.73,853310.59
510325,201902,410,164,246,163672,245508,409180
510330,201902,434,244,190,243513.97,189620,433133.97
510335,201902,607,348,259,347306.95,259484.9,606791.85
510336,201902,49,35,14,34930,13972,48902
510337,201902,115,50,65,49900,64870,114770
510340,201902,17175,8174,9001,8157884.38,8986308.1,17144192.48
510343,201902,67,48,19,47904,18962,66866
510345,201902,164,111,53,110778,52894.4,163672.4
510350,201902,659,371,288,370262.9,287427.92,657690.82
510360,201902,195,123,72,122755.96,71861.88,194617.84
510370,201902,143,75,68,74850,67866.94,142716.94
510380,201902,90,63,27,62874,26946.98,89820.98
510385,201902,57,27,30,26946,29940.98,56886.98
510390,201902,114,48,66,47904,65868,113772
510395,201902,46,35,11,34930,10978,45908
510410,201902,702,465,237,464070.99,236526.98,700597.97
510420,201902,572,277,295,276463.6,294442.24,570905.84
510450,201902,52,28,24,27944,23952,51896
510452,201902,44,25,19,24950,18962,43912
510454,201902,53,26,27,25948,26946,52894
510455,201902,129,79,50,78842,50898,129740
510460,201902,177,92,85,91817.68,84830.98,176648.66
510480,201902,750,443,307,443120.1,306399.64,749519.74
510490,201902,347,180,167,179645.84,166668.9,346314.74
510500,201902,249,191,58,190618,57884,248502
510510,201902,800,463,337,462075.38,336326,798401.38
510515,201902,1163,618,545,616769.88,543911.96,1160681.84
510517,201902,261,110,151,109780,151696.98,261476.98
510520,201902,233,152,81,151699.92,80842.88,232542.80
510523,201902,95,70,25,69860,24950,94810
510525,201902,750,440,310,439124.91,310382.9,749507.81
510530,201902,17,13,4,12974,3992,16966
510550,201902,261,120,141,119760.98,141716,261476.98
510558,201902,277,137,140,136726.98,139720,276446.98
510560,201902,406,239,167,238522.4,167665.96,406188.36
510562,201902,651,459,192,458082,191616,649698
510590,201902,792,410,382,409181.96,381237.97,790419.93
510600,201902,251,140,111,139720,110779.96,250499.96
510610,201902,169,83,86,82834,86826.4,169660.4
510615,201902,194,82,112,81836,111776,193612
510617,201902,19,11,8,10978,7984,18962
510618,201902,120,58,62,57884,61876,119760
510619,201902,101,70,31,69860.98,30938.98,100799.96
510620,201902,177,97,80,97804,79840,177644
510621,201902,191,124,67,123752.98,66867.96,190620.94
510622,201902,465,297,168,296411.88,168662.98,465074.86
510623,201902,347,233,114,232535.96,113772,346307.96
510624,201902,91,45,46,44910.98,45908,90818.98
510625,201902,542,330,212,329355.68,211588.37,540944.05
510626,201902,113,71,42,70858,41916,112774
510627,201902,62,44,18,43912,17964,61876
510628,201902,155,93,62,92814.98,61876,154690.98
510629,201902,257,168,89,167664,88822,256486
510630,201902,453,234,219,234531.96,218565.34,453097.30
510631,201902,10,3,7,2994,6986.4,9980.4
510637,201902,353,205,148,204593.93,147714.78,352308.71
510642,201902,966,539,427,540918.94,426147.96,967066.90
510645,201902,0,0,0,0,0,0
510650,201902,1450,972,478,971068.14,478046.87,1449115.01
510665,201902,82,42,40,41919.88,39920,81839.88
510670,201902,66,38,28,37924,27944,65868
510675,201902,1145,710,435,708583.34,436127.96,1144711.30
510677,201902,350,178,172,177649.88,171662.86,349312.74
510680,201902,102,58,44,57885.96,43912.98,101798.94
510682,201902,214,110,104,109780.62,103792,213572.62
510685,201902,51,38,13,37924,12974,50898
510700,201902,612,358,254,357293.8,253502.79,610796.59
510704,201902,1115,601,514,599914.59,513080.76,1112995.35
510706,201902,127,65,62,64870,61877.96,126747.96
510710,201902,397,274,123,273457.84,122755.92,396213.76
510715,201902,62,48,14,47904,13972,61876
510718,201902,207,116,91,115770.94,90818,206588.94
510719,201902,34,16,18,16966,17964,34930
510720,201902,194,134,60,133732.98,59880,193612.98
510724,201902,88,35,53,34930,52894,87824
510726,201902,53,26,27,25948,26947.96,52895.96
510729,201902,74,35,39,34930,38922,73852
510730,201902,470,266,204,265469.96,203593.97,469063.93
510735,201902,109,43,66,42914,65868,108782
510740,201902,26,15,11,14970,10978,25948
510757,201902,16,12,4,11976,3992,15968
510760,201902,7084,3768,3316,3760532.09,3310584.83,7071116.92
510770,201902,698,329,369,328346.88,368273.72,696620.60
510774,201902,15,5,10,4990,9980,14970
510775,201902,114,85,29,84830,28942,113772
510776,201902,28,9,19,8982,18962,27944
510777,201902,184,81,103,80838,102794,183632
510779,201902,49,24,25,23952.98,24951.96,48904.94
510780,201902,286,159,127,158688.88,126750.86,285439.74
510785,201902,422,229,193,228542,193612,422154
510787,201902,196,97,99,96806.98,98803.97,195610.95
510788,201902,0,0,0,0,0,0
510790,201902,2389,1269,1120,1266511.9,1121844.12,2388356.02
510792,201902,1131,658,473,657689.84,472068.71,1129758.55
510794,201902,118,59,59,58882,58882.98,117764.98
510795,201902,2377,1403,974,1400199.76,972059.66,2372259.42
510800,201902,183,115,68,114770,67864.98,182634.98
510805,201902,176,122,54,121756,53892,175648
510810,201902,98,41,57,40923.88,56886,97809.88
510820,201902,252,119,133,118766.12,132736.51,251502.63
510830,201902,68,41,27,40918,26946.98,67864.98
510835,201902,10,8,2,7984,1996,9980
510840,201902,9143,4510,4633,4501197.14,4625963.43,9127160.57
510850,201902,204,82,122,81836,121756.98,203592.98
510860,201902,397,178,219,177650.86,218572.18,396223.04
510880,201902,65,49,16,48902.98,15968,64870.98
510885,201902,71,44,27,43912.98,26946,70858.98
510890,201902,71,42,29,41916,28942,70858
510895,201902,185,106,79,105788,78844.37,184632.37
520005,201902,47,32,15,31936,14970,46906
520010,201902,276,129,147,128742,148702.8,277444.8
520013,201902,686,429,257,429140.98,257484,686624.98
520015,201902,56,40,16,39920,15968,55888
520017,201902,93,53,40,52894.4,39920,92814.4
520020,201902,24,14,10,13972,9980,23952
520025,201902,2042,1123,919,1120754.4,917162,2037916.4
520030,201902,808,426,382,425148.98,381236,806384.98
520050,201902,74,50,24,50898,23952,74850
520055,201902,47,31,16,30938,15968,46906
520060,201902,187,124,63,123752,62874,186626
520080,201902,586,421,165,420158,164670,584828
520082,201902,19,14,5,13972,4990,18962
520085,201902,100,75,25,74850,24950,99800
520090,201902,90,60,30,59880,29940,89820
520110,201902,9179,4037,5142,4033923.1,5137710.1,9171633.2
520120,201902,14,8,6,7984,5988,13972
520130,201902,780,541,239,540916.98,238522.4,779439.38
520140,201902,11960,6770,5190,6759467.6,5180636.98,11940104.58
520145,201902,47,32,15,31936,14970,46906
520150,201902,186,144,42,143712,41916,185628
520160,201902,33,24,9,23952,8982,32934
520170,201902,245,152,93,151698.93,92816.92,244515.85
520180,201902,142,73,69,72854,68862,141716
520215,201902,215,140,75,139720,74850,214570
520235,201902,71,53,18,52894,17964,70858
520250,201902,131,80,51,79840,50898,130738
520260,201902,112,70,42,69860,41916,111776
520280,201902,47,33,14,32934,13972,46906
520310,201902,39,27,12,26946,11976,38922
520320,201902,164,103,61,103159.93,60878,164037.93
520330,201902,782,414,368,413174.94,367264.98,780439.92
520340,201902,346,199,147,198602,146706.98,345308.98
520350,201902,527,244,283,243512,282434,525946
520355,201902,89,55,34,54890,33932,88822
520357,201902,25,20,5,19960,4990,24950
520360,201902,1,1,0,998,,998.0
520380,201902,145,75,70,74850,69860,144710
520390,201902,273,118,155,117764,154690,272454
520393,201902,15,11,4,10978,3992,14970
520396,201902,92,59,33,58882,32934,91816
520400,201902,216,126,90,125748.4,89820,215568.4
520410,201902,192,98,94,98802.98,94810.98,193613.96
520420,201902,20,14,6,13972,5988,19960
520425,201902,311,144,167,143712,166667.4,310379.4
520430,201902,466,242,224,241516,223553.88,465069.88
520440,201902,616,420,196,419160,195608,614768
520450,201902,1922,867,1055,865266.98,1055888.9,1921155.88
520455,201902,57,40,17,39920,16966,56886
520460,201902,33,17,16,16966,15968,32934
520465,201902,26,23,3,22954,2994,25948
520470,201902,418,262,156,261476,155688,417164
520480,201902,80,48,32,47904.98,31940.9,79845.88
520485,201902,121,45,76,44910,75848.4,120758.4
520490,201902,429,314,115,313372,115768,429140
520495,201902,170,102,68,101796,67864,169660
520500,201902,176,133,43,132734,42914,175648
520505,201902,177,95,82,94810,82834,177644
520510,201902,1777,880,897,879273.68,895284.36,1774558.04
520520,201902,36,28,8,27944,7984,35928
520530,201902,231,175,56,174650,55888,230538
520540,201902,545,375,170,374250,169660,543910
520545,201902,144,85,59,84830,58882,143712
520547,201902,46,27,19,26946,18962,45908
520549,201902,1157,565,592,563870.72,591817.73,1155688.45
520551,201902,295,154,141,153692,140718.4,294410.4
520552,201902,47,28,19,27944,18962,46906
520570,201902,16,9,7,8982,6986,15968
520580,201902,292,180,112,179640,114770,294410
520590,201902,161,99,62,98802.98,61876,160678.98
520620,201902,1158,544,614,543911.96,612772,1156683.96
520630,201902,42,26,16,25948,15968,41916
520640,201902,406,235,171,234530,171656,406186
520650,201902,62,40,22,39920,21956,61876
520660,201902,37,21,16,20958.98,15968,36926.98
520670,201902,36,31,5,30938,4990,35928
520680,201902,55,36,19,35928,18962,54890
520690,201902,35,12,23,11976,22954.98,34930.98
520710,201902,38,34,4,33932,3992,37924
520725,201902,191,125,66,124750,65868,190618
520735,201902,59,41,18,40918,17964,58882
520740,201902,408,203,205,202594.3,204590.98,407185.28
520750,201902,35,27,8,26946,7984,34930
520753,201902,59,39,20,38922,19960,58882
520760,201902,120,82,38,81836,37924,119760
520780,201902,298,223,75,222554,74850.96,297404.96
520790,201902,158,80,78,79840,77844,157684
520800,201902,3426,1847,1579,1845305.15,1576840.88,3422146.03
520810,201902,171,126,45,125748,44910,170658
520815,201902,4,4,0,3992,,3992.0
520830,201902,149,105,44,104790,43912,148702
520840,201902,356,238,118,238522,117764,356286
520850,201902,109,71,38,70858,37924,108782
520860,201902,1706,1097,609,1094806.4,607782.4,1702588.8
520870,201902,31572,15454,16118,15430098.03,16093778.77,31523876.80
520880,201902,1099,597,502,596804.4,502992,1099796.4
520890,201902,798,475,323,475049.38,322354.8,797404.18
520910,201902,1018,543,475,542912.88,474050,1016962.88
520915,201902,101,76,25,75848,24950,100798
520920,201902,402,190,212,189620,212574,402194
520929,201902,16,15,1,14970,998,15968
520940,201902,75,49,26,48902,25948,74850
520945,201902,19,11,8,10978,7984,18962
520960,201902,49,31,18,30938,17964,48902
520970,201902,330,204,126,203592.98,125748,329340.98
520980,201902,85,65,20,64870,19960,84830
520990,201902,470,318,152,317364,151696,469060
520993,201902,124,59,65,58882,64870,123752
520995,201902,246,138,108,137724.66,107784.8,245509.46
521000,201902,1592,930,662,928140.6,661674.8,1589815.4
521010,201902,665,313,352,312378.12,352295.96,664674.08
521015,201902,17,11,6,10978,5988,16966
521020,201902,1454,1024,430,1021952.98,431138.36,1453091.34
521030,201902,50,35,15,34930,14970,49900
521040,201902,943,589,354,587822.9,355288.4,943111.3
521056,201902,40,30,10,29940,9980,39920
521060,201902,135,87,48,86826,47904,134730
521080,201902,464,350,114,349301.38,113772,463073.38
521090,201902,537,333,204,333332,204590,537922
521100,201902,280,211,69,210578.98,68862,279440.98
521120,201902,1043,737,306,736524.4,305388.98,1041913.38
521130,201902,366,265,101,264470,100801.34,365271.34
521140,201902,175,94,81,93812,80838,174650
521150,201902,2758,1201,1557,1198601.34,1554885.96,2753487.30
521160,201902,32,16,16,15968,15968,31936
521170,201902,197,114,83,113772,82834,196606
521180,201902,1148,731,417,729538.2,418162.9,1147701.1
521190,201902,2535,1068,1467,1065864,1464066,2529930
521200,201902,50,37,13,36926,12974,49900
521205,201902,11,8,3,7984,2994,10978
521210,201902,141,80,61,79840,61876,141716
521220,201902,820,564,256,562872,255488.9,818360.9
521225,201902,33,22,11,21956,10978,32934
521230,201902,111,76,35,75848,34930,110778
521250,201902,6175,3574,2601,3567853.16,2595799.98,6163653.14
521260,201902,23,15,8,14970,7984,22954
521270,201902,142,111,31,110778,30938,141716
521280,201902,439,261,178,261509.26,177644,439153.26
521290,201902,29,12,17,11976,16966,28942
521295,201902,100,68,32,67864,31936,99800
521300,201902,219,115,104,114771.96,103795.34,218567.30
521305,201902,36,25,11,24950,10978,35928
521308,201902,1079,803,276,801652.82,275449.38,1077102.20
521310,201902,1340,794,546,792416.9,544909.34,1337326.24
521340,201902,20,16,4,15968,3992,19960
521350,201902,129,97,32,96806,31936,128742
521370,201902,188,128,60,127744,59880,187624
521375,201902,182,99,83,98802,82834,181636
521377,201902,52,37,15,36926,14970,51896
521380,201902,1070,695,375,693611.92,375248,1068859.92
521385,201902,15,8,7,7984,6986,14970
521390,201902,102,82,20,81836,19960,101796
521400,201902,334,215,119,214570,118762,333332
521405,201902,143,78,65,77844,65868,143712
521410,201902,60,39,21,38922,20958,59880
521440,201902,198,143,55,142714,54890,197604
521450,201902,735,408,327,407184,326346,733530
521460,201902,1183,741,442,739651.06,441116,1180767.06
521470,201902,12,8,4,7984,3992,11976
521480,201902,44,30,14,29942.94,13974.86,43917.80
521483,201902,316,172,144,171656.4,144710,316366.4
521486,201902,294,189,105,188622,104790.6,293412.6
521487,201902,21,11,10,10978,9980,20958
521490,201902,26,15,11,14970,10978,25948
521500,201902,118,79,39,78842,38922,117764
521520,201902,41,29,12,28942,11976,40918
521523,201902,646,396,250,395208,250498,645706
521525,201902,45,30,15,29940,14970,44910
521530,201902,257,138,119,137724,118762,256486
521540,201902,29,15,14,14970,13972,28942
521550,201902,89,41,48,40921.34,47907.92,88829.26
521560,201902,797,550,247,549898.4,246506.7,796405.1
521565,201902,52,35,17,34930,16966,51896
521570,201902,507,335,172,334330,172654.9,506984.9
521580,201902,59,37,22,36926,21956,58882
521590,201902,38,20,18,19960,17964,37924
521600,201902,26,16,10,15968,9980,25948
521630,201902,245,131,114,130738,113775.44,244513.44
521640,201902,301,157,144,156686,143712,300398
521645,201902,28,15,13,14970,12974,27944
521680,201902,220,140,80,139720,80838.4,220558.4
521690,201902,2,2,0,1996,,1996.0
521710,201902,1166,563,603,561874,601794.98,1163668.98
521720,201902,544,374,170,374250,170658.94,544908.94
521730,201902,639,310,329,309380.8,330338.4,639719.2
521740,201902,897,370,527,369260.98,525949.34,895210.32
521760,201902,1663,923,740,921154.59,738522.34,1659676.93
521770,201902,819,521,298,519958,298402,818360
521800,201902,2028,1271,757,1271530.89,756493.8,2028024.69
521805,201902,32,19,13,18962,12974,31936
521810,201902,91,58,33,57884,32934,90818
521830,201902,950,676,274,674648.13,273452.98,948101.11
521839,201902,85,56,29,55888,28942,84830
521850,201902,1095,580,515,578844.99,513986.48,1092831.47
521860,201902,353,225,128,224550,128742,353292
521870,201902,73,43,30,42914,29940,72854
521878,201902,39,19,20,18962,19960,38922
521880,201902,4689,2114,2575,2109774.16,2570854.15,4680628.31
521890,201902,590,418,172,418162,171656,589818
521900,201902,296,239,57,238522,56886,295408
521910,201902,150,104,46,103792,45908,149700
521920,201902,52,26,26,25948,25948,51896
521925,201902,37,23,14,22954,13972,36926
521930,201902,1127,642,485,640723.84,484041.76,1124765.60
521935,201902,36,27,9,26946,8982,35928
521940,201902,194,99,95,98802,94810,193612
521945,201902,15,13,2,12974,1996,14970
521950,201902,9,5,4,4990,3992,8982
521960,201902,74,56,18,56752.93,17964,74716.93
521970,201902,411,266,145,265468,144710,410178
521971,201902,89,46,43,45908,42914,88822
521973,201902,30,15,15,14970,14970,29940
521975,201902,1233,637,596,636724.4,594808.7,1231533.1
521980,201902,248,172,76,171656,75848,247504
521990,201902,74,54,20,53892,19960,73852
522000,201902,288,186,102,185628,101796,287424
522005,201902,19,11,8,10978,7984,18962
522010,201902,1137,641,496,639718.98,495008,1134726.98
522015,201902,58,37,21,36926.98,20958,57884.98
522020,201902,874,484,390,483032.4,389220.8,872253.2
522026,201902,30,21,9,20958,8982,29940
522028,201902,15,11,4,10978,3992,14970
522040,201902,759,301,458,300400.46,459084.9,759485.36
522045,201902,2299,1432,867,1429137.69,865267.48,2294405.17
522050,201902,164,80,84,79840,83832,163672
522060,201902,544,349,195,348302,195608,543910
522068,201902,129,88,41,87824,40918,128742
522070,201902,10,10,0,9980,,9980.0
522100,201902,44,25,19,24950,18962,43912
522108,201902,40,31,9,30938,8982,39920
522119,201902,57,30,27,29940,26946,56886
522130,201902,78,32,46,31936.98,45911.92,77848.90
522140,201902,3865,1962,1903,1958077.32,1900193.58,3858270.90
522145,201902,53,33,20,32934,19960,52894
522150,201902,64,48,16,47904,15968,63872
522155,201902,52,34,18,33932.98,17964,51896.98
522157,201902,4,3,1,2994,998,3992
522160,201902,1732,1029,703,1026942,702592.98,1729534.98
522170,201902,400,270,130,269460,129740,399200
522180,201902,38,20,18,19960,17964,37924
522185,201902,1959,772,1187,772453.78,1186622.99,1959076.77
522190,201902,45,26,19,25948,18962,44910
522200,201902,301,183,118,182634,117764,300398
522205,201902,159,109,50,108782,49900,158682
522220,201902,159,114,45,113772,44910,158682
522230,201902,32,27,5,26946,4990,31936
530010,201902,54957,28349,26608,28302151.52,26571804.2,54873955.72
110001,201903,519,412,107,411176,107784,518960
110002,201903,2778,1716,1062,1715563.38,1062871.36,2778434.74
110003,201903,90,75,15,74850.18,14970,89820.18
110004,201903,2020,1317,703,1314368.36,703590,2017958.36
110005,201903,439,356,83,355288.4,82834,438122.4
110006,201903,453,348,105,348302,104790,453092
110007,201903,75,62,13,61876,12974,74850
110008,201903,235,135,100,135728,99800,235528
110009,201903,822,577,245,577842.82,245509.58,823352.40
110010,201903,1782,1102,680,1102791.96,680639.44,1783431.40
110011,201903,1859,1445,414,1445104.1,416166,1861270.1
110012,201903,4166,2435,1731,2431128.98,1727540.36,4158669.34
110013,201903,767,600,167,598800,166666,765466
110014,201903,370,317,53,316366.4,52894,369260.4
110015,201903,1428,1154,274,1152691.13,273452,1426143.13
110018,201903,1123,696,427,695606.34,426148.96,1121755.30
110020,201903,15578,9148,6430,9153697.93,6446136.14,15599834.07
110025,201903,647,479,168,478042.4,169660.98,647703.38
110026,201903,40,28,12,27944,11976,39920
110028,201903,1702,1241,461,1239518.06,461077.2,1700595.26
110029,201903,141,127,14,126746,13972,140718
110030,201903,2443,1659,784,1659517.1,784429.8,2443946.9
110032,201903,290,223,67,222555.35,66866.99,289422.34
110033,201903,669,501,168,500996.8,168662,669658.8
110034,201903,371,273,98,272455.15,97804,370259.15
110037,201903,105,89,16,89820,15968,105788
110040,201903,363,248,115,247504,114770,362274
110045,201903,952,652,300,650697.2,299400.64,950097.84
110050,201903,91,80,11,79840.4,10978,90818.4
110060,201903,84,47,37,46906,36926,83832
110070,201903,117,73,44,72854,43912.4,116766.4
110080,201903,412,246,166,245508,166666,412174
110090,201903,34,28,6,27944,5988,33932
110092,201903,102,55,47,54890,46906,101796
110094,201903,196,142,54,141716,53892,195608
110100,201903,30,25,5,24950,4990,29940
110110,201903,66,40,26,39920,25948,65868
110120,201903,72,61,11,60878,10978,71856
110130,201903,300,246,54,246506.4,53892,300398.4
110140,201903,245,167,78,166666,77844,244510
110143,201903,50,41,9,40918,8982,49900
110145,201903,24,18,6,17964,5988,23952
110146,201903,23,12,11,11976,10978,22954
110147,201903,40,30,10,29940,9980,39920
110148,201903,37,26,11,25948,10978,36926
110149,201903,313,223,90,222554,90818,313372
110150,201903,134,105,29,104790,29940,134730
110155,201903,7,6,1,5988,998,6986
110160,201903,65,54,11,53892,10978,64870
110170,201903,203,164,39,165668,39920,205588
110175,201903,55,40,15,39920,14970,54890
110180,201903,96,83,13,82834,12974,95808
120001,201903,145,99,46,98802,45909.98,144711.98
120005,201903,194,120,74,121756,73852,195608
120010,201903,1047,668,379,667663.27,378242.98,1045906.25
120013,201903,149,102,47,101796,46906,148702
120017,201903,95,58,37,57884,36926,94810
120020,201903,3583,2873,710,2879231.83,709578,3588809.83
120025,201903,572,327,245,326346.98,244510,570856.98
120030,201903,1051,886,165,884229,164670,1048899
120032,201903,48,41,7,40918,6986,47904
120033,201903,217,191,26,190618,26946,217564
120034,201903,165,119,46,118762,45908,164670
120035,201903,37,28,9,27944,8982,36926
120038,201903,397,255,142,254490,141716,396206
120039,201903,25,24,1,23952,998,24950
120040,201903,14064,9722,4342,9726103.66,4347311.09,14073414.75
120042,201903,45,40,5,39920,4990,44910
120043,201903,11,3,8,2994,7984,10978
120045,201903,543,353,190,355288.98,190618.98,545907.96
120050,201903,1269,974,295,973051.68,295408,1268459.68
120060,201903,1451,1184,267,1184626,267464,1452090
120070,201903,486,348,138,349600.6,137724,487324.6
120080,201903,168,105,63,104790,62874,167664
130002,201903,150,108,42,107784,41916,149700
130006,201903,76,44,32,43912,31936,75848
130008,201903,141,75,66,74850,65868,140718
130010,201903,143,80,63,79840,63872,143712
130014,201903,255,184,71,183632,70858,254490
130020,201903,93,52,41,51896,40918,92814
130030,201903,932,555,377,553890,376246,930136
130040,201903,310,158,152,157684,152694.36,310378.36
130050,201903,595,319,276,318362,275448,593810
130060,201903,872,595,277,594808,277444,872252
130063,201903,582,325,257,324350,258482,582832
130068,201903,189,124,65,123752,64870,188622
130070,201903,1318,905,413,903190,415168,1318358
130080,201903,685,452,233,452094,232534.98,684628.98
130083,201903,72,40,32,39920,31936,71856
130090,201903,366,186,180,185628,179640,365268
130100,201903,1125,502,623,501994,621754,1123748
130110,201903,707,303,404,302394,403192,705586
130115,201903,171,72,99,71856,98802,170658
130120,201903,1627,1044,583,1041912,584828,1626740
130130,201903,609,425,184,424150,185628,609778
130140,201903,1514,1153,361,1151692,360278,1511970
130150,201903,418,360,58,359280,57884,417164
130160,201903,463,267,196,266466,195608,462074
130165,201903,25,19,6,18962,5988,24950
130170,201903,973,697,276,698369.77,276446,974815.77
130180,201903,149,89,60,88822,59880,148702
130185,201903,2400,1161,1239,1163668,1240514.8,2404182.8
130190,201903,3549,2239,1310,2236519.28,1310374,3546893.28
130195,201903,283,228,55,228542,55888,284430
130200,201903,172,82,90,81836,89820,171656
130210,201903,79,41,38,40918,37924,78842
130220,201903,179,124,55,123752,54890,178642
130230,201903,326,208,118,207584,117764,325348
130240,201903,1400,890,510,889218.99,509978,1399196.99
130250,201903,4833,3120,1713,3119748.4,1710572,4830320.4
130255,201903,432,211,221,210578,220558,431136
130260,201903,55077,26634,28443,26623575.05,28449990.75,55073565.80
130270,201903,1595,1064,531,1063957.82,529938,1593895.82
130280,201903,124,74,50,73852,49900,123752
130290,201903,2125,1525,600,1522948,598800,2121748
130300,201903,446,312,134,311376,133732,445108
130310,201903,880,459,421,459080,420158,879238
130320,201903,466,252,214,252494,213572,466066
130330,201903,734,451,283,450098,283432,733530
130340,201903,3489,2059,1430,2056878.8,1428138.8,3485017.6
130350,201903,460,296,164,295408,164670,460078
130353,201903,839,353,486,352294.4,485028,837322.4
130356,201903,819,376,443,375248,442114,817362
130360,201903,65,41,24,40918,23952,64870
130370,201903,671,508,163,507982,163672,671654
130380,201903,674,490,184,492014,183632,675646
130390,201903,490,390,100,391216,99800,491016
130395,201903,175,39,136,38922,135728,174650
130400,201903,64,44,20,43912,19960,63872
130406,201903,2058,1289,769,1289416.8,770457.28,2059874.08
130410,201903,475,210,265,209580,264470,474050
130420,201903,3166,2569,597,2567854.9,596804,3164658.9
130423,201903,158,77,81,76846,80838,157684
130426,201903,153,87,66,86826,65868,152694
130430,201903,411,266,145,265468,144710,410178
130440,201903,204,69,135,68862,134730,203592
140002,201903,34,11,23,10978,22954,33932
140005,201903,204,126,78,125748,77844,203592
140010,201903,10518,7010,3508,6998986.25,3507973.64,10506959.89
140015,201903,141,65,76,64870,75848,140718
140017,201903,117,81,36,81836,35928,117764
140020,201903,468,314,154,313372,153692,467064
140023,201903,43,21,22,21956.54,21956,43912.54
140028,201903,18,11,7,10978,6986,17964
140030,201903,350,249,101,248502,100798,349300
140040,201903,56,39,17,38922,16966,55888
140045,201903,243,109,134,109780,133732,243512
140047,201903,629,429,200,428142,199600,627742
140050,201903,145,93,52,92814,51896,144710
140060,201903,40,29,11,28942,10978,39920
140070,201903,33,30,3,29940,2994,32934
150010,201903,4703,2959,1744,2955078,1743506.4,4698584.4
150013,201903,158,111,47,110778,46906,157684
150020,201903,1068,585,483,584828,482034,1066862
150030,201903,708,294,414,293412,415168,708580
150034,201903,198,131,67,130738,66866,197604
150040,201903,1423,856,567,855286,566864,1422150
150050,201903,635,372,263,372254,262474,634728
150060,201903,4782,3109,1673,3109020.34,1676640.98,4785661.32
150070,201903,312,141,171,140718,171656,312374
150080,201903,14322,7192,7130,7190598.85,7123736.29,14314335.14
150085,201903,416,268,148,267464,148702,416166
150090,201903,753,643,110,641714,109780,751494
150095,201903,345,219,126,218562,127744,346306
150100,201903,58,39,19,38922,18962,57884
150110,201903,174,89,85,88822,86826,175648
150120,201903,428,314,114,313372,113772,427144
150125,201903,54,22,32,21956,31936,53892
150130,201903,1975,1072,903,1071852,901194,1973046
150140,201903,54158,25436,28722,25424063.4,28703501.96,54127565.36
150145,201903,186,104,82,103792,81836,185628
150150,201903,2818,1299,1519,1297400,1517958.8,2815358.8
150157,201903,411,291,120,290418,120758,411176
150160,201903,125,97,28,96806,27944,124750
150170,201903,3668,2741,927,2738512,929138,3667650
150172,201903,329,223,106,223552,106786,330338
150175,201903,80,50,30,49900,29940,79840
150178,201903,786,524,262,522952.4,262474,785426.4
150180,201903,3107,1524,1583,1520952.5,1581830.4,3102782.9
150190,201903,333,215,118,214570,119760,334330
150195,201903,120,61,59,60878,58882,119760
150200,201903,200,97,103,97804,102794,200598
150210,201903,3145,2568,577,2564860,577842.99,3142702.99
150215,201903,543,353,190,352294,189620.4,541914.4
150220,201903,3762,2566,1196,2561867.52,1199597.4,3761464.92
150230,201903,1164,944,220,942112.45,220558,1162670.45
150240,201903,5981,3517,2464,3510967.29,2460070.98,5971038.27
150250,201903,33,16,17,15968,16966,32934
150260,201903,79,48,31,48902,30938,79840
150270,201903,2320,1516,804,1513966,805386.8,2319352.8
150275,201903,549,346,203,345308,202594,547902
150276,201903,108,49,59,48902,58882,107784
150277,201903,763,331,432,331336.98,434130,765466.98
150280,201903,335,214,121,213572,120758,334330
150285,201903,87,43,44,42914,43912,86826
150290,201903,950,585,365,585826,365268.4,951094.4
150293,201903,655,313,342,312374,342314,654688
150295,201903,474,217,257,217564,258482,476046
150300,201903,76,40,36,39920,35928,75848
150304,201903,166,108,58,107784,57884,165668
150307,201903,387,323,64,322354,63872,386226
150309,201903,569,417,152,416166.98,152697.6,568864.58
150310,201903,249,168,81,167664,80838,248502
150320,201903,2036,1424,612,1423148,611774,2034922
150330,201903,2087,1213,874,1211572,875246,2086818
150340,201903,202,137,65,136726,64870,201596
150345,201903,614,343,271,342314.98,271456,613770.98
150350,201903,406,321,85,321356,85828,407184
150360,201903,4582,2963,1619,2963063.49,1620752,4583815.49
150370,201903,781,549,232,548900.98,231536.98,780437.96
150375,201903,198,104,94,103792,93812,197604
150380,201903,1417,960,457,958080,458082,1416162
150390,201903,747,431,316,430138.99,316366,746504.99
150400,201903,104,87,17,86826,16966,103792
150405,201903,1251,818,433,816364.92,433132,1249496.92
150410,201903,128,85,43,84830,42914,127744
150420,201903,7429,4096,3333,4090976.18,3334363.88,7425340.06
150430,201903,543,362,181,361276,181636,542912
150440,201903,569,344,225,344310,224550,568860
150442,201903,2238,1212,1026,1209576.58,1023948,2233524.58
150445,201903,532,344,188,344310,187624,531934
150450,201903,249,122,127,121756,126746,248502
150460,201903,743,565,178,564868.4,178642,743510.4
150470,201903,1334,814,520,813370,519958,1333328
150475,201903,45,34,11,33932,10978,44910
150480,201903,1269,896,373,895206,373252,1268458
150490,201903,603,329,274,328342,273452,601794
150495,201903,329,238,91,237524,90818,328342
150497,201903,301,201,100,202594,99800,302394
150500,201903,207,137,70,136726,69860,206586
150503,201903,907,454,453,453092.4,453093.38,906185.78
150506,201903,991,656,335,656684,336326,993010
150510,201903,1225,700,525,701594.4,524948,1226542.4
150520,201903,271,183,88,182634,87824,270458
150530,201903,1618,897,721,896204.5,721554,1617758.5
150540,201903,237,167,70,166666,69860,236526
150543,201903,760,420,340,419160,342314,761474
150548,201903,493,346,147,345308,146706,492014
150549,201903,62,45,17,44910,16966,61876
150550,201903,2850,1512,1338,1513966.5,1338318.4,2852284.9
150553,201903,3205,1908,1297,1907178.8,1298398,3205576.8
150555,201903,145,79,66,78842,65868,144710
150560,201903,16,10,6,10978,5988,16966
150563,201903,83,43,40,42914,39920,82834
150565,201903,171,105,66,104790,65868,170658
150570,201903,413,278,135,277444,134730,412174
150580,201903,1581,721,860,721554,862272,1583826
150590,201903,794,510,284,508980,283432,792412
150600,201903,459,284,175,284430,175648,460078
150610,201903,141,122,19,121756,18962,140718
150611,201903,119,82,37,81836,36926,118762
150613,201903,3205,1978,1227,1979034,1227540.98,3206574.98
150616,201903,497,299,198,299400.5,197604,497004.5
150618,201903,1252,682,570,680636.98,571854,1252490.98
150619,201903,404,310,94,309380,93812,403192
150620,201903,1270,758,512,757482,514968.99,1272450.99
150630,201903,293,193,100,193612,99800,293412
150635,201903,492,212,280,212574,279440,492014
150640,201903,57,28,29,27944,28942,56886
150650,201903,2366,1391,975,1389466.4,974049.39,2363515.79
150655,201903,247,183,64,182634,63872,246506
150658,201903,103,58,45,57884,44910,102794
150660,201903,499,350,149,349300,148702,498002
150670,201903,1018,377,641,377244.98,640716.98,1017961.96
150680,201903,9872,5462,4410,5455070.3,4411161.96,9866232.26
150690,201903,14,8,6,7984,5988,13972
150700,201903,500,331,169,330338,169660,499998
150710,201903,282,164,118,163672,117764,281436
150715,201903,840,516,324,514968.98,323352,838320.98
150720,201903,416,326,90,326346,90818,417164
150730,201903,967,525,442,523950.98,443112,967062.98
150740,201903,221,154,67,153692,66866,220558
150745,201903,808,444,364,444110,363272,807382
150746,201903,49,30,19,29940,19960,49900
150747,201903,253,195,58,194610,57884,252494
150750,201903,131,75,56,74850,55888,130738
150760,201903,1751,1152,599,1149696,598800,1748496
150770,201903,376,204,172,204590,172654,377244
150775,201903,97,44,53,44910,52894,97804
150780,201903,192,106,86,105788,86826,192614
150790,201903,855,471,384,471056,385228,856284
150795,201903,1497,887,610,886224,611774,1497998
150796,201903,376,218,158,218562,157684,376246
150797,201903,289,160,129,159680,128742,288422
150800,201903,1442,865,577,864268,575846.97,1440114.97
150803,201903,591,488,103,488022,103792,591814
150805,201903,190,119,71,118762,70858.99,189620.99
150808,201903,1010,558,452,559878,453092,1012970
150810,201903,3373,2350,1023,2351289.81,1024946.4,3376236.21
150812,201903,443,242,201,241516,201596,443112
150815,201903,969,643,326,642712,325348,968060
150820,201903,1555,948,607,947102,607782,1554884
150830,201903,803,579,224,577842,224550,802392
150835,201903,194,118,76,117764,75848,193612
150840,201903,1349,868,481,867262.44,480038,1347300.44
160005,201903,52,31,21,30938,20958,51896
160010,201903,190,120,70,119760,69860.99,189620.99
160015,201903,120,72,48,71856,47904,119760
160020,201903,134,77,57,76846,56886,133732
160021,201903,43,23,20,22954,19960,42914
160023,201903,120,74,46,73852,45908,119760
160025,201903,29,13,16,12974,15968,28942
160027,201903,1498,865,633,863270.5,632732,1496002.5
160030,201903,15669,8150,7519,8153669.76,7523932.05,15677601.81
160040,201903,299,175,124,174650,123752,298402
160050,201903,712,365,347,364270,349300.94,713570.94
160053,201903,320,185,135,184630.4,134730,319360.4
160055,201903,32,23,9,22954,8982,31936
160060,201903,6515,3464,3051,3464059.99,3051885.39,6515945.38
160070,201903,175,108,67,107784,67864,175648
160080,201903,87,45,42,44910,41916,86826
170025,201903,25,14,11,13972,10978,24950
170030,201903,227,185,42,185628.88,41916,227544.88
170035,201903,226,107,119,106786,118762,225548
170040,201903,181,140,41,139720,40918,180638
170070,201903,325,198,127,197637.26,127744,325381.26
170100,201903,364,263,101,262474,100798,363272
170105,201903,60,49,11,48902,10978,59880
170110,201903,112,71,41,70858,40918,111776
170130,201903,65,32,33,31936,32934.4,64870.4
170190,201903,98,64,34,63872,33932,97804
170200,201903,388,262,126,262474.98,125748.9,388223.88
170210,201903,5988,3168,2820,3168652.9,2820350.58,5989003.48
170215,201903,106,49,57,48902,57884,106786
170220,201903,1418,1046,372,1043908,373252.4,1417160.4
170230,201903,155,104,51,103792,50898,154690
170240,201903,532,355,177,356286.8,176646,532932.8
170255,201903,1114,898,216,898200,215568,1113768
170270,201903,41,29,12,28942,11976,40918
170290,201903,102,75,27,74850,26946,101796
170300,201903,85,57,28,56886,27944,84830
170305,201903,49,38,11,37924,10978,48902
170307,201903,64,49,15,48902,14970,63872
170310,201903,107,61,46,60878,45908,106786
170320,201903,23,18,5,17964,4990,22954
170330,201903,24,22,2,21956,1996,23952
170360,201903,27,16,11,15968,10978,26946
170370,201903,124,65,59,64870,58882,123752
170380,201903,82,63,19,62874,18962,81836
170382,201903,44,39,5,38922,4990,43912
170384,201903,141,106,35,105788,34930,140718
170386,201903,63,27,36,26946,35928,62874
170388,201903,50,20,30,19960,29940,49900
170389,201903,26,21,5,20958,4990,25948
170390,201903,59,35,24,34930.98,23952,58882.98
170410,201903,32,23,9,22954,8982,31936
170460,201903,17,13,4,12974,3992,16966
170510,201903,36,29,7,28942,6986,35928
170550,201903,1530,894,636,893210,638720,1531930
170555,201903,110,79,31,78842,30938,109780
170560,201903,97,72,25,71856,24950,96806
170600,201903,37,18,19,17964,18962,36926
170610,201903,191,101,90,100798,89822.36,190620.36
170625,201903,36,19,17,18962,16966,35928
170650,201903,77,59,18,58882,17964,76846
170700,201903,571,434,137,433132.5,136726,569858.5
170710,201903,160,98,62,97804,61877.96,159681.96
170720,201903,87,70,17,69860,16966,86826
170730,201903,77,46,31,45908,30938,76846
170740,201903,90,67,23,66866,22954,89820
170755,201903,64,34,30,33932,29940,63872
170765,201903,138,72,66,71856.2,65868,137724.2
170770,201903,224,136,88,135728,87824,223552
170820,201903,602,398,204,397204,203593.2,600797.2
170825,201903,32,18,14,17964,13972,31936
170830,201903,86,67,19,66866,18962,85828
170900,201903,192,151,41,150698,41916,192614
170930,201903,871,465,406,465068,406186.4,871254.4
170950,201903,3079,1395,1684,1395205.38,1690614.05,3085819.43
170980,201903,18,10,8,9980,7984,17964
171050,201903,146,115,31,114770,30938,145708
171070,201903,38,32,6,31936,5988,37924
171090,201903,45,34,11,33932,10978,44910
171110,201903,20,13,7,12974,6986,19960
171150,201903,44,23,21,22954,20958,43912
171180,201903,24,12,12,11976,11976,23952
171190,201903,149,86,63,85828,63872,149700
171195,201903,63,51,12,50898,11976,62874
171200,201903,49,25,24,24950,23952,48902
171215,201903,4,3,1,2994,998,3992
171240,201903,56,45,11,44910,10978,55888
171245,201903,56,51,5,50898,4990,55888
171250,201903,72,39,33,38922,32934,71856
171270,201903,16,12,4,11976,3992,15968
171280,201903,41,37,4,36926.7,3992,40918.7
171320,201903,990,577,413,577842,413172,991014
171330,201903,425,210,215,209580,216566,426146
171360,201903,90,66,24,65868,24950,90818
171370,201903,29,16,13,15968,12974,28942
171380,201903,134,110,24,109780,23952,133732
171395,201903,55,36,19,35928,19960,55888
171420,201903,296,194,102,193612,101796,295408
171430,201903,67,55,12,54890,11976,66866
171488,201903,190,104,86,103792,85828,189620
171500,201903,57,32,25,31936,24950,56886
171510,201903,67,45,22,44910,21956,66866
171515,201903,42,35,7,34930,6986.4,41916.4
171525,201903,29,27,2,26946,1996,28942
171550,201903,11,8,3,7984,2994,10978
171570,201903,57,30,27,29940,27944,57884
171575,201903,325,208,117,208582,117764,326346
171610,201903,1731,877,854,877248.84,853300.78,1730549.62
171620,201903,136,96,40,95808,39920,135728
171630,201903,54,28,26,27944,26946,54890
171650,201903,274,185,89,184630,88822,273452
171660,201903,267,146,121,146706,121757.39,268463.39
171665,201903,54,38,16,37924,15968,53892
171670,201903,429,248,181,247504.5,180638,428142.5
171700,201903,68,60,8,59880,7984,67864
171720,201903,25,10,15,9980,14970,24950
171750,201903,102,55,47,54890,46906,101796
171780,201903,78,63,15,63872,14970,78842
171790,201903,78,67,11,66866,10978,77844
171800,201903,38,30,8,29940,7984,37924
171820,201903,2081,1203,878,1201592.44,882232.98,2083825.42
171830,201903,34,27,7,26946,6986,33932
171840,201903,62,40,22,39920,21956,61876
171845,201903,32,20,12,19960,11976,31936
171850,201903,40,30,10,29940,9980,39920
171855,201903,78,62,16,61876,15968,77844
171865,201903,10,8,2,7984,1996,9980
171870,201903,32,23,9,22954,8982,31936
171875,201903,82,58,24,57884,23952,81836
171880,201903,33,22,11,21956,10978,32934
171884,201903,47,24,23,23952,22954,46906
171886,201903,121,47,74,46906,73852,120758
171888,201903,27,21,6,20958,5988,26946
171889,201903,19,14,5,13972,4990,18962
171890,201903,57,47,10,46906,9980,56886
171900,201903,43,30,13,29940,12974,42914
172000,201903,38,31,7,30938,6986,37924
172010,201903,44,36,8,35928,7984,43912
172015,201903,26,16,10,15968.58,9980,25948.58
172020,201903,139,89,50,88822,49900,138722
172025,201903,31,20,11,19960,10978,30938
172030,201903,38,24,14,23952,13972,37924
172049,201903,78,50,28,49900,27944,77844
172065,201903,150,98,52,97804,51896,149700
172080,201903,98,65,33,64870,32934,97804
172085,201903,24,12,12,11976,11976,23952
172090,201903,419,329,90,328342,90818,419160
172093,201903,26,20,6,19960,5988,25948
172097,201903,17,9,8,8982,7984.4,16966.4
172100,201903,4893,2794,2099,2792406.84,2104783.98,4897190.82
172110,201903,80,53,27,52894,26946,79840
172120,201903,1676,1434,242,1432131.5,241516.96,1673648.46
172125,201903,3,3,0,2994,0,2994
172130,201903,18,13,5,12974,4990,17964
172208,201903,197,126,71,125748,70858,196606
172210,201903,388,191,197,193612,197604.4,391216.4
210005,201903,2941,1842,1099,1841310.75,1097804,2939114.75
210010,201903,181,93,88,92814,87824,180638
210015,201903,38,28,10,27944,9980,37924
210020,201903,350,188,162,187624,161676,349300
210030,201903,340,217,123,216566,123752.98,340318.98
210040,201903,142,111,31,110778,30938,141716
210043,201903,262,190,72,189620,71856,261476
210047,201903,584,324,260,323352,259480,582832
210050,201903,298,220,78,219560,77844,297404
210055,201903,44,33,11,32934,10978,43912
210060,201903,557,443,114,442114,113772,555886
210070,201903,415,312,103,311376,102794,414170
210080,201903,111,101,10,100798,10978,111776
210083,201903,303,143,160,142714,159680,302394
210087,201903,40,30,10,29940,9980,39920
210090,201903,470,331,139,330338,139720,470058
210095,201903,468,348,120,347304,119760,467064
210100,201903,699,544,155,542912,154690,697602
210110,201903,142,82,60,81836,59880,141716
210120,201903,5345,4099,1246,4097796.12,1249497.53,5347293.65
210125,201903,207,123,84,122754,84830,207584
210130,201903,516,286,230,285428,229540,514968
210135,201903,32,19,13,18962,12974,31936
210140,201903,4398,3457,941,3460066.6,942112,4402178.6
210150,201903,374,238,136,238522,135728,374250
210160,201903,3399,2868,531,2865258.55,529938,3395196.55
210170,201903,1185,944,241,944108,240518,1184626
210173,201903,133,113,20,112774,19960,132734
210177,201903,427,220,207,219560,206586,426146
210180,201903,33,18,15,17964,14970,32934
210190,201903,416,276,140,275448,139720,415168
210193,201903,2,1,1,998,998,1996
210197,201903,80,54,26,53892,25948,79840
210200,201903,640,514,126,513970,126746,640716
210203,201903,258,176,82,175648,81836,257484
210207,201903,381,299,82,298402,81836,380238
210210,201903,779,722,57,720556,57884,778440
210215,201903,78,68,10,67864,9980,77844
210220,201903,402,334,68,333332,67864,401196
210230,201903,303,236,67,235528,66866,302394
210232,201903,1467,966,501,965066,499998,1465064
210235,201903,158,125,33,124750.6,32934,157684.6
210237,201903,43,25,18,24950,17964,42914
210240,201903,90,75,15,74850,14970,89820
210250,201903,187,154,33,153692,32934,186626
210255,201903,358,268,90,268462,90818,359280
210260,201903,410,270,140,269460,139720,409180
210270,201903,684,444,240,444110,240518,684628
210275,201903,56,43,13,42914,12974,55888
210280,201903,1065,694,371,694608.48,371256,1065864.48
210290,201903,514,346,168,345308,167664,512972
210300,201903,5825,3529,2296,3524936.39,2296398.97,5821335.36
210310,201903,112,79,33,78842,32934,111776
210312,201903,118,80,38,79840,37924,117764
210315,201903,117,89,28,88822,27944,116766
210317,201903,123,91,32,90818,31936,122754
210320,201903,2370,1983,387,1980032.96,387224,2367256.96
210325,201903,130,93,37,92814,36926.4,129740.4
210330,201903,5159,2801,2358,2798392.7,2359272,5157664.7
210340,201903,1343,974,369,975046,368263.94,1343309.94
210350,201903,621,516,105,514968,104790,619758
210355,201903,148,120,28,119760,27944,147704
210360,201903,2545,1646,899,1645702.06,900196.4,2545898.46
210370,201903,1247,569,678,567862,679638,1247500
210375,201903,193,99,94,98802,93812,192614
210380,201903,715,541,174,541914,173652,715566
210390,201903,201,168,33,168662,32934,201596
210400,201903,421,361,60,360278,60878.96,421156.96
210405,201903,1008,690,318,689618,318362,1007980
210407,201903,55,44,11,43912,10978,54890
210408,201903,62,56,6,55888,5988,61876
210409,201903,333,282,51,282434,50898,333332
210410,201903,445,348,97,347304,96806.98,444110.98
210420,201903,199,164,35,164670,34930,199600
210430,201903,40,27,13,26946,12974,39920
210440,201903,356,227,129,226546,132734,359280
210450,201903,156,121,35,120758,34930,155688
210455,201903,227,126,101,125748,100798,226546
210460,201903,334,214,120,213572,119760,333332
210462,201903,68,57,11,56886,10978,67864
210465,201903,165,119,46,118762,45908,164670
210467,201903,530,384,146,383232,145708,528940
210470,201903,45,38,7,37924,6986,44910
210480,201903,1309,925,384,924148,383232,1307380
210490,201903,213,137,76,136726,76846,213572
210500,201903,567,319,248,318362,247504,565866
210510,201903,572,450,122,450098,122754,572852
210515,201903,420,241,179,240518,179640,420158
210520,201903,418,365,53,364270,52894,417164
210530,201903,9420,5056,4364,5050883.52,4364258.6,9415142.12
210535,201903,127,93,34,92814,33932,126746
210540,201903,1535,969,566,967062.2,564868,1531930.2
210542,201903,1208,599,609,599798,609778.4,1209576.4
210545,201903,16,15,1,14970,998,15968
210547,201903,132,114,18,113772,17964,131736
210550,201903,722,518,204,517963.4,204590,722553.4
210560,201903,176,149,27,148702,26946,175648
210565,201903,30,22,8,21956,7984,29940
210570,201903,1353,1077,276,1076842.44,275448,1352290.44
210580,201903,114,99,15,98802,14970,113772
210590,201903,771,623,148,623750,147704,771454
210592,201903,32,29,3,28942,2994,31936
210594,201903,107,89,18,88822,17964,106786
210596,201903,96,82,14,81836,14970,96806
210598,201903,130,96,34,95808,33932,129740
210600,201903,339,288,51,287424,50898,338322
210610,201903,256,237,19,236526,18962,255488
210620,201903,45,27,18,26946,17964,44910
210630,201903,67,64,3,64870,2994,67864
210632,201903,1056,718,338,716564,337324,1053888
210635,201903,20,17,3,16966,2994,19960
210637,201903,101,72,29,71856,28942,100798
210640,201903,588,515,73,515966,72854,588820
210650,201903,413,340,73,340318,72854,413172
210660,201903,395,293,102,293412,102794,396206
210663,201903,23,14,9,13972,8982,22954
210667,201903,111,35,76,34930,75848,110778
210670,201903,267,235,32,234530,31936,266466
210675,201903,565,302,263,301396,262474,563870
210680,201903,215,139,76,138722,75848,214570
210690,201903,641,516,125,515966,124750,640716
210700,201903,179,132,47,131736,46906,178642
210710,201903,279,164,115,163672,114770,278442
210720,201903,135,117,18,116766,17964,134730
210725,201903,69,61,8,60878,7984,68862
210730,201903,25,18,7,17964,6986,24950
210735,201903,403,279,124,278442,124750.4,403192.4
210740,201903,558,474,84,473052,83832,556884
210745,201903,159,118,41,117764,40918,158682
210750,201903,2436,1171,1265,1169656.5,1265464.4,2435120.9
210760,201903,266,199,67,198602,66866,265468
210770,201903,403,314,89,313372,88822,402194
210780,201903,424,311,113,310378,112774,423152
210790,201903,187,146,41,145708,40918,186626
210800,201903,166,124,42,123752,41916,165668
210805,201903,52,48,4,47904,3992,51896
210810,201903,485,382,103,381236,102794,484030
210820,201903,2301,1866,435,1863267.76,444110,2307377.76
210825,201903,167,89,78,88822,77844,166666
210830,201903,770,493,277,493012,276446,769458
210840,201903,204,139,65,138722,64870,203592
210845,201903,256,169,87,168662,88822,257484
210850,201903,810,530,280,529938,280438,810376
210860,201903,4006,2147,1859,2145700.9,1862268,4007968.9
210870,201903,480,367,113,367264,112774,480038
210880,201903,69,52,17,51896,16966,68862
210890,201903,341,290,51,289420,50898,340318
210900,201903,603,390,213,389220,212574,601794
210905,201903,65,32,33,31936,32934,64870
210910,201903,2023,1516,507,1513967.01,510976,2024943.01
210920,201903,200,66,134,65868,133732,199600
210923,201903,79,56,23,55888,22954,78842
210927,201903,426,189,237,188622,237524,426146
210930,201903,70,56,14,55888,14970,70858
210940,201903,90,71,19,70858,18962,89820
210945,201903,202,99,103,98802,102794,201596
210950,201903,530,391,139,390218,138722,528940
210955,201903,74,49,25,48902,24950,73852
210960,201903,2346,1075,1271,1072850,1271452,2344302
210970,201903,115,102,13,101796,13972,115768
210975,201903,90,81,9,80838,8982,89820
210980,201903,1162,533,629,532932,631734.4,1164666.4
210990,201903,4255,2693,1562,2688613,1562868,4251481
211000,201903,1372,1094,278,1091812.4,277444,1369256.4
211003,201903,893,619,274,620756,273452.98,894208.98
211010,201903,501,444,57,444110,56886,500996
211020,201903,1584,606,978,605786,978040,1583826
211023,201903,32,27,5,26946,4990,31936
211027,201903,71,50,21,49900,21956,71856
211030,201903,391,268,123,268462,122754,391216
211040,201903,317,255,62,254490.4,62874,317364.4
211050,201903,1180,772,408,771454,408182.4,1179636.4
211060,201903,677,578,99,576844.96,99800,676644.96
211065,201903,21,17,4,16966,3992,20958
211070,201903,923,759,164,758480.66,166666,925146.66
211080,201903,89,85,4,84830,3992,88822
211085,201903,60,31,29,30938.4,28942,59880.4
211090,201903,92,74,18,73852,17964,91816
211100,201903,499,403,96,402194,96806.4,499000.4
211102,201903,257,172,85,171656,84830,256486
211105,201903,222,156,66,156686,65868,222554
211107,201903,133,79,54,78842,53892,132734
211110,201903,840,554,286,553890,287424.98,841314.98
211120,201903,5754,2683,3071,2681628.6,3075837.72,5757466.32
211125,201903,33,26,7,25948,6986,32934
211130,201903,44859,19577,25282,19568794.12,25321263.53,44890057.65
211140,201903,429,366,63,366266.99,62874,429140.99
211150,201903,1298,826,472,827342,472055.39,1299397.39
211153,201903,165,98,67,98802,66866,165668
211157,201903,64,50,14,49900,13972,63872
211160,201903,712,598,114,598800,113772,712572
211163,201903,0,0,0,0,0,0
211167,201903,10,9,1,8982,998,9980
211170,201903,439,314,125,313372,125748,439120
211172,201903,121,84,37,84830,36926,121756
211174,201903,265,161,104,160678,103792,264470
211176,201903,505,371,134,370258,133732,503990
211178,201903,92,61,31,61876,30938,92814
211180,201903,207,164,43,164670,42914,207584
211190,201903,70,65,5,64870,4990,69860
211195,201903,29,19,10,18962,9980,28942
211200,201903,153,132,21,131736,20958,152694
211210,201903,503,328,175,328342,175648,503990
211220,201903,4092,2348,1744,2347298.53,1749495.99,4096794.52
211223,201903,95,90,5,89820,4990,94810
211227,201903,71,53,18,52894,17964,70858
211230,201903,774,633,141,631734,142714,774448
211240,201903,413,312,101,311376,100798,412174
211245,201903,190,90,100,89820,99800,189620
211250,201903,1636,1405,231,1403189.59,230538.98,1633728.57
211260,201903,835,671,164,669658,163672,833330
211270,201903,2056,1650,406,1646700,405188.4,2051888.4
211280,201903,1861,1154,707,1153688,709578,1863266
211285,201903,205,124,81,123752,80838,204590
211290,201903,691,474,217,474050,217564,691614
211300,201903,810,634,176,632732.96,175648,808380.96
211400,201903,1572,928,644,926144,644708,1570852
220005,201903,17,16,1,15968,998,16966
220010,201903,89,67,22,66866,21956,88822
220020,201903,652,525,127,523950,126746,650696
220025,201903,109,106,3,105788,2994,108782
220027,201903,39,32,7,31936,6986,38922
220030,201903,105,87,18,86826,17964,104790
220040,201903,1184,896,288,895206.6,287424,1182630.6
220045,201903,41,30,11,29940,10978,40918
220050,201903,685,573,112,571855.08,111776,683631.08
220060,201903,171,148,23,148702,22954,171656
220070,201903,105,97,8,97804,8982,106786
220080,201903,15,14,1,13972,998,14970
220090,201903,34,28,6,27944,5988,33932
220095,201903,2,1,1,998,998,1996
220100,201903,23,19,4,18962,3992,22954
220105,201903,24,23,1,22954.4,998,23952.4
220110,201903,220,201,19,201596,18962,220558
220115,201903,47,45,2,44910,1996,46906
220117,201903,22,20,2,19960,1996,21956
220120,201903,1485,1099,386,1097800,387224,1485024
220130,201903,29,29,0,28942,0,28942
220140,201903,97,76,21,75848,20958,96806
220150,201903,486,351,135,350298,134730,485028
220155,201903,5,5,0,4990,0,4990
220157,201903,18,15,3,14970,2994,17964
220160,201903,81,71,10,70858,9980,80838
220170,201903,35,33,2,32934,1996,34930
220173,201903,6,6,0,5988,0,5988
220177,201903,6,6,0,5988,0,5988
220180,201903,66,66,0,65868,0,65868
220190,201903,1065,953,112,951094,111776,1062870
220191,201903,44,39,5,38922,4990,43912
220192,201903,71,68,3,67864,2994,70858
220194,201903,44,42,2,41916,1996,43912
220196,201903,99,84,15,83832,14970,98802
220198,201903,4,3,1,2994,998,3992
220200,201903,427,356,71,355288.5,71856,427144.5
220202,201903,38,34,4,33932,3992,37924
220205,201903,42,38,4,37924,3992,41916
220207,201903,13,12,1,11976,998,12974
220208,201903,80,43,37,42914,36926,79840
220209,201903,31,28,3,27944,2994,30938
220210,201903,16,14,2,13972,1996,15968
220211,201903,26,25,1,24950,998,25948
220213,201903,42,38,4,37924,3992.4,41916.4
220217,201903,39,31,8,30938,7984,38922
220220,201903,2093,1359,734,1357280,733531.1,2090811.1
220225,201903,11,5,6,4990,5988,10978
220230,201903,970,769,201,767462,201596,969058
220240,201903,157,144,13,144710,12974,157684
220245,201903,32,29,3,28942.99,2994,31936.99
220250,201903,118,106,12,105788,11976,117764
220253,201903,42,37,5,36926,4990,41916
220255,201903,29,26,3,25948,2994,28942
220260,201903,699,511,188,509978,187624,697602
220265,201903,12,9,3,8982,2994,11976
220270,201903,728,651,77,650696,76846,727542
220271,201903,42,35,7,34930,6986,41916
220272,201903,26,26,0,25948,0,25948
220273,201903,14,12,2,11976,1996,13972
220275,201903,52,42,10,41916,9980,51896
220277,201903,11,9,2,8982,1996,10978
220280,201903,14,11,3,10978,2994,13972
220285,201903,45,42,3,41916,2994,44910
220290,201903,1459,1252,207,1250494.38,206586.9,1457081.28
220300,201903,50,48,2,47904,1996,49900
220310,201903,313,265,48,264470.99,47904.98,312375.97
220320,201903,435,400,35,399200.4,34930,434130.4
220323,201903,0,0,0,0,0,0
220325,201903,15,10,5,9980,4990,14970
220327,201903,12,11,1,10978,998,11976
220330,201903,210,149,61,148702,61876,210578
220335,201903,133,115,18,114770,17964,132734
220340,201903,33,20,13,19960,12974,32934
220342,201903,59,52,7,51896,6986,58882
220345,201903,83,76,7,75848,6986,82834
220350,201903,433,379,54,378242,53892,432134
220360,201903,42,30,12,29940,11976,41916
220370,201903,1170,956,214,954088,214570,1168658
220375,201903,22,20,2,19960,1996,21956
220380,201903,18,16,2,15968,1996,17964
220385,201903,17,15,2,14970,1996,16966
220390,201903,2309,1326,983,1326342.84,982033.2,2308376.04
220400,201903,31,28,3,27944,2994,30938
220410,201903,19,18,1,17964,998,18962
220415,201903,14,13,1,12974,998,13972
220420,201903,129,106,23,105788,22954,128742
220430,201903,131,119,12,119760.5,11976,131736.5
220435,201903,20,14,6,13972,5988,19960
220440,201903,299,255,44,254490,43912,298402
220450,201903,339,173,166,172654,165668,338322
220455,201903,55,53,2,52894,1996,54890
220460,201903,20,20,0,19960,0,19960
220465,201903,104,69,35,68862,34930,103792
220470,201903,238,209,29,208582,28942,237524
220480,201903,74,65,9,64870,8982,73852
220490,201903,90,77,13,76846,12974,89820
220500,201903,97,83,14,82834,13972,96806
220510,201903,448,346,102,346306,103792,450098
220515,201903,20,18,2,17964,1996,19960
220520,201903,376,338,38,338322.34,37924,376246.34
220525,201903,18,12,6,11976,5988,17964
220527,201903,31,24,7,23952,6986,30938
220530,201903,36,15,21,14970,20958,35928
220535,201903,6,6,0,5988,0,5988
220540,201903,61,51,10,50898,9980,60878
220545,201903,50,35,15,34930,14970,49900
220550,201903,656,507,149,505986,148702,654688
220551,201903,23,18,5,17964,4990,22954
220552,201903,13,13,0,12974,0,12974
220553,201903,47,43,4,42914,3992,46906
220554,201903,10,7,3,6986,2994,9980
220555,201903,30,27,3,26946,2994,29940
220556,201903,50,46,4,45908,3992,49900
220557,201903,56,51,5,50898,4990,55888
220558,201903,6,2,4,1996,3992,5988
220559,201903,5,5,0,4990,0,4990
220560,201903,68,44,24,43912,23952,67864
220570,201903,784,479,305,479040.4,304390,783430.4
220580,201903,558,515,43,514968,42914,557882
220585,201903,6,5,1,4990,998,5988
220590,201903,14,14,0,13972,0,13972
220595,201903,61,46,15,45908,14970,60878
220600,201903,22,14,8,13972,7984,21956
220605,201903,20,19,1,18962,998,19960
220610,201903,68,60,8,59880,7984,67864
220620,201903,561,452,109,451096,108782,559878
220630,201903,5,4,1,3992,998,4990
220635,201903,34,30,4,29940,3992,33932
220640,201903,100,79,21,78842,20958,99800
220650,201903,113,106,7,105788,6986,112774
220660,201903,39,31,8,30938,7984,38922
220665,201903,4,4,0,3992,0,3992
220667,201903,23,21,2,20958,1996,22954
220669,201903,30,27,3,26946,2994,29940
220670,201903,66,54,12,53892,11976,65868
220672,201903,66,46,20,45908,20958,66866
220675,201903,37,29,8,28942,7984,36926
220680,201903,40,34,6,33932,5988,39920
220690,201903,46,44,2,43912,1996,45908
220695,201903,50,23,27,22954,26946,49900
220700,201903,1671,1286,385,1284426.8,384230,1668656.8
220710,201903,4,3,1,2994,998,3992
220720,201903,108,88,20,87824,19960,107784
220730,201903,18,18,0,17964,0,17964
220735,201903,3,1,2,998,1996,2994
220740,201903,48,44,4,43912,3992,47904
220750,201903,104,89,15,88822,14970,103792
220755,201903,15,15,0,14970,0,14970
220760,201903,57,54,3,53892,2994,56886
220770,201903,5733,3031,2702,3026936.26,2702587.32,5729523.58
220775,201903,21,9,12,8982,11976,20958
220777,201903,17,16,1,15968,998,16966
220779,201903,2,2,0,1996,0,1996
220780,201903,895,767,128,765466,127744.4,893210.4
220785,201903,4,1,3,998,2994,3992
220790,201903,1049,841,208,840316.64,207584,1047900.64
220793,201903,8,8,0,7984,0,7984
220795,201903,16,15,1,15968,998,16966
220800,201903,4015,3086,929,3082824.88,929138.99,4011963.87
220810,201903,68,60,8,59880,7984,67864
220820,201903,247,226,21,225548,20958,246506
220830,201903,1224,1052,172,1051892.8,172654,1224546.8
220840,201903,2397,1676,721,1673649.81,721554.78,2395204.59
220850,201903,54,46,8,45908,7984,53892
220855,201903,10,7,3,6986,2994,9980
220860,201903,11,10,1,9980,998,10978
220865,201903,25,23,2,22954,1996,24950
220870,201903,66,61,5,61876,4990,66866
220880,201903,326,252,74,251496,74850.4,326346.4
220885,201903,37,34,3,33932,2994,36926
220887,201903,15,15,0,14970,0,14970
220890,201903,101,89,12,89820,11976,101796
220900,201903,18,12,6,11976,5988,17964
220910,201903,56,47,9,46906,8982,55888
220915,201903,10,9,1,8982,998,9980
220920,201903,45,41,4,40918,3992,44910
220930,201903,42,41,1,40918,998,41916
220935,201903,17,17,0,16966,0,16966
220937,201903,39,37,2,36926,1996,38922
220940,201903,57,52,5,51896,4990,56886
220945,201903,0,0,0,0,0,0
220950,201903,45,41,4,40918,3992,44910
220955,201903,28,24,4,23952,3992,27944
220960,201903,6,6,0,5988,0,5988
220965,201903,35,32,3,31936,2994,34930
220970,201903,56,47,9,46906,8982,55888
220975,201903,12,10,2,9980,1996,11976
220980,201903,32,30,2,29940,1996,31936
220985,201903,68,60,8,59880,8982,68862
220987,201903,32,30,2,29940,1996,31936
220990,201903,18,17,1,16966,998,17964
220995,201903,24,19,5,19960,4990,24950
220997,201903,56,46,10,45908,9980,55888
221000,201903,1141,1031,110,1028938,109780,1138718
221005,201903,62,55,7,54890,6986,61876
221010,201903,17,13,4,12974,3992,16966
221020,201903,43,41,2,41916,1996,43912
221030,201903,32,26,6,25948,5988,31936
221035,201903,23,23,0,22954,0,22954
221037,201903,10,6,4,5988,3992,9980
221038,201903,28,25,3,24950,2994,27944
221039,201903,22,22,0,21956,0,21956
221040,201903,259,223,36,222554,35928,258482
221050,201903,236,202,34,201596,34930,236526
221060,201903,1840,1626,214,1625742,213572,1839314
221062,201903,34,33,1,32934,998,33932
221063,201903,13,9,4,8982,3992,12974
221065,201903,51,45,6,44910,5988,50898
221070,201903,141,123,18,122754,17964,140718
221080,201903,380,333,47,332334,46906,379240
221090,201903,31,30,1,29940,998,30938
221093,201903,53,36,17,36926,16966,53892
221095,201903,9,9,0,8982,0,8982
221097,201903,16,13,3,12974,2994,15968
221100,201903,25309,14822,10487,14812324.86,10489979.9,25302304.76
221110,201903,1056,787,269,787422.4,268462,1055884.4
221120,201903,531,399,132,398202.4,132734,530936.4
221130,201903,958,786,172,784428,171656,956084
221135,201903,34,31,3,30938,2994,33932
221140,201903,44,37,7,36926,6986,43912
221150,201903,12,9,3,8982,2994,11976
221160,201903,14,13,1,12974,998,13972
221170,201903,14,14,0,13972,0,13972
230010,201903,168,152,16,151696,15968,167664
230015,201903,125,105,20,104790,19960,124750
230020,201903,1636,1382,254,1379236.4,254497.76,1633734.16
230030,201903,1674,1208,466,1207581.78,465068,1672649.78
230040,201903,205,178,27,177644.4,26946,204590.4
230050,201903,214,157,57,156686,56886,213572
230060,201903,157,127,30,126746,29940,156686
230070,201903,295,264,31,264470,30938,295408
230075,201903,840,734,106,733530.8,106786,840316.8
230080,201903,193,166,27,165668,26946,192614
230090,201903,111,78,33,77844,32934,110778
230100,201903,2003,1198,805,1195605.34,804390.82,1999996.16
230110,201903,2755,1783,972,1780432.4,973050,2753482.4
230120,201903,967,778,189,776444.6,188622,965066.6
230125,201903,147,122,25,121756,24950,146706
230130,201903,477,424,53,423152,52894,476046
230140,201903,212,184,28,183632,27944,211576
230150,201903,159,121,38,120758,37924,158682
230160,201903,937,807,130,805386,129740,935126
230170,201903,587,538,49,536925,48902,585827
230180,201903,79,74,5,73852,4990,78842
230185,201903,413,357,56,356286,55888,412174
230190,201903,2260,1819,441,1818357.74,440118,2258475.74
230195,201903,489,425,64,424150,63872,488022
230200,201903,383,331,52,330338,51896,382234
230205,201903,377,242,135,242514,134730,377244
230210,201903,1276,1014,262,1014968.22,262474.94,1277443.16
230220,201903,1547,1058,489,1055884,488022.94,1543906.94
230230,201903,893,772,121,771454,120758,892212
230240,201903,1697,1461,236,1459326.86,237524,1696850.86
230250,201903,1803,1492,311,1491013.58,311376,1802389.58
230260,201903,3065,1898,1167,1896200,1167660,3063860
230270,201903,1377,1107,270,1105786.17,271456,1377242.17
230280,201903,2732,2045,687,2043904.8,685626,2729530.8
230290,201903,406,362,44,361278.67,43912,405190.67
230300,201903,514,385,129,384230,128742,512972
230310,201903,421,318,103,318362,102794,421156
230320,201903,942,804,138,802393.4,138722,941115.4
230330,201903,306,246,60,245508,60878.6,306386.6
230340,201903,458,369,89,369260.6,88822,458082.6
230350,201903,3093,1973,1120,1974044,1123748,3097792
230360,201903,272,214,58,213572,58882,272454
230365,201903,138,111,27,110778,26946,137724
230370,201903,9808,4870,4938,4861287.39,4937156.95,9798444.34
230380,201903,481,412,69,411176.4,68862.2,480038.6
230390,201903,518,290,228,289420,228542,517962
230393,201903,263,222,41,221556,41916,263472
230395,201903,353,283,70,283432.48,69860,353292.48
230400,201903,609,484,125,486026,124750,610776
230410,201903,2652,1665,987,1663667.09,987023,2650690.09
230420,201903,6291,4173,2118,4168649.84,2115762.56,6284412.40
230423,201903,319,277,42,276446,41916,318362
230425,201903,376,311,65,310378.34,64870,375248.34
230426,201903,122,99,23,98802,22954,121756
230427,201903,80,77,3,76846,2994,79840
230428,201903,1427,732,695,731534,694608.94,1426142.94
230430,201903,462,379,83,378242.99,83832,462074.99
230435,201903,839,588,251,586824.31,250498.98,837323.29
230440,201903,85628,38262,47366,38249543.23,47366334.21,85615877.44
230445,201903,283,196,87,195608,86826,282434
230450,201903,538,431,107,430138,106786,536924
230460,201903,60,50,10,49900,9980,59880
230465,201903,310,253,57,252494,56886,309380
230470,201903,1968,1547,421,1546900,421156.5,1968056.5
230480,201903,158,149,9,148702,8982,157684
230490,201903,295,238,57,238522,56886,295408
230495,201903,460,342,118,341316,117764,459080
230500,201903,984,734,250,732532,249500.4,982032.4
230510,201903,52,41,11,40918,10978,51896
230520,201903,389,303,86,302394.18,85828,388222.18
230523,201903,2216,1413,803,1410174.96,805387.46,2215562.42
230526,201903,292,245,47,244510,46906,291416
230530,201903,679,509,170,509978.94,169660,679638.94
230533,201903,190,180,10,179640,9980,189620
230535,201903,358,268,90,267464,89820.22,357284.22
230540,201903,1856,1640,216,1636720,216566,1853286
230550,201903,3725,2393,1332,2394205.32,1333328,3727533.32
230560,201903,578,441,137,440118.8,137724.94,577843.74
230565,201903,212,156,56,155688,55888,211576
230570,201903,300,264,36,264470,35928,300398
230580,201903,1134,846,288,844308.94,288422,1132730.94
230590,201903,974,760,214,758480.5,214570,973050.5
230600,201903,254,231,23,231536,22954,254490
230610,201903,352,282,70,281436.6,70858,352294.6
230620,201903,170,139,31,138722,30938,169660
230625,201903,724,527,197,526944.6,196606.94,723551.54
230630,201903,1306,1032,274,1029936,275448,1305384
230640,201903,3702,3209,493,3204579,495010.61,3699589.61
230650,201903,423,370,53,371257.91,52894,424151.91
230655,201903,670,583,87,582832.6,87828.86,670661.46
230660,201903,361,305,56,304390,55888,360278
230670,201903,434,382,52,381236,51896,433132
230680,201903,201,181,20,180638,19960,200598
230690,201903,886,770,116,769458,117764,887222
230700,201903,753,638,115,637722.94,114770.94,752493.88
230710,201903,732,696,36,696604.6,35928,732532.6
230720,201903,150,130,20,129740,20958,150698
230725,201903,259,209,50,208582,49900.98,258482.98
230730,201903,12001,6522,5479,6517941,5473037.29,11990978.29
230740,201903,665,539,126,538920.4,125748,664668.4
230750,201903,843,722,121,720556.6,120758,841314.6
230760,201903,1386,1196,190,1194606,191616,1386222
230763,201903,309,259,50,258482,49900,308382
230765,201903,7187,3416,3771,3414186.56,3772467.57,7186654.13
230770,201903,5002,2574,2428,2569854.18,2425141.34,4994995.52
230780,201903,685,602,83,601794.96,83832,685626.96
230790,201903,237,197,40,196606,39920,236526
230800,201903,1127,826,301,824348,300398,1124746
230810,201903,1331,1186,145,1183628,144710,1328338
230820,201903,348,246,102,245508.4,101796,347304.4
230830,201903,949,818,131,816364,130738,947102
230835,201903,281,246,35,245508,34930,280438
230837,201903,166,139,27,138722,26946,165668
230840,201903,926,743,183,744508.4,183632.4,928140.8
230850,201903,1506,1312,194,1311372,193612.4,1504984.4
230860,201903,302,226,76,226546,75848,302394
230870,201903,1835,1570,265,1566860.94,264470,1831330.94
230880,201903,53,38,15,37924,14970,52894
230890,201903,552,508,44,506984,43912.97,550896.97
230900,201903,280,208,72,207584,71856.58,279440.58
230910,201903,211,170,41,169660,40918,210578
230920,201903,413,326,87,326346,86826,413172
230930,201903,939,667,272,666664.68,271456,938120.68
230940,201903,839,669,170,667662.94,172654.6,840317.54
230945,201903,497,415,82,415169,81836,497005
230950,201903,396,338,58,338089.13,57884,395973.13
230960,201903,2599,1770,829,1768457.92,828342.28,2596800.20
230970,201903,1762,997,765,997011.4,764475.52,1761486.92
230980,201903,209,177,32,177644,31936,209580
230990,201903,139,114,25,113772,24950,138722
231000,201903,206,187,19,186626,18962,205588
231010,201903,144,110,34,109780,33932,143712
231020,201903,1329,927,402,929142.72,402196.86,1331339.58
231025,201903,1029,775,254,775446.6,254490.4,1029937.0
231030,201903,1120,941,179,940117.35,179640,1119757.35
231040,201903,139,95,44,94810,43912,138722
231050,201903,982,878,104,877242,104790,982032
231060,201903,145,126,19,125748,18962,144710
231070,201903,1456,1029,427,1026943.3,428142.94,1455086.24
231080,201903,261,243,18,242514,17964,260478
231085,201903,584,362,222,362274.6,221556,583830.6
231090,201903,246,204,42,203592,41916,245508
231095,201903,165,132,33,131736,32934,164670
231100,201903,132,112,20,111776,19960,131736
231110,201903,359,310,49,309380,48902,358282
231120,201903,291,248,43,247504,42914,290418
231123,201903,145,139,6,138722,5988,144710
231126,201903,320,254,66,253492,65868,319360
231130,201903,4616,3606,1010,3600785.93,1009977.91,4610763.84
231135,201903,214,187,27,186626,26946,213572
231140,201903,3102,2287,815,2284422,815366,3099788
231150,201903,366,351,15,350298,15968,366266
231160,201903,1198,958,240,957082.94,240518.94,1197601.88
231170,201903,533,365,168,364270,168662,532932
231180,201903,1654,1408,246,1407180,245508,1652688
231190,201903,205,178,27,177644,26946,204590
231195,201903,221,190,31,189620,30938,220558
231200,201903,826,674,152,675646,152694.6,828340.6
231210,201903,602,507,95,505986,94810,600796
231220,201903,1036,753,283,753490.9,283432,1036922.9
231230,201903,1431,1144,287,1143708,286426,1430134
231240,201903,1412,1029,383,1029936.94,384230.4,1414167.34
231250,201903,114,104,10,103792,9980,113772
231260,201903,288,190,98,189620,97804.4,287424.4
231270,201903,1009,840,169,838321.49,168662,1006983.49
231280,201903,65,49,16,48902,15968,64870
231290,201903,7418,4149,3269,4145692.8,3269449.8,7415142.6
231300,201903,639,588,51,586824,50898,637722
231310,201903,739,684,55,682632.74,54890,737522.74
231320,201903,578,439,139,438124,138722,576846
231325,201903,94,83,11,82834,10978,93812
231330,201903,2038,1580,458,1580085.53,457084.7,2037170.23
231335,201903,254,226,28,225548,27944,253492
231340,201903,1666,1226,440,1223548,439120,1662668
231350,201903,1262,1039,223,1037920,222554.8,1260474.8
231355,201903,424,370,54,369260,53892,423152
231360,201903,491,379,112,379240.4,111776,491016.4
231370,201903,89,75,14,74850,13972,88822
231375,201903,294,213,81,212574,80838,293412
231380,201903,466,385,81,386226,81836,468062
231390,201903,203,166,37,165668,36926,202594
231395,201903,732,460,272,459080,272454,731534
231400,201903,1114,921,193,919161.04,192616.34,1111777.38
231410,201903,1333,1089,244,1087820.2,245509.74,1333329.94
240010,201903,390,176,214,175648.31,213572.98,389221.29
240020,201903,2245,1778,467,1774445.5,467065.97,2241511.47
240030,201903,129,111,18,110778,17964,128742
240040,201903,30,30,0,29940,0,29940
240050,201903,518,447,71,447104,70858,517962
240060,201903,64,60,4,59880,3992,63872
240070,201903,198,155,43,155688,42914,198602
240080,201903,471,315,156,314371.39,155688.46,470059.85
240090,201903,101,91,10,90818,9980,100798
240100,201903,1471,1391,80,1391213.5,79840,1471053.5
240110,201903,1047,680,367,679639.58,366266.7,1045906.28
240120,201903,137,116,21,116766,20958,137724
240130,201903,288,268,20,267464,19960,287424
240140,201903,84,65,19,64870,18962,83832
240145,201903,719,640,79,638720,78842,717562
240150,201903,18,15,3,14970,2994,17964
240160,201903,42,37,5,36926,4990,41916
240165,201903,38,32,6,31936.5,5988,37924.5
240170,201903,93,69,24,68862,23952,92814
240180,201903,82,69,13,68862,12974,81836
240185,201903,45,40,5,39920,4990,44910
240190,201903,13,11,2,10978,1996,12974
240200,201903,3048,1705,1343,1703588.4,1344307.4,3047895.8
240210,201903,169,131,38,130738,37924,168662
240220,201903,1099,800,299,798400.7,299400,1097800.7
240230,201903,847,785,62,783430.77,62874,846304.77
240240,201903,73,50,23,49900,22954,72854
240250,201903,89,79,10,78842,9980,88822
240260,201903,1800,1343,457,1342310,457084,1799394
240270,201903,192,169,23,168662,22954,191616
240280,201903,40,30,10,29940,9980,39920
240290,201903,51,50,1,49900,998,50898
240300,201903,176,101,75,100798,76846,177644
240310,201903,2173,1215,958,1213570.27,957082.74,2170653.01
240320,201903,203,192,11,191616,10978,202594
240325,201903,4314,2643,1671,2641710.27,1668658.07,4310368.34
240330,201903,67,63,4,62874,3992,66866
240340,201903,60,38,22,37924,21956,59880
240350,201903,90,80,10,79840,9980,89820
240360,201903,466,320,146,321356,145708,467064
240370,201903,45,42,3,41916,2994,44910
240375,201903,72,41,31,40918,30938,71856
240380,201903,227,185,42,186626,41916.8,228542.8
240390,201903,14,12,2,11976,1996,13972
240400,201903,82,78,4,77844,3992,81836
240410,201903,10,6,4,6986,3992,10978
240420,201903,929,704,225,703590.2,224550,928140.2
240430,201903,264,248,16,247504,15968,263472
240440,201903,88,49,39,48902,38922,87824
240450,201903,209,141,68,140718.4,67864,208582.4
240460,201903,61,48,13,47904,12974,60878
240470,201903,238,206,32,205588,31936,237524
240480,201903,14,13,1,12974,998,13972
240485,201903,81,69,12,68862,11976,80838
240490,201903,47,47,0,46906,0,46906
240500,201903,84,67,17,66866,16966,83832
240510,201903,50,36,14,35928,14970,50898
240520,201903,118,113,5,112774,4990,117764
240530,201903,55,49,6,48902,5988,54890
240540,201903,79,69,10,68862,9980,78842
240550,201903,14,13,1,12974,998,13972
240560,201903,375,277,98,276446,98802,375248
240570,201903,458,285,173,284430,172654,457084
240580,201903,1252,1011,241,1009977.4,241516.99,1251494.39
240590,201903,28,26,2,25948,1996,27944
240600,201903,109,106,3,105788,2994,108782
240610,201903,513,433,80,433132.4,80838,513970.4
240615,201903,19,18,1,17964,998,18962
240620,201903,92,88,4,87824,3992,91816
240630,201903,36,34,2,33932,1996,35928
240640,201903,27,22,5,21956,4990,26946
240650,201903,235,197,38,196606,37924,234530
240660,201903,103,89,14,88822,13972,102794
240670,201903,298,177,121,176646.7,120758,297404.7
240680,201903,50,39,11,38922,10978,49900
240690,201903,47,45,2,44910,1996,46906
240700,201903,190,156,34,155688,33932,189620
240710,201903,1931,1227,704,1226543.3,704588,1931131.3
240720,201903,1076,796,280,795406,280438,1075844
240725,201903,62,58,4,57884,3992,61876
240730,201903,138,120,18,119760,18962,138722
240740,201903,234,199,35,198602,34930.74,233532.74
240750,201903,43,27,16,26946,15968,42914
240760,201903,41,37,4,36926,3992,40918
240770,201903,146,113,33,112774,32934,145708
240780,201903,681,563,118,561874,117764,679638
240790,201903,37,36,1,35928,998,36926
240800,201903,9100,6207,2893,6202579.8,2892207.68,9094787.48
240810,201903,20196,11177,9019,11180618.08,9015962.45,20196580.53
240820,201903,218,139,79,138722,79840,218562
240830,201903,1633,1345,288,1343308.7,287424,1630732.7
240840,201903,83,73,10,72854,9980,82834
240850,201903,84,74,10,73852,9980,83832
240860,201903,111,108,3,107784,2994,110778
240870,201903,59,51,8,50898,7984,58882
240880,201903,29,26,3,25948,2994,28942
240890,201903,1165,678,487,676646.26,487024.99,1163671.25
240895,201903,50,36,14,35928,13972,49900
240910,201903,160,145,15,144710,14970,159680
240920,201903,15,12,3,11976,2994,14970
240930,201903,404,363,41,364270,40918,405188
240933,201903,35,26,9,25948,8982,34930
240940,201903,2435,2150,285,2152687.28,284430,2437117.28
240950,201903,51,48,3,47904,2994,50898
240960,201903,32,26,6,25948,5988,31936
240970,201903,118,86,32,85828,31936,117764
240980,201903,195,155,40,154690,39920,194610
240990,201903,124,83,41,82834,40918,123752
241000,201903,67,62,5,61876,4990,66866
241010,201903,60,49,11,48902,10978,59880
241020,201903,112,104,8,103792,7984,111776
241025,201903,9,3,6,2994,5988,8982
241030,201903,119,97,22,96806,21956,118762
241040,201903,35,30,5,29940,4990,34930
241050,201903,88,78,10,77844,9980,87824
241060,201903,29,24,5,23952,4990,28942
241070,201903,17,17,0,16966,0,16966
241080,201903,61,55,6,54890,5988,60878
241090,201903,50,41,9,40918,8982,49900
241100,201903,71,62,9,61876,8982,70858
241105,201903,6,2,4,1996,3992,5988
241110,201903,48,45,3,44910,2994,47904
241120,201903,1440,1107,333,1105085.4,332334,1437419.4
241140,201903,221,184,37,183632.4,36926,220558.4
241142,201903,43,39,4,38922,3992,42914
241150,201903,1197,1054,143,1053888,143712,1197600
241160,201903,22,22,0,21956,998,22954
241170,201903,44,39,5,38922,4990,43912
241180,201903,45,39,6,38922,5988,44910
241190,201903,38,37,1,36926,998,37924
241200,201903,3847,2070,1777,2067859.83,1775444.49,3843304.32
241210,201903,68,59,9,58882,8982,67864
241220,201903,1397,944,453,943110.71,457084.97,1400195.68
241230,201903,241,201,40,200598,39920,240518
241240,201903,55,42,13,41916,12974,54890
241250,201903,1127,1034,93,1034926.4,92814,1127740.4
241255,201903,50,41,9,40918,8982,49900
241260,201903,639,503,136,501994,136726,638720
241270,201903,51,38,13,37924,12974,50898
241280,201903,100,87,13,86826,12974,99800
241290,201903,110,84,26,83832,25948,109780
241300,201903,77,57,20,56886,19960,76846
241310,201903,51,38,13,37924.7,12974,50898.7
241320,201903,28,14,14,13972,13972,27944
241330,201903,63,58,5,57884,4990,62874
241335,201903,64,57,7,56886,6986,63872
241340,201903,187,140,47,139720,46906,186626
241350,201903,63,58,5,57884,4990,62874
241355,201903,44,39,5,38922,4990,43912
241360,201903,50,49,1,48902,998,49900
241370,201903,49,40,9,39920,8982,48902
241380,201903,40,36,4,35928,3992,39920
241390,201903,77,62,15,61876,14970,76846
241400,201903,205,165,40,164670,39920,204590
241410,201903,185,167,18,166666,17964,184630
241415,201903,98,79,19,78842,19960,98802
241420,201903,98,74,24,73852,23952.64,97804.64
241430,201903,30,27,3,26946,2994,29940
241440,201903,509,416,93,416166.97,92814,508980.97
241445,201903,37,35,2,34930,1996,36926
241450,201903,284,233,51,232534,50898,283432
241460,201903,141,129,12,128742.5,11976,140718.5
241470,201903,41,34,7,33932,6986,40918
241475,201903,60,57,3,56886,2994,59880
241480,201903,97,71,26,70858,25948,96806
241490,201903,8,7,1,6986,998,7984
241500,201903,47,34,13,33932,12974,46906
250010,201903,104,88,16,87824,15968,103792
250020,201903,34,30,4,29940,3992,33932
250030,201903,819,619,200,618760,201596.6,820356.6
250040,201903,345,286,59,285428,58882,344310
250050,201903,233,193,40,192614.99,39920,232534.99
250053,201903,59,45,14,44910,13972,58882
250057,201903,0,0,0,0,0,0
250060,201903,473,366,107,365268,107784,473052
250070,201903,708,579,129,577842.75,128742,706584.75
250073,201903,8,8,0,7984,0,7984
250077,201903,195,147,48,146706,47904,194610
250080,201903,422,331,91,330338.72,90818,421156.72
250090,201903,199,132,67,131736,66866,198602
250100,201903,511,425,86,424150,85828.2,509978.2
250110,201903,564,427,137,428142,137724,565866
250115,201903,25,8,17,7984,16966,24950
250120,201903,113,84,29,83832,28942,112774
250130,201903,571,464,107,465068,106786.6,571854.6
250135,201903,15,9,6,8982,5988,14970
250140,201903,82,75,7,74850,6986,81836
250150,201903,572,416,156,415168,155688,570856
250153,201903,8,7,1,6986,998,7984
250157,201903,28,23,5,22954,4990,27944
250160,201903,215,171,44,170658,44910,215568
250170,201903,61,42,19,41916,19960,61876
250180,201903,4082,2792,1290,2789413.06,1288422.15,4077835.21
250190,201903,856,570,286,570856,285428.5,856284.5
250200,201903,52,44,8,43912,7984,51896
250205,201903,23,20,3,19960,2994,22954
250210,201903,86,76,10,75848,10978,86826
250215,201903,63,55,8,54890,7984,62874
250220,201903,26,20,6,20958,5988,26946
250230,201903,79,72,7,71856.99,6986,78842.99
250240,201903,240,198,42,197604,41916,239520
250250,201903,401,344,57,344310,57884,402194
250260,201903,35,31,4,30938,3992,34930
250270,201903,62,48,14,47904,13972,61876
250280,201903,382,317,65,317364,64870,382234
250290,201903,92,85,7,84830,6986,91816
250300,201903,554,381,173,380238,173653.97,553891.97
250310,201903,46,42,4,41916,3992,45908
250320,201903,1977,1357,620,1355287.68,619759.38,1975047.06
250330,201903,93,82,11,81836,10978,92814
250340,201903,25,22,3,21956,2994,24950
250350,201903,143,95,48,94810,47904,142714
250355,201903,35,27,8,26946,7984,34930
250360,201903,200,164,36,163672,35928,199600
250370,201903,2411,1626,785,1622748,784428,2407176
250375,201903,8,3,5,2994,4990,7984
250380,201903,56,41,15,40918,14970,55888
250390,201903,42,34,8,33932,7984,41916
250400,201903,16209,8264,7945,8263448.85,7955063.72,16218512.57
250403,201903,373,304,69,304390,68862,373252
250407,201903,59,50,9,49900,8982,58882
250410,201903,30,26,4,25948,3992,29940
250415,201903,42,28,14,27944,13972,41916
250420,201903,47,39,8,38922,7984,46906
250430,201903,1493,1270,223,1268707.5,223552,1492259.5
250435,201903,16,12,4,11976,3992,15968
250440,201903,685,585,100,583830.6,99800,683630.6
250450,201903,85,70,15,69860,14970,84830
250460,201903,432,296,136,296406,135728,432134
250470,201903,88,66,22,65868,21956,87824
250480,201903,329,265,64,264470,64870,329340
250485,201903,1,1,0,998,0,998
250490,201903,226,189,37,188622,36926,225548
250500,201903,83,63,20,62874,19960,82834
250510,201903,727,576,151,574848,150698,725546
250520,201903,174,121,53,120758,52894,173652
250523,201903,114,96,18,95808,18962,114770
250527,201903,99,79,20,78842,19960,98802
250530,201903,8,5,3,4990,2994,7984
250535,201903,26,22,4,21956,3992,25948
250540,201903,128,99,29,99800,28942,128742
250550,201903,72,69,3,68862,2994,71856
250560,201903,40,30,10,29940,9980,39920
250570,201903,157,127,30,126746,29940,156686
250580,201903,118,94,24,93876,23952,117828
250590,201903,22,15,7,14970,6986,21956
250600,201903,1268,854,414,854289.44,413172,1267461.44
250610,201903,154,133,21,133732,20958,154690
250620,201903,23,19,4,18962,3992,22954
250625,201903,67,49,18,48902,17964,66866
250630,201903,3034,1965,1069,1964081.27,1067867.92,3031949.19
250640,201903,206,169,37,168662,36926,205588
250650,201903,28,20,8,19960,7984,27944
250660,201903,44,33,11,32934,10978,43912
250670,201903,63,42,21,41916,20958,62874
250680,201903,392,323,69,323352,68862,392214
250690,201903,1890,1317,573,1314370.15,573850.8,1888220.95
250700,201903,929,814,115,812372.5,114770,927142.5
250710,201903,440,343,97,343312,96806,440118
250720,201903,114,88,26,87824,25948,113772
250730,201903,378,323,55,323352,54890,378242
250740,201903,53,49,4,48902,3992,52894
250750,201903,21084,12806,8278,12801082.52,8280417.1,21081499.62
250760,201903,77,59,18,58882,17964,76846
250770,201903,349,232,117,231536.44,117764,349300.44
250780,201903,56,43,13,42914,12974,55888
250790,201903,469,305,164,304390,163672,468062
250800,201903,151,139,12,138722,11976,150698
250810,201903,81,62,19,61876,18962,80838
250820,201903,158,130,28,129740,27944,157684
250830,201903,423,294,129,293412.4,128742,422154.4
250840,201903,51,49,2,48902,1996,50898
250850,201903,55,44,11,43912,10978,54890
250855,201903,13,11,2,10978,1996,12974
250860,201903,200,141,59,140718,58882,199600
250870,201903,34,31,3,30938,2994,33932
250880,201903,82,61,21,60878,20958,81836
250890,201903,2633,1968,665,1966060,665666,2631726
250900,201903,13,11,2,10978,1996,12974
250905,201903,122,96,26,95808,25948,121756
250910,201903,1162,833,329,831334.99,328342,1159676.99
250915,201903,110,77,33,76846,32934,109780
250920,201903,140,106,34,105788,34930,140718
250930,201903,166,105,61,104790,61876,166666
250933,201903,2,1,1,998,998,1996
250937,201903,9,8,1,7984,998,8982
250939,201903,31,23,8,22954,7984,30938
250940,201903,110,83,27,82834,26946,109780
250950,201903,71,48,23,47904,22954,70858
250960,201903,90,49,41,48902,40918,89820
250970,201903,1228,869,359,868260,358282,1226542
250980,201903,90,63,27,62874,26946,89820
250990,201903,170,132,38,131736,37924,169660
251000,201903,75,66,9,65868,8982,74850
251010,201903,102,81,21,80838.99,20958,101796.99
251020,201903,80,70,10,69860,9980,79840
251030,201903,43,33,10,32934,9980,42914
251040,201903,53,39,14,38922,13972,52894
251050,201903,22,20,2,20958,1996,22954
251060,201903,49,38,11,38922,10978,49900
251065,201903,4,4,0,3992,0,3992
251070,201903,23,19,4,18962.98,3992,22954.98
251080,201903,4847,2342,2505,2338336.26,2500993.03,4839329.29
251090,201903,197,165,32,164670,31936,196606
251100,201903,16,16,0,15968,0,15968
251110,201903,44,35,9,34930,8982,43912
251120,201903,1811,1101,710,1100795.2,713570,1814365.2
251130,201903,390,316,74,315368,73852,389220
251140,201903,529,348,181,349301.2,181636,530937.2
251150,201903,309,268,41,267464.98,40918,308382.98
251160,201903,99,83,16,82834.99,15968,98802.99
251170,201903,100,80,20,79840,19960,99800
251180,201903,291,184,107,183632.99,106786.99,290419.98
251190,201903,188,128,60,127744,59880,187624
251200,201903,258,210,48,209580,47904,257484
251203,201903,37,35,2,34930,1996,36926
251207,201903,95,78,17,78842,16966,95808
251210,201903,1462,1062,400,1059876,399200,1459076
251220,201903,48,38,10,37924,9980,47904
251230,201903,584,495,89,494010,89820,583830
251240,201903,99,71,28,70858,27944,98802
251250,201903,1361,967,394,967062.9,393212.7,1360275.6
251260,201903,12,6,6,5988,5988,11976
251270,201903,330,248,82,248502,82834.7,331336.7
251272,201903,67,60,7,59880,6986,66866
251274,201903,27,21,6,20958,5988,26946
251275,201903,30,18,12,17964,11976,29940
251276,201903,11,9,2,8982,1996,10978
251278,201903,9,7,2,6986,1996,8982
251280,201903,103,98,5,97804,4990,102794
251290,201903,717,541,176,539918,176646,716564
251300,201903,16,13,3,12974,2994,15968
251310,201903,374,269,105,269460.99,104790,374250.99
251315,201903,21,20,1,19960,998,20958
251320,201903,61,49,12,48902,11976,60878
251330,201903,82,73,9,72854,8982,81836
251335,201903,12,7,5,6986,4990,11976
251340,201903,717,423,294,422154,295408,717562
251350,201903,36,35,1,34930,998,35928
251360,201903,75,66,9,65868,8982,74850
251365,201903,14,14,0,13972,0,13972
251370,201903,5401,3683,1718,3682623.14,1718556.6,5401179.74
251380,201903,47,37,10,36926,9980,46906
251385,201903,3,3,0,2994,0,2994
251390,201903,732,570,162,568860.7,162674.4,731535.1
251392,201903,11,5,6,4990,5988,10978
251394,201903,9,9,0,8982,0,8982
251396,201903,15,10,5,9980,4990,14970
251398,201903,18,15,3,14970,2994,17964
251400,201903,43,36,7,35928,6986,42914
251410,201903,37,31,6,30938,5988,36926
251420,201903,100,74,26,73852,25948,99800
251430,201903,42,39,3,38922,2994,41916
251440,201903,34,21,13,20958,12974,33932
251445,201903,57,52,5,51896,4990,56886
251450,201903,412,360,52,359280.2,51896,411176.2
251455,201903,2,1,1,998,998,1996
251460,201903,16,14,2,13972,1996,15968
251465,201903,4,2,2,1996,1996,3992
251470,201903,47,37,10,36926,9980,46906
251480,201903,26,23,3,22954,2994,25948
251490,201903,119,83,36,82834,35928.4,118762.4
251500,201903,126,104,22,103792,21956,125748
251510,201903,38,29,9,28942,8982,37924
251520,201903,27,27,0,26946,0,26946
251530,201903,4498,3175,1323,3171644.8,1324346,4495990.8
251540,201903,74,64,10,63872,9980,73852
251550,201903,406,315,91,314370,92814.9,407184.9
251560,201903,22,15,7,14970,6986,21956
251570,201903,19,19,0,18962,0,18962
251580,201903,124,101,23,100798,22954,123752
251590,201903,119,87,32,87015,31936,118951
251593,201903,26,17,9,16966,8982,25948
251597,201903,59,49,10,48902,9980,58882
251600,201903,1088,775,313,773457.71,314371.36,1087829.07
251610,201903,225,172,53,171656,52894,224550
251615,201903,4,4,0,3992,0,3992
251620,201903,4272,2837,1435,2833324.24,1435126.2,4268450.44
251630,201903,445,326,119,325348,118762.98,444110.98
251640,201903,146,104,42,103792,42914,146706
251650,201903,267,194,73,193612.7,72854,266466.7
251660,201903,222,199,23,198602,22954,221556
251670,201903,364,285,79,284430,78842,363272
251675,201903,4,4,0,3992,0,3992
251680,201903,93,83,10,83832,9980,93812
251690,201903,344,286,58,285428,58882,344310
251700,201903,284,243,41,242514,40918,283432
251710,201903,23,15,8,14970,7984,22954
251720,201903,30,21,9,20958,8982.4,29940.4
251740,201903,10,8,2,7984,1996,9980
260005,201903,3168,1800,1368,1798399.91,1368260.88,3166660.79
260010,201903,1564,1136,428,1136722.14,431137.04,1567859.18
260020,201903,417,367,50,366266,49900,416166
260030,201903,580,421,159,420158,159680,579838
260040,201903,844,527,317,525946,317364,843310
260050,201903,1149,834,315,834328,315368.8,1149696.8
260060,201903,402,367,35,366266,34930,401196
260070,201903,1415,893,522,895209.85,523950.69,1419160.54
260080,201903,720,569,151,567862,150698,718560
260090,201903,539,342,197,342315.96,198602,540917.96
260100,201903,230,162,68,161676,67864,229540
260105,201903,224,125,99,124750,98802,223552
260110,201903,2793,2068,725,2066858.98,725546.4,2792405.38
260120,201903,2895,1475,1420,1472051.62,1430135.3,2902186.92
260130,201903,160,113,47,112774,46906,159680
260140,201903,2148,1416,732,1416172.48,734528.98,2150701.46
260150,201903,222,145,77,144710,76846,221556
260160,201903,312,261,51,260478,51896,312374
260170,201903,3373,2073,1300,2070851.28,1298398.4,3369249.68
260180,201903,156,131,25,130738,24950,155688
260190,201903,2284,1611,673,1611770,673650,2285420
260200,201903,934,763,171,761474.63,170658.4,932133.03
260210,201903,1437,1023,414,1020954,413172.98,1434126.98
260220,201903,729,660,69,658680,68862,727542
260230,201903,1196,901,295,899198,296406,1195604
260240,201903,227,172,55,171656,54890,226546
260250,201903,88,66,22,66866,21956,88822
260260,201903,1002,720,282,718560,282434,1000994
260270,201903,425,344,81,344310,80838,425148
260280,201903,1360,935,425,934128,427144.4,1361272.4
260290,201903,6421,3494,2927,3492008.28,2933128.47,6425136.75
260300,201903,903,795,108,793410.6,108782.4,902193.0
260310,201903,522,417,105,416166,104790,520956
260320,201903,879,662,217,660676,218562,879238
260330,201903,42,32,10,31936,9980,41916
260340,201903,70,50,20,50898,20958,71856
260345,201903,5605,3137,2468,3136718.27,2467059.9,5603778.17
260350,201903,486,353,133,353292.4,132734,486026.4
260360,201903,275,144,131,143712,130738,274450
260370,201903,675,448,227,447104.5,226547.09,673651.59
260380,201903,606,441,165,440118,168662.66,608780.66
260390,201903,295,252,43,251496,42914,294410
260392,201903,103,89,14,88822,13972,102794
260400,201903,4057,2365,1692,2363266.89,1693607.38,4056874.27
260410,201903,14614,7766,6848,7761449.75,6866241.28,14627691.03
260415,201903,126,114,12,113772,11976,125748
260420,201903,1791,1086,705,1083829.81,704588,1788417.81
260430,201903,190,173,17,172655.25,16966,189621.25
260440,201903,220,158,62,157684.98,61876,219560.98
260450,201903,463,336,127,335329.2,126746,462075.2
260460,201903,826,441,385,442115.2,385228,827343.2
260470,201903,359,223,136,223552,137724.8,361276.8
260480,201903,217,138,79,137724,78842,216566
260490,201903,214,175,39,175648,38922,214570
260500,201903,1124,760,364,763470,367264,1130734
260510,201903,768,615,153,614768,152694,767462
260515,201903,245,222,23,221556,23952,245508
260520,201903,3282,1979,1303,1979035.93,1305384.78,3284420.71
260530,201903,803,655,148,653690,147704,801394
260540,201903,565,433,132,432134,131736,563870
260545,201903,12,10,2,9980,2994,12974
260550,201903,343,214,129,213572,128742,342314
260560,201903,526,396,130,396206.4,129740,525946.4
260570,201903,995,816,179,814368.4,178642,993010.4
260580,201903,256,228,28,228542,27944,256486
260590,201903,630,366,264,367264,265468,632732
260600,201903,8067,4236,3831,4234516.83,3837310,8071826.83
260610,201903,486,332,154,331336,155688,487024
260620,201903,3683,1944,1739,1945104.66,1743507.11,3688611.77
260630,201903,84,80,4,79840,3992,83832
260640,201903,3669,2012,1657,2011969.9,1656680.98,3668650.88
260650,201903,321,234,87,233532,88822,322354
260660,201903,531,358,173,358282,172654,530936
260670,201903,102,75,27,74850,26946,101796
260680,201903,3660,2073,1587,2071851.64,1585823.36,3657675.00
260690,201903,122,93,29,92814,28942,121756
260700,201903,331,209,122,208582,122754,331336
260710,201903,36,33,3,32934,2994,35928
260720,201903,2297,1383,914,1385225.6,917162,2302387.6
260730,201903,655,501,154,500996,153692,654688
260740,201903,60,56,4,55888,3992,59880
260750,201903,629,445,184,444110,184630,628740
260760,201903,627,338,289,337324,288422,625746
260765,201903,980,518,462,517962.99,461076,979038.99
260770,201903,222,167,55,166666,54890,221556
260775,201903,806,483,323,483033.3,323352.98,806386.28
260780,201903,271,177,94,178642,93812,272454
260790,201903,12149,6723,5426,6716551.28,5435113.91,12151665.19
260795,201903,163,112,51,112774,51896,164670
260800,201903,292,245,47,245508,46906,292414
260805,201903,174,113,61,112774,60878,173652
260810,201903,741,649,92,648700,91816,740516
260820,201903,315,208,107,208582.74,106786,315368.74
260825,201903,200,139,61,138722,61876,200598
260830,201903,270,169,101,170658,100798,271456
260840,201903,234,172,62,171656,61876,233532
260845,201903,187,126,61,125748,60878,186626
260850,201903,483,359,124,358282,124750,483032
260860,201903,252,189,63,188622,63872,252494
260870,201903,369,275,94,275448.54,94810,370258.54
260875,201903,731,523,208,524948,207584,732532
260880,201903,1592,1003,589,1003988.2,591814,1595802.2
260890,201903,2402,1700,702,1696601,700596.8,2397197.8
260900,201903,1013,706,307,705586,310378,1015964
260910,201903,271,212,59,212574,58882,271456
260915,201903,309,214,95,214570,94810,309380
260920,201903,178,99,79,98802,78842,177644
260930,201903,396,343,53,343314.91,52894.97,396209.88
260940,201903,2838,1563,1275,1563867.6,1276442.4,2840310.0
260950,201903,2016,1179,837,1178639.66,838320,2016959.66
260960,201903,13901,7245,6656,7244494.66,6660662.87,13905157.53
260970,201903,434,374,60,374250,59880,434130
260980,201903,195,172,23,171656,22954,194610
260990,201903,2599,2130,469,2126739.34,469060,2595799.34
261000,201903,4354,2584,1770,2578690.86,1774444.6,4353135.46
261010,201903,177,133,44,133732,43912,177644
261020,201903,612,461,151,461076.7,150698,611774.7
261030,201903,226,167,59,167664,58882,226546
261040,201903,369,326,43,325348,42914,368262
261050,201903,493,432,61,432134,60878,493012
261060,201903,1352,896,456,895206.5,457084,1352290.5
261070,201903,8806,4503,4303,4503003.57,4307420.35,8810423.92
261080,201903,384,297,87,296406,88822,385228
261090,201903,2259,1737,522,1734528.31,526945.45,2261473.76
261100,201903,1099,764,335,762473.3,336326,1098799.3
261110,201903,8403,5178,3225,5175630.79,3226537.66,8402168.45
261120,201903,268,226,42,225548,41916,267464
261130,201903,566,339,227,339320.6,227544.62,566865.22
261140,201903,187,122,65,122754,64870,187624
261150,201903,678,414,264,416166.18,266466,682632.18
261153,201903,73,69,4,68862,3992,72854
261160,201903,77193,38966,38227,38958922.16,38270346.23,77229268.39
261170,201903,457,344,113,344310,112774,457084
261180,201903,1795,1117,678,1115764,676644,1792408
261190,201903,612,432,180,431138.52,180638.98,611777.50
261200,201903,219,190,29,189620,29940,219560
261210,201903,33,29,4,28942,3992,32934
261220,201903,2681,1887,794,1885224.18,792413.37,2677637.55
261230,201903,337,251,86,251496,85828,337324
261240,201903,457,396,61,396206,60878,457084
261245,201903,234,195,39,194610,38922,233532
261247,201903,167,131,36,130738,36926,167664
261250,201903,2918,1495,1423,1493008.9,1422150,2915158.9
261255,201903,255,231,24,230538,24950,255488
261260,201903,866,750,116,749498.76,115768,865266.76
261270,201903,179,137,42,136726,42914,179640
261280,201903,174,146,28,145708,27944,173652
261290,201903,128,91,37,91816,36926,128742
261300,201903,1266,912,354,910176,353292,1263468
261310,201903,778,523,255,521954.8,255488,777442.8
261320,201903,561,387,174,386226,174650,560876
261330,201903,982,761,221,761474,222554,984028
261340,201903,291,167,124,166666,125748,292414
261350,201903,825,589,236,587822.4,237524,825346.4
261360,201903,1273,836,437,836324,437124,1273448
261370,201903,4893,3005,1888,3005979.36,1888219.49,4894198.85
261380,201903,561,419,142,418162.2,141716.4,559878.6
261390,201903,3525,2368,1157,2365260.62,1156684.02,3521944.64
261400,201903,280,256,24,255488,23952,279440
261410,201903,1107,750,357,748500,356286,1104786
261420,201903,877,557,320,559880.36,320358.98,880239.34
261430,201903,330,296,34,296406,33932,330338
261440,201903,126,116,10,116766,9980,126746
261450,201903,2544,2093,451,2090811.3,454091.36,2544902.66
261460,201903,739,595,144,594808.74,145708,740516.74
261470,201903,255,196,59,196606,59880,256486
261480,201903,390,310,80,310378.6,80838.99,391217.59
261485,201903,337,212,125,211576,125748,337324
261500,201903,615,417,198,417164,199600,616764
261510,201903,50,34,16,33932,15968,49900
261520,201903,108,96,12,95808,11976,107784
261530,201903,4114,2612,1502,2609771.19,1502989.84,4112761.03
261540,201903,1169,716,453,716564,454090,1170654
261550,201903,277,137,140,136726.4,139720,276446.4
261560,201903,821,545,276,543910.7,275450.63,819361.33
261570,201903,390,307,83,306386,82834,389220
261580,201903,382,299,83,298402,83832,382234
261590,201903,201,165,36,164670,35928,200598
261600,201903,298,239,59,238522,58882,297404
261610,201903,105,90,15,89820,14970,104790
261618,201903,66,52,14,51896,13972,65868
261620,201903,202,126,76,125748,75848,201596
261630,201903,575,446,129,445108,129740,574848
261640,201903,6367,3401,2966,3399192.34,2972044.9,6371237.24
261650,201903,497,319,178,319360,177644,497004
270010,201903,535,475,60,474050.4,59880,533930.4
270020,201903,299,236,63,235528.99,62874,298402.99
270030,201903,9219,5960,3259,5959085.76,3265492.46,9224578.22
270040,201903,2033,1273,760,1274446,759478,2033924
270050,201903,169,125,44,124750,43912,168662
270060,201903,115,65,50,64870,49900,114770
270070,201903,892,652,240,650696,240518.98,891214.98
270080,201903,37,31,6,30938,5988,36926
270090,201903,20,16,4,15968,3992,19960
270100,201903,1221,819,402,819358.98,404190,1223548.98
270110,201903,139,105,34,104790,33932,138722
270120,201903,225,186,39,186626,39920,226546
270130,201903,251,171,80,171656,79840,251496
270135,201903,102,62,40,61876,39920,101796
270140,201903,1351,834,517,835329.91,515967.38,1351297.29
270150,201903,259,205,54,204590,53892,258482
270160,201903,528,401,127,400198,129740,529938
270170,201903,779,507,272,510976,272454,783430
270180,201903,73,56,17,56886,16966,73852
270190,201903,97,86,11,85828,10978,96806
270200,201903,108,97,11,96806,10978,107784
270210,201903,476,253,223,252494,224550,477044
270220,201903,180,142,38,141716,37924,179640
270230,201903,2108,1291,817,1290416.14,818361.94,2108778.08
270235,201903,726,556,170,554893.78,170662.88,725556.66
270240,201903,3121,2456,665,2453086.53,664670.54,3117757.07
270250,201903,166,121,45,120758,48902,169660
270255,201903,220,190,30,192614,29940,222554
270260,201903,356,285,71,284430,70858,355288
270270,201903,103,43,60,42914.98,59880,102794.98
270280,201903,257,147,110,146706,110778,257484
270290,201903,1197,916,281,915166,281436.98,1196602.98
270300,201903,292,194,98,193612,98802,292414
270310,201903,903,728,175,729542.88,174651.96,904194.84
270320,201903,892,765,127,763471.61,127744,891215.61
270330,201903,278,235,43,234530,42914,277444
270340,201903,60,48,12,47904,11976,59880
270350,201903,92,47,45,46906,44910,91816
270360,201903,62,36,26,35928,25948,61876
270370,201903,57,45,12,44910,11976,56886
270375,201903,75,48,27,47904,26946,74850
270380,201903,1006,598,408,598134.66,410178,1008312.66
270390,201903,191,111,80,110778,79840,190618
270400,201903,703,518,185,516967.41,186626,703593.41
270410,201903,694,504,190,502992,190618,693610
270420,201903,417,279,138,278442,138725.88,417167.88
270430,201903,33186,23863,9323,23873356.5,9339297.3,33212653.8
270440,201903,491,387,104,386226,104790,491016
270450,201903,796,431,365,430138,365268.42,795406.42
270460,201903,192,151,41,150698,42914,193612
270470,201903,1437,975,462,975046.79,468062,1443108.79
270480,201903,538,441,97,441116.8,96806,537922.8
270490,201903,24,19,5,18962,4990,23952
270500,201903,510,422,88,421156,87824,508980
270510,201903,764,473,291,472054,291416,763470
270520,201903,339,211,128,210578,127744,338322
270530,201903,67,59,8,58882,7984,66866
270540,201903,120,92,28,91816,27944,119760
270550,201903,1750,1335,415,1337321.98,415168,1752489.98
270560,201903,286,138,148,137724,149700,287424
270570,201903,490,342,148,341316,148702,490018
270580,201903,92,70,22,69860,21956,91816
270590,201903,72,58,14,57884,13972,71856
270600,201903,180,147,33,146706,32934,179640
270610,201903,210,177,33,176646.98,32934,209580.98
270620,201903,30,29,1,28942,998,29940
270630,201903,3897,2975,922,2971915.09,921154,3893069.09
270640,201903,905,665,240,664668,239521.94,904189.94
270642,201903,225,191,34,190618,33932,224550
270644,201903,257,175,82,174650.98,81836,256486.98
270650,201903,305,183,122,183632,121756,305388
270660,201903,254,208,46,207584,45908,253492
270670,201903,3105,2367,738,2362470.48,737523.38,3099993.86
270680,201903,475,279,196,278442.98,196606,475048.98
270690,201903,1141,737,404,736524,403192,1139716
270700,201903,34,26,8,25948,7984,33932
270710,201903,897,685,212,684628,211576,896204
270720,201903,254,197,57,197604,58882,256486
270730,201903,1936,1143,793,1141712.8,792414.08,1934126.88
270740,201903,44,28,16,27944,15968,43912
270750,201903,674,497,177,496006.6,176646,672652.6
270760,201903,299,216,83,215568,83832,299400
270770,201903,2820,1819,1001,1817361.02,1000994.96,2818355.98
270780,201903,84,53,31,52894,30939.98,83833.98
270790,201903,257,170,87,169660,86826,256486
270800,201903,1984,1602,382,1599794.99,381236,1981030.99
270810,201903,293,236,57,235528,56886,292414
270820,201903,158,104,54,103792,53892.8,157684.8
270830,201903,846,617,229,617762.99,229541.39,847304.38
270840,201903,1437,1079,358,1077840,357284.74,1435124.74
270850,201903,1611,985,626,987023,625746,1612769
270860,201903,2514,1650,864,1647700.81,866266.67,2513967.48
270870,201903,126,68,58,67864,57884,125748
270880,201903,903,683,220,681644.72,220563.84,902208.56
270890,201903,327,240,87,240518,87824,328342
270895,201903,67,58,9,57884,8982,66866
270900,201903,100,77,23,77844,22954,100798
270910,201903,318,251,67,252494,67864,320358
270915,201903,1901,1166,735,1168685.72,736535.2,1905220.92
270920,201903,493,417,76,417164,75848,493012
270930,201903,6184,4547,1637,4544941.48,1642721.87,6187663.35
270940,201903,2381,1820,561,1819354,559878.4,2379232.4
280010,201903,41,36,5,35928,4990,40918
280020,201903,453,398,55,398202.96,54890,453092.96
280030,201903,20193,13099,7094,13104781.53,7099788.16,20204569.69
280040,201903,335,219,116,218562,118762,337324
280050,201903,388,301,87,300398,86826,387224
280060,201903,339,228,111,227545.18,110778,338323.18
280067,201903,998,709,289,708580.49,290418.75,998999.24
280070,201903,126,104,22,104790,21956,126746
280100,201903,606,478,128,479040.89,127744.6,606785.49
280110,201903,75,70,5,69860,4990,74850
280120,201903,636,512,124,510976,124750,635726
280130,201903,1585,1028,557,1026942.6,557882,1584824.6
280140,201903,479,393,86,392214,85828,478042
280150,201903,360,265,95,264470,94810,359280
280160,201903,97,85,12,84830,11976,96806
280170,201903,420,276,144,277444.49,143712,421156.49
280190,201903,28,26,2,25948,1996,27944
280200,201903,30,23,7,22954,6986,29940
280210,201903,2829,2024,805,2022951.27,805386.4,2828337.67
280220,201903,44,35,9,34930,8982,43912
280230,201903,328,272,56,271456.7,55888,327344.7
280240,201903,117,111,6,110778,5988,116766
280250,201903,17,11,6,10978,5988,16966
280260,201903,83,73,10,72854,9980,82834
280270,201903,157,122,35,121756,35928,157684
280280,201903,195,125,70,124750,69860,194610
280290,201903,3211,2333,878,2337254.64,879238.64,3216493.28
280300,201903,1604,1229,375,1228538.4,374250,1602788.4
280310,201903,103,99,4,99800.6,3992,103792.6
280320,201903,665,462,203,461076,202594,663670
280330,201903,357,258,99,257484,98802,356286
280340,201903,413,334,79,333332,79840,413172
280350,201903,3580,2784,796,2781429.34,794408.7,3575838.04
280360,201903,443,284,159,283432,158682,442114
280370,201903,100,88,12,87824,11976,99800
280380,201903,56,43,13,42914,12974,55888
280390,201903,179,154,25,154690,24950,179640
280400,201903,345,240,105,239521.36,104790,344311.36
280410,201903,285,234,51,233532.6,50898,284430.6
280420,201903,171,144,27,143712,26946,170658
280430,201903,27,17,10,16966,9980,26946
280440,201903,697,539,158,537923.46,157684,695607.46
280445,201903,118,110,8,109780,7984,117764
280450,201903,1166,1001,165,999996,164670,1164666
280460,201903,621,447,174,446106.7,174650,620756.7
280470,201903,190,177,13,176646,12974.7,189620.7
280480,201903,2422,1725,697,1725545.36,697603.62,2423148.98
280490,201903,289,268,21,268462.15,20958,289420.15
280500,201903,41,37,4,36926,3992,40918
280510,201903,141,109,32,109780,31936.4,141716.4
280520,201903,56,42,14,41916,13972,55888
280530,201903,74,48,26,48902,25948,74850
280540,201903,522,425,97,424150.7,97804,521954.7
280550,201903,730,673,57,674650.4,56886,731536.4
280560,201903,500,439,61,439120,60878,499998
280570,201903,2196,1707,489,1708578.38,488022,2196600.38
280580,201903,608,470,138,470060.19,137724.8,607784.99
280590,201903,172,111,61,110778,60878,171656
280600,201903,378,318,60,317364,59880,377244
280610,201903,131,100,31,99800,30938,130738
280620,201903,551,459,92,459080,91816,550896
280630,201903,162,134,28,134730,27944,162674
280640,201903,198,159,39,158682.96,38922,197604.96
280650,201903,75,53,22,52894,21956,74850
280660,201903,143,104,39,103792,38922,142714
280670,201903,1765,1129,636,1128742.65,635726.86,1764469.51
280680,201903,182,156,26,156686.61,25948,182634.61
280690,201903,93,81,12,80838,11976,92814
280700,201903,22,22,0,21956,0,21956
280710,201903,1455,1118,337,1115764.6,337324,1453088.6
280720,201903,115,78,37,77844,36926,114770
280730,201903,26,22,4,21956,3992,25948
280740,201903,2504,1869,635,1867258.8,638720,2505978.8
280750,201903,226,200,26,199600,25948,225548
280760,201903,696,482,214,483032,214570,697602
290010,201903,205,141,64,140718,63872,204590
290020,201903,179,164,15,163672,14970,178642
290030,201903,605,397,208,396206,207584,603790
290035,201903,131,107,24,106786,23952,130738
290040,201903,287,188,99,187624,99800,287424
290050,201903,82,64,18,63872,17964,81836
290060,201903,259,117,142,116766,141716,258482
290070,201903,5634,2818,2816,2815359.86,2814366.01,5629725.87
290080,201903,488,224,264,225549.92,263473.92,489023.84
290090,201903,390,173,217,173652,216566,390218
290100,201903,1621,1074,547,1073849.7,546904.4,1620754.1
290110,201903,802,488,314,487025.12,314370.99,801396.11
290115,201903,201,186,15,185628,14970,200598
290120,201903,766,504,262,503990,262474,766464
290130,201903,429,260,169,259480,168662,428142
290135,201903,296,224,72,223552,71856,295408
290140,201903,309,260,49,259480,48902,308382
290150,201903,132,98,34,97804,34930,132734
290160,201903,248,187,61,186626.62,60878,247504.62
290170,201903,90,66,24,65868,23952,89820
290180,201903,168,131,37,130738,36926,167664
290190,201903,438,363,75,363272,74850,438122
290195,201903,302,188,114,187624,113772,301396
290200,201903,277,227,50,226546,49900,276446
290205,201903,146,91,55,91816,54890,146706
290210,201903,1150,833,317,832332.4,316366,1148698.4
290220,201903,222,122,100,121756,99800,221556
290225,201903,291,113,178,112774,177644,290418
290230,201903,61,40,21,39920,20958,60878
290240,201903,319,125,194,124750,193612,318362
290250,201903,264,243,21,243512,20958,264470
290260,201903,301,243,58,242514.4,57884,300398.4
290265,201903,193,162,31,161676,30938,192614
290270,201903,1424,1185,239,1182630.5,239521.36,1422151.86
290280,201903,477,344,133,343312,132734,476046
290290,201903,1272,753,519,752492.94,517962.4,1270455.34
290300,201903,454,384,70,384230.4,69860,454090.4
290310,201903,308,136,172,135728,171656,307384
290320,201903,4073,2529,1544,2526936.57,1544905,4071841.57
290323,201903,187,163,24,163672,23952,187624
290327,201903,163,129,34,128742,33932,162674
290330,201903,89,49,40,48902,39920,88822
290340,201903,899,366,533,365268.96,533930,899198.96
290350,201903,609,369,240,370258,240518,610776
290360,201903,366,277,89,276446.97,88822,365268.97
290370,201903,917,383,534,382234,533930.97,916164.97
290380,201903,315,193,122,194610,121756,316366
290390,201903,2478,1555,923,1551892.5,923150,2475042.5
290395,201903,250,142,108,141716.5,107784,249500.5
290400,201903,283,209,74,209580.4,74850,284430.4
290405,201903,250,220,30,220558,29940,250498
290410,201903,600,511,89,510976.55,88822,599798.55
290420,201903,245,194,51,194610,50898,245508
290430,201903,487,308,179,307384,178642,486026
290440,201903,72,64,8,64870,7984,72854
290450,201903,231,180,51,179640,51896,231536
290460,201903,1904,1143,761,1141721.8,760478.24,1902200.04
290470,201903,1411,598,813,596813.8,811391.64,1408205.44
290475,201903,585,548,37,546904.68,36926,583830.68
290480,201903,293,164,129,163672,128742,292414
290485,201903,241,223,18,222554,17964,240518
290490,201903,1206,875,331,875246,331336,1206582
290500,201903,715,365,350,364270,349300,713570
290510,201903,226,173,53,173652,52894,226546
290515,201903,145,89,56,88822,55888,144710
290520,201903,1425,945,480,943110.54,480038.73,1423149.27
290530,201903,313,289,24,288422,23952,312374
290540,201903,96,52,44,51896,43912,95808
290550,201903,152,126,26,125748,25948,151696
290560,201903,3274,1384,1890,1384226.4,1888219.32,3272445.72
290570,201903,6068,3106,2962,3105782.31,2980035.52,6085817.83
290580,201903,1283,773,510,771454,509978,1281432
290590,201903,563,463,100,462074,99800,561874
290600,201903,1763,1220,543,1222552.02,542912,1765464.02
290610,201903,219,197,22,196606.54,21956,218562.54
290620,201903,350,312,38,311376,37924,349300
290630,201903,2034,880,1154,880236,1152690.4,2032926.4
290640,201903,152,125,27,124750,27944,152694
290650,201903,1711,819,892,817362.69,892212,1709574.69
290660,201903,279,226,53,225548,52894,278442
290670,201903,1038,533,505,532932.8,504988.63,1037921.43
290680,201903,1233,994,239,993010,239520,1232530
290682,201903,294,220,74,219561.24,73852.98,293414.22
290685,201903,236,153,83,152694,82834,235528
290687,201903,988,642,346,641876.4,346306,988182.4
290689,201903,141,78,63,77844.97,62874,140718.97
290690,201903,627,263,364,263472.98,366270.84,629743.82
290700,201903,245,120,125,119760,124750,244510
290710,201903,707,482,225,483032,226546,709578
290720,201903,1048,851,197,849298.5,196606.4,1045904.9
290730,201903,1164,673,491,674648,490018,1164666
290740,201903,15,13,2,12974,1996,14970
290750,201903,1365,636,729,636724,727544.69,1364268.69
290755,201903,70,63,7,62874,6986,69860
290760,201903,298,258,40,258482,39920,298402
290770,201903,189,178,11,177644,10978.4,188622.4
290780,201903,1035,817,218,817365.74,217564,1034929.74
290790,201903,372,264,108,263472,107784,371256
290800,201903,2562,1036,1526,1037920,1523946,2561866
290810,201903,457,319,138,319360.4,137724,457084.4
290820,201903,392,235,157,234530.97,156686,391216.97
290830,201903,411,290,121,289420,121756,411176
290840,201903,1731,1077,654,1075844.8,654688.8,1730533.6
290850,201903,785,435,350,434130,349300,783430
290860,201903,632,293,339,292414,338322.4,630736.4
290870,201903,645,459,186,458082.64,185628.84,643711.48
290880,201903,124,70,54,69860,53892,123752
290890,201903,341,243,98,243512,98802,342314
290900,201903,167,126,41,126746,40918,167664
290910,201903,386,296,90,295408,90818,386226
290920,201903,228,192,36,191616,35928,227544
290930,201903,855,649,206,647702.4,206586.96,854289.36
290940,201903,246,205,41,204590,41916,246506
290950,201903,170,100,70,99800,69860,169660
290960,201903,465,317,148,316366,147704,464070
290970,201903,252,224,28,224550,27944,252494
290980,201903,1564,1116,448,1114766.68,450099.2,1564865.88
290990,201903,402,339,63,338324.36,62876.94,401201.30
291000,201903,862,253,609,252494,608780,861274
291005,201903,2251,994,1257,994008.4,1260474.98,2254483.38
291010,201903,155,140,15,139720,14970,154690
291020,201903,100,78,22,77844,21956,99800
291030,201903,99,73,26,72854,25948,98802
291040,201903,574,301,273,301396,272454,573850
291050,201903,1383,778,605,776444.96,604788,1381232.96
291060,201903,1520,844,676,844308,674648,1518956
291070,201903,1956,1458,498,1456083.62,497005.78,1953089.40
291072,201903,7358,2762,4596,2760469.82,4597789.43,7358259.25
291075,201903,221,182,39,182634,38922,221556
291077,201903,52,35,17,34930,16966,51896
291080,201903,20024,8890,11134,8886200.2,11133696.64,20019896.84
291085,201903,297,239,58,238522,57884,296406
291090,201903,296,115,181,114770.4,180638,295408.4
291100,201903,649,191,458,191616,458082,649698
291110,201903,404,310,94,310378.96,93812,404190.96
291120,201903,2494,1216,1278,1215564.7,1276443.49,2492008.19
291125,201903,62,32,30,31936,29940,61876
291130,201903,214,190,24,189620,23952,213572
291140,201903,140,109,31,109780,30938.4,140718.4
291150,201903,378,158,220,157684,219560,377244
291160,201903,377,313,64,312374.5,63872,376246.5
291165,201903,29,25,4,24950,3992,28942
291170,201903,3059,1543,1516,1542909.67,1517959.6,3060869.27
291180,201903,1303,514,789,512975.74,787424.88,1300400.62
291185,201903,84,82,2,81836,1996,83832
291190,201903,1307,579,728,577843.24,726544.86,1304388.10
291200,201903,166,124,42,123752,41916,165668
291210,201903,2228,891,1337,889218.4,1337321.38,2226539.78
291220,201903,276,207,69,206586,68862,275448
291230,201903,1012,355,657,355288.4,655686,1010974.4
291240,201903,435,412,23,411176.4,22954,434130.4
291250,201903,445,361,84,360278,83832,444110
291260,201903,53,41,12,40918,11976,52894
291270,201903,1199,493,706,493012,705586,1198598
291280,201903,374,178,196,177644.4,195608,373252.4
291290,201903,1750,910,840,909178.4,838321.4,1747499.8
291300,201903,233,181,52,180638,51896,232534
291310,201903,237,214,23,213572,22954,236526
291320,201903,1398,1001,397,999996,396206.8,1396202.8
291330,201903,129,110,19,109780,18962,128742
291340,201903,176,98,78,97804,77844,175648
291345,201903,136,93,43,92814,42914,135728
291350,201903,1608,548,1060,550896,1058878.7,1609774.7
291360,201903,8532,4235,4297,4234519.01,4296393.86,8530912.87
291370,201903,1140,644,496,643710.4,497004.98,1140715.38
291380,201903,265,209,56,208582,55888,264470
291390,201903,3857,1717,2140,1715563.54,2135721.2,3851284.74
291400,201903,2083,1490,593,1489016,592812.21,2081828.21
291410,201903,156,138,18,137724,17964,155688
291420,201903,117,87,30,86826,29940,116766
291430,201903,161,89,72,88822,71856.11,160678.11
291440,201903,511,414,97,413172.4,96806,509978.4
291450,201903,900,570,330,568860.5,330338,899198.5
291460,201903,1825,1488,337,1489016.4,338322,1827338.4
291465,201903,2208,1050,1158,1048911.9,1156695.58,2205607.48
291470,201903,2820,1429,1391,1426142.71,1391212.4,2817355.11
291480,201903,11796,5250,6546,5250504.37,6556990.84,11807495.21
291490,201903,565,241,324,240518,323352,563870
291500,201903,375,214,161,213572,162674,376246
291510,201903,1225,479,746,479040,746504,1225544
291520,201903,958,438,520,439120,520956,960076
291530,201903,979,271,708,271456,709578,981034
291535,201903,122,104,18,103792,17964,121756
291540,201903,356,108,248,108782,247504.2,356286.2
291550,201903,1197,572,625,570857.2,626745.38,1197602.58
291560,201903,5414,2770,2644,2773536.52,2647866.65,5421403.17
291570,201903,201,103,98,102794,97804,200598
291580,201903,1252,770,482,770457.81,482034,1252491.81
291590,201903,91,37,54,36926,53892,90818
291600,201903,1362,647,715,647702,713571.96,1361273.96
291610,201903,1449,692,757,691614,756486.54,1448100.54
291620,201903,563,262,301,262474,300398,562872
291630,201903,478,158,320,157684,319360,477044
291640,201903,3887,1958,1929,1957082.2,1931143.36,3888225.56
291650,201903,416,283,133,282434.53,133732,416166.53
291660,201903,412,167,245,166666,245508,412174
291670,201903,221,142,79,141716,78842,220558
291680,201903,685,391,294,391216,293412.8,684628.8
291685,201903,598,332,266,331336.5,266466,597802.5
291690,201903,567,313,254,312374,254491.86,566865.86
291700,201903,952,750,202,748500,201596,950096
291710,201903,1684,795,889,796404.5,891214.98,1687619.48
291720,201903,402,268,134,267464,134730,402194
291730,201903,943,559,384,561874,383232,945106
291733,201903,273,186,87,185628,86826,272454
291735,201903,71,54,17,53892,16966,70858
291740,201903,352,273,79,273452,78842,352294
291750,201903,2072,1357,715,1354287.45,715566,2069853.45
291760,201903,3040,1678,1362,1679634,1363268,3042902
291770,201903,791,536,255,534934.91,254490,789424.91
291780,201903,46,28,18,27944,17964,45908
291790,201903,165,79,86,78842,85828,164670
291800,201903,10051,4137,5914,4130725.1,5904171.08,10034896.18
291810,201903,1129,824,305,823350.4,306386.6,1129737.0
291820,201903,276,198,78,197604,77844,275448
291830,201903,1100,435,665,436126.98,664668.98,1100795.96
291835,201903,587,547,40,545906,40918,586824
291840,201903,4810,2489,2321,2490011.35,2318354.98,4808366.33
291845,201903,281,96,185,95808,184630,280438
291850,201903,335,298,37,297404,36926,334330
291855,201903,259,106,153,105788,153692,259480
291860,201903,173,108,65,107784,64870,172654
291870,201903,81,31,50,30938,49900,80838
291875,201903,189,175,14,174650,14970,189620
291880,201903,485,381,104,380238,103792,484030
291890,201903,245,82,163,81836,162674.4,244510.4
291900,201903,56,31,25,30938,24950,55888
291905,201903,128,91,37,90818.4,36926,127744.4
291910,201903,172,139,33,138722,32934,171656
291915,201903,415,369,46,368262.5,45908,414170.5
291920,201903,4996,2596,2400,2593802.6,2399193.98,4992996.58
291930,201903,182,107,75,106786,74850,181636
291940,201903,350,197,153,197604,152694,350298
291950,201903,1147,934,213,933130.4,212574,1145704.4
291955,201903,1163,700,463,699598,462074,1161672
291960,201903,184,131,53,130738,52894,183632
291970,201903,764,575,189,574848,188622,763470
291980,201903,1514,1341,173,1338319.38,172654.4,1510973.78
291990,201903,130,120,10,119760,9980,129740
291992,201903,177,90,87,89820,86826,176646
291995,201903,155,106,49,105788,48902,154690
292000,201903,388,298,90,298402.4,89820,388222.4
292010,201903,289,205,84,205588,84830,290418
292020,201903,287,209,78,208582,77844,286426
292030,201903,142,112,30,112774,29940,142714
292040,201903,635,326,309,325348,308382,633730
292045,201903,100,92,8,91816,7984,99800
292050,201903,938,674,264,674648,263472.4,938120.4
292060,201903,936,776,160,775446.86,159680,935126.86
292070,201903,49,20,29,19960,28942,48902
292080,201903,134,92,42,91816,42914,134730
292090,201903,502,183,319,182634,319360,501994
292100,201903,1406,620,786,623750.6,784428.98,1408179.58
292105,201903,212,183,29,183632,28942,212574
292110,201903,2088,780,1308,778440,1307384.88,2085824.88
292120,201903,682,542,140,541914,141716,683630
292130,201903,447,262,185,261476,184630,446106
292140,201903,201,160,41,159680,40918,200598
292145,201903,166,86,80,85828.4,79840,165668.4
292150,201903,1466,1185,281,1183628,280438,1464066
292160,201903,175,144,31,143712,30938,174650
292170,201903,1206,1059,147,1060874,147704,1208578
292180,201903,216,156,60,156686,60878,217564
292190,201903,160,98,62,97804,62874,160678
292200,201903,1287,472,815,471057.36,814369.36,1285426.72
292205,201903,127,113,14,112774,13972,126746
292210,201903,372,262,110,261476.1,109780,371256.1
292220,201903,20,16,4,15968,3992,19960
292225,201903,40,35,5,34930,4990,39920
292230,201903,952,764,188,764468.75,187624,952092.75
292240,201903,621,455,166,455088.7,165668,620756.7
292250,201903,1744,1131,613,1129736,613770.4,1743506.4
292260,201903,433,257,176,256486,175648.94,432134.94
292265,201903,252,177,75,177644,74850,252494
292270,201903,734,330,404,331336,403192.6,734528.6
292273,201903,206,116,90,115768,89820,205588
292275,201903,179,92,87,91816,86826,178642
292280,201903,142,101,41,100798,40918,141716
292285,201903,68,56,12,55888,11976,67864
292290,201903,579,392,187,392214.09,186626.4,578840.49
292300,201903,1649,639,1010,637722.4,1011973.71,1649696.11
292303,201903,103,70,33,70858,32934,103792
292305,201903,113,82,31,81836,30938,112774
292310,201903,862,567,295,565867.24,294410.56,860277.80
292320,201903,672,505,167,505986,168662,674648
292330,201903,181,101,80,100798,79840,180638
292335,201903,286,224,62,223552,61876,285428
292340,201903,579,406,173,406186.4,172654,578840.4
292350,201903,271,147,124,146706,123752,270458
292360,201903,710,540,170,538920.96,169660,708580.96
292370,201903,756,581,175,580836,174650,755486
292380,201903,659,518,141,516964.54,140718,657682.54
292390,201903,494,197,297,196606,297404,494010
292400,201903,3433,2137,1296,2136720.14,1299397,3436117.14
292405,201903,270,180,90,179640,89820,269460
292410,201903,141,85,56,84830,55888,140718
292420,201903,298,255,43,254490,42914,297404
292430,201903,528,414,114,413172,113772,526944
292440,201903,592,507,85,508980.44,84830,593810.44
292450,201903,260,201,59,200598,58882,259480
292460,201903,568,421,147,420158.98,147704,567862.98
292465,201903,221,181,40,180638,39920,220558
292467,201903,110,68,42,67864,41916,109780
292470,201903,275,190,85,189620,84830,274450
292480,201903,343,233,110,232534,109780.4,342314.4
292490,201903,231,155,76,154690,75848,230538
292500,201903,1131,499,632,498002.75,632732,1130734.75
292510,201903,3384,1549,1835,1545902.44,1833327.18,3379229.62
292520,201903,1080,515,565,513970.99,565866.98,1079837.97
292525,201903,387,278,109,277444,108782,386226
292530,201903,4248,1735,2513,1735525.73,2509975.48,4245501.21
292540,201903,463,251,212,251496,212574,464070
292550,201903,1053,570,483,569872.84,483043.54,1052916.38
292560,201903,322,303,19,303392,18962,322354
292570,201903,300,231,69,230538,69860,300398
292575,201903,482,310,172,309380.4,171656,481036.4
292580,201903,972,638,334,636724,333332.4,970056.4
292590,201903,550,475,75,474050,74850,548900
292593,201903,138,110,28,110778,27944,138722
292595,201903,187,144,43,143712,42914,186626
292600,201903,1264,933,331,934128.63,330338,1264466.63
292610,201903,128,100,28,99800,27944,127744
292620,201903,537,450,87,449101.38,87824,536925.38
292630,201903,1398,802,596,800396.67,596804.27,1397200.94
292640,201903,804,559,245,558880,246506,805386
292650,201903,181,154,27,154690.4,27944,182634.4
292660,201903,2031,1460,571,1458079.15,569858.55,2027937.70
292665,201903,146,106,40,106786,39920,146706
292670,201903,407,328,79,328342.99,78842,407184.99
292680,201903,258,199,59,198602,58882,257484
292690,201903,192,146,46,145708,45908,191616
292700,201903,952,633,319,631734,318362,950096
292710,201903,107,94,13,93812,12974,106786
292720,201903,895,503,392,503990,395208,899198
292730,201903,198,93,105,92814,104790,197604
292740,201903,67837,33695,34142,33679541.61,34142621.06,67822162.67
292750,201903,386,276,110,275448.78,109780,385228.78
292760,201903,328,271,57,271456.38,56886,328342.38
292770,201903,793,340,453,340318.4,455088,795406.4
292780,201903,414,160,254,159680,253492,413172
292790,201903,739,370,369,369260,368262,737522
292800,201903,1195,728,467,726544.94,466066,1192610.94
292805,201903,407,116,291,116766,290418,407184
292810,201903,1476,842,634,842312.8,632732.98,1475045.78
292820,201903,729,600,129,601794.7,129740.98,731535.68
292830,201903,101,83,18,82834,17964,100798
292840,201903,680,561,119,559878.6,118762,678640.6
292850,201903,135,91,44,90818,43912,134730
292860,201903,2224,1311,913,1309376.4,917162,2226538.4
292870,201903,3505,2363,1142,2359275.53,1143708,3502983.53
292880,201903,1482,967,515,966065.42,513970,1480035.42
292890,201903,495,427,68,427145.94,67864,495009.94
292895,201903,135,89,46,88822,45908,134730
292900,201903,388,283,105,283432,105788,389220
292905,201903,461,235,226,234530,225548,460078
292910,201903,429,327,102,326346.3,101796,428142.3
292920,201903,537,243,294,242514,293412,535926
292925,201903,503,465,38,464070,37924.96,501994.96
292930,201903,582,360,222,360278,222554,582832
292935,201903,288,123,165,123752,164670.98,288422.98
292937,201903,247,167,80,167664,79840,247504
292940,201903,197,153,44,152694,43912,196606
292950,201903,1139,590,549,588821.3,547902,1136723.3
292960,201903,609,423,186,423152,185628,608780
292970,201903,252,181,71,180638,70858,251496
292975,201903,137,78,59,77844,58882.6,136726.6
292980,201903,272,184,88,183632.76,87824,271456.76
292990,201903,1324,987,337,986025.2,337324,1323349.2
293000,201903,107,77,30,76846,29940,106786
293010,201903,2768,1669,1099,1668656.3,1098798.99,2767455.29
293015,201903,663,533,130,532932,129740,662672
293020,201903,341,278,63,278442,62874,341316
293030,201903,612,535,77,533930.8,76846,610776.8
293040,201903,352,279,73,278442,72854,351296
293050,201903,2768,1639,1129,1637718.4,1127741.98,2765460.38
293060,201903,253,203,50,202594.58,49900,252494.58
293070,201903,3485,1803,1682,1801392.89,1680634.88,3482027.77
293075,201903,92,61,31,60878,30938,91816
293076,201903,72,48,24,47904,23952,71856
293077,201903,467,278,189,278442.4,188622,467064.4
293080,201903,458,411,47,410179.02,46906,457085.02
293090,201903,132,116,16,115768,15968,131736
293100,201903,527,368,159,367264,158682,525946
293105,201903,345,243,102,242514.4,101796,344310.4
293110,201903,172,123,49,122754,49900,172654
293120,201903,328,224,104,223552.45,104790,328342.45
293130,201903,241,163,78,165668,77844,243512
293135,201903,8005,3197,4808,3194619.26,4812410.9,8007030.16
293140,201903,188,122,66,121756.6,65868,187624.6
293150,201903,335,288,47,287424,46906,334330
293160,201903,428,246,182,245508,181636,427144
293170,201903,151,105,46,104790,45908,150698
293180,201903,480,334,146,333332.4,146706,480038.4
293190,201903,1336,932,404,931134.7,403192.4,1334327.1
293200,201903,538,478,60,477044,59880,536924
293210,201903,378,291,87,291416.68,86826,378242.68
293220,201903,2620,1087,1533,1085824,1531930.58,2617754.58
293230,201903,1741,643,1098,643710.35,1095804,1739514.35
293240,201903,225,206,19,205588,18962,224550
293245,201903,118,98,20,97804,19960,117764
293250,201903,716,265,451,264470.67,451096,715566.67
293260,201903,295,249,46,248502,45908,294410
293270,201903,1155,551,604,550896.68,603790,1154686.68
293280,201903,258,145,113,145708,112774,258482
293290,201903,3040,1996,1044,1994004.4,1042911.97,3036916.37
293300,201903,720,516,204,514969.67,203592,718561.67
293305,201903,166,139,27,138722,26946,165668
293310,201903,143,109,34,108782,33932,142714
293315,201903,164,127,37,126746,36926,163672
293317,201903,90,64,26,63872,25948,89820
293320,201903,984,567,417,567862.5,419160,987022.5
293325,201903,190,70,120,69860,119760,189620
293330,201903,13068,6173,6895,6170636.95,6893193.16,13063830.11
293340,201903,257,189,68,188622,67864,256486
293345,201903,245,195,50,194610,49900,244510
293350,201903,635,357,278,356286,277444,633730
293360,201903,1569,1119,450,1118758,449100,1567858
310010,201903,146,77,69,76846,68862.4,145708.4
310020,201903,1073,601,472,599798.4,472054.44,1071852.84
310030,201903,331,269,62,268462.2,61876,330338.2
310040,201903,46,31,15,30938,15968,46906
310050,201903,184,118,66,117764,65868,183632
310060,201903,246,172,74,171656,73852,245508
310070,201903,15,8,7,7984,6986,14970
310080,201903,44,23,21,22954,20958,43912
310090,201903,980,519,461,518961.6,461076.8,980038.4
310100,201903,310,239,71,239520,71856,311376
310110,201903,727,395,332,396206,332334.4,728540.4
310120,201903,381,209,172,208582,171656,380238
310130,201903,34,22,12,21956,11976,33932
310140,201903,23,12,11,11976,10978,22954
310150,201903,1267,873,394,871255.43,393212.8,1264468.23
310160,201903,2090,1061,1029,1060875.17,1027940.8,2088815.97
310163,201903,96,55,41,54890,40918,95808
310170,201903,2597,1138,1459,1136722.74,1462072.6,2598795.34
310180,201903,131,50,81,49900,80838,130738
310190,201903,480,335,145,335328,150698,486026
310200,201903,494,317,177,316366.4,176646,493012.4
310205,201903,52,39,13,38922,12974,51896
310210,201903,287,232,55,231536,54890,286426
310220,201903,58,35,23,34930,22954,57884
310230,201903,275,193,82,193612,82834,276446
310240,201903,112,97,15,96806,14970,111776
310250,201903,105,84,21,83832,20958,104790
310260,201903,772,417,355,416168.04,355288,771456.04
310270,201903,279,187,92,186626.84,91816,278442.84
310280,201903,360,271,89,271456,88822,360278
310285,201903,216,154,62,153692,61876,215568
310290,201903,255,146,109,145708,108782,254490
310300,201903,152,124,28,124750,27944,152694
310310,201903,10,8,2,7984,1996,9980
310320,201903,30,15,15,14970,14970,29940
310330,201903,34,26,8,25948,7984,33932
310340,201903,1759,1162,597,1160675.4,595806.4,1756481.8
310350,201903,2887,1590,1297,1590813.86,1298399.38,2889213.24
310360,201903,40,33,7,32934,6986,39920
310370,201903,125,103,22,102794,21956.4,124750.4
310375,201903,111,42,69,41916,68862.96,110778.96
310380,201903,46,26,20,25948,19960,45908
310390,201903,93,63,30,62874,31936,94810
310400,201903,2386,1587,799,1584824.8,798400,2383224.8
310410,201903,125,69,56,68862,55888,124750
310420,201903,687,366,321,366266.6,320358.2,686624.8
310430,201903,321,214,107,213572,106786,320358
310440,201903,72,43,29,42914,28942,71856
310445,201903,81,68,13,67864,12974,80838
310450,201903,846,536,310,534928,309380,844308
310460,201903,258,187,71,186626,70858,257484
310470,201903,513,333,180,332334,179640,511974
310480,201903,79,59,20,58882,19960,78842
310490,201903,528,256,272,255488,272454,527942
310500,201903,128,54,74,53892,73852,127744
310510,201903,598,405,193,404190,193612.98,597802.98
310520,201903,132,93,39,92814,38922,131736
310530,201903,97,41,56,40918,55888,96806
310540,201903,468,285,183,284431.2,182634,467065.2
310550,201903,85,56,29,55888,28942,84830
310560,201903,2981,2058,923,2055882.8,921154,2977036.8
310570,201903,110,75,35,74850,35928,110778
310590,201903,361,237,124,238522.5,123752,362274.5
310600,201903,160,91,69,90818.4,68862,159680.4
310610,201903,59,23,36,23952,35928,59880
310620,201903,47224,22793,24431,22795273.2,24433052.63,47228325.83
310630,201903,624,401,223,402194,223552.4,625746.4
310640,201903,150,122,28,121756,27944,149700
310650,201903,162,142,20,141716,19960,161676
310660,201903,89,59,30,59880,29940,89820
310665,201903,59,42,17,41916,16966,58882
310670,201903,6583,2941,3642,2940114.68,3641729.88,6581844.56
310680,201903,60,37,23,36926,22954,59880
310690,201903,588,418,170,417164.1,170658,587822.1
310700,201903,57,38,19,37924,18962,56886
310710,201903,1305,890,415,889219.38,415168.8,1304388.18
310720,201903,99,29,70,28942,69860,98802
310730,201903,1389,981,408,980036.9,409180,1389216.9
310740,201903,979,554,425,552893.2,424150.5,977043.7
310750,201903,244,145,99,144710.66,99800,244510.66
310760,201903,63,44,19,43912,18962.4,62874.4
310770,201903,92,43,49,42914,48902,91816
310780,201903,392,319,73,318362.98,72854,391216.98
310790,201903,98,81,17,80838,16966,97804
310800,201903,457,225,232,225548.5,231536,457084.5
310810,201903,169,120,49,119760.18,48902,168662.18
310820,201903,352,279,73,279440,72854,352294
310825,201903,206,169,37,168662,36926,205588
310830,201903,463,226,237,226546.4,236526,463072.4
310840,201903,372,214,158,213572,157684,371256
310850,201903,109,86,23,85828,22954,108782
310855,201903,398,317,81,316366,80838,397204
310860,201903,1615,1210,405,1210577.48,406186.7,1616764.18
310870,201903,54,43,11,42914,10978,53892
310880,201903,83,65,18,64870,17964,82834
310890,201903,303,181,122,180638,122754,303392
310900,201903,638,298,340,297404.6,340318.96,637723.56
310910,201903,245,169,76,168662.6,75848,244510.6
310920,201903,474,283,191,282434.9,190618,473052.9
310925,201903,37,29,8,28942,7984.4,36926.4
310930,201903,1079,663,416,662687.84,417175.88,1079863.72
310940,201903,671,347,324,347304,324350,671654
310945,201903,120,71,49,70858,48902,119760
310950,201903,250,199,51,198602,50898,249500
310960,201903,83,28,55,27944,54890.99,82834.99
310970,201903,165,105,60,104790,60878,165668
310980,201903,48,27,21,26946,20958,47904
310990,201903,146,80,66,79840,65868,145708
311000,201903,846,430,416,430139.77,416166.98,846306.75
311010,201903,42,34,8,33932,7984,41916
311020,201903,43,27,16,26946,15968,42914
311030,201903,399,240,159,239520,158682.78,398202.78
311040,201903,40,35,5,34930,4990,39920
311050,201903,463,191,272,192614.8,271456,464070.8
311060,201903,769,437,332,436126.8,332334.4,768461.2
311070,201903,351,169,182,168662,181636,350298
311080,201903,107,58,49,57884,49900,107784
311090,201903,343,162,181,161676.4,180638,342314.4
311100,201903,607,361,246,360278,245508,605786
311110,201903,693,486,207,485028,207584.98,692612.98
311115,201903,74,53,21,52894,21956,74850
311120,201903,1094,582,512,582832.4,512972,1095804.4
311130,201903,380,226,154,227544,153692,381236
311140,201903,163,88,75,87824,74850,162674
311150,201903,363,241,122,240518,121756,362274
311160,201903,728,525,203,524948.4,202594,727542.4
311170,201903,79,61,18,60878,17964,78842
311180,201903,348,232,116,231536,115768.4,347304.4
311190,201903,35,16,19,15968,18962,34930
311200,201903,328,232,96,232534,96806,329340
311205,201903,33,23,10,22954,9980,32934
311210,201903,47,39,8,39920,7984,47904
311220,201903,19,18,1,17964,998,18962
311230,201903,1640,1076,564,1077840.6,563870,1641710.6
311240,201903,174,113,61,112774,60878,173652
311250,201903,100,29,71,28942,70858,99800
311260,201903,556,353,203,353292,202594,555886
311265,201903,115,80,35,79840,34930,114770
311270,201903,293,207,86,206586,85828,292414
311280,201903,208,98,110,98802,110778,209580
311290,201903,112,91,21,90818,20958.4,111776.4
311300,201903,577,368,209,368262,208582,576844
311310,201903,25,19,6,18962,5988,24950
311320,201903,668,498,170,499000,169660,668660
311330,201903,1073,795,278,793410,277444.8,1070854.8
311340,201903,2635,1867,768,1865262.8,767462.98,2632725.78
311350,201903,273,210,63,209580,62874,272454
311360,201903,180,112,68,111776,67864,179640
311370,201903,1211,502,709,501994.5,711574,1213568.5
311380,201903,7,6,1,5988,998,6986
311390,201903,266,146,120,145708,119760,265468
311400,201903,157,106,51,105788,50898,156686
311410,201903,102,58,44,57884.4,43912,101796.4
311420,201903,303,170,133,170659.95,132734,303393.95
311430,201903,866,573,293,571854.9,293412.4,865267.3
311440,201903,487,340,147,340318,147704,488022
311450,201903,328,206,122,205588,121756,327344
311455,201903,295,201,94,200598.98,94810,295408.98
311460,201903,137,57,80,56886,79840,136726
311470,201903,22,13,9,12974,8982,21956
311480,201903,42,18,24,17964,23952,41916
311490,201903,16,10,6,9980,5988,15968
311500,201903,22,10,12,9980,11976,21956
311510,201903,635,450,185,450098,185628,635726
311520,201903,41,33,8,32934,7984,40918
311530,201903,1789,1337,452,1337321.28,452094,1789415.28
311535,201903,72,51,21,50898,20958,71856
311540,201903,36,31,5,30938,4990,35928
311545,201903,196,143,53,142714,52894,195608
311547,201903,34,25,9,24950,8982,33932
311550,201903,679,325,354,324350,353292.98,677642.98
311560,201903,42,29,13,28942,12974,41916
311570,201903,295,200,95,199600,94810,294410
311580,201903,327,195,132,196606,132734,329340
311590,201903,34,31,3,30938,2994,33932
311600,201903,98,79,19,78842,18962,97804
311610,201903,254,220,34,219560.5,33932,253492.5
311615,201903,112,93,19,92814,18962,111776
311620,201903,22,12,10,11976,9980,21956
311630,201903,86,72,14,71856,13972,85828
311640,201903,133,71,62,70858,62874,133732
311650,201903,134,96,38,96806,37924,134730
311660,201903,417,204,213,203592,214570,418162
311670,201903,162,105,57,105788.58,56886,162674.58
311680,201903,218,161,57,161676,56886,218562
311690,201903,17,11,6,10978,5988,16966
311700,201903,201,142,59,141716,58882,200598
311710,201903,207,131,76,130738.4,76846,207584.4
311720,201903,40,29,11,28942.4,10978,39920.4
311730,201903,591,389,202,389220,201596,590816
311740,201903,36,27,9,26946,8982,35928
311750,201903,705,479,226,479041.73,227544,706585.73
311760,201903,59,33,26,32934,25948,58882
311770,201903,389,194,195,194611.34,195608,390219.34
311780,201903,180,99,81,98802.4,80838,179640.4
311783,201903,85,75,10,74850,9980,84830
311787,201903,35,14,21,13972,20958,34930
311790,201903,268,125,143,124750,142714,267464
311800,201903,670,453,217,452094.5,217564,669658.5
311810,201903,48,41,7,40918,6986,47904
311820,201903,114,97,17,96806,16966,113772
311830,201903,1960,1243,717,1242511.5,716564,1959075.5
311840,201903,1020,564,456,562874,456086.9,1018960.9
311850,201903,10,6,4,5988,3992,9980
311860,201903,9548,4362,5186,4358268.7,5191602.25,9549870.95
311870,201903,140,77,63,76846,62874,139720
311880,201903,938,696,242,694609.38,241516,936125.38
311890,201903,216,108,108,108700,107784,216484
311900,201903,80,33,47,32934,46906,79840
311910,201903,1426,891,535,890216.7,533930.4,1424147.1
311920,201903,227,150,77,149700,76846,226546
311930,201903,910,518,392,516964.4,391216.5,908180.9
311940,201903,2536,1350,1186,1349296,1184626,2533922
311950,201903,55,41,14,40918,13972,54890
311960,201903,65,47,18,46906,17964,64870
311970,201903,25,15,10,14970,9980,24950
311980,201903,46,36,10,35928,9980,45908
311990,201903,46,34,12,35928,11976,47904
311995,201903,60,41,19,40918,18962,59880
312000,201903,34,25,9,24950,8982,33932
312010,201903,84,63,21,62874,20958,83832
312015,201903,97,72,25,72854.4,24950,97804.4
312020,201903,132,90,42,90818.4,41916,132734.4
312030,201903,51,40,11,39920,10978,50898
312040,201903,86,54,32,53892,31936,85828
312050,201903,203,113,90,112774,89820,202594
312060,201903,64,39,25,38922,24950,63872
312070,201903,72,45,27,44910,26946,71856
312080,201903,540,250,290,250498,293412,543910
312083,201903,57,40,17,39920,16966,56886
312087,201903,111,89,22,89820,21956,111776
312090,201903,3062,1818,1244,1815366.5,1247500.96,3062867.46
312100,201903,154,106,48,105558.86,47904,153462.86
312110,201903,114,72,42,71856,41916,113772
312120,201903,148,111,37,110778.97,36926,147704.97
312125,201903,94,50,44,50898,43912,94810
312130,201903,123,85,38,84830,37924,122754
312140,201903,144,112,32,111776.4,31936,143712.4
312150,201903,46,36,10,35928,9980,45908
312160,201903,1553,1023,530,1021045.6,529938.4,1550984.0
312170,201903,11,10,1,9980,998,10978
312180,201903,104,64,40,63872,40918.8,104790.8
312190,201903,31,27,4,26946,3992,30938
312200,201903,757,652,105,650696.4,104790,755486.4
312210,201903,93,62,31,61876,30938,92814
312220,201903,133,96,37,95808.5,36926,132734.5
312230,201903,3616,1774,1842,1776443.12,1841318.06,3617761.18
312235,201903,165,112,53,112774,52894,165668
312240,201903,104,72,32,71856,31936,103792
312245,201903,174,121,53,120758.99,52894,173652.99
312247,201903,65,45,20,44910,19960,64870
312250,201903,174,84,90,83832,89820,173652
312260,201903,114,75,39,74850,39920,114770
312270,201903,139,85,54,84830,53892,138722
312280,201903,29,17,12,16966,11976,28942
312290,201903,154,106,48,105788,47904.6,153692.6
312300,201903,203,133,70,132734,69860,202594
312310,201903,57,53,4,52894,3992,56886
312320,201903,435,277,158,277444,160678,438122
312330,201903,91,82,9,81836,8982,90818
312340,201903,38,17,21,16966,20958,37924
312350,201903,18,11,7,10978,6986,17964
312352,201903,99,69,30,68862,29940,98802
312360,201903,559,252,307,252494,307384,559878
312370,201903,306,175,131,174650,130738.4,305388.4
312380,201903,142,97,45,96806,44910,141716
312385,201903,172,138,34,137724,33932,171656
312390,201903,303,191,112,190618,112774,303392
312400,201903,380,294,86,293412,85829,379241
312410,201903,928,305,623,305388,621755.39,927143.39
312420,201903,619,484,135,483032.4,134730,617762.4
312430,201903,860,638,222,636725.89,221556,858281.89
312440,201903,46,34,12,33932,11976,45908
312450,201903,205,127,78,126746,77844,204590
312460,201903,50,26,24,25948,23952,49900
312470,201903,55,35,20,34930,19960,54890
312480,201903,201,123,78,122754,77844,200598
312490,201903,272,191,81,190618,80838,271456
312500,201903,35,20,15,19960,14970,34930
312510,201903,477,186,291,185628,290418,476046
312520,201903,42,14,28,13972,27944,41916
312530,201903,52,37,15,36926,14970,51896
312540,201903,102,89,13,88822,12974,101796
312550,201903,39,30,9,29940,8982,38922
312560,201903,220,168,52,167664.4,51896,219560.4
312570,201903,441,263,178,262474,178642,441116
312580,201903,88,46,42,45908,41916,87824
312590,201903,260,206,54,205588,53892,259480
312595,201903,138,123,15,122754,14970,137724
312600,201903,70,43,27,42914.1,26946,69860.1
312610,201903,1616,850,766,851296.06,765466.6,1616762.66
312620,201903,196,142,54,141716,53892,195608
312630,201903,71,59,12,58882,11976,70858
312640,201903,43,11,32,10978,31936,42914
312650,201903,154,129,25,129740.4,24950,154690.4
312660,201903,77,58,19,58882.7,18962,77844.7
312670,201903,886,588,298,586824,299400,886224
312675,201903,37,29,8,28942,7984,36926
312680,201903,83,55,28,54890,27944,82834
312690,201903,236,129,107,128742,106786,235528
312695,201903,38,31,7,30938,6986,37924
312700,201903,218,127,91,126746,90818,217564
312705,201903,81,67,14,66866,13972,80838
312707,201903,130,95,35,95808.3,36926,132734.3
312710,201903,1915,1036,879,1034927.4,882232.58,1917159.98
312720,201903,63,31,32,30938,32934,63872
312730,201903,282,165,117,164670,117764,282434
312733,201903,54,45,9,44910,8982,53892
312735,201903,25,17,8,16966,7984,24950
312737,201903,72,37,35,36926,34930,71856
312738,201903,54,39,15,38922,14970,53892
312740,201903,75,50,25,49900.4,24950,74850.4
312750,201903,71,52,19,51896,18962,70858
312760,201903,277,202,75,201596,74850,276446
312770,201903,7643,3541,4102,3541910.09,4106774.53,7648684.62
312780,201903,420,323,97,322354,96806,419160
312790,201903,24,19,5,18962,4990,23952
312800,201903,1610,1125,485,1125744.9,485028.46,1610773.36
312810,201903,377,242,135,242514,134730,377244
312820,201903,191,144,47,143712,46906,190618
312825,201903,26,18,8,17964,7984,25948
312830,201903,269,158,111,157684.46,110778,268462.46
312840,201903,155,112,43,111776,42914,154690
312850,201903,51,46,5,45908,4990,50898
312860,201903,165,103,62,102794,61876,164670
312870,201903,1001,533,468,532932.9,467064,999996.9
312880,201903,148,101,47,100798,46906,147704
312890,201903,164,117,47,117764,47904,165668
312900,201903,205,156,49,155688,48902,204590
312910,201903,183,98,85,98802,86826,185628
312920,201903,156,89,67,88822,67864,156686
312930,201903,328,236,92,235528,91816,327344
312940,201903,112,81,31,80838,31936,112774
312950,201903,712,475,237,474050,236526,710576
312960,201903,173,131,42,130738.96,41916,172654.96
312965,201903,61,54,7,54890,6986,61876
312970,201903,276,219,57,218562,56886,275448
312980,201903,2403,1252,1151,1251494.18,1150694.99,2402189.17
312990,201903,47,26,21,25948,20958,46906
313000,201903,45,26,19,25948,18962,44910
313005,201903,173,136,37,135728,36926.4,172654.4
313010,201903,931,383,548,383232,547902.98,931134.98
313020,201903,187,100,87,100798,86826,187624
313030,201903,203,133,70,132734.54,70858,203592.54
313040,201903,68,25,43,24950,42914,67864
313050,201903,247,167,80,166666,79840,246506
313055,201903,45,34,11,33932,10978,44910
313060,201903,125,91,34,90818,33932,124750
313065,201903,60,41,19,40918,18962,59880
313070,201903,143,76,67,75848,66866,142714
313080,201903,43,19,24,18962,23952,42914
313090,201903,706,489,217,490018.4,216566,706584.4
313100,201903,165,62,103,61876,102794,164670
313110,201903,136,74,62,73852,61876,135728
313115,201903,187,103,84,102794,83832,186626
313120,201903,797,453,344,452094.4,344310.4,796404.8
313130,201903,5520,3055,2465,3055882.58,2461069.3,5516951.88
313140,201903,151,81,70,80838,69860,150698
313150,201903,311,247,64,246506,64870,311376
313160,201903,196,144,52,144710.4,51896,196606.4
313170,201903,1406,972,434,973051.44,433132.98,1406184.42
313180,201903,308,185,123,184630,123752,308382
313190,201903,758,465,293,465068,292414.2,757482.2
313200,201903,29,26,3,25948,2994,28942
313210,201903,1027,872,155,874249.62,154690,1028939.62
313220,201903,254,168,86,167664,85828,253492
313230,201903,274,205,69,204590.65,68862,273452.65
313240,201903,1958,1048,910,1046906.29,913170,1960076.29
313250,201903,1290,977,313,976045.2,312375.12,1288420.32
313260,201903,91,52,39,51896,39920,91816
313270,201903,956,562,394,560876.3,394210.4,955086.7
313280,201903,59,49,10,49900,9980,59880
313290,201903,221,179,42,179640.4,41916,221556.4
313300,201903,354,183,171,182635,171656,354291
313310,201903,243,126,117,125748,116766,242514
313320,201903,376,285,91,284431,91816,376247
313330,201903,1386,867,519,867262.6,517962,1385224.6
313340,201903,334,234,100,233532,99800,333332
313350,201903,504,341,163,340318,162674,502992
313360,201903,117,68,49,67864,48902.4,116766.4
313370,201903,193,73,120,73852,119760,193612
313375,201903,277,166,111,165668,110778,276446
313380,201903,1329,703,626,701594.99,626744.99,1328339.98
313390,201903,53,47,6,46906.6,5988,52894.6
313400,201903,417,285,132,284430.6,132734.8,417165.4
313410,201903,23,13,10,12974,9980,22954
313420,201903,4675,2486,2189,2481029.6,2189613.5,4670643.1
313430,201903,143,70,73,69860,72854,142714
313440,201903,1485,1021,464,1019956.71,464072,1484028.71
313450,201903,63,27,36,26946,35928,62874
313460,201903,384,180,204,179640.4,203592,383232.4
313470,201903,531,245,286,244510,285428,529938
313480,201903,153,107,46,106786.4,45908,152694.4
313490,201903,513,248,265,247504.4,265468.9,512973.3
313500,201903,21,13,8,12974,7984,20958
313505,201903,1030,816,214,814368,214570,1028938
313507,201903,98,61,37,60878,36926,97804
313510,201903,2808,1811,997,1811371,998998.46,2810369.46
313520,201903,3544,2782,762,2780433.11,761474.99,3541908.10
313530,201903,42,28,14,27944,13972,41916
313535,201903,52,44,8,43912,7984,51896
313540,201903,75,58,17,57884,16966,74850
313545,201903,113,96,17,95808,16966,112774
313550,201903,233,196,37,196606,36926.4,233532.4
313560,201903,329,168,161,167664,160678,328342
313570,201903,57,29,28,28942,28942,57884
313580,201903,1341,750,591,749498,589819.2,1339317.2
313590,201903,77,45,32,44910,31936,76846
313600,201903,688,419,269,420158.4,268462.4,688620.8
313610,201903,61,49,12,48902.8,11976,60878.8
313620,201903,1380,726,654,725546.8,653690,1379236.8
313630,201903,1642,1260,382,1259477.2,382234,1641711.2
313640,201903,129,76,53,76846,52894,129740
313650,201903,242,114,128,114770,128742.4,243512.4
313652,201903,18,18,0,17964,0,17964
313655,201903,58,35,23,34930,22954,57884
313657,201903,47,44,3,43912,2994,46906
313660,201903,135,92,43,91816,42931.96,134747.96
313665,201903,664,328,336,327344,335328,662672
313670,201903,10237,7075,3162,7079819.93,3163661.2,10243481.13
313680,201903,45,33,12,32934,11976.78,44910.78
313690,201903,154,115,39,115768,38922,154690
313695,201903,77,60,17,59880,16966,76846
313700,201903,317,254,63,253492.4,62874,316366.4
313710,201903,142,97,45,97804,44910,142714
313720,201903,1137,551,586,550896.8,585827.4,1136724.2
313730,201903,62,43,19,42914,18962,61876
313740,201903,158,129,29,128742,29940,158682
313750,201903,427,315,112,314370,112774,427144
313753,201903,241,178,63,177644,62874,240518
313760,201903,1281,470,811,469060.4,809380.1,1278440.5
313770,201903,362,270,92,269460.5,92814,362274.5
313780,201903,759,397,362,396206,362274,758480
313790,201903,29,28,1,27944,998,28942
313800,201903,148,95,53,95808,52894,148702
313810,201903,70,40,30,39920,29940,69860
313820,201903,1308,650,658,649699.2,658682.15,1308381.35
313830,201903,64,47,17,46906,17964,64870
313835,201903,61,51,10,50898,9980,60878
313840,201903,1712,1065,647,1063869.2,645706.8,1709576.0
313850,201903,186,68,118,67864,118762,186626
313860,201903,471,360,111,359280.4,110778,470058.4
313862,201903,173,116,57,115768,56886,172654
313865,201903,99,78,21,77844,20958,98802
313867,201903,48,38,10,37924,10978,48902
313868,201903,30,19,11,18962,10978,29940
313870,201903,126,67,59,66866,58882,125748
313880,201903,369,235,134,234530,133732.4,368262.4
313890,201903,334,180,154,179641,153692,333333
313900,201903,905,502,403,500996.5,405188.9,906185.4
313910,201903,139,102,37,102794,36926,139720
313920,201903,634,453,181,453092,180638.9,633730.9
313925,201903,32,28,4,27944,3992,31936
313930,201903,825,643,182,642712,185628.95,828340.95
313940,201903,1816,1147,669,1144706,668660.4,1813366.4
313950,201903,938,603,335,602792.8,334330,937122.8
313960,201903,1388,807,581,806385.16,579839.8,1386224.96
313970,201903,129,85,44,84830,43912,128742
313980,201903,216,139,77,139720.5,76846,216566.5
313990,201903,371,222,149,222554,149700,372254
314000,201903,924,622,302,620757.74,301396,922153.74
314010,201903,81,53,28,52894,27944,80838
314015,201903,58,18,40,17964,39920,57884
314020,201903,54,38,16,37924,15968,53892
314030,201903,78,38,40,37924,39920,77844
314040,201903,44,29,15,28942,14970,43912
314050,201903,298,178,120,177644.4,120758,298402.4
314053,201903,96,62,34,61876.4,33932,95808.4
314055,201903,303,184,119,183632,118762,302394
314060,201903,143,123,20,122754,19960,142714
314070,201903,1053,555,498,555886,497004,1052890
314080,201903,216,140,76,139720,75848.36,215568.36
314085,201903,145,98,47,97804,46906,144710
314090,201903,367,265,102,264470.9,101796,366266.9
314100,201903,482,399,83,398202.3,82834,481036.3
314110,201903,733,399,334,398202,334330,732532
314120,201903,92,54,38,53892,37924,91816
314130,201903,21,11,10,10978,9980,20958
314140,201903,1114,686,428,684628.4,427144,1111772.4
314150,201903,166,105,61,104790,60878,165668
314160,201903,347,263,84,262474.6,84830.6,347305.2
314170,201903,79,61,18,61876,17964,79840
314180,201903,728,644,84,644708.8,83832.5,728541.3
314190,201903,101,62,39,61876,38922,100798
314200,201903,475,325,150,325348,149700,475048
314210,201903,273,209,64,208582,64870.4,273452.4
314220,201903,312,234,78,233532.4,77844.4,311376.8
314225,201903,67,49,18,48902,17964,66866
314230,201903,116,52,64,51896,64870,116766
314240,201903,140,109,31,108782,30938,139720
314250,201903,60,38,22,37924,22954,60878
314260,201903,231,110,121,109780,120758,230538
314270,201903,335,265,70,264470,69860,334330
314280,201903,702,400,302,399200.98,301396,700596.98
314290,201903,556,458,98,457084.9,97804,554888.9
314300,201903,386,281,105,280440.5,104790.9,385231.4
314310,201903,1427,971,456,970056.08,457084,1427140.08
314315,201903,39,31,8,30938,7984,38922
314320,201903,605,400,205,401196.4,205588,606784.4
314330,201903,10848,5465,5383,5461059.88,5382217.53,10843277.41
314340,201903,587,273,314,272454,314370.8,586824.8
314345,201903,40,30,10,29940,9980,39920
314350,201903,189,121,68,120758,68862,189620
314360,201903,75,46,29,45908,28942,74850
314370,201903,60,47,13,46906,12974,59880
314380,201903,96,66,30,65868,29940,95808
314390,201903,3294,2109,1185,2106779.5,1185624.6,3292404.1
314400,201903,693,499,194,499001.5,194610,693611.5
314410,201903,464,308,156,309380,156686,466066
314420,201903,19,9,10,8982,9980,18962
314430,201903,2477,908,1569,908181.9,1568856,2477037.9
314435,201903,266,158,108,157684,107784,265468
314437,201903,28,22,6,21956,5988,27944
314440,201903,100,74,26,73852,25948,99800
314450,201903,152,110,42,110778,41916,152694
314460,201903,652,309,343,308382,342314,650696
314465,201903,89,59,30,58882,29940,88822
314467,201903,69,57,12,56886,11976,68862
314470,201903,405,208,197,207584.98,196606,404190.98
314480,201903,1097,539,558,537922,557882,1095804
314490,201903,85,62,23,61876,22954,84830
314500,201903,304,203,101,204590,101796,306386
314505,201903,133,89,44,88822,43912,132734
314510,201903,239,199,40,199600,39920,239520
314520,201903,1259,670,589,668667.6,589819.2,1258486.8
314530,201903,761,610,151,608781.66,151696,760477.66
314535,201903,212,130,82,130738,81836,212574
314537,201903,65,39,26,38922,25948,64870
314540,201903,15,9,6,8982,5988,14970
314545,201903,51,33,18,32934,17964,50898
314550,201903,82,44,38,43912,37924,81836
314560,201903,838,457,381,457085.2,382234,839319.2
314570,201903,20,17,3,16966,2994,19960
314580,201903,15,8,7,7984,6986,14970
314585,201903,24,19,5,18962,4990,23952
314587,201903,80,71,9,70858,8982,79840
314590,201903,586,429,157,428143.7,156686,584829.7
314600,201903,950,621,329,623118.93,330339.03,953457.96
314610,201903,958,514,444,513971.3,443112,957083.3
314620,201903,145,105,40,105788,39920,145708
314625,201903,95,70,25,69860,24950,94810
314630,201903,1210,631,579,630736,579838,1210574
314640,201903,83,57,26,56886,25948,82834
314650,201903,185,107,78,106786,77844,184630
314655,201903,65,48,17,47904,16966,64870
314660,201903,18,15,3,14970,2994,17964
314670,201903,205,158,47,157684.4,46906,204590.4
314675,201903,216,128,88,127744,87824,215568
314690,201903,556,305,251,305388,251496,556884
314700,201903,2389,1307,1082,1304387.6,1081832,2386219.6
314710,201903,1633,960,673,963072.5,672652.4,1635724.9
314720,201903,393,233,160,233532,159680,393212
314730,201903,519,268,251,267465.4,250498.98,517964.38
314740,201903,704,348,356,347304,355288,702592
314750,201903,20,18,2,17964,1996,19960
314760,201903,331,156,175,156686,174650,331336
314770,201903,110,79,31,79840.4,30938,110778.4
314780,201903,20,6,14,5988,13972,19960
314790,201903,2383,1516,867,1513969.87,869258,2383227.87
314795,201903,45,39,6,38922.5,5988,44910.5
314800,201903,2924,1719,1205,1719555.48,1206582,2926137.48
314810,201903,1537,871,666,873250,665667.58,1538917.58
314820,201903,96,53,43,52894,42914,95808
314830,201903,217,178,39,177644,38922.4,216566.4
314840,201903,86,49,37,48902,36926,85828
314850,201903,346,169,177,168662,176646,345308
314860,201903,703,531,172,534929.13,171656.7,706585.83
314870,201903,1503,795,708,795406,708580,1503986
314875,201903,58,50,8,49900,7984,57884
314880,201903,46,32,14,31936,13972,45908
314890,201903,54,31,23,30938,22954,53892
314900,201903,31,25,6,24950,5988,30938
314910,201903,253,170,83,170658,82834,253492
314915,201903,155,135,20,135728,19960,155688
314920,201903,119,73,46,72854,45908,118762
314930,201903,1070,537,533,536924.8,532932,1069856.8
314940,201903,49,39,10,38922,9980,48902
314950,201903,35,25,10,24950,9980,34930
314960,201903,53,39,14,38922,13972,52894
314970,201903,145,74,71,73852,71856,145708
314980,201903,294,185,109,184630,109780,294410
314990,201903,463,258,205,257484,204590,462074
314995,201903,209,62,147,61876,146706,208582
315000,201903,94,76,18,75848,17964,93812
315010,201903,46,30,16,29940,15968,45908
315015,201903,175,144,31,143712,30938,174650
315020,201903,73,63,10,62874,9980,72854
315030,201903,116,90,26,89820,25948.4,115768.4
315040,201903,70,51,19,51896,18962,70858
315050,201903,192,115,77,114770,76846.4,191616.4
315053,201903,44,39,5,38922,4990,43912
315057,201903,98,81,17,80838,16966,97804
315060,201903,68,60,8,59881.32,7984,67865.32
315070,201903,106,60,46,59880,46906,106786
315080,201903,378,309,69,308382,68862,377244
315090,201903,107,62,45,61876,44910,106786
315100,201903,79,42,37,41916,37924,79840
315110,201903,285,155,130,155688,130738,286426
315120,201903,1642,831,811,830336,810376.68,1640712.68
315130,201903,349,253,96,252494,95808,348302
315140,201903,529,310,219,309380.4,218562.2,527942.6
315150,201903,968,463,505,463072,505986.4,969058.4
315160,201903,218,111,107,110778,106786,217564
315170,201903,326,213,113,213572.4,112774,326346.4
315180,201903,3279,1380,1899,1382232.4,1902190.3,3284422.7
315190,201903,327,194,133,193612.2,132734,326346.2
315200,201903,1244,723,521,721554,520956,1242510
315210,201903,1605,918,687,916164.6,688620.2,1604784.8
315213,201903,41,24,17,23952,16966,40918
315217,201903,213,171,42,170658,41916,212574
315220,201903,1566,1202,364,1201593.58,365268.4,1566861.98
315230,201903,168,123,45,122754.4,45908,168662.4
315240,201903,430,277,153,276446,152694.98,429140.98
315250,201903,2518,1254,1264,1257480.5,1269456.8,2526937.3
315260,201903,147,89,58,89820,58882,148702
315270,201903,128,91,37,90818,36926,127744
315280,201903,676,441,235,441116.6,234530,675646.6
315290,201903,206,125,81,124750,80838,205588
315300,201903,72,52,20,51896,19960,71856
315310,201903,71,65,6,64870,5988,70858
315320,201903,169,97,72,96806,71856,168662
315330,201903,59,50,9,49900,8982,58882
315340,201903,401,288,113,288422,113772,402194
315350,201903,152,91,61,90818,60878,151696
315360,201903,94,49,45,48902,44910,93812
315370,201903,57,33,24,32934,23952,56886
315380,201903,10,7,3,6986,2994,9980
315390,201903,68,18,50,17964,49900,67864
315400,201903,839,630,209,629738.7,208582,838320.7
315410,201903,354,217,137,216566.4,136727.4,353293.8
315415,201903,62,46,16,45908,15968,61876
315420,201903,203,155,48,154690.4,47904,202594.4
315430,201903,668,388,280,388222.4,281436.6,669659.0
315440,201903,87,59,28,58882,27944,86826
315445,201903,250,202,48,201596,47904,249500
315450,201903,186,140,46,139720,45908,185628
315460,201903,3541,1799,1742,1798396.98,1740513.03,3538910.01
315470,201903,42,18,24,17964,23952,41916
315480,201903,64,24,40,23952,39920,63872
315490,201903,644,403,241,402194,240518,642712
315500,201903,23,16,7,15968,6986,22954
315510,201903,152,101,51,100798,50898,151696
315520,201903,74,65,9,64870,8982,73852
315530,201903,53,28,25,27944,24950,52894
315540,201903,239,161,78,161676,77844,239520
315550,201903,180,143,37,142714,37924,180638
315560,201903,739,596,143,595806.4,143712,739518.4
315570,201903,311,161,150,160679.8,149700.6,310380.4
315580,201903,698,463,235,463072,234530,697602
315590,201903,204,108,96,107784,96806,204590
315600,201903,297,224,73,223552,72854,296406
315610,201903,98,51,47,50898,46906,97804
315620,201903,35,27,8,26946,7984,34930
315630,201903,136,90,46,89820,45908,135728
315640,201903,67,41,26,40918,25948,66866
315645,201903,60,42,18,41916,17964,59880
315650,201903,169,124,45,123752.8,44910,168662.8
315660,201903,476,216,260,215568,259480,475048
315670,201903,2439,1218,1221,1218559.72,1219558.36,2438118.08
315680,201903,858,587,271,586824,271456,858280
315690,201903,682,471,211,470059.33,211576,681635.33
315700,201903,1895,1005,890,1006983.27,891214.38,1898197.65
315710,201903,330,93,237,93812,237524,331336
315720,201903,443,282,161,281436,160678,442114
315725,201903,203,162,41,161676.4,40918,202594.4
315727,201903,37,19,18,18962,17964,36926
315730,201903,48,46,2,45908,1996,47904
315733,201903,87,59,28,58882,27944,86826
315737,201903,50,39,11,38922,10978,49900
315740,201903,39,32,7,31936,6986,38922
315750,201903,158,121,37,120758,36926,157684
315760,201903,44,34,10,34930,9980,44910
315765,201903,123,78,45,77844,44910,122754
315770,201903,231,142,89,141716,88822.4,230538.4
315780,201903,3403,1779,1624,1779435,1625743.15,3405178.15
315790,201903,213,165,48,164670,47904,212574
315800,201903,295,216,79,215568,78842,294410
315810,201903,95,56,39,55888,38922.4,94810.4
315820,201903,789,575,214,574849.6,213572,788421.6
315830,201903,135,78,57,77844,56886,134730
315840,201903,85,59,26,59880,25948,85828
315850,201903,264,194,70,193612.5,69860,263472.5
315860,201903,12,4,8,3992,7984,11976
315870,201903,38,30,8,29940,7984,37924
315880,201903,110,73,37,72854,36926,109780
315890,201903,87,64,23,63872,22954,86826
315895,201903,466,319,147,318362.5,146706.8,465069.3
315900,201903,72,37,35,36926,35928,72854
315910,201903,42,28,14,27944,13972,41916
315920,201903,174,112,62,111776,61876.3,173652.3
315930,201903,47,17,30,16966,29940,46906
315935,201903,145,112,33,111776,32934.98,144710.98
315940,201903,94,70,24,69860,23952,93812
315950,201903,47,34,13,33932,12974,46906
315960,201903,552,262,290,261476.4,290418.4,551894.8
315970,201903,35,28,7,27944,6986,34930
315980,201903,697,337,360,336326.1,361276,697602.1
315990,201903,256,150,106,149700.5,105789.38,255489.88
316000,201903,53,35,18,34930,17964,52894
316010,201903,80,68,12,67864,11976,79840
316020,201903,114,98,16,97804,15968,113772
316030,201903,406,219,187,218562.8,186626.9,405189.7
316040,201903,517,221,296,220558.4,296406.4,516964.8
316045,201903,64,57,7,56886,6986,63872
316050,201903,15,13,2,12974,1996,14970
316060,201903,101,65,36,65868,35928,101796
316070,201903,1097,700,397,699598.1,397204,1096802.1
316080,201903,105,68,37,67864,36926,104790
316090,201903,38,22,16,21956,16966,38922
316095,201903,76,65,11,64870,10978,75848
316100,201903,317,186,131,185628.5,130738,316366.5
316105,201903,36,24,12,23952,11976,35928
316110,201903,1886,1519,367,1517958.95,367264,1885222.95
316120,201903,80,60,20,59880,19960,79840
316130,201903,131,101,30,100798.4,29940,130738.4
316140,201903,29,21,8,20958,7984,28942
316150,201903,207,143,64,145708,63872,209580
316160,201903,79,47,32,47904,31936,79840
316165,201903,69,52,17,52894.6,16966,69860.6
316170,201903,197,133,64,132734,63872,196606
316180,201903,204,89,115,88822,114770.4,203592.4
316190,201903,143,105,38,104790,37924,142714
316200,201903,685,387,298,388222,298402,686624
316210,201903,769,515,254,514141.65,254490,768631.65
316220,201903,111,76,35,75848,35928,111776
316225,201903,26,15,11,14970,10978,25948
316230,201903,31,19,12,18962,11976,30938
316240,201903,647,519,128,518960,127744,646704
316245,201903,122,103,19,102794,18962,121756
316250,201903,1528,1054,474,1055886.52,475048,1530934.52
316255,201903,122,98,24,97804,23952,121756
316257,201903,181,96,85,95808,84830,180638
316260,201903,191,135,56,134730.5,55888.8,190619.3
316265,201903,27,19,8,18962,7984,26946
316270,201903,672,472,200,471057,200598.84,671655.84
316280,201903,544,334,210,333333.23,209580.8,542914.03
316290,201903,714,473,241,473052.66,240518,713570.66
316292,201903,522,210,312,210578,311376.5,521954.5
316294,201903,101,60,41,59880,40918,100798
316295,201903,296,134,162,133733.36,161676,295409.36
316300,201903,98,71,27,70858,27944,98802
316310,201903,37,20,17,19960,16966,36926
316320,201903,43,26,17,26946,16966,43912
316330,201903,133,87,46,86826.5,45908,132734.5
316340,201903,142,98,44,97804,44910,142714
316350,201903,195,141,54,140718.84,53892,194610.84
316360,201903,24,17,7,16966,6986,23952
316370,201903,1083,569,514,567863.5,513970,1081833.5
316380,201903,124,96,28,95808,27944,123752
316390,201903,122,89,33,89820,32934,122754
316400,201903,135,104,31,104790,30938,135728
316410,201903,302,220,82,219560,81836,301396
316420,201903,206,145,61,145708,60878,206586
316430,201903,154,81,73,81836,72854,154690
316440,201903,97,47,50,46906,49900,96806
316443,201903,39,37,2,36926,1996,38922
316447,201903,64,49,15,48902,14970,63872
316450,201903,234,175,59,174650,58882,233532
316460,201903,73,29,44,28942,43912,72854
316470,201903,1630,1195,435,1194600.57,437124.4,1631724.97
316480,201903,13,10,3,9980,2994,12974
316490,201903,18,7,11,6986,11976,18962
316500,201903,156,101,55,100798,54890,155688
316510,201903,164,125,39,124750,38922,163672
316520,201903,196,122,74,121756,73852,195608
316530,201903,159,111,48,110778,47904,158682
316540,201903,139,78,61,78842,60878,139720
316550,201903,136,93,43,92814,42914,135728
316553,201903,259,122,137,122754,136726,259480
316555,201903,34,29,5,28942,4990,33932
316556,201903,11,8,3,7984,2994,10978
316557,201903,18,13,5,12974,5988,18962
316560,201903,68,52,16,51896,15968,67864
316570,201903,237,217,20,216566,19960,236526
316580,201903,20,16,4,15968,3992,19960
316590,201903,112,96,16,95808,15968,111776
316600,201903,184,152,32,151696,31936,183632
316610,201903,68,50,18,49900,17964,67864
316620,201903,139,106,33,105788,32934,138722
316630,201903,42,33,9,32934,8982,41916
316640,201903,17,10,7,9980,6986,16966
316650,201903,73,56,17,55888,16966,72854
316660,201903,8,3,5,2994,4990,7984
316670,201903,447,157,290,157684.96,289420,447104.96
316680,201903,158,111,47,110778,47904.6,158682.6
316690,201903,186,121,65,120758,66866,187624
316695,201903,63,55,8,54890,7984,62874
316700,201903,16,9,7,8982,6986,15968
316710,201903,754,561,193,559878.5,194610,754488.5
316720,201903,4971,2549,2422,2548896.69,2421150.74,4970047.43
316730,201903,18,17,1,16966,998,17964
316740,201903,122,79,43,78842,42914,121756
316750,201903,19,13,6,12974,5988,18962
316760,201903,319,257,62,256486,61876,318362
316770,201903,141,78,63,77844,62874,140718
316780,201903,78,49,29,48902,28942,77844
316790,201903,55,42,13,41916,12974,54890
316800,201903,1750,1096,654,1094806,653691,1748497
316805,201903,21,13,8,12974,7984,20958
316810,201903,71,48,23,47904,22954,70858
316820,201903,44,21,23,20958,22954,43912
316830,201903,90,41,49,40918,48902,89820
316840,201903,512,311,201,310378.4,200598,510976.4
316850,201903,341,226,115,225548,115768,341316
316860,201903,6055,2702,3353,2705580.96,3354278.3,6059859.26
316870,201903,1517,1005,512,1002992.5,512973.2,1515965.7
316880,201903,126,65,61,64870,60878,125748
316890,201903,247,169,78,168662,77844,246506
316900,201903,431,298,133,298402.36,132734,431136.36
316905,201903,19,9,10,8982,9980,18962
316910,201903,52,23,29,22954,28942,51896
316920,201903,134,105,29,104790,28942,133732
316930,201903,1911,986,925,987022.8,925146.3,1912169.1
316935,201903,893,545,348,544908.64,348302.4,893211.04
316940,201903,1094,636,458,634728.8,460078.4,1094807.2
316950,201903,181,91,90,90818,89820,180638
316960,201903,1124,633,491,633730.4,490018.4,1123748.8
316970,201903,655,515,140,513970,139720,653690
316980,201903,111,66,45,65868,44910,110778
316990,201903,2253,1510,743,1507978.34,743510.96,2251489.30
317000,201903,335,257,78,256486,77844,334330
317005,201903,247,175,72,174650,71856,246506
317010,201903,6421,3602,2819,3600788.19,2819350.4,6420138.59
317020,201903,16464,7384,9080,7386214.39,9084811.5,16471025.89
317030,201903,81,32,49,31936,48902,80838
317040,201903,3116,1947,1169,1947099.8,1168659.27,3115759.07
317043,201903,80,58,22,57884,21956,79840
317047,201903,34,17,17,16966,16966.99,33932.99
317050,201903,177,137,40,137724,39920,177644
317052,201903,132,100,32,99800,31936,131736
317057,201903,187,141,46,140718,46906,187624
317060,201903,60,40,20,39920,19960,59880
317065,201903,59,48,11,47904,10978,58882
317070,201903,2005,949,1056,947103.5,1054886.8,2001990.3
317075,201903,107,56,51,55888,50898,106786
317080,201903,859,456,403,455088.5,402194.6,857283.1
317090,201903,654,528,126,526944,126746,653690
317100,201903,430,325,105,324350,104790,429140
317103,201903,111,94,17,93812,16966,110778
317107,201903,40,35,5,34930,4990,39920
317110,201903,111,47,64,46906,63872,110778
317115,201903,41,36,5,36926,4990,41916
317120,201903,1899,982,917,982032.8,918161.04,1900193.84
317130,201903,1967,1293,674,1293409.6,675646,1969055.6
317140,201903,11,10,1,9980,998,10978
317150,201903,274,162,112,161676.4,111776,273452.4
317160,201903,319,233,86,232534.63,86826,319360.63
317170,201903,212,146,66,145708,65868,211576
317180,201903,443,319,124,318362,123752,442114
317190,201903,264,179,85,178642,84830,263472
317200,201903,806,565,241,564870.96,240518,805388.96
317210,201903,167,93,74,92814,73852,166666
317220,201903,22,13,9,12974,8982,21956
320010,201903,613,451,162,451096.9,161676,612772.9
320013,201903,133,98,35,97804,34930,132734
320016,201903,284,181,103,180638,103792,284430
320020,201903,734,440,294,439121.1,294410,733531.1
320030,201903,148,108,40,107784,39920,147704
320035,201903,144,108,36,107784,35928,143712
320040,201903,499,260,239,259480,239520.4,499000.4
320050,201903,106,81,25,82834,24950,107784
320060,201903,1605,769,836,769459.37,837325.74,1606785.11
320070,201903,104,69,35,69860,34930,104790
320080,201903,794,458,336,458083.89,336326.5,794410.39
320090,201903,1243,870,373,871254.4,372254.4,1243508.8
320100,201903,339,197,142,196606,142714,339320
320110,201903,125,80,45,79841.1,44910.4,124751.5
320115,201903,112,93,19,92814,18962,111776
320120,201903,3384,1895,1489,1893208.36,1491013.77,3384222.13
320130,201903,7511,3544,3967,3548908.45,3967083.33,7515991.78
320140,201903,430,284,146,283432.6,145709.58,429142.18
320150,201903,2025,1175,850,1174648.48,851294,2025942.48
320160,201903,671,300,371,299400.99,374251.79,673652.78
320170,201903,114,91,23,90818,22954,113772
320180,201903,53,30,23,29940,22954,52894
320190,201903,248,165,83,164670,82834.4,247504.4
320200,201903,59,47,12,46906,11976,58882
320210,201903,878,491,387,490018.8,386227.76,876246.56
320220,201903,311,117,194,116766,195608,312374
320225,201903,86,71,15,70858,14970,85828
320230,201903,592,383,209,382234.6,208582,590816.6
320240,201903,3150,1599,1551,1599796,1551891.78,3151687.78
320245,201903,474,325,149,326346.4,148702,475048.4
320250,201903,227,119,108,118762,107784,226546
320255,201903,144,116,28,115768,27944.7,143712.7
320260,201903,193,137,56,137724,55888,193612
320265,201903,159,127,32,126746,31936,158682
320270,201903,157,127,30,126746,29940,156686
320280,201903,1005,603,402,601795.75,404190,1005985.75
320290,201903,62,53,9,53892,8982,62874
320300,201903,556,390,166,390219.34,165670.04,555889.38
320305,201903,677,370,307,369260,307384.6,676644.6
320310,201903,214,121,93,120758.76,92814,213572.76
320313,201903,314,158,156,157684.9,157684.4,315369.3
320316,201903,109,87,22,87824,21956,109780
320320,201903,3425,1571,1854,1571852.38,1852289.95,3424142.33
320330,201903,260,198,62,197604,61876,259480
320332,201903,878,529,349,529940.7,349300.9,879241.6
320334,201903,252,157,95,156686.4,94810,251496.4
320335,201903,143,100,43,99800,42914,142714
320340,201903,571,396,175,396207.3,175648,571855.3
320350,201903,987,426,561,428143.69,564869.2,993012.89
320360,201903,169,91,78,91816,77844,169660
320370,201903,247,189,58,188622.56,57884.4,246506.96
320380,201903,290,203,87,203592,88822,292414
320390,201903,1153,701,452,700597.52,453092.8,1153690.32
320400,201903,313,228,85,227545,84830,312375
320405,201903,942,412,530,411176.99,529941.38,941118.37
320410,201903,979,503,476,501994.8,476047.3,978042.1
320420,201903,487,251,236,251497.45,237524,489021.45
320425,201903,198,107,91,106786,90818,197604
320430,201903,396,224,172,223552.5,171656,395208.5
320435,201903,168,114,54,115768,53892,169660
320440,201903,199,117,82,116766,81836,198602
320450,201903,129,73,56,72854,55888,128742
320455,201903,246,203,43,202594.4,42914,245508.4
320460,201903,258,155,103,154690,102794.4,257484.4
320465,201903,116,79,37,78842,36926,115768
320470,201903,674,428,246,427144.99,246506.99,673651.98
320480,201903,182,119,63,119760,62874,182634
320490,201903,3078,1538,1540,1536923.79,1541917.68,3078841.47
320495,201903,98,60,38,59880.96,37924.8,97805.76
320500,201903,9745,4853,4892,4863269.26,4897201.17,9760470.43
320501,201903,542,273,269,272454,268462,540916
320503,201903,288,206,82,205588,81836,287424
320506,201903,258,190,68,189620,67864,257484
320510,201903,998,471,527,471056.4,526945.38,998001.78
320515,201903,80,67,13,66866,12974,79840
320517,201903,210,150,60,149700,59880,209580
320520,201903,7002,3142,3860,3141708.5,3867257.55,7008966.05
320530,201903,5706,2884,2822,2886223.32,2821351.29,5707574.61
330010,201903,3103,1615,1488,1615764.2,1490014,3105778.2
330015,201903,156,65,91,65868.3,90818,156686.3
330020,201903,3654,1612,2042,1611771.8,2041908.4,3653680.2
330022,201903,245,134,111,133732,110778,244510
330023,201903,555,191,364,190618,363272,553890
330025,201903,594,124,470,123752,470058,593810
330030,201903,1953,1272,681,1273450.66,681635.5,1955086.16
330040,201903,2426,1282,1144,1283429.6,1144708.2,2428137.8
330045,201903,8464,2748,5716,2748492.8,5719539.2,8468032.0
330050,201903,878,568,310,567862,309380,877242
330060,201903,938,584,354,582832.9,353292,936124.9
330070,201903,3468,1325,2143,1325344.98,2146699.94,3472044.92
330080,201903,1477,687,790,689620.44,789418,1479038.44
330090,201903,372,218,154,217564,153692,371256
330093,201903,278,126,152,126746,151697.88,278443.88
330095,201903,96,50,46,49900,45908,95808
330100,201903,9592,4969,4623,4972039.53,4625730.4,9597769.93
330110,201903,498,215,283,214570.7,284430,499000.7
330115,201903,559,302,257,301396,257484,558880
330120,201903,375,188,187,187624,187625.6,375249.6
330130,201903,1537,408,1129,409180.6,1126742.96,1535923.56
330140,201903,597,315,282,314370.94,282434.6,596805.54
330150,201903,480,278,202,277444,201596,479040
330160,201903,207,128,79,128742,78842,207584
330170,201903,26912,9507,17405,9510948.77,17402139.47,26913088.24
330180,201903,233,146,87,145708,86826,232534
330185,201903,884,328,556,327344.98,555887.92,883232.90
330187,201903,319,96,223,95808,223552,319360
330190,201903,5588,2262,3326,2261471.36,3330328.08,5591799.44
330200,201903,4791,1481,3310,1482031.44,3315357.46,4797388.90
330205,201903,425,251,174,251496,173652.4,425148.4
330210,201903,1010,626,384,624750.84,384232.18,1008983.02
330220,201903,2598,1572,1026,1572849,1024946.4,2597795.4
330225,201903,554,300,254,299400,253492,552892
330227,201903,2383,761,1622,760476.4,1622751.26,2383227.66
330230,201903,219,129,90,128742,89820,218562
330240,201903,3671,1941,1730,1942115.04,1729568.12,3671683.16
330245,201903,157,72,85,71856.74,84830,156686.74
330250,201903,6754,3521,3233,3527933.47,3237516.11,6765449.58
330260,201903,559,158,401,157684,404190,561874
330270,201903,3447,1262,2185,1263468.6,2185622.8,3449091.4
330280,201903,453,292,161,292415.2,160678.98,453094.18
330285,201903,7249,2366,4883,2363265.5,4887211.32,7250476.82
330290,201903,608,230,378,230538,378242,608780
330300,201903,786,526,260,526878.96,259480.94,786359.90
330310,201903,439,248,191,248502.9,191616,440118.9
330320,201903,8195,3146,5049,3147695,5053874.4,8201569.4
330330,201903,8991,3582,5409,3581824.68,5421147.66,9002972.34
330340,201903,2712,1618,1094,1617758.6,1094806,2712564.6
330350,201903,18101,7175,10926,7173632.5,10947074.68,18120707.18
330360,201903,2349,1177,1172,1182631.54,1171653.94,2354285.48
330370,201903,1059,552,507,550897.1,508980.6,1059877.7
330380,201903,851,368,483,368262,485028.6,853290.6
330385,201903,612,321,291,321356.5,292414,613770.5
330390,201903,5308,2927,2381,2926537.97,2385220.8,5311758.77
330395,201903,297,183,114,182634,113772.7,296406.7
330400,201903,707,383,324,383233,324350,707583
330410,201903,500,363,137,364271.1,137724.4,501995.5
330411,201903,231,129,102,129740.62,102794,232534.62
330412,201903,249,104,145,103792.4,144710,248502.4
330414,201903,5972,2477,3495,2475041.68,3505975.2,5981016.88
330415,201903,581,268,313,267464,312374.6,579838.6
330420,201903,2249,1176,1073,1175645.42,1078839.38,2254484.80
330430,201903,1803,872,931,872253.2,931136.8,1803390.0
330440,201903,274,132,142,131736,142714,274450
330450,201903,117,51,66,50898,65868,116766
330452,201903,1811,858,953,856286.52,951094.4,1807380.92
330455,201903,110196,40140,70056,40167614.55,70151455.99,110319070.54
330460,201903,260,108,152,107784,151696.94,259480.94
330470,201903,1241,678,563,676645.3,563870.4,1240515.7
330475,201903,1394,379,1015,380238.6,1012970,1393208.6
330480,201903,802,429,373,428142,372254.6,800396.6
330490,201903,13806,4823,8983,4819343.1,8987995.66,13807338.76
330500,201903,1341,607,734,605786,734528.46,1340314.46
330510,201903,11117,3858,7259,3865255.46,7261451.8,11126707.26
330513,201903,103,50,53,50898,52894,103792
330515,201903,824,341,483,340319.26,484031.2,824350.46
330520,201903,2518,938,1580,937122.54,1582828,2519950.54
330530,201903,214,113,101,113772.5,100798.6,214571.1
330540,201903,363,182,181,181636.4,181636,363272.4
330550,201903,2944,1069,1875,1068858.8,1873246.8,2942105.6
330555,201903,799,306,493,306386.96,495008.6,801395.56
330560,201903,649,217,432,216566,432134.94,648700.94
330570,201903,259,184,75,183632,74850,258482
330575,201903,788,327,461,326346,462075.78,788421.78
330580,201903,3410,1924,1486,1923147.94,1490014.8,3413162.74
330590,201903,314,159,155,158682,154690.98,313372.98
330600,201903,1122,724,398,723550.4,400198,1123748.4
330610,201903,1552,851,701,851295.8,700599,1551894.8
330615,201903,198,150,48,149700,47904,197604
330620,201903,1048,438,610,440118.6,610776,1050894.6
330630,201903,4002,2559,1443,2558875.56,1443109.1,4001984.66
350010,201903,604,405,199,404190.82,198602,602792.82
350020,201903,46,22,24,21956,23952,45908
350030,201903,512,324,188,324350.4,187624.8,511975.2
350040,201903,126,49,77,48902,76846,125748
350050,201903,300,161,139,160678,139720.98,300398.98
350055,201903,83,47,36,46906,35928,82834
350060,201903,74,28,46,27944,45908,73852
350070,201903,809,483,326,483066.39,328358.2,811424.59
350075,201903,72,48,24,47904,23952,71856
350080,201903,51,31,20,30938,19960,50898
350090,201903,86,47,39,47904,39920,87824
350100,201903,291,179,112,179640,112774,292414
350110,201903,58,39,19,38922,18962,57884
350115,201903,157,94,63,93812,62874,156686
350120,201903,107,72,35,71856,34930,106786
350130,201903,345,164,181,163672.58,180638.9,344311.48
350140,201903,39,25,14,24950,13972,38922
350150,201903,70,54,16,53892,15968,69860
350160,201903,2566,1015,1551,1015968.27,1555889.92,2571858.19
350170,201903,401,242,159,242514.4,158682.4,401196.8
350180,201903,182,98,84,97804,83832,181636
350190,201903,1032,552,480,554889.59,480038.4,1034927.99
350200,201903,68,25,43,24950,42914,67864
350210,201903,1306,737,569,737524.99,571854.63,1309379.62
350220,201903,669,569,100,567862.63,100798,668660.63
350230,201903,81,55,26,54890,25948,80838
350240,201903,62,45,17,44910,17964,62874
350250,201903,1184,583,601,581835.4,602793.1,1184628.5
350260,201903,89,65,24,64870,23952,88822
350270,201903,838,552,286,551894.6,286426.4,838321.0
350275,201903,308,127,181,126746.2,180638,307384.2
350280,201903,4666,2390,2276,2391225.34,2280434.95,4671660.29
350290,201903,420,196,224,195608,223552.4,419160.4
350300,201903,59,31,28,30938,27944,58882
350310,201903,98,63,35,62874,35928,98802
350315,201903,40,25,15,24950,14970,39920
350320,201903,3258,1604,1654,1604784.9,1650693,3255477.9
350330,201903,1672,904,768,903192.2,774449.2,1677641.4
350335,201903,21,14,7,13972,6986,20958
350340,201903,134,62,72,62874,71856.3,134730.3
350350,201903,94,47,47,46906,46906,93812
350360,201903,126,83,43,83832.99,42914,126746.99
350370,201903,86,51,35,50898.63,34930,85828.63
350380,201903,763,323,440,322354.8,441116,763470.8
350390,201903,1512,611,901,611775.43,903190.4,1514965.83
350395,201903,26,21,5,20958,4990,25948
350400,201903,1687,873,814,874250.56,819359.62,1693610.18
350410,201903,2354,1059,1295,1057880.4,1298399.59,2356279.99
350420,201903,238,147,91,146707.03,91816,238523.03
350430,201903,75,46,29,45908,28942,74850
350440,201903,147,107,40,106786.4,39920,146706.4
350450,201903,1651,1013,638,1015967.07,636725.2,1652692.27
350460,201903,332,124,208,124750,208582,333332
350470,201903,17,11,6,10978,5988,16966
350480,201903,172,94,78,93812,77844,171656
350490,201903,233,119,114,118762,113772,232534
350500,201903,43,19,24,18962,23952,42914
350510,201903,165,111,54,110778,54890,165668
350520,201903,447,216,231,215568,231536,447104
350530,201903,441,206,235,206586,236526,443112
350535,201903,79,64,15,63872,14970,78842
350540,201903,383,192,191,191616,191616,383232
350550,201903,2717,1605,1112,1604786.91,1114771.39,2719558.30
350560,201903,651,455,196,455088.63,196606,651694.63
350570,201903,4103,1746,2357,1744505.63,2356280.93,4100786.56
350580,201903,386,183,203,183632.63,202594.99,386227.62
350590,201903,919,503,416,502992.4,418162.4,921154.8
350600,201903,6182,3096,3086,3103785.16,3091807.37,6195592.53
350610,201903,1541,812,729,814369.26,730536.98,1544906.24
350620,201903,35,23,12,22954,11976,34930
350630,201903,235,137,98,136726.63,98802.63,235529.26
350635,201903,907,374,533,374250.4,534928.8,909179.2
350640,201903,122,92,30,91816,29940,121756
350650,201903,1902,1259,643,1262471.18,645706.98,1908178.16
350660,201903,759,333,426,332334,427144.99,759478.99
350670,201903,315,159,156,158682,155688,314370
350680,201903,182,95,87,95808,86826,182634
350690,201903,200,103,97,102794,96806,199600
350700,201903,772,367,405,368262.71,404190,772452.71
350710,201903,349,132,217,131736,216566,348302
350715,201903,55,44,11,43912,10978,54890
350720,201903,17,11,6,10978,5988,16966
350730,201903,46,29,17,28942,16966,45908
350740,201903,207,115,92,114770,91816,206586
350745,201903,19,10,9,9980.44,8982,18962.44
350750,201903,2157,1372,785,1374248.2,787422,2161670.2
350760,201903,3730,1650,2080,1648696.66,2083824.4,3732521.06
350770,201903,61,43,18,42914,17964,60878
350775,201903,49,35,14,34930,13972.98,48902.98
350780,201903,433,216,217,215568,216755,432323
350790,201903,370,155,215,155688,214570,370258
350800,201903,450,263,187,262474,188622,451096
350810,201903,517,414,103,413172.63,102794,515966.63
350820,201903,88,54,34,53892,33932,87824
350830,201903,82,44,38,44910,37924,82834
350840,201903,775,328,447,328342.4,446107.38,774449.78
350850,201903,1762,1018,744,1017960.5,744511.93,1762472.43
350860,201903,588,339,249,339322.46,248502,587824.46
350870,201903,440,300,140,300398,139720,440118
350880,201903,279,154,125,153692,124750,278442
350890,201903,41,27,14,26946,13972,40918
350900,201903,1453,465,988,464071.36,988020,1452091.36
350910,201903,22,13,9,12974,8982,21956
350920,201903,626,339,287,339320,287424,626744
350925,201903,1216,654,562,653690.78,561875.2,1215565.98
350930,201903,101,61,40,60878,39920,100798
350940,201903,725,401,324,401196,325348.36,726544.36
350945,201903,107,78,29,77844,28942,106786
350950,201903,16024,7775,8249,7776421.71,8256460.81,16032882.52
350960,201903,1280,595,685,596804.4,689618.99,1286423.39
350970,201903,1139,591,548,589712.03,548900.8,1138612.83
350980,201903,95,65,30,64870,29940,94810
350990,201903,373,134,239,133732,239520,373252
350995,201903,35,16,19,15968,18962,34930
351000,201903,634,439,195,438123.26,194610,632733.26
351010,201903,50,31,19,30938,18962,49900
351015,201903,55,38,17,37924,16966,54890
351020,201903,1647,984,663,984028.99,664668,1648696.99
351030,201903,351,237,114,236526,114770,351296
351040,201903,860,453,407,453092.98,408182.11,861275.09
351050,201903,3344,1544,1800,1547903.64,1806388.88,3354292.52
351060,201903,5053,2076,2977,2075842.36,2983026.56,5058868.92
351070,201903,410,257,153,257484.97,152694,410178.97
351080,201903,787,568,219,570856,219560,790416
351090,201903,57,26,31,25948,30938,56886
351100,201903,442,255,187,255488.68,187624,443112.68
351110,201903,2079,999,1080,1000006.38,1081849.06,2081855.44
351120,201903,71,35,36,34930,35928,70858
351130,201903,172,59,113,59880,113772,173652
351140,201903,333,230,103,230538,102794,333332
351150,201903,426,231,195,230538.7,194610,425148.7
351160,201903,261,177,84,176646.4,83832,260478.4
351170,201903,186,105,81,104790,80838,185628
351190,201903,85,58,27,57884,26946,84830
351200,201903,364,242,122,241516.4,121756,363272.4
351210,201903,122,60,62,59880,61876,121756
351220,201903,533,317,216,317366.16,215568,532934.16
351230,201903,285,202,83,202594,82834,285428
351240,201903,227,100,127,99800,128742,228542
351250,201903,74,53,21,52894.53,20958,73852.53
351260,201903,152,113,39,113772,39920,153692
351270,201903,50,20,30,19960,29940,49900
351280,201903,1078,494,584,493013.26,585827.61,1078840.87
351290,201903,230,105,125,104790,124750.4,229540.4
351300,201903,3714,1729,1985,1730455.15,1987019.62,3717474.77
351310,201903,760,392,368,392214,369260,761474
351320,201903,114,69,45,68862,46906,115768
351330,201903,39,26,13,25948,12974,38922
351340,201903,1244,759,485,759479,484032.95,1243511.95
351350,201903,2536,1483,1053,1482031.7,1054886,2536917.7
351360,201903,779,390,389,389220,390218,779438
351370,201903,383,194,189,193612,189620,383232
351380,201903,9107,4154,4953,4155678.93,4960065.79,9115744.72
351385,201903,29,18,11,17964,10978,28942
351390,201903,286,215,71,215568.31,70858,286426.31
351400,201903,65,40,25,39920,24952.94,64872.94
351410,201903,442,277,165,276446.6,164670,441116.6
351420,201903,62,50,12,49900,11976,61876
351430,201903,69,39,30,38922,29940,68862
351440,201903,792,556,236,557884.96,235528.99,793413.95
351450,201903,257,131,126,130738,125748,256486
351460,201903,115,52,63,51896,62874,114770
351470,201903,133,70,63,69860,62874,132734
351480,201903,519,289,230,288423.36,229540,517963.36
351490,201903,283,104,179,103792,178642,282434
351492,201903,33,23,10,22954,9980,32934
351495,201903,27,19,8,18962,7984,26946
351500,201903,3569,1519,2050,1517959,2053885.36,3571844.36
351510,201903,1855,766,1089,765467.39,1090814.4,1856281.79
351512,201903,20,16,4,15968,3992,19960
351515,201903,197,114,83,113772,82834.96,196606.96
351518,201903,791,494,297,499000.99,298402,797402.99
351519,201903,71,45,26,44910,25948,70858
351520,201903,146,90,56,89820,55888,145708
351530,201903,22,15,7,14970,6986,21956
351535,201903,128,72,56,71856,55888,127744
351540,201903,452,323,129,322355.05,128742,451097.05
351550,201903,1367,831,536,830337.66,536924,1367261.66
351560,201903,73,40,33,39920,32934.96,72854.96
351565,201903,9,6,3,5988,2994,8982
351570,201903,2676,1396,1280,1395206.38,1281435.96,2676642.34
351580,201903,40,36,4,35928,3992,39920
351590,201903,66,44,22,43912,21956,65868
351600,201903,194,145,49,144710,48902,193612
351610,201903,60,28,32,27944,31936,59880
351620,201903,5914,3363,2551,3368254.21,2553883.44,5922137.65
351630,201903,2671,1381,1290,1379236.9,1292410.4,2671647.3
351640,201903,1762,845,917,845306.49,916165.03,1761471.52
351650,201903,33,28,5,28942,4990,33932
351660,201903,141,91,50,90818,49900,140718
351670,201903,706,433,273,434131.1,272454,706585.1
351680,201903,71,56,15,55888,14970,70858
351685,201903,34,20,14,20958,13972,34930
351690,201903,300,210,90,210578.45,89820,300398.45
351700,201903,160,113,47,112774,46906,159680
351710,201903,74,51,23,50898,22954,73852
351720,201903,130,64,66,63872,65868,129740
351730,201903,98,67,31,66866.63,30938.03,97804.66
351740,201903,726,475,251,475049.66,250498,725547.66
351750,201903,354,149,205,148702,205588,354290
351760,201903,787,600,187,599798,188622,788420
351770,201903,303,258,45,257484,44910,302394
351780,201903,165,96,69,95808.98,69860,165668.98
351790,201903,253,133,120,132734,119760,252494
351800,201903,46,30,16,29940,15968,45908
351810,201903,121,81,40,80838,39920,120758
351820,201903,860,621,239,621755.6,239521.39,861276.99
351830,201903,519,189,330,188622,331336,519958
351840,201903,1862,944,918,944109.44,917165.96,1861275.40
351850,201903,240,174,66,173652.3,65868,239520.3
351860,201903,712,486,226,487026.41,225548,712574.41
351870,201903,5574,2683,2891,2680630.74,2895201.23,5575831.97
351880,201903,18984,8091,10893,8091793.27,10920159.89,19011953.16
351885,201903,90,60,30,59880,29940,89820
351890,201903,69,58,11,57884,10978,68862
351900,201903,220,130,90,129740,89820,219560
351905,201903,78,31,47,30938,46906,77844
351907,201903,3286,1429,1857,1427141.34,1859277.56,3286418.90
351910,201903,181,76,105,75848,104790,180638
351920,201903,124,69,55,68862,54891.98,123753.98
351925,201903,91,61,30,60878,29940,90818
351930,201903,394,256,138,257484,137724,395208
351940,201903,244,112,132,112774,131736,244510
351950,201903,140,80,60,79840,59880,139720
351960,201903,903,427,476,428455,475048.4,903503.4
351970,201903,1914,1036,878,1034926.4,881235.78,1916162.18
351980,201903,150,76,74,75848,73852,149700
351990,201903,273,179,94,178642.8,94810,273452.8
352000,201903,353,217,136,219561.2,136726,356287.2
352010,201903,383,238,145,238522,145708,384230
352020,201903,191,68,123,67864,122754,190618
352030,201903,1070,556,514,554888,519958,1074846
352040,201903,584,249,335,248502,335328,583830
352042,201903,285,91,194,91816,194610.8,286426.8
352044,201903,371,220,151,219560,150698,370258
352050,201903,3335,1319,2016,1318360.76,2016958.4,3335319.16
352060,201903,103,64,39,63872,38922.4,102794.4
352070,201903,95,70,25,69861.26,25948,95809.26
352080,201903,65,39,26,38922,25948,64870
352090,201903,167,112,55,111776,54890,166666
352100,201903,264,125,139,125749.39,139722.38,265471.77
352110,201903,115,35,80,34930,79840,114770
352115,201903,65,24,41,23952,40918,64870
352120,201903,92,65,27,64870.63,26946,91816.63
352130,201903,219,181,38,180638,37924,218562
352140,201903,188,80,108,81836,107784.4,189620.4
352150,201903,117,63,54,62874,53892,116766
352160,201903,136,85,51,84830,50898,135728
352170,201903,371,261,110,260478,110778,371256
352180,201903,605,398,207,401196,206586.99,607782.99
352190,201903,253,98,155,98802,154690,253492
352200,201903,32,17,15,16966,14970,31936
352210,201903,3910,1667,2243,1672651.31,2244504.63,3917155.94
352215,201903,53,30,23,29940,22954,52894
352220,201903,7048,2699,4349,2698594.65,4347292.79,7045887.44
352230,201903,3274,2113,1161,2113780.28,1159686.62,3273466.90
352240,201903,2296,1332,964,1332330.4,966064.9,2298395.3
352250,201903,2643,1353,1290,1353291.32,1291413.97,2644705.29
352260,201903,1024,544,480,544908.8,480038.4,1024947.2
352265,201903,60,26,34,25948,33932,59880
352270,201903,421,252,169,252494,169661.88,422155.88
352280,201903,422,270,152,269460.63,152694,422154.63
352290,201903,176,109,67,108782,66866,175648
352300,201903,95,72,23,71856,22954,94810
352310,201903,5919,2823,3096,2822348.67,3097796.29,5920144.96
352320,201903,958,503,455,504988.4,458082,963070.4
352330,201903,512,247,265,247504,265468.4,512972.4
352340,201903,1374,668,706,669658.8,705587.6,1375246.4
352350,201903,331,203,128,203592,127744.4,331336.4
352360,201903,221,94,127,94810,126746.2,221556.2
352370,201903,104,68,36,67864,35928,103792
352380,201903,120,74,46,73852,45908,119760
352390,201903,2481,1125,1356,1125744.8,1359278.18,2485022.98
352400,201903,490,215,275,214570,274450.4,489020.4
352410,201903,829,597,232,595807.26,234530,830337.26
352420,201903,107,69,38,68862,37924,106786
352430,201903,1781,807,974,808382.69,975048.21,1783430.90
352440,201903,3138,1585,1553,1586821.28,1558880.72,3145702.00
352450,201903,200,166,34,165668,33932,199600
352460,201903,600,310,290,309381.39,290418,599799.39
352470,201903,630,219,411,218562,410178.98,628740.98
352480,201903,1380,775,605,776444,604788.4,1381232.4
352490,201903,66,25,41,24950,40918,65868
352500,201903,1202,539,663,538920.34,664669.38,1203589.72
352510,201903,753,408,345,408183.26,344310,752493.26
352520,201903,596,269,327,269460,328342,597802
352530,201903,1717,911,806,914168,805386.4,1719554.4
352540,201903,74,50,24,49900,23952,73852
352550,201903,181,106,75,105788,75848,181636
352560,201903,50,39,11,38922,10978,49900
352570,201903,679,349,330,348303.03,331336,679639.03
352580,201903,57,41,16,40918,16966,57884
352585,201903,20,8,12,7984,11976,19960
352590,201903,4410,2229,2181,2229532.31,2184624.18,4414156.49
352600,201903,348,245,103,244510.63,104790,349300.63
352610,201903,969,435,534,435128.97,533930,969058.97
352620,201903,973,396,577,397204,577842,975046
352630,201903,172,64,108,63872,107784,171656
352640,201903,545,377,168,379240,167664,546904
352650,201903,89,60,29,59880,29940,89820
352660,201903,76,46,30,45908,30938,76846
352670,201903,1652,903,749,903191.59,751504.89,1654696.48
352680,201903,908,582,326,582833.83,327344.6,910178.43
352690,201903,4424,2033,2391,2035923.15,2400190.63,4436113.78
352700,201903,117,72,45,71856,44910,116766
352710,201903,1365,741,624,740516,625746.99,1366262.99
352720,201903,1335,640,695,643710,697602.4,1341312.4
352725,201903,23,21,2,20958,1996,22954
352730,201903,386,201,185,200598,184630,385228
352740,201903,423,273,150,274450.96,150698.68,425149.64
352750,201903,22,14,8,13972,7984,21956
352760,201903,190,130,60,130738,61876,192614
352770,201903,80,63,17,62874,16966,79840
352780,201903,76,40,36,39920,35928,75848
352790,201903,29,23,6,22954.63,5988,28942.63
352800,201903,244,173,71,172654,73852,246506
352810,201903,163,104,59,104791.26,58882,163673.26
352820,201903,64,52,12,51896,11976,63872
352830,201903,90,63,27,62874,26946,89820
352840,201903,650,343,307,343312.5,307384,650696.5
352850,201903,1408,497,911,496006,914168,1410174
352860,201903,133,85,48,84830,47904,132734
352870,201903,45,27,18,26946,17964.4,44910.4
352880,201903,189,126,63,125748.9,62874,188622.9
352885,201903,31,23,8,22954,7984,30938
352890,201903,58,40,18,39920,17964.4,57884.4
352900,201903,4790,2334,2456,2333330.82,2466065.82,4799396.64
352910,201903,37,30,7,29940,6986,36926
352920,201903,681,416,265,417164,266466,683630
352930,201903,1228,594,634,593821.76,636769.98,1230591.74
352940,201903,6452,2724,3728,2728536.01,3731529.09,6460065.10
352950,201903,94,37,57,37924,56886,94810
352960,201903,62,42,20,41916,19960,61876
352965,201903,18,8,10,7984,9980,17964
352970,201903,499,377,122,377244.02,122755.61,499999.63
352980,201903,167,89,78,88822,78842,167664
352990,201903,980,441,539,442114,538920.4,981034.4
353000,201903,64,29,35,28942,34930,63872
353010,201903,551,342,209,342314,211576,553890
353020,201903,287,209,78,208582,77844,286426
353030,201903,1254,577,677,576844,677642.98,1254486.98
353040,201903,93,58,35,57884,34930,92814
353050,201903,1310,840,470,839319.42,469060,1308379.42
353060,201903,8442,3792,4650,3791411.26,4653684.88,8445096.14
353070,201903,1678,1082,596,1079838.96,598622.35,1678461.31
353080,201903,1306,690,616,693611.16,615766,1309377.16
353090,201903,57,32,25,31936,24950,56886
353100,201903,58,48,10,47904,9980,57884
353110,201903,2034,641,1393,642712.4,1396203.19,2038915.59
353120,201903,90,49,41,48902,40918,89820
353130,201903,863,419,444,418165.74,444111.96,862277.70
353140,201903,569,230,339,230538,339320,569858
353150,201903,355,201,154,200598,153692,354290
353160,201903,96,79,17,78842,16966,95808
353170,201903,190,63,127,62874,126747.96,189621.96
353180,201903,979,458,521,457084.4,521954.7,979039.1
353190,201903,495,354,141,354290.3,140718.4,495008.7
353200,201903,206,108,98,107784,97804,205588
353205,201903,23,17,6,16966,5988,22954
353210,201903,83,50,33,49900,32934,82834
353215,201903,53,30,23,29940,22954,52894
353220,201903,81,47,34,46906,33932,80838
353230,201903,160,65,95,64870,94810,159680
353240,201903,295,162,133,161676,132734,294410
353250,201903,203,106,97,106786,96806,203592
353260,201903,455,325,130,324351.1,130738,455089.1
353270,201903,66,50,16,49900,15968,65868
353280,201903,98,54,44,53892.6,43912,97804.6
353282,201903,127,88,39,87824,38922,126746
353284,201903,24,19,5,18962,4990,23952
353286,201903,0,0,0,0,0,0
353290,201903,74,43,31,42914,30938,73852
353300,201903,427,234,193,233533.26,192614,426147.26
353310,201903,48,42,6,41916,5988,47904
353320,201903,61,39,22,38922,21956,60878
353325,201903,56,33,23,32934,22955.36,55889.36
353330,201903,65,46,19,45908.7,18962,64870.7
353340,201903,613,212,401,211576,402195.39,613771.39
353350,201903,918,439,479,438124.6,480040.76,918165.36
353360,201903,108,88,20,87824,19960.4,107784.4
353370,201903,122,68,54,67864,53892,121756
353380,201903,29,20,9,19960.99,8982,28942.99
353390,201903,1119,541,578,541914,580836,1122750
353400,201903,45,27,18,26946,17964,44910
353410,201903,111,70,41,69860,41916.9,111776.9
353420,201903,59,24,35,23952,34930,58882
353430,201903,580,388,192,388223.38,191616,579839.38
353440,201903,10669,4750,5919,4756474,5918152.32,10674626.32
353450,201903,55,31,24,30938,23952,54890
353460,201903,593,328,265,327344.1,264470,591814.1
353470,201903,2139,1156,983,1156686.19,983033.96,2139720.15
353475,201903,229,152,77,152695.38,77844,230539.38
353480,201903,184,152,32,151696,31936,183632
353490,201903,236,140,96,142714,95808,238522
353500,201903,193,112,81,111776.63,80838,192614.63
353510,201903,99,72,27,71856.98,26946,98802.98
353520,201903,207,143,64,142714,64870,207584
353530,201903,470,251,219,250498,218562,469060
353540,201903,374,250,124,249500,123752,373252
353550,201903,743,490,253,489021.24,253492,742513.24
353560,201903,622,259,363,258482,365268,623750
353570,201903,61,32,29,31936.4,28942,60878.4
353580,201903,356,272,84,272454.74,83832,356286.74
353590,201903,86,58,28,57884,27944,85828
353600,201903,267,152,115,153692.63,114770,268462.63
353610,201903,118,64,54,63872,53892,117764
353620,201903,603,315,288,315368,290418,605786
353625,201903,52,31,21,30938,20958,51896
353630,201903,237,173,64,172654.58,64870,237524.58
353640,201903,128,87,41,86826,40918,127744
353650,201903,903,357,546,356286,544908,901194
353657,201903,26,20,6,19960,5988,25948
353660,201903,258,140,118,139720,117764,257484
353670,201903,780,470,310,471057.03,310378.4,781435.43
353680,201903,108,76,32,75848.5,31936,107784.5
353690,201903,45,36,9,35928.52,8982,44910.52
353700,201903,278,199,79,198602.09,78842,277444.09
353710,201903,461,220,241,220558.6,241516.4,462075.0
353715,201903,47,33,14,32934,13972,46906
353720,201903,352,166,186,165668.98,185628,351296.98
353730,201903,1119,691,428,689619.6,427144,1116763.6
353740,201903,641,350,291,349300.47,292414,641714.47
353750,201903,86,55,31,54890,30938,85828
353760,201903,2818,1086,1732,1088820.75,1735524.18,2824344.93
353770,201903,90,74,16,73852,15968,89820
353780,201903,1238,600,638,599798.63,638720,1238518.63
353790,201903,518,308,210,307384.96,210578.4,517963.36
353800,201903,3286,1655,1631,1657681.89,1633798.2,3291480.09
353810,201903,235,135,100,134730.98,99800.98,234531.96
353820,201903,200,97,103,98802,102794,201596
353830,201903,46,39,7,38922,6986,45908
353850,201903,169,86,83,85828,83832,169660
353860,201903,493,224,269,223552,268462,492014
353870,201903,5257,2679,2578,2677640.39,2585822.03,5263462.42
353880,201903,683,485,198,484030.4,198602,682632.4
353890,201903,584,338,246,337324.4,245508.84,582833.24
353900,201903,134,70,64,69860,63872,133732
353910,201903,172,84,88,83832,88822,172654
353920,201903,448,249,199,248502.3,198602.99,447105.29
353930,201903,1004,598,406,599798,408184.14,1007982.14
353940,201903,186,101,85,100798,86826,187624
353950,201903,528,324,204,323352,205588.98,528940.98
353960,201903,70,57,13,56886,12974,69860
353970,201903,71,40,31,39920,30938,70858
353980,201903,1606,782,824,781434,823353.96,1604787.96
353990,201903,73,41,32,40918,31936,72854
354000,201903,367,185,182,184630.6,181636.99,366267.59
354010,201903,91,50,41,49900,40918,90818
354020,201903,528,338,190,337324,190618,527942
354025,201903,49,39,10,38922,9980,48902
354030,201903,63,37,26,36926,25948,62874
354040,201903,97,70,27,69860,26946,96806
354050,201903,192,102,90,101796.4,90818,192614.4
354060,201903,758,366,392,367264.4,392214.4,759478.8
354070,201903,931,556,375,555887.28,376246,932133.28
354075,201903,221,113,108,112774.4,107784,220558.4
354080,201903,299,125,174,125748,173652,299400
354085,201903,21,13,8,12974,7984,20958
354090,201903,304,168,136,169576,136726,306302
354100,201903,5558,2408,3150,2412168.23,3155678.92,5567847.15
354105,201903,89,45,44,44910,43912,88822
354110,201903,46,20,26,19960,25948,45908
354120,201903,133,94,39,93812.98,38922.4,132735.38
354130,201903,707,461,246,461076,246507.39,707583.39
354140,201903,3131,1456,1675,1459076.6,1679634.99,3138711.59
354150,201903,635,395,240,395209.76,239520,634729.76
354160,201903,697,446,251,445108,251496.4,696604.4
354165,201903,23,15,8,14970,7984,22954
354170,201903,176,120,56,120758,55888,176646
354180,201903,66,40,26,39920.51,25948,65868.51
354190,201903,205,91,114,90818,113772,204590
354200,201903,119,65,54,64870,53892,118762
354210,201903,63,30,33,29940,32934,62874
354220,201903,641,399,242,399200,242514.4,641714.4
354230,201903,159,67,92,66866,92814,159680
354240,201903,321,211,110,211576.64,109780,321356.64
354250,201903,86,52,34,51896,33932,85828
354260,201903,2036,953,1083,951098.03,1084826.87,2035924.90
354270,201903,96,71,25,70858,24950,95808
354280,201903,43,23,20,22954,19960,42914
354290,201903,137,93,44,92814,43912,136726
354300,201903,420,288,132,287424.63,131736,419160.63
354310,201903,98,72,26,71856.4,25948,97804.4
354320,201903,189,99,90,98802,89820.4,188622.4
354323,201903,14,13,1,12974,998,13972
354325,201903,111,67,44,66866.6,44910,111776.6
354330,201903,2625,868,1757,870114.8,1758478.01,2628592.81
354340,201903,10645,5218,5427,5220560.03,5430124.7,10650684.73
354350,201903,128,83,45,82834,44910,127744
354360,201903,87,48,39,47904,38922,86826
354370,201903,260,145,115,145708,114770,260478
354380,201903,202,120,82,119760,81836,201596
354390,201903,2719,993,1726,993010.99,1729535.97,2722546.96
354400,201903,319,168,151,167664,150698.8,318362.8
354410,201903,612,293,319,292414.4,318362.4,610776.8
354420,201903,278,176,102,175648,101796,277444
354425,201903,316,183,133,182634,132734,315368
354430,201903,182,110,72,109780,71856,181636
354440,201903,34,25,9,24950,8982,33932
354450,201903,47,34,13,33932,12974,46906
354460,201903,103,60,43,59880,42914,102794
354470,201903,41,25,16,24950,15968,40918
354480,201903,117,61,56,60878.98,55888,116766.98
354490,201903,145,89,56,88822,55888,144710
354500,201903,392,195,197,195608,199600,395208
354510,201903,93,68,25,68862,24950,93812
354515,201903,35,12,23,12974,22954,35928
354520,201903,1616,707,909,705444.4,910176.8,1615621.2
354530,201903,697,353,344,353292.99,344310,697602.99
354540,201903,275,153,122,152694,122754,275448
354550,201903,41,25,16,24950,16966,41916
354560,201903,155,84,71,84830,70858,155688
354570,201903,135,88,47,87824.5,46906,134730.5
354580,201903,1945,942,1003,943112.29,1004987.39,1948099.68
354600,201903,253,145,108,145708.2,108782,254490.2
354610,201903,73,63,10,63872.46,9980.98,73853.44
354620,201903,60,18,42,17964,41916,59880
354625,201903,18,12,6,11976,5988.99,17964.99
354630,201903,317,213,104,213572.98,103792,317364.98
354640,201903,805,525,280,524948.3,279440,804388.3
354650,201903,74,41,33,40918,32934.98,73852.98
354660,201903,806,600,206,598801.03,208582,807383.03
354670,201903,261,92,169,91816.76,170658.6,262475.36
354680,201903,1279,479,800,479405.93,803390,1282795.93
354690,201903,80,51,29,50898.4,28942,79840.4
354700,201903,74,54,20,53892,19960,73852
354710,201903,48,34,14,33932,14970,48902
354720,201903,20,20,0,19960,0,19960
354730,201903,1783,768,1015,771455.78,1016962.4,1788418.18
354740,201903,63,44,19,43912,18962,62874
354750,201903,434,255,179,255488.98,179640.4,435129.38
354760,201903,495,302,193,305389.46,192614.31,498003.77
354765,201903,10,5,5,4990,4990,9980
354770,201903,340,222,118,222554,117764,340318
354780,201903,8035,3270,4765,3271456.4,4771466.08,8042922.48
354790,201903,108,63,45,62874,44910,107784
354800,201903,440,239,201,239520,200598.4,440118.4
354805,201903,102,50,52,49900,51896,101796
354810,201903,117,71,46,70858,46906,117764
354820,201903,191,83,108,82834.56,107784,190618.56
354830,201903,39,20,19,19960,18962,38922
354840,201903,60,40,20,39920,19960,59880
354850,201903,4553,2071,2482,2081829.2,2485020.4,4566849.6
354860,201903,334,161,173,160678,172654.93,333332.93
354870,201903,12576,5655,6921,5658672.94,6930121.31,12588794.25
354880,201903,3056,1146,1910,1143708.4,1912173.34,3055881.74
354890,201903,2899,1600,1299,1600796.27,1302390.99,2903187.26
354900,201903,63,42,21,41916,20958,62874
354910,201903,1249,666,583,667663.03,582832,1250495.03
354920,201903,50,42,8,41916,7984,49900
354925,201903,13,8,5,7984,5988,13972
354930,201903,31,28,3,27944.39,2994,30938.39
354940,201903,840,612,228,614020,227544,841564
354950,201903,209,137,72,137724.6,71856,209580.6
354960,201903,160,63,97,62874,96806.4,159680.4
354970,201903,922,615,307,615766.97,306386.4,922153.37
354980,201903,8521,3152,5369,3151687.96,5375236.47,8526924.43
354990,201903,8997,4260,4737,4260469.49,4734564.98,8995034.47
354995,201903,551,191,360,191616,359280,550896
355000,201903,483,168,315,168662,315368,484030
355010,201903,611,382,229,382234.4,228543.23,610777.63
355020,201903,746,464,282,463072.32,282436.38,745508.70
355030,201903,209356,81808,127548,81819641.07,127710262.49,209529903.56
355040,201903,736,344,392,344310.5,392214,736524.5
355050,201903,149,99,50,98803.4,49900,148703.4
355060,201903,1602,818,784,818361.2,787422.6,1605783.8
355070,201903,1439,702,737,702593.81,736525.61,1439119.42
355080,201903,205,122,83,121756,83832,205588
355090,201903,284,178,106,177644.78,107784.32,285429.10
355100,201903,4827,2393,2434,2396103.92,2437118.19,4833222.11
355110,201903,264,172,92,171657.39,91816,263473.39
355120,201903,85,63,22,62874,21956.98,84830.98
355130,201903,58,33,25,32934,24950,57884
355140,201903,187,121,66,120758,65868,186626
355150,201903,691,414,277,413173.39,276446.69,689620.08
355160,201903,471,227,244,227544.63,243512,471056.63
355170,201903,2089,1100,989,1099796,989018,2088814
355180,201903,651,277,374,276446,373252,649698
355190,201903,221,153,68,153692,67864,221556
355200,201903,117,67,50,66866,49900,116766
355210,201903,695,400,295,402194.8,295408.98,697603.78
355220,201903,7025,3728,3297,3732526.48,3302384.2,7034910.68
355230,201903,107,64,43,63872,42914,106786
355240,201903,4398,1897,2501,1897202.62,2503985,4401187.62
355250,201903,5556,2662,2894,2663664.87,2907179.65,5570844.52
355255,201903,48,31,17,30938,16966,47904
355260,201903,182,108,74,107784.4,73853.96,181638.36
355270,201903,166,103,63,102794,62874,165668
355280,201903,6283,2618,3665,2616758.8,3667652.76,6284411.56
355290,201903,74,57,17,57884,16966,74850
355300,201903,191,123,68,122754,67864.4,190618.4
355310,201903,111,61,50,61876,49900,111776
355320,201903,89,48,41,47904,40918,88822
355330,201903,282,161,121,160678,121756,282434
355340,201903,1570,526,1044,524948.4,1043908,1568856.4
355350,201903,132,69,63,68862,62874,131736
355360,201903,176,113,63,112774,62874,175648
355365,201903,25,20,5,19960,4990,24950
355370,201903,1042,601,441,600810.58,442124.18,1042934.76
355380,201903,797,525,272,523950,271456,795406
355385,201903,66,46,20,45908,19960,65868
355390,201903,105,62,43,64870,42914,107784
355395,201903,186,111,75,110778.47,75848,186626.47
355400,201903,1615,988,627,989936.53,628741.99,1618678.52
355410,201903,4882,2323,2559,2324614.08,2562870.14,4887484.22
355420,201903,49,35,14,34930,13972,48902
355430,201903,352,213,139,212574,139720,352294
355440,201903,81,49,32,48902,31936,80838
355450,201903,449,221,228,221556.48,227544.4,449100.88
355460,201903,65,50,15,49900.54,14970,64870.54
355465,201903,49,31,18,30938,17964,48902
355470,201903,182,73,109,72854.7,108782,181636.7
355475,201903,14,9,5,8982,4990,13972
355480,201903,469,210,259,209580.6,259480,469060.6
355490,201903,114,81,33,80838,33932,114770
355495,201903,57,30,27,29940,27944,57884
355500,201903,1636,921,715,922155.69,716566.96,1638722.65
355510,201903,271,197,74,196607.26,73852,270459.26
355520,201903,30,22,8,21956.4,7984,29940.4
355530,201903,22,15,7,14970,6986,21956
355535,201903,77,37,40,36926,39920,76846
355540,201903,2366,940,1426,940257.11,1427141.61,2367398.72
355550,201903,61,37,24,36926,23952,60878
355560,201903,245,117,128,116766,128742,245508
355570,201903,26,18,8,17964,8982,26946
355580,201903,258,177,81,176646,81837.39,258483.39
355590,201903,22,14,8,13972,7984,21956
355600,201903,273,140,133,139720,133732.4,273452.4
355610,201903,228,154,74,153692,74850,228542
355620,201903,1342,651,691,651694.4,689618.99,1341313.39
355630,201903,437,323,114,323352,114770.63,438122.63
355635,201903,124,62,62,61876,61877.97,123753.97
355640,201903,561,318,243,318362,243512,561874
355645,201903,834,354,480,353292,481036.4,834328.4
355650,201903,2085,885,1200,886225.74,1201592.98,2087818.72
355660,201903,252,140,112,139720,111776,251496
355670,201903,534,214,320,213572,319360,532932
355680,201903,206,117,89,116766.97,88822.4,205589.37
355690,201903,90,43,47,42914,47904.67,90818.67
355695,201903,12,9,3,8982,2994,11976
355700,201903,1140,593,547,592812.66,547902.8,1140715.46
355710,201903,2232,1233,999,1233530.63,998998,2232528.63
355715,201903,18,15,3,14970,2994,17964
355720,201903,199,119,80,118762.44,80838,199600.44
355730,201903,98,58,40,57884,40918,98802
410010,201903,131,110,21,109780,20958,130738
410020,201903,104,89,15,88822,14970,103792
410030,201903,163,105,58,104790.6,57884,162674.6
410040,201903,1056,564,492,563870,491016.6,1054886.6
410045,201903,31,26,5,25948,4990,30938
410050,201903,469,266,203,265468,202594,468062
410060,201903,271,205,66,204590,65868,270458
410070,201903,310,257,53,256486,52894,309380
410080,201903,166,105,61,104790,60878,165668
410090,201903,77,69,8,68862.56,7984,76846.56
410100,201903,296,212,84,211576,83832,295408
410105,201903,45,27,18,26946,17964,44910
410110,201903,328,200,128,200598,127744,328342
410115,201903,31,21,10,20958,9980,30938
410120,201903,406,212,194,211576,194610,406186
410130,201903,48,30,18,29940,17964,47904
410140,201903,3148,1535,1613,1533928.5,1616762.6,3150691.1
410150,201903,2721,1102,1619,1102791.14,1622748.4,2725539.54
410160,201903,502,316,186,316366,185628,501994
410165,201903,69,46,23,45908,23952,69860
410170,201903,170,122,48,121756,47904,169660
410180,201903,2176,1256,920,1257480.4,923151.59,2180631.99
410185,201903,36,32,4,31936,3992,35928
410190,201903,498,328,170,328342,170658,499000
410200,201903,953,718,235,717562,234530,952092
410210,201903,571,298,273,298402,273452.4,571854.4
410220,201903,43,21,22,20958,21956,42914
410230,201903,141,73,68,72854,67864,140718
410240,201903,754,495,259,494010.8,259480.4,753491.2
410250,201903,375,276,99,275448,98802,374250
410260,201903,293,167,126,166666.4,125748,292414.4
410270,201903,31,21,10,20958,9980,30938
410275,201903,61,46,15,45908,14970,60878
410280,201903,326,188,138,187624,137724,325348
410290,201903,241,152,89,151696,88822,240518
410300,201903,80,62,18,61876,17964,79840
410302,201903,20,12,8,11976,7984,19960
410304,201903,44,30,14,29940,13972,43912
410305,201903,212,115,97,114770,96806,211576
410310,201903,272,171,101,170658,100798,271456
410315,201903,51,37,14,36926.44,13972,50898.44
410320,201903,135,94,41,93812,40918,134730
410322,201903,35,24,11,23952,10978,34930
410330,201903,173,124,49,123752,48902.6,172654.6
410335,201903,101,57,44,56886,43912,100798
410337,201903,41,35,6,34930,5988,40918
410340,201903,33,31,2,30938,1996,32934
410345,201903,222,137,85,137724,84830,222554
410347,201903,51,38,13,37924,12974,50898
410350,201903,240,145,95,144710,94810,239520
410360,201903,466,289,177,288422.8,176647.2,465070.0
410370,201903,2372,1018,1354,1017961.08,1355285.64,2373246.72
410380,201903,222,138,84,137724,83832,221556
410390,201903,375,273,102,272454.99,101796,374250.99
410395,201903,33,22,11,21956,10978,32934
410400,201903,847,421,426,421157.61,426581.5,847739.11
410405,201903,92,70,22,69860,22954,92814
410410,201903,36,28,8,27944,7984,35928
410420,201903,1663,815,848,813283.16,849298.34,1662581.50
410425,201903,173,80,93,79840.6,92814,172654.6
410430,201903,2194,1278,916,1278438.74,917162.56,2195601.30
410440,201903,380,279,101,278442,100798,379240
410442,201903,358,239,119,238522.7,118762,357284.7
410445,201903,409,289,120,288422,119760,408182
410450,201903,392,206,186,206586,186626,393212
410460,201903,466,249,217,249500,216566,466066
410465,201903,203,129,74,129740,73852,203592
410470,201903,228,146,82,145708,81836,227544
410480,201903,6002,2977,3025,2983033.3,3027944.07,6010977.37
410490,201903,1420,917,503,915167.2,501994.4,1417161.6
410500,201903,261,153,108,152694,107784,260478
410510,201903,166,125,41,124750,40918.98,165668.98
410520,201903,256,191,65,190618,64870,255488
410530,201903,230,85,145,84830,145708.99,230538.99
410540,201903,314,227,87,227544.99,86826,314370.99
410550,201903,1667,751,916,750496,917162.7,1667658.7
410560,201903,136,102,34,101796,33932,135728
410570,201903,431,294,137,293413.32,136726,430139.32
410580,201903,3265,1459,1806,1459077.32,1806381,3265458.32
410590,201903,399,282,117,282434,116766,399200
410600,201903,194,167,27,166666,26946,193612
410610,201903,59,50,9,49900,8982,58882
410620,201903,240,172,68,173652,67864,241516
410630,201903,444,265,179,264470,178642,443112
410640,201903,1034,651,383,651695.3,382234.99,1033930.29
410645,201903,102,76,26,75848.2,25948,101796.2
410650,201903,365,248,117,247504,116766,364270
410655,201903,78,59,19,58882,18962,77844
410657,201903,22,9,13,8982,12974,21956
410660,201903,608,429,179,430139.7,178642,608781.7
410670,201903,73,62,11,61876,10978,72854
410680,201903,196,164,32,163672,32934,196606
410685,201903,18,12,6,11976,5988,17964
410690,201903,28220,12185,16035,12198474.33,16070520.07,28268994.40
410700,201903,322,241,81,240518.4,80838,321356.4
410710,201903,130,108,22,107784,21956,129740
410712,201903,23,16,7,15968,6986,22954
410715,201903,90,68,22,68862,21956,90818
410720,201903,700,401,299,401196.31,301396.98,702593.29
410725,201903,181,134,47,133732,46906,180638
410730,201903,88,51,37,50898,36926,87824
410740,201903,119,87,32,86826,31936,118762
410750,201903,232,164,68,163672,67864,231536
410752,201903,24,15,9,14970,8982,23952
410753,201903,49,22,27,21956,26946,48902
410754,201903,40,25,15,24950.4,14970,39920.4
410755,201903,82,54,28,53892,27944,81836
410760,201903,744,422,322,421156.4,321356,742512.4
410765,201903,1712,826,886,824350.36,884229.2,1708579.56
410770,201903,106,83,23,82834,22954,105788
410773,201903,54,41,13,40918,12974,53892
410775,201903,183,134,49,133732,48902,182634
410780,201903,82,45,37,44910,36926,81836
410785,201903,55,43,12,42914,11976,54890
410790,201903,73,35,38,34930,37924,72854
410800,201903,285,180,105,179640.52,104790,284430.52
410810,201903,23,20,3,19960,2994.4,22954.4
410820,201903,180,131,49,130738,48902,179640
410830,201903,8511,3804,4707,3806378.52,4711568.17,8517946.69
410832,201903,106,77,29,76846,28942,105788
410840,201903,1418,792,626,791416.97,624751.44,1416168.41
410845,201903,66,43,23,42914.4,22954,65868.4
410850,201903,197,140,57,139720,56886,196606
410855,201903,49,42,7,41916,6986,48902
410860,201903,700,406,294,406186.94,294410,700596.94
410865,201903,103,79,24,79840,23952,103792
410870,201903,154,130,24,129740,23952,153692
410880,201903,1122,573,549,572857.34,549902.88,1122760.22
410890,201903,81,57,24,57884,24950,82834
410895,201903,72,56,16,55888,15968,71856
410900,201903,21,13,8,12974,7984,20958
410910,201903,14,12,2,11976,1996,13972
410920,201903,36,24,12,23952,11976,35928
410930,201903,503,321,182,320358,181636,501994
410940,201903,4337,2517,1820,2515959.84,1821350.8,4337310.64
410950,201903,111,84,27,83832,26946,110778
410960,201903,781,347,434,347304,433132,780436
410965,201903,69,55,14,54890,13972,68862
410970,201903,628,449,179,448102,178642,626744
410975,201903,110,65,45,64870.72,45908,110778.72
410980,201903,1629,743,886,741514.4,887222.99,1628737.39
410990,201903,267,186,81,185628,80838,266466
411000,201903,63,40,23,39920,22954.4,62874.4
411005,201903,26,20,6,19960,5988,25948
411007,201903,253,145,108,145708,107784,253492
411010,201903,592,412,180,412174,179640,591814
411020,201903,300,209,91,208582,90818,299400
411030,201903,16,9,7,8982,6986,15968
411040,201903,52,38,14,37924,13972,51896
411050,201903,218,168,50,167679.84,49903.52,217583.36
411060,201903,512,347,165,347304.98,166666,513970.98
411065,201903,64,55,9,54890,8982,63872
411070,201903,1208,777,431,780437.54,430138,1210575.54
411080,201903,233,164,69,163672,68862,232534
411090,201903,107,80,27,79840,26946,106786
411095,201903,280,111,169,110778,168662,279440
411100,201903,113,94,19,94810,18962,113772
411110,201903,120,83,37,82834,36926,119760
411120,201903,191,138,53,137724,52894,190618
411125,201903,203,93,110,92814,110778,203592
411130,201903,121,103,18,102794,17964,120758
411140,201903,203,135,68,134730,67864.88,202594.88
411150,201903,1237,822,415,821354,415169.03,1236523.03
411155,201903,124,82,42,81836,41916,123752
411160,201903,26,12,14,11976,13972,25948
411170,201903,53,48,5,47904,4990,52894
411180,201903,974,657,317,655686.83,316366,972052.83
411190,201903,339,192,147,191616,146706,338322
411200,201903,670,437,233,437124.63,235528,672652.63
411210,201903,702,378,324,377244,324350.98,701594.98
411220,201903,150,112,38,111776,37924,149700
411230,201903,42,36,6,35928,5988,41916
411240,201903,124,84,40,83832,39920,123752
411250,201903,438,323,115,322354,114770,437124
411260,201903,20,13,7,12974,6986,19960
411270,201903,286,152,134,152694,134730,287424
411275,201903,203,178,25,178642,24950,203592
411280,201903,224,160,64,159680.63,63872,223552.63
411290,201903,58,45,13,44910,12974,57884
411295,201903,146,115,31,114770,31936,146706
411300,201903,70,34,36,33932,35928,69860
411310,201903,91,70,21,70858,20958,91816
411320,201903,750,527,223,527942.8,222554.6,750497.4
411325,201903,62,39,23,38922,22954,61876
411330,201903,914,591,323,592812.5,324350.16,917162.66
411340,201903,27,19,8,18962,7984.34,26946.34
411342,201903,68,51,17,50898,16966,67864
411345,201903,119,61,58,60878,57884,118762
411350,201903,495,392,103,392214.58,102794.4,495008.98
411360,201903,55,35,20,34930,20958,55888
411370,201903,14316,5861,8455,5863255.4,8467049.81,14330305.21
411373,201903,181,134,47,133732,46906,180638
411375,201903,73,60,13,59880,12974,72854
411380,201903,96,74,22,73852,21956,95808
411390,201903,133,88,45,88822,44910,133732
411400,201903,365,278,87,277444.98,86826,364270.98
411410,201903,443,227,216,226546,215568.4,442114.4
411420,201903,1032,468,564,468062,564868,1032930
411430,201903,426,262,164,261476,164670.98,426146.98
411435,201903,35,24,11,23952,10978,34930
411440,201903,466,373,93,373252,92814,466066
411450,201903,427,359,68,358282,67864,426146
411460,201903,763,299,464,299405.48,465078.66,764484.14
411470,201903,84,62,22,61876,21956,83832
411480,201903,649,371,278,371256,280438,651694
411490,201903,298,191,107,191616,106786,298402
411500,201903,107,91,16,90818,15968,106786
411510,201903,232,184,48,183632,47904,231536
411520,201903,5998,2343,3655,2344305.69,3666656.92,6010962.61
411530,201903,119,84,35,84830.98,34930,119760.98
411535,201903,49,21,28,20958,27944,48902
411540,201903,359,247,112,246506,111776,358282
411545,201903,54,38,16,37924,15968,53892
411550,201903,73,57,16,57884,15968,73852
411560,201903,386,178,208,177644.44,207584,385228.44
411570,201903,788,295,493,294411.66,497004.6,791416.26
411573,201903,29,18,11,17964,10978,28942
411575,201903,288,182,106,182634,105788,288422
411580,201903,1246,499,747,500996.6,746504,1247500.6
411585,201903,72,36,36,35928,35928,71856
411590,201903,21,15,6,14970,5988,20958
411600,201903,25,11,14,10978,13972,24950
411605,201903,242,103,139,102794,139720,242514
411610,201903,210,143,67,143712,66866,210578
411620,201903,345,195,150,195608,149700,345308
411630,201903,57,40,17,39920,17964,57884
411640,201903,32,26,6,25948,5988,31936
411650,201903,12,7,5,6986,4990,11976
411660,201903,35,27,8,26946,7984,34930
411670,201903,249,186,63,185628,62874,248502
411680,201903,155,135,20,134730,20958,155688
411690,201903,587,312,275,311382.16,274453.52,585835.68
411695,201903,62,45,17,44910,16966,61876
411700,201903,152,131,21,130738,20958,151696
411705,201903,105,69,36,68862,35928,104790
411710,201903,309,208,101,207584,100798,308382
411720,201903,141,93,48,92814,47904,140718
411721,201903,61,52,9,51896,8982,60878
411722,201903,98,41,57,40918,56886,97804
411725,201903,152,118,34,117764.4,33932,151696.4
411727,201903,76,61,15,60878,14970,75848
411729,201903,33,26,7,25948,7984,33932
411730,201903,542,345,197,344310,196606,540916
411740,201903,40,25,15,24950,15968,40918
411745,201903,69,47,22,46906,22954,69860
411750,201903,866,398,468,398202.4,467064.4,865266.8
411760,201903,1201,908,293,906184.4,292414.98,1198599.38
411770,201903,449,294,155,293412,155688,449100
411780,201903,326,212,114,211576,113772,325348
411790,201903,531,300,231,299401.27,230539.96,529941.23
411800,201903,167,131,36,130738,35928,166666
411810,201903,166,126,40,125748,39920,165668
411820,201903,2147,1010,1137,1007981,1135724.6,2143705.6
411830,201903,12,12,0,11976,0,11976
411840,201903,1962,1220,742,1217560,742513.53,1960073.53
411845,201903,50,20,30,19960,29940,49900
411850,201903,1223,697,526,698600.99,526946.66,1225547.65
411860,201903,45,31,14,30938.47,13972,44910.47
411870,201903,76,53,23,53892,22954,76846
411880,201903,427,276,151,275448.25,150698,426146.25
411885,201903,105,70,35,69860,34930,104790
411890,201903,319,204,115,203593.39,115768,319361.39
411900,201903,71,52,19,51896,18962,70858
411910,201903,182,144,38,143712,37924,181636
411915,201903,2091,898,1193,901194,1191613.98,2092807.98
411920,201903,121,99,22,98802,21956,120758
411925,201903,11,8,3,7984,2994,10978
411930,201903,805,594,211,592812.74,211576,804388.74
411940,201903,595,414,181,413172,181636,594808
411950,201903,913,479,434,478042.8,434130,912172.8
411960,201903,1051,728,323,727543.3,322354,1049897.3
411965,201903,23,16,7,15968,6986,22954
411970,201903,83,76,7,75848,6986,82834
411980,201903,168,117,51,116766,50898,167664
411990,201903,5169,3000,2169,3005982.1,2170651.7,5176633.8
411995,201903,464,175,289,174650,288422,463072
412000,201903,311,194,117,194610,116766,311376
412010,201903,49,30,19,29940,18962,48902
412015,201903,46,34,12,33932,11976,45908
412020,201903,28,24,4,23952,3992,27944
412030,201903,56,49,7,48902,6986,55888
412033,201903,52,34,18,33932.44,17964,51896.44
412035,201903,67,45,22,44910,22954,67864
412040,201903,36,23,13,22954.4,12974,35928.4
412050,201903,197,150,47,149700,46906,196606
412060,201903,768,584,184,583830.88,183632,767462.88
412065,201903,48,32,16,31936,15968,47904
412070,201903,161,107,54,107784,53892,161676
412080,201903,275,145,130,144710,129740,274450
412085,201903,34,16,18,15968,17964,33932
412090,201903,779,498,281,497004.9,280438,777442.9
412100,201903,246,208,38,207584.8,37924,245508.8
412110,201903,69,53,16,52894,15968,68862
412120,201903,313,200,113,199600,113772,313372
412125,201903,82,48,34,47904,33932,81836
412130,201903,40,29,11,28942.36,10978,39920.36
412135,201903,27,16,11,15968,10978,26946
412140,201903,321,226,95,225548,96806,322354
412150,201903,246,172,74,171656.48,73852,245508.48
412160,201903,86,52,34,51896,33932,85828
412170,201903,682,481,201,480038.4,201596,681634.4
412175,201903,36,27,9,27944,8982,36926
412180,201903,195,153,42,152695.11,41916,194611.11
412190,201903,334,263,71,264470,70858,335328
412200,201903,203,126,77,125748,76846,202594
412210,201903,75,59,16,58882,15968,74850
412215,201903,227,162,65,162674,64870,227544
412217,201903,70,55,15,54890,14970,69860
412220,201903,822,611,211,609778,210578,820356
412230,201903,333,201,132,200598,131738.94,332336.94
412240,201903,1350,670,680,670677.56,679654.68,1350332.24
412250,201903,381,243,138,242514,137724,380238
412260,201903,106,78,28,77844,27944,105788
412265,201903,175,138,37,137724,36926,174650
412270,201903,74,49,25,48902,25948,74850
412280,201903,89,73,16,72854,15968,88822
412290,201903,97,66,31,65868,30938,96806
412300,201903,216,139,77,138722,76846,215568
412310,201903,45,39,6,39920,5988,45908
412320,201903,96,82,14,81836,13972,95808
412330,201903,181,158,23,157684,22954,180638
412340,201903,151,106,45,106786,44910.4,151696.4
412350,201903,602,300,302,299400,301396,600796
412360,201903,29,25,4,24950,3992,28942
412370,201903,163,142,21,141716.2,20958,162674.2
412380,201903,258,192,66,191616,65869.78,257485.78
412382,201903,51,26,25,25948,24950,50898
412385,201903,147,108,39,107784,38922,146706
412390,201903,280,212,68,211576,67864,279440
412395,201903,73,59,14,58882,13972,72854
412400,201903,77,53,24,52894,23952,76846
412402,201903,249,121,128,120758,127744,248502
412405,201903,831,319,512,318362,510976,829338
412410,201903,962,602,360,600796.4,360278,961074.4
412420,201903,14,12,2,11976,1996,13972
412430,201903,21,15,6,14970,5988,20958
412440,201903,605,333,272,334344.96,274457.44,608802.40
412450,201903,80,69,11,69860,10978,80838
412460,201903,84,62,22,61876,21956,83832
412470,201903,226,181,45,180638,44910,225548
412480,201903,159,117,42,116766.7,41916,158682.7
412490,201903,161,140,21,139720,20958,160678
412500,201903,449,372,77,371256.85,77844,449100.85
412510,201903,186,155,31,155688.4,30938,186626.4
412520,201903,86,58,28,57884,27944,85828
412530,201903,110,58,52,57884,51896,109780
412535,201903,111,80,31,79841.96,30938,110779.96
412540,201903,77,36,41,35928,40918,76846
412545,201903,93,68,25,68862,24950,93812
412550,201903,3606,1635,1971,1636720,1972049.2,3608769.2
412555,201903,13,9,4,8982,3992,12974
412560,201903,592,430,162,430138,161676,591814
412570,201903,734,401,333,402194,334330,736524
412575,201903,91,62,29,61876,28942,90818
412580,201903,168,111,57,110778,56886,167664
412590,201903,36,32,4,31936,3992,35928
412600,201903,168,126,42,126746,41916,168662
412610,201903,30,18,12,17964,11976,29940
412620,201903,149,128,21,127744,20958,148702
412625,201903,2206,1179,1027,1179637.03,1028940.39,2208577.42
412627,201903,67,52,15,51896,14970,66866
412630,201903,415,278,137,277444.07,136726,414170.07
412635,201903,63,18,45,17964,45908,63872
412640,201903,119,77,42,76846,41916,118762
412650,201903,341,219,122,219560,122754,342314
412660,201903,469,291,178,291416,177644,469060
412665,201903,49,43,6,42914,5988,48902
412667,201903,291,201,90,201600.84,90820.2,292421.04
412670,201903,63,52,11,51896,10978,62874
412680,201903,294,233,61,234530,60878.88,295408.88
412690,201903,99,64,35,64870,34930.4,99800.4
412700,201903,153,105,48,104790,48902.4,153692.4
412710,201903,1401,852,549,851296.2,548900,1400196.2
412720,201903,233,155,78,154690,77844,232534
412730,201903,183,151,32,151696,33932,185628
412740,201903,419,231,188,230538,187624,418162
412750,201903,462,268,194,267464,194610,462074
412760,201903,273,143,130,142714,129740,272454
412770,201903,2135,1204,931,1204587.23,930137.78,2134725.01
412780,201903,155,119,36,118762,35928,154690
412785,201903,260,132,128,132734,127744,260478
412788,201903,37,21,16,20958,15968,36926
412790,201903,130,108,22,107784,21956,129740
412795,201903,152,113,39,112774,38922,151696
412796,201903,316,217,99,216566,99800,316366
412800,201903,582,374,208,374250,207584,581834
412810,201903,2987,1643,1344,1642710.87,1344306,2987016.87
412820,201903,938,601,337,600796.71,339320.98,940117.69
412830,201903,14,11,3,10978,2994,13972
412840,201903,224,158,66,157684.4,66866,224550.4
412850,201903,787,523,264,522952,264470,787422
412853,201903,172,92,80,91816,79840.4,171656.4
412855,201903,218,117,101,116766.26,100798,217564.26
412860,201903,93,67,26,66866,25948,92814
412862,201903,59,44,15,43912,14970,58882
412863,201903,6,5,1,4990,998,5988
412865,201903,41,31,10,30938,9980,40918
412870,201903,107,69,38,68862,37924,106786
412880,201903,100,72,28,71856.4,27944,99800.4
420005,201903,44,39,5,38922,4990,43912
420010,201903,370,245,125,244510.3,127744.4,372254.7
420020,201903,86,71,15,70858,14970,85828
420030,201903,28,26,2,25948,1996,27944
420040,201903,111,86,25,85828,24950,110778
420050,201903,51,31,20,30938,19960,50898
420055,201903,19,18,1,17964,998,18962
420060,201903,32,24,8,23952,7984,31936
420070,201903,106,88,18,90818,17964,108782
420075,201903,10,10,0,9980,0,9980
420080,201903,49,43,6,42914,5988,48902
420090,201903,34,32,2,31936,1996,33932
420100,201903,161,137,24,136726.4,24950,161676.4
420110,201903,18,18,0,17964,0,17964
420120,201903,57,44,13,44910,12974,57884
420125,201903,84,67,17,66866,16966,83832
420127,201903,28,24,4,24950,3992,28942
420130,201903,401,251,150,250498,149700,400198
420140,201903,1310,749,561,747504.68,561875.86,1309380.54
420150,201903,42,37,5,36926,4990,41916
420160,201903,36,34,2,33932,1996,35928
420165,201903,19,14,5,13972,4990,18962
420170,201903,72,47,25,46906,24950,71856
420180,201903,24,22,2,21956,1996,23952
420190,201903,30,26,4,25948,3992,29940
420195,201903,126,61,65,60878,64870,125748
420200,201903,1270,563,707,561874.4,706589.84,1268464.24
420205,201903,69,40,29,39920,28942,68862
420207,201903,114,64,50,63872.5,49900,113772.5
420208,201903,21,17,4,16966,3992,20958
420209,201903,20,16,4,15968,3992,19960
420210,201903,468,230,238,229540,237524.98,467064.98
420213,201903,50,39,11,38922,10978,49900
420215,201903,28,24,4,23952,3992,27944
420220,201903,64,41,23,41916,22954,64870
420230,201903,812,463,349,463072,348302.98,811374.98
420240,201903,2279,1526,753,1524947.14,753490,2278437.14
420243,201903,40,32,8,31936,7984,39920
420245,201903,134,72,62,71856,61876,133732
420250,201903,60,37,23,36926,22954,59880
420253,201903,40,32,8,31936,8982,40918
420257,201903,13,11,2,10978,1996,12974
420260,201903,105,90,15,89820,14970,104790
420270,201903,40,31,9,30938.99,8982,39920.99
420280,201903,281,209,72,210582.62,71858.66,282441.28
420285,201903,20,11,9,10978,8982,19960
420287,201903,56,35,21,34930,20958,55888
420290,201903,968,681,287,679638.99,288426.95,968065.94
420300,201903,1422,1136,286,1136723.74,287424.98,1424148.72
420310,201903,58,44,14,43912,13972,57884
420315,201903,32,28,4,27944,3992,31936
420320,201903,873,447,426,446106,425148.99,871254.99
420325,201903,0,0,0,0,0,0
420330,201903,127,88,39,87824,38922,126746
420340,201903,163,110,53,109781.18,52894,162675.18
420350,201903,252,186,66,186626,65868,252494
420360,201903,754,570,184,570856.98,184632.46,755489.44
420370,201903,116,72,44,71856,43912.4,115768.4
420380,201903,1145,816,329,816366.08,329344.72,1145710.80
420390,201903,264,182,82,181636,82834,264470
420395,201903,185,134,51,133732,50898,184630
420400,201903,250,189,61,189620.75,60878,250498.75
420410,201903,62,47,15,46906,14970,61876
420415,201903,34,30,4,29940,3992,33932
420417,201903,56,42,14,41916,13972,55888
420419,201903,12,12,0,11976,0,11976
420420,201903,2819,1744,1075,1744508.97,1079839.74,2824348.71
420425,201903,76,63,13,62874.98,12974.98,75849.96
420430,201903,1255,876,379,876245.64,379240,1255485.64
420435,201903,17,15,2,14970,1996,16966
420440,201903,103,72,31,72854.4,30938,103792.4
420445,201903,22,21,1,20958,998,21956
420450,201903,73,37,36,36926,35928,72854
420455,201903,214,164,50,163674.94,50900.94,214575.88
420460,201903,2337,1539,798,1539921.7,798407.84,2338329.54
420470,201903,118,86,32,85828,31936,117764
420475,201903,6,6,0,5988,0,5988
420480,201903,873,661,212,659679.2,211576.8,871256.0
420490,201903,110,82,28,81836,27944,109780
420500,201903,611,275,336,275448.86,336326,611774.86
420510,201903,18,15,3,14970,2994,17964
420515,201903,26,19,7,19960,6986,26946
420517,201903,8,8,0,7984,0,7984
420519,201903,0,0,0,0,0,0
420520,201903,75,55,20,54890,19960,74850
420530,201903,165,111,54,110778.3,53892,164670.3
420535,201903,20,19,1,18962,998,19960
420540,201903,5221,3101,2120,3105035.23,2123745.56,5228780.79
420543,201903,27,27,0,26946,0,26946
420545,201903,198,139,59,139720,58882.98,198602.98
420550,201903,878,712,166,712574.16,165671.92,878246.08
420555,201903,40,29,11,28942,10978,39920
420560,201903,68,55,13,54890,12974,67864
420570,201903,158,96,62,95808,61876,157684
420580,201903,291,131,160,130738,159680.4,290418.4
420590,201903,512,360,152,359280,153692,512972
420600,201903,106,60,46,60878.4,45908,106786.4
420610,201903,41,38,3,37924,2994,40918
420620,201903,77,63,14,62874,13972,76846
420630,201903,156,113,43,112774,42915.98,155689.98
420640,201903,90,81,9,80838,8982,89820
420650,201903,233,121,112,121756,111776,233532
420660,201903,56,44,12,43912,11976,55888
420665,201903,38,28,10,27944,9980,37924
420670,201903,317,241,76,240518,75848.98,316366.98
420675,201903,16,15,1,14970,998,15968
420680,201903,36,26,10,25948,9980,35928
420690,201903,173,143,30,142714,29940,172654
420700,201903,691,485,206,485034.32,205595.84,690630.16
420710,201903,155,90,65,89820,65868,155688
420720,201903,113,91,22,90818.98,21956,112774.98
420730,201903,578,371,207,371260.26,207588.32,578848.58
420740,201903,48,47,1,46906,998,47904
420750,201903,517,348,169,352294,168662,520956
420757,201903,19,16,3,15968,2994,18962
420760,201903,37,31,6,30938,5988,36926
420765,201903,73,58,15,57884,14970,72854
420768,201903,53,49,4,48902,4990,53892
420770,201903,80,67,13,67864,12974,80838
420775,201903,44,40,4,39920,3992,43912
420780,201903,238,188,50,187624,50898,238522
420785,201903,12,9,3,8982,2994,11976
420790,201903,172,145,27,144714.9,26947.96,171662.86
420800,201903,70,54,16,53892,15968,69860
420810,201903,252,222,30,222554,30938,253492
420820,201903,2351,1383,968,1384227.6,967064.77,2351292.37
420830,201903,604,334,270,334331.2,269460,603791.2
420840,201903,149,112,37,111776,37924,149700
420845,201903,427,190,237,189620,238522.4,428142.4
420850,201903,239,188,51,187624,51896,239520
420860,201903,64,54,10,53892,9980,63872
420870,201903,121,87,34,86826,33932,120758
420880,201903,178,123,55,123752,55888,179640
420890,201903,903,454,449,454091.77,455088.98,909180.75
420895,201903,9,9,0,8982,0,8982
420900,201903,418,333,85,332334,85828.98,418162.98
420910,201903,5837,3291,2546,3291412.53,2545902.94,5837315.47
420915,201903,76,71,5,70858,4990,75848
420917,201903,21,15,6,14970,5988,20958
420920,201903,23,16,7,15968,6986,22954
420930,201903,2809,1740,1069,1737514.98,1073022.26,2810537.24
420940,201903,600,439,161,440118.4,160682.49,600800.89
420945,201903,10,8,2,7984,1996,9980
420950,201903,55,49,6,48902,5988,54890
420960,201903,117,93,24,92815.96,23952.98,116768.94
420970,201903,303,241,62,240521.54,61877.96,302399.50
420980,201903,23,23,0,22954,0,22954
420985,201903,64,57,7,56886,6986,63872
420990,201903,75,59,16,58882,15968,74850
421000,201903,33,21,12,20958,11976,32934
421003,201903,68,47,21,46906,20958.98,67864.98
421005,201903,7,4,3,3992,2994,6986
421010,201903,759,530,229,529939.38,229541.1,759480.48
421020,201903,25,21,4,20958,3992,24950
421030,201903,124,105,19,104790.3,18962,123752.3
421040,201903,67,55,12,55888,11976,67864
421050,201903,323,228,95,227544.4,94810,322354.4
421055,201903,25,21,4,20958,3992,24950
421060,201903,77,52,25,52894,24950,77844
421070,201903,48,44,4,43912.4,3992,47904.4
421080,201903,33,31,2,30938,1996,32934
421085,201903,25,19,6,18962,5988,24950
421090,201903,39,29,10,28942,9980,38922
421100,201903,132,98,34,97804,33932,131736
421105,201903,215,175,40,174650.98,39920.98,214571.96
421110,201903,113,92,21,91816,20958,112774
421120,201903,157,122,35,121756.98,34930,156686.98
421125,201903,18,13,5,12974,4990,17964
421130,201903,809,526,283,524948,282434.4,807382.4
421140,201903,31,23,8,22954,7984,30938
421145,201903,41,33,8,32934,7984,40918
421150,201903,105,76,29,76846,28942.8,105788.8
421160,201903,69,46,23,45908,23952,69860
421165,201903,17,16,1,15968,998,16966
421170,201903,191,162,29,162798.32,28942.98,191741.30
421175,201903,155,104,51,103792,50898,154690
421180,201903,59,39,20,38922.24,19960,58882.24
421185,201903,18,15,3,14970,2994,17964
421187,201903,0,0,0,0,0,0
421189,201903,41,30,11,30938,10978,41916
421190,201903,1619,1032,587,1033928.6,586824.8,1620753.4
421200,201903,89,66,23,65868,22954,88822
421205,201903,27,17,10,16966,9980,26946
421210,201903,170,122,48,121756,47904,169660
421220,201903,283,222,61,221556,61876,283432
421223,201903,52,43,9,42914.6,8982,51896.6
421225,201903,69,44,25,43912.6,24950,68862.6
421227,201903,84,63,21,62874,20958,83832
421230,201903,52,39,13,38922,12974,51896
421240,201903,19,19,0,18962,0,18962
421250,201903,359,221,138,221557.63,138722,360279.63
421260,201903,25,21,4,20958,3992,24950
421265,201903,1,1,0,998,0,998
421270,201903,52,46,6,45908,5988,51896
421280,201903,337,193,144,193944.66,143712,337656.66
421290,201903,325,222,103,221556,102794,324350
421300,201903,25,20,5,19960,4990,24950
421310,201903,51,38,13,37924,12974,50898
421315,201903,28,18,10,17964,9980,27944
421320,201903,137,93,44,92814,43912,136726
421330,201903,104,77,27,76846,26946.98,103792.98
421335,201903,39,27,12,27944,11976,39920
421340,201903,257,169,88,168662.82,87824,256486.82
421350,201903,193,111,82,110778.97,81836,192614.97
421360,201903,676,504,172,503991.88,171656.98,675648.86
421370,201903,195,152,43,151696,42914,194610
421380,201903,128,104,24,103792,24950,128742
421390,201903,17,12,5,11976,4990,16966
421400,201903,121,104,17,103792,16966,120758
421410,201903,20,18,2,17964,1996,19960
421415,201903,21,20,1,19960,998,20958
421420,201903,151,124,27,123752,26946,150698
421430,201903,14,10,4,9980,3992,13972
421440,201903,59,47,12,46906,11976,58882
421450,201903,91,78,13,77844,12974,90818
421460,201903,61,50,11,49900,10978,60878
421470,201903,65,43,22,42914,21956,64870
421480,201903,660,496,164,496006,163672.98,659678.98
421490,201903,23,22,1,21956.98,998,22954.98
421500,201903,502,328,174,327347.34,173666.7,501014.04
421505,201903,23,16,7,15968,6986,22954
421507,201903,36,30,6,29940,5988.4,35928.4
421510,201903,74,49,25,48902,24950,73852
421520,201903,63,54,9,53892,8982,62874
421530,201903,50,44,6,43912,5988,49900
421535,201903,27,26,1,25948.44,998,26946.44
421540,201903,58,50,8,49900,7984,57884
421545,201903,100,75,25,74850.98,24950,99800.98
421550,201903,297,217,80,216566,80838,297404
421555,201903,24,19,5,19960,4990.8,24950.8
421560,201903,8,7,1,6986,998,7984
421565,201903,121,84,37,84830,36926,121756
421567,201903,29,25,4,25948,3992,29940
421568,201903,32,30,2,29940,1996,31936
421569,201903,9,9,0,8982,0,8982
421570,201903,178,119,59,118762,58882,177644
421575,201903,28,23,5,22954,4990,27944
421580,201903,706,424,282,423152,281436,704588
421590,201903,21,20,1,19960,998,20958
421600,201903,130,80,50,79840,49900.8,129740.8
421605,201903,110,78,32,77844.3,31936,109780.3
421610,201903,198,157,41,156686.4,40918,197604.4
421620,201903,1073,631,442,633731.38,442114,1075845.38
421625,201903,24,21,3,20958,2994,23952
421630,201903,288,182,106,181636.9,106787.6,288424.5
421635,201903,18,8,10,7984,9980,17964
421640,201903,96,82,14,81836.6,13972,95808.6
421650,201903,296,175,121,175648,122754,298402
421660,201903,2218,1341,877,1340314.8,877244.76,2217559.56
421670,201903,201,142,59,141716,58882,200598
421680,201903,172,156,16,155688,15968,171656
421690,201903,346,246,100,245510.94,100798.44,346309.38
421700,201903,61,40,21,39920,20958.2,60878.2
421710,201903,27,26,1,25948,998,26946
421715,201903,7,6,1,5988,998,6986
421720,201903,589,434,155,434130,155688,589818
421725,201903,13,5,8,4990,7984,12974
421730,201903,37,26,11,25948,10978,36926
421740,201903,90,43,47,42914,46906,89820
421750,201903,218,162,56,161676,55888,217564
421755,201903,25,23,2,22954,1996,24950
421760,201903,111,80,31,79840,30938,110778
421770,201903,607,405,202,406197.14,201601.12,607798.26
421775,201903,31,20,11,19960,10978,30938
421780,201903,190,148,42,147704,41916,189620
421790,201903,157,133,24,133732,23952,157684
421795,201903,20,15,5,14970,5988,20958
421800,201903,510,325,185,324350,184630.5,508980.5
421810,201903,74,60,14,59880,13972,73852
421820,201903,325,218,107,217564.4,106786,324350.4
421825,201903,133,111,22,110778,21956,132734
421830,201903,133,100,33,99800,32934,132734
421835,201903,3,3,0,2994,0,2994
421840,201903,52,44,8,43912.98,7984,51896.98
421850,201903,79,68,11,67864,10978.99,78842.99
421860,201903,38,31,7,30938,6986,37924
421870,201903,983,753,230,753519.98,229546.16,983066.14
421875,201903,53,45,8,44910,7984,52894
421880,201903,170,122,48,121756,47904.4,169660.4
421885,201903,27,21,6,20958,5988,26946
421890,201903,123,88,35,87824,34930.98,122754.98
421895,201903,49,45,4,44910,3992,48902
421900,201903,161,128,33,128744.94,32937.92,161682.86
421910,201903,67,43,24,42914,24950,67864
421915,201903,31,26,5,25948,4990,30938
421917,201903,42,31,11,30938,10978,41916
421920,201903,35,32,3,31936,2994,34930
421930,201903,739,580,159,578840,160680.94,739520.94
421935,201903,51,44,7,43912,6986,50898
421940,201903,40,36,4,35928,3992,39920
421950,201903,877,594,283,593811.2,282435.58,876246.78
421960,201903,40,33,7,32934.4,6986,39920.4
421970,201903,361,231,130,230538.2,130738.98,361277.18
421985,201903,29,18,11,17964,10978,28942
422000,201903,0,0,0,0,0,0
430003,201903,198,52,146,51896,145708,197604
430005,201903,39,30,9,29940,8982,38922
430010,201903,271,190,81,189620,80838,270458
430020,201903,153,100,53,99800.4,52894,152694.4
430030,201903,128,104,24,103792,23952,127744
430040,201903,2983,1751,1232,1749495.7,1233530.34,2983026.04
430045,201903,69,59,10,58882,9980,68862
430047,201903,7,6,1,5988,998,6986
430050,201903,79,67,12,66866,11976,78842
430055,201903,14,12,2,11976,1996,13972
430057,201903,6,4,2,3992,1996,5988
430060,201903,3672,2179,1493,2177644.99,1496007.66,3673652.65
430063,201903,60,55,5,54890,4990,59880
430064,201903,159,132,27,131736,26946,158682
430066,201903,7,6,1,5988,998,6986
430070,201903,46,35,11,34930,10978,45908
430080,201903,68,47,21,46906,21956,68862
430085,201903,34,13,21,12974,20958,33932
430087,201903,31,24,7,23952.7,6986,30938.7
430090,201903,73,66,7,65868,6986,72854
430100,201903,123,82,41,82834,40918,123752
430105,201903,143,73,70,72854.6,69860,142714.6
430107,201903,20,15,5,14970,4990,19960
430110,201903,415,247,168,247504,167664,415168
430120,201903,142,131,11,130738,10978,141716
430130,201903,793,493,300,494010.4,301396,795406.4
430140,201903,120,113,7,112774,6986,119760
430150,201903,111,72,39,71856,38922,110778
430155,201903,32,29,3,28942,2994,31936
430160,201903,3697,2203,1494,2201590.5,1492010.4,3693600.9
430163,201903,329,150,179,150698.98,180638,331336.98
430165,201903,29,19,10,18962,9980,28942
430170,201903,89,75,14,74850,13972,88822
430175,201903,85,67,18,66866,17964,84830
430180,201903,102,83,19,82834,18962,101796
430185,201903,32,24,8,23952,7984,31936
430187,201903,94,41,53,40918,52894,93812
430190,201903,219,124,95,123752,94810,218562
430192,201903,15,13,2,12974,1996,14970
430195,201903,16,11,5,10978,4990,15968
430200,201903,172,151,21,150698,20958,171656
430205,201903,20,19,1,18962,998,19960
430210,201903,663,517,146,515966.4,148702.4,664668.8
430215,201903,15,13,2,12974,1996,14970
430220,201903,73,51,22,50898,21956,72854
430222,201903,13,7,6,6986,5988,12974
430223,201903,13,7,6,6986,5988,12974
430225,201903,2,1,1,998,998,1996
430230,201903,311,183,128,182634,127744.8,310378.8
430235,201903,56,41,15,40918,14970,55888
430237,201903,28,22,6,21956,5988,27944
430240,201903,133,85,48,85828,47904,133732
430245,201903,67,57,10,56886,10978,67864
430250,201903,193,115,78,114770,77844,192614
430258,201903,11,9,2,8982,1996,10978
430260,201903,35,31,4,30938,3992,34930
430265,201903,36,30,6,29940,5988,35928
430270,201903,544,409,135,409180.3,135731.92,544912.22
430280,201903,1030,640,390,640716,393213.9,1033929.9
430290,201903,382,220,162,219560.6,161676,381236.6
430300,201903,2114,1181,933,1181635.34,933137.03,2114772.37
430310,201903,1947,1014,933,1012971.96,934134.94,1947106.90
430320,201903,54,45,9,44910,8982,53892
430330,201903,94,84,10,84830,9980,94810
430340,201903,71,61,10,60878,9980,70858
430350,201903,1640,1143,497,1144706.6,497004.98,1641711.58
430355,201903,23,21,2,20958,1996,22954
430360,201903,86,44,42,43912,42914,86826
430367,201903,31,22,9,21956,8982,30938
430370,201903,58,50,8,49900,7984,57884
430380,201903,138,104,34,103792,33932,137724
430390,201903,602,381,221,380238,221556,601794
430400,201903,139,106,33,105788,32934,138722
430410,201903,60,46,14,45908,13972,59880
430420,201903,498,331,167,331336.94,166666.98,498003.92
430430,201903,54,53,1,52229.33,998,53227.33
430435,201903,155,117,38,116766,37924,154690
430440,201903,514,334,180,334330.6,181636,515966.6
430450,201903,1163,959,204,960076,204590,1164666
430460,201903,5033,2776,2257,2775442.57,2262491.26,5037933.83
430461,201903,17,15,2,14970,1996,16966
430462,201903,9,6,3,5988,2994,8982
430463,201903,1049,559,490,559878.6,489021.96,1048900.56
430465,201903,24,14,10,13972,9980,23952
430466,201903,654,472,182,472054.4,182634,654688.4
430467,201903,93,52,41,51896.6,41916,93812.6
430468,201903,109,66,43,65868,42914,108782
430469,201903,22,17,5,16966,4990,21956
430470,201903,1160,657,503,656981.95,503990,1160971.95
430471,201903,55,40,15,39920,14970,54890
430480,201903,102,64,38,63872,37924,101796
430485,201903,6,6,0,5988.4,0,5988.4
430490,201903,85,69,16,68862,15968,84830
430495,201903,39,29,10,28942,9980,38922
430500,201903,193,129,64,128742,63872.63,192614.63
430510,201903,3348,2195,1153,2197597.24,1153688,3351285.24
430511,201903,17,16,1,15968,998,16966
430512,201903,139,99,40,99800,39920,139720
430513,201903,50,40,10,39920,9980,49900
430515,201903,32,30,2,29940,1996,31936
430517,201903,168,150,18,150698,17964,168662
430520,201903,369,260,109,259480,108782,368262
430530,201903,89,51,38,51896,37924,89820
430535,201903,462,314,148,313372,148702.99,462074.99
430537,201903,10,10,0,9980,0,9980
430540,201903,79,54,25,53892,24950,78842
430543,201903,360,114,246,113772,246506,360278
430544,201903,43,40,3,39920,2994,42914
430545,201903,349,178,171,177644.96,172654,350298.96
430550,201903,43,36,7,35928,6986,42914
430558,201903,5,3,2,2994,1996,4990
430560,201903,53,25,28,24950,27944,52894
430570,201903,106,42,64,41916,63872,105788
430580,201903,123,101,22,100798,22954.6,123752.6
430583,201903,14,14,0,13972,0,13972
430585,201903,9,4,5,3992,4990,8982
430587,201903,16,7,9,6986,8982,15968
430590,201903,149,122,27,121756,26946,148702
430593,201903,2,2,0,1996,0,1996
430595,201903,17,14,3,13972,2994,16966
430597,201903,47,25,22,24950,21956,46906
430600,201903,220,155,65,154690,64870,219560
430605,201903,160,101,59,100798,58882,159680
430607,201903,26,22,4,21956,3992,25948
430610,201903,1622,771,851,771454.9,850297.38,1621752.28
430613,201903,3,3,0,2994,0,2994
430620,201903,114,84,30,84830,29940,114770
430630,201903,48,41,7,40918,6986,47904
430632,201903,34,29,5,28942,4990,33932
430635,201903,40,37,3,36926,2994,39920
430637,201903,53,29,24,28942,24950,53892
430640,201903,193,108,85,107784,84830,192614
430642,201903,23,21,2,20958,1996,22954
430645,201903,36,29,7,28942,6986,35928
430650,201903,255,207,48,206586.4,47904,254490.4
430655,201903,4,4,0,3992,0,3992
430660,201903,981,481,500,480038,499998.73,980036.73
430670,201903,75,52,23,51896,22954,74850
430673,201903,74,40,34,39920,33932,73852
430675,201903,14,11,3,10978,2994,13972
430676,201903,504,309,195,309380.94,195608.94,504989.88
430680,201903,252,177,75,176646.8,74850,251496.8
430690,201903,533,332,201,332334.98,201596.63,533931.61
430692,201903,7,5,2,4990,1996,6986
430693,201903,139,94,45,94810,45908,140718
430695,201903,73,61,12,60878,11976,72854
430697,201903,58,36,22,35928,21956,57884
430700,201903,1549,1088,461,1088818.76,461076,1549894.76
430705,201903,23,21,2,20958,1996,22954
430710,201903,254,167,87,166666,86826,253492
430720,201903,108,91,17,90818,16966,107784
430730,201903,135,115,20,114770,19960,134730
430740,201903,71,47,24,46906,23952,70858
430745,201903,35,28,7,27944,6986,34930
430750,201903,342,227,115,227544,115768,343312
430755,201903,89,53,36,52894,35928,88822
430760,201903,360,216,144,216567.04,144710.98,361278.02
430770,201903,1436,760,676,759480.24,676647.92,1436128.16
430780,201903,312,197,115,196606.98,114770.98,311377.96
430781,201903,28,25,3,24950,2994,27944
430783,201903,54,45,9,44910,8982,53892
430786,201903,6,3,3,2994,2994,5988
430790,201903,535,347,188,346306,187624.4,533930.4
430800,201903,161,134,27,133732.51,26946,160678.51
430805,201903,40,36,4,35928,3992,39920
430807,201903,45,26,19,25948,18962,44910
430810,201903,74,48,26,47904,25948,73852
430820,201903,143,84,59,83832,58882,142714
430825,201903,11,9,2,8982,1996,10978
430830,201903,232,215,17,214570.4,16966,231536.4
430840,201903,126,85,41,84830,42914.6,127744.6
430843,201903,5,3,2,2994,1996,4990
430845,201903,70,41,29,40918,29940,70858
430850,201903,572,402,170,401196,169663.9,570859.9
430860,201903,166,104,62,103792,61876,165668
430865,201903,71,39,32,38922,31936.98,70858.98
430870,201903,81,66,15,65868,14970,80838
430880,201903,156,115,41,115768,40918,156686
430885,201903,10,8,2,7984,1996,9980
430890,201903,349,211,138,210578,137724,348302
430900,201903,528,369,159,367763,160678,528441
430905,201903,109,48,61,47904,60878,108782
430910,201903,271,150,121,150698,120758.98,271456.98
430912,201903,5,5,0,4990,0,4990
430915,201903,33,27,6,26946,5988,32934
430920,201903,4195,2333,1862,2336789.33,1864267.94,4201057.27
430925,201903,4,3,1,2994,998,3992
430930,201903,2072,1225,847,1223550.66,846307.88,2069858.54
430940,201903,259,165,94,165668,93812,259480
430950,201903,151,122,29,121756,28942,150698
430955,201903,22,13,9,12974,8982,21956
430957,201903,18,17,1,16966,998,17964
430960,201903,241,158,83,157684,83832,241516
430965,201903,110,71,39,70858,38922,109780
430970,201903,85,71,14,70858,13972,84830
430975,201903,39,35,4,34930,3992,38922
430980,201903,46,30,16,29940,15968,45908
430990,201903,116,88,28,87824,27944,115768
430995,201903,118,113,5,112774,4990,117764
431000,201903,307,139,168,138723,167664,306387
431010,201903,346,203,143,203592,143712,347304
431020,201903,1936,1126,810,1123748.6,811374,1935122.6
431030,201903,42,33,9,32934,8982,41916
431033,201903,378,192,186,191616,186626,378242
431036,201903,14,9,5,8982,4990,13972
431040,201903,133,82,51,81836,50898,132734
431041,201903,38,26,12,25948,11976,37924
431043,201903,50,30,20,29940,19960,49900
431046,201903,11,7,4,6986,3992,10978
431050,201903,198,127,71,126746,70858,197604
431053,201903,75,46,29,45908.96,28942,74850.96
431055,201903,64,44,20,43912,19960,63872
431057,201903,18,18,0,17964,0,17964
431060,201903,1645,1039,606,1036924.35,605801.4,1642725.75
431065,201903,19,11,8,10978,7984,18962
431070,201903,69,63,6,62874,5988,68862
431075,201903,6,6,0,5988,0,5988
431080,201903,131,81,50,80838,49900,130738
431085,201903,32,29,3,28942,2994,31936
431087,201903,14,11,3,10978,2994,13972
431090,201903,56,45,11,44910,10978,55888
431100,201903,1205,724,481,722553.34,480038,1202591.34
431110,201903,247,151,96,151696,95808.4,247504.4
431112,201903,28,17,11,16966,10978,27944
431113,201903,31,22,9,22954,8982,31936
431115,201903,156,109,47,108782,47904,156686
431120,201903,604,360,244,360278.6,243513.92,603792.52
431123,201903,4,3,1,2994,998,3992
431125,201903,100,91,9,90818,8982,99800
431127,201903,10,4,6,3992,5988,9980
431130,201903,687,443,244,443112,245508,688620
431140,201903,758,528,230,526944.4,231536,758480.4
431142,201903,32,26,6,25948.95,5988,31936.95
431150,201903,196,148,48,147704,47904,195608
431160,201903,55,49,6,48902,5988,54890
431162,201903,19,14,5,13972,4990,18962
431164,201903,6,6,0,5988,0,5988
431170,201903,105,84,21,83832,20958,104790
431171,201903,69,41,28,40918,27944,68862
431173,201903,1,1,0,998,0,998
431175,201903,196,100,96,99800.4,95808,195608.4
431177,201903,73,56,17,55888,16966,72854
431179,201903,14,12,2,11976,1996,13972
431180,201903,455,279,176,279440,175648.98,455088.98
431190,201903,86,66,20,65868,19960,85828
431198,201903,69,48,21,47904,20958,68862
431200,201903,20,16,4,15968,3992,19960
431205,201903,23,23,0,22954,0,22954
431210,201903,85,51,34,50898,33932,84830
431213,201903,29,25,4,24950,3992,28942
431215,201903,23,20,3,19960,2994,22954
431217,201903,4,4,0,3992,998,4990
431220,201903,69,60,9,59880,8982,68862
431225,201903,150,102,48,101796.98,47904,149700.98
431230,201903,102,92,10,91816,9980,101796
431235,201903,8,8,0,7984,0,7984
431237,201903,24,17,7,16966,6986,23952
431238,201903,9,6,3,6986.4,2994,9980.4
431240,201903,985,650,335,648700.2,338322,987022.2
431242,201903,39,38,1,37924,998,38922
431244,201903,11,8,3,7984,2994,10978
431245,201903,49,38,11,37924,10978,48902
431247,201903,13,11,2,10978,1996,12974
431250,201903,278,149,129,148702,128742,277444
431260,201903,60,46,14,45908,13972,59880
431261,201903,18,12,6,11976,5988,17964
431262,201903,18,17,1,16966,998,17964
431265,201903,156,86,70,85828,69860,155688
431267,201903,15,14,1,13972,998,14970
431270,201903,324,267,57,266466,56886,323352
431275,201903,38,35,3,34930,2994,37924
431280,201903,17,13,4,12974,3992,16966
431290,201903,25,20,5,19960,4990,24950
431295,201903,4,3,1,3992,998,4990
431300,201903,21,18,3,17964,2994,20958
431301,201903,6,6,0,5988,0,5988
431303,201903,54,36,18,35928,17964,53892
431306,201903,237,127,110,127566.35,109780,237346.35
431308,201903,6,5,1,4990,998,5988
431310,201903,68,58,10,57884,9980,67864
431320,201903,136,81,55,81836,54890,136726
431330,201903,175,114,61,113772,60878,174650
431333,201903,31,26,5,25948,4990,30938
431335,201903,8,4,4,3992,3992,7984
431337,201903,325,149,176,148702,175648,324350
431339,201903,22,19,3,18962,2994,21956
431340,201903,2980,1711,1269,1711494.51,1269474.34,2980968.85
431342,201903,38,24,14,23952,13972,37924
431344,201903,18,18,0,17964,0,17964
431346,201903,5,5,0,4990,0,4990
431349,201903,35,32,3,31936,2994,34930
431350,201903,913,539,374,538921.08,374250,913171.08
431360,201903,50,45,5,44910,4990,49900
431365,201903,323,156,167,155688,166666,322354
431370,201903,1319,789,530,788420.4,531940.86,1320361.26
431380,201903,99,85,14,84830,13972,98802
431390,201903,518,288,230,287424,229540,516964
431395,201903,291,134,157,133732,156686.96,290418.96
431400,201903,40,29,11,28942,10978,39920
431402,201903,100,71,29,70858,28942,99800
431403,201903,22,12,10,11976,9980,21956
431405,201903,653,359,294,360278.9,293414.94,653693.84
431406,201903,31,27,4,26946,3992,30938
431407,201903,52,41,11,40918,10978,51896
431410,201903,3408,2094,1314,2097797.5,1314366,3412163.5
431413,201903,17,14,3,13972,2994,16966
431415,201903,72,54,18,53892,17964,71856
431417,201903,22,12,10,11976,9980,21956
431420,201903,311,216,95,215568,94810,310378
431430,201903,47,23,24,22954,23952,46906
431440,201903,8853,6283,2570,6292400.79,2572845.4,8865246.19
431442,201903,28,15,13,14970,12974,27944
431445,201903,23,20,3,19960,2994,22954
431446,201903,3,3,0,2994,0,2994
431447,201903,84,61,23,60878,22954,83832
431449,201903,55,48,7,47904,6986,54890
431450,201903,411,280,131,280438,130738,411176
431454,201903,0,0,0,0,0,0
431455,201903,50,39,11,38922,10978,49900
431460,201903,518,358,160,357284,159680,516964
431470,201903,119,92,27,92814,26946,119760
431475,201903,11,10,1,9980,998,10978
431477,201903,35,24,11,23952,10978,34930
431478,201903,8,7,1,6986,998,7984
431480,201903,488,311,177,310378,176646,487024
431490,201903,28188,16079,12109,16083886.81,12127835.05,28211721.86
431500,201903,81,59,22,58882,21956,80838
431505,201903,31,17,14,16966,13972,30938
431507,201903,13,10,3,9980,2994,12974
431510,201903,257,182,75,181636.1,75848,257484.1
431513,201903,24,20,4,19960,3992,23952
431514,201903,7,6,1,5988,998,6986
431515,201903,80,68,12,67864,12974,80838
431517,201903,5,4,1,3992,998,4990
431520,201903,38,34,4,33932,3992,37924
431530,201903,1563,706,857,704590.88,858280.94,1562871.82
431531,201903,23,21,2,21956,1996,23952
431532,201903,27,18,9,17964,8982,26946
431535,201903,26,16,10,15968,9980,25948
431540,201903,143,126,17,125748,16966,142714
431545,201903,14,12,2,11976,1996,13972
431550,201903,356,200,156,199600,155688,355288
431555,201903,13,12,1,11976,998,12974
431560,201903,4438,3131,1307,3133725.17,1307380,4441105.17
431570,201903,805,432,373,432134.8,372254,804388.8
431575,201903,38,24,14,23952,13972,37924
431580,201903,97,67,30,66866,29940,96806
431590,201903,148,126,22,126746,22954,149700
431595,201903,11,10,1,9980,998,10978
431600,201903,219,124,95,123752,94810,218562
431610,201903,121,89,32,89820,31936,121756
431620,201903,45,37,8,36926,7984,44910
431630,201903,134,112,22,111776,21956,133732
431640,201903,1337,837,500,836324.4,500997.36,1337321.76
431642,201903,35,32,3,31936,2994,34930
431643,201903,43,19,24,18962,23952,42914
431645,201903,313,183,130,182634,130738,313372
431647,201903,10,10,0,9980,0,9980
431650,201903,36,26,10,25948,9980,35928
431660,201903,310,197,113,196606,112774,309380
431670,201903,231,110,121,110778,120758,231536
431673,201903,4,4,0,3992,0,3992
431675,201903,30,25,5,24950,4990,29940
431680,201903,1131,823,308,825346,307384,1132730
431690,201903,4765,2906,1859,2911169.28,1859278.3,4770447.58
431695,201903,24,20,4,19960,3992,23952
431697,201903,0,0,0,0,0,0
431700,201903,173,135,38,134730,37924,172654
431710,201903,4011,1765,2246,1767459.58,2247506.78,4014966.36
431720,201903,1362,831,531,829338.6,531934.99,1361273.59
431725,201903,1,1,0,998,0,998
431730,201903,1192,811,381,811377.12,382234,1193611.12
431740,201903,1366,671,695,670656.96,695611.3,1366268.26
431750,201903,1857,1211,646,1209577.71,647702.98,1857280.69
431755,201903,5,4,1,3992,998,4990
431760,201903,1016,657,359,655686,358282,1013968
431770,201903,395,293,102,292414,101796,394210
431775,201903,31,23,8,22954,8982,31936
431780,201903,562,352,210,353292,211576,564868
431790,201903,168,130,38,129740,37924,167664
431795,201903,12,10,2,9980,1996,11976
431800,201903,3341,1760,1581,1759486.2,1582929.32,3342415.52
431805,201903,18,16,2,16966,1996,18962
431810,201903,608,407,201,406186,201596.98,607782.98
431820,201903,324,186,138,188622,137724,326346
431830,201903,2322,1410,912,1410174,912177.9,2322351.9
431840,201903,493,329,164,328342.6,163672,492014.6
431842,201903,35,29,6,28942,5988,34930
431843,201903,12,9,3,8982,2994,11976
431844,201903,17,15,2,14970,1996,16966
431845,201903,29,25,4,24950,3992,28942
431846,201903,29,24,5,23952,4990,28942
431848,201903,14,12,2,11976,1996,13972
431849,201903,10,7,3,6986,2994,9980
431850,201903,800,661,139,659678,138722,798400
431860,201903,113,81,32,80838,31936,112774
431861,201903,4,2,2,1996,1996,3992
431862,201903,51,34,17,33932,16966,50898
431870,201903,3401,2027,1374,2026942.3,1372257.76,3399200.06
431880,201903,926,683,243,683630.94,243512,927142.94
431890,201903,1299,812,487,813370.4,491016,1304386.4
431900,201903,176,126,50,125748,49900,175648
431910,201903,53,40,13,39920,12974,52894
431912,201903,38,22,16,21956,15968,37924
431915,201903,130,104,26,103792,25948,129740
431920,201903,151,110,41,109780,40918,150698
431930,201903,80,65,15,65868,14970,80838
431935,201903,3,3,0,2994,0,2994
431936,201903,12,11,1,10978,998,11976
431937,201903,19,14,5,13972,4990,18962
431940,201903,470,315,155,315368,154690.5,470058.5
431950,201903,500,315,185,314371.92,184631.96,499003.88
431960,201903,736,410,326,409182.36,325349.96,734532.32
431970,201903,73,65,8,64870,7984,72854
431971,201903,3,3,0,2994,0,2994
431973,201903,25,20,5,19960,4990,24950
431975,201903,8,7,1,6986,998,7984
431980,201903,205,127,78,126746,77844,204590
431990,201903,1214,654,560,654623.13,559880.9,1214504.03
432000,201903,1667,913,754,912174.1,754493.55,1666667.65
432010,201903,276,184,92,183632,92814,276446
432020,201903,171,141,30,141716,29940,171656
432023,201903,15,13,2,12974,1996,14970
432026,201903,70,65,5,64870,4990,69860
432030,201903,65,31,34,30938,33932,64870
432032,201903,19,16,3,15968,2994,18962
432035,201903,48,39,9,38922,8982,47904
432040,201903,103,70,33,70858,32934,103792
432045,201903,8,7,1,6986,998,7984
432050,201903,77,47,30,46906,29940,76846
432055,201903,112,83,29,83832,28942,112774
432057,201903,4,3,1,2994.4,998,3992.4
432060,201903,35,32,3,31936,2994,34930
432065,201903,33,29,4,28942,3992,32934
432067,201903,87,78,9,77844,8982,86826
432070,201903,404,305,99,304640.8,98802.98,403443.78
432080,201903,822,572,250,570856,249500,820356
432085,201903,15,12,3,11976,2994,14970
432090,201903,268,176,92,175648,91816,267464
432100,201903,173,116,57,115768,56886,172654
432110,201903,589,405,184,405188,183632,588820
432120,201903,948,579,369,579838,369260,949098
432130,201903,501,364,137,363272,136726,499998
432132,201903,24,21,3,20958,2994,23952
432135,201903,78,65,13,65868,12974,78842
432140,201903,266,215,51,214570,51896,266466
432143,201903,201,127,74,126746,73852,200598
432145,201903,282,194,88,193612,87824,281436
432146,201903,14,13,1,12974,998,13972
432147,201903,126,61,65,60878,64870,125748
432149,201903,14,10,4,9980,3992,13972
432150,201903,837,519,318,517962.96,318363.55,836326.51
432160,201903,1426,748,678,749499.57,676645.94,1426145.51
432162,201903,4,3,1,2994,998,3992
432163,201903,18,14,4,13972,3992,17964
432166,201903,116,86,30,86328,29940,116268
432170,201903,225,118,107,119760,107784,227544
432180,201903,542,339,203,338322,203592.4,541914.4
432183,201903,8,7,1,6986,998,7984
432185,201903,79,69,10,68862,9980,78842
432190,201903,461,271,190,271456,192614.98,464070.98
432195,201903,85,72,13,71856,12974,84830
432200,201903,395,254,141,256486,142714.98,399200.98
432210,201903,119,75,44,74850,43912,118762
432215,201903,57,53,4,52894,3992,56886
432218,201903,20,19,1,18962,998,19960
432220,201903,676,351,325,351296,324351.61,675647.61
432225,201903,13,8,5,7984,4990,12974
432230,201903,145,93,52,92814,51896,144710
432232,201903,13,12,1,11976,998,12974
432234,201903,4,3,1,2994,998,3992
432235,201903,3,3,0,2994,0,2994
432237,201903,26,15,11,15968,10978,26946
432240,201903,4342,2447,1895,2445105.08,1901191.78,4346296.86
432250,201903,1082,695,387,695606,387224,1082830
432252,201903,43,38,5,37924,4990,42914
432253,201903,59,47,12,46906,11976,58882
432254,201903,26,13,13,12974,12974,25948
432255,201903,14,13,1,12974,998,13972
432260,201903,883,701,182,699598.4,182634,882232.4
432270,201903,242,177,65,176646,64870,241516
432280,201903,134,101,33,100798.6,32934,133732.6
432285,201903,1,1,0,998,0,998
432290,201903,68,60,8,59880,7984,67864
432300,201903,4538,2587,1951,2587752.99,1954097.56,4541850.55
432310,201903,117,96,21,96806,20958,117764
432320,201903,21,17,4,16966,3992,20958
432330,201903,16,12,4,11976,3992,15968
432335,201903,7,6,1,5988,998,6986
432340,201903,39,35,4,34930,3992,38922
432345,201903,97,70,27,69860,26946,96806
432350,201903,23,22,1,21956,998,22954
432360,201903,7,5,2,4990,1996,6986
432370,201903,26,26,0,25948,0,25948
432375,201903,33,31,2,30938,1996,32934
432377,201903,8,8,0,7984,0,7984
432380,201903,164,74,90,73852,89820,163672
500020,201903,243,139,104,138722,104790,243512
500025,201903,121,57,64,56886,63872,120758
500060,201903,1460,914,546,912172,547903.38,1460075.38
500070,201903,797,383,414,384230.96,414170.98,798401.94
500080,201903,133,107,26,106786,25948,132734
500085,201903,134,108,26,108782.4,25948,134730.4
500090,201903,331,158,173,157684,173652,331336
500100,201903,731,386,345,386226,347304.8,733530.8
500110,201903,2255,1036,1219,1035929.71,1219568.57,2255498.28
500124,201903,269,157,112,156686,111776,268462
500150,201903,325,136,189,135728.98,188624.94,324353.92
500190,201903,527,369,158,368262,157684.4,525946.4
500200,201903,194,167,27,166666.28,26946,193612.28
500210,201903,1452,523,929,521957.92,929166.34,1451124.26
500215,201903,247,147,100,146706,99800,246506
500220,201903,762,498,264,500000.66,267464,767464.66
500230,201903,249,169,80,169660,80838,250498
500240,201903,693,485,208,484030.36,207584,691614.36
500260,201903,594,227,367,226546,367264.97,593810.97
500270,201903,29203,12581,16622,12576843.94,16625873.55,29202717.49
500280,201903,190,70,120,69860,123752,193612
500290,201903,1174,705,469,705586,472054.98,1177640.98
500295,201903,429,270,159,270458.4,158682,429140.4
500310,201903,59,18,41,17964,40918,58882
500315,201903,733,445,288,446106,287424,733530
500320,201903,3633,1834,1799,1837319.75,1807383.88,3644703.63
500325,201903,907,503,404,501994,405188.4,907182.4
500330,201903,1445,680,765,680636.4,767462.98,1448099.38
500345,201903,314,241,73,240519.38,72854,313373.38
500348,201903,247,152,95,152694,94810.98,247504.98
500350,201903,130,64,66,63872,65868,129740
500370,201903,5452,2463,2989,2461070.48,2989017.3,5450087.78
500375,201903,351,259,92,258482,91816,350298
500380,201903,603,345,258,344310,257484,601794
500390,201903,70,34,36,33932,35928,69860
500400,201903,211,147,64,147704,63872.98,211576.98
500410,201903,558,224,334,223555.89,333338.85,556894.74
500430,201903,531,377,154,376246,154690,530936
500440,201903,201,102,99,102794,98802,201596
500450,201903,405,174,231,174650,230538,405188
500460,201903,296,152,144,151696,144710,296406
500470,201903,439,347,92,347305.39,91816.98,439122.37
500480,201903,111,65,46,65868,46906,112774
500490,201903,106,43,63,42914,62874,105788
500500,201903,1427,515,912,514978.81,912203.51,1427182.32
500510,201903,46,35,11,36926,10978.98,47904.98
500515,201903,106,74,32,73852,31936,105788
500520,201903,341,186,155,185628.8,154691.39,340320.19
500525,201903,86,48,38,47904,37924,85828
500540,201903,904,387,517,386226.98,518961.96,905188.94
500560,201903,904,518,386,517962,386226.4,904188.4
500568,201903,976,574,402,573850.98,401197.39,975048.37
500570,201903,1205,690,515,691633.22,516026.56,1207659.78
500580,201903,333,174,159,175648,158684.91,334332.91
500600,201903,318,171,147,170658,147705.96,318363.96
500620,201903,923,659,264,657682.4,263472,921154.4
500625,201903,78,66,12,65868,11976,77844
500627,201903,27,13,14,12974,13972,26946
500630,201903,1576,846,730,847303.3,730536,1577839.3
500635,201903,529,310,219,309380,220558,529938
500640,201903,418,218,200,218563,199600,418163
500660,201903,5496,2110,3386,2107776.4,3389210.98,5496987.38
500690,201903,579,207,372,206596.76,372279.48,578876.24
500710,201903,385,195,190,195608,189621.96,385229.96
500720,201903,966,571,395,571854,397204,969058
500730,201903,199,121,78,120758,77844,198602
500740,201903,844,367,477,367270.34,477074.67,844345.01
500750,201903,149,48,101,47904,100798.98,148702.98
500755,201903,121,86,35,85828.4,34930,120758.4
500769,201903,742,416,326,417166.37,326348.95,743515.32
500770,201903,419,223,196,224550.98,195608,420158.98
500780,201903,167,112,55,111776,54890,166666
500790,201903,1060,541,519,540916,518964.91,1059880.91
500793,201903,267,148,119,147704,119761.38,267465.38
500795,201903,174,126,48,125748,47904.98,173652.98
500797,201903,50,37,13,36926,12974,49900
500800,201903,420,187,233,186626.98,233532,420158.98
500830,201903,2233,1256,977,1259478.18,976044.98,2235523.16
500840,201903,144,107,37,106786,36926.98,143712.98
510010,201903,166,92,74,91816,74850,166666
510020,201903,489,227,262,228561.6,262504.38,491065.98
510025,201903,1681,960,721,960086.15,721569.1,1681655.25
510030,201903,676,355,321,354293.9,322355.96,676649.86
510035,201903,130,58,72,57885.96,71856.98,129742.94
510040,201903,384,173,211,172654,210580.68,383234.68
510050,201903,398,219,179,218568.84,178649.28,397218.12
510060,201903,112,58,54,57884,54890,112774
510080,201903,226,91,135,92814.98,135728.98,228543.96
510100,201903,73,34,39,33932,38922,72854
510120,201903,37,23,14,22954,13972,36926
510125,201903,397,248,149,247504,149701.97,397205.97
510130,201903,568,331,237,331344.82,238533.76,569878.58
510140,201903,405,130,275,129740,277444,407184
510160,201903,98,42,56,41916,55888.99,97804.99
510170,201903,848,519,329,518974.15,331350.68,850324.83
510180,201903,2890,1403,1487,1400237.43,1486058.48,2886295.91
510185,201903,14,7,7,6986,6986,13972
510190,201903,221,75,146,74850,145708,220558
510250,201903,2564,1532,1032,1531938.24,1032935.3,2564873.54
510260,201903,192,141,51,141731.68,50899.96,192631.64
510263,201903,454,257,197,257487.74,197604.98,455092.72
510267,201903,675,382,293,383246.32,295430.52,678676.84
510268,201903,59,29,30,28942,30938,59880
510269,201903,70,33,37,32934.98,36926,69860.98
510270,201903,404,206,198,206589.92,197608.9,404198.82
510279,201903,225,169,56,169662.94,55888.4,225551.34
510285,201903,177,75,102,75848.98,101796,177644.98
510300,201903,512,285,227,285431.93,229546.86,514978.79
510305,201903,213,99,114,98803.97,113772.98,212576.95
510310,201903,105,55,50,54890,49900,104790
510320,201903,853,540,313,538926.86,313385.73,852312.59
510325,201903,409,165,244,165668,244510,410178
510330,201903,428,240,188,240519.97,188622,429141.97
510335,201903,606,344,262,345310.95,263476.9,608787.85
510336,201903,50,36,14,35928,13972,49900
510337,201903,111,47,64,48902,63872,112774
510340,201903,17176,8170,9006,8170590.3,9013252.81,17183843.11
510343,201903,66,47,19,46906,18962,65868
510345,201903,165,111,54,110778,53892.4,164670.4
510350,201903,657,368,289,368266.9,288425.92,656692.82
510360,201903,195,124,71,123752.98,71861.88,195614.86
510370,201903,141,71,70,71856,69862.94,141718.94
510380,201903,90,63,27,62874,26946.98,89820.98
510385,201903,57,27,30,26946,29940.98,56886.98
510390,201903,112,48,64,47904,63872,111776
510395,201903,47,34,13,33932,12974,46906
510410,201903,702,463,239,462075.98,238522.98,700598.96
510420,201903,566,275,291,274468.58,291448.24,565916.82
510450,201903,53,28,25,27944,25948,53892
510452,201903,44,25,19,24950,18962,43912
510454,201903,53,26,27,25948,26946,52894
510455,201903,128,78,50,78842,49900,128742
510460,201903,176,91,85,90819.68,84830.98,175650.66
510480,201903,751,444,307,444118.1,306397.68,750515.78
510490,201903,348,180,168,179645.84,168664.9,348310.74
510500,201903,246,188,58,187624,57884,245508
510510,201903,801,464,337,463073.38,336326,799399.38
510515,201903,1167,619,548,618765.88,546905.96,1165671.84
510517,201903,260,109,151,110778,150698.98,261476.98
510520,201903,233,152,81,151699.92,80842.88,232542.80
510523,201903,95,70,25,69860,24950,94810
510525,201903,761,449,312,450102.91,311380.9,761483.81
510530,201903,18,13,5,12974,4990,17964
510550,201903,256,116,140,115768.98,140718,256486.98
510558,201903,276,136,140,136726.98,139720,276446.98
510560,201903,409,241,168,242514.4,167665.96,410180.36
510562,201903,650,458,192,459080,192614,651694
510590,201903,783,407,376,408183.96,378243.97,786427.93
510600,201903,248,136,112,136726,111777.96,248503.96
510610,201903,169,83,86,82834,85828.78,168662.78
510615,201903,193,81,112,80838,111776,192614
510617,201903,19,11,8,10978,7984,18962
510618,201903,119,57,62,56886,61876,118762
510619,201903,103,70,33,69860.98,32934.98,102795.96
510620,201903,176,98,78,97804,78842,176646
510621,201903,194,126,68,125748.98,67865.96,193614.94
510622,201903,468,299,169,298407.88,168663.96,467071.84
510623,201903,348,234,114,233533.96,113772,347305.96
510624,201903,90,45,45,44910.98,44910,89820.98
510625,201903,539,331,208,330352.7,208594.37,538947.07
510626,201903,114,72,42,71856.98,41916,113772.98
510627,201903,63,45,18,44910,17964,62874
510628,201903,154,91,63,90818.98,62874,153692.98
510629,201903,258,169,89,169660,88822,258482
510630,201903,451,234,217,233533.96,218565.34,452099.30
510631,201903,11,3,8,2994,7984.4,10978.4
510637,201903,352,207,145,206589.93,144720.78,351310.71
510642,201903,966,539,427,538922.94,428143.96,967066.90
510645,201903,0,0,0,0,0,0
510650,201903,1452,972,480,971068.14,481040.87,1452109.01
510665,201903,81,41,40,40921.88,39920,80841.88
510670,201903,66,38,28,37924,27944,65868
510675,201903,1149,716,433,718563.34,434131.96,1152695.30
510677,201903,350,177,173,176651.88,172660.86,349312.74
510680,201903,100,58,42,57885.96,41916.98,99802.94
510682,201903,213,106,107,105788.62,106786,212574.62
510685,201903,50,38,12,37924,11976,49900
510700,201903,610,356,254,356296.78,253502.79,609799.57
510704,201903,1114,601,513,600913.57,513079.78,1113993.35
510706,201903,129,66,63,65868,62875.96,128743.96
510710,201903,401,277,124,277449.84,123753.92,401203.76
510715,201903,61,47,14,46906,13972,60878
510718,201903,209,117,92,116768.94,91816,208584.94
510719,201903,37,18,19,17964,18962,36926
510720,201903,192,134,58,133732.98,57884,191616.98
510724,201903,89,36,53,35928,52894,88822
510726,201903,50,25,25,24950,25948.98,50898.98
510729,201903,74,35,39,34930,38922,73852
510730,201903,469,266,203,265469.96,202595.97,468065.93
510735,201903,109,44,65,43912,64870,108782
510740,201903,25,14,11,13972,10978,24950
510757,201903,16,12,4,11976,3992,15968
510760,201903,7089,3784,3305,3787479.91,3305592.87,7093072.78
510770,201903,696,327,369,327348.88,368273.72,695622.60
510774,201903,15,5,10,4990,9980,14970
510775,201903,112,84,28,83832,28942,112774
510776,201903,27,8,19,7984,18962,26946
510777,201903,183,81,102,80838,101796,182634
510779,201903,49,24,25,23952.98,24951.96,48904.94
510780,201903,287,160,127,159686.88,126750.86,286437.74
510785,201903,415,227,188,226546,191616,418162
510787,201903,194,96,98,95808.98,97805.97,193614.95
510788,201903,0,0,0,0,0,0
510790,201903,2407,1285,1122,1284475.9,1122841.14,2407317.04
510792,201903,1127,659,468,657689.84,469074.71,1126764.55
510794,201903,118,58,60,57884,60878.98,118762.98
510795,201903,2377,1415,962,1413174.74,968066.68,2381241.42
510800,201903,186,115,71,115768,70858.98,186626.98
510805,201903,175,121,54,120758,53892.98,174650.98
510810,201903,96,41,55,40923.88,54890,95813.88
510820,201903,248,119,129,118766.12,129742.51,248508.63
510830,201903,68,42,26,41916,25948.98,67864.98
510835,201903,11,8,3,7984,2994,10978
510840,201903,9137,4510,4627,4512172.42,4624964.18,9137136.60
510850,201903,205,82,123,81836,122754.98,204590.98
510860,201903,394,175,219,175654.86,218572.18,394227.04
510880,201903,64,48,16,47904.98,15968,63872.98
510885,201903,72,44,28,43912.98,27944,71856.98
510890,201903,71,42,29,41916,28942,70858
510895,201903,186,107,79,107784,78844.37,186628.37
520005,201903,45,30,15,29940,14970,44910
520010,201903,274,125,149,124750,149700.8,274450.8
520013,201903,685,431,254,430138.98,257484,687622.98
520015,201903,57,41,16,40918,15968,56886
520017,201903,91,52,39,51896.4,38922,90818.4
520020,201903,24,14,10,13972,9980,23952
520025,201903,2049,1129,920,1127740.4,920156,2047896.4
520030,201903,811,429,382,430138.98,383232,813370.98
520050,201903,73,49,24,48902,24950,73852
520055,201903,48,31,17,30938,16966,47904
520060,201903,187,124,63,123752,62874,186626
520080,201903,579,415,164,415201.26,163672,578873.26
520082,201903,19,14,5,13972,4990,18962
520085,201903,100,74,26,73852,25948,99800
520090,201903,91,61,30,60878,29940,90818
520110,201903,9170,4031,5139,4032925.1,5133719.68,9166644.78
520120,201903,14,8,6,7984,5988,13972
520130,201903,784,547,237,547902.98,237524.4,785427.38
520140,201903,11972,6777,5195,6773439.2,5199599.38,11973038.58
520145,201903,46,31,15,31936,14970,46906
520150,201903,185,144,41,143712,40918,184630
520160,201903,33,24,9,23952,8982,32934
520170,201903,244,150,94,149702.93,93814.92,243517.85
520180,201903,143,72,71,71856,70858,142714
520215,201903,215,140,75,139720,74850,214570
520235,201903,71,53,18,52894,17964,70858
520250,201903,129,77,52,76846,51896,128742
520260,201903,112,69,43,68862,42914,111776
520280,201903,48,33,15,32934,14970,47904
520310,201903,41,29,12,28942,11976,40918
520320,201903,164,104,60,103792,59880,163672
520330,201903,788,419,369,418164.94,368262.98,786427.92
520340,201903,339,197,142,197604,141716.98,339320.98
520350,201903,528,243,285,242514,285428,527942
520355,201903,91,56,35,55888,34930,90818
520357,201903,26,20,6,19960,5988,25948
520360,201903,1,1,0,998,0,998
520380,201903,142,73,69,72854,68862,141716
520390,201903,269,116,153,115768,153692,269460
520393,201903,15,11,4,10978,3992,14970
520396,201903,94,61,33,60878,32934,93812
520400,201903,215,125,90,124750.4,89820,214570.4
520410,201903,193,99,94,98802.98,93812.98,192615.96
520420,201903,20,14,6,13972,5988,19960
520425,201903,308,144,164,144710,165669.4,310379.4
520430,201903,464,242,222,241516,221557.88,463073.88
520440,201903,618,422,196,422154,196606,618760
520450,201903,1928,872,1056,871254.98,1057884.9,1929139.88
520455,201903,56,40,16,39920,15968,55888
520460,201903,33,17,16,16966,15968,32934
520465,201903,27,23,4,22954,3992,26946
520470,201903,418,261,157,261476,156686,418162
520480,201903,78,47,31,46906.98,30942.9,77849.88
520485,201903,120,44,76,44910,75848.4,120758.4
520490,201903,423,311,112,310378,112774,423152
520495,201903,167,99,68,98802,67864,166666
520500,201903,174,131,43,130738,42914,173652
520505,201903,177,95,82,94810,81836,176646
520510,201903,1786,887,899,887257.68,897281.34,1784539.02
520520,201903,38,30,8,29940,7984,37924
520530,201903,233,178,55,177644,54890,232534
520540,201903,551,380,171,380238,170658,550896
520545,201903,142,84,58,83832,57884,141716
520547,201903,46,27,19,26946,18962,45908
520549,201903,1156,563,593,563870.32,591817.73,1155688.05
520551,201903,292,155,137,155588.2,137724.4,293312.6
520552,201903,47,28,19,27944,18962,46906
520570,201903,16,9,7,8982,6986,15968
520580,201903,292,180,112,179640,111776,291416
520590,201903,162,99,63,98802.98,62874,161676.98
520620,201903,1155,544,611,542913.96,609778,1152691.96
520630,201903,42,26,16,25948,15968,41916
520640,201903,401,234,167,233532,167664,401196
520650,201903,62,40,22,39920,21956,61876
520660,201903,36,20,16,19960.98,15968,35928.98
520670,201903,36,31,5,30938,4990,35928
520680,201903,55,36,19,35928,18962,54890
520690,201903,35,12,23,11976,23952.98,35928.98
520710,201903,38,34,4,33932,3992,37924
520725,201903,190,124,66,123752,65868,189620
520735,201903,58,41,17,40918,16966,57884
520740,201903,407,201,206,200598.3,205588.98,406187.28
520750,201903,36,28,8,27944,7984,35928
520753,201903,58,39,19,38922,18962,57884
520760,201903,116,79,37,79840,37924,117764
520780,201903,296,219,77,218562,76846.96,295408.96
520790,201903,153,81,72,80838,71856,152694
520800,201903,3430,1845,1585,1843308.19,1582828.88,3426137.07
520810,201903,173,127,46,126746,45908,172654
520815,201903,4,4,0,3992,0,3992
520830,201903,148,104,44,103792,43912,147704
520840,201903,352,236,116,236526,116766,353292
520850,201903,105,68,37,67864.98,36926,104790.98
520860,201903,1712,1103,609,1102790.4,609778.4,1712568.8
520870,201903,31588,15445,16143,15452054.12,16152661.07,31604715.19
520880,201903,1113,605,508,603790.4,506984,1110774.4
520890,201903,799,476,323,478043.38,324350,802393.38
520910,201903,1009,541,468,542912.88,472054,1014966.88
520915,201903,102,78,24,77844,23952,101796
520920,201903,397,189,208,188622,208582,397204
520929,201903,17,16,1,15968,998,16966
520940,201903,75,49,26,48902,25948,74850
520945,201903,19,11,8,10978,7984,18962
520960,201903,49,31,18,30938,17964,48902
520970,201903,328,203,125,203592.98,126746,330338.98
520980,201903,86,64,22,63872,21956,85828
520990,201903,470,318,152,317364,151696,469060
520993,201903,122,59,63,59880,63872,123752
520995,201903,246,139,107,139720.66,106787.2,246507.86
521000,201903,1590,933,657,933130.6,657683.2,1590813.8
521010,201903,671,319,352,318366.12,351297.96,669664.08
521015,201903,17,11,6,10978,6986,17964
521020,201903,1449,1017,432,1016962.98,433134.36,1450097.34
521030,201903,50,35,15,34930,14970,49900
521040,201903,943,588,355,589818.9,354290.4,944109.3
521056,201903,39,29,10,28942,9980,38922
521060,201903,133,87,46,86826,47904,134730
521080,201903,459,346,113,346307.38,113772,460079.38
521090,201903,537,333,204,333332,203592,536924
521100,201903,277,209,68,208915.64,67864,276779.64
521120,201903,1045,740,305,741514.4,305388.98,1046903.38
521130,201903,363,261,102,261476,101799.34,363275.34
521140,201903,176,94,82,93812,81836,175648
521150,201903,2755,1197,1558,1196605.34,1555883.96,2752489.30
521160,201903,32,16,16,16966,15968,32934
521170,201903,194,112,82,112774,82834,195608
521180,201903,1157,737,420,736524.2,420158.9,1156683.1
521190,201903,2545,1076,1469,1073848,1468058,2541906
521200,201903,49,36,13,35928,12974,48902
521205,201903,11,8,3,7984,2994,10978
521210,201903,138,78,60,77844,59880,137724
521220,201903,817,563,254,562872,253492.9,816364.9
521225,201903,33,22,11,21956,10978,32934
521230,201903,110,74,36,73852,35928,109780
521250,201903,6173,3572,2601,3570848.12,2599792.84,6170640.96
521260,201903,24,15,9,14970,8982,23952
521270,201903,142,112,30,111776,29940,141716
521280,201903,441,265,176,264470,175648,440118
521290,201903,29,12,17,11976,16966,28942
521295,201903,100,68,32,67864,31936,99800
521300,201903,219,116,103,116767.96,103795.34,220563.30
521305,201903,37,26,11,25948,10978,36926
521308,201903,1074,800,274,801686.08,274451.38,1076137.46
521310,201903,1339,791,548,789955.16,547903.34,1337858.50
521340,201903,21,16,5,15968,4990,20958
521350,201903,127,95,32,96806,31936,128742
521370,201903,188,129,59,128742,59880,188622
521375,201903,179,98,81,97804,82834,180638
521377,201903,52,37,15,36926,14970,51896
521380,201903,1063,693,370,694609.92,372254,1066863.92
521385,201903,15,8,7,7984,6986,14970
521390,201903,100,80,20,79840,19960,99800
521400,201903,334,214,120,214570,119760,334330
521405,201903,143,78,65,77844,64870,142714
521410,201903,60,39,21,38922,20958,59880
521440,201903,198,143,55,143712,54890,198602
521450,201903,737,410,327,409180,327344,736524
521460,201903,1182,746,436,745506,439120,1184626
521470,201903,12,8,4,7984,3992,11976
521480,201903,44,30,14,29942.94,13974.86,43917.80
521483,201903,315,173,142,172654.4,141716,314370.4
521486,201903,290,187,103,187624,103792.6,291416.6
521487,201903,22,12,10,11976,9980,21956
521490,201903,26,15,11,14970,10978,25948
521500,201903,119,80,39,79840,38922,118762
521520,201903,41,29,12,28942,11976,40918
521523,201903,654,400,254,401196,254490,655686
521525,201903,46,31,15,30938,14970,45908
521530,201903,254,137,117,136726,117764,254490
521540,201903,29,15,14,14970,13972,28942
521550,201903,88,40,48,39923.34,47907.92,87831.26
521560,201903,801,554,247,552892.4,246506.7,799399.1
521565,201903,55,36,19,35928,18962,54890
521570,201903,507,338,169,337324,168662.9,505986.9
521580,201903,59,37,22,36926,21956,58882
521590,201903,37,20,17,19960,16966,36926
521600,201903,27,16,11,15968,10978,26946
521630,201903,245,131,114,130738,113775.44,244513.44
521640,201903,303,159,144,158682,143712,302394
521645,201903,28,15,13,14970,12974,27944
521680,201903,222,140,82,139720,81836.6,221556.6
521690,201903,2,2,0,1996,0,1996
521710,201903,1166,562,604,561874,602792.98,1164666.98
521720,201903,540,370,170,371256,169660.94,540916.94
521730,201903,636,305,331,306386.8,330338.4,636725.2
521740,201903,900,374,526,373252.98,525950.32,899203.30
521760,201903,1683,933,750,931633.59,751496.34,1683129.93
521770,201903,816,520,296,522952,298402,821354
521800,201903,2028,1273,755,1270466.38,755495.8,2025962.18
521805,201903,32,19,13,18962,12974,31936
521810,201903,89,57,32,56886,31936,88822
521830,201903,952,677,275,675646.13,274450.98,950097.11
521839,201903,85,55,30,54890,29940,84830
521850,201903,1094,581,513,581838.99,512988.48,1094827.47
521860,201903,355,227,128,226546,127744,354290
521870,201903,70,41,29,40918,28942,69860
521878,201903,39,19,20,18962,19960,38922
521880,201903,4690,2124,2566,2125742.16,2568858.15,4694600.31
521890,201903,591,420,171,420158,170658,590816
521900,201903,294,238,56,239520,55888,295408
521910,201903,148,102,46,102794,45908,148702
521920,201903,52,26,26,25948,25948,51896
521925,201903,37,23,14,22954,13972,36926
521930,201903,1134,646,488,644715.66,489031.76,1133747.42
521935,201903,34,25,9,24950,8982,33932
521940,201903,192,98,94,97804,94810,192614
521945,201903,15,13,2,12974,1996,14970
521950,201903,9,5,4,4990,3992,8982
521960,201903,74,56,18,55888,17964,73852
521970,201903,413,267,146,266466,145708,412174
521971,201903,89,45,44,44910,43912,88822
521973,201903,30,15,15,14970,14970,29940
521975,201903,1239,638,601,639718.41,600797.1,1240515.51
521980,201903,247,171,76,170658,75848,246506
521990,201903,75,55,20,54890,19960,74850
522000,201903,288,185,103,184630,102794,287424
522005,201903,19,11,8,10978,7984,18962
522010,201903,1129,641,488,642712.98,493012,1135724.98
522015,201903,57,36,21,35928.98,20958,56886.98
522020,201903,879,488,391,487024.4,392214.8,879239.2
522026,201903,29,20,9,19960,8982,28942
522028,201903,16,12,4,11976,3992,15968
522040,201903,761,300,461,299402.46,462077.92,761480.38
522045,201903,2298,1431,867,1432130.7,867264.46,2299395.16
522050,201903,162,80,82,79840,81836,161676
522060,201903,545,353,192,352294,193612,545906
522068,201903,128,87,41,86826,40918,127744
522070,201903,10,10,0,9980,0,9980
522100,201903,43,24,19,23952,18962,42914
522108,201903,41,32,9,31936,8982,40918
522119,201903,56,30,26,29940,25948,55888
522130,201903,78,32,46,31936.98,45911.92,77848.90
522140,201903,3853,1952,1901,1958077.32,1901191.58,3859268.90
522145,201903,51,33,18,32934,19960,52894
522150,201903,65,49,16,48902,15968,64870
522155,201903,52,35,17,34930.98,16966,51896.98
522157,201903,4,3,1,2994,998,3992
522160,201903,1729,1029,700,1032930,702592.98,1735522.98
522170,201903,402,272,130,271456,129740,401196
522180,201903,38,20,18,19960,17964,37924
522185,201903,1958,774,1184,774449.78,1185624.99,1960074.77
522190,201903,43,26,17,25948,18962,44910
522200,201903,298,181,117,180638,116766,297404
522205,201903,156,107,49,107784,48902,156686
522220,201903,161,115,46,115768,45908,161676
522230,201903,32,27,5,26946,4990,31936
530010,201903,55001,28431,26570,28434588.19,26595756.94,55030345.13
110001,201904,516,411,105,411176,105788,516964
110002,201904,2780,1720,1060,1721551.38,1058879.36,2780430.74
110003,201904,87,73,14,72854.18,13972,86826.18
110004,201904,2020,1325,695,1322352.36,696604,2018956.36
110005,201904,438,355,83,354290.4,82834,437124.4
110006,201904,452,349,103,348302,102794,451096
110007,201904,76,62,14,61876,13972,75848
110008,201904,237,136,101,135728,100798,236526
110009,201904,829,584,245,583830.42,245509.58,829340.00
110010,201904,1774,1099,675,1096803.96,674651.44,1771455.40
110011,201904,1865,1451,414,1449096.1,415168,1864264.1
110012,201904,4176,2448,1728,2443104.4,1726542.36,4169646.76
110013,201904,771,603,168,601794,167664,769458
110014,201904,372,318,54,318362.4,53892,372254.4
110015,201904,1435,1161,274,1158679.93,273452,1432131.93
110018,201904,1123,696,427,697602.34,427146.96,1124749.30
110020,201904,15611,9169,6442,9160683.13,6438152.14,15598835.27
110025,201904,646,479,167,478042.4,167664.98,645707.38
110026,201904,39,27,12,26946,11976,38922
110028,201904,1703,1243,460,1240517,459081.2,1699598.2
110029,201904,142,128,14,127744,13972,141716
110030,201904,2452,1665,787,1661513.1,785427.8,2446940.9
110032,201904,290,223,67,222555.35,66866.99,289422.34
110033,201904,668,499,169,499000.8,168662,667662.8
110034,201904,370,273,97,272455.15,96806,369261.15
110037,201904,105,88,17,87824,16966,104790
110040,201904,361,246,115,245508,114770,360278
110045,201904,956,659,297,658681.2,296406.64,955087.84
110050,201904,90,79,11,78842.4,10978,89820.4
110060,201904,82,47,35,46906,35928,82834
110070,201904,116,73,43,72854,42914.4,115768.4
110080,201904,411,245,166,244510,165668,410178
110090,201904,35,28,7,27944,6986,34930
110092,201904,101,54,47,53892,46906,100798
110094,201904,195,140,55,139720,54890,194610
110100,201904,30,25,5,24950,4990,29940
110110,201904,65,39,26,38922,25948,64870
110120,201904,73,61,12,60878,11976,72854
110130,201904,303,248,55,247504.4,54890,302394.4
110140,201904,244,167,77,166666,76846,243512
110143,201904,49,41,8,40918,8982,49900
110145,201904,24,19,5,18962,5988,24950
110146,201904,23,12,11,11976,10978,22954
110147,201904,40,30,10,29940,9980,39920
110148,201904,37,26,11,25948,10978,36926
110149,201904,307,216,91,215568,90818,306386
110150,201904,135,106,29,105788,28942,134730
110155,201904,7,6,1,5988,998,6986
110160,201904,66,55,11,54890,10978,65868
110170,201904,206,166,40,165668,39920,205588
110175,201904,56,41,15,40918,14970,55888
110180,201904,95,82,13,81836,12974,94810
120001,201904,146,99,47,98802,46907.98,145709.98
120005,201904,194,119,75,118762,74850,193612
120010,201904,1059,676,383,674649.27,383232.98,1057882.25
120013,201904,149,102,47,101796,46906,148702
120017,201904,92,57,35,56886,34930,91816
120020,201904,3572,2870,702,2878233.83,707582,3585815.83
120025,201904,569,326,243,325348.98,242514,567862.98
120030,201904,1052,888,164,886225,165668,1051893
120032,201904,47,41,6,40918,5988,46906
120033,201904,216,190,26,189620,25948,215568
120034,201904,165,120,45,119760,45908,165668
120035,201904,37,28,9,27944,8982,36926
120038,201904,395,252,143,251496,142714,394210
120039,201904,25,24,1,23952,998,24950
120040,201904,14088,9747,4341,9737846.89,4348309.49,14086156.38
120042,201904,48,43,5,42914,4990,47904
120043,201904,10,3,7,2994,6986,9980
120045,201904,546,357,189,356286.98,188622.98,544909.96
120050,201904,1272,976,296,975047.68,296406,1271453.68
120060,201904,1455,1188,267,1185624,267464,1453088
120070,201904,485,348,137,348303.2,137724,486027.2
120080,201904,169,106,63,105788,62874,168662
130002,201904,149,107,42,106786,41916,148702
130006,201904,74,43,31,42914,30938,73852
130008,201904,140,74,66,73852,65868,139720
130010,201904,142,79,63,78842,62874,141716
130014,201904,259,186,73,185628,72854,258482
130020,201904,93,52,41,51896,40918,92814
130030,201904,935,559,376,557882,376246,934128
130040,201904,325,161,164,160678,163672.36,324350.36
130050,201904,596,319,277,318362,276446,594808
130060,201904,869,593,276,591814,275448,867262
130063,201904,582,325,257,324350,256486,580836
130068,201904,188,123,65,122754,64870,187624
130070,201904,1318,904,414,903190,413172,1316362
130080,201904,681,447,234,446106,233532.98,679638.98
130083,201904,70,39,31,38922,31936,70858
130090,201904,365,186,179,185628,178642,364270
130100,201904,1128,503,625,501994,623750,1125744
130110,201904,713,302,411,301396,410178,711574
130115,201904,172,73,99,72854,98802,171656
130120,201904,1630,1050,580,1047900,580836,1628736
130130,201904,612,425,187,424150,186626,610776
130140,201904,1513,1154,359,1151692,358282,1509974
130150,201904,419,361,58,360278,57884,418162
130160,201904,464,268,196,267464,195608,463072
130165,201904,27,20,7,19960,6986,26946
130170,201904,971,694,277,693546.12,276446,969992.12
130180,201904,149,89,60,88822,59880,148702
130185,201904,2423,1163,1260,1161672,1257480.8,2419152.8
130190,201904,3552,2242,1310,2237517.28,1308378,3545895.28
130195,201904,285,228,57,227544,56886,284430
130200,201904,174,82,92,81836,91816,173652
130210,201904,78,41,37,40918,36926,77844
130220,201904,182,125,57,124750,56886,181636
130230,201904,326,210,116,209580,117764,327344
130240,201904,1400,891,509,889218.99,507982,1397200.99
130250,201904,4847,3125,1722,3118750.4,1718556,4837306.4
130255,201904,431,210,221,209580,220558,430138
130260,201904,55381,26802,28579,26762296.75,28544800.75,55307097.50
130270,201904,1592,1064,528,1061961.82,527942,1589903.82
130280,201904,125,75,50,74850,49900,124750
130290,201904,2126,1526,600,1522948,598800,2121748
130300,201904,445,313,132,312374,131736,444110
130310,201904,879,460,419,459080,418162,877242
130320,201904,485,269,216,269460,216566,486026
130330,201904,738,453,285,452094,284430,736524
130340,201904,3518,2072,1446,2067856.8,1444106.8,3511963.6
130350,201904,458,298,160,297404,159680,457084
130353,201904,856,366,490,365268.4,489020,854288.4
130356,201904,822,379,443,378242,443112,821354
130360,201904,64,40,24,39920,23952,63872
130370,201904,676,513,163,511974,162674,674648
130380,201904,673,489,184,489020,183632,672652
130390,201904,489,389,100,388222,99800,488022
130395,201904,175,40,135,39920,134730,174650
130400,201904,63,43,20,42914,19960,62874
130406,201904,2068,1296,772,1293409.29,771455.28,2064864.57
130410,201904,475,211,264,210578,263472,474050
130420,201904,3164,2573,591,2571946.7,593810,3165756.7
130423,201904,158,77,81,76846,80838,157684
130426,201904,153,87,66,86826,65868,152694
130430,201904,406,263,143,263472,144710,408182
130440,201904,205,69,136,68862,135728,204590
140002,201904,34,11,23,10978,22954,33932
140005,201904,204,127,77,126746,76846,203592
140010,201904,10553,7019,3534,7006969.96,3531926.22,10538896.18
140015,201904,139,64,75,63872,74850,138722
140017,201904,118,82,36,81836,35928,117764
140020,201904,471,317,154,316366,153692,470058
140023,201904,45,23,22,22954.54,21956,44910.54
140028,201904,18,11,7,10978,6986,17964
140030,201904,350,251,99,250498,98802,349300
140040,201904,56,39,17,38922,16966,55888
140045,201904,240,107,133,106786,132734,239520
140047,201904,633,429,204,429140,203592,632732
140050,201904,145,93,52,92814,51896,144710
140060,201904,39,28,11,27944,10978,38922
140070,201904,34,31,3,30938,2994,33932
150010,201904,4698,2962,1736,2956076.4,1733526.4,4689602.8
150013,201904,159,113,46,112774,45908,158682
150020,201904,1069,584,485,582832,484030,1066862
150030,201904,702,292,410,291416,409180,700596
150034,201904,199,129,70,128742,69860,198602
150040,201904,1424,855,569,853290,567862,1421152
150050,201904,633,373,260,372254,259480,631734
150060,201904,4794,3115,1679,3109685.68,1678636.98,4788322.66
150070,201904,312,141,171,140718,170658,311376
150080,201904,14337,7210,7127,7198582.85,7115752.69,14314335.54
150085,201904,414,266,148,265468,147704,413172
150090,201904,754,644,110,642712,109780,752492
150095,201904,348,221,127,220558,126746,347304
150100,201904,59,39,20,38922,19960,58882
150110,201904,174,89,85,88822,84830,173652
150120,201904,428,315,113,314370,112774,427144
150125,201904,55,22,33,21956,32934,54890
150130,201904,1974,1070,904,1069856,902192,1972048
150140,201904,54246,25463,28783,25419075.56,28736635.88,54155711.44
150145,201904,188,105,83,104790,82834,187624
150150,201904,2851,1313,1538,1312370,1535922.8,2848292.8
150157,201904,407,287,120,286426,119760,406186
150160,201904,126,98,28,97804,28942,126746
150170,201904,3674,2748,926,2743502,925146,3668648
150172,201904,332,225,107,224550,106786,331336
150175,201904,81,51,30,50898,29940,80838
150178,201904,792,527,265,525946.4,264470,790416.4
150180,201904,3121,1535,1586,1531930.5,1582828.4,3114758.9
150190,201904,334,215,119,214570,118762,333332
150195,201904,118,60,58,59880,57884,117764
150200,201904,198,95,103,94810,102794,197604
150210,201904,3151,2571,580,2566856,578840.99,3145696.99
150215,201904,543,353,190,352294,189620.4,541914.4
150220,201904,3764,2571,1193,2565859.52,1190615.4,3756474.92
150230,201904,1163,944,219,943110.45,218562,1161672.45
150240,201904,5992,3531,2461,3525937.29,2457076.98,5983014.27
150250,201904,33,16,17,15968,16966,32934
150260,201904,80,49,31,48902,30938,79840
150270,201904,2321,1510,811,1507978,810376.8,2318354.8
150275,201904,551,348,203,347304,202594,549898
150276,201904,108,49,59,48902,58882,107784
150277,201904,760,330,430,329340.98,429140,758480.98
150280,201904,330,211,119,210578,118762,329340
150285,201904,87,44,43,43912,42914,86826
150290,201904,951,585,366,583830,365268.4,949098.4
150293,201904,650,310,340,309380,339320,648700
150295,201904,479,221,258,220558,257484,478042
150300,201904,76,40,36,39920,35928,75848
150304,201904,166,107,59,106786,58882,165668
150307,201904,387,323,64,322354,63872,386226
150309,201904,573,420,153,419160.98,152697.6,571858.58
150310,201904,245,165,80,164670,79840,244510
150320,201904,2032,1419,613,1416162,611774,2027936
150330,201904,2080,1209,871,1206582,870256,2076838
150340,201904,202,137,65,136726,64870,201596
150345,201904,611,343,268,342314,267464,609778
150350,201904,403,320,83,319360,82834,402194
150360,201904,4600,2971,1629,2969051.49,1627738,4596789.49
150370,201904,786,552,234,551894.98,235528.98,787423.96
150375,201904,196,103,93,102794,92814,195608
150380,201904,1431,969,462,967062,461076,1428138
150390,201904,745,430,315,429140.99,314370,743510.99
150400,201904,104,87,17,86826,16966,103792
150405,201904,1251,817,434,815366.92,433132,1248498.92
150410,201904,128,86,42,85828,41916,127744
150420,201904,7453,4104,3349,4098960.58,3349333.88,7448294.46
150430,201904,545,366,179,365268,178642,543910
150440,201904,570,346,224,345308,223552,568860
150442,201904,2248,1220,1028,1217560.58,1025944,2243504.58
150445,201904,533,346,187,345308,186626,531934
150450,201904,248,122,126,121756,125748,247504
150460,201904,742,563,179,561874.4,178642,740516.4
150470,201904,1332,814,518,812372,517962,1330334
150475,201904,48,36,12,35928,11976,47904
150480,201904,1270,893,377,891214,377244,1268458
150490,201904,602,329,273,328342,272454,600796
150495,201904,326,235,91,235528,90818,326346
150497,201904,299,199,100,198602,99800,298402
150500,201904,206,136,70,135728,69860,205588
150503,201904,910,453,457,452094.4,456087.38,908181.78
150506,201904,986,657,329,655686,329340,985026
150510,201904,1231,703,528,701594.4,527942,1229536.4
150520,201904,273,185,88,184630,87824,272454
150530,201904,1623,901,722,899198.5,722552,1621750.5
150540,201904,236,166,70,165668,69860,235528
150543,201904,770,426,344,425148,343312,768460
150548,201904,492,346,146,345308,145708,491016
150549,201904,61,44,17,43912,16966,60878
150550,201904,2855,1517,1338,1515962.5,1338318.4,2854280.9
150553,201904,3226,1917,1309,1915162.8,1307380,3222542.8
150555,201904,147,80,67,79840,66866,146706
150560,201904,16,10,6,9980,5988,15968
150563,201904,85,44,41,43912,40918,84830
150565,201904,170,104,66,103792,65868,169660
150570,201904,413,278,135,277444,134730,412174
150580,201904,1580,722,858,720556,856284,1576840
150590,201904,801,515,286,513970,285428,799398
150600,201904,459,283,176,283432,175648,459080
150610,201904,141,122,19,121756,18962,140718
150611,201904,120,83,37,82834,36926,119760
150613,201904,3222,1983,1239,1980032,1238518.98,3218550.98
150616,201904,496,298,198,297404.5,197604,495008.5
150618,201904,1262,687,575,685626.98,573850,1259476.98
150619,201904,403,308,95,307384,94810,402194
150620,201904,1279,760,519,758480,517962.99,1276442.99
150630,201904,292,194,98,193612,97804,291416
150635,201904,494,214,280,213572,279440,493012
150640,201904,57,28,29,27944,28942,56886
150650,201904,2364,1387,977,1385474.4,975047.39,2360521.79
150655,201904,246,183,63,182634,62874,245508
150658,201904,103,59,44,58882,43912,102794
150660,201904,500,351,149,350298,148702,499000
150670,201904,1017,374,643,373252.98,641714.98,1014967.96
150680,201904,9884,5466,4418,5464052.3,4418147.96,9882200.26
150690,201904,13,8,5,7984,4990,12974
150700,201904,496,330,166,329340,165668,495008
150710,201904,280,161,119,160678,118762,279440
150715,201904,840,516,324,514968.98,324350,839318.98
150720,201904,416,326,90,325348,89820,415168
150730,201904,970,523,447,521954.98,446106,968060.98
150740,201904,222,155,67,155688,66866,222554
150745,201904,813,443,370,442114,369260,811374
150746,201904,51,32,19,31936,18962,50898
150747,201904,250,194,56,193612,55888,249500
150750,201904,132,76,56,75848,55888,131736
150760,201904,1752,1154,598,1151692,596804,1748496
150770,201904,379,206,173,205588,172654,378242
150775,201904,96,43,53,42914,52894,95808
150780,201904,193,107,86,106786,85828,192614
150790,201904,860,475,385,474050,384230,858280
150795,201904,1498,890,608,888220,608780,1497000
150796,201904,373,215,158,214570,157684,372254
150797,201904,291,159,132,158682,131736,290418
150800,201904,1446,869,577,867262,575846.97,1443108.97
150803,201904,591,489,102,488022,101796,589818
150805,201904,190,120,70,119760,69860.99,189620.99
150808,201904,1010,553,457,551894,456086,1007980
150810,201904,3381,2357,1024,2352287.41,1021952.4,3374239.81
150812,201904,437,238,199,238522,198602,437124
150815,201904,973,646,327,644708,326346,971054
150820,201904,1565,961,604,959078,602792,1561870
150830,201904,800,576,224,574848,224550,799398
150835,201904,199,120,79,119760,78842,198602
150840,201904,1361,870,491,868260.2,490018,1358278.2
160005,201904,53,32,21,31936,20958,52894
160010,201904,189,119,70,118762,69860.99,188622.99
160015,201904,120,72,48,71856,47904,119760
160020,201904,133,76,57,75848,56886,132734
160021,201904,44,24,20,23952,19960,43912
160023,201904,120,75,45,74850,44910,119760
160025,201904,29,13,16,12974,15968,28942
160027,201904,1494,864,630,863303.76,629738,1493041.76
160030,201904,15707,8185,7522,8172631.76,7517944.74,15690576.50
160040,201904,302,177,125,176646,124750,301396
160050,201904,717,366,351,365268,351296.94,716564.94
160053,201904,323,187,136,186626.4,135728,322354.4
160055,201904,32,23,9,22954,8982,31936
160060,201904,6527,3477,3050,3474039.99,3051885.39,6525925.38
160070,201904,172,105,67,104790,66866,171656
160080,201904,88,45,43,44910,42914,87824
170025,201904,24,14,10,13972,10978,24950
170030,201904,224,184,40,183632.88,39920,223552.88
170035,201904,227,107,120,106786,119760,226546
170040,201904,180,140,40,139720,40918,180638
170070,201904,322,197,125,196606,125748,322354
170100,201904,367,265,102,264470,101796,366266
170105,201904,59,48,11,47904,10978,58882
170110,201904,111,70,41,69860,40918,110778
170130,201904,65,32,33,31936,32934.4,64870.4
170190,201904,97,63,34,62874,33932,96806
170200,201904,385,262,123,261476.98,123752.9,385229.88
170210,201904,6025,3193,2832,3186616.9,2827336.58,6013953.48
170215,201904,111,51,60,50898,60878,111776
170220,201904,1422,1052,370,1050894,369260,1420154
170230,201904,156,105,51,104790,50898,155688
170240,201904,533,355,178,354290.8,177644,531934.8
170255,201904,1111,896,215,894208,215568,1109776
170270,201904,41,29,12,28942,11976,40918
170290,201904,103,77,26,76846,25948,102794
170300,201904,87,58,29,57884,28942.4,86826.4
170305,201904,49,38,11,37924,10978,48902
170307,201904,62,47,15,46906,14970,61876
170310,201904,107,61,46,60878,45908,106786
170320,201904,23,18,5,17964,4990,22954
170330,201904,25,23,2,22954,1996,24950
170360,201904,28,17,11,16966,10978,27944
170370,201904,125,66,59,65868,58882,124750
170380,201904,83,64,19,63872,18962,82834
170382,201904,44,39,5,38922,4990,43912
170384,201904,143,108,35,107784,34930,142714
170386,201904,61,26,35,25948,34930,60878
170388,201904,49,19,30,18962,29940,48902
170389,201904,25,20,5,19960,4990,24950
170390,201904,59,35,24,34930.98,23952,58882.98
170410,201904,32,23,9,22954,8982,31936
170460,201904,17,13,4,12974,3992,16966
170510,201904,36,29,7,28942,6986,35928
170550,201904,1530,899,631,898200,629738,1527938
170555,201904,110,79,31,78842,30938,109780
170560,201904,97,72,25,71856,24950,96806
170600,201904,37,18,19,17964,18962,36926
170610,201904,188,99,89,99800,88824.36,188624.36
170625,201904,37,20,17,19960,16966,36926
170650,201904,78,60,18,59880,17964,77844
170700,201904,571,434,137,433132.5,136726,569858.5
170710,201904,161,99,62,98802,61877.96,160679.96
170720,201904,86,69,17,68862,16966,85828
170730,201904,78,47,31,46906,30938,77844
170740,201904,89,66,23,65868,22954,88822
170755,201904,64,34,30,33932,29940,63872
170765,201904,136,71,65,70858.2,64870,135728.2
170770,201904,219,134,85,134730,84830,219560
170820,201904,602,398,204,397204,204590.42,601794.42
170825,201904,32,18,14,17964,13972,31936
170830,201904,86,67,19,66866,18962,85828
170900,201904,190,149,41,148702,40918,189620
170930,201904,874,466,408,467064.52,407184.4,874248.92
170950,201904,3085,1403,1682,1400195.38,1680634.05,3080829.43
170980,201904,18,10,8,9980,7984,17964
171050,201904,145,114,31,113772,30938,144710
171070,201904,38,32,6,31936,5988,37924
171090,201904,44,33,11,33932,10978,44910
171110,201904,21,13,8,12974,8982,21956
171150,201904,44,23,21,22954,20958,43912
171180,201904,24,12,12,11976,11976,23952
171190,201904,150,86,64,85828,63872,149700
171195,201904,63,51,12,50898,11976,62874
171200,201904,49,25,24,24950,23952,48902
171215,201904,4,3,1,2994,998,3992
171240,201904,55,45,10,44910,9980,54890
171245,201904,55,49,6,48902,5988,54890
171250,201904,71,39,32,38922,32934,71856
171270,201904,16,12,4,11976,3992,15968
171280,201904,41,37,4,36926.7,3992,40918.7
171320,201904,991,582,409,580836,409180,990016
171330,201904,429,211,218,210578,217564,428142
171360,201904,86,63,23,62874,23952,86826
171370,201904,28,16,12,15968,11976,27944
171380,201904,136,111,25,110778,24950,135728
171395,201904,54,35,19,34930,18962,53892
171420,201904,293,193,100,192614,99800,292414
171430,201904,68,56,12,55888,11976,67864
171488,201904,188,104,84,103792,83832,187624
171500,201904,58,32,26,31936,25948,57884
171510,201904,67,45,22,44910,21956,66866
171515,201904,42,35,7,34930,6986.4,41916.4
171525,201904,29,27,2,26946,1996,28942
171550,201904,11,8,3,7984,2994,10978
171570,201904,57,29,28,28942,27944,56886
171575,201904,324,207,117,206586,116766,323352
171610,201904,1741,886,855,884234.84,853300.78,1737535.62
171620,201904,135,95,40,94810,39920,134730
171630,201904,53,27,26,26946,25948,52894
171650,201904,273,184,89,183632,88822,272454
171660,201904,266,147,119,146706,118762.4,265468.4
171665,201904,54,38,16,37924,15968,53892
171670,201904,428,248,180,247504.5,179640,427144.5
171700,201904,68,60,8,59880,7984,67864
171720,201904,25,10,15,9980,14970,24950
171750,201904,102,54,48,53892,47904,101796
171780,201904,78,63,15,62874,14970,77844
171790,201904,78,67,11,66866,10978,77844
171800,201904,38,30,8,29940,7984,37924
171820,201904,2090,1213,877,1210574.44,878240.98,2088815.42
171830,201904,34,27,7,26946,6986,33932
171840,201904,62,40,22,39920,21956,61876
171845,201904,30,18,12,17964,11976,29940
171850,201904,40,30,10,29940,9980,39920
171855,201904,79,63,16,62874,15968,78842
171865,201904,9,8,1,7984,998,8982
171870,201904,33,23,10,22954,9980,32934
171875,201904,81,57,24,56886,23952,80838
171880,201904,33,22,11,21956,10978,32934
171884,201904,47,24,23,23952,22954,46906
171886,201904,123,49,74,48902,73852,122754
171888,201904,27,21,6,20958,5988,26946
171889,201904,19,14,5,13972,4990,18962
171890,201904,58,48,10,47904,9980,57884
171900,201904,43,30,13,29940,12974,42914
172000,201904,40,33,7,32934,6986,39920
172010,201904,44,36,8,35928,7984,43912
172015,201904,28,18,10,17964.58,9980,27944.58
172020,201904,139,89,50,88822,49900,138722
172025,201904,31,20,11,19960,10978,30938
172030,201904,40,25,15,24950,14970,39920
172049,201904,79,50,29,49900,28942,78842
172065,201904,148,96,52,95808,51896,147704
172080,201904,99,66,33,65868,32934,98802
172085,201904,25,13,12,12974,11976,24950
172090,201904,419,328,91,328342,90818,419160
172093,201904,25,19,6,18962,5988,24950
172097,201904,17,10,7,9980,6986.4,16966.4
172100,201904,4922,2818,2104,2812366.84,2102787.98,4915154.82
172110,201904,80,53,27,52894,26946,79840
172120,201904,1677,1437,240,1435125.5,240518.96,1675644.46
172125,201904,3,3,0,2994,,2994.0
172130,201904,18,13,5,12974,4990,17964
172208,201904,200,125,75,124750,74850,199600
172210,201904,389,192,197,191616,196606.4,388222.4
210005,201904,2965,1860,1105,1857278.75,1103792.4,2961071.15
210010,201904,181,93,88,92814,87824,180638
210015,201904,39,29,10,28942,9980,38922
210020,201904,348,190,158,189620,157684,347304
210030,201904,338,216,122,215568,121756.98,337324.98
210040,201904,142,111,31,110778,30938,141716
210043,201904,263,191,72,190618,71856,262474
210047,201904,580,322,258,321356,258482,579838
210050,201904,299,221,78,220558,77844,298402
210055,201904,44,33,11,32934,10978,43912
210060,201904,562,450,112,449100,111776,560876
210070,201904,418,315,103,314370,102794,417164
210080,201904,110,100,10,99800,9980,109780
210083,201904,305,143,162,142714,161676,304390
210087,201904,40,30,10,29940,9980,39920
210090,201904,473,333,140,332334,139720,472054
210095,201904,468,348,120,347304,119760,467064
210100,201904,695,542,153,540916,152694,693610
210110,201904,143,83,60,82834,59880,142714
210120,201904,5341,4097,1244,4090811.08,1241513.53,5332324.61
210125,201904,208,124,84,123752,83832,207584
210130,201904,517,287,230,286426,229540,515966
210135,201904,32,19,13,18962,12974,31936
210140,201904,4410,3470,940,3463060.6,938120,4401180.6
210150,201904,376,241,135,240518,134730,375248
210160,201904,3417,2883,534,2877234.55,532932,3410166.55
210170,201904,1202,958,244,956084,243512,1199596
210173,201904,134,114,20,113772,19960,133732
210177,201904,425,221,204,220558,203592,424150
210180,201904,33,18,15,17964,14970,32934
210190,201904,416,276,140,275448,140718,416166
210193,201904,2,1,1,998,998,1996
210197,201904,81,55,26,54890,25948,80838
210200,201904,641,515,126,513970,125748,639718
210203,201904,254,173,81,172654,80838,253492
210207,201904,383,301,82,300398,81836,382234
210210,201904,781,724,57,722552,56886,779438
210215,201904,79,69,10,68862,9980,78842
210220,201904,404,336,68,335328,67864,403192
210230,201904,306,237,69,236526,68862,305388
210232,201904,1469,969,500,967062,499000,1466062
210235,201904,162,127,35,126746.6,34930,161676.6
210237,201904,43,25,18,24950,17964,42914
210240,201904,91,76,15,75848,14970,90818
210250,201904,191,158,33,157684,32934,190618
210255,201904,359,269,90,268462,89820,358282
210260,201904,411,272,139,271456,138722,410178
210270,201904,682,445,237,444110,237524,681634
210275,201904,56,43,13,42914,12974,55888
210280,201904,1065,695,370,694608.48,369260,1063868.48
210290,201904,513,348,165,347304,164670,511974
210300,201904,5821,3531,2290,3524936.39,2285420.97,5810357.36
210310,201904,112,79,33,78842,32934,111776
210312,201904,117,80,37,79840,36926,116766
210315,201904,116,88,28,87824,27944,115768
210317,201904,123,91,32,90818,31936,122754
210320,201904,2377,1992,385,1988016.96,384230,2372246.96
210325,201904,130,92,38,91816,37924.4,129740.4
210330,201904,5150,2803,2347,2798392.7,2349292,5147684.7
210340,201904,1341,977,364,975046,363273.94,1338319.94
210350,201904,625,520,105,518960,104790,623750
210355,201904,149,120,29,119760,28942,148702
210360,201904,2539,1644,895,1640712.06,894208.4,2534920.46
210370,201904,1251,571,680,569858,678640,1248498
210375,201904,193,99,94,98802,93812,192614
210380,201904,717,543,174,541914,173652,715566
210390,201904,202,169,33,168662,32934,201596
210400,201904,422,361,61,361276,60878.96,422154.96
210405,201904,1015,698,317,696604,317364,1013968
210407,201904,56,45,11,44910,10978,55888
210408,201904,63,57,6,56886,5988,62874
210409,201904,335,284,51,283432,50898,334330
210410,201904,444,348,96,347304,95808.98,443112.98
210420,201904,202,165,37,164670,36926,201596
210430,201904,41,27,14,26946,13972,40918
210440,201904,357,227,130,226546,129740,356286
210450,201904,157,122,35,121756,34930,156686
210455,201904,230,126,104,125748,103792,229540
210460,201904,334,215,119,214570,118762,333332
210462,201904,68,57,11,56886,10978,67864
210465,201904,163,119,44,118762,44910,163672
210467,201904,533,386,147,385228,146706,531934
210470,201904,47,40,7,39920,6986,46906
210480,201904,1315,933,382,932132,381236,1313368
210490,201904,213,137,76,136726,75848,212574
210500,201904,566,320,246,319360,245508,564868
210510,201904,575,453,122,452094,121756,573850
210515,201904,421,242,179,241516,178642,420158
210520,201904,418,365,53,364270,52894,417164
210530,201904,9450,5074,4376,5064855.92,4370246.6,9435102.52
210535,201904,128,94,34,93812,33932,127744
210540,201904,1535,970,565,968060.2,563870,1531930.2
210542,201904,1200,599,601,598800,599798.4,1198598.4
210545,201904,16,15,1,14970,998,15968
210547,201904,131,113,18,112774,17964,130738
210550,201904,721,519,202,518961.4,202594,721555.4
210560,201904,176,150,26,149700,25948,175648
210565,201904,31,23,8,22954,7984,30938
210570,201904,1359,1083,276,1080834.44,275448,1356282.44
210580,201904,114,99,15,98802,14970,113772
210590,201904,773,625,148,623750,147704,771454
210592,201904,32,29,3,28942,2994,31936
210594,201904,107,89,18,88822,17964,106786
210596,201904,96,82,14,81836,13972,95808
210598,201904,127,95,32,94810,31936,126746
210600,201904,342,291,51,290418,50898,341316
210610,201904,258,239,19,238522,18962,257484
210620,201904,45,27,18,26946,17964,44910
210630,201904,69,66,3,65868,2994,68862
210632,201904,1057,719,338,717562,337324,1054886
210635,201904,21,17,4,16966,3992,20958
210637,201904,101,71,30,70858,29940,100798
210640,201904,588,515,73,514968,72854,587822
210650,201904,413,340,73,339320,72854,412174
210660,201904,393,292,101,291416,101796,393212
210663,201904,24,15,9,14970,8982,23952
210667,201904,112,36,76,35928,75848,111776
210670,201904,266,234,32,233532,31936,265468
210675,201904,572,305,267,304390,266466,570856
210680,201904,218,139,79,138722,78842,217564
210690,201904,641,517,124,515966,123752,639718
210700,201904,178,131,47,130738,46906,177644
210710,201904,278,164,114,163672,114770,278442
210720,201904,136,118,18,117764,17964,135728
210725,201904,71,63,8,62874,7984,70858
210730,201904,25,18,7,17964,6986,24950
210735,201904,404,280,124,279440,123752.4,403192.4
210740,201904,558,475,83,474050,82834,556884
210745,201904,158,117,41,116766,40918,157684
210750,201904,2453,1182,1271,1180634.5,1270454.4,2451088.9
210760,201904,269,203,66,202594,66866,269460
210770,201904,406,317,89,316366,88822,405188
210780,201904,423,311,112,310378,111776,422154
210790,201904,187,146,41,145708,40918,186626
210800,201904,167,125,42,124750,41916,166666
210805,201904,53,49,4,48902,3992,52894
210810,201904,485,383,102,382234,101796,484030
210820,201904,2294,1866,428,1862269.76,427144,2289413.76
210825,201904,167,89,78,88822,77844,166666
210830,201904,769,492,277,491016,276446,767462
210840,201904,206,141,65,140718,64870,205588
210845,201904,256,169,87,168662,86826,255488
210850,201904,807,527,280,526944,279440,806384
210860,201904,4012,2152,1860,2148694.9,1856280,4004974.9
210870,201904,483,370,113,369260,112774,482034
210880,201904,70,53,17,52894,16966,69860
210890,201904,339,287,52,286426,51896,338322
210900,201904,609,392,217,391216,216566,607782
210905,201904,65,32,33,31936,32934,64870
210910,201904,2017,1516,501,1512969.48,499998,2012967.48
210920,201904,199,66,133,65868,132734,198602
210923,201904,81,57,24,56886,23952,80838
210927,201904,427,190,237,189620,236526,426146
210930,201904,73,58,15,57884,14970,72854
210940,201904,91,72,19,71856,18962,90818
210945,201904,202,99,103,98802,102794,201596
210950,201904,530,392,138,391216,137724,528940
210955,201904,74,49,25,48902,24950,73852
210960,201904,2351,1075,1276,1073848,1273448,2347296
210970,201904,115,102,13,101796,12974,114770
210975,201904,90,81,9,80838,8982,89820
210980,201904,1164,536,628,534928,626744.4,1161672.4
210990,201904,4247,2694,1553,2689611,1550892,4240503
211000,201904,1374,1098,276,1095804.4,275448,1371252.4
211003,201904,894,620,274,618760,273452.98,892212.98
211010,201904,503,445,58,444110,57884,501994
211020,201904,1585,610,975,608780,974048,1582828
211023,201904,33,28,5,27944,4990,32934
211027,201904,72,51,21,50898,20958,71856
211030,201904,393,272,121,271456,120758,392214
211040,201904,318,256,62,255488.4,61876,317364.4
211050,201904,1184,776,408,774448,407184.4,1181632.4
211060,201904,678,580,98,578840.96,97804,676644.96
211065,201904,21,17,4,16966,3992,20958
211070,201904,920,757,163,757482.66,162674,920156.66
211080,201904,88,84,4,83832,3992,87824
211085,201904,60,31,29,30938.4,28942,59880.4
211090,201904,93,75,18,74850,17964,92814
211100,201904,503,407,96,406186,95808.4,501994.4
211102,201904,258,174,84,173652,83832,257484
211105,201904,224,157,67,156686,66866,223552
211107,201904,132,78,54,77844,53892,131736
211110,201904,840,553,287,553890,286426.98,840316.98
211120,201904,5766,2696,3070,2690610.6,3068851.72,5759462.32
211125,201904,32,25,7,24950,6986,31936
211130,201904,44876,19631,25245,19604722.1,25213479.53,44818201.63
211140,201904,433,372,61,371256.99,60878,432134.99
211150,201904,1301,831,470,829338,469061.39,1298399.39
211153,201904,167,99,68,98802,68862,167664
211157,201904,65,51,14,50898,13972,64870
211160,201904,707,594,113,592812,112774,705586
211163,201904,0,0,0,0,0,0
211167,201904,10,9,1,8982,998,9980
211170,201904,439,315,124,314370,123752,438122
211172,201904,122,85,37,84830,36926,121756
211174,201904,265,162,103,161676,102794,264470
211176,201904,507,373,134,372254,133732,505986
211178,201904,92,61,31,60878,30938,91816
211180,201904,209,166,43,165668,42914,208582
211190,201904,68,63,5,62874,4990,67864
211195,201904,32,22,10,21956,9980,31936
211200,201904,153,132,21,131736,20958,152694
211210,201904,504,330,174,329340,174650,503990
211220,201904,4099,2357,1742,2354284.53,1740513.99,4094798.52
211223,201904,96,91,5,90818,4990,95808
211227,201904,71,53,18,52894,17964,70858
211230,201904,777,635,142,633730,141716,775446
211240,201904,416,315,101,314370,100798,415168
211245,201904,192,92,100,91816,99800,191616
211250,201904,1636,1408,228,1406183.59,228543.92,1634727.51
211260,201904,835,671,164,671654,163672,835326
211270,201904,2061,1656,405,1652688,404190.8,2056878.8
211280,201904,1865,1160,705,1157680,703590,1861270
211285,201904,206,125,81,124750,80838,205588
211290,201904,690,472,218,472054,217564,689618
211300,201904,808,633,175,631734.96,174650,806384.96
211400,201904,1580,934,646,932132,644708,1576840
220005,201904,17,16,1,15968,998,16966
220010,201904,90,68,22,67864,21956,89820
220020,201904,658,529,129,527942,128742,656684
220025,201904,110,107,3,106786,2994,109780
220027,201904,39,32,7,31936,6986,38922
220030,201904,107,89,18,88822,17964,106786
220040,201904,1197,907,290,905186.6,291416,1196602.6
220045,201904,42,31,11,30938,10978,41916
220050,201904,688,577,111,575847.08,110778,686625.08
220060,201904,170,148,22,147704,21956,169660
220070,201904,108,100,8,99800,7984,107784
220080,201904,16,14,2,13972,1996,15968
220090,201904,34,28,6,27944,5988,33932
220095,201904,2,1,1,998,998,1996
220100,201904,22,18,4,17964,3992,21956
220105,201904,24,23,1,22954.4,998,23952.4
220110,201904,221,202,19,201596,18962,220558
220115,201904,46,45,1,44910,998,45908
220117,201904,23,21,2,20958,1996,22954
220120,201904,1502,1115,387,1113768,386226,1499994
220130,201904,30,30,0,29940,,29940.0
220140,201904,98,77,21,76846,20958,97804
220150,201904,490,356,134,355288,134730,490018
220155,201904,5,5,0,4990,,4990.0
220157,201904,18,15,3,14970,2994,17964
220160,201904,81,71,10,70858,9980,80838
220170,201904,35,34,1,33932,998,34930
220173,201904,6,6,0,5988,,5988.0
220177,201904,6,6,0,5988,,5988.0
220180,201904,67,67,0,66866,,66866.0
220190,201904,1065,954,111,953090,110778,1063868
220191,201904,44,39,5,38922,4990,43912
220192,201904,71,68,3,67864,2994,70858
220194,201904,44,42,2,41916,1996,43912
220196,201904,99,84,15,83832,14970,98802
220198,201904,4,3,1,2994,998,3992
220200,201904,428,358,70,357284.5,69860,427144.5
220202,201904,38,34,4,33932,3992,37924
220205,201904,43,39,4,38922,3992,42914
220207,201904,13,12,1,11976,998,12974
220208,201904,81,45,36,44910,35928,80838
220209,201904,31,28,3,27944,2994,30938
220210,201904,16,14,2,13972,1996,15968
220211,201904,26,25,1,24950,998,25948
220213,201904,41,37,4,36926,3992.4,40918.4
220217,201904,40,32,8,31936,7984,39920
220220,201904,2106,1367,739,1367260,738521.1,2105781.1
220225,201904,11,5,6,4990,5988,10978
220230,201904,975,772,203,770456,202594,973050
220240,201904,160,147,13,146706,12974,159680
220245,201904,32,29,3,28942.99,2994,31936.99
220250,201904,119,107,12,106786,11976,118762
220253,201904,42,37,5,36926,4990,41916
220255,201904,29,26,3,25948,2994,28942
220260,201904,702,516,186,514968,187624,702592
220265,201904,11,9,2,8982,1996,10978
220270,201904,735,657,78,655686,77844,733530
220271,201904,42,35,7,34930,6986,41916
220272,201904,26,26,0,25948,,25948.0
220273,201904,14,12,2,11976,1996,13972
220275,201904,52,42,10,41916,9980,51896
220277,201904,12,10,2,9980,1996,11976
220280,201904,14,11,3,10978,2994,13972
220285,201904,46,43,3,42914,2994,45908
220290,201904,1465,1259,206,1256482.4,205588.9,1462071.3
220300,201904,49,47,2,46906,1996,48902
220310,201904,314,266,48,265468.99,47904.98,313373.97
220320,201904,435,401,34,400198.4,33932,434130.4
220323,201904,0,0,0,0,0,0
220325,201904,15,10,5,9980,4990,14970
220327,201904,12,11,1,10978,998,11976
220330,201904,212,151,61,150698,60878,211576
220335,201904,135,117,18,116766,17964,134730
220340,201904,33,20,13,19960,12974,32934
220342,201904,60,53,7,52894,6986,59880
220345,201904,83,76,7,75848,6986,82834
220350,201904,435,382,53,381236,52894,434130
220360,201904,42,30,12,29940,11976,41916
220370,201904,1179,962,217,960076,216566,1176642
220375,201904,21,19,2,18962,1996,20958
220380,201904,18,16,2,15968,1996,17964
220385,201904,17,15,2,14970,1996,16966
220390,201904,2311,1329,982,1326342.84,980036.7,2306379.54
220400,201904,31,28,3,27944,2994,30938
220410,201904,19,18,1,17964,998,18962
220415,201904,14,13,1,12974,998,13972
220420,201904,126,105,21,104790,20958,125748
220430,201904,132,120,12,119760,11976,131736
220435,201904,20,14,6,13972,5988,19960
220440,201904,302,258,44,257484,43912,301396
220450,201904,339,174,165,173652,164670,338322
220455,201904,55,53,2,52894,1996,54890
220460,201904,19,19,0,18962,,18962.0
220465,201904,104,68,36,67864,35928,103792
220470,201904,238,208,30,208582,29940,238522
220480,201904,73,64,9,63872,8982,72854
220490,201904,91,78,13,77844,12974,90818
220500,201904,96,83,13,82834,12974,95808
220510,201904,444,344,100,343312,99800,443112
220515,201904,22,20,2,19960,1996,21956
220520,201904,378,339,39,338322.34,38922,377244.34
220525,201904,18,12,6,11976,5988,17964
220527,201904,31,24,7,23952,6986,30938
220530,201904,36,15,21,14970,20958,35928
220535,201904,6,6,0,5988,,5988.0
220540,201904,62,51,11,50898,10978,61876
220545,201904,51,36,15,35928,14970,50898
220550,201904,664,515,149,513970,149700,663670
220551,201904,23,18,5,17964,4990,22954
220552,201904,14,14,0,13972,,13972.0
220553,201904,48,44,4,43912,3992,47904
220554,201904,10,7,3,6986,2994,9980
220555,201904,31,27,4,26946,3992,30938
220556,201904,50,46,4,45908,3992,49900
220557,201904,56,51,5,50898,4990,55888
220558,201904,6,2,4,1996,3992,5988
220559,201904,3,3,0,2994,,2994.0
220560,201904,69,45,24,44910,23952,68862
220570,201904,788,484,304,483032.4,303392,786424.4
220580,201904,562,518,44,516964,43912,560876
220585,201904,6,5,1,4990,998,5988
220590,201904,14,14,0,13972,,13972.0
220595,201904,62,47,15,46906,14970,61876
220600,201904,21,13,8,12974,7984,20958
220605,201904,21,20,1,19960,998,20958
220610,201904,70,62,8,61876,7984,69860
220620,201904,566,457,109,456086,108782,564868
220630,201904,5,4,1,3992,998,4990
220635,201904,36,32,4,31936,3992,35928
220640,201904,101,80,21,79840,20958,100798
220650,201904,114,107,7,106786,6986,113772
220660,201904,39,31,8,30938,7984,38922
220665,201904,4,4,0,3992,,3992.0
220667,201904,26,23,3,22954,2994,25948
220669,201904,30,27,3,26946,2994,29940
220670,201904,64,52,12,51896,11976,63872
220672,201904,65,45,20,44910,19960,64870
220675,201904,38,30,8,29940,7984,37924
220680,201904,41,35,6,34930,5988,40918
220690,201904,44,42,2,41916,1996,43912
220695,201904,50,23,27,22954,26946,49900
220700,201904,1680,1292,388,1289416.9,387224,1676640.9
220710,201904,4,3,1,2994,998,3992
220720,201904,108,88,20,87824,19960,107784
220730,201904,18,18,0,17964,,17964.0
220735,201904,3,1,2,998,1996,2994
220740,201904,49,45,4,44910,3992,48902
220750,201904,106,91,15,90818,14970,105788
220755,201904,16,16,0,15968,,15968.0
220760,201904,60,57,3,56886,2994,59880
220770,201904,5755,3053,2702,3047894.66,2696599.32,5744493.98
220775,201904,21,9,12,8982,11976,20958
220777,201904,17,16,1,15968,998,16966
220779,201904,1,1,0,998,,998.0
220780,201904,894,766,128,764468,127744.4,892212.4
220785,201904,4,1,3,998,2994,3992
220790,201904,1059,849,210,847302.64,209580,1056882.64
220793,201904,8,8,0,7984,,7984.0
220795,201904,16,15,1,14970,998,15968
220800,201904,4025,3093,932,3089810.88,931134.99,4020945.87
220810,201904,67,59,8,58882,7984,66866
220820,201904,248,227,21,226546,20958,247504
220830,201904,1229,1059,170,1057880,169660,1227540
220840,201904,2410,1683,727,1679637.33,727542.78,2407180.11
220850,201904,52,44,8,43912,7984,51896
220855,201904,9,6,3,5988,2994,8982
220860,201904,12,11,1,10978,998,11976
220865,201904,26,24,2,23952,1996,25948
220870,201904,66,61,5,60878,4990,65868
220880,201904,329,255,74,254490,73852.4,328342.4
220885,201904,38,35,3,34930,2994,37924
220887,201904,15,15,0,14970,,14970.0
220890,201904,101,89,12,88822,11976,100798
220900,201904,21,14,7,13972,6986,20958
220910,201904,56,47,9,46906,8982,55888
220915,201904,10,9,1,8982,998,9980
220920,201904,49,45,4,44910,3992,48902
220930,201904,42,41,1,40918,998,41916
220935,201904,18,18,0,17964,,17964.0
220937,201904,39,38,1,37924,998,38922
220940,201904,57,52,5,51896,4990,56886
220945,201904,0,0,0,0,0,0
220950,201904,45,41,4,40918,3992,44910
220955,201904,26,22,4,21956,3992,25948
220960,201904,6,6,0,5988,,5988.0
220965,201904,35,32,3,31936,2994,34930
220970,201904,57,47,10,46906,9980,56886
220975,201904,12,10,2,9980,1996,11976
220980,201904,33,31,2,30938,1996,32934
220985,201904,67,59,8,58882,7984,66866
220987,201904,32,30,2,29940,1996,31936
220990,201904,19,18,1,17964,998,18962
220995,201904,24,19,5,18962,4990,23952
220997,201904,55,45,10,44910,9980,54890
221000,201904,1147,1036,111,1035924,110778,1146702
221005,201904,61,54,7,53892,6986,60878
221010,201904,17,13,4,12974,3992,16966
221020,201904,43,41,2,40918,1996,42914
221030,201904,32,26,6,25948,5988,31936
221035,201904,23,23,0,22954,,22954.0
221037,201904,10,6,4,5988,3992,9980
221038,201904,28,25,3,24950,2994,27944
221039,201904,23,23,0,22954,,22954.0
221040,201904,258,222,36,222554,35928,258482
221050,201904,239,205,34,204590,33932,238522
221060,201904,1843,1628,215,1625742,214570,1840312
221062,201904,35,33,2,32934,1996,34930
221063,201904,13,9,4,8982,3992,12974
221065,201904,52,46,6,45908,5988,51896
221070,201904,142,123,19,122754,18962,141716
221080,201904,381,334,47,333332,46906,380238
221090,201904,31,30,1,29940,998,30938
221093,201904,54,37,17,36926,16966,53892
221095,201904,9,9,0,8982,,8982.0
221097,201904,17,14,3,13972,2994,16966
221100,201904,25450,14927,10523,14903141.92,10509940.72,25413082.64
221110,201904,1068,798,270,796404.4,269460,1065864.4
221120,201904,532,400,132,400198.4,131736,531934.4
221130,201904,966,793,173,792412,172654,965066
221135,201904,34,31,3,30938,2994,33932
221140,201904,44,37,7,36926,6986,43912
221150,201904,12,9,3,8982,2994,11976
221160,201904,14,13,1,12974,998,13972
221170,201904,14,14,0,13972,,13972.0
230010,201904,168,153,15,152694,14970,167664
230015,201904,124,104,20,104790,20958,125748
230020,201904,1640,1387,253,1384226.4,252501.76,1636728.16
230030,201904,1681,1214,467,1212571.78,466066,1678637.78
230040,201904,209,181,28,180638.4,27944,208582.4
230050,201904,215,158,57,157684,56886,214570
230060,201904,159,128,31,127744,30938,158682
230070,201904,296,265,31,264470,30938,295408
230075,201904,848,741,107,739518.8,106786,846304.8
230080,201904,193,167,26,166666,25948,192614
230090,201904,112,79,33,79840,32934,112774
230100,201904,2020,1207,813,1205587.08,812374.82,2017961.90
230110,201904,2775,1805,970,1801390.4,970056,2771446.4
230120,201904,967,777,190,776445.54,189620,966065.54
230125,201904,147,122,25,121756,24950,146706
230130,201904,480,427,53,426146,52894,479040
230140,201904,214,185,29,184630,28942,213572
230150,201904,158,121,37,120758,36926,157684
230160,201904,941,811,130,810376,129740,940116
230170,201904,590,541,49,540917,48902,589819
230180,201904,79,74,5,73852,4990,78842
230185,201904,413,357,56,356286,55888,412174
230190,201904,2279,1836,443,1833327.74,443112,2276439.74
230195,201904,487,424,63,424150,63872,488022
230200,201904,384,332,52,331336,51896,383232
230205,201904,379,244,135,243512,134730,378242
230210,201904,1284,1022,262,1019958.22,261476.94,1281435.16
230220,201904,1551,1058,493,1056882,492015.88,1548897.88
230230,201904,898,778,120,776444,119760,896204
230240,201904,1709,1470,239,1467310.86,238522,1705832.86
230250,201904,1806,1497,309,1494007.58,308382,1802389.58
230260,201904,3082,1909,1173,1905182,1173648,3078830
230270,201904,1377,1107,270,1105786.17,269460,1375246.17
230280,201904,2744,2055,689,2051888.8,688620,2740508.8
230290,201904,408,364,44,363275.61,43912,407187.61
230300,201904,516,386,130,385228,129740,514968
230310,201904,421,319,102,318362,101796,420158
230320,201904,946,807,139,806385.4,138722,945107.4
230330,201904,306,246,60,245508,59880.6,305388.6
230340,201904,456,367,89,367264.6,88822,456086.6
230350,201904,3102,1979,1123,1975042.94,1120754,3095796.94
230360,201904,273,215,58,215568,57884,273452
230365,201904,139,112,27,111776,26946,138722
230370,201904,9831,4889,4942,4881254.25,4941157.57,9822411.82
230380,201904,482,414,68,413173.36,67864.2,481037.56
230390,201904,521,291,230,290418,229540,519958
230393,201904,262,220,42,219560,41916,261476
230395,201904,357,287,70,286426.48,69860,356286.48
230400,201904,605,480,125,480038,124750,604788
230410,201904,2660,1668,992,1666661.09,990017.94,2656679.03
230420,201904,6303,4182,2121,4176634.8,2118756.56,6295391.36
230423,201904,320,278,42,277444,41916,319360
230425,201904,382,314,68,313372.34,67864,381236.34
230426,201904,126,101,25,100798,24950,125748
230427,201904,80,77,3,76846,2994,79840
230428,201904,1439,732,707,731534,706584.94,1438118.94
230430,201904,464,379,85,378242.99,84830,463072.99
230435,201904,844,595,249,593810.31,249500.98,843311.29
230440,201904,85901,38441,47460,38390305.61,47418292.08,85808597.69
230445,201904,289,201,88,200598,87824,288422
230450,201904,542,436,106,435128,105788,540916
230460,201904,60,50,10,49900,9980,59880
230465,201904,310,253,57,252494,56886,309380
230470,201904,1981,1557,424,1553886,424150.5,1978036.5
230480,201904,159,150,9,149700,8982,158682
230490,201904,294,238,56,237524,55888,293412
230495,201904,455,338,117,338322,116766,455088
230500,201904,994,737,257,735526,257484.56,993010.56
230510,201904,53,42,11,41916,10978,52894
230520,201904,392,306,86,305388.18,85828,391216.18
230523,201904,2223,1419,804,1416163.64,804389.46,2220553.10
230526,201904,290,243,47,242514,46906,289420
230530,201904,676,506,170,505986.94,169660,675646.94
230533,201904,193,183,10,182634,9980,192614
230535,201904,359,270,89,269460,89820,359280
230540,201904,1868,1649,219,1646700,218562,1865262
230550,201904,3744,2409,1335,2407179.32,1334326,3741505.32
230560,201904,577,443,134,443112.8,133732.94,576845.74
230565,201904,214,158,56,157684,56886,214570
230570,201904,299,263,36,262474,35928,298402
230580,201904,1134,846,288,844308.94,287424,1131732.94
230590,201904,973,758,215,758481.46,214570,973051.46
230600,201904,254,231,23,230538,22954,253492
230610,201904,352,283,69,282434.6,68862,351296.6
230620,201904,169,138,31,137724,30938,168662
230625,201904,731,530,201,528940.6,200598.94,729539.54
230630,201904,1316,1043,273,1040914,272454,1313368
230640,201904,3709,3216,493,3212563,494012.61,3706575.61
230650,201904,426,374,52,373253.91,51896,425149.91
230655,201904,668,581,87,581835.54,86829.89,668665.43
230660,201904,363,306,57,305388,56886,362274
230670,201904,434,381,53,381236,52894,434130
230680,201904,201,181,20,180638,19960,200598
230690,201904,888,771,117,769458,116766,886224
230700,201904,761,645,116,643710.94,115768.94,759479.88
230710,201904,735,699,36,697602.6,36926,734528.6
230720,201904,149,130,19,129740,18962,148702
230725,201904,262,212,50,211576,49900.98,261476.98
230730,201904,12023,6544,5479,6538899,5476031.29,12014930.29
230740,201904,670,541,129,539918.4,128742,668660.4
230750,201904,838,719,119,717562.6,118762,836324.6
230760,201904,1398,1206,192,1203588,191616,1395204
230763,201904,312,262,50,261476,49900,311376
230765,201904,7203,3423,3780,3419191.72,3774481.59,7193673.31
230770,201904,5000,2576,2424,2571851.12,2421149.34,4993000.46
230780,201904,690,607,83,606784.96,82834,689618.96
230790,201904,242,200,42,199600,41916,241516
230800,201904,1134,830,304,829338,306386,1135724
230810,201904,1338,1192,146,1190614,145708,1336322
230820,201904,350,250,100,249500.4,99800,349300.4
230830,201904,951,819,132,817362,131736,949098
230835,201904,282,247,35,246506,34930,281436
230837,201904,169,142,27,142714,26946,169660
230840,201904,928,743,185,742512.4,184630.4,927142.8
230850,201904,1510,1317,193,1314366,192614.4,1506980.4
230860,201904,303,226,77,225548,76846,302394
230870,201904,1842,1578,264,1574844.94,264470,1839314.94
230880,201904,57,40,17,39920,16966,56886
230890,201904,553,509,44,507982,43912.97,551894.97
230900,201904,280,207,73,206586,72854.58,279440.58
230910,201904,211,170,41,169660,40918,210578
230920,201904,417,328,89,327344,88822,416166
230930,201904,944,672,272,670656.68,271456,942112.68
230940,201904,840,669,171,669658.94,170658.6,840317.54
230945,201904,499,417,82,416167,82834,499001
230950,201904,400,343,57,342314,57884,400198
230960,201904,2603,1773,830,1770455.8,828342.28,2598798.08
230970,201904,1766,1001,765,1001004.34,764479.34,1765483.68
230980,201904,209,177,32,176646,31936,208582
230990,201904,139,114,25,113772,24950,138722
231000,201904,208,189,19,189620,18962,208582
231010,201904,145,111,34,110778,33932,144710
231020,201904,1328,926,402,925160.32,402197.82,1327358.14
231025,201904,1030,777,253,775446.6,252494.4,1027941.0
231030,201904,1129,948,181,946105.35,180638,1126743.35
231040,201904,138,95,43,94810,42914,137724
231050,201904,985,881,104,879238,103792,983030
231060,201904,146,126,20,125748,19960,145708
231070,201904,1458,1033,425,1031934.24,425148.94,1457083.18
231080,201904,261,243,18,242514,17964,260478
231085,201904,583,361,222,360278.6,222554,582832.6
231090,201904,247,204,43,203592,42914,246506
231095,201904,165,132,33,131736,32934,164670
231100,201904,135,114,21,113772,20958,134730
231110,201904,364,315,49,314370,48902,363272
231120,201904,293,250,43,249500,42914,292414
231123,201904,147,141,6,140718,5988,146706
231126,201904,325,257,68,256486,67864,324350
231130,201904,4611,3602,1009,3597791.93,1007981.91,4605773.84
231135,201904,215,188,27,187624,26946,214570
231140,201904,3110,2297,813,2293404,812372,3105776
231150,201904,366,350,16,349300,15968,365268
231160,201904,1202,962,240,960076.94,239520.94,1199597.88
231170,201904,538,368,170,367264,169660,536924
231180,201904,1669,1423,246,1420154,245508,1665662
231190,201904,204,176,28,175648,27944,203592
231195,201904,220,189,31,189620,30938,220558
231200,201904,830,677,153,675646,153692.6,829338.6
231210,201904,602,508,94,507982,93812,601794
231220,201904,1043,761,282,759478.9,281436,1040914.9
231230,201904,1439,1148,291,1146702,290418,1437120
231240,201904,1418,1036,382,1034926.94,381236.4,1416163.34
231250,201904,115,105,10,105788,9980,115768
231260,201904,285,187,98,186626,97804.4,284430.4
231270,201904,1014,844,170,842313.49,170658,1012971.49
231280,201904,65,49,16,48902,15968,64870
231290,201904,7448,4170,3278,4162658.8,3276435.8,7439094.6
231300,201904,641,589,52,587822,51896,639718
231310,201904,741,686,55,684628.74,54890,739518.74
231320,201904,578,440,138,439122,137724,576846
231325,201904,96,85,11,84830,10978,95808
231330,201904,2040,1582,458,1579088.47,457084.7,2036173.17
231335,201904,255,227,28,226546,27944,254490
231340,201904,1672,1230,442,1228538,441116,1669654
231350,201904,1276,1052,224,1049896,223552.8,1273448.8
231355,201904,429,374,55,374250,54890,429140
231360,201904,495,381,114,380238.4,113772,494010.4
231370,201904,88,74,14,73852,13972,87824
231375,201904,294,213,81,212574,80838,293412
231380,201904,468,386,82,385228,81836,467064
231390,201904,203,166,37,165668,36926,202594
231395,201904,736,462,274,461076,273452,734528
231400,201904,1115,922,193,921157.04,193614.34,1114771.38
231410,201904,1344,1099,245,1096802.2,245509.74,1342311.94
240010,201904,392,177,215,176646.43,214570.98,391217.41
240020,201904,2253,1784,469,1782429.5,468063.97,2250493.47
240030,201904,129,111,18,110778,17964,128742
240040,201904,30,30,0,29940,,29940.0
240050,201904,520,448,72,447104,71856,518960
240060,201904,66,62,4,61876,3992,65868
240070,201904,197,154,43,153692,42914,196606
240080,201904,482,320,162,319361.39,161676.46,481037.85
240090,201904,103,91,12,90818,11976,102794
240100,201904,1482,1401,81,1398199.5,80838,1479037.5
240110,201904,1048,679,369,680637.58,368262.7,1048900.28
240120,201904,137,116,21,116766,20958,137724
240130,201904,288,268,20,267464,19960,287424
240140,201904,84,65,19,64870,18962,83832
240145,201904,720,641,79,639718,78842,718560
240150,201904,19,16,3,15968,2994,18962
240160,201904,41,37,4,36926,3992,40918
240165,201904,37,31,6,31936.5,5988,37924.5
240170,201904,90,66,24,65868,23952,89820
240180,201904,82,69,13,68862,12974,81836
240185,201904,45,40,5,39920,4990,44910
240190,201904,13,11,2,10978,1996,12974
240200,201904,3064,1713,1351,1712570.4,1352291.4,3064861.8
240210,201904,169,131,38,130738,37924,168662
240220,201904,1097,798,299,796404.7,298402,1094806.7
240230,201904,852,786,66,785426.77,65868,851294.77
240240,201904,75,52,23,51896,22954,74850
240250,201904,89,79,10,78842,9980,88822
240260,201904,1796,1342,454,1339316,454090,1793406
240270,201904,191,169,22,168662,21956,190618
240280,201904,41,31,10,30938,9980,40918
240290,201904,51,50,1,49900,998,50898
240300,201904,176,101,75,100798,74850,175648
240310,201904,2179,1216,963,1215566.27,961074.74,2176641.01
240320,201904,202,191,11,190618,10978,201596
240325,201904,4330,2653,1677,2650692.27,1676642.07,4327334.34
240330,201904,69,65,4,64870,3992,68862
240340,201904,60,39,21,38922,20958,59880
240350,201904,89,79,10,78842,9980,88822
240360,201904,465,317,148,316366,147704,464070
240370,201904,45,42,3,41916,2994,44910
240375,201904,72,41,31,40918,30938,71856
240380,201904,228,186,42,185628,41916.8,227544.8
240390,201904,14,12,2,11976,1996,13972
240400,201904,83,78,5,77844,4990,82834
240410,201904,11,7,4,6986,3992,10978
240420,201904,936,709,227,707582.2,226546,934128.2
240430,201904,267,251,16,250498,15968,266466
240440,201904,88,49,39,48902,38922,87824
240450,201904,210,141,69,140718.4,68862,209580.4
240460,201904,62,48,14,47904,13972,61876
240470,201904,240,208,32,207584,31936,239520
240480,201904,15,13,2,12974,1996,14970
240485,201904,81,69,12,68862,11976,80838
240490,201904,46,46,0,46906,,46906.0
240500,201904,85,68,17,67864,16966,84830
240510,201904,50,36,14,35928,13972,49900
240520,201904,118,113,5,112774,4990,117764
240530,201904,56,50,6,49900,5988,55888
240540,201904,79,69,10,68862,9980,78842
240550,201904,14,13,1,12974,998,13972
240560,201904,375,276,99,276446,98802.4,375248.4
240570,201904,460,288,172,287424.94,171656,459080.94
240580,201904,1253,1012,241,1010975.4,240518.99,1251494.39
240590,201904,28,26,2,25948,1996,27944
240600,201904,108,105,3,104790,2994,107784
240610,201904,512,431,81,431136.4,80838,511974.4
240615,201904,19,18,1,17964,998,18962
240620,201904,93,89,4,88822,3992,92814
240630,201904,36,34,2,33932,1996,35928
240640,201904,27,22,5,21956,4990,26946
240650,201904,235,197,38,196606,37924,234530
240660,201904,104,90,14,89820,13972,103792
240670,201904,297,176,121,175648.7,120758,296406.7
240680,201904,49,39,10,38922,9980,48902
240690,201904,47,45,2,44910,1996,46906
240700,201904,191,157,34,156686,33932,190618
240710,201904,1936,1229,707,1228539.3,707582,1936121.3
240720,201904,1080,803,277,801394,277444,1078838
240725,201904,62,58,4,57884,3992,61876
240730,201904,141,123,18,122754,17964,140718
240740,201904,235,200,35,199600,34930.74,234530.74
240750,201904,45,27,18,26946,17964,44910
240760,201904,41,37,4,36926,3992,40918
240770,201904,146,113,33,112774,32934,145708
240780,201904,684,564,120,562872,119760,682632
240790,201904,37,36,1,35928,998,36926
240800,201904,9167,6249,2918,6238507.8,2915161.68,9153669.48
240810,201904,20215,11181,9034,11166647.01,9022947.89,20189594.90
240820,201904,222,142,80,141716.19,79840,221556.19
240830,201904,1641,1353,288,1350294.7,287424,1637718.7
240840,201904,84,74,10,73852,9980,83832
240850,201904,85,75,10,74850,9980,84830
240860,201904,111,108,3,107784,2994,110778
240870,201904,59,51,8,50898,7984,58882
240880,201904,29,26,3,25948,2994,28942
240890,201904,1172,684,488,682634.26,487024.99,1169659.25
240895,201904,57,37,20,36926,19960,56886
240910,201904,158,143,15,142714,14970,157684
240920,201904,16,13,3,12974,2994,15968
240930,201904,403,362,41,362274,40918,403192
240933,201904,35,26,9,25948,8982,34930
240940,201904,2435,2149,286,2146698.58,286426,2433124.58
240950,201904,50,47,3,46906,2994,49900
240960,201904,31,26,5,25948,4990,30938
240970,201904,118,86,32,85828,31936,117764
240980,201904,199,159,40,158682,39920,198602
240990,201904,125,83,42,82834,41916,124750
241000,201904,68,63,5,62874,4990,67864
241010,201904,61,50,11,49900,10978,60878
241020,201904,112,104,8,103792,7984,111776
241025,201904,9,3,6,2994,5988,8982
241030,201904,117,95,22,94810,21956,116766
241040,201904,35,30,5,29940,4990,34930
241050,201904,88,78,10,77844,9980,87824
241060,201904,29,24,5,23952,4990,28942
241070,201904,17,17,0,16966,,16966.0
241080,201904,62,56,6,55888,5988,61876
241090,201904,50,41,9,40918,8982,49900
241100,201904,71,62,9,61876,8982,70858
241105,201904,6,2,4,1996,3992,5988
241110,201904,48,45,3,44910,2994,47904
241120,201904,1450,1114,336,1112770,335328,1448098
241140,201904,222,184,38,183632.4,37924,221556.4
241142,201904,43,39,4,38922,3992,42914
241150,201904,1198,1056,142,1053888,142714,1196602
241160,201904,22,22,0,21956,,21956.0
241170,201904,44,39,5,38922,4990,43912
241180,201904,45,39,6,38922,5988,44910
241190,201904,38,37,1,36926,998,37924
241200,201904,3845,2073,1772,2069855.03,1769456.49,3839311.52
241210,201904,68,59,9,58882,8982,67864
241220,201904,1403,949,454,949098.71,453092.97,1402191.68
241230,201904,241,202,39,201596,39920,241516
241240,201904,55,42,13,41916,12974,54890
241250,201904,1132,1034,98,1033928.4,97804,1131732.4
241255,201904,51,41,10,40918,9980,50898
241260,201904,641,506,135,504988,134730,639718
241270,201904,50,37,13,36926,12974,49900
241280,201904,100,87,13,86826,12974,99800
241290,201904,111,85,26,84830,25948,110778
241300,201904,75,55,20,54890,19960,74850
241310,201904,52,39,13,38922.7,12974,51896.7
241320,201904,28,15,13,14970,13972,28942
241330,201904,64,59,5,58882,4990,63872
241335,201904,64,57,7,56886,6986,63872
241340,201904,186,139,47,139720,46906,186626
241350,201904,60,55,5,54890,4990,59880
241355,201904,43,38,5,37924,4990,42914
241360,201904,50,49,1,48902,998,49900
241370,201904,49,40,9,39920,8982,48902
241380,201904,40,36,4,35928,3992,39920
241390,201904,77,62,15,61876,14970,76846
241400,201904,206,166,40,165668,39920,205588
241410,201904,185,167,18,166666,17964,184630
241415,201904,98,79,19,78842,18962,97804
241420,201904,98,74,24,73852,23952.64,97804.64
241430,201904,30,27,3,26946,2994,29940
241440,201904,514,416,98,415168.97,97804,512972.97
241445,201904,37,35,2,34930,1996,36926
241450,201904,284,233,51,232534,50898,283432
241460,201904,143,130,13,129740.5,12974,142714.5
241470,201904,41,34,7,33932,6986,40918
241475,201904,59,56,3,55888,2994,58882
241480,201904,96,71,25,70858,24950,95808
241490,201904,8,7,1,6986,998,7984
241500,201904,47,34,13,33932,12974,46906
250010,201904,104,88,16,87824,15968,103792
250020,201904,34,31,3,30938,2994,33932
250030,201904,824,624,200,622752,199600.6,822352.6
250040,201904,346,287,59,286426,58882,345308
250050,201904,236,196,40,195608.99,39920,235528.99
250053,201904,59,45,14,44910,13972,58882
250057,201904,0,0,0,0,0,0
250060,201904,473,363,110,362274,109780,472054
250070,201904,711,582,129,580836.75,128742,709578.75
250073,201904,8,8,0,7984,,7984.0
250077,201904,193,145,48,145708,47904,193612
250080,201904,421,331,90,330338.72,89820,420158.72
250090,201904,199,132,67,131736,66866,198602
250100,201904,508,424,84,423152,83832.2,506984.2
250110,201904,571,433,138,432134.8,137724,569858.8
250115,201904,24,8,16,7984,15968,23952
250120,201904,114,84,30,83832,29940,113772
250130,201904,572,464,108,463072,107784.6,570856.6
250135,201904,15,9,6,8982,5988,14970
250140,201904,82,74,8,73852,7984,81836
250150,201904,578,419,159,419160,159680,578840
250153,201904,8,7,1,6986,998,7984
250157,201904,29,24,5,23952,4990,28942
250160,201904,216,172,44,171656,43912,215568
250170,201904,61,42,19,41916,18962,60878
250180,201904,4087,2798,1289,2792506.66,1286426.15,4078932.81
250190,201904,857,569,288,567862,287424.5,855286.5
250200,201904,52,44,8,43912,7984,51896
250205,201904,23,20,3,19960,2994,22954
250210,201904,86,76,10,75848,9980,85828
250215,201904,63,55,8,54890,7984,62874
250220,201904,26,20,6,19960,5988,25948
250230,201904,79,72,7,71856.99,6986,78842.99
250240,201904,238,196,42,195608,41916,237524
250250,201904,401,344,57,343312,56886,400198
250260,201904,35,31,4,30938,3992,34930
250270,201904,63,48,15,47904,14970,62874
250280,201904,384,319,65,318362,64870,383232
250290,201904,90,83,7,82834,6986,89820
250300,201904,552,380,172,380238,171657.97,551895.97
250310,201904,46,42,4,41916,3992,45908
250320,201904,1971,1354,617,1351295.68,616765.38,1968061.06
250330,201904,95,84,11,83832,10978,94810
250340,201904,25,22,3,21956,2994,24950
250350,201904,143,95,48,94810,47904,142714
250355,201904,35,27,8,26946,7984,34930
250360,201904,202,166,36,165668,35928,201596
250370,201904,2416,1627,789,1625742,787422,2413164
250375,201904,8,3,5,2994,4990,7984
250380,201904,54,40,14,39920,13972,53892
250390,201904,42,34,8,33932,7984,41916
250400,201904,16254,8295,7959,8288399.79,7966041.72,16254441.51
250403,201904,371,303,68,302394,67864,370258
250407,201904,59,50,9,49900,8982,58882
250410,201904,30,26,4,25948,3992,29940
250415,201904,42,28,14,27944,13972,41916
250420,201904,45,38,7,37924,6986,44910
250430,201904,1497,1275,222,1272699.5,221556,1494255.5
250435,201904,16,12,4,11976,3992,15968
250440,201904,685,586,99,584828.6,98802,683630.6
250450,201904,85,70,15,69860,14970,84830
250460,201904,434,297,137,296406,137724,434130
250470,201904,89,67,22,66866,21956,88822
250480,201904,332,267,65,266466,64870,331336
250485,201904,1,1,0,998,,998.0
250490,201904,228,191,37,190618,36926,227544
250500,201904,81,61,20,60878,19960,80838
250510,201904,729,579,150,577842,150698,728540
250520,201904,174,121,53,121756,52894,174650
250523,201904,112,94,18,94810,17964,112774
250527,201904,101,81,20,80838,19960,100798
250530,201904,8,5,3,4990,2994,7984
250535,201904,25,21,4,20958,3992,24950
250540,201904,128,100,28,99800,28942,128742
250550,201904,71,68,3,68862,2994,71856
250560,201904,40,30,10,29940,9980,39920
250570,201904,157,127,30,126746,29940,156686
250580,201904,117,93,24,92878,23952,116830
250590,201904,23,15,8,14970,7984,22954
250600,201904,1275,858,417,857282.81,418162,1275444.81
250610,201904,156,134,22,133732,21956,155688
250620,201904,23,19,4,18962,3992,22954
250625,201904,72,54,18,53892,17964,71856
250630,201904,3032,1965,1067,1962084.57,1068865.92,3030950.49
250640,201904,208,171,37,170658,36926,207584
250650,201904,28,20,8,19960,7984,27944
250660,201904,44,33,11,32934,10978,43912
250670,201904,62,42,20,41916,19960,61876
250680,201904,396,327,69,326346,68862,395208
250690,201904,1885,1310,575,1307384.15,573850.8,1881234.95
250700,201904,928,813,115,811374.5,114770,926144.5
250710,201904,441,343,98,342314,97804,440118
250720,201904,114,88,26,87824,25948,113772
250730,201904,376,322,54,321356,53892,375248
250740,201904,54,50,4,49900,3992,53892
250750,201904,21167,12852,8315,12832195.37,8305367.1,21137562.47
250760,201904,76,58,18,57884,17964,75848
250770,201904,350,233,117,233532.44,116766,350298.44
250780,201904,56,43,13,42914,12974,55888
250790,201904,473,309,164,308382,163672,472054
250800,201904,151,139,12,138722,11976,150698
250810,201904,81,62,19,61876,18962,80838
250820,201904,156,128,28,127744,27944,155688
250830,201904,425,295,130,294410.4,129740,424150.4
250840,201904,51,49,2,48902,1996,50898
250850,201904,57,46,11,45908,10978,56886
250855,201904,13,11,2,10978,1996,12974
250860,201904,203,143,60,142714,59880,202594
250870,201904,35,32,3,32934,2994,35928
250880,201904,85,62,23,61876,22954,84830
250890,201904,2651,1983,668,1979034,666664,2645698
250900,201904,12,10,2,9980,1996,11976
250905,201904,122,96,26,95808,25948,121756
250910,201904,1168,835,333,833330.99,334330,1167660.99
250915,201904,111,78,33,77844,32934,110778
250920,201904,140,106,34,105788,33932,139720
250930,201904,167,105,62,104790,61876,166666
250933,201904,2,1,1,998,998,1996
250937,201904,9,8,1,7984,998,8982
250939,201904,31,23,8,22954,7984,30938
250940,201904,108,82,26,81836,25948,107784
250950,201904,70,47,23,46906,22954,69860
250960,201904,91,50,41,49900,40918,90818
250970,201904,1231,872,359,871254,360278,1231532
250980,201904,90,63,27,62874,26946,89820
250990,201904,170,132,38,132734,37924,170658
251000,201904,76,67,9,66866,8982,75848
251010,201904,103,82,21,81836.99,20958,102794.99
251020,201904,81,70,11,69860,10978,80838
251030,201904,44,34,10,33932,9980,43912
251040,201904,53,39,14,38922,13972,52894
251050,201904,23,21,2,20958,1996,22954
251060,201904,49,38,11,37924,10978,48902
251065,201904,4,4,0,3992,,3992.0
251070,201904,23,19,4,18962.98,3992,22954.98
251080,201904,4883,2369,2514,2366280.26,2513967.03,4880247.29
251090,201904,197,166,31,165668,30938,196606
251100,201904,16,16,0,15968,,15968.0
251110,201904,44,35,9,34930,8982,43912
251120,201904,1808,1103,705,1100795.2,704588,1805383.2
251130,201904,391,317,74,316366,73852,390218
251140,201904,526,346,180,346307.2,179640,525947.2
251150,201904,310,269,41,268462.98,40918,309380.98
251160,201904,98,82,16,81836.99,15968,97804.99
251170,201904,103,83,20,82834,19960,102794
251180,201904,293,184,109,183632.99,108782.99,292415.98
251190,201904,189,129,60,128742,60878,189620
251200,201904,258,211,47,210578,47904,258482
251203,201904,38,36,2,35928,1996,37924
251207,201904,96,79,17,78842,16966,95808
251210,201904,1466,1067,399,1065864,398202,1464066
251220,201904,48,38,10,37924,9980,47904
251230,201904,620,527,93,525946,92814,618760
251240,201904,100,72,28,71856,27944,99800
251250,201904,1362,971,391,969058.9,391216.7,1360275.6
251260,201904,12,6,6,5988,5988,11976
251270,201904,324,245,79,244510,78842.7,323352.7
251272,201904,67,60,7,59880,6986,66866
251274,201904,27,21,6,20958,5988,26946
251275,201904,30,18,12,17964,11976,29940
251276,201904,11,9,2,8982,1996,10978
251278,201904,10,8,2,7984,1996,9980
251280,201904,103,98,5,97804,4990,102794
251290,201904,726,544,182,542912,182634,725546
251300,201904,16,13,3,12974,2994,15968
251310,201904,372,268,104,267464.99,103792,371256.99
251315,201904,22,21,1,20958,998,21956
251320,201904,61,49,12,48902,11976,60878
251330,201904,83,74,9,73852,8982,82834
251335,201904,13,8,5,7984,4990,12974
251340,201904,718,424,294,423152,294410,717562
251350,201904,36,35,1,34930,998,35928
251360,201904,75,66,9,65868,8982,74850
251365,201904,14,14,0,13972,,13972.0
251370,201904,5426,3706,1720,3699589.14,1717558.6,5417147.74
251380,201904,48,38,10,37924,9980,47904
251385,201904,3,3,0,2994,,2994.0
251390,201904,729,568,161,567862.7,160678.4,728541.1
251392,201904,12,6,6,5988,5988,11976
251394,201904,9,9,0,8982,,8982.0
251396,201904,14,9,5,8982,4990,13972
251398,201904,18,15,3,14970,2994,17964
251400,201904,43,36,7,35928,6986,42914
251410,201904,38,31,7,30938,6986,37924
251420,201904,101,75,26,74850,25948,100798
251430,201904,42,39,3,38922,2994,41916
251440,201904,35,22,13,21956,12974,34930
251445,201904,56,52,4,51896,3992,55888
251450,201904,410,358,52,358282.2,51896,410178.2
251455,201904,2,1,1,998,998,1996
251460,201904,16,14,2,13972,1996,15968
251465,201904,4,2,2,1996,1996,3992
251470,201904,47,37,10,36926,9980,46906
251480,201904,26,23,3,22954,2994,25948
251490,201904,120,84,36,83832,35928.4,119760.4
251500,201904,128,106,22,105788,21956,127744
251510,201904,38,29,9,28942,8982,37924
251520,201904,27,27,0,26946,,26946.0
251530,201904,4496,3175,1321,3168650.8,1320354,4489004.8
251540,201904,75,65,10,64870,9980,74850
251550,201904,405,314,91,314370,90818.9,405188.9
251560,201904,22,15,7,14970,6986,21956
251570,201904,20,19,1,18962,998,19960
251580,201904,124,101,23,100798,22954,123752
251590,201904,120,87,33,87015,32934,119949
251593,201904,26,17,9,16966,8982,25948
251597,201904,62,52,10,51896,9980,61876
251600,201904,1084,774,310,774455.71,310379.36,1084835.07
251610,201904,227,176,51,175648,50898,226546
251615,201904,4,4,0,3992,,3992.0
251620,201904,4275,2839,1436,2834322.24,1434127.6,4268449.84
251630,201904,447,329,118,328342,117764.98,446106.98
251640,201904,145,105,40,104790,39920,144710
251650,201904,265,193,72,192614.7,71856,264470.7
251660,201904,187,166,21,165668,20958,186626
251670,201904,367,287,80,286426,79840,366266
251675,201904,4,4,0,3992,,3992.0
251680,201904,94,84,10,83832,9980,93812
251690,201904,344,286,58,285428,57884,343312
251700,201904,284,243,41,242514,40918,283432
251710,201904,23,15,8,14970,7984,22954
251720,201904,30,21,9,20958,8982.4,29940.4
251740,201904,10,8,2,7984,1996,9980
260005,201904,3180,1807,1373,1804387.91,1375246.88,3179634.79
260010,201904,1566,1136,430,1134726.14,430139.04,1564865.18
260020,201904,417,368,49,367264,48902,416166
260030,201904,581,421,160,420158,159680,579838
260040,201904,838,524,314,522952,315368,838320
260050,201904,1146,832,314,831334,313372.8,1144706.8
260060,201904,401,366,35,365268,34930,400198
260070,201904,1411,890,521,890219.85,520956.69,1411176.54
260080,201904,723,571,152,569858,151696,721554
260090,201904,534,337,197,336327.96,196606,532933.96
260100,201904,232,164,68,163672,67864,231536
260105,201904,225,125,100,124750,99800,224550
260110,201904,2813,2078,735,2073845.38,736524.4,2810369.78
260120,201904,2903,1484,1419,1482031.62,1421153.3,2903184.92
260130,201904,159,112,47,112774,46906,159680
260140,201904,2149,1417,732,1414176.48,731534.98,2145711.46
260150,201904,221,145,76,144710,76846,221556
260160,201904,314,262,52,261476,51896,313372
260170,201904,3380,2076,1304,2072847.3,1302390.4,3375237.7
260180,201904,159,134,25,133732,24950,158682
260190,201904,2275,1604,671,1600792,669658,2270450
260200,201904,942,766,176,764468.63,175648.4,940117.03
260210,201904,1439,1026,413,1024946,413172.98,1438118.98
260220,201904,730,660,70,658680,69860,728540
260230,201904,1198,903,295,901194,294410,1195604
260240,201904,226,173,53,172654,52894,225548
260250,201904,89,67,22,66866,21956,88822
260260,201904,1000,718,282,717562,281436,998998
260270,201904,424,343,81,343312,80838,424150
260280,201904,1368,939,429,938120,428142.4,1366262.4
260290,201904,6422,3498,2924,3495002.28,2919156.47,6414158.75
260300,201904,906,798,108,796404.6,108782.4,905187.0
260310,201904,523,417,106,416166,106786,522952
260320,201904,877,661,216,659678,216566,876244
260330,201904,43,33,10,32934,9980,42914
260340,201904,70,50,20,49900,19960,69860
260345,201904,5610,3135,2475,3128734.27,2472049.9,5600784.17
260350,201904,484,351,133,352294.4,132734,485028.4
260360,201904,277,145,132,144710,131736,276446
260370,201904,680,450,230,450098.5,229541.09,679639.59
260380,201904,605,442,163,442114,162674.66,604788.66
260390,201904,294,251,43,250498,42914,293412
260392,201904,104,89,15,88822,14970,103792
260400,201904,4064,2366,1698,2365262.89,1697599.38,4062862.27
260410,201904,14629,7766,6863,7761449.75,6859255.28,14620705.03
260415,201904,127,115,12,114770,11976,126746
260420,201904,1781,1080,701,1077841.81,700596,1778437.81
260430,201904,190,173,17,172655.25,16966,189621.25
260440,201904,218,157,61,156686.98,60878,217564.98
260450,201904,460,336,124,335329.2,124750,460079.2
260460,201904,826,443,383,442115.2,382234,824349.2
260470,201904,361,224,137,223552,137724.8,361276.8
260480,201904,217,139,78,138722,77844,216566
260490,201904,216,178,38,177644,37924,215568
260500,201904,1130,762,368,760476,367264,1127740
260510,201904,771,622,149,620756,148702,769458
260515,201904,246,222,24,221556,23952,245508
260520,201904,3277,1983,1294,1982028.99,1295404.78,3277433.77
260530,201904,803,655,148,653690,148702,802392
260540,201904,563,433,130,432134,129740,561874
260545,201904,12,10,2,9980,2994,12974
260550,201904,340,212,128,211576,128742,340318
260560,201904,529,398,131,397204.4,130738,527942.4
260570,201904,999,818,181,817362.4,180638,998000.4
260580,201904,256,228,28,227544,27944,255488
260590,201904,628,365,263,364270,262474,626744
260600,201904,8089,4260,3829,4253944.06,3823338,8077282.06
260610,201904,488,333,155,332334,154690,487024
260620,201904,3696,1958,1738,1956082.66,1737520.07,3693602.73
260630,201904,85,81,4,80838,3992,84830
260640,201904,3660,2011,1649,2007977.9,1646700.98,3654678.88
260650,201904,321,234,87,233532,87824,321356
260660,201904,529,358,171,357284,170658,527942
260670,201904,103,76,27,75848,26946,102794
260680,201904,3659,2076,1583,2072849.64,1584825.36,3657675.00
260690,201904,123,94,29,93812,28942,122754
260700,201904,329,210,119,209580,118762,328342
260710,201904,36,33,3,32934,2994,35928
260720,201904,2294,1382,912,1380235.6,911174,2291409.6
260730,201904,658,505,153,504988,152694,657682
260740,201904,60,56,4,55888,3992,59880
260750,201904,628,446,182,445108,181636,626744
260760,201904,626,337,289,337324.47,289420,626744.47
260765,201904,981,520,461,520956.99,461076,982032.99
260770,201904,223,167,56,166649,55888,222537
260775,201904,803,476,327,478043.3,326346.98,804390.28
260780,201904,272,178,94,177644,93812,271456
260790,201904,12160,6721,5439,6713557.28,5435114.31,12148671.59
260795,201904,162,112,50,111776,50898,162674
260800,201904,292,245,47,245508,46906,292414
260805,201904,171,112,59,111776,59880,171656
260810,201904,751,655,96,653690,96806,750496
260820,201904,314,207,107,206586.26,106786,313372.26
260825,201904,204,142,62,141716,61876,203592
260830,201904,274,174,100,173652,99800,273452
260840,201904,234,172,62,171656,61876,233532
260845,201904,190,129,61,129740,60878,190618
260850,201904,481,357,124,356286,123752,480038
260860,201904,255,192,63,191616,62874,254490
260870,201904,370,275,95,274450.54,94810,369260.54
260875,201904,740,529,211,527942,210578,738520
260880,201904,1600,1005,595,1002990.2,594808,1597798.2
260890,201904,2398,1696,702,1692609,700596.8,2393205.8
260900,201904,1011,704,307,702592,306386,1008978
260910,201904,271,212,59,211576,58882,270458
260915,201904,309,215,94,214570,93812,308382
260920,201904,178,99,79,98802,78842,177644
260930,201904,397,343,54,343314.91,53892.97,397207.88
260940,201904,2832,1561,1271,1560873.6,1269456.4,2830330.0
260950,201904,2023,1183,840,1182631.66,839318,2021949.66
260960,201904,13893,7246,6647,7236510.96,6652677.77,13889188.73
260970,201904,434,373,61,372254,60878,433132
260980,201904,198,175,23,174650,22954,197604
260990,201904,2613,2139,474,2135721.74,473052,2608773.74
261000,201904,4348,2583,1765,2578691.36,1764464.6,4343155.96
261010,201904,180,135,45,134730.64,44910,179640.64
261020,201904,614,461,153,460078.7,152694,612772.7
261030,201904,231,172,59,171656,58882,230538
261040,201904,369,325,44,324350,43912,368262
261050,201904,495,432,63,431136,62874,494010
261060,201904,1360,902,458,900196.5,457084,1357280.5
261070,201904,8796,4509,4287,4501008.53,4288457.39,8789465.92
261080,201904,383,297,86,296406,85828,382234
261090,201904,2258,1741,517,1738520.31,518960.47,2257480.78
261100,201904,1102,767,335,765467.3,335328,1100795.3
261110,201904,8452,5210,3242,5201579.69,3238514.51,8440094.20
261120,201904,268,226,42,225548,41916,267464
261130,201904,565,340,225,339320.6,224550.62,563871.22
261140,201904,189,123,66,122754,65868,188622
261150,201904,677,414,263,413172.18,262474,675646.18
261153,201904,72,68,4,67864,3992,71856
261160,201904,77211,38963,38248,38918636.23,38228430.23,77147066.46
261170,201904,460,348,112,347304,111776,459080
261180,201904,1800,1119,681,1116762,679638,1796400
261190,201904,610,430,180,430140.52,180638.98,610779.50
261200,201904,219,190,29,190618,28942,219560
261210,201904,33,29,4,28942,3992,32934
261220,201904,2694,1896,798,1892210.18,796405.37,2688615.55
261230,201904,337,251,86,250498,85828,336326
261240,201904,457,396,61,395208,60878,456086
261245,201904,236,196,40,195608,39920,235528
261247,201904,166,132,34,131736,34930,166666
261250,201904,2924,1498,1426,1497000.9,1424146,2921146.9
261255,201904,257,233,24,232534,23952,256486
261260,201904,871,754,117,753490.76,116766,870256.76
261270,201904,179,138,41,137724,41916,179640
261280,201904,174,146,28,145708,27944,173652
261290,201904,128,91,37,90818,36926,127744
261300,201904,1270,916,354,914168,353292,1267460
261310,201904,787,532,255,530936.4,254490,785426.4
261320,201904,560,385,175,384230,174650,558880
261330,201904,988,763,225,762472,224550.63,987022.63
261340,201904,290,166,124,165668,123752,289420
261350,201904,828,589,239,587822.4,238522,826344.4
261360,201904,1281,841,440,840316,439120,1279436
261370,201904,4902,3012,1890,3005979.36,1887221.49,4893200.85
261380,201904,562,420,142,419160.7,141716.4,560877.1
261390,201904,3557,2388,1169,2384222.41,1166663.3,3550885.71
261400,201904,281,256,25,255488,24950,280438
261410,201904,1108,751,357,750496,357284,1107780
261420,201904,883,559,324,557884.36,323352.98,881237.34
261430,201904,327,294,33,294410,32934,327344
261440,201904,126,116,10,115768,9980,125748
261450,201904,2544,2095,449,2090811.3,448103.36,2538914.66
261460,201904,741,596,145,595806.74,144710,740516.74
261470,201904,252,193,59,192614,58882,251496
261480,201904,396,311,85,310378.6,84830.99,395209.59
261485,201904,340,214,126,213572,125748,339320
261500,201904,616,419,197,418162,196606,614768
261510,201904,47,32,15,31936,14970,46906
261520,201904,108,96,12,95808,11976,107784
261530,201904,4114,2611,1503,2606777.19,1501991.84,4108769.03
261540,201904,1178,723,455,722552,456086,1178638
261550,201904,276,136,140,135728.4,139720,275448.4
261560,201904,825,547,278,545906.7,277445.78,823352.48
261570,201904,391,307,84,306386,83832,390218
261580,201904,382,300,82,299400,81836,381236
261590,201904,199,163,36,163672,35928,199600
261600,201904,300,240,60,239520,59880,299400
261610,201904,105,90,15,89820,14970,104790
261618,201904,69,54,15,53892,14970,68862
261620,201904,202,126,76,125748,75848,201596
261630,201904,575,446,129,445108,128742,573850
261640,201904,6377,3411,2966,3409171.91,2966056.9,6375228.81
261650,201904,497,319,178,318362,177644,496006
270010,201904,538,478,60,477044.4,59880,536924.4
270020,201904,298,235,63,234530.99,62874,297404.99
270030,201904,9228,5975,3253,5964076.74,3251520.46,9215597.20
270040,201904,2036,1276,760,1273614.33,758480,2032094.33
270050,201904,167,125,42,124750,42914,167664
270060,201904,115,65,50,64870,49900,114770
270070,201904,894,654,240,654688,239520.98,894208.98
270080,201904,37,31,6,30938,5988,36926
270090,201904,20,16,4,15968,3992,19960
270100,201904,1222,821,401,820356.98,401196,1221552.98
270110,201904,139,105,34,104790,33932,138722
270120,201904,224,185,39,185628,38922,224550
270130,201904,252,173,79,172654,78842,251496
270135,201904,101,61,40,60878,39920,100798
270140,201904,1347,830,517,829741.11,515967.79,1345708.90
270150,201904,266,210,56,209580,55888,265468
270160,201904,521,399,122,399200,122754,521954
270170,201904,779,508,271,506984,270458,777442
270180,201904,74,57,17,56886,16966,73852
270190,201904,98,87,11,86826,10978,97804
270200,201904,107,96,11,95808,10978,106786
270210,201904,479,255,224,254490,223552,478042
270220,201904,180,143,37,142714,37924,180638
270230,201904,2114,1300,814,1297402.14,816364.98,2113767.12
270235,201904,726,557,169,557887.78,169664.88,727552.66
270240,201904,3122,2461,661,2456080.53,660678.54,3116759.07
270250,201904,167,121,46,120758,45908,166666
270255,201904,221,190,31,189620,30938,220558
270260,201904,363,291,72,290418,71856,362274
270270,201904,103,43,60,42914.98,59880,102794.98
270280,201904,258,149,109,148702,108782,257484
270290,201904,1203,919,284,917162,283432.98,1200594.98
270300,201904,290,193,97,193612,96806,290418
270310,201904,905,730,175,729310.01,174651.96,903961.97
270320,201904,893,766,127,764469.61,126746,891215.61
270330,201904,278,235,43,234530,42914,277444
270340,201904,61,49,12,48902,11976,60878
270350,201904,95,48,47,47904,46906,94810
270360,201904,62,36,26,35928,25948,61876
270370,201904,56,45,11,44910,10978,55888
270375,201904,75,48,27,47904,26946,74850
270380,201904,998,594,404,593044.86,404190,997234.86
270390,201904,191,111,80,110778,79840,190618
270400,201904,714,528,186,527945.41,186626,714571.41
270410,201904,694,506,188,504988,187624,692612
270420,201904,417,280,137,280438,137727.88,418165.88
270430,201904,33291,23974,9317,23951999.42,9322331.3,33274330.72
270440,201904,493,390,103,389220,102794,492014
270450,201904,796,432,364,431136,364270.42,795406.42
270460,201904,195,153,42,152694,41916,194610
270470,201904,1444,980,464,978040.79,464070,1442110.79
270480,201904,540,444,96,443112.8,95808,538920.8
270490,201904,24,19,5,18962,4990,23952
270500,201904,511,423,88,422154,87824,509978
270510,201904,772,476,296,475048,296406,771454
270520,201904,337,209,128,208582,127744,336326
270530,201904,67,59,8,58882,7984,66866
270540,201904,119,91,28,90818,27944,118762
270550,201904,1753,1337,416,1335325.98,415168,1750493.98
270560,201904,289,140,149,139720,148702,288422
270570,201904,493,347,146,346306,145708,492014
270580,201904,93,71,22,70858,21956,92814
270590,201904,71,57,14,56886,13972,70858
270600,201904,181,148,33,147704,32934,180638
270610,201904,212,179,33,178642.98,32934,211576.98
270620,201904,30,29,1,28942,998,29940
270630,201904,3913,2987,926,2981030.16,925146,3906176.16
270640,201904,906,667,239,665666,238523.94,904189.94
270642,201904,225,191,34,190618,33932,224550
270644,201904,257,176,81,175648.98,80838,256486.98
270650,201904,305,181,124,181236.79,123752,304988.79
270660,201904,257,210,47,209580,46906,256486
270670,201904,3118,2380,738,2375243.9,738521.38,3113765.28
270680,201904,472,276,196,275448.98,195608,471056.98
270690,201904,1145,741,404,739518,404190,1143708
270700,201904,34,26,8,25948,7984,33932
270710,201904,897,685,212,683630,211576,895206
270720,201904,256,198,58,197604,57884,255488
270730,201904,1938,1148,790,1145704.8,788422.08,1934126.88
270740,201904,44,28,16,27944,15968,43912
270750,201904,672,495,177,495008.6,176646,671654.6
270760,201904,300,217,83,216566,82834,299400
270770,201904,2819,1823,996,1820355.71,997002.96,2817358.67
270780,201904,84,53,31,52894,30939.98,83833.98
270790,201904,255,168,87,167664,86826,254490
270800,201904,1991,1606,385,1603786.99,384230.8,1988017.79
270810,201904,292,235,57,235528,56886,292414
270820,201904,158,104,54,103792,53892.8,157684.8
270830,201904,843,616,227,615767.98,227545.39,843313.37
270840,201904,1440,1083,357,1080834,356286.74,1437120.74
270850,201904,1614,988,626,986025,624748,1610773
270860,201904,2519,1657,862,1655917.67,860278.67,2516196.34
270870,201904,125,67,58,66866,57884,124750
270880,201904,902,683,219,681644.72,218566.86,900211.58
270890,201904,324,236,88,235528,87824,323352
270895,201904,67,58,9,57884,8982,66866
270900,201904,100,77,23,76846,22954,99800
270910,201904,319,252,67,251496,66866,318362
270915,201904,1902,1169,733,1166788.53,733541.2,1900329.73
270920,201904,494,418,76,417164,75848,493012
270930,201904,6197,4562,1635,4553890.22,1632740.89,6186631.11
270940,201904,2384,1824,560,1821350,558880.4,2380230.4
280010,201904,41,36,5,35928,4990,40918
280020,201904,453,400,53,400198.96,52894,453092.96
280030,201904,20201,13113,7088,13094801.44,7082821.96,20177623.40
280040,201904,332,219,113,218562,113772,332334
280050,201904,386,299,87,299400,86826,386226
280060,201904,341,229,112,228543.18,111776,340319.18
280067,201904,1004,715,289,713570.49,288422.75,1001993.24
280070,201904,126,104,22,103792,21956,125748
280100,201904,608,477,131,477044.8,130738.6,607783.4
280110,201904,75,70,5,69860,4990,74850
280120,201904,638,513,125,511974,124750,636724
280130,201904,1593,1035,558,1032930.6,557882,1590812.6
280140,201904,480,393,87,392214,86826,479040
280150,201904,364,268,96,267464,95808,363272
280160,201904,99,87,12,86826,11976,98802
280170,201904,421,279,142,278442.49,141716,420158.49
280190,201904,27,25,2,24950,1996,26946
280200,201904,30,23,7,22954,6986,29940
280210,201904,2831,2030,801,2026943.07,800396.4,2827339.47
280220,201904,43,34,9,33932,8982,42914
280230,201904,329,272,57,271456.7,56886,328342.7
280240,201904,117,111,6,110778,5988,116766
280250,201904,17,11,6,10978,5988,16966
280260,201904,83,73,10,72854,9980,82834
280270,201904,157,122,35,121756,34930,156686
280280,201904,192,123,69,122754,68862,191616
280290,201904,3231,2353,878,2348232.64,877242.64,3225475.28
280300,201904,1601,1228,373,1225544.4,372254,1597798.4
280310,201904,105,100,5,99800.6,4990,104790.6
280320,201904,667,463,204,463072,203592,666664
280330,201904,354,257,97,257484,96806,354290
280340,201904,414,334,80,334330,79840,414170
280350,201904,3585,2784,801,2778435.34,799398.7,3577834.04
280360,201904,442,284,158,283432,158682,442114
280370,201904,99,87,12,86826,11976,98802
280380,201904,56,43,13,42914,12974,55888
280390,201904,180,155,25,154690,24950,179640
280400,201904,348,242,106,241517.6,105788,347305.6
280410,201904,287,235,52,234530.6,51896,286426.6
280420,201904,171,144,27,143712,26946,170658
280430,201904,29,18,11,17964,10978,28942
280440,201904,693,536,157,534929.46,157684,692613.46
280445,201904,119,111,8,110778,7984,118762
280450,201904,1171,1005,166,1002990,165668,1168658
280460,201904,612,441,171,441116.7,170658,611774.7
280470,201904,189,176,13,175648,12974.7,188622.7
280480,201904,2436,1731,705,1728538.76,703591.62,2432130.38
280490,201904,289,269,20,269460.15,19960,289420.15
280500,201904,41,37,4,36926,3992,40918
280510,201904,142,111,31,110778,30938.4,141716.4
280520,201904,56,42,14,41916,13972,55888
280530,201904,73,47,26,47904,25948,73852
280540,201904,522,425,97,424150.7,96806,520956.7
280550,201904,734,677,57,675648.4,56886,732534.4
280560,201904,499,438,61,438122,60878,499000
280570,201904,2199,1708,491,1705584.38,491016,2196600.38
280580,201904,612,473,139,472056.19,138722.8,610778.99
280590,201904,175,114,61,113772,60878,174650
280600,201904,378,318,60,317364,59880,377244
280610,201904,129,99,30,98802,29940,128742
280620,201904,553,461,92,460078,91816,551894
280630,201904,159,132,27,131736,27944,159680
280640,201904,197,158,39,157684.96,38922,196606.96
280650,201904,77,55,22,54890,21956,76846
280660,201904,138,102,36,101796,35928,137724
280670,201904,1769,1132,637,1129741.47,636724.86,1766466.33
280680,201904,180,155,25,154690.69,25948,180638.69
280690,201904,91,79,12,78842,11976,90818
280700,201904,22,22,0,21956,,21956.0
280710,201904,1457,1121,336,1118758.6,335328,1454086.6
280720,201904,115,77,38,76846,37924,114770
280730,201904,26,22,4,21956,3992,25948
280740,201904,2519,1879,640,1875242.8,638720,2513962.8
280750,201904,225,199,26,198602,25948,224550
280760,201904,712,492,220,491016,219560,710576
290010,201904,206,143,63,142714,62874,205588
290020,201904,180,165,15,164670,14970,179640
290030,201904,606,397,209,397204,208582,605786
290035,201904,132,107,25,106786,24950,131736
290040,201904,288,190,98,189620,97804,287424
290050,201904,84,66,18,65868,17964,83832
290060,201904,260,117,143,116766,142714,259480
290070,201904,5638,2823,2815,2817355.86,2809375.61,5626731.47
290080,201904,483,222,261,221556.96,260479.92,482036.88
290090,201904,390,174,216,173652,215568,389220
290100,201904,1622,1075,547,1072851.2,546904.4,1619755.6
290110,201904,816,497,319,497005.12,318362.99,815368.11
290115,201904,203,188,15,188622,14970,203592
290120,201904,763,502,261,501994.03,262474,764468.03
290130,201904,427,259,168,258482,167664,426146
290135,201904,297,225,72,225548,71856,297404
290140,201904,314,262,52,261476,51896,313372
290150,201904,134,98,36,97804,35928,133732
290160,201904,249,189,60,188622.62,59880,248502.62
290170,201904,96,70,26,69860,25948,95808
290180,201904,169,131,38,130738.6,37924,168662.6
290190,201904,438,364,74,363272,73852,437124
290195,201904,297,184,113,183632,112774,296406
290200,201904,278,227,51,226546,50898,277444
290205,201904,146,91,55,90818,54890,145708
290210,201904,1157,840,317,838320.4,317364,1155684.4
290220,201904,223,122,101,121756,100798,222554
290225,201904,292,112,180,111776,179640,291416
290230,201904,60,40,20,39920,19960,59880
290240,201904,323,126,197,125748,196606,322354
290250,201904,262,241,21,240518,20958,261476
290260,201904,304,246,58,245508.4,57884,303392.4
290265,201904,196,165,31,164670,30938,195608
290270,201904,1429,1189,240,1186622.5,239521.36,1426143.86
290280,201904,482,348,134,347304,133732,481036
290290,201904,1284,760,524,758480.94,522952.4,1281433.34
290300,201904,455,385,70,384230.4,69860,454090.4
290310,201904,307,135,172,134730,172654,307384
290320,201904,4085,2537,1548,2532924.57,1544905.39,4077829.96
290323,201904,187,163,24,162674,23952,186626
290327,201904,164,130,34,129740,33932,163672
290330,201904,88,48,40,47904,39920,87824
290340,201904,892,361,531,360278,529938,890216
290350,201904,613,374,239,373252,238522,611774
290360,201904,368,277,91,276446.97,90818,367264.97
290370,201904,921,385,536,384230,534928.97,919158.97
290380,201904,316,193,123,192614,122754,315368
290390,201904,2492,1566,926,1562870.5,926144,2489014.5
290395,201904,251,143,108,142714.5,108782,251496.5
290400,201904,284,209,75,208582.4,74850,283432.4
290405,201904,249,219,30,218562,29940,248502
290410,201904,601,513,88,511974.95,87824,599798.95
290420,201904,247,196,51,195608,50898,246506
290430,201904,484,306,178,305388,177644,483032
290440,201904,72,64,8,63872,7984,71856
290450,201904,231,180,51,179640,50898,230538
290460,201904,1914,1149,765,1146711.8,763472.24,1910184.04
290470,201904,1410,599,811,597812.78,810393.64,1408206.42
290475,201904,590,552,38,550896.68,37924.4,588821.08
290480,201904,293,164,129,163672,128742,292414
290485,201904,243,224,19,223552,18962,242514
290490,201904,1212,878,334,876244,333332,1209576
290500,201904,712,363,349,362274,348302,710576
290510,201904,228,175,53,174650,52894,227544
290515,201904,145,89,56,88822,55888,144710
290520,201904,1430,951,479,949098.54,478042.73,1427141.27
290530,201904,313,289,24,288422,23952,312374
290540,201904,96,52,44,51896,43912,95808
290550,201904,154,127,27,126746,26946,153692
290560,201904,3275,1383,1892,1381232,1890215.32,3271447.32
290570,201904,6078,3114,2964,3110773.29,2959077.52,6069850.81
290580,201904,1296,777,519,775446,517962,1293408
290590,201904,563,463,100,462074,99800,561874
290600,201904,1770,1229,541,1227542.02,539918,1767460.02
290610,201904,221,199,22,198602.54,21956,220558.54
290620,201904,352,314,38,314370,37924,352294
290630,201904,2025,879,1146,877242,1144706.4,2021948.4
290640,201904,151,124,27,123752,26946,150698
290650,201904,1714,820,894,818360.69,892212,1710572.69
290660,201904,278,226,52,225548,51896,277444
290670,201904,1042,536,506,534928.8,505986.63,1040915.43
290680,201904,1233,994,239,992012,238522,1230534
290682,201904,296,222,74,221557.24,73852.98,295410.22
290685,201904,237,154,83,153692,82834,236526
290687,201904,997,648,349,646866.4,348302,995168.4
290689,201904,144,80,64,79840.97,63872,143712.97
290690,201904,620,258,362,257484.98,362278.84,619763.82
290700,201904,244,119,125,118762,124750,243512
290710,201904,709,481,228,480038,227544,707582
290720,201904,1050,852,198,850296.5,197604.4,1047900.9
290730,201904,1165,676,489,674648,488022,1162670
290740,201904,14,12,2,11976,1996,13972
290750,201904,1362,635,727,633730,725548.72,1359278.72
290755,201904,71,65,6,64870,5988,70858
290760,201904,297,259,38,258482,38922,297404
290770,201904,189,178,11,177644,10978.4,188622.4
290780,201904,1040,821,219,820359.74,218562,1038921.74
290790,201904,376,265,111,264470,110778,375248
290800,201904,2563,1035,1528,1032930,1524944,2557874
290810,201904,463,322,141,321356.4,140718,462074.4
290820,201904,392,235,157,234530.97,156686,391216.97
290830,201904,413,292,121,291416,121756,413172
290840,201904,1740,1079,661,1076843.68,659678.8,1736522.48
290850,201904,792,442,350,441116,349300,790416
290860,201904,630,292,338,291416,338322.4,629738.4
290870,201904,646,460,186,459080.64,185628.84,644709.48
290880,201904,125,70,55,69860,54890,124750
290890,201904,345,246,99,245508,98802,344310
290900,201904,167,126,41,125748,40918,166666
290910,201904,384,294,90,293412,89820,383232
290920,201904,227,191,36,190618,35928,226546
290930,201904,855,650,205,648700.4,204590.96,853291.36
290940,201904,246,205,41,204590,40918,245508
290950,201904,170,100,70,99800,69860,169660
290960,201904,469,320,149,319360,148702,468062
290970,201904,254,225,29,224550,28942,253492
290980,201904,1576,1125,451,1122750.68,450099.2,1572849.88
290990,201904,404,341,63,340320.36,63874.94,404195.30
291000,201904,863,253,610,252494,608780,861274
291005,201904,2250,993,1257,991014.4,1254486.98,2245501.38
291010,201904,157,142,15,141716,14970,156686
291020,201904,100,78,22,77844,21956,99800
291030,201904,98,72,26,71856,25948,97804
291040,201904,580,308,272,308382,271456,579838
291050,201904,1390,781,609,779438.96,607782,1387220.96
291060,201904,1515,844,671,842312,671654,1513966
291070,201904,1965,1466,499,1464067.62,498003.78,1962071.40
291072,201904,7357,2763,4594,2758473.82,4587809.11,7346282.93
291075,201904,221,182,39,181636,38922,220558
291077,201904,52,35,17,34930,16966,51896
291080,201904,20093,8919,11174,8907157.93,11161640.64,20068798.57
291085,201904,302,245,57,244510,56886,301396
291090,201904,298,116,182,115768.4,181636,297404.4
291100,201904,650,191,459,190618,458082,648700
291110,201904,407,311,96,310378.96,96806,407184.96
291120,201904,2498,1219,1279,1216562.7,1277441.49,2494004.19
291125,201904,64,32,32,31936,31936,63872
291130,201904,211,188,23,187624,22954,210578
291140,201904,143,112,31,111776,30938.4,142714.4
291150,201904,384,160,224,159680,223552,383232
291160,201904,378,314,64,313372.5,63872,377244.5
291165,201904,29,25,4,24950,3992,28942
291170,201904,3077,1560,1517,1556881.1,1515963.46,3072844.56
291180,201904,1300,515,785,513973.74,785428.88,1299402.62
291185,201904,83,81,2,80838,1996,82834
291190,201904,1310,581,729,579839.24,727542.86,1307382.10
291200,201904,169,128,41,127744,41916,169660
291210,201904,2230,893,1337,892212.62,1339317.38,2231530.00
291220,201904,276,206,70,205588,69860,275448
291230,201904,1019,357,662,356286.4,661674,1017960.4
291240,201904,436,414,22,413172.4,22954,436126.4
291250,201904,447,363,84,362274,83832,446106
291260,201904,52,40,12,39920,11976,51896
291270,201904,1192,491,701,490018,700596,1190614
291280,201904,373,177,196,176646.4,195608,372254.4
291290,201904,1750,912,838,910176.4,838321.4,1748497.8
291300,201904,233,180,53,181636,52894,234530
291310,201904,237,214,23,213572,22954,236526
291320,201904,1402,1001,401,999230.86,401196.8,1400427.66
291330,201904,130,111,19,110778,18962,129740
291340,201904,176,98,78,97804,77844,175648
291345,201904,138,95,43,94810,42914,137724
291350,201904,1612,550,1062,550896,1061872.7,1612768.7
291360,201904,8538,4242,4296,4236514.86,4303379.06,8539893.92
291370,201904,1140,643,497,641714.4,496006.98,1137721.38
291380,201904,263,207,56,206586,55888,262474
291390,201904,3853,1718,2135,1714565.94,2130731.2,3845297.14
291400,201904,2090,1499,591,1496002,589818.21,2085820.21
291410,201904,160,141,19,140718,18962,159680
291420,201904,118,88,30,87824,29940,117764
291430,201904,165,92,73,91816,72854.11,164670.11
291440,201904,513,415,98,414170.4,97804,511974.4
291450,201904,905,573,332,571854.5,331336,903190.5
291460,201904,1830,1494,336,1495005.2,335328,1830333.2
291465,201904,2203,1052,1151,1049909.9,1149709.58,2199619.48
291470,201904,2842,1441,1401,1438118.71,1398198.4,2836317.11
291480,201904,11824,5263,6561,5255493.39,6556988.3,11812481.69
291490,201904,566,242,324,241516,323352,564868
291500,201904,377,217,160,216566,159680,376246
291510,201904,1235,484,751,483032,749498,1232530
291520,201904,959,439,520,438122,518960,957082
291530,201904,980,274,706,273452,704588,978040
291535,201904,124,104,20,103792,19960,123752
291540,201904,354,106,248,105788,247504.2,353292.2
291550,201904,1204,575,629,573851.2,627743.38,1201594.58
291560,201904,5418,2779,2639,2773539.4,2633891.77,5407431.17
291570,201904,202,102,100,101796,99800,201596
291580,201904,1251,771,480,769459.81,479040,1248499.81
291590,201904,91,37,54,36926,53892,90818
291600,201904,1365,651,714,649698,712573.96,1362271.96
291610,201904,1452,696,756,694608,756486.54,1451094.54
291620,201904,565,261,304,261476,303392,564868
291630,201904,477,158,319,157684,318362,476046
291640,201904,3904,1974,1930,1970056.2,1926153.36,3896209.56
291650,201904,421,288,133,287424.53,132734,420158.53
291660,201904,410,166,244,165668,243512,409180
291670,201904,225,145,80,144710,79840,224550
291680,201904,686,393,293,392214,292414.8,684628.8
291685,201904,597,331,266,330338.5,265468,595806.5
291690,201904,569,315,254,315368,253493.86,568861.86
291700,201904,957,754,203,752492,202594,955086
291710,201904,1684,794,890,792412.5,890216.98,1682629.48
291720,201904,404,270,134,269460,133732,403192
291730,201904,946,562,384,560876,383232,944108
291733,201904,278,191,87,190618,86826,277444
291735,201904,71,54,17,53892,16966,70858
291740,201904,352,273,79,272454,78842,351296
291750,201904,2087,1365,722,1362271.45,720556,2082827.45
291760,201904,3050,1684,1366,1680632,1363268,3043900
291770,201904,794,537,257,535932.91,256486,792418.91
291780,201904,45,27,18,26946,17964,44910
291790,201904,166,80,86,79840,85828,165668
291800,201904,10105,4149,5956,4141702.91,5944091.08,10085793.99
291810,201904,1129,825,304,823350.4,303392.6,1126743.0
291820,201904,278,199,79,198602,78842,277444
291830,201904,1107,436,671,435128.98,669658.98,1104787.96
291835,201904,585,544,41,542912,40918,583830
291840,201904,4831,2498,2333,2495001.35,2330330.98,4825332.33
291845,201904,281,96,185,95808,184630,280438
291850,201904,334,297,37,296406,36926,333332
291855,201904,258,105,153,104790,152694,257484
291860,201904,172,107,65,106786,64870,171656
291870,201904,82,31,51,30938,50898,81836
291875,201904,189,175,14,174650,13972,188622
291880,201904,486,382,104,381236,103792,485028
291890,201904,243,80,163,79840,162674.4,242514.4
291900,201904,58,32,26,31936,25948,57884
291905,201904,129,93,36,92814.4,35928,128742.4
291910,201904,174,141,33,140718,32934,173652
291915,201904,418,371,47,370258.5,46906,417164.5
291920,201904,4999,2597,2402,2591806.6,2397197.98,4989004.58
291930,201904,182,107,75,106786,74850,181636
291940,201904,351,197,154,196606,154690,351296
291950,201904,1153,940,213,938120.4,212574,1150694.4
291955,201904,1178,708,470,707582,470058,1177640
291960,201904,181,129,52,128742,52894,181636
291970,201904,768,579,189,577842,188622,766464
291980,201904,1520,1344,176,1341313.38,175648.4,1516961.78
291990,201904,129,119,10,118762,9980,128742
291992,201904,178,91,87,90818,86826,177644
291995,201904,158,107,51,106786,50898,157684
292000,201904,391,301,90,300398.4,89820,390218.4
292010,201904,290,206,84,205588,83832,289420
292020,201904,290,211,79,210578,78842,289420
292030,201904,144,113,31,112774,30938,143712
292040,201904,640,328,312,327344,311376,638720
292045,201904,100,92,8,91816,7984,99800
292050,201904,937,676,261,674648,260478.4,935126.4
292060,201904,942,779,163,777442.86,162674,940116.86
292070,201904,49,20,29,19960,28942,48902
292080,201904,133,91,42,90818,41916,132734
292090,201904,507,187,320,186626,319360,505986
292100,201904,1406,626,780,624748.6,778440.98,1403189.58
292105,201904,213,184,29,183632,28942,212574
292110,201904,2080,783,1297,782432,1297405.86,2079837.86
292120,201904,686,544,142,542912,141716,684628
292130,201904,447,262,185,261476,184630,446106
292140,201904,201,160,41,159680,40918,200598
292145,201904,166,87,79,86826.4,78842,165668.4
292150,201904,1475,1194,281,1192610,280438,1473048
292160,201904,175,143,32,142714,31936,174650
292170,201904,1212,1064,148,1061872,147704,1209576
292180,201904,216,156,60,155688,59880,215568
292190,201904,162,99,63,98802,62874,161676
292200,201904,1291,476,815,475049.36,813371.36,1288420.72
292205,201904,128,114,14,113772,13972,127744
292210,201904,373,264,109,263472.1,109780,373252.1
292220,201904,20,16,4,15968,3992,19960
292225,201904,39,34,5,33932,4990,38922
292230,201904,963,779,184,777442.75,183632,961074.75
292240,201904,621,456,165,455088.7,164670,619758.7
292250,201904,1756,1144,612,1141712,610776.4,1752488.4
292260,201904,431,257,174,256486,174650.94,431136.94
292265,201904,252,177,75,176646,74850,251496
292270,201904,734,330,404,331336,404190.6,735526.6
292273,201904,203,114,89,113772,88822,202594
292275,201904,181,93,88,92814,87824,180638
292280,201904,144,103,41,102794,40918,143712
292285,201904,69,57,12,56886,11976,68862
292290,201904,582,395,187,394210.09,186626.4,580836.49
292300,201904,1648,641,1007,639718.4,1004987.71,1644706.11
292303,201904,102,69,33,68862,32934,101796
292305,201904,111,80,31,79840,30938,110778
292310,201904,870,569,301,567863.24,300398.56,868261.80
292320,201904,673,508,165,506984,164670,671654
292330,201904,179,101,78,100798,77844,178642
292335,201904,286,224,62,223552,61876,285428
292340,201904,580,409,171,408182.4,170658,578840.4
292350,201904,275,147,128,146706,127744,274450
292360,201904,710,540,170,538921.52,170658,709579.52
292370,201904,756,581,175,580836,174650,755486
292380,201904,662,520,142,519958.54,141716,661674.54
292390,201904,492,196,296,195608,295408,491016
292400,201904,3453,2155,1298,2151690.14,1295405,3447095.14
292405,201904,272,182,90,181636,89820,271456
292410,201904,141,85,56,84830,55888,140718
292420,201904,298,256,42,255488,41916,297404
292430,201904,530,414,116,413172,115768,528940
292440,201904,597,511,86,509978.44,85828,595806.44
292450,201904,262,202,60,201596,59880,261476
292460,201904,568,424,144,423152.98,144710,567862.98
292465,201904,222,181,41,180638,40918,221556
292467,201904,111,69,42,68862,41916,110778
292470,201904,277,191,86,190618,85828,276446
292480,201904,343,232,111,231536,110778.4,342314.4
292490,201904,230,156,74,155688,74850,230538
292500,201904,1130,500,630,499000.75,628740,1127740.75
292510,201904,3399,1560,1839,1557878.44,1837319.18,3395197.62
292520,201904,1077,514,563,512972.99,561874.98,1074847.97
292525,201904,398,283,115,283432,114770,398202
292530,201904,4268,1742,2526,1739517.73,2520953.48,4260471.21
292540,201904,468,253,215,252494,214570,467064
292550,201904,1056,572,484,570870.44,483043.54,1053913.98
292560,201904,325,306,19,305388,18962,324350
292570,201904,301,231,70,230538,69860,300398
292575,201904,484,312,172,311376.4,171656,483032.4
292580,201904,976,641,335,639718,335328.4,975046.4
292590,201904,556,481,75,480038,74850,554888
292593,201904,140,112,28,111776,27944,139720
292595,201904,187,144,43,143712,42914,186626
292600,201904,1259,928,331,927142.63,330338,1257480.63
292610,201904,131,101,30,100798,29940,130738
292620,201904,538,451,87,450099.38,86826,536925.38
292630,201904,1405,806,599,804388.67,598800.27,1403188.94
292640,201904,807,560,247,558880,246506,805386
292650,201904,181,154,27,153692.4,26946,180638.4
292660,201904,2039,1464,575,1461073.15,573850.55,2034923.70
292665,201904,149,108,41,107784,40918,148702
292670,201904,408,327,81,326346.99,80838,407184.99
292680,201904,259,200,59,199600,58882,258482
292690,201904,193,147,46,146706,45908,192614
292700,201904,952,633,319,631734,320358,952092
292710,201904,107,94,13,93812,12974,106786
292720,201904,900,505,395,504988,394210,899198
292730,201904,198,93,105,92814,104790,197604
292740,201904,67973,33790,34183,33739421.71,34140628.01,67880049.72
292750,201904,386,277,109,276446.78,108782,385228.78
292760,201904,329,272,57,271456.38,56886,328342.38
292770,201904,801,347,454,346306.4,453092,799398.4
292780,201904,415,162,253,161676,254490,416166
292790,201904,743,369,374,368262,373252,741514
292800,201904,1206,731,475,730536,474050,1204586
292805,201904,404,114,290,113772,289420,403192
292810,201904,1487,847,640,845306.8,638720.98,1484027.78
292820,201904,732,603,129,601794.7,128742.98,730537.68
292830,201904,102,84,18,83832,17964,101796
292840,201904,681,560,121,558880.6,120758,679638.6
292850,201904,136,92,44,91816,43912,135728
292860,201904,2222,1310,912,1307380.4,910176,2217556.4
292870,201904,3514,2370,1144,2366261.53,1141712,3507973.53
292880,201904,1485,967,518,965067.42,516964,1482031.42
292890,201904,497,427,70,426147.94,69860,496007.94
292895,201904,135,89,46,88822,45908,134730
292900,201904,393,286,107,285428,106786,392214
292905,201904,461,235,226,234530,225548,460078
292910,201904,431,329,102,328342.3,101796,430138.3
292920,201904,536,242,294,241516,293412,534928
292925,201904,502,464,38,463072,37924.96,500996.96
292930,201904,583,359,224,358282,223552,581834
292935,201904,287,122,165,121756,164670.98,286426.98
292937,201904,249,170,79,169660,78842,248502
292940,201904,198,154,44,153692,43912,197604
292950,201904,1134,589,545,587823.3,543910,1131733.3
292960,201904,614,427,187,426146,187624,613770
292970,201904,250,180,70,179640,69860,249500
292975,201904,137,78,59,77844,58882.6,136726.6
292980,201904,279,188,91,187624.76,90818,278442.76
292990,201904,1326,990,336,989019.64,335328,1324347.64
293000,201904,107,78,29,77844,29940,107784
293010,201904,2772,1679,1093,1675642.3,1091812.99,2767455.29
293015,201904,667,535,132,533930,131736,665666
293020,201904,344,281,63,280438,62874,343312
293030,201904,612,536,76,534928.8,76846,611774.8
293040,201904,352,282,70,281436,69860,351296
293050,201904,2783,1654,1129,1650692.4,1126743.98,2777436.38
293060,201904,257,207,50,206586.58,49900,256486.58
293070,201904,3487,1806,1681,1802390.89,1677640.88,3480031.77
293075,201904,92,60,32,59880,31936,91816
293076,201904,72,48,24,47904,23952,71856
293077,201904,470,279,191,278442.4,190618,469060.4
293080,201904,456,409,47,408182.74,46906,455088.74
293090,201904,132,116,16,115768,15968,131736
293100,201904,531,370,161,369260,160678.4,529938.4
293105,201904,348,245,103,244510.4,103792,348302.4
293110,201904,174,124,50,123752,49900,173652
293120,201904,332,228,104,227544.45,103792,331336.45
293130,201904,246,168,78,167664,77844,245508
293135,201904,8028,3202,4826,3196615.26,4816401.94,8013017.20
293140,201904,193,126,67,125748.6,66866,192614.6
293150,201904,333,286,47,285428,46906,332334
293160,201904,428,246,182,245508,182634,428142
293170,201904,153,106,47,105788,46906,152694
293180,201904,479,336,143,335328.4,142714,478042.4
293190,201904,1343,937,406,935126.7,405188.71,1340315.41
293200,201904,537,477,60,476046,59880,535926
293210,201904,380,293,87,292414.68,86826,379240.68
293220,201904,2608,1085,1523,1083828,1523946.58,2607774.58
293230,201904,1738,643,1095,641714.35,1094806,1736520.35
293240,201904,226,207,19,206586,18962,225548
293245,201904,118,98,20,97804,19960,117764
293250,201904,713,265,448,264470.67,448102,712572.67
293260,201904,298,252,46,251496,45908,297404
293270,201904,1154,551,603,549898.68,601794,1151692.68
293280,201904,259,148,111,147704,110778,258482
293290,201904,3055,2008,1047,2005980.4,1045905.97,3051886.37
293300,201904,727,522,205,520957.67,204590,725547.67
293305,201904,168,140,28,139720,27944,167664
293310,201904,145,110,35,109780,34930,144710
293315,201904,168,130,38,129740,37924,167664
293317,201904,92,65,27,64870,26946,91816
293320,201904,986,568,418,566864.5,419160,986024.5
293325,201904,190,71,119,70858,118762,189620
293330,201904,13118,6193,6925,6183610.72,6915148.92,13098759.64
293340,201904,260,192,68,191616,67864,259480
293345,201904,245,196,49,195608,48902,244510
293350,201904,641,362,279,361276.4,278442,639718.4
293360,201904,1573,1121,452,1118758,451096,1569854
310010,201904,146,77,69,76846,68862.4,145708.4
310020,201904,1067,595,472,595806.4,471056.44,1066862.84
310030,201904,333,272,61,271456.2,60878,332334.2
310040,201904,46,31,15,30938,14970,45908
310050,201904,186,119,67,118762,66866,185628
310060,201904,247,173,74,172654,73852,246506
310070,201904,15,8,7,7984,6986,14970
310080,201904,44,24,20,23952,19960,43912
310090,201904,983,522,461,520957.6,460078.8,981036.4
310100,201904,308,239,69,238522,68862,307384
310110,201904,723,396,327,397204,327344.4,724548.4
310120,201904,382,211,171,210578,170658,381236
310130,201904,34,22,12,21956,11976,33932
310140,201904,23,12,11,11976,10978,22954
310150,201904,1262,870,392,869259,392214.8,1261473.8
310160,201904,2093,1060,1033,1058879.17,1030934.8,2089813.97
310163,201904,96,54,42,53892,41916,95808
310170,201904,2601,1140,1461,1140714.74,1461074.6,2601789.34
310180,201904,131,50,81,49900,80838,130738
310190,201904,481,336,145,335328,144710,480038
310200,201904,498,320,178,319360.4,177644,497004.4
310205,201904,51,38,13,37924,12974,50898
310210,201904,287,233,54,232534,53892,286426
310220,201904,58,35,23,34930,22954,57884
310230,201904,275,193,82,192614,81836,274450
310240,201904,111,96,15,96806,14970,111776
310250,201904,104,83,21,82834,20958,103792
310260,201904,772,419,353,418164.04,353292,771456.04
310270,201904,281,189,92,188622.84,91816,280438.84
310280,201904,362,272,90,271456,89820,361276
310285,201904,216,156,60,155688,60878,216566
310290,201904,256,144,112,145708,111776,257484
310300,201904,152,124,28,123752,27944,151696
310310,201904,9,7,2,6986,1996,8982
310320,201904,30,15,15,14970,14970,29940
310330,201904,33,25,8,24950,7984,32934
310340,201904,1761,1169,592,1167661.4,594808.4,1762469.8
310350,201904,2888,1592,1296,1591811.78,1295404.98,2887216.76
310360,201904,40,33,7,32934,6986,39920
310370,201904,123,102,21,101796,20958.4,122754.4
310375,201904,111,42,69,41916,68862.96,110778.96
310380,201904,45,25,20,24950,19960,44910
310390,201904,92,63,29,62874,29940,92814
310400,201904,2385,1584,801,1584824.8,799398,2384222.8
310410,201904,125,69,56,68862,55888,124750
310420,201904,687,367,320,366266.6,319360.2,685626.8
310430,201904,321,213,108,212574,107784,320358
310440,201904,71,43,28,42914,27944,70858
310445,201904,81,68,13,67864,12974,80838
310450,201904,842,529,313,529938,312374,842312
310460,201904,261,188,73,187624,72854,260478
310470,201904,512,333,179,332334,179640,511974
310480,201904,79,59,20,58882,19960,78842
310490,201904,528,256,272,255488,271456,526944
310500,201904,130,54,76,53892,75848,129740
310510,201904,595,404,191,404190,193612.98,597802.98
310520,201904,133,94,39,93812,38922,132734
310530,201904,100,43,57,42914,56886,99800
310540,201904,464,282,182,282435.2,181636,464071.2
310550,201904,86,56,30,55888,29940,85828
310560,201904,2996,2061,935,2056880.8,933130,2990010.8
310570,201904,109,74,35,73852,34930,108782
310590,201904,364,239,125,238522.4,124750,363272.4
310600,201904,160,91,69,90818.4,68862,159680.4
310610,201904,60,24,36,23952,35928,59880
310620,201904,47288,22878,24410,22860144.31,24403112.82,47263257.13
310630,201904,623,401,222,400198,221556.4,621754.4
310640,201904,150,122,28,121756,27944,149700
310650,201904,162,142,20,141716,19960,161676
310660,201904,89,59,30,58882,29940,88822
310665,201904,59,42,17,41916,16966,58882
310670,201904,6575,2935,3640,2932131.02,3637737.48,6569868.50
310680,201904,60,37,23,36926,22954,59880
310690,201904,592,420,172,419160.1,171656,590816.1
310700,201904,57,38,19,37924,18962,56886
310710,201904,1332,905,427,903191.38,427144.4,1330335.78
310720,201904,100,30,70,29940,69860,99800
310730,201904,1403,992,411,995006.9,410178,1405184.9
310740,201904,984,556,428,556885.2,427144.5,984029.7
310750,201904,245,145,100,144710.66,99800,244510.66
310760,201904,64,44,20,43912,19960.4,63872.4
310770,201904,92,43,49,42914,48902,91816
310780,201904,392,319,73,319360.98,72854,392214.98
310790,201904,98,81,17,80838,16966,97804
310800,201904,458,227,231,226546.5,230538,457084.5
310810,201904,169,120,49,119760.18,48902,168662.18
310820,201904,353,279,74,278442,73852,352294
310825,201904,202,168,34,167664,33932,201596
310830,201904,462,224,238,225548.4,239520,465068.4
310840,201904,369,212,157,211576,156686,368262
310850,201904,110,88,22,87824,21956,109780
310855,201904,401,319,82,318362,81836,400198
310860,201904,1611,1205,406,1203590.56,406186.7,1609777.26
310870,201904,53,43,10,42914,10978,53892
310880,201904,83,65,18,64870,17964,82834
310890,201904,308,184,124,183632,123752,307384
310900,201904,649,300,349,299400.6,349300.96,648701.56
310910,201904,246,170,76,169660.6,75848,245508.6
310920,201904,472,282,190,281436.9,189620,471056.9
310925,201904,37,29,8,28942,7984.4,36926.4
310930,201904,1079,663,416,663685.84,415178.89,1078864.73
310940,201904,672,348,324,347304,323352,670656
310945,201904,122,73,49,72854,48902,121756
310950,201904,252,202,50,201596,49900,251496
310960,201904,81,28,53,27944,52894.99,80838.99
310970,201904,166,104,62,103792,61876,165668
310980,201904,48,26,22,25948,21956,47904
310990,201904,149,81,68,80838,67864,148702
311000,201904,841,426,415,425149.77,416166.98,841316.75
311010,201904,42,34,8,33932,7984,41916
311020,201904,43,27,16,26946,15968,42914
311030,201904,397,236,161,235528,160678,396206
311040,201904,39,35,4,34930,3992,38922
311050,201904,467,191,276,190618.8,275448,466066.8
311060,201904,769,435,334,434130.8,333332.4,767463.2
311070,201904,349,168,181,168662,180638,349300
311080,201904,109,59,50,58882,49900,108782
311090,201904,344,161,183,160678.4,182634,343312.4
311100,201904,607,359,248,359280,247504,606784
311110,201904,694,486,208,485028.4,207584.98,692613.38
311115,201904,76,55,21,54890,20958,75848
311120,201904,1095,581,514,579838.4,512972,1092810.4
311130,201904,379,226,153,225548,152694,378242
311140,201904,162,89,73,88822,73852,162674
311150,201904,363,241,122,240518,121756,362274
311160,201904,727,526,201,524948.4,200598,725546.4
311170,201904,80,62,18,61876,17964,79840
311180,201904,349,233,116,232534,115768.4,348302.4
311190,201904,34,16,18,15968,17964,33932
311200,201904,331,235,96,234530,95808,330338
311205,201904,33,23,10,22954,9980,32934
311210,201904,48,40,8,39920,7984,47904
311220,201904,18,17,1,17964,998,18962
311230,201904,1643,1077,566,1075844.6,565866,1641710.6
311240,201904,174,113,61,112774,60878,173652
311250,201904,99,29,70,28942,69860,98802
311260,201904,559,355,204,354290,203592,557882
311265,201904,115,80,35,79840,34930,114770
311270,201904,293,207,86,206586,85828,292414
311280,201904,207,97,110,96806,109780,206586
311290,201904,110,89,21,88822,20958.4,109780.4
311300,201904,586,374,212,373252,211576,584828
311310,201904,25,19,6,18962,5988,24950
311320,201904,670,499,171,498002,170658,668660
311330,201904,1073,796,277,796404,277444.8,1073848.8
311340,201904,2645,1875,770,1872248.8,770456.98,2642705.78
311350,201904,274,211,63,210578,63872,274450
311360,201904,181,112,69,111776,68862,180638
311370,201904,1213,505,708,503990.5,709578.96,1213569.46
311380,201904,7,6,1,5988,998,6986
311390,201904,264,145,119,144710,118762,263472
311400,201904,156,105,51,104790,50898,155688
311410,201904,101,57,44,56886.4,44910,101796.4
311420,201904,302,170,132,169661,132734,302395
311430,201904,867,576,291,575846.9,290418.4,866265.3
311440,201904,485,340,145,339320,145708,485028
311450,201904,326,206,120,206586,120758,327344
311455,201904,293,200,93,199600.98,93812,293412.98
311460,201904,137,57,80,56886,79840,136726
311470,201904,23,14,9,13972,8982,22954
311480,201904,43,19,24,18962,23952,42914
311490,201904,17,11,6,10978,5988,16966
311500,201904,22,10,12,9980,11976,21956
311510,201904,635,452,183,451096,183632,634728
311520,201904,41,33,8,32934,7984,40918
311530,201904,1795,1340,455,1337321.28,454090,1791411.28
311535,201904,71,51,20,50898,20958,71856
311540,201904,36,31,5,30938,4990,35928
311545,201904,197,144,53,143712,52894,196606
311547,201904,34,25,9,24950,8982,33932
311550,201904,672,321,351,320358,352294.98,672652.98
311560,201904,42,29,13,28942,12974,41916
311570,201904,293,199,94,198602,94810,293412
311580,201904,326,194,132,193612,131736,325348
311590,201904,34,30,4,29940,3992,33932
311600,201904,98,79,19,78842,18962,97804
311610,201904,256,222,34,221556.5,33932,255488.5
311615,201904,114,95,19,94810,18962,113772
311620,201904,22,12,10,11976,9980,21956
311630,201904,87,73,14,72854,13972,86826
311640,201904,133,71,62,70858,61876,132734
311650,201904,133,96,37,95808,36926,132734
311660,201904,415,203,212,202594,211576,414170
311670,201904,166,108,58,107784.58,57884,165668.58
311680,201904,216,159,57,160678,56886,217564
311690,201904,15,10,5,9980,4990,14970
311700,201904,200,141,59,140718,58882,199600
311710,201904,207,131,76,130738.63,75848,206586.63
311720,201904,40,29,11,28942.4,10978,39920.4
311730,201904,593,392,201,391216,201596.98,592812.98
311740,201904,36,27,9,26946,8982,35928
311750,201904,709,479,230,478043.36,229540,707583.36
311760,201904,59,33,26,32934,25948,58882
311770,201904,390,196,194,195609.34,194610,390219.34
311780,201904,180,98,82,97804.4,81836,179640.4
311783,201904,86,76,10,75848,9980,85828
311787,201904,35,14,21,13972,20958,34930
311790,201904,269,126,143,125748,142714,268462
311800,201904,674,456,218,455088.5,217564,672652.5
311810,201904,49,41,8,40918,7984,48902
311820,201904,116,98,18,98802,17964,116766
311830,201904,1965,1250,715,1247501.5,713570,1961071.5
311840,201904,1020,567,453,565868,452094.9,1017962.9
311850,201904,11,7,4,6986,3992,10978
311860,201904,9539,4354,5185,4352280.7,5187610.25,9539890.95
311870,201904,141,78,63,77844,62874,140718
311880,201904,940,699,241,697603.38,240518,938121.38
311890,201904,218,110,108,109698,107784,217482
311900,201904,80,33,47,32934,46906,79840
311910,201904,1422,890,532,889218.7,531934.4,1421153.1
311920,201904,228,151,77,150698,76846,227544
311930,201904,910,521,389,520956.4,388222.5,909178.9
311940,201904,2532,1349,1183,1348298,1181632,2529930
311950,201904,59,45,14,44910,13972,58882
311960,201904,65,47,18,47904,17964,65868
311970,201904,26,16,10,15968,9980,25948
311980,201904,46,36,10,35928,9980,45908
311990,201904,48,36,12,35928,11976,47904
311995,201904,60,41,19,40918,18962,59880
312000,201904,34,25,9,24950,8982,33932
312010,201904,85,64,21,63872,20958,84830
312015,201904,98,73,25,72854.4,24950,97804.4
312020,201904,132,90,42,89820.4,41916,131736.4
312030,201904,51,40,11,39920,10978,50898
312040,201904,86,54,32,53892,31936,85828
312050,201904,203,113,90,112774,89820,202594
312060,201904,64,39,25,38922,24950,63872
312070,201904,72,45,27,44910,26946,71856
312080,201904,539,252,287,251496,286426,537922
312083,201904,57,40,17,39920,16966,56886
312087,201904,112,89,23,88822,22954,111776
312090,201904,3085,1835,1250,1832332.5,1248499.36,3080831.86
312100,201904,153,105,48,104560.86,47904,152464.86
312110,201904,116,72,44,71856,43912,115768
312120,201904,148,111,37,110778.97,36926,147704.97
312125,201904,90,49,41,48902,41916,90818
312130,201904,124,86,38,85828,37924,123752
312140,201904,144,112,32,111776.4,31936,143712.4
312150,201904,46,36,10,35928,9980,45908
312160,201904,1557,1023,534,1022043.2,533930.4,1555973.6
312170,201904,11,10,1,9980,998,10978
312180,201904,107,67,40,66866,39920.8,106786.8
312190,201904,31,27,4,26946,3992,30938
312200,201904,763,656,107,654688.4,106786,761474.4
312210,201904,93,62,31,61876,30938,92814
312220,201904,134,97,37,96806.5,36926,133732.5
312230,201904,3617,1769,1848,1767461.12,1852296.06,3619757.18
312235,201904,164,112,52,111776,51896,163672
312240,201904,107,75,32,74850,31936,106786
312245,201904,177,124,53,123752.99,52894,176646.99
312247,201904,64,44,20,43912,19960,63872
312250,201904,176,84,92,83832,91816,175648
312260,201904,115,76,39,75848,38922,114770
312270,201904,138,84,54,83832,53892,137724
312280,201904,29,17,12,16966,11976,28942
312290,201904,155,107,48,106786,47904.6,154690.6
312300,201904,207,135,72,134730,71856,206586
312310,201904,57,53,4,52894,3992,56886
312320,201904,437,279,158,278442,158682,437124
312330,201904,93,83,10,82834,9980,92814
312340,201904,38,17,21,16966,20958,37924
312350,201904,18,11,7,10978,6986,17964
312352,201904,99,69,30,68862,29940,98802
312360,201904,559,250,309,250498,308382,558880
312370,201904,306,176,130,175648,129740.4,305388.4
312380,201904,145,99,46,98802,45908,144710
312385,201904,171,138,33,137724,32934,170658
312390,201904,307,192,115,191616,114770,306386
312400,201904,380,294,86,293412,85829,379241
312410,201904,933,308,625,308382,624749.39,933131.39
312420,201904,619,481,138,481036.4,137724,618760.4
312430,201904,860,638,222,637723.89,221556,859279.89
312440,201904,45,34,11,33932,10978,44910
312450,201904,206,128,78,127744,78842,206586
312460,201904,45,22,23,21956,22954,44910
312470,201904,54,34,20,33932,19960,53892
312480,201904,202,124,78,123752,77844,201596
312490,201904,273,192,81,191616,80838,272454
312500,201904,35,20,15,19960,14970,34930
312510,201904,481,188,293,188622,292414,481036
312520,201904,42,14,28,13972,27944,41916
312530,201904,52,37,15,36926,14970,51896
312540,201904,102,89,13,88822,12974,101796
312550,201904,39,30,9,29940,8982,38922
312560,201904,221,169,52,168662.4,51896,220558.4
312570,201904,445,267,178,266466,177644,444110
312580,201904,88,46,42,45908,41916,87824
312590,201904,260,205,55,205588,54890,260478
312595,201904,138,124,14,123752,13972,137724
312600,201904,70,43,27,42914.1,26946,69860.1
312610,201904,1616,850,766,849300.06,765466.08,1614766.14
312620,201904,197,143,54,142714,53892,196606
312630,201904,71,58,13,57884,12974,70858
312640,201904,43,11,32,10978,31936,42914
312650,201904,153,128,25,127744.4,24950,152694.4
312660,201904,78,59,19,58882.7,18962,77844.7
312670,201904,885,585,300,584828,300398,885226
312675,201904,37,29,8,28942,7984,36926
312680,201904,82,54,28,53892,27944,81836
312690,201904,240,131,109,130738,108782,239520
312695,201904,37,30,7,29940,6986,36926
312700,201904,220,129,91,128742,90818,219560
312705,201904,81,67,14,66866,13972,80838
312707,201904,129,94,35,94810.3,34930,129740.3
312710,201904,1919,1043,876,1040915.36,877242.58,1918157.94
312720,201904,63,31,32,30938,31936,62874
312730,201904,280,165,115,165668,115768,281436
312733,201904,54,45,9,44910,8982,53892
312735,201904,25,17,8,16966,7984,24950
312737,201904,72,37,35,36926,34930,71856
312738,201904,54,39,15,38922,14970,53892
312740,201904,75,50,25,49900.4,24950,74850.4
312750,201904,71,52,19,51896,18962,70858
312760,201904,278,202,76,201596,75848,277444
312770,201904,7661,3569,4092,3564863.92,4097791.93,7662655.85
312780,201904,420,323,97,322354,96806,419160
312790,201904,24,19,5,18962,4990,23952
312800,201904,1619,1130,489,1129736.9,488022.46,1617759.36
312810,201904,375,242,133,241516,133732,375248
312820,201904,193,144,49,143712,48902,192614
312825,201904,26,18,8,17964,7984,25948
312830,201904,263,154,109,153692.46,108782,262474.46
312840,201904,155,111,44,110778,43912,154690
312850,201904,50,45,5,44910,4990,49900
312860,201904,166,104,62,103792,61876,165668
312870,201904,1006,538,468,539918.9,470058,1009976.9
312880,201904,146,100,46,100798,46906,147704
312890,201904,164,117,47,116766,46906,163672
312900,201904,205,156,49,155688,48902,204590
312910,201904,184,98,86,97804,85828,183632
312920,201904,156,89,67,88822,67864,156686
312930,201904,328,235,93,235528,92814,328342
312940,201904,112,81,31,80838,30938,111776
312950,201904,707,472,235,475048,236526,711574
312960,201904,173,131,42,130738.96,42914,173652.96
312965,201904,61,54,7,54890,6986,61876
312970,201904,274,219,55,218562.4,54890,273452.4
312980,201904,2408,1257,1151,1255486.18,1150694.99,2406181.17
312990,201904,47,26,21,25948,20958,46906
313000,201904,46,26,20,25948,19960,45908
313005,201904,173,137,36,136726,35928.4,172654.4
313010,201904,930,382,548,381236,546904.98,928140.98
313020,201904,189,101,88,100798,87824,188622
313030,201904,203,133,70,132734.54,69860,202594.54
313040,201904,69,25,44,24950,43912,68862
313050,201904,218,153,65,152694,64870,217564
313055,201904,45,34,11,33932,10978,44910
313060,201904,125,90,35,89820,34930,124750
313065,201904,60,41,19,40918,18962,59880
313070,201904,141,76,65,75848,65868,141716
313080,201904,43,19,24,18962,23952,42914
313090,201904,707,492,215,491016.4,215568,706584.4
313100,201904,168,63,105,62874,104790,167664
313110,201904,139,77,62,76846,61876,138722
313115,201904,187,105,82,104790,81836,186626
313120,201904,788,450,338,449100.4,337324.4,786424.8
313130,201904,5525,3062,2463,3057878.58,2459074.02,5516952.60
313140,201904,152,81,71,80838,70858,151696
313150,201904,310,248,62,247504,61876,309380
313160,201904,196,144,52,143712.4,51896,195608.4
313170,201904,1413,977,436,976045.6,436126.98,1412172.58
313180,201904,308,185,123,184630,122754,307384
313190,201904,758,465,293,464070,293412.2,757482.2
313200,201904,29,26,3,25948,2994,28942
313210,201904,1033,876,157,875247.62,156686,1031933.62
313220,201904,253,168,85,167664,84830,252494
313230,201904,276,206,70,205588.65,69860,275448.65
313240,201904,1965,1051,914,1048902.29,914168,1963070.29
313250,201904,1289,977,312,977042.8,311377.12,1288419.92
313260,201904,90,51,39,51896,38922,90818
313270,201904,962,567,395,566864.3,394210.4,961074.7
313280,201904,58,48,10,47904,9980,57884
313290,201904,220,177,43,176646.4,42914,219560.4
313300,201904,357,184,173,183633,172654,356287
313310,201904,244,127,117,126746,116766,243512
313320,201904,377,287,90,286427,89820,376247
313330,201904,1384,866,518,865266.6,519958,1385224.6
313340,201904,335,236,99,235528,98802,334330
313350,201904,507,343,164,343312,163672,506984
313360,201904,118,68,50,67864,49900.4,117764.4
313370,201904,195,74,121,73852,120758,194610
313375,201904,274,167,107,167664,107784,275448
313380,201904,1333,710,623,709578.2,622752.99,1332331.19
313390,201904,53,47,6,46906.6,5988,52894.6
313400,201904,420,286,134,286426.6,133732.8,420159.4
313410,201904,23,13,10,12974,9980,22954
313420,201904,4682,2495,2187,2491009.6,2184623.5,4675633.1
313430,201904,141,69,72,68862,73852,142714
313440,201904,1479,1017,462,1014967.97,464072,1479039.97
313450,201904,63,28,35,27944,35928,63872
313460,201904,387,180,207,179640.4,207584,387224.4
313470,201904,532,246,286,246506,285428,531934
313480,201904,151,106,45,105788.4,44910,150698.4
313490,201904,519,251,268,250498.4,268462.9,518961.3
313500,201904,20,12,8,11976,7984,19960
313505,201904,1021,810,211,810376,211576,1021952
313507,201904,98,61,37,60878,36926,97804
313510,201904,2798,1802,996,1802389,995006,2797395
313520,201904,3538,2772,766,2768456.85,764468.99,3532925.84
313530,201904,41,28,13,27944,12974,40918
313535,201904,52,44,8,43912,7984,51896
313540,201904,76,59,17,58882,16966,75848
313545,201904,113,95,18,94810,17964,112774
313550,201904,235,198,37,197604,36926.4,234530.4
313560,201904,330,168,162,167664,161676,329340
313570,201904,58,29,29,28942,28942,57884
313580,201904,1340,753,587,752492,588821.2,1341313.2
313590,201904,77,45,32,44910,31936,76846
313600,201904,687,419,268,418162,268462.4,686624.4
313610,201904,62,50,12,49900.8,11976,61876.8
313620,201904,1385,734,651,732532.8,651694,1384226.8
313630,201904,1638,1259,379,1257481.2,378242,1635723.2
313640,201904,128,76,52,75848,51896,127744
313650,201904,241,114,127,113772,126746.4,240518.4
313652,201904,18,18,0,17964,,17964.0
313655,201904,58,35,23,34930,22954,57884
313657,201904,47,44,3,43912,2994,46906
313660,201904,136,93,43,92814,42931.96,135745.96
313665,201904,664,328,336,327344,335328,662672
313670,201904,10302,7115,3187,7105767.93,3189609.2,10295377.13
313680,201904,43,32,11,32934,10978.78,43912.78
313690,201904,154,114,40,113772,39920,153692
313695,201904,75,58,17,58882,16966,75848
313700,201904,315,252,63,253492.4,62874,316366.4
313710,201904,141,97,44,96806,43912,140718
313720,201904,1128,547,581,545906.4,581835.4,1127741.8
313730,201904,62,43,19,42914,18962,61876
313740,201904,158,129,29,128742,28942,157684
313750,201904,429,316,113,315368,112774,428142
313753,201904,243,180,63,179640,62874,242514
313760,201904,1278,468,810,468062.4,810378.1,1278440.5
313770,201904,363,270,93,269460.5,92814,362274.5
313780,201904,761,398,363,397204,363272,760476
313790,201904,29,28,1,27944,998,28942
313800,201904,145,92,53,92814,52894,145708
313810,201904,70,40,30,39920,29940,69860
313820,201904,1312,651,661,651695.2,663672.15,1315367.35
313830,201904,64,47,17,46906,16966,63872
313835,201904,61,51,10,50898,9980,60878
313840,201904,1714,1065,649,1062871.2,648700.8,1711572.0
313850,201904,186,68,118,67864,117764,185628
313860,201904,473,361,112,361276.4,111776,473052.4
313862,201904,174,116,58,116766,57884,174650
313865,201904,101,80,21,79840,20958,100798
313867,201904,48,38,10,37924,9980,47904
313868,201904,31,20,11,19960,10978,30938
313870,201904,125,66,59,65868,58882,124750
313880,201904,367,236,131,235528,131736.4,367264.4
313890,201904,333,179,154,178643,153692,332335
313900,201904,911,504,407,502992.5,407184.9,910177.4
313910,201904,143,105,38,104790,37924,142714
313920,201904,631,450,181,449100,180638.9,629738.9
313925,201904,32,28,4,27944,3992,31936
313930,201904,827,647,180,645706,180638.95,826344.95
313940,201904,1818,1150,668,1147700,667662.4,1815362.4
313950,201904,936,602,334,600796.8,333332,934128.8
313960,201904,1382,804,578,804389.16,576845.8,1381234.96
313970,201904,131,87,44,86826,43912,130738
313980,201904,217,139,78,138722.5,77844,216566.5
313990,201904,373,222,151,221556,150698,372254
314000,201904,926,624,302,622753.74,301396,924149.74
314010,201904,82,54,28,53892,27944,81836
314015,201904,58,18,40,17964,39920,57884
314020,201904,55,39,16,38922,15968,54890
314030,201904,78,38,40,37924,39920,77844
314040,201904,43,28,15,27944,14970,42914
314050,201904,296,177,119,176646.4,119760,296406.4
314053,201904,95,61,34,60878.4,33932,94810.4
314055,201904,304,187,117,186626,116766,303392
314060,201904,144,124,20,123752,19960,143712
314070,201904,1058,563,495,561874,494010,1055884
314080,201904,216,139,77,138722,76846.36,215568.36
314085,201904,144,98,46,97804,45908,143712
314090,201904,367,265,102,264470.9,101796,366266.9
314100,201904,481,398,83,398202.3,82834,481036.3
314110,201904,735,402,333,401196,334330,735526
314120,201904,92,54,38,53892,37924,91816
314130,201904,21,11,10,10978,9980,20958
314140,201904,1116,689,427,688620.4,426146,1114766.4
314150,201904,166,106,60,105788,59880,165668
314160,201904,349,265,84,264470.6,83832.6,348303.2
314170,201904,77,60,17,59880,16966,76846
314180,201904,734,649,85,648701.19,84830.5,733531.69
314190,201904,100,62,38,61876,37924,99800
314200,201904,475,325,150,324350,149700,474050
314210,201904,272,208,64,207584,63872.4,271456.4
314220,201904,312,233,79,232534.4,78842.4,311376.8
314225,201904,67,49,18,49900,17964,67864
314230,201904,119,54,65,53892,64870,118762
314240,201904,140,109,31,108782,30938,139720
314250,201904,60,38,22,37924,21956,59880
314260,201904,227,109,118,108782,117764,226546
314270,201904,333,263,70,262474,69860,332334
314280,201904,703,399,304,398202.98,303392,701594.98
314290,201904,553,454,99,455088.9,98802,553890.9
314300,201904,388,282,106,281438.5,105788.9,387227.4
314310,201904,1426,967,459,966314.53,458082,1424396.53
314315,201904,39,31,8,30938,7984,38922
314320,201904,602,400,202,400198.4,204590,604788.4
314330,201904,10884,5499,5385,5491998.28,5385211.53,10877209.81
314340,201904,590,276,314,275448,315368.8,590816.8
314345,201904,40,30,10,29940,9980,39920
314350,201904,186,119,67,118762,66866,185628
314360,201904,78,48,30,47904,29940,77844
314370,201904,61,47,14,46906,13972,60878
314380,201904,96,67,29,66866,28942,95808
314390,201904,3289,2105,1184,2101789.5,1183628.6,3285418.1
314400,201904,693,498,195,498003.5,194610,692613.5
314410,201904,468,309,159,308382,158682,467064
314420,201904,18,8,10,7984,9980,17964
314430,201904,2482,912,1570,910177.9,1569854,2480031.9
314435,201904,265,158,107,157684,107784,265468
314437,201904,28,22,6,21956,5988,27944
314440,201904,98,72,26,72854,25948,98802
314450,201904,158,115,43,114770,42914,157684
314460,201904,655,309,346,308382,345308,653690
314465,201904,88,59,29,58882,29940,88822
314467,201904,69,57,12,56886,11976,68862
314470,201904,405,209,196,208582.98,196606,405188.98
314480,201904,1093,539,554,537922,557882,1095804
314490,201904,84,61,23,60878,22954,83832
314500,201904,302,203,99,202594,98802,301396
314505,201904,132,88,44,87824,43912,131736
314510,201904,239,198,41,197604,40918,238522
314520,201904,1268,679,589,678647.6,587823.2,1266470.8
314530,201904,760,609,151,609779.66,151696,761475.66
314535,201904,214,132,82,131736,81836,213572
314537,201904,65,39,26,38922,25948,64870
314540,201904,14,9,5,8982,4990,13972
314545,201904,52,34,18,33932,17964,51896
314550,201904,82,44,38,43912,37924,81836
314560,201904,832,457,375,456087.2,377244,833331.2
314570,201904,20,16,4,15968,3992,19960
314580,201904,15,8,7,7984,6986,14970
314585,201904,25,19,6,18962,5988,24950
314587,201904,80,71,9,70858,8982,79840
314590,201904,582,425,157,426147.7,156686,582833.7
314600,201904,950,622,328,620757,328343.03,949100.03
314610,201904,955,510,445,509979.3,447104,957083.3
314620,201904,144,105,39,104790,38922,143712
314625,201904,96,71,25,70858,24950,95808
314630,201904,1210,629,581,628740,580836,1209576
314640,201904,83,57,26,56886,25948,82834
314650,201904,186,108,78,107784,77844,185628
314655,201904,67,49,18,48902,17964,66866
314660,201904,19,15,4,14970,3992,18962
314670,201904,205,158,47,157684.4,46906,204590.4
314675,201904,217,129,88,128742,87824,216566
314690,201904,556,304,252,304390,251496,555886
314700,201904,2375,1294,1081,1308379.6,1078838,2387217.6
314710,201904,1638,968,670,967064.5,673650.4,1640714.9
314720,201904,396,234,162,233532,161676,395208
314730,201904,521,269,252,268496.66,251496.98,519993.64
314740,201904,705,349,356,348302,355288,703590
314750,201904,21,19,2,18962,1996,20958
314760,201904,333,156,177,156686,176646,333332
314770,201904,109,78,31,77844.4,30938,108782.4
314780,201904,21,6,15,5988,14970,20958
314790,201904,2379,1512,867,1512971.87,868260,2381231.87
314795,201904,45,39,6,38922.5,5988,44910.5
314800,201904,2922,1722,1200,1721551.48,1200594,2922145.48
314810,201904,1535,873,662,871254,664668.6,1535922.6
314820,201904,97,53,44,52894,43912,96806
314830,201904,217,178,39,177644,38922.4,216566.4
314840,201904,87,50,37,49900,36926,86826
314850,201904,351,171,180,170658,179640,350298
314860,201904,704,531,173,530937.13,173652.7,704589.83
314870,201904,1508,799,709,797402,707582,1504984
314875,201904,58,50,8,49900,7984,57884
314880,201904,47,33,14,32934,13972,46906
314890,201904,54,31,23,30938,22954,53892
314900,201904,31,25,6,24950,5988,30938
314910,201904,252,169,83,169660,82834,252494
314915,201904,154,134,20,133732,19960,153692
314920,201904,119,73,46,72854,45908,118762
314930,201904,1073,539,534,537922.8,532932,1070854.8
314940,201904,49,39,10,38922,9980,48902
314950,201904,35,25,10,24950,9980,34930
314960,201904,51,39,12,38922,11976,50898
314970,201904,146,75,71,74850,70858,145708
314980,201904,295,186,109,185628,108782,294410
314990,201904,461,256,205,256486,204590,461076
314995,201904,208,62,146,61876,145708,207584
315000,201904,93,75,18,74850,17964,92814
315010,201904,46,30,16,29940,15968,45908
315015,201904,174,143,31,142714,30938,173652
315020,201904,72,62,10,61876,9980,71856
315030,201904,115,89,26,88822,25948.4,114770.4
315040,201904,70,51,19,50898,18962,69860
315050,201904,191,114,77,113772,76846.4,190618.4
315053,201904,44,39,5,38922,4990,43912
315057,201904,98,81,17,80838,16966,97804
315060,201904,68,60,8,59881.35,7984,67865.35
315070,201904,106,60,46,59880,45908,105788
315080,201904,378,309,69,308382,68862,377244
315090,201904,109,63,46,62874,45908,108782
315100,201904,81,43,38,42914,37924,80838
315110,201904,282,153,129,152694,128742,281436
315120,201904,1648,836,812,835326,813370.68,1648696.68
315130,201904,351,253,98,252494,97804,350298
315140,201904,527,309,218,308382.4,218562.24,526944.64
315150,201904,970,466,504,466066,505986.4,972052.4
315160,201904,218,112,106,111776,105788,217564
315170,201904,325,211,114,210578.4,114770,325348.4
315180,201904,3308,1403,1905,1402192.4,1904186.7,3306379.1
315190,201904,329,197,132,196606.2,131736,328342.2
315200,201904,1239,722,517,720556,515966,1236522
315210,201904,1613,924,689,922152.6,689618.2,1611770.8
315213,201904,40,23,17,22954,16966,39920
315217,201904,213,170,43,169660,42914,212574
315220,201904,1567,1205,362,1203589.58,362274.4,1565863.98
315230,201904,173,127,46,126746.4,45908,172654.4
315240,201904,430,274,156,273452,155688.98,429140.98
315250,201904,2532,1262,1270,1259476.5,1270454.8,2529931.3
315260,201904,146,90,56,89820,55888,145708
315270,201904,128,91,37,90818,36926,127744
315280,201904,673,439,234,438122.25,233532,671654.25
315290,201904,206,125,81,124750,80838,205588
315300,201904,74,54,20,53892,19960,73852
315310,201904,70,64,6,63872,5988,69860
315320,201904,169,97,72,96806,71856,168662
315330,201904,59,50,9,49900,8982,58882
315340,201904,400,287,113,286426,112774,399200
315350,201904,153,92,61,91816,60878,152694
315360,201904,93,49,44,48902,43912,92814
315370,201904,57,33,24,32934,23952,56886
315380,201904,10,7,3,6986,2994,9980
315390,201904,68,19,49,18962,48902,67864
315400,201904,846,633,213,632732.7,212574,845306.7
315410,201904,354,217,137,217564.4,136727.4,354291.8
315415,201904,63,47,16,46906,15968,62874
315420,201904,203,155,48,154690.4,47904,202594.4
315430,201904,666,387,279,386226.4,278442.6,664669.0
315440,201904,89,60,29,59880,28942,88822
315445,201904,251,203,48,202594,47904,250498
315450,201904,186,141,45,140718,44910,185628
315460,201904,3541,1799,1742,1795402.98,1738516.98,3533919.96
315470,201904,41,17,24,16966,23952,40918
315480,201904,64,24,40,23952,39920,63872
315490,201904,645,404,241,403192,240518,643710
315500,201904,23,16,7,15968,6986,22954
315510,201904,153,103,50,102794,49900,152694
315520,201904,71,64,7,63872,6986,70858
315530,201904,53,28,25,27944,24950,52894
315540,201904,240,162,78,161676,77844,239520
315550,201904,181,144,37,143712,36926,180638
315560,201904,734,592,142,592812.4,141716,734528.4
315570,201904,311,162,149,161677.83,148702.6,310380.43
315580,201904,704,467,237,466066,236526,702592
315590,201904,203,107,96,106786,95808,202594
315600,201904,298,224,74,223552,73852,297404
315610,201904,98,51,47,51896,46906,98802
315620,201904,34,27,7,26946,6986,33932
315630,201904,136,90,46,89820,45908,135728
315640,201904,67,41,26,40918,25948,66866
315645,201904,60,42,18,41916,17964,59880
315650,201904,167,122,45,122754.8,44910,167664.8
315660,201904,476,217,259,216566,258482,475048
315670,201904,2446,1219,1227,1217561.8,1225546.8,2443108.6
315680,201904,856,584,272,583830,271456,855286
315690,201904,684,474,210,475049.33,209580,684629.33
315700,201904,1898,1008,890,1005985.27,889218,1895203.27
315710,201904,332,96,236,95808,236526,332334
315720,201904,444,282,162,281436,162674,444110
315725,201904,202,161,41,160678.4,40918,201596.4
315727,201904,38,20,18,19960,17964,37924
315730,201904,48,46,2,45908,1996,47904
315733,201904,87,59,28,58882,27944,86826
315737,201904,50,39,11,38922,10978,49900
315740,201904,39,32,7,31936,6986,38922
315750,201904,160,123,37,122754,36926,159680
315760,201904,44,34,10,33932,9980,43912
315765,201904,123,78,45,77844,44910,122754
315770,201904,232,143,89,142714,88822.4,231536.4
315780,201904,3424,1787,1637,1785423,1635723.15,3421146.15
315790,201904,214,166,48,165668,47904,213572
315800,201904,293,215,78,214570,77844,292414
315810,201904,95,56,39,55888,38922.4,94810.4
315820,201904,785,574,211,573851.2,211576,785427.2
315830,201904,136,78,58,77844,57884,135728
315840,201904,86,60,26,59880,25948,85828
315850,201904,262,194,68,193612.5,67864,261476.5
315860,201904,12,4,8,3992,7984,11976
315870,201904,38,30,8,29940,7984,37924
315880,201904,109,72,37,72854,36926,109780
315890,201904,86,63,23,62874,22954,85828
315895,201904,463,316,147,315368.5,146706.8,462075.3
315900,201904,72,37,35,36926,34930,71856
315910,201904,41,28,13,27944,13972,41916
315920,201904,174,112,62,111776,62874.3,174650.3
315930,201904,47,17,30,16966,29940,46906
315935,201904,140,108,32,107784,31936.98,139720.98
315940,201904,93,71,22,70858,22954,93812
315950,201904,46,33,13,32934,12974,45908
315960,201904,554,265,289,264470.4,288422.4,552892.8
315970,201904,36,29,7,28942,6986,35928
315980,201904,696,340,356,339320.1,357284,696604.1
315990,201904,256,150,106,149700.5,105788.98,255489.48
316000,201904,53,35,18,34930,17964,52894
316010,201904,83,71,12,70858,11976,82834
316020,201904,115,99,16,98802,15968,114770
316030,201904,407,221,186,220558.8,185628.9,406187.7
316040,201904,518,222,296,221556.4,295408.4,516964.8
316045,201904,64,57,7,56886,6986,63872
316050,201904,15,13,2,12974,1996,14970
316060,201904,102,66,36,65868,35928,101796
316070,201904,1108,711,397,709578.1,396206,1105784.1
316080,201904,108,70,38,69860,37924,107784
316090,201904,37,22,15,21956,14970,36926
316095,201904,76,65,11,64870,10978,75848
316100,201904,317,185,132,185628.5,132734,318362.5
316105,201904,37,25,12,24950,11976,36926
316110,201904,1870,1508,362,1505982.95,363272,1869254.95
316120,201904,79,60,19,59880,18962,78842
316130,201904,129,99,30,98802.4,29940,128742.4
316140,201904,31,23,8,22954,7984,30938
316150,201904,208,143,65,142714,64870,207584
316160,201904,80,48,32,47904,31936,79840
316165,201904,69,52,17,51896.6,16966,68862.6
316170,201904,196,132,64,131736,63872,195608
316180,201904,204,89,115,88822,114770.4,203592.4
316190,201904,143,105,38,104790,37924,142714
316200,201904,684,389,295,388222,294410,682632
316210,201904,773,516,257,516137.65,256486,772623.65
316220,201904,115,77,38,76846,37924,114770
316225,201904,26,15,11,14970,10978,25948
316230,201904,33,19,14,18962,13972,32934
316240,201904,654,527,127,525946,127744,653690
316245,201904,122,103,19,102794,18962,121756
316250,201904,1537,1060,477,1057881.66,477044,1534925.66
316255,201904,122,98,24,97804,23952,121756
316257,201904,177,94,83,93812,82834,176646
316260,201904,191,135,56,134730.5,55888.8,190619.3
316265,201904,27,19,8,18962,7984,26946
316270,201904,674,474,200,473053,199600.84,672653.84
316280,201904,542,332,210,333333.23,210578.8,543912.03
316290,201904,717,474,243,475048.66,242514,717562.66
316292,201904,521,211,310,211576,309380.5,520956.5
316294,201904,101,60,41,59880,40918,100798
316295,201904,297,135,162,134731.36,161676,296407.36
316300,201904,98,71,27,70858,26946,97804
316310,201904,36,19,17,18962,16966,35928
316320,201904,43,26,17,25948,16966,42914
316330,201904,132,87,45,86826.5,44910,131736.5
316340,201904,143,99,44,98802,43912,142714
316350,201904,195,141,54,140718.3,53892,194610.3
316360,201904,24,17,7,16966,6986,23952
316370,201904,1090,575,515,573851.5,513970,1087821.5
316380,201904,125,96,29,95808,28942,124750
316390,201904,121,88,33,87824,32934,120758
316400,201904,135,104,31,103792,30938,134730
316410,201904,304,221,83,220558,82834,303392
316420,201904,207,146,61,145708,60878,206586
316430,201904,154,81,73,80838,72854,153692
316440,201904,97,47,50,46906,50898,97804
316443,201904,38,36,2,36926,1996,38922
316447,201904,65,50,15,49900,14970,64870
316450,201904,233,175,58,174650,57884,232534
316460,201904,73,29,44,28942,43912,72854
316470,201904,1635,1204,431,1203581.77,434130.4,1637712.17
316480,201904,13,10,3,9980,2994,12974
316490,201904,18,7,11,6986,10978,17964
316500,201904,156,101,55,100798,54890,155688
316510,201904,164,126,38,125748,38922,164670
316520,201904,197,123,74,122754,73852,196606
316530,201904,163,114,49,113772,48902,162674
316540,201904,140,79,61,78842,60878,139720
316550,201904,136,93,43,92814,42914,135728
316553,201904,263,123,140,122754,139720,262474
316555,201904,36,31,5,30938,4990,35928
316556,201904,11,8,3,7984,2994,10978
316557,201904,19,14,5,13972,4990,18962
316560,201904,69,52,17,51896,16966,68862
316570,201904,238,218,20,217564,19960,237524
316580,201904,20,16,4,15968,3992,19960
316590,201904,112,96,16,95808,15968,111776
316600,201904,182,151,31,151696,30938,182634
316610,201904,67,49,18,48902,17964,66866
316620,201904,142,108,34,107784,33932,141716
316630,201904,42,33,9,32934,8982,41916
316640,201904,17,10,7,9980,6986,16966
316650,201904,73,56,17,55888,16966,72854
316660,201904,8,3,5,2994,4990,7984
316670,201904,445,156,289,155688.96,290418,446106.96
316680,201904,161,114,47,113772,46906.6,160678.6
316690,201904,187,122,65,121756,64870,186626
316695,201904,65,57,8,56886,7984,64870
316700,201904,17,10,7,9980,6986,16966
316710,201904,756,564,192,562872.5,191616,754488.5
316720,201904,4977,2543,2434,2540912.85,2430132.74,4971045.59
316730,201904,18,17,1,16966,998,17964
316740,201904,122,79,43,78842,42914,121756
316750,201904,19,13,6,12974,5988,18962
316760,201904,321,259,62,258482,61876,320358
316770,201904,143,79,64,78842,63872,142714
316780,201904,79,50,29,49900,28942,78842
316790,201904,55,42,13,41916,12974,54890
316800,201904,1748,1095,653,1093808,651695,1745503
316805,201904,22,14,8,13972,7984,21956
316810,201904,71,48,23,47904,22954,70858
316820,201904,44,21,23,20958,22954,43912
316830,201904,89,41,48,40918,47904,88822
316840,201904,511,310,201,309380.4,201596,510976.4
316850,201904,341,226,115,226546,114770,341316
316860,201904,6052,2698,3354,2696599.25,3350286.3,6046885.55
316870,201904,1518,1005,513,1004988.5,512973.2,1517961.7
316880,201904,127,64,63,63872,62874,126746
316890,201904,247,169,78,168662,77844,246506
316900,201904,431,299,132,298402.36,132734,431136.36
316905,201904,20,9,11,8982,10978,19960
316910,201904,54,23,31,22954,30938,53892
316920,201904,135,106,29,105788,28942,134730
316930,201904,1908,988,920,987022.8,920156.3,1907179.1
316935,201904,896,544,352,544908.64,353292.4,898201.04
316940,201904,1094,635,459,633730.8,458082.4,1091813.2
316950,201904,183,92,91,91816,90818,182634
316960,201904,1121,631,490,630736.8,489020.4,1119757.2
316970,201904,658,519,139,518960,138722,657682
316980,201904,113,67,46,66866,45908,112774
316990,201904,2254,1510,744,1507978.34,742513.5,2250491.84
317000,201904,337,260,77,259480,76846,336326
317005,201904,244,174,70,173652,70858,244510
317010,201904,6443,3625,2818,3626736.59,2820348.4,6447084.99
317020,201904,16485,7383,9102,7379228.13,9105769.5,16484997.63
317030,201904,81,32,49,31936,48902,80838
317040,201904,3123,1952,1171,1950093.8,1171652.6,3121746.4
317043,201904,78,57,21,56886,20958,77844
317047,201904,34,17,17,16966,16966.99,33932.99
317050,201904,177,137,40,137624.2,39920,177544.2
317052,201904,132,100,32,99800,31936,131736
317057,201904,185,140,45,139720,44910,184630
317060,201904,62,43,19,42914,18962,61876
317065,201904,59,48,11,47904,10978,58882
317070,201904,2012,954,1058,952094.3,1055884.8,2007979.1
317075,201904,110,58,52,57884,51896,109780
317080,201904,857,458,399,458082.5,398202.6,856285.1
317090,201904,656,530,126,529938,125748,655686
317100,201904,433,329,104,328342,103792,432134
317103,201904,110,93,17,92814,16966,109780
317107,201904,41,35,6,34930,5988,40918
317110,201904,112,48,64,47904,63872,111776
317115,201904,42,37,5,36926,4990,41916
317120,201904,1900,984,916,982032.8,914168.4,1896201.2
317130,201904,1981,1308,673,1305385.6,671654,1977039.6
317140,201904,12,10,2,9980,1996,11976
317150,201904,276,164,112,163672.4,112774,276446.4
317160,201904,321,235,86,234530.63,85828,320358.63
317170,201904,212,146,66,146706,66866,213572
317180,201904,446,322,124,321356,123752,445108
317190,201904,265,181,84,180638,83832,264470
317200,201904,810,567,243,565868.96,242514,808382.96
317210,201904,172,97,75,96806,75848,172654
317220,201904,23,13,10,12974,9980,22954
320010,201904,613,451,162,450098.5,162674,612772.5
320013,201904,133,98,35,97804,34930,132734
320016,201904,282,179,103,178642,102794,281436
320020,201904,726,436,290,435129.1,290418,725547.1
320030,201904,147,107,40,106786,39920,146706
320035,201904,143,108,35,107784,34930,142714
320040,201904,498,259,239,259480,238522.4,498002.4
320050,201904,105,81,24,80838,24950,105788
320060,201904,1604,768,836,767463.68,835329.74,1602793.42
320070,201904,102,68,34,67864,33932,101796
320080,201904,797,461,336,460079.89,335328.5,795408.39
320090,201904,1241,868,373,867262,372254.4,1239516.4
320100,201904,337,194,143,193612,142714,336326
320110,201904,126,81,45,80839.1,44910.4,125749.5
320115,201904,113,94,19,93812,18962,112774
320120,201904,3394,1902,1492,1900194.46,1489017.77,3389212.23
320130,201904,7532,3549,3983,3554896.45,3984050.31,7538946.76
320140,201904,429,285,144,284430.6,143713.58,428144.18
320150,201904,2019,1166,853,1167662.17,852292,2019954.17
320160,201904,671,299,372,298402.99,371257.79,669660.78
320170,201904,115,92,23,91816,22954,114770
320180,201904,53,30,23,29940,22954,52894
320190,201904,244,164,80,163672,79840.4,243512.4
320200,201904,58,46,12,46906,11976,58882
320210,201904,878,489,389,489020.8,388223.76,877244.56
320220,201904,311,118,193,117764,193612,311376
320225,201904,87,72,15,71856,14970,86826
320230,201904,594,384,210,383232.6,209580,592812.6
320240,201904,3153,1599,1554,1596801.6,1553887.78,3150689.38
320245,201904,475,327,148,326346.4,147704,474050.4
320250,201904,228,120,108,119760,107784,227544
320255,201904,144,115,29,114770,28942.7,143712.7
320260,201904,194,138,56,137724,55888,193612
320265,201904,161,127,34,126746,33932,160678
320270,201904,157,127,30,126746,29940,156686
320280,201904,1001,601,400,602793.08,402194,1004987.08
320290,201904,62,54,8,53892,7984,61876
320300,201904,559,393,166,392215.34,165670.04,557885.38
320305,201904,680,371,309,370258,308382.6,678640.6
320310,201904,214,121,93,121756.76,92814,214570.76
320313,201904,316,159,157,158682.9,156686.4,315369.3
320316,201904,110,88,22,87824,21956,109780
320320,201904,3435,1583,1852,1582831.36,1852290.75,3435122.11
320330,201904,261,199,62,198602,61876,260478
320332,201904,880,531,349,529940.7,349300.9,879241.6
320334,201904,254,158,96,157684.4,96806,254490.4
320335,201904,143,100,43,99800,42914,142714
320340,201904,572,398,174,397205.79,175648,572853.79
320350,201904,985,425,560,424151.69,559879.2,984030.89
320360,201904,169,91,78,90818,77844,168662
320370,201904,246,188,58,187624.56,57884.4,245508.96
320380,201904,292,204,88,203592,87824,291416
320390,201904,1161,700,461,698601.52,460078.8,1158680.32
320400,201904,311,227,84,226547,83832,310379
320405,201904,942,410,532,410178.99,530939.38,941118.37
320410,201904,980,504,476,503990,475049.3,979039.3
320420,201904,482,247,235,246507.3,236526,483033.3
320425,201904,197,107,90,106786,89820,196606
320430,201904,396,225,171,224550.5,170658,395208.5
320435,201904,166,112,54,112774,53892,166666
320440,201904,200,118,82,117764,81836,199600
320450,201904,129,73,56,72854,55888,128742
320455,201904,247,204,43,203592.4,42914,246506.4
320460,201904,260,160,100,160678,100798.4,261476.4
320465,201904,115,79,36,78842,35928,114770
320470,201904,679,431,248,430139.39,247504.99,677644.38
320480,201904,184,119,65,118762,64870,183632
320490,201904,3078,1536,1542,1534927.79,1538923.28,3073851.07
320495,201904,101,61,40,60878.96,39920.8,100799.76
320500,201904,9816,4897,4919,4888219.47,4917161.17,9805380.64
320501,201904,542,271,271,270458,270458,540916
320503,201904,293,210,83,209580,82834,292414
320506,201904,260,191,69,190618,68862,259480
320510,201904,1000,473,527,472054.4,525947.38,998001.78
320515,201904,81,68,13,67864,12974,80838
320517,201904,208,150,58,149700,58882,208582
320520,201904,6997,3135,3862,3134724,3858275.25,6992999.25
320530,201904,5756,2924,2832,2923149.32,2830331.53,5753480.85
330010,201904,3107,1619,1488,1615764.2,1486022,3101786.2
330015,201904,156,66,90,65868.56,89820,155688.56
330020,201904,3655,1612,2043,1608777.8,2041908.4,3650686.2
330022,201904,244,134,110,133732,109780,243512
330023,201904,558,194,364,193612,365268,558880
330025,201904,597,124,473,123752,472054,595806
330030,201904,1957,1280,677,1277442.66,677643.5,1955086.16
330040,201904,2430,1291,1139,1289418.5,1139718.2,2429136.7
330045,201904,8466,2755,5711,2749490.8,5711555.2,8461046.0
330050,201904,883,572,311,570856,310378,881234
330060,201904,940,584,356,582832.9,355288,938120.9
330070,201904,3491,1334,2157,1331332.98,2153685.94,3485018.92
330080,201904,1488,689,799,689619.5,797402,1487021.5
330090,201904,373,218,155,217564,154690,372254
330093,201904,278,126,152,125748,151697.88,277445.88
330095,201904,95,50,45,49900,44910,94810
330100,201904,9594,4969,4625,4963057.53,4625730.4,9588787.93
330110,201904,499,214,285,213572.7,284430,498002.7
330115,201904,559,303,256,302394,255488,557882
330120,201904,375,191,184,190618,184631.6,375249.6
330130,201904,1540,409,1131,408182.6,1130734.96,1538917.56
330140,201904,595,314,281,314370.94,281436.6,595807.54
330150,201904,483,280,203,279440,202594,482034
330160,201904,206,127,79,126746,78842,205588
330170,201904,26960,9502,17458,9489990.94,17453037.71,26943028.65
330180,201904,236,148,88,149700,87824,237524
330185,201904,903,329,574,328342.98,574849.92,903192.90
330187,201904,317,97,220,96806,223552,320358
330190,201904,5600,2258,3342,2255482.56,3340308.08,5595790.64
330200,201904,4812,1484,3328,1482031.44,3324339.46,4806370.90
330205,201904,422,248,174,248502,173652.4,422154.4
330210,201904,1010,626,384,625782.1,383234.18,1009016.28
330220,201904,2598,1573,1025,1571851.06,1023948.4,2595799.46
330225,201904,556,302,254,301396,253492,554888
330227,201904,2385,763,1622,761474.4,1619757.26,2381231.66
330230,201904,220,127,93,126746,92814,219560
330240,201904,3662,1932,1730,1931137.04,1728571.06,3659708.10
330245,201904,157,72,85,71856.74,84830,156686.74
330250,201904,6793,3531,3262,3528931.05,3264462.11,6793393.16
330260,201904,565,160,405,159680,405188,564868
330270,201904,3450,1260,2190,1257480.6,2190612.8,3448093.4
330280,201904,451,291,160,290419.2,159680.98,450100.18
330285,201904,7280,2378,4902,2374243.5,4898188.53,7272432.03
330290,201904,610,232,378,231536,378242.4,609778.4
330300,201904,785,523,262,521955.5,261476.94,783432.44
330310,201904,438,248,190,247504.9,189620,437124.9
330320,201904,8164,3134,5030,3133723,5028924.4,8162647.4
330330,201904,8988,3576,5412,3576834.68,5411167.66,8988002.34
330340,201904,2720,1627,1093,1624744.6,1092810,2717554.6
330350,201904,18103,7183,10920,7183612.5,10921126.68,18104739.18
330360,201904,2345,1174,1171,1172651.76,1171653.94,2344305.70
330370,201904,1063,551,512,550896.87,510976.6,1061873.47
330380,201904,859,371,488,371256,487024.61,858280.61
330385,201904,611,320,291,319360.5,290418,609778.5
330390,201904,5327,2937,2390,2935120.77,2391208.8,5326329.57
330395,201904,302,187,115,186626,114770.7,301396.7
330400,201904,712,386,326,386227,326346,712573
330410,201904,500,363,137,362274.5,136726.4,499000.9
330411,201904,235,132,103,131736.62,103792,235528.62
330412,201904,247,101,146,100798.4,145708,246506.4
330414,201904,5960,2480,3480,2476039.88,3483021.27,5959061.15
330415,201904,579,267,312,266466,311376.6,577842.6
330420,201904,2257,1185,1072,1185625.42,1070855.38,2256480.80
330430,201904,1800,871,929,870257.2,930138.8,1800396.0
330440,201904,274,132,142,131736,141716,273452
330450,201904,118,52,66,51896,65868,117764
330452,201904,1816,863,953,862274.52,952092.4,1814366.92
330455,201904,110290,40206,70084,40152642.99,70085588.09,110238231.08
330460,201904,261,107,154,106786,153692.94,260478.94
330470,201904,1236,677,559,675647.3,559878.4,1235525.7
330475,201904,1393,379,1014,378242.6,1012970,1391212.6
330480,201904,800,429,371,428142,372254.6,800396.6
330490,201904,13875,4830,9045,4827327.1,9035899.66,13863226.76
330500,201904,1351,607,744,605786,743510.46,1349296.46
330510,201904,11111,3866,7245,3862262.26,7245483.8,11107746.06
330513,201904,102,49,53,49900,52894,102794
330515,201904,824,342,482,341317.26,481037.2,822354.46
330520,201904,2520,941,1579,940116.54,1576840,2516956.54
330530,201904,213,114,99,113772.5,98802.6,212575.1
330540,201904,363,181,182,180638.4,183632,364270.4
330550,201904,2937,1066,1871,1064866.8,1868256.8,2933123.6
330555,201904,798,307,491,306386.96,490018.6,796405.56
330560,201904,648,218,430,217564,429140.94,646704.94
330570,201904,256,182,74,182634,74850,257484
330575,201904,793,330,463,329340,462075.78,791415.78
330580,201904,3413,1930,1483,1928138.2,1485024.8,3413163.0
330590,201904,314,160,154,159680,154690.98,314370.98
330600,201904,1121,722,399,720556.4,400198,1120754.4
330610,201904,1565,861,704,859279.8,703592.3,1562872.1
330615,201904,200,151,49,150698,48902,199600
330620,201904,1060,441,619,442114.6,617762,1059876.6
330630,201904,4015,2574,1441,2573845.56,1446103.1,4019948.66
350010,201904,606,410,196,409180.82,195608,604788.82
350020,201904,46,22,24,21956,23952,45908
350030,201904,511,322,189,321356.4,188622.8,509979.2
350040,201904,125,48,77,47904,76846,124750
350050,201904,300,161,139,160678,138722.98,299400.98
350055,201904,83,47,36,46906,35928,82834
350060,201904,74,28,46,27944,45908,73852
350070,201904,813,485,328,484063.11,327360.64,811423.75
350075,201904,71,47,24,46906,23952,70858
350080,201904,51,31,20,30938,19960,50898
350090,201904,85,47,38,46906,37924,84830
350100,201904,292,181,111,180638,110778,291416
350110,201904,60,40,20,39920,19960,59880
350115,201904,160,96,64,95808,63872,159680
350120,201904,108,73,35,72854,34930,107784
350130,201904,342,162,180,161676.58,179640.9,341317.48
350140,201904,40,26,14,25948,13972,39920
350150,201904,71,55,16,54890,15968,70858
350160,201904,2559,1013,1546,1010979.26,1544911.92,2555891.18
350170,201904,405,245,160,244510.8,159680.4,404191.2
350180,201904,180,99,81,98802,82834,181636
350190,201904,1031,550,481,548901.59,480038.4,1028939.99
350200,201904,69,26,43,25948,42914,68862
350210,201904,1303,737,566,736526.99,564868.63,1301395.62
350220,201904,669,569,100,568860.63,99800,668660.63
350230,201904,81,54,27,53892,26946,80838
350240,201904,63,45,18,44910,17964,62874
350250,201904,1180,579,601,577843.4,600797.3,1178640.7
350260,201904,89,65,24,64870.4,23952,88822.4
350270,201904,846,559,287,557882.6,286426.4,844309.0
350275,201904,308,129,179,128742,178642,307384
350280,201904,4660,2389,2271,2390226.35,2272450.95,4662677.30
350290,201904,421,196,225,195608,225548.4,421156.4
350300,201904,60,32,28,32934,27944,60878
350310,201904,98,63,35,62874,34930,97804
350315,201904,40,25,15,24950,14970,39920
350320,201904,3258,1606,1652,1603786.9,1651691,3255477.9
350330,201904,1679,911,768,910178.23,766465.2,1676643.43
350335,201904,21,14,7,13972,6986,20958
350340,201904,134,62,72,61876,71856.3,133732.3
350350,201904,94,47,47,46906,46906,93812
350360,201904,127,84,43,83832.99,42914,126746.99
350370,201904,86,51,35,50898.63,34930,85828.63
350380,201904,766,326,440,325348.8,440118,765466.8
350390,201904,1505,612,893,611775.43,893210.4,1504985.83
350395,201904,26,21,5,20958,4990,25948
350400,201904,1688,876,812,876248.16,811375.62,1687623.78
350410,201904,2364,1066,1298,1064866.92,1297401.59,2362268.51
350420,201904,238,148,90,147705.03,89820,237525.03
350430,201904,75,46,29,45908,28942,74850
350440,201904,149,109,40,108782.4,39920,148702.4
350450,201904,1652,1014,638,1014969.07,638721.2,1653690.27
350460,201904,336,126,210,125748,209580,335328
350470,201904,16,10,6,9980,5988,15968
350480,201904,172,95,77,94810,76846,171656
350490,201904,233,119,114,118762,113772,232534
350500,201904,43,19,24,18962,23952,42914
350510,201904,167,112,55,111776.9,54890,166666.9
350520,201904,445,215,230,214570,229540,444110
350530,201904,441,205,236,204590,235528,440118
350535,201904,79,64,15,64870,14970,79840
350540,201904,384,191,193,190618,192614,383232
350550,201904,2724,1613,1111,1611772.91,1117765.39,2729538.30
350560,201904,653,457,196,456086.63,195608,651694.63
350570,201904,4109,1747,2362,1745503.63,2359274.93,4104778.56
350580,201904,386,184,202,183632.63,202594.99,386227.62
350590,201904,923,505,418,503990.4,418162.4,922152.8
350600,201904,6170,3086,3084,3085821.76,3088813.37,6174635.13
350610,201904,1550,818,732,816365.26,730536.98,1546902.24
350620,201904,35,23,12,22954,11976,34930
350630,201904,237,138,99,137724.63,98802.63,236527.26
350635,201904,908,372,536,373252.4,534928.8,908181.2
350640,201904,123,93,30,92814,29940,122754
350650,201904,1903,1260,643,1261472.98,645706.98,1907179.96
350660,201904,759,333,426,332334,425148.99,757482.99
350670,201904,316,158,158,157684,157684,315368
350680,201904,183,96,87,95808,86826,182634
350690,201904,199,103,96,102794,95808,198602
350700,201904,776,371,405,370258.4,406186,776444.4
350710,201904,351,131,220,130738,219560,350298
350715,201904,55,44,11,43912,10978,54890
350720,201904,17,11,6,10978,5988,16966
350730,201904,46,29,17,28942,16966,45908
350740,201904,207,115,92,114770,91816,206586
350745,201904,19,10,9,9980.44,8982,18962.44
350750,201904,2171,1377,794,1376244.38,792412,2168656.38
350760,201904,3750,1672,2078,1669654.66,2077836.4,3747491.06
350770,201904,61,43,18,42914,17964,60878
350775,201904,47,33,14,32934,13972.98,46906.98
350780,201904,437,218,219,217564,220747,438311
350790,201904,371,156,215,156686,215568,372254
350800,201904,455,264,191,263472,191616,455088
350810,201904,518,416,102,416167.33,101796,517963.33
350820,201904,87,54,33,53892,32934,86826
350830,201904,83,45,38,44910,37924,82834
350840,201904,781,331,450,330338.4,450099.38,780437.78
350850,201904,1767,1019,748,1018958.5,747505.93,1766464.43
350860,201904,588,342,246,341318.46,246506,587824.46
350870,201904,441,300,141,300398,140718,441116
350880,201904,276,151,125,150698,124750,275448
350890,201904,42,28,14,27944,13972,41916
350900,201904,1456,465,991,464071.36,989018,1453089.36
350910,201904,22,13,9,12974,8982,21956
350920,201904,630,343,287,342314,286426,628740
350925,201904,1214,651,563,649698.78,563871.2,1213569.98
350930,201904,102,62,40,61876,39920,101796
350940,201904,724,398,326,397204,326346.36,723550.36
350945,201904,107,78,29,77844,28942,106786
350950,201904,16055,7828,8227,7822329.68,8229514.81,16051844.49
350960,201904,1288,604,684,605786.4,683630.99,1289417.39
350970,201904,1138,592,546,590710.03,545906.8,1136616.83
350980,201904,95,64,31,63872,30938,94810
350990,201904,378,135,243,134730,242514,377244
350995,201904,35,16,19,15968,18962,34930
351000,201904,633,439,194,438123.26,194610,632733.26
351010,201904,51,32,19,31936,18962,50898
351015,201904,54,38,16,37924,16966,54890
351020,201904,1646,988,658,988020.99,659678,1647698.99
351030,201904,349,236,113,236526,112774,349300
351040,201904,862,454,408,453092,407184.11,860276.11
351050,201904,3337,1545,1792,1543911.64,1791418.88,3335330.52
351060,201904,5053,2074,2979,2070852.36,2976040.56,5046892.92
351070,201904,408,256,152,255488.97,152694,408182.97
351080,201904,784,566,218,564868,217564,782432
351090,201904,57,26,31,25948,30938,56886
351100,201904,441,254,187,253492.68,187624,441116.68
351110,201904,2087,1006,1081,1005994.84,1080852.04,2086846.88
351120,201904,70,35,35,34930,34930,69860
351130,201904,172,59,113,58882,112774,171656
351140,201904,336,232,104,231536,103792,335328
351150,201904,428,232,196,231536.7,195608,427144.7
351160,201904,263,180,83,179640.4,83832,263472.4
351170,201904,186,104,82,103792,82834,186626
351190,201904,85,58,27,57884,26946,84830
351200,201904,364,243,121,242514.4,120758,363272.4
351210,201904,121,59,62,58882,61876,120758
351220,201904,532,317,215,317365.76,215568,532933.76
351230,201904,286,203,83,202594,82834,285428
351240,201904,230,103,127,102794,126746,229540
351250,201904,73,52,21,51896.53,21956,73852.53
351260,201904,152,113,39,112774,38922,151696
351270,201904,48,20,28,19960,27944,47904
351280,201904,1075,493,582,492015.26,581835.61,1073850.87
351290,201904,230,105,125,104790,124750.4,229540.4
351300,201904,3722,1735,1987,1732451.15,1987019.62,3719470.77
351310,201904,762,392,370,391216,369260.98,760476.98
351320,201904,112,68,44,67864,44910,112774
351330,201904,39,26,13,25948,12974,38922
351340,201904,1244,755,489,755487,488024.95,1243511.95
351350,201904,2541,1486,1055,1483029.02,1055884,2538913.02
351360,201904,776,386,390,385228,389220,774448
351370,201904,381,193,188,193612,187624,381236
351380,201904,9163,4175,4988,4169651.31,4985015.39,9154666.70
351385,201904,29,18,11,17964,10978,28942
351390,201904,287,215,72,214570.54,71856,286426.54
351400,201904,66,41,25,40918,24952.94,65870.94
351410,201904,443,278,165,277444.6,165668,443112.6
351420,201904,61,49,12,48902,11976,60878
351430,201904,69,39,30,38922,29940,68862
351440,201904,794,558,236,556886.96,235528.99,792415.95
351450,201904,261,133,128,133732,127744,261476
351460,201904,114,53,61,52894,61876,114770
351470,201904,133,70,63,69860,62874,132734
351480,201904,525,293,232,292415.76,231536,523951.76
351490,201904,286,106,180,105788,179640,285428
351492,201904,32,23,9,22954,8982,31936
351495,201904,27,19,8,18962,7984,26946
351500,201904,3578,1517,2061,1514965,2059873.36,3574838.36
351510,201904,1870,767,1103,767462.8,1100794.4,1868257.2
351512,201904,20,16,4,15968,3992,19960
351515,201904,198,115,83,114770,82834.96,197604.96
351518,201904,791,495,296,494010.99,295408,789418.99
351519,201904,69,44,25,43912,25948,69860
351520,201904,148,93,55,92814,54890,147704
351530,201904,22,15,7,14970,6986,21956
351535,201904,129,73,56,72854,55888,128742
351540,201904,457,326,131,325349.05,130738,456087.05
351550,201904,1370,832,538,832333.66,540916,1373249.66
351560,201904,73,40,33,39920,32934.96,72854.96
351565,201904,9,6,3,5988,2994,8982
351570,201904,2673,1394,1279,1393210.38,1280437.96,2673648.34
351580,201904,40,36,4,35928,3992,39920
351590,201904,66,44,22,43912,21956,65868
351600,201904,194,145,49,144710,48902,193612
351610,201904,59,28,31,27944,30938,58882
351620,201904,5931,3371,2560,3367256.47,2563863.26,5931119.73
351630,201904,2685,1395,1290,1392210.9,1287420.37,2679631.27
351640,201904,1778,852,926,852292.49,926145.03,1778437.52
351650,201904,32,27,5,26946,4990,31936
351660,201904,142,91,51,90818,50898,141716
351670,201904,707,432,275,432135.1,274450,706585.1
351680,201904,71,56,15,55888,14970,70858
351685,201904,35,20,15,19960,14970,34930
351690,201904,300,210,90,209580.45,89820,299400.45
351700,201904,161,113,48,112774,47904,160678
351710,201904,73,50,23,49900,22954,72854
351720,201904,129,64,65,63872,64870,128742
351730,201904,98,67,31,66866.63,30938.03,97804.66
351740,201904,729,480,249,479041.66,249500,728541.66
351750,201904,356,149,207,148702,206586,355288
351760,201904,789,601,188,600796,188622,789418
351770,201904,303,258,45,258482,44910,303392
351780,201904,164,95,69,94810.98,68862,163672.98
351790,201904,251,131,120,131736,119760,251496
351800,201904,48,32,16,31936,15968,47904
351810,201904,121,82,39,81836,38922,120758
351820,201904,864,625,239,623751.6,239521.39,863272.99
351830,201904,524,192,332,191616,331336,522952
351840,201904,1863,944,919,943111.44,919160.97,1862272.41
351850,201904,241,174,67,173652.3,66866,240518.3
351860,201904,705,484,221,483034.41,224550,707584.41
351870,201904,5604,2702,2902,2699592.74,2900190.73,5599783.47
351880,201904,19077,8131,10946,8122731.27,10948103.79,19070835.06
351885,201904,90,60,30,59880,29940,89820
351890,201904,69,58,11,57884,10978,68862
351900,201904,220,131,89,130738,88822,219560
351905,201904,76,30,46,29940,46906,76846
351907,201904,3303,1442,1861,1439117.34,1859277.56,3298394.90
351910,201904,184,78,106,77844,106786,184630
351920,201904,124,69,55,68862,55889.98,124751.98
351925,201904,91,61,30,60878,29940,90818
351930,201904,395,256,139,255488,138722,394210
351940,201904,245,112,133,111776,132734,244510
351950,201904,140,79,61,79840,60878,140718
351960,201904,902,427,475,426459,474050.4,900509.4
351970,201904,1914,1041,873,1040914.4,874249.78,1915164.18
351980,201904,151,78,73,77844,72854,150698
351990,201904,272,178,94,177644.8,93812,271456.8
352000,201904,356,220,136,219561.2,135728,355289.2
352010,201904,387,242,145,242514,145708,388222
352020,201904,190,67,123,66866,122754,189620
352030,201904,1073,559,514,557882,512972,1070854
352040,201904,580,248,332,247504,333332,580836
352042,201904,285,91,194,90818,193612.8,284430.8
352044,201904,370,219,151,218562,150698,369260
352050,201904,3325,1316,2009,1315366.76,2008974.4,3324341.16
352060,201904,101,63,38,62874,37924.4,100798.4
352070,201904,94,69,25,68863.26,24950,93813.26
352080,201904,65,39,26,38922,25948,64870
352090,201904,165,111,54,111776,53892,165668
352100,201904,263,125,138,125749.39,137726.38,263475.77
352110,201904,117,35,82,34930,81836,116766
352115,201904,65,24,41,23952,40918,64870
352120,201904,91,65,26,64870.63,25948,90818.63
352130,201904,219,181,38,181636,37924,219560
352140,201904,193,85,108,84830,107784.4,192614.4
352150,201904,119,65,54,64870,53892,118762
352160,201904,135,85,50,84830,49900,134730
352170,201904,374,263,111,262474,110778,373252
352180,201904,607,401,206,400198,205588.99,605786.99
352190,201904,255,99,156,98802,155688,254490
352200,201904,32,17,15,16966,14970,31936
352210,201904,3910,1669,2241,1667662.22,2238516.63,3906178.85
352215,201904,54,30,24,29940,23952,53892
352220,201904,7102,2709,4393,2705580.65,4393201.19,7098781.84
352230,201904,3281,2123,1158,2121762.89,1157690.62,3279453.51
352240,201904,2309,1336,973,1335324.4,972052.9,2307377.3
352250,201904,2635,1352,1283,1351295.32,1286423.97,2637719.29
352260,201904,1026,546,480,544908.8,479040.4,1023949.2
352265,201904,59,26,33,25948,33932,59880
352270,201904,422,254,168,254490,167665.88,422155.88
352280,201904,423,272,151,271456.63,150698,422154.63
352290,201904,176,109,67,108782,66866,175648
352300,201904,95,72,23,71856,22954,94810
352310,201904,5931,2829,3102,2824344.67,3099792.29,5924136.96
352320,201904,966,507,459,505986.4,458082,964068.4
352330,201904,512,248,264,247504,263472.4,510976.4
352340,201904,1376,669,707,668660.8,706585.6,1375246.4
352350,201904,332,205,127,204590,127744.4,332334.4
352360,201904,221,96,125,95808,124750.2,220558.2
352370,201904,109,72,37,71856,36926,108782
352380,201904,120,74,46,73852,45908,119760
352390,201904,2492,1128,1364,1125744.8,1363270.18,2489014.98
352400,201904,487,215,272,214570,272454.4,487024.4
352410,201904,832,597,235,596804.63,234530,831334.63
352420,201904,105,68,37,67864,36926,104790
352430,201904,1786,810,976,809380.69,974050.21,1783430.90
352440,201904,3137,1587,1550,1585823.78,1549898.72,3135722.50
352450,201904,201,167,34,166666,33932,200598
352460,201904,605,315,290,314371.39,290418,604789.39
352470,201904,631,219,412,218562,411176.98,629738.98
352480,201904,1386,786,600,784428,599798.4,1384226.4
352490,201904,67,26,41,25948,40918,66866
352500,201904,1212,544,668,542912.34,668661.38,1211573.72
352510,201904,747,405,342,406187.26,341316,747503.26
352520,201904,603,275,328,274450,327344,601794
352530,201904,1732,921,811,921154,810376.4,1731530.4
352540,201904,73,49,24,48902,23952,72854
352550,201904,182,108,74,107784,74850,182634
352560,201904,50,39,11,38922,10978,49900
352570,201904,683,355,328,354291.03,328342,682633.03
352580,201904,57,41,16,40918,15968,56886
352585,201904,19,7,12,6986,11976,18962
352590,201904,4432,2247,2185,2243504.63,2182628.18,4426132.81
352600,201904,346,245,101,244510.63,101796,346306.63
352610,201904,974,436,538,435128.97,537922,973050.97
352620,201904,985,397,588,396206,586824,983030
352630,201904,173,64,109,63872,108782,172654
352640,201904,546,376,170,375248,169660,544908
352650,201904,87,59,28,58882,27944,86826
352660,201904,73,45,28,44910,27944,72854
352670,201904,1651,902,749,902193.59,748510.89,1650704.48
352680,201904,924,592,332,591815.83,331336.6,923152.43
352690,201904,4454,2050,2404,2047899.15,2399192.63,4447091.78
352700,201904,116,71,45,70858,44910,115768
352710,201904,1365,743,622,742512,621754.99,1364266.99
352720,201904,1344,646,698,645706,696604.4,1342310.4
352725,201904,23,21,2,20958,1996,22954
352730,201904,380,197,183,196606,184630,381236
352740,201904,424,273,151,274450.96,150698.68,425149.64
352750,201904,21,14,7,13972,7984,21956
352760,201904,187,126,61,127744,60878,188622
352770,201904,79,62,17,62874,16966,79840
352780,201904,76,40,36,39920,35928,75848
352790,201904,28,22,6,21956.63,5988,27944.63
352800,201904,247,174,73,173652,72854,246506
352810,201904,162,103,59,103793.26,58882,162675.26
352820,201904,64,52,12,51896,11976,63872
352830,201904,91,63,28,62874,27944,90818
352840,201904,656,348,308,347304.5,308382,655686.5
352850,201904,1409,497,912,497004,910176,1407180
352860,201904,132,84,48,83832,47904,131736
352870,201904,45,27,18,26946,17964.4,44910.4
352880,201904,189,126,63,125748.9,62874,188622.9
352885,201904,30,22,8,22954,7984,30938
352890,201904,56,38,18,37924,17964.4,55888.4
352900,201904,4780,2329,2451,2329338.82,2450097.82,4779436.64
352910,201904,37,30,7,29940,6986,36926
352920,201904,690,418,272,419160,271456,690616
352930,201904,1239,601,638,599809.76,637766.02,1237575.78
352940,201904,6479,2736,3743,2731530.01,3741509.49,6473039.50
352950,201904,96,38,58,37924,57884,95808
352960,201904,60,41,19,40918,19960,60878
352965,201904,19,9,10,8982,9980,18962
352970,201904,509,383,126,382234.02,125749.61,507983.63
352980,201904,168,89,79,89820,78842,168662
352990,201904,988,447,541,446106,540916,987022
353000,201904,65,30,35,29940,34930,64870
353010,201904,547,341,206,341316,206586,547902
353020,201904,288,209,79,210578,78842,289420
353030,201904,1247,574,673,573850,675646.98,1249496.98
353040,201904,95,60,35,59880,34930,94810
353050,201904,1315,843,472,841315.42,473052,1314367.42
353060,201904,8445,3804,4641,3798398.29,4637717.11,8436115.40
353070,201904,1686,1088,598,1088820.96,597624.35,1686445.31
353080,201904,1308,692,616,691615.16,616764,1308379.16
353090,201904,58,32,26,31936,25948,57884
353100,201904,58,48,10,47904,9980,57884
353110,201904,2041,639,1402,638720.4,1401193.19,2039913.59
353120,201904,90,49,41,48902,40918,89820
353130,201904,862,417,445,417167.74,445109.96,862277.70
353140,201904,566,229,337,228542,337324,565866
353150,201904,355,201,154,201596.63,153692,355288.63
353160,201904,93,78,15,77844,16966,94810
353170,201904,190,63,127,62874,126747.96,189621.96
353180,201904,988,462,526,461076.4,524948.7,986025.1
353190,201904,496,355,141,354290.3,140718,495008.3
353200,201904,205,107,98,107784,97804,205588
353205,201904,23,17,6,16966,5988,22954
353210,201904,82,49,33,48902,32934,81836
353215,201904,52,29,23,29940,22954,52894
353220,201904,83,48,35,47904,34930,82834
353230,201904,161,67,94,66866,93812,160678
353240,201904,301,164,137,163672,136726,300398
353250,201904,203,106,97,105788,96806,202594
353260,201904,455,324,131,323353.1,130738,454091.1
353270,201904,67,51,16,50898,15968,66866
353280,201904,101,56,45,55888.6,44910,100798.6
353282,201904,129,89,40,88822,39920,128742
353284,201904,26,19,7,18962,6986,25948
353286,201904,0,0,0,,,0.0
353290,201904,73,43,30,42914,30938,73852
353300,201904,430,238,192,237525.26,192614,430139.26
353310,201904,47,41,6,41916,5988,47904
353320,201904,62,39,23,38922,22954,61876
353325,201904,57,33,24,32934,23953.36,56887.36
353330,201904,65,46,19,45908.7,18962,64870.7
353340,201904,613,212,401,211576,400199.39,611775.39
353350,201904,921,439,482,438124.6,481039.74,919164.34
353360,201904,104,84,20,83832,19960.4,103792.4
353370,201904,122,68,54,67864,54890,122754
353380,201904,30,20,10,19960.99,9980,29940.99
353390,201904,1123,548,575,546904,574848,1121752
353400,201904,46,28,18,27944,17964,45908
353410,201904,109,69,40,68862,41916.9,110778.9
353420,201904,59,24,35,23952,34930,58882
353430,201904,583,393,190,392215.38,189620,581835.38
353440,201904,10660,4756,5904,4753480.98,5904180.32,10657661.30
353450,201904,55,31,24,30938,23952,54890
353460,201904,599,333,266,332334.1,265468,597802.1
353470,201904,2144,1154,990,1154690.19,992015.96,2146706.15
353475,201904,228,153,75,152695.38,74850,227545.38
353480,201904,184,153,31,152694,31936.4,184630.4
353490,201904,234,141,93,140718,94810,235528
353500,201904,193,112,81,111776.63,80838,192614.63
353510,201904,100,73,27,72854.98,26946,99800.98
353520,201904,208,144,64,143712,64870,208582
353530,201904,469,251,218,250498,218562,469060
353540,201904,375,250,125,249500,124750,374250
353550,201904,748,490,258,490019.24,257484,747503.24
353560,201904,620,259,361,258482,361276,619758
353570,201904,64,34,30,33932.4,29940,63872.4
353580,201904,356,272,84,271456.18,83832,355288.18
353590,201904,88,60,28,59880,27944,87824
353600,201904,271,156,115,155688.63,114770,270458.63
353610,201904,118,64,54,63872,53892,117764
353620,201904,608,317,291,317364,290418,607782
353625,201904,53,31,22,30938,21956,52894
353630,201904,240,175,65,174650.58,64870,239520.58
353640,201904,127,86,41,85828,40918,126746
353650,201904,905,364,541,363272,542912,906184
353657,201904,25,18,7,18962,6986,25948
353660,201904,264,143,121,142714,120758,263472
353670,201904,780,470,310,471057.03,310378.4,781435.43
353680,201904,108,77,31,76846.5,30938,107784.5
353690,201904,46,37,9,36926.52,8982,45908.52
353700,201904,278,198,80,197604.09,79840,277444.09
353710,201904,461,221,240,220558.6,240518.4,461077.0
353715,201904,48,34,14,33932,13972,47904
353720,201904,353,168,185,167664.98,185628,353292.98
353730,201904,1123,696,427,694609.6,430138.8,1124748.4
353740,201904,636,348,288,348302,288422,636724
353750,201904,86,55,31,54890,30938,85828
353760,201904,2821,1086,1735,1084828.75,1733528.18,2818356.93
353770,201904,91,75,16,74850,15968,90818
353780,201904,1243,601,642,599798.63,641714,1241512.63
353790,201904,517,308,209,308382.96,208582.4,516965.36
353800,201904,3300,1664,1636,1661673.89,1635794.2,3297468.09
353810,201904,233,135,98,134730.98,97804.98,232535.96
353820,201904,203,99,104,98802,103792,202594
353830,201904,46,39,7,38922,6986,45908
353850,201904,170,86,84,85828,83832,169660
353860,201904,496,225,271,224550,270458,495008
353870,201904,5281,2703,2578,2700593.45,2580831.94,5281425.39
353880,201904,687,485,202,484030.4,202594,686624.4
353890,201904,585,339,246,339320.4,246506.84,585827.24
353900,201904,135,71,64,70858,63872,134730
353910,201904,172,84,88,83832,87824,171656
353920,201904,448,248,200,247504.3,200598.99,448103.29
353930,201904,1003,597,406,595806,405190.14,1000996.14
353940,201904,190,102,88,101796,87824,189620
353950,201904,523,322,201,322354,200598.98,522952.98
353960,201904,70,57,13,56886,12974,69860
353970,201904,72,41,31,40918,30938,71856
353980,201904,1604,778,826,778440,825349.96,1603789.96
353990,201904,74,43,31,42914,31936,74850
354000,201904,370,188,182,187624.6,181636.99,369261.59
354010,201904,91,50,41,49900,40918,90818
354020,201904,531,338,193,337324,192614,529938
354025,201904,50,40,10,39920,9980,49900
354030,201904,62,37,25,36926,25948,62874
354040,201904,99,72,27,71856,26946,98802
354050,201904,190,102,88,101796.4,88822,190618.4
354060,201904,758,368,390,367264.4,390218,757482.4
354070,201904,937,557,380,555887.28,381236.4,937123.68
354075,201904,218,111,107,110778.4,106786,217564.4
354080,201904,305,128,177,127744,176646,304390
354085,201904,20,13,7,12974,7984,20958
354090,201904,305,168,137,167580,136726,304306
354100,201904,5565,2415,3150,2415162.23,3146696.92,5561859.15
354105,201904,89,45,44,44910,43912,88822
354110,201904,47,21,26,20958,25948,46906
354120,201904,135,96,39,95808.98,38922.11,134731.09
354130,201904,706,461,245,460078,246508.37,706586.37
354140,201904,3130,1454,1676,1452090.4,1676640,3128730.4
354150,201904,638,396,242,395209.76,241516,636725.76
354160,201904,696,448,248,447104.4,248502.4,695606.8
354165,201904,21,14,7,13972,7984,21956
354170,201904,180,123,57,122754,56886,179640
354180,201904,67,41,26,40918.51,25948,66866.51
354190,201904,203,91,112,90818,111776,202594
354200,201904,119,65,54,64870,53892,118762
354210,201904,63,30,33,29940,32934,62874
354220,201904,642,400,242,399200,241516.15,640716.15
354230,201904,161,68,93,67864,92814,160678
354240,201904,324,213,111,212574.64,110778,323352.64
354250,201904,86,52,34,51896,33932,85828
354260,201904,2050,961,1089,960080.75,1089816.87,2049897.62
354270,201904,96,71,25,70858,24950,95808
354280,201904,43,23,20,22954,19960,42914
354290,201904,140,97,43,96806,42914,139720
354300,201904,419,288,131,287424.63,131736.8,419161.43
354310,201904,97,72,25,71856.4,24950,96806.4
354320,201904,188,98,90,97804,89820.4,187624.4
354323,201904,14,13,1,12974,998,13972
354325,201904,111,67,44,66866.6,43912,110778.6
354330,201904,2627,872,1755,872110.8,1755484.01,2627594.81
354340,201904,10673,5245,5428,5239522.03,5425134.73,10664656.76
354350,201904,125,81,44,80838,43912,124750
354360,201904,87,48,39,47904,39920,87824
354370,201904,260,145,115,144710,114770,259480
354380,201904,202,121,81,120758,80838,201596
354390,201904,2712,989,1723,989018.99,1723547.97,2712566.96
354400,201904,321,171,150,170658,149700.8,320358.8
354410,201904,614,295,319,294410.4,318362.4,612772.8
354420,201904,277,176,101,175648,100798,276446
354425,201904,316,184,132,183632,132734,316366
354430,201904,182,110,72,110778,71856,182634
354440,201904,34,25,9,24950,8982,33932
354450,201904,47,34,13,33932,13972,47904
354460,201904,103,60,43,59880,42914,102794
354470,201904,39,23,16,22954,15968,38922
354480,201904,118,62,56,61876.98,55888,117764.98
354490,201904,146,90,56,89820,55888,145708
354500,201904,392,196,196,195608,196606,392214
354510,201904,95,69,26,68862,25948,94810
354515,201904,35,12,23,11976,22954,34930
354520,201904,1621,709,912,708438.4,911174.8,1619613.2
354530,201904,700,354,346,353292.99,346306,699598.99
354540,201904,277,154,123,153692,122754,276446
354550,201904,41,25,16,24950,15968,40918
354560,201904,157,85,72,84830,71856,156686
354570,201904,137,90,47,89820.5,47904,137724.5
354580,201904,1940,940,1000,940118.29,1001993.39,1942111.68
354600,201904,251,144,107,143712.2,106786,250498.2
354610,201904,75,64,11,63872.46,10978.98,74851.44
354620,201904,60,18,42,17964,41916,59880
354625,201904,17,11,6,11976,5988.99,17964.99
354630,201904,315,210,105,209580.98,104790,314370.98
354640,201904,805,528,277,527942.3,277444,805386.3
354650,201904,75,41,34,40918,33932.98,74850.98
354660,201904,806,600,206,599799.03,205588,805387.03
354670,201904,263,93,170,92814.76,169660.6,262475.36
354680,201904,1281,481,800,481036,799398,1280434
354690,201904,78,51,27,50898.4,27944,78842.4
354700,201904,74,54,20,53892,19960,73852
354710,201904,48,34,14,33932,13972,47904
354720,201904,21,21,0,20958,,20958.0
354730,201904,1786,770,1016,770457.78,1015964.4,1786422.18
354740,201904,64,45,19,44910,18962,63872
354750,201904,438,256,182,255488.98,181636.5,437125.48
354760,201904,496,301,195,302395.86,194610.4,497006.26
354765,201904,10,5,5,4990,4990,9980
354770,201904,339,221,118,220558,117764,338322
354780,201904,8058,3273,4785,3270458.4,4780446.11,8050904.51
354790,201904,106,61,45,60878,44910,105788
354800,201904,443,242,201,241516,201596.4,443112.4
354805,201904,102,50,52,49900,51896,101796
354810,201904,114,69,45,68862,44910,113772
354820,201904,191,83,108,82834.56,107784,190618.56
354830,201904,40,21,19,20958,18962,39920
354840,201904,60,40,20,39920,19960,59880
354850,201904,4562,2063,2499,2061869.2,2495998.5,4557867.7
354860,201904,334,160,174,159680,173652.93,333332.93
354870,201904,12675,5705,6970,5702584.06,6960061.71,12662645.77
354880,201904,3037,1134,1903,1133728.4,1901195.34,3034923.74
354890,201904,2889,1593,1296,1593810.5,1293408,2887218.5
354900,201904,63,42,21,41916,20958,62874
354910,201904,1252,668,584,666665.03,584828,1251493.03
354920,201904,50,42,8,41916,7984,49900
354925,201904,13,8,5,7984,4990,12974
354930,201904,31,28,3,27944.43,2994,30938.43
354940,201904,842,615,227,614020.5,228542,842562.5
354950,201904,209,137,72,136726.6,72854,209580.6
354960,201904,161,61,100,61876,99800.4,161676.4
354970,201904,920,613,307,611774.97,308382.4,920157.37
354980,201904,8560,3178,5382,3174642.46,5382223.45,8556865.91
354990,201904,9014,4271,4743,4266457.49,4738556.8,9005014.29
354995,201904,553,190,363,189620,362274,551894
355000,201904,485,169,316,168662,315368,484030
355010,201904,611,384,227,383232,228543.23,611775.23
355020,201904,748,467,281,466066.32,281438.38,747504.70
355030,201904,209759,82057,127702,81979156.04,127658364.99,209637521.03
355040,201904,741,346,395,345308.5,394210,739518.5
355050,201904,150,101,49,100799.4,48902,149701.4
355060,201904,1608,822,786,820357.2,784428.6,1604785.8
355070,201904,1445,704,741,703591.81,741515.61,1445107.42
355080,201904,205,122,83,121756,82834,204590
355090,201904,284,175,109,176646.78,108782.32,285429.10
355100,201904,4893,2417,2476,2416064.14,2478036.19,4894100.33
355110,201904,264,173,91,172655.39,90818,263473.39
355120,201904,85,63,22,62874,21956.98,84830.98
355130,201904,58,33,25,32934,24950,57884
355140,201904,188,122,66,122754,65868,188622
355150,201904,693,417,276,416167.39,275448.4,691615.79
355160,201904,469,224,245,223552.63,244510,468062.63
355170,201904,2101,1106,995,1104786,996004,2100790
355180,201904,662,282,380,281436,379240,660676
355190,201904,222,155,67,154690,67864,222554
355200,201904,117,67,50,66866,49900,116766
355210,201904,696,406,290,405188.56,289420.98,694609.54
355220,201904,7060,3747,3313,3744501.87,3311366.2,7055868.07
355230,201904,106,64,42,63872,41916,105788
355240,201904,4390,1897,2493,1893209.92,2492009,4385218.92
355250,201904,5555,2660,2895,2660670.87,2894205.65,5554876.52
355255,201904,48,31,17,30938,16966,47904
355260,201904,184,110,74,109780.4,74851.96,184632.36
355270,201904,165,102,63,101796,62874,164670
355280,201904,6321,2621,3700,2616758.8,3696594.76,6313353.56
355290,201904,75,58,17,57884,16966,74850
355300,201904,193,124,69,123752,68862.4,192614.4
355310,201904,113,63,50,62874,49900,112774
355320,201904,89,48,41,47904,41916,89820
355330,201904,280,159,121,159680,120758,280438
355340,201904,1565,528,1037,526944.4,1034926,1561870.4
355350,201904,132,69,63,68862,62874,131736
355360,201904,176,113,63,112774,62874,175648
355365,201904,25,20,5,19960,4990,24950
355370,201904,1042,601,441,599812.58,440128.18,1039940.76
355380,201904,795,522,273,523950,272454,796404
355385,201904,66,46,20,45908,19960,65868
355390,201904,106,62,44,61876,43912,105788
355395,201904,185,110,75,109780.47,74850,184630.47
355400,201904,1626,993,633,994926.93,632733.99,1627660.92
355410,201904,4897,2337,2560,2334328.58,2557880.14,4892208.72
355420,201904,51,37,14,36926,13972,50898
355430,201904,354,213,141,212574,141716,354290
355440,201904,81,49,32,48902,31936,80838
355450,201904,447,223,224,223552.48,226546.4,450098.88
355460,201904,65,50,15,49900.54,14970,64870.54
355465,201904,49,31,18,30938,17964,48902
355470,201904,181,73,108,72854.7,108782,181636.7
355475,201904,14,9,5,8982,4990,13972
355480,201904,470,209,261,209580.6,260478,470058.6
355490,201904,117,85,32,84830,32934,117764
355495,201904,58,31,27,30938,26946,57884
355500,201904,1627,912,715,915169.69,713572.96,1628742.65
355510,201904,271,197,74,196607.26,73852,270459.26
355520,201904,29,22,7,21956.4,7984,29940.4
355530,201904,22,15,7,14970,6986,21956
355535,201904,78,38,40,37924,39920,77844
355540,201904,2387,947,1440,945247.11,1438119.61,2383366.72
355550,201904,61,37,24,36926,23952,60878
355560,201904,249,120,129,119760,129740,249500
355570,201904,26,18,8,17964,7984,25948
355580,201904,256,175,81,175648,81837.39,257485.39
355590,201904,22,14,8,13972,7984,21956
355600,201904,272,140,132,139720,131736,271456
355610,201904,230,155,75,154690,74850,229540
355620,201904,1328,644,684,644708.4,686624.99,1331333.39
355630,201904,438,324,114,324350,113772.63,438122.63
355635,201904,124,62,62,61876,62875.97,124751.97
355640,201904,562,318,244,317364,243512,560876
355645,201904,833,356,477,355288,477044.4,832332.4
355650,201904,2079,885,1194,883231.74,1192610.98,2075842.72
355660,201904,253,140,113,139720,112774,252494
355670,201904,541,217,324,216566,323352,539918
355680,201904,205,117,88,116766.97,88822.4,205589.37
355690,201904,91,45,46,44910,46906.67,91816.67
355695,201904,12,9,3,8982,2994,11976
355700,201904,1142,592,550,590816.66,549898.8,1140715.46
355710,201904,2225,1228,997,1228540.63,996004,2224544.63
355715,201904,19,16,3,15968,2994,18962
355720,201904,201,120,81,119760.44,80838,200598.44
355730,201904,99,59,40,58882,39920,98802
410010,201904,131,110,21,110778,20958,131736
410020,201904,105,89,16,88822,15968,104790
410030,201904,163,105,58,106786.6,57884,164670.6
410040,201904,1071,570,501,568860,499998.6,1068858.6
410045,201904,31,26,5,25948,4990,30938
410050,201904,471,269,202,268462,201596,470058
410060,201904,276,208,68,207584,67864,275448
410070,201904,309,256,53,256486,52894,309380
410080,201904,168,108,60,107784,59880,167664
410090,201904,77,68,9,67864.56,8982,76846.56
410100,201904,299,214,85,213572,84830,298402
410105,201904,44,27,17,26946,16966,43912
410110,201904,333,206,127,205588,126746,332334
410115,201904,33,23,10,22954,9980,32934
410120,201904,409,214,195,213572,194610,408182
410130,201904,47,30,17,29940,16966,46906
410140,201904,3153,1543,1610,1543909.2,1610775,3154684.2
410150,201904,2721,1099,1622,1098798.74,1622748.4,2721547.14
410160,201904,503,317,186,316366,185628,501994
410165,201904,69,46,23,45908,22954,68862
410170,201904,170,122,48,121756,47904,169660
410180,201904,2186,1256,930,1254486.4,929139.59,2183625.99
410185,201904,35,32,3,31936,2994,34930
410190,201904,503,333,170,332334.74,169660,501994.74
410200,201904,955,718,237,717562,236526,954088
410210,201904,572,297,275,296406,274450.4,570856.4
410220,201904,44,22,22,21956,21956,43912
410230,201904,142,74,68,73852,67864,141716
410240,201904,756,497,259,496006.8,258482.4,754489.2
410250,201904,377,277,100,276446,99800,376246
410260,201904,297,170,127,169660.4,126746,296406.4
410270,201904,31,21,10,20958,9980,30938
410275,201904,61,46,15,45908,14970,60878
410280,201904,325,187,138,186626,137724,324350
410290,201904,241,152,89,151696,88822,240518
410300,201904,79,61,18,60878,17964,78842
410302,201904,19,12,7,11976,6986,18962
410304,201904,42,28,14,27944,13972,41916
410305,201904,213,116,97,115768,96806,212574
410310,201904,271,171,100,170658,99800,270458
410315,201904,51,37,14,36926.44,13972,50898.44
410320,201904,135,94,41,93812,40918,134730
410322,201904,35,24,11,23952,10978,34930
410330,201904,175,125,50,124750,49900.6,174650.6
410335,201904,102,58,44,57884,43912,101796
410337,201904,41,35,6,34930,5988,40918
410340,201904,34,31,3,30938,2994,33932
410345,201904,221,135,86,134730,86826,221556
410347,201904,52,39,13,38922,12974,51896
410350,201904,242,146,96,145708,95808,241516
410360,201904,468,290,178,289420.8,177645.2,467066.0
410370,201904,2379,1021,1358,1019957.08,1355285.64,2375242.72
410380,201904,222,138,84,137724,83832,221556
410390,201904,377,274,103,273452.99,102794,376246.99
410395,201904,33,22,11,21956,10978,32934
410400,201904,850,423,427,422155.61,426581.5,848737.11
410405,201904,94,72,22,71856,21956,93812
410410,201904,36,28,8,27944,7984,35928
410420,201904,1666,819,847,819271.16,846304.34,1665575.50
410425,201904,174,79,95,78842.6,94810,173652.6
410430,201904,2194,1278,916,1277440.74,917162.56,2194603.30
410440,201904,379,279,100,278442,99800,378242
410442,201904,355,238,117,237524.7,116766,354290.7
410445,201904,407,289,118,289420,118762,408182
410450,201904,389,205,184,204590,183632,388222
410460,201904,469,249,220,248502,219560,468062
410465,201904,205,131,74,130738,73852,204590
410470,201904,227,145,82,145708,81836,227544
410480,201904,6030,2988,3042,2988024.1,3037923.4,6025947.5
410490,201904,1432,924,508,923150.84,506984.4,1430135.24
410500,201904,263,154,109,153692,108782,262474
410510,201904,166,125,41,124750,40918.98,165668.98
410520,201904,256,191,65,190618,64870,255488
410530,201904,231,85,146,84830,145708.99,230538.99
410540,201904,317,229,88,228542.99,87824,316366.99
410550,201904,1675,755,920,753490,918160,1671650
410560,201904,137,103,34,102794,33932,136726
410570,201904,436,297,139,297405.32,138722,436127.32
410580,201904,3277,1466,1811,1465065.32,1808377,3273442.32
410590,201904,405,286,119,285428,120758,406186
410600,201904,196,169,27,168662,26946,195608
410610,201904,59,50,9,49900,8982,58882
410620,201904,241,173,68,172654,67864,240518
410630,201904,446,265,181,264470,180638,445108
410640,201904,1034,652,382,652693.3,381236.99,1033930.29
410645,201904,104,78,26,77844.2,25948,103792.2
410650,201904,363,245,118,244510,117764,362274
410655,201904,81,61,20,60878,19960,80838
410657,201904,22,9,13,8982,12974,21956
410660,201904,609,431,178,430138.71,178642,608780.71
410670,201904,72,61,11,60878,10978,71856
410680,201904,199,166,33,165668,32934,198602
410685,201904,19,12,7,11976,6986,18962
410690,201904,28273,12219,16054,12205461.96,16042577.01,28248038.97
410700,201904,325,240,85,239520.4,84830,324350.4
410710,201904,130,107,23,107784,22954,130738
410712,201904,23,16,7,15968,6986,22954
410715,201904,89,67,22,66866,21956,88822
410720,201904,705,406,299,405188.88,298402.98,703591.86
410725,201904,181,134,47,133732,46906,180638
410730,201904,90,52,38,51896,37924,89820
410740,201904,119,87,32,86826,31936,118762
410750,201904,235,164,71,163672,70858,234530
410752,201904,24,15,9,14970,8982,23952
410753,201904,49,23,26,22954,25948,48902
410754,201904,42,26,16,25948.4,15968,41916.4
410755,201904,82,54,28,53892,27944,81836
410760,201904,742,422,320,421156.4,319360,740516.4
410765,201904,1725,827,898,826346.36,898201.2,1724547.56
410770,201904,107,84,23,83832,22954,106786
410773,201904,54,41,13,40918,12974,53892
410775,201904,188,137,51,136726,50898,187624
410780,201904,82,45,37,44910,36926,81836
410785,201904,57,45,12,44910,11976,56886
410790,201904,72,35,37,34930,36926,71856
410800,201904,284,178,106,177644.52,105788,283432.52
410810,201904,24,21,3,20958,2994.4,23952.4
410820,201904,180,131,49,130738,48902,179640
410830,201904,8541,3819,4722,3816358.52,4721548.17,8537906.69
410832,201904,106,78,28,77844,27944,105788
410840,201904,1421,796,625,796407.11,625748.46,1422155.57
410845,201904,67,44,23,43912.4,22954,66866.4
410850,201904,199,140,59,139720,58882,198602
410855,201904,50,43,7,42914,6986,49900
410860,201904,707,410,297,409180.94,296406,705586.94
410865,201904,105,80,25,79840,24950,104790
410870,201904,154,130,24,129740,24950,154690
410880,201904,1123,575,548,573855.34,548904.88,1122760.22
410890,201904,83,58,25,57884,24950,82834
410895,201904,72,56,16,55888,15968,71856
410900,201904,22,14,8,13972,7984,21956
410910,201904,14,12,2,11976,1996,13972
410920,201904,36,24,12,23952,11976,35928
410930,201904,504,322,182,322354,181636,503990
410940,201904,4384,2530,1854,2525939.84,1852288.8,4378228.64
410950,201904,111,84,27,83832,26946,110778
410960,201904,785,348,437,347304,436126,783430
410965,201904,67,53,14,52894,13972,66866
410970,201904,627,450,177,449100,176646,625746
410975,201904,112,67,45,66866.72,44910,111776.72
410980,201904,1628,744,884,743510.4,883230.99,1626741.39
410990,201904,268,187,81,186626,80838,267464
411000,201904,64,41,23,40918,22954.4,63872.4
411005,201904,26,20,6,19960,5988,25948
411007,201904,252,145,107,144710,106786,251496
411010,201904,598,415,183,415168,182634,597802
411020,201904,301,209,92,208582,92814,301396
411030,201904,16,9,7,8982,6986,15968
411040,201904,53,38,15,37924,14970,52894
411050,201904,217,168,49,168669.04,48902.88,217571.92
411060,201904,514,351,163,350298.98,164670,514968.98
411065,201904,65,56,9,55888,8982,64870
411070,201904,1230,782,448,781435.54,448102,1229537.54
411080,201904,231,163,68,162674,68862,231536
411090,201904,107,80,27,79840,26946,106786
411095,201904,283,113,170,112774,169660,282434
411100,201904,113,94,19,93812,18962,112774
411110,201904,120,83,37,82834,36926,119760
411120,201904,192,139,53,138722,52894,191616
411125,201904,207,95,112,94810,111776,206586
411130,201904,122,104,18,103792,17964,121756
411140,201904,203,135,68,134730,67864,202594
411150,201904,1239,823,416,822352,416167.03,1238519.03
411155,201904,127,84,43,83832,42914,126746
411160,201904,26,12,14,11976,13972,25948
411170,201904,53,48,5,47904,4990,52894
411180,201904,972,657,315,655686.83,316366,972052.83
411190,201904,337,192,145,192614,145708,338322
411200,201904,672,436,236,436126.63,235528,671654.63
411210,201904,707,382,325,382234,324350.98,706584.98
411220,201904,150,112,38,111776,37924,149700
411230,201904,43,37,6,36926,5988,42914
411240,201904,125,84,41,83832,40918,124750
411250,201904,439,324,115,323352,114770,438122
411260,201904,20,13,7,12974,6986,19960
411270,201904,283,150,133,149700,132734,282434
411275,201904,205,180,25,179640,24950,204590
411280,201904,223,159,64,159680.63,63872,223552.63
411290,201904,58,45,13,44910,12974,57884
411295,201904,145,114,31,113772,30938,144710
411300,201904,69,34,35,33932,34930,68862
411310,201904,92,71,21,70858,20958,91816
411320,201904,755,527,228,525946.8,227544.6,753491.4
411325,201904,65,42,23,41916,22954,64870
411330,201904,925,596,329,594808.5,328342.16,923150.66
411340,201904,27,19,8,18962,7984.34,26946.34
411342,201904,68,51,17,50898,16966,67864
411345,201904,118,61,57,60878,56886,117764
411350,201904,492,390,102,390218.58,102794.4,493012.98
411360,201904,56,35,21,34930,20958,55888
411370,201904,14365,5882,8483,5881218.95,8474035.81,14355254.76
411373,201904,179,132,47,132734,46906,179640
411375,201904,74,61,13,60878,12974,73852
411380,201904,94,72,22,72854,21956,94810
411390,201904,132,88,44,87824,43912,131736
411400,201904,364,278,86,277444.98,85828,363272.98
411410,201904,446,228,218,228542,218562.4,447104.4
411420,201904,1032,469,563,468062,561874,1029936
411430,201904,431,264,167,263472,167664.98,431136.98
411435,201904,35,24,11,23952,10978,34930
411440,201904,463,373,90,372254,90818,463072
411450,201904,434,363,71,362274,70858,433132
411460,201904,772,306,466,305393.04,466076.66,771469.70
411470,201904,85,63,22,63872,21956,85828
411480,201904,660,379,281,378242,280438,658680
411490,201904,298,191,107,190618,106786,297404
411500,201904,108,92,16,91816,15968,107784
411510,201904,233,185,48,184630,47904,232534
411520,201904,6022,2348,3674,2344305.69,3670648.92,6014954.61
411530,201904,119,84,35,84830,34930,119760
411535,201904,49,21,28,20958,27944,48902
411540,201904,357,245,112,244510,111776,356286
411545,201904,53,38,15,37924,14970,52894
411550,201904,73,56,17,55888,16966,72854
411560,201904,381,176,205,175648.44,204590,380238.44
411570,201904,794,299,495,298403.26,494010.6,792413.86
411573,201904,29,18,11,17964,10978,28942
411575,201904,291,183,108,182634,107784,290418
411580,201904,1252,500,752,499998.6,751494,1251492.6
411585,201904,74,37,37,36926,36926,73852
411590,201904,21,15,6,14970,5988,20958
411600,201904,25,11,14,10978,13972,24950
411605,201904,243,103,140,102794,139720,242514
411610,201904,211,143,68,142714,67864,210578
411620,201904,349,196,153,195608,152694,348302
411630,201904,57,39,18,38922,17964,56886
411640,201904,33,27,6,26946,5988,32934
411650,201904,12,7,5,6986,4990,11976
411660,201904,38,28,10,27944,9980,37924
411670,201904,250,187,63,186626,62874,249500
411680,201904,157,136,21,135728,20958,156686
411690,201904,589,314,275,313372,275448,588820
411695,201904,63,46,17,45908,16966,62874
411700,201904,152,131,21,130738,20958,151696
411705,201904,105,69,36,68862,35928,104790
411710,201904,309,210,99,209580,98802,308382
411720,201904,140,92,48,91816,47904,139720
411721,201904,62,53,9,52894,8982,61876
411722,201904,98,42,56,41916,55888,97804
411725,201904,152,119,33,118762.4,32934,151696.4
411727,201904,77,60,17,59880,16966,76846
411729,201904,35,28,7,27944,6986,34930
411730,201904,552,348,204,348302,203592,551894
411740,201904,40,26,14,25948,13972,39920
411745,201904,69,47,22,46906,21956,68862
411750,201904,872,399,473,398202.4,473052.4,871254.8
411760,201904,1197,902,295,900196.4,294410.98,1194607.38
411770,201904,454,298,156,297404,155688,453092
411780,201904,329,215,114,215568,113772.01,329340.01
411790,201904,531,300,231,299401.27,230539.96,529941.23
411800,201904,168,132,36,131736,35928,167664
411810,201904,167,127,40,126746,39920,166666
411820,201904,2151,1010,1141,1007981,1138718.6,2146699.6
411830,201904,12,12,0,11976,,11976.0
411840,201904,1980,1228,752,1228538,752493.53,1981031.53
411845,201904,51,20,31,19960,30938,50898
411850,201904,1235,702,533,700596.99,531936.66,1232533.65
411860,201904,45,31,14,30938.4,13972,44910.4
411870,201904,76,53,23,52894,22954,75848
411880,201904,425,274,151,273453.22,150698,424151.22
411885,201904,108,73,35,72854,34930,107784
411890,201904,317,203,114,202595.39,114770,317365.39
411900,201904,73,54,19,53892,18962,72854
411910,201904,181,144,37,143712,36926,180638
411915,201904,2102,901,1201,901194,1202591.62,2103785.62
411920,201904,122,100,22,99800,21956,121756
411925,201904,10,7,3,6986,2994,9980
411930,201904,817,604,213,602792.74,212574,815366.74
411940,201904,595,415,180,415168,180638,595806
411950,201904,916,481,435,480038.8,436126,916164.8
411960,201904,1051,729,322,727543.3,321356,1048899.3
411965,201904,23,16,7,15968,6986,22954
411970,201904,83,76,7,75848,6986,82834
411980,201904,172,119,53,118762,52894,171656
411990,201904,5199,3026,2173,3022946.88,2170651.7,5193598.58
411995,201904,470,177,293,176646,292414,469060
412000,201904,310,194,116,193612,115768,309380
412010,201904,49,30,19,29940,18962,48902
412015,201904,46,34,12,33932,11976,45908
412020,201904,28,24,4,23952,3992,27944
412030,201904,56,49,7,48902,7984,56886
412033,201904,51,33,18,32934.44,17964,50898.44
412035,201904,67,45,22,44910,21956,66866
412040,201904,36,23,13,22954.4,12974,35928.4
412050,201904,201,153,48,152694,47904,200598
412060,201904,779,590,189,588820,188622,777442
412065,201904,48,32,16,31936,15968,47904
412070,201904,162,108,54,107784,53892,161676
412080,201904,276,145,131,144710,130738,275448
412085,201904,33,15,18,14970,17964,32934
412090,201904,790,505,285,503990.9,284430,788420.9
412100,201904,244,206,38,205588.8,37924,243512.8
412110,201904,69,53,16,52894,15968,68862
412120,201904,315,200,115,199600,114770,314370
412125,201904,85,49,36,48902,35928,84830
412130,201904,39,28,11,27944.36,10978,38922.36
412135,201904,27,16,11,15968,10978,26946
412140,201904,323,226,97,225548.6,97804,323352.6
412150,201904,247,168,79,167664.48,78842,246506.48
412160,201904,88,53,35,52894,34930,87824
412170,201904,686,482,204,481036.4,203592,684628.4
412175,201904,38,29,9,28942,8982,37924
412180,201904,197,155,42,154690.87,43912,198602.87
412190,201904,337,266,71,265468,70858,336326
412200,201904,204,126,78,125748,78842,204590
412210,201904,75,59,16,58882,15968,74850
412215,201904,228,163,65,162674,64870,227544
412217,201904,70,55,15,54890,14970,69860
412220,201904,823,611,212,610776,211576,822352
412230,201904,331,200,131,201596,130740.94,332336.94
412240,201904,1351,674,677,673671.72,678656.24,1352327.96
412250,201904,384,245,139,244510,138722,383232
412260,201904,106,78,28,77844,27944,105788
412265,201904,174,137,37,136726,36926,173652
412270,201904,77,52,25,51896,24950,76846
412280,201904,90,74,16,73852,15968,89820
412290,201904,98,67,31,66866,30938,97804
412300,201904,216,139,77,138722,77844,216566
412310,201904,47,40,7,39920,6986,46906
412320,201904,97,83,14,82834,13972,96806
412330,201904,182,159,23,158682,22954,181636
412340,201904,154,107,47,107784,46906.4,154690.4
412350,201904,604,303,301,302394,300398,602792
412360,201904,29,25,4,24950,3992,28942
412370,201904,164,143,21,142714.2,20958,163672.2
412380,201904,262,194,68,193612,67865.78,261477.78
412382,201904,52,26,26,25948,25948,51896
412385,201904,144,106,38,105788,38922,144710
412390,201904,283,215,68,214570,67864,282434
412395,201904,73,59,14,58882,13972,72854
412400,201904,77,53,24,52894,23952,76846
412402,201904,249,121,128,120758,127744,248502
412405,201904,829,317,512,316366,510976,827342
412410,201904,963,603,360,602792.4,359280,962072.4
412420,201904,14,12,2,11976,1996,13972
412430,201904,21,15,6,14970,5988,20958
412440,201904,605,333,272,333346.52,271462.12,604808.64
412450,201904,78,67,11,66866,10978,77844
412460,201904,89,67,22,66866,21956,88822
412470,201904,225,181,44,180638,43912,224550
412480,201904,159,117,42,116766.47,41916,158682.47
412490,201904,161,141,20,140718,19960,160678
412500,201904,449,371,78,371256.85,77844,449100.85
412510,201904,189,156,33,155688.4,32934,188622.4
412520,201904,89,59,30,58882,29940,88822
412530,201904,110,58,52,57884,51896,109780
412535,201904,110,79,31,78843.96,30938,109781.96
412540,201904,78,36,42,35928,41916,77844
412545,201904,93,68,25,67864,24950,92814
412550,201904,3628,1646,1982,1644704,1983027.2,3627731.2
412555,201904,13,9,4,8982,3992,12974
412560,201904,598,431,167,430503.93,167664,598167.93
412570,201904,740,404,336,403192,335328,738520
412575,201904,92,64,28,63872,28942,92814
412580,201904,168,112,56,111776,55888,167664
412590,201904,36,32,4,31936,3992,35928
412600,201904,169,126,43,125748,42914,168662
412610,201904,30,18,12,17964,11976,29940
412620,201904,152,131,21,130738,20958,151696
412625,201904,2222,1187,1035,1185625.03,1034928.53,2220553.56
412627,201904,72,56,16,55888,15968,71856
412630,201904,418,281,137,280438.07,136726,417164.07
412635,201904,63,18,45,17964,44910,62874
412640,201904,117,76,41,75848,40918,116766
412650,201904,344,223,121,222554,120758,343312
412660,201904,471,291,180,290418,180638,471056
412665,201904,51,45,6,44910,5988,50898
412667,201904,289,202,87,201600.84,86828.2,288429.04
412670,201904,64,53,11,52894,10978,63872
412680,201904,295,234,61,234530,60878.98,295408.98
412690,201904,103,67,36,66866,35928.4,102794.4
412700,201904,156,106,50,105788,49900.4,155688.4
412710,201904,1415,862,553,860278.2,551894,1412172.2
412720,201904,237,157,80,156686,79840,236526
412730,201904,188,157,31,157684,31936,189620
412740,201904,421,234,187,233532,186626,420158
412750,201904,461,269,192,268462,193612,462074
412760,201904,274,143,131,143712,130738,274450
412770,201904,2141,1208,933,1205585.23,932133.78,2137719.01
412780,201904,153,119,34,118762,33932,152694
412785,201904,264,136,128,135728,127744,263472
412788,201904,37,21,16,20958,15968,36926
412790,201904,131,109,22,109780,21956,131736
412795,201904,151,113,38,112774,37924,150698
412796,201904,320,218,102,218562,101796,320358
412800,201904,580,372,208,371256.8,208582,579838.8
412810,201904,2990,1647,1343,1644706.87,1340314,2985020.87
412820,201904,948,611,337,609779.9,336326.98,946106.88
412830,201904,14,11,3,10978,2994,13972
412840,201904,223,158,65,157684.4,65868,223552.4
412850,201904,786,522,264,520956,263472,784428
412853,201904,173,91,82,90818,81836.4,172654.4
412855,201904,217,118,99,117764.26,99800,217564.26
412860,201904,91,65,26,64870,25948,90818
412862,201904,59,44,15,43912,14970,58882
412863,201904,6,5,1,4990,998,5988
412865,201904,42,31,11,30938,10978,41916
412870,201904,108,69,39,68862,38922,107784
412880,201904,101,72,29,71856.4,28942,100798.4
420005,201904,45,40,5,39920,4990,44910
420010,201904,370,244,126,243512.3,125748.4,369260.7
420020,201904,86,72,14,71856,14970,86826
420030,201904,26,24,2,25948,1996,27944
420040,201904,112,87,25,86826,24950,111776
420050,201904,52,32,20,31936,19960,51896
420055,201904,19,18,1,17964,998,18962
420060,201904,33,25,8,24950,7984,32934
420070,201904,106,88,18,87824,17964,105788
420075,201904,10,10,0,9980,,9980.0
420080,201904,48,42,6,41916,5988,47904
420090,201904,34,32,2,31936,1996,33932
420100,201904,161,138,23,137724.4,23952,161676.4
420110,201904,18,18,0,17964,,17964.0
420120,201904,60,46,14,45908,13972,59880
420125,201904,84,67,17,67864,16966,84830
420127,201904,29,24,5,23952,4990,28942
420130,201904,403,252,151,251496,150698,402194
420140,201904,1319,751,568,749500.68,567863.86,1317364.54
420150,201904,43,38,5,37924,4990,42914
420160,201904,35,33,2,33932,1996,35928
420165,201904,20,15,5,14970,4990,19960
420170,201904,72,47,25,46906,24950,71856
420180,201904,23,21,2,20958,1996,22954
420190,201904,31,25,6,24950,5988,30938
420195,201904,129,64,65,63872,64870,128742
420200,201904,1275,566,709,564868.4,709583.84,1274452.24
420205,201904,70,41,29,40918,28942,69860
420207,201904,114,64,50,63872.5,49900,113772.5
420208,201904,21,17,4,16966,3992,20958
420209,201904,20,16,4,15968,3992,19960
420210,201904,473,234,239,233532,238522.98,472054.98
420213,201904,50,39,11,38922,10978,49900
420215,201904,28,24,4,23952,3992,27944
420220,201904,66,43,23,42914,22954,65868
420230,201904,825,473,352,472054,351296.98,823350.98
420240,201904,2290,1536,754,1535925.14,754488,2290413.14
420243,201904,41,33,8,32934,7984,40918
420245,201904,136,72,64,71856,63872,135728
420250,201904,60,37,23,36926,22954,59880
420253,201904,41,33,8,32934,7984,40918
420257,201904,13,11,2,10978,1996,12974
420260,201904,104,89,15,88822,14970,103792
420270,201904,40,31,9,30938.99,8982,39920.99
420280,201904,284,212,72,211579.64,71858.66,283438.30
420285,201904,20,11,9,10978,8982,19960
420287,201904,54,34,20,33932,19960,53892
420290,201904,981,691,290,689618.99,290422.95,980041.94
420300,201904,1421,1136,285,1135725.74,285428.98,1421154.72
420310,201904,60,44,16,43912,15968,59880
420315,201904,32,28,4,27944,3992,31936
420320,201904,880,451,429,451096,428142.99,879238.99
420325,201904,0,0,0,0,0,0
420330,201904,126,86,40,85828,39920,125748
420340,201904,163,110,53,109781.18,52894,162675.18
420350,201904,254,188,66,187624,65868,253492
420360,201904,755,571,184,569858.98,183634.46,753493.44
420370,201904,118,74,44,73852,43912.4,117764.4
420380,201904,1141,813,328,811376.08,328346.72,1139722.80
420390,201904,265,183,82,182634,81836,264470
420395,201904,185,134,51,134730,51896,186626
420400,201904,252,191,61,190618.75,60878,251496.75
420410,201904,64,49,15,48902,14970,63872
420415,201904,34,30,4,29940,3992,33932
420417,201904,55,41,14,40918,13972,54890
420419,201904,11,11,0,10978,,10978.0
420420,201904,2829,1754,1075,1751494.97,1074849.74,2826344.71
420425,201904,76,63,13,62874.98,12974.98,75849.96
420430,201904,1248,870,378,870257.9,378242,1248499.9
420435,201904,17,15,2,14970,1996,16966
420440,201904,103,73,30,72854.4,29940,102794.4
420445,201904,23,22,1,21956,998,22954
420450,201904,76,39,37,38922,36926,75848
420455,201904,220,167,53,167666.94,52897.92,220564.86
420460,201904,2354,1548,806,1546940.96,805394.82,2352335.78
420470,201904,117,85,32,85828,31936,117764
420475,201904,7,7,0,6986,,6986.0
420480,201904,882,666,216,664669.2,215568.8,880238.0
420490,201904,110,82,28,81836,27944,109780
420500,201904,609,271,338,270458.86,338322,608780.86
420510,201904,19,16,3,15968,2994,18962
420515,201904,26,19,7,18962,6986,25948
420517,201904,9,9,0,8982,,8982.0
420519,201904,0,0,0,0,0,0
420520,201904,75,56,19,55888,18962,74850
420530,201904,167,112,55,111776.3,54890,166666.3
420535,201904,20,19,1,18962,998,19960
420540,201904,5293,3149,2144,3144955.22,2142707.56,5287662.78
420543,201904,27,27,0,26946,,26946.0
420545,201904,199,139,60,138722,59880.98,198602.98
420550,201904,890,721,169,719560.16,168665.92,888226.08
420555,201904,41,30,11,29940,10978,40918
420560,201904,68,55,13,54890,12974,67864
420570,201904,156,94,62,93812,61876,155688
420580,201904,289,129,160,128742,159680.4,288422.4
420590,201904,517,363,154,362274,153692,515966
420600,201904,108,61,47,60878.4,46906,107784.4
420610,201904,41,38,3,37924,2994,40918
420620,201904,78,64,14,63872,13972,77844
420630,201904,156,113,43,112774,42915.98,155689.98
420640,201904,88,80,8,80838,7984,88822
420650,201904,235,121,114,121756,113772,235528
420660,201904,55,43,12,42914,11976,54890
420665,201904,38,28,10,27944,9980,37924
420670,201904,317,240,77,239520,76846.98,316366.98
420675,201904,16,15,1,14970,998,15968
420680,201904,36,26,10,25948,9980,35928
420690,201904,177,145,32,145708,31936,177644
420700,201904,708,497,211,496012.32,210585.84,706598.16
420710,201904,153,89,64,88822,63872,152694
420720,201904,111,90,21,89820.98,20958,110778.98
420730,201904,586,374,212,374254.26,213576.32,587830.58
420740,201904,49,48,1,47904,998,48902
420750,201904,513,348,165,347304,166666,513970
420757,201904,19,16,3,15968,2994,18962
420760,201904,37,31,6,30938,5988,36926
420765,201904,73,58,15,57884,14970,72854
420768,201904,53,49,4,48902,3992,52894
420770,201904,80,67,13,66866,12974,79840
420775,201904,44,40,4,39920,3992,43912
420780,201904,237,189,48,188622,47904,236526
420785,201904,12,9,3,8982,2994,11976
420790,201904,171,144,27,144713.92,26947.96,171661.88
420800,201904,69,53,16,52894,15968,68862
420810,201904,252,222,30,221556,29940,251496
420820,201904,2373,1396,977,1393209.6,975048.77,2368258.37
420830,201904,607,335,272,334330.8,272454,606784.8
420840,201904,148,111,37,110778,36926,147704
420845,201904,429,192,237,191616,236526.4,428142.4
420850,201904,243,191,52,190618,51896,242514
420860,201904,64,54,10,53892,9980,63872
420870,201904,123,89,34,88822,33932,122754
420880,201904,181,125,56,124750,56886,181636
420890,201904,904,456,448,456087.77,447104.98,903192.75
420895,201904,9,9,0,8982,,8982.0
420900,201904,418,332,86,332334,85828.98,418162.98
420910,201904,5851,3299,2552,3292410.21,2551891.74,5844301.95
420915,201904,76,71,5,70858,4990,75848
420917,201904,21,15,6,14970,5988,20958
420920,201904,23,16,7,15968,6986,22954
420930,201904,2833,1759,1074,1756476.3,1073019.32,2829495.62
420940,201904,603,442,161,442114.4,160682.49,602796.89
420945,201904,10,8,2,7984,1996,9980
420950,201904,57,51,6,50898,5988,56886
420960,201904,118,94,24,93814.94,23952.98,117767.92
420970,201904,304,242,62,241520.52,61877.96,303398.48
420980,201904,22,22,0,21956,,21956.0
420985,201904,63,56,7,55888,6986,62874
420990,201904,76,60,16,59880,15968,75848
421000,201904,35,21,14,20958,13972,34930
421003,201904,67,46,21,46906,20958.98,67864.98
421005,201904,7,4,3,3992,2994,6986
421010,201904,766,535,231,534929.38,230539.1,765468.48
421020,201904,26,21,5,20958,4990,25948
421030,201904,123,104,19,104790.3,18962,123752.3
421040,201904,67,55,12,54890,11976,66866
421050,201904,328,231,97,231536.4,96806,328342.4
421055,201904,25,21,4,20958,3992,24950
421060,201904,81,53,28,52894,27944,80838
421070,201904,47,43,4,42914.4,3992,46906.4
421080,201904,33,31,2,30938,1996,32934
421085,201904,25,19,6,18962,5988,24950
421090,201904,39,29,10,28942,9980,38922
421100,201904,132,97,35,97804,34930,132734
421105,201904,214,174,40,173652.98,39920.98,213573.96
421110,201904,112,91,21,91816,20958,112774
421120,201904,155,120,35,119760.98,34930,154690.98
421125,201904,18,13,5,12974,4990,17964
421130,201904,817,527,290,525946,289420.4,815366.4
421140,201904,31,23,8,22954,7984,30938
421145,201904,41,33,8,32934,7984,40918
421150,201904,103,75,28,74850,28942.8,103792.8
421160,201904,68,46,22,45908,21956,67864
421165,201904,17,16,1,15968,998,16966
421170,201904,192,163,29,162798.32,28942.98,191741.30
421175,201904,157,106,51,105788,50898,156686
421180,201904,59,39,20,38922.24,19960,58882.24
421185,201904,18,15,3,14970,2994,17964
421187,201904,0,0,0,0,0,0
421189,201904,43,31,12,30938,11976,42914
421190,201904,1619,1031,588,1028938.6,586824.8,1615763.4
421200,201904,89,66,23,65868,22954,88822
421205,201904,28,17,11,16966,10978,27944
421210,201904,171,122,49,121756,48902,170658
421220,201904,282,222,60,221556,59880,281436
421223,201904,52,43,9,42914.6,8982,51896.6
421225,201904,70,45,25,44910.6,24950,69860.6
421227,201904,85,64,21,63872,20958,84830
421230,201904,52,39,13,38922,12974,51896
421240,201904,18,18,0,17964,,17964.0
421250,201904,364,224,140,223553.6,140718,364271.6
421260,201904,23,19,4,18962,3992,22954
421265,201904,1,1,0,998,,998.0
421270,201904,52,46,6,45908,5988,51896
421280,201904,341,195,146,194610,145708,340318
421290,201904,326,222,104,221556,103792,325348
421300,201904,25,20,5,19960,4990,24950
421310,201904,51,38,13,37924,12974,50898
421315,201904,28,18,10,17964,9980,27944
421320,201904,136,92,44,92814,43912,136726
421330,201904,104,77,27,76846,26946.98,103792.98
421335,201904,39,27,12,26946,11976,38922
421340,201904,258,168,90,167665.72,89820,257485.72
421350,201904,194,111,83,110778.97,82834,193612.97
421360,201904,676,505,171,504989.88,170659.92,675649.80
421370,201904,196,153,43,152694,42914,195608
421380,201904,130,105,25,104790,24950,129740
421390,201904,17,12,5,11976,4990,16966
421400,201904,120,103,17,102794,16966,119760
421410,201904,20,18,2,17964,1996,19960
421415,201904,21,20,1,19960,998,20958
421420,201904,149,122,27,121756,26946,148702
421430,201904,14,10,4,9980,3992,13972
421440,201904,59,47,12,46906,11976,58882
421450,201904,91,78,13,77844,12974,90818
421460,201904,63,52,11,51896,10978,62874
421470,201904,66,44,22,43912,21956,65868
421480,201904,664,501,163,500996,163672.98,664668.98
421490,201904,23,22,1,21956.98,998,22954.98
421500,201904,503,329,174,329343.34,173666.7,503010.04
421505,201904,23,16,7,15968,6986,22954
421507,201904,37,30,7,29940,6986,36926
421510,201904,75,49,26,48902,25948,74850
421520,201904,62,53,9,52894,8982,61876
421530,201904,52,45,7,44910,6986,51896
421535,201904,27,26,1,25948.44,998,26946.44
421540,201904,57,49,8,48902,7984,56886
421545,201904,99,74,25,73852.98,24950,98802.98
421550,201904,299,218,81,217564,80838,298402
421555,201904,24,19,5,18962,4990.8,23952.8
421560,201904,8,7,1,6986,998,7984
421565,201904,122,85,37,84830,36926,121756
421567,201904,29,25,4,24950,3992,28942
421568,201904,31,29,2,28942,1996,30938
421569,201904,9,9,0,8982,,8982.0
421570,201904,183,123,60,122754,59880,182634
421575,201904,28,23,5,22954,4990,27944
421580,201904,715,431,284,430138,284430,714568
421590,201904,21,20,1,19960,998,20958
421600,201904,130,80,50,79840,49900.8,129740.8
421605,201904,113,81,32,80838.3,31936,112774.3
421610,201904,198,157,41,156686.4,40918,197604.4
421620,201904,1075,632,443,630737.38,444110,1074847.38
421625,201904,23,20,3,19960,2994,22954
421630,201904,290,184,106,183632.9,105789.6,289422.5
421635,201904,17,8,9,7984,8982,16966
421640,201904,97,83,14,82834.6,13972,96806.6
421650,201904,300,180,120,179640,119760,299400
421660,201904,2225,1346,879,1347300.8,877244.76,2224545.56
421670,201904,198,143,55,142714,54890,197604
421680,201904,173,157,16,156686,15968,172654
421690,201904,344,246,98,245510.94,97804.44,343315.38
421700,201904,62,40,22,39920,21956.2,61876.2
421710,201904,27,26,1,25948,998,26946
421715,201904,7,6,1,5988,998,6986
421720,201904,590,432,158,431136,158682,589818
421725,201904,13,5,8,4990,7984,12974
421730,201904,37,26,11,25948,10978,36926
421740,201904,90,43,47,42914,46906,89820
421750,201904,218,162,56,161676,55888,217564
421755,201904,25,23,2,22954,1996,24950
421760,201904,110,79,31,79840,30938,110778
421770,201904,607,405,202,404201.14,202599.12,606800.26
421775,201904,31,20,11,19960,10978,30938
421780,201904,192,149,43,149700,42914,192614
421790,201904,156,132,24,131736,24950,156686
421795,201904,20,15,5,14970,4990,19960
421800,201904,513,329,184,328342,183632.5,511974.5
421810,201904,76,62,14,61876,13972,75848
421820,201904,326,219,107,218562.4,107784,326346.4
421825,201904,134,112,22,111776,21956,133732
421830,201904,134,100,34,99800,33932,133732
421835,201904,3,3,0,2994,,2994.0
421840,201904,52,44,8,43912.98,7984,51896.98
421850,201904,79,68,11,67864,10978.99,78842.99
421860,201904,39,31,8,30938,7984,38922
421870,201904,996,764,232,764498.24,232540.16,997038.40
421875,201904,53,45,8,44910,7984,52894
421880,201904,169,122,47,121756,46906.4,168662.4
421885,201904,26,21,5,20958,4990,25948
421890,201904,126,90,36,89820,35928.98,125748.98
421895,201904,49,45,4,44910,3992,48902
421900,201904,163,130,33,129742.94,32937.92,162680.86
421910,201904,66,42,24,41916,23952,65868
421915,201904,31,26,5,25948,4990,30938
421917,201904,41,30,11,29940,10978,40918
421920,201904,36,33,3,32934,2994,35928
421930,201904,741,583,158,582832,157686.94,740518.94
421935,201904,51,44,7,43912,6986,50898
421940,201904,41,37,4,36926,3992,40918
421950,201904,873,588,285,586825.2,284431.58,871256.78
421960,201904,40,33,7,32934.4,6986,39920.4
421970,201904,364,234,130,233532.4,129740.98,363273.38
421985,201904,29,18,11,17964,10978,28942
422000,201904,0,0,0,0,0,0
430003,201904,196,52,144,51896,144710,196606
430005,201904,39,30,9,29940,8982,38922
430010,201904,271,190,81,189620,80838,270458
430020,201904,152,100,52,99800.4,52894,152694.4
430030,201904,129,106,23,105788,22954,128742
430040,201904,2992,1752,1240,1748498.64,1239518.34,2988016.98
430045,201904,69,59,10,58882,9980,68862
430047,201904,7,6,1,5988,998,6986
430050,201904,78,66,12,66866,11976,78842
430055,201904,14,12,2,11976,1996,13972
430057,201904,6,4,2,3992,1996,5988
430060,201904,3682,2186,1496,2182634.39,1496006.72,3678641.11
430063,201904,60,55,5,54890,4990,59880
430064,201904,160,133,27,132734,26946,159680
430066,201904,7,6,1,5988,998,6986
430070,201904,47,36,11,35928,10978,46906
430080,201904,69,48,21,47904,20958,68862
430085,201904,35,13,22,12974,21956,34930
430087,201904,31,24,7,23952.7,6986,30938.7
430090,201904,73,66,7,65868,6986,72854
430100,201904,123,82,41,81836,40918,122754
430105,201904,144,75,69,74850.6,68862,143712.6
430107,201904,20,15,5,14970,4990,19960
430110,201904,414,247,167,247504,166666,414170
430120,201904,143,132,11,131736,10978,142714
430130,201904,797,491,306,490018.4,305388,795406.4
430140,201904,123,116,7,115768,6986,122754
430150,201904,110,72,38,71856,38922,110778
430155,201904,33,30,3,29940,2994,32934
430160,201904,3708,2205,1503,2202589.1,1500992.4,3703581.5
430163,201904,328,150,178,149700,178642,328342
430165,201904,29,19,10,18962,9980,28942
430170,201904,89,75,14,75848,13972,89820
430175,201904,85,67,18,66866,17964,84830
430180,201904,102,84,18,83832,17964,101796
430185,201904,32,24,8,23952,7984,31936
430187,201904,95,42,53,41916,52894,94810
430190,201904,217,122,95,121756,94810,216566
430192,201904,15,13,2,12974,1996,14970
430195,201904,15,10,5,9980,4990,14970
430200,201904,174,153,21,152694,20958,173652
430205,201904,20,19,1,18962,998,19960
430210,201904,667,521,146,522952.4,145708.4,668660.8
430215,201904,15,13,2,12974,1996,14970
430220,201904,74,52,22,51896,21956,73852
430222,201904,13,7,6,6986,5988,12974
430223,201904,13,7,6,6986,5988,12974
430225,201904,2,1,1,998,998,1996
430230,201904,314,184,130,183632,129740,313372
430235,201904,56,42,14,41916,13972,55888
430237,201904,28,22,6,21956,5988,27944
430240,201904,133,85,48,84830,47904,132734
430245,201904,68,58,10,57884,9980,67864
430250,201904,194,115,79,114770,78842,193612
430258,201904,11,9,2,8982,1996,10978
430260,201904,35,31,4,30938,3992,34930
430265,201904,36,30,6,29940,5988,35928
430270,201904,546,410,136,409180.3,135731.92,544912.22
430280,201904,1036,643,393,641714,392215.9,1033929.9
430290,201904,384,219,165,218562.6,164670,383232.6
430300,201904,2116,1182,934,1184629.34,933136.05,2117765.39
430310,201904,1942,1010,932,1009977.96,933136.94,1943114.90
430320,201904,55,45,10,44910,9980,54890
430330,201904,94,84,10,83832,9980,93812
430340,201904,71,61,10,60878,9980,70858
430350,201904,1653,1155,498,1154686.6,498002.98,1652689.58
430355,201904,23,21,2,20958,1996,22954
430360,201904,86,44,42,43912,41916,85828
430367,201904,31,22,9,21956,8982,30938
430370,201904,58,50,8,49900,7984,57884
430380,201904,138,104,34,103792,33932,137724
430390,201904,600,379,221,378242,221556,599798
430400,201904,141,108,33,107784,32934,140718
430410,201904,60,46,14,45908,13972,59880
430420,201904,504,334,170,333333.34,169660.98,502994.32
430430,201904,54,53,1,52229.33,998,53227.33
430435,201904,156,117,39,116766,38922,155688
430440,201904,516,338,178,338322.6,180638,518960.6
430450,201904,1163,960,203,958080,202594,1160674
430460,201904,5049,2781,2268,2776440.28,2265486.18,5041926.46
430461,201904,17,15,2,14970,1996,16966
430462,201904,9,6,3,5988,2994,8982
430463,201904,1055,563,492,562872.6,491017.96,1053890.56
430465,201904,24,14,10,13972,9980,23952
430466,201904,666,482,184,482034.4,183632,665666.4
430467,201904,93,52,41,51896.6,40918,92814.6
430468,201904,110,67,43,66866,42914,109780
430469,201904,23,18,5,17964,4990,22954
430470,201904,1167,659,508,657979.95,507982,1165961.95
430471,201904,55,40,15,39920,14970,54890
430480,201904,100,62,38,62874,37924,100798
430485,201904,6,6,0,5988.4,,5988.4
430490,201904,87,71,16,70858,15968,86826
430495,201904,37,27,10,26946,9980,36926
430500,201904,193,129,64,128742,63872.63,192614.63
430510,201904,3372,2221,1151,2218555.24,1154686,3373241.24
430511,201904,17,16,1,15968,998,16966
430512,201904,139,99,40,98802,39920,138722
430513,201904,50,40,10,39920,9980,49900
430515,201904,32,30,2,29940,1996,31936
430517,201904,168,150,18,149700,17964,167664
430520,201904,369,258,111,259480,110778,370258
430530,201904,90,51,39,50898,38922,89820
430535,201904,458,313,145,312374,146706.99,459080.99
430537,201904,10,10,0,9980,,9980.0
430540,201904,79,54,25,53892,24950,78842
430543,201904,361,114,247,113772,246506,360278
430544,201904,44,41,3,40918,2994,43912
430545,201904,352,180,172,179641.9,171656,351297.9
430550,201904,43,36,7,35928,6986,42914
430558,201904,5,3,2,2994,1996,4990
430560,201904,53,25,28,24950,27944,52894
430570,201904,108,43,65,42914,64870,107784
430580,201904,123,101,22,100798,21956.6,122754.6
430583,201904,14,14,0,13972,,13972.0
430585,201904,9,4,5,3992,4990,8982
430587,201904,16,7,9,6986,8982,15968
430590,201904,150,123,27,122754,26946,149700
430593,201904,2,2,0,1996,,1996.0
430595,201904,16,13,3,13972,2994,16966
430597,201904,49,27,22,26946,21956,48902
430600,201904,221,156,65,155688,64870,220558
430605,201904,159,100,59,99800,59880,159680
430607,201904,25,22,3,21956,2994,24950
430610,201904,1627,772,855,773450.9,854289.38,1627740.28
430613,201904,3,3,0,2994,,2994.0
430620,201904,113,83,30,82834,29940,112774
430630,201904,48,41,7,40918,6986,47904
430632,201904,34,29,5,28942,4990,33932
430635,201904,39,36,3,35928,2994,38922
430637,201904,54,29,25,28942,24950,53892
430640,201904,193,108,85,107784,84830,192614
430642,201904,22,20,2,19960,1996,21956
430645,201904,37,30,7,29940,6986,36926
430650,201904,257,209,48,208582.4,47904,256486.4
430655,201904,4,4,0,3992,,3992.0
430660,201904,983,479,504,481036,502992.4,984028.4
430670,201904,76,53,23,52894,22954,75848
430673,201904,74,40,34,39920,33932,73852
430675,201904,14,11,3,10978,2994,13972
430676,201904,505,307,198,306386.94,197604.94,503991.88
430680,201904,260,182,78,182634.4,77844,260478.4
430690,201904,538,335,203,334330.98,202594.63,536925.61
430692,201904,7,5,2,4990,1996,6986
430693,201904,140,96,44,95808,43912,139720
430695,201904,74,62,12,61876,11976,73852
430697,201904,60,38,22,37924,21956,59880
430700,201904,1542,1082,460,1079836.76,460078,1539914.76
430705,201904,23,21,2,20958,1996,22954
430710,201904,255,168,87,167664,86826,254490
430720,201904,107,90,17,89820,16966,106786
430730,201904,136,116,20,115768,19960,135728
430740,201904,71,47,24,46906,23952,70858
430745,201904,35,28,7,27944,6986,34930
430750,201904,340,226,114,225548,114770,340318
430755,201904,89,54,35,53892,34930,88822
430760,201904,366,219,147,218563.04,146706.98,365270.02
430770,201904,1439,757,682,758482.24,680639.92,1439122.16
430780,201904,314,200,114,199600.98,114770.98,314371.96
430781,201904,27,24,3,23952,2994,26946
430783,201904,54,45,9,44910,8982,53892
430786,201904,6,3,3,2994,2994,5988
430790,201904,535,346,189,345308,188622.4,533930.4
430800,201904,161,134,27,133732.51,26946,160678.51
430805,201904,40,36,4,35928,3992,39920
430807,201904,45,26,19,25948,18962,44910
430810,201904,74,48,26,47904,25948,73852
430820,201904,144,86,58,85828,58882,144710
430825,201904,11,9,2,8982,1996,10978
430830,201904,238,221,17,221556.4,16966,238522.4
430840,201904,128,86,42,85828,41916,127744
430843,201904,5,3,2,2994,1996,4990
430845,201904,70,41,29,40918,28942,69860
430850,201904,574,403,171,402194,170661.9,572855.9
430860,201904,167,105,62,104790,62874,167664
430865,201904,71,39,32,38922,31936.98,70858.98
430870,201904,82,67,15,66866,14970,81836
430880,201904,156,116,40,115768,39920,155688
430885,201904,9,7,2,6986,1996,8982
430890,201904,346,210,136,209580,136726,346306
430900,201904,527,370,157,368761,158682,527443
430905,201904,108,48,60,47904,59880,107784
430910,201904,275,152,123,151696,122754.98,274450.98
430912,201904,6,6,0,5988,,5988.0
430915,201904,34,28,6,27944,5988,33932
430920,201904,4216,2343,1873,2342311.6,1870255.94,4212567.54
430925,201904,4,3,1,2994,998,3992
430930,201904,2065,1219,846,1221554.48,845309.88,2066864.36
430940,201904,262,168,94,167664,93812,261476
430950,201904,151,123,28,122754,27944,150698
430955,201904,22,13,9,12974,8982,21956
430957,201904,19,18,1,17964,998,18962
430960,201904,242,159,83,158682,82834,241516
430965,201904,113,72,41,71856,40918,112774
430970,201904,85,71,14,70858,13972,84830
430975,201904,40,36,4,35928,3992,39920
430980,201904,46,30,16,29940,15968,45908
430990,201904,116,88,28,87824,27944,115768
430995,201904,120,115,5,114770,4990,119760
431000,201904,306,138,168,137725,167664,305389
431010,201904,349,204,145,204590,144710,349300
431020,201904,1948,1134,814,1131732.6,812372,1944104.6
431030,201904,43,33,10,32934,9980,42914
431033,201904,379,193,186,192614,185628,378242
431036,201904,14,9,5,8982,4990,13972
431040,201904,135,83,52,82834,51896,134730
431041,201904,38,26,12,25948,11976,37924
431043,201904,50,30,20,29940,19960,49900
431046,201904,11,7,4,6986,3992,10978
431050,201904,197,126,71,125748,70858,196606
431053,201904,73,45,28,44910.96,27944,72854.96
431055,201904,64,44,20,43912,19960,63872
431057,201904,18,18,0,17964,,17964.0
431060,201904,1647,1037,610,1035926.35,609793.4,1645719.75
431065,201904,19,11,8,10978,7984,18962
431070,201904,70,64,6,63872,5988,69860
431075,201904,6,6,0,5988,,5988.0
431080,201904,132,83,49,82834,48902,131736
431085,201904,33,30,3,29940,2994,32934
431087,201904,15,12,3,11976,2994,14970
431090,201904,54,43,11,43912,10978,54890
431100,201904,1212,726,486,725547.42,485028,1210575.42
431110,201904,247,152,95,152694,94810.4,247504.4
431112,201904,28,17,11,16966,10978,27944
431113,201904,32,23,9,22954,8982,31936
431115,201904,156,109,47,109780,46906,156686
431120,201904,607,364,243,363272.6,244511.92,607784.52
431123,201904,4,3,1,2994,998,3992
431125,201904,100,91,9,90818,8982,99800
431127,201904,9,4,5,3992,4990,8982
431130,201904,691,446,245,447104,245508,692612
431140,201904,763,532,231,531934.4,232534,764468.4
431142,201904,33,27,6,26946.95,5988,32934.95
431150,201904,197,149,48,148702,47904,196606
431160,201904,55,49,6,48902,5988,54890
431162,201904,18,13,5,12974,4990,17964
431164,201904,6,6,0,5988,,5988.0
431170,201904,106,85,21,84830,20958,105788
431171,201904,69,41,28,41916,28942,70858
431173,201904,1,1,0,998,,998.0
431175,201904,198,102,96,101796.4,95808,197604.4
431177,201904,75,58,17,57884,16966,74850
431179,201904,14,12,2,11976,1996,13972
431180,201904,465,285,180,284430,179640.98,464070.98
431190,201904,86,66,20,65868,19960,85828
431198,201904,70,49,21,48902,20958,69860
431200,201904,20,16,4,15968,3992,19960
431205,201904,23,23,0,22954,,22954.0
431210,201904,84,51,33,50898,32934,83832
431213,201904,28,24,4,23952,3992,27944
431215,201904,23,20,3,19960,2994,22954
431217,201904,4,4,0,3992,,3992.0
431220,201904,69,60,9,59880.8,8982,68862.8
431225,201904,150,102,48,101796.98,47904,149700.98
431230,201904,102,92,10,91816,9980,101796
431235,201904,8,8,0,7984,,7984.0
431237,201904,24,17,7,16966,6986,23952
431238,201904,9,6,3,5988.4,2994,8982.4
431240,201904,991,655,336,654688.2,336326,991014.2
431242,201904,40,39,1,38922,998,39920
431244,201904,11,8,3,7984,2994,10978
431245,201904,49,38,11,37924,10978,48902
431247,201904,13,11,2,10978,1996,12974
431250,201904,281,148,133,148702,132734,281436
431260,201904,59,46,13,45908,12974,58882
431261,201904,18,12,6,11976,5988,17964
431262,201904,18,17,1,16966,998,17964
431265,201904,157,86,71,86826,70858,157684
431267,201904,15,14,1,13972,998,14970
431270,201904,326,269,57,268462,56886,325348
431275,201904,39,36,3,35928,2994,38922
431280,201904,18,14,4,13972,3992,17964
431290,201904,25,20,5,19960,4990,24950
431295,201904,3,3,0,2994,,2994.0
431300,201904,22,19,3,18962,2994,21956
431301,201904,6,6,0,5988,,5988.0
431303,201904,54,36,18,35928,17964,53892
431306,201904,238,128,110,127566.35,109780,237346.35
431308,201904,6,5,1,4990,998,5988
431310,201904,67,57,10,57884,9980,67864
431320,201904,141,85,56,84830,55888,140718
431330,201904,177,115,62,114770,61876,176646
431333,201904,30,26,4,25948,4990,30938
431335,201904,8,4,4,3992,3992,7984
431337,201904,329,153,176,152694,176646,329340
431339,201904,21,18,3,18962,2994,21956
431340,201904,2984,1711,1273,1710496.51,1277458.34,2987954.85
431342,201904,38,24,14,23952,13972,37924
431344,201904,18,18,0,17964,,17964.0
431346,201904,5,5,0,4990,,4990.0
431349,201904,35,32,3,31936,2994,34930
431350,201904,918,545,373,543911.08,374250,918161.08
431360,201904,49,44,5,43912,4990,48902
431365,201904,326,157,169,156686,168662,325348
431370,201904,1324,791,533,789418.4,532938.86,1322357.26
431380,201904,99,85,14,84830,13972,98802
431390,201904,521,287,234,286426,234530,520956
431395,201904,295,136,159,135728,158682.96,294410.96
431400,201904,41,30,11,29940,10978,40918
431402,201904,101,72,29,71856,28942,100798
431403,201904,22,12,10,11976,9980,21956
431405,201904,656,360,296,359280.9,295410.94,654691.84
431406,201904,31,27,4,26946,3992,30938
431407,201904,52,41,11,40918,10978,51896
431410,201904,3425,2108,1317,2104783.5,1316362.09,3421145.59
431413,201904,17,14,3,13972,2994,16966
431415,201904,72,53,19,52894,18962,71856
431417,201904,23,12,11,11976,10978,22954
431420,201904,313,218,95,217564,95808,313372
431430,201904,47,23,24,22954,23952,46906
431440,201904,8881,6289,2592,6282420.03,2592805.4,8875225.43
431442,201904,28,16,12,15968,11976,27944
431445,201904,23,20,3,19960,2994,22954
431446,201904,3,3,0,2994,,2994.0
431447,201904,86,63,23,62874,22954,85828
431449,201904,56,49,7,48902,6986,55888
431450,201904,415,284,131,284430,130738,415168
431454,201904,0,0,0,0,0,0
431455,201904,51,40,11,39920,10978,50898
431460,201904,518,358,160,357284,160678,517962
431470,201904,119,92,27,91816,26946,118762
431475,201904,11,10,1,9980,998,10978
431477,201904,35,24,11,23952,10978,34930
431478,201904,8,7,1,6986,998,7984
431480,201904,487,311,176,311376,175648,487024
431490,201904,28313,16149,12164,16134286.59,12158769.49,28293056.08
431500,201904,81,60,21,59880,20958,80838
431505,201904,32,19,13,18962,12974,31936
431507,201904,13,10,3,9980,2994,12974
431510,201904,258,183,75,182634.1,74850,257484.1
431513,201904,24,20,4,19960,3992,23952
431514,201904,7,6,1,5988,998,6986
431515,201904,80,68,12,67864,11976,79840
431517,201904,5,4,1,3992,998,4990
431520,201904,38,34,4,33932,3992,37924
431530,201904,1564,705,859,704590.88,857282.94,1561873.82
431531,201904,24,22,2,21956,1996,23952
431532,201904,28,19,9,18962,8982,27944
431535,201904,28,18,10,17964,9980,27944
431540,201904,143,126,17,125748,16966,142714
431545,201904,14,12,2,11976,1996,13972
431550,201904,356,199,157,199600,157684,357284
431555,201904,13,12,1,11976,998,12974
431560,201904,4467,3138,1329,3134723.17,1327340,4462063.17
431570,201904,807,433,374,433132.8,373252,806384.8
431575,201904,38,24,14,23952,13972,37924
431580,201904,99,68,31,67864,30938,98802
431590,201904,149,127,22,126746,21956,148702
431595,201904,12,11,1,10978,998,11976
431600,201904,221,125,96,124750,95808,220558
431610,201904,122,90,32,89820,31936,121756
431620,201904,45,37,8,36926,7984,44910
431630,201904,134,112,22,111776,21956,133732
431640,201904,1346,847,499,847302.4,500997.36,1348299.76
431642,201904,34,32,2,31936,1996,33932
431643,201904,42,19,23,18962,22954,41916
431645,201904,317,184,133,184630,132734,317364
431647,201904,10,10,0,9980,,9980.0
431650,201904,35,25,10,24950,9980,34930
431660,201904,318,201,117,201596,116766,318362
431670,201904,234,111,123,110778,122754,233532
431673,201904,5,5,0,5988,,5988.0
431675,201904,29,24,5,23952,4990,28942
431680,201904,1130,825,305,826344,304390,1130734
431690,201904,4784,2923,1861,2920151.28,1861274.3,4781425.58
431695,201904,24,20,4,19960,3992,23952
431697,201904,0,0,0,0,0,0
431700,201904,172,135,37,134730,36926,171656
431710,201904,4029,1775,2254,1771451.58,2250500.78,4021952.36
431720,201904,1364,830,534,829338.6,532932.99,1362271.59
431725,201904,1,1,0,998,,998.0
431730,201904,1195,811,384,812375.12,383232,1195607.12
431740,201904,1367,675,692,673650.96,691618.32,1365269.28
431750,201904,1862,1214,648,1214567.71,647702.98,1862270.69
431755,201904,5,4,1,3992,998,4990
431760,201904,1021,662,359,660676,358282,1018958
431770,201904,398,295,103,294410,102794,397204
431775,201904,31,23,8,22954,7984,30938
431780,201904,561,350,211,349300,210578,559878
431790,201904,169,131,38,130738,37924,168662
431795,201904,12,10,2,9980,1996,11976
431800,201904,3339,1764,1575,1761482.2,1573945.36,3335427.56
431805,201904,18,16,2,15968,1996,17964
431810,201904,609,408,201,407184,201596.98,608780.98
431820,201904,325,189,136,188622,136726,325348
431830,201904,2347,1421,926,1419156,925150.92,2344306.92
431840,201904,496,330,166,329340.6,166666,496006.6
431842,201904,35,29,6,28942,5988,34930
431843,201904,12,9,3,8982,2994,11976
431844,201904,17,15,2,14970,1996,16966
431845,201904,27,25,2,24950,2994,27944
431846,201904,29,24,5,23952,4990,28942
431848,201904,14,12,2,11976,1996,13972
431849,201904,11,7,4,6986,3992,10978
431850,201904,804,664,140,663670,140718,804388
431860,201904,115,82,33,81836,32934,114770
431861,201904,4,2,2,1996,1996,3992
431862,201904,51,34,17,33932,16966,50898
431870,201904,3411,2034,1377,2031933.28,1379243.76,3411177.04
431880,201904,930,686,244,686624.94,244510,931134.94
431890,201904,1305,817,488,815366.4,487024,1302390.4
431900,201904,177,127,50,126746,49900,176646
431910,201904,52,39,13,38922,12974,51896
431912,201904,38,22,16,21956,15968,37924
431915,201904,131,105,26,104790,25948,130738
431920,201904,151,110,41,109780,40918,150698
431930,201904,79,64,15,63872,14970,78842
431935,201904,3,3,0,2994,,2994.0
431936,201904,12,11,1,10978,998,11976
431937,201904,19,14,5,13972,4990,18962
431940,201904,470,315,155,314370,154690.5,469060.5
431950,201904,503,317,186,316367.38,185629.96,501997.34
431960,201904,736,409,327,408184.36,327345.96,735530.32
431970,201904,73,65,8,64870,7984,72854
431971,201904,3,3,0,2994,,2994.0
431973,201904,25,20,5,19960,4990,24950
431975,201904,8,7,1,6986,998,7984
431980,201904,206,128,78,127744,77844,205588
431990,201904,1212,653,559,652627.13,557884.9,1210512.03
432000,201904,1672,913,759,913172.1,758485,1671657.1
432010,201904,280,187,93,186626,92814,279440
432020,201904,173,143,30,142714,29940,172654
432023,201904,15,13,2,12974,1996,14970
432026,201904,70,65,5,64870,4990,69860
432030,201904,66,32,34,31936,33932,65868
432032,201904,19,16,3,15968,2994,18962
432035,201904,48,39,9,38922,8982,47904
432040,201904,105,73,32,72854,31936,104790
432045,201904,8,7,1,6986,998,7984
432050,201904,79,48,31,47904,30938,78842
432055,201904,112,83,29,82834,28942,111776
432057,201904,4,3,1,2994.4,998,3992.4
432060,201904,35,32,3,31936,2994,34930
432065,201904,33,29,4,28942,3992,32934
432067,201904,87,78,9,77844,8982,86826
432070,201904,399,303,96,302644.8,95808.98,398453.78
432080,201904,826,576,250,575846,250498,826344
432085,201904,15,12,3,11976,2994,14970
432090,201904,268,175,93,174650,92814,267464
432100,201904,176,118,58,117764,57884,175648
432110,201904,589,403,186,403192,185628,588820
432120,201904,946,579,367,578840,367264,946104
432130,201904,508,368,140,367264,139720,506984
432132,201904,24,21,3,20958,2994,23952
432135,201904,77,64,13,63872,12974,76846
432140,201904,267,216,51,215568,50898,266466
432143,201904,204,130,74,129740,73852,203592
432145,201904,283,195,88,194610,87824,282434
432146,201904,14,13,1,12974,998,13972
432147,201904,125,60,65,59880,64870,124750
432149,201904,14,10,4,9980,3992,13972
432150,201904,836,519,317,518960.96,316367.55,835328.51
432160,201904,1422,745,677,744509.57,678641.94,1423151.51
432162,201904,4,3,1,2994,998,3992
432163,201904,18,14,4,13972,3992,17964
432166,201904,117,87,30,87326,29940,117266
432170,201904,224,118,106,117764,106786,224550
432180,201904,543,341,202,340318,201596.4,541914.4
432183,201904,6,6,0,5988,,5988.0
432185,201904,79,69,10,69860,9980,79840
432190,201904,466,273,193,272454,192614.98,465068.98
432195,201904,86,73,13,72854,12974,85828
432200,201904,398,255,143,254490,142714.98,397204.98
432210,201904,118,74,44,73852,43912,117764
432215,201904,57,53,4,52894,3992,56886
432218,201904,20,19,1,18962,998,19960
432220,201904,672,350,322,349300,323353.61,672653.61
432225,201904,13,8,5,7984,4990,12974
432230,201904,147,95,52,94810,52894,147704
432232,201904,14,13,1,12974,998,13972
432234,201904,4,3,1,2994,998,3992
432235,201904,3,3,0,2994,,2994.0
432237,201904,26,15,11,14970,10978,25948
432240,201904,4354,2461,1893,2457081.08,1890213.78,4347294.86
432250,201904,1087,695,392,694608,392214,1086822
432252,201904,43,38,5,37924,4990,42914
432253,201904,59,47,12,46906,11976,58882
432254,201904,26,13,13,12974,12974,25948
432255,201904,13,12,1,11976,998,12974
432260,201904,889,706,183,704588.4,182634,887222.4
432270,201904,242,177,65,176646,64870,241516
432280,201904,134,100,34,99800.6,33932,133732.6
432285,201904,1,1,0,998,,998.0
432290,201904,67,59,8,58882,7984,66866
432300,201904,4572,2598,1974,2594738.39,1971063.54,4565801.93
432310,201904,119,98,21,97804,20958,118762
432320,201904,21,17,4,16966,3992,20958
432330,201904,16,12,4,11976,3992,15968
432335,201904,7,6,1,5988,998,6986
432340,201904,39,35,4,34930,3992,38922
432345,201904,97,70,27,69860,26946,96806
432350,201904,25,24,1,23952,998,24950
432360,201904,7,5,2,4990,1996,6986
432370,201904,26,26,0,25948,,25948.0
432375,201904,33,31,2,30938,1996,32934
432377,201904,8,8,0,7984,,7984.0
432380,201904,165,75,90,74850,89820,164670
500020,201904,243,140,103,139720,102794,242514
500025,201904,125,61,64,60878,64870,125748
500060,201904,1462,915,547,914168,546905.38,1461073.38
500070,201904,802,386,416,385228.96,415168.98,800397.94
500080,201904,136,110,26,109780,25948,135728
500085,201904,133,108,25,107784.4,24950,132734.4
500090,201904,331,157,174,156686,173652,330338
500100,201904,731,386,345,386226,345308.8,731534.8
500110,201904,2280,1053,1227,1050899.71,1226554.09,2277453.80
500124,201904,266,156,110,156686,109780,266466
500150,201904,322,136,186,135728.98,185630.94,321359.92
500190,201904,531,370,161,369260,160678.4,529938.4
500200,201904,193,166,27,165668.28,26946,192614.28
500210,201904,1460,524,936,522958.86,937154.26,1460113.12
500215,201904,245,145,100,144710,99800,244510
500220,201904,761,497,264,497006.66,263472,760478.66
500230,201904,255,170,85,169660,84830,254490
500240,201904,695,486,209,486026.36,209580,695606.36
500260,201904,594,228,366,227544,366266,593810
500270,201904,29397,12665,16732,12652695.86,16717686.39,29370382.25
500280,201904,190,70,120,69860,119760,189620
500290,201904,1180,707,473,705586,472054.98,1177640.98
500295,201904,432,274,158,273452.4,157684,431136.4
500310,201904,59,18,41,17964,40918,58882
500315,201904,735,446,289,446106,288422,734528
500320,201904,3662,1844,1818,1840313.75,1814369.88,3654683.63
500325,201904,912,504,408,502992,407184.4,910176.4
500330,201904,1444,679,765,677642.4,765466.98,1443109.38
500345,201904,314,242,72,241517.38,71856,313373.38
500348,201904,248,151,97,150698,96806.98,247504.98
500350,201904,130,64,66,63872,65868,129740
500370,201904,5467,2473,2994,2470052.48,2992010.9,5462063.38
500375,201904,352,260,92,259480,91816,351296
500380,201904,600,343,257,343312,257484,600796
500390,201904,70,34,36,33932,35928,69860
500400,201904,214,149,65,148702,64870.98,213572.98
500410,201904,556,224,332,223555.89,334336.85,557892.74
500430,201904,532,375,157,375248,156686,531934
500440,201904,204,105,99,104790,98802,203592
500450,201904,408,176,232,175648,232534,408182
500460,201904,297,153,144,152694,143712,296406
500470,201904,439,347,92,347305.39,92814.98,440120.37
500480,201904,109,65,44,64870,43912,108782
500490,201904,106,44,62,43912,61876,105788
500500,201904,1426,515,911,514978.81,911205.51,1426184.32
500510,201904,47,36,11,35928,10978.98,46906.98
500515,201904,106,74,32,73852,31936,105788
500520,201904,341,184,157,183632.8,157685.39,341318.19
500525,201904,87,47,40,47904,39920,87824
500540,201904,905,388,517,387224.98,515967.96,903192.94
500560,201904,909,519,390,518960,390218.4,909178.4
500568,201904,976,573,403,571854.98,402195.39,974050.37
500570,201904,1209,693,516,691633.22,516026.56,1207659.78
500580,201904,336,176,160,175648,159682.91,335330.91
500600,201904,320,172,148,171656,147705.96,319361.96
500620,201904,923,654,269,652692.4,268462,921154.4
500625,201904,78,66,12,65868,11976,77844
500627,201904,26,12,14,11976,13972,25948
500630,201904,1578,848,730,848301.7,729538,1577839.7
500635,201904,530,310,220,309380,219560,528940
500640,201904,415,218,197,218563.2,197604,416167.2
500660,201904,5523,2115,3408,2110770.4,3404179.86,5514950.26
500690,201904,580,208,372,207594.76,371281.48,578876.24
500710,201904,385,193,192,192614,191617.96,384231.96
500720,201904,967,570,397,568860,397204,966064
500730,201904,197,119,78,118762,77844,196606
500740,201904,849,369,480,368268.34,479068.69,847337.03
500750,201904,150,47,103,46906,102794.98,149700.98
500755,201904,123,88,35,87824.4,34930,122754.4
500769,201904,742,419,323,419162.77,324353.35,743516.12
500770,201904,417,221,196,220558.98,195608,416166.98
500780,201904,168,113,55,112774,54890,167664
500790,201904,1063,539,524,537922,522956.91,1060878.91
500793,201904,269,150,119,149700,118763.38,268463.38
500795,201904,174,126,48,125748,47904.98,173652.98
500797,201904,50,37,13,36926,12974,49900
500800,201904,420,189,231,188622.98,231536,420158.98
500830,201904,2244,1267,977,1265465.98,976044,2241509.98
500840,201904,144,107,37,106786,36926.98,143712.98
510010,201904,167,92,75,91816,74850,166666
510020,201904,490,227,263,226565.6,262504.38,489069.98
510025,201904,1698,966,732,964078.15,730552.08,1694630.23
510030,201904,679,357,322,356289.9,321357.96,677647.86
510035,201904,131,59,72,58883.96,71856.98,130740.94
510040,201904,381,172,209,172654,209582.68,382236.68
510050,201904,395,218,177,217570.84,176653.28,394224.12
510060,201904,116,60,56,59880,55888,115768
510080,201904,229,92,137,91816.98,136726.98,228543.96
510100,201904,73,34,39,33932,38922,72854
510120,201904,37,23,14,22954,13972,36926
510125,201904,393,244,149,246506,149701.97,396207.97
510130,201904,572,334,238,333340.82,237535.76,570876.58
510140,201904,409,130,279,129740,278442,408182
510160,201904,104,42,62,41916,61876.99,103792.99
510170,201904,847,519,328,517976.88,328356.68,846333.56
510180,201904,2896,1408,1488,1406227.39,1486058.1,2892285.49
510185,201904,14,6,8,5988,7984,13972
510190,201904,220,75,145,74850,146706,221556
510250,201904,2578,1542,1036,1539921.26,1034932.23,2574853.49
510260,201904,189,139,50,138736.7,50899.96,189636.66
510263,201904,456,257,199,257487.74,198602.98,456090.72
510267,201904,691,388,303,387238.32,302416.52,689654.84
510268,201904,61,30,31,29940,30938,60878
510269,201904,69,32,37,31936.98,36926,68862.98
510270,201904,404,207,197,206589.92,196610.9,403200.82
510279,201904,225,169,56,169662.94,55888.4,225551.34
510285,201904,179,76,103,75848.98,103792,179640.98
510300,201904,511,286,225,285432.92,225554.86,510987.78
510305,201904,215,100,115,99801.97,114770.98,214572.95
510310,201904,105,55,50,54890,49900,104790
510320,201904,851,540,311,539923.88,310391.73,850315.61
510325,201904,407,165,242,164670,241516,406186
510330,201904,426,242,184,241517.97,183632,425149.97
510335,201904,606,345,261,344312.95,260482.9,604795.85
510336,201904,49,36,13,35928,12974,48902
510337,201904,112,47,65,46906,65868,112774
510340,201904,17226,8188,9038,8178836.51,9035206.78,17214043.29
510343,201904,64,45,19,46906,18962,65868
510345,201904,165,111,54,110778,53892.4,164670.4
510350,201904,658,370,288,369264.9,287427.92,656692.82
510360,201904,199,125,74,124750.98,73857.88,198608.86
510370,201904,141,72,69,71856,68864.94,140720.94
510380,201904,88,62,26,61876,25948.98,87824.98
510385,201904,58,27,31,26946,30938.98,57884.98
510390,201904,113,48,65,47904,64870,112774
510395,201904,47,34,13,33932,12974,46906
510410,201904,699,463,236,463073.98,236526.98,699600.96
510420,201904,567,278,289,277462.58,290450.24,567912.82
510450,201904,52,28,24,27944,24950,52894
510452,201904,45,26,19,25948,18962,44910
510454,201904,53,26,27,25948,26946,52894
510455,201904,127,77,50,76846,49900,126746
510460,201904,178,91,87,90819.68,86826.98,177646.66
510480,201904,750,445,305,444118.1,304401.68,748519.78
510490,201904,348,180,168,179645.84,167666.9,347312.74
510500,201904,243,184,59,184630,58882,243512
510510,201904,804,466,338,465070.36,337324,802394.36
510515,201904,1169,619,550,617767.88,548901.96,1166669.84
510517,201904,265,112,153,111776,152694.98,264470.98
510520,201904,233,152,81,151698.94,80842.88,232541.82
510523,201904,95,71,24,70858,23952,94810
510525,201904,773,457,316,456090.91,315372.9,771463.81
510530,201904,18,13,5,12974,4990,17964
510550,201904,259,118,141,117764.98,140718,258482.98
510558,201904,276,136,140,135728.98,139720,275448.98
510560,201904,412,243,169,242514.4,169661.96,412176.36
510562,201904,653,461,192,461076,191616,652692
510590,201904,780,407,373,406186.98,372255.97,778442.95
510600,201904,250,136,114,135728,113773.96,249501.96
510610,201904,170,83,87,82834,86826,169660
510615,201904,195,82,113,81836,113772,195608
510617,201904,19,11,8,10978,7984,18962
510618,201904,120,57,63,56886,62874,119760
510619,201904,102,70,32,69860.98,31936.98,101797.96
510620,201904,175,97,78,97804,77844,175648
510621,201904,197,128,69,127744.98,68863.96,196608.94
510622,201904,470,297,173,296411.88,172655.96,469067.84
510623,201904,346,235,111,234531.96,112774,347305.96
510624,201904,90,45,45,44910.98,44910,89820.98
510625,201904,545,335,210,334344.7,209592.37,543937.07
510626,201904,115,73,42,72854.98,41916,114770.98
510627,201904,65,47,18,46906,17964,64870
510628,201904,152,91,61,90818.98,60878,151696.98
510629,201904,258,168,90,167664,90818,258482
510630,201904,454,235,219,234531.96,218565.34,453097.30
510631,201904,11,3,8,2994,7984.4,10978.4
510637,201904,354,210,144,210581.93,143722.78,354304.71
510642,201904,978,546,432,544910.94,431137.96,976048.90
510645,201904,0,0,0,0,0,0
510650,201904,1448,970,478,968074.14,478046.87,1446121.01
510665,201904,82,42,40,41919.88,39920,81839.88
510670,201904,64,37,27,36926,26946,63872
510675,201904,1154,721,433,720559.34,434131.96,1154691.30
510677,201904,346,175,171,175653.88,172660.86,348314.74
510680,201904,100,60,40,59881.96,39920.98,99802.94
510682,201904,214,104,110,103792.62,109780,213572.62
510685,201904,50,38,12,37924,11976,49900
510700,201904,617,358,259,357294.78,258492.79,615787.57
510704,201904,1115,601,514,599916.55,513079.78,1112996.33
510706,201904,129,67,62,66866,61877.96,128743.96
510710,201904,404,279,125,279445.84,124751.92,404197.76
510715,201904,62,47,15,46906,14970,61876
510718,201904,206,114,92,113774.94,91816,205590.94
510719,201904,37,18,19,17964,18962,36926
510720,201904,192,134,58,133732.98,57884,191616.98
510724,201904,90,36,54,35928,53892,89820
510726,201904,51,26,25,25948,24950.98,50898.98
510729,201904,74,35,39,34930,38922,73852
510730,201904,470,266,204,265469.96,203593.97,469063.93
510735,201904,109,44,65,43912,64870,108782
510740,201904,25,14,11,13972,10978,24950
510757,201904,17,13,4,12974,3992,16966
510760,201904,7118,3802,3316,3796459.51,3311578.91,7108038.42
510770,201904,696,327,369,326350.88,368273.72,694624.60
510774,201904,15,5,10,4990,9980,14970
510775,201904,111,85,26,84830,25948,110778
510776,201904,28,9,19,8982,18962,27944
510777,201904,183,81,102,80838,101796,182634
510779,201904,49,24,25,23953.96,24951.96,48905.92
510780,201904,289,161,128,160684.88,127748.86,288433.74
510785,201904,416,227,189,226546,188622,415168
510787,201904,196,98,98,97804.98,99801.97,197606.95
510788,201904,0,0,0,0,0,0
510790,201904,2431,1300,1131,1298447.9,1130823.18,2429271.08
510792,201904,1137,666,471,664675.84,471069.73,1135745.57
510794,201904,116,56,60,55888,59880.98,115768.98
510795,201904,2373,1413,960,1410180.74,959084.68,2369265.42
510800,201904,188,116,72,115768,71856.98,187624.98
510805,201904,175,122,53,121756,53892.98,175648.98
510810,201904,96,42,54,41921.88,53892,95813.88
510820,201904,247,120,127,119764.12,126748.51,246512.63
510830,201904,69,42,27,41916,26946.98,68862.98
510835,201904,12,9,3,8982,3992,12974
510840,201904,9151,4516,4635,4513169.44,4634941.24,9148110.68
510850,201904,209,83,126,82834,125748.98,208582.98
510860,201904,392,175,217,175654.86,216576.18,392231.04
510880,201904,64,48,16,47904.98,15968,63872.98
510885,201904,74,45,29,44910.98,28942,73852.98
510890,201904,72,43,29,42914,28942,71856
510895,201904,187,108,79,107784,78844.37,186628.37
520005,201904,46,31,15,30938,14970,45908
520010,201904,276,127,149,126746,148702.8,275448.8
520013,201904,687,431,256,430138.98,255488,685626.98
520015,201904,57,41,16,40918,15968,56886
520017,201904,92,53,39,52894.4,38922,91816.4
520020,201904,23,13,10,13972,9980,23952
520025,201904,2053,1134,919,1131732.4,919158,2050890.4
520030,201904,810,430,380,429140.98,381236,810376.98
520050,201904,73,49,24,48902,23952,72854
520055,201904,48,31,17,30938,16966,47904
520060,201904,186,123,63,123752,62874,186626
520080,201904,577,416,161,415168,160678,575846
520082,201904,19,14,5,13972,4990,18962
520085,201904,99,74,25,73852,25948,99800
520090,201904,92,61,31,60878,30938,91816
520110,201904,9178,4032,5146,4028933.1,5147691.68,9176624.78
520120,201904,14,8,6,7984,5988,13972
520130,201904,787,551,236,549898.98,236526.4,786425.38
520140,201904,12017,6789,5228,6779427.2,5223551.52,12002978.72
520145,201904,47,31,16,30938,15968,46906
520150,201904,185,144,41,143712,40918,184630
520160,201904,34,25,9,24950,8982,33932
520170,201904,246,148,98,148704.93,97806.92,246511.85
520180,201904,143,71,72,70858,71856,142714
520215,201904,214,139,75,139720,74850,214570
520235,201904,72,54,18,53892,17964,71856
520250,201904,131,79,52,78842,51896,130738
520260,201904,111,70,41,69860,41916,111776
520280,201904,48,33,15,32934,14970,47904
520310,201904,40,27,13,27045.8,12974,40019.8
520320,201904,168,108,60,107784,59880,167664
520330,201904,795,422,373,421158.94,373252.98,794411.92
520340,201904,338,196,142,195741.06,141716.98,337458.04
520350,201904,525,243,282,243512,283432,526944
520355,201904,91,56,35,55888,34930,90818
520357,201904,26,20,6,19960,5988,25948
520360,201904,1,1,0,998,,998.0
520380,201904,142,73,69,72854,68862,141716
520390,201904,268,116,152,115768,153692,269460
520393,201904,14,10,4,9980,3992,13972
520396,201904,94,61,33,60878,32934,93812
520400,201904,213,123,90,122754.4,89820,212574.4
520410,201904,192,99,93,98802.98,93812.98,192615.96
520420,201904,21,15,6,14970,5988,20958
520425,201904,309,146,163,145708,162675.4,308383.4
520430,201904,463,242,221,241516,220559.88,462075.88
520440,201904,624,426,198,425148,197604,622752
520450,201904,1931,873,1058,871254.98,1057884.9,1929139.88
520455,201904,56,40,16,39920,15968,55888
520460,201904,35,19,16,18962,15968,34930
520465,201904,29,24,5,23952,4990,28942
520470,201904,419,264,155,263472,154690,418162
520480,201904,79,47,32,46906.98,31940.9,78847.88
520485,201904,119,44,75,43912,74850.4,118762.4
520490,201904,423,311,112,311376,111776,423152
520495,201904,167,99,68,98802,67864,166666
520500,201904,176,134,42,133732,41916,175648
520505,201904,178,97,81,96806,80838,177644
520510,201904,1785,887,898,889253.68,897280.36,1786534.04
520520,201904,39,30,9,29940,8982,38922
520530,201904,233,178,55,177644,54890,232534
520540,201904,552,384,168,383864.06,168662,552526.06
520545,201904,141,85,56,84830,55888,140718
520547,201904,45,26,19,25948,18962,44910
520549,201904,1159,568,591,566864.32,590819.73,1157684.05
520551,201904,291,154,137,153692,136726.4,290418.4
520552,201904,47,28,19,27944,18962,46906
520570,201904,15,9,6,8982,5988,14970
520580,201904,294,181,113,180638,112774,293412
520590,201904,163,99,64,98802.98,63872,162674.98
520620,201904,1154,541,613,540918.36,612772,1153690.36
520630,201904,41,25,16,24950,15968,40918
520640,201904,400,237,163,237524,163672,401196
520650,201904,62,40,22,39920,21956,61876
520660,201904,38,21,17,20958.98,16966,37924.98
520670,201904,35,30,5,29940,4990,34930
520680,201904,55,36,19,35928,18962,54890
520690,201904,35,12,23,11976,22954.98,34930.98
520710,201904,39,34,5,33932,4990,38922
520725,201904,187,123,64,123752,63872,187624
520735,201904,58,41,17,40918,16966,57884
520740,201904,407,201,206,200598.3,205588.98,406187.28
520750,201904,37,29,8,28942,7984,36926
520753,201904,58,39,19,38922,18962,57884
520760,201904,113,78,35,77844,35928,113772
520780,201904,294,218,76,217564,75848.96,293412.96
520790,201904,154,81,73,80838,72854,153692
520800,201904,3419,1843,1576,1842310.19,1576840.88,3419151.07
520810,201904,174,128,46,127744,45908,173652
520815,201904,4,4,0,3992,,3992.0
520830,201904,148,104,44,103792,43912,147704
520840,201904,355,239,116,238522,115768,354290
520850,201904,105,68,37,67864.98,36926,104790.98
520860,201904,1720,1111,609,1108778.4,609778.4,1718556.8
520870,201904,31755,15522,16233,15501954.21,16216532.09,31718486.30
520880,201904,1120,605,515,603790.4,514968,1118758.4
520890,201904,804,480,324,479040.98,324350,803390.98
520910,201904,1009,540,469,539918.88,468062,1007980.88
520915,201904,102,78,24,78842,23952,102794
520920,201904,399,190,209,189620,208582,398202
520929,201904,18,17,1,16966,998,17964
520940,201904,75,49,26,48902,25948,74850
520945,201904,19,11,8,10978,7984,18962
520960,201904,49,31,18,30938,17964,48902
520970,201904,330,206,124,205588.98,123752,329340.98
520980,201904,91,67,24,66866,23952,90818
520990,201904,467,318,149,317364,148702,466066
520993,201904,127,61,66,60878,65868,126746
520995,201904,246,139,107,138722.66,106786.4,245509.06
521000,201904,1592,934,658,934128.6,658681.2,1592809.8
521010,201904,674,320,354,319364.12,353293.96,672658.08
521015,201904,17,11,6,10978,5988,16966
521020,201904,1448,1017,431,1016962.98,430140.36,1447103.34
521030,201904,49,34,15,33932,14970,48902
521040,201904,941,591,350,589818.9,351296.4,941115.3
521056,201904,40,30,10,29940,9980,39920
521060,201904,133,87,46,86826,45908,132734
521080,201904,456,343,113,342315.38,112774,455089.38
521090,201904,540,336,204,335328,203592,538920
521100,201904,278,209,69,208582.98,68862,277444.98
521120,201904,1055,746,309,744508.4,309380.98,1053889.38
521130,201904,365,260,105,259480,104793.34,364273.34
521140,201904,176,94,82,93812,81836,175648
521150,201904,2753,1193,1560,1190617.34,1558877.96,2749495.30
521160,201904,32,16,16,15968,15968,31936
521170,201904,197,114,83,113772,82834,196606
521180,201904,1167,746,421,744508.2,421156.9,1165665.1
521190,201904,2542,1076,1466,1074846,1471052,2545898
521200,201904,51,38,13,37924,12974,50898
521205,201904,11,8,3,7984,2994,10978
521210,201904,139,80,59,79840,58882,138722
521220,201904,810,559,251,558880,250498.9,809378.9
521225,201904,34,22,12,21956,11976,33932
521230,201904,109,73,36,72854,35928,108782
521250,201904,6167,3568,2599,3561866.62,2595801.08,6157667.70
521260,201904,24,15,9,14970,8982,23952
521270,201904,141,111,30,111776,29940,141716
521280,201904,440,267,173,267464,172654,440118
521290,201904,29,12,17,11976,16966,28942
521295,201904,100,67,33,67864,32934,100798
521300,201904,220,116,104,115769.96,103795.34,219565.30
521305,201904,37,26,11,25948,10978,36926
521308,201904,1068,796,272,796412.82,271457.38,1067870.20
521310,201904,1339,791,548,789456.16,547903.34,1337359.50
521340,201904,21,16,5,15968,4990,20958
521350,201904,126,94,32,93812,31936,125748
521370,201904,186,128,58,128742,57884,186626
521375,201904,180,98,82,97804,81836,179640
521377,201904,52,37,15,36926,14970,51896
521380,201904,1071,698,373,696605.92,373252,1069857.92
521385,201904,14,8,6,7984,6986,14970
521390,201904,101,81,20,80838,19960,100798
521400,201904,339,219,120,218562,119760,338322
521405,201904,144,78,66,77844,65868,143712
521410,201904,62,41,21,40918,20958,61876
521440,201904,199,144,55,143712,54890,198602
521450,201904,742,413,329,412174,329340,741514
521460,201904,1181,747,434,746504,433132,1179636
521470,201904,12,8,4,7984,3992,11976
521480,201904,44,30,14,29942.94,13974.86,43917.80
521483,201904,314,172,142,172654.4,141716,314370.4
521486,201904,292,189,103,188622,102794.6,291416.6
521487,201904,22,12,10,11976,9980,21956
521490,201904,26,15,11,14970,10978,25948
521500,201904,119,80,39,79840,38922,118762
521520,201904,42,29,13,28942,12974,41916
521523,201904,665,407,258,406186,257484,663670
521525,201904,46,31,15,30938,14970,45908
521530,201904,255,137,118,136726,117764,254490
521540,201904,28,15,13,14970,13972,28942
521550,201904,88,40,48,39923.34,47907.92,87831.26
521560,201904,797,552,245,551894.4,244510.7,796405.1
521565,201904,54,36,18,35928,17964,53892
521570,201904,508,340,168,340318,167664.9,507982.9
521580,201904,59,37,22,36926,21956,58882
521590,201904,37,20,17,19960,16966,36926
521600,201904,26,15,11,15968,10978,26946
521630,201904,245,131,114,130738,113775.44,244513.44
521640,201904,306,159,147,158682,146706,305388
521645,201904,28,15,13,14970,12974,27944
521680,201904,224,143,81,142714,80838.6,223552.6
521690,201904,2,2,0,1996,,1996.0
521710,201904,1172,568,604,566864,602792.98,1169656.98
521720,201904,545,372,173,371256,172655.74,543911.74
521730,201904,639,308,331,307384.8,331336.4,638721.2
521740,201904,903,378,525,377244.98,524952.32,902197.30
521760,201904,1683,936,747,936124.59,747504.34,1683628.93
521770,201904,826,525,301,523950,301396,825346
521800,201904,2031,1277,754,1274458.78,753499.8,2027958.58
521805,201904,32,19,13,18962,12974,31936
521810,201904,90,57,33,56886,32934,89820
521830,201904,950,676,274,676644.13,273452.98,950097.11
521839,201904,84,54,30,53892,29940,83832
521850,201904,1086,579,507,578844.99,508996.48,1087841.47
521860,201904,356,228,128,227544,127744,355288
521870,201904,70,41,29,40918,28942,69860
521878,201904,39,18,21,17964,20958,38922
521880,201904,4696,2125,2571,2120785.42,2570854.15,4691639.57
521890,201904,591,421,170,420158,169660,589818
521900,201904,294,238,56,237524,55888,293412
521910,201904,150,104,46,103792,45908,149700
521920,201904,52,26,26,25948,25948,51896
521925,201904,37,23,14,22954,13972,36926
521930,201904,1136,645,491,644715.66,490028.78,1134744.44
521935,201904,34,25,9,24950,8982,33932
521940,201904,194,99,95,98802,94810,193612
521945,201904,15,13,2,12974,1996,14970
521950,201904,9,5,4,4990,3992,8982
521960,201904,74,56,18,55888,17964,73852
521970,201904,411,267,144,266466,145708,412174
521971,201904,89,45,44,44910,43912,88822
521973,201904,32,17,15,16966,14970,31936
521975,201904,1242,638,604,638720.58,603791.1,1242511.68
521980,201904,247,171,76,170658,75848,246506
521990,201904,75,55,20,54890,19960,74850
522000,201904,290,185,105,184630,104790,289420
522005,201904,20,11,9,10978,8982,19960
522010,201904,1138,647,491,645706.98,490018,1135724.98
522015,201904,57,36,21,35928.98,20958,56886.98
522020,201904,873,488,385,487922.9,387224.8,875147.7
522026,201904,30,21,9,20958,8982,29940
522028,201904,17,13,4,12974,3992,16966
522040,201904,766,305,461,304392.46,461079.92,765472.38
522045,201904,2318,1445,873,1442110.7,872254.46,2314365.16
522050,201904,161,79,82,79840,81836,161676
522060,201904,548,354,194,353292,193612,546904
522068,201904,128,87,41,86826,40918,127744
522070,201904,11,11,0,10978,,10978.0
522100,201904,42,23,19,22954,18962,41916
522108,201904,41,32,9,31936,8982,40918
522119,201904,55,30,25,29940,24950,54890
522130,201904,78,32,46,31936.98,45911.92,77848.90
522140,201904,3856,1953,1903,1950093.32,1902190.56,3852283.88
522145,201904,52,34,18,33932,17964,51896
522150,201904,68,51,17,50898,16966,67864
522155,201904,52,35,17,34930.98,16966,51896.98
522157,201904,4,3,1,2994,998,3992
522160,201904,1736,1037,699,1034926,698600.98,1733526.98
522170,201904,405,275,130,274450,129740,404190
522180,201904,38,20,18,19960,17964,37924
522185,201904,1964,779,1185,777443.78,1183628.99,1961072.77
522190,201904,44,26,18,25948,17964,43912
522200,201904,299,181,118,180638,117764,298402
522205,201904,155,106,49,106786,48902,155688
522220,201904,161,115,46,114770,45908,160678
522230,201904,36,30,6,29940,5988,35928
530010,201904,54949,28438,26511,28401937.07,26509928.16,54911865.23
110001,201905,515,411,104,410178,103792,513970
110002,201905,2794,1733,1061,1729535.38,1059877.36,2789412.74
110003,201905,88,74,14,73852.18,13972,87824.18
110004,201905,2031,1330,701,1327342.36,700596.99,2027939.35
110005,201905,442,358,84,357284.4,83832,441116.4
110006,201905,454,352,102,351296.4,101796,453092.4
110007,201905,77,63,14,62874,13972,76846
110008,201905,237,136,101,135728,100798,236526
110009,201905,835,592,243,590816.42,242515.58,833332.00
110010,201905,1777,1100,677,1097801.96,677644.94,1775446.90
110011,201905,1867,1455,412,1452090.1,412174,1864264.1
110012,201905,4183,2456,1727,2452086.4,1723548.36,4175634.76
110013,201905,778,610,168,608780,167664,776444
110014,201905,374,320,54,319360.4,53892,373252.4
110015,201905,1434,1160,274,1157681.93,273452,1431133.93
110018,201905,1123,695,428,693610.34,427146.96,1120757.30
110020,201905,15651,9204,6447,9187628.77,6436156.14,15623784.91
110025,201905,646,480,166,479040.4,166666.98,645707.38
110026,201905,38,27,11,26946,10978,37924
110028,201905,1701,1244,457,1241515.05,456087.2,1697602.25
110029,201905,141,127,14,126746,13972,140718
110030,201905,2451,1666,785,1663509.1,786425.8,2449934.9
110032,201905,290,224,66,223553.35,65868.99,289422.34
110033,201905,669,499,170,498002.8,169660,667662.8
110034,201905,372,276,96,275449.15,95808,371257.15
110037,201905,105,91,14,90818,13972,104790
110040,201905,361,247,114,246506,113772,360278
110045,201905,954,660,294,658681.2,294410.64,953091.84
110050,201905,92,80,12,79840.4,11976,91816.4
110060,201905,81,46,35,45908,34930,80838
110070,201905,114,71,43,70858,42914.4,113772.4
110080,201905,412,246,166,245508,165668,411176
110090,201905,35,28,7,27944,6986,34930
110092,201905,100,53,47,52894,46906,99800
110094,201905,192,139,53,138722,52894,191616
110100,201905,30,25,5,24950,4990,29940
110110,201905,66,40,26,39920,25948,65868
110120,201905,73,61,12,60878,11976,72854
110130,201905,306,251,55,250498.4,54890,305388.4
110140,201905,243,167,76,166666,76846,243512
110143,201905,49,41,8,40918,7984,48902
110145,201905,24,19,5,18962,4990,23952
110146,201905,23,12,11,11976,10978,22954
110147,201905,39,29,10,28942,9980,38922
110148,201905,37,26,11,25948,10978,36926
110149,201905,308,218,90,217564,90818,308382
110150,201905,132,104,28,103792,27944,131736
110155,201905,7,6,1,5988,998,6986
110160,201905,65,54,11,53892,10978,64870
110170,201905,205,167,38,166666,37924,204590
110175,201905,58,43,15,42914,14970,57884
110180,201905,96,83,13,82834,12974,95808
120001,201905,148,100,48,99800,47905.98,147705.98
120005,201905,196,121,75,120758,74850,195608
120010,201905,1064,679,385,677643.67,385228.98,1062872.65
120013,201905,149,102,47,101796,46906,148702
120017,201905,93,57,36,56886,35928,92814
120020,201905,3594,2890,704,2888213.83,703590,3591803.83
120025,201905,565,326,239,325348.98,238522,563870.98
120030,201905,1058,894,164,892213,164670,1056883
120032,201905,47,41,6,40918,5988,46906
120033,201905,216,191,25,190618,25948,216566
120034,201905,165,120,45,119760,44910,164670
120035,201905,37,28,9,27944,8982,36926
120038,201905,390,250,140,249500,139720,389220
120039,201905,27,26,1,25948,998,26946
120040,201905,14102,9745,4357,9729861.06,4352301.4,14082162.46
120042,201905,50,45,5,44910,4990,49900
120043,201905,10,3,7,2994,6986,9980
120045,201905,551,361,190,360412.04,189620.98,550033.02
120050,201905,1274,979,295,977043.68,294410,1271453.68
120060,201905,1463,1196,267,1193608,266466,1460074
120070,201905,480,343,137,343313.2,137724,481037.2
120080,201905,173,108,65,107784,64870,172654
130002,201905,151,109,42,108782,41916,150698
130006,201905,74,43,31,42914,30938,73852
130008,201905,139,74,65,73852,64870,138722
130010,201905,142,79,63,78842,62874,141716
130014,201905,259,186,73,185628,72854,258482
130020,201905,93,52,41,51896,40918,92814
130030,201905,939,560,379,558880,378242,937122
130040,201905,327,161,166,160678,165668.36,326346.36
130050,201905,601,322,279,321356,278442,599798
130060,201905,870,596,274,595806,274450,870256
130063,201905,585,326,259,325348,258482,583830
130068,201905,187,121,66,120758,65868,186626
130070,201905,1315,900,415,898200,414170,1312370
130080,201905,691,451,240,450098,239520.98,689618.98
130083,201905,70,39,31,38922,30938,69860
130090,201905,365,184,181,183632,180638,364270
130100,201905,1139,504,635,502992,633730,1136722
130110,201905,722,302,420,301396,419160,720556
130115,201905,170,73,97,72854,96806,169660
130120,201905,1634,1055,579,1053888,577842,1631730
130130,201905,612,422,190,421156,189620,610776
130140,201905,1508,1153,355,1150694,354290,1504984
130150,201905,425,367,58,366266,57884,424150
130160,201905,464,267,197,266466,196606,463072
130165,201905,41,34,7,33932,6986,40918
130170,201905,972,692,280,690552.12,279440,969992.12
130180,201905,172,112,60,111776,59880,171656
130185,201905,2421,1163,1258,1160674,1255484.8,2416158.8
130190,201905,3552,2238,1314,2234523.28,1311372,3545895.28
130195,201905,285,228,57,227544,56886,284430
130200,201905,174,83,91,82834,90818,173652
130210,201905,78,41,37,40918,36926,77844
130220,201905,181,124,57,123752,56886,180638
130230,201905,323,210,113,209580,113772,323352
130240,201905,1402,895,507,893210.99,505986,1399196.99
130250,201905,4851,3123,1728,3117752.4,1725542,4843294.4
130255,201905,429,210,219,209580,219560,429140
130260,201905,55596,26917,28679,26872076.35,28635619.15,55507695.50
130270,201905,1591,1064,527,1063957.82,525946,1589903.82
130280,201905,125,75,50,74850,49900,124750
130290,201905,2126,1528,598,1524944,598800,2123744
130300,201905,444,312,132,311376,131736,443112
130310,201905,883,461,422,460078,421156,881234
130320,201905,494,272,222,271456,221556,493012
130330,201905,737,452,285,451096,284430,735526
130340,201905,3524,2069,1455,2065860.8,1452090.8,3517951.6
130350,201905,459,299,160,298402,159680,458082
130353,201905,861,371,490,370258,489020,859278
130356,201905,827,381,446,380238,445108,825346
130360,201905,64,39,25,38922,24950,63872
130370,201905,680,518,162,516964,161676,678640
130380,201905,677,494,183,493012,182634,675646
130390,201905,490,390,100,389220,99800,489020
130395,201905,174,39,135,38922,134730,173652
130400,201905,64,44,20,43912,19960,63872
130406,201905,2063,1290,773,1288418.4,771455.28,2059873.68
130410,201905,473,211,262,210578,261476,472054
130420,201905,3158,2571,587,2565858.9,585826,3151684.9
130423,201905,159,78,81,77844,80838,158682
130426,201905,153,87,66,86826,65868,152694
130430,201905,406,262,144,261476,143712,405188
130440,201905,206,69,137,68862,136726,205588
140002,201905,33,11,22,10978,21956,32934
140005,201905,205,127,78,126746,77844,204590
140010,201905,10604,7032,3572,7018946.36,3565858.22,10584804.58
140015,201905,138,64,74,63872,73852,137724
140017,201905,117,81,36,80838,35928,116766
140020,201905,472,317,155,316366,154690,471056
140023,201905,46,25,21,24950.54,20958,45908.54
140028,201905,18,11,7,10978,6986,17964
140030,201905,350,251,99,250498,98802,349300
140040,201905,57,40,17,39920,16966,56886
140045,201905,237,107,130,106786,129740,236526
140047,201905,629,425,204,425148,203592,628740
140050,201905,144,92,52,91816,51896,143712
140060,201905,39,28,11,27944,10978,38922
140070,201905,34,31,3,30938,2994,33932
150010,201905,4679,2953,1726,2947094.4,1723546.4,4670640.8
150013,201905,159,113,46,112774,45908,158682
150020,201905,1071,588,483,586824,482034,1068858
150030,201905,697,292,405,291416,404190,695606
150034,201905,201,130,71,129740,70858,200598
150040,201905,1419,851,568,851294,567862,1419156
150050,201905,629,372,257,371256,256486,627742
150060,201905,4775,3108,1667,3101701.68,1669654.98,4771356.66
150070,201905,312,141,171,140718,170658,311376
150080,201905,14393,7245,7148,7231517.65,7135711.19,14367228.84
150085,201905,412,263,149,262474,148702,411176
150090,201905,756,644,112,642712,111776,754488
150095,201905,349,223,126,222554,125748,348302
150100,201905,58,39,19,38922,18962,57884
150110,201905,175,89,86,88822,85828,174650
150120,201905,426,314,112,313372,111776,425148
150125,201905,54,22,32,21956,31936,53892
150130,201905,1979,1068,911,1065864,909178,1975042
150140,201905,54284,25486,28798,25436042.24,28742424.28,54178466.52
150145,201905,184,102,82,101796,81836,183632
150150,201905,2898,1340,1558,1337320,1555882.8,2893202.8
150157,201905,409,289,120,288422.8,119760,408182.8
150160,201905,126,98,28,97804,27944,125748
150170,201905,3664,2747,917,2741506,915166,3656672
150172,201905,331,224,107,223552,106786,330338
150175,201905,80,50,30,49900,29940,79840
150178,201905,787,526,261,525946.4,261476,787422.4
150180,201905,3118,1538,1580,1534924.5,1576840.4,3111764.9
150190,201905,335,217,118,216566,117764,334330
150195,201905,118,60,58,59880,57884,117764
150200,201905,196,94,102,93812,101796,195608
150210,201905,3148,2569,579,2563862,577842.99,3141704.99
150215,201905,543,351,192,350298,191616.4,541914.4
150220,201905,3740,2555,1185,2549891.52,1182631.4,3732522.92
150230,201905,1168,951,217,949098.45,217564,1166662.45
150240,201905,5993,3543,2450,3535917.29,2445101.97,5981019.26
150250,201905,33,16,17,15968,16966,32934
150260,201905,81,50,31,49900,30938,80838
150270,201905,2321,1508,813,1504984,813370.8,2318354.8
150275,201905,545,347,198,346306,197604,543910
150276,201905,108,49,59,48902,58882,107784
150277,201905,762,332,430,331336.98,431136,762472.98
150280,201905,329,210,119,209580,118762,328342
150285,201905,88,45,43,44910,42914,87824
150290,201905,956,593,363,591814,362274.4,954088.4
150293,201905,650,312,338,311376,337324,648700
150295,201905,475,222,253,221556,254490,476046
150300,201905,78,41,37,40918,36926,77844
150304,201905,167,107,60,106786,59880,166666
150307,201905,387,323,64,322354,63872,386226
150309,201905,576,422,154,422154.98,153695.6,575850.58
150310,201905,246,164,82,163672,81836,245508
150320,201905,2034,1424,610,1421152,608780,2029932
150330,201905,2073,1204,869,1201592,867262,2068854
150340,201905,204,139,65,138722,64870,203592
150345,201905,610,344,266,343312,265468,608780
150350,201905,407,324,83,323352,82834,406186
150360,201905,4608,2976,1632,2970049.49,1629734,4599783.49
150370,201905,791,554,237,552892.98,236526.98,789419.96
150375,201905,195,103,92,102794,91816,194610
150380,201905,1443,981,462,979038,461076,1440114
150390,201905,753,434,319,433132.99,318362,751494.99
150400,201905,104,87,17,86826,16966,103792
150405,201905,1244,812,432,810376.92,431136,1241512.92
150410,201905,127,85,42,84830,41916,126746
150420,201905,7471,4110,3361,4102953.56,3359313.88,7462267.44
150430,201905,548,368,180,367264,179640,546904
150440,201905,570,347,223,346306,222554,568860
150442,201905,2248,1221,1027,1219556.58,1024946,2244502.58
150445,201905,536,349,187,348302,186626,534928
150450,201905,246,121,125,120758,124750,245508
150460,201905,741,562,179,560876.62,178642,739518.62
150470,201905,1328,812,516,811374,514968,1326342
150475,201905,224,175,49,174650,48902,223552
150480,201905,1269,895,374,893210,373252,1266462
150490,201905,601,330,271,329340,270458,599798
150495,201905,327,236,91,235528,90818,326346
150497,201905,296,198,98,198602,98802,297404
150500,201905,205,135,70,134730,69860,204590
150503,201905,915,456,459,455088.4,459081.43,914169.83
150506,201905,988,660,328,658680,327344,986024
150510,201905,1242,704,538,702592.4,536924,1239516.4
150520,201905,272,184,88,183632,87824,271456
150530,201905,1630,900,730,898200.5,728540,1626740.5
150540,201905,234,165,69,164670,68862,233532
150543,201905,773,430,343,430138,342314,772452
150548,201905,494,349,145,348302,144710,493012
150549,201905,61,44,17,43912,16966,60878
150550,201905,2844,1515,1329,1512968.5,1327340.4,2840308.9
150553,201905,3242,1927,1315,1925142.8,1313368,3238510.8
150555,201905,146,79,67,78842,66866,145708
150560,201905,17,10,7,9980,6986,16966
150563,201905,85,43,42,42914,41916,84830
150565,201905,169,103,66,102794,65868,168662
150570,201905,415,280,135,279440,134730,414170
150580,201905,1575,718,857,717562,855286,1572848
150590,201905,804,517,287,515966,286426,802392
150600,201905,457,280,177,279440,176646,456086
150610,201905,143,124,19,123752,18962,142714
150611,201905,120,82,38,81836,37924,119760
150613,201905,3228,1993,1235,1989014,1235524.98,3224538.98
150616,201905,497,298,199,297404.5,198602,496006.5
150618,201905,1276,694,582,692612.98,580836,1273448.98
150619,201905,402,307,95,306386,94810,401196
150620,201905,1273,756,517,755486,515966.99,1271452.99
150630,201905,294,195,99,194610,98802,293412
150635,201905,493,214,279,213572,278442,492014
150640,201905,57,28,29,27944,28942,56886
150650,201905,2362,1390,972,1387470.4,970057.39,2357527.79
150655,201905,247,185,62,184630,61876,246506
150658,201905,102,58,44,57884,43912,101796
150660,201905,504,354,150,353292,150698,503990
150670,201905,1015,372,643,372254.98,643710.98,1015965.96
150680,201905,9707,5333,4374,5324332.3,4370243.96,9694576.26
150690,201905,14,9,5,8982,4990,13972
150700,201905,493,328,165,327344,164670,492014
150710,201905,282,163,119,162674,118762,281436
150715,201905,838,513,325,511974.98,324350,836324.98
150720,201905,419,328,91,327344,90818,418162
150730,201905,976,523,453,522952.98,452094,975046.98
150740,201905,224,156,68,155688,67864,223552
150745,201905,807,442,365,441116,364270,805386
150746,201905,51,32,19,31936,18962,50898
150747,201905,248,194,54,193612,53892,247504
150750,201905,132,76,56,76846,55888,132734
150760,201905,1756,1156,600,1153688,598800,1752488
150770,201905,384,209,175,208582,174650,383232
150775,201905,98,44,54,43912,53892,97804
150780,201905,189,104,85,103792,84830,188622
150790,201905,860,477,383,476046,382234,858280
150795,201905,1503,898,605,898200,604788,1502988
150796,201905,374,216,158,215568,157684,373252
150797,201905,295,162,133,161676,132734,294410
150800,201905,1446,870,576,868260,575846.97,1444106.97
150803,201905,595,492,103,491016,102794,593810
150805,201905,191,121,70,120758,69860.99,190618.99
150808,201905,1007,552,455,550896,454090,1004986
150810,201905,3382,2361,1021,2358275.41,1018958.4,3377233.81
150812,201905,438,238,200,237524,199600,437124
150815,201905,970,642,328,640716,328342,969058
150820,201905,1560,957,603,956084,601794,1557878
150830,201905,794,575,219,573850,219560,793410
150835,201905,196,117,79,116766,78842,195608
150840,201905,1363,868,495,866264.2,494010,1360274.2
160005,201905,53,32,21,31936,20958,52894
160010,201905,188,119,69,118762,68862.99,187624.99
160015,201905,119,71,48,70858,47904,118762
160020,201905,131,75,56,74850,55888,130738
160021,201905,44,24,20,23952,19960,43912
160023,201905,121,77,44,76846,43912,120758
160025,201905,29,13,16,12974,15968,28942
160027,201905,1486,860,626,858280.5,625746,1484026.5
160030,201905,15726,8203,7523,8189598.16,7512954.21,15702552.37
160040,201905,300,176,124,175648,123752,299400
160050,201905,719,367,352,366266,351296.94,717562.94
160053,201905,322,187,135,186626.4,134730,321356.4
160055,201905,33,24,9,23952,8982,32934
160060,201905,6542,3485,3057,3478031.99,3051885.39,6529917.38
160070,201905,171,105,66,104790,65868,170658
160080,201905,89,45,44,44910,43912,88822
170025,201905,24,14,10,13972,9980,23952
170030,201905,225,184,41,183632.88,40918,224550.88
170035,201905,226,107,119,106786,118762,225548
170040,201905,179,140,39,139720,38922,178642
170070,201905,320,198,122,197604,121756,319360
170100,201905,364,264,100,263472,99800,363272
170105,201905,58,47,11,46906,10978,57884
170110,201905,110,70,40,69860,39920,109780
170130,201905,65,32,33,31936,32934.4,64870.4
170190,201905,96,62,34,61876,33932,95808
170200,201905,385,263,122,262474.98,121756.9,384231.88
170210,201905,6040,3218,2822,3212564.9,2818355.04,6030919.94
170215,201905,111,49,62,49900,61876,111776
170220,201905,1428,1058,370,1055884,369260,1425144
170230,201905,153,102,51,101796,50898,152694
170240,201905,531,355,176,354290.8,176646,530936.8
170255,201905,1107,893,214,891214,213572,1104786
170270,201905,40,29,11,28942,10978,39920
170290,201905,107,80,27,79840,26946,106786
170300,201905,90,61,29,60878,28942.4,89820.4
170305,201905,48,37,11,36926,10978,47904
170307,201905,61,46,15,45908,14970,60878
170310,201905,108,62,46,61876,45908,107784
170320,201905,23,18,5,17964,4990,22954
170330,201905,23,22,1,21956,998,22954
170360,201905,28,17,11,16966,10978,27944
170370,201905,125,66,59,65868,58882,124750
170380,201905,83,64,19,63872,18962,82834
170382,201905,44,39,5,38922,4990,43912
170384,201905,143,108,35,107784,34930,142714
170386,201905,61,26,35,25948,34930,60878
170388,201905,48,19,29,18962,28942,47904
170389,201905,25,20,5,19960,4990,24950
170390,201905,60,36,24,36926.98,23952,60878.98
170410,201905,32,23,9,22954,8982,31936
170460,201905,16,12,4,11976,3992,15968
170510,201905,34,27,7,26946,6986,33932
170550,201905,1531,900,631,900196,631734,1531930
170555,201905,111,80,31,79840,30938,110778
170560,201905,99,72,27,71856,26946,98802
170600,201905,37,18,19,17964,18962,36926
170610,201905,191,102,89,101796,88824.36,190620.36
170625,201905,35,20,15,19960,14970,34930
170650,201905,79,60,19,60878,18962,79840
170700,201905,577,439,138,438122.5,137724,575846.5
170710,201905,161,99,62,98802,61877.96,160679.96
170720,201905,86,69,17,68862,16966,85828
170730,201905,78,46,32,45908,31936,77844
170740,201905,91,68,23,67864,22954,90818
170755,201905,66,35,31,34930,30938,65868
170765,201905,136,71,65,70858.39,64870,135728.39
170770,201905,219,134,85,133732,84830,218562
170820,201905,599,396,203,396206,202594.8,598800.8
170825,201905,32,18,14,17964,13972,31936
170830,201905,85,68,17,67864,16966,84830
170900,201905,189,148,41,147704,40918,188622
170930,201905,880,470,410,469061.03,409180.4,878241.43
170950,201905,3090,1403,1687,1401193.38,1683628.05,3084821.43
170980,201905,18,10,8,9980,7984,17964
171050,201905,145,115,30,114770,29940,144710
171070,201905,38,32,6,31936,5988,37924
171090,201905,45,33,12,32934,11976,44910
171110,201905,21,13,8,12974,7984,20958
171150,201905,42,21,21,20958,20958,41916
171180,201905,25,13,12,12974,11976,24950
171190,201905,146,85,61,84830,60878,145708
171195,201905,61,50,11,49900,11976,61876
171200,201905,49,25,24,24950,23952,48902
171215,201905,5,3,2,2994,1996,4990
171240,201905,55,45,10,44910,9980,54890
171245,201905,55,49,6,48902,5988,54890
171250,201905,72,40,32,39920,31936,71856
171270,201905,16,12,4,11976,3992,15968
171280,201905,40,36,4,35928.7,3992,39920.7
171320,201905,991,582,409,580836,408182,989018
171330,201905,430,210,220,209580,219560,429140
171360,201905,87,64,23,63872,22954,86826
171370,201905,28,16,12,15968,11976,27944
171380,201905,136,111,25,110778,24950,135728
171395,201905,55,36,19,35928,18962,54890
171420,201905,294,193,101,192614,100798,293412
171430,201905,70,58,12,57884,11976,69860
171488,201905,182,100,82,99800,82834,182634
171500,201905,56,30,26,29940,25948,55888
171510,201905,67,45,22,44910,21956,66866
171515,201905,42,35,7,34930,6986.4,41916.4
171525,201905,29,27,2,26946,1996,28942
171550,201905,13,9,4,8982,3992,12974
171570,201905,57,29,28,28942,27944,56886
171575,201905,324,208,116,207584,115768,323352
171610,201905,1740,888,852,887228.84,850306.78,1737535.62
171620,201905,135,95,40,94810,39920,134730
171630,201905,53,27,26,26946,25948,52894
171650,201905,274,184,90,183632,89820,273452
171660,201905,266,147,119,146706,118762.4,265468.4
171665,201905,54,38,16,37924,15968,53892
171670,201905,428,249,179,248502.5,178642,427144.5
171700,201905,66,59,7,58882,6986,65868
171720,201905,25,10,15,9980,14970,24950
171750,201905,101,55,46,54890,45908,100798
171780,201905,77,62,15,61876,14970,76846
171790,201905,78,67,11,66866,10978,77844
171800,201905,39,31,8,30938,7984,38922
171820,201905,2092,1217,875,1214566.44,873251.78,2087818.22
171830,201905,35,28,7,27944,6986,34930
171840,201905,61,40,21,39920,20958,60878
171845,201905,30,18,12,17964,11976,29940
171850,201905,39,29,10,28942,9980,38922
171855,201905,78,62,16,61876,15968,77844
171865,201905,9,8,1,7984,998,8982
171870,201905,33,23,10,22954,9980,32934
171875,201905,81,57,24,56886,23952,80838
171880,201905,35,23,12,22954,11976,34930
171884,201905,48,25,23,24950,22954,47904
171886,201905,123,49,74,48902,73852,122754
171888,201905,27,21,6,20958,5988,26946
171889,201905,19,14,5,13972,4990,18962
171890,201905,59,49,10,48902,9980,58882
171900,201905,42,29,13,28942,12974,41916
172000,201905,40,33,7,32934,6986,39920
172010,201905,45,37,8,36926,7984,44910
172015,201905,29,20,9,19960.58,8982,28942.58
172020,201905,138,88,50,87824,49900,137724
172025,201905,31,20,11,19960,10978,30938
172030,201905,40,24,16,23952,15968.98,39920.98
172049,201905,78,50,28,49900,27944,77844
172065,201905,147,95,52,94810,51896,146706
172080,201905,98,66,32,65868,31936,97804
172085,201905,25,13,12,12974,11976,24950
172090,201905,419,329,90,328342,89820,418162
172093,201905,22,19,3,18962,2994,21956
172097,201905,17,10,7,9980,6986.4,16966.4
172100,201905,4922,2821,2101,2816358.84,2098795.98,4915154.82
172110,201905,80,53,27,52894,26946,79840
172120,201905,1679,1438,241,1435125.5,241516.96,1676642.46
172125,201905,3,3,0,2994,0,2994
172130,201905,18,13,5,12974,4990,17964
172208,201905,198,125,73,124750,72854,197604
172210,201905,391,192,199,191616,198602.4,390218.4
210005,201905,2958,1859,1099,1855282.75,1097804.8,2953087.55
210010,201905,179,93,86,92814,85828,178642
210015,201905,39,29,10,28942,9980,38922
210020,201905,349,191,158,190618,157684,348302
210030,201905,336,216,120,215568,119760.98,335328.98
210040,201905,143,112,31,111776,30938,142714
210043,201905,264,192,72,191616,71856,263472
210047,201905,579,322,257,321356,256486,577842
210050,201905,298,221,77,220558,76846,297404
210055,201905,44,33,11,32934,10978,43912
210060,201905,564,453,111,452094,110778,562872
210070,201905,417,316,101,315368,100798,416166
210080,201905,108,98,10,97804,9980,107784
210083,201905,307,145,162,144710,161676,306386
210087,201905,39,29,10,28942,9980,38922
210090,201905,473,335,138,334330,137724,472054
210095,201905,470,348,122,347304,121756,469060
210100,201905,691,539,152,537922,151696,689618
210110,201905,142,85,57,84830,56886,141716
210120,201905,5322,4098,1224,4093805.08,1223549.53,5317354.61
210125,201905,209,126,83,125748,82834,208582
210130,201905,516,286,230,285428,229540,514968
210135,201905,32,19,13,18962,12974,31936
210140,201905,4412,3473,939,3471044.6,938120,4409164.6
210150,201905,373,240,133,239520,133732,373252
210160,201905,3414,2882,532,2876236.55,531934,3408170.55
210170,201905,1207,964,243,962072,242514,1204586
210173,201905,133,113,20,112774,19960,132734
210177,201905,424,221,203,220558,202594,423152
210180,201905,32,18,14,17964,13972,31936
210190,201905,418,278,140,277444,139720,417164
210193,201905,2,1,1,998,998,1996
210197,201905,81,55,26,54890,25948,80838
210200,201905,639,513,126,511974,125748,637722
210203,201905,252,171,81,171656,80838,252494
210207,201905,382,301,81,300398,80838,381236
210210,201905,778,722,56,720556,55888,776444
210215,201905,80,70,10,69860,9980,79840
210220,201905,405,337,68,336326,67864,404190
210230,201905,308,238,70,237524,69860,307384
210232,201905,1463,969,494,967062,493012,1460074
210235,201905,162,127,35,126746.6,34930,161676.6
210237,201905,43,25,18,24950,17964,42914
210240,201905,90,75,15,74850,14970,89820
210250,201905,193,160,33,159680,32934,192614
210255,201905,359,269,90,268462,89820,358282
210260,201905,413,273,140,272454,139720,412174
210270,201905,680,444,236,443112,236526,679638
210275,201905,56,43,13,42914,12974,55888
210280,201905,1064,698,366,696604.48,365268,1061872.48
210290,201905,511,348,163,347304,162674,509978
210300,201905,5784,3533,2251,3526932.39,2249492.97,5776425.36
210310,201905,112,79,33,78842,32934,111776
210312,201905,117,80,37,79840,36926,116766
210315,201905,114,87,27,86826,26946,113772
210317,201905,125,92,33,91816,32934,124750
210320,201905,2373,1988,385,1984024.96,384230,2368254.96
210325,201905,130,92,38,91816,37924.4,129740.4
210330,201905,5127,2797,2330,2791406.7,2328334,5119740.7
210340,201905,1339,976,363,974048,362275.94,1336323.94
210350,201905,622,517,105,515966,104790,620756
210355,201905,148,119,29,118762,28942,147704
210360,201905,2521,1641,880,1637718.06,878240.4,2515958.46
210370,201905,1247,575,672,573850,672652,1246502
210375,201905,195,101,94,100798,93812,194610
210380,201905,719,547,172,545906,171656,717562
210390,201905,201,168,33,167664,32934,200598
210400,201905,419,358,61,357284,60878.96,418162.96
210405,201905,1017,703,314,701594,313372,1014966
210407,201905,55,44,11,44910,10978,55888
210408,201905,62,56,6,55888,5988,61876
210409,201905,333,285,48,284430,47904,332334
210410,201905,442,347,95,346306,94810,441116
210420,201905,205,168,37,167664,36926,204590
210430,201905,42,28,14,27944,13972,41916
210440,201905,358,227,131,226546,130738,357284
210450,201905,156,121,35,120758,34930,155688
210455,201905,231,127,104,126746,104790,231536
210460,201905,328,212,116,211576,115768,327344
210462,201905,67,56,11,55888,10978,66866
210465,201905,163,119,44,118762,43912,162674
210467,201905,535,390,145,389220,144710.98,533930.98
210470,201905,48,41,7,40918,6986,47904
210480,201905,1320,941,379,940116,378242.07,1318358.07
210490,201905,214,138,76,137724,75848,213572
210500,201905,558,314,244,314370,244510,558880
210510,201905,577,454,123,453092,122754,575846
210515,201905,412,238,174,237524,173652,411176
210520,201905,416,366,50,365268,49900,415168
210530,201905,9467,5090,4377,5081821.92,4371243.62,9453065.54
210535,201905,129,96,33,95808,32934,128742
210540,201905,1539,977,562,975046.2,560876,1535922.2
210542,201905,1200,606,594,604788,593810.4,1198598.4
210545,201905,16,15,1,14970,998,15968
210547,201905,132,114,18,113772,17964,131736
210550,201905,720,519,201,517963.4,200598,718561.4
210560,201905,176,150,26,149700,25948,175648
210565,201905,26,20,6,19960,5988,25948
210570,201905,1358,1086,272,1083828.44,271456,1355284.44
210580,201905,116,100,16,99800,15968,115768
210590,201905,775,628,147,626744,146706,773450
210592,201905,32,29,3,28942,2994,31936
210594,201905,106,88,18,87824,17964,105788
210596,201905,96,81,15,80838,14970,95808
210598,201905,126,94,32,93812,31936,125748
210600,201905,338,288,50,287424,49900,337324
210610,201905,256,238,18,237524,17964,255488
210620,201905,45,27,18,26946,17964,44910
210630,201905,69,66,3,65868,2994,68862
210632,201905,1060,721,339,719558,338322,1057880
210635,201905,20,17,3,16966,2994,19960
210637,201905,102,72,30,71856,29940,101796
210640,201905,588,515,73,513970,72854,586824
210650,201905,411,338,73,337324,72854,410178
210660,201905,393,292,101,291416,100798.14,392214.14
210663,201905,24,15,9,14970,8982,23952
210667,201905,112,36,76,35928,75848,111776
210670,201905,265,233,32,232534,31936,264470
210675,201905,571,306,265,305388,265468,570856
210680,201905,215,139,76,138722,75848,214570
210690,201905,642,515,127,514968,126746,641714
210700,201905,178,131,47,130738,46906,177644
210710,201905,280,166,114,165668,113772,279440
210720,201905,135,117,18,116766,17964,134730
210725,201905,69,61,8,60878,7984,68862
210730,201905,25,18,7,17964,6986,24950
210735,201905,404,279,125,278442,124750.4,403192.4
210740,201905,560,477,83,476046,82834,558880
210745,201905,160,119,41,118762,40918,159680
210750,201905,2455,1186,1269,1185624.5,1267460.4,2453084.9
210760,201905,270,204,66,203592,65868,269460
210770,201905,402,315,87,314370,87824,402194
210780,201905,421,311,110,310378,109780,420158
210790,201905,186,147,39,146706,38922,185628
210800,201905,168,127,41,126746,40918,167664
210805,201905,53,49,4,48902,3992,52894
210810,201905,489,387,102,386226,101796,488022
210820,201905,2283,1860,423,1859275.76,423152,2282427.76
210825,201905,166,89,77,88822,76846,165668
210830,201905,769,492,277,492014,276446,768460
210840,201905,205,140,65,139720,64870,204590
210845,201905,256,169,87,168662,86826,255488
210850,201905,806,528,278,526944,277444,804388
210860,201905,4015,2160,1855,2155680.9,1852288,4007968.9
210870,201905,481,369,112,368262,111776,480038
210880,201905,74,57,17,56886,16966,73852
210890,201905,338,286,52,285428,51896,337324
210900,201905,612,394,218,393212,218562,611774
210905,201905,65,32,33,31936,32934,64870
210910,201905,2017,1515,502,1511971.48,500996,2012967.48
210920,201905,197,65,132,64870,131736,196606
210923,201905,81,57,24,56886,23952,80838
210927,201905,426,190,236,189620,235528,425148
210930,201905,73,58,15,57884,14970,72854
210940,201905,91,72,19,71856,18962,90818
210945,201905,205,102,103,101796,102794,204590
210950,201905,527,391,136,390218,136726,526944
210955,201905,75,50,25,49900,24950,74850
210960,201905,2340,1081,1259,1078838,1257480,2336318
210970,201905,117,104,13,103792,12974,116766
210975,201905,88,79,9,78842,8982,87824
210980,201905,1158,535,623,533930,621754.4,1155684.4
210990,201905,4244,2705,1539,2702585,1539914,4242499
211000,201905,1365,1092,273,1089816.4,274450,1364266.4
211003,201905,896,624,272,622752,272454.98,895206.98
211010,201905,502,445,57,445108,57884,502992
211020,201905,1577,612,965,610776,964068,1574844
211023,201905,33,28,5,27944,4990,32934
211027,201905,72,52,20,51896,19960,71856
211030,201905,392,274,118,273452,118762,392214
211040,201905,316,255,61,254490.4,60878,315368.4
211050,201905,1185,777,408,776444,408182.4,1184626.4
211060,201905,676,579,97,577842.96,96806,674648.96
211065,201905,21,17,4,16966,3992,20958
211070,201905,923,760,163,758480.66,162674,921154.66
211080,201905,87,83,4,82834,3992,86826
211085,201905,59,30,29,29940.4,28942,58882.4
211090,201905,93,75,18,74850,17964,92814
211100,201905,501,406,95,405188,94810.4,499998.4
211102,201905,255,172,83,171656,82834,254490
211105,201905,224,157,67,156686,66866,223552
211107,201905,133,78,55,77844,54890,132734
211110,201905,839,550,289,549898,289420.98,839318.98
211120,201905,5747,2698,3049,2692606.2,3046895.72,5739501.92
211125,201905,31,24,7,23952,6986,30938
211130,201905,44738,19638,25100,19606718.96,25079748.33,44686467.29
211140,201905,431,371,60,371256.99,59880,431136.99
211150,201905,1301,833,468,831334,467065.39,1298399.39
211153,201905,168,100,68,99800,67864,167664
211157,201905,64,50,14,49900,13972,63872
211160,201905,713,601,112,600796,111776,712572
211163,201905,0,,,,,0.0
211167,201905,10,9,1,8982,998,9980
211170,201905,436,315,121,314370,120758,435128
211172,201905,121,84,37,83832,36926,120758
211174,201905,264,161,103,160678,102794,263472
211176,201905,504,372,132,371256,131736,502992
211178,201905,91,61,30,60878,29940,90818
211180,201905,207,167,40,166666,39920,206586
211190,201905,70,65,5,64870,4990,69860
211195,201905,34,24,10,23952,9980,33932
211200,201905,152,131,21,130738,20958,151696
211210,201905,503,328,175,327344,174650,501994
211220,201905,4106,2360,1746,2357278.53,1743507.99,4100786.52
211223,201905,95,91,4,90818,3992,94810
211227,201905,72,54,18,53892,17964,71856
211230,201905,768,627,141,625746,140718,766464
211240,201905,415,316,99,315368,98802,414170
211245,201905,193,93,100,92814,99800,192614
211250,201905,1628,1401,227,1398199.59,226546.94,1624746.53
211260,201905,835,671,164,669658,163672,833330
211270,201905,2055,1653,402,1649694,401196.8,2050890.8
211280,201905,1866,1161,705,1158678,705586,1864264
211285,201905,202,122,80,121756,79840,201596
211290,201905,689,475,214,474050,213572,687622
211300,201905,808,636,172,634728.96,171656,806384.96
211400,201905,1581,941,640,939118,639718,1578836
220005,201905,17,16,1,15968,998,16966
220010,201905,89,67,22,66866,21956,88822
220020,201905,655,525,130,523950,129740,653690
220025,201905,110,107,3,106786,2994,109780
220027,201905,39,32,7,31936,6986,38922
220030,201905,107,89,18,88822,17964,106786
220040,201905,1211,920,291,918160.6,290418,1208578.6
220045,201905,39,28,11,27944,10978,38922
220050,201905,686,578,108,576845.08,107784,684629.08
220060,201905,173,151,22,150698,21956,172654
220070,201905,106,98,8,97804,7984,105788
220080,201905,16,14,2,13972,1996,15968
220090,201905,34,28,6,27944,5988,33932
220095,201905,2,1,1,998,998,1996
220100,201905,23,19,4,18962,3992,22954
220105,201905,24,23,1,22954.4,998,23952.4
220110,201905,224,205,19,204590,18962,223552
220115,201905,46,45,1,44910,998,45908
220117,201905,23,21,2,20958,1996,22954
220120,201905,1508,1120,388,1117760,387224,1504984
220130,201905,30,30,0,29940,0,29940
220140,201905,100,79,21,78842,20958,99800
220150,201905,494,360,134,359280,133732,493012
220155,201905,5,5,0,4990,0,4990
220157,201905,18,15,3,14970,2994,17964
220160,201905,80,70,10,69860,9980,79840
220170,201905,34,33,1,32934,998,33932
220173,201905,7,7,0,6986,0,6986
220177,201905,6,6,0,5988,0,5988
220180,201905,67,67,0,66866,0,66866
220190,201905,1069,958,111,956084,110778,1066862
220191,201905,44,39,5,38922,4990,43912
220192,201905,72,69,3,68862,2994,71856
220194,201905,44,42,2,41916,1996,43912
220196,201905,97,82,15,81836,14970,96806
220198,201905,4,3,1,2994,998,3992
220200,201905,424,355,69,354290.5,68862,423152.5
220202,201905,37,33,4,32934,3992,36926
220205,201905,43,39,4,38922,3992,42914
220207,201905,13,12,1,11976,998,12974
220208,201905,80,44,36,43912,35928,79840
220209,201905,31,28,3,27944,2994,30938
220210,201905,16,14,2,13972,1996,15968
220211,201905,26,25,1,24950,998,25948
220213,201905,40,36,4,35928,3992.4,39920.4
220217,201905,40,32,8,31936,7984,39920
220220,201905,2113,1376,737,1373248,735527.1,2108775.1
220225,201905,11,5,6,4990,5988,10978
220230,201905,972,771,201,769458,200598,970056
220240,201905,161,148,13,147704,12974,160678
220245,201905,32,29,3,28942.99,2994,31936.99
220250,201905,118,106,12,106786,11976,118762
220253,201905,41,36,5,35928,4990,40918
220255,201905,29,26,3,25948,2994,28942
220260,201905,701,516,185,515966,184630,700596
220265,201905,11,9,2,8982,1996,10978
220270,201905,738,660,78,658680,77844,736524
220271,201905,42,35,7,34930,6986,41916
220272,201905,26,26,0,25948,0,25948
220273,201905,13,12,1,11976,998,12974
220275,201905,54,44,10,43912,9980,53892
220277,201905,11,9,2,8982,1996,10978
220280,201905,14,11,3,10978,2994,13972
220285,201905,46,43,3,42914,2994,45908
220290,201905,1461,1256,205,1254486.4,204590.9,1459077.3
220300,201905,49,47,2,46906,1996,48902
220310,201905,314,267,47,266466.99,46906.98,313373.97
220320,201905,440,407,33,406186.4,32934,439120.4
220323,201905,0,,,,,0.0
220325,201905,14,9,5,8982,4990,13972
220327,201905,12,11,1,10978,998,11976
220330,201905,216,154,62,153692,61876,215568
220335,201905,136,118,18,117764,17964,135728
220340,201905,36,22,14,21956,13972,35928
220342,201905,60,53,7,52894,6986,59880
220345,201905,82,76,6,75848,5988,81836
220350,201905,434,381,53,380238,52894,433132
220360,201905,42,30,12,29940,11976,41916
220370,201905,1194,979,215,978040,215568,1193608
220375,201905,21,19,2,18962,1996,20958
220380,201905,19,16,3,15968,2994,18962
220385,201905,17,15,2,14970,1996,16966
220390,201905,2323,1334,989,1331332.84,987022.7,2318355.54
220400,201905,31,28,3,27944,2994,30938
220410,201905,19,18,1,17964,998,18962
220415,201905,13,12,1,11976,998,12974
220420,201905,127,106,21,105788,20958,126746
220430,201905,133,120,13,119760,12974,132734
220435,201905,20,14,6,13972,5988,19960
220440,201905,300,257,43,256486,42914,299400
220450,201905,339,175,164,174650,163672,338322
220455,201905,55,53,2,52894,1996,54890
220460,201905,20,20,0,19960,0,19960
220465,201905,104,68,36,67864,35928,103792
220470,201905,239,209,30,208582,29940,238522
220480,201905,71,63,8,62874,7984,70858
220490,201905,91,78,13,77844,12974,90818
220500,201905,95,82,13,81836,12974,94810
220510,201905,445,345,100,344310,99800,444110
220515,201905,23,21,2,20958,1996,22954
220520,201905,378,339,39,338322.34,38922,377244.34
220525,201905,17,12,5,11976,4990,16966
220527,201905,32,25,7,24950,6986,31936
220530,201905,35,14,21,13972,20958,34930
220535,201905,5,5,0,4990,0,4990
220540,201905,61,50,11,49900,10978,60878
220545,201905,50,36,14,35928,13972,49900
220550,201905,664,517,147,515966,146706,662672
220551,201905,20,15,5,14970,4990,19960
220552,201905,14,14,0,13972,0,13972
220553,201905,49,45,4,44910,3992,48902
220554,201905,10,7,3,6986,2994,9980
220555,201905,31,27,4,26946,3992,30938
220556,201905,48,44,4,43912,3992,47904
220557,201905,54,50,4,50898,4990,55888
220558,201905,7,3,4,2994,3992,6986
220559,201905,3,3,0,2994,0,2994
220560,201905,69,45,24,44910,23952,68862
220570,201905,789,488,301,487024.4,301396,788420.4
220580,201905,559,515,44,513970,43912,557882
220585,201905,6,5,1,4990,998,5988
220590,201905,14,14,0,13972,0,13972
220595,201905,62,47,15,46906,14970,61876
220600,201905,20,13,7,12974,6986,19960
220605,201905,22,20,2,19960,1996,21956
220610,201905,70,62,8,61876,7984,69860
220620,201905,569,461,108,460078,107784,567862
220630,201905,5,4,1,3992,998,4990
220635,201905,37,33,4,32934,3992,36926
220640,201905,102,81,21,80838,20958,101796
220650,201905,113,106,7,105788,6986,112774
220660,201905,39,31,8,30938,7984,38922
220665,201905,4,4,0,3992,0,3992
220667,201905,21,19,2,18962,1996,20958
220669,201905,29,26,3,25948,2994,28942
220670,201905,65,53,12,52894,11976,64870
220672,201905,65,45,20,44910,19960,64870
220675,201905,37,29,8,28942,7984,36926
220680,201905,41,35,6,34930,5988,40918
220690,201905,44,42,2,41916,1996,43912
220695,201905,50,23,27,22954,26946,49900
220700,201905,1698,1311,387,1308378.4,387224,1695602.4
220710,201905,4,3,1,2994,998,3992
220720,201905,108,88,20,87824,19960,107784
220730,201905,18,18,0,17964,0,17964
220735,201905,3,1,2,998,1996,2994
220740,201905,49,45,4,44910,3992,48902
220750,201905,107,91,16,90818,15968,106786
220755,201905,16,16,0,15968,0,15968
220760,201905,61,58,3,57884,2994,60878
220770,201905,5757,3065,2692,3059870.66,2687617.32,5747487.98
220775,201905,20,10,10,9980,9980,19960
220777,201905,17,16,1,15968,998,16966
220779,201905,0,0,0,0,0,0
220780,201905,893,766,127,764468,126746.4,891214.4
220785,201905,4,1,3,998,2994,3992
220790,201905,1063,854,209,852292.82,208582,1060874.82
220793,201905,8,8,0,7984,0,7984
220795,201905,17,16,1,15968,998,16966
220800,201905,4018,3092,926,3087814.88,927142.99,4014957.87
220810,201905,68,60,8,59880.4,7984,67864.4
220820,201905,247,226,21,225548,20958,246506
220830,201905,1234,1067,167,1064866,166666,1231532
220840,201905,2415,1690,725,1687621.33,724548.78,2412170.11
220850,201905,51,43,8,42914,7984,50898
220855,201905,9,6,3,5988,2994,8982
220860,201905,12,11,1,10978,998,11976
220865,201905,27,25,2,24950,1996,26946
220870,201905,67,62,5,61876,4990,66866
220880,201905,329,255,74,254490,73852.4,328342.4
220885,201905,37,34,3,33932,2994,36926
220887,201905,15,15,0,14970,0,14970
220890,201905,101,89,12,88822,11976,100798
220900,201905,20,13,7,12974,6986,19960
220910,201905,57,48,9,47904,8982,56886
220915,201905,10,9,1,8982,998,9980
220920,201905,50,46,4,45908,3992,49900
220930,201905,42,41,1,40918,998,41916
220935,201905,18,18,0,17964,0,17964
220937,201905,40,39,1,38922,998,39920
220940,201905,57,52,5,51896,4990,56886
220945,201905,0,,,,,0.0
220950,201905,46,41,5,40918,4990,45908
220955,201905,27,24,3,23952,2994,26946
220960,201905,6,6,0,5988,0,5988
220965,201905,34,31,3,30938,2994,33932
220970,201905,56,46,10,46906,9980,56886
220975,201905,10,8,2,7984,1996,9980
220980,201905,33,31,2,30938,1996,32934
220985,201905,67,59,8,58882,7984,66866
220987,201905,32,30,2,29940,1996,31936
220990,201905,19,18,1,17964,998,18962
220995,201905,24,19,5,18962,4990,23952
220997,201905,56,46,10,45908,9980,55888
221000,201905,1152,1041,111,1038918,110778,1149696
221005,201905,60,53,7,52894,6986,59880
221010,201905,17,13,4,12974,3992,16966
221020,201905,43,41,2,40918,1996,42914
221030,201905,33,27,6,26946,5988,32934
221035,201905,24,24,0,23952,0,23952
221037,201905,10,6,4,5988,3992,9980
221038,201905,28,25,3,24950,2994,27944
221039,201905,22,22,0,21956,0,21956
221040,201905,258,222,36,221556,35928,257484
221050,201905,236,204,32,203592,31936,235528
221060,201905,1846,1632,214,1628736,213572,1842308
221062,201905,35,33,2,32934,1996,34930
221063,201905,13,9,4,8982,3992,12974
221065,201905,53,46,7,45908,6986,52894
221070,201905,142,123,19,122754,18962,141716
221080,201905,378,331,47,330338,46906,377244
221090,201905,30,29,1,28942,998,29940
221093,201905,53,36,17,35928,16966,52894
221095,201905,9,9,0,8982,0,8982
221097,201905,17,14,3,13972,2994,16966
221100,201905,25387,14944,10443,14935077.92,10501956.78,25437034.70
221110,201905,1069,802,267,800396.4,266466,1066862.4
221120,201905,533,402,131,401196.4,130738,531934.4
221130,201905,970,795,175,793410,174650,968060
221135,201905,34,31,3,30938,2994,33932
221140,201905,44,37,7,36926,6986,43912
221150,201905,12,9,3,8982,2994,11976
221160,201905,14,13,1,12974,998,13972
221170,201905,14,14,0,13972,0,13972
230010,201905,166,151,15,150698,14970,165668
230015,201905,126,104,22,103792,21956,125748
230020,201905,1648,1394,254,1392210.4,253499.76,1645710.16
230030,201905,1683,1215,468,1212571.78,468062,1680633.78
230040,201905,209,182,27,181636.4,26946,208582.4
230050,201905,219,162,57,161676,56886,218562
230060,201905,159,128,31,127744,30938,158682
230070,201905,294,264,30,264470,29940,294410
230075,201905,850,745,105,743510.8,104790,848300.8
230080,201905,195,169,26,168662,25948,194610
230090,201905,111,78,33,77844,32934,110778
230100,201905,2018,1201,817,1200598.02,817363.88,2017961.90
230110,201905,2776,1805,971,1803386.8,970056,2773442.8
230120,201905,969,779,190,777443.54,189620,967063.54
230125,201905,149,124,25,123752,24950,148702
230130,201905,476,426,50,426146,49900,476046
230140,201905,213,184,29,183632,28942,212574
230150,201905,156,121,35,120758,34930,155688
230160,201905,948,814,134,812372,133732,946104
230170,201905,596,545,51,543911,50898,594809
230180,201905,79,74,5,73852,4990,78842
230185,201905,413,358,55,357284,54890,412174
230190,201905,2290,1842,448,1839315.74,447104,2286419.74
230195,201905,488,425,63,424150,62874,487024
230200,201905,384,332,52,331336,51896,383232
230205,201905,381,245,136,244510,135728,380238
230210,201905,1289,1026,263,1023950.22,262474.94,1286425.16
230220,201905,1551,1060,491,1057880,490019.88,1547899.88
230230,201905,896,774,122,773450,121756,895206
230240,201905,1714,1475,239,1472300.86,238522.12,1710822.98
230250,201905,1812,1498,314,1495005.58,313372,1808377.58
230260,201905,3088,1917,1171,1913166,1169656,3082822
230270,201905,1377,1110,267,1107782.17,266466,1374248.17
230280,201905,2753,2067,686,2062867.27,684628,2747495.27
230290,201905,410,365,45,364273.61,44910,409183.61
230300,201905,518,385,133,385228,132734,517962
230310,201905,424,322,102,321356,101796,423152
230320,201905,943,805,138,803391.4,137724,941115.4
230330,201905,307,247,60,246506,59880.6,306386.6
230340,201905,451,363,88,362274.6,87824,450098.6
230350,201905,3098,1982,1116,1978036.94,1116762,3094798.94
230360,201905,271,215,56,214570,55888,270458
230365,201905,138,111,27,110778,26946,137724
230370,201905,9853,4908,4945,4902222.55,4939172.01,9841394.56
230380,201905,480,413,67,412175.36,67864.2,480039.56
230390,201905,522,292,230,291416,229540,520956
230393,201905,261,220,41,219560,40918,260478
230395,201905,359,288,71,288422.48,70858,359280.48
230400,201905,606,482,124,481036,123752,604788
230410,201905,2662,1674,988,1670653.09,986025.94,2656679.03
230420,201905,6311,4193,2118,4187611.84,2121750.56,6309362.40
230423,201905,320,278,42,277444,41916,319360
230425,201905,385,317,68,316366.34,67864,384230.34
230426,201905,125,101,24,100798,24950,125748
230427,201905,80,77,3,76846,2994,79840
230428,201905,1444,734,710,734528.96,708581.88,1443110.84
230430,201905,463,379,84,378242.99,83832,462074.99
230435,201905,848,598,250,596804.31,250498.98,847303.29
230440,201905,86019,38567,47452,38522054.59,47406330.12,85928384.71
230445,201905,292,205,87,204590,86826,291416
230450,201905,541,435,106,434130,105788,539918
230460,201905,59,49,10,48902,9980,58882
230465,201905,308,251,57,251496,56886,308382
230470,201905,1976,1557,419,1553886.94,418162.5,1972049.44
230480,201905,159,150,9,150698,8982,159680
230490,201905,295,237,58,236526,57884,294410
230495,201905,457,340,117,339320,116766,456086
230500,201905,997,740,257,738520,257484,996004
230510,201905,52,41,11,40918,10978,51896
230520,201905,390,306,84,305388.18,84830,390218.18
230523,201905,2223,1423,800,1421153.92,800397.11,2221551.03
230526,201905,289,241,48,240518,47904,288422
230530,201905,677,507,170,505986.94,169660,675646.94
230533,201905,193,184,9,183632,8982,192614
230535,201905,362,272,90,271456,89820,361276
230540,201905,1867,1651,216,1648696,215568,1864264
230550,201905,3758,2420,1338,2418157.32,1337320,3755477.32
230560,201905,581,445,136,444110.8,135728.94,579839.74
230565,201905,214,157,57,156686,56886,213572
230570,201905,301,265,36,264470,35928,300398
230580,201905,1140,850,290,848300.94,289420,1137720.94
230590,201905,982,766,216,764469.46,215568,980037.46
230600,201905,251,228,23,227544,22954,250498
230610,201905,356,286,70,285428.6,69860,355288.6
230620,201905,171,141,30,140718,29940,170658
230625,201905,733,532,201,530936.6,201596.94,732533.54
230630,201905,1315,1041,274,1039916,273452,1313368
230640,201905,3715,3227,488,3220547,490020.61,3710567.61
230650,201905,431,377,54,376247.91,53892,430139.91
230655,201905,669,581,88,579839.54,87827.89,667667.43
230660,201905,360,305,55,304390,54890,359280
230670,201905,434,381,53,380238,52894,433132
230680,201905,201,182,19,181636,18962,200598
230690,201905,888,772,116,770456,115768,886224
230700,201905,767,649,118,647702.94,117764.94,765467.88
230710,201905,735,699,36,698600.6,35928,734528.6
230720,201905,147,129,18,128742,17964,146706
230725,201905,261,211,50,210578,49900.98,260478.98
230730,201905,11345,6181,5164,6172632.26,5155673.29,11328305.55
230740,201905,674,544,130,543910.4,129740,673650.4
230750,201905,835,717,118,716564.6,117764,834328.6
230760,201905,1402,1210,192,1207580,192614,1400194
230763,201905,310,260,50,259480,49900,309380
230765,201905,7222,3430,3792,3425178.76,3791447.19,7216625.95
230770,201905,5003,2585,2418,2581832.06,2416159.34,4997991.40
230780,201905,692,610,82,608780.96,81836,690616.96
230790,201905,241,199,42,198602,41916,240518
230800,201905,1134,832,302,830336,302394,1132730
230810,201905,1345,1197,148,1194606,147704,1342310
230820,201905,354,251,103,250498.4,102794,353292.4
230830,201905,960,825,135,823350,134730,958080
230835,201905,283,248,35,247504,34930,282434
230837,201905,169,142,27,141716,26946,168662
230840,201905,926,739,187,737522.4,186626.4,924148.8
230850,201905,1506,1310,196,1310374,195608.4,1505982.4
230860,201905,300,224,76,223552,75848,299400
230870,201905,1842,1579,263,1577838.94,262474,1840312.94
230880,201905,57,41,16,40918,15968,56886
230890,201905,556,512,44,510976,43912.97,554888.97
230900,201905,281,208,73,207584,72854.58,280438.58
230910,201905,214,173,41,172654,40918,213572
230920,201905,421,333,88,332334,87824,420158
230930,201905,952,677,275,676644.68,274450,951094.68
230940,201905,837,667,170,665666.98,169660.6,835327.58
230945,201905,498,417,81,416167,80838,497005
230950,201905,403,345,58,344310,57884,402194
230960,201905,2614,1786,828,1782431.8,826346.28,2608778.08
230970,201905,1759,995,764,993021.28,762484.28,1755505.56
230980,201905,210,177,33,176646,32934,209580
230990,201905,137,112,25,111776,24950,136726
231000,201905,209,190,19,189620,18962,208582
231010,201905,147,112,35,111776,34930,146706
231020,201905,1330,929,401,927157.28,402197.82,1329355.10
231025,201905,1030,778,252,776444.6,252494.4,1028939.0
231030,201905,1129,948,181,947103.35,180638,1127741.35
231040,201905,138,95,43,94810,42914,137724
231050,201905,994,888,106,886224,105788,992012
231060,201905,146,126,20,125748,19960,145708
231070,201905,1451,1028,423,1026944.24,423152.94,1450097.18
231080,201905,262,244,18,243512,17964,261476
231085,201905,585,363,222,362274.6,221556,583830.6
231090,201905,245,201,44,201596,43912,245508
231095,201905,165,131,34,130738,33932,164670
231100,201905,138,117,21,116766,20958,137724
231110,201905,366,315,51,315368,50898,366266
231120,201905,293,250,43,249500,42914,292414
231123,201905,147,141,6,140718,5988,146706
231126,201905,325,257,68,256486,67864,324350
231130,201905,4614,3605,1009,3598789.93,1007981.91,4606771.84
231135,201905,214,188,26,187624,25948,213572
231140,201905,3106,2296,810,2292406,808380,3100786
231150,201905,370,353,17,352294,16966,369260
231160,201905,1197,958,239,956084.94,238522.94,1194607.88
231170,201905,539,372,167,371256,166666,537922
231180,201905,1692,1445,247,1442110,246506,1688616
231190,201905,204,175,29,175648,28942,204590
231195,201905,222,190,32,189620,31936,221556
231200,201905,826,674,152,672652,151696.6,824348.6
231210,201905,604,511,93,509978,92814,602792
231220,201905,1044,761,283,759478.9,282434.94,1041913.84
231230,201905,1441,1149,292,1146702,291416,1438118
231240,201905,1416,1031,385,1028938.94,384230.4,1413169.34
231250,201905,116,106,10,105788,9980,115768
231260,201905,284,186,98,185628,97804.4,283432.4
231270,201905,1016,847,169,845307.49,168662,1013969.49
231280,201905,67,51,16,50898,15968,66866
231290,201905,7467,4187,3280,4180623.01,3275437.8,7456060.81
231300,201905,636,587,49,585826,51896,637722
231310,201905,746,690,56,688620.74,55888,744508.74
231320,201905,581,443,138,442116,137724,579840
231325,201905,95,84,11,83832,10978,94810
231330,201905,2034,1579,455,1577091.53,454090.7,2031182.23
231335,201905,252,224,28,223552,27944,251496
231340,201905,1679,1235,444,1233528,443112,1676640
231350,201905,1281,1055,226,1052890,225548.8,1278438.8
231355,201905,429,373,56,372254,55888,428142
231360,201905,497,380,117,380238.4,116766,497004.4
231370,201905,88,74,14,73852,13972,87824
231375,201905,293,212,81,211576,80838,292414
231380,201905,471,387,84,386226,83832,470058
231390,201905,203,166,37,165668,36926,202594
231395,201905,735,463,272,462074,271456,733530
231400,201905,1116,926,190,924151.04,191618.34,1115769.38
231410,201905,1342,1097,245,1094806.2,244511.74,1339317.94
240010,201905,392,178,214,177644.43,213572.98,391217.41
240020,201905,2267,1798,469,1794405.5,468063.97,2262469.47
240030,201905,128,111,17,110778,16966,127744
240040,201905,31,31,0,30938,0,30938
240050,201905,519,445,74,445108,73852,518960
240060,201905,66,62,4,61876,3992,65868
240070,201905,204,160,44,159680,43912,203592
240080,201905,490,325,165,324351.54,164670.46,489022.00
240090,201905,103,92,11,91816,10978,102794
240100,201905,1481,1400,81,1397201.5,80838,1478039.5
240110,201905,1051,684,367,682633.58,367264.7,1049898.28
240120,201905,139,118,21,117764,20958,138722
240130,201905,290,270,20,269460,19960,289420
240140,201905,84,65,19,64870,18962,83832
240145,201905,721,644,77,642712,77844,720556
240150,201905,19,16,3,15968,2994,18962
240160,201905,41,37,4,36926,3992,40918
240165,201905,38,32,6,31936.5,5988,37924.5
240170,201905,90,66,24,65868,23952,89820
240180,201905,83,69,14,68862,13972,82834
240185,201905,45,40,5,39920,4990,44910
240190,201905,13,11,2,10978,1996,12974
240200,201905,3074,1718,1356,1715564.8,1353289.4,3068854.2
240210,201905,168,131,37,130738,37924,168662
240220,201905,1094,793,301,791414.7,300398,1091812.7
240230,201905,855,789,66,787422.77,65868,853290.77
240240,201905,79,55,24,54890,23952,78842
240250,201905,89,79,10,78842,9980,88822
240260,201905,1792,1339,453,1336322,452094,1788416
240270,201905,192,170,22,169660,21956,191616
240280,201905,41,31,10,30938,9980,40918
240290,201905,51,50,1,49900,998,50898
240300,201905,174,100,74,99800,73852,173652
240310,201905,2181,1218,963,1216564.27,962072.74,2178637.01
240320,201905,204,193,11,192614,10978,203592
240325,201905,4340,2660,1680,2654684.27,1676642.07,4331326.34
240330,201905,69,65,4,64870,3992,68862
240340,201905,59,38,21,37924,20958,58882
240350,201905,89,80,9,79840,8982,88822
240360,201905,462,316,146,315368,145708,461076
240370,201905,46,43,3,42914,2994,45908
240375,201905,72,41,31,40918,30938,71856
240380,201905,227,186,41,185628,40918.8,226546.8
240390,201905,14,12,2,11976,1996,13972
240400,201905,83,78,5,77844,4990,82834
240410,201905,11,7,4,6986,3992,10978
240420,201905,942,714,228,713570.2,227544,941114.2
240430,201905,268,252,16,251496,15968,267464
240440,201905,91,50,41,49900,40918,90818
240450,201905,211,142,69,141716.4,68862,210578.4
240460,201905,61,47,14,46906,13972,60878
240470,201905,240,209,31,208582,30938,239520
240480,201905,15,13,2,12974,1996,14970
240485,201905,82,70,12,69860,11976,81836
240490,201905,46,46,0,45908,0,45908
240500,201905,85,68,17,67864,16966,84830
240510,201905,50,36,14,35928,13972,49900
240520,201905,119,114,5,113772,4990,118762
240530,201905,56,50,6,49900,5988,55888
240540,201905,81,70,11,69860,10978,80838
240550,201905,13,12,1,12974,998,13972
240560,201905,374,274,100,273452,99800,373252
240570,201905,457,287,170,286426.94,169660,456086.94
240580,201905,1259,1014,245,1011973.4,244510.99,1256484.39
240590,201905,29,27,2,26946,1996,28942
240600,201905,110,107,3,106786,2994,109780
240610,201905,511,429,82,428142.4,81836,509978.4
240615,201905,20,19,1,18962,998,19960
240620,201905,92,88,4,87824,3992,91816
240630,201905,36,34,2,33932,1996,35928
240640,201905,27,22,5,21956,4990,26946
240650,201905,235,197,38,196606,37924,234530
240660,201905,104,91,13,90818,12974,103792
240670,201905,296,175,121,175648.7,120758,296406.7
240680,201905,51,41,10,40918,9980,50898
240690,201905,47,45,2,44910,1996,46906
240700,201905,189,155,34,154690,33932,188622
240710,201905,1936,1227,709,1225811.43,708580,1934391.43
240720,201905,1080,803,277,801394,277444,1078838
240725,201905,63,59,4,58882,3992,62874
240730,201905,141,123,18,122754,17964,140718
240740,201905,237,202,35,201596,34930.74,236526.74
240750,201905,50,27,23,26946,22954,49900
240760,201905,41,37,4,36926,3992,40918
240770,201905,145,113,32,112774,31936,144710
240780,201905,686,566,120,564868,119760,684628
240790,201905,38,37,1,36926,998,37924
240800,201905,9214,6290,2924,6281422.6,2921149.68,9202572.28
240810,201905,20218,11171,9047,11154669.76,9035923.09,20190592.85
240820,201905,221,142,79,141716.19,78842,220558.19
240830,201905,1638,1350,288,1347300.7,287424,1634724.7
240840,201905,84,74,10,73852,9980,83832
240850,201905,86,76,10,75848,9980,85828
240860,201905,109,106,3,105788,2994,108782
240870,201905,59,51,8,50898,7984,58882
240880,201905,29,26,3,25948,2994,28942
240890,201905,1169,682,487,681636.26,486026.99,1167663.25
240895,201905,58,36,22,35928,21956,57884
240910,201905,158,143,15,142714,14970,157684
240920,201905,15,12,3,11976,2994,14970
240930,201905,404,363,41,363272,40918,404190
240933,201905,34,26,8,25948,7984,33932
240940,201905,2435,2150,285,2145700.58,284430,2430130.58
240950,201905,52,49,3,48902,2994,51896
240960,201905,31,26,5,25948,4990,30938
240970,201905,117,85,32,84830,31936,116766
240980,201905,198,160,38,159680,37924,197604
240990,201905,126,83,43,82834,42914,125748
241000,201905,68,63,5,62874,4990,67864
241010,201905,60,49,11,49900,10978,60878
241020,201905,112,104,8,103792,7984,111776
241025,201905,8,3,5,2994,4990,7984
241030,201905,117,95,22,94810,21956,116766
241040,201905,36,30,6,29940,5988,35928
241050,201905,86,76,10,76846,9980,86826
241060,201905,29,24,5,23952,4990,28942
241070,201905,18,18,0,17964,0,17964
241080,201905,62,56,6,55888,5988,61876
241090,201905,50,41,9,40918,8982,49900
241100,201905,70,61,9,60878,8982,69860
241105,201905,5,1,4,998,3992,4990
241110,201905,48,45,3,44910,2994,47904
241120,201905,1445,1112,333,1109776,332334,1442110
241140,201905,222,184,38,183632.4,37924,221556.4
241142,201905,43,39,4,38922,3992,42914
241150,201905,1195,1053,142,1051892,141716,1193608
241160,201905,21,21,0,21956,0,21956
241170,201905,43,38,5,37924,4990,42914
241180,201905,45,39,6,38922,5988,44910
241190,201905,38,37,1,36926,998,37924
241200,201905,3841,2070,1771,2066861.03,1769456.49,3836317.52
241210,201905,68,59,9,58882,8982,67864
241220,201905,1403,951,452,949098.71,451096.97,1400195.68
241230,201905,240,201,39,200598,38922,239520
241240,201905,55,42,13,41916,12974,54890
241250,201905,1133,1034,99,1031932.4,98802,1130734.4
241255,201905,50,40,10,39920,9980,49900
241260,201905,642,507,135,505986,134730,640716
241270,201905,50,37,13,36926,12974,49900
241280,201905,100,87,13,86826,12974,99800
241290,201905,112,87,25,86826,24950,111776
241300,201905,75,55,20,54890,19960,74850
241310,201905,51,38,13,37924.7,12974,50898.7
241320,201905,28,15,13,14970,12974,27944
241330,201905,61,57,4,56886,3992,60878
241335,201905,65,58,7,57884,6986,64870
241340,201905,187,140,47,139720,46906,186626
241350,201905,60,55,5,54890,4990,59880
241355,201905,44,38,6,37924,5988,43912
241360,201905,52,51,1,50898,998,51896
241370,201905,48,40,8,39920,7984,47904
241380,201905,40,36,4,35928,3992,39920
241390,201905,77,62,15,61876,14970,76846
241400,201905,207,167,40,166666,39920,206586
241410,201905,184,165,19,164670,18962,183632
241415,201905,100,81,19,80838,18962,99800
241420,201905,97,73,24,72854,23952.64,96806.64
241430,201905,29,26,3,25948,2994,28942
241440,201905,519,419,100,418162.97,99800.96,517963.93
241445,201905,37,35,2,34930,1996,36926
241450,201905,286,235,51,234530,50898,285428
241460,201905,144,131,13,130738.5,12974,143712.5
241470,201905,41,34,7,33932,6986,40918
241475,201905,59,56,3,55888,2994,58882
241480,201905,96,71,25,70858,24950,95808
241490,201905,8,7,1,6986,998,7984
241500,201905,47,35,12,34930,11976,46906
250010,201905,104,88,16,87824,15968,103792
250020,201905,33,30,3,29940,2994,32934
250030,201905,828,627,201,625746,200598.6,826344.6
250040,201905,344,283,61,283432,60878,344310
250050,201905,237,196,41,195608.99,40918,236526.99
250053,201905,60,46,14,45908,13972,59880
250057,201905,0,,,,,0.0
250060,201905,476,367,109,366266,108782,475048
250070,201905,711,581,130,579838.75,129740,709578.75
250073,201905,8,8,0,7984,0,7984
250077,201905,191,143,48,142714,47904,190618
250080,201905,420,330,90,329340.72,89820,419160.72
250090,201905,200,132,68,131736,67864,199600
250100,201905,510,425,85,424150,84830.2,508980.2
250110,201905,577,436,141,435128,140718,575846
250115,201905,22,7,15,6986,14970,21956
250120,201905,114,84,30,83832,29940,113772
250130,201905,574,466,108,465068,107784.6,572852.6
250135,201905,14,9,5,8982,4990,13972
250140,201905,84,75,9,74850,8982,83832
250150,201905,576,420,156,419160,155688,574848
250153,201905,8,7,1,6986,998,7984
250157,201905,29,23,6,22954,5988,28942
250160,201905,215,171,44,170658,43912,214570
250170,201905,61,42,19,41916,18962,60878
250180,201905,4097,2804,1293,2800390.16,1290418.15,4090808.31
250190,201905,862,574,288,572852,287424.5,860276.5
250200,201905,52,44,8,43912,7984,51896
250205,201905,23,20,3,19960,2994,22954
250210,201905,85,76,9,75848,8982,84830
250215,201905,62,54,8,54890,7984,62874
250220,201905,25,19,6,18962,5988,24950
250230,201905,78,72,6,71856.99,5988,77844.99
250240,201905,242,200,42,199600,41916,241516
250250,201905,404,350,54,349300,53892,403192
250260,201905,37,32,5,31936,4990,36926
250270,201905,63,48,15,47904,14970,62874
250280,201905,383,317,66,316366,65868,382234
250290,201905,91,84,7,83832,6986,90818
250300,201905,551,380,171,379240,170659.97,549899.97
250310,201905,47,43,4,42914,3992,46906
250320,201905,1972,1355,617,1352293.68,615767.38,1968061.06
250330,201905,95,84,11,83832,10978,94810
250340,201905,25,22,3,21956,2994,24950
250350,201905,144,96,48,95808,47904,143712
250355,201905,36,28,8,27944,7984,35928
250360,201905,201,165,36,164670,35928,200598
250370,201905,2409,1627,782,1623746,780436,2404182
250375,201905,7,3,4,2994,3992,6986
250380,201905,53,40,13,39920,12974,52894
250390,201905,42,34,8,33932,7984,41916
250400,201905,16304,8322,7982,8310356.34,7975023.72,16285380.06
250403,201905,363,298,65,297404,65868,363272
250407,201905,59,50,9,49900,8982,58882
250410,201905,30,26,4,25948,3992,29940
250415,201905,40,26,14,25948,13972,39920
250420,201905,45,38,7,37924,6986,44910
250430,201905,1493,1275,218,1272699.5,217564,1490263.5
250435,201905,16,12,4,11976,3992,15968
250440,201905,690,589,101,587822.6,100798,688620.6
250450,201905,85,70,15,69860,14970,84830
250460,201905,435,299,136,298402,135728,434130
250470,201905,89,67,22,66866,21956,88822
250480,201905,331,266,65,265468,64870,330338
250485,201905,1,1,0,998,0,998
250490,201905,226,191,35,190618,34930,225548
250500,201905,81,61,20,60878,19960,80838
250510,201905,726,576,150,574848,149700,724548
250520,201905,171,118,53,117764,52894,170658
250523,201905,113,94,19,93812,18962,112774
250527,201905,99,79,20,78842,19960,98802
250530,201905,8,5,3,4990,2994,7984
250535,201905,25,21,4,20958,3992,24950
250540,201905,130,101,29,100798,28942,129740
250550,201905,71,68,3,67864,2994,70858
250560,201905,41,31,10,30938,9980,40918
250570,201905,157,127,30,126746,29940,156686
250580,201905,116,92,24,91880,23952,115832
250590,201905,23,15,8,14970,7984,22954
250600,201905,1279,860,419,858281.04,419160,1277441.04
250610,201905,154,133,21,132734,20958,153692
250620,201905,23,19,4,18962,3992,22954
250625,201905,72,54,18,53892,17964,71856
250630,201905,3020,1962,1058,1958092.28,1055891.92,3013984.20
250640,201905,210,173,37,172654,36926,209580
250650,201905,28,20,8,19960,7984,27944
250660,201905,46,34,12,33932,11976,45908
250670,201905,63,43,20,42914,19960,62874
250680,201905,395,326,69,325348,68862,394210
250690,201905,1884,1308,576,1306386.15,575846.8,1882232.95
250700,201905,928,813,115,811375.2,114770,926145.2
250710,201905,439,342,97,341316,96806,438122
250720,201905,112,87,25,87824,24950,112774
250730,201905,374,320,54,319360,53892,373252
250740,201905,55,51,4,50898,3992,54890
250750,201905,21236,12921,8315,12906046.99,8305366.7,21211413.69
250760,201905,75,58,17,57884,16966,74850
250770,201905,349,232,117,231536.44,116766,348302.44
250780,201905,56,43,13,42914,12974,55888
250790,201905,473,308,165,307384,164670,472054
250800,201905,152,140,12,139720,11976,151696
250810,201905,82,63,19,62874,18962,81836
250820,201905,155,126,29,125748,28942,154690
250830,201905,424,295,129,294410.4,128742,423152.4
250840,201905,51,49,2,48902,1996,50898
250850,201905,57,46,11,45908,10978,56886
250855,201905,13,11,2,10978,1996,12974
250860,201905,204,143,61,142714,60878,203592
250870,201905,33,30,3,29940,2994,32934
250880,201905,85,62,23,61876,22954,84830
250890,201905,2667,1998,669,1994004,668660,2662664
250900,201905,17,15,2,14970,1996,16966
250905,201905,122,95,27,94810,26946,121756
250910,201905,1167,837,330,835326.99,330338,1165664.99
250915,201905,110,78,32,77844,31936,109780
250920,201905,140,106,34,105788,33932,139720
250930,201905,167,104,63,103792,62874,166666
250933,201905,2,1,1,998,998,1996
250937,201905,9,8,1,7984,998,8982
250939,201905,32,23,9,22954,8982,31936
250940,201905,108,83,25,82834,24950,107784
250950,201905,67,47,20,46906,19960,66866
250960,201905,92,51,41,50898,40918,91816
250970,201905,1229,871,358,870256,357284,1227540
250980,201905,90,63,27,62874,26946,89820
250990,201905,171,133,38,132734,37924,170658
251000,201905,76,67,9,66866,8982,75848
251010,201905,104,82,22,81836.99,21956,103792.99
251020,201905,79,69,10,68862,9980,78842
251030,201905,45,35,10,34930,9980,44910
251040,201905,53,39,14,38922,13972,52894
251050,201905,23,21,2,20958,1996,22954
251060,201905,49,38,11,37924,10978,48902
251065,201905,4,4,0,3992,0,3992
251070,201905,23,19,4,18962.98,3992,22954.98
251080,201905,4906,2380,2526,2376260.26,2524945.03,4901205.29
251090,201905,196,165,31,164670,30938,195608
251100,201905,16,16,0,15968,0,15968
251110,201905,44,35,9,34930,8982,43912
251120,201905,1807,1105,702,1103789.2,701594,1805383.2
251130,201905,389,317,72,316366,71856,388222
251140,201905,528,347,181,346307.2,180638,526945.2
251150,201905,313,273,40,272454.98,39920,312374.98
251160,201905,97,82,15,81836.99,14970,96806.99
251170,201905,103,83,20,82834,19960,102794
251180,201905,294,185,109,184630.99,108782.99,293413.98
251190,201905,191,129,62,128742,61876,190618
251200,201905,258,211,47,210578,46906,257484
251203,201905,38,36,2,35928,1996,37924
251207,201905,95,78,17,77844,16966,94810
251210,201905,1471,1071,400,1068858,399200,1468058
251220,201905,48,38,10,37924,9980,47904
251230,201905,618,526,92,524948,91816,616764
251240,201905,100,72,28,71856,27944,99800
251250,201905,1360,968,392,966064.9,392214.7,1358279.6
251260,201905,12,6,6,5988,5988,11976
251270,201905,324,246,78,245508,77844.7,323352.7
251272,201905,67,60,7,59880,6986,66866
251274,201905,27,21,6,20958,5988,26946
251275,201905,29,17,12,16966,11976,28942
251276,201905,11,9,2,8982,1996,10978
251278,201905,10,8,2,7984,1996,9980
251280,201905,101,96,5,95808,4990,100798
251290,201905,731,547,184,545906,183632,729538
251300,201905,16,13,3,12974,2994,15968
251310,201905,369,265,104,264470.99,103792,368262.99
251315,201905,22,21,1,20958,998,21956
251320,201905,60,48,12,47904,11976,59880
251330,201905,82,73,9,72854,8982,81836
251335,201905,14,9,5,8982,4990,13972
251340,201905,717,426,291,425148,292414,717562
251350,201905,36,35,1,34930,998,35928
251360,201905,75,66,9,65868,8982,74850
251365,201905,14,14,0,13972,0,13972
251370,201905,5437,3711,1726,3703581.14,1723546.6,5427127.74
251380,201905,48,38,10,37924,9980,47904
251385,201905,3,3,0,2994,0,2994
251390,201905,730,570,160,568860.7,159680.4,728541.1
251392,201905,12,6,6,5988,5988,11976
251394,201905,9,9,0,8982,0,8982
251396,201905,14,9,5,8982,4990,13972
251398,201905,18,15,3,14970,2994,17964
251400,201905,43,36,7,35928,6986,42914
251410,201905,37,31,6,30938,5988,36926
251420,201905,102,76,26,75848,25948,101796
251430,201905,42,39,3,38922,2994,41916
251440,201905,34,21,13,20958,12974,33932
251445,201905,54,50,4,49900,3992,53892
251450,201905,412,361,51,360278.2,50898,411176.2
251455,201905,2,1,1,998,998,1996
251460,201905,16,14,2,13972,1996,15968
251465,201905,4,2,2,1996,1996,3992
251470,201905,47,37,10,36926,9980,46906
251480,201905,26,23,3,22954,2994,25948
251490,201905,121,85,36,84830,35928.4,120758.4
251500,201905,126,104,22,103792,21956,125748
251510,201905,37,28,9,27944,8982,36926
251520,201905,26,26,0,25948,0,25948
251530,201905,4489,3173,1316,3166654.8,1314366,4481020.8
251540,201905,74,64,10,63872,9980,73852
251550,201905,406,314,92,313372,91816.9,405188.9
251560,201905,22,15,7,14970,6986,21956
251570,201905,20,19,1,18962,998,19960
251580,201905,124,101,23,100798,22954,123752
251590,201905,121,88,33,88013,32934,120947
251593,201905,27,17,10,16966,9980,26946
251597,201905,63,53,10,52894,9980,62874
251600,201905,1084,777,307,775453.71,306387.36,1081841.07
251610,201905,225,176,49,175648,48902,224550
251615,201905,4,4,0,3992,0,3992
251620,201905,4279,2840,1439,2834322.24,1437121.6,4271443.84
251630,201905,445,328,117,327344,116766.98,444110.98
251640,201905,144,105,39,104790,38922,143712
251650,201905,266,194,72,194610.7,71856,266466.7
251660,201905,188,167,21,166666,20958,187624
251670,201905,366,288,78,287424,77844,365268
251675,201905,4,4,0,3992,0,3992
251680,201905,93,84,9,83832,8982,92814
251690,201905,348,286,62,285428,61876,347304
251700,201905,286,245,41,244510,40918,285428
251710,201905,23,15,8,14970,7984,22954
251720,201905,31,22,9,21956,8982.4,30938.4
251740,201905,10,8,2,7984,1996,9980
260005,201905,3180,1808,1372,1805385.91,1371254.88,3176640.79
260010,201905,1575,1145,430,1142710.14,430138.64,1572848.78
260020,201905,419,370,49,369260,48902,418162
260030,201905,579,421,158,420158,157684,577842
260040,201905,832,521,311,519958,310378,830336
260050,201905,1145,833,312,832332,313372.8,1145704.8
260060,201905,396,363,33,362274,32934,395208
260070,201905,1400,883,517,881237.85,515966.69,1397204.54
260080,201905,725,574,151,572852,150698,723550
260090,201905,529,338,191,337325.96,190618,527943.96
260100,201905,232,164,68,163672,67864,231536
260105,201905,220,123,97,123752,96806,220558
260110,201905,2825,2090,735,2086819.38,733530.4,2820349.78
260120,201905,2870,1475,1395,1475045.62,1392210.7,2867256.32
260130,201905,160,113,47,112774,46906,159680
260140,201905,2154,1415,739,1412180.48,739518.98,2151699.46
260150,201905,220,144,76,143712,75848,219560
260160,201905,319,266,53,265468,52894,318362
260170,201905,3376,2080,1296,2076838.88,1294406.4,3371245.28
260180,201905,159,134,25,133732,24950,158682
260190,201905,2267,1602,665,1598796,663670,2262466
260200,201905,946,768,178,766464.63,177644.4,944109.03
260210,201905,1444,1029,415,1026942,414170.98,1441112.98
260220,201905,730,659,71,657682,70858,728540
260230,201905,1199,907,292,905186,292414,1197600
260240,201905,221,169,52,168662,51896,220558
260250,201905,88,67,21,66866,20958,87824
260260,201905,998,716,282,714568,281436,996004
260270,201905,424,344,80,343312,79840,423152
260280,201905,1352,939,413,937122,412175.38,1349297.38
260290,201905,6414,3503,2911,3496998.28,2906182.47,6403180.75
260300,201905,907,798,109,796404.6,108782.4,905187.0
260310,201905,525,417,108,416166.4,107784,523950.4
260320,201905,868,655,213,654688,213572,868260
260330,201905,44,34,10,33932,9980,43912
260340,201905,72,52,20,51896,19960,71856
260345,201905,5580,3122,2458,3117755.47,2455083.9,5572839.37
260350,201905,481,350,131,349300.4,130738,480038.4
260360,201905,276,145,131,144710,130738,275448
260370,201905,682,451,231,451096.5,230539.09,681635.59
260380,201905,604,441,163,440118,162674.66,602792.66
260390,201905,296,253,43,252494,42914,295408
260392,201905,105,90,15,89820,14970,104790
260400,201905,4059,2361,1698,2357278.89,1695603.38,4052882.27
260410,201905,14558,7749,6809,7740491.17,6800373.28,14540864.45
260415,201905,127,115,12,114770,11976,126746
260420,201905,1783,1086,697,1083829.81,695606,1779435.81
260430,201905,193,176,17,175649.25,16966,192615.25
260440,201905,215,155,60,155688.98,59880,215568.98
260450,201905,459,334,125,333333.2,124750,458083.2
260460,201905,825,442,383,441117.2,382234,823351.2
260470,201905,360,223,137,222554,136726.8,359280.8
260480,201905,218,142,76,141716,75848,217564
260490,201905,215,178,37,177644,36926,214570
260500,201905,1130,765,365,763470,365268,1128738
260510,201905,775,626,149,624748,148702,773450
260515,201905,251,227,24,226546,23952,250498
260520,201905,3258,1974,1284,1971050.99,1287420.78,3258471.77
260530,201905,807,659,148,658680,147704,806384
260540,201905,566,434,132,433132,131736,564868
260545,201905,12,10,2,9980,1996,11976
260550,201905,339,212,127,211576,126746,338322
260560,201905,528,396,132,395208.4,131736,526944.4
260570,201905,999,821,178,819358.4,177644,997002.4
260580,201905,257,229,28,228542,27944,256486
260590,201905,625,364,261,363272,260478,623750
260600,201905,8069,4280,3789,4272440.33,3785414,8057854.33
260610,201905,493,334,159,333332,159680,493012
260620,201905,3688,1955,1733,1951093.02,1730534.07,3681627.09
260630,201905,85,81,4,80838,3992,84830
260640,201905,3642,2009,1633,2006979.9,1639714.98,3646694.88
260650,201905,319,233,86,232534,85828,318362
260660,201905,529,361,168,360278,169660,529938
260670,201905,103,76,27,75848,26946,102794
260680,201905,3661,2083,1578,2079835.64,1574845.36,3654681.00
260690,201905,126,95,31,94810,30938,125748
260700,201905,327,210,117,209580,116766,326346
260710,201905,37,34,3,33932,2994,36926
260720,201905,2316,1392,924,1390215.6,923150,2313365.6
260730,201905,656,501,155,499998,154690,654688
260740,201905,62,58,4,57884,3992,61876
260750,201905,628,447,181,447104,180638,627742
260760,201905,622,336,286,335328.63,285428,620756.63
260765,201905,977,518,459,517962.99,458082,976044.99
260770,201905,219,163,56,162657,55888,218545
260775,201905,799,474,325,473053.3,324350.98,797404.28
260780,201905,270,176,94,176646,93812,270458
260790,201905,12170,6734,5436,6720543.28,5428127.91,12148671.19
260795,201905,163,111,52,110778,51896,162674
260800,201905,294,247,47,246506,46906,293412
260805,201905,171,112,59,111776,58882,170658
260810,201905,754,657,97,655686,96806,752492
260820,201905,314,206,108,205588.34,107784,313372.34
260825,201905,205,144,61,143712,60878,204590
260830,201905,277,174,103,174650,102794,277444
260840,201905,233,171,62,170658,61876,232534
260845,201905,187,128,59,127744,58882,186626
260850,201905,476,353,123,352294,122754,475048
260860,201905,255,192,63,191616,62874,254490
260870,201905,370,276,94,275448,93812,369260
260875,201905,744,533,211,532932,210578,743510
260880,201905,1583,1007,576,1004986.2,574848,1579834.2
260890,201905,2398,1695,703,1694605,706584.8,2401189.8
260900,201905,1000,700,300,699598,299400,998998
260910,201905,268,210,58,209580,57884,267464
260915,201905,307,214,93,213572,92814,306386
260920,201905,176,97,79,96806,78842,175648
260930,201905,398,342,56,341317.94,55888.97,397206.91
260940,201905,2818,1550,1268,1548897.6,1266462.4,2815360.0
260950,201905,2020,1182,838,1179637.66,837322,2016959.66
260960,201905,13875,7242,6633,7236510.96,6628725.77,13865236.73
260970,201905,436,374,62,373252,61876,435128
260980,201905,198,176,22,175648,21956,197604
260990,201905,2613,2140,473,2136719.34,472054,2608773.34
261000,201905,4338,2583,1755,2577835.58,1752488.6,4330324.18
261010,201905,182,135,47,134730,46906,181636
261020,201905,612,459,153,458083.46,152694,610777.46
261030,201905,233,174,59,173652,58882,232534
261040,201905,367,324,43,323352,42914,366266
261050,201905,496,434,62,434130,62874,497004
261060,201905,1357,901,456,899198.5,455088,1354286.5
261070,201905,8759,4501,4258,4493025.49,4253524.99,8746550.48
261080,201905,384,297,87,297404,86826,384230
261090,201905,2258,1742,516,1739518.31,515966.47,2255484.78
261100,201905,1106,771,335,769459.3,335328,1104787.3
261110,201905,8469,5221,3248,5212556.82,3242506.01,8455062.83
261120,201905,268,226,42,225548,41916,267464
261130,201905,568,342,226,341316.6,225549.58,566866.18
261140,201905,189,123,66,122754,65868,188622
261150,201905,678,417,261,416166.18,262474,678640.18
261153,201905,71,67,4,66866,3992,70858
261160,201905,77019,38898,38121,38850974.18,38080727.19,76931701.37
261170,201905,460,349,111,349300,111776,461076
261180,201905,1799,1117,682,1114766,680636,1795402
261190,201905,612,433,179,433134.52,179640.98,612775.50
261200,201905,218,189,29,188622,28942,217564
261210,201905,34,29,5,28942,4990,33932
261220,201905,2699,1902,797,1899196.18,796405.37,2695601.55
261230,201905,338,254,84,253492,83832,337324
261240,201905,460,398,62,397204,61876,459080
261245,201905,235,195,40,194610,39920,234530
261247,201905,166,132,34,131736,33932,165668
261250,201905,2945,1509,1436,1505982.4,1434126,2940108.4
261255,201905,257,233,24,232534,23952,256486
261260,201905,870,756,114,754488.76,114770,869258.76
261270,201905,178,137,41,136726,40918,177644
261280,201905,174,146,28,145708,27944,173652
261290,201905,127,90,37,90818,36926,127744
261300,201905,1269,918,351,916164,352294,1268458
261310,201905,787,533,254,532932.4,254490,787422.4
261320,201905,559,388,171,387224,171656,558880
261330,201905,993,767,226,765466,225548.63,991014.63
261340,201905,289,166,123,165668,122754,288422
261350,201905,830,593,237,591814.4,236526,828340.4
261360,201905,1283,844,439,842312,438122,1280434
261370,201905,4889,3005,1884,2998995.26,1880234.77,4879230.03
261380,201905,560,419,141,419160.06,140718.4,559878.46
261390,201905,3564,2388,1176,2384222.4,1173649.3,3557871.7
261400,201905,282,258,24,257484,23952,281436
261410,201905,1115,754,361,752492,360278,1112770
261420,201905,880,561,319,559880.47,319360.98,879241.45
261430,201905,327,294,33,293412,32934,326346
261440,201905,127,117,10,116766,9980,126746
261450,201905,2542,2091,451,2086819.3,451097.36,2537916.66
261460,201905,744,599,145,597802.74,144710,742512.74
261470,201905,254,195,59,194610,58882,253492
261480,201905,398,314,84,313372.6,83832.99,397205.59
261485,201905,342,214,128,213572,127744,341316
261500,201905,614,418,196,417164,195608,612772
261510,201905,50,35,15,34930,14970,49900
261520,201905,110,98,12,97804,11976,109780
261530,201905,4104,2606,1498,2600789.19,1495005.84,4095795.03
261540,201905,1183,727,456,725546,456086,1181632
261550,201905,278,138,140,137724.4,139720,277444.4
261560,201905,823,547,276,545906.7,275450.22,821356.92
261570,201905,392,309,83,308382,82834,391216
261580,201905,382,300,82,299400,81836,381236
261590,201905,194,160,34,159680,33932,193612
261600,201905,301,241,60,240518,59880,300398
261610,201905,102,88,14,87824,13972,101796
261618,201905,72,56,16,55888,15968,71856
261620,201905,201,124,77,123752,76846,200598
261630,201905,574,446,128,445108,127744,572852
261640,201905,6381,3412,2969,3411167.91,2965059.27,6376227.18
261650,201905,500,321,179,320358,178642,499000
270010,201905,540,480,60,479040.4,59880,538920.4
270020,201905,297,235,62,234530.99,61876,296406.99
270030,201905,9220,5976,3244,5967069.16,3241540.06,9208609.22
270040,201905,2022,1266,756,1263468,758480,2021948
270050,201905,166,125,41,124750,40918,165668
270060,201905,115,65,50,64870,49900,114770
270070,201905,890,651,239,649698,238522.98,888220.98
270080,201905,37,31,6,30938,5988,36926
270090,201905,20,16,4,15968,3992,19960
270100,201905,1224,822,402,820356.98,401196,1221552.98
270110,201905,139,105,34,104790,33932,138722
270120,201905,222,184,38,183632,37924,221556
270130,201905,250,171,79,170658,78842,249500
270135,201905,103,61,42,60878,41916,102794
270140,201905,1356,836,520,835329.91,518960.98,1354290.89
270150,201905,267,211,56,210578,55888,266466
270160,201905,519,399,120,399200,119760,518960
270170,201905,777,505,272,504988,272454,777442
270180,201905,74,57,17,56886,16966,73852
270190,201905,98,87,11,86826,10978,97804
270200,201905,108,97,11,96806,10978,107784
270210,201905,482,259,223,258482,222554,481036
270220,201905,180,144,36,143712,35928,179640
270230,201905,2106,1295,811,1292412.14,809378.98,2101791.12
270235,201905,726,557,169,555891.78,168666.88,724558.66
270240,201905,3135,2473,662,2469054.53,660678.54,3129733.07
270250,201905,167,121,46,120758,45908,166666
270255,201905,220,189,31,188622,30938,219560
270260,201905,364,293,71,292414,70858,363272
270270,201905,102,43,59,42914.98,59880,102794.98
270280,201905,260,151,109,151696,108782,260478
270290,201905,1200,919,281,917162,280438.98,1197600.98
270300,201905,289,194,95,193612,94810,288422
270310,201905,902,727,175,725550.88,174651.96,900202.84
270320,201905,887,760,127,759479.61,127744,887223.61
270330,201905,277,235,42,234530,41916,276446
270340,201905,60,48,12,47904,11976,59880
270350,201905,96,49,47,48902,46906,95808
270360,201905,62,35,27,34930,26946,61876
270370,201905,57,46,11,45908,10978,56886
270375,201905,75,48,27,47904,26946,74850
270380,201905,1004,600,404,598800,403192,1001992
270390,201905,190,111,79,110778,79840,190618
270400,201905,722,535,187,533934.39,186626,720560.39
270410,201905,690,502,188,501994,187624,689618
270420,201905,417,281,136,280438,135731.88,416169.88
270430,201905,33244,23936,9308,23905560.05,9298379.49,33203939.54
270440,201905,493,389,104,389220,103792,493012
270450,201905,794,434,360,433132,362274,795406
270460,201905,192,151,41,150698,40918,191616
270470,201905,1441,974,467,974813.92,467064,1441877.92
270480,201905,544,449,95,448102.8,94810,542912.8
270490,201905,24,19,5,18962,4990,23952
270500,201905,509,421,88,420158,87824,507982
270510,201905,772,476,296,475048,295408,770456
270520,201905,334,207,127,207584,126746,334330
270530,201905,68,59,9,58882,8982,67864
270540,201905,117,91,26,90818,25948,116766
270550,201905,1753,1338,415,1337321.98,415168,1752489.98
270560,201905,290,142,148,141716,147704,289420
270570,201905,497,348,149,347304,148702,496006
270580,201905,97,74,23,73852,22954,96806
270590,201905,70,56,14,55888,13972,69860
270600,201905,182,149,33,148702,32934,181636
270610,201905,209,177,32,176646.98,31936,208582.98
270620,201905,30,29,1,28942,998,29940
270630,201905,3908,2985,923,2980032.16,922152,3902184.16
270640,201905,902,665,237,664668,236527.94,901195.94
270642,201905,224,190,34,189620,33932,223552
270644,201905,256,173,83,172654.98,82834,255488.98
270650,201905,312,187,125,187624,125748,313372
270660,201905,256,209,47,208582,46906,255488
270670,201905,3110,2375,735,2371251.9,734529.38,3105781.28
270680,201905,470,274,196,273452.98,195608,469060.98
270690,201905,1154,746,408,744508.98,407184,1151692.98
270700,201905,34,26,8,25948,7984,33932
270710,201905,893,683,210,681634,209580,891214
270720,201905,257,199,58,198602,57884,256486
270730,201905,1927,1140,787,1140714.8,786426.08,1927140.88
270740,201905,44,28,16,27944,15968,43912
270750,201905,667,493,174,492014.6,173652,665666.6
270760,201905,299,217,82,216566,81836,298402
270770,201905,2820,1828,992,1826809.43,991014.96,2817824.39
270780,201905,84,53,31,52894,30939.98,83833.98
270790,201905,253,168,85,167664,85828,253492
270800,201905,1990,1607,383,1603786.99,382234.4,1986021.39
270810,201905,293,237,56,236526,55888,292414
270820,201905,156,103,53,102794,52894.8,155688.8
270830,201905,836,615,221,613771.98,221556.99,835328.97
270840,201905,1436,1084,352,1081832,352294.74,1434126.74
270850,201905,1605,987,618,986025,617762,1603787
270860,201905,2525,1665,860,1662670.81,858282.67,2520953.48
270870,201905,126,68,58,67864,57884,125748
270880,201905,909,691,218,689628.72,217568.86,907197.58
270890,201905,319,231,88,230538,87824,318362
270895,201905,64,55,9,54890,8982,63872
270900,201905,100,77,23,76846,22954,99800
270910,201905,320,254,66,253492,65868,319360
270915,201905,1912,1183,729,1183657.69,729549.2,1913206.89
270920,201905,494,418,76,417164,75848,493012
270930,201905,6191,4561,1630,4552892.22,1627750.89,6180643.11
270940,201905,2374,1823,551,1822348,552892.4,2375240.4
280010,201905,41,36,5,35928,4990,40918
280020,201905,455,401,54,400198.96,53892,454090.96
280030,201905,20185,13110,7075,13087816.48,7068849.76,20156666.24
280040,201905,331,217,114,216566,113772,330338
280050,201905,384,297,87,296406,86826,383232
280060,201905,342,230,112,229540.48,111776,341316.48
280067,201905,1012,725,287,723550.49,287424.75,1010975.24
280070,201905,125,103,22,102794,21956,124750
280100,201905,613,480,133,479040.8,132734.6,611775.4
280110,201905,74,69,5,68862,4990,73852
280120,201905,643,518,125,516964,124750,641714
280130,201905,1599,1040,559,1037920.6,557882,1595802.6
280140,201905,477,391,86,390218,85828,476046
280150,201905,368,271,97,270458,96806,367264
280160,201905,98,87,11,86826,10978,97804
280170,201905,415,275,140,274450.49,139720,414170.49
280190,201905,27,25,2,24950,1996,26946
280200,201905,30,23,7,22954,6986,29940
280210,201905,2835,2037,798,2032931.16,798400.4,2831331.56
280220,201905,42,33,9,32934,8982,41916
280230,201905,329,272,57,271456.7,56886,328342.7
280240,201905,117,111,6,110778,5988,116766
280250,201905,17,11,6,10978,5988,16966
280260,201905,83,73,10,72854,9980,82834
280270,201905,157,122,35,121756,34930,156686
280280,201905,194,124,70,123752,69860,193612
280290,201905,3250,2368,882,2365198.64,881234.64,3246433.28
280300,201905,1602,1230,372,1228538.4,371256,1599794.4
280310,201905,103,98,5,98802.6,4990,103792.6
280320,201905,665,463,202,462074,202594,664668
280330,201905,354,257,97,256486,96806,353292
280340,201905,415,336,79,335328,78842,414170
280350,201905,3584,2790,794,2786420.24,795406.7,3581826.94
280360,201905,444,285,159,284430,158682,443112
280370,201905,99,87,12,86826,11976,98802
280380,201905,56,43,13,42914,12974,55888
280390,201905,180,155,25,154690,24950,179640
280400,201905,345,236,109,235529.36,108782,344311.36
280410,201905,289,235,54,234530.6,53892,288422.6
280420,201905,172,145,27,144710,26946,171656
280430,201905,29,18,11,17964,10978,28942
280440,201905,690,536,154,534929.46,154690,689619.46
280445,201905,118,110,8,109780,7984,117764
280450,201905,1163,999,164,997002,163672,1160674
280460,201905,613,442,171,441116.7,170658,611774.7
280470,201905,191,177,14,176646,13972.7,190618.7
280480,201905,2445,1735,710,1731532.76,708581.62,2440114.38
280490,201905,288,268,20,267464.15,19960,287424.15
280500,201905,41,37,4,36926,3992,40918
280510,201905,140,111,29,110778,28942.4,139720.4
280520,201905,54,41,13,40918,12974,53892
280530,201905,73,47,26,46906,25948,72854
280540,201905,525,428,97,427144.7,96806,523950.7
280550,201905,734,677,57,675648.4,56886,732534.4
280560,201905,498,437,61,436126,60878,497004
280570,201905,2201,1710,491,1709576.38,490018,2199594.38
280580,201905,613,474,139,473054.19,139720.8,612774.99
280590,201905,175,113,62,112774,61876,174650
280600,201905,380,320,60,319360,59880,379240
280610,201905,130,100,30,99800,29940,129740
280620,201905,554,462,92,461076,91816,552892
280630,201905,157,130,27,129740,26946,156686
280640,201905,197,158,39,157684.96,38922,196606.96
280650,201905,78,57,21,56886,21956,78842
280660,201905,139,102,37,101796,36926,138722
280670,201905,1766,1129,637,1126747.35,635726.86,1762474.21
280680,201905,182,157,25,156686.69,24950,181636.69
280690,201905,91,79,12,78842,11976,90818
280700,201905,22,22,0,21956,0,21956
280710,201905,1463,1125,338,1122750.6,337324,1460074.6
280720,201905,112,75,37,74850,36926,111776
280730,201905,26,22,4,21956,3992,25948
280740,201905,2517,1880,637,1876240.8,635726,2511966.8
280750,201905,225,199,26,198602,25948,224550
280760,201905,725,501,224,499998,224550,724548
290010,201905,208,144,64,143712,63872.94,207584.94
290020,201905,177,163,14,162674,14970,177644
290030,201905,606,396,210,395208,209580,604788
290035,201905,132,107,25,106786,24950,131736
290040,201905,290,194,96,193612,95808,289420
290050,201905,84,66,18,66866,17964,84830
290060,201905,260,117,143,116766,142714,259480
290070,201905,5614,2813,2801,2808373.86,2798397.61,5606771.47
290080,201905,479,224,255,223552.96,254491.92,478044.88
290090,201905,390,176,214,175648,214570,390218
290100,201905,1623,1074,549,1071853.2,547902.4,1619755.6
290110,201905,813,495,318,494011.12,318362.99,812374.11
290115,201905,202,187,15,186626,14970,201596
290120,201905,763,503,260,501994.03,259480,761474.03
290130,201905,426,258,168,257484,167664,425148
290135,201905,295,223,72,222554,71856,294410
290140,201905,315,263,52,262474,51896,314370
290150,201905,133,97,36,96806,35928,132734
290160,201905,250,189,61,188622.62,60878,249500.62
290170,201905,95,69,26,68862,25948,94810
290180,201905,171,132,39,131736.6,38922,170658.6
290190,201905,441,367,74,366266,73852,440118
290195,201905,299,186,113,185628,112774,298402
290200,201905,278,226,52,225548,51896,277444
290205,201905,142,87,55,86826,54890,141716
290210,201905,1155,844,311,842312.4,310378,1152690.4
290220,201905,222,122,100,121756,99800,221556
290225,201905,296,116,180,115768,179640,295408
290230,201905,63,42,21,41916,20958,62874
290240,201905,325,127,198,126746,197604,324350
290250,201905,262,242,20,241516,19960,261476
290260,201905,302,243,59,242514.4,58882,301396.4
290265,201905,194,164,30,163672,29940,193612
290270,201905,1426,1184,242,1182630.5,241517.36,1424147.86
290280,201905,483,346,137,345308,136726,482034
290290,201905,1287,762,525,760476.94,524948.4,1285425.34
290300,201905,454,386,68,385228.4,67864,453092.4
290310,201905,308,136,172,135728,171656,307384
290320,201905,4066,2522,1544,2516956.57,1543906.6,4060863.17
290323,201905,190,166,24,165668,23952,189620
290327,201905,163,129,34,128742,33932,162674
290330,201905,91,50,41,49900,40918,90818
290340,201905,889,362,527,361276,525946,887222
290350,201905,614,371,243,370258,242514,612772
290360,201905,369,277,92,276446.97,91816,368262.97
290370,201905,922,386,536,385228,534928.97,920156.97
290380,201905,319,195,124,194610,123752,318362
290390,201905,2485,1562,923,1560874.9,921154,2482028.9
290395,201905,250,142,108,141716.5,107784,249500.5
290400,201905,284,209,75,208582.4,74850,283432.4
290405,201905,249,219,30,218562,29940,248502
290410,201905,603,515,88,513970.95,87824,601794.95
290420,201905,246,196,50,195608,49900,245508
290430,201905,483,308,175,307384,174650,482034
290440,201905,73,65,8,64870,7984,72854
290450,201905,229,179,50,178642,49900,228542
290460,201905,1914,1152,762,1149705.8,760478.24,1910184.04
290470,201905,1407,599,808,597812.78,807399.64,1405212.42
290475,201905,588,549,39,547902.68,38922.4,586825.08
290480,201905,290,160,130,160678,129740,290418
290485,201905,246,226,20,225548,19960,245508
290490,201905,1213,875,338,873250,337324,1210574
290500,201905,716,364,352,363272,351296,714568
290510,201905,228,175,53,174650,52894,227544
290515,201905,147,91,56,90818,55888,146706
290520,201905,1438,957,481,955086.54,480038.73,1435125.27
290530,201905,313,289,24,288422,23952,312374
290540,201905,96,53,43,52894,42914,95808
290550,201905,153,127,26,126746,25948,152694
290560,201905,3252,1374,1878,1372250,1877241.32,3249491.32
290570,201905,6084,3120,2964,3115763.29,2961073.52,6076836.81
290580,201905,1291,778,513,776444,511974,1288418
290590,201905,567,466,101,465068,100798,565866
290600,201905,1775,1236,539,1233530.02,539918,1773448.02
290610,201905,221,199,22,198602.54,21956,220558.54
290620,201905,350,312,38,311376,37924,349300
290630,201905,2023,876,1147,875246,1145704.4,2020950.4
290640,201905,151,124,27,123752,26946,150698
290650,201905,1711,822,889,820356.69,887222,1707578.69
290660,201905,277,226,51,225548,50898,276446
290670,201905,1043,539,504,537922.8,502992.63,1040915.43
290680,201905,1237,999,238,997002,237524,1234526
290682,201905,296,222,74,221557.24,73852.98,295410.22
290685,201905,238,154,84,153692,83832,237524
290687,201905,1008,659,349,657844.4,348302,1006146.4
290689,201905,142,79,63,78842.97,62874,141716.97
290690,201905,622,263,359,262474.98,358286.84,620761.82
290700,201905,243,119,124,118762,124750,243512
290710,201905,711,484,227,483032,226546,709578
290720,201905,1046,848,198,846304.5,197604.4,1043908.9
290730,201905,1167,677,490,676644,489020,1165664
290740,201905,14,12,2,11976,1996,13972
290750,201905,1358,631,727,629738,725548.72,1355286.72
290755,201905,72,66,6,65868,5988,71856
290760,201905,299,261,38,260478,37924,298402
290770,201905,190,179,11,178642,10978.4,189620.4
290780,201905,1044,828,216,826347.74,215568,1041915.74
290790,201905,377,265,112,264470,111776,376246
290800,201905,2557,1034,1523,1031932,1521950,2553882
290810,201905,466,324,142,323352,141716,465068
290820,201905,397,238,159,237524.97,158682,396206.97
290830,201905,412,292,120,291416,119760,411176
290840,201905,1740,1079,661,1076843.68,660676.8,1737520.48
290850,201905,790,442,348,441116,347304,788420
290860,201905,628,291,337,290418,336326.4,626744.4
290870,201905,645,465,180,464070.64,179640.84,643711.48
290880,201905,124,69,55,68862,54890,123752
290890,201905,349,249,100,248502,99800,348302
290900,201905,167,126,41,125748,40918,166666
290910,201905,384,295,89,294410,88822,383232
290920,201905,226,190,36,189620,35928,225548
290930,201905,852,648,204,646704.4,203592.96,850297.36
290940,201905,247,206,41,205588,40918,246506
290950,201905,171,101,70,100798,69860,170658
290960,201905,465,319,146,318362,146706,465068
290970,201905,256,227,29,226546,28942,255488
290980,201905,1585,1132,453,1130734.68,453093.2,1583827.88
290990,201905,404,340,64,339321.75,63874.94,403196.69
291000,201905,864,253,611,252494,610776,863270
291005,201905,2248,995,1253,993010.68,1252490.98,2245501.66
291010,201905,158,143,15,142714,14970,157684
291020,201905,99,77,22,76846,21956,98802
291030,201905,99,73,26,72854,25948,98802
291040,201905,580,309,271,308382,271456,579838
291050,201905,1392,785,607,783430.96,607782,1391212.96
291060,201905,1517,849,668,847302,666664,1513966
291070,201905,1970,1473,497,1470055.98,498003.78,1968059.76
291072,201905,7336,2766,4570,2760469.82,4567849.92,7328319.74
291075,201905,222,183,39,182634,38922,221556
291077,201905,53,36,17,35928,16966,52894
291080,201905,20125,8922,11203,8910152.73,11190583.63,20100736.36
291085,201905,301,246,55,245508,54890,300398
291090,201905,302,119,183,118762.4,182634,301396.4
291100,201905,650,193,457,192614,456086,648700
291110,201905,412,315,97,314370.96,96806,411176.96
291120,201905,2496,1222,1274,1219556.7,1273449.49,2493006.19
291125,201905,64,32,32,31936,31936,63872
291130,201905,210,187,23,186626,22954,209580
291140,201905,141,111,30,110778,29940.4,140718.4
291150,201905,386,160,226,160678,225548,386226
291160,201905,383,317,66,316366.5,65868,382234.5
291165,201905,28,24,4,23952,3992,27944
291170,201905,3074,1559,1515,1556881.1,1511971.2,3068852.3
291180,201905,1296,515,781,513973.74,779440.88,1293414.62
291185,201905,83,81,2,80838,1996,82834
291190,201905,1313,586,727,584829.24,726544.46,1311373.70
291200,201905,169,128,41,127744,40918,168662
291210,201905,2235,898,1337,896205.08,1336323.38,2232528.46
291220,201905,279,210,69,209580,68862,278442
291230,201905,1012,355,657,354290.4,656684,1010974.4
291240,201905,436,414,22,413172.4,21956,435128.4
291250,201905,447,363,84,362274,83832,446106
291260,201905,53,41,12,40918,11976,52894
291270,201905,1188,491,697,490018,695606,1185624
291280,201905,367,176,191,175648.4,190618,366266.4
291290,201905,1744,908,836,906184.4,834329.4,1740513.8
291300,201905,235,182,53,181636,52894,234530
291310,201905,234,212,22,211576,21956,233532
291320,201905,1399,999,400,997002,399200.8,1396202.8
291330,201905,129,110,19,109780,18962,128742
291340,201905,179,100,79,99800,78842,178642
291345,201905,139,95,44,94810,43912,138722
291350,201905,1613,551,1062,549898,1060874.7,1610772.7
291360,201905,8513,4232,4281,4225536.86,4279427.06,8504963.92
291370,201905,1136,642,494,640716.4,493012.98,1133729.38
291380,201905,259,205,54,205588,54890,260478
291390,201905,3827,1709,2118,1707579.94,2116759.42,3824339.36
291400,201905,2086,1497,589,1494006,588820.63,2082826.63
291410,201905,161,142,19,141716,18962,160678
291420,201905,118,88,30,88822,29940,118762
291430,201905,163,91,72,90818,71856.11,162674.11
291440,201905,513,415,98,415168.4,97804,512972.4
291450,201905,904,571,333,569858.5,332334,902192.5
291460,201905,1819,1486,333,1484027.6,332334,1816361.6
291465,201905,2192,1049,1143,1046915.9,1141725.58,2188641.48
291470,201905,2840,1441,1399,1439116.71,1397200.4,2836317.11
291480,201905,11781,5247,6534,5244515.79,6525050.34,11769566.13
291490,201905,562,240,322,240518,322354,562872
291500,201905,377,217,160,216566,159680,376246
291510,201905,1234,482,752,481036,750496,1231532
291520,201905,957,439,518,439120,516964,956084
291530,201905,983,276,707,275448,705586,981034
291535,201905,124,104,20,103792,19960,123752
291540,201905,354,106,248,105788.4,247504.2,353292.6
291550,201905,1201,577,624,575847.2,623751.38,1199598.58
291560,201905,5388,2764,2624,2758564.56,2619915.91,5378480.47
291570,201905,204,103,101,102794,100798,203592
291580,201905,1254,775,479,773451.81,478042,1251493.81
291590,201905,89,36,53,35928,52894,88822
291600,201905,1361,649,712,647702,710577.96,1358279.96
291610,201905,1458,704,754,702592,753491.58,1456083.58
291620,201905,567,261,306,260478,305388,565866
291630,201905,476,158,318,157684,317364,475048
291640,201905,3904,1977,1927,1974048.2,1925155.36,3899203.56
291650,201905,420,287,133,286426.53,132734,419160.53
291660,201905,409,165,244,164670,243512,408182
291670,201905,226,145,81,144710,80838,225548
291680,201905,681,396,285,395208,284430.8,679638.8
291685,201905,594,330,264,329340.5,263472,592812.5
291690,201905,567,317,250,316366,249501.86,565867.86
291700,201905,961,759,202,757482,201596,959078
291710,201905,1682,795,887,793410.5,885226.98,1678637.48
291720,201905,407,272,135,271456,134730,406186
291730,201905,951,568,383,566864,382234,949098
291733,201905,280,193,87,192614,86826,279440
291735,201905,72,54,18,53892,17964,71856
291740,201905,352,274,78,273452,77844,351296
291750,201905,2093,1370,723,1367261.45,721554,2088815.45
291760,201905,3047,1683,1364,1679634,1363268.4,3042902.4
291770,201905,796,539,257,537928.91,256486,794414.91
291780,201905,45,27,18,26946,17964,44910
291790,201905,165,80,85,79840,84830,164670
291800,201905,10099,4162,5937,4154676.91,5930119.08,10084795.99
291810,201905,1119,821,298,819358.4,297404.6,1116763.0
291820,201905,277,199,78,198602,77844,276446
291830,201905,1113,441,672,440118.98,670656.98,1110775.96
291835,201905,584,543,41,541914,40918,582832
291840,201905,4844,2508,2336,2502985.35,2334322.98,4837308.33
291845,201905,280,95,185,94810,184630,279440
291850,201905,334,297,37,296406,36926,333332
291855,201905,262,105,157,104790,156686,261476
291860,201905,173,107,66,106786,65868,172654
291870,201905,82,32,50,31936,49900,81836
291875,201905,189,175,14,174650,13972,188622
291880,201905,479,380,99,379240,98802,478042
291890,201905,247,81,166,80838,165668.4,246506.4
291900,201905,57,32,25,31936,25948,57884
291905,201905,128,94,34,93812.4,33932,127744.4
291910,201905,174,141,33,140718,32934,173652
291915,201905,415,367,48,368262.5,47904,416166.5
291920,201905,4999,2595,2404,2590809.58,2399193.98,4990003.56
291930,201905,179,105,74,104790,73852,178642
291940,201905,354,199,155,198602,154690,353292
291950,201905,1147,935,212,934128.4,212574,1146702.4
291955,201905,1188,715,473,713570.4,472054,1185624.4
291960,201905,184,132,52,131736,51896,183632
291970,201905,767,579,188,577842,187624,765466
291980,201905,1521,1345,176,1342311.38,175648.4,1517959.78
291990,201905,130,120,10,119760,9980,129740
291992,201905,178,90,88,89820,87824,177644
291995,201905,158,107,51,106786,50898,157684
292000,201905,392,305,87,304390.4,86826,391216.4
292010,201905,292,207,85,206586,84830,291416
292020,201905,291,213,78,212574,77844,290418
292030,201905,143,112,31,111776,30938,142714
292040,201905,644,329,315,328342,314370,642712
292045,201905,101,93,8,92814,7984,100798
292050,201905,934,678,256,677642,255488.4,933130.4
292060,201905,936,775,161,773450.36,160678,934128.36
292070,201905,50,21,29,20958,28942,49900
292080,201905,133,91,42,90818,41916,132734
292090,201905,507,186,321,185628,321356,506984
292100,201905,1404,625,779,624748.6,779438.98,1404187.58
292105,201905,213,184,29,183632,28942,212574
292110,201905,2071,780,1291,779438,1288423.86,2067861.86
292120,201905,690,545,145,543910,144710,688620
292130,201905,443,259,184,258482,183632,442114
292140,201905,205,164,41,163672,40918,204590
292145,201905,166,87,79,86826.4,78842,165668.4
292150,201905,1480,1199,281,1197600,281436,1479036
292160,201905,177,144,33,143712,32934,176646
292170,201905,1212,1063,149,1060874,148702,1209576
292180,201905,216,156,60,155688,59880,215568
292190,201905,163,100,63,99800,62874,162674
292200,201905,1291,483,808,482035.36,808381.36,1290416.72
292205,201905,128,114,14,114770,13972,128742
292210,201905,368,260,108,259480.1,107784,367264.1
292220,201905,22,17,5,16966,4990,21956
292225,201905,41,35,6,34930,5988,40918
292230,201905,970,783,187,781434.75,186626,968060.75
292240,201905,619,454,165,453092.7,164670,617762.7
292250,201905,1762,1150,612,1147700,610776.4,1758476.4
292260,201905,434,259,175,258482,174651.34,433133.34
292265,201905,253,178,75,177644,74850,252494
292270,201905,738,334,404,333332,403192.6,736524.6
292273,201905,201,113,88,112774,87824,200598
292275,201905,180,92,88,91816,87824,179640
292280,201905,144,103,41,102794,40918,143712
292285,201905,67,57,10,56886,9980,66866
292290,201905,582,395,187,394210.09,186626.4,580836.49
292300,201905,1648,643,1005,641714.4,1004986.72,1646701.12
292303,201905,104,69,35,68862,34930,103792
292305,201905,112,81,31,80838,30938,111776
292310,201905,874,574,300,572853.24,301396.56,874249.80
292320,201905,672,508,164,507982,164670,672652
292330,201905,181,103,78,102794,77844,180638
292335,201905,288,226,62,225548,61876,287424
292340,201905,579,409,170,408182.4,169660,577842.4
292350,201905,272,146,126,145708,125748,271456
292360,201905,711,542,169,541914.56,168662,710576.56
292370,201905,759,584,175,582832,174650,757482
292380,201905,665,522,143,520956.54,142714,663670.54
292390,201905,494,197,297,196606,296406,493012
292400,201905,3466,2162,1304,2157678.14,1303389,3461067.14
292405,201905,271,182,89,181636,88822,270458
292410,201905,143,87,56,86826,55888,142714
292420,201905,299,257,42,256486,41916,298402
292430,201905,529,414,115,413172,114770,527942
292440,201905,592,508,84,507982.44,83832,591814.44
292450,201905,263,203,60,202594,59880,262474
292460,201905,569,426,143,426146.98,142714,568860.98
292465,201905,221,180,41,179640,40918,220558
292467,201905,111,69,42,68862,41916,110778
292470,201905,281,192,89,191616,88822,280438
292480,201905,343,234,109,233532,108782.4,342314.4
292490,201905,227,155,72,154690,71856,226546
292500,201905,1124,497,627,496006.75,625746,1121752.75
292510,201905,3406,1569,1837,1565862.44,1836321.18,3402183.62
292520,201905,1081,515,566,514968.99,564868.98,1079837.97
292525,201905,401,286,115,285428,114770,400198
292530,201905,4296,1762,2534,1759477.73,2530933.5,4290411.23
292540,201905,469,257,212,256486,211576,468062
292550,201905,1050,569,481,568874.44,480049.54,1048923.98
292560,201905,325,306,19,305388,18962,324350
292570,201905,302,232,70,231536,69860,301396
292575,201905,487,315,172,314370.4,171656,486026.4
292580,201905,978,644,334,643710,333332.4,977042.4
292590,201905,558,483,75,482034,74850,556884
292593,201905,140,112,28,111776,27944,139720
292595,201905,187,144,43,144710,42914,187624
292600,201905,1258,926,332,924148.63,332334,1256482.63
292610,201905,132,101,31,100798,30938,131736
292620,201905,536,449,87,449101.38,86826,535927.38
292630,201905,1408,808,600,806384.67,599798.27,1406182.94
292640,201905,812,565,247,564868,246506,811374
292650,201905,184,156,28,155688.4,27944,183632.4
292660,201905,2050,1476,574,1473049.15,572853.34,2045902.49
292665,201905,147,106,41,105788,40918,146706
292670,201905,406,327,79,326346.99,78842,405188.99
292680,201905,261,200,61,199600,60878,260478
292690,201905,192,146,46,145708,45908,191616
292700,201905,950,634,316,632732,315368,948100
292710,201905,108,95,13,94810,12974,107784
292720,201905,903,509,394,508980,394210,903190
292730,201905,199,93,106,92814,105788,198602
292740,201905,67937,33809,34128,33756389.35,34084737.53,67841126.88
292750,201905,384,275,109,274450.78,108782,383232.78
292760,201905,333,275,58,274450.38,57884,332334.38
292770,201905,798,346,452,345308.8,451096,796404.8
292780,201905,411,160,251,160678,251496,412174
292790,201905,742,368,374,367264,374250,741514
292800,201905,1213,736,477,734528,476046,1210574
292805,201905,399,114,285,113772,284430,398202
292810,201905,1491,851,640,850296.8,639718.98,1490015.78
292820,201905,737,607,130,605786.7,129740.98,735527.68
292830,201905,103,85,18,84830,17964,102794
292840,201905,689,568,121,566864.6,120758,687622.6
292850,201905,138,94,44,93812,43912,137724
292860,201905,2215,1307,908,1304386.4,906184,2210570.4
292870,201905,3502,2352,1150,2347299.53,1149696,3496995.53
292880,201905,1490,967,523,966065.42,521954,1488019.42
292890,201905,505,434,71,433133.94,70858,503991.94
292895,201905,139,91,48,90818,47904,138722
292900,201905,393,284,109,283432.25,108782,392214.25
292905,201905,460,234,226,233532,227544,461076
292910,201905,437,335,102,334330.3,101796,436126.3
292920,201905,539,243,296,242514,295408,537922
292925,201905,503,465,38,464070,37924.96,501994.96
292930,201905,585,358,227,357284,226546,583830
292935,201905,287,122,165,121756,164670.98,286426.98
292937,201905,249,170,79,169660,78842,248502
292940,201905,199,156,43,155688,42914,198602
292950,201905,1130,587,543,586825.3,541914,1128739.3
292960,201905,614,427,187,426146,186626,612772
292970,201905,247,178,69,177644,69860,247504
292975,201905,133,75,58,74850,57884.6,132734.6
292980,201905,281,190,91,189620.76,90818,280438.76
292990,201905,1333,995,338,993010.8,338322,1331332.8
293000,201905,109,80,29,79840,28942,108782
293010,201905,2775,1687,1088,1683626.3,1087820.99,2771447.29
293015,201905,668,537,131,535926,130738,666664
293020,201905,344,280,64,279440,63872,343312
293030,201905,612,536,76,534928.8,75848,610776.8
293040,201905,352,282,70,281436,69860,351296
293050,201905,2786,1653,1133,1650692.4,1130735.98,2781428.38
293060,201905,257,207,50,206586.58,49900,256486.58
293070,201905,3469,1801,1668,1797400.89,1665664.88,3463065.77
293075,201905,92,61,31,60878,30938,91816
293076,201905,73,49,24,48902,23952,72854
293077,201905,475,285,190,284430.4,189620,474050.4
293080,201905,455,410,45,409180.74,45908,455088.74
293090,201905,133,117,16,116766,15968,132734
293100,201905,533,371,162,371256,161676,532932
293105,201905,347,244,103,244510,102794,347304
293110,201905,174,124,50,123752,49900,173652
293120,201905,333,228,105,227544.45,104790,332334.45
293130,201905,247,169,78,168662,77844,246506
293135,201905,8006,3197,4809,3192623.26,4801431.94,7994055.20
293140,201905,195,127,68,126746.6,67864,194610.6
293150,201905,330,283,47,282434,46906,329340
293160,201905,429,247,182,246506,181636,428142
293170,201905,158,109,49,108782,48902,157684
293180,201905,483,340,143,339320.4,142714,482034.4
293190,201905,1344,939,405,938120.7,404190,1342310.7
293200,201905,540,481,59,480038,58882,538920
293210,201905,380,293,87,292414.68,86826,379240.68
293220,201905,2595,1081,1514,1080834,1511970.58,2592804.58
293230,201905,1731,638,1093,636724.35,1090814,1727538.35
293240,201905,225,206,19,205588,18962,224550
293245,201905,120,100,20,99800,19960,119760
293250,201905,708,262,446,262474.67,446106,708580.67
293260,201905,297,251,46,250498,45908,296406
293270,201905,1147,544,603,542912.68,601794,1144706.68
293280,201905,261,149,112,148702,111776,260478
293290,201905,3067,2015,1052,2010970.4,1050895.97,3061866.37
293300,201905,723,518,205,516965.67,204590,721555.67
293305,201905,166,139,27,138722,26946,165668
293310,201905,145,110,35,109780,34930,144710
293315,201905,169,131,38,130738,37924,168662
293317,201905,93,66,27,65868,26946,92814
293320,201905,991,571,420,569858.5,419160,989018.5
293325,201905,189,72,117,71856,116766,188622
293330,201905,13117,6193,6924,6183610.72,6916146.92,13099757.64
293340,201905,260,192,68,191616,67864,259480
293345,201905,245,195,50,194610,49900,244510
293350,201905,636,360,276,359280.4,276446,635726.4
293360,201905,1566,1118,448,1115764,447104,1562868
310010,201905,144,75,69,74850,68862.4,143712.4
310020,201905,1066,597,469,595806.4,468062.44,1063868.84
310030,201905,335,274,61,273452.2,60878,334330.2
310040,201905,47,32,15,31936,14970,46906
310050,201905,184,117,67,116766,66866,183632
310060,201905,249,175,74,174650,73852,248502
310070,201905,15,8,7,7984,6986,14970
310080,201905,44,24,20,23952,19960,43912
310090,201905,992,527,465,525947.6,464070.8,990018.4
310100,201905,309,241,68,240518,67864,308382
310110,201905,723,396,327,395208,326346.4,721554.4
310120,201905,382,212,170,211576,170658,382234
310130,201905,34,22,12,21956,11976,33932
310140,201905,23,12,11,11976,10978,22954
310150,201905,1261,869,392,868261,391216.8,1259477.8
310160,201905,2092,1065,1027,1062871.17,1025944.8,2088815.97
310163,201905,96,54,42,53892,41916,95808
310170,201905,2594,1141,1453,1138718.74,1452092.6,2590811.34
310180,201905,130,49,81,48902,80838,129740
310190,201905,480,336,144,336326,143712,480038
310200,201905,499,320,179,319360.4,178642,498002.4
310205,201905,51,38,13,37924,12974,50898
310210,201905,289,235,54,234530,53892,288422
310220,201905,58,35,23,34930,22954,57884
310230,201905,272,190,82,189620,81836,271456
310240,201905,108,95,13,94810,12974,107784
310250,201905,102,81,21,80838,20958,101796
310260,201905,766,417,349,417166.04,349300,766466.04
310270,201905,281,190,91,189620.84,90818,280438.84
310280,201905,366,274,92,273452,91816,365268
310285,201905,215,155,60,154690,59880,214570
310290,201905,255,143,112,142714,111776,254490
310300,201905,152,125,27,124750,26946,151696
310310,201905,9,7,2,6986,1996,8982
310320,201905,30,15,15,14970,14970,29940
310330,201905,33,25,8,24950,7984,32934
310340,201905,1761,1172,589,1170655.4,587822.4,1758477.8
310350,201905,2880,1586,1294,1585823.78,1292410.98,2878234.76
310360,201905,40,33,7,32934,6986,39920
310370,201905,122,102,20,101796,19960.4,121756.4
310375,201905,111,42,69,41916,68862.96,110778.96
310380,201905,45,25,20,24950,19960,44910
310390,201905,92,63,29,62874,28942,91816
310400,201905,2385,1588,797,1584824.8,796404,2381228.8
310410,201905,125,70,55,69860,55888,125748
310420,201905,679,361,318,361276.6,317364.2,678640.8
310430,201905,322,214,108,213572,107784,321356
310440,201905,72,43,29,42914,28942,71856
310445,201905,81,68,13,67864,12974,80838
310450,201905,838,526,312,524948,311376,836324
310460,201905,263,188,75,187624,74850,262474
310470,201905,511,333,178,332334,177644,509978
310480,201905,79,59,20,58882,19960,78842
310490,201905,527,256,271,255488,270458,525946
310500,201905,131,54,77,53892,76846,130738
310510,201905,600,407,193,406186,192614.98,598800.98
310520,201905,133,94,39,93812,38922,132734
310530,201905,99,43,56,42914,55888,98802
310540,201905,466,283,183,282434.6,182634,465068.6
310550,201905,85,56,29,55888,28942,84830
310560,201905,3004,2066,938,2061870.8,937122,2998992.8
310570,201905,108,74,34,73852,33932,107784
310590,201905,364,239,125,238522.4,124750,363272.4
310600,201905,158,90,68,89820.4,67864,157684.4
310610,201905,61,24,37,23952,36926,60878
310620,201905,47303,22921,24382,22886091.06,24359200.34,47245291.40
310630,201905,627,404,223,403192,222554.4,625746.4
310640,201905,149,121,28,120758,27944,148702
310650,201905,162,142,20,141716,19960,161676
310660,201905,89,59,30,58882,29940,88822
310665,201905,59,43,16,42914,15968,58882
310670,201905,6612,2965,3647,2960075.02,3645721.48,6605796.50
310680,201905,60,37,23,36926,22954,59880
310690,201905,590,418,172,417164.1,171656,588820.1
310700,201905,57,38,19,37924,18962,56886
310710,201905,1335,913,422,912173.38,423152.4,1335325.78
310720,201905,101,31,70,30938,69860,100798
310730,201905,1403,991,412,990016.9,411176,1401192.9
310740,201905,985,557,428,555887.2,427144.5,983031.7
310750,201905,243,144,99,143712.66,99800,243512.66
310760,201905,64,44,20,43912,19960.4,63872.4
310770,201905,93,43,50,42914,49900,92814
310780,201905,390,319,71,318362.98,70858,389220.98
310790,201905,100,83,17,82834,16966,99800
310800,201905,458,227,231,226546.5,230538,457084.5
310810,201905,171,121,50,120758.18,49900,170658.18
310820,201905,353,279,74,279440,73852,353292
310825,201905,202,168,34,167664,33932,201596
310830,201905,464,225,239,224550.4,238522,463072.4
310840,201905,368,213,155,212574,154690,367264
310850,201905,109,87,22,86826,21956,108782
310855,201905,401,319,82,318362,81836,400198
310860,201905,1597,1194,403,1194608.76,402194.7,1596803.46
310870,201905,54,44,10,43912,9980,53892
310880,201905,84,65,19,64870,18962,83832
310890,201905,306,184,122,183632,121756,305388
310900,201905,656,305,351,304390.6,350298.96,654689.56
310910,201905,242,167,75,167664.6,75848,243512.6
310920,201905,473,282,191,281436.9,190618,472054.9
310925,201905,36,28,8,27944,7984.4,35928.4
310930,201905,1076,661,415,660691.84,414180.89,1074872.73
310940,201905,674,349,325,348302,324350,672652
310945,201905,120,73,47,72854,46906,119760
310950,201905,250,200,50,200598,49900,250498
310960,201905,82,28,54,27944,53892.99,81836.99
310970,201905,165,102,63,101796,62874,164670
310980,201905,47,26,21,25948,20958,46906
310990,201905,149,82,67,81836,66866,148702
311000,201905,831,425,406,424151.77,406186.98,830338.75
311010,201905,43,36,7,35928,6986,42914
311020,201905,42,26,16,25948,15968,41916
311030,201905,396,236,160,235528,159680,395208
311040,201905,39,35,4,34930,3992,38922
311050,201905,471,191,280,190618.8,279440,470058.8
311060,201905,767,437,330,436126.4,330338.4,766464.8
311070,201905,347,166,181,165668,180638,346306
311080,201905,110,60,50,59880,49900,109780
311090,201905,342,161,181,160678.4,180638,341316.4
311100,201905,604,359,245,358282,244510,602792
311110,201905,696,486,210,486026.4,209580.98,695607.38
311115,201905,76,55,21,54890,20958,75848
311120,201905,1094,580,514,578840.4,513970,1092810.4
311130,201905,380,229,151,228542,150698,379240
311140,201905,160,88,72,87824,72854,160678
311150,201905,365,243,122,242514,121756,364270
311160,201905,726,523,203,523950.4,202594,726544.4
311170,201905,81,63,18,62874,17964,80838
311180,201905,350,234,116,233532,115768.4,349300.4
311190,201905,34,16,18,15968,17964,33932
311200,201905,329,234,95,233532,94810,328342
311205,201905,33,23,10,22954,9980,32934
311210,201905,48,40,8,39920.8,7984,47904.8
311220,201905,19,18,1,17964,998,18962
311230,201905,1647,1080,567,1077840.6,565866,1643706.6
311240,201905,174,113,61,112774,60878,173652
311250,201905,100,29,71,28942,70858,99800
311260,201905,560,356,204,355288,203592,558880
311265,201905,116,81,35,80838,34930,115768
311270,201905,290,204,86,203592,85828,289420
311280,201905,208,98,110,97804,109780,207584
311290,201905,111,89,22,88822,21956.4,110778.4
311300,201905,592,375,217,374250,216566,590816
311310,201905,25,19,6,18962,5988,24950
311320,201905,668,501,167,499998,167664,667662
311330,201905,1081,801,280,800396,279440.8,1079836.8
311340,201905,2636,1869,767,1865262.8,765466.98,2630729.78
311350,201905,274,212,62,211576,61876,273452
311360,201905,180,112,68,111776,67864,179640
311370,201905,1208,506,702,504988.5,702592.96,1207581.46
311380,201905,7,6,1,5988,998,6986
311390,201905,262,143,119,142714,118762,261476
311400,201905,156,106,50,105788,49900,155688
311410,201905,101,57,44,56886.4,43912,100798.4
311420,201905,302,170,132,169661,131736,301397
311430,201905,865,574,291,572852.9,290418.4,863271.3
311440,201905,485,341,144,340318,143712,484030
311450,201905,326,208,118,207584,117764,325348
311455,201905,291,201,90,200598.98,89820,290418.98
311460,201905,137,57,80,56886,79840,136726
311470,201905,23,14,9,13972,8982,22954
311480,201905,43,19,24,18962,23952,42914
311490,201905,17,11,6,10978,5988,16966
311500,201905,23,10,13,9980,12974,22954
311510,201905,636,453,183,453092,182634,635726
311520,201905,41,33,8,32934,7984,40918
311530,201905,1803,1342,461,1340315.28,460078,1800393.28
311535,201905,71,51,20,50898,19960,70858
311540,201905,36,31,5,30938,4990,35928
311545,201905,196,144,52,143712,51896,195608
311547,201905,34,25,9,24950,8982,33932
311550,201905,673,323,350,322354,350298.98,672652.98
311560,201905,41,28,13,27944,12974,40918
311570,201905,292,198,94,197604,93812,291416
311580,201905,326,193,133,192614,132734,325348
311590,201905,34,30,4,29940,3992,33932
311600,201905,98,79,19,78842,18962,97804
311610,201905,256,222,34,221556.5,33932,255488.5
311615,201905,116,97,19,96806,18962,115768
311620,201905,22,12,10,11976,9980,21956
311630,201905,87,74,13,73852,12974,86826
311640,201905,134,72,62,71856,61876,133732
311650,201905,132,95,37,94810,36926,131736
311660,201905,415,202,213,201596,212574,414170
311670,201905,163,106,57,106786.58,56886,163672.58
311680,201905,216,159,57,158682,56886,215568
311690,201905,14,9,5,8982,4990,13972
311700,201905,200,141,59,140718,58882,199600
311710,201905,206,131,75,130738,74850,205588
311720,201905,40,29,11,28942.4,10978,39920.4
311730,201905,600,398,202,397204,201596.98,598800.98
311740,201905,37,27,10,26946,9980,36926
311750,201905,714,482,232,481037.36,231536,712573.36
311760,201905,58,33,25,32934,24950,57884
311770,201905,395,201,194,200599.34,193612,394211.34
311780,201905,176,97,79,96806.4,78842,175648.4
311783,201905,86,76,10,75848,9980,85828
311787,201905,35,14,21,13972,20958,34930
311790,201905,268,124,144,123752,143712,267464
311800,201905,676,456,220,455088.5,220558,675646.5
311810,201905,49,41,8,40918,7984,48902
311820,201905,115,98,17,97804,16966,114770
311830,201905,1949,1236,713,1235525.5,711574,1947099.5
311840,201905,1024,570,454,568862,453092.9,1021954.9
311850,201905,11,7,4,6986,3992,10978
311860,201905,9549,4361,5188,4360264.7,5185613.85,9545878.55
311870,201905,141,78,63,77844,62874,140718
311880,201905,940,699,241,697603.38,240518,938121.38
311890,201905,218,110,108,109698,107784,217482
311900,201905,79,33,46,32934,45908,78842
311910,201905,1425,896,529,894208.7,528940.4,1423149.1
311920,201905,228,151,77,150698,76846,227544
311930,201905,911,525,386,523950.4,385228.5,909178.9
311940,201905,2520,1342,1178,1339316,1175644.86,2514960.86
311950,201905,60,46,14,45908,13972,59880
311960,201905,66,47,19,46906,18962,65868
311970,201905,26,16,10,15968,9980,25948
311980,201905,46,36,10,35928,9980,45908
311990,201905,47,36,11,35928,10978,46906
311995,201905,60,41,19,40918,18962,59880
312000,201905,34,25,9,24950,8982,33932
312010,201905,84,63,21,62874,20958,83832
312015,201905,98,74,24,73852.4,23952,97804.4
312020,201905,127,85,42,84830.4,41916,126746.4
312030,201905,52,41,11,40918,10978,51896
312040,201905,86,54,32,53892,31936,85828
312050,201905,204,113,91,112774,90818,203592
312060,201905,63,38,25,37924,24950,62874
312070,201905,73,46,27,45908,26946,72854
312080,201905,538,250,288,250498,287424,537922
312083,201905,56,40,16,39920,15968,55888
312087,201905,110,87,23,86826,22954,109780
312090,201905,3094,1841,1253,1839750.96,1252491.36,3092242.32
312100,201905,153,106,47,105558.86,46906,152464.86
312110,201905,116,72,44,71856,43912,115768
312120,201905,148,111,37,110778.97,36926,147704.97
312125,201905,90,48,42,48902,41916,90818
312130,201905,124,86,38,85828,37924,123752
312140,201905,148,115,33,114770.4,32934,147704.4
312150,201905,46,36,10,35928,9980,45908
312160,201905,1555,1024,531,1022043.2,531934.4,1553977.6
312170,201905,11,10,1,9980,998,10978
312180,201905,106,67,39,66866,38922.8,105788.8
312190,201905,31,27,4,26946,3992,30938
312200,201905,760,652,108,650696.4,107784,758480.4
312210,201905,92,61,31,60878,30938,91816
312220,201905,135,98,37,97804.5,36926,134730.5
312230,201905,3609,1766,1843,1763469.12,1840321.04,3603790.16
312235,201905,166,114,52,113772,51896,165668
312240,201905,107,75,32,74850,31936,106786
312245,201905,176,124,52,123752.99,51896,175648.99
312247,201905,63,44,19,43912,18962,62874
312250,201905,174,84,90,83832,89820,173652
312260,201905,116,76,40,75848,39920,115768
312270,201905,138,84,54,83832,53892,137724
312280,201905,30,17,13,16966,12974,29940
312290,201905,156,108,48,107784,47904.6,155688.6
312300,201905,209,137,72,136726,71856,208582
312310,201905,58,53,5,52894,4990,57884
312320,201905,436,278,158,277444,157684,435128
312330,201905,94,84,10,83832,9980,93812
312340,201905,38,17,21,16966,20958,37924
312350,201905,18,11,7,10978,6986,17964
312352,201905,99,70,29,69860,28942,98802
312360,201905,558,249,309,248502,309380,557882
312370,201905,306,175,131,174650,130738.4,305388.4
312380,201905,147,101,46,100798,45908,146706
312385,201905,169,136,33,136726,32934,169660
312390,201905,308,193,115,192614,114770,307384
312400,201905,383,296,87,295408,86827,382235
312410,201905,927,304,623,303392,621755.39,925147.39
312420,201905,626,486,140,485028.4,139720,624748.4
312430,201905,863,640,223,638721.89,222554,861275.89
312440,201905,44,34,10,33932,9980,43912
312450,201905,207,129,78,128742,77844,206586
312460,201905,33,16,17,15968,16966,32934
312470,201905,53,34,19,33932,18962,52894
312480,201905,201,122,79,121756,78842,200598
312490,201905,275,194,81,193612,80838,274450
312500,201905,35,20,15,19960,14970,34930
312510,201905,492,193,299,192614,298402,491016
312520,201905,41,13,28,13972,27944,41916
312530,201905,51,36,15,36926,14970,51896
312540,201905,101,88,13,87824,12974,100798
312550,201905,38,29,9,28942,8982,37924
312560,201905,223,170,53,169660.4,52894,222554.4
312570,201905,445,267,178,266466,177644,444110
312580,201905,88,46,42,45908,41916,87824
312590,201905,260,204,56,203592,55888,259480
312595,201905,137,123,14,123752,13972,137724
312600,201905,70,43,27,42914.1,26946,69860.1
312610,201905,1609,849,760,847303.6,760476,1607779.6
312620,201905,198,143,55,142714,54890,197604
312630,201905,71,58,13,57884,12974,70858
312640,201905,43,11,32,10978,31936,42914
312650,201905,155,130,25,129740.4,24950,154690.4
312660,201905,79,59,20,58882.7,19960,78842.7
312670,201905,890,590,300,588820,299400,888220
312675,201905,37,29,8,28942,7984,36926
312680,201905,84,56,28,55888,27944,83832
312690,201905,240,131,109,131736,108782,240518
312695,201905,38,31,7,30938,6986,37924
312700,201905,221,131,90,130738,90818,221556
312705,201905,83,69,14,68862,13972,82834
312707,201905,132,95,37,94810.3,36926,131736.3
312710,201905,1906,1035,871,1034926.65,872252,1907178.65
312720,201905,63,31,32,30938,31936,62874
312730,201905,279,165,114,164670,113772,278442
312733,201905,53,45,8,44910,7984,52894
312735,201905,25,17,8,16966,7984,24950
312737,201905,71,37,34,36926,33932,70858
312738,201905,55,39,16,38922,15968,54890
312740,201905,74,49,25,48902.4,24950,73852.4
312750,201905,69,50,19,49900,18962,68862
312760,201905,279,203,76,202594,75848,278442
312770,201905,7650,3571,4079,3564863.92,4077831.93,7642695.85
312780,201905,417,322,95,322354,94810,417164
312790,201905,24,19,5,18962,4990,23952
312800,201905,1623,1135,488,1132730.9,487024.46,1619755.36
312810,201905,377,244,133,243512,132734,376246
312820,201905,192,143,49,142714,48902,191616
312825,201905,26,18,8,17964,7984,25948
312830,201905,262,154,108,153692.46,107784,261476.46
312840,201905,155,110,45,109780,44910,154690
312850,201905,50,45,5,44910,4990,49900
312860,201905,162,101,61,100798,60878,161676
312870,201905,1008,541,467,540916.9,466066,1006982.9
312880,201905,146,103,43,102794,42914,145708
312890,201905,164,117,47,116766,46906,163672
312900,201905,205,156,49,155688,48902,204590
312910,201905,184,98,86,97804,85828,183632
312920,201905,155,89,66,88822,65868,154690
312930,201905,326,234,92,233532,91816,325348
312940,201905,111,80,31,79840,30938,110778
312950,201905,704,472,232,471056,231536,702592
312960,201905,174,131,43,130738.96,42914,173652.96
312965,201905,60,53,7,52894,6986,59880
312970,201905,276,221,55,220558.4,54890,275448.4
312980,201905,2411,1263,1148,1260476.18,1146702.99,2407179.17
312990,201905,47,26,21,25948,20958,46906
313000,201905,47,27,20,26946,19960,46906
313005,201905,173,137,36,136726,35928.4,172654.4
313010,201905,933,383,550,382234,548900.98,931134.98
313020,201905,190,101,89,100798,88822,189620
313030,201905,204,133,71,132734.54,70858,203592.54
313040,201905,70,25,45,24950,44910,69860
313050,201905,206,145,61,144710,61876,206586
313055,201905,45,34,11,33932,10978,44910
313060,201905,124,89,35,88822,34930,123752
313065,201905,58,41,17,40918,16966,57884
313070,201905,140,75,65,74850,64870,139720
313080,201905,43,19,24,18962,23952,42914
313090,201905,709,492,217,491016.4,216566,707582.4
313100,201905,170,63,107,62874,106786,169660
313110,201905,139,77,62,76846,61876,138722
313115,201905,186,104,82,103792,81836,185628
313120,201905,788,452,336,451096.4,336326.4,787422.8
313130,201905,5523,3061,2462,3056880.58,2458075.9,5514956.48
313140,201905,151,80,71,79840,70858,150698
313150,201905,310,247,63,246506,62874,309380
313160,201905,197,145,52,144710.4,51896,196606.4
313170,201905,1412,979,433,977043.6,432134.98,1409178.58
313180,201905,309,185,124,184630,123752,308382
313190,201905,755,461,294,461076,293412.2,754488.2
313200,201905,29,26,3,25948,2994,28942
313210,201905,1028,873,155,871255.62,154690,1025945.62
313220,201905,255,169,86,168662,85828.4,254490.4
313230,201905,276,208,68,207584.65,67864,275448.65
313240,201905,1967,1055,912,1052894.29,910176,1963070.29
313250,201905,1286,975,311,974048.8,310379.12,1284427.92
313260,201905,91,52,39,51896,38922,90818
313270,201905,965,570,395,568860.3,394210.4,963070.7
313280,201905,58,48,10,47904,9980,57884
313290,201905,222,179,43,178642.4,42914,221556.4
313300,201905,358,186,172,185629,171656,357285
313310,201905,247,127,120,126746,119760,246506
313320,201905,375,286,89,285428.6,88822,374250.6
313330,201905,1388,872,516,870256,514968,1385224
313340,201905,336,238,98,237524,97804,335328
313350,201905,506,343,163,343312,163672,506984
313360,201905,117,68,49,67864,48902.4,116766.4
313370,201905,194,74,120,73852,119760,193612
313375,201905,275,168,107,167664,106786,274450
313380,201905,1336,715,621,713570.2,620756.99,1334327.19
313390,201905,55,49,6,48902.6,5988,54890.6
313400,201905,417,283,134,282434.6,133732.8,416167.4
313410,201905,23,13,10,12974,9980,22954
313420,201905,4685,2506,2179,2500989.6,2175641.69,4676631.29
313430,201905,140,70,70,69860,70858,140718
313440,201905,1469,1012,457,1012971.08,458084,1471055.08
313450,201905,64,28,36,27944,35928,63872
313460,201905,386,178,208,178642,207584,386226
313470,201905,534,248,286,247504,285428,532932
313480,201905,150,106,44,105788.4,43912,149700.4
313490,201905,518,251,267,250498.4,266466.9,516965.3
313500,201905,20,12,8,11976,7984,19960
313505,201905,1017,809,208,808380,208582,1016962
313507,201905,99,61,38,60878,37924,98802
313510,201905,2794,1800,994,1796401,994008,2790409
313520,201905,3534,2769,765,2766461.39,763470.99,3529932.38
313530,201905,40,27,13,26946,12974,39920
313535,201905,51,44,7,43912,6986,50898
313540,201905,76,58,18,57884,17964,75848
313545,201905,115,97,18,96806,17964,114770
313550,201905,236,199,37,198602,36926.4,235528.4
313560,201905,329,168,161,167664,160678,328342
313570,201905,57,28,29,27944,28942,56886
313580,201905,1339,754,585,754488,585827.2,1340315.2
313590,201905,77,45,32,44910,31936,76846
313600,201905,682,419,263,419160,263472.4,682632.4
313610,201905,62,50,12,49900.8,11976,61876.8
313620,201905,1386,735,651,734528.8,649698,1384226.8
313630,201905,1648,1267,381,1264716.8,380238,1644954.8
313640,201905,128,76,52,75848,51896,127744
313650,201905,240,114,126,113772,125748.4,239520.4
313652,201905,18,18,0,17964,0,17964
313655,201905,60,37,23,36926,22954,59880
313657,201905,47,44,3,43912,2994,46906
313660,201905,133,93,40,92814,39937.96,132751.96
313665,201905,665,331,334,330338,333332,663670
313670,201905,10331,7138,3193,7126726.4,3189609.2,10316335.6
313680,201905,42,31,11,30938,10978.78,41916.78
313690,201905,156,117,39,116766,38922,155688
313695,201905,76,59,17,58882,16966,75848
313700,201905,315,254,61,253492.4,60878,314370.4
313710,201905,142,98,44,97804,43912,141716
313720,201905,1123,545,578,543910.4,577843.4,1121753.8
313730,201905,62,43,19,42914,18962,61876
313740,201905,158,129,29,128742,28942,157684
313750,201905,430,317,113,316366,112774,429140
313753,201905,244,181,63,180638,62874,243512
313760,201905,1281,470,811,469060.4,809380.1,1278440.5
313770,201905,362,269,93,268462.5,92814,361276.5
313780,201905,758,398,360,398202,359280,757482
313790,201905,29,28,1,27944,998,28942
313800,201905,145,92,53,91816,52894,144710
313810,201905,70,41,29,40918,28942,69860
313820,201905,1311,650,661,648701.2,659680.34,1308381.54
313830,201905,63,47,16,46906,15968,62874
313835,201905,61,51,10,50898,9980,60878
313840,201905,1715,1067,648,1064867.2,646704.8,1711572.0
313850,201905,186,68,118,67864,117764,185628
313860,201905,474,363,111,362274.4,110778,473052.4
313862,201905,174,116,58,115768,57884,173652
313865,201905,103,81,22,80838,21956,102794
313867,201905,48,38,10,37924,9980,47904
313868,201905,31,20,11,19960,10978,30938
313870,201905,125,66,59,65868,58882,124750
313880,201905,368,236,132,235528,131736.4,367264.4
313890,201905,334,181,153,180639,152694,333333
313900,201905,908,502,406,501994.5,405188.9,907183.4
313910,201905,143,105,38,104790,37924,142714
313920,201905,631,449,182,448102,181636.9,629738.9
313925,201905,31,28,3,27944,2994,30938
313930,201905,831,651,180,649698,179640.95,829338.95
313940,201905,1822,1150,672,1147700,670656.4,1818356.4
313950,201905,937,603,334,602792.8,334330,937122.8
313960,201905,1379,802,577,801394.76,575847.8,1377242.56
313970,201905,131,87,44,86826,43912,130738
313980,201905,220,142,78,141716.5,77844,219560.5
313990,201905,379,222,157,221556,156686,378242
314000,201905,927,626,301,624749.74,300398,925147.74
314010,201905,80,53,27,52894,26946,79840
314015,201905,55,17,38,16966,37924,54890
314020,201905,55,39,16,38922,15968,54890
314030,201905,80,39,41,38922,40918,79840
314040,201905,44,28,16,27944,15968,43912
314050,201905,295,176,119,175648.4,118762,294410.4
314053,201905,95,61,34,60878.4,33932,94810.4
314055,201905,305,187,118,186626,117764,304390
314060,201905,145,125,20,124750.4,19960,144710.4
314070,201905,1058,565,493,563870,492014,1055884
314080,201905,216,139,77,138722,76846.36,215568.36
314085,201905,145,100,45,99800,44910,144710
314090,201905,369,266,103,265468.9,102794,368262.9
314100,201905,478,395,83,394210.3,82834,477044.3
314110,201905,735,401,334,401196.4,333332,734528.4
314120,201905,91,53,38,52894,37924,90818
314130,201905,22,12,10,11976,9980,21956
314140,201905,1115,690,425,689618.4,424150,1113768.4
314150,201905,166,106,60,105788,59880,165668
314160,201905,349,265,84,264470.6,83832.6,348303.2
314170,201905,77,61,16,60878,15968,76846
314180,201905,733,649,84,648700.8,83832.5,732533.3
314190,201905,100,62,38,61876,37924,99800
314200,201905,476,325,151,324350,150698,475048
314210,201905,261,202,59,201596,58882.4,260478.4
314220,201905,312,234,78,233532.4,77844.4,311376.8
314225,201905,67,49,18,48902,17964,66866
314230,201905,119,54,65,53892,64870,118762
314240,201905,141,108,33,107784,32934,140718
314250,201905,60,38,22,37924,21956,59880
314260,201905,227,110,117,109780,116766,226546
314270,201905,334,265,69,264470,68862,333332
314280,201905,706,401,305,400198.98,304390,704588.98
314290,201905,554,456,98,455088.9,97804,552892.9
314300,201905,385,279,106,278444.5,105788.9,384233.4
314310,201905,1421,963,458,962322.53,458082,1420404.53
314315,201905,36,29,7,28942,6986,35928
314320,201905,602,398,204,398202.4,203592,601794.4
314330,201905,10883,5495,5388,5491931.65,5382217.53,10874149.18
314340,201905,588,273,315,272454,314370.8,586824.8
314345,201905,42,31,11,30938,10978,41916
314350,201905,186,119,67,118762,66866,185628
314360,201905,76,47,29,46906,28942,75848
314370,201905,61,47,14,46906,13972,60878
314380,201905,97,66,31,65868,30938,96806
314390,201905,3295,2112,1183,2110771.5,1184626.6,3295398.1
314400,201905,693,498,195,497005.5,194610,691615.5
314410,201905,470,312,158,311376,157684,469060
314420,201905,18,8,10,7984,9980,17964
314430,201905,2476,906,1570,905187.4,1566860,2472047.4
314435,201905,263,157,106,156686,105788,262474
314437,201905,28,22,6,21956,5988,27944
314440,201905,99,73,26,72854,25948,98802
314450,201905,158,115,43,114770,43912,158682
314460,201905,656,309,347,308382,346306,654688
314465,201905,87,59,28,58882,27944,86826
314467,201905,69,57,12,56886,11976,68862
314470,201905,402,205,197,204591.38,196606,401197.38
314480,201905,1098,539,559,538920,557882,1096802
314490,201905,83,60,23,59880,22954,82834
314500,201905,299,201,98,201596,97804,299400
314505,201905,130,86,44,85828,43912,129740
314510,201905,235,196,39,195608,38922,234530
314520,201905,1273,685,588,683637.6,587823.2,1271460.8
314530,201905,760,609,151,607783.66,150698,758481.66
314535,201905,213,132,81,131736,80838,212574
314537,201905,65,39,26,38922,25948,64870
314540,201905,14,9,5,8982,4990,13972
314545,201905,52,34,18,33932,17964,51896
314550,201905,81,43,38,42914,37924,80838
314560,201905,831,456,375,455089.2,374250,829339.2
314570,201905,21,17,4,16966,3992,20958
314580,201905,15,8,7,7984,6986,14970
314585,201905,26,20,6,19960,5988,25948
314587,201905,78,69,9,68862,8982,77844
314590,201905,576,422,154,422156.28,153692,575848.28
314600,201905,953,623,330,622753,329341.03,952094.03
314610,201905,955,510,445,508981.3,444110,953091.3
314620,201905,143,104,39,103792,38922,142714
314625,201905,97,72,25,71856.8,24950,96806.8
314630,201905,1215,633,582,631734,580836.4,1212570.4
314640,201905,83,57,26,56886,25948,82834
314650,201905,187,109,78,108782,77844,186626
314655,201905,66,48,18,47904,17964,65868
314660,201905,19,15,4,14970,3992,18962
314670,201905,202,155,47,154690.4,46906,201596.4
314675,201905,215,128,87,127744,86826,214570
314690,201905,558,308,250,307384,249500,556884
314700,201905,2353,1284,1069,1282431.6,1066862,2349293.6
314710,201905,1645,976,669,975048.5,667662.4,1642710.9
314720,201905,395,233,162,232534,162674,395208
314730,201905,521,270,251,269461.4,252494.98,521956.38
314740,201905,703,348,355,347304,355288,702592
314750,201905,21,19,2,18962,1996,20958
314760,201905,332,156,176,155688,175648,331336
314770,201905,109,78,31,77844.4,30938,108782.4
314780,201905,21,6,15,5988,14970,20958
314790,201905,2370,1506,864,1504987.87,863270,2368257.87
314795,201905,46,40,6,39920.5,5988,45908.5
314800,201905,2899,1705,1194,1707579.48,1191612,2899191.48
314810,201905,1532,874,658,872252,656684.6,1528936.6
314820,201905,94,50,44,49900,43912,93812
314830,201905,220,180,40,179640,39920,219560
314840,201905,87,50,37,49900,36926,86826
314850,201905,354,173,181,172654,180638,353292
314860,201905,705,531,174,529939.13,173652.7,703591.83
314870,201905,1507,795,712,793410,710576,1503986
314875,201905,58,50,8,49900,7984,57884
314880,201905,46,32,14,31936,13972,45908
314890,201905,54,31,23,30938,22954,53892
314900,201905,33,26,7,25948,6986,32934
314910,201905,251,169,82,168662,81836,250498
314915,201905,151,132,19,131736,18962,150698
314920,201905,116,71,45,70858,44910,115768
314930,201905,1074,541,533,539918.4,531934,1071852.4
314940,201905,47,37,10,36926,9980,46906
314950,201905,36,25,11,24950,10978,35928
314960,201905,51,39,12,38922,11976,50898
314970,201905,146,75,71,74850,70858,145708
314980,201905,297,188,109,187624,108782,296406
314990,201905,460,256,204,255488,203592,459080
314995,201905,208,62,146,61876,145708,207584
315000,201905,92,74,18,73852,17964,91816
315010,201905,46,30,16,29940,15968,45908
315015,201905,172,141,31,140718,30938,171656
315020,201905,72,62,10,61876,9980,71856
315030,201905,114,89,25,88822,24950.4,113772.4
315040,201905,70,51,19,50898,18962,69860
315050,201905,192,115,77,114770,76846.4,191616.4
315053,201905,44,39,5,38922,4990,43912
315057,201905,98,81,17,80838,16966,97804
315060,201905,68,60,8,59880.52,7984,67864.52
315070,201905,105,59,46,58882,45908,104790
315080,201905,380,309,71,309380,70858,380238
315090,201905,108,63,45,62874,44910,107784
315100,201905,87,44,43,43912,42914,86826
315110,201905,281,153,128,152694,128742,281436
315120,201905,1648,838,810,836324,808380.68,1644704.68
315130,201905,351,253,98,252494,97804,350298
315140,201905,526,308,218,307384.4,217564.8,524949.2
315150,201905,974,469,505,469060,503990.4,973050.4
315160,201905,221,113,108,112774,107784,220558
315170,201905,325,211,114,210578.4,113772,324350.4
315180,201905,3303,1404,1899,1401194.4,1898198.3,3299392.7
315190,201905,330,198,132,197604.2,131736,329340.2
315200,201905,1239,723,516,721554,514968,1236522
315210,201905,1621,929,692,928140.6,690616.2,1618756.8
315213,201905,39,22,17,21956,16966,38922
315217,201905,213,170,43,169660,42914,212574
315220,201905,1560,1202,358,1201593.58,358282.4,1559875.98
315230,201905,171,126,45,125748.4,44910,170658.4
315240,201905,433,277,156,276446,155688.98,432134.98
315250,201905,2540,1268,1272,1265464.5,1271452.8,2536917.3
315260,201905,146,89,57,88822,56886,145708
315270,201905,128,90,38,89820,37924,127744
315280,201905,673,439,234,438122.2,233532,671654.2
315290,201905,206,125,81,124750,80838.63,205588.63
315300,201905,75,55,20,54890,19960,74850
315310,201905,71,64,7,63872,6986,70858
315320,201905,166,95,71,94810,70858,165668
315330,201905,59,50,9,49900,8982,58882
315340,201905,399,289,110,288422,110778,399200
315350,201905,154,93,61,92814,60878,153692
315360,201905,93,49,44,48902,43912,92814
315370,201905,57,33,24,32934,23952,56886
315380,201905,11,8,3,7984,2994,10978
315390,201905,69,18,51,17964,50898,68862
315400,201905,847,635,212,633730.7,211576,845306.7
315410,201905,354,216,138,216566.4,137725.4,354291.8
315415,201905,63,47,16,46906,15968,62874
315420,201905,203,155,48,154690.4,47904,202594.4
315430,201905,662,385,277,385228.4,276446.6,661675.0
315440,201905,90,61,29,60878,28942,89820
315445,201905,250,203,47,202594,46906,249500
315450,201905,186,141,45,140718,44910,185628
315460,201905,3548,1808,1740,1804384.98,1739514.98,3543899.96
315470,201905,41,17,24,16966,23952,40918
315480,201905,63,24,39,23952,38922,62874
315490,201905,641,402,239,401196,238522,639718
315500,201905,23,16,7,15968,6986,22954
315510,201905,154,104,50,103792,49900,153692
315520,201905,72,65,7,64870,6986,71856
315530,201905,51,26,25,25948,24950,50898
315540,201905,241,162,79,161676,78842,240518
315550,201905,182,145,37,144710,36926,181636
315560,201905,734,592,142,590816.4,141716,732532.4
315570,201905,313,163,150,162675.83,149700.6,312376.43
315580,201905,705,468,237,467064,236526,703590
315590,201905,203,107,96,106786,95808,202594
315600,201905,300,226,74,225548,73852,299400
315610,201905,100,52,48,51896,47904,99800
315620,201905,33,26,7,25948,6986,32934
315630,201905,134,88,46,87824,45908,133732
315640,201905,69,43,26,42914,25948,68862
315645,201905,55,39,16,38922,15968,54890
315650,201905,168,123,45,122754.8,44910,167664.8
315660,201905,474,216,258,215568,257484,473052
315670,201905,2442,1219,1223,1217561.8,1220555.96,2438117.76
315680,201905,853,581,272,579838,271456,851294
315690,201905,685,476,209,475049.33,208582,683631.33
315700,201905,1895,1008,887,1005985.27,886224,1892209.27
315710,201905,333,97,236,96806,235528,332334
315720,201905,444,283,161,282434.4,160678,443112.4
315725,201905,202,161,41,160678.4,40918,201596.4
315727,201905,39,21,18,20958,17964,38922
315730,201905,50,48,2,47904,1996,49900
315733,201905,87,60,27,59880,27944,87824
315737,201905,50,39,11,38922,10978,49900
315740,201905,38,31,7,30938,6986,37924
315750,201905,160,123,37,122754,36926,159680
315760,201905,45,35,10,34930,9980,44910
315765,201905,123,77,46,76846,45908,122754
315770,201905,232,143,89,142714,88822.4,231536.4
315780,201905,3424,1792,1632,1789415,1630733.15,3420148.15
315790,201905,215,167,48,166666,47904,214570
315800,201905,293,215,78,214570,77844,292414
315810,201905,95,56,39,55888,38922.4,94810.4
315820,201905,774,567,207,565867.2,206586,772453.2
315830,201905,136,79,57,78842,56886,135728
315840,201905,86,60,26,59880,25948,85828
315850,201905,263,195,68,194610.5,67864,262474.5
315860,201905,12,4,8,3992,7984,11976
315870,201905,38,30,8,29940,7984,37924
315880,201905,109,71,38,70858,37924,108782
315890,201905,87,64,23,63872,22954,86826
315895,201905,460,314,146,313372.5,146706.8,460079.3
315900,201905,72,37,35,36926,34930,71856
315910,201905,40,27,13,26946,12974,39920
315920,201905,173,112,61,111776,60878.3,172654.3
315930,201905,48,18,30,17964,29940,47904
315935,201905,139,107,32,106786,31936.98,138722.98
315940,201905,94,71,23,70858,22954,93812
315950,201905,45,33,12,32934,11976,44910
315960,201905,552,266,286,265468.4,285428.4,550896.8
315970,201905,35,28,7,27944,6986,34930
315980,201905,697,339,358,338322.1,357284,695606.1
315990,201905,256,150,106,149700.5,105788.98,255489.48
316000,201905,55,35,20,34930,19960,54890
316010,201905,83,71,12,70858,11976,82834
316020,201905,114,98,16,97804,15968,113772
316030,201905,405,220,185,219560.8,184630.9,404191.7
316040,201905,516,221,295,220558.4,294410.4,514968.8
316045,201905,64,57,7,56886,6986,63872
316050,201905,15,13,2,12974,1996,14970
316060,201905,101,65,36,64870,35928,100798
316070,201905,1108,713,395,713570.1,394210,1107780.1
316080,201905,108,70,38,69860,37924,107784
316090,201905,38,22,16,21956,15968,37924
316095,201905,76,65,11,64870,10978,75848
316100,201905,317,184,133,183632.5,132734,316366.5
316105,201905,38,26,12,25948,11976,37924
316110,201905,1876,1512,364,1508977.36,363272,1872249.36
316120,201905,79,60,19,59880,18962,78842
316130,201905,128,98,30,97804.4,29940,127744.4
316140,201905,31,23,8,22954,7984,30938
316150,201905,210,145,65,144710,64870,209580
316160,201905,80,48,32,47904,31936,79840
316165,201905,69,52,17,51896.6,16966,68862.6
316170,201905,196,132,64,131736,63872,195608
316180,201905,205,89,116,89820,115768.4,205588.4
316190,201905,142,105,37,104790,36926,141716
316200,201905,687,390,297,389220.4,296406,685626.4
316210,201905,772,515,257,514141.65,256486,770627.65
316220,201905,115,77,38,76846,37924,114770
316225,201905,26,15,11,14970,10978,25948
316230,201905,32,18,14,17964,13972,31936
316240,201905,653,526,127,524948,126746,651694
316245,201905,123,104,19,103792,18962,122754
316250,201905,1558,1079,479,1076843.66,479040,1555883.66
316255,201905,124,100,24,99800,23952,123752
316257,201905,178,95,83,94810,82834,177644
316260,201905,192,135,57,134730.5,56886.8,191617.3
316265,201905,27,19,8,18962,7984,26946
316270,201905,675,475,200,474051.05,199600.84,673651.89
316280,201905,544,334,210,334331.23,210579.4,544910.63
316290,201905,720,479,241,479040.66,240518,719558.66
316292,201905,518,210,308,209580,307384.5,516964.5
316294,201905,101,60,41,59880,40918,100798
316295,201905,299,135,164,134731.36,163672,298403.36
316300,201905,99,72,27,71856,26946,98802
316310,201905,36,19,17,18962,16966,35928
316320,201905,44,27,17,26946,16966,43912
316330,201905,132,88,44,87824.5,43912,131736.5
316340,201905,144,100,44,99800,43912,143712
316350,201905,197,141,56,140718.3,55888,196606.3
316360,201905,24,17,7,16966,6986,23952
316370,201905,1083,574,509,572852.97,507982,1080834.97
316380,201905,122,94,28,93812,27944,121756
316390,201905,121,88,33,87824,32934,120758
316400,201905,135,104,31,103792,30938,134730
316410,201905,302,220,82,219560,81836,301396
316420,201905,207,146,61,145708,60878,206586
316430,201905,154,81,73,80838,72854,153692
316440,201905,97,47,50,46906,49900,96806
316443,201905,38,36,2,35928,1996,37924
316447,201905,65,50,15,49900,14970,64870
316450,201905,233,175,58,174650,57884,232534
316460,201905,74,29,45,28942,44910,73852
316470,201905,1646,1214,432,1212563.77,431136.4,1643700.17
316480,201905,13,10,3,9980,2994,12974
316490,201905,17,7,10,6986,9980,16966
316500,201905,156,102,54,101796,53892,155688
316510,201905,163,126,37,125748,36926,162674
316520,201905,197,123,74,122754,73852,196606
316530,201905,161,113,48,112774,47904,160678
316540,201905,140,77,63,77844,62874,140718
316550,201905,136,93,43,92814,42914,135728
316553,201905,266,125,141,124750,140718,265468
316555,201905,36,31,5,30938,4990,35928
316556,201905,11,8,3,7984,2994,10978
316557,201905,18,14,4,13972,3992,17964
316560,201905,70,52,18,51896,17964,69860
316570,201905,236,216,20,215568,19960,235528
316580,201905,20,16,4,15968,3992,19960
316590,201905,113,97,16,96806,15968,112774
316600,201905,183,152,31,151696,30938,182634
316610,201905,67,49,18,48902,17964,66866
316620,201905,145,111,34,110778,33932,144710
316630,201905,42,33,9,32934,8982,41916
316640,201905,19,12,7,11976,6986,18962
316650,201905,74,57,17,56886,16966,73852
316660,201905,8,3,5,2994,4990,7984
316670,201905,444,155,289,154690.96,288422,443112.96
316680,201905,156,110,46,109780,45908.6,155688.6
316690,201905,186,121,65,120758,64870,185628
316695,201905,65,57,8,56886,7984,64870
316700,201905,16,10,6,9980,5988,15968
316710,201905,754,563,191,562872.5,190618,753490.5
316720,201905,4962,2532,2430,2530932.55,2430132.74,4961065.29
316730,201905,18,17,1,16966,998,17964
316740,201905,124,81,43,80838,42914,123752
316750,201905,19,13,6,12974,5988,18962
316760,201905,322,260,62,259480,61876,321356
316770,201905,143,79,64,78842,63872,142714
316780,201905,77,48,29,47904,28942,76846
316790,201905,56,41,15,40918,14970,55888
316800,201905,1740,1090,650,1087820,648701,1736521
316805,201905,21,13,8,12974,7984,20958
316810,201905,72,49,23,48902,22954,71856
316820,201905,44,21,23,20958,22954,43912
316830,201905,89,41,48,40918,47904,88822
316840,201905,511,311,200,310378.4,199600,509978.4
316850,201905,341,224,117,223552,116766,340318
316860,201905,6042,2699,3343,2693606.06,3339308.3,6032914.36
316870,201905,1509,1002,507,999998.5,506985.2,1506983.7
316880,201905,129,65,64,64870.4,63872,128742.4
316890,201905,247,168,79,167664,78842,246506
316900,201905,435,304,131,303392.36,130738,434130.36
316905,201905,20,9,11,8982,10978,19960
316910,201905,55,23,32,22954,31936,54890
316920,201905,137,108,29,107784,28942,136726
316930,201905,1899,988,911,986024.8,910176.3,1896201.1
316935,201905,898,545,353,543910.64,352294.4,896205.04
316940,201905,1093,635,458,633730.8,457084.4,1090815.2
316950,201905,183,93,90,92814.4,90818,183632.4
316960,201905,1123,634,489,632733.13,488022.4,1120755.53
316970,201905,656,517,139,515966,139720,655686
316980,201905,114,68,46,67864,46906,114770
316990,201905,2250,1507,743,1503986.34,741515.5,2245501.84
317000,201905,331,255,76,254490,75848,330338
317005,201905,243,175,68,174650,67864,242514
317010,201905,6446,3640,2806,3635718.59,2803382.4,6439100.99
317020,201905,16486,7392,9094,7386213.36,9085809.1,16472022.46
317030,201905,82,32,50,31936,49900,81836
317040,201905,3122,1956,1166,1952090.2,1164666.6,3116756.8
317043,201905,77,56,21,55888,20958,76846
317047,201905,33,17,16,16966,16966.99,33932.99
317050,201905,176,136,40,135728,39920,175648
317052,201905,132,100,32,99800,31936,131736
317057,201905,185,141,44,140718,43912,184630
317060,201905,63,43,20,42914,19960,62874
317065,201905,59,48,11,47904,10978,58882
317070,201905,2001,945,1056,943111.9,1053888.8,1997000.7
317075,201905,111,59,52,58882,51896,110778
317080,201905,859,460,399,459080.5,398202.6,857283.1
317090,201905,657,532,125,530936,124750,655686
317100,201905,434,330,104,330338,103792,434130
317103,201905,110,93,17,92814,16966,109780
317107,201905,41,35,6,34930,5988,40918
317110,201905,112,49,63,48902,62874,111776
317115,201905,42,37,5,36926,4990,41916
317120,201905,1899,982,917,980036.8,915166.4,1895203.2
317130,201905,1993,1319,674,1317361.6,672652,1990013.6
317140,201905,12,10,2,9980,1996,11976
317150,201905,276,165,111,165668.4,110778,276446.4
317160,201905,324,238,86,237525.03,85828,323353.03
317170,201905,212,147,65,146706,65868,212574
317180,201905,443,321,122,320358,123752,444110
317190,201905,265,181,84,180638,83832,264470
317200,201905,806,563,243,562874.96,242514,805388.96
317210,201905,184,103,81,102794,80838,183632
317220,201905,23,13,10,12974,9980,22954
320010,201905,610,450,160,449100.5,160678,609778.5
320013,201905,131,97,34,96806,33932,130738
320016,201905,284,181,103,180638,103792,284430
320020,201905,723,435,288,434131.1,288422,722553.1
320030,201905,147,106,41,106786,40918,147704
320035,201905,143,108,35,107784,34930,142714
320040,201905,496,258,238,257484,238522.4,496006.4
320050,201905,105,81,24,80838,23952,104790
320060,201905,1608,774,834,772454.58,832335.74,1604790.32
320070,201905,102,68,34,67864,33932,101796
320080,201905,795,461,334,460079.89,333332.5,793412.39
320090,201905,1246,873,373,871254,373252.4,1244506.4
320100,201905,334,192,142,191616,141716,333332
320110,201905,126,81,45,80839.1,44910.4,125749.5
320115,201905,111,92,19,91816,18962,110778
320120,201905,3386,1890,1496,1886221.86,1495005.77,3381227.63
320130,201905,7526,3549,3977,3542920.45,3975067.05,7517987.50
320140,201905,430,285,145,284430.6,144711.58,429142.18
320150,201905,2009,1158,851,1156684.17,851294,2007978.17
320160,201905,674,302,372,301396.99,371257.79,672654.78
320170,201905,114,92,22,91816,21956,113772
320180,201905,53,30,23,29940,22954,52894
320190,201905,246,164,82,163672,81836.4,245508.4
320200,201905,57,46,11,45908,11976,57884
320210,201905,877,490,387,489020.8,387225.76,876246.56
320220,201905,310,118,192,117764,191616,309380
320225,201905,88,73,15,72854,14970,87824
320230,201905,593,383,210,383232.6,209580,592812.6
320240,201905,3153,1596,1557,1594805.6,1554885.78,3149691.38
320245,201905,472,326,146,326346.4,145708,472054.4
320250,201905,228,121,107,120758,107784,228542
320255,201905,145,116,29,115768,28942.7,144710.7
320260,201905,194,138,56,137724,55888,193612
320265,201905,159,126,33,125748,32934,158682
320270,201905,155,125,30,124750,29940,154690
320280,201905,1001,603,398,601796.33,397204,999000.33
320290,201905,62,54,8,53892,7984,61876
320300,201905,561,394,167,393213.34,166668.04,559881.38
320305,201905,678,369,309,368262,308382.6,676644.6
320310,201905,214,121,93,120758.76,92814,213572.76
320313,201905,316,159,157,158682.9,156686.4,315369.3
320316,201905,111,89,22,88822,21956,110778
320320,201905,3443,1597,1846,1594807.36,1845304.75,3440112.11
320330,201905,260,199,61,198602,60878,259480
320332,201905,878,529,349,528942.7,349300.9,878243.6
320334,201905,254,157,97,156686.4,96806,253492.4
320335,201905,143,101,42,100798,41916,142714
320340,201905,570,396,174,396206.9,173652,569858.9
320350,201905,988,429,559,428143.69,557883.6,986027.29
320360,201905,167,90,77,89820,77844,167664
320370,201905,246,188,58,187624.56,57884.4,245508.96
320380,201905,288,202,86,201596,85828,287424
320390,201905,1158,701,457,699599.52,456086.8,1155686.32
320400,201905,311,227,84,226547.4,83832,310379.4
320405,201905,943,412,531,411176.99,529941.38,941118.37
320410,201905,978,505,473,503990,473053.3,977043.3
320420,201905,484,250,234,249501.3,233532,483033.3
320425,201905,198,108,90,107784,89820,197604
320430,201905,394,226,168,225548.5,167664,393212.5
320435,201905,164,111,53,110778,52894,163672
320440,201905,203,121,82,120758,81836,202594
320450,201905,128,73,55,72854,55888,128742
320455,201905,250,206,44,205588.4,43912,249500.4
320460,201905,258,160,98,159680,97804.4,257484.4
320465,201905,114,78,36,77844,35928,113772
320470,201905,682,435,247,434131.39,246506.99,680638.38
320480,201905,187,122,65,121756,64870,186626
320490,201905,3087,1539,1548,1535925.79,1546910.05,3082835.84
320495,201905,101,60,41,59880.96,40918.8,100799.76
320500,201905,9851,4949,4902,4944108.75,4898199.17,9842307.92
320501,201905,543,275,268,274450,269460,543910
320503,201905,293,210,83,209580,82834,292414
320506,201905,256,186,70,185628,69860,255488
320510,201905,997,469,528,469060.4,528941.38,998001.78
320515,201905,81,68,13,67864,12974,80838
320517,201905,208,150,58,149700,57884,207584
320520,201905,6995,3136,3859,3131730,3856279.25,6988009.25
320530,201905,5780,2950,2830,2946103.32,2828335.53,5774438.85
330010,201905,3083,1614,1469,1610774.2,1468058,3078832.2
330015,201905,158,66,92,65868.56,91816,157684.56
330020,201905,3672,1624,2048,1621752.4,2045900.4,3667652.8
330022,201905,245,134,111,133732,110778,244510
330023,201905,564,196,368,195608,367264,562872
330025,201905,592,124,468,123752,469060,592812
330030,201905,1954,1275,679,1272452.66,677643.5,1950096.16
330040,201905,2422,1293,1129,1292412.5,1127742.2,2420154.7
330045,201905,8446,2749,5697,2744500.8,5692593.2,8437094.0
330050,201905,886,574,312,573850,311376,885226
330060,201905,940,581,359,580836.9,358282,939118.9
330070,201905,3491,1327,2164,1327340.98,2163665.94,3491006.92
330080,201905,1492,689,803,687623.5,801394,1489017.5
330090,201905,376,221,155,221556,154690,376246
330093,201905,275,127,148,126746,148703.88,275449.88
330095,201905,95,51,44,50898,44910,95808
330100,201905,9566,4966,4600,4962059.53,4596788.4,9558847.93
330110,201905,501,215,286,214570.7,285428,499998.7
330115,201905,553,298,255,297404,254490,551894
330120,201905,376,191,185,190618,184631.6,375249.6
330130,201905,1529,407,1122,407184.6,1119756.96,1526941.56
330140,201905,597,316,281,315368.94,281436,596804.94
330150,201905,497,285,212,284430,211576,496006
330160,201905,207,128,79,127744,78842,206586
330170,201905,27001,9505,17496,9493982.94,17484973.32,26978956.26
330180,201905,238,150,88,149700,87824,237524
330185,201905,905,330,575,329340.98,573851.92,903192.90
330187,201905,321,101,220,100798,219560,320358
330190,201905,5592,2256,3336,2252488.56,3335318.08,5587806.64
330200,201905,4789,1478,3311,1477041.44,3310367.46,4787408.90
330205,201905,422,250,172,249500,171656.4,421156.4
330210,201905,1000,621,379,619760.84,378244.18,998005.02
330220,201905,2590,1567,1023,1564865,1022950.4,2587815.4
330225,201905,560,301,259,301396,258482,559878
330227,201905,2377,761,1616,759478.4,1613769.26,2373247.66
330230,201905,221,129,92,128742,91816,220558
330240,201905,3653,1927,1726,1923153.04,1723581.06,3646734.10
330245,201905,156,71,85,71856.74,84830,156686.74
330250,201905,6804,3548,3256,3542903.05,3255480.11,6798383.16
330260,201905,565,160,405,159680,405188,564868
330270,201905,3456,1256,2200,1254486.6,2195602.8,3450089.4
330280,201905,447,288,159,287425.2,158682.98,446108.18
330285,201905,7237,2358,4879,2358275.5,4873238.32,7231513.82
330290,201905,612,234,378,233532,378242.4,611774.4
330300,201905,781,521,260,520957.5,260478.94,781436.44
330310,201905,435,247,188,246506.9,187624,434130.9
330320,201905,8128,3140,4988,3135719,4986010.31,8121729.31
330330,201905,8984,3576,5408,3574838.68,5407175.26,8982013.94
330340,201905,2728,1633,1095,1631730.6,1092810,2724540.6
330350,201905,18093,7178,10915,7167644.5,10903162.68,18070807.18
330360,201905,2338,1169,1169,1167661.76,1167661.94,2335323.70
330370,201905,1052,548,504,546904.7,503990.6,1050895.3
330380,201905,855,371,484,370258,484030.61,854288.61
330385,201905,614,324,290,323352.5,289420,612772.5
330390,201905,5367,2952,2415,2949092.4,2416158.8,5365251.2
330395,201905,300,186,114,186626,113772.7,300398.7
330400,201905,707,384,323,385229,323352,708581
330410,201905,499,361,138,360278.5,137724.4,498002.9
330411,201905,239,132,107,131736.62,106786,238522.62
330412,201905,247,103,144,102794.4,145708,248502.4
330414,201905,5912,2466,3446,2463065.88,3448090.8,5911156.68
330415,201905,579,266,313,266466.49,312374.6,578841.09
330420,201905,2266,1185,1081,1182631.42,1079837.78,2262469.20
330430,201905,1789,865,924,865267.05,924150.8,1789417.85
330440,201905,274,132,142,131736,141716,273452
330450,201905,117,51,66,50898,65868,116766
330452,201905,1820,865,955,863272.52,954088.4,1817360.92
330455,201905,110077,40196,69881,40140566.78,69844071.01,109984637.79
330460,201905,260,106,154,105788,153692.94,259480.94
330470,201905,1232,678,554,678641.3,555886.8,1234528.1
330475,201905,1388,377,1011,376246.6,1009976,1386222.6
330480,201905,800,432,368,431136,368262.6,799398.6
330490,201905,13914,4841,9073,4834313.1,9065839.66,13900152.76
330500,201905,1352,607,745,606784,745506.46,1352290.46
330510,201905,11067,3871,7196,3866253.51,7193588.6,11059842.11
330513,201905,104,51,53,50898,52894,103792
330515,201905,825,340,485,340319.26,485029.2,825348.46
330520,201905,2507,938,1569,937122.54,1567858,2504980.54
330530,201905,212,114,98,113772.5,97804.6,211577.1
330540,201905,362,180,182,179640.4,181636,361276.4
330550,201905,2936,1063,1873,1060874.8,1872248.8,2933123.6
330555,201905,806,312,494,311376.96,493012.6,804389.56
330560,201905,642,214,428,214570,427144.94,641714.94
330570,201905,257,183,74,183632,73852,257484
330575,201905,797,330,467,329340,467065.78,796405.78
330580,201905,3410,1936,1474,1934126.2,1476042.8,3410169.0
330590,201905,309,158,151,157684,150698.98,308382.98
330600,201905,1125,724,401,722552.4,400198,1122750.4
330610,201905,1565,862,703,861275.8,701596.3,1562872.1
330615,201905,201,152,49,151696,48902,200598
330620,201905,1060,435,625,437124.6,623750,1060874.6
330630,201905,4030,2586,1444,2584823.56,1444107.1,4028930.66
350010,201905,603,411,192,411176.82,191616,602792.82
350020,201905,45,21,24,20958,23952,44910
350030,201905,512,325,187,324350.4,186626.8,510977.2
350040,201905,125,48,77,47904,76846,124750
350050,201905,304,163,141,162674,141716.98,304390.98
350055,201905,83,47,36,46906,35928,82834
350060,201905,75,28,47,27944,46906,74850
350070,201905,811,483,328,482067.11,327360.64,809427.75
350075,201905,70,47,23,46906,22954,69860
350080,201905,50,30,20,29940,19960,49900
350090,201905,87,48,39,47904,38922,86826
350100,201905,291,180,111,179640,110778,290418
350110,201905,58,39,19,38922,18962,57884
350115,201905,162,97,65,97804,64870,162674
350120,201905,108,74,34,73852,34930,108782
350130,201905,344,163,181,162674.58,180638.9,343313.48
350140,201905,40,26,14,25948,13972,39920
350150,201905,71,55,16,54890,15968,70858
350160,201905,2545,1012,1533,1010979.26,1534931.92,2545911.18
350170,201905,402,243,159,242514.8,160678.4,403193.2
350180,201905,179,100,79,99800,79840,179640
350190,201905,1026,549,477,547903.59,476046.4,1023949.99
350200,201905,71,27,44,26946,43912,70858
350210,201905,1299,735,564,733532.99,562872.63,1296405.62
350220,201905,670,569,101,567862.63,101796,669658.63
350230,201905,79,54,25,53892,24950,78842
350240,201905,63,45,18,44910,17964,62874
350250,201905,1178,578,600,576845.4,598801.7,1175647.1
350260,201905,91,67,24,66866.4,23952,90818.4
350270,201905,851,562,289,561874.6,288422.4,850297.0
350275,201905,310,129,181,128742,180638,309380
350280,201905,4653,2384,2269,2381244.72,2267460.95,4648705.67
350290,201905,422,200,222,199600,221556.4,421156.4
350300,201905,60,32,28,31936,27944,59880
350310,201905,96,61,35,60878,34930,95808
350315,201905,40,25,15,24950,14970,39920
350320,201905,3261,1605,1656,1602788.9,1654685.03,3257473.93
350330,201905,1673,910,763,908182.23,762473.2,1670655.43
350335,201905,21,14,7,13972,6986,20958
350340,201905,132,62,70,61876,69860.3,131736.3
350350,201905,95,48,47,47904,46906,94810
350360,201905,127,85,42,84830.99,41916,126746.99
350370,201905,89,50,39,49900.63,38922,88822.63
350380,201905,774,336,438,335328.8,438122,773450.8
350390,201905,1506,611,895,611775.43,894208.4,1505983.83
350395,201905,27,22,5,21956,4990,26946
350400,201905,1685,878,807,878244.09,805387.62,1683631.71
350410,201905,2363,1069,1294,1067860,1293409.59,2361269.59
350420,201905,238,147,91,147705.03,90818,238523.03
350430,201905,76,46,30,45908,29940,75848
350440,201905,149,109,40,108782.4,39920,148702.4
350450,201905,1643,1009,634,1008981.07,633731.2,1642712.27
350460,201905,337,126,211,126746,210578,337324
350470,201905,16,10,6,9980,5988,15968
350480,201905,170,94,76,93812,75848,169660
350490,201905,233,119,114,118762,113772,232534
350500,201905,46,20,26,19960,25948,45908
350510,201905,168,113,55,112774.9,54890,167664.9
350520,201905,449,216,233,215568,232534,448102
350530,201905,443,207,236,206586,235528,442114
350535,201905,77,63,14,62874,13972,76846
350540,201905,381,191,190,190618,189620,380238
350550,201905,2725,1615,1110,1612770.91,1108783.39,2721554.30
350560,201905,658,460,198,459080.63,197604,656684.63
350570,201905,4114,1752,2362,1750493.63,2357278.93,4107772.56
350580,201905,386,182,204,181636.63,203592.99,385229.62
350590,201905,918,501,417,499998.4,418162.4,918160.8
350600,201905,6176,3092,3084,3090812.58,3080829.37,6171641.95
350610,201905,1543,815,728,816365.26,728540.98,1544906.24
350620,201905,35,23,12,22954,11976,34930
350630,201905,236,138,98,137724.63,97804.63,235529.26
350635,201905,916,376,540,376246.4,539918.8,916165.2
350640,201905,124,94,30,93812,29940,123752
350650,201905,1897,1252,645,1250494.89,643710.98,1894205.87
350660,201905,759,332,427,331336,426146.99,757482.99
350670,201905,314,158,156,157684,155688,313372
350680,201905,183,96,87,95808,87824.8,183632.8
350690,201905,200,105,95,104790,94810,199600
350700,201905,769,366,403,365268.4,402194,767462.4
350710,201905,355,132,223,131736,222554,354290
350715,201905,55,44,11,43912,10978,54890
350720,201905,17,11,6,10978,5988,16966
350730,201905,46,29,17,28942,16966,45908
350740,201905,208,116,92,115768,91816,207584
350745,201905,20,11,9,10978.44,8982,19960.44
350750,201905,2185,1382,803,1380236.38,801394,2181630.38
350760,201905,3743,1667,2076,1663666.66,2071848.99,3735515.65
350770,201905,62,43,19,42914,18962,61876
350775,201905,48,34,14,33932,13972.98,47904.98
350780,201905,441,222,219,221556,219749,441305
350790,201905,367,153,214,152694,214570,367264
350800,201905,456,266,190,265468,189620,455088
350810,201905,515,415,100,414171.33,100798,514969.33
350820,201905,88,55,33,54890,32934,87824
350830,201905,83,45,38,44910,37924,82834
350840,201905,781,330,451,329340.4,450099.38,779439.78
350850,201905,1760,1014,746,1013968.5,745509.93,1759478.43
350860,201905,588,341,247,340320.46,246506,586826.46
350870,201905,438,299,139,298402,138722,437124
350880,201905,275,150,125,150698,124750,275448
350890,201905,42,28,14,27944,13972,41916
350900,201905,1458,468,990,467065.36,989018,1456083.36
350910,201905,23,14,9,13972,8982,22954
350920,201905,633,344,289,343312,288422,631734
350925,201905,1216,651,565,649698.78,563871.2,1213569.98
350930,201905,99,60,39,60878,38922,99800
350940,201905,722,398,324,397204,324350.36,721554.36
350945,201905,106,77,29,76846,28942,105788
350950,201905,16034,7820,8214,7811351.68,8206560.79,16017912.47
350960,201905,1284,605,679,603790.4,681634.99,1285425.39
350970,201905,1133,594,539,593704.03,544908.8,1138612.83
350980,201905,93,63,30,62874,30938,93812
350990,201905,380,135,245,134730,244510,379240
350995,201905,35,16,19,15968,18962,34930
351000,201905,629,438,191,438123.26,190618,628741.26
351010,201905,50,32,18,31936,17964,49900
351015,201905,55,38,17,37924,16966,54890
351020,201905,1608,962,646,961074.99,646704,1607778.99
351030,201905,349,239,110,238522,110778,349300
351040,201905,869,462,407,461076.48,407184.11,868260.59
351050,201905,3324,1541,1783,1538921.64,1780439.89,3319361.53
351060,201905,5066,2076,2990,2072848.36,2987018.56,5059866.92
351070,201905,408,256,152,255488.97,151696,407184.97
351080,201905,783,565,218,564868,218562,783430
351090,201905,57,26,31,25948,30938,56886
351100,201905,439,254,185,253492.68,184630,438122.68
351110,201905,2086,1011,1075,1008989.96,1073866.04,2082856.00
351120,201905,70,35,35,34930,34930,69860
351130,201905,172,59,113,58882,112774,171656
351140,201905,333,230,103,230538,102794,333332
351150,201905,425,231,194,230538.7,195608,426146.7
351160,201905,266,182,84,181636.4,83832,265468.4
351170,201905,185,103,82,102794,81836,184630
351190,201905,85,58,27,57884,26946,84830
351200,201905,363,243,120,242514.4,119760,362274.4
351210,201905,119,58,61,57884,60878,118762
351220,201905,533,318,215,317365.76,214570,531935.76
351230,201905,282,200,82,200598,82834,283432
351240,201905,231,104,127,103792,126746,230538
351250,201905,72,51,21,50898.53,20958,71856.53
351260,201905,152,113,39,112774,38922,151696
351270,201905,47,20,27,19960,26946,46906
351280,201905,1064,490,574,490019.26,574849.61,1064868.87
351290,201905,230,105,125,104790,124750.4,229540.4
351300,201905,3722,1735,1987,1733449.15,1984025.62,3717474.77
351310,201905,763,393,370,393212,370258.98,763470.98
351320,201905,112,68,44,67864,43912,111776
351330,201905,37,24,13,23952,12974,36926
351340,201905,1239,754,485,755487,484032.95,1239519.95
351350,201905,2538,1487,1051,1485025,1050894,2535919
351360,201905,771,385,386,385228,386226,771454
351370,201905,383,196,187,195608,187624,383232
351380,201905,9170,4162,5008,4158672.13,5001981.39,9160653.52
351385,201905,29,18,11,17964,10978,28942
351390,201905,288,217,71,216566.54,70858,287424.54
351400,201905,66,41,25,40918,24952.94,65870.94
351410,201905,441,278,163,277444.6,163672,441116.6
351420,201905,61,49,12,48902,11976,60878
351430,201905,67,37,30,36926,29940,66866
351440,201905,794,557,237,555888.56,236526.99,792415.55
351450,201905,261,132,129,132734,129740,262474
351460,201905,116,55,61,54890,60878,115768
351470,201905,132,70,62,69860,62874,132734
351480,201905,528,295,233,294411.76,232534,526945.76
351490,201905,288,107,181,106786,180638,287424
351492,201905,34,24,10,23952,9980,33932
351495,201905,26,18,8,17964,7984,25948
351500,201905,3568,1516,2052,1513967,2048895.36,3562862.36
351510,201905,1878,773,1105,772452.8,1103788.4,1876241.2
351512,201905,20,16,4,15968,3992,19960
351515,201905,196,113,83,112774,82834.96,195608.96
351518,201905,795,499,296,498002.99,296406,794408.99
351519,201905,71,45,26,44910,25948,70858
351520,201905,149,94,55,93812,54890,148702
351530,201905,22,15,7,14970,6986,21956
351535,201905,127,72,55,71856,54890,126746
351540,201905,460,328,132,327345.05,131736,459081.05
351550,201905,1374,835,539,833331.66,537922,1371253.66
351560,201905,71,39,32,38922,32934.96,71856.96
351565,201905,9,6,3,5988,2994,8982
351570,201905,2667,1393,1274,1390216.38,1271455.96,2661672.34
351580,201905,40,36,4,35928,3992,39920
351590,201905,66,44,22,43912,21956,65868
351600,201905,193,144,49,143712,48902,192614
351610,201905,58,27,31,26946,30938,57884
351620,201905,5935,3378,2557,3374242.47,2554881.26,5929123.73
351630,201905,2695,1394,1301,1393208.9,1302390,2695598.9
351640,201905,1796,869,927,867262.49,930137.03,1797399.52
351650,201905,32,27,5,26946,4990,31936
351660,201905,141,91,50,90818,50898,141716
351670,201905,724,450,274,450099.1,274450,724549.1
351680,201905,72,57,15,56886,14970,71856
351685,201905,33,20,13,19960,13972,33932
351690,201905,303,213,90,212574.45,89820,302394.45
351700,201905,158,111,47,111776.4,46906,158682.4
351710,201905,72,49,23,48902,22954,71856
351720,201905,128,64,64,63872,63872,127744
351730,201905,99,68,31,67864.63,30938.26,98802.89
351740,201905,728,481,247,480039.66,247504,727543.66
351750,201905,355,149,206,148702,205588,354290
351760,201905,786,598,188,596804,187624,784428
351770,201905,303,259,44,258482,43912,302394
351780,201905,162,94,68,93812.98,67864,161676.98
351790,201905,253,133,120,132734,120758,253492
351800,201905,47,31,16,30938,15968,46906
351810,201905,121,82,39,81836,38922,120758
351820,201905,861,622,239,621755.6,238523.39,860278.99
351830,201905,523,189,334,188622,333332,521954
351840,201905,1864,946,918,944109.44,917164.97,1861274.41
351850,201905,241,174,67,173652.3,66866.96,240519.26
351860,201905,705,483,222,482036.41,221556,703592.41
351870,201905,5628,2719,2909,2715561.27,2911168.73,5626730.00
351880,201905,19096,8111,10985,8101773.09,10973053.38,19074826.47
351885,201905,89,60,29,59880,28942,88822
351890,201905,70,59,11,58882,10978,69860
351900,201905,221,131,90,130738,89820,220558
351905,201905,74,30,44,29940,44910,74850
351907,201905,3301,1441,1860,1439117.34,1857281.56,3296398.90
351910,201905,184,78,106,77844,105788,183632
351920,201905,123,69,54,68862,53893.98,122755.98
351925,201905,89,60,29,59880,28942,88822
351930,201905,388,251,137,250498,136726,387224
351940,201905,241,110,131,109780,130738,240518
351950,201905,139,80,59,79840,59880,139720
351960,201905,906,431,475,430451,474050.4,904501.4
351970,201905,1907,1040,867,1041912.4,867263.78,1909176.18
351980,201905,153,80,73,79840,72854,152694
351990,201905,271,178,93,177644.8,92814,270458.8
352000,201905,354,221,133,220559.2,133732,354291.2
352010,201905,389,246,143,245508,142714,388222
352020,201905,190,67,123,66866,122754,189620
352030,201905,1071,560,511,558880,511974,1070854
352040,201905,581,249,332,249500,331336,580836
352042,201905,284,90,194,89820,193612.8,283432.8
352044,201905,367,218,149,217564,148702,366266
352050,201905,3320,1317,2003,1315366.76,2004982.4,3320349.16
352060,201905,101,63,38,62874,37924.4,100798.4
352070,201905,94,68,26,67865.26,25948,93813.26
352080,201905,66,41,25,40918,24950,65868
352090,201905,165,111,54,110778,53892,164670
352100,201905,262,126,136,125749.39,135730.38,261479.77
352110,201905,116,35,81,34930,80838,115768
352115,201905,64,24,40,23952,39920,63872
352120,201905,90,64,26,63872.63,25948,89820.63
352130,201905,222,184,38,183632,37924,221556
352140,201905,192,85,107,84830,106786.4,191616.4
352150,201905,117,64,53,63872,52894,116766
352160,201905,135,84,51,83832,50898,134730
352170,201905,374,263,111,262474,110778,373252
352180,201905,606,401,205,401196,204590.99,605786.99
352190,201905,255,101,154,100798,154690,255488
352200,201905,32,17,15,16966,14970,31936
352210,201905,3915,1678,2237,1677641.77,2235522.63,3913164.40
352215,201905,55,31,24,30938,23952,54890
352220,201905,7110,2705,4405,2703584.65,4401185.19,7104769.84
352230,201905,3280,2121,1159,2118768.89,1157690.62,3276459.51
352240,201905,2347,1363,984,1361272.4,983030.9,2344303.3
352250,201905,2635,1354,1281,1353291.35,1279438.37,2632729.72
352260,201905,1023,549,474,547902.8,476046.4,1023949.2
352265,201905,59,26,33,25948,32934,58882
352270,201905,416,250,166,249500,165669.88,415169.88
352280,201905,427,275,152,275448.63,151696,427144.63
352290,201905,177,110,67,109780,66866,176646
352300,201905,94,71,23,71856,22954,94810
352310,201905,6003,2865,3138,2860273.08,3137716.29,5997989.37
352320,201905,964,505,459,506984.4,459080,966064.4
352330,201905,514,249,265,248502,264470.4,512972.4
352340,201905,1373,666,707,664668.8,707583.6,1372252.4
352350,201905,335,207,128,206586,127744.4,334330.4
352360,201905,219,95,124,94810,123752.2,218562.2
352370,201905,109,72,37,71856,36926,108782
352380,201905,119,75,44,74850,44910,119760
352390,201905,2489,1127,1362,1125744.8,1360276.18,2486020.98
352400,201905,488,217,271,216566,270458.4,487024.4
352410,201905,838,596,242,594808.63,241516,836324.63
352420,201905,105,70,35,69860,34930,104790
352430,201905,1782,814,968,812375.32,967064.21,1779439.53
352440,201905,3130,1585,1545,1581831.84,1544908.72,3126740.56
352450,201905,201,167,34,166666,33932,200598
352460,201905,610,318,292,317365.39,292414,609779.39
352470,201905,632,219,413,218562,412174.98,630736.98
352480,201905,1386,783,603,781434,601794.4,1383228.4
352490,201905,67,26,41,25948,40918,66866
352500,201905,1213,548,665,546904.34,665667.38,1212571.72
352510,201905,747,404,343,405189.26,343312,748501.26
352520,201905,601,275,326,274450,325348,599798
352530,201905,1736,922,814,922152,812372.4,1734524.4
352540,201905,73,49,24,48902,23952,72854
352550,201905,180,107,73,106786,72854,179640
352560,201905,51,40,11,39920,10978,50898
352570,201905,679,353,326,353293.03,325348,678641.03
352580,201905,58,42,16,41916,15968,57884
352585,201905,19,7,12,6986,11976,18962
352590,201905,4417,2240,2177,2238514.63,2176640.18,4415154.81
352600,201905,347,247,100,246506.63,99800,346306.63
352610,201905,970,434,536,434130.97,536924,971054.97
352620,201905,990,397,593,397204,591814,989018
352630,201905,174,64,110,63872,109780,173652
352640,201905,547,379,168,379240,168662,547902
352650,201905,88,60,28,59880,27944,87824
352660,201905,72,44,28,43912,27944,71856
352670,201905,1642,899,743,897203.59,743519.9,1640723.49
352680,201905,924,590,334,589820.03,333332.6,923152.63
352690,201905,4463,2050,2413,2049895.15,2408174.66,4458069.81
352700,201905,116,71,45,70858,44910,115768
352710,201905,1359,739,620,739518,619758,1359276
352720,201905,1344,645,699,644708,698600.4,1343308.4
352725,201905,23,21,2,20958,1996,22954
352730,201905,389,205,184,204590,183632,388222
352740,201905,420,272,148,272455.04,148702.68,421157.72
352750,201905,21,14,7,13972,6986,20958
352760,201905,187,126,61,125748,60878,186626
352770,201905,79,62,17,61876,16966,78842
352780,201905,75,40,35,39920,34930,74850
352790,201905,27,22,5,21956.63,4990,26946.63
352800,201905,246,175,71,174650,71856,246506
352810,201905,161,102,59,101796.63,58882,160678.63
352820,201905,66,54,12,53892,11976,65868
352830,201905,91,63,28,62874,27944,90818
352840,201905,662,350,312,349300.5,312374,661674.5
352850,201905,1417,498,919,497004,918160,1415164
352860,201905,135,86,49,85828,48902,134730
352870,201905,45,27,18,26946,17964.4,44910.4
352880,201905,188,126,62,125748.9,62874,188622.9
352885,201905,29,21,8,20958,7984,28942
352890,201905,56,38,18,37924,17964.4,55888.4
352900,201905,4768,2324,2444,2324350.02,2442115.71,4766465.73
352910,201905,40,33,7,32934,6986,39920
352920,201905,685,416,269,416166,269460,685626
352930,201905,1235,603,632,601805.76,632776.02,1234581.78
352940,201905,6451,2731,3720,2729534.01,3713565.49,6443099.50
352950,201905,94,36,58,35928,57884,93812
352960,201905,58,40,18,39920,17964,57884
352965,201905,19,9,10,8982,9980,18962
352970,201905,512,386,126,386226.02,125749.61,511975.63
352980,201905,167,88,79,88822,78842,167664
352990,201905,977,440,537,442114,537922,980036
353000,201905,65,30,35,29940,34930,64870
353010,201905,550,341,209,341316,208582,549898
353020,201905,285,206,79,205588,78842,284430
353030,201905,1238,569,669,567862,668660.98,1236522.98
353040,201905,90,57,33,56886,32934,89820
353050,201905,1321,849,472,847303.42,473052,1320355.42
353060,201905,8466,3812,4654,3807378.23,4648694.48,8456072.71
353070,201905,1690,1084,606,1081834.96,605608.35,1687443.31
353080,201905,1295,683,612,681635.16,613770,1295405.16
353090,201905,58,32,26,32934,25948,58882
353100,201905,59,48,11,47904,10978,58882
353110,201905,2048,642,1406,643710.4,1403189.19,2046899.59
353120,201905,91,50,41,49900,40918,90818
353130,201905,859,414,445,413175.74,444111.96,857287.70
353140,201905,561,226,335,225548,335328,560876
353150,201905,350,198,152,197604.63,152694,350298.63
353160,201905,93,78,15,77844,14970,92814
353170,201905,188,63,125,62874,124751.96,187625.96
353180,201905,991,470,521,469060.4,520956.7,990017.1
353190,201905,500,358,142,357284.3,141716,499000.3
353200,201905,208,108,100,107784,99800,207584
353205,201905,22,16,6,15968,5988,21956
353210,201905,83,50,33,49900,32934,82834
353215,201905,51,29,22,28942,21956,50898
353220,201905,84,48,36,47904,35928,83832
353230,201905,160,67,93,66866,92814,159680
353240,201905,304,167,137,166666,137724,304390
353250,201905,204,105,99,104790,98802,203592
353260,201905,455,325,130,324351.1,129740,454091.1
353270,201905,67,51,16,50898,15968,66866
353280,201905,103,56,47,55888.6,46906,102794.6
353282,201905,128,87,41,86826,40918,127744
353284,201905,26,19,7,18962,6986,25948
353286,201905,0,0,0,0,0,0
353290,201905,74,43,31,42914,30938,73852
353300,201905,433,243,190,242515.26,190618,433133.26
353310,201905,46,40,6,39920,5988,45908
353320,201905,61,38,23,37924,22954,60878
353325,201905,56,32,24,31936,23953.36,55889.36
353330,201905,64,45,19,44910.7,18962,63872.7
353340,201905,609,213,396,212574,395209.39,607783.39
353350,201905,915,439,476,439122.6,477047.74,916170.34
353360,201905,105,84,21,83832,20958.4,104790.4
353370,201905,120,66,54,65868,53892,119760
353380,201905,29,19,10,18962.99,9980,28942.99
353390,201905,1116,544,572,542912,571854,1114766
353400,201905,45,28,17,27944,16966,44910
353410,201905,109,69,40,68862,39920.9,108782.9
353420,201905,59,24,35,23952,34930,58882
353430,201905,585,395,190,395209.38,189620,584829.38
353440,201905,10635,4748,5887,4742502.98,5882224.32,10624727.30
353450,201905,55,31,24,30938,23952,54890
353460,201905,599,332,267,331336.1,266466,597802.1
353470,201905,2146,1155,991,1157684.19,990019.96,2147704.15
353475,201905,227,153,74,152695.38,73852,226547.38
353480,201905,183,152,31,151696,30938.4,182634.4
353490,201905,239,145,94,144710,94810.4,239520.4
353500,201905,192,111,81,110778.63,80838,191616.63
353510,201905,101,73,28,72854.98,27944,100798.98
353520,201905,208,145,63,144710,62874,207584
353530,201905,475,256,219,255488,218562,474050
353540,201905,375,253,122,252494,121756,374250
353550,201905,751,489,262,488023.24,262474,750497.24
353560,201905,614,257,357,256486,357284.28,613770.28
353570,201905,66,35,31,34930.4,30938,65868.4
353580,201905,356,272,84,271456.34,83832,355288.34
353590,201905,89,61,28,60878,27944,88822
353600,201905,271,157,114,156686.63,113772,270458.63
353610,201905,119,65,54,64870,53892,118762
353620,201905,608,317,291,316366,291416,607782
353625,201905,52,30,22,29940,21956,51896
353630,201905,237,176,61,175648.58,62874,238522.58
353640,201905,129,88,41,87824,41916,129740
353650,201905,903,362,541,363272,539918,903190
353657,201905,25,18,7,17964,6986,24950
353660,201905,262,142,120,141716,119760,261476
353670,201905,774,467,307,466067.03,306386,772453.03
353680,201905,108,78,30,77844.5,29940,107784.5
353690,201905,45,36,9,35928.52,8982,44910.52
353700,201905,280,199,81,198602.09,80838,279440.09
353710,201905,457,220,237,219560.6,236526.4,456087.0
353715,201905,45,33,12,32934,11976,44910
353720,201905,348,165,183,164670.98,182634,347304.98
353730,201905,1116,694,422,694609.43,423152.8,1117762.23
353740,201905,636,350,286,349300,285428,634728
353750,201905,86,55,31,54890,30938,85828
353760,201905,2835,1097,1738,1096804.75,1735524.18,2832328.93
353770,201905,91,75,16,74850,15968,90818
353780,201905,1212,583,629,583830.63,627742,1211572.63
353790,201905,520,307,213,306386.96,212574.4,518961.36
353800,201905,3303,1663,1640,1659677.89,1636792.2,3296470.09
353810,201905,229,132,97,131736.98,96806.98,228543.96
353820,201905,195,94,101,94810,100798,195608
353830,201905,48,41,7,40918,6986,47904
353850,201905,173,87,86,86826,85828,172654
353860,201905,498,227,271,226546,270458,497004
353870,201905,5274,2702,2572,2698597.45,2572847.65,5271445.10
353880,201905,687,484,203,484030.4,202594,686624.4
353890,201905,583,339,244,338322.4,244510.84,582833.24
353900,201905,132,69,63,69860,62874,132734
353910,201905,172,84,88,84830,87824,172654
353920,201905,440,244,196,243512.3,195608.99,439121.29
353930,201905,1000,596,404,594808,404192.14,999000.14
353940,201905,191,103,88,102794,87824,190618
353950,201905,516,318,198,317364,198602.98,515966.98
353960,201905,73,59,14,58882,13972,72854
353970,201905,69,39,30,38922,29940,68862
353980,201905,1608,778,830,778440,832335.96,1610775.96
353990,201905,75,44,31,43912,30938,74850
354000,201905,370,188,182,187624,181636.99,369260.99
354010,201905,91,50,41,49900,40918,90818
354020,201905,533,341,192,341316,192614,533930
354025,201905,54,44,10,43912,9980,53892
354030,201905,62,37,25,36926,24950,61876
354040,201905,100,72,28,71856,27944,99800
354050,201905,191,102,89,101796.4,88822,190618.4
354060,201905,757,371,386,371256.4,385228,756484.4
354070,201905,939,562,377,560877.28,376246.4,937123.68
354075,201905,221,113,108,112774.85,107784,220558.85
354080,201905,306,129,177,128742,176646,305388
354085,201905,21,13,8,12974,7984,20958
354090,201905,304,169,135,169576,134730,304306
354100,201905,5555,2413,3142,2408175.1,3139710.92,5547886.02
354105,201905,90,45,45,44910,44910,89820
354110,201905,47,21,26,20958,25948,46906
354120,201905,135,96,39,95808.98,38922,134730.98
354130,201905,700,457,243,456086,242516.37,698602.37
354140,201905,3138,1463,1675,1461072.4,1673646,3134718.4
354150,201905,638,398,240,398203.76,239520,637723.76
354160,201905,690,443,247,444110.4,247504.4,691614.8
354165,201905,21,14,7,13972,6986,20958
354170,201905,182,124,58,123752,57884,181636
354180,201905,67,41,26,40918.51,25948,66866.51
354190,201905,200,91,109,90818,108782,199600
354200,201905,120,65,55,64870,54890,119760
354210,201905,62,29,33,28942,32934,61876
354220,201905,646,403,243,402194,242514,644708
354230,201905,161,68,93,67864.44,92814,160678.44
354240,201905,326,214,112,213572.64,111776,325348.64
354250,201905,86,52,34,51896,33932,85828
354260,201905,2061,965,1096,964071.87,1094807.67,2058879.54
354270,201905,96,71,25,70858,24950,95808
354280,201905,42,23,19,22954,19960,42914
354290,201905,140,96,44,95808,43912,139720
354300,201905,417,288,129,287424.63,128742.26,416166.89
354310,201905,97,72,25,71856.4,24950,96806.4
354320,201905,190,98,92,97804,91816.4,189620.4
354323,201905,14,13,1,12974,998,13972
354325,201905,112,68,44,67864.6,43912,111776.6
354330,201905,2607,870,1737,869116.8,1738518.01,2607634.81
354340,201905,10635,5223,5412,5219562.03,5405174.7,10624736.73
354350,201905,120,79,41,78842,40918,119760
354360,201905,86,48,38,48902,37924,86826
354370,201905,257,143,114,143712,113772,257484
354380,201905,197,118,79,117764,78842,196606
354390,201905,2706,989,1717,988020.99,1718556.98,2706577.97
354400,201905,319,170,149,169660,148702.4,318362.4
354410,201905,613,295,318,294410.4,318362.4,612772.8
354420,201905,276,176,100,175648,99800,275448
354425,201905,314,184,130,183632,129740,313372
354430,201905,182,110,72,109780,71856,181636
354440,201905,35,26,9,25948,8982,34930
354450,201905,48,35,13,34930,12974,47904
354460,201905,101,58,43,57884,42914,100798
354470,201905,39,23,16,22954,15968,38922
354480,201905,120,63,57,62874.98,56886,119760.98
354490,201905,147,91,56,90818,55888,146706
354500,201905,390,196,194,195608,193612,389220
354510,201905,97,71,26,70858,25948,96806
354515,201905,35,12,23,11976,22954,34930
354520,201905,1616,704,912,702450.4,912172.8,1614623.2
354530,201905,733,373,360,372254.99,359280,731534.99
354540,201905,277,153,124,152694,123752,276446
354550,201905,41,24,17,23952,16966,40918
354560,201905,157,87,70,86826,70858,157684
354570,201905,139,91,48,90818.5,47904,138722.5
354580,201905,1936,931,1005,930138.29,1002991.39,1933129.68
354600,201905,251,143,108,142714.2,107784,250498.2
354610,201905,75,64,11,63872.46,10978.98,74851.44
354620,201905,60,18,42,17964,41916,59880
354625,201905,16,11,5,10978,4990.99,15968.99
354630,201905,315,210,105,209580.98,104790,314370.98
354640,201905,802,525,277,523950.3,276446,800396.3
354650,201905,74,42,32,41916,31936.98,73852.98
354660,201905,806,599,207,597803.03,206586,804389.03
354670,201905,263,91,172,90818.76,171656.6,262475.36
354680,201905,1276,482,794,481036,795406,1276442
354690,201905,79,52,27,51896.4,26946,78842.4
354700,201905,72,52,20,51896,19960,71856
354710,201905,48,34,14,33932,13972,47904
354720,201905,21,21,0,20958,0,20958
354730,201905,1785,770,1015,768461.78,1012970.4,1781432.18
354740,201905,63,45,18,44910,17964,62874
354750,201905,438,257,181,256486.98,181636,438122.98
354760,201905,491,298,193,299401.86,193612.4,493014.26
354765,201905,10,5,5,4990,4990,9980
354770,201905,341,223,118,222554,117764,340318
354780,201905,8066,3269,4797,3263472.4,4793420.11,8056892.51
354790,201905,104,59,45,58882,44910,103792
354800,201905,441,240,201,240518,200598.4,441116.4
354805,201905,101,49,52,48902,51896,100798
354810,201905,114,69,45,68862,44910,113772
354820,201905,191,83,108,82834.56,107784,190618.56
354830,201905,40,21,19,20958,18962,39920
354840,201905,61,41,20,40918,19960,60878
354850,201905,4554,2060,2494,2057877.2,2493004.56,4550881.76
354860,201905,335,160,175,159680,174650.93,334330.93
354870,201905,12631,5694,6937,5685618.06,6932117.11,12617735.17
354880,201905,3024,1132,1892,1131732.4,1892212.36,3023944.76
354890,201905,2891,1590,1301,1588819.73,1299396,2888215.73
354900,201905,63,42,21,41916,20958,62874
354910,201905,1250,665,585,663671.03,583830,1247501.03
354920,201905,49,41,8,40918,7984,48902
354925,201905,13,8,5,7984,4990,12974
354930,201905,32,29,3,28942.43,2994,31936.43
354940,201905,837,611,226,610028.5,225548,835576.5
354950,201905,209,138,71,137724.6,71856,209580.6
354960,201905,160,61,99,61876,98802.4,160678.4
354970,201905,909,608,301,607782.97,300398.4,908181.37
354980,201905,8580,3196,5384,3192605.56,5381227.42,8573832.98
354990,201905,9000,4271,4729,4269450.91,4730573.79,9000024.70
354995,201905,553,190,363,189620,362274,551894
355000,201905,484,168,316,167664,315368,483032
355010,201905,608,381,227,381236,227545.23,608781.23
355020,201905,747,467,280,466066.32,279442.38,745508.70
355030,201905,209900,82164,127736,82064171.11,127661356.42,209725527.53
355040,201905,744,353,391,352294.4,392214,744508.4
355050,201905,153,103,50,102795.4,49900,152695.4
355060,201905,1600,820,780,818361.2,781434.6,1599795.8
355070,201905,1444,704,740,703591.81,738521.61,1442113.42
355080,201905,204,122,82,121756,81836,203592
355090,201905,282,175,107,174650.78,106786.32,281437.10
355100,201905,4904,2432,2472,2431033.82,2471050.19,4902084.01
355110,201905,264,173,91,172655.39,90818,263473.39
355120,201905,85,63,22,62874,21956.98,84830.98
355130,201905,58,33,25,32934,24950,57884
355140,201905,187,121,66,120758,65868,186626
355150,201905,695,416,279,415169.39,278442.4,693611.79
355160,201905,468,223,245,222554.63,244510.3,467064.93
355170,201905,2094,1106,988,1105784,990016,2095800
355180,201905,665,280,385,281436,384230,665666
355190,201905,220,154,66,153692,65868,219560
355200,201905,115,67,48,66866,47904,114770
355210,201905,694,408,286,407184.97,286426.98,693611.95
355220,201905,7085,3761,3324,3757475.87,3322343.8,7079819.67
355230,201905,106,63,43,62874,42914,105788
355240,201905,4377,1900,2477,1897201.92,2478036.37,4375238.29
355250,201905,5586,2674,2912,2668654.87,2906182.61,5574837.48
355255,201905,49,31,18,30938,17964,48902
355260,201905,185,111,74,110778.4,73853.96,184632.36
355270,201905,169,105,64,104790,63872,168662
355280,201905,6318,2617,3701,2614762.44,3697591.78,6312354.22
355290,201905,75,59,16,58882,16966,75848
355300,201905,196,126,70,125748,69860.4,195608.4
355310,201905,115,64,51,63872,50898,114770
355320,201905,88,47,41,46906,40918,87824
355330,201905,278,160,118,159680,118762,278442
355340,201905,1572,528,1044,526944.4,1041912,1568856.4
355350,201905,130,68,62,67864,61876,129740
355360,201905,176,113,63,112774,62874,175648
355365,201905,25,20,5,19960,4990,24950
355370,201905,1043,606,437,604803.16,437134.18,1041937.34
355380,201905,796,523,273,522952,272454,795406
355385,201905,67,47,20,46906,19960,66866
355390,201905,106,62,44,61876,43912,105788
355395,201905,186,111,75,110778.47,74850,185628.47
355400,201905,1627,995,632,992930.93,630737.99,1623668.92
355410,201905,4890,2329,2561,2325346.27,2558878.14,4884224.41
355420,201905,52,37,15,36926,14970,51896
355430,201905,352,212,140,211576,139720,351296
355440,201905,79,48,31,48902,31936,80838
355450,201905,452,226,226,225548.88,225548.4,451097.28
355460,201905,65,50,15,49900.54,14970,64870.54
355465,201905,50,32,18,31936,17964,49900
355470,201905,180,73,107,72854.7,106786,179640.7
355475,201905,13,9,4,8982,3992,12974
355480,201905,470,209,261,208582.6,260478,469060.6
355490,201905,120,87,33,86826,32934,119760
355495,201905,57,30,27,29940,26946,56886
355500,201905,1632,911,721,911177.69,720558.96,1631736.65
355510,201905,273,199,74,198603.26,73852,272455.26
355520,201905,33,26,7,25948.4,6986,32934.4
355530,201905,22,15,7,14970,6986,21956
355535,201905,79,39,40,38922,39920,78842
355540,201905,2382,948,1434,948241.11,1435125.61,2383366.72
355550,201905,62,38,24,37924,23952,61876
355560,201905,249,119,130,119760,129740,249500
355570,201905,26,18,8,17964,7984,25948
355580,201905,253,174,79,173652,79841.39,253493.39
355590,201905,22,14,8,13972,7984,21956
355600,201905,270,141,129,140718,129740,270458
355610,201905,232,156,76,156686,75848,232534
355620,201905,1320,641,679,639718.4,677642.99,1317361.39
355630,201905,438,324,114,323352,113772.63,437124.63
355635,201905,124,61,63,60878,62875.97,123753.97
355640,201905,560,319,241,319360,242514,561874
355645,201905,835,355,480,354290,480038.4,834328.4
355650,201905,2074,881,1193,880237.74,1190614.98,2070852.72
355660,201905,252,140,112,139720,111776,251496
355670,201905,538,217,321,216566,321356,537922
355680,201905,203,115,88,114770.97,87824,202594.97
355690,201905,92,45,47,44910,46906.67,91816.67
355695,201905,12,9,3,8982,2994,11976
355700,201905,1144,596,548,595806.66,546904.8,1142711.46
355710,201905,2221,1223,998,1221554.63,997002,2218556.63
355715,201905,19,16,3,15968,2994,18962
355720,201905,206,124,82,123752.44,81836,205588.44
355730,201905,97,57,40,56886,39920,96806
410010,201905,131,111,20,110778,19960,130738
410020,201905,106,90,16,89820,15968,105788
410030,201905,166,106,60,105788.6,59880,165668.6
410040,201905,1076,575,501,573850,500996.6,1074846.6
410045,201905,31,26,5,25948,4990,30938
410050,201905,469,269,200,269460,200598,470058
410060,201905,277,210,67,209580,66866,276446
410070,201905,309,256,53,256486,52894,309380
410080,201905,170,110,60,109780,59880,169660
410090,201905,79,70,9,69860.56,8982,78842.56
410100,201905,299,216,83,215568,82834,298402
410105,201905,44,27,17,26946,16966,43912
410110,201905,328,202,126,203592,126746,330338
410115,201905,32,23,9,22954,8982,31936
410120,201905,410,214,196,213572,195608,409180
410130,201905,46,29,17,28942,16966,45908
410140,201905,3163,1558,1605,1554886.76,1603789,3158675.76
410150,201905,2718,1096,1622,1094806.74,1619754.8,2714561.54
410160,201905,508,318,190,317364,189620.4,506984.4
410165,201905,68,45,23,44910,22954,67864
410170,201905,168,121,47,121756.4,46906,168662.4
410180,201905,2193,1258,935,1255484.4,934129.59,2189613.99
410185,201905,36,32,4,31936,3992,35928
410190,201905,503,334,169,333332.51,168662,501994.51
410200,201905,962,724,238,722552,238522,961074
410210,201905,578,300,278,299400,277444.4,576844.4
410220,201905,44,22,22,21956,21956,43912
410230,201905,144,75,69,74850,68862,143712
410240,201905,757,499,258,498002.8,257484.4,755487.2
410250,201905,383,279,104,278442,103792,382234
410260,201905,298,171,127,170658.4,126746,297404.4
410270,201905,31,21,10,20958,9980,30938
410275,201905,61,46,15,45908,14970,60878
410280,201905,325,187,138,186626,137724,324350
410290,201905,241,152,89,151696,88822,240518
410300,201905,77,59,18,59880,17964,77844
410302,201905,20,13,7,12974,6986,19960
410304,201905,42,28,14,27944,13972,41916
410305,201905,216,118,98,117764,97804,215568
410310,201905,270,169,101,168662,100798,269460
410315,201905,50,36,14,35928.44,13972,49900.44
410320,201905,134,94,40,93812,39920,133732
410322,201905,36,24,12,23952,11976,35928
410330,201905,176,126,50,125748,49900.6,175648.6
410335,201905,102,58,44,57884,43912,101796
410337,201905,41,35,6,34930,5988,40918
410340,201905,34,31,3,30938,2994,33932
410345,201905,220,134,86,133732,85828,219560
410347,201905,52,39,13,38922,12974,51896
410350,201905,241,145,96,144710,95808,240518
410360,201905,468,291,177,290418.8,176647.2,467066.0
410370,201905,2385,1026,1359,1023949.08,1356283.64,2380232.72
410380,201905,219,136,83,135728,82834,218562
410390,201905,379,274,105,273452.99,105788,379240.99
410395,201905,32,21,11,20958,10978,31936
410400,201905,834,409,425,408183.61,423587.5,831771.11
410405,201905,94,72,22,71856,21956,93812
410410,201905,35,28,7,27944,6986,34930
410420,201905,1670,823,847,821267.16,845306.34,1666573.50
410425,201905,170,78,92,77844.6,91816,169660.6
410430,201905,2201,1282,919,1279436.74,917162.56,2196599.30
410440,201905,379,279,100,278442,99800,378242
410442,201905,354,240,114,239520.7,114770,354290.7
410445,201905,405,288,117,289420,116766,406186
410450,201905,384,200,184,199600,183632,383232
410460,201905,471,251,220,250498,219560,470058
410465,201905,207,132,75,132734,74850,207584
410470,201905,229,145,84,144710,83832,228542
410480,201905,6039,2997,3042,2995009.7,3042912.41,6037922.11
410490,201905,1422,913,509,911175.34,508980.4,1420155.74
410500,201905,265,155,110,154690,109780,264470
410510,201905,167,125,42,124750,41916.98,166666.98
410520,201905,255,191,64,190618,63872,254490
410530,201905,233,87,146,86826,145708.99,232534.99
410540,201905,316,230,86,229540.99,86826,316366.99
410550,201905,1681,754,927,752492.4,926144.8,1678637.2
410560,201905,139,104,35,103792,34930,138722
410570,201905,434,294,140,293413.32,139720,433133.32
410580,201905,3306,1491,1815,1488019.32,1812369,3300388.32
410590,201905,406,286,120,285428,119760,405188
410600,201905,194,168,26,167664,25948,193612
410610,201905,60,51,9,50898,8982,59880
410620,201905,243,175,68,174650,67864,242514
410630,201905,445,264,181,263472,180638,444110
410640,201905,1038,654,384,653691.3,383232.99,1036924.29
410645,201905,104,78,26,77844.2,25948,103792.2
410650,201905,364,245,119,244510,118762,363272
410655,201905,80,60,20,59880,19960,79840
410657,201905,22,9,13,8982,12974,21956
410660,201905,612,436,176,435128.31,176646,611774.31
410670,201905,73,62,11,61876,10978,72854
410680,201905,199,166,33,165668,32934,198602
410685,201905,18,11,7,10978,6986,17964
410690,201905,28226,12207,16019,12190491.77,16005649.83,28196141.60
410700,201905,328,240,88,239520.4,87824,327344.4
410710,201905,129,106,23,106786,22954,129740
410712,201905,24,17,7,16966,6986,23952
410715,201905,90,69,21,68862,20958,89820
410720,201905,705,402,303,401196.88,302394.98,703591.86
410725,201905,185,137,48,136726,47904,184630
410730,201905,92,53,39,52894,38922,91816
410740,201905,117,85,32,84830,31936,116766
410750,201905,237,165,72,165668,71856,237524
410752,201905,24,15,9,14970,8982,23952
410753,201905,48,22,26,21956,25948,47904
410754,201905,43,27,16,26946.4,15968,42914.4
410755,201905,82,54,28,53892,27944,81836
410760,201905,743,421,322,420158.4,321356,741514.4
410765,201905,1717,826,891,824350.36,891215.2,1715565.56
410770,201905,107,85,22,84830,22954,107784
410773,201905,54,41,13,40918,12974,53892
410775,201905,188,137,51,136726,50898,187624
410780,201905,83,46,37,45908,36926,82834
410785,201905,57,45,12,44910,11976,56886
410790,201905,72,36,36,35928,35928,71856
410800,201905,281,176,105,175648.52,104790,280438.52
410810,201905,22,19,3,18962,2994.4,21956.4
410820,201905,180,131,49,130738,48902,179640
410830,201905,8522,3809,4713,3805380.08,4708574.17,8513954.25
410832,201905,106,78,28,77844,27944,105788
410840,201905,1420,796,624,795408.97,622754.46,1418163.43
410845,201905,68,44,24,43912.4,23952,67864.4
410850,201905,194,137,57,136726,56886,193612
410855,201905,50,43,7,42914,6986,49900
410860,201905,702,407,295,407184.4,295408,702592.4
410865,201905,103,79,24,78842,24950,103792
410870,201905,152,128,24,127744,23952,151696
410880,201905,1121,573,548,571860.14,546908.88,1118769.02
410890,201905,82,58,24,57884,23952,81836
410895,201905,70,55,15,54890,14970,69860
410900,201905,23,15,8,14970,7984,22954
410910,201905,15,13,2,12974,1996,14970
410920,201905,36,24,12,23952,11976,35928
410930,201905,506,323,183,322354,182634,504988
410940,201905,4389,2529,1860,2525939.84,1859274.8,4385214.64
410950,201905,109,83,26,82834,25948,108782
410960,201905,781,346,435,345308,434130.4,779438.4
410965,201905,67,53,14,52894,13972,66866
410970,201905,631,455,176,454090,175648,629738
410975,201905,113,67,46,66866.72,45908,112774.72
410980,201905,1628,746,882,746504.55,881234.99,1627739.54
410990,201905,266,185,81,184630,80838,265468
411000,201905,66,43,23,42914,22954.4,65868.4
411005,201905,27,21,6,20958,5988,26946
411007,201905,255,147,108,146706,107784,254490
411010,201905,600,417,183,416166,182634,598800
411020,201905,300,207,93,206586,92814,299400
411030,201905,16,9,7,8982,6986,15968
411040,201905,55,40,15,39920,14970,54890
411050,201905,215,168,47,167664,46906,214570
411060,201905,519,356,163,355288.98,162674,517962.98
411065,201905,65,56,9,55888,8982,64870
411070,201905,1233,781,452,779439.54,451096,1230535.54
411080,201905,228,160,68,159680,67864,227544
411090,201905,108,81,27,80838,26946,107784
411095,201905,281,114,167,114770,166666,281436
411100,201905,113,94,19,93812,18962,112774
411110,201905,120,82,38,81836,37924,119760
411120,201905,194,141,53,140718,52894,193612
411125,201905,207,94,113,93812,112774,206586
411130,201905,124,106,18,105788,17964,123752
411140,201905,204,136,68,135728,68862,204590
411150,201905,1242,827,415,825346,414171.03,1239517.03
411155,201905,125,84,41,83832,40918,124750
411160,201905,26,12,14,11976,13972,25948
411170,201905,53,48,5,47904,4990,52894
411180,201905,985,663,322,661674.83,321356,983030.83
411190,201905,336,192,144,191616,143712,335328
411200,201905,668,435,233,435128.63,236526,671654.63
411210,201905,702,379,323,378242,323352.98,701594.98
411220,201905,150,112,38,111776,37924,149700
411230,201905,43,36,7,35928,6986,42914
411240,201905,124,83,41,82834,40918,123752
411250,201905,441,324,117,323352,116766,440118
411260,201905,20,13,7,12974,6986,19960
411270,201905,281,149,132,148702,131736,280438
411275,201905,201,176,25,175648,24950,200598
411280,201905,221,157,64,156686.63,63872,220558.63
411290,201905,59,45,14,44910,13972,58882
411295,201905,145,114,31,113772,30938,144710
411300,201905,69,35,34,34930,34930,69860
411310,201905,95,74,21,73852,20958,94810
411320,201905,754,527,227,525946.05,226546.6,752492.65
411325,201905,64,42,22,41916,21956,63872
411330,201905,919,591,328,589818.5,328342.16,918160.66
411340,201905,27,19,8,18962,7984.34,26946.34
411342,201905,68,51,17,50898,16966,67864
411345,201905,120,61,59,60878,58882,119760
411350,201905,490,390,100,389220.58,100798.4,490018.98
411360,201905,54,34,20,33932,19960,53892
411370,201905,14336,5886,8450,5882217,8443097.57,14325314.57
411373,201905,179,132,47,131736,46906,178642
411375,201905,72,59,13,58882,12974,71856
411380,201905,93,71,22,70858,21956,92814
411390,201905,131,87,44,86826,43912,130738
411400,201905,362,278,84,277444.98,83832,361276.98
411410,201905,449,227,222,226546,221556.4,448102.4
411420,201905,1028,467,561,466066,559878,1025944
411430,201905,434,265,169,264470,168662.98,433132.98
411435,201905,37,26,11,25948,10978,36926
411440,201905,463,372,91,372254,90818,463072
411450,201905,433,363,70,362274,69860,432134
411460,201905,768,304,464,304393.28,465073.82,769467.10
411470,201905,85,62,23,61876,22954,84830
411480,201905,659,379,280,378242,279440,657682
411490,201905,297,192,105,191616,104790,296406
411500,201905,108,92,16,91816,15968,107784
411510,201905,234,185,49,184630,48902,233532
411520,201905,6013,2347,3666,2344305.69,3667655.32,6011961.01
411530,201905,119,84,35,83832,34930,118762
411535,201905,49,21,28,20958,27944,48902
411540,201905,358,246,112,245508,111776,357284
411545,201905,52,38,14,37924,13972,51896
411550,201905,76,58,18,57884,17964,75848
411560,201905,379,175,204,174650,203592,378242
411570,201905,803,302,501,301397.26,499998.6,801395.86
411573,201905,30,18,12,17964,11976,29940
411575,201905,288,180,108,179640,107784,287424
411580,201905,1249,498,751,497004,751494,1248498
411585,201905,73,36,37,35928,36926,72854
411590,201905,21,15,6,14970,5988,20958
411600,201905,25,11,14,10978,13972,24950
411605,201905,245,104,141,103792,140718,244510
411610,201905,210,142,68,141716,67864,209580
411620,201905,353,198,155,197604,154690,352294
411630,201905,57,39,18,38922,17964,56886
411640,201905,33,27,6,26946,5988,32934
411650,201905,12,7,5,6986,4990,11976
411660,201905,38,28,10,27944,9980,37924
411670,201905,249,187,62,186626,61876,248502
411680,201905,157,136,21,135728,20958,156686
411690,201905,594,316,278,315368,277444,592812
411695,201905,63,47,16,46906,15968,62874
411700,201905,152,131,21,130738,20958,151696
411705,201905,106,70,36,69860,35928,105788
411710,201905,310,211,99,210578,98802,309380
411720,201905,139,91,48,90818,47904,138722
411721,201905,62,53,9,52894,8982,61876
411722,201905,98,42,56,41916,55888,97804
411725,201905,155,122,33,121756.4,32934,154690.4
411727,201905,79,61,18,60878,17964,78842
411729,201905,36,29,7,28942,6986,35928
411730,201905,553,352,201,351296,200598,551894
411740,201905,40,26,14,25948,13972,39920
411745,201905,69,47,22,46906,21956,68862
411750,201905,867,400,467,399200.4,469060.4,868260.8
411760,201905,1196,899,297,898200.4,296406.98,1194607.38
411770,201905,457,302,155,301396,154690,456086
411780,201905,328,213,115,212574,114770.5,327344.5
411790,201905,531,301,230,300399.27,229541.96,529941.23
411800,201905,169,132,37,132734,36926,169660
411810,201905,167,127,40,126746,39920,166666
411820,201905,2148,1009,1139,1006983,1136722.6,2143705.6
411830,201905,12,12,0,11976,0,11976
411840,201905,1981,1234,747,1233528,747503.53,1981031.53
411845,201905,51,20,31,19960,30938,50898
411850,201905,1230,699,531,697602.99,529941.64,1227544.63
411860,201905,45,31,14,30938.4,13972,44910.4
411870,201905,75,53,22,52894,21956,74850
411880,201905,421,271,150,270459.22,149700,420159.22
411885,201905,108,73,35,72854,34930,107784
411890,201905,316,203,113,202595.39,113772,316367.39
411900,201905,73,54,19,53892,18962,72854
411910,201905,180,143,37,142714,36926,179640
411915,201905,2105,900,1205,898200,1202591.54,2100791.54
411920,201905,123,99,24,98802,23952,122754
411925,201905,10,7,3,6986,2994,9980
411930,201905,818,603,215,601794.74,214570,816364.74
411940,201905,599,417,182,416166.74,181636,597802.74
411950,201905,917,484,433,484030.8,433132,917162.8
411960,201905,1048,725,323,723551.7,322354,1045905.7
411965,201905,23,16,7,15968,6986,22954
411970,201905,83,76,7,75848,6986,82834
411980,201905,172,119,53,118762,52894,171656
411990,201905,5198,3022,2176,3017956.88,2175642.1,5193598.98
411995,201905,467,177,290,176646,289420,466066
412000,201905,309,194,115,193612,114770,308382
412010,201905,50,31,19,30938,18962,49900
412015,201905,46,34,12,33932,11976,45908
412020,201905,29,25,4,24950,3992,28942
412030,201905,54,48,6,47904,5988,53892
412033,201905,50,32,18,31936.44,17964,49900.44
412035,201905,66,45,21,44910,20958,65868
412040,201905,37,23,14,23952.4,13972,37924.4
412050,201905,202,155,47,154690,46906,201596
412060,201905,781,592,189,590816,188622,779438
412065,201905,49,32,17,31936,16966,48902
412070,201905,164,110,54,109780,53892,163672
412080,201905,275,145,130,144710,129740,274450
412085,201905,34,16,18,15968,17964,33932
412090,201905,787,502,285,500996.9,284430,785426.9
412100,201905,245,207,38,206586.8,37924,244510.8
412110,201905,68,52,16,51896,15968,67864
412120,201905,317,202,115,201596,114770,316366
412125,201905,85,49,36,48902,36926,85828
412130,201905,39,28,11,27944.36,10978,38922.36
412135,201905,27,16,11,15968,10978,26946
412140,201905,326,227,99,226546,98802,325348
412150,201905,248,168,80,167664.48,79840,247504.48
412160,201905,88,53,35,52894,34930,87824
412170,201905,688,481,207,481036.4,206586,687622.4
412175,201905,37,29,8,28942,7984,36926
412180,201905,197,156,41,155688.71,41916,197604.71
412190,201905,340,269,71,268462,70858,339320
412200,201905,204,126,78,125748,77844,203592
412210,201905,74,58,16,57884,15968,73852
412215,201905,225,161,64,160678,64870,225548
412217,201905,69,54,15,53892,14970,68862
412220,201905,829,613,216,611774,216566,828340
412230,201905,331,200,131,199600,130740.94,330340.94
412240,201905,1351,678,673,676665.72,672667.8,1349333.52
412250,201905,386,247,139,246506,138722,385228
412260,201905,107,79,28,78842,27944,106786
412265,201905,177,140,37,139720,36926,176646
412270,201905,79,53,26,52894,25948,78842
412280,201905,90,74,16,73852,15968,89820
412290,201905,98,66,32,65868,31936,97804
412300,201905,212,136,76,135728,75848,211576
412310,201905,47,40,7,39920,6986,46906
412320,201905,97,83,14,82834,13972,96806
412330,201905,183,160,23,159680,22954,182634
412340,201905,155,108,47,107784,46906.4,154690.4
412350,201905,603,303,300,302394,300398,602792
412360,201905,29,25,4,24950,3992,28942
412370,201905,163,143,20,143712.2,19960,163672.2
412380,201905,265,196,69,195608,68863.78,264471.78
412382,201905,53,27,26,26946,25948,52894
412385,201905,144,107,37,106786,36926,143712
412390,201905,283,217,66,216566,65868,282434
412395,201905,74,60,14,59880,13972,73852
412400,201905,78,52,26,52894,25948,78842
412402,201905,250,121,129,120758,128742,249500
412405,201905,830,319,511,318362,509978,828340
412410,201905,964,603,361,601794.4,361276,963070.4
412420,201905,13,11,2,10978,1996,12974
412430,201905,21,15,6,14970,5988,20958
412440,201905,602,331,271,330352.52,271462.12,601814.64
412450,201905,76,65,11,64870,10978,75848
412460,201905,88,67,21,66866,21956,88822
412470,201905,227,183,44,182634,43912,226546
412480,201905,155,114,41,113772.3,40918,154690.3
412490,201905,165,144,21,143712,20958,164670
412500,201905,449,372,77,371256.85,77844,449100.85
412510,201905,188,155,33,154690.4,32934,187624.4
412520,201905,90,60,30,59880,29940,89820
412530,201905,110,58,52,57884,51896,109780
412535,201905,109,79,30,78843.96,29940,108783.96
412540,201905,78,36,42,35928,41916,77844
412545,201905,92,67,25,66866,24950,91816
412550,201905,3643,1655,1988,1651690,1987019.2,3638709.2
412555,201905,13,9,4,8982,3992,12974
412560,201905,605,433,172,432134,171656,603790
412570,201905,743,405,338,404190,337324,741514
412575,201905,94,66,28,65868,27944,93812
412580,201905,169,113,56,112774,55888,168662
412590,201905,36,32,4,31936,3992,35928
412600,201905,172,129,43,128742.74,42914,171656.74
412610,201905,31,19,12,18962,11976,30938
412620,201905,152,131,21,130738,20958,151696
412625,201905,2223,1192,1031,1189617.03,1030936.73,2220553.76
412627,201905,72,56,16,55888,15968,71856
412630,201905,419,282,137,281436.07,136726,418162.07
412635,201905,64,18,46,17964,45908,63872
412640,201905,115,76,39,75848,38922,114770
412650,201905,353,227,126,226546,125748,352294
412660,201905,473,290,183,289420,182634,472054
412665,201905,51,45,6,44910,5988,50898
412667,201905,295,207,88,206591.28,87826.2,294417.48
412670,201905,65,54,11,53892,10978,64870
412680,201905,298,236,62,237524,62874.48,300398.48
412690,201905,104,67,37,66866,36926.4,103792.4
412700,201905,155,105,50,104790,49900.4,154690.4
412710,201905,1422,867,555,865268.2,553890,1419158.2
412720,201905,233,152,81,152694,80838,233532
412730,201905,191,159,32,158682,31936,190618
412740,201905,422,235,187,234530,186626,421156
412750,201905,458,267,191,266466,190618,457084
412760,201905,276,146,130,145708,129740,275448
412770,201905,2134,1203,931,1201593.23,930137.78,2131731.01
412780,201905,153,120,33,119760,32934,152694
412785,201905,267,136,131,135728,130738,266466
412788,201905,36,21,15,20958,14970,35928
412790,201905,132,110,22,109780,21956,131736
412795,201905,151,113,38,112774,37924,150698
412796,201905,319,217,102,216566,102794,319360
412800,201905,580,374,206,373252.8,205588,578840.8
412810,201905,2993,1655,1338,1654685.68,1338318,2993003.68
412820,201905,947,608,339,606785.9,338323.67,945109.57
412830,201905,14,11,3,10978,2994,13972
412840,201905,222,157,65,156686.4,64870,221556.4
412850,201905,788,521,267,519958,266466,786424
412853,201905,172,91,81,90818,80838.4,171656.4
412855,201905,214,117,97,116766.26,96806,213572.26
412860,201905,91,65,26,64870,25948,90818
412862,201905,59,44,15,43912,14970,58882
412863,201905,5,5,0,4990,0,4990
412865,201905,43,32,11,31936,10978,42914
412870,201905,110,71,39,70858,38922,109780
412880,201905,101,72,29,71856.4,28942,100798.4
420005,201905,45,40,5,39920,4990,44910
420010,201905,371,245,126,244510.3,125748.4,370258.7
420020,201905,85,71,14,70858,13972,84830
420030,201905,26,24,2,23952,1996,25948
420040,201905,111,86,25,85828,24950,110778
420050,201905,52,32,20,31936,19960,51896
420055,201905,18,18,0,17964,0,17964
420060,201905,34,25,9,24950,8982,33932
420070,201905,109,91,18,90818,17964,108782
420075,201905,10,10,0,9980,0,9980
420080,201905,48,42,6,41916,5988,47904
420090,201905,34,32,2,31936,1996,33932
420100,201905,160,138,22,137724.4,21956,159680.4
420110,201905,18,18,0,17964,0,17964
420120,201905,61,47,14,46906,13972,60878
420125,201905,84,67,17,66866,16966,83832
420127,201905,30,25,5,24950,4990,29940
420130,201905,404,251,153,250498,152694,403192
420140,201905,1330,755,575,753492.68,574849.86,1328342.54
420150,201905,44,38,6,37924,5988,43912
420160,201905,35,33,2,32934,1996,34930
420165,201905,19,14,5,13972,4990,18962
420170,201905,74,48,26,47904,25948,73852
420180,201905,23,21,2,20958,1996,22954
420190,201905,30,25,5,24950,4990,29940
420195,201905,133,66,67,65868,66866,132734
420200,201905,1272,567,705,565866.4,706589.84,1272456.24
420205,201905,71,42,29,41916,28942,70858
420207,201905,115,64,51,64870.5,50898,115768.5
420208,201905,21,17,4,16966,3992,20958
420209,201905,20,16,4,15968,3992,19960
420210,201905,474,234,240,233532,239520.98,473052.98
420213,201905,50,39,11,38922,10978,49900
420215,201905,28,24,4,23952,3992,27944
420220,201905,67,43,24,42914,23952,66866
420230,201905,833,474,359,473052,358282.98,831334.98
420240,201905,2285,1536,749,1532931.14,748500,2281431.14
420243,201905,43,34,9,33932,8982,42914
420245,201905,137,72,65,71856,64870,136726
420250,201905,60,37,23,36926,22954,59880
420253,201905,41,33,8,32934,7984,40918
420257,201905,13,11,2,10978,1996,12974
420260,201905,103,88,15,88822,14970,103792
420270,201905,41,31,10,30938.99,9980,40918.99
420280,201905,288,215,73,214573.64,72856.66,287430.30
420285,201905,21,12,9,11976,8982,20958
420287,201905,54,34,20,33932,19960,53892
420290,201905,991,697,294,695606.99,293416.95,989023.94
420300,201905,1423,1137,286,1136724.84,285428.98,1422153.82
420310,201905,62,45,17,44910,16966,61876
420315,201905,33,29,4,28942,3992,32934
420320,201905,881,451,430,450098,429140.99,879238.99
420325,201905,0,,,,,0.0
420330,201905,126,86,40,85828,39920,125748
420340,201905,163,110,53,109781.18,52894,162675.18
420350,201905,253,186,67,186626,66866,253492
420360,201905,755,574,181,572852.98,180640.46,753493.44
420370,201905,120,75,45,74850.6,44910.4,119761.0
420380,201905,1141,812,329,810378.08,328346.36,1138724.44
420390,201905,265,182,83,181636,82834,264470
420395,201905,186,135,51,134730,50898,185628
420400,201905,254,193,61,192614.75,60878,253492.75
420410,201905,65,49,16,48902,15968,64870
420415,201905,34,30,4,29940,3992,33932
420417,201905,53,41,12,40918,11976,52894
420419,201905,11,11,0,10978,0,10978
420420,201905,2831,1754,1077,1752493.37,1076846.3,2829339.67
420425,201905,75,61,14,60878.98,13972.98,74851.96
420430,201905,1245,871,374,870258.13,373252.98,1243511.11
420435,201905,17,15,2,14970,1996,16966
420440,201905,101,72,29,71856.4,29940,101796.4
420445,201905,23,22,1,21956,998,22954
420450,201905,76,39,37,38922,36926,75848
420455,201905,223,170,53,169662.94,52897.92,222560.86
420460,201905,2377,1566,811,1563873.7,811383.01,2375256.71
420470,201905,114,82,32,81836,31936,113772
420475,201905,7,7,0,6986,0,6986
420480,201905,882,665,217,664669.2,216566.8,881236.0
420490,201905,107,80,27,79840,26946,106786
420500,201905,590,265,325,265468.86,324350,589818.86
420510,201905,19,16,3,15968,2994,18962
420515,201905,27,19,8,18962,7984,26946
420517,201905,9,9,0,8982,0,8982
420519,201905,0,,,,,0.0
420520,201905,77,57,20,56886,19960,76846
420530,201905,164,109,55,108782.3,54890,163672.3
420535,201905,19,18,1,17964,998,18962
420540,201905,5356,3186,2170,3181881.66,2168656.94,5350538.60
420543,201905,28,27,1,26946,998,27944
420545,201905,202,143,59,142714,58882.98,201596.98
420550,201905,882,720,162,718561.76,162677.92,881239.68
420555,201905,41,30,11,29940,10978,40918
420560,201905,68,55,13,54890,12974,67864
420570,201905,157,95,62,94810,62874,157684
420580,201905,289,129,160,128742,159680.4,288422.4
420590,201905,515,360,155,359280,154690,513970
420600,201905,109,63,46,62874.56,45908,108782.56
420610,201905,41,38,3,37924,2994,40918
420620,201905,77,64,13,63872,12974,76846
420630,201905,159,116,43,115768,42915.98,158683.98
420640,201905,87,79,8,78842,7984,86826
420650,201905,233,121,112,120758,111776,232534
420660,201905,54,42,12,41916,11976,53892
420665,201905,39,29,10,28942,9980,38922
420670,201905,315,239,76,238522,75848.98,314370.98
420675,201905,16,15,1,14970,998,15968
420680,201905,37,27,10,26946,9980,36926
420690,201905,178,145,33,144710,32934,177644
420700,201905,708,495,213,494016.32,212581.84,706598.16
420710,201905,153,89,64,88822,63872,152694
420720,201905,112,90,22,89820.98,21956,111776.98
420730,201905,591,378,213,377248.26,213576.32,590824.58
420740,201905,49,48,1,47904,998,48902
420750,201905,511,349,162,348302,162674,510976
420757,201905,18,15,3,14970,2994,17964
420760,201905,37,31,6,30938,5988,36926
420765,201905,74,58,16,57884,15968,73852
420768,201905,52,48,4,47904,3992,51896
420770,201905,81,68,13,67864,12974,80838
420775,201905,44,40,4,39920,3992,43912
420780,201905,235,188,47,187624,46906,234530
420785,201905,13,10,3,9980,2994,12974
420790,201905,171,144,27,143715.92,26947.96,170663.88
420800,201905,69,53,16,52894,15968,68862
420810,201905,254,225,29,224550,28942,253492
420820,201905,2372,1397,975,1395205.6,974050.77,2369256.37
420830,201905,613,338,275,337324.8,274450,611774.8
420840,201905,149,112,37,111776,36926,148702
420845,201905,426,192,234,191616,233532.4,425148.4
420850,201905,247,193,54,192614,53892,246506
420860,201905,64,54,10,53892,9980,63872
420870,201905,123,89,34,88822,33932,122754
420880,201905,183,126,57,125748,56886.98,182634.98
420890,201905,906,457,449,456087.77,448102.98,904190.75
420895,201905,8,8,0,7984,0,7984
420900,201905,418,334,84,334330,83832.98,418162.98
420910,201905,5848,3303,2545,3299395.73,2545903.74,5845299.47
420915,201905,75,70,5,69860,4990,74850
420917,201905,20,14,6,13972,5988,19960
420920,201905,24,17,7,16966,6986,23952
420930,201905,2831,1764,1067,1761466.3,1066032.91,2827499.21
420940,201905,607,444,163,443112.4,162678.49,605790.89
420945,201905,10,8,2,7984,1996,9980
420950,201905,58,52,6,51896,5988,57884
420960,201905,119,95,24,94812.94,23952.98,118765.92
420970,201905,303,243,60,242518.52,59881.96,302400.48
420980,201905,22,22,0,21956,0,21956
420985,201905,63,56,7,55888,6986,62874
420990,201905,78,60,18,59880,17964,77844
421000,201905,34,21,13,20958,12974,33932
421003,201905,66,45,21,44910,20958.98,65868.98
421005,201905,7,4,3,3992,2994,6986
421010,201905,773,537,236,535926.4,236527.1,772453.5
421020,201905,26,21,5,20958,4990,25948
421030,201905,121,102,19,101796.3,18962,120758.3
421040,201905,68,55,13,54890,13972,68862
421050,201905,329,230,99,229540.4,98802,328342.4
421055,201905,25,21,4,20958,3992,24950
421060,201905,82,54,28,53892,27944,81836
421070,201905,48,44,4,43912.4,3992,47904.4
421080,201905,33,31,2,30938,1996,32934
421085,201905,25,19,6,18962,5988,24950
421090,201905,37,29,8,28942,7984,36926
421100,201905,129,95,34,94810,34930,129740
421105,201905,215,175,40,174650.98,39920.98,214571.96
421110,201905,112,91,21,90818,20958,111776
421120,201905,153,118,35,117764.98,34930,152694.98
421125,201905,18,13,5,12974,4990,17964
421130,201905,824,529,295,527942,294410.4,822352.4
421140,201905,31,23,8,22954,7984,30938
421145,201905,41,33,8,32934,7984,40918
421150,201905,102,75,27,74850,26946.8,101796.8
421160,201905,68,46,22,45908,21956,67864
421165,201905,17,16,1,15968,998,16966
421170,201905,192,162,30,161800.32,29940.98,191741.30
421175,201905,155,103,52,102794,51896,154690
421180,201905,59,39,20,38922.24,19960,58882.24
421185,201905,18,15,3,14970,2994,17964
421187,201905,0,,,,,0.0
421189,201905,43,31,12,30938,11976,42914
421190,201905,1615,1032,583,1029936,582832.8,1612768.8
421200,201905,90,67,23,66866,22954,89820
421205,201905,28,17,11,16966,10978,27944
421210,201905,170,121,49,120758,48902,169660
421220,201905,281,222,59,221556,58882,280438
421223,201905,52,43,9,42914.6,8982,51896.6
421225,201905,69,45,24,44910.6,23952,68862.6
421227,201905,85,64,21,63872,20958,84830
421230,201905,53,39,14,38922,13972,52894
421240,201905,18,18,0,17964,0,17964
421250,201905,365,226,139,225549.6,138722,364271.6
421260,201905,23,19,4,18962,3992,22954
421265,201905,1,1,0,998,0,998
421270,201905,51,45,6,44910,5988,50898
421280,201905,341,196,145,195608,144710,340318
421290,201905,326,221,105,220558,104790,325348
421300,201905,25,20,5,19960,4990,24950
421310,201905,50,37,13,36926,12974,49900
421315,201905,28,18,10,17964,9980,27944
421320,201905,136,92,44,91816,43912,135728
421330,201905,103,76,27,75848,26946.98,102794.98
421335,201905,39,27,12,26946,11976,38922
421340,201905,255,167,88,166667.56,87824,254491.56
421350,201905,197,111,86,110778.97,85828,196606.97
421360,201905,677,506,171,504989.88,170659.92,675649.80
421370,201905,195,153,42,152694,41916,194610
421380,201905,130,104,26,103792,25948,129740
421390,201905,17,12,5,11976,4990,16966
421400,201905,118,102,16,101796,15968,117764
421410,201905,19,17,2,16966,1996,18962
421415,201905,21,20,1,19960,998,20958
421420,201905,143,117,26,116766,26946,143712
421430,201905,14,10,4,9980,3992,13972
421440,201905,58,47,11,46906,10978,57884
421450,201905,90,77,13,76846,12974,89820
421460,201905,62,51,11,50898,10978,61876
421470,201905,67,45,22,44910,21956,66866
421480,201905,675,510,165,508980,164670.98,673650.98
421490,201905,23,22,1,21956.98,998,22954.98
421500,201905,503,330,173,329343.34,172669.68,502013.02
421505,201905,23,16,7,15968,6986,22954
421507,201905,37,30,7,29940,6986,36926
421510,201905,76,50,26,49900,25948,75848
421520,201905,62,53,9,52894,8982,61876
421530,201905,52,45,7,44910,6986,51896
421535,201905,27,26,1,25948.44,998,26946.44
421540,201905,57,49,8,48902,7984,56886
421545,201905,101,75,26,74851.78,25948,100799.78
421550,201905,301,217,84,216566,83832,300398
421555,201905,24,19,5,18962,4990.8,23952.8
421560,201905,8,7,1,6986,998,7984
421565,201905,124,86,38,85828,37924,123752
421567,201905,31,25,6,24950,5988,30938
421568,201905,30,27,3,26946,2994,29940
421569,201905,9,9,0,8982,0,8982
421570,201905,185,124,61,123752,60878,184630
421575,201905,28,23,5,22954,4990,27944
421580,201905,715,428,287,428142,286426,714568
421590,201905,21,20,1,19960,998,20958
421600,201905,129,80,49,79840,48902.8,128742.8
421605,201905,114,81,33,80838.3,32934,113772.3
421610,201905,198,156,42,155688.4,41916,197604.4
421620,201905,1072,633,439,631735.38,438122,1069857.38
421625,201905,23,20,3,19960,2994,22954
421630,201905,290,185,105,184630.9,104791.6,289422.5
421635,201905,17,8,9,7984,8982,16966
421640,201905,97,83,14,82834.6,13972,96806.6
421650,201905,302,181,121,180638,121756,302394
421660,201905,2253,1364,889,1362271.78,887226.73,2249498.51
421670,201905,197,144,53,143712,53892,197604
421680,201905,175,158,17,157684,16966,174650
421690,201905,345,249,96,248504.94,96806.44,345311.38
421700,201905,62,40,22,39920,21956.8,61876.8
421710,201905,27,26,1,25948,998,26946
421715,201905,7,6,1,5988,998,6986
421720,201905,600,437,163,436126,163672,599798
421725,201905,13,5,8,4990,7984,12974
421730,201905,37,26,11,25948,10978,36926
421740,201905,89,42,47,41916,46906,88822
421750,201905,217,162,55,162674,55888,218562
421755,201905,25,23,2,22954,1996,24950
421760,201905,107,77,30,76846,29940,106786
421770,201905,608,403,205,402204.54,205593.12,607797.66
421775,201905,32,20,12,19960,11976,31936
421780,201905,190,148,42,147704,41916,189620
421790,201905,158,134,24,133732,23952,157684
421795,201905,19,15,4,14970,3992,18962
421800,201905,513,331,182,330338,181636.5,511974.5
421810,201905,77,63,14,62874,13972,76846
421820,201905,326,220,106,219560.4,106786,326346.4
421825,201905,134,114,20,113772,19960,133732
421830,201905,132,99,33,98802,32934,131736
421835,201905,3,3,0,2994,0,2994
421840,201905,52,44,8,43912.98,7984,51896.98
421850,201905,80,69,11,68862,10978.99,79840.99
421860,201905,39,31,8,30938,7984,38922
421870,201905,998,764,234,763500.14,233537.72,997037.86
421875,201905,53,45,8,44910,7984,52894
421880,201905,168,121,47,120758,46906.4,167664.4
421885,201905,26,21,5,20958,4990,25948
421890,201905,126,90,36,89820,35928.98,125748.98
421895,201905,49,45,4,44910,3992,48902
421900,201905,164,130,34,129742.94,33936.9,163679.84
421910,201905,67,43,24,42914,23952,66866
421915,201905,31,26,5,25948,4990,30938
421917,201905,41,30,11,29940,10978,40918
421920,201905,37,34,3,34930,2994,37924
421930,201905,743,582,161,580836,160680.94,741516.94
421935,201905,52,45,7,44910,6986,51896
421940,201905,41,37,4,36926,3992,40918
421950,201905,876,590,286,588821.2,285429.58,874250.78
421960,201905,40,33,7,32934.4,6986,39920.4
421970,201905,361,234,127,234530.4,127744.98,362275.38
421985,201905,29,18,11,17964,10978,28942
422000,201905,0,,,,,0.0
430003,201905,197,53,144,52894,143712,196606
430005,201905,39,30,9,29940,8982,38922
430010,201905,271,191,80,190618,80838,271456
430020,201905,151,99,52,99800.4,51896,151696.4
430030,201905,129,106,23,105788,22954,128742
430040,201905,2995,1759,1236,1755484.64,1235526.34,2991010.98
430045,201905,70,59,11,58882,10978,69860
430047,201905,7,6,1,5988,998,6986
430050,201905,77,65,12,65868,11976,77844
430055,201905,14,12,2,11976,1996,13972
430057,201905,6,4,2,3992,1996,5988
430060,201905,3675,2194,1481,2192614.39,1481036.72,3673651.11
430063,201905,60,55,5,54890,4990,59880
430064,201905,159,132,27,131736,26946,158682
430066,201905,7,5,2,4990,1996,6986
430070,201905,47,36,11,35928,10978,46906
430080,201905,71,49,22,48902,21956,70858
430085,201905,35,13,22,12974,21956,34930
430087,201905,31,24,7,23952.7,6986,30938.7
430090,201905,73,66,7,65868,6986,72854
430100,201905,123,82,41,81836,40918,122754
430105,201905,145,76,69,75848.6,68862,144710.6
430107,201905,20,15,5,14970,4990,19960
430110,201905,415,248,167,247504,166666,414170
430120,201905,143,132,11,131736,10978,142714
430130,201905,797,493,304,492014.4,303392,795406.4
430140,201905,123,116,7,115768,6986,122754
430150,201905,110,72,38,71856,37924,109780
430155,201905,34,31,3,30938,2994,33932
430160,201905,3716,2212,1504,2211571.1,1503987.38,3715558.48
430163,201905,332,152,180,151696,180638,332334
430165,201905,30,19,11,18962,10978,29940
430170,201905,91,77,14,76846,13972,90818
430175,201905,85,67,18,66866,17964,84830
430180,201905,100,83,17,82834,16966,99800
430185,201905,33,24,9,23952,8982,32934
430187,201905,94,41,53,40918,52894,93812
430190,201905,217,123,94,122754,93812,216566
430192,201905,15,13,2,12974,1996,14970
430195,201905,15,10,5,9980,4990,14970
430200,201905,175,154,21,153692,20958,174650
430205,201905,20,19,1,18962,998,19960
430210,201905,670,522,148,520956.4,147704.4,668660.8
430215,201905,14,12,2,11976,1996,13972
430220,201905,74,52,22,51896,21956,73852
430222,201905,13,7,6,6986,5988,12974
430223,201905,13,7,6,6986,5988,12974
430225,201905,2,1,1,998,998,1996
430230,201905,313,185,128,184630,128742,313372
430235,201905,57,43,14,42914,13972,56886
430237,201905,26,21,5,20958,4990,25948
430240,201905,133,85,48,84830,47904,132734
430245,201905,69,58,11,57884,10978,68862
430250,201905,193,114,79,113772,78842,192614
430258,201905,11,9,2,8982,1996,10978
430260,201905,34,30,4,30938,3992,34930
430265,201905,37,31,6,30938,5988,36926
430270,201905,544,408,136,408182.3,135731.92,543914.22
430280,201905,1038,641,397,639718,397205.9,1036923.9
430290,201905,385,219,166,218562.6,165668,384230.6
430300,201905,2118,1186,932,1183631.34,931140.05,2114771.39
430310,201905,1942,1009,933,1007981.96,933135.98,1941117.94
430320,201905,55,45,10,44910,9980,54890
430330,201905,96,86,10,85828,9980,95808
430340,201905,71,61,10,60878,9980,70858
430350,201905,1664,1156,508,1153688.6,506984.98,1660673.58
430355,201905,23,21,2,20958,1996,22954
430360,201905,85,43,42,42914,41916,84830
430367,201905,33,24,9,23952,8982,32934
430370,201905,57,49,8,48902,7984,56886
430380,201905,139,104,35,103792,34930,138722
430390,201905,605,386,219,385228,218562,603790
430400,201905,140,107,33,106786,32934,139720
430410,201905,61,47,14,46906,13972,60878
430420,201905,510,339,171,338323.34,170658.98,508982.32
430430,201905,54,53,1,53227.33,998,54225.33
430435,201905,155,115,40,114770,39920,154690
430440,201905,516,340,176,339320.6,176646,515966.6
430450,201905,1173,967,206,966064,206586,1172650
430460,201905,5074,2785,2289,2779434.28,2286443.2,5065877.48
430461,201905,17,15,2,14970,1996,16966
430462,201905,9,6,3,5988,2994,8982
430463,201905,1063,567,496,565867.56,495009.96,1060877.52
430465,201905,24,14,10,13972,9980,23952
430466,201905,675,486,189,485028.4,188622,673650.4
430467,201905,93,52,41,51896.6,40918,92814.6
430468,201905,112,68,44,67864,43912,111776
430469,201905,23,18,5,17964,4990,22954
430470,201905,1163,657,506,655983.95,505986,1161969.95
430471,201905,54,39,15,38922,14970,53892
430480,201905,99,61,38,60878,37924,98802
430485,201905,6,6,0,5988.4,0,5988.4
430490,201905,87,70,17,69860,16966,86826
430495,201905,38,28,10,27944,9980,37924
430500,201905,194,130,64,129740,63872.63,193612.63
430510,201905,3377,2227,1150,2227537.24,1150694,3378231.24
430511,201905,16,15,1,14970,998,15968
430512,201905,140,99,41,98802,40918,139720
430513,201905,50,40,10,39920,9980,49900
430515,201905,31,29,2,28942,1996,30938
430517,201905,170,152,18,151696,17964,169660
430520,201905,371,261,110,260478,109780,370258
430530,201905,86,49,37,48902,36926,85828
430535,201905,455,313,142,313372,141716.99,455088.99
430537,201905,10,10,0,9980,0,9980
430540,201905,79,54,25,53892,24950,78842
430543,201905,361,116,245,115768,244510,360278
430544,201905,44,41,3,40918,2994,43912
430545,201905,357,185,172,184631.9,171656,356287.9
430550,201905,44,37,7,36926,6986,43912
430558,201905,5,3,2,2994,1996,4990
430560,201905,54,26,28,25948,27944,53892
430570,201905,108,43,65,42914,64870,107784
430580,201905,126,103,23,102794,22954.6,125748.6
430583,201905,15,15,0,14970,0,14970
430585,201905,10,4,6,3992,5988,9980
430587,201905,16,8,8,7984,7984,15968
430590,201905,149,122,27,121756,26946,148702
430593,201905,2,2,0,1996,0,1996
430595,201905,16,13,3,12974,2994,15968
430597,201905,49,27,22,26946,21956,48902
430600,201905,223,158,65,157684,64870,222554
430605,201905,157,99,58,98802,57884,156686
430607,201905,25,22,3,21956,2994,24950
430610,201905,1621,774,847,773450.9,847303.38,1620754.28
430613,201905,3,3,0,2994,0,2994
430620,201905,113,83,30,82834,29940,112774
430630,201905,47,41,6,40918,5988,46906
430632,201905,33,28,5,27944,4990,32934
430635,201905,36,33,3,34930,2994,37924
430637,201905,56,31,25,30938,24950,55888
430640,201905,900,484,416,483032.74,415168,898200.74
430642,201905,22,20,2,19960,1996,21956
430645,201905,37,30,7,29940,6986,36926
430650,201905,258,210,48,209580.4,47904,257484.4
430655,201905,3,3,0,2994,0,2994
430660,201905,978,477,501,478042,499998.4,978040.4
430670,201905,75,52,23,51896,22954,74850
430673,201905,74,41,33,40918,32934,73852
430675,201905,14,11,3,10978,2994,13972
430676,201905,504,306,198,305388.94,197604.94,502993.88
430680,201905,257,182,75,182634.4,74850,257484.4
430690,201905,539,336,203,335328.98,202594.63,537923.61
430692,201905,7,5,2,4990,1996,6986
430693,201905,139,96,43,95808,43912,139720
430695,201905,74,62,12,61876,11976,73852
430697,201905,58,36,22,35928,21956,57884
430700,201905,1546,1083,463,1080834.4,463072,1543906.4
430705,201905,22,20,2,19960,1996,21956
430710,201905,261,170,91,169660,90818,260478
430720,201905,108,91,17,90818,16966,107784
430730,201905,137,117,20,116766,19960,136726
430740,201905,70,46,24,45908,23952,69860
430745,201905,34,27,7,26946,6986,33932
430750,201905,336,225,111,225548,110778,336326
430755,201905,89,53,36,52894,35928,88822
430760,201905,369,221,148,220559.04,148702.98,369262.02
430770,201905,1441,757,684,756486.24,683633.92,1440120.16
430780,201905,318,206,112,205588.98,111776.98,317365.96
430781,201905,29,26,3,25948,2994,28942
430783,201905,54,45,9,44910,8982,53892
430786,201905,6,3,3,2994,2994,5988
430790,201905,534,350,184,349300,183632.4,532932.4
430800,201905,160,133,27,132734.51,26946,159680.51
430805,201905,41,38,3,37924,2994,40918
430807,201905,46,26,20,25948,19960,45908
430810,201905,75,49,26,48902,25948,74850
430820,201905,145,87,58,86826,58882,145708
430825,201905,11,9,2,8982,1996,10978
430830,201905,239,222,17,221556.4,16966,238522.4
430840,201905,130,88,42,87824,41916,129740
430843,201905,6,4,2,3992,1996,5988
430845,201905,69,41,28,40918,27944,68862
430850,201905,576,407,169,407184,168665.9,575849.9
430860,201905,167,107,60,106786,59880,166666
430865,201905,72,39,33,38922,32934.98,71856.98
430870,201905,82,67,15,66866,14970,81836
430880,201905,155,116,39,115768,38922,154690
430885,201905,9,7,2,6986,1996,8982
430890,201905,351,213,138,212574,137724,350298
430900,201905,526,369,157,368761,156686,525447
430905,201905,106,47,59,46906,58882,105788
430910,201905,278,154,124,153692,123752.98,277444.98
430912,201905,5,5,0,4990,0,4990
430915,201905,35,29,6,28942,5988,34930
430920,201905,4212,2340,1872,2339317.91,1870255.94,4209573.85
430925,201905,4,3,1,2994,998,3992
430930,201905,2064,1217,847,1215565.86,845309.88,2060875.74
430940,201905,263,169,94,168662,93812,262474
430950,201905,151,123,28,122754,27944,150698
430955,201905,22,13,9,12974,8982,21956
430957,201905,19,18,1,17964,998,18962
430960,201905,245,161,84,160678,83832,244510
430965,201905,114,73,41,72854,40918,113772
430970,201905,83,70,13,69860,13972,83832
430975,201905,40,36,4,35928,3992,39920
430980,201905,49,32,17,31936,16966,48902
430990,201905,116,88,28,87824,27944,115768
430995,201905,119,114,5,113772,4990,118762
431000,201905,304,137,167,136727,166666,303393
431010,201905,350,205,145,204590,144710,349300
431020,201905,1937,1133,804,1130735,805386,1936121
431030,201905,41,31,10,30938,9980,40918
431033,201905,378,191,187,190618,186626,377244
431036,201905,14,9,5,8982,4990,13972
431040,201905,136,84,52,83832,51896,135728
431041,201905,38,26,12,25948,11976,37924
431043,201905,50,30,20,29940,19960,49900
431046,201905,11,7,4,6986,3992,10978
431050,201905,199,128,71,127744,70858,198602
431053,201905,73,44,29,43912.96,28942,72854.96
431055,201905,64,44,20,43912,19960,63872
431057,201905,18,18,0,17964,0,17964
431060,201905,1654,1043,611,1040916.35,610791.4,1651707.75
431065,201905,19,11,8,10978,7984,18962
431070,201905,68,62,6,61876,5988,67864
431075,201905,6,6,0,5988,0,5988
431080,201905,133,83,50,82834,49900,132734
431085,201905,34,31,3,30938,2994,33932
431087,201905,15,12,3,11976,2994,14970
431090,201905,54,43,11,42914,10978,53892
431100,201905,1216,729,487,727543.42,486026,1213569.42
431110,201905,244,149,95,148702,94810.4,243512.4
431112,201905,28,17,11,16966,10978,27944
431113,201905,33,24,9,23952,8982,32934
431115,201905,157,109,48,108782,47904,156686
431120,201905,606,365,241,364270.6,240519.92,604790.52
431123,201905,4,3,1,2994,998,3992
431125,201905,98,89,9,88822,8982,97804
431127,201905,9,4,5,3992,4990,8982
431130,201905,698,453,245,452094,244510,696604
431140,201905,767,538,229,537922.4,228542,766464.4
431142,201905,33,27,6,26946.95,5988,32934.95
431150,201905,199,150,49,149700,48902,198602
431160,201905,55,49,6,48902,5988,54890
431162,201905,18,13,5,12974,4990,17964
431164,201905,6,6,0,5988,0,5988
431170,201905,107,86,21,85828,20958,106786
431171,201905,69,41,28,40918,27944,68862
431173,201905,1,1,0,998,0,998
431175,201905,199,102,97,101796.4,96806,198602.4
431177,201905,74,57,17,56886,16966,73852
431179,201905,14,12,2,11976,1996,13972
431180,201905,469,289,180,288422,179640.98,468062.98
431190,201905,86,66,20,65868,19960,85828
431198,201905,70,49,21,48902,20958,69860
431200,201905,20,16,4,15968,3992,19960
431205,201905,23,23,0,22954,0,22954
431210,201905,88,53,35,52894,34930,87824
431213,201905,29,25,4,24950,3992,28942
431215,201905,23,20,3,19960,2994,22954
431217,201905,5,4,1,3992,998,4990
431220,201905,69,60,9,59880.8,8982,68862.8
431225,201905,150,101,49,100798.98,48902,149700.98
431230,201905,103,93,10,92814,9980,102794
431235,201905,8,8,0,7984,0,7984
431237,201905,24,17,7,16966,6986,23952
431238,201905,9,6,3,5988.4,2994,8982.4
431240,201905,991,653,338,651694.2,337324,989018.2
431242,201905,40,39,1,39920,998,40918
431244,201905,11,8,3,7984,2994,10978
431245,201905,49,38,11,37924,10978,48902
431247,201905,13,10,3,9980,2994,12974
431250,201905,280,148,132,147704,131736,279440
431260,201905,58,45,13,44910,12974,57884
431261,201905,19,13,6,12974,5988,18962
431262,201905,18,17,1,16966,998,17964
431265,201905,152,85,67,84830,68862,153692
431267,201905,15,14,1,13972,998,14970
431270,201905,327,268,59,267464,58882,326346
431275,201905,39,36,3,35928,2994,38922
431280,201905,19,15,4,14970,3992,18962
431290,201905,25,20,5,19960,4990,24950
431295,201905,3,3,0,2994,0,2994
431300,201905,22,19,3,18962,2994,21956
431301,201905,6,6,0,5988,0,5988
431303,201905,55,36,19,35928,18962,54890
431306,201905,240,130,110,129562.35,109780,239342.35
431308,201905,6,5,1,4990,998,5988
431310,201905,67,57,10,56886,9980,66866
431320,201905,143,87,56,86826,55888,142714
431330,201905,180,115,65,114770,65868,180638
431333,201905,30,26,4,25948,3992,29940
431335,201905,9,5,4,4990,3992,8982
431337,201905,328,151,177,150698,177644,328342
431339,201905,21,18,3,17964,2994,20958
431340,201905,2982,1701,1281,1698521.11,1279453.36,2977974.47
431342,201905,38,24,14,23952,13972,37924
431344,201905,18,18,0,17964,0,17964
431346,201905,5,5,0,4990,0,4990
431349,201905,35,32,3,31936,2994,34930
431350,201905,923,545,378,543911.08,380238,924149.08
431360,201905,47,42,5,41916,4990,46906
431365,201905,322,158,164,157684,166666,324350
431370,201905,1331,794,537,792412.4,535932.86,1328345.26
431380,201905,98,84,14,84830,13972,98802
431390,201905,516,287,229,286426,230538,516964
431395,201905,295,137,158,136726,158682.96,295408.96
431400,201905,43,31,12,30938,11976,42914
431402,201905,104,74,30,73852,29940,103792
431403,201905,23,13,10,12974,9980,22954
431405,201905,659,365,294,364270.9,294412.94,658683.84
431406,201905,31,27,4,26946,3992,30938
431407,201905,53,42,11,41916,10978,52894
431410,201905,3418,2095,1323,2091809.5,1320354.3,3412163.8
431413,201905,17,14,3,13972,2994,16966
431415,201905,72,53,19,52894,18962,71856
431417,201905,23,12,11,11976,10978,22954
431420,201905,318,218,100,217564,99800,317364
431430,201905,46,22,24,21956,23952,45908
431440,201905,8913,6300,2613,6292400.52,2610769.4,8903169.92
431442,201905,27,16,11,15968,10978,26946
431445,201905,23,20,3,19960,2994,22954
431446,201905,4,4,0,3992,0,3992
431447,201905,88,65,23,64870,22954,87824
431449,201905,57,49,8,48902,7984,56886
431450,201905,418,287,131,286426,130738,417164
431454,201905,0,,,,,0.0
431455,201905,51,40,11,39920,10978,50898
431460,201905,516,358,158,357284,158682,515966
431470,201905,120,93,27,92814,26946,119760
431475,201905,11,10,1,9980,998,10978
431477,201905,35,24,11,23952,10978,34930
431478,201905,8,7,1,6986,998,7984
431480,201905,493,316,177,315368,176646,492014
431490,201905,28377,16173,12204,16152745.48,12192697.29,28345442.77
431500,201905,80,59,21,58882,20958,79840
431505,201905,31,19,12,18962,11976,30938
431507,201905,13,10,3,9980,2994,12974
431510,201905,259,183,76,182634.1,75848,258482.1
431513,201905,25,21,4,20958,3992,24950
431514,201905,7,6,1,5988,998,6986
431515,201905,80,68,12,67864,11976,79840
431517,201905,5,4,1,3992,998,4990
431520,201905,38,34,4,33932,3992,37924
431530,201905,1553,704,849,702594.88,848300.94,1550895.82
431531,201905,24,22,2,21956,1996,23952
431532,201905,28,19,9,18962,8982,27944
431535,201905,28,18,10,17964,9980,27944
431540,201905,143,126,17,125748,16966,142714
431545,201905,14,12,2,11976,1996,13972
431550,201905,356,200,156,199600,155688,355288
431555,201905,13,12,1,11976,998,12974
431560,201905,4490,3155,1335,3152687.17,1338318.4,4491005.57
431570,201905,807,434,373,433132.8,372254,805386.8
431575,201905,40,26,14,25948,13972,39920
431580,201905,99,69,30,68862,29940,98802
431590,201905,149,127,22,126746,21956,148702
431595,201905,12,11,1,10978,998,11976
431600,201905,226,126,100,125748,99800,225548
431610,201905,123,91,32,90818,31936,122754
431620,201905,45,37,8,36926,7984,44910
431630,201905,134,111,23,110778,22954,133732
431640,201905,1345,847,498,845306.4,499001.36,1344307.76
431642,201905,34,32,2,31936,1996,33932
431643,201905,42,19,23,18962,22954,41916
431645,201905,319,185,134,184630,133732,318362
431647,201905,10,10,0,9980,0,9980
431650,201905,34,24,10,23952,9980,33932
431660,201905,320,203,117,202594,116766,319360
431670,201905,232,110,122,109780,122754,232534
431673,201905,5,5,0,4990,0,4990
431675,201905,29,24,5,23952,4990,28942
431680,201905,1133,832,301,830336,303392,1133728
431690,201905,4799,2934,1865,2928135,1864268.3,4792403.3
431695,201905,24,20,4,19960,3992,23952
431697,201905,0,,,,,0.0
431700,201905,170,135,35,134730,36926,171656
431710,201905,4033,1779,2254,1777439.58,2252496.78,4029936.36
431720,201905,1371,833,538,831334.6,536924.99,1368259.59
431725,201905,1,1,0,998,0,998
431730,201905,1197,812,385,810378.16,385228,1195606.16
431740,201905,1370,680,690,678640.96,688624.32,1367265.28
431750,201905,1858,1216,642,1213569.71,642712.98,1856282.69
431755,201905,5,4,1,3992,998,4990
431760,201905,1019,659,360,659678.23,361276,1020954.23
431770,201905,398,295,103,294410,102794,397204
431775,201905,31,23,8,22954,7984,30938
431780,201905,560,351,209,350298,208582,558880
431790,201905,171,132,39,131736,38922,170658
431795,201905,12,10,2,9980,1996,11976
431800,201905,3332,1762,1570,1760485.1,1568953.4,3329438.5
431805,201905,18,16,2,15968,1996,17964
431810,201905,608,409,199,408182,199600.98,607782.98
431820,201905,322,188,134,187624,133732,321356
431830,201905,2342,1413,929,1412170,927146.92,2339316.92
431840,201905,493,327,166,326346.6,165668,492014.6
431842,201905,35,29,6,28942,5988,34930
431843,201905,12,9,3,8982,2994,11976
431844,201905,16,14,2,13972,1996,15968
431845,201905,27,25,2,24950,1996,26946
431846,201905,29,24,5,23952,4990,28942
431848,201905,15,13,2,12974,1996,14970
431849,201905,11,7,4,6986,3992,10978
431850,201905,803,661,142,660676,141716,802392
431860,201905,113,80,33,80838,33932,114770
431861,201905,4,2,2,1996,1996,3992
431862,201905,53,35,18,34930,17964,52894
431870,201905,3423,2035,1388,2034927.28,1386229.76,3421157.04
431880,201905,937,692,245,690616.94,245508,936124.94
431890,201905,1303,815,488,813370.82,488022,1301392.82
431900,201905,175,126,49,125748,48902,174650
431910,201905,53,39,14,38922,13972,52894
431912,201905,39,23,16,22954,15968,38922
431915,201905,130,104,26,103792,25948,129740
431920,201905,153,111,42,110778,41916,152694
431930,201905,81,66,15,65868,14970,80838
431935,201905,3,3,0,2994,0,2994
431936,201905,12,11,1,10978,998,11976
431937,201905,19,14,5,13972,4990,18962
431940,201905,470,316,154,315368,153692.5,469060.5
431950,201905,499,314,185,313373.38,184631.96,498005.34
431960,201905,741,410,331,409182.36,330339.96,739522.32
431970,201905,74,65,9,64870,8982,73852
431971,201905,3,3,0,2994,0,2994
431973,201905,24,20,4,19960,3992,23952
431975,201905,9,8,1,7984,998,8982
431980,201905,207,130,77,129740,76846,206586
431990,201905,1205,650,555,648635.9,556886.9,1205522.8
432000,201905,1683,918,765,917165.06,765471,1682636.06
432010,201905,281,191,90,190618,89820,280438
432020,201905,174,144,30,143712,29940,173652
432023,201905,16,14,2,13972,1996,15968
432026,201905,68,63,5,62874,4990,67864
432030,201905,66,32,34,31936,33932,65868
432032,201905,19,16,3,15968,2994,18962
432035,201905,51,42,9,41916,8982,50898
432040,201905,104,72,32,72854,31936,104790
432045,201905,8,7,1,6986,998,7984
432050,201905,80,50,30,49900,30938,80838
432055,201905,115,86,29,85828,28942,114770
432057,201905,4,3,1,3992.4,998,4990.4
432060,201905,35,32,3,31936,2994,34930
432065,201905,34,30,4,29940,3992,33932
432067,201905,88,79,9,78842,8982,87824
432070,201905,401,305,96,304640.8,95808.98,400449.78
432080,201905,823,577,246,576844,246506,823350
432085,201905,15,12,3,11976,2994,14970
432090,201905,270,176,94,175648,93812,269460
432100,201905,177,119,58,118762,57884,176646
432110,201905,595,406,189,406186,188622,594808
432120,201905,951,586,365,585826,364270,950096
432130,201905,508,369,139,368262,138722,506984
432132,201905,24,21,3,20958,2994,23952
432135,201905,77,64,13,63872,12974,76846
432140,201905,270,218,52,217564,51896,269460
432143,201905,205,132,73,131736,72854,204590
432145,201905,282,196,86,195608,86826,282434
432146,201905,14,13,1,12974,998,13972
432147,201905,126,60,66,59880,65868,125748
432149,201905,14,10,4,9980,3992,13972
432150,201905,839,520,319,518960,319361.55,838321.55
432160,201905,1435,754,681,752493.57,680637.94,1433131.51
432162,201905,4,3,1,2994,998,3992
432163,201905,19,14,5,13972,4990,18962
432166,201905,116,86,30,86328,29940,116268
432170,201905,222,116,106,115768,105788,221556
432180,201905,539,336,203,336326,202594.4,538920.4
432183,201905,6,6,0,5988,0,5988
432185,201905,80,70,10,69860,9980,79840
432190,201905,467,273,194,273452,193612.98,467064.98
432195,201905,87,73,14,73852,13972,87824
432200,201905,401,259,142,258482,141716.98,400198.98
432210,201905,118,74,44,73852,43912,117764
432215,201905,57,53,4,52894,3992,56886
432218,201905,20,19,1,18962,998,19960
432220,201905,671,350,321,350298,320359.61,670657.61
432225,201905,13,8,5,7984,4990,12974
432230,201905,145,94,51,93812,51896,145708
432232,201905,14,13,1,12974,998,13972
432234,201905,4,3,1,2994,998,3992
432235,201905,3,3,0,2994,0,2994
432237,201905,27,15,12,14970,11976,26946
432240,201905,4358,2464,1894,2460074.48,1892209.78,4352284.26
432250,201905,1094,703,391,701594,390218,1091812
432252,201905,43,38,5,37924,4990,42914
432253,201905,59,47,12,46906,11976,58882
432254,201905,27,13,14,12974,13972,26946
432255,201905,14,13,1,12974,998,13972
432260,201905,876,696,180,694608.4,180638,875246.4
432270,201905,241,177,64,176646,64870,241516
432280,201905,138,104,34,103792.6,34930,138722.6
432285,201905,1,1,0,998,0,998
432290,201905,67,59,8,58882,7984,66866
432300,201905,4579,2601,1978,2598729.63,1978049.54,4576779.17
432310,201905,119,98,21,97804,20958,118762
432320,201905,22,17,5,16966,4990,21956
432330,201905,16,12,4,11976,3992,15968
432335,201905,7,6,1,5988,998,6986
432340,201905,39,35,4,34930,3992,38922
432345,201905,98,71,27,70858,26946,97804
432350,201905,25,24,1,23952,998,24950
432360,201905,7,5,2,4990,1996,6986
432370,201905,26,26,0,25948,0,25948
432375,201905,34,32,2,31936,1996,33932
432377,201905,8,8,0,7984,0,7984
432380,201905,166,75,91,74850,90818,165668
500020,201905,246,141,105,140718,104790,245508
500025,201905,126,63,63,62874,63872,126746
500060,201905,1467,921,546,919158,544909.38,1464067.38
500070,201905,802,388,414,388222.96,414170,802392.96
500080,201905,136,110,26,109780,25948,135728
500085,201905,133,108,25,107784.4,24950,132734.4
500090,201905,330,157,173,156686,172654,329340
500100,201905,731,382,349,381236,348302.8,729538.8
500110,201905,2278,1050,1228,1047905.71,1226554.49,2274460.20
500124,201905,264,154,110,153692,109780,263472
500150,201905,322,137,185,136726.98,184632.94,321359.92
500190,201905,528,367,161,366266.9,160679.3,526946.2
500200,201905,193,166,27,165668.28,26946,192614.28
500210,201905,1465,525,940,523956.86,938159.1,1462115.96
500215,201905,244,145,99,144710,98802,243512
500220,201905,764,498,266,497007.62,265468,762475.62
500230,201905,250,167,83,167664,82834,250498
500240,201905,691,483,208,482034.36,207584,689618.36
500260,201905,594,229,365,228542,364270,592812
500270,201905,29541,12740,16801,12721698.86,16780558.61,29502257.47
500280,201905,195,71,124,70858,123752,194610
500290,201905,1180,706,474,704588,473052.98,1177640.98
500295,201905,438,275,163,274450.4,162674,437124.4
500310,201905,63,21,42,20958,41916,62874
500315,201905,733,445,288,445108,287424,732532
500320,201905,3674,1843,1831,1840313.75,1830337.88,3670651.63
500325,201905,918,507,411,505986,410178.4,916164.4
500330,201905,1447,682,765,681634.4,764468.98,1446103.38
500345,201905,312,240,72,240519.38,71856,312375.38
500348,201905,245,148,97,147704,96806,244510
500350,201905,130,65,65,64870,64870,129740
500370,201905,5473,2471,3002,2469053.5,2997998.9,5467052.4
500375,201905,350,258,92,257484,91816,349300
500380,201905,600,344,256,343312,256486,599798
500390,201905,72,34,38,33932,37924,71856
500400,201905,211,147,64,147704,63872.98,211576.98
500410,201905,555,225,330,224553.89,330343.87,554897.76
500430,201905,532,376,156,375248,156686,531934
500440,201905,203,105,98,104790,97804,202594
500450,201905,408,177,231,177644,231536,409180
500460,201905,296,152,144,151696,143712,295408
500470,201905,438,346,92,345309.39,91816.98,437126.37
500480,201905,109,65,44,64870,43912,108782
500490,201905,110,46,64,45908,63872,109780
500500,201905,1429,519,910,518970.81,909209.51,1428180.32
500510,201905,47,36,11,35928,10978.98,46906.98
500515,201905,105,74,31,73852,30938,104790
500520,201905,342,187,155,186626.8,154691.39,341318.19
500525,201905,87,48,39,47904,38922,86826
500540,201905,907,389,518,388222.98,516965.96,905188.94
500560,201905,908,516,392,514968,391216.4,906184.4
500568,201905,983,577,406,575846.98,405189.39,981036.37
500570,201905,1207,696,511,694628.6,511035.58,1205664.18
500580,201905,341,180,161,179640,161678.91,341318.91
500600,201905,320,172,148,171656,147705.96,319361.96
500620,201905,925,655,270,656684.4,270458,927142.4
500625,201905,78,66,12,65868,11976,77844
500627,201905,27,13,14,12974,13972,26946
500630,201905,1587,852,735,850297.48,733530,1583827.48
500635,201905,528,311,217,310378,218562,528940
500640,201905,412,217,195,216566.8,194610,411176.8
500660,201905,5509,2114,3395,2109772.4,3398191.2,5507963.6
500690,201905,577,206,371,205597.78,370283.48,575881.26
500710,201905,385,195,190,194610,189621.96,384231.96
500720,201905,966,572,394,571854.19,396206,968060.19
500730,201905,194,119,75,118762,75848,194610
500740,201905,865,377,488,376252.34,488050.69,864303.03
500750,201905,150,48,102,47904,101796.98,149700.98
500755,201905,122,88,34,87824.4,33932,121756.4
500769,201905,741,419,322,418164.37,321357.97,739522.34
500770,201905,417,220,197,220558.98,197604,418162.98
500780,201905,166,113,53,112774,52894,165668
500790,201905,1069,543,526,541914,524952.91,1066866.91
500793,201905,271,152,119,151696,119761.38,271457.38
500795,201905,172,125,47,124750,46906.98,171656.98
500797,201905,50,37,13,36926,12974,49900
500800,201905,423,192,231,192614.98,231536,424150.98
500830,201905,2265,1281,984,1278439.98,982032.71,2260472.69
500840,201905,144,107,37,106786,36926.98,143712.98
510010,201905,168,92,76,91816,75848,167664
510020,201905,487,227,260,226564.62,259509.4,486074.02
510025,201905,1704,973,731,972062.15,730551.1,1702613.25
510030,201905,676,357,319,357287.9,319361.96,676649.86
510035,201905,130,59,71,58883.96,70858.98,129742.94
510040,201905,382,172,210,171656,209582.68,381238.68
510050,201905,394,218,176,217570.84,176653.28,394224.12
510060,201905,118,60,58,59880,57884,117764
510080,201905,229,92,137,91816.98,136726.98,228543.96
510100,201905,73,33,40,32934,39920,72854
510120,201905,36,23,13,22954,12974,35928
510125,201905,393,246,147,245508,147705.97,393213.97
510130,201905,574,334,240,333340.82,240529.76,573870.58
510140,201905,407,128,279,127744,278442,406186
510160,201905,100,41,59,40918,58882.99,99800.99
510170,201905,842,515,327,516978.88,326360.68,843339.56
510180,201905,2896,1408,1488,1406227.39,1486059.08,2892286.47
510185,201905,14,6,8,5988,7984,13972
510190,201905,218,75,143,74850,142714,217564
510250,201905,2580,1541,1039,1538257.92,1036926.32,2575184.24
510260,201905,188,139,49,139734.7,48902.98,188637.68
510263,201905,458,259,199,258485.74,198602.98,457088.72
510267,201905,684,384,300,385242.32,299422.52,684664.84
510268,201905,60,29,31,28942,30938,59880
510269,201905,68,31,37,30938.98,36926,67864.98
510270,201905,400,206,194,206589.92,193616.9,400206.82
510279,201905,224,168,56,167666.94,55888.4,223555.34
510285,201905,182,76,106,75848.98,105788,181636.98
510300,201905,508,284,224,283436.92,223558.86,506995.78
510305,201905,214,99,115,98803.97,114770.98,213574.95
510310,201905,107,56,51,55888,50898,106786
510320,201905,858,545,313,543915.88,312387.73,856303.61
510325,201905,409,166,243,165668,242514,408182
510330,201905,423,241,182,240519.97,181636,422155.97
510335,201905,612,351,261,350300.95,260482.9,610783.85
510336,201905,50,37,13,36926,12974,49900
510337,201905,112,47,65,46906,64870,111776
510340,201905,17226,8177,9049,8165864.49,9033210.8,17199075.29
510343,201905,65,46,19,45908,18962,64870
510345,201905,165,111,54,110778,53892.4,164670.4
510350,201905,658,371,287,370262.9,288425.92,658688.82
510360,201905,199,126,73,125748.98,72859.88,198608.86
510370,201905,143,73,70,72854,69862.94,142716.94
510380,201905,88,62,26,61876,25948.98,87824.98
510385,201905,57,27,30,26946,29940.98,56886.98
510390,201905,112,48,64,47904,63872,111776
510395,201905,47,34,13,33932,12974,46906
510410,201905,700,465,235,464071.98,234531.96,698603.94
510420,201905,568,280,288,279458.58,288454.24,567912.82
510450,201905,52,28,24,27944,23952,51896
510452,201905,45,26,19,25948,18962,44910
510454,201905,53,26,27,25948,26946,52894
510455,201905,127,77,50,76846,49900,126746
510460,201905,176,91,85,90819.68,84830.98,175650.66
510480,201905,749,446,303,445116.1,304401.68,749517.78
510490,201905,351,183,168,182639.84,168664.9,351304.74
510500,201905,244,186,58,185628,57884,243512
510510,201905,805,467,338,468064.36,338322,806386.36
510515,201905,1166,621,545,619763.88,544909.96,1164673.84
510517,201905,264,112,152,111776,151696.98,263472.98
510520,201905,232,151,81,150700.94,80842.88,231543.82
510523,201905,95,71,24,70858,23952,94810
510525,201905,784,464,320,463076.91,319364.9,782441.81
510530,201905,18,13,5,12974,4990,17964
510550,201905,257,117,140,116766.98,139720,256486.98
510558,201905,276,136,140,135728.98,139720,275448.98
510560,201905,417,247,170,246506.4,169661.96,416168.36
510562,201905,659,467,192,466066,191616,657682
510590,201905,774,405,369,404190.98,368263.97,772454.95
510600,201905,251,136,115,135728,114771.96,250499.96
510610,201905,171,83,88,82834,87824,170658
510615,201905,197,83,114,82834,113772,196606
510617,201905,20,11,9,10978,8982,19960
510618,201905,119,57,62,56886,61876,118762
510619,201905,102,70,32,69860.98,31936.98,101797.96
510620,201905,177,99,78,98802,77844,176646
510621,201905,196,128,68,127744.98,67865.96,195610.94
510622,201905,476,302,174,301401.88,173653.96,475055.84
510623,201905,347,236,111,235529.96,110778,346307.96
510624,201905,88,45,43,44910.98,42914,87824.98
510625,201905,550,341,209,340332.7,208594.37,548927.07
510626,201905,115,73,42,72854.98,41916,114770.98
510627,201905,65,46,19,45908,18962,64870
510628,201905,152,91,61,90818.98,60878,151696.98
510629,201905,261,171,90,170658,89820,260478
510630,201905,452,235,217,234531.96,216569.34,451101.30
510631,201905,11,3,8,2994,7984.47,10978.47
510637,201905,354,212,142,211579.93,141726.78,353306.71
510642,201905,981,547,434,546906.94,434131.96,981038.90
510645,201905,0,,,,,0.0
510650,201905,1446,967,479,967076.14,479044.87,1446121.01
510665,201905,82,43,39,42917.88,38922,81839.88
510670,201905,64,37,27,36926,26946,63872
510675,201905,1157,724,433,722555.34,434131.96,1156687.30
510677,201905,348,177,171,176651.88,170664.86,347316.74
510680,201905,99,60,39,59881.96,38922.98,98804.94
510682,201905,215,105,110,104790.62,109780,214570.62
510685,201905,50,38,12,37924,11976,49900
510700,201905,618,359,259,358292.78,258492.79,616785.57
510704,201905,1120,603,517,601915.49,516073.78,1117989.27
510706,201905,129,67,62,66866,61877.96,128743.96
510710,201905,404,280,124,279445.84,123753.92,403199.76
510715,201905,62,47,15,46906,14970,61876
510718,201905,206,114,92,113774.94,91816,205590.94
510719,201905,37,18,19,17964,18962,36926
510720,201905,192,134,58,133732.98,57884,191616.98
510724,201905,89,36,53,35928,52894,88822
510726,201905,51,26,25,25948,24950.98,50898.98
510729,201905,72,34,38,33932,37924,71856
510730,201905,469,267,202,266467.96,201597.97,468065.93
510735,201905,110,45,65,44910,64870,109780
510740,201905,24,13,11,12974,10978,23952
510757,201905,17,13,4,12974,3992,16966
510760,201905,7127,3808,3319,3802446.13,3313575.33,7116021.46
510770,201905,688,327,361,326350.88,360288.74,686639.62
510774,201905,15,5,10,4990,9980,14970
510775,201905,112,85,27,84830,26946,111776
510776,201905,29,10,19,9980,18962,28942
510777,201905,181,81,100,80838,100798,181636
510779,201905,49,24,25,23953.96,24951.96,48905.92
510780,201905,290,162,128,161682.88,127748.86,289431.74
510785,201905,418,227,191,226546,190618,417164
510787,201905,197,99,98,98802.98,97805.97,196608.95
510788,201905,0,,,,,0.0
510790,201905,2435,1300,1135,1297448.92,1134815.18,2432264.10
510792,201905,1142,667,475,665673.84,474063.73,1139737.57
510794,201905,116,56,60,55888,59880.98,115768.98
510795,201905,2369,1408,961,1407186.74,962078.68,2369265.42
510800,201905,188,115,73,114770,72854.98,187624.98
510805,201905,172,120,52,119760,51896.98,171656.98
510810,201905,96,42,54,41921.88,53892,95813.88
510820,201905,248,121,127,120762.12,126748.51,247510.63
510830,201905,68,41,27,40918,26946.98,67864.98
510835,201905,12,9,3,8982,2994,11976
510840,201905,9146,4511,4635,4506182.46,4628952.26,9135134.72
510850,201905,208,83,125,82834,124750.98,207584.98
510860,201905,392,176,216,175654.86,215579.16,391234.02
510880,201905,65,48,17,47904.98,16966,64870.98
510885,201905,73,44,29,44910.98,28942,73852.98
510890,201905,71,43,28,42914,27944,70858
510895,201905,189,111,78,110778,77846.37,188624.37
520005,201905,46,31,15,30938,14970,45908
520010,201905,276,129,147,128742,146706.8,275448.8
520013,201905,686,431,255,430138.98,254490,684628.98
520015,201905,55,41,14,40918,14970,55888
520017,201905,92,53,39,52894.4,38922,91816.4
520020,201905,23,13,10,12974,9980,22954
520025,201905,2064,1137,927,1138718.8,925146,2063864.8
520030,201905,814,432,382,431136.98,381236,812372.98
520050,201905,73,50,23,49900,22954,72854
520055,201905,48,31,17,30938,16966,47904
520060,201905,185,122,63,121756,62874,184630
520080,201905,577,417,160,416166,159680,575846
520082,201905,19,14,5,13972,4990,18962
520085,201905,98,73,25,72854,24950,97804
520090,201905,92,61,31,60878,30938,91816
520110,201905,9179,4037,5142,4030929.5,5135714.7,9166644.2
520120,201905,14,8,6,7984,5988,13972
520130,201905,788,549,239,547902.98,238522.4,786425.38
520140,201905,12011,6793,5218,6783419.2,5215566.6,11998985.8
520145,201905,47,31,16,30938,15968,46906
520150,201905,184,143,41,142714,40918,183632
520160,201905,35,26,9,25948,8982,34930
520170,201905,242,145,97,144712.93,96808.92,241521.85
520180,201905,144,73,71,72854,70858,143712
520215,201905,211,137,74,136726,74850,211576
520235,201905,73,54,19,53892,18962,72854
520250,201905,129,78,51,77844,50898,128742
520260,201905,111,70,41,69860,40918,110778
520280,201905,48,33,15,32934,14970,47904
520310,201905,40,27,13,26946,12974,39920
520320,201905,168,109,59,108782,58882,167664
520330,201905,794,422,372,421158.94,371256.98,792415.92
520340,201905,342,200,142,199600,141716.98,341316.98
520350,201905,524,244,280,243512,280438,523950
520355,201905,92,56,36,55888,35928,91816
520357,201905,27,21,6,20958,5988,26946
520360,201905,1,1,0,998,0,998
520380,201905,143,74,69,73852,68862,142714
520390,201905,265,116,149,115768,150698,266466
520393,201905,13,9,4,8982,3992,12974
520396,201905,93,60,33,59880,32934.98,92814.98
520400,201905,214,123,91,122754.4,90818,213572.4
520410,201905,192,98,94,97804.98,93812.98,191617.96
520420,201905,21,15,6,14970,5988,20958
520425,201905,305,144,161,143712,160679.4,304391.4
520430,201905,464,244,220,243512,219561.88,463073.88
520440,201905,625,428,197,427144,197604,624748
520450,201905,1933,878,1055,876244.98,1054890.9,1931135.88
520455,201905,55,40,15,39920,14970,54890
520460,201905,35,19,16,18962,15968,34930
520465,201905,28,24,4,23952,3992,27944
520470,201905,421,265,156,264470,155688,420158
520480,201905,80,48,32,47904.98,31940.9,79845.88
520485,201905,119,43,76,43912,75848.4,119760.4
520490,201905,423,312,111,311376,110778,422154
520495,201905,167,98,69,97804,68862,166666
520500,201905,176,134,42,133732,41916,175648
520505,201905,178,97,81,96806,80838,177644
520510,201905,1780,884,896,882267.68,896284.32,1778552.00
520520,201905,39,30,9,29940,8982,38922
520530,201905,233,178,55,177644,54890,232534
520540,201905,559,390,169,390251.26,168662,558913.26
520545,201905,140,85,55,84830,54890,139720
520547,201905,46,26,20,25948,19960,45908
520549,201905,1163,574,589,572852.32,587825.73,1160678.05
520551,201905,288,153,135,152694,135728.4,288422.4
520552,201905,49,30,19,29940,18962,48902
520570,201905,16,10,6,9980,5988,15968
520580,201905,295,181,114,180638,113772,294410
520590,201905,161,98,63,97804.98,62874,160678.98
520620,201905,1159,541,618,539919.38,616764,1156683.38
520630,201905,41,25,16,24950,15968,40918
520640,201905,400,239,161,238522,160678,399200
520650,201905,63,41,22,40918,21956,62874
520660,201905,38,21,17,20958.98,16966,37924.98
520670,201905,36,31,5,30938,4990,35928
520680,201905,54,36,18,35928,17964,53892
520690,201905,35,12,23,11976,22954.98,34930.98
520710,201905,37,33,4,32934,3992,36926
520725,201905,185,122,63,121756,63872,185628
520735,201905,59,41,18,40918,17964,58882
520740,201905,406,201,205,200598.3,204590.98,405189.28
520750,201905,35,27,8,26946,7984,34930
520753,201905,58,39,19,38922,18962,57884
520760,201905,110,77,33,76846,32934,109780
520780,201905,293,217,76,216566,75848.96,292414.96
520790,201905,152,81,71,80838,70858,151696
520800,201905,3414,1838,1576,1835323.99,1573846.88,3409170.87
520810,201905,169,125,44,124750,43912,168662
520815,201905,5,4,1,3992,998,4990
520830,201905,148,104,44,103792,43912,147704
520840,201905,356,240,116,239520,115768,355288
520850,201905,104,67,37,66866.98,36926,103792.98
520860,201905,1726,1115,611,1113768.4,609778.4,1723546.8
520870,201905,31799,15549,16250,15523909.79,16238489.47,31762399.26
520880,201905,1128,609,519,607782.4,518960,1126742.4
520890,201905,797,478,319,477178.04,319360,796538.04
520910,201905,1006,537,469,535926.88,468062,1003988.88
520915,201905,104,79,25,78842,24950,103792
520920,201905,401,194,207,193612,206586,400198
520929,201905,17,16,1,15968,998,16966
520940,201905,73,48,25,47904,24950,72854
520945,201905,19,11,8,10978,7984,18962
520960,201905,49,31,18,30938,17964,48902
520970,201905,336,211,125,210578.98,124750,335328.98
520980,201905,91,67,24,66866,23952,90818
520990,201905,466,317,149,316366,148702,465068
520993,201905,128,62,66,61876,65868,127744
520995,201905,245,139,106,138722.66,105788.4,244511.06
521000,201905,1591,936,655,936124.6,654689.2,1590813.8
521010,201905,672,321,351,320362.12,350299.96,670662.08
521015,201905,17,11,6,10978,5988,16966
521020,201905,1453,1018,435,1015964.98,434133.34,1450098.32
521030,201905,49,34,15,33932,14970,48902
521040,201905,938,591,347,589818.9,348302.4,938121.3
521056,201905,41,31,10,30938,9980,40918
521060,201905,133,87,46,87824,45908,133732
521080,201905,452,339,113,338323.38,112774,451097.38
521090,201905,542,340,202,339320,201596,540916
521100,201905,278,209,69,208583.62,68862,277445.62
521120,201905,1063,751,312,751494.4,311376.98,1062871.38
521130,201905,366,259,107,259480,106789.34,366269.34
521140,201905,177,95,82,94810,81836,176646
521150,201905,2744,1196,1548,1193610.36,1545903.96,2739514.32
521160,201905,32,16,16,15968,15968,31936
521170,201905,196,114,82,113772,81836,195608
521180,201905,1169,747,422,747502.2,421156.9,1168659.1
521190,201905,2543,1078,1465,1076842,1466062.98,2542904.98
521200,201905,52,39,13,38922,12974,51896
521205,201905,11,8,3,7984,2994,10978
521210,201905,137,79,58,78842,57884,136726
521220,201905,813,561,252,559878,251496.9,811374.9
521225,201905,34,22,12,21956,11976,33932
521230,201905,109,73,36,72854,35928,108782
521250,201905,6143,3551,2592,3544902.01,2588815.88,6133717.89
521260,201905,23,14,9,13972,8982,22954
521270,201905,142,112,30,111776,29940,141716
521280,201905,439,267,172,266466,171656,438122
521290,201905,30,13,17,12974,16966,29940
521295,201905,98,65,33,64870,32934,97804
521300,201905,221,116,105,116767.96,104793.34,221561.30
521305,201905,37,26,11,25948,10978,36926
521308,201905,1070,799,271,799406.82,270459.38,1069866.20
521310,201905,1344,793,551,791418.9,550897.34,1342316.24
521340,201905,21,16,5,15968,4990,20958
521350,201905,126,94,32,93812,31936,125748
521370,201905,186,128,58,127744,57884,185628
521375,201905,175,94,81,94810,80838,175648
521377,201905,51,37,14,36926,13972,50898
521380,201905,1068,693,375,691615.92,374250,1065865.92
521385,201905,14,8,6,7984,5988,13972
521390,201905,98,79,19,78842,18962,97804
521400,201905,341,222,119,221556,119760,341316
521405,201905,145,79,66,78842,65868,144710
521410,201905,63,42,21,41916,20958,62874
521440,201905,200,144,56,143712,55888,199600
521450,201905,739,412,327,411176,326346,737522
521460,201905,1180,747,433,745506,433132,1178638
521470,201905,12,8,4,7984,3992,11976
521480,201905,43,30,13,29942.94,12976.86,42919.80
521483,201905,316,176,140,175648.4,139720,315368.4
521486,201905,290,188,102,187624,101796.6,289420.6
521487,201905,23,12,11,11976,10978,22954
521490,201905,26,15,11,14970,10978,25948
521500,201905,120,79,41,78842,40918,119760
521520,201905,42,29,13,28942,12974,41916
521523,201905,673,413,260,412174,260478,672652
521525,201905,47,32,15,31936,14970,46906
521530,201905,251,136,115,135728,114770,250498
521540,201905,29,16,13,15968,12974,28942
521550,201905,88,40,48,39923.34,47908.9,87832.24
521560,201905,794,549,245,548900.4,244510.7,793411.1
521565,201905,55,37,18,36926,17964,54890
521570,201905,508,341,167,340318,167664.9,507982.9
521580,201905,58,36,22,35928,21956,57884
521590,201905,37,20,17,19960,16966,36926
521600,201905,25,15,10,14970,9980,24950
521630,201905,245,131,114,130738,113775.44,244513.44
521640,201905,303,156,147,155688,146706,302394
521645,201905,28,15,13,14970,12974,27944
521680,201905,224,142,82,141716,81836.6,223552.6
521690,201905,2,2,0,1996,0,1996
521710,201905,1167,567,600,566864,598800.98,1165664.98
521720,201905,543,371,172,370258,172655.26,542913.26
521730,201905,640,309,331,308382.8,330338.4,638721.2
521740,201905,903,379,524,380238.98,522956.32,903195.30
521760,201905,1686,939,747,938120.59,747503.36,1685623.95
521770,201905,827,526,301,525946,300398,826344
521800,201905,2024,1277,747,1275456.78,745515.8,2020972.58
521805,201905,32,19,13,18962,12974,31936
521810,201905,88,55,33,54890,32934,87824
521830,201905,948,676,272,674648.13,271456.98,946105.11
521839,201905,85,55,30,54890,29940,84830
521850,201905,1092,585,507,583834.99,506002.48,1089837.47
521860,201905,356,227,129,226546,128742,355288
521870,201905,70,41,29,40918,28942,69860
521878,201905,39,18,21,17964,20958,38922
521880,201905,4714,2131,2583,2126740.16,2580834.15,4707574.31
521890,201905,592,423,169,422154,168662,590816
521900,201905,294,239,55,238522,54890,293412
521910,201905,149,103,46,102794,45908,148702
521920,201905,51,25,26,24950,25948,50898
521925,201905,40,24,16,23952,15968,39920
521930,201905,1141,644,497,642719.52,496016.78,1138736.30
521935,201905,35,26,9,25948,8982,34930
521940,201905,192,98,94,97804,93812,191616
521945,201905,15,13,2,12974,1996,14970
521950,201905,8,4,4,3992,3992,7984
521960,201905,73,55,18,54890,17964,72854
521970,201905,410,266,144,265468,143712,409180
521971,201905,88,44,44,43912,43912,87824
521973,201905,33,17,16,16966,15968,32934
521975,201905,1239,638,601,636725.01,600797.1,1237522.11
521980,201905,248,172,76,171656,75848,247504
521990,201905,76,55,21,54890,20958,75848
522000,201905,287,184,103,183632,102794,286426
522005,201905,19,11,8,10978,7984,18962
522010,201905,1146,653,493,651694.98,492014,1143708.98
522015,201905,58,37,21,36926.98,20958,57884.98
522020,201905,878,491,387,490018.99,386226.8,876245.79
522026,201905,27,18,9,17964,8982,26946
522028,201905,17,13,4,12974,3992,16966
522040,201905,765,306,459,306388.46,459083.92,765472.38
522045,201905,2325,1447,878,1445104.7,876246.46,2321351.16
522050,201905,161,80,81,79840,80838,160678
522060,201905,550,355,195,354290,194610,548900
522068,201905,126,85,41,84830,40918,125748
522070,201905,10,10,0,9980,0,9980
522100,201905,42,23,19,22954,18962,41916
522108,201905,42,32,10,31936,9980,41916
522119,201905,54,29,25,28942,24950,53892
522130,201905,77,32,45,31936.98,45911.92,77848.90
522140,201905,3845,1944,1901,1940114.3,1897200.56,3837314.86
522145,201905,52,35,17,34930,16966,51896
522150,201905,68,51,17,50898,16966,67864
522155,201905,53,35,18,34930.98,17964,52894.98
522157,201905,4,3,1,2994,998,3992
522160,201905,1742,1049,693,1046902,694608.98,1741510.98
522170,201905,404,275,129,274450,128742,403192
522180,201905,37,20,17,19960,16966,36926
522185,201905,1961,778,1183,776446.76,1180634.99,1957081.75
522190,201905,43,25,18,24950,17964,42914
522200,201905,301,184,117,183632,116766,300398
522205,201905,155,107,48,106786,47904,154690
522220,201905,159,114,45,113772,44910,158682
522230,201905,34,29,5,28942,4990,33932
530010,201905,54839,28380,26459,28344750.64,26434080.57,54778831.21
110001,201906,516,412,104,411176,104790,515966
110002,201906,2787,1736,1051,1732529.38,1050895.36,2783424.74
110003,201906,87,74,13,73852.18,12974,86826.18
110004,201906,2019,1320,699,1319358.36,697602.99,2016961.35
110005,201906,438,356,82,355288.4,81836,437124.4
110006,201906,450,348,102,347304.4,101796,449100.4
110007,201906,75,62,13,62874,12974,75848
110008,201906,234,133,101,132734,100798,233532
110009,201906,836,594,242,592812.42,242515.58,835328.00
110010,201906,1780,1104,676,1101793.96,675648.94,1777442.90
110011,201906,1862,1454,408,1451092.1,407184,1858276.1
110012,201906,4157,2435,1722,2444102.4,1722550.36,4166652.76
110013,201906,775,607,168,606784,168662,775446
110014,201906,370,317,53,316366,52894,369260
110015,201906,1423,1153,270,1151693.53,270458,1422151.53
110018,201906,1112,691,421,690616,420160.96,1110776.96
110020,201906,15606,9191,6415,9182638.91,6415199.04,15597837.95
110025,201906,633,473,160,474050.4,162674.98,636725.38
110026,201906,38,26,12,25948,11976,37924
110028,201906,1696,1240,456,1238520.9,455089.2,1693610.1
110029,201906,139,126,13,125748,12974,138722
110030,201906,2451,1668,783,1665504.28,781435.8,2446940.08
110032,201906,291,225,66,225549.35,65868.99,291418.34
110033,201906,666,495,171,494010.8,170658,664668.8
110034,201906,370,275,95,276447.15,94810,371257.15
110037,201906,101,88,13,87824,12974,100798
110040,201906,360,246,114,245508,113772,359280
110045,201906,939,655,284,653691.2,285428.64,939119.84
110050,201906,91,79,12,79840.4,11976,91816.4
110060,201906,80,45,35,44910,34930,79840
110070,201906,113,70,43,69860,42914.4,112774.4
110080,201906,414,247,167,246506,166666,413172
110090,201906,32,26,6,25948,5988,31936
110092,201906,99,53,46,52894,45908,98802
110094,201906,191,138,53,137724,52894,190618
110100,201906,30,25,5,24950,4990,29940
110110,201906,66,40,26,39920,25948,65868
110120,201906,71,60,11,59880,10978,70858
110130,201906,298,246,52,245508.4,51896,297404.4
110140,201906,238,164,74,163672,73852,237524
110143,201906,49,41,8,40918,7984,48902
110145,201906,23,18,5,17964,4990,22954
110146,201906,24,12,12,11976,11976,23952
110147,201906,37,27,10,26946,9980,36926
110148,201906,36,25,11,24950,10978,35928
110149,201906,307,217,90,216566,89820,306386
110150,201906,131,103,28,103792,27944,131736
110155,201906,7,6,1,5988,998,6986
110160,201906,65,54,11,53892,10978,64870
110170,201906,201,162,39,161676,38922,200598
110175,201906,60,45,15,44910,14970,59880
110180,201906,95,82,13,81836,12974,94810
120001,201906,146,99,47,98802,46907.98,145709.98
120005,201906,197,122,75,121756,74850,196606
120010,201906,1063,673,390,672653.67,389220.98,1061874.65
120013,201906,146,99,47,98802,46906,145708
120017,201906,94,58,36,57884,35928,93812
120020,201906,3599,2899,700,2899192.79,699598,3598790.79
120025,201906,558,320,238,320358.98,237524,557882.98
120030,201906,1055,893,162,891215,162674,1053889
120032,201906,47,41,6,40918,5988,46906
120033,201906,215,190,25,190618,24950,215568
120034,201906,164,120,44,119760,43912,163672
120035,201906,37,28,9,27944,8982,36926
120038,201906,392,254,138,253492,137724,391216
120039,201906,27,26,1,25948,998,26946
120040,201906,14079,9726,4353,9715888.56,4347310.69,14063199.25
120042,201906,49,44,5,43912,4990,48902
120043,201906,10,3,7,2994,6986,9980
120045,201906,546,356,190,355288.98,189620.98,544909.96
120050,201906,1268,974,294,973051.68,293412,1266463.68
120060,201906,1466,1200,266,1198598,265468,1464066
120070,201906,472,337,135,336327.2,134730,471057.2
120080,201906,174,107,67,106786,66866,173652
130002,201906,152,110,42,109780,41916,151696
130006,201906,73,43,30,42914,30938,73852
130008,201906,138,74,64,73852,63872,137724
130010,201906,141,79,62,78842,61876,140718
130014,201906,255,183,72,182634,71856,254490
130020,201906,92,51,41,50898,40918,91816
130030,201906,937,555,382,553890,381236,935126
130040,201906,325,159,166,158682,165668.36,324350.36
130050,201906,598,319,279,319360,278442,597802
130060,201906,872,598,274,596804,273452,870256
130063,201906,588,328,260,327344,259480,586824
130068,201906,188,124,64,123752,63872,187624
130070,201906,1316,902,414,900196,415168,1315364
130080,201906,689,451,238,450098,237524.98,687622.98
130083,201906,70,39,31,38922,30938,69860
130090,201906,357,182,175,182634,176646,359280
130100,201906,1137,503,634,502992,632732,1135724
130110,201906,723,303,420,302394,419160,721554
130115,201906,169,72,97,71856,96806,168662
130120,201906,1630,1056,574,1054886,572852,1627738
130130,201906,609,422,187,421156,186626,607782
130140,201906,1549,1197,352,1194606,352294,1546900
130150,201906,429,372,57,371256,56886,428142
130160,201906,461,265,196,264470,195608,460078
130165,201906,38,32,6,31936,5988,37924
130170,201906,967,690,277,688556.12,276446,965002.12
130180,201906,173,113,60,112774,59880,172654
130185,201906,2418,1159,1259,1156682,1256482.8,2413164.8
130190,201906,3544,2236,1308,2233525.28,1305384,3538909.28
130195,201906,279,224,55,223552,54890,278442
130200,201906,174,83,91,82834,90818,173652
130210,201906,78,41,37,40918,36926,77844
130220,201906,179,123,56,122754,55888,178642
130230,201906,323,210,113,210578,112774,323352
130240,201906,1397,891,506,891214.99,505986,1397200.99
130250,201906,4842,3115,1727,3109768.4,1723546,4833314.4
130255,201906,425,209,216,208582,216566,425148
130260,201906,55642,26923,28719,26909002.91,28681760.01,55590762.92
130270,201906,1585,1058,527,1058967.82,525946,1584913.82
130280,201906,123,73,50,72854,49900,122754
130290,201906,2139,1527,612,1523946,610776,2134722
130300,201906,448,314,134,313372,133732,447104
130310,201906,880,462,418,461076,417164,878240
130320,201906,493,271,222,271456,221556,493012
130330,201906,740,454,286,453092,285428,738520
130340,201906,3540,2073,1467,2068854.8,1464066.8,3532921.6
130350,201906,458,297,161,296406,160678,457084
130353,201906,866,372,494,371256,494010,865266
130356,201906,834,386,448,385228,448102,833330
130360,201906,64,38,26,37924,25948,63872
130370,201906,688,525,163,523950,162674,686624
130380,201906,671,492,179,493012,178642,671654
130390,201906,487,387,100,386226,99800,486026
130395,201906,173,40,133,39920,133732,173652
130400,201906,63,43,20,42914,19960,62874
130406,201906,2054,1287,767,1284426.4,765467.28,2049893.68
130410,201906,472,213,259,212574,260478,473052
130420,201906,3159,2570,589,2564860.9,587822,3152682.9
130423,201906,160,79,81,78842,80838,159680
130426,201906,152,87,65,86826,64870,151696
130430,201906,403,260,143,259480,142714,402194
130440,201906,205,69,136,68862,135728,204590
140002,201906,32,10,22,9980,21956,31936
140005,201906,203,126,77,125748,76846,202594
140010,201906,10536,6975,3561,6965053.82,3556876.22,10521930.04
140015,201906,135,63,72,62874,71856,134730
140017,201906,116,80,36,79840,35928,115768
140020,201906,467,315,152,314370,151696,466066
140023,201906,46,25,21,24950.54,20958,45908.54
140028,201906,18,11,7,10978,6986,17964
140030,201906,348,249,99,248502,98802,347304
140040,201906,57,40,17,39920,16966,56886
140045,201906,233,105,128,105788,127744,233532
140047,201906,625,420,205,419160,204590,623750
140050,201906,143,91,52,90818,51896,142714
140060,201906,39,28,11,27944,10978,38922
140070,201906,34,31,3,30938,2994,33932
150010,201906,4647,2927,1720,2924140.4,1718556.4,4642696.8
150013,201906,158,112,46,111776.98,45908,157684.98
150020,201906,1066,586,480,586824,479040,1065864
150030,201906,695,292,403,291416,402194,693610
150034,201906,200,130,70,129740,69860,199600
150040,201906,1404,842,562,841314,560876,1402190
150050,201906,625,371,254,370258,253492,623750
150060,201906,4756,3097,1659,3094715.68,1656680.98,4751396.66
150070,201906,312,142,170,141716,169660,311376
150080,201906,14320,7204,7116,7197586.05,7107768.32,14305354.37
150085,201906,404,259,145,258482,144710,403192
150090,201906,749,637,112,636724,111776,748500
150095,201906,347,222,125,221556,124750,346306
150100,201906,58,39,19,38922,18962,57884
150110,201906,175,90,85,89820,84830,174650
150120,201906,425,313,112,312374,111776,424150
150125,201906,53,22,31,21956,30938,52894
150130,201906,1975,1065,910,1063868,908180,1972048
150140,201906,54006,25354,28652,25328258.21,28639630.28,53967888.49
150145,201906,183,101,82,100798,81836,182634
150150,201906,2891,1330,1561,1330334,1559874.8,2890208.8
150157,201906,406,286,120,285428.8,119760,405188.8
150160,201906,126,98,28,97804,27944,125748
150170,201906,3631,2722,909,2719550,907182,3626732
150172,201906,327,222,105,221556,104790,326346
150175,201906,81,51,30,50898,29940,80838
150178,201906,785,528,257,526944.4,257484,784428.4
150180,201906,3108,1532,1576,1529934.5,1572848.4,3102782.9
150190,201906,333,214,119,213572,118762,332334
150195,201906,117,59,58,58882,57884,116766
150200,201906,196,95,101,94810,100798,195608
150210,201906,3127,2550,577,2544900,575846.99,3120746.99
150215,201906,540,351,189,352294,188622.4,540916.4
150220,201906,3716,2535,1181,2533923.52,1180635.4,3714558.92
150230,201906,1167,951,216,950096.45,215568,1165664.45
150240,201906,5948,3520,2428,3514959.29,2427137.97,5942097.26
150250,201906,31,15,16,14970,15968,30938
150260,201906,83,52,31,51896,30938,82834
150270,201906,2306,1499,807,1498996,805386.8,2304382.8
150275,201906,537,342,195,341316,194610,535926
150276,201906,108,49,59,48902,58882,107784
150277,201906,759,329,430,328342.98,429140,757482.98
150280,201906,331,212,119,211576,118762,330338
150285,201906,86,43,43,42914,42914,85828
150290,201906,954,591,363,589818,362274.4,952092.4
150293,201906,649,312,337,311376,336326,647702
150295,201906,472,219,253,218562,252494.4,471056.4
150300,201906,78,40,38,39920,37924,77844
150304,201906,166,106,60,105788,59880,165668
150307,201906,386,322,64,322354,63872,386226
150309,201906,580,424,156,423152.98,155691.6,578844.58
150310,201906,238,160,78,159680,79840,239520
150320,201906,2016,1408,608,1406182,606784,2012966
150330,201906,2054,1197,857,1194606,858280,2052886
150340,201906,199,134,65,134730,64870,199600
150345,201906,612,344,268,344310,267464,611774
150350,201906,407,324,83,323352,82834,406186
150360,201906,4583,2961,1622,2958073.49,1619754,4577827.49
150370,201906,795,560,235,558880.98,235528.98,794409.96
150375,201906,194,102,92,101796,92814,194610
150380,201906,1439,982,457,981034,457084,1438118
150390,201906,761,434,327,435128.99,326346,761474.99
150400,201906,106,88,18,87824,17964,105788
150405,201906,1237,808,429,807382.92,428142,1235524.92
150410,201906,126,84,42,83832,41916,125748
150420,201906,7457,4126,3331,4121915.56,3330369.92,7452285.48
150430,201906,548,368,180,367264,179640,546904
150440,201906,561,342,219,341316,218562,559878
150442,201906,2249,1222,1027,1220554.58,1025944,2246498.58
150445,201906,530,344,186,343312,185628,528940
150450,201906,244,120,124,119760,123752,243512
150460,201906,740,560,180,558880,179640,738520
150470,201906,1328,814,514,813370,512972,1326342
150475,201906,220,172,48,171656,47904,219560
150480,201906,1272,899,373,897202,372254,1269456
150490,201906,594,325,269,324350,269460,593810
150495,201906,323,232,91,231536,90818,322354
150497,201906,296,197,99,196606,98802,295408
150500,201906,206,136,70,135728,69860,205588
150503,201906,918,458,460,457084.4,459080.98,916165.38
150506,201906,972,650,322,649698,321356,971054
150510,201906,1250,710,540,709578.4,538920,1248498.4
150520,201906,272,184,88,183632,87824,271456
150530,201906,1631,904,727,902192.5,725546,1627738.5
150540,201906,235,166,69,165668,68862,234530
150543,201906,773,429,344,428142,343312,771454
150548,201906,481,337,144,338322,143712,482034
150549,201906,61,44,17,43912,16966,60878
150550,201906,2832,1511,1321,1508976.5,1320354.4,2829330.9
150553,201906,3228,1918,1310,1915162.8,1307380,3222542.8
150555,201906,144,77,67,76846,66866,143712
150560,201906,17,10,7,9980,6986,16966
150563,201906,87,45,42,44910,41916,86826
150565,201906,166,101,65,100798,64870,165668
150570,201906,410,276,134,275448,133732,409180
150580,201906,1574,716,858,714568,857282,1571850
150590,201906,803,517,286,516964,285428,802392
150600,201906,458,279,179,278442,178642,457084
150610,201906,142,123,19,122754,18962,141716
150611,201906,116,78,38,77844,37924,115768
150613,201906,3224,1990,1234,1988016,1232530.98,3220546.98
150616,201906,500,300,200,299400.5,199600,499000.5
150618,201906,1283,703,580,701594.98,578840,1280434.98
150619,201906,399,304,95,304390,94810,399200
150620,201906,1266,753,513,752492,511974,1264466
150630,201906,291,192,99,192614,98802,291416
150635,201906,486,209,277,209580,277444,487024
150640,201906,55,28,27,27944,26946,54890
150650,201906,2355,1392,963,1390464.4,963071.39,2353535.79
150655,201906,243,184,59,183632,58882,242514
150658,201906,97,54,43,53892,42914,96806
150660,201906,500,349,151,348302,150698,499000
150670,201906,1002,368,634,367264.98,632732.98,999997.96
150680,201906,9672,5313,4359,5311358.8,4358267.96,9669626.76
150690,201906,15,10,5,9980,4990,14970
150700,201906,484,322,162,322354,164670,487024
150710,201906,278,160,118,159680,117764,277444
150715,201906,832,509,323,508980.98,323352,832332.98
150720,201906,411,321,90,320358,89820,410178
150730,201906,974,521,453,520956.98,452094,973050.98
150740,201906,222,154,68,153692,67864,221556
150745,201906,801,439,362,439120,361276,800396
150746,201906,51,32,19,31936,18962,50898
150747,201906,244,191,53,190618,53892,244510
150750,201906,132,76,56,75848,55888,131736
150760,201906,1757,1153,604,1150694,602792,1753486
150770,201906,382,209,173,208582,172654,381236
150775,201906,96,44,52,43912,51896,95808
150780,201906,187,104,83,103792,82834,186626
150790,201906,854,473,381,473052,381236,854288
150795,201906,1495,893,602,893210,600796,1494006
150796,201906,371,215,156,214570,156686,371256
150797,201906,294,161,133,160678,132734,293412
150800,201906,1443,869,574,868260,572852.97,1441112.97
150803,201906,584,481,103,481036,102794,583830
150805,201906,190,120,70,119760.4,69860.99,189621.39
150808,201906,1003,548,455,548900,454090,1002990
150810,201906,3364,2344,1020,2344303.41,1018958.4,3363261.81
150812,201906,437,237,200,237524,199600,437124
150815,201906,966,639,327,637722,326346,964068
150820,201906,1553,952,601,950096,599798,1549894
150830,201906,787,572,215,571854,214570,786424
150835,201906,198,119,79,118762,78842,197604
150840,201906,1364,869,495,867262.2,494010,1361272.2
160005,201906,52,31,21,30938,20958,51896
160010,201906,187,119,68,118762,68862.99,187624.99
160015,201906,118,70,48,69860,47904,117764
160020,201906,128,73,55,72854,54890,127744
160021,201906,42,23,19,22954,18962,41916
160023,201906,123,79,44,78842,43912,122754
160025,201906,29,13,16,12974,15968,28942
160027,201906,1482,859,623,857282.5,621754,1479036.5
160030,201906,15673,8184,7489,8174628.89,7479021.81,15653650.70
160040,201906,294,171,123,170658,122754,293412
160050,201906,712,363,349,363272,348302.94,711574.94
160053,201906,320,185,135,184630.4,135728,320358.4
160055,201906,32,24,8,23952,7984,31936
160060,201906,6526,3475,3051,3468051.99,3045897.39,6513949.38
160070,201906,172,106,66,105788,65868,171656
160080,201906,92,49,43,48902,42914,91816
170025,201906,25,14,11,13972,10978,24950
170030,201906,224,183,41,182634.88,40918,223552.88
170035,201906,225,108,117,107784,117764,225548
170040,201906,177,138,39,137724,38922,176646
170070,201906,323,201,122,200598,121756,322354
170100,201906,362,262,100,262474,99800,362274
170105,201906,58,47,11,46906,10978,57884
170110,201906,109,69,40,68862,39920,108782
170130,201906,65,32,33,31936,32934.4,64870.4
170190,201906,96,62,34,61876,33932,95808
170200,201906,383,261,122,260478.98,121756.9,382235.88
170210,201906,6058,3241,2817,3243502.9,2818354.61,6061857.51
170215,201906,107,48,59,47904,58882,106786
170220,201906,1424,1055,369,1053888,368262,1422150
170230,201906,155,104,51,103792,50898,154690
170240,201906,530,355,175,356286.8,175648,531934.8
170255,201906,1102,888,214,886224,213572,1099796
170270,201906,40,29,11,28942,10978,39920
170290,201906,107,80,27,79840,26946,106786
170300,201906,88,60,28,59880,27944,87824
170305,201906,48,37,11,36926,10978,47904
170307,201906,61,46,15,45908,14970,60878
170310,201906,108,61,47,60878,46906,107784
170320,201906,24,18,6,17964,5988,23952
170330,201906,23,22,1,21956,998,22954
170360,201906,27,16,11,15968,10978,26946
170370,201906,125,66,59,65868,58882,124750
170380,201906,83,65,18,64870,18962,83832
170382,201906,44,39,5,38922,4990,43912
170384,201906,142,107,35,106786,34930,141716
170386,201906,60,26,34,25948,33932,59880
170388,201906,48,19,29,18962,28942,47904
170389,201906,26,21,5,20958,4990,25948
170390,201906,60,35,25,34930.98,24950.98,59881.96
170410,201906,32,23,9,22954,8982,31936
170460,201906,16,12,4,11976,3992,15968
170510,201906,34,27,7,26946,6986,33932
170550,201906,1529,901,628,901194,627742,1528936
170555,201906,112,81,31,80838,30938,111776
170560,201906,100,72,28,71856,27944,99800
170600,201906,37,18,19,17964,18962,36926
170610,201906,191,102,89,101796,88824.36,190620.36
170625,201906,35,20,15,19960,14970,34930
170650,201906,77,58,19,57884,18962,76846
170700,201906,576,439,137,438122.5,136726,574848.5
170710,201906,159,98,61,97804,60878.98,158682.98
170720,201906,86,69,17,68862,16966,85828
170730,201906,78,46,32,45908,31936,77844
170740,201906,89,66,23,66866,22954,89820
170755,201906,66,35,31,34930,30938,65868
170765,201906,135,72,63,71856.8,62874,134730.8
170770,201906,218,133,85,132734,84830,217564
170820,201906,595,394,201,394210,200598.8,594808.8
170825,201906,32,18,14,17964,13972,31936
170830,201906,83,66,17,66866,16966,83832
170900,201906,189,148,41,147704,40918,188622
170930,201906,875,467,408,467064.32,407184.4,874248.72
170950,201906,3085,1401,1684,1398199.38,1681632.05,3079831.43
170980,201906,18,10,8,9980,7984,17964
171050,201906,145,115,30,114770,29940,144710
171070,201906,38,32,6,31936,5988,37924
171090,201906,45,33,12,32934,11976,44910
171110,201906,20,12,8,11976,7984,19960
171150,201906,42,21,21,20958,20958,41916
171180,201906,24,13,11,12974,10978,23952
171190,201906,146,85,61,84830,60878,145708
171195,201906,63,52,11,51896,10978,62874
171200,201906,49,25,24,24950,23952,48902
171215,201906,5,3,2,2994,1996,4990
171240,201906,54,43,11,42914,10978,53892
171245,201906,56,50,6,49900,5988,55888
171250,201906,73,41,32,40918,31936,72854
171270,201906,15,11,4,10978,3992,14970
171280,201906,40,36,4,35928.7,3992,39920.7
171320,201906,992,582,410,580836,409180,990016
171330,201906,428,210,218,209580,218562,428142
171360,201906,84,62,22,62874,21956,84830
171370,201906,29,16,13,15968,12974,28942
171380,201906,134,110,24,109780,23952,133732
171395,201906,53,34,19,33932,18962,52894
171420,201906,291,191,100,190618,99800,290418
171430,201906,71,59,12,58882,11976,70858
171488,201906,178,99,79,98802,79840,178642
171500,201906,56,30,26,29940,25948,55888
171510,201906,66,44,22,43912,21956,65868
171515,201906,41,34,7,33932,6986.4,40918.4
171525,201906,29,27,2,26946,1996,28942
171550,201906,13,9,4,8982,3992,12974
171570,201906,57,29,28,28942,27944,56886
171575,201906,322,209,113,208582,112774,321356
171610,201906,1743,891,852,890222.84,851304.78,1741527.62
171620,201906,135,95,40,94810,39920,134730
171630,201906,56,30,26,29940,25948,55888
171650,201906,274,185,89,184630,88822,273452
171660,201906,265,146,119,145708,118762.4,264470.4
171665,201906,54,38,16,37924,15968,53892
171670,201906,428,251,177,250498.5,177644,428142.5
171700,201906,66,59,7,58882,6986,65868
171720,201906,25,10,15,9980,14970,24950
171750,201906,101,55,46,54890,45908,100798
171780,201906,79,63,16,62874,15968,78842
171790,201906,77,67,10,66866,9980,76846
171800,201906,38,30,8,29940,7984,37924
171820,201906,2084,1212,872,1211572.44,871255.78,2082828.22
171830,201906,36,29,7,28942,6986,35928
171840,201906,62,41,21,40918,20958,61876
171845,201906,30,18,12,17964,11976,29940
171850,201906,39,29,10,28942,9980,38922
171855,201906,78,62,16,61876,15968,77844
171865,201906,8,7,1,6986,998,7984
171870,201906,33,24,9,23952,8982,32934
171875,201906,80,56,24,55888,23952,79840
171880,201906,35,23,12,22954,11976,34930
171884,201906,48,25,23,24950,22954,47904
171886,201906,125,51,74,50898,73852,124750
171888,201906,28,22,6,21956,5988,27944
171889,201906,20,14,6,13972,5988,19960
171890,201906,57,47,10,46906,9980,56886
171900,201906,42,29,13,28942,12974,41916
172000,201906,41,34,7,33932,6986,40918
172010,201906,45,37,8,36926,7984,44910
172015,201906,29,20,9,19960.58,8982,28942.58
172020,201906,138,88,50,87824,49900,137724
172025,201906,32,20,12,19960,11976,31936
172030,201906,40,24,16,23952,15968.98,39920.98
172049,201906,78,50,28,49900,27944,77844
172065,201906,145,93,52,92814,51896,144710
172080,201906,99,67,32,66866,31936,98802
172085,201906,26,14,12,13972,11976,25948
172090,201906,413,325,88,324350.18,87824,412174.18
172093,201906,22,19,3,18962,2994,21956
172097,201906,17,10,7,9980,6986.4,16966.4
172100,201906,4921,2821,2100,2819352.84,2096799.98,4916152.82
172110,201906,78,52,26,51896,25948,77844
172120,201906,1679,1439,240,1436123.5,239520.96,1675644.46
172125,201906,3,3,0,2994,0,2994
172130,201906,18,13,5,12974,4990,17964
172208,201906,197,123,74,122754,73852,196606
172210,201906,387,189,198,188622,197604.4,386226.4
210005,201906,2951,1855,1096,1854284.75,1093812.8,2948097.55
210010,201906,177,92,85,91816,84830,176646
210015,201906,38,28,10,27944,9980,37924
210020,201906,343,187,156,186626,155688,342314
210030,201906,332,213,119,213572,118762.98,332334.98
210040,201906,143,112,31,111776,30938,142714
210043,201906,261,189,72,189620,71856,261476
210047,201906,572,316,256,315368,255488,570856
210050,201906,298,221,77,220558,76846,297404
210055,201906,45,34,11,33932,10978,44910
210060,201906,560,451,109,452094,109780,561874
210070,201906,417,316,101,315368,100798,416166
210080,201906,109,99,10,98802,9980,108782
210083,201906,306,145,161,144710,160678,305388
210087,201906,39,29,10,28942,9980,38922
210090,201906,460,324,136,323352,135728,459080
210095,201906,469,348,121,347304,120758,468062
210100,201906,694,541,153,540916,152694,693610
210110,201906,142,85,57,84830,56886,141716
210120,201906,5287,4071,1216,4066859.08,1215565.53,5282424.61
210125,201906,207,124,83,123752,82834,206586
210130,201906,512,284,228,283432,227544,510976
210135,201906,31,18,13,18962,12974,31936
210140,201906,4393,3462,931,3460066.6,930136,4390202.6
210150,201906,376,243,133,242514,132734,375248
210160,201906,3391,2866,525,2865258.55,524948,3390206.55
210170,201906,1194,952,242,952092,242514,1194606
210173,201906,130,110,20,109780,19960,129740
210177,201906,423,220,203,219560,202594,422154
210180,201906,31,17,14,17964,13972,31936
210190,201906,418,279,139,278442,138722,417164
210193,201906,2,1,1,998,998,1996
210197,201906,82,56,26,55888,25948,81836
210200,201906,633,510,123,509978,123752,633730
210203,201906,246,166,80,165668,79840,245508
210207,201906,382,300,82,299400,81836,381236
210210,201906,769,713,56,711574,55888,767462
210215,201906,78,68,10,67864,9980,77844
210220,201906,403,336,67,335328,66866,402194
210230,201906,308,241,67,240518,66866,307384
210232,201906,1452,964,488,962072,487024,1449096
210235,201906,161,126,35,125748.6,34930,160678.6
210237,201906,43,25,18,24950,17964,42914
210240,201906,89,75,14,74850,13972,88822
210250,201906,189,158,31,157684,30938,188622
210255,201906,357,268,89,267464,88822,356286
210260,201906,409,271,138,271456,137724,409180
210270,201906,672,440,232,439120,231536,670656
210275,201906,55,42,13,41916,12974,54890
210280,201906,1064,698,366,696604.48,365268,1061872.48
210290,201906,515,351,164,350298,163672,513970
210300,201906,5750,3525,2225,3518948.39,2221548.97,5740497.36
210310,201906,110,77,33,77844,32934,110778
210312,201906,115,79,36,78842,35928,114770
210315,201906,112,86,26,85828,25948,111776
210317,201906,123,91,32,90818,31936,122754
210320,201906,2364,1977,387,1977038.96,386226,2363264.96
210325,201906,127,90,37,89820,36926.4,126746.4
210330,201906,5083,2772,2311,2772444.7,2309372,5081816.7
210340,201906,1329,971,358,970056,358283.94,1328339.94
210350,201906,620,517,103,515966,102794,618760
210355,201906,146,117,29,116766,28942,145708
210360,201906,2511,1635,876,1631730.06,875246.4,2506976.46
210370,201906,1245,574,671,572852,669658,1242510
210375,201906,188,95,93,95808,92814,188622
210380,201906,707,538,169,537922,168662,706584
210390,201906,200,167,33,166666,32934,199600
210400,201906,411,351,60,350298,59880.96,410178.96
210405,201906,1011,698,313,697602,313372,1010974
210407,201906,55,44,11,43912,10978,54890
210408,201906,60,54,6,53892,5988,59880
210409,201906,335,288,47,287424,46906,334330
210410,201906,435,340,95,339320,94810,434130
210420,201906,205,168,37,167664,36926,204590
210430,201906,41,28,13,27944,12974,40918
210440,201906,356,225,131,224550,130738,355288
210450,201906,156,121,35,121756,34930,156686
210455,201906,230,126,104,125748,103792,229540
210460,201906,324,209,115,208582,114770,323352
210462,201906,65,54,11,53892,10978,64870
210465,201906,159,115,44,115768,43912,159680
210467,201906,531,385,146,385228,146706.98,531934.98
210470,201906,49,42,7,41916,6986,48902
210480,201906,1303,928,375,929138,374250.75,1303388.75
210490,201906,210,136,74,135728,73852,209580
210500,201906,556,315,241,314370,240518,554888
210510,201906,579,456,123,455088,122754,577842
210515,201906,414,241,173,240518,172654,413172
210520,201906,413,363,50,363272,49900,413172
210530,201906,9423,5073,4350,5073837.92,4348289.62,9422127.54
210535,201906,131,98,33,97804,32934,130738
210540,201906,1528,968,560,968060.2,558880,1526940.2
210542,201906,1201,609,592,607782,590816.8,1198598.8
210545,201906,16,15,1,14970,998,15968
210547,201906,130,112,18,111776,17964,129740
210550,201906,715,515,200,514969.4,199600,714569.4
210560,201906,175,149,26,148702,25948,174650
210565,201906,25,20,5,19960,4990,24950
210570,201906,1347,1076,271,1073848.44,270458,1344306.44
210580,201906,114,99,15,98802,14970,113772
210590,201906,769,622,147,620756,146706,767462
210592,201906,32,29,3,28942,2994,31936
210594,201906,107,90,17,89820,16966,106786
210596,201906,95,80,15,79840,14970,94810
210598,201906,124,93,31,92814,30938,123752
210600,201906,337,287,50,286426,49900,336326
210610,201906,254,237,17,236526,16966,253492
210620,201906,45,27,18,26946,17964,44910
210630,201906,68,65,3,64870,2994,67864
210632,201906,1051,715,336,714568,335328,1049896
210635,201906,20,17,3,16966,2994,19960
210637,201906,103,73,30,72854,29940,102794
210640,201906,582,509,73,507982,72854,580836
210650,201906,406,333,73,332334,72854,405188
210660,201906,395,296,99,295408,99800.14,395208.14
210663,201906,25,16,9,15968,8982,24950
210667,201906,113,37,76,36926,75848,112774
210670,201906,265,233,32,232534,31936,264470
210675,201906,565,304,261,303392,260478,563870
210680,201906,215,139,76,139720,75848,215568
210690,201906,637,510,127,508980,126746,635726
210700,201906,174,129,45,129740,45908,175648
210710,201906,277,164,113,163672,112774,276446
210720,201906,137,119,18,118762,17964,136726
210725,201906,69,61,8,60878,7984,68862
210730,201906,25,18,7,17964,6986,24950
210735,201906,399,277,122,276446,121756.4,398202.4
210740,201906,553,470,83,469060,82834,551894
210745,201906,157,116,41,115768,40918,156686
210750,201906,2440,1181,1259,1179636.5,1256482.4,2436118.9
210760,201906,267,202,65,201596,64870,266466
210770,201906,401,315,86,314370,85828,400198
210780,201906,419,308,111,308382,110778,419160
210790,201906,187,148,39,147704,38922,186626
210800,201906,169,129,40,128742,39920,168662
210805,201906,53,49,4,48902,3992,52894
210810,201906,487,388,99,387224,98802,486026
210820,201906,2256,1843,413,1840313.76,412174,2252487.76
210825,201906,167,90,77,89820,76846,166666
210830,201906,765,489,276,488022,275448,763470
210840,201906,207,142,65,141716,64870,206586
210845,201906,254,169,85,168662,84830,253492
210850,201906,801,528,273,526944,272454,799398
210860,201906,3994,2153,1841,2148694.9,1838316,3987010.9
210870,201906,477,366,111,365268,110778,476046
210880,201906,72,55,17,54890,16966,71856
210890,201906,329,278,51,281436,50898,332334
210900,201906,604,391,213,390218,213572,603790
210905,201906,64,32,32,31936,31936,63872
210910,201906,2004,1504,500,1503987.48,499000,2002987.48
210920,201906,195,64,131,63872,130738,194610
210923,201906,82,57,25,56886,24950,81836
210927,201906,424,189,235,188622,234530,423152
210930,201906,73,58,15,57884,14970,72854
210940,201906,87,68,19,67864,18962,86826
210945,201906,206,103,103,102794,102794,205588
210950,201906,527,392,135,391216,134730,525946
210955,201906,74,49,25,48902,24950,73852
210960,201906,2322,1070,1252,1067860,1250494,2318354
210970,201906,112,99,13,98802,12974,111776
210975,201906,85,77,8,76846,7984,84830
210980,201906,1154,534,620,532932,618760.4,1151692.4
210990,201906,4229,2699,1530,2694601,1527938,4222539
211000,201906,1352,1080,272,1079836.4,271456,1351292.4
211003,201906,890,619,271,618760,270458,889218
211010,201906,501,444,57,443112,56886,499998
211020,201906,1565,607,958,605786,956084,1561870
211023,201906,32,27,5,26946,4990,31936
211027,201906,71,51,20,50898,19960,70858
211030,201906,390,272,118,271456,117764,389220
211040,201906,311,252,59,251496.4,58882,310378.4
211050,201906,1177,770,407,769458,406186.4,1175644.4
211060,201906,670,573,97,571854.96,96806,668660.96
211065,201906,21,17,4,16966,3992,20958
211070,201906,913,753,160,754488.66,159680,914168.66
211080,201906,85,81,4,80838,3992,84830
211085,201906,59,30,29,29940.4,28942,58882.4
211090,201906,91,73,18,74850,17964,92814
211100,201906,497,402,95,401196,94810.4,496006.4
211102,201906,252,171,81,170658,80838,251496
211105,201906,223,156,67,155688,66866,222554
211107,201906,134,78,56,77844,55888,133732
211110,201906,834,545,289,544908,288422.98,833330.98
211120,201906,5704,2697,3007,2692606.2,3004979.72,5697585.92
211125,201906,30,23,7,22954,6986,29940
211130,201906,44422,19539,24883,19534863.84,24859190.15,44394053.99
211140,201906,423,363,60,362274.99,59880,422154.99
211150,201906,1297,833,464,831334,464071.39,1295405.39
211153,201906,167,100,67,99800,66866,166666
211157,201906,67,53,14,52894,13972,66866
211160,201906,716,607,109,605786,108782,714568
211163,201906,0,,,,,0.0
211167,201906,11,10,1,9980,998,10978
211170,201906,437,316,121,315368,120758,436126
211172,201906,120,83,37,82834,36926,119760
211174,201906,258,157,101,156686,100798,257484
211176,201906,509,376,133,375248,132734,507982
211178,201906,89,59,30,58882,29940,88822
211180,201906,208,168,40,167664,39920,207584
211190,201906,70,65,5,65868,4990,70858
211195,201906,34,24,10,23952,9980,33932
211200,201906,149,128,21,127744,20958,148702
211210,201906,492,324,168,323352,167664,491016
211220,201906,4088,2353,1735,2352288.53,1733527.99,4085816.52
211223,201906,96,92,4,91816,3992,95808
211227,201906,72,54,18,53892,17964,71856
211230,201906,762,622,140,620756,139720,760476
211240,201906,408,312,96,312374,95808,408182
211245,201906,192,92,100,91816,99800,191616
211250,201906,1613,1388,225,1387221.59,224550.94,1611772.53
211260,201906,835,670,165,669658,164670,834328
211270,201906,2040,1643,397,1640712.4,397204.8,2037917.2
211280,201906,1853,1153,700,1152690,698600,1851290
211285,201906,202,122,80,121756,79840,201596
211290,201906,683,471,212,470058,212574,682632
211300,201906,798,629,169,627742.96,169660,797402.96
211400,201906,1584,944,640,943110,638720,1581830
220005,201906,17,16,1,15968,998,16966
220010,201906,89,67,22,66866,21956,88822
220020,201906,665,535,130,533930,129740,663670
220025,201906,110,107,3,106786,2994,109780
220027,201906,39,32,7,31936,6986,38922
220030,201906,104,86,18,85828,17964,103792
220040,201906,1208,920,288,919158.6,289420,1208578.6
220045,201906,38,27,11,26946,10978,37924
220050,201906,681,573,108,573851.08,107784,681635.08
220060,201906,171,150,21,151696,20958,172654
220070,201906,105,97,8,96806,7984,104790
220080,201906,16,14,2,13972,1996,15968
220090,201906,33,27,6,27944,5988,33932
220095,201906,2,1,1,998,998,1996
220100,201906,22,18,4,17964,3992,21956
220105,201906,25,24,1,23952.4,998,24950.4
220110,201906,221,204,17,203592,16966,220558
220115,201906,45,43,2,42914,1996,44910
220117,201906,23,21,2,20958,1996,22954
220120,201906,1493,1108,385,1108778,384230,1493008
220130,201906,30,30,0,29940,0,29940
220140,201906,101,81,20,80838,19960,100798
220150,201906,484,353,131,353292,130738,484030
220155,201906,5,5,0,4990,0,4990
220157,201906,17,14,3,13972,2994,16966
220160,201906,80,70,10,69860,9980,79840
220170,201906,33,32,1,31936,998,32934
220173,201906,7,7,0,6986,0,6986
220177,201906,6,6,0,5988,0,5988
220180,201906,67,67,0,66866,0,66866
220190,201906,1070,959,111,957082,110778,1067860
220191,201906,44,39,5,38922,4990,43912
220192,201906,71,68,3,67864,2994,70858
220194,201906,46,44,2,43912,1996,45908
220196,201906,96,80,16,79840,15968,95808
220198,201906,4,3,1,2994,998,3992
220200,201906,421,352,69,351296.5,68862,420158.5
220202,201906,37,33,4,32934,3992,36926
220205,201906,42,38,4,37924,3992,41916
220207,201906,13,12,1,11976,998,12974
220208,201906,78,42,36,41916,35928,77844
220209,201906,30,27,3,26946,2994,29940
220210,201906,16,14,2,13972,1996,15968
220211,201906,26,25,1,24950,998,25948
220213,201906,41,37,4,36926,3992.4,40918.4
220217,201906,40,32,8,31936,7984,39920
220220,201906,2115,1377,738,1375244,737523.1,2112767.1
220225,201906,11,5,6,4990,5988,10978
220230,201906,971,771,200,769458,199600,969058
220240,201906,161,148,13,147704,12974,160678
220245,201906,32,29,3,28942.99,2994,31936.99
220250,201906,116,104,12,103792,11976,115768
220253,201906,40,35,5,34930,4990,39920
220255,201906,29,26,3,25948,2994,28942
220260,201906,703,518,185,516964,184630,701594
220265,201906,9,7,2,6986,1996,8982
220270,201906,736,660,76,659678,75848,735526
220271,201906,41,34,7,33932,6986,40918
220272,201906,24,24,0,23952,0,23952
220273,201906,13,12,1,11976,998,12974
220275,201906,55,45,10,44910,9980,54890
220277,201906,13,11,2,10978,1996,12974
220280,201906,14,11,3,10978,2994,13972
220285,201906,46,43,3,42914,2994,45908
220290,201906,1458,1253,205,1253488.4,204590.9,1458079.3
220300,201906,49,47,2,46906,1996,48902
220310,201906,315,267,48,267464.99,47904.98,315369.97
220320,201906,440,406,34,405188.4,33932,439120.4
220323,201906,0,,,,,0.0
220325,201906,14,9,5,8982,4990,13972
220327,201906,12,11,1,10978,998,11976
220330,201906,220,156,64,155688,63872,219560
220335,201906,136,118,18,117764,17964,135728
220340,201906,37,23,14,22954,13972,36926
220342,201906,59,52,7,51896,6986,58882
220345,201906,81,75,6,74850,5988,80838
220350,201906,434,381,53,380238,52894,433132
220360,201906,42,30,12,29940,11976,41916
220370,201906,1196,980,216,978040,215568,1193608
220375,201906,21,19,2,18962,1996,20958
220380,201906,19,16,3,15968,2994,18962
220385,201906,17,15,2,14970,1996,16966
220390,201906,2321,1334,987,1331332.84,986024.7,2317357.54
220400,201906,32,29,3,28942,2994,31936
220410,201906,20,18,2,17964,1996,19960
220415,201906,13,12,1,11976,998,12974
220420,201906,127,106,21,105788,20958,126746
220430,201906,132,119,13,118762,12974,131736
220435,201906,21,15,6,14970,5988,20958
220440,201906,294,251,43,252494,42914,295408
220450,201906,336,173,163,172654,162674,335328
220455,201906,54,52,2,51896,1996,53892
220460,201906,20,20,0,19960,0,19960
220465,201906,103,67,36,66866,35928,102794
220470,201906,239,210,29,209580,28942,238522
220480,201906,73,65,8,64870,7984,72854
220490,201906,91,78,13,77844,12974,90818
220500,201906,97,84,13,83832,12974,96806
220510,201906,444,345,99,344310,98802,443112
220515,201906,23,21,2,20958,1996,22954
220520,201906,377,339,38,338322.34,37924,376246.34
220525,201906,16,11,5,10978,4990,15968
220527,201906,32,25,7,24950,6986,31936
220530,201906,34,13,21,12974,20958,33932
220535,201906,5,5,0,4990,0,4990
220540,201906,63,52,11,51896,10978,62874
220545,201906,49,35,14,34930,13972,48902
220550,201906,660,513,147,511974,146706,658680
220551,201906,18,14,4,13972,3992,17964
220552,201906,14,14,0,13972,0,13972
220553,201906,50,46,4,45908,3992,49900
220554,201906,9,7,2,6986,1996,8982
220555,201906,31,27,4,26946,3992,30938
220556,201906,48,44,4,43912,3992,47904
220557,201906,55,51,4,50898,3992,54890
220558,201906,8,3,5,2994,4990,7984
220559,201906,3,3,0,2994,0,2994
220560,201906,69,45,24,44910,23952,68862
220570,201906,785,482,303,481036.4,302394,783430.4
220580,201906,558,514,44,512972,43912,556884
220585,201906,6,5,1,4990,998,5988
220590,201906,13,13,0,12974,0,12974
220595,201906,61,46,15,45908,14970,60878
220600,201906,20,13,7,12974,6986,19960
220605,201906,22,20,2,19960,1996,21956
220610,201906,71,63,8,62874,7984,70858
220620,201906,566,460,106,460078,105788,565866
220630,201906,5,4,1,3992,998,4990
220635,201906,37,33,4,32934,3992,36926
220640,201906,103,83,20,82834,19960,102794
220650,201906,112,105,7,104790,6986,111776
220660,201906,38,30,8,29940,7984,37924
220665,201906,4,4,0,3992,0,3992
220667,201906,23,20,3,19960,2994,22954
220669,201906,28,25,3,24950,2994,27944
220670,201906,64,52,12,51896,11976,63872
220672,201906,64,44,20,44910,19960,64870
220675,201906,37,29,8,28942,7984,36926
220680,201906,41,35,6,34930,5988,40918
220690,201906,44,42,2,41916,1996,43912
220695,201906,47,21,26,20958,25948,46906
220700,201906,1703,1318,385,1317360,384230,1701590
220710,201906,4,3,1,2994,998,3992
220720,201906,108,88,20,87824,19960,107784
220730,201906,18,18,0,17964,0,17964
220735,201906,3,1,2,998,1996,2994
220740,201906,49,45,4,44910,3992,48902
220750,201906,109,92,17,91816,16966,108782
220755,201906,14,14,0,13972,0,13972
220760,201906,61,58,3,57884,2994,60878
220770,201906,5748,3063,2685,3057874.66,2680631.32,5738505.98
220775,201906,19,9,10,8982,9980,18962
220777,201906,17,16,1,15968,998,16966
220779,201906,0,0,0,0,0,0
220780,201906,890,761,129,759478,128742.4,888220.4
220785,201906,3,1,2,998,1996,2994
220790,201906,1063,853,210,851294.82,209580,1060874.82
220793,201906,7,7,0,6986,0,6986
220795,201906,16,15,1,14970,998,15968
220800,201906,4015,3092,923,3086816.88,922152.99,4008969.87
220810,201906,66,58,8,57884.4,7984,65868.4
220820,201906,246,225,21,224550,20958,245508
220830,201906,1230,1063,167,1060874,166666,1227540
220840,201906,2420,1693,727,1690615.33,725546.78,2416162.11
220850,201906,52,44,8,43912,7984,51896
220855,201906,9,6,3,5988,2994,8982
220860,201906,12,11,1,10978,998,11976
220865,201906,29,27,2,26946,1996,28942
220870,201906,68,63,5,62874,4990,67864
220880,201906,328,257,71,256486,70858.4,327344.4
220885,201906,36,33,3,32934,2994,35928
220887,201906,15,15,0,14970,0,14970
220890,201906,100,88,12,88822,11976,100798
220900,201906,20,13,7,12974,6986,19960
220910,201906,57,47,10,46906,9980.4,56886.4
220915,201906,10,9,1,8982,998,9980
220920,201906,49,45,4,44910,3992,48902
220930,201906,41,40,1,39920,998,40918
220935,201906,16,16,0,15968,0,15968
220937,201906,40,39,1,38922,998,39920
220940,201906,56,51,5,50898,4990,55888
220945,201906,0,,,,,0.0
220950,201906,46,41,5,40918,4990,45908
220955,201906,24,21,3,20958,2994,23952
220960,201906,7,7,0,6986,0,6986
220965,201906,34,31,3,30938,2994,33932
220970,201906,58,48,10,47904,9980,57884
220975,201906,11,8,3,7984,2994,10978
220980,201906,32,30,2,29940,1996,31936
220985,201906,65,57,8,57884,7984,65868
220987,201906,32,30,2,29940,1996,31936
220990,201906,19,18,1,17964,998,18962
220995,201906,22,18,4,17964,3992,21956
220997,201906,59,49,10,48902,9980,58882
221000,201906,1155,1044,111,1041912,110778,1152690
221005,201906,59,52,7,51896,6986,58882
221010,201906,17,13,4,12974,3992,16966
221020,201906,43,41,2,40918,1996,42914
221030,201906,32,26,6,25948,5988,31936
221035,201906,24,24,0,23952,0,23952
221037,201906,12,8,4,7984,3992,11976
221038,201906,27,24,3,23952,2994,26946
221039,201906,21,21,0,20958,0,20958
221040,201906,257,221,36,220558,35928,256486
221050,201906,233,201,32,200598,31936,232534
221060,201906,1833,1622,211,1619754,211576,1831330
221062,201906,34,33,1,32934,998,33932
221063,201906,14,10,4,9980,3992,13972
221065,201906,53,46,7,45908,6986,52894
221070,201906,142,123,19,122754,18962,141716
221080,201906,377,330,47,329340,46906,376246
221090,201906,29,28,1,28942,998,29940
221093,201906,53,36,17,35928,16966,52894
221095,201906,9,9,0,8982,0,8982
221097,201906,17,14,3,13972,2994,16966
221100,201906,25295,14900,10395,14893162.8,10386187.8,25279350.6
221110,201906,1069,800,269,798400.4,268462,1066862.4
221120,201906,529,398,131,399200.4,130738,529938.4
221130,201906,964,791,173,793410,173652,967062
221135,201906,34,31,3,30938,2994,33932
221140,201906,46,39,7,38922,6986,45908
221150,201906,12,9,3,8982,2994,11976
221160,201906,13,13,0,12974,0,12974
221170,201906,15,15,0,14970,0,14970
230010,201906,165,151,14,150698,13972,164670
230015,201906,125,103,22,102794,21956,124750
230020,201906,1640,1389,251,1387220.4,252501.76,1639722.16
230030,201906,1681,1213,468,1210575.78,467064,1677639.78
230040,201906,207,180,27,179640.4,26946,206586.4
230050,201906,218,161,57,160678,56886,217564
230060,201906,158,128,30,127744,29940,157684
230070,201906,294,264,30,263472,29940,293412
230075,201906,848,746,102,744508.8,101796,846304.8
230080,201906,193,167,26,166666,25948,192614
230090,201906,111,79,32,78842,31936,110778
230100,201906,2018,1198,820,1195609.96,818362.84,2013972.80
230110,201906,2783,1814,969,1811370.8,968060,2779430.8
230120,201906,962,776,186,774449.54,186626,961075.54
230125,201906,150,125,25,124750,24950,149700
230130,201906,473,425,48,424150,48902,473052
230140,201906,213,183,30,182634,29940,212574
230150,201906,155,120,35,119760,34930,154690
230160,201906,940,807,133,808380,132734,941114
230170,201906,595,543,52,541915,51896,593811
230180,201906,79,74,5,73852,4990,78842
230185,201906,410,355,55,354290,54890,409180
230190,201906,2291,1842,449,1840313.74,448102,2288415.74
230195,201906,485,424,61,423152,60878,484030
230200,201906,384,333,51,332334,50898,383232
230205,201906,380,242,138,241516,137724,379240
230210,201906,1294,1034,260,1032932.22,259480.94,1292413.16
230220,201906,1548,1056,492,1053888,492016.82,1545904.82
230230,201906,902,779,123,778440,122754,901194
230240,201906,1707,1471,236,1469306.86,235529.14,1704836.00
230250,201906,1807,1492,315,1492011.58,315368,1807379.58
230260,201906,3081,1908,1173,1904184,1170654,3074838
230270,201906,1365,1100,265,1098800.17,264470,1363270.17
230280,201906,2749,2063,686,2058875.27,684628,2743503.27
230290,201906,414,369,45,369263.61,44910,414173.61
230300,201906,517,385,132,384230,131736,515966
230310,201906,420,320,100,319360,99800,419160
230320,201906,943,805,138,807383.4,138722,946105.4
230330,201906,307,247,60,246506,59880.6,306386.6
230340,201906,446,360,86,360278.6,85828,446106.6
230350,201906,3086,1969,1117,1966061.9,1116762,3082823.9
230360,201906,269,216,53,216566,52894,269460
230365,201906,141,114,27,113772,26946,140718
230370,201906,9842,4908,4934,4903251.13,4928210.21,9831461.34
230380,201906,481,414,67,413173.36,66866.2,480039.56
230390,201906,517,287,230,286426,229540,515966
230393,201906,259,219,40,219560,39920,259480
230395,201906,356,285,71,285428.48,70858,356286.48
230400,201906,604,481,123,481036,122754,603790
230410,201906,2664,1674,990,1670653.09,989019.94,2659673.03
230420,201906,6311,4194,2117,4187611.84,2114764.56,6302376.40
230423,201906,318,278,40,277444,40918,318362
230425,201906,386,318,68,317364.34,67864,385228.34
230426,201906,123,100,23,99800,22954,122754
230427,201906,80,77,3,76846,2994,79840
230428,201906,1442,733,709,731534.96,708582.82,1440117.78
230430,201906,463,381,82,381236.99,81836,463072.99
230435,201906,846,597,249,595806.31,248502.98,844309.29
230440,201906,85944,38601,47343,38557011.54,47290594.28,85847605.82
230445,201906,292,205,87,204590,86826,291416
230450,201906,538,432,106,431136,105788,536924
230460,201906,58,48,10,47904,9980,57884
230465,201906,309,252,57,251496,56886,308382
230470,201906,1969,1547,422,1544904.94,421156.5,1966061.44
230480,201906,159,150,9,149700,8982,158682
230490,201906,295,236,59,235528,58882,294410
230495,201906,455,338,117,337324,117764,455088
230500,201906,996,738,258,737522,258482,996004
230510,201906,51,40,11,40918,10978,51896
230520,201906,387,303,84,302394.18,83832,386226.18
230523,201906,2220,1419,801,1417161.24,799399.34,2216560.58
230526,201906,284,238,46,237524,46906,284430
230530,201906,677,507,170,505986.94,170658,676644.94
230533,201906,194,185,9,184630,8982,193612
230535,201906,363,272,91,271456,90818,362274
230540,201906,1855,1637,218,1636720,217564,1854284
230550,201906,3762,2422,1340,2419354.79,1338318,3757672.79
230560,201906,582,444,138,444110.8,137724.94,581835.74
230565,201906,213,156,57,155688,56886,212574
230570,201906,301,265,36,264470,35928,300398
230580,201906,1140,847,293,846304.94,293412,1139716.94
230590,201906,981,766,215,765467.46,215568,981035.46
230600,201906,249,228,21,227544,20958,248502
230610,201906,356,285,71,285428.6,70858,356286.6
230620,201906,174,144,30,143712.4,29940,173652.4
230625,201906,733,530,203,529938.6,202594.94,732533.54
230630,201906,1317,1040,277,1039916,276446,1316362
230640,201906,3715,3220,495,3214559,496008.61,3710567.61
230650,201906,435,379,56,379241.91,55888,435129.91
230655,201906,662,574,88,573851.54,87827.89,661679.43
230660,201906,354,300,54,299400,53892,353292
230670,201906,432,380,52,380238,51896,432134
230680,201906,200,181,19,180638,18962,199600
230690,201906,889,770,119,768460,118762,887222
230700,201906,769,652,117,650696.94,117764.94,768461.88
230710,201906,733,697,36,696604.6,35928,732532.6
230720,201906,148,129,19,128742,18962,147704
230725,201906,262,212,50,211576,49900.98,261476.98
230730,201906,12059,6550,5509,6550875,5501979.29,12052854.29
230740,201906,673,542,131,540916.4,130738,671654.4
230750,201906,833,716,117,715566.6,116766,832332.6
230760,201906,1401,1211,190,1209576,191616,1401192
230763,201906,315,264,51,263472,50898,314370
230765,201906,7213,3419,3794,3414201.72,3788452.25,7202653.97
230770,201906,4976,2574,2402,2570853.12,2398195.34,4969048.46
230780,201906,697,614,83,612772,82834,695606
230790,201906,239,198,41,197604,40918,238522
230800,201906,1127,827,300,827342,301396,1128738
230810,201906,1343,1193,150,1191612,149700,1341312
230820,201906,354,249,105,248502.4,104790,353292.4
230830,201906,965,828,137,826344,136726,963070
230835,201906,283,247,36,246506,35928,282434
230837,201906,167,142,25,141716,24950,166666
230840,201906,919,736,183,734528.4,183632.4,918160.8
230850,201906,1495,1300,195,1297400,194610.88,1492010.88
230860,201906,301,224,77,223552,76846,300398
230870,201906,1830,1569,261,1569854.94,261476,1831330.94
230880,201906,60,45,15,44910,14970,59880
230890,201906,554,510,44,508980,43912.97,552892.97
230900,201906,280,208,72,208582,72854.58,281436.58
230910,201906,213,171,42,170658,41916,212574
230920,201906,417,329,88,328342,87824,416166
230930,201906,950,678,272,677642.68,271456,949098.68
230940,201906,831,661,170,662672.98,169660.6,832333.58
230945,201906,497,416,81,415169,80838,496007
230950,201906,408,349,59,348302,58882,407184
230960,201906,2619,1789,830,1786423.8,828343.22,2614767.02
230970,201906,1759,992,767,990026.34,765477.34,1755503.68
230980,201906,209,176,33,175648,32934,208582
230990,201906,135,111,24,110778,23952,134730
231000,201906,208,189,19,188622,18962,207584
231010,201906,145,111,34,110778,33932,144710
231020,201906,1331,931,400,930151.28,399203.82,1329355.10
231025,201906,1035,782,253,782432.6,252494.4,1034927.0
231030,201906,1128,947,181,945107.35,181636,1126743.35
231040,201906,138,95,43,94810,43912,138722
231050,201906,983,877,106,876244,105788,982032
231060,201906,146,125,21,125748,20958,146706
231070,201906,1445,1027,418,1024948.24,417164.94,1442113.18
231080,201906,261,243,18,242514,17964,260478
231085,201906,579,358,221,357284.6,220558,577842.6
231090,201906,246,202,44,201596,43912,245508
231095,201906,165,132,33,131736,32934,164670
231100,201906,138,117,21,116766,20958,137724
231110,201906,363,312,51,311376,50898,362274
231120,201906,290,248,42,247504,42914,290418
231123,201906,147,141,6,140718,5988,146706
231126,201906,326,259,67,258482,66866,325348
231130,201906,4622,3610,1012,3603779.93,1010975.91,4614755.84
231135,201906,213,186,27,185628,26946,212574
231140,201906,3096,2293,803,2288414,802392,3090806
231150,201906,365,349,16,349300,15968,365268
231160,201906,1192,950,242,948100.94,241516.94,1189617.88
231170,201906,536,373,163,372254,162674,534928
231180,201906,1690,1445,245,1443108,244510,1687618
231190,201906,205,175,30,174650,29940,204590
231195,201906,222,190,32,189620,31936,221556
231200,201906,821,669,152,668660,151696.6,820356.6
231210,201906,597,503,94,503990,93812,597802
231220,201906,1038,759,279,757482.9,279440.94,1036923.84
231230,201906,1440,1147,293,1144706,292414,1437120
231240,201906,1412,1027,385,1025944.94,384230.4,1410175.34
231250,201906,115,105,10,104790,9980,114770
231260,201906,280,184,96,183632,95808.4,279440.4
231270,201906,1016,845,171,843311.49,170658,1013969.49
231280,201906,67,51,16,50898,15968,66866
231290,201906,7461,4185,3276,4179624.4,3273441.8,7453066.2
231300,201906,630,583,47,582832,46906,629738
231310,201906,743,687,56,687622.74,55888,743510.74
231320,201906,580,443,137,443114,136726,579840
231325,201906,93,82,11,81836,10978,92814
231330,201906,2030,1578,452,1577091.53,451096,2028187.53
231335,201906,252,224,28,224550,27944,252494
231340,201906,1681,1237,444,1235524,443112,1678636
231350,201906,1261,1036,225,1033928,225548.8,1259476.8
231355,201906,428,371,57,370258,56886,427144
231360,201906,493,376,117,376246.4,116766,493012.4
231370,201906,88,74,14,73852,13972,87824
231375,201906,291,209,82,208582,82834,291416
231380,201906,475,388,87,389220,86826,476046
231390,201906,199,162,37,162674,36926,199600
231395,201906,731,459,272,458082,271456,729538
231400,201906,1117,927,190,925149.04,189622.34,1114771.38
231410,201906,1322,1080,242,1078838.2,241517.74,1320355.94
240010,201906,386,174,212,173652.43,211576.98,385229.41
240020,201906,2282,1812,470,1811371.5,469061.97,2280433.47
240030,201906,127,110,17,109780,16966,126746
240040,201906,32,32,0,31936,0,31936
240050,201906,521,447,74,446106,73852,519958
240060,201906,66,62,4,61876,3992,65868
240070,201906,204,160,44,160678,43912,204590
240080,201906,498,332,166,331336.99,165668.46,497005.45
240090,201906,104,93,11,92814,10978,103792
240100,201906,1478,1397,81,1396204.46,80838,1477042.46
240110,201906,1055,687,368,685627.58,367264.7,1052892.28
240120,201906,139,118,21,117764,20958,138722
240130,201906,289,269,20,269460,19960,289420
240140,201906,84,65,19,64870,18962,83832
240145,201906,717,641,76,639718,75848,715566
240150,201906,19,16,3,15968,2994,18962
240160,201906,41,37,4,36926,3992,40918
240165,201906,38,32,6,31936.5,5988,37924.5
240170,201906,93,69,24,68862,23952,92814
240180,201906,81,68,13,67864,13972,81836
240185,201906,45,40,5,39920,4990,44910
240190,201906,13,11,2,10978,1996,12974
240200,201906,3083,1723,1360,1720554.8,1357281.4,3077836.2
240210,201906,166,129,37,128742,36926,165668
240220,201906,1083,783,300,789418.7,299400,1088818.7
240230,201906,859,792,67,791414.77,66866,858280.77
240240,201906,80,56,24,55888,23952,79840
240250,201906,87,77,10,76846,9980,86826
240260,201906,1796,1342,454,1342310,453092,1795402
240270,201906,188,167,21,166666,20958,187624
240280,201906,43,32,11,31936,10978,42914
240290,201906,51,50,1,49900,998,50898
240300,201906,173,99,74,98802,74850,173652
240310,201906,2184,1220,964,1217562.27,962072.74,2179635.01
240320,201906,204,193,11,192614,10978,203592
240325,201906,4335,2656,1679,2652688.27,1675644.07,4328332.34
240330,201906,68,64,4,63872,3992,67864
240340,201906,62,40,22,39920,21956,61876
240350,201906,89,81,8,80838,7984,88822
240360,201906,468,322,146,321356,145708,467064
240370,201906,46,43,3,42914,2994,45908
240375,201906,72,41,31,40918,30938,71856
240380,201906,226,186,40,185628,39920.8,225548.8
240390,201906,14,12,2,11976,1996,13972
240400,201906,83,78,5,77844,4990,82834
240410,201906,11,7,4,6986,3992,10978
240420,201906,943,712,231,710576.2,230538,941114.2
240430,201906,266,250,16,250498,15968,266466
240440,201906,93,51,42,50898,41916,92814
240450,201906,213,143,70,143712.4,69860,213572.4
240460,201906,60,46,14,45908,13972,59880
240470,201906,240,209,31,208582,30938,239520
240480,201906,15,13,2,12974,1996,14970
240485,201906,82,70,12,69860,11976,81836
240490,201906,46,45,1,44910,998,45908
240500,201906,84,67,17,66866,16966,83832
240510,201906,50,36,14,35928,13972,49900
240520,201906,119,114,5,113772,4990,118762
240530,201906,56,50,6,49900,5988,55888
240540,201906,80,69,11,68862,10978,79840
240550,201906,13,12,1,11976,998,12974
240560,201906,374,274,100,273452,99800,373252
240570,201906,457,286,171,285428.94,170658,456086.94
240580,201906,1246,1004,242,1003989.4,241516.99,1245506.39
240590,201906,29,27,2,26946,1996,28942
240600,201906,110,107,3,106786,2994,109780
240610,201906,509,426,83,425148.4,82834,507982.4
240615,201906,20,19,1,18962,998,19960
240620,201906,90,86,4,85828,3992,89820
240630,201906,35,33,2,32934,1996,34930
240640,201906,27,22,5,21956,4990,26946
240650,201906,236,198,38,197604,37924,235528
240660,201906,104,91,13,90818,12974,103792
240670,201906,300,179,121,178642.7,120758,299400.7
240680,201906,51,41,10,40918,9980,50898
240690,201906,46,44,2,43912,1996,45908
240700,201906,189,155,34,154690,33932,188622
240710,201906,1928,1225,703,1222551.3,703590,1926141.3
240720,201906,1081,802,279,802392.58,278442.2,1080834.78
240725,201906,64,60,4,59880,3992,63872
240730,201906,142,124,18,123752,17964,141716
240740,201906,236,202,34,201596,33932.74,235528.74
240750,201906,51,27,24,26946,23952,50898
240760,201906,42,38,4,37924,3992,41916
240770,201906,145,113,32,112774,31936,144710
240780,201906,682,562,120,561874,119760,681634
240790,201906,38,37,1,36926,998,37924
240800,201906,9196,6280,2916,6282420.6,2917157.68,9199578.28
240810,201906,20142,11130,9012,11120737.66,8999996.57,20120734.23
240820,201906,218,139,79,138722.19,78842,217564.19
240830,201906,1635,1347,288,1347300.7,287424,1634724.7
240840,201906,84,74,10,73852,9980,83832
240850,201906,84,75,9,75848,8982,84830
240860,201906,110,107,3,106786,2994,109780
240870,201906,59,51,8,50898,7984,58882
240880,201906,30,27,3,26946,2994,29940
240890,201906,1171,682,489,680637.76,488022.99,1168660.75
240895,201906,61,36,25,35928,24950,60878
240910,201906,158,143,15,144710,14970,159680
240920,201906,16,13,3,12974,2994,15968
240930,201906,405,364,41,363272,40918,404190
240933,201906,35,27,8,26946,7984,34930
240940,201906,2430,2145,285,2143704.58,285428,2429132.58
240950,201906,50,47,3,47904,2994,50898
240960,201906,30,25,5,24950,4990,29940
240970,201906,117,84,33,83832,32934,116766
240980,201906,197,160,37,159680,36926,196606
240990,201906,125,82,43,81836,42914,124750
241000,201906,66,62,4,61876,3992,65868
241010,201906,61,50,11,49900,10978,60878
241020,201906,114,106,8,105788,7984,113772
241025,201906,8,3,5,2994,4990,7984
241030,201906,114,94,20,93812,19960,113772
241040,201906,36,30,6,29940,5988,35928
241050,201906,86,76,10,75848,9980,85828
241060,201906,29,24,5,23952,4990,28942
241070,201906,18,18,0,17964,0,17964
241080,201906,61,55,6,55888,5988,61876
241090,201906,50,41,9,40918,8982,49900
241100,201906,71,61,10,60878,9980,70858
241105,201906,6,1,5,998,4990,5988
241110,201906,47,44,3,43912,2994,46906
241120,201906,1441,1110,331,1108778,331336,1440114
241140,201906,223,185,38,184630.4,37924,222554.4
241142,201906,43,39,4,38922,3992,42914
241150,201906,1185,1044,141,1043908,140718,1184626
241160,201906,21,21,0,20958,0,20958
241170,201906,43,38,5,37924,4990,42914
241180,201906,46,40,6,39920,5988,45908
241190,201906,38,37,1,36926,998,37924
241200,201906,3843,2065,1778,2063867.93,1777439.89,3841307.82
241210,201906,67,58,9,57884,8982,66866
241220,201906,1394,946,448,945106.71,447104.97,1392211.68
241230,201906,241,202,39,201596,38922,240518
241240,201906,55,42,13,41916,12974,54890
241250,201906,1135,1034,101,1033928.4,100798,1134726.4
241255,201906,51,41,10,40918,9980,50898
241260,201906,643,505,138,504988,137724,642712
241270,201906,48,35,13,34930,12974,47904
241280,201906,100,86,14,86826,13972,100798
241290,201906,111,86,25,85828,24950,110778
241300,201906,74,55,19,54890,18962,73852
241310,201906,51,38,13,37924.7,12974,50898.7
241320,201906,29,16,13,15968,12974,28942
241330,201906,60,56,4,55888,3992,59880
241335,201906,66,59,7,58882,6986,65868
241340,201906,186,139,47,138722,46906,185628
241350,201906,59,54,5,53892,4990,58882
241355,201906,45,39,6,38922,5988,44910
241360,201906,52,51,1,50898,998,51896
241370,201906,48,40,8,39920,7984,47904
241380,201906,40,36,4,35928,3992,39920
241390,201906,79,64,15,63872,14970,78842
241400,201906,210,170,40,169660,39920,209580
241410,201906,185,166,19,165668,18962,184630
241415,201906,100,81,19,80838,18962,99800
241420,201906,96,72,24,71856,23952.64,95808.64
241430,201906,28,25,3,24950,2994,27944
241440,201906,520,419,101,419160.97,100798.96,519959.93
241445,201906,36,34,2,33932,1996,35928
241450,201906,284,233,51,232534,50898,283432
241460,201906,144,131,13,130738.5,12974,143712.5
241470,201906,41,34,7,33932,6986,40918
241475,201906,58,55,3,54890,2994,57884
241480,201906,95,70,25,69860,24950,94810
241490,201906,9,8,1,7984,998,8982
241500,201906,47,35,12,34930,11976,46906
250010,201906,103,87,16,87824,15968,103792
250020,201906,33,30,3,29940,2994,32934
250030,201906,827,625,202,623750,201596.6,825346.6
250040,201906,345,286,59,285428,58882,344310
250050,201906,236,195,41,195608.99,40918,236526.99
250053,201906,60,46,14,45908,13972,59880
250057,201906,0,,,,,0.0
250060,201906,478,369,109,368262,108782,477044
250070,201906,712,578,134,576844.75,133732,710576.75
250073,201906,8,8,0,7984,0,7984
250077,201906,189,144,45,143712,44910,188622
250080,201906,416,327,89,327344.72,88822,416166.72
250090,201906,199,131,68,130738,67864,198602
250100,201906,506,420,86,419160,85828.2,504988.2
250110,201906,572,432,140,432134,140718,572852
250115,201906,22,7,15,6986,14970,21956
250120,201906,116,86,30,85828,29940,115768
250130,201906,572,467,105,466066,105788.6,571854.6
250135,201906,14,9,5,8982,4990,13972
250140,201906,83,74,9,73852,8982,82834
250150,201906,576,421,155,420158,154690,574848
250153,201906,8,7,1,6986,998,7984
250157,201906,31,24,7,23952,6986,30938
250160,201906,213,171,42,170658,41916,212574
250170,201906,61,42,19,41916,18962,60878
250180,201906,4085,2809,1276,2808374.95,1278442.15,4086817.10
250190,201906,856,570,286,570856,285428.5,856284.5
250200,201906,51,43,8,42914,7984,50898
250205,201906,23,20,3,19960,2994,22954
250210,201906,85,76,9,75848,8982,84830
250215,201906,62,54,8,53892,7984,61876
250220,201906,25,19,6,18962,5988,24950
250230,201906,79,73,6,72854.99,5988,78842.99
250240,201906,241,199,42,199600,41916,241516
250250,201906,403,349,54,348302,53892,402194
250260,201906,37,32,5,31936,4990,36926
250270,201906,61,47,14,46906,14970,61876
250280,201906,379,313,66,312374,65868,378242
250290,201906,91,84,7,83832,6986,90818
250300,201906,545,374,171,374250,170659.97,544909.97
250310,201906,47,43,4,42914,3992,46906
250320,201906,1961,1349,612,1349299.68,611775.38,1961075.06
250330,201906,96,85,11,84830,10978,95808
250340,201906,24,22,2,21956,1996,23952
250350,201906,144,96,48,95808,47904,143712
250355,201906,34,27,7,26946,6986,33932
250360,201906,198,162,36,161676,35928,197604
250370,201906,2400,1628,772,1625875.06,770456,2396331.06
250375,201906,7,3,4,2994,3992,6986
250380,201906,55,42,13,41916,12974,54890
250390,201906,42,34,8,33932,7984,41916
250400,201906,16266,8306,7960,8300375.54,7959056.24,16259431.78
250403,201906,359,295,64,294410,63872,358282
250407,201906,60,50,10,49900,9980,59880
250410,201906,30,26,4,25948,3992,29940
250415,201906,40,26,14,25948,13972,39920
250420,201906,45,38,7,37924,6986,44910
250430,201906,1491,1274,217,1271701.5,216566,1488267.5
250435,201906,16,12,4,11976,3992,15968
250440,201906,688,586,102,584828.6,101796,686624.6
250450,201906,85,70,15,69860,14970,84830
250460,201906,430,297,133,296406,132734,429140
250470,201906,89,67,22,66866,21956,88822
250480,201906,329,264,65,263472,64870,328342
250485,201906,1,1,0,998,0,998
250490,201906,223,188,35,187624,34930,222554
250500,201906,82,62,20,61876,19960,81836
250510,201906,727,577,150,576844,149700,726544
250520,201906,171,119,52,118762,51896,170658
250523,201906,111,92,19,91816,18962,110778
250527,201906,100,80,20,79840,19960,99800
250530,201906,8,5,3,4990,2994,7984
250535,201906,25,21,4,20958,3992,24950
250540,201906,129,100,29,99800,28942,128742
250550,201906,71,68,3,67864,2994,70858
250560,201906,42,31,11,30938,10978,41916
250570,201906,157,127,30,126746,29940,156686
250580,201906,115,91,24,90882,23952,114834
250590,201906,24,16,8,15968,7984,23952
250600,201906,1278,860,418,859279.04,418162,1277441.04
250610,201906,156,135,21,134730,20958,155688
250620,201906,23,19,4,18962,3992,22954
250625,201906,70,53,17,52894,16966,69860
250630,201906,3005,1951,1054,1948112.28,1052897.92,3001010.20
250640,201906,210,173,37,173652,36926,210578
250650,201906,27,19,8,18962,7984,26946
250660,201906,47,35,12,34930,11976,46906
250670,201906,63,43,20,42914,19960,62874
250680,201906,395,326,69,325348,68862,394210
250690,201906,1874,1299,575,1300398.15,573850.8,1874248.95
250700,201906,921,810,111,808380.5,110778,919158.5
250710,201906,434,338,96,337324,95808,433132
250720,201906,113,88,25,87824,24950,112774
250730,201906,372,318,54,317364,53892,371256
250740,201906,53,49,4,48902,3992,52894
250750,201906,21212,12923,8289,12909039.91,8285406.12,21194446.03
250760,201906,75,58,17,57884,16966,74850
250770,201906,351,234,117,233532.44,116766,350298.44
250780,201906,57,43,14,42914,13972,56886
250790,201906,471,308,163,307384,162674,470058
250800,201906,150,138,12,137724,11976,149700
250810,201906,80,61,19,60878,18962,79840
250820,201906,154,126,28,125748,27944,153692
250830,201906,424,294,130,293412.4,129740,423152.4
250840,201906,51,49,2,48902,1996,50898
250850,201906,56,46,10,45908,9980,55888
250855,201906,13,11,2,10978,1996,12974
250860,201906,201,141,60,140718,59880,200598
250870,201906,33,30,3,29940,2994,32934
250880,201906,84,62,22,61876,21956,83832
250890,201906,2681,2013,668,2009972,666664,2676636
250900,201906,19,17,2,16966,1996,18962
250905,201906,119,92,27,91816,26946,118762
250910,201906,1161,832,329,830336.99,329340,1159676.99
250915,201906,109,77,32,76846,31936,108782
250920,201906,140,106,34,105788,34930,140718
250930,201906,169,106,63,105788,62874,168662
250933,201906,2,1,1,998,998,1996
250937,201906,9,8,1,7984,998,8982
250939,201906,34,25,9,24950,8982,33932
250940,201906,108,83,25,82834,24950,107784
250950,201906,66,46,20,46906,19960,66866
250960,201906,92,51,41,50898,40918,91816
250970,201906,1220,864,356,864268,355288,1219556
250980,201906,89,63,26,62874,25948,88822
250990,201906,171,132,39,131736,38922,170658
251000,201906,77,68,9,67864,8982,76846
251010,201906,103,81,22,80838.99,21956,102794.99
251020,201906,80,70,10,69860,9980,79840
251030,201906,43,34,9,33932,9980,43912
251040,201906,53,39,14,38922,13972,52894
251050,201906,23,21,2,20958,1996,22954
251060,201906,49,38,11,37924,10978,48902
251065,201906,4,4,0,3992,0,3992
251070,201906,23,19,4,18962.98,3992,22954.98
251080,201906,4901,2383,2518,2381749.26,2517958.63,4899707.89
251090,201906,194,164,30,164670,29940,194610
251100,201906,17,17,0,16966,0,16966
251110,201906,45,36,9,35928,8982,44910
251120,201906,1802,1106,696,1104787.2,696604,1801391.2
251130,201906,390,319,71,318362,70858,389220
251140,201906,526,347,179,347305.2,179640,526945.2
251150,201906,311,271,40,270458.98,39920,310378.98
251160,201906,95,80,15,79840.99,14970,94810.99
251170,201906,103,83,20,82834,19960,102794
251180,201906,291,182,109,181636.99,108782.99,290419.98
251190,201906,192,129,63,128742,62874,191616
251200,201906,261,215,46,214570,45908,260478
251203,201906,36,34,2,33932,1996,35928
251207,201906,94,77,17,76846,16966,93812
251210,201906,1470,1073,397,1070854,396206,1467060
251220,201906,48,38,10,37924,9980,47904
251230,201906,610,515,95,514968,94810,609778
251240,201906,100,72,28,71856,27944,99800
251250,201906,1356,966,390,965066.9,390218.7,1355285.6
251260,201906,11,6,5,5988,4990,10978
251270,201906,323,246,77,246506,76846.7,323352.7
251272,201906,65,58,7,57884,6986,64870
251274,201906,27,21,6,20958,5988,26946
251275,201906,30,17,13,16966,12974,29940
251276,201906,11,9,2,8982,1996,10978
251278,201906,10,8,2,7984,1996,9980
251280,201906,99,95,4,94810,3992,98802
251290,201906,732,551,181,549898,180638,730536
251300,201906,16,13,3,12974,2994,15968
251310,201906,364,261,103,260478.99,102794,363272.99
251315,201906,23,22,1,21956,998,22954
251320,201906,61,49,12,48902,11976,60878
251330,201906,81,72,9,71856,8982,80838
251335,201906,14,9,5,8982,4990,13972
251340,201906,715,426,289,425148,288422,713570
251350,201906,36,35,1,34930,998,35928
251360,201906,75,67,8,66866,7984,74850
251365,201906,14,14,0,13972,0,13972
251370,201906,5459,3727,1732,3725537.14,1730532.6,5456069.74
251380,201906,48,38,10,37924,9980,47904
251385,201906,3,3,0,2994,0,2994
251390,201906,729,569,160,567862.7,159680.4,727543.1
251392,201906,12,6,6,5988,5988,11976
251394,201906,9,9,0,8982,0,8982
251396,201906,11,7,4,6986,3992,10978
251398,201906,17,14,3,13972,2994,16966
251400,201906,42,35,7,34930,6986,41916
251410,201906,37,31,6,30938,5988,36926
251420,201906,102,75,27,74850,26946,101796
251430,201906,42,39,3,38922,2994,41916
251440,201906,34,21,13,20958,12974,33932
251445,201906,54,50,4,49900,3992,53892
251450,201906,409,359,50,358282.2,50898,409180.2
251455,201906,2,1,1,998,998,1996
251460,201906,16,14,2,13972,1996,15968
251465,201906,4,2,2,1996,1996,3992
251470,201906,46,37,9,36926,8982,45908
251480,201906,25,22,3,21956,2994,24950
251490,201906,121,85,36,84830,35928.4,120758.4
251500,201906,127,104,23,103792,22954,126746
251510,201906,38,29,9,28942,8982,37924
251520,201906,25,25,0,24950,0,24950
251530,201906,4472,3165,1307,3161664.8,1305384,4467048.8
251540,201906,73,63,10,62874,9980,72854
251550,201906,403,312,91,312374,90818.9,403192.9
251560,201906,21,15,6,14970,5988,20958
251570,201906,20,19,1,18962,998,19960
251580,201906,126,103,23,102794,22954,125748
251590,201906,119,87,32,87015,31936,118951
251593,201906,27,17,10,16966,9980,26946
251597,201906,61,51,10,50898,9980,60878
251600,201906,1079,775,304,773457.71,304391.36,1077849.07
251610,201906,228,178,50,177644,49900,227544
251615,201906,5,5,0,4990,0,4990
251620,201906,4267,2830,1437,2826338.64,1434127.6,4260466.24
251630,201906,444,328,116,327344,115768.98,443112.98
251640,201906,144,105,39,104790,38922,143712
251650,201906,265,193,72,192614.7,71856,264470.7
251660,201906,183,164,19,163672,19960,183632
251670,201906,365,287,78,286426,77844,364270
251675,201906,4,4,0,3992,0,3992
251680,201906,94,85,9,84830,8982,93812
251690,201906,346,284,62,283432,61876,345308
251700,201906,287,247,40,246506,39920,286426
251710,201906,22,15,7,14970,6986,21956
251720,201906,27,18,9,17964,8982.4,26946.4
251740,201906,10,8,2,7984,1996,9980
260005,201906,3155,1796,1359,1792411.91,1360276.88,3152688.79
260010,201906,1567,1142,425,1139716.14,425148.64,1564864.78
260020,201906,413,364,49,364270,48902,413172
260030,201906,580,423,157,422154,156686,578840
260040,201906,821,513,308,511974,308382,820356
260050,201906,1146,832,314,830336,313372.8,1143708.8
260060,201906,395,362,33,361276,32934,394210
260070,201906,1388,872,516,872255.85,514968.69,1387224.54
260080,201906,721,571,150,569858,149700,719558
260090,201906,518,337,181,336327.96,182634,518961.96
260100,201906,231,164,67,163672,66866,230538
260105,201906,218,121,97,120758,96806,217564
260110,201906,2833,2095,738,2090810.98,737522.4,2828333.38
260120,201906,2855,1473,1382,1471053.62,1380234.7,2851288.32
260130,201906,162,115,47,116766,46906,163672
260140,201906,2143,1406,737,1403198.48,736524.98,2139723.46
260150,201906,220,145,75,144710,74850,219560
260160,201906,322,267,55,266466,54890,321356
260170,201906,3357,2073,1284,2071848.48,1282430.4,3354278.88
260180,201906,158,134,24,133732,23952,157684
260190,201906,2259,1598,661,1595802,659678,2255480
260200,201906,949,770,179,769458.63,179640.4,949099.03
260210,201906,1440,1030,410,1028938,409180.98,1438118.98
260220,201906,723,653,70,651926.86,69860,721786.86
260230,201906,1191,899,292,898200.94,291416,1189616.94
260240,201906,220,167,53,167664,52894,220558
260250,201906,88,67,21,66866,20958,87824
260260,201906,1000,719,281,717562,280438,998000
260270,201906,421,340,81,340318,80838,421156
260280,201906,1338,936,402,934128,401197.38,1335325.38
260290,201906,6408,3496,2912,3498994.28,2910174.07,6409168.35
260300,201906,908,796,112,795406.6,111776.4,907183.0
260310,201906,530,419,111,419160.4,110778,529938.4
260320,201906,863,651,212,650696,211576,862272
260330,201906,44,33,11,32934,10978,43912
260340,201906,73,53,20,52894,19960,72854
260345,201906,5571,3121,2450,3118753.47,2448097.9,5566851.37
260350,201906,479,349,130,348302.4,129740,478042.4
260360,201906,271,142,129,141716,128742,270458
260370,201906,683,451,232,451096.5,231537.39,682633.89
260380,201906,602,439,163,438122,162674.66,600796.66
260390,201906,292,250,42,249500,41916,291416
260392,201906,105,89,16,89820,15968,105788
260400,201906,4062,2369,1693,2365262.89,1690613.38,4055876.27
260410,201906,14500,7726,6774,7715541.17,6766441.28,14481982.45
260415,201906,126,114,12,113772,11976,125748
260420,201906,1769,1077,692,1077841.81,690616,1768457.81
260430,201906,190,174,16,174651.25,15968,190619.25
260440,201906,212,155,57,155688.98,56886,212574.98
260450,201906,456,331,125,330339.2,124750,455089.2
260460,201906,818,437,381,437125.2,381236,818361.2
260470,201906,356,221,135,221556,134730.8,356286.8
260480,201906,217,142,75,142714,74850,217564
260490,201906,212,177,35,176646,34930,211576
260500,201906,1124,760,364,758480,363272,1121752
260510,201906,777,627,150,627742,149700,777442
260515,201906,246,222,24,222554,23952,246506
260520,201906,3246,1969,1277,1970052.99,1276442.78,3246495.77
260530,201906,792,650,142,649698,142714,792412
260540,201906,564,434,130,434130,129740,563870
260545,201906,12,10,2,9980,1996,11976
260550,201906,336,212,124,211576,124750,336326
260560,201906,530,396,134,396206.4,133732,529938.4
260570,201906,987,810,177,810376.4,176646,987022.4
260580,201906,256,228,28,227544,27944,255488
260590,201906,623,362,261,361276,261476,622752
260600,201906,8038,4283,3755,4279426.33,3751482,8030908.33
260610,201906,484,329,155,330338,157684,488022
260620,201906,3669,1943,1726,1941113.02,1722550.07,3663663.09
260630,201906,87,83,4,82834,3992,86826
260640,201906,3622,2003,1619,1999992.92,1616760.98,3616753.90
260650,201906,323,237,86,236526,85828,322354
260660,201906,531,362,169,361276,168662,529938
260670,201906,102,76,26,75848,25948,101796
260680,201906,3651,2077,1574,2075842.94,1574845.36,3650688.30
260690,201906,125,94,31,93812,30938,124750
260700,201906,327,209,118,208582,117764,326346
260710,201906,39,36,3,35928,2994,38922
260720,201906,2312,1393,919,1397201.6,920521.93,2317723.53
260730,201906,657,501,156,499998,155688,655686
260740,201906,62,58,4,57884,3992,61876
260750,201906,619,442,177,442114,176646,618760
260760,201906,620,335,285,334330.63,284430,618760.63
260765,201906,971,517,454,515966.99,455088,971054.99
260770,201906,221,165,56,164653,55888,220541
260775,201906,793,472,321,471057.3,320358.98,791416.28
260780,201906,269,174,95,174650,94810,269460
260790,201906,12184,6734,5450,6728527.28,5448087.91,12176615.19
260795,201906,164,113,51,112774,50898,163672
260800,201906,293,246,47,245508,46906,292414
260805,201906,170,112,58,112774,57884,170658
260810,201906,751,654,97,652692,96806,749498
260820,201906,310,203,107,202594.34,106786,309380.34
260825,201906,205,143,62,143712,61876,205588
260830,201906,279,176,103,175648,102794,278442
260840,201906,230,168,62,168662,61876,230538
260845,201906,184,126,58,125748,57884,183632
260850,201906,474,352,122,351296,121756,473052
260860,201906,253,191,62,190618,61876,252494
260870,201906,367,273,94,272454,93812,366266
260875,201906,743,533,210,531934,210578,742512
260880,201906,1569,1004,565,1002990.2,564868,1567858.2
260890,201906,2385,1688,697,1685623,695606.8,2381229.8
260900,201906,991,692,299,691614,298402,990016
260910,201906,265,207,58,206586,57884,264470
260915,201906,305,212,93,211576,92814,304390
260920,201906,179,98,81,97804,80838,178642
260930,201906,398,342,56,341318.91,55888.97,397207.88
260940,201906,2792,1535,1257,1532929.63,1254486.4,2787416.03
260950,201906,2021,1179,842,1176643.66,840316.4,2016960.06
260960,201906,13784,7199,6585,7202578.36,6586809.77,13789388.13
260970,201906,433,371,62,370258,61876,432134
260980,201906,197,175,22,174650,21956,196606
260990,201906,2608,2133,475,2128736.23,474050,2602786.23
261000,201906,4324,2582,1742,2578833.58,1740512.6,4319346.18
261010,201906,182,133,49,132734,48902,181636
261020,201906,607,454,153,453093.66,152694,605787.66
261030,201906,234,175,59,174650,58882,233532
261040,201906,364,322,42,322354,41916,364270
261050,201906,505,443,62,442114,61876,503990
261060,201906,1356,899,457,897202.5,456086,1353288.5
261070,201906,8723,4482,4241,4478054.99,4233565.41,8711620.40
261080,201906,383,296,87,296406,86826,383232
261090,201906,2243,1727,516,1724548.31,514968.47,2239516.78
261100,201906,1108,774,334,772453.3,336326,1108779.3
261110,201906,8445,5203,3242,5201579.69,3237516.01,8439095.70
261120,201906,265,223,42,222554,41916,264470
261130,201906,562,337,225,338322.6,225549.58,563872.18
261140,201906,186,120,66,119760,65868,185628
261150,201906,683,423,260,422154.18,260478,682632.18
261153,201906,68,64,4,63872,3992,67864
261160,201906,76732,38779,37953,38749411.27,37920048.76,76669460.03
261170,201906,462,351,111,350298,110778,461076
261180,201906,1801,1120,681,1117760,679638,1797398
261190,201906,607,430,177,429142.52,176646.98,605789.50
261200,201906,217,189,28,189620,27944,217564
261210,201906,34,29,5,28942,4990,33932
261220,201906,2692,1899,793,1897200.57,795407.37,2692607.94
261230,201906,335,251,84,251496,83832,335328
261240,201906,461,399,62,398202,61876,460078
261245,201906,237,197,40,196606,39920,236526
261247,201906,168,134,34,134730,33932,168662
261250,201906,2935,1503,1432,1500992.4,1432130,2933122.4
261255,201906,256,233,23,232534,22954,255488
261260,201906,868,753,115,752492.76,114770,867262.76
261270,201906,179,137,42,136726,41916,178642
261280,201906,173,145,28,144710,27944,172654
261290,201906,127,90,37,89820,36926,126746
261300,201906,1270,921,349,920156,349300,1269456
261310,201906,786,531,255,530936,254490,785426
261320,201906,557,387,170,386226,169660,555886
261330,201906,993,765,228,764468,227544.63,992012.63
261340,201906,286,165,121,164670,120758,285428
261350,201906,830,591,239,589818.4,238522,828340.4
261360,201906,1280,842,438,840316,437124,1277440
261370,201906,4863,2989,1874,2987019.26,1872250.77,4859270.03
261380,201906,557,417,140,417164.06,140718.4,557882.46
261390,201906,3559,2383,1176,2378234.4,1173648.7,3551883.1
261400,201906,281,256,25,256486,24950,281436
261410,201906,1117,756,361,755486,360278,1115764
261420,201906,877,559,318,557884.47,317364.98,875249.45
261430,201906,328,295,33,294410,32934,327344
261440,201906,126,116,10,115768,9980,125748
261450,201906,2542,2090,452,2086819.31,451097.36,2537916.67
261460,201906,734,591,143,589818.74,143712,733530.74
261470,201906,247,190,57,190618,56886,247504
261480,201906,400,315,85,314370.6,84830.99,399201.59
261485,201906,341,214,127,213572,126746,340318
261500,201906,607,415,192,414170,191616,605786
261510,201906,48,33,15,33932,14970,48902
261520,201906,110,97,13,96806,12974,109780
261530,201906,4072,2583,1489,2589811.19,1491013.84,4080825.03
261540,201906,1200,736,464,734528,463072,1197600
261550,201906,279,137,142,136726.4,141716,278442.4
261560,201906,825,545,280,543910.7,279441.38,823352.08
261570,201906,390,307,83,306386,82834,389220
261580,201906,380,298,82,298402,81836,380238
261590,201906,200,163,37,162674,36926,199600
261600,201906,298,239,59,238522,58882,297404
261610,201906,102,88,14,87824,13972,101796
261618,201906,72,56,16,55888,15968,71856
261620,201906,195,119,76,118762,75848,194610
261630,201906,574,446,128,445108,127744,572852
261640,201906,6362,3417,2945,3416157.91,2941106.5,6357264.41
261650,201906,497,319,178,319360,178642,498002
270010,201906,535,476,59,475048.4,58882,533930.4
270020,201906,297,235,62,234530.99,61876,296406.99
270030,201906,9192,5967,3225,5962079.36,3221580.06,9183659.42
270040,201906,2017,1262,755,1260474,754488,2014962
270050,201906,162,121,41,120758,40918,161676
270060,201906,113,63,50,62874,49900,112774
270070,201906,888,649,239,647702,238522.98,886224.98
270080,201906,37,31,6,30938,5988,36926
270090,201906,20,16,4,15968,3992,19960
270100,201906,1218,818,400,817362.98,401196,1218558.98
270110,201906,136,103,33,103792,32934,136726
270120,201906,220,181,39,180638,38922,219560
270130,201906,240,165,75,164670,74850,239520
270135,201906,103,61,42,60878,41916,102794
270140,201906,1355,835,520,835162.61,518960.98,1354123.59
270150,201906,263,208,55,207584,54890,262474
270160,201906,518,397,121,396206,120758,516964
270170,201906,778,506,272,504988,271456,776444
270180,201906,74,57,17,56886,16966,73852
270190,201906,97,86,11,85828,10978,96806
270200,201906,104,93,11,92814,10978,103792
270210,201906,480,259,221,258482,221556,480038
270220,201906,179,143,36,142714,35928,178642
270230,201906,2110,1298,812,1295505.94,811375.94,2106881.88
270235,201906,718,550,168,550901.78,167668.88,718570.66
270240,201906,3141,2479,662,2474044.53,660678.54,3134723.07
270250,201906,165,119,46,118762,45908,164670
270255,201906,214,183,31,182634,30938,213572
270260,201906,360,291,69,290418,70858,361276
270270,201906,101,43,58,42914.98,57884,100798.98
270280,201906,260,150,110,149700,111776,261476
270290,201906,1184,907,277,906184,276446.98,1182630.98
270300,201906,288,192,96,191616,95808,287424
270310,201906,899,724,175,723554.88,174651.96,898206.84
270320,201906,852,730,122,728541.61,121756,850297.61
270330,201906,281,238,43,237524,42914,280438
270340,201906,59,47,12,46906,11976,58882
270350,201906,96,49,47,48902,46906,95808
270360,201906,61,35,26,34930,25948,60878
270370,201906,56,45,11,44910,10978,55888
270375,201906,74,47,27,46906,26946,73852
270380,201906,998,599,399,598800,398202,997002
270390,201906,190,111,79,110778,78842,189620
270400,201906,715,529,186,529941.41,185628,715569.41
270410,201906,688,500,188,499000,187624,686624
270420,201906,410,278,132,278442,131738.9,410180.9
270430,201906,33208,23907,9301,23895413.46,9299377.54,33194791.00
270440,201906,490,387,103,386226,102794,489020
270450,201906,796,434,362,433132,361276,794408
270460,201906,194,153,41,152694,40918,193612
270470,201906,1444,981,463,984028.79,462074,1446102.79
270480,201906,542,446,96,445108.8,95808,540916.8
270490,201906,24,19,5,18962,4990,23952
270500,201906,504,416,88,415168,87824,502992
270510,201906,770,476,294,477044,295408,772452
270520,201906,332,207,125,206586,124750,331336
270530,201906,67,58,9,57884,8982,66866
270540,201906,117,91,26,90818,25948,116766
270550,201906,1756,1343,413,1341313.98,412174,1753487.98
270560,201906,287,142,145,141716,144710,286426
270570,201906,498,350,148,349300,147704,497004
270580,201906,96,72,24,71856,23952,95808
270590,201906,70,56,14,55888,13972,69860
270600,201906,176,144,32,144710,31936,176646
270610,201906,210,178,32,177644.98,31936,209580.98
270620,201906,30,29,1,28942,998,29940
270630,201906,3870,2959,911,2957078.16,909178,3866256.16
270640,201906,892,657,235,656684,234531.94,891215.94
270642,201906,224,190,34,189620,33932,223552
270644,201906,256,173,83,172654.98,82834,255488.98
270650,201906,314,186,128,185628,127744,313372
270660,201906,254,207,47,206586,46906,253492
270670,201906,3116,2381,735,2379235.9,733530.4,3112766.3
270680,201906,468,273,195,272454.98,194610,467064.98
270690,201906,1149,747,402,745506.35,403192,1148698.35
270700,201906,34,26,8,25948,7984,33932
270710,201906,886,679,207,677642,206586,884228
270720,201906,250,195,55,194610,54890,249500
270730,201906,1924,1142,782,1141313.6,783432.08,1924745.68
270740,201906,43,28,15,27944,14970,42914
270750,201906,663,488,175,488255.46,174650,662905.46
270760,201906,297,216,81,215568,80838,296406
270770,201906,2805,1821,984,1819390.96,983030.96,2802421.92
270780,201906,83,52,31,51896,30939.98,82835.98
270790,201906,249,165,84,164670,83832,248502
270800,201906,1977,1595,382,1593807.28,381236.4,1975043.68
270810,201906,294,237,57,236526,56886,293412
270820,201906,156,103,53,102794,52894.8,155688.8
270830,201906,825,605,220,603791.98,219560.99,823352.97
270840,201906,1420,1072,348,1073848,347304.74,1421152.74
270850,201906,1594,977,617,977043,615766,1592809
270860,201906,2523,1664,859,1663302.84,857284.67,2520587.51
270870,201906,124,67,57,66866,56886,123752
270880,201906,904,688,216,686634.72,215572.86,902207.58
270890,201906,318,231,87,230538,86826,317364
270895,201906,64,55,9,54890,8982,63872
270900,201906,101,78,23,77844,22954,100798
270910,201906,319,253,66,253492,65868,319360
270915,201906,1900,1177,723,1175506.37,721565.2,1897071.57
270920,201906,489,413,76,412174,75848,488022
270930,201906,6168,4551,1617,4548900.22,1615774.89,6164675.11
270940,201906,2361,1813,548,1810372,547902,2358274
280010,201906,40,35,5,34930,4990,39920
280020,201906,455,401,54,401196.96,53892,455088.96
280030,201906,20162,13100,7062,13082828.07,7053879.76,20136707.83
280040,201906,332,218,114,217564,113772,331336
280050,201906,382,295,87,294410,86826,381236
280060,201906,344,233,111,232534.48,110778,343312.48
280067,201906,1011,723,288,723550.49,287424.75,1010975.24
280070,201906,125,103,22,102794,21956,124750
280100,201906,608,476,132,477044.8,131736.6,608781.4
280110,201906,76,71,5,70858,4990,75848
280120,201906,641,515,126,515966,125748,641714
280130,201906,1609,1050,559,1048898.6,557882.09,1606780.69
280140,201906,472,389,83,389220,82834,472054
280150,201906,371,272,99,271456,98802,370258
280160,201906,99,87,12,86826,11976,98802
280170,201906,411,274,137,273452,136726,410178
280190,201906,27,25,2,24950,1996,26946
280200,201906,27,22,5,21956,4990,26946
280210,201906,2839,2047,792,2046903.16,791414.4,2838317.56
280220,201906,43,34,9,33932,8982,42914
280230,201906,328,272,56,271456.7,56886,328342.7
280240,201906,118,112,6,111776,5988,117764
280250,201906,17,11,6,10978,5988,16966
280260,201906,81,71,10,71856,9980,81836
280270,201906,157,122,35,121756,34930,156686
280280,201906,193,125,68,124750,67864,192614
280290,201906,3255,2379,876,2376176.64,876244.64,3252421.28
280300,201906,1593,1224,369,1222550.4,368262,1590812.4
280310,201906,103,99,4,98802.6,4990,103792.6
280320,201906,661,460,201,459080,200598,659678
280330,201906,344,249,95,249500,94810,344310
280340,201906,412,334,78,333332,77844,411176
280350,201906,3571,2782,789,2778436.24,788420.7,3566856.94
280360,201906,438,280,158,281436,159680,441116
280370,201906,99,87,12,86826,11976,98802
280380,201906,56,43,13,42914,12974,55888
280390,201906,176,151,25,150698,24950,175648
280400,201906,342,233,109,232535.36,108782,341317.36
280410,201906,286,232,54,231536.6,53892,285428.6
280420,201906,171,144,27,143712,26946,170658
280430,201906,27,17,10,16966,9980,26946
280440,201906,692,538,154,536925.46,153692,690617.46
280445,201906,117,109,8,108782,7984,116766
280450,201906,1166,1001,165,998998,164670,1163668
280460,201906,609,438,171,437124.7,171656,608780.7
280470,201906,190,176,14,176646,13972.7,190618.7
280480,201906,2453,1741,712,1740514.76,712573.62,2453088.38
280490,201906,285,265,20,265468.15,19960,285428.15
280500,201906,40,37,3,36926,2994,39920
280510,201906,138,111,27,110778,26946.4,137724.4
280520,201906,53,40,13,39920,12974,52894
280530,201906,73,47,26,46906,25948,72854
280540,201906,516,421,95,420158.7,94810,514968.7
280550,201906,732,675,57,673652.4,56886,730538.4
280560,201906,494,433,61,432134,60878,493012
280570,201906,2197,1711,486,1710574.38,488022,2198596.38
280580,201906,611,472,139,471058.19,138722.8,609780.99
280590,201906,172,112,60,111776,59880,171656
280600,201906,380,319,61,318362,60878,379240
280610,201906,130,99,31,98802,30938,129740
280620,201906,550,459,91,459080,90818,549898
280630,201906,153,128,25,127744,25948,153692
280640,201906,197,158,39,157684.96,38922,196606.96
280650,201906,78,57,21,56886,20958,77844
280660,201906,138,101,37,100798,36926,137724
280670,201906,1759,1121,638,1120759.35,636724.86,1757484.21
280680,201906,180,155,25,154690.69,24950,179640.69
280690,201906,92,80,12,79840,11976,91816
280700,201906,20,20,0,20958,0,20958
280710,201906,1458,1120,338,1117760.6,337324,1455084.6
280720,201906,111,74,37,73852,36926,110778
280730,201906,25,21,4,20958,3992,24950
280740,201906,2506,1873,633,1871250.8,632732,2503982.8
280750,201906,225,199,26,198602,25948,224550
280760,201906,725,500,225,499000,224550,723550
290010,201906,206,144,62,143712,61876.94,205588.94
290020,201906,176,162,14,161676,13972,175648
290030,201906,601,393,208,392214,207584,599798
290035,201906,131,106,25,105788,24950,130738
290040,201906,286,190,96,189620,95808,285428
290050,201906,86,67,19,66866,18962,85828
290060,201906,264,119,145,118762,144710,263472
290070,201906,5579,2791,2788,2789411.86,2784424.64,5573836.50
290080,201906,482,226,256,225548.96,255489.92,481038.88
290090,201906,386,173,213,172654,213572,386226
290100,201906,1620,1071,549,1069857.2,547902.8,1617760.0
290110,201906,816,495,321,494011.12,321356.99,815368.11
290115,201906,202,187,15,186626,14970,201596
290120,201906,760,499,261,498002.78,260478,758480.78
290130,201906,427,259,168,258482,167664,426146
290135,201906,294,222,72,222554,71856,294410
290140,201906,313,260,53,260478,52894,313372
290150,201906,132,96,36,96806,35928,132734
290160,201906,249,188,61,187624.62,60878,248502.62
290170,201906,95,69,26,68862,25948,94810
290180,201906,170,131,39,130738.6,38922,169660.6
290190,201906,437,363,74,362274,73852,436126
290195,201906,303,190,113,189620,112774,302394
290200,201906,277,225,52,224550,51896,276446
290205,201906,142,87,55,86826,54890,141716
290210,201906,1149,839,310,837322.4,309380,1146702.4
290220,201906,221,121,100,120758,99800,220558
290225,201906,292,115,177,114770,176646,291416
290230,201906,63,42,21,41916,20958,62874
290240,201906,325,127,198,126746,197604,324350
290250,201906,257,237,20,236526,19960,256486
290260,201906,304,244,60,243512.4,59880,303392.4
290265,201906,191,161,30,160678,29940,190618
290270,201906,1410,1170,240,1170654.5,239521.36,1410175.86
290280,201906,476,340,136,339320,135728,475048
290290,201906,1288,764,524,762472.94,523950.4,1286423.34
290300,201906,451,384,67,384230.4,66866,451096.4
290310,201906,308,137,171,136726,170658,307384
290320,201906,4064,2523,1541,2519950.57,1537919.13,4057869.70
290323,201906,189,166,23,165668,22954,188622
290327,201906,163,129,34,128742,33932,162674
290330,201906,90,50,40,49900,39920,89820
290340,201906,886,362,524,361276,523950,885226
290350,201906,609,369,240,368262,239520,607782
290360,201906,368,278,90,277444.97,89820,367264.97
290370,201906,921,384,537,383232,535926.97,919158.97
290380,201906,317,194,123,193612,122754,316366
290390,201906,2471,1557,914,1553888.9,913170,2467058.9
290395,201906,249,140,109,139720.5,108782,248502.5
290400,201906,283,208,75,207584.4,74850,282434.4
290405,201906,249,218,31,217564,30938,248502
290410,201906,647,541,106,539918.95,105788,645706.95
290420,201906,246,196,50,195608,49900,245508
290430,201906,482,308,174,307384,173652,481036
290440,201906,75,67,8,66866,7984,74850
290450,201906,229,179,50,178642,49900,228542
290460,201906,1923,1160,763,1158687.8,762474.24,1921162.04
290470,201906,1403,596,807,595815.8,805403.64,1401219.44
290475,201906,583,544,39,542912.68,38922.4,581835.08
290480,201906,291,161,130,160678,129740,290418
290485,201906,243,223,20,222554,19960,242514
290490,201906,1195,861,334,860276,333332,1193608
290500,201906,719,367,352,366266,351296,717562
290510,201906,227,174,53,173652,52894,226546
290515,201906,145,89,56,88822,55888,144710
290520,201906,1428,947,481,949098.54,480038.73,1429137.27
290530,201906,311,287,24,286426,23952,310378
290540,201906,95,52,43,51896,42914,94810
290550,201906,148,122,26,122754,25948,148702
290560,201906,3239,1373,1866,1370254,1864267.32,3234521.32
290570,201906,6027,3077,2950,3088816.89,2952091.52,6040908.41
290580,201906,1287,771,516,769458,515966,1285424
290590,201906,567,466,101,465068,100798,565866
290600,201906,1768,1231,537,1229538.02,535926,1765464.02
290610,201906,211,189,22,188622.54,21956,210578.54
290620,201906,349,311,38,312374,37924,350298
290630,201906,2018,877,1141,876244,1138718.4,2014962.4
290640,201906,151,125,26,124750,25948,150698
290650,201906,1718,825,893,828340.69,893210,1721550.69
290660,201906,277,226,51,225548,50898,276446
290670,201906,1044,538,506,537922.8,505986.63,1043909.43
290680,201906,1237,1000,237,998000,236526,1234526
290682,201906,296,222,74,221557.24,73852.98,295410.22
290685,201906,238,154,84,153692,83832,237524
290687,201906,1019,663,356,662834.4,355288,1018122.4
290689,201906,145,81,64,80838.97,63872,144710.97
290690,201906,618,263,355,263472.98,355292.84,618765.82
290700,201906,240,118,122,117764,122754,240518
290710,201906,707,483,224,483032,224550,707582
290720,201906,1041,844,197,844308.5,197604.4,1041912.9
290730,201906,1156,671,485,670656,487024,1157680
290740,201906,15,13,2,12974,1996,14970
290750,201906,1350,627,723,625746,722554.3,1348300.3
290755,201906,72,66,6,65868,5988,71856
290760,201906,300,262,38,261476,37924,299400
290770,201906,189,178,11,177644,10978.4,188622.4
290780,201906,1044,828,216,826347.74,215568,1041915.74
290790,201906,376,264,112,265468,111776,377244
290800,201906,2549,1030,1519,1028938,1517958,2546896
290810,201906,463,321,142,320358,141716,462074
290820,201906,401,240,161,239520.97,160678,400198.97
290830,201906,408,287,121,287424,120758,408182
290840,201906,1738,1080,658,1078839.68,658680.8,1737520.48
290850,201906,789,439,350,438122,349300,787422
290860,201906,624,289,335,288422,334330.4,622752.4
290870,201906,643,461,182,460078.64,181636.84,641715.48
290880,201906,125,69,56,68862,55888,124750
290890,201906,355,252,103,251496,102794,354290
290900,201906,167,127,40,126746,39920,166666
290910,201906,384,296,88,295408,87824,383232
290920,201906,223,188,35,187624,34930,222554
290930,201906,841,638,203,637722.4,203592.96,841315.36
290940,201906,245,204,41,204590,40918,245508
290950,201906,167,99,68,99800,68862,168662
290960,201906,471,324,147,324350,146706,471056
290970,201906,252,224,28,223552,27944,251496
290980,201906,1598,1138,460,1137720.68,459080.8,1596801.48
290990,201906,398,335,63,335328.98,62876.94,398205.92
291000,201906,864,254,610,254490,608780,863270
291005,201906,2246,994,1252,993011,1249496.98,2242507.98
291010,201906,157,143,14,142714,13972,156686
291020,201906,99,77,22,76846,21956,98802
291030,201906,98,72,26,71856,25948,97804
291040,201906,587,316,271,315368,270458,585826
291050,201906,1389,785,604,783430.96,602792,1386222.96
291060,201906,1510,847,663,845306,662672,1507978
291070,201906,1963,1471,492,1470055.98,491017.78,1961073.76
291072,201906,7299,2756,4543,2754482.78,4536911.92,7291394.70
291075,201906,225,186,39,185628,38922,224550
291077,201906,53,36,17,35928,16966,52894
291080,201906,20161,8922,11239,8919134.12,11231499.94,20150634.06
291085,201906,298,244,54,243512,53892,297404
291090,201906,302,118,184,117764.4,183632,301396.4
291100,201906,650,195,455,194610,454090,648700
291110,201906,408,311,97,310378.96,96806,407184.96
291120,201906,2482,1216,1266,1213568.7,1263469.49,2477038.19
291125,201906,63,31,32,30938,31936,62874
291130,201906,208,185,23,184630,22954,207584
291140,201906,143,114,29,113772,28942.4,142714.4
291150,201906,382,157,225,157684,225548,383232
291160,201906,387,320,67,319360.5,66866,386226.5
291165,201906,31,26,5,25948,4990,30938
291170,201906,3067,1550,1517,1549895.5,1516961.2,3066856.7
291180,201906,1291,516,775,514971.74,773452.88,1288424.62
291185,201906,82,80,2,79840,1996,81836
291190,201906,1315,585,730,583831.24,728540.46,1312371.70
291200,201906,167,126,41,125748,40918,166666
291210,201906,2239,908,1331,906185.08,1329337.38,2235522.46
291220,201906,276,208,68,207584,67864,275448
291230,201906,1005,350,655,349300.4,654688,1003988.4
291240,201906,433,411,22,411176.4,21956,433132.4
291250,201906,442,359,83,358282,82834,441116
291260,201906,52,40,12,39920,11976,51896
291270,201906,1188,492,696,491016,696604,1187620
291280,201906,365,175,190,174650.4,189620,364270.4
291290,201906,1742,909,833,908180.4,832333.4,1740513.8
291300,201906,236,183,53,182634,52894,235528
291310,201906,233,213,20,212574,19960,232534
291320,201906,1396,996,400,996004,399200.8,1395204.8
291330,201906,127,108,19,108782,18962,127744
291340,201906,181,102,79,101796,78842,180638
291345,201906,139,95,44,94810,43912,138722
291350,201906,1612,554,1058,552892,1055884.7,1608776.7
291360,201906,8482,4221,4261,4213561.41,4259467.06,8473028.47
291370,201906,1130,639,491,638720.4,491016.98,1129737.38
291380,201906,257,203,54,202594,53892,256486
291390,201906,3811,1702,2109,1698597.94,2104782.4,3803380.34
291400,201906,2078,1488,590,1486022,588820.81,2074842.81
291410,201906,162,143,19,143712,18962,162674
291420,201906,117,87,30,86826,29940,116766
291430,201906,162,90,72,89820,71856.11,161676.11
291440,201906,518,421,97,420158.8,96806,516964.8
291450,201906,907,576,331,574848.5,330338,905186.5
291460,201906,1814,1482,332,1482031.2,332334,1814365.2
291465,201906,2188,1050,1138,1047913.9,1135737.58,2183651.48
291470,201906,2844,1444,1400,1443108.71,1398198.4,2841307.11
291480,201906,11768,5262,6506,5253496.81,6502096.34,11755593.15
291490,201906,562,237,325,236526,324350,560876
291500,201906,376,216,160,216566,159680,376246
291510,201906,1227,478,749,478042,749498,1227540
291520,201906,956,440,516,439120,514968,954088
291530,201906,974,275,699,275448,698600,974048
291535,201906,124,104,20,103792,19960,123752
291540,201906,352,105,247,104790.4,246506.2,351296.6
291550,201906,1206,580,626,579839.2,625747.38,1205586.58
291560,201906,5360,2749,2611,2748584.58,2607940.87,5356525.45
291570,201906,202,104,98,103792,97804,201596
291580,201906,1237,761,476,759479.81,476046,1235525.81
291590,201906,87,36,51,35928,50898,86826
291600,201906,1197,591,606,589818,605787.96,1195605.96
291610,201906,1470,714,756,712572,754489.58,1467061.58
291620,201906,562,259,303,258482,302394,560876
291630,201906,470,153,317,152694,316366,469060
291640,201906,3956,2024,1932,2021952.2,1928148.96,3950101.16
291650,201906,420,286,134,286426.53,133732,420158.53
291660,201906,407,165,242,164670,241516,406186
291670,201906,224,144,80,143712,79840,223552
291680,201906,685,402,283,401196,282434.8,683630.8
291685,201906,592,328,264,328342.5,263472,591814.5
291690,201906,569,319,250,319360,249501.86,568861.86
291700,201906,959,758,201,757482,200598,958080
291710,201906,1685,799,886,797402.5,884228.98,1681631.48
291720,201906,407,271,136,270458,135728,406186
291730,201906,945,561,384,559878,383232,943110
291733,201906,281,194,87,193612,86826,280438
291735,201906,72,54,18,53892,17964,71856
291740,201906,348,271,77,270458,77844,348302
291750,201906,2087,1362,725,1361272.8,724548,2085820.8
291760,201906,3042,1684,1358,1682628,1355284.4,3037912.4
291770,201906,788,529,259,530942.91,260478,791420.91
291780,201906,46,27,19,26946,18962,45908
291790,201906,163,79,84,78842,83832,162674
291800,201906,10102,4168,5934,4165654.91,5929121.08,10094775.99
291810,201906,1127,829,298,827342.4,297404.6,1124747.0
291820,201906,274,197,77,196606,76846,273452
291830,201906,1115,440,675,439120.98,673650.98,1112771.96
291835,201906,586,545,41,543910,40918,584828
291840,201906,4839,2499,2340,2495001.35,2337317.38,4832318.73
291845,201906,279,96,183,95808,182634,278442
291850,201906,334,297,37,296406,36926,333332
291855,201906,263,107,156,106786,156686,263472
291860,201906,175,109,66,108782,65868,174650
291870,201906,82,31,51,30938,50898,81836
291875,201906,182,168,14,171656,13972,185628
291880,201906,476,377,99,376246,98802,475048
291890,201906,243,80,163,79840,162674.4,242514.4
291900,201906,58,33,25,32934,24950,57884
291905,201906,131,96,35,95808.4,34930,130738.4
291910,201906,171,138,33,137724,32934,170658
291915,201906,414,366,48,365268.5,47904,413172.5
291920,201906,4973,2586,2387,2580828.98,2383225.98,4964054.96
291930,201906,176,104,72,103792,72854,176646
291940,201906,353,198,155,198602,154690,353292
291950,201906,1148,934,214,934128.4,213572,1147700.4
291955,201906,1189,715,474,714568.4,473052,1187620.4
291960,201906,180,131,49,130738,48902,179640
291970,201906,771,582,189,580836,188622,769458
291980,201906,1522,1348,174,1345305.38,173652.4,1518957.78
291990,201906,129,119,10,119760,9980,129740
291992,201906,174,86,88,87824,87824,175648
291995,201906,159,108,51,107784,50898,158682
292000,201906,390,302,88,301396.4,87824,389220.4
292010,201906,291,205,86,205588,85828,291416
292020,201906,290,212,78,211576,77844,289420
292030,201906,144,112,32,111776,31936,143712
292040,201906,641,325,316,326346,315368,641714
292045,201906,102,93,9,92814,8982,101796
292050,201906,937,680,257,679638,256486.4,936124.4
292060,201906,931,772,159,770456.36,158682,929138.36
292070,201906,49,21,28,20958,27944,48902
292080,201906,133,91,42,90818,41916,132734
292090,201906,509,187,322,186626,321356,507982
292100,201906,1391,617,774,615766.6,772452.98,1388219.58
292105,201906,212,183,29,182634,28942,211576
292110,201906,2227,840,1387,838320,1385229.86,2223549.86
292120,201906,692,546,146,544908,145708,690616
292130,201906,444,260,184,259480,183632,443112
292140,201906,207,166,41,165668,40918,206586
292145,201906,165,86,79,85828.4,78842,164670.4
292150,201906,1477,1197,280,1196602,279440,1476042
292160,201906,175,143,32,142714,32934,175648
292170,201906,1212,1064,148,1063868,147704,1211572
292180,201906,216,156,60,155688,59880,215568
292190,201906,160,99,61,98802,60878,159680
292200,201906,1288,481,807,481037.36,806385.36,1287422.72
292205,201906,126,112,14,111776,13972,125748
292210,201906,365,259,106,258482,105788,364270
292220,201906,22,17,5,16966,4990,21956
292225,201906,39,34,5,33932,4990,38922
292230,201906,972,786,186,785426.75,185628,971054.75
292240,201906,613,448,165,447104.7,164670,611774.7
292250,201906,1759,1150,609,1147700,608780.4,1756480.4
292260,201906,428,253,175,252494,174650.94,427144.94
292265,201906,250,175,75,175648,74850,250498
292270,201906,739,337,402,336326,401196.6,737522.6
292273,201906,200,113,87,112774,86826,199600
292275,201906,178,90,88,89820,87824,177644
292280,201906,145,103,42,102794,41916,144710
292285,201906,68,58,10,57884,9980,67864
292290,201906,577,389,188,388222.09,187624.4,575846.49
292300,201906,1645,641,1004,639718.8,1001992.72,1641711.52
292303,201906,103,68,35,67864,34930,102794
292305,201906,111,80,31,79840,30938,110778
292310,201906,883,581,302,579839.24,301396.56,881235.80
292320,201906,623,476,147,475048,146706,621754
292330,201906,180,102,78,101796,77844,179640
292335,201906,286,225,61,224550,60878,285428
292340,201906,577,407,170,407184.4,169660,576844.4
292350,201906,270,146,124,145708,123752,269460
292360,201906,711,544,167,543910.56,166666,710576.56
292370,201906,754,580,174,578840,174650,753490
292380,201906,662,520,142,518960.54,141716,660676.54
292390,201906,493,198,295,197604,294410,492014
292400,201906,3470,2168,1302,2166660.14,1301393,3468053.14
292405,201906,268,177,91,177644,90818,268462
292410,201906,142,86,56,85828,55888,141716
292420,201906,296,254,42,254490,41916,296406
292430,201906,525,410,115,409180,114770,523950
292440,201906,590,506,84,504988.44,83832,588820.44
292450,201906,263,203,60,202594,59880,262474
292460,201906,566,424,142,423152.98,141716,564868.98
292465,201906,222,181,41,181636,40918,222554
292467,201906,114,71,43,70858,42914,113772
292470,201906,281,192,89,191616,88822,280438
292480,201906,341,235,106,234530,105788.4,340318.4
292490,201906,227,156,71,155688,70858,226546
292500,201906,1132,500,632,499000.75,631734,1130734.75
292510,201906,3408,1573,1835,1570852.44,1831331.18,3402183.62
292520,201906,1078,508,570,508980.99,569858.98,1078839.97
292525,201906,401,286,115,285428,114770,400198
292530,201906,4290,1767,2523,1764467.73,2520952.54,4285420.27
292540,201906,467,259,208,258482,208582,467064
292550,201906,1044,567,477,565879.48,479051.54,1044931.02
292560,201906,322,303,19,302394,18962,321356
292570,201906,302,234,68,233532,67864,301396
292575,201906,483,313,170,312374.4,169660,482034.4
292580,201906,982,646,336,644708,335328.4,980036.4
292590,201906,554,480,74,479040,73852,552892
292593,201906,140,111,29,110778,28942,139720
292595,201906,189,146,43,145708,42914,188622
292600,201906,1254,922,332,921154.63,331336,1252490.63
292610,201906,134,102,32,101796,31936,133732
292620,201906,537,450,87,449101.38,86826,535927.38
292630,201906,1408,806,602,804388.67,600796.27,1405184.94
292640,201906,802,555,247,553890,246506,800396
292650,201906,184,156,28,155688.4,27944,183632.4
292660,201906,2040,1469,571,1470055.15,569859.15,2039914.30
292665,201906,148,107,41,106786,40918,147704
292670,201906,405,327,78,326346.99,77844,404190.99
292680,201906,262,200,62,199600,61876,261476
292690,201906,190,145,45,144710,44910,189620
292700,201906,947,633,314,631734,315368,947102
292710,201906,108,95,13,94810,12974,107784
292720,201906,908,510,398,508980,397204,906184
292730,201906,196,93,103,92814,102794,195608
292740,201906,67788,33737,34051,33697506.29,34022859,67720365.29
292750,201906,386,277,109,276446.78,108782,385228.78
292760,201906,331,273,58,272454.38,57884,330338.38
292770,201906,788,341,447,340318.4,447104,787422.4
292780,201906,410,162,248,161676,248502,410178
292790,201906,743,369,374,368262,373252,741514
292800,201906,1215,735,480,733530,480038,1213568
292805,201906,397,115,282,114770,282434,397204
292810,201906,1489,850,639,848300.8,639719.38,1488020.18
292820,201906,732,602,130,600796.7,129740.98,730537.68
292830,201906,103,85,18,84830,17964,102794
292840,201906,688,567,121,565866.6,120758,686624.6
292850,201906,138,94,44,93812,43912,137724
292860,201906,2197,1298,899,1295404.4,897202,2192606.4
292870,201906,3490,2346,1144,2346301.53,1142710,3489011.53
292880,201906,1485,965,520,964069.42,518960,1483029.42
292890,201906,502,433,69,432135.94,68862,500997.94
292895,201906,137,89,48,89820,47904,137724
292900,201906,391,283,108,282434.36,107784,390218.36
292905,201906,459,234,225,233532,224550,458082
292910,201906,439,337,102,336326.3,101796,438122.3
292920,201906,538,243,295,242514,295408,537922
292925,201906,503,465,38,464070,37924.96,501994.96
292930,201906,583,353,230,353292,229540,582832
292935,201906,285,121,164,121756,163672.98,285428.98
292937,201906,244,166,78,165668,77844,243512
292940,201906,199,156,43,155688,42914,198602
292950,201906,1126,585,541,584829.3,539918,1124747.3
292960,201906,603,425,178,425148,178642,603790
292970,201906,248,178,70,177644,69860,247504
292975,201906,131,73,58,72854,57884.6,130738.6
292980,201906,278,188,90,188622.76,89820,278442.76
292990,201906,1331,995,336,993010.8,335328,1328338.8
293000,201906,109,80,29,79840,28942,108782
293010,201906,2759,1676,1083,1672648.3,1082830.99,2755479.29
293015,201906,662,531,131,531934,130738,662672
293020,201906,343,279,64,278442,63872,342314
293030,201906,600,524,76,522952.8,75848,598800.8
293040,201906,350,280,70,281436,69860,351296
293050,201906,2795,1662,1133,1660672.4,1130735.98,2791408.38
293060,201906,257,207,50,206586.58,49900,256486.58
293070,201906,3448,1783,1665,1779436.89,1663669.58,3443106.47
293075,201906,92,61,31,60878,30938,91816
293076,201906,73,49,24,48902,23952,72854
293077,201906,478,285,193,284430.4,192614,477044.4
293080,201906,453,409,44,408182.74,43912,452094.74
293090,201906,131,115,16,115768,15968,131736
293100,201906,531,370,161,369260,160678,529938
293105,201906,346,242,104,241516,104790,346306
293110,201906,174,124,50,123752,49900,173652
293120,201906,333,228,105,227544.45,104790,332334.45
293130,201906,245,167,78,166666,77844,244510
293135,201906,7968,3186,4782,3179649.26,4781470.98,7961120.24
293140,201906,194,126,68,125748.6,67864,193612.6
293150,201906,327,281,46,280438,45908,326346
293160,201906,427,245,182,244510,181636,426146
293170,201906,157,109,48,108782,48902,157684
293180,201906,486,343,143,342314.4,143712,486026.4
293190,201906,1338,938,400,936124.7,402194,1338318.7
293200,201906,536,477,59,478042,58882,536924
293210,201906,380,294,86,293412,85828,379240
293220,201906,2579,1083,1496,1080834,1495004.58,2575838.58
293230,201906,1721,637,1084,636724.35,1081832,1718556.35
293240,201906,226,207,19,206586,18962,225548
293245,201906,120,100,20,99800,19960,119760
293250,201906,705,259,446,260478.67,445108,705586.67
293260,201906,298,251,47,250498,46906,297404
293270,201906,1143,543,600,541914.68,598800,1140714.68
293280,201906,257,146,111,145708,110778,256486
293290,201906,3053,2006,1047,2004982.4,1045905.97,3050888.37
293300,201906,720,514,206,513971.67,205588,719559.67
293305,201906,168,140,28,139720,27944,167664
293310,201906,144,110,34,109780,34930,144710
293315,201906,169,131,38,130738,37924,168662
293317,201906,92,65,27,64870,26946,91816
293320,201906,1004,575,429,573850.5,428142,1001992.5
293325,201906,185,71,114,70858,113772,184630
293330,201906,13137,6220,6917,6209558.72,6910159.23,13119717.95
293340,201906,259,191,68,190618,67864,258482
293345,201906,245,195,50,194610,49900,244510
293350,201906,630,359,271,358282.4,271456,629738.4
293360,201906,1554,1111,443,1110774,442114,1552888
310010,201906,145,76,69,75848,68862.4,144710.4
310020,201906,1061,596,465,594808.4,465068.44,1059876.84
310030,201906,332,271,61,270458.2,60878,331336.2
310040,201906,47,32,15,31936,14970,46906
310050,201906,186,119,67,118762.4,66866,185628.4
310060,201906,246,173,73,172654,72854,245508
310070,201906,15,8,7,7984,6986,14970
310080,201906,44,24,20,23952,19960,43912
310090,201906,993,528,465,526945.6,465068.8,992014.4
310100,201906,308,240,68,239520,67864,307384
310110,201906,722,398,324,397204,325348.4,722552.4
310120,201906,377,208,169,207584,168662,376246
310130,201906,34,22,12,21956,11976,33932
310140,201906,23,12,11,11976,10978,22954
310150,201906,1258,868,390,867263,389220.8,1256483.8
310160,201906,2080,1061,1019,1060875.17,1018958.8,2079833.97
310163,201906,95,54,41,53892,41916,95808
310170,201906,2572,1135,1437,1132730.74,1439118.6,2571849.34
310180,201906,134,52,82,51896,82834,134730
310190,201906,476,333,143,332334,142714,475048
310200,201906,499,322,177,321356.4,177644,499000.4
310205,201906,51,38,13,37924,12974,50898
310210,201906,282,229,53,229540,52894,282434
310220,201906,59,36,23,35928,22954,58882
310230,201906,270,189,81,188622,80838,269460
310240,201906,107,95,12,94810,12974,107784
310250,201906,102,81,21,80838,20958,101796
310260,201906,765,419,346,418164.04,346306,764470.04
310270,201906,279,188,91,187624.84,90818,278442.84
310280,201906,364,271,93,270458,92814,363272
310285,201906,215,156,59,155688,58882,214570
310290,201906,253,141,112,140718,111776,252494
310300,201906,152,125,27,124750,26946,151696
310310,201906,9,7,2,6986,1996,8982
310320,201906,30,15,15,14970,14970,29940
310330,201906,33,25,8,24950,7984,32934
310340,201906,1756,1168,588,1165665.4,587822.4,1753487.8
310350,201906,2862,1580,1282,1578837.38,1280434.98,2859272.36
310360,201906,40,33,7,32934,6986,39920
310370,201906,123,103,20,102794,19960.4,122754.4
310375,201906,109,42,67,41916,67864.96,109780.96
310380,201906,46,26,20,25948,19960,45908
310390,201906,91,62,29,61876,28942,90818
310400,201906,2366,1576,790,1573846.8,790416,2364262.8
310410,201906,124,71,53,70858,52894,123752
310420,201906,672,354,318,354290.6,317364.2,671654.8
310430,201906,318,211,107,210578,106786,317364
310440,201906,71,43,28,42914,27944,70858
310445,201906,80,67,13,66866,12974,79840
310450,201906,837,529,308,528940,307384,836324
310460,201906,260,187,73,186626,73852,260478
310470,201906,509,332,177,331336,176646,507982
310480,201906,79,59,20,58882,19960,78842
310490,201906,527,255,272,254490,271456,525946
310500,201906,132,54,78,53892,77844,131736
310510,201906,602,413,189,412174,189620.98,601794.98
310520,201906,133,94,39,93812,38922,132734
310530,201906,97,42,55,41916,54890,96806
310540,201906,462,278,184,277444.6,183632,461076.6
310550,201906,84,55,29,54890,28942,83832
310560,201906,3006,2070,936,2069854.8,935126,3004980.8
310570,201906,108,74,34,73852,33932,107784
310590,201906,367,241,126,240518.4,125748,366266.4
310600,201906,158,90,68,89820.4,67864,157684.4
310610,201906,61,24,37,23952,36926,60878
310620,201906,46912,22741,24171,22745372.29,24186546.03,46931918.32
310630,201906,623,401,222,400198,222554.4,622752.4
310640,201906,147,119,28,119760,27944,147704
310650,201906,165,145,20,144710,19960,164670
310660,201906,90,60,30,59880,29940,89820
310665,201906,59,43,16,42914,15968,58882
310670,201906,6577,2957,3620,2953088.04,3620771.48,6573859.52
310680,201906,60,37,23,36926,22954,59880
310690,201906,589,417,172,416166.1,172654,588820.1
310700,201906,57,38,19,37924,18962,56886
310710,201906,1336,910,426,910177.38,427144.4,1337321.78
310720,201906,101,31,70,30938,69860,100798
310730,201906,1414,1000,414,998000.9,413172,1411172.9
310740,201906,984,558,426,556885.2,425148.5,982033.7
310750,201906,243,145,98,144710.66,98802,243512.66
310760,201906,62,44,18,43912,17964.4,61876.4
310770,201906,95,44,51,43912,50898,94810
310780,201906,384,315,69,316366.98,68862,385228.98
310790,201906,101,83,18,82834,17964,100798
310800,201906,457,226,231,225548.5,230538,456086.5
310810,201906,171,121,50,120758.9,49900,170658.9
310820,201906,351,277,74,276446,73852,350298
310825,201906,199,165,34,164670,33932,198602
310830,201906,462,225,237,224550.4,237524,462074.4
310840,201906,369,214,155,214570,154690,369260
310850,201906,107,86,21,85828,20958,106786
310855,201906,398,317,81,316366,80838,397204
310860,201906,1589,1189,400,1187623.16,402194.7,1589817.86
310870,201906,53,43,10,42914,9980,52894
310880,201906,83,64,19,63872,18962,82834
310890,201906,305,183,122,182634,121756,304390
310900,201906,657,303,354,302401.08,353304.48,655705.56
310910,201906,237,163,74,165668.6,73852,239520.6
310920,201906,473,282,191,281436.9,190618,472054.9
310925,201906,35,28,7,27944,6986.4,34930.4
310930,201906,1077,666,411,664683.84,412184.89,1076868.73
310940,201906,670,347,323,347304,323352,670656
310945,201906,121,74,47,73852,46906,120758
310950,201906,248,199,49,198602,48902,247504
310960,201906,81,28,53,27944,52894.99,80838.99
310970,201906,165,103,62,102794,62874,165668
310980,201906,46,26,20,25948,19960,45908
310990,201906,150,82,68,81836,67864,149700
311000,201906,823,420,403,421157.77,403192.98,824350.75
311010,201906,43,37,6,36926,6986,43912
311020,201906,42,26,16,25948,15968,41916
311030,201906,394,234,160,233532,159680,393212
311040,201906,39,35,4,34930,3992,38922
311050,201906,474,195,279,194610.8,279440,474050.8
311060,201906,775,438,337,437124.4,336326.4,773450.8
311070,201906,346,166,180,165668,179640,345308
311080,201906,109,59,50,58882,49900,108782
311090,201906,340,159,181,158682.4,180638,339320.4
311100,201906,600,358,242,357284,241516,598800
311110,201906,693,485,208,484030.4,207584.98,691615.38
311115,201906,76,55,21,54890,20958,75848
311120,201906,1090,576,514,577842.4,512972,1090814.4
311130,201906,378,229,149,228542,149700,378242
311140,201906,161,88,73,87824,72854,160678
311150,201906,357,237,120,236526,119760,356286
311160,201906,729,526,203,527942.4,202594,730536.4
311170,201906,82,64,18,63872,17964,81836
311180,201906,345,231,114,232534,115768.4,348302.4
311190,201906,34,16,18,15968,17964,33932
311200,201906,326,232,94,232534,94810,327344
311205,201906,33,23,10,22954,9980,32934
311210,201906,48,40,8,39920.8,7984,47904.8
311220,201906,20,19,1,18962,998,19960
311230,201906,1641,1077,564,1075844.6,566864,1642708.6
311240,201906,172,113,59,112774,58882,171656
311250,201906,95,25,70,24950,69860,94810
311260,201906,561,356,205,356286,204590,560876
311265,201906,118,83,35,82834,34930,117764
311270,201906,290,202,88,201596,87824,289420
311280,201906,209,100,109,99800,108782,208582
311290,201906,110,88,22,87824,21956.4,109780.4
311300,201906,594,375,219,374250,219560,593810
311310,201906,25,19,6,18962,5988,24950
311320,201906,670,503,167,501994,166666,668660
311330,201906,1093,814,279,813370.6,279440.8,1092811.4
311340,201906,2625,1864,761,1861270.8,761474.98,2622745.78
311350,201906,275,213,62,212574,61876,274450
311360,201906,175,108,67,107784,67864,175648
311370,201906,1202,505,697,503990.5,695606.96,1199597.46
311380,201906,7,6,1,5988,998,6986
311390,201906,262,144,118,143712,117764,261476
311400,201906,154,104,50,103792,49900,153692
311410,201906,101,59,42,58882.4,41916,100798.4
311420,201906,302,170,132,169660.6,131736,301396.6
311430,201906,858,568,290,567862.9,290418.4,858281.3
311440,201906,484,340,144,340318,144710,485028
311450,201906,320,204,116,204590,116766,321356
311455,201906,291,201,90,200598,89820,290418
311460,201906,136,56,80,56886,79840,136726
311470,201906,22,13,9,12974,8982,21956
311480,201906,43,19,24,18962,23952,42914
311490,201906,17,11,6,10978,5988,16966
311500,201906,23,10,13,9980,12974,22954
311510,201906,636,454,182,453092,182634,635726
311520,201906,41,33,8,32934,7984,40918
311530,201906,1811,1349,462,1348299.28,461076,1809375.28
311535,201906,70,50,20,49900,19960,69860
311540,201906,35,30,5,29940,4990,34930
311545,201906,193,142,51,141716,50898,192614
311547,201906,34,25,9,24950,8982,33932
311550,201906,674,323,351,322354,350298.98,672652.98
311560,201906,41,28,13,27944,12974,40918
311570,201906,290,198,92,198602,92814,291416
311580,201906,328,196,132,195608,131736,327344
311590,201906,33,30,3,29940,2994,32934
311600,201906,99,79,20,78842,19960,98802
311610,201906,256,222,34,221556.5,33932,255488.5
311615,201906,114,96,18,95808,17964,113772
311620,201906,22,12,10,11976,9980,21956
311630,201906,86,73,13,72854,12974,85828
311640,201906,133,72,61,72854,60878,133732
311650,201906,132,95,37,94810,36926,131736
311660,201906,414,200,214,199600,213572,413172
311670,201906,164,107,57,106786.58,56886,163672.58
311680,201906,215,158,57,157684,56886,214570
311690,201906,13,9,4,8982,3992,12974
311700,201906,199,141,58,140718,58882,199600
311710,201906,201,129,72,128742,71856,200598
311720,201906,40,29,11,28942.4,10978,39920.4
311730,201906,596,395,201,394210,200598.98,594808.98
311740,201906,37,27,10,26946,9980,36926
311750,201906,716,485,231,484031.36,231536,715567.36
311760,201906,58,33,25,32934,24950,57884
311770,201906,393,199,194,199601.34,193612,393213.34
311780,201906,175,95,80,94810.4,79840,174650.4
311783,201906,87,77,10,76846,9980,86826
311787,201906,35,14,21,13972,20958,34930
311790,201906,269,126,143,125748,142714,268462
311800,201906,675,455,220,455088.9,220558,675646.9
311810,201906,50,42,8,41916,7984,49900
311820,201906,115,98,17,97804,16966,114770
311830,201906,1947,1234,713,1231533.5,711574,1943107.5
311840,201906,1018,567,451,565868,450098.9,1015966.9
311850,201906,10,6,4,5988,3992,9980
311860,201906,9495,4325,5170,4325334.7,5172639.85,9497974.55
311870,201906,138,76,62,75848,61876,137724
311880,201906,937,696,241,694609.38,240518,935127.38
311890,201906,216,109,107,108700,106786,215486
311900,201906,79,33,46,32934,45908,78842
311910,201906,1422,895,527,893210.7,525946.4,1419157.1
311920,201906,227,151,76,150698,76846,227544
311930,201906,911,525,386,523950.4,386226.5,910176.9
311940,201906,2509,1334,1175,1335324,1174646.86,2509970.86
311950,201906,59,45,14,44910,13972,58882
311960,201906,67,48,19,47904,18962,66866
311970,201906,26,16,10,15968,9980,25948
311980,201906,46,36,10,35928,9980,45908
311990,201906,45,36,9,35928,8982,44910
311995,201906,57,39,18,38922,17964,56886
312000,201906,34,25,9,24950,8982,33932
312010,201906,85,64,21,63872,20958,84830
312015,201906,98,74,24,73852.4,23952,97804.4
312020,201906,126,84,42,83832.4,41916,125748.4
312030,201906,52,41,11,40918,10978,51896
312040,201906,86,54,32,53892,31936,85828
312050,201906,222,123,99,122754,98802,221556
312060,201906,63,38,25,37924,24950,62874
312070,201906,72,46,26,45908,25948,71856
312080,201906,537,250,287,249500,286426,535926
312083,201906,56,40,16,39920,15968,55888
312087,201906,110,87,23,86826,22954,109780
312090,201906,3092,1846,1246,1843310.5,1244507.36,3087817.86
312100,201906,153,107,46,106556.86,46906,153462.86
312110,201906,114,70,44,70858,43912,114770
312120,201906,145,109,36,109780.97,35928,145708.97
312125,201906,90,48,42,47904,41916,89820
312130,201906,123,85,38,84830,37924,122754
312140,201906,147,114,33,113772.4,32934,146706.4
312150,201906,46,36,10,35928,9980,45908
312160,201906,1551,1025,526,1024038.8,526944.4,1550983.2
312170,201906,10,9,1,8982,998,9980
312180,201906,105,66,39,65868,38922.8,104790.8
312190,201906,33,29,4,28942,3992,32934
312200,201906,759,652,107,650696.4,106786,757482.4
312210,201906,91,60,31,60878,30938,91816
312220,201906,136,99,37,98802.5,36926,135728.5
312230,201906,3599,1763,1836,1760475.12,1833335.04,3593810.16
312235,201906,166,114,52,113772,51896,165668
312240,201906,107,75,32,74850,31936,106786
312245,201906,177,125,52,124750.99,51896,176646.99
312247,201906,65,46,19,45908,18962,64870
312250,201906,177,84,93,83832,92814,176646
312260,201906,116,76,40,75848,39920,115768
312270,201906,138,85,53,84830,52894,137724
312280,201906,28,15,13,15968,12974,28942
312290,201906,156,109,47,108782,47904.6,156686.6
312300,201906,207,136,71,135728,70858,206586
312310,201906,58,53,5,52894,4990,57884
312320,201906,433,277,156,276446,156686,433132
312330,201906,95,85,10,84830,9980,94810
312340,201906,38,17,21,16966,20958,37924
312350,201906,18,11,7,10978,6986,17964
312352,201906,100,71,29,70858,28942,99800
312360,201906,560,250,310,249500,310378,559878
312370,201906,307,176,131,175648,130738.4,306386.4
312380,201906,148,102,46,101796,45908,147704
312385,201906,169,137,32,136726,31936,168662
312390,201906,307,193,114,192614,113772,306386
312400,201906,374,287,87,287424,86827,374251
312410,201906,923,300,623,299400,622753.39,922153.39
312420,201906,623,486,137,485028.4,136726,621754.4
312430,201906,864,641,223,641715.89,222554,864269.89
312440,201906,43,33,10,32934,9980,42914
312450,201906,205,130,75,129740,75848,205588
312460,201906,33,16,17,15968,16966,32934
312470,201906,53,34,19,33932,18962,52894
312480,201906,198,120,78,120758,78842,199600
312490,201906,271,190,81,189620,80838,270458
312500,201906,35,20,15,19960,14970,34930
312510,201906,497,196,301,195608,300398,496006
312520,201906,41,13,28,12974,27944,40918
312530,201906,50,35,15,34930,14970,49900
312540,201906,101,88,13,87824,12974,100798
312550,201906,40,31,9,30938,8982,39920
312560,201906,223,170,53,169660.4,52894,222554.4
312570,201906,441,266,175,265468,174650,440118
312580,201906,86,45,41,44910,40918,85828
312590,201906,255,200,55,201596,54890,256486
312595,201906,135,122,13,121756,13972,135728
312600,201906,71,43,28,42914.1,27944,70858.1
312610,201906,1604,848,756,848301.6,755486,1603787.6
312620,201906,197,143,54,142714,54890,197604
312630,201906,71,58,13,57884,12974,70858
312640,201906,42,11,31,10978,30938,41916
312650,201906,154,129,25,128742.4,24950,153692.4
312660,201906,77,58,19,57884.7,18962,76846.7
312670,201906,891,591,300,589818,299400,889218
312675,201906,35,27,8,26946,7984,34930
312680,201906,83,56,27,55888,26946,82834
312690,201906,241,132,109,131736,108782,240518
312695,201906,39,32,7,31936,6986,38922
312700,201906,221,131,90,130738,89820,220558
312705,201906,83,69,14,68862,13972,82834
312707,201906,130,93,37,92814.3,36926,129740.3
312710,201906,1892,1031,861,1028939.36,862571.4,1891510.76
312720,201906,64,32,32,31936,31936,63872
312730,201906,277,164,113,163672,112774,276446
312733,201906,53,45,8,44910,7984,52894
312735,201906,24,16,8,15968,7984,23952
312737,201906,71,37,34,36926,33932,70858
312738,201906,54,39,15,38922,14970,53892
312740,201906,76,51,25,50898.4,24950,75848.4
312750,201906,69,50,19,49900,18962,68862
312760,201906,277,202,75,202594,74850,277444
312770,201906,7625,3566,4059,3566859.92,4058869.93,7625729.85
312780,201906,418,323,95,322354,94810,417164
312790,201906,22,18,4,17964,3992,21956
312800,201906,1612,1121,491,1121752.9,490018.46,1611771.36
312810,201906,373,241,132,240518,131736,372254
312820,201906,189,141,48,140718,47904,188622
312825,201906,26,18,8,17964,7984,25948
312830,201906,260,152,108,151696.46,107784,259480.46
312840,201906,153,109,44,109780,43912,153692
312850,201906,49,44,5,43912,4990,48902
312860,201906,161,101,60,100798,59880,160678
312870,201906,1008,538,470,540916.9,469060,1009976.9
312880,201906,144,101,43,100798,42914,143712
312890,201906,164,116,48,115768,47904,163672
312900,201906,207,156,51,155688,50898,206586
312910,201906,184,98,86,97804,85828,183632
312920,201906,157,90,67,89820,66866,156686
312930,201906,326,234,92,233532,91816,325348
312940,201906,111,80,31,79840,30938,110778
312950,201906,706,473,233,472054,232534,704588
312960,201906,171,130,41,130738.96,40918,171656.96
312965,201906,62,54,8,53892,7984,61876
312970,201906,279,224,55,223552.4,55888,279440.4
312980,201906,2388,1255,1133,1254488.18,1134726.99,2389215.17
312990,201906,46,25,21,24950,20958,45908
313000,201906,46,27,19,26946,18962,45908
313005,201906,171,136,35,135728,34930.4,170658.4
313010,201906,931,383,548,383232,546904.98,930136.98
313020,201906,190,101,89,100798,88822,189620
313030,201906,203,133,70,132734.54,69860,202594.54
313040,201906,71,25,46,24950,45908,70858
313050,201906,197,140,57,139720,56886,196606
313055,201906,44,34,10,33932,9980,43912
313060,201906,123,88,35,87824,34930,122754
313065,201906,58,41,17,40918,16966,57884
313070,201906,139,75,64,74850,63872,138722
313080,201906,43,19,24,18962,23952,42914
313090,201906,698,483,215,483032.4,214570,697602.4
313100,201906,169,63,106,62874,105788,168662
313110,201906,138,76,62,75848,61876,137724
313115,201906,188,105,83,104790,82834,187624
313120,201906,786,451,335,450098.4,334330.4,784428.8
313130,201906,5503,3050,2453,3046901.48,2451089.9,5497991.38
313140,201906,148,79,69,79840,68862,148702
313150,201906,308,245,63,244510,62874,307384
313160,201906,195,144,51,143712.4,50898,194610.4
313170,201906,1403,976,427,976045.6,427144.98,1403190.58
313180,201906,309,185,124,184630,123752,308382
313190,201906,752,456,296,456086,295408.2,751494.2
313200,201906,30,27,3,26946,2994,29940
313210,201906,1023,870,153,868261.62,153692,1021953.62
313220,201906,255,169,86,168662,85828.4,254490.4
313230,201906,277,210,67,209580.65,66866,276446.65
313240,201906,2092,1111,981,1111776.29,982032,2093808.29
313250,201906,1279,969,310,969058.8,309381.12,1278439.92
313260,201906,90,51,39,50898,38922,89820
313270,201906,962,568,394,566864.3,393212.78,960077.08
313280,201906,55,45,10,45908,9980,55888
313290,201906,224,181,43,180638.4,42914,223552.4
313300,201906,356,185,171,184631,170658,355289
313310,201906,244,126,118,125748,117764,243512
313320,201906,370,282,88,281436.6,88822,370258.6
313330,201906,1383,869,514,867262,512972,1380234
313340,201906,334,237,97,236526,96806,333332
313350,201906,496,335,161,334330,161676,496006
313360,201906,115,66,49,66866,48902.4,115768.4
313370,201906,194,75,119,74850,118762,193612
313375,201906,278,169,109,168662,108782,277444
313380,201906,1331,714,617,716564.2,615766.99,1332331.19
313390,201906,54,48,6,47904.6,5988,53892.6
313400,201906,414,282,132,281436.6,131736.8,413173.4
313410,201906,24,14,10,13972,9980,23952
313420,201906,4673,2501,2172,2495999.6,2170651.1,4666650.7
313430,201906,141,71,70,70858,69860,140718
313440,201906,1460,1007,453,1005984.71,453093.6,1459078.31
313450,201906,63,27,36,26946,35928,62874
313460,201906,381,176,205,175648,205588,381236
313470,201906,527,245,282,244510.8,282434,526944.8
313480,201906,149,105,44,104790.4,43912,148702.4
313490,201906,513,248,265,247504.4,264470.9,511975.3
313500,201906,19,11,8,10978,7984,18962
313505,201906,1012,805,207,803390,206586,1009976
313507,201906,99,61,38,60878,37924,98802
313510,201906,2777,1790,987,1788417,985026,2773443
313520,201906,3511,2759,752,2757478.45,752492.99,3509971.44
313530,201906,40,27,13,26946,12974,39920
313535,201906,51,44,7,43912,6986,50898
313540,201906,73,54,19,54890,18962,73852
313545,201906,118,100,18,99800,17964,117764
313550,201906,232,195,37,194610,36926.4,231536.4
313560,201906,326,168,158,167664,157684,325348
313570,201906,57,28,29,27944,28942,56886
313580,201906,1333,752,581,751494,579839.2,1331333.2
313590,201906,77,45,32,44910,31936,76846
313600,201906,679,418,261,417164,262474.4,679638.4
313610,201906,59,49,10,48902.66,9980,58882.66
313620,201906,1385,736,649,734528.8,648700,1383228.8
313630,201906,1641,1263,378,1260724.8,378242,1638966.8
313640,201906,126,76,50,75848,49900,125748
313650,201906,238,113,125,112774,124750.4,237524.4
313652,201906,17,17,0,16966,0,16966
313655,201906,59,36,23,35928,22954,58882
313657,201906,47,44,3,43912,2994,46906
313660,201906,134,93,41,92814,40935.96,133749.96
313665,201906,663,328,335,327344.9,335328,662672.9
313670,201906,10354,7161,3193,7155667.17,3191605.2,10347272.37
313680,201906,42,31,11,30938,10978.78,41916.78
313690,201906,153,114,39,113772,38922,152694
313695,201906,73,57,16,56886,15968,72854
313700,201906,313,253,60,252494.4,59880,312374.4
313710,201906,144,99,45,98802,44910,143712
313720,201906,1114,541,573,540916.4,572853.4,1113769.8
313730,201906,62,43,19,42914,18962,61876
313740,201906,157,128,29,127744,28942,156686
313750,201906,428,315,113,315368,112774,428142
313753,201906,238,177,61,176646,60878,237524
313760,201906,1270,463,807,463072.4,805388.1,1268460.5
313770,201906,366,272,94,271456.5,93812,365268.5
313780,201906,756,395,361,394210,360278,754488
313790,201906,28,27,1,26946,998,27944
313800,201906,144,90,54,89820,53892,143712
313810,201906,71,40,31,39920,30938,70858
313820,201906,1308,646,662,644708.8,660677.75,1305386.55
313830,201906,63,47,16,46906,15968,62874
313835,201906,62,52,10,51896,9980,61876
313840,201906,1711,1066,645,1063869.2,644708.8,1708578.0
313850,201906,190,70,120,69860,119760,189620
313860,201906,471,362,109,361276.4,108782,470058.4
313862,201906,177,119,58,118762,57884,176646
313865,201906,103,80,23,79840,22954,102794
313867,201906,49,39,10,38922,9980,48902
313868,201906,31,20,11,19960,10978,30938
313870,201906,123,65,58,64870,57884,122754
313880,201906,365,233,132,233532,131736.4,365268.4
313890,201906,333,179,154,178642.6,153692,332334.6
313900,201906,902,503,399,501994.5,400198.9,902193.4
313910,201906,140,102,38,102794,37924,140718
313920,201906,631,449,182,449100,181636.9,630736.9
313925,201906,31,28,3,27944,2994,30938
313930,201906,831,650,181,648700,180638.95,829338.95
313940,201906,1811,1143,668,1141712,668660.4,1810372.4
313950,201906,937,603,334,601794.8,333332,935126.8
313960,201906,1367,795,572,793410.76,570857.8,1364268.56
313970,201906,129,86,43,85828,42914,128742
313980,201906,219,143,76,142714.5,75848,218562.5
313990,201906,225,155,70,154690,69860,224550
314000,201906,923,625,298,623751.74,298402,922153.74
314010,201906,80,52,28,51896,27944,79840
314015,201906,54,17,37,16966,36926,53892
314020,201906,55,38,17,37924,16966,54890
314030,201906,79,39,40,38922,39920,78842
314040,201906,45,29,16,28942,15968,44910
314050,201906,290,175,115,174650.4,115768,290418.4
314053,201906,93,61,32,60878.4,31936,92814.4
314055,201906,304,186,118,185628,117764,303392
314060,201906,143,123,20,122754.89,19960,142714.89
314070,201906,1052,566,486,565866,485028,1050894
314080,201906,215,138,77,137724,76846.36,214570.36
314085,201906,142,99,43,99800,42914,142714
314090,201906,367,265,102,264470.9,101796,366266.9
314100,201906,477,395,82,394210.3,81836,476046.3
314110,201906,737,404,333,403192.4,333332,736524.4
314120,201906,91,54,37,53892,36926,90818
314130,201906,22,12,10,11976,9980,21956
314140,201906,1114,688,426,686624.4,425148,1111772.4
314150,201906,164,104,60,103792,59880,163672
314160,201906,346,263,83,262474.6,82834.6,345309.2
314170,201906,79,62,17,61876,16966,78842
314180,201906,732,648,84,646705.3,83832.5,730537.8
314190,201906,99,61,38,60878,37924,98802
314200,201906,476,326,150,325348,149700,475048
314210,201906,257,199,58,198602,58882.4,257484.4
314220,201906,312,233,79,232534.4,78842,311376.4
314225,201906,67,49,18,48902,17964,66866
314230,201906,117,54,63,53892,63872,117764
314240,201906,141,108,33,107784,32934,140718
314250,201906,60,38,22,37924,21956,59880
314260,201906,225,109,116,108782,115768,224550
314270,201906,335,267,68,266466,67864,334330
314280,201906,701,400,301,399200.98,300398,699598.98
314290,201906,552,454,98,453092.61,97804,550896.61
314300,201906,378,273,105,272456.5,104790.9,377247.4
314310,201906,1413,957,456,956334.53,455088,1411422.53
314315,201906,36,29,7,28942,6986,35928
314320,201906,601,398,203,397204.4,202594,599798.4
314330,201906,10828,5467,5361,5465051.88,5361259.53,10826311.41
314340,201906,589,274,315,273452,315368.8,588820.8
314345,201906,42,31,11,30938,10978,41916
314350,201906,189,120,69,119760,68862,188622
314360,201906,77,48,29,47904,28942,76846
314370,201906,60,47,13,46906,12974,59880
314380,201906,94,63,31,62874,30938,93812
314390,201906,3297,2127,1170,2123745.5,1171652.6,3295398.1
314400,201906,692,498,194,497005.5,193612,690617.5
314410,201906,475,315,160,314370,160678,475048
314420,201906,18,8,10,7984,9980,17964
314430,201906,2461,901,1560,900197.4,1558876,2459073.4
314435,201906,264,157,107,156686,106786,263472
314437,201906,28,22,6,21956,5988,27944
314440,201906,98,72,26,71856,25948,97804
314450,201906,159,116,43,115768,42914,158682
314460,201906,657,309,348,308382,347304,655686
314465,201906,85,58,27,57884,26946,84830
314467,201906,69,57,12,56886,11976,68862
314470,201906,403,208,195,207585.38,194610,402195.38
314480,201906,1089,536,553,534928,552892,1087820
314490,201906,83,60,23,59880,22954,82834
314500,201906,297,199,98,199600,97804,297404
314505,201906,129,85,44,84830,43912,128742
314510,201906,230,194,36,193612,35928,229540
314520,201906,1264,678,586,679645.6,585827.2,1265472.8
314530,201906,756,605,151,604789.66,151696,756485.66
314535,201906,212,132,80,131736,79840,211576
314537,201906,65,39,26,38922,25948,64870
314540,201906,15,10,5,9980,4990,14970
314545,201906,53,35,18,34930,17964,52894
314550,201906,82,44,38,43912,37924,81836
314560,201906,824,453,371,453093.1,370258,823351.1
314570,201906,21,17,4,16966,3992,20958
314580,201906,14,7,7,6986,6986,13972
314585,201906,25,19,6,18962,5988,24950
314587,201906,80,71,9,70858,8982,79840
314590,201906,578,424,154,423154.1,154690,577844.1
314600,201906,942,618,324,617763,325349.03,943112.03
314610,201906,955,513,442,511975.3,441116,953091.3
314620,201906,143,105,38,104790,37924,142714
314625,201906,97,71,26,70858,25948,96806
314630,201906,1217,635,582,633730,580836.4,1214566.4
314640,201906,82,57,25,56886,25948,82834
314650,201906,185,108,77,107784,76846,184630
314655,201906,65,48,17,47904,16966,64870
314660,201906,18,15,3,14970,2994,17964
314670,201906,200,154,46,153692.4,45908,199600.4
314675,201906,214,128,86,127744,85828,213572
314690,201906,563,310,253,309380,253492,562872
314700,201906,2337,1274,1063,1271453.6,1060874,2332327.6
314710,201906,1636,970,666,970058.32,664668.4,1634726.72
314720,201906,390,234,156,233532,157684,391216
314730,201906,515,270,245,269461.8,248502.98,517964.78
314740,201906,701,347,354,346306,353292,699598
314750,201906,21,19,2,18962,1996,20958
314760,201906,333,158,175,157684,174650,332334
314770,201906,108,78,30,77844.4,30938,108782.4
314780,201906,21,6,15,5988,14970,20958
314790,201906,2357,1497,860,1497003.87,863270,2360273.87
314795,201906,47,41,6,40918.5,5988,46906.5
314800,201906,2890,1709,1181,1708577.88,1183628,2892205.88
314810,201906,1535,878,657,876244,655686.6,1531930.6
314820,201906,96,52,44,51896,43912,95808
314830,201906,217,177,40,176646,39920,216566
314840,201906,86,50,36,49900,35928,85828
314850,201906,348,169,179,168662,178642,347304
314860,201906,702,528,174,526945.13,173652.7,700597.83
314870,201906,1508,797,711,795406,709578,1504984
314875,201906,59,51,8,50898,7984,58882
314880,201906,45,31,14,30938,13972,44910
314890,201906,55,32,23,31936,22954,54890
314900,201906,31,24,7,23952,6986,30938
314910,201906,250,168,82,167664,81836,249500
314915,201906,149,131,18,131736,17964,149700
314920,201906,114,70,44,69860,43912,113772
314930,201906,1075,541,534,540916.4,532932,1073848.4
314940,201906,47,37,10,36926,9980,46906
314950,201906,36,25,11,24950,10978,35928
314960,201906,50,38,12,37924,11976,49900
314970,201906,147,75,72,74850,71856,146706
314980,201906,297,189,108,188622,107784,296406
314990,201906,462,258,204,258482,203592,462074
314995,201906,209,62,147,61876,146706,208582
315000,201906,90,72,18,71856,17964,89820
315010,201906,46,30,16,29940,15968,45908
315015,201906,170,139,31,138722,30938,169660
315020,201906,72,61,11,60878,10978,71856
315030,201906,112,88,24,87824,23952.76,111776.76
315040,201906,70,50,20,50898,19960,70858
315050,201906,191,115,76,114770,75848,190618
315053,201906,43,38,5,37924,4990,42914
315057,201906,95,78,17,78842,16966,95808
315060,201906,69,61,8,60878.52,7984,68862.52
315070,201906,105,59,46,58882,45908,104790
315080,201906,379,308,71,307384,70858,378242
315090,201906,108,63,45,62874,44910,107784
315100,201906,83,41,42,40918,41916,82834
315110,201906,277,152,125,151696,124750,276446
315120,201906,1642,833,809,832332,808380.68,1640712.68
315130,201906,351,253,98,252494,97804,350298
315140,201906,522,306,216,305388.4,216566.8,521955.2
315150,201906,968,466,502,466066,501994.4,968060.4
315160,201906,221,113,108,112774,107784,220558
315170,201906,324,211,113,211576.4,112774,324350.4
315180,201906,3288,1399,1889,1404188.4,1886222.7,3290411.1
315190,201906,330,198,132,197604.2,131736,329340.2
315200,201906,1237,723,514,722552,513970,1236522
315210,201906,1621,931,690,929138.6,688620.2,1617758.8
315213,201906,39,22,17,21956,16966,38922
315217,201906,213,170,43,169660,42914,212574
315220,201906,1556,1199,357,1197601.58,356286.4,1553887.98
315230,201906,171,126,45,125748.4,44910,170658.4
315240,201906,429,277,152,276446,152694.98,429140.98
315250,201906,2536,1273,1263,1271452.5,1265464.8,2536917.3
315260,201906,144,88,56,87824,55888,143712
315270,201906,130,92,38,91816,37924,129740
315280,201906,668,435,233,434130.2,232534,666664.2
315290,201906,199,121,78,120758,77844.63,198602.63
315300,201906,75,55,20,54890,19960,74850
315310,201906,72,65,7,64870,6986,71856
315320,201906,165,95,70,94810,69860,164670
315330,201906,58,49,9,48902,8982,57884
315340,201906,395,286,109,285428,108782,394210
315350,201906,152,92,60,91816,60878,152694
315360,201906,93,49,44,48902,43912,92814
315370,201906,57,33,24,32934,23952,56886
315380,201906,11,8,3,7984,2994,10978
315390,201906,68,17,51,16966,50898.4,67864.4
315400,201906,847,634,213,634728.7,212574,847302.7
315410,201906,355,216,139,215568.4,138723.4,354291.8
315415,201906,62,46,16,45908,16966,62874
315420,201906,203,154,49,153692.4,48902.4,202594.8
315430,201906,656,384,272,383232.4,271456.6,654689.0
315440,201906,91,63,28,62874,27944,90818
315445,201906,243,199,44,199600,44910,244510
315450,201906,185,140,45,139720,44910,184630
315460,201906,3780,1945,1835,1947098.98,1835322.98,3782421.96
315470,201906,41,17,24,16966,23952,40918
315480,201906,63,24,39,23952,38922,62874
315490,201906,639,399,240,398202,239520,637722
315500,201906,21,14,7,13972,6986,20958
315510,201906,155,105,50,104790,49900,154690
315520,201906,70,63,7,62874,6986,69860
315530,201906,51,26,25,25948,24950,50898
315540,201906,239,160,79,159680,78842,238522
315550,201906,184,147,37,146706,36926,183632
315560,201906,731,589,142,587822.4,141716,729538.4
315570,201906,311,160,151,160679.76,150698.6,311378.36
315580,201906,704,469,235,469060,234530,703590
315590,201906,203,107,96,106786,95808,202594
315600,201906,303,227,76,226546,75848,302394
315610,201906,99,52,47,51896,46906,98802
315620,201906,34,26,8,25948,7984,33932
315630,201906,133,87,46,86826,45908,132734
315640,201906,68,42,26,41916,25948,67864
315645,201906,53,38,15,37924,14970,52894
315650,201906,169,124,45,123752.8,44910,168662.8
315660,201906,467,210,257,211576,256486,468062
315670,201906,2429,1210,1219,1207581.8,1218559.96,2426141.76
315680,201906,852,585,267,583830,266466,850296
315690,201906,683,473,210,473053.73,209580,682633.73
315700,201906,1887,1003,884,1000995.27,882232,1883227.27
315710,201906,336,98,238,97804,237524,335328
315720,201906,446,282,164,283432.4,163672,447104.4
315725,201906,200,159,41,158682.4,40918,199600.4
315727,201906,39,22,17,21956,16966,38922
315730,201906,50,48,2,47904,1996,49900
315733,201906,87,60,27,59880,26946,86826
315737,201906,51,40,11,39920,10978,50898
315740,201906,39,32,7,31936,6986,38922
315750,201906,160,124,36,123752,36926,160678
315760,201906,45,35,10,34930,9980,44910
315765,201906,122,77,45,76846,44910,121756
315770,201906,231,144,87,143712,87824.4,231536.4
315780,201906,3411,1783,1628,1780433.4,1626741.15,3407174.55
315790,201906,216,167,49,166666,48902,215568
315800,201906,290,212,78,211576,77844,289420
315810,201906,95,56,39,55888,38922.4,94810.4
315820,201906,766,561,205,559879.2,204590,764469.2
315830,201906,136,79,57,78842,56886,135728
315840,201906,86,60,26,59880,25948,85828
315850,201906,261,192,69,191616.5,68862,260478.5
315860,201906,12,4,8,3992,7984,11976
315870,201906,37,29,8,28942,7984,36926
315880,201906,109,71,38,70858,37924,108782
315890,201906,86,64,22,63872,21956,85828
315895,201906,449,305,144,307384.5,143712.8,451097.3
315900,201906,72,37,35,36926,34930,71856
315910,201906,38,25,13,24950,12974,37924
315920,201906,172,111,61,110778,60878.3,171656.3
315930,201906,47,17,30,16966,29940,46906
315935,201906,138,106,32,105788,31936.98,137724.98
315940,201906,94,71,23,70858,22954,93812
315950,201906,44,32,12,31936,11976,43912
315960,201906,551,264,287,263472.4,286426.4,549898.8
315970,201906,35,28,7,27944,6986,34930
315980,201906,688,337,351,336326.1,351296,687622.1
315990,201906,254,149,105,148702.5,104790.98,253493.48
316000,201906,55,35,20,34930,19960,54890
316010,201906,82,70,12,69860,11976,81836
316020,201906,113,97,16,96806,15968,112774
316030,201906,405,221,184,220558.8,184630.9,405189.7
316040,201906,512,217,295,216566.4,294410.4,510976.8
316045,201906,63,56,7,55888,6986,62874
316050,201906,15,13,2,12974,1996,14970
316060,201906,99,64,35,63872,34930,98802
316070,201906,1102,710,392,708580.1,395208,1103788.1
316080,201906,106,70,36,69860,35928,105788
316090,201906,38,22,16,21956,15968,37924
316095,201906,76,66,10,65868,9980,75848
316100,201906,313,181,132,180638.5,131736,312374.5
316105,201906,38,26,12,25948,11976,37924
316110,201906,1874,1512,362,1509974.55,361276,1871250.55
316120,201906,79,60,19,59880,18962,78842
316130,201906,127,97,30,96806.4,29940,126746.4
316140,201906,31,23,8,22954,7984,30938
316150,201906,209,144,65,143712,65868,209580
316160,201906,79,47,32,46906,31936,78842
316165,201906,66,52,14,51896.6,13972,65868.6
316170,201906,192,129,63,128742,62874,191616
316180,201906,203,88,115,87824,114770.4,202594.4
316190,201906,137,100,37,100798,36926,137724
316200,201906,683,388,295,388222,295408,683630
316210,201906,774,519,255,518133.65,254490,772623.65
316220,201906,115,77,38,76846,37924,114770
316225,201906,26,15,11,14970,10978,25948
316230,201906,31,17,14,17964,13972,31936
316240,201906,648,521,127,519958,127744,647702
316245,201906,124,105,19,104790,18962,123752
316250,201906,1553,1075,478,1076843.66,477044,1553887.66
316255,201906,122,99,23,98802,22954,121756
316257,201906,177,95,82,94810,81836,176646
316260,201906,191,134,57,133732.5,56886.8,190619.3
316265,201906,27,19,8,18962,7984,26946
316270,201906,672,477,195,476046.6,194610.84,670657.44
316280,201906,545,335,210,335329.23,210579.4,545908.63
316290,201906,724,482,242,481036.66,242514,723550.66
316292,201906,512,207,305,206586,304390,510976
316294,201906,99,59,40,58882,39920,98802
316295,201906,301,135,166,134731.36,165668,300399.36
316300,201906,100,73,27,72854,26946,99800
316310,201906,36,19,17,18962,16966,35928
316320,201906,44,27,17,26946,16966,43912
316330,201906,131,87,44,86826.5,43912,130738.5
316340,201906,143,99,44,98802,43912,142714
316350,201906,197,141,56,140718.3,55888,196606.3
316360,201906,24,17,7,16966,6986,23952
316370,201906,1083,573,510,572853.1,509978,1082831.1
316380,201906,121,93,28,92814,27944,120758
316390,201906,120,88,32,87824,31936,119760
316400,201906,135,104,31,103792,30938,134730
316410,201906,300,219,81,218562,80838,299400
316420,201906,207,146,61,145708,60878,206586
316430,201906,152,79,73,79840,72854,152694
316440,201906,97,47,50,46906,49900,96806
316443,201906,38,36,2,35928,1996,37924
316447,201906,66,51,15,50898,14970,65868
316450,201906,231,174,57,173652,56886,230538
316460,201906,75,30,45,29940,44910,74850
316470,201906,1639,1212,427,1209569.77,426146.4,1635716.17
316480,201906,13,10,3,9980,2994,12974
316490,201906,17,7,10,6986,9980,16966
316500,201906,156,103,53,102794,53892,156686
316510,201906,161,124,37,124750,36926,161676
316520,201906,198,123,75,122754,74850,197604
316530,201906,161,113,48,112774,47904,160678
316540,201906,139,77,62,76846,61876,138722
316550,201906,135,92,43,91816,42914,134730
316553,201906,273,130,143,130738,142714.72,273452.72
316555,201906,36,31,5,30938,4990,35928
316556,201906,11,8,3,7984,2994,10978
316557,201906,18,14,4,13972,3992,17964
316560,201906,69,51,18,50898,17964,68862
316570,201906,235,215,20,214570,19960,234530
316580,201906,20,16,4,15968,3992,19960
316590,201906,112,97,15,96806,14970,111776
316600,201906,183,152,31,151696,30938,182634
316610,201906,68,50,18,49900,17964,67864
316620,201906,143,110,33,109780,32934,142714
316630,201906,42,33,9,32934,8982,41916
316640,201906,20,13,7,12974,6986,19960
316650,201906,78,61,17,60878,16966,77844
316660,201906,8,3,5,2994,4990,7984
316670,201906,442,155,287,154690.96,286426,441116.96
316680,201906,155,109,46,108782,45908.6,154690.6
316690,201906,185,120,65,119760,64870,184630
316695,201906,64,56,8,55888,7984,63872
316700,201906,16,10,6,9980,5988,15968
316710,201906,750,558,192,556884.5,191616,748500.5
316720,201906,4949,2526,2423,2521950.41,2419154.74,4941105.15
316730,201906,17,16,1,15968,998,16966
316740,201906,122,79,43,78842,42914,121756
316750,201906,19,13,6,12974,5988,18962
316760,201906,321,260,61,259480,60878,320358
316770,201906,141,78,63,77844,62874,140718
316780,201906,75,47,28,46906,27944,74850
316790,201906,53,39,14,38922,13972,52894
316800,201906,1735,1086,649,1083828,647703,1731531
316805,201906,21,13,8,12974,7984,20958
316810,201906,72,49,23,48902,22954,71856
316820,201906,44,21,23,20958,22954,43912
316830,201906,92,44,48,43912,47904,91816
316840,201906,509,310,199,309380.4,198602,507982.4
316850,201906,343,227,116,226546,115768,342314
316860,201906,5995,2685,3310,2683626.16,3311364.3,5994990.46
316870,201906,1516,1011,505,1008980.22,505987.2,1514967.42
316880,201906,129,65,64,64870,63872,128742
316890,201906,247,168,79,167664,78842,246506
316900,201906,436,303,133,303392.36,132734,436126.36
316905,201906,20,9,11,8982,10978,19960
316910,201906,54,22,32,21956,31936,53892
316920,201906,136,107,29,106786,28942,135728
316930,201906,1883,982,901,981034.8,903190.3,1884225.1
316935,201906,898,547,351,545906.64,350298.4,896205.04
316940,201906,1089,632,457,631734.8,456086.4,1087821.2
316950,201906,181,93,88,92814.4,87824,180638.4
316960,201906,1121,629,492,628740.4,491016.4,1119756.8
316970,201906,657,518,139,516964,138722,655686
316980,201906,113,68,45,67864,44910,112774
316990,201906,2243,1501,742,1497998.34,741515.5,2239513.84
317000,201906,329,253,76,252494,75848,328342
317005,201906,242,175,67,174650,67864,242514
317010,201906,6415,3620,2795,3624740.59,2793402.4,6418142.99
317020,201906,16382,7356,9026,7353280.02,9029921.5,16383201.52
317030,201906,82,32,50,31936,49900,81836
317040,201906,3117,1954,1163,1951092.2,1160674.6,3111766.8
317043,201906,75,55,20,54890,19960,74850
317047,201906,31,16,15,15968,14970.99,30938.99
317050,201906,176,136,40,135728,39920,175648
317052,201906,134,101,33,100798,32934,133732
317057,201906,183,139,44,138722,43912,182634
317060,201906,63,43,20,42914,19960,62874
317065,201906,57,46,11,45908,10978,56886
317070,201906,1994,942,1052,943111.62,1052890.8,1996002.42
317075,201906,111,59,52,58882,51896,110778
317080,201906,860,462,398,462074.5,397204.6,859279.1
317090,201906,654,530,124,528940,123752,652692
317100,201906,429,328,101,329340,101796,431136
317103,201906,110,93,17,92814,16966,109780
317107,201906,44,38,6,37924,5988,43912
317110,201906,110,48,62,47904,61876,109780
317115,201906,46,41,5,40918,4990,45908
317120,201906,1884,971,913,972052.8,913170.4,1885223.2
317130,201906,1993,1322,671,1320356,669658,1990014
317140,201906,12,10,2,9980,1996,11976
317150,201906,275,164,111,163672.4,110778,274450.4
317160,201906,322,238,84,237525.03,83832,321357.03
317170,201906,213,146,67,145708,66866,212574
317180,201906,441,319,122,318362,121756,440118
317190,201906,264,181,83,180638,82834,263472
317200,201906,804,564,240,562875.16,239520,802395.16
317210,201906,184,103,81,102794,80838,183632
317220,201906,23,13,10,12974,9980,22954
320010,201906,611,451,160,451096.5,159680,610776.5
320013,201906,131,97,34,96806,33932,130738
320016,201906,279,178,101,178642,100798,279440
320020,201906,720,434,286,433133.1,286426,719559.1
320030,201906,144,103,41,102794,40918,143712
320035,201906,140,106,34,105788,33932,139720
320040,201906,495,259,236,258482,235528,494010
320050,201906,102,80,22,79840,23952,103792
320060,201906,1623,789,834,789420.58,832335.74,1621756.32
320070,201906,101,67,34,66866,33932,100798
320080,201906,792,461,331,460079.89,330338.5,790418.39
320090,201906,1241,870,371,868260,371256.4,1239516.4
320100,201906,331,191,140,190618,139720,330338
320110,201906,126,81,45,80839.1,44910.4,125749.5
320115,201906,109,90,19,89820,18962,108782
320120,201906,3375,1881,1494,1886221.86,1493009.77,3379231.63
320130,201906,7471,3524,3947,3521962.45,3947123.65,7469086.10
320140,201906,429,285,144,284430.6,143712.68,428143.28
320150,201906,2008,1158,850,1155686.17,849298,2004984.17
320160,201906,669,299,370,299400.99,369261.79,668662.78
320170,201906,114,92,22,91816,21956,113772
320180,201906,52,30,22,29940,22954,52894
320190,201906,246,163,83,163672,82834.4,246506.4
320200,201906,56,45,11,45908,10978,56886
320210,201906,877,491,386,491016.8,385229.76,876246.56
320220,201906,309,116,193,115768,192614,308382
320225,201906,87,72,15,71856,14970,86826
320230,201906,590,381,209,380238.6,209580,589818.6
320240,201906,3149,1591,1558,1589815.2,1556881.78,3146696.98
320245,201906,465,320,145,319360.4,144710,464070.4
320250,201906,225,119,106,118762,105788,224550
320255,201906,144,116,28,115768,27944.7,143712.7
320260,201906,194,139,55,138722,54890,193612
320265,201906,160,127,33,126746,32934,159680
320270,201906,154,124,30,123752,29940,153692
320280,201906,998,602,396,603791.53,397204,1000995.53
320290,201906,62,54,8,53892,7984,61876
320300,201906,560,396,164,396207.34,164672.04,560879.38
320305,201906,674,369,305,370258,305388.6,675646.6
320310,201906,216,123,93,122754.76,93812,216566.76
320313,201906,317,159,158,158682.9,157684.4,316367.3
320316,201906,111,89,22,88822,21956,110778
320320,201906,3437,1597,1840,1593808.42,1841312.75,3435121.17
320330,201906,261,201,60,200598,60878,261476
320332,201906,864,522,342,521956.7,341316.9,863273.6
320334,201906,249,151,98,152694.4,97804,250498.4
320335,201906,141,100,41,99800,41916,141716
320340,201906,568,394,174,394210.9,173652,567862.9
320350,201906,986,426,560,426147.5,558881.6,985029.1
320360,201906,168,91,77,90818,76846,167664
320370,201906,243,187,56,186626.56,55888.4,242514.96
320380,201906,286,200,86,199600,85828,285428
320390,201906,1155,703,452,701595.52,453092.8,1154688.32
320400,201906,310,227,83,226547.4,82834,309381.4
320405,201906,938,410,528,410178.99,526947.38,937126.37
320410,201906,977,506,471,504988,470059.3,975047.3
320420,201906,483,249,234,248503.3,233532,482035.3
320425,201906,194,106,88,105788,87824,193612
320430,201906,392,224,168,223552.5,167664,391216.5
320435,201906,163,111,52,110778,51896,162674
320440,201906,201,120,81,119760,80838,200598
320450,201906,130,75,55,74850,54890,129740
320455,201906,245,201,44,201596.4,43912,245508.4
320460,201906,260,161,99,160678,98802,259480
320465,201906,114,79,35,78842,34930,113772
320470,201906,681,434,247,434131.39,246506.99,680638.38
320480,201906,186,121,65,121756,65868,187624
320490,201906,3082,1543,1539,1543908.89,1539923.2,3083832.09
320495,201906,100,59,41,58882.96,40918.8,99801.76
320500,201906,9795,4920,4875,4938120.75,4878239.17,9816359.92
320501,201906,538,272,266,272454,267464,539918
320503,201906,291,208,83,207584,82834,290418
320506,201906,257,185,72,185628,71856,257484
320510,201906,993,468,525,468062.4,525947.38,994009.78
320515,201906,82,69,13,68862,12974,81836
320517,201906,208,150,58,150698,57884,208582
320520,201906,6936,3101,3835,3106780,3840311.83,6947091.83
320530,201906,5781,2958,2823,2960075.32,2822348.36,5782423.68
330010,201906,3074,1611,1463,1607780.2,1464066,3071846.2
330015,201906,159,66,93,65868.56,92814,158682.56
330020,201906,3653,1615,2038,1616762.4,2038914.4,3655676.8
330022,201906,245,134,111,133732,110778,244510
330023,201906,562,196,366,195608,366266,561874
330025,201906,582,122,460,121756,461076,582832
330030,201906,1937,1268,669,1269458.66,672653.5,1942112.16
330040,201906,2407,1284,1123,1285426.52,1121754.2,2407180.72
330045,201906,8393,2742,5651,2741506.8,5655667.6,8397174.4
330050,201906,885,573,312,571854,311376,883230
330060,201906,938,579,359,577842.9,358282,936124.9
330070,201906,3486,1327,2159,1326343.14,2156679.94,3483023.08
330080,201906,1488,686,802,684629.6,802392,1487021.6
330090,201906,375,220,155,219560,154690,374250
330093,201906,269,124,145,123752,146707.88,270459.88
330095,201906,94,51,43,50898,42914,93812
330100,201906,9513,4944,4569,4940102.93,4568844.4,9508947.33
330110,201906,501,213,288,212574.7,287424,499998.7
330115,201906,548,293,255,292414,255488,547902
330120,201906,374,189,185,189620,185629.6,375249.6
330130,201906,1522,408,1114,407184.6,1112770.96,1519955.56
330140,201906,596,316,280,316366.94,279440,595806.94
330150,201906,494,281,213,280438,212574,493012
330160,201906,206,128,78,127744,77844,205588
330170,201906,26943,9493,17450,9483005.38,17446051.32,26929056.70
330180,201906,237,149,88,148702,87824,236526
330185,201906,902,325,577,324350.98,575847.92,900198.90
330187,201906,320,100,220,99800,219560,319360
330190,201906,5567,2232,3335,2234524.56,3330328.08,5564852.64
330200,201906,4765,1470,3295,1470055.44,3292403.46,4762458.90
330205,201906,427,253,174,252494,173652.4,426146.4
330210,201906,999,620,379,619760.84,378244.18,998005.02
330220,201906,2581,1558,1023,1554885,1024946.4,2579831.4
330225,201906,560,300,260,299400,259480,558880
330227,201906,2362,758,1604,758480.4,1605785.26,2364265.66
330230,201906,219,127,92,127744,91816,219560
330240,201906,3632,1909,1723,1910179.04,1719589.06,3629768.10
330245,201906,156,71,85,70858.74,84830,155688.74
330250,201906,6788,3541,3247,3538910.35,3249491.71,6788402.06
330260,201906,563,159,404,158682,405188,563870
330270,201906,3450,1248,2202,1247500.6,2200592.8,3448093.4
330280,201906,446,286,160,285429.2,159680.98,445110.18
330285,201906,7208,2342,4866,2341309.5,4865254.32,7206563.82
330290,201906,615,235,380,234530,379240.4,613770.4
330300,201906,779,520,259,518961.5,258482.94,777444.44
330310,201906,439,252,187,251496.9,186626,438122.9
330320,201906,8060,3108,4952,3109771.58,4948085.6,8057857.18
330330,201906,8941,3565,5376,3564858.68,5379232.24,8944090.92
330340,201906,2724,1632,1092,1630732.6,1092810,2723542.6
330350,201906,18297,7284,11013,7277424.5,11015936.68,18293361.18
330360,201906,2332,1170,1162,1167661.76,1160675.94,2328337.70
330370,201906,1037,540,497,541914.7,499000.6,1040915.3
330380,201906,857,372,485,371256,484030.61,855286.61
330385,201906,614,324,290,323352.5,290418,613770.5
330390,201906,5373,2956,2417,2956078.4,2418154.8,5374233.2
330395,201906,301,186,115,185628,114770.7,300398.7
330400,201906,702,383,319,383233,318362,701595
330410,201906,499,362,137,361277.7,136726.4,498004.1
330411,201906,236,131,105,130738.62,104790,235528.62
330412,201906,244,100,144,100798.4,143712,244510.4
330414,201906,5567,2304,3263,2300391.88,3262462.8,5562854.68
330415,201906,579,267,312,267464.7,312374.6,579839.3
330420,201906,2262,1189,1073,1191613.42,1073849.38,2265462.80
330430,201906,1784,857,927,858280.8,926146.8,1784427.6
330440,201906,273,133,140,132734,139720,272454
330450,201906,117,52,65,51896,64870,116766
330452,201906,1822,866,956,865268.52,956084.4,1821352.92
330455,201906,109678,40031,69647,40031253.76,69643471.84,109674725.60
330460,201906,260,106,154,105788,153692.94,259480.94
330470,201906,1222,675,547,677643.3,546905.5,1224548.8
330475,201906,1375,371,1004,371256,1006982,1378238
330480,201906,794,430,364,429140,365268.6,794408.6
330490,201906,13838,4811,9027,4811359.1,9031907.66,13843266.76
330500,201906,1345,604,741,603790,740516.46,1344306.46
330510,201906,11001,3862,7139,3864257.86,7149675.9,11013933.76
330513,201906,101,50,51,49900,50898,100798
330515,201906,827,341,486,340319.26,485029.2,825348.46
330520,201906,2498,934,1564,934128.54,1561870,2495998.54
330530,201906,212,114,98,113772.5,97804.6,211577.1
330540,201906,364,180,184,180638.4,183632,364270.4
330550,201906,2915,1065,1850,1062870.8,1849294.8,2912165.6
330555,201906,807,309,498,308382.96,499000,807382.96
330560,201906,635,209,426,209580,425148.94,634728.94
330570,201906,256,184,72,183632,71856,255488
330575,201906,786,324,462,324350,461077.4,785427.4
330580,201906,3392,1921,1471,1921152.2,1473049.2,3394201.4
330590,201906,307,156,151,155688,150698.98,306386.98
330600,201906,1124,724,400,724548.4,399200,1123748.4
330610,201906,1560,860,700,860277.8,700598.3,1560876.1
330615,201906,199,151,48,150698,47904,198602
330620,201906,1058,437,621,437124.6,621754,1058878.6
330630,201906,4018,2575,1443,2575840.8,1443109.1,4018949.9
350010,201906,600,408,192,408182.82,191616,599798.82
350020,201906,45,21,24,20958,23952,44910
350030,201906,509,321,188,320358.4,187624.8,507983.2
350040,201906,124,48,76,47904,75848,123752
350050,201906,306,165,141,164670,140718.98,305388.98
350055,201906,84,47,37,46906,36926,83832
350060,201906,76,29,47,28942,46906,75848
350070,201906,802,478,324,480070.67,323368.64,803439.31
350075,201906,70,47,23,46906,22954,69860
350080,201906,48,29,19,28942,18962,47904
350090,201906,86,47,39,46906,38922,85828
350100,201906,294,181,113,180638,112774,293412
350110,201906,58,39,19,39920,18962,58882
350115,201906,161,96,65,95808,65868,161676
350120,201906,107,73,34,73852,33932,107784
350130,201906,344,163,181,162674.58,180639.88,343314.46
350140,201906,39,26,13,25948,12974,38922
350150,201906,70,54,16,53892,15968,69860
350160,201906,2530,1006,1524,1005989.26,1523953.92,2529943.18
350170,201906,401,242,159,241517.01,158682.4,400199.41
350180,201906,177,99,78,98802,77844,176646
350190,201906,1017,541,476,539919.59,477044.4,1016963.99
350200,201906,71,26,45,25948,44910,70858
350210,201906,1285,725,560,726547.42,559878.63,1286426.05
350220,201906,671,570,101,571854.63,100798,672652.63
350230,201906,78,53,25,53892,24950,78842
350240,201906,63,45,18,44910,17964,62874
350250,201906,1175,577,598,575847.4,597803.7,1173651.1
350260,201906,89,66,23,66866.5,23952,90818.5
350270,201906,850,562,288,561874.42,287424.4,849298.82
350275,201906,307,129,178,128742,177644,306386
350280,201906,4613,2364,2249,2362273.74,2252490.95,4614764.69
350290,201906,422,202,220,201596,219560.4,421156.4
350300,201906,61,33,28,32934,27944,60878
350310,201906,96,61,35,60878,34930,95808
350315,201906,39,24,15,23952,14970,38922
350320,201906,3263,1605,1658,1602788.9,1656680.6,3259469.5
350330,201906,1667,906,761,907184.23,762473.2,1669657.43
350335,201906,21,14,7,13972,6986,20958
350340,201906,130,61,69,60878,68862.3,129740.3
350350,201906,93,46,47,45908,46906,92814
350360,201906,127,85,42,84830.99,41916,126746.99
350370,201906,86,48,38,47904.63,37924,85828.63
350380,201906,766,329,437,329340.8,437125.2,766466.0
350390,201906,1509,612,897,610777.43,899198.4,1509975.83
350395,201906,27,22,5,21956,4990,26946
350400,201906,1678,876,802,876248.09,803391.62,1679639.71
350410,201906,2388,1073,1315,1072850,1313369.59,2386219.59
350420,201906,238,147,91,146707.03,90818,237525.03
350430,201906,76,46,30,45908,29940,75848
350440,201906,145,105,40,105788.4,39920,145708.4
350450,201906,1639,1008,631,1007983.46,629739.2,1637722.66
350460,201906,338,125,213,124750,212574,337324
350470,201906,16,10,6,9980,5988,15968
350480,201906,168,93,75,92814,76846,169660
350490,201906,234,119,115,118762,115768,234530
350500,201906,48,21,27,20958,26946,47904
350510,201906,168,114,54,113772.9,53892,167664.9
350520,201906,448,215,233,214570,233532,448102
350530,201906,442,209,233,209580,233532,443112
350535,201906,77,63,14,62874,13972,76846
350540,201906,383,193,190,192614,189620,382234
350550,201906,2732,1619,1113,1616762.91,1114771.39,2731534.30
350560,201906,656,460,196,459080.63,195608,654688.63
350570,201906,4077,1737,2340,1735523.63,2340312.93,4075836.56
350580,201906,379,177,202,176646.63,201596.99,378243.62
350590,201906,908,498,410,497004.4,411176.68,908181.08
350600,201906,6146,3066,3080,3067859.09,3081827.37,6149686.46
350610,201906,1530,807,723,807383.26,722552.98,1529936.24
350620,201906,35,23,12,22954,11976,34930
350630,201906,234,136,98,135728.63,97804.63,233533.26
350635,201906,917,374,543,375248.4,543910.8,919159.2
350640,201906,123,94,29,93812,28942,122754
350650,201906,1896,1252,644,1249496.58,644708.98,1894205.56
350660,201906,754,330,424,330338,425148.99,755486.99
350670,201906,312,155,157,154690,156686,311376
350680,201906,180,94,86,94810,85828.8,180638.8
350690,201906,198,105,93,104790,92814,197604
350700,201906,767,366,401,365268.4,402194,767462.4
350710,201906,356,133,223,132734,222554,355288
350715,201906,54,44,10,43912,9980,53892
350720,201906,17,11,6,10978,5988,16966
350730,201906,44,27,17,26946,16966,43912
350740,201906,205,115,90,115768,90818,206586
350745,201906,19,10,9,9980.44,8982,18962.44
350750,201906,2171,1367,804,1364268.38,802392,2166660.38
350760,201906,3725,1651,2074,1648696.66,2073844,3722540.66
350770,201906,63,44,19,43912,18962,62874
350775,201906,47,34,13,33932,12974.98,46906.98
350780,201906,436,220,216,219560,215757,435317
350790,201906,368,154,214,153692,214570,368262
350800,201906,458,270,188,269460,189620,459080
350810,201906,514,413,101,412175.33,100798,512973.33
350820,201906,89,55,34,54890,33932,88822
350830,201906,82,44,38,43912,37924,81836
350840,201906,772,325,447,325348.4,447105.38,772453.78
350850,201906,1754,1008,746,1007980.5,744511.93,1752492.43
350860,201906,584,336,248,335330.46,247504,582834.46
350870,201906,435,296,139,297404,138722,436126
350880,201906,276,151,125,150698,124750,275448
350890,201906,41,28,13,27944,12974,40918
350900,201906,1455,470,985,469061.36,985026,1454087.36
350910,201906,24,14,10,13972,9980,23952
350920,201906,640,349,291,348302,290418,638720
350925,201906,1207,646,561,645706.78,559879.2,1205585.98
350930,201906,99,59,40,58882,39920,98802
350940,201906,719,398,321,397204,320358.36,717562.36
350945,201906,107,78,29,77844,28942,106786
350950,201906,16160,7764,8396,7764445.08,8392188.41,16156633.49
350960,201906,1289,606,683,607782.4,682632.99,1290415.39
350970,201906,1124,592,532,590710.03,532932.4,1123642.43
350980,201906,93,63,30,62874,29940,92814
350990,201906,378,137,241,136726,240518,377244
350995,201906,35,16,19,15968,18962,34930
351000,201906,628,438,190,438123.26,190618,628741.26
351010,201906,52,33,19,32934,18962,51896
351015,201906,55,38,17,37924,16966,54890
351020,201906,1601,964,637,965066.99,637722,1602788.99
351030,201906,347,237,110,237524,109780,347304
351040,201906,862,456,406,456086.48,406186.11,862272.59
351050,201906,3317,1537,1780,1534929.64,1779442.49,3314372.13
351060,201906,5035,2066,2969,2062867.96,2970052.56,5032920.52
351070,201906,409,258,151,258482.97,150698,409180.97
351080,201906,780,564,216,562872,216566,779438
351090,201906,57,26,31,25948,30938,56886
351100,201906,438,253,185,253492.68,184630,438122.68
351110,201906,2084,1007,1077,1005995.96,1077859.96,2083855.92
351120,201906,68,35,33,34930,33932,68862
351130,201906,172,59,113,59880,112774,172654
351140,201906,334,230,104,229540,103792,333332
351150,201906,424,232,192,231536.49,191616,423152.49
351160,201906,265,181,84,181636.4,84830,266466.4
351170,201906,185,105,80,104790,79840,184630
351190,201906,85,58,27,57884,26946,84830
351200,201906,365,245,120,244510.4,119760,364270.4
351210,201906,121,61,60,60878,59880,120758
351220,201906,534,321,213,321357.76,212574,533931.76
351230,201906,281,200,81,199600,80838,280438
351240,201906,233,105,128,104790,127744,232534
351250,201906,72,51,21,50898.53,20958,71856.53
351260,201906,152,113,39,112774,38922,151696
351270,201906,46,19,27,18962,26946,45908
351280,201906,1062,486,576,487025.26,574849.61,1061874.87
351290,201906,233,106,127,105788,126746.4,232534.4
351300,201906,3694,1734,1960,1730455.15,1966061.62,3696516.77
351310,201906,758,390,368,390218,367264.98,757482.98
351320,201906,115,69,46,68862,45908,114770
351330,201906,37,24,13,23952,12974,36926
351340,201906,1230,744,486,743511,485030.95,1228541.95
351350,201906,2557,1492,1065,1489017,1064866,2553883
351360,201906,765,381,384,380238,383232,763470
351370,201906,382,194,188,193612,187624,381236
351380,201906,9177,4155,5022,4159671.09,5019945.39,9179616.48
351385,201906,29,17,12,17964,11976,29940
351390,201906,286,215,71,214570.54,70858,285428.54
351400,201906,65,41,24,40918,23954.94,64872.94
351410,201906,441,278,163,278442.6,162674,441116.6
351420,201906,61,49,12,49900,11976,61876
351430,201906,67,37,30,36926,29940,66866
351440,201906,797,561,236,560878.56,235528.99,796407.55
351450,201906,257,132,125,132734,124750,257484
351460,201906,115,55,60,54890,59880,114770
351470,201906,133,72,61,71856,61876,133732
351480,201906,526,296,230,295409.76,229540,524949.76
351490,201906,287,107,180,106786,179640,286426
351492,201906,34,23,11,22954,10978,33932
351495,201906,27,19,8,18962,7984,26946
351500,201906,3556,1508,2048,1507979.94,2045901.36,3553881.30
351510,201906,1886,777,1109,776444.8,1108778.4,1885223.2
351512,201906,20,16,4,15968,3992,19960
351515,201906,195,113,82,112774,83832.96,196606.96
351518,201906,783,488,295,489020.99,296406,785426.99
351519,201906,72,46,26,45908,25948,71856
351520,201906,150,94,56,94810,55888,150698
351530,201906,22,15,7,14970,6986,21956
351535,201906,130,73,57,72854,56886,129740
351540,201906,458,328,130,327345.05,131736,459081.05
351550,201906,1370,831,539,830337.66,537922,1368259.66
351560,201906,71,40,31,39920,30938.96,70858.96
351565,201906,9,6,3,5988,2994,8982
351570,201906,2661,1386,1275,1384228.38,1273450.97,2657679.35
351580,201906,42,37,5,36926,4990,41916
351590,201906,67,45,22,44910,21956,66866
351600,201906,192,144,48,143712,47904,191616
351610,201906,57,26,31,25948,30938,56886
351620,201906,5909,3351,2558,3352287.27,2559871.66,5912158.93
351630,201906,2686,1387,1299,1388218.9,1298398,2686616.9
351640,201906,1812,873,939,872252.49,938121.03,1810373.52
351650,201906,33,28,5,27944,4990,32934
351660,201906,137,88,49,87824,48902,136726
351670,201906,726,449,277,448103.2,276446,724549.2
351680,201906,72,57,15,56886,14970,71856
351685,201906,32,19,13,18962,12974,31936
351690,201906,302,213,89,212574.45,88822,301396.45
351700,201906,157,111,46,110778.4,45908,156686.4
351710,201906,71,48,23,47904,22954,70858
351720,201906,125,63,62,63872,61876,125748
351730,201906,99,68,31,67864.63,30938.63,98803.26
351740,201906,723,476,247,476047.66,250498,726545.66
351750,201906,356,150,206,150698,206586,357284
351760,201906,778,589,189,587822,188622,776444
351770,201906,304,260,44,259480,43912,303392
351780,201906,161,93,68,92814.98,67864,160678.98
351790,201906,254,133,121,132734,120758,253492
351800,201906,46,30,16,29940,15968,45908
351810,201906,123,84,39,83832,38922,122754
351820,201906,855,619,236,620757.6,235529.39,856286.99
351830,201906,522,191,331,190618,331336,521954
351840,201906,1857,947,910,945107.44,913172.97,1858280.41
351850,201906,236,173,63,172654.3,63872.96,236527.26
351860,201906,701,481,220,480040.41,219560,699600.41
351870,201906,5618,2692,2926,2690611.74,2923144.73,5613756.47
351880,201906,19004,8057,10947,8062852.07,10958083.38,19020935.45
351885,201906,88,59,29,59880,28942,88822
351890,201906,70,59,11,59880,10978,70858
351900,201906,223,133,90,132734.4,90818,223552.4
351905,201906,73,29,44,28942,43912,72854
351907,201906,3334,1435,1899,1437121.34,1899198.54,3336319.88
351910,201906,183,78,105,77844,104790,182634
351920,201906,123,69,54,68862,53893.98,122755.98
351925,201906,89,60,29,59880,28942,88822
351930,201906,385,249,136,249500,135728,385228
351940,201906,237,108,129,107784,129740,237524
351950,201906,136,77,59,76846,58882,135728
351960,201906,909,434,475,433445,474050.4,907495.4
351970,201906,1883,1020,863,1018958.4,866265.78,1885224.18
351980,201906,152,79,73,78842,72854,151696
351990,201906,268,176,92,176646.8,92814,269460.8
352000,201906,353,219,134,218563.2,133732,352295.2
352010,201906,389,244,145,244510,144710,389220
352020,201906,189,66,123,65868,122754,188622
352030,201906,1067,559,508,558880,509978,1068858
352040,201906,578,247,331,247504,330338,577842
352042,201906,286,90,196,89820,195608.8,285428.8
352044,201906,367,218,149,217564,148702,366266
352050,201906,3323,1303,2020,1304388.76,2018954,3323342.76
352060,201906,103,64,39,63872,38922.4,102794.4
352070,201906,94,68,26,67865.26,25948,93813.26
352080,201906,67,41,26,40918,25948,66866
352090,201906,165,111,54,110778,53892,164670
352100,201906,265,129,136,128743.39,135730.38,264473.77
352110,201906,116,35,81,34930,80838,115768
352115,201906,62,23,39,22954,38922,61876
352120,201906,89,63,26,62874.63,25948,88822.63
352130,201906,220,182,38,182634.4,37924,220558.4
352140,201906,188,82,106,81836,105788.4,187624.4
352150,201906,117,64,53,63872,52894,116766
352160,201906,138,87,51,86826,50898,137724
352170,201906,377,267,110,266466,109780,376246
352180,201906,606,401,205,400198,204590.99,604788.99
352190,201906,255,102,153,101796,152694,254490
352200,201906,32,17,15,16966,14970,31936
352210,201906,3949,1675,2274,1673649.77,2270452.63,3944102.40
352215,201906,54,31,23,30938,22954,53892
352220,201906,7070,2694,4376,2693604.65,4373240.79,7066845.44
352230,201906,3264,2112,1152,2111782.89,1150703.63,3262486.52
352240,201906,2333,1352,981,1350294.89,980036.9,2330331.79
352250,201906,2637,1353,1284,1352293.35,1283430.37,2635723.72
352260,201906,1020,545,475,543910.8,475048.8,1018959.6
352265,201906,60,26,34,25948,33932,59880
352270,201906,413,245,168,244510,167665.88,412175.88
352280,201906,418,268,150,268462.63,149700,418162.63
352290,201906,175,109,66,108782,65868,174650
352300,201906,94,71,23,70858,22954,93812
352310,201906,6004,2861,3143,2863267.95,3142706.29,6005974.24
352320,201906,968,509,459,507982.4,460078,968060.4
352330,201906,514,249,265,249500,266466.4,515966.4
352340,201906,1373,662,711,662672.8,710577.2,1373250.0
352350,201906,334,206,128,205588,127744.4,333332.4
352360,201906,219,95,124,94810,124750.2,219560.2
352370,201906,108,72,36,71856,36926,108782
352380,201906,117,75,42,74850,41916,116766
352390,201906,2474,1122,1352,1123749.61,1353290.18,2477039.79
352400,201906,487,215,272,214570,272454.4,487024.4
352410,201906,846,602,244,600796.63,243512,844308.63
352420,201906,104,70,34,69860,33932,103792
352430,201906,1768,807,961,807385.32,962074.61,1769459.93
352440,201906,3113,1573,1540,1575843.84,1538920.72,3114764.56
352450,201906,199,166,33,165668,33932,199600
352460,201906,607,317,290,316367.39,289420,605787.39
352470,201906,632,218,414,217564,417164.98,634728.98
352480,201906,1378,781,597,781434,597802.4,1379236.4
352490,201906,65,24,41,23952,40918,64870
352500,201906,1206,545,661,544908.34,660677.38,1205585.72
352510,201906,750,407,343,406187.26,342314,748501.26
352520,201906,600,276,324,276446,327344,603790
352530,201906,1734,921,813,921154.4,815366.4,1736520.8
352540,201906,73,49,24,48902,23952,72854
352550,201906,181,106,75,105788,74850,180638
352560,201906,51,40,11,39920,10978,50898
352570,201906,673,352,321,352295.43,321356,673651.43
352580,201906,57,41,16,40918,15968,56886
352585,201906,19,7,12,6986,11976,18962
352590,201906,4423,2238,2185,2238514.63,2186619.78,4425134.41
352600,201906,344,244,100,243512,99800,343312
352610,201906,964,436,528,436126.97,529938,966064.97
352620,201906,991,396,595,395208,593810,989018
352630,201906,171,61,110,60878,109780,170658
352640,201906,547,378,169,377244,168662,545906
352650,201906,86,59,27,58882,26946,85828
352660,201906,71,43,28,42914,27944,70858
352670,201906,1637,897,740,898201.59,739527.9,1637729.49
352680,201906,916,586,330,585828.03,331336.6,917164.63
352690,201906,4456,2033,2423,2032929.15,2419152.66,4452081.81
352700,201906,115,70,45,69860,44910,114770
352710,201906,1360,737,623,737522,622752,1360274
352720,201906,1336,638,698,636724,696604.4,1333328.4
352725,201906,23,21,2,20958,1996,22954
352730,201906,384,202,182,201596,182634,384230
352740,201906,420,274,146,274451.18,145708.68,420159.86
352750,201906,19,13,6,12974,5988,18962
352760,201906,186,126,60,125748,60878,186626
352770,201906,79,62,17,61876,16966,78842
352780,201906,75,40,35,39920,34930,74850
352790,201906,28,23,5,22954.63,4990,27944.63
352800,201906,245,174,71,173652,70858,244510
352810,201906,159,101,58,101796.63,57884,159680.63
352820,201906,67,55,12,54890,11976,66866
352830,201906,91,63,28,62874,27944,90818
352840,201906,661,350,311,349300.5,310378,659678.5
352850,201906,1417,492,925,491016,924148,1415164
352860,201906,132,84,48,84830,47904,132734
352870,201906,45,27,18,26946,17964.4,44910.4
352880,201906,187,125,62,124750.9,61876,186626.9
352885,201906,29,21,8,20958,7984,28942
352890,201906,55,37,18,37924,17964.4,55888.4
352900,201906,4777,2314,2463,2314370.12,2463072.81,4777442.93
352910,201906,40,33,7,32934,6986,39920
352920,201906,681,412,269,412174,268462,680636
352930,201906,1230,598,632,597813.76,630780.02,1228593.78
352940,201906,6414,2721,3693,2722548.01,3694603.49,6417151.50
352950,201906,95,37,58,36926,57884,94810
352960,201906,56,39,17,38922,16966,55888
352965,201906,20,10,10,9980,9980,19960
352970,201906,514,391,123,392214.02,122755.61,514969.63
352980,201906,165,87,78,86826,77844,164670
352990,201906,980,439,541,439120,540916,980036
353000,201906,64,30,34,29940,33932,63872
353010,201906,548,339,209,338322,209580,547902
353020,201906,288,208,80,207584,80838,288422
353030,201906,1230,566,664,566864.34,663670.98,1230535.32
353040,201906,89,58,31,57884,30938,88822
353050,201906,1327,850,477,849299.69,476046,1325345.69
353060,201906,8431,3786,4645,3782428.23,4637716.48,8420144.71
353070,201906,1693,1079,614,1079838.96,612594.35,1692433.31
353080,201906,1295,676,619,675647.16,617762,1293409.16
353090,201906,58,32,26,31936,25948,57884
353100,201906,58,47,11,46906,10978,57884
353110,201906,2060,641,1419,641714.4,1419157.19,2060871.59
353120,201906,92,50,42,49900,41916,91816
353130,201906,855,409,446,409182.76,445109.96,854292.72
353140,201906,551,220,331,221556,330338,551894
353150,201906,350,199,151,198602.63,150698,349300.63
353160,201906,93,79,14,78842,13972,92814
353170,201906,186,63,123,62874,122755.96,185629.96
353180,201906,989,467,522,466066,522952.7,989018.7
353190,201906,499,359,140,358282.3,139720,498002.3
353200,201906,207,108,99,107784,98802,206586
353205,201906,23,16,7,15968,6986,22954
353210,201906,83,49,34,48902,33932,82834
353215,201906,50,28,22,28942,21956,50898
353220,201906,83,47,36,46906,35928,82834
353230,201906,160,66,94,65868,93812,159680
353240,201906,302,163,139,162674,138722,301396
353250,201906,205,106,99,105788,98802,204590
353260,201906,455,325,130,324351.1,129740,454091.1
353270,201906,68,51,17,50898,16966,67864
353280,201906,103,56,47,55888.6,46906,102794.6
353282,201906,128,87,41,86826,41916,128742
353284,201906,26,19,7,18962,6986,25948
353286,201906,0,0,0,0,0,0
353290,201906,76,44,32,43912,31936,75848
353300,201906,431,241,190,240519.26,191616,432135.26
353310,201906,47,41,6,40918,5988,46906
353320,201906,60,37,23,37924,22954,60878
353325,201906,55,32,23,31936,22955.36,54891.36
353330,201906,62,43,19,43912.7,18962,62874.7
353340,201906,611,212,399,212574,398203.39,610777.39
353350,201906,905,438,467,437126.6,468065.74,905192.34
353360,201906,105,84,21,83832,20958.4,104790.4
353370,201906,121,66,55,65868,55888,121756
353380,201906,32,21,11,20958.99,10978,31936.99
353390,201906,1110,540,570,539918,570856,1110774
353400,201906,46,28,18,27944,17964,45908
353410,201906,106,67,39,66866,38922.9,105788.9
353420,201906,59,24,35,23952,34930,58882
353430,201906,583,392,191,393213.38,190618,583831.38
353440,201906,10581,4712,5869,4714558.98,5865258.32,10579817.30
353450,201906,55,31,24,30938,23952,54890
353460,201906,600,332,268,331336.1,268462,599798.1
353470,201906,2138,1152,986,1149700.19,984031.96,2133732.15
353475,201906,230,155,75,154691.38,74850,229541.38
353480,201906,184,153,31,152694,30938.4,183632.4
353490,201906,240,147,93,146706,93812.4,240518.4
353500,201906,192,111,81,110778.63,81836,192614.63
353510,201906,103,75,28,74850.98,27944,102794.98
353520,201906,207,145,62,144710,61876,206586
353530,201906,474,258,216,257484,217564,475048
353540,201906,370,249,121,249500,120758,370258
353550,201906,743,484,259,483033.24,260478,743511.24
353560,201906,602,247,355,246506,354290.6,600796.6
353570,201906,66,35,31,34930.4,30938,65868.4
353580,201906,355,271,84,270458.34,83832,354290.34
353590,201906,92,64,28,63872,27944,91816
353600,201906,273,157,116,156686.63,115768,272454.63
353610,201906,118,64,54,63872,53892,117764
353620,201906,607,317,290,316366,291416,607782
353625,201906,51,29,22,28942,21956,50898
353630,201906,237,176,61,175648.58,60878,236526.58
353640,201906,128,87,41,86826,40918,127744
353650,201906,910,359,551,358282,550896,909178
353657,201906,24,18,6,17964,5988,23952
353660,201906,263,142,121,141716,120758,262474
353670,201906,768,461,307,463073.03,306386,769459.03
353680,201906,107,77,30,76846.5,29940,106786.5
353690,201906,46,36,10,35928.52,9980,45908.52
353700,201906,280,200,80,199600.09,79840,279440.09
353710,201906,457,219,238,218562.6,237524.4,456087.0
353715,201906,47,34,13,33932,12974,46906
353720,201906,347,163,184,163672.98,183632,347304.98
353730,201906,1112,690,422,688621.2,422154.8,1110776.0
353740,201906,633,349,284,349300,284430,633730
353750,201906,82,52,30,52894,29940,82834
353760,201906,2839,1090,1749,1088820.75,1746502.18,2835322.93
353770,201906,90,74,16,73852,15968,89820
353780,201906,1205,578,627,577842.63,627742,1205584.63
353790,201906,512,303,209,303392.96,210578.4,513971.36
353800,201906,3270,1640,1630,1643709.89,1630804.34,3274514.23
353810,201906,229,131,98,130738.98,97804.98,228543.96
353820,201906,192,92,100,91816,99800,191616
353830,201906,48,41,7,40918,6986,47904
353850,201906,174,88,86,87824,85828,173652
353860,201906,497,223,274,223552,273452,497004
353870,201906,5237,2675,2562,2679635.68,2564862.8,5244498.48
353880,201906,688,484,204,483032.4,203592,686624.4
353890,201906,579,335,244,334330.4,243512.84,577843.24
353900,201906,131,68,63,67864,62874,130738
353910,201906,172,84,88,83832,87824,171656
353920,201906,438,243,195,243512.3,194610.99,438123.29
353930,201906,992,590,402,590816,401198.14,992014.14
353940,201906,192,103,89,102794,88822,191616
353950,201906,517,320,197,319360,197604.98,516964.98
353960,201906,73,59,14,58882,13972,72854
353970,201906,67,38,29,37924,28942,66866
353980,201906,1604,768,836,768460,835329.96,1603789.96
353990,201906,75,44,31,43912,30938,74850
354000,201906,364,182,182,182634,182634.99,365268.99
354010,201906,93,51,42,50898,41916,92814
354020,201906,530,337,193,337324,193612,530936
354025,201906,55,45,10,44910,9980,54890
354030,201906,61,37,24,36926,23952,60878
354040,201906,100,73,27,72854,26946,99800
354050,201906,188,99,89,99800.4,88822,188622.4
354060,201906,757,371,386,370258.4,386226,756484.4
354070,201906,929,552,377,550897.28,376246.4,927143.68
354075,201906,220,112,108,111776,107784,219560
354080,201906,307,130,177,129740,176646,306386
354085,201906,21,13,8,12974,7984,20958
354090,201906,302,169,133,168578,132734,301312
354100,201906,5557,2388,3169,2395201.56,3169650.92,5564852.48
354105,201906,91,45,46,44910,45908,90818
354110,201906,49,23,26,22954,25948,48902
354120,201906,133,94,39,93812.98,38922,132734.98
354130,201906,699,457,242,456086,241518.37,697604.37
354140,201906,3135,1459,1676,1459076.4,1675642,3134718.4
354150,201906,639,396,243,397205.76,244510,641715.76
354160,201906,683,438,245,438122.4,244510.4,682632.8
354165,201906,20,14,6,13972,5988,19960
354170,201906,181,123,58,123752,57884,181636
354180,201906,67,41,26,40918.51,25948,66866.51
354190,201906,200,90,110,89820,109780,199600
354200,201906,120,65,55,64870,54890,119760
354210,201906,62,29,33,28942,32934,61876
354220,201906,644,403,241,402194,240518,642712
354230,201906,162,69,93,68862.6,92814,161676.6
354240,201906,326,213,113,212574.64,112774,325348.64
354250,201906,84,50,34,49900,33932,83832
354260,201906,2058,960,1098,960079.87,1099797.67,2059877.54
354270,201906,95,69,26,68862,25948,94810
354280,201906,41,22,19,21956,18962,40918
354290,201906,139,97,42,96806,41916,138722
354300,201906,409,281,128,281436.63,127744.26,409180.89
354310,201906,99,74,25,73852.4,24950,98802.4
354320,201906,190,98,92,97804,91816.4,189620.4
354323,201906,14,13,1,12974,998,13972
354325,201906,112,67,45,66866.6,44910,111776.6
354330,201906,2589,860,1729,859136.8,1728538.01,2587674.81
354340,201906,10572,5182,5390,5183634.03,5389206.73,10572840.76
354350,201906,120,79,41,78842,40918,119760
354360,201906,85,47,38,46906,37924,84830
354370,201906,256,140,116,141716,116766,258482
354380,201906,197,118,79,117764,78842,196606
354390,201906,2690,982,1708,986025.94,1706580.98,2692606.92
354400,201906,318,171,147,170658,147704.4,318362.4
354410,201906,618,297,321,296406.4,321356.4,617762.8
354420,201906,275,175,100,174650,99800,274450
354425,201906,311,182,129,181636,129740,311376
354430,201906,181,110,71,109780,70858,180638
354440,201906,34,25,9,24950,8982,33932
354450,201906,49,36,13,35928,12974,48902
354460,201906,102,59,43,58882,42914,101796
354470,201906,39,23,16,22954,15968,38922
354480,201906,116,61,55,60878.98,55888,116766.98
354490,201906,147,92,55,91816,54890,146706
354500,201906,391,196,195,196606,194610,391216
354510,201906,96,70,26,69860,25948,95808
354515,201906,36,12,24,11976,23952,35928
354520,201906,1609,699,910,702450.8,911174.8,1613625.6
354530,201906,728,371,357,371257.79,357284,728541.79
354540,201906,277,154,123,153692,122754,276446
354550,201906,41,24,17,23952,16966,40918
354560,201906,156,86,70,85828,69860,155688
354570,201906,140,92,48,91816.5,47904,139720.5
354580,201906,1936,922,1014,924149.89,1011973.39,1936123.28
354600,201906,247,140,107,140718.2,106786,247504.2
354610,201906,75,64,11,63872.46,10978.98,74851.44
354620,201906,60,18,42,17964,41916,59880
354625,201906,16,11,5,10978,4990.99,15968.99
354630,201906,315,209,106,208582.98,105788,314370.98
354640,201906,803,524,279,522952.3,279440,802392.3
354650,201906,75,43,32,42914,31936.98,74850.98
354660,201906,804,600,204,598801.03,204590,803391.03
354670,201906,259,92,167,91816.76,169660.6,261477.36
354680,201906,1266,474,792,475048,790416,1265464
354690,201906,80,53,27,52894.4,26946,79840.4
354700,201906,71,51,20,50898,19960,70858
354710,201906,48,35,13,34930,12974,47904
354720,201906,21,21,0,20958,0,20958
354730,201906,1766,754,1012,752493.78,1011972.4,1764466.18
354740,201906,64,46,18,45908,17964,63872
354750,201906,435,254,181,253492.98,180638,434130.98
354760,201906,487,296,191,296407.86,190618.4,487026.26
354765,201906,10,5,5,4990,4990,9980
354770,201906,344,224,120,223552,120758,344310
354780,201906,8155,3263,4892,3263472.97,4894215.17,8157688.14
354790,201906,104,59,45,58882,44910,103792
354800,201906,439,242,197,241516,196606.4,438122.4
354805,201906,101,49,52,48902,51896,100798
354810,201906,111,67,44,66866,44910,111776
354820,201906,191,84,107,83832.56,106786,190618.56
354830,201906,39,20,19,20958,18962,39920
354840,201906,61,41,20,40918,19960,60878
354850,201906,4564,2055,2509,2058875.6,2509971.1,4568846.7
354860,201906,327,155,172,154690,172654.93,327344.93
354870,201906,12566,5662,6904,5656676.4,6902177.11,12558853.51
354880,201906,3010,1122,1888,1121752.69,1889218.36,3010971.05
354890,201906,2889,1588,1301,1587821.73,1300394,2888215.73
354900,201906,62,42,20,41916,20958,62874
354910,201906,1249,667,582,665667.03,583830,1249497.03
354920,201906,48,40,8,39920,7984,47904
354925,201906,13,8,5,7984,4990,12974
354930,201906,33,30,3,29940.43,2994,32934.43
354940,201906,838,612,226,611026.5,226546,837572.5
354950,201906,209,138,71,137724.6,70858,208582.6
354960,201906,160,61,99,60878,98802.4,159680.4
354970,201906,915,612,303,610777.77,302394.4,913172.17
354980,201906,8566,3176,5390,3177635.56,5398193.42,8575828.98
354990,201906,8952,4238,4714,4244500.91,4719595.78,8964096.69
354995,201906,554,187,367,186626,366266,552892
355000,201906,481,163,318,162674,317364,480038
355010,201906,601,379,222,378242.4,222554.6,600797.0
355020,201906,745,464,281,464070.32,280440.38,744510.70
355030,201906,209540,81998,127542,81956617.88,127488705.09,209445322.97
355040,201906,742,353,389,352294.4,388222,740516.4
355050,201906,152,102,50,101797.4,49900,151697.4
355060,201906,1577,806,771,807383.2,772452.6,1579835.8
355070,201906,1434,696,738,695607.81,736525.61,1432133.42
355080,201906,200,120,80,119760,80838,200598
355090,201906,280,175,105,174650.22,104790.32,279440.54
355100,201906,4924,2423,2501,2423049.82,2498994.19,4922044.01
355110,201906,264,174,90,173653.39,90818,264471.39
355120,201906,82,61,21,60878,20958.98,81836.98
355130,201906,57,32,25,31936,24950,56886
355140,201906,187,121,66,120758,65868,186626
355150,201906,689,413,276,413173.39,276446,689619.39
355160,201906,466,222,244,221556.63,243512.4,465069.03
355170,201906,2085,1093,992,1093808,991014,2084822
355180,201906,671,283,388,282434,387224,669658
355190,201906,219,154,65,153692,64870,218562
355200,201906,115,67,48,66866,47904,114770
355210,201906,692,409,283,408182,283432.98,691614.98
355220,201906,7050,3739,3311,3741507.87,3308372.78,7049880.65
355230,201906,105,63,42,62874,41916,104790
355240,201906,4392,1881,2511,1885225.92,2513964.37,4399190.29
355250,201906,5574,2668,2906,2664662.87,2903188.61,5567851.48
355255,201906,49,31,18,30938,17964,48902
355260,201906,184,111,73,110778.4,72855.96,183634.36
355270,201906,169,106,63,105788,62874,168662
355280,201906,6334,2622,3712,2620750.4,3709567.78,6330318.18
355290,201906,75,58,17,58882,16966,75848
355300,201906,192,123,69,122754,68862.4,191616.4
355310,201906,114,64,50,63872,49900,113772
355320,201906,88,47,41,46906,40918,87824
355330,201906,280,159,121,158682,120758,279440
355340,201906,1565,527,1038,525946.4,1037920,1563866.4
355350,201906,127,67,60,66866,59880,126746
355360,201906,174,111,63,110778,62874,173652
355365,201906,24,19,5,18962,4990,23952
355370,201906,1040,608,432,607796.18,433140.22,1040936.40
355380,201906,796,523,273,521954,272454,794408
355385,201906,69,49,20,48902,19960,68862
355390,201906,105,62,43,61876,42914,104790
355395,201906,187,112,75,111776.47,74850,186626.47
355400,201906,1617,990,627,990186.62,627743.99,1617930.61
355410,201906,4870,2317,2553,2320355.38,2553888.14,4874243.52
355420,201906,50,36,14,35928,13972,49900
355430,201906,355,213,142,213572,143712,357284
355440,201906,79,48,31,47904,30938,78842
355450,201906,452,227,225,226546.88,224550.4,451097.28
355460,201906,66,50,16,49900.54,15968,65868.54
355465,201906,50,32,18,31936,17964,49900
355470,201906,179,73,106,72854.7,106786,179640.7
355475,201906,13,9,4,8982,3992,12974
355480,201906,467,207,260,206586.6,259480,466066.6
355490,201906,120,87,33,86826,32934,119760
355495,201906,57,30,27,29940,26946,56886
355500,201906,1629,905,724,905188.79,722554.96,1627743.75
355510,201906,274,198,76,197605.26,75848,273453.26
355520,201906,33,26,7,25948.4,6986,32934.4
355530,201906,21,14,7,13972,6986,20958
355535,201906,78,38,40,37924,39920,77844
355540,201906,2372,946,1426,944249.11,1425145.61,2369394.72
355550,201906,61,38,23,37924,22954,60878
355560,201906,248,119,129,118762,129740,248502
355570,201906,26,18,8,17964,7984,25948
355580,201906,251,174,77,173652,76847.39,250499.39
355590,201906,21,14,7,13972,6986,20958
355600,201906,273,140,133,139720,132734,272454
355610,201906,231,155,76,155688,76846,232534
355620,201906,1328,630,698,632732.4,696604.99,1329337.39
355630,201906,438,324,114,324350,113772.63,438122.63
355635,201906,123,59,64,58882,63873.97,122755.97
355640,201906,560,317,243,316366,242514,558880
355645,201906,832,356,476,355288,475048.4,830336.4
355650,201906,2078,884,1194,884229.74,1192610.98,2076840.72
355660,201906,255,142,113,141716,112774,254490
355670,201906,540,217,323,216566,323352,539918
355680,201906,205,117,88,116766.97,87824,204590.97
355690,201906,93,45,48,44910,47904,92814
355695,201906,13,9,4,8982,3992,12974
355700,201906,1141,597,544,598800.66,543910.8,1142711.46
355710,201906,2221,1224,997,1223550.63,997002,2220552.63
355715,201906,19,16,3,15968,2994,18962
355720,201906,205,124,81,123752.44,80838,204590.44
355730,201906,96,55,41,54890,40918,95808
410010,201906,129,109,20,108782,19960,128742
410020,201906,106,90,16,89820,15968,105788
410030,201906,162,104,58,103792.6,57884,161676.6
410040,201906,1068,571,497,573850,499000.6,1072850.6
410045,201906,31,26,5,25948,4990,30938
410050,201906,470,270,200,271456,200598,472054
410060,201906,278,211,67,210578,66866,277444
410070,201906,308,254,54,255488,53892,309380
410080,201906,169,110,59,109780,58882,168662
410090,201906,79,70,9,69860.56,8982,78842.56
410100,201906,296,215,81,216566,80838,297404
410105,201906,46,29,17,28942,16966,45908
410110,201906,325,201,124,200598,123752,324350
410115,201906,32,23,9,22954,8982,31936
410120,201906,412,217,195,217564,194610,412174
410130,201906,46,29,17,28942,16966,45908
410140,201906,3157,1548,1609,1545904.44,1606782.6,3152687.04
410150,201906,2705,1086,1619,1084826.74,1617758.8,2702585.54
410160,201906,508,317,191,316366,190618.4,506984.4
410165,201906,67,44,23,43912,22954,66866
410170,201906,166,119,47,118762.4,46906,165668.4
410180,201906,2185,1255,930,1254486.4,932133.59,2186619.99
410185,201906,36,31,5,30938,4990,35928
410190,201906,499,332,167,331336.51,166666,498002.51
410200,201906,954,717,237,717562,236526,954088
410210,201906,578,301,277,302394,278442.4,580836.4
410220,201906,45,23,22,22954,21956,44910
410230,201906,142,73,69,73852,68862,142714
410240,201906,753,494,259,493012.8,259480,752492.8
410250,201906,384,282,102,281436,102794,384230
410260,201906,296,169,127,168662.4,126746,295408.4
410270,201906,32,22,10,21956,9980,31936
410275,201906,60,45,15,45908,14970,60878
410280,201906,324,188,136,187624,135728,323352
410290,201906,237,151,86,150698,86826,237524
410300,201906,77,59,18,58882,17964,76846
410302,201906,19,12,7,11976,6986,18962
410304,201906,41,27,14,27944,13972,41916
410305,201906,214,115,99,115768,98802,214570
410310,201906,219,134,85,133732,84830,218562
410315,201906,49,35,14,34930,13972,48902
410320,201906,135,95,40,95808,39920,135728
410322,201906,35,23,12,22954,11976,34930
410330,201906,178,127,51,126746,50898.6,177644.6
410335,201906,102,58,44,57884,43912,101796
410337,201906,41,35,6,34930,5988,40918
410340,201906,34,31,3,30938,2994,33932
410345,201906,217,132,85,131736,84830,216566
410347,201906,52,39,13,39920,12974,52894
410350,201906,241,147,94,146706,93812,240518
410360,201906,471,294,177,293412.8,177645.2,471058.0
410370,201906,2374,1017,1357,1015965.08,1358279.64,2374244.72
410380,201906,218,134,84,133732,83832,217564
410390,201906,378,274,104,273452.99,103792,377244.99
410395,201906,30,19,11,18962,10978,29940
410400,201906,830,409,421,408183.61,420593.5,828777.11
410405,201906,93,71,22,70858,21956,92814
410410,201906,35,28,7,27944,6986,34930
410420,201906,1657,815,842,816277.16,841314.34,1657591.50
410425,201906,170,78,92,77844.6,91816,169660.6
410430,201906,2205,1281,924,1280434.74,923150.56,2203585.30
410440,201906,376,275,101,274450,100798,375248
410442,201906,352,240,112,240518.7,111776,352294.7
410445,201906,408,290,118,289420,117764,407184
410450,201906,379,196,183,195608,182634,378242
410460,201906,469,252,217,251496,216566,468062
410465,201906,209,133,76,132734,75848,208582
410470,201906,229,145,84,145708,83832,229540
410480,201906,6030,2995,3035,2992015.17,3031934.41,6023949.58
410490,201906,1414,911,503,910176.84,502992.4,1413169.24
410500,201906,262,153,109,152694,108782,261476
410510,201906,166,125,41,124750,40918.98,165668.98
410520,201906,253,189,64,189620,63872,253492
410530,201906,231,85,146,86826,145708.99,232534.99
410540,201906,314,230,84,229540.99,83832,313372.99
410550,201906,1675,754,921,753490.4,921154.8,1674645.2
410560,201906,141,106,35,105788,34930,140718
410570,201906,437,298,139,297405.32,138722,436127.32
410580,201906,3360,1524,1836,1523947.32,1833327,3357274.32
410590,201906,406,284,122,283432,121756,405188
410600,201906,191,164,27,163672,26946,190618
410610,201906,56,47,9,46906,8982,55888
410620,201906,239,172,67,171656,66866,238522
410630,201906,443,262,181,262474,180638,443112
410640,201906,1032,651,381,650697.3,380238.99,1030936.29
410645,201906,103,78,25,77844.2,24950,102794.2
410650,201906,360,241,119,242514,118762,361276
410655,201906,80,59,21,58882,20958,79840
410657,201906,22,9,13,8982,12974,21956
410660,201906,611,434,177,435128.31,176646,611774.31
410670,201906,73,62,11,61876,10978,72854
410680,201906,201,166,35,165668,34930,200598
410685,201906,19,11,8,10978,7984,18962
410690,201906,28164,12212,15952,12212447.05,15955749.83,28168196.88
410700,201906,329,242,87,241516.4,86826,328342.4
410710,201906,127,106,21,105788,20958,126746
410712,201906,23,16,7,15968,6986,22954
410715,201906,88,67,21,66866,20958,87824
410720,201906,701,401,300,401196,302394.98,703590.98
410725,201906,185,135,50,134730,49900,184630
410730,201906,91,52,39,51896,38922,90818
410740,201906,115,84,31,83832,30938,114770
410750,201906,241,167,74,167664,73852,241516
410752,201906,24,15,9,14970,8982,23952
410753,201906,49,23,26,22954,25948,48902
410754,201906,43,27,16,26946.4,15968,42914.4
410755,201906,81,54,27,53892,27944,81836
410760,201906,738,418,320,418162.4,319360,737522.4
410765,201906,1713,827,886,825348.68,885227.2,1710575.88
410770,201906,109,86,23,85828,22954,108782
410773,201906,54,41,13,40918,12974,53892
410775,201906,185,136,49,135728,49900,185628
410780,201906,82,45,37,45908,36926,82834
410785,201906,57,45,12,44910.44,11976,56886.44
410790,201906,73,37,36,36926,35928,72854
410800,201906,282,176,106,176646,105788,282434
410810,201906,22,19,3,18962,2994.4,21956.4
410820,201906,183,134,49,133732,48902,182634
410830,201906,8498,3807,4691,3806378.05,4689612.17,8495990.22
410832,201906,105,77,28,76846,27944,104790
410840,201906,1411,792,619,792414.97,621756.46,1414171.43
410845,201906,68,44,24,43912.4,23952,67864.4
410850,201906,193,137,56,136726,55888,192614
410855,201906,51,44,7,43912,6986,50898
410860,201906,703,406,297,406186.4,298402,704588.4
410865,201906,100,77,23,76846,22954,99800
410870,201906,153,129,24,128742,23952,152694
410880,201906,1116,575,541,573856.14,540920.88,1114777.02
410890,201906,82,56,26,55888,25948,81836
410895,201906,71,55,16,54890,15968,70858
410900,201906,23,16,7,15968,6986,22954
410910,201906,15,13,2,12974,1996,14970
410920,201906,36,24,12,23952,11976,35928
410930,201906,503,323,180,322354,180638,502992
410940,201906,4381,2527,1854,2526938.82,1859274.8,4386213.62
410950,201906,108,82,26,81836,25948,107784
410960,201906,778,344,434,344310,434130.61,778440.61
410965,201906,66,53,13,52894,12974,65868
410970,201906,629,456,173,455088,172654,627742
410975,201906,114,68,46,67864.72,45908,113772.72
410980,201906,1634,749,885,747502.55,885226.99,1632729.54
410990,201906,263,183,80,184630,79840,264470
411000,201906,66,43,23,42914,22954.4,65868.4
411005,201906,28,22,6,21956,5988,27944
411007,201906,252,146,106,145708,105788,251496
411010,201906,598,416,182,416166,181636,597802
411020,201906,295,205,90,204590,90818,295408
411030,201906,15,8,7,7984,6986,14970
411040,201906,56,42,14,41916,13972,55888
411050,201906,213,167,46,167664,45908,213572
411060,201906,518,357,161,357284.98,160678,517962.98
411065,201906,65,56,9,55888,8982,64870
411070,201906,1225,773,452,773451.54,452094,1225545.54
411080,201906,230,162,68,162674,67864,230538
411090,201906,107,81,26,80838,25948,106786
411095,201906,278,113,165,112774,164670,277444
411100,201906,114,95,19,94810,18962,113772
411110,201906,120,82,38,82834,37924,120758
411120,201906,193,141,52,140718,52894,193612
411125,201906,205,94,111,93812,110778,204590
411130,201906,125,106,19,105788,18962,124750
411140,201906,207,138,69,137724,68862,206586
411150,201906,1234,826,408,824348,408183.37,1232531.37
411155,201906,122,82,40,83832,39920,123752
411160,201906,26,12,14,11976,13972,25948
411170,201906,51,47,4,46906,3992,50898
411180,201906,988,666,322,664668.83,321356,986024.83
411190,201906,337,194,143,193612,143712,337324
411200,201906,670,435,235,436126.63,234530,670656.63
411210,201906,699,380,319,380238,320358.98,700596.98
411220,201906,149,110,39,110778,38922,149700
411230,201906,42,35,7,35928,6986,42914
411240,201906,121,81,40,80838,39920,120758
411250,201906,439,322,117,322354,116766,439120
411260,201906,20,13,7,12974,6986,19960
411270,201906,277,147,130,147704,130738,278442
411275,201906,201,176,25,175648,24950,200598
411280,201906,220,156,64,155688.63,63872,219560.63
411290,201906,60,46,14,45908,13972,59880
411295,201906,143,114,29,113772,28942,142714
411300,201906,69,35,34,34930,33932,68862
411310,201906,93,72,21,71856,20958,92814
411320,201906,753,528,225,526944,224550.6,751494.6
411325,201906,64,42,22,41916,21956,63872
411330,201906,911,585,326,586824.5,327344.16,914168.66
411340,201906,27,19,8,18962,7984.34,26946.34
411342,201906,69,52,17,51896,16966,68862
411345,201906,118,60,58,59880,57884,117764
411350,201906,486,388,98,387324.38,97804.4,485128.78
411360,201906,53,34,19,33932,18962,52894
411370,201906,14319,5898,8421,5900181.99,8419144.42,14319326.41
411373,201906,177,131,46,130738,46906,177644
411375,201906,72,59,13,58882,12974,71856
411380,201906,92,71,21,70858,20958,91816
411390,201906,131,87,44,86826,43912,130738
411400,201906,362,277,85,276446.98,84830,361276.98
411410,201906,446,227,219,227544,220558.4,448102.4
411420,201906,1018,460,558,460078,557882,1017960
411430,201906,429,262,167,261476,166666.98,428142.98
411435,201906,36,25,11,24950,10978,35928
411440,201906,459,368,91,368262,90818,459080
411450,201906,423,356,67,356286,67864,424150
411460,201906,765,303,462,302395.08,462076.86,764471.94
411470,201906,88,65,23,64870,22954,87824
411480,201906,657,379,278,379240,277444,656684
411490,201906,297,193,104,192614,104790,297404
411500,201906,106,91,15,91816,14970,106786
411510,201906,233,185,48,184630,47904,232534
411520,201906,6006,2343,3663,2340312.79,3660669.57,6000982.36
411530,201906,119,83,36,82834,35928,118762
411535,201906,49,20,29,19960,28942,48902
411540,201906,351,240,111,241516,110778,352294
411545,201906,52,38,14,37924,13972,51896
411550,201906,74,56,18,55888,17964,73852
411560,201906,375,171,204,170658,203592,374250
411570,201906,803,301,502,301397.26,500996.6,802393.86
411573,201906,29,18,11,17964,10978,28942
411575,201906,287,181,106,180638,106786,287424
411580,201906,1242,492,750,491016,750496,1241512
411585,201906,74,36,38,35928,37924,73852
411590,201906,20,14,6,14970,5988,20958
411600,201906,23,10,13,9980,12974,22954
411605,201906,241,102,139,101796,138722,240518
411610,201906,209,141,68,140718,67864,208582
411620,201906,349,196,153,196606,153692,350298
411630,201906,56,39,17,38922,16966,55888
411640,201906,33,27,6,26946,5988,32934
411650,201906,12,7,5,6986,4990,11976
411660,201906,39,29,10,28942,9980,38922
411670,201906,246,186,60,185628,60878,246506
411680,201906,157,136,21,135728,20958,156686
411690,201906,599,319,280,318362,279440,597802
411695,201906,59,43,16,42914,15968,58882
411700,201906,151,130,21,129740,20958,150698
411705,201906,105,69,36,68862,35928,104790
411710,201906,304,205,99,206586,98802,305388
411720,201906,138,90,48,90818,47904,138722
411721,201906,62,53,9,52894,8982,61876
411722,201906,98,42,56,41916,55888,97804
411725,201906,155,122,33,121756.4,32934,154690.4
411727,201906,81,62,19,61876,18962,80838
411729,201906,39,31,8,30938,7984,38922
411730,201906,554,351,203,350298,202594,552892
411740,201906,40,26,14,25948,13972,39920
411745,201906,69,47,22,46906,21956,68862
411750,201906,864,399,465,399200.4,465068.4,864268.8
411760,201906,1189,895,294,894208.4,293412.98,1187621.38
411770,201906,455,300,155,300398,154690,455088
411780,201906,323,209,114,208582,113772.5,322354.5
411790,201906,530,299,231,298403.27,230539.96,528943.23
411800,201906,166,130,36,129740,35928,165668
411810,201906,168,127,41,126746,40918,167664
411820,201906,2127,1000,1127,999997,1124746.6,2124743.6
411830,201906,12,12,0,11976,0,11976
411840,201906,1974,1233,741,1232530,741515.53,1974045.53
411845,201906,51,20,31,19960,30938,50898
411850,201906,1229,695,534,698600.99,532935.64,1231536.63
411860,201906,45,31,14,30938.4,13972,44910.4
411870,201906,75,51,24,51896,23952,75848
411880,201906,423,274,149,273453.22,148702,422155.22
411885,201906,108,73,35,72854,34930,107784
411890,201906,317,204,113,203593.79,112774,316367.79
411900,201906,73,54,19,53892,18962,72854
411910,201906,180,143,37,143712,36926,180638
411915,201906,2105,897,1208,896204,1205585.22,2101789.22
411920,201906,121,97,24,96806,23952,120758
411925,201906,10,7,3,6986,2994,9980
411930,201906,813,595,218,595806.74,218562,814368.74
411940,201906,592,410,182,410178.79,181636,591814.79
411950,201906,914,483,431,482034.8,430138,912172.8
411960,201906,1036,717,319,715567.7,321356,1036923.7
411965,201906,24,17,7,16966,6986,23952
411970,201906,82,75,7,74850,6986,81836
411980,201906,173,120,53,119760,52894,172654
411990,201906,5202,3030,2172,3027936.88,2172647.7,5200584.58
411995,201906,467,179,288,179640,288422,468062
412000,201906,310,194,116,193612,115768,309380
412010,201906,50,31,19,30938,18962,49900
412015,201906,45,33,12,32934,11976,44910
412020,201906,30,26,4,25948,3992,29940
412030,201906,51,47,4,46906,4990,51896
412033,201906,51,33,18,32934.44,17964,50898.44
412035,201906,65,44,21,43912,20958,64870
412040,201906,37,23,14,22954.4,13972,36926.4
412050,201906,200,154,46,153692,45908,199600
412060,201906,781,593,188,591814,189620,781434
412065,201906,50,32,18,31936,17964,49900
412070,201906,165,110,55,110778,54890,165668
412080,201906,275,145,130,144710,129740,274450
412085,201906,34,16,18,15968,17964,33932
412090,201906,784,504,280,503990.9,280438,784428.9
412100,201906,244,207,37,206586.8,37924,244510.8
412110,201906,68,52,16,51896.36,15968,67864.36
412120,201906,316,201,115,200598,114770,315368
412125,201906,84,49,35,48902,34930,83832
412130,201906,39,28,11,27944.36,10978,38922.36
412135,201906,27,16,11,15968,10978,26946
412140,201906,322,225,97,225548,96806,322354
412150,201906,255,173,82,172654,81836,254490
412160,201906,86,51,35,50898,34930,85828
412170,201906,687,481,206,480038.4,205588,685626.4
412175,201906,38,30,8,29940,7984,37924
412180,201906,194,153,41,152694.28,40918,193612.28
412190,201906,341,270,71,269460,70858,340318
412200,201906,202,124,78,123752,77844,201596
412210,201906,74,58,16,57884,15968,73852
412215,201906,225,160,65,159946.13,64870,224816.13
412217,201906,68,54,14,53892,13972,67864
412220,201906,820,608,212,606784,212574,819358
412230,201906,328,201,127,200598,126747.96,327345.96
412240,201906,1334,665,669,664688.4,670667.84,1335356.24
412250,201906,390,248,142,248502,141716,390218
412260,201906,107,79,28,78842,27944,106786
412265,201906,175,139,36,138722,35928,174650
412270,201906,81,55,26,54890,25948,80838
412280,201906,90,74,16,73852,15968,89820
412290,201906,96,66,30,65868,30938,96806
412300,201906,209,133,76,132734,75848,208582
412310,201906,48,41,7,40918,6986,47904
412320,201906,97,83,14,82834,13972,96806
412330,201906,185,162,23,161676,22954,184630
412340,201906,153,107,46,106786,45908.4,152694.4
412350,201906,594,299,295,300398,295408,595806
412360,201906,30,25,5,24950,4990,29940
412370,201906,162,142,20,141716.2,19960,161676.2
412380,201906,262,195,67,194610,66866.98,261476.98
412382,201906,53,27,26,26946,25948,52894
412385,201906,144,107,37,106786,36926,143712
412390,201906,283,217,66,216566,65868,282434
412395,201906,75,60,15,59880,14970,74850
412400,201906,76,50,26,51896,25948,77844
412402,201906,246,119,127,119760.8,126746,246506.8
412405,201906,827,316,511,315368,509978,825346
412410,201906,965,603,362,602792.4,362274,965066.4
412420,201906,13,11,2,10978,1996,12974
412430,201906,21,15,6,14970,5988,20958
412440,201906,600,330,270,330350.76,269465.28,599816.04
412450,201906,73,63,10,62874,9980,72854
412460,201906,86,64,22,65868,21956,87824
412470,201906,225,181,44,180638,43912,224550
412480,201906,154,113,41,112774.3,40918,153692.3
412490,201906,164,143,21,142714,20958,163672
412500,201906,447,370,77,370258.45,76846,447104.45
412510,201906,187,153,34,153692.4,33932,187624.4
412520,201906,86,57,29,57884,28942,86826
412530,201906,109,58,51,57884,50898,108782
412535,201906,101,76,25,75849.96,24950,100799.96
412540,201906,78,36,42,35928,41916,77844
412545,201906,91,66,25,65868,24950,90818
412550,201906,3649,1658,1991,1657678,1987019.2,3644697.2
412555,201906,13,9,4,8982,3992,12974
412560,201906,608,434,174,433132,173652.7,606784.7
412570,201906,736,403,333,402194,332334,734528
412575,201906,93,66,27,65868,26946,92814
412580,201906,168,113,55,112774,54890,167664
412590,201906,36,32,4,31936,3992,35928
412600,201906,170,127,43,126746.08,42914,169660.08
412610,201906,30,18,12,17964,11976,29940
412620,201906,151,130,21,130738,20958,151696
412625,201906,2204,1180,1024,1180635.93,1023950.73,2204586.66
412627,201906,71,55,16,54890,15968,70858
412630,201906,416,280,136,279440.07,135728,415168.07
412635,201906,63,17,46,16966,45908,62874
412640,201906,114,76,38,75848,38922,114770
412650,201906,352,226,126,226546,125748,352294
412660,201906,477,293,184,292414,184630,477044
412665,201906,51,45,6,44910,5988,50898
412667,201906,297,207,90,206591.28,89822.2,296413.48
412670,201906,65,54,11,53892,10978,64870
412680,201906,298,236,62,235528,61876.48,297404.48
412690,201906,105,68,37,67864,36926.4,104790.4
412700,201906,154,105,49,104790,48902.4,153692.4
412710,201906,1418,868,550,866266.2,548900,1415166.2
412720,201906,229,150,79,151696,78842,230538
412730,201906,188,157,31,156686,30938,187624
412740,201906,418,231,187,230538,186626,417164
412750,201906,456,269,187,268462,186626,455088
412760,201906,271,144,127,146706,127744,274450
412770,201906,2112,1186,926,1189617.86,929139.78,2118757.64
412780,201906,151,119,32,119760,32934,152694
412785,201906,266,135,131,134730,130738,265468
412788,201906,28,18,10,17964,9980,27944
412790,201906,132,110,22,109780,21956,131736
412795,201906,150,111,39,110778,38922,149700
412796,201906,315,212,103,213572,102794,316366
412800,201906,579,374,205,374250.95,206586,580836.95
412810,201906,2994,1657,1337,1656681.3,1335324,2992005.3
412820,201906,948,609,339,607983.5,339320.98,947304.48
412830,201906,14,11,3,10978,2994,13972
412840,201906,219,155,64,155688.4,63872,219560.4
412850,201906,787,518,269,517962,268462,786424
412853,201906,173,92,81,91816,80838.4,172654.4
412855,201906,214,117,97,116766.26,96806,213572.26
412860,201906,91,65,26,64870,25948,90818
412862,201906,60,45,15,44910,14970,59880
412863,201906,5,5,0,4990,0,4990
412865,201906,43,32,11,31936,10978,42914
412870,201906,110,71,39,70858,38922,109780
412880,201906,99,72,27,71856.4,26946,98802.4
420005,201906,41,37,4,36926,4990,41916
420010,201906,370,244,126,243512.3,126746.4,370258.7
420020,201906,84,70,14,69860,13972,83832
420030,201906,26,24,2,23952,1996,25948
420040,201906,111,85,26,84830,25948,110778
420050,201906,51,31,20,30938,19960,50898
420055,201906,18,18,0,17964,0,17964
420060,201906,33,25,8,24950,7984,32934
420070,201906,107,89,18,88822,17964,106786
420075,201906,10,10,0,9980,0,9980
420080,201906,47,41,6,40918,5988,46906
420090,201906,33,31,2,30938,1996,32934
420100,201906,160,138,22,137724.4,21956,159680.4
420110,201906,18,18,0,17964,0,17964
420120,201906,60,46,14,49900,13972,63872
420125,201906,84,67,17,67864,16966,84830
420127,201906,29,24,5,23952,4990,28942
420130,201906,406,252,154,251496,153692,405188
420140,201906,1317,742,575,742514.56,573850.9,1316365.46
420150,201906,45,38,7,37924,6986,44910
420160,201906,35,33,2,32934,1996,34930
420165,201906,19,14,5,13972,4990,18962
420170,201906,74,48,26,47904,25948,73852
420180,201906,23,21,2,20958,1996,22954
420190,201906,28,23,5,23952,4990,28942
420195,201906,133,66,67,65868,66866,132734
420200,201906,1266,565,701,568860.4,702597.84,1271458.24
420205,201906,70,41,29,40918,28942,69860
420207,201906,116,63,53,62874,52894,115768
420208,201906,21,17,4,16966,3992,20958
420209,201906,20,16,4,15968,3992,19960
420210,201906,475,235,240,234530,239520.98,474050.98
420213,201906,51,40,11,39920,10978,50898
420215,201906,27,23,4,22954,3992,26946
420220,201906,66,42,24,41916,23952,65868
420230,201906,828,471,357,475048.46,358282.98,833331.44
420240,201906,2271,1521,750,1531933.14,751494,2283427.14
420243,201906,43,34,9,33932,8982,42914
420245,201906,136,71,65,70858,64870,135728
420250,201906,61,38,23,37924,22954,60878
420253,201906,40,32,8,31936,7984,39920
420257,201906,13,11,2,10978,1996,12974
420260,201906,102,87,15,86826,14970,101796
420270,201906,40,30,10,30938.99,9980,40918.99
420280,201906,290,217,73,216569.64,72856.66,289426.30
420285,201906,21,12,9,11976,8982,20958
420287,201906,54,34,20,33932,19960,53892
420290,201906,993,700,293,703590.99,293415.96,997006.95
420300,201906,1426,1141,285,1139718.74,284430.98,1424149.72
420310,201906,48,33,15,32934,14970,47904
420315,201906,31,27,4,26946,3992,30938
420320,201906,881,452,429,452094.88,428142.99,880237.87
420325,201906,0,,,,,0.0
420330,201906,119,83,36,82834,36926,119760
420340,201906,161,108,53,107785.18,52894,160679.18
420350,201906,250,184,66,183632,65868,249500
420360,201906,753,573,180,571854.98,179642.46,751497.44
420370,201906,121,76,45,75848.6,44910.4,120759.0
420380,201906,1143,811,332,810378.08,331340.32,1141718.40
420390,201906,265,182,83,181636,82834,264470
420395,201906,188,135,53,134730,52894,187624
420400,201906,256,194,62,193612.75,61876,255488.75
420410,201906,65,49,16,48902,15968,64870
420415,201906,34,30,4,29940,3992,33932
420417,201906,52,40,12,39920,11976,51896
420419,201906,11,11,0,10978,0,10978
420420,201906,2809,1741,1068,1738521.37,1066865.34,2805386.71
420425,201906,73,59,14,58882.98,13972.98,72855.96
420430,201906,1236,863,373,862273.5,372254.98,1234528.48
420435,201906,16,14,2,13972,1996,15968
420440,201906,102,73,29,72854.4,28942,101796.4
420445,201906,23,22,1,21956,998,22954
420450,201906,76,39,37,38922,36926,75848
420455,201906,222,170,52,169662.94,52897.92,222560.86
420460,201906,2362,1549,813,1552895.7,812381.22,2365276.92
420470,201906,110,79,31,78842,30938,109780
420475,201906,7,7,0,6986,0,6986
420480,201906,858,651,207,662673.2,213572.8,876246.0
420490,201906,105,77,28,76846,27944,104790
420500,201906,572,260,312,260478.86,313372,573850.86
420510,201906,19,17,2,16966,1996,18962
420515,201906,28,20,8,19960,7984,27944
420517,201906,10,10,0,9980,0,9980
420519,201906,0,,,,,0.0
420520,201906,75,56,19,55888,19960,75848
420530,201906,164,110,54,109780.3,53892,163672.3
420535,201906,19,18,1,17964,998,18962
420540,201906,5364,3195,2169,3195853.78,2169654.94,5365508.72
420543,201906,27,26,1,25948,998,26946
420545,201906,204,146,58,145708.98,59880.98,205589.96
420550,201906,881,718,163,717563.76,162677.92,880241.68
420555,201906,39,28,11,27944,10978,38922
420560,201906,68,55,13,54890,12974,67864
420570,201906,153,91,62,90818,61876,152694
420580,201906,285,126,159,126746,158682.4,285428.4
420590,201906,515,362,153,361276,152694,513970
420600,201906,108,62,46,62874,45908,108782
420610,201906,39,36,3,35928,2994,38922
420620,201906,77,64,13,63872,12974,76846
420630,201906,158,115,43,116766,42915.98,159681.98
420640,201906,84,76,8,76846,7984,84830
420650,201906,234,120,114,119760,113772,233532
420660,201906,53,41,12,40918,11976,52894
420665,201906,36,27,9,26946,8982,35928
420670,201906,315,239,76,239520,75848.98,315368.98
420675,201906,16,15,1,14970,998,15968
420680,201906,37,27,10,26946,9980,36926
420690,201906,176,144,32,144710,31936,176646
420700,201906,701,489,212,488027.34,212581.84,700609.18
420710,201906,151,86,65,85828,64870,150698
420720,201906,109,87,22,86826.98,21956,108782.98
420730,201906,590,377,213,378246.26,213576.32,591822.58
420740,201906,50,49,1,48902,998,49900
420750,201906,515,353,162,353292,161676,514968
420757,201906,18,15,3,14970,2994,17964
420760,201906,36,31,5,30938,4990,35928
420765,201906,73,57,16,56886,15968,72854
420768,201906,51,47,4,46906,3992,50898
420770,201906,82,69,13,69860,13972,83832
420775,201906,44,40,4,39920,3992,43912
420780,201906,234,187,47,186626,46906,233532
420785,201906,12,9,3,9980,2994,12974
420790,201906,168,142,26,141719.92,25949.96,167669.88
420800,201906,70,54,16,53892,15968,69860
420810,201906,251,221,30,220558,29940,250498
420820,201906,2372,1392,980,1399197.6,978042.77,2377240.37
420830,201906,610,337,273,337324.8,272454,609778.8
420840,201906,147,110,37,109780,36926,146706
420845,201906,427,193,234,192614,234530.4,427144.4
420850,201906,248,194,54,193612,53892,247504
420860,201906,63,53,10,52894,9980,62874
420870,201906,121,86,35,87824,34930,122754
420880,201906,183,126,57,126746,56886.98,183632.98
420890,201906,908,456,452,457085.5,451096.98,908182.48
420895,201906,8,8,0,7984,0,7984
420900,201906,420,335,85,335328,84830.98,420158.98
420910,201906,5808,3271,2537,3271451.73,2543908.64,5815360.37
420915,201906,75,70,5,69860,4990,74850
420917,201906,20,14,6,13972,5988,19960
420920,201906,23,16,7,15968,6986,22954
420930,201906,2830,1764,1066,1762464.3,1064036,2826500.3
420940,201906,608,443,165,442114.4,164674.49,606788.89
420945,201906,10,8,2,8982,1996,10978
420950,201906,57,52,5,51896,4990,56886
420960,201906,116,92,24,92816.94,23952.98,116769.92
420970,201906,304,244,60,243516.52,59881.96,303398.48
420980,201906,22,22,0,21956,0,21956
420985,201906,63,56,7,55888,6986,62874
420990,201906,79,60,19,59880,18962,78842
421000,201906,34,21,13,20958,12974,33932
421003,201906,63,44,19,43912,19960.98,63872.98
421005,201906,7,4,3,3992,2994,6986
421010,201906,771,536,235,535926.4,235529.1,771455.5
421020,201906,26,21,5,20958,4990,25948
421030,201906,119,101,18,100798.3,17964,118762.3
421040,201906,69,55,14,54890,13972,68862
421050,201906,329,230,99,230538.4,98802,329340.4
421055,201906,23,19,4,18962,3992,22954
421060,201906,81,53,28,52894,27944,80838
421070,201906,49,44,5,43912.4,4990,48902.4
421080,201906,32,30,2,29940,1996,31936
421085,201906,25,19,6,18962,5988,24950
421090,201906,37,29,8,28942,7984,36926
421100,201906,123,90,33,90818,32934,123752
421105,201906,211,171,40,170658.98,39920.98,210579.96
421110,201906,108,87,21,86826,20958,107784
421120,201906,154,119,35,118762.98,34930,153692.98
421125,201906,17,12,5,11976,4990,16966
421130,201906,824,527,297,527942,296406.4,824348.4
421140,201906,31,23,8,22954,7984,30938
421145,201906,41,33,8,32934,7984,40918
421150,201906,102,75,27,75848,26946.8,102794.8
421160,201906,68,46,22,45908,21956,67864
421165,201906,17,16,1,15968,998,16966
421170,201906,189,159,30,158806.32,29940.98,188747.30
421175,201906,155,104,51,103792,50898,154690
421180,201906,56,36,20,36926.24,19960,56886.24
421185,201906,17,14,3,13972,2994,16966
421187,201906,0,,,,,0.0
421189,201906,43,31,12,30938,11976,42914
421190,201906,1601,1020,581,1018958,581834.83,1600792.83
421200,201906,90,67,23,66866,22954,89820
421205,201906,28,17,11,16966,10978,27944
421210,201906,167,119,48,118762,47904,166666
421220,201906,279,219,60,218562,59880,278442
421223,201906,49,41,8,40918.6,8982,49900.6
421225,201906,71,46,25,45908.6,24950,70858.6
421227,201906,85,64,21,63872,20958,84830
421230,201906,51,37,14,36926,13972,50898
421240,201906,18,18,0,17964,0,17964
421250,201906,365,223,142,223553.6,141716,365269.6
421260,201906,24,20,4,19960,3992,23952
421265,201906,1,1,0,998,0,998
421270,201906,50,44,6,43912,5988,49900
421280,201906,342,197,145,197604,144710,342314
421290,201906,328,223,105,222554,104790,327344
421300,201906,25,20,5,19960,4990,24950
421310,201906,50,37,13,37924,12974,50898
421315,201906,28,18,10,17964,9980,27944
421320,201906,136,92,44,91816,43912,135728
421330,201906,104,77,27,76846,26946.98,103792.98
421335,201906,39,27,12,26946,11976,38922
421340,201906,253,164,89,163673.32,88822,252495.32
421350,201906,197,112,85,111776.97,84830,196606.97
421360,201906,669,499,170,499001.88,170659.92,669661.80
421370,201906,195,151,44,150698,43912,194610
421380,201906,129,104,25,103792,24950,128742
421390,201906,17,12,5,11976,4990,16966
421400,201906,120,102,18,101796,17964,119760
421410,201906,20,18,2,17964,1996,19960
421415,201906,21,20,1,19960,998,20958
421420,201906,142,116,26,115768,25948,141716
421430,201906,15,11,4,10978,3992,14970
421440,201906,57,46,11,45908,10978,56886
421450,201906,93,79,14,78842,13972,92814
421460,201906,62,51,11,50898,10978,61876
421470,201906,68,45,23,44910,22954,67864
421480,201906,676,511,165,510976,164670.98,675646.98
421490,201906,23,22,1,21956.98,998,22954.98
421500,201906,499,326,173,325351.34,172669.68,498021.02
421505,201906,23,16,7,15968,6986,22954
421507,201906,27,21,6,20958,5988,26946
421510,201906,75,49,26,48902,25948,74850
421520,201906,56,47,9,48902,8982,57884
421530,201906,51,44,7,43912,6986,50898
421535,201906,28,27,1,26946.07,998,27944.07
421540,201906,56,49,7,48902,6986,55888
421545,201906,100,74,26,73852.98,25948,99800.98
421550,201906,289,207,82,211576,83832,295408
421555,201906,24,19,5,18962,4990.8,23952.8
421560,201906,8,7,1,6986,998,7984
421565,201906,124,86,38,85828,37924,123752
421567,201906,32,25,7,24950,6986,31936
421568,201906,28,25,3,24950,2994,27944
421569,201906,9,9,0,8982,0,8982
421570,201906,186,123,63,122754,62874,185628
421575,201906,29,24,5,23952,4990,28942
421580,201906,708,423,285,424150,286426,710576
421590,201906,21,20,1,19960,998,20958
421600,201906,156,103,53,102794,52894.8,155688.8
421605,201906,111,79,32,80838.3,32934,113772.3
421610,201906,194,153,41,152694.4,40918,193612.4
421620,201906,1056,622,434,622753.38,434130,1056883.38
421625,201906,23,20,3,19960,2994,22954
421630,201906,286,183,103,182634.9,102795.6,285430.5
421635,201906,17,8,9,7984,8982,16966
421640,201906,97,83,14,82834,13972,96806
421650,201906,299,179,120,180638,119760,300398
421660,201906,2251,1363,888,1361273.78,886228.73,2247502.51
421670,201906,192,140,52,139720,52894,192614
421680,201906,175,158,17,158682,16966,175648
421690,201906,341,247,94,248504.94,93812.44,342317.38
421700,201906,61,40,21,39920,20958.8,60878.8
421710,201906,27,26,1,25948,998,26946
421715,201906,6,5,1,4990,998,5988
421720,201906,599,431,168,431136.62,167664,598800.62
421725,201906,14,6,8,5988,7984,13972
421730,201906,38,27,11,26946,10978,37924
421740,201906,90,42,48,41916,47904,89820
421750,201906,215,161,54,160678,53892,214570
421755,201906,25,23,2,22954,1996,24950
421760,201906,103,73,30,72854,29940,102794
421770,201906,616,406,210,405198.54,209585.12,614783.66
421775,201906,31,19,12,18962,11976,30938
421780,201906,193,151,42,151696,41916,193612
421790,201906,160,136,24,135728,23952,159680
421795,201906,19,15,4,14970,3992,18962
421800,201906,512,329,183,329340,182634.5,511974.5
421810,201906,76,63,13,62874,12974,75848
421820,201906,327,222,105,221556.4,104790,326346.4
421825,201906,132,112,20,111776,19960,131736
421830,201906,134,100,34,99800,33932,133732
421835,201906,3,3,0,2994,0,2994
421840,201906,52,44,8,43912.98,7984,51896.98
421850,201906,78,67,11,67864,10978.99,78842.99
421860,201906,40,32,8,31936,7984,39920
421870,201906,996,756,240,757511.7,239525.72,997037.42
421875,201906,52,44,8,43912,7984,51896
421880,201906,166,120,46,119760,46906.4,166666.4
421885,201906,23,19,4,18962,3992,22954
421890,201906,129,91,38,90818,37924.98,128742.98
421895,201906,49,45,4,44910,3992,48902
421900,201906,162,128,34,127745.96,33936.9,161682.86
421910,201906,65,41,24,40918,23952,64870
421915,201906,31,26,5,25948,4990,30938
421917,201906,40,29,11,28942,10978,39920
421920,201906,38,35,3,34930.4,2994,37924.4
421930,201906,734,576,158,576844,158684.94,735528.94
421935,201906,52,45,7,44910,6986,51896
421940,201906,42,37,5,36926,4990,41916
421950,201906,873,587,286,588821.2,286427.58,875248.78
421960,201906,39,33,6,32934.4,5988,38922.4
421970,201906,360,234,126,234530.4,125748.98,360279.38
421985,201906,28,18,10,17964,9980,27944
422000,201906,0,,,,,0.0
430003,201906,195,51,144,50898,143712,194610
430005,201906,38,29,9,28942,8982,37924
430010,201906,269,190,79,189620,78842,268462
430020,201906,147,96,51,95808.4,50898,146706.4
430030,201906,128,105,23,105788,22954,128742
430040,201906,2989,1754,1235,1751492.64,1232532.34,2984024.98
430045,201906,70,59,11,58882,10978,69860
430047,201906,7,6,1,5988,998,6986
430050,201906,76,65,11,64870,10978,75848
430055,201906,14,12,2,11976,1996,13972
430057,201906,6,4,2,3992,1996,5988
430060,201906,3726,2191,1535,2187623.45,1535926.72,3723550.17
430063,201906,58,53,5,52894,4990,57884
430064,201906,155,128,27,127744,26946,154690
430066,201906,6,4,2,3992,1996,5988
430070,201906,47,36,11,35928,10978,46906
430080,201906,70,48,22,47904,21956,69860
430085,201906,35,13,22,12974,21956,34930
430087,201906,31,24,7,23952.7,6986,30938.7
430090,201906,72,65,7,64870,6986,71856
430100,201906,124,84,40,83832,39920,123752
430105,201906,145,76,69,75848.6,69860,145708.6
430107,201906,19,14,5,13972,4990,18962
430110,201906,416,249,167,248502,166666,415168
430120,201906,144,133,11,132734,10978,143712
430130,201906,797,492,305,492014.4,304390,796404.4
430140,201906,122,115,7,114770,6986,121756
430150,201906,108,70,38,69860,37924,107784
430155,201906,34,31,3,30938,2994,33932
430160,201906,3713,2210,1503,2207578.84,1502988.4,3710567.24
430163,201906,332,151,181,150698,181636,332334
430165,201906,30,19,11,18962,10978,29940
430170,201906,90,77,13,76846,12974,89820
430175,201906,81,63,18,62874,17964,80838
430180,201906,100,82,18,81836,17964,99800
430185,201906,33,25,8,24950,7984,32934
430187,201906,91,38,53,37924,52894,90818
430190,201906,215,121,94,121756,93812,215568
430192,201906,13,11,2,10978,1996,12974
430195,201906,15,10,5,9980,4990,14970
430200,201906,172,151,21,150698,20958,171656
430205,201906,19,18,1,17964,998,18962
430210,201906,676,529,147,527942.4,147704.4,675646.8
430215,201906,13,11,2,10978,1996,12974
430220,201906,74,52,22,51896,21956,73852
430222,201906,12,6,6,5988,5988,11976
430223,201906,13,6,7,5988,6986,12974
430225,201906,2,1,1,998,998,1996
430230,201906,311,185,126,184630,125748,310378
430235,201906,57,43,14,42914,13972,56886
430237,201906,26,21,5,20958,4990,25948
430240,201906,135,87,48,86826,47904,134730
430245,201906,67,55,12,54890,11976,66866
430250,201906,195,116,79,115768,78842,194610
430258,201906,11,9,2,8982,1996,10978
430260,201906,34,30,4,29940,3992,33932
430265,201906,37,31,6,30938,5988,36926
430270,201906,540,405,135,404190.3,134733.92,538924.22
430280,201906,1038,643,395,641714,394211.9,1035925.9
430290,201906,385,218,167,217564.6,166666,384230.6
430300,201906,2109,1179,930,1179639.34,929144.05,2108783.39
430310,201906,1940,1005,935,1002991.96,935132.78,1938124.74
430320,201906,54,44,10,43912,9980,53892
430330,201906,95,85,10,84830,9980,94810
430340,201906,71,61,10,60878,9980,70858
430350,201906,1657,1147,510,1151692.6,509978.98,1661671.58
430355,201906,23,20,3,19960,2994,22954
430360,201906,85,43,42,42914,41916,84830
430367,201906,33,24,9,23952,8982,32934
430370,201906,56,48,8,47904,7984,55888
430380,201906,139,104,35,103792,34930,138722
430390,201906,601,382,219,382234,218562,600796
430400,201906,137,104,33,103792,32934,136726
430410,201906,58,45,13,44910,12974,57884
430420,201906,508,337,171,336327.34,170658.98,506986.32
430430,201906,54,53,1,52229.33,998,53227.33
430435,201906,155,116,39,115768,38922,154690
430440,201906,519,341,178,341316.6,177644,518960.6
430450,201906,1165,963,202,964068,203592,1167660
430460,201906,5069,2785,2284,2785422.28,2283449.18,5068871.46
430461,201906,17,15,2,14970,1996,16966
430462,201906,8,5,3,4990,2994,7984
430463,201906,1063,568,495,568861.56,497005.96,1065867.52
430465,201906,24,14,10,13972,9980,23952
430466,201906,681,492,189,491016.4,189620,680636.4
430467,201906,95,53,42,52894.6,41916,94810.6
430468,201906,110,67,43,66866,43912,110778
430469,201906,22,17,5,16966,4990,21956
430470,201906,1163,655,508,654985.95,506984,1161969.95
430471,201906,54,39,15,38922,14970,53892
430480,201906,101,62,39,61876,38922,100798
430485,201906,6,6,0,5988.4,0,5988.4
430490,201906,82,66,16,65868,15968,81836
430495,201906,36,27,9,26946,9980,36926
430500,201906,196,132,64,131736,63872.63,195608.63
430510,201906,3382,2228,1154,2229533.24,1154686,3384219.24
430511,201906,16,15,1,14970,998,15968
430512,201906,141,101,40,100798,39920,140718
430513,201906,49,39,10,38922,9980,48902
430515,201906,29,27,2,28942,1996,30938
430517,201906,167,149,18,148702,17964,166666
430520,201906,363,253,110,252494,109780,362274
430530,201906,85,48,37,47904,36926,84830
430535,201906,454,312,142,313372,141716.99,455088.99
430537,201906,11,11,0,10978,0,10978
430540,201906,79,54,25,53892,24950,78842
430543,201906,362,115,247,114770,246506,361276
430544,201906,44,41,3,40918,2994,43912
430545,201906,357,188,169,188623.9,170658,359281.9
430550,201906,44,37,7,36926,6986,43912
430558,201906,5,3,2,2994,1996,4990
430560,201906,53,27,26,26946,25948,52894
430570,201906,108,43,65,42914,64870,107784
430580,201906,124,102,22,101796,21956.6,123752.6
430583,201906,13,13,0,12974,0,12974
430585,201906,11,4,7,3992,6986,10978
430587,201906,15,7,8,6986,7984,14970
430590,201906,151,124,27,123752,26946,150698
430593,201906,2,2,0,1996,0,1996
430595,201906,16,13,3,12974,2994,15968
430597,201906,47,25,22,24950,21956,46906
430600,201906,225,160,65,160678,64870,225548
430605,201906,158,98,60,97804,59880,157684
430607,201906,23,20,3,19960,2994,22954
430610,201906,1612,773,839,772452.9,838321.38,1610774.28
430613,201906,3,3,0,2994,0,2994
430620,201906,112,81,31,80838,30938,111776
430630,201906,47,41,6,40918,5988,46906
430632,201906,33,28,5,27944,4990,32934
430635,201906,36,33,3,32934,2994,35928
430637,201906,55,30,25,29940,24950,54890
430640,201906,192,108,84,107784,83832,191616
430642,201906,21,19,2,18962,1996,20958
430645,201906,37,30,7,29940,6986,36926
430650,201906,256,208,48,207584.4,48902,256486.4
430655,201906,3,3,0,2994,0,2994
430660,201906,979,480,499,479040,498002.4,977042.4
430670,201906,76,53,23,52894,22954,75848
430673,201906,74,42,32,41916,31936,73852
430675,201906,13,10,3,9980,2994,12974
430676,201906,501,303,198,302394.94,197604.94,499999.88
430680,201906,252,178,74,178642.4,73852,252494.4
430690,201906,541,337,204,336326.98,204590.63,540917.61
430692,201906,7,5,2,4990,1996,6986
430693,201906,139,95,44,94810,43912,138722
430695,201906,74,62,12,61876,11976,73852
430697,201906,58,36,22,35928,21956,57884
430700,201906,1555,1086,469,1083828.4,468062,1551890.4
430705,201906,22,20,2,19960,1996,21956
430710,201906,262,170,92,169660,91816,261476
430720,201906,105,90,15,89820,15968,105788
430730,201906,138,118,20,117764,19960,137724
430740,201906,70,46,24,45908,23952,69860
430745,201906,34,27,7,26946,6986,33932
430750,201906,336,224,112,223552,111776,335328
430755,201906,90,53,37,52894,36926,89820
430760,201906,370,219,151,218563.04,150698.98,369262.02
430770,201906,1440,757,683,755488.24,681637.92,1437126.16
430780,201906,313,200,113,199600.98,112774.98,312375.96
430781,201906,29,25,4,24950,3992,28942
430783,201906,52,43,9,42914,8982,51896
430786,201906,6,3,3,2994,2994,5988
430790,201906,532,347,185,347304,185628.4,532932.4
430800,201906,162,135,27,134730.51,26946,161676.51
430805,201906,40,37,3,36926,2994,39920
430807,201906,46,26,20,25948,19960,45908
430810,201906,76,50,26,49900,25948,75848
430820,201906,142,84,58,84830,57884,142714
430825,201906,10,8,2,7984,1996,9980
430830,201906,236,220,16,222554.4,16966,239520.4
430840,201906,129,88,41,87824,40918,128742
430843,201906,6,4,2,3992,1996,5988
430845,201906,69,41,28,40918,27944,68862
430850,201906,575,407,168,406186,167667.9,573853.9
430860,201906,169,108,61,107784,60878,168662
430865,201906,71,38,33,37924,32934.98,70858.98
430870,201906,81,66,15,65868,14970,80838
430880,201906,154,115,39,114770,38922,153692
430885,201906,10,8,2,7984,1996,9980
430890,201906,352,215,137,215568,136726,352294
430900,201906,523,367,156,365767,155688,521455
430905,201906,108,48,60,47904,59880,107784
430910,201906,280,158,122,157684,122754.98,280438.98
430912,201906,5,5,0,4990,0,4990
430915,201906,34,29,5,28942,4990,33932
430920,201906,4206,2331,1875,2330336.2,1874247.94,4204584.14
430925,201906,4,3,1,2994,998,3992
430930,201906,2055,1209,846,1208579.86,848303.88,2056883.74
430940,201906,260,168,92,168662,91816,260478
430950,201906,152,124,28,123752,27944,151696
430955,201906,22,13,9,12974,8982,21956
430957,201906,18,17,1,16966,998,17964
430960,201906,246,161,85,160678,84830,245508
430965,201906,113,71,42,70858,41916,112774
430970,201906,84,71,13,70858,12974,83832
430975,201906,40,36,4,35928,3992,39920
430980,201906,45,29,16,28942,15968,44910
430990,201906,115,88,27,87824,27944,115768
430995,201906,118,113,5,112774,4990,117764
431000,201906,306,139,167,138723,166666,305389
431010,201906,343,201,142,200598,141716,342314
431020,201906,1922,1120,802,1118759.49,801394,1920153.49
431030,201906,41,32,9,31936,8982,40918
431033,201906,377,188,189,188622,190618,379240
431036,201906,14,9,5,8982,4990,13972
431040,201906,134,82,52,81836,51896,133732
431041,201906,38,26,12,25948,11976,37924
431043,201906,49,30,19,29940,18962,48902
431046,201906,11,7,4,6986,3992,10978
431050,201906,197,126,71,125748,70858,196606
431053,201906,73,45,28,44910.96,27944,72854.96
431055,201906,64,45,19,44910,18962,63872
431057,201906,18,18,0,17964,0,17964
431060,201906,1657,1051,606,1048900.35,606799.4,1655699.75
431065,201906,19,11,8,10978,7984,18962
431070,201906,67,61,6,60878,5988,66866
431075,201906,7,7,0,6986,0,6986
431080,201906,131,82,49,81836,48902,130738
431085,201906,34,31,3,30938,2994,33932
431087,201906,15,12,3,11976,2994,14970
431090,201906,54,43,11,42914,10978,53892
431100,201906,1214,727,487,725548.28,486026,1211574.28
431110,201906,243,148,95,147704,94810.4,242514.4
431112,201906,28,17,11,16966,10978,27944
431113,201906,34,25,9,24950,8982,33932
431115,201906,155,107,48,106786,47904,154690
431120,201906,600,362,238,363272.6,237525.92,600798.52
431123,201906,4,3,1,2994,998,3992
431125,201906,96,87,9,86826,8982,95808
431127,201906,9,4,5,3992,4990,8982
431130,201906,700,453,247,453092,246506,699598
431140,201906,764,534,230,535926.4,230538,766464.4
431142,201906,32,26,6,25948.95,5988,31936.95
431150,201906,199,151,48,150698,47904,198602
431160,201906,54,49,5,48902,4990,53892
431162,201906,17,13,4,12974,3992,16966
431164,201906,6,6,0,5988,0,5988
431170,201906,108,86,22,85828,21956,107784
431171,201906,67,41,26,40918,25948,66866
431173,201906,1,1,0,998,0,998
431175,201906,197,102,95,101796.4,95808,197604.4
431177,201906,73,57,16,56886,15968,72854
431179,201906,13,11,2,11976,1996,13972
431180,201906,461,281,180,281436,179640.98,461076.98
431190,201906,85,65,20,64870,19960,84830
431198,201906,69,48,21,47904,20958,68862
431200,201906,20,16,4,15968,3992,19960
431205,201906,24,24,0,23952,0,23952
431210,201906,88,53,35,52894,34930,87824
431213,201906,30,26,4,25948,3992,29940
431215,201906,22,19,3,18962,2994,21956
431217,201906,5,4,1,3992,998,4990
431220,201906,69,60,9,59880.8,8982,68862.8
431225,201906,147,99,48,98802.98,48902,147704.98
431230,201906,103,93,10,93812,9980,103792
431235,201906,8,8,0,7984,0,7984
431237,201906,23,16,7,15968,6986,22954
431238,201906,9,6,3,5988.4,2994,8982.4
431240,201906,986,644,342,643710.2,342314,986024.2
431242,201906,38,37,1,36926,998,37924
431244,201906,11,8,3,7984,2994,10978
431245,201906,50,39,11,38922,10978,49900
431247,201906,12,9,3,8982,2994,11976
431250,201906,277,148,129,148702,129740,278442
431260,201906,58,45,13,44910,12974,57884
431261,201906,18,12,6,11976,5988,17964
431262,201906,18,17,1,16966,998,17964
431265,201906,149,83,66,82834,66866,149700
431267,201906,13,12,1,11976,998,12974
431270,201906,329,269,60,269460,59880,329340
431275,201906,39,36,3,35928,2994,38922
431280,201906,19,15,4,14970,3992,18962
431290,201906,25,20,5,19960,4990,24950
431295,201906,3,3,0,2994,0,2994
431300,201906,21,18,3,17964,2994,20958
431301,201906,6,6,0,5988,0,5988
431303,201906,56,36,20,35928,19960,55888
431306,201906,237,127,110,128564.35,109780,238344.35
431308,201906,7,5,2,4990,1996,6986
431310,201906,67,57,10,56886,9980,66866
431320,201906,142,85,57,84830,56886,141716
431330,201906,182,117,65,116766,64870,181636
431333,201906,29,25,4,24950,3992,28942
431335,201906,9,5,4,4990,3992,8982
431337,201906,330,151,179,150698,179640,330338
431339,201906,20,17,3,16966,2994,19960
431340,201906,2996,1703,1293,1699519.23,1290430.38,2989949.61
431342,201906,38,24,14,23952,13972,37924
431344,201906,17,17,0,16966,0,16966
431346,201906,5,5,0,4990,0,4990
431349,201906,36,33,3,32934,2994,35928
431350,201906,918,539,379,539919.08,378242.4,918161.48
431360,201906,47,42,5,41916,4990,46906
431365,201906,325,158,167,158682,166666,325348
431370,201906,1322,791,531,789418.4,531938.9,1321357.3
431380,201906,97,83,14,82834,13972,96806
431390,201906,508,281,227,281436,227544,508980
431395,201906,296,135,161,136726,160678.96,297404.96
431400,201906,44,32,12,31936,11976,43912
431402,201906,104,74,30,73852,29940,103792
431403,201906,22,12,10,11976,9980,21956
431405,201906,655,361,294,360278.9,293413.96,653692.86
431406,201906,30,26,4,25948,3992,29940
431407,201906,51,40,11,39920,10978,50898
431410,201906,3410,2089,1321,2091809.5,1321352.7,3413162.2
431413,201906,17,14,3,13972,2994,16966
431415,201906,71,53,18,52894,18962,71856
431417,201906,23,13,10,12974,9980,22954
431420,201906,314,216,98,215568,97804,313372
431430,201906,47,22,25,21956,24950,46906
431440,201906,8928,6309,2619,6304376.19,2618753.4,8923129.59
431442,201906,29,16,13,15968,12974,28942
431445,201906,24,21,3,20958,2994,23952
431446,201906,4,4,0,3992,0,3992
431447,201906,88,65,23,64870,22954,87824
431449,201906,55,47,8,46906,7984,54890
431450,201906,417,286,131,285428,130738,416166
431454,201906,0,,,,,0.0
431455,201906,52,41,11,40918,10978,51896
431460,201906,519,361,158,360278,158682,518960
431470,201906,120,93,27,92814,26946,119760
431475,201906,10,9,1,8982,998,9980
431477,201906,36,24,12,23952,11976,35928
431478,201906,8,7,1,6986,998,7984
431480,201906,487,308,179,309380,178642,488022
431490,201906,28694,16133,12561,16133785.97,12561954.65,28695740.62
431500,201906,80,59,21,58882,20958,79840
431505,201906,26,17,9,16966,10978,27944
431507,201906,13,10,3,9980,2994,12974
431510,201906,257,182,75,181636.1,75848,257484.1
431513,201906,25,21,4,20958,3992,24950
431514,201906,6,5,1,4990,998,5988
431515,201906,79,67,12,66866,11976,78842
431517,201906,5,4,1,3992,998,4990
431520,201906,37,33,4,32934,3992,36926
431530,201906,1549,699,850,698602.88,848300.94,1546903.82
431531,201906,23,21,2,20958,1996,22954
431532,201906,27,18,9,18962,8982,27944
431535,201906,26,16,10,15968,9980,25948
431540,201906,141,124,17,124750,16966,141716
431545,201906,14,12,2,11976,1996,13972
431550,201906,352,199,153,199600,154690,354290
431555,201906,13,12,1,11976,998,12974
431560,201906,4489,3150,1339,3149693.17,1338318.8,4488011.97
431570,201906,808,435,373,434130.8,372254,806384.8
431575,201906,38,24,14,23952,13972,37924
431580,201906,98,67,31,68862,30938,99800
431590,201906,149,127,22,126746,21956,148702
431595,201906,12,11,1,10978,998,11976
431600,201906,225,126,99,125748,98802,224550
431610,201906,123,91,32,90818,31936,122754
431620,201906,45,37,8,36926,7984,44910
431630,201906,133,110,23,109780,22954,132734
431640,201906,1347,851,496,849298.4,495009.36,1344307.76
431642,201906,34,32,2,31936,1996,33932
431643,201906,41,19,22,18962,21956,40918
431645,201906,323,185,138,184630,137724,322354
431647,201906,10,10,0,9980,0,9980
431650,201906,33,24,9,23952,8982,32934
431660,201906,323,206,117,205588,116766,322354
431670,201906,233,110,123,109780,122754,232534
431673,201906,4,4,0,3992,0,3992
431675,201906,28,23,5,22954,4990,27944
431680,201906,1119,821,298,820356,297404,1117760
431690,201906,4774,2909,1865,2916159,1865266.3,4781425.3
431695,201906,22,18,4,17964,3992,21956
431697,201906,0,,,,,0.0
431700,201906,168,133,35,132734,34930,167664
431710,201906,4037,1782,2255,1782429.58,2253494.78,4035924.36
431720,201906,1369,836,533,834329,533930.99,1368259.99
431725,201906,1,1,0,998,0,998
431730,201906,1191,808,383,807384.16,382234,1189618.16
431740,201906,1368,680,688,679638.96,686628.32,1366267.28
431750,201906,1847,1209,638,1210575.71,637722.98,1848298.69
431755,201906,5,4,1,3992,998,4990
431760,201906,1019,658,361,657682.4,360278,1017960.4
431770,201906,397,295,102,294410,101796,396206
431775,201906,31,23,8,22954,7984,30938
431780,201906,557,350,207,349300,206586,555886
431790,201906,172,133,39,133732,38922,172654
431795,201906,12,10,2,9980,1996,11976
431800,201906,3349,1759,1590,1757491.9,1589908.86,3347400.76
431805,201906,18,16,2,15968,1996,17964
431810,201906,608,408,200,408182,199600.98,607782.98
431820,201906,322,186,136,185628,135728,321356
431830,201906,2338,1411,927,1408178,927145.93,2335323.93
431840,201906,491,327,164,327344.6,165668,493012.6
431842,201906,34,28,6,27944,5988,33932
431843,201906,12,9,3,8982,2994,11976
431844,201906,16,14,2,13972,1996,15968
431845,201906,27,25,2,24950,1996,26946
431846,201906,29,24,5,23952,4990,28942
431848,201906,14,12,2,11976,1996,13972
431849,201906,11,7,4,6986,3992,10978
431850,201906,798,656,142,656684,141716,798400
431860,201906,113,80,33,79840,32934,112774
431861,201906,4,2,2,1996,1996,3992
431862,201906,53,35,18,34930,17964,52894
431870,201906,3400,2023,1377,2022951.28,1377247.76,3400199.04
431880,201906,932,691,241,690616.94,240518,931134.94
431890,201906,1292,807,485,807382,484030,1291412
431900,201906,177,127,50,126746,49900,176646
431910,201906,54,40,14,39920,13972,53892
431912,201906,37,21,16,20958,15968,36926
431915,201906,129,103,26,102794,25948,128742
431920,201906,153,112,41,111776,40918,152694
431930,201906,81,66,15,65868,14970,80838
431935,201906,3,3,0,2994,0,2994
431936,201906,13,11,2,10978,1996,12974
431937,201906,20,15,5,14970,4990,19960
431940,201906,466,313,153,312374,152694.5,465068.5
431950,201906,497,313,184,312375.38,183633.96,496009.34
431960,201906,745,412,333,412176.36,332335.96,744512.32
431970,201906,74,65,9,64870,8982,73852
431971,201906,3,3,0,2994,0,2994
431973,201906,23,19,4,18962,3992,22954
431975,201906,9,8,1,7984,998,8982
431980,201906,207,130,77,129740,76846,206586
431990,201906,1198,647,551,648635.71,550898.9,1199534.61
432000,201906,1687,917,770,915169.06,769463,1684632.06
432010,201906,278,186,92,185628,91816,277444
432020,201906,174,143,31,142714,30938,173652
432023,201906,16,14,2,13972,1996,15968
432026,201906,67,62,5,61876,4990,66866
432030,201906,66,32,34,31936,33932,65868
432032,201906,18,15,3,14970,2994,17964
432035,201906,51,42,9,41916,8982,50898
432040,201906,103,71,32,70858,31936,102794
432045,201906,8,7,1,6986,998,7984
432050,201906,82,51,31,50898,30938,81836
432055,201906,115,86,29,86826,28942,115768
432057,201906,5,4,1,3992.4,998,4990.4
432060,201906,34,31,3,30938,2994,33932
432065,201906,33,29,4,28942,3992,32934
432067,201906,88,80,8,79840,7984,87824
432070,201906,404,309,95,308632.8,94810.98,403443.78
432080,201906,821,571,250,571854,249500,821354
432085,201906,14,11,3,10978,2994,13972
432090,201906,266,174,92,173652,91816,265468
432100,201906,174,118,56,117764,55888,173652
432110,201906,597,406,191,407184,190618,597802
432120,201906,954,588,366,587822,365268,953090
432130,201906,504,366,138,365268,137724,502992
432132,201906,24,21,3,20958,2994,23952
432135,201906,77,64,13,63872,12974,76846
432140,201906,267,215,52,214570,51896,266466
432143,201906,205,132,73,131736,72854,204590
432145,201906,275,190,85,189620,84830,274450
432146,201906,13,12,1,11976,998,12974
432147,201906,123,58,65,57884,64870,122754
432149,201906,14,10,4,9980,3992,13972
432150,201906,833,515,318,513970,317365.55,831335.55
432160,201906,1431,748,683,749499.57,682633.94,1432133.51
432162,201906,4,3,1,2994,998,3992
432163,201906,19,14,5,13972,4990,18962
432166,201906,115,86,29,86328,28942,115270
432170,201906,225,116,109,115768,108782,224550
432180,201906,536,333,203,333332,202594.4,535926.4
432183,201906,6,6,0,5988,0,5988
432185,201906,78,69,9,68862,8982,77844
432190,201906,468,275,193,274450,192614.98,467064.98
432195,201906,86,71,15,70858,14970,85828
432200,201906,393,251,142,253492,141716.98,395208.98
432210,201906,119,75,44,74850,43912,118762
432215,201906,56,52,4,51896,3992,55888
432218,201906,20,19,1,18962,998,19960
432220,201906,672,352,320,351296,319361.61,670657.61
432225,201906,13,8,5,7984,4990,12974
432230,201906,145,94,51,93812,50898,144710
432232,201906,15,14,1,13972,998,14970
432234,201906,4,3,1,2994,998,3992
432235,201906,3,3,0,2994,0,2994
432237,201906,27,15,12,14970,11976,26946
432240,201906,4361,2467,1894,2464065.52,1899196.18,4363261.70
432250,201906,1096,703,393,701594,392214,1093808
432252,201906,42,37,5,37924,4990,42914
432253,201906,59,47,12,46906,11976,58882
432254,201906,27,13,14,12974,13972,26946
432255,201906,14,13,1,12974,998,13972
432260,201906,855,678,177,679638.4,178642,858280.4
432270,201906,243,179,64,178642,63872,242514
432280,201906,140,105,35,105788.6,34930,140718.6
432285,201906,2,2,0,1996,0,1996
432290,201906,67,59,8,58882,7984,66866
432300,201906,4629,2594,2035,2594738.49,2033937.04,4628675.53
432310,201906,118,98,20,97804,19960,117764
432320,201906,22,17,5,16966,4990,21956
432330,201906,16,12,4,11976,3992,15968
432335,201906,7,6,1,5988,998,6986
432340,201906,38,34,4,33932,3992,37924
432345,201906,96,69,27,68862,26946,95808
432350,201906,25,24,1,23952,998,24950
432360,201906,7,5,2,4990,1996,6986
432370,201906,25,24,1,23952,998,24950
432375,201906,33,31,2,30938,1996,32934
432377,201906,8,8,0,7984,0,7984
432380,201906,165,75,90,74850,90818,165668
500020,201906,243,140,103,140718,102794,243512
500025,201906,125,62,63,61876,62874,124750
500060,201906,1455,910,545,913170,543911.38,1457081.38
500070,201906,792,385,407,384230.96,407184,791414.96
500080,201906,134,109,25,108782,24950,133732
500085,201906,134,108,26,107784.4,25948,133732.4
500090,201906,327,157,170,156686,169660,326346
500100,201906,733,385,348,384230,347304.8,731534.8
500110,201906,2278,1054,1224,1052895.71,1223560.49,2276456.20
500124,201906,262,153,109,152694,108782,261476
500150,201906,322,137,185,136726.98,184632.94,321359.92
500190,201906,519,361,158,361276.9,158682.4,519959.3
500200,201906,190,164,26,163672.28,25948,189620.28
500210,201906,1461,526,935,524954.86,933169.1,1458123.96
500215,201906,244,143,101,143712,100798,244510
500220,201906,761,496,265,495011.62,264470,759481.62
500230,201906,249,168,81,167664,80838,248502
500240,201906,688,479,209,479040.36,208582,687622.36
500260,201906,597,233,364,233532,363272,596804
500270,201906,29498,12761,16737,12757455.16,16725665.84,29483121.00
500280,201906,193,70,123,69860,123752,193612
500290,201906,1174,704,470,704588,472054.98,1176642.98
500295,201906,441,279,162,278442.4,161676,440118.4
500310,201906,66,23,43,22954,43912,66866
500315,201906,731,445,286,444110,285428,729538
500320,201906,3668,1843,1825,1842309.75,1828341.88,3670651.63
500325,201906,919,508,411,507982.4,410178.4,918160.8
500330,201906,1439,676,763,674648.4,763470.98,1438119.38
500345,201906,308,237,71,237525.38,70858,308383.38
500348,201906,246,149,97,148702,96806,245508
500350,201906,128,64,64,63872,63872,127744
500370,201906,5435,2451,2984,2450092.48,2986022.9,5436115.38
500375,201906,348,257,91,256486,90818,347304
500380,201906,595,342,253,343312,252494,595806
500390,201906,72,34,38,33932,37924,71856
500400,201906,210,147,63,146706,63872.98,210578.98
500410,201906,556,226,330,225551.89,329345.87,554897.76
500430,201906,534,378,156,378242,155688,533930
500440,201906,206,106,100,105788,99800,205588
500450,201906,406,176,230,176646,229540,406186
500460,201906,291,149,142,148702,142714,291416
500470,201906,438,346,92,346307.39,91816.98,438124.37
500480,201906,108,66,42,65868,42914,108782
500490,201906,110,46,64,45908,63872,109780
500500,201906,1432,521,911,519968.81,909209.51,1429178.32
500510,201906,46,35,11,34930,10978.98,45908.98
500515,201906,104,74,30,73852,29940,103792
500520,201906,341,187,154,186626.8,153693.39,340320.19
500525,201906,89,50,39,49900,38922,88822
500540,201906,907,387,520,389220.98,518961.96,908182.94
500560,201906,909,517,392,516964,393212.4,910176.4
500568,201906,980,577,403,576844.98,403193.39,980038.37
500570,201906,1202,692,510,690636.6,511035.18,1201671.78
500580,201906,336,178,158,177644,158684.91,336328.91
500600,201906,319,170,149,169660,148703.96,318363.96
500620,201906,923,656,267,654688.4,267464,922152.4
500625,201906,77,65,12,64870,11976,76846
500627,201906,25,12,13,11976,12974,24950
500630,201906,1576,850,726,850296.9,726544,1576840.9
500635,201906,524,310,214,309380,214570,523950
500640,201906,408,216,192,215568.8,191616,407184.8
500660,201906,5486,2111,3375,2106778.4,3373241.21,5480019.61
500690,201906,575,206,369,205597.78,368286.5,573884.28
500710,201906,383,195,188,194610,188623.96,383233.96
500720,201906,961,567,394,566864.43,393212,960076.43
500730,201906,193,119,74,118762,73852,192614
500740,201906,862,377,485,376252.34,485056.69,861309.03
500750,201906,151,48,103,47904,102794.98,150698.98
500755,201906,125,89,36,88822.4,35928,124750.4
500769,201906,741,418,323,418164.37,322355.97,740520.34
500770,201906,414,216,198,215568,197604,413172
500780,201906,164,111,53,110778,52894,163672
500790,201906,1063,542,521,541914,521958.91,1063872.91
500793,201906,269,150,119,149700,118763.38,268463.38
500795,201906,170,123,47,122754,46906.98,169660.98
500797,201906,50,37,13,36926,12974,49900
500800,201906,419,191,228,190618.98,230538,421156.98
500830,201906,2258,1276,982,1276443.98,983030.6,2259474.58
500840,201906,141,106,35,106786,35928.98,142714.98
510010,201906,169,93,76,92814,75848,168662
510020,201906,487,226,261,225566.62,260506.42,486073.04
510025,201906,1707,978,729,978050.15,729553.1,1707603.25
510030,201906,674,355,319,354293.9,318364.95,672658.85
510035,201906,131,59,72,58883.96,71856.98,130740.94
510040,201906,380,172,208,171656,207586.68,379242.68
510050,201906,394,218,176,217570.84,175655.28,393226.12
510060,201906,117,60,57,59880,56886,116766
510080,201906,223,88,135,87825.96,134730.98,222556.94
510100,201906,73,33,40,32934,39920,72854
510120,201906,37,24,13,23952,12974,36926
510125,201906,388,243,145,242514,144711.97,387225.97
510130,201906,572,332,240,331344.82,239531.76,570876.58
510140,201906,403,123,280,123752,279440,403192
510160,201906,97,39,58,39920,57884,97804
510170,201906,832,507,325,507996.88,325362.68,833359.56
510180,201906,2872,1400,1472,1397245.37,1471088.1,2868333.47
510185,201906,14,6,8,5988,7984,13972
510190,201906,217,75,142,74850,141716,216566
510250,201906,2567,1528,1039,1527945.26,1037924.32,2565869.58
510260,201906,187,138,49,137738.7,48902.98,186641.68
510263,201906,463,264,199,263475.74,198602.98,462078.72
510267,201906,681,382,299,381251.3,298424.52,679675.82
510268,201906,60,29,31,28942,30938,59880
510269,201906,70,33,37,32934.98,36926,69860.98
510270,201906,392,201,191,203595.92,190622.9,394218.82
510279,201906,226,169,57,168664.94,56886.4,225551.34
510285,201906,180,75,105,74850.98,104790,179640.98
510300,201906,512,288,224,287428.92,223558.86,510987.78
510305,201906,215,100,115,99801.97,114770.98,214572.95
510310,201906,106,55,51,54890,50898,105788
510320,201906,848,539,309,540921.88,310391.73,851313.61
510325,201906,407,166,241,165668,240518,406186
510330,201906,422,240,182,239521.97,181636,421157.97
510335,201906,613,355,258,355290.95,258486.9,613777.85
510336,201906,52,38,14,37924,13972,51896
510337,201906,109,45,64,44910,63872,108782
510340,201906,17144,8123,9021,8126939.56,9012248.86,17139188.42
510343,201906,63,44,19,43912,18962,62874
510345,201906,166,112,54,111776,53892.4,165668.4
510350,201906,658,371,287,370262.9,286430.32,656693.22
510360,201906,197,126,71,125748.98,70863.88,196612.86
510370,201906,141,71,70,70858,69862.94,140720.94
510380,201906,88,62,26,61876,25948.98,87824.98
510385,201906,58,27,31,26946,30938.98,57884.98
510390,201906,112,48,64,47904,63872,111776
510395,201906,47,34,13,33932,12974,46906
510410,201906,698,466,232,465069.98,232535.96,697605.94
510420,201906,568,281,287,280456.58,286456.28,566912.86
510450,201906,51,27,24,26946,23952,50898
510452,201906,46,27,19,26946,18962,45908
510454,201906,53,25,28,24950,27944,52894
510455,201906,127,78,49,77844,49900,127744
510460,201906,173,91,82,90819.68,81836.98,172656.66
510480,201906,731,435,296,436133.12,296416.7,732549.82
510490,201906,350,182,168,181641.84,167666.9,349308.74
510500,201906,240,182,58,182634,57884,240518
510510,201906,806,467,339,467065.38,338322,805387.38
510515,201906,1158,619,539,620761.88,542912.98,1163674.86
510517,201906,259,109,150,108782,150698.98,259480.98
510520,201906,231,150,81,149702.94,80842.88,230545.82
510523,201906,93,69,24,68862,23952,92814
510525,201906,779,463,316,463076.91,315372.9,778449.81
510530,201906,18,13,5,12974,4990,17964
510550,201906,254,117,137,116766.98,138722,255488.98
510558,201906,276,135,141,134730.98,140718,275448.98
510560,201906,418,248,170,247504.4,169661.96,417166.36
510562,201906,659,470,189,470058,188622,658680
510590,201906,770,404,366,404190.98,367265.97,771456.95
510600,201906,248,135,113,134730,112775.96,247505.96
510610,201906,169,82,87,81836,86826,168662
510615,201906,193,80,113,79840,112774,192614
510617,201906,18,11,7,10978,6986,17964
510618,201906,117,57,60,56886,59880,116766
510619,201906,102,70,32,69860.98,31936.98,101797.96
510620,201906,178,99,79,98802,78842,177644
510621,201906,189,123,66,122754.98,65869.96,188624.94
510622,201906,472,300,172,304395.88,172655.96,477051.84
510623,201906,344,235,109,234531.96,108782,343313.96
510624,201906,87,44,43,43912.98,42914,86826.98
510625,201906,547,340,207,339334.7,207596.37,546931.07
510626,201906,115,73,42,72854.98,41916,114770.98
510627,201906,66,47,19,46906,18962,65868
510628,201906,150,90,60,89820.98,59880,149700.98
510629,201906,252,165,87,165668,87824,253492
510630,201906,448,231,217,231537.96,216569.34,448107.30
510631,201906,11,3,8,2994,7984,10978
510637,201906,353,211,142,211579.93,141726.78,353306.71
510642,201906,974,548,426,546906.94,427145.96,974052.90
510645,201906,0,,,,,0.0
510650,201906,1440,962,478,961088.14,478046.87,1439135.01
510665,201906,81,43,38,42917.88,37924,80841.88
510670,201906,63,37,26,36926,25948,62874
510675,201906,1145,718,427,724551.34,428144.94,1152696.28
510677,201906,350,178,172,179645.88,171661.88,351307.76
510680,201906,101,61,40,60879.96,39920.98,100800.94
510682,201906,214,104,110,103792,109780,213572
510685,201906,49,38,11,37924,11976,49900
510700,201906,609,353,256,352303.8,256495.81,608799.61
510704,201906,1117,600,517,602911.53,516073.78,1118985.31
510706,201906,129,67,62,67864,61877.96,129741.96
510710,201906,401,280,121,279445.84,120759.92,400205.76
510715,201906,62,46,16,45908,15968,61876
510718,201906,204,112,92,111778.94,91816,203594.94
510719,201906,37,18,19,17964,18962,36926
510720,201906,190,133,57,132734.98,56886,189620.98
510724,201906,89,36,53,35928,52894,88822
510726,201906,51,26,25,25948,24950.98,50898.98
510729,201906,71,33,38,32934,37924,70858
510730,201906,470,267,203,266467.96,202595.97,469063.93
510735,201906,109,45,64,44910,63872,108782
510740,201906,25,13,12,12974,11976,24950
510757,201906,17,13,4,12974,3992,16966
510760,201906,7106,3801,3305,3799450.29,3304590.39,7104040.68
510770,201906,682,323,359,323356.88,360288.74,683645.62
510774,201906,17,7,10,6986,9980,16966
510775,201906,111,85,26,84830,25948,110778
510776,201906,29,10,19,9980,18962,28942
510777,201906,184,82,102,81836,101796,183632
510779,201906,49,24,25,23953.96,24951.96,48905.92
510780,201906,290,162,128,161682.88,127749.85,289432.73
510785,201906,411,225,186,224550,185628,410178
510787,201906,194,95,99,95808.98,98803.97,194612.95
510788,201906,0,,,,,0.0
510790,201906,2443,1307,1136,1307431.86,1136810.2,2444242.06
510792,201906,1145,669,476,667669.84,476059.73,1143729.57
510794,201906,114,56,58,55888,57884.98,113772.98
510795,201906,2354,1399,955,1397206.74,958086.68,2355293.42
510800,201906,187,116,71,115768,71856.98,187624.98
510805,201906,171,118,53,117764,52894.98,170658.98
510810,201906,96,43,53,42919.88,53892,96811.88
510820,201906,247,121,126,120762.12,125750.51,246512.63
510830,201906,68,41,27,40918,26946.98,67864.98
510835,201906,12,9,3,8982,2994,11976
510840,201906,9105,4487,4618,4485219.56,4610986.3,9096205.86
510850,201906,209,84,125,83832,124750.98,208582.98
510860,201906,389,175,214,175654.86,213583.16,389238.02
510880,201906,65,48,17,47904.98,16966,64870.98
510885,201906,71,43,28,43912.98,28942,72854.98
510890,201906,71,43,28,42914,27944,70858
510895,201906,190,112,78,111776,77846.37,189622.37
520005,201906,48,31,17,30938,16966,47904
520010,201906,273,126,147,125748,146706.8,272454.8
520013,201906,692,435,257,435128.98,256486,691614.98
520015,201906,54,41,13,40918,12974,53892
520017,201906,91,52,39,51896.4,38922,90818.4
520020,201906,23,13,10,12974,9980,22954
520025,201906,2068,1139,929,1136722.8,928140,2064862.8
520030,201906,812,435,377,435128.98,380238,815366.98
520050,201906,74,50,24,49900,23952,73852
520055,201906,46,30,16,29940,16966,46906
520060,201906,180,121,59,120758,59880,180638
520080,201906,574,414,160,414170,159680,573850
520082,201906,19,14,5,13972,4990,18962
520085,201906,96,71,25,70858,24950,95808
520090,201906,93,62,31,61876,30938,92814
520110,201906,9163,4028,5135,4023943.5,5126733.48,9150676.98
520120,201906,14,8,6,7984,5988,13972
520130,201906,790,551,239,549898.98,238522.4,788421.38
520140,201906,11957,6765,5192,6757471.99,5188621.08,11946093.07
520145,201906,48,32,16,31936,15968,47904
520150,201906,183,143,40,142714,40918,183632
520160,201906,35,26,9,25948,8982,34930
520170,201906,245,147,98,146708.93,97806.92,244515.85
520180,201906,144,73,71,72854,70858,143712
520215,201906,211,138,73,137724,72854,210578
520235,201906,72,54,18,53892,17964,71856
520250,201906,129,78,51,77844,50898,128742
520260,201906,111,70,41,69860,40918,110778
520280,201906,48,33,15,32934,14970,47904
520310,201906,40,27,13,26946,12974,39920
520320,201906,169,111,58,110778,57884,168662
520330,201906,791,421,370,420160.94,370258.98,790419.92
520340,201906,339,199,140,198602,140718.98,339320.98
520350,201906,516,242,274,241516,273452,514968
520355,201906,91,55,36,54890,35928,90818
520357,201906,26,21,5,20958,4990,25948
520360,201906,1,1,0,998,0,998
520380,201906,143,74,69,73852,68862,142714
520390,201906,264,116,148,115768,147704,263472
520393,201906,13,9,4,8982,3992,12974
520396,201906,92,59,33,59880,32934.98,92814.98
520400,201906,214,123,91,123752.4,90818,214570.4
520410,201906,192,98,94,97804.98,93812.98,191617.96
520420,201906,20,14,6,13972,5988,19960
520425,201906,301,142,159,141716,158683.4,300399.4
520430,201906,465,244,221,243512,221557.88,465069.88
520440,201906,636,438,198,437124,197604,634728
520450,201906,1925,872,1053,874248.98,1052894.9,1927143.88
520455,201906,54,39,15,38922,14970,53892
520460,201906,35,19,16,18962,15968,34930
520465,201906,27,23,4,22954,3992,26946
520470,201906,423,269,154,268462,153692,422154
520480,201906,80,48,32,47904.98,31940.9,79845.88
520485,201906,119,42,77,41916,76846.4,118762.4
520490,201906,420,311,109,310378,109780,420158
520495,201906,167,98,69,97804,68862,166666
520500,201906,174,133,41,132734,40918,173652
520505,201906,178,98,80,97804,79840,177644
520510,201906,1769,875,894,876279.68,894290.28,1770569.96
520520,201906,39,30,9,29940,8982,38922
520530,201906,234,179,55,178642,54890,233532
520540,201906,557,390,167,389220,166666,555886
520545,201906,139,85,54,84830,53892,138722
520547,201906,46,26,20,25948,19960,45908
520549,201906,1157,567,590,565866.32,590819.73,1156686.05
520551,201906,285,153,132,152694,132734.4,285428.4
520552,201906,48,30,18,29940,17964,47904
520570,201906,16,10,6,9980,5988,15968
520580,201906,291,178,113,177644,113772,291416
520590,201906,159,96,63,96806.98,62874,159680.98
520620,201906,1161,542,619,540917.38,619758,1160675.38
520630,201906,39,24,15,23952,14970,38922
520640,201906,399,238,161,237524,160678,398202
520650,201906,62,40,22,39920,21956,61876
520660,201906,39,22,17,21956.98,16966,38922.98
520670,201906,35,31,4,30938,3992,34930
520680,201906,53,35,18,34930,17964,52894
520690,201906,35,12,23,11976,22955.96,34931.96
520710,201906,37,33,4,32934,3992,36926
520725,201906,184,122,62,121756,61876,183632
520735,201906,59,41,18,40918,17964,58882
520740,201906,406,201,205,201596,204590.98,406186.98
520750,201906,35,27,8,26946,7984,34930
520753,201906,58,39,19,38922,18962,57884
520760,201906,109,75,34,74850,33932,108782
520780,201906,292,217,75,216566,74850.96,291416.96
520790,201906,151,82,69,81836,69860,151696
520800,201906,3403,1838,1565,1834326.59,1564864.88,3399191.47
520810,201906,171,127,44,126746,43912,170658
520815,201906,5,4,1,3992,998,4990
520830,201906,148,104,44,103792,43912,147704
520840,201906,360,243,117,242514,116766,359280
520850,201906,103,66,37,65868.98,36926,102794.98
520860,201906,1724,1118,606,1117094.66,604788.4,1721883.06
520870,201906,31676,15469,16207,15459039.75,16194578.82,31653618.57
520880,201906,1126,610,516,608780.4,515966,1124746.4
520890,201906,793,478,315,478042.98,314370,792412.98
520910,201906,1005,536,469,534928.88,470058,1004986.88
520915,201906,101,79,22,78842,21956,100798
520920,201906,402,194,208,193612,207584,401196
520929,201906,17,16,1,16966,998,17964
520940,201906,74,49,25,48902,24950,73852
520945,201906,19,11,8,10978,7984,18962
520960,201906,50,31,19,30938,18962,49900
520970,201906,333,209,124,208582.98,123752,332334.98
520980,201906,93,69,24,68862,23952,92814
520990,201906,463,316,147,315368,147704,463072
520993,201906,129,62,67,61876,66866,128742
520995,201906,244,139,105,138722.66,105788.4,244511.06
521000,201906,1584,934,650,936124.6,649699.2,1585823.8
521010,201906,676,324,352,323355.92,352296.36,675652.28
521015,201906,18,12,6,11976,5988,17964
521020,201906,1450,1020,430,1018958.98,431139.34,1450098.32
521030,201906,50,35,15,34930,14970,49900
521040,201906,935,592,343,590816.9,342314.4,933131.3
521056,201906,43,32,11,31936,10978,42914
521060,201906,133,88,45,87824,44910,132734
521080,201906,453,342,111,341317.38,110778,452095.38
521090,201906,543,341,202,340318,201596,541914
521100,201906,278,211,67,210579.62,67864,278443.62
521120,201906,1054,744,310,743510.4,309380.98,1052891.38
521130,201906,366,259,107,258482,106789.34,365271.34
521140,201906,177,96,81,95808,81836,177644
521150,201906,2739,1192,1547,1191614.36,1543907.96,2735522.32
521160,201906,31,16,15,15968,14970,30938
521170,201906,197,115,82,114770,81836,196606
521180,201906,1167,745,422,745506.2,421156.9,1166663.1
521190,201906,2541,1080,1461,1079836,1461072.98,2540908.98
521200,201906,52,39,13,38922,12974,51896
521205,201906,11,8,3,7984,2994,10978
521210,201906,137,78,59,77844,58882,136726
521220,201906,810,562,248,560876,249500.9,810376.9
521225,201906,33,21,12,20958,11976,32934
521230,201906,107,72,35,72854,34930,107784
521250,201906,6136,3554,2582,3550890.01,2578835.88,6129725.89
521260,201906,23,14,9,13972,8982,22954
521270,201906,142,111,31,110778,30938,141716
521280,201906,435,264,171,263472,170658,434130
521290,201906,29,12,17,11976,16966,28942
521295,201906,99,67,32,66866,31936,98802
521300,201906,219,115,104,114771.96,103795.34,218567.30
521305,201906,37,26,11,25948,10978,36926
521308,201906,1069,801,268,800404.82,267465.38,1067870.20
521310,201906,1337,788,549,789422.9,547903.34,1337326.24
521340,201906,21,16,5,15968,4990,20958
521350,201906,127,95,32,94810,31936,126746
521370,201906,185,128,57,127744,57884,185628
521375,201906,171,93,78,92814,80838,173652
521377,201906,51,37,14,36926,13972,50898
521380,201906,1063,688,375,687623.92,374250,1061873.92
521385,201906,13,8,5,7984,5988,13972
521390,201906,97,78,19,77844,18962,96806
521400,201906,343,225,118,224550,117764,342314
521405,201906,147,80,67,79840,66866,146706
521410,201906,64,43,21,42914,20958,63872
521440,201906,200,146,54,146706,53892,200598
521450,201906,733,411,322,410178,321356,731534
521460,201906,1173,740,433,740516,432134,1172650
521470,201906,12,8,4,7984,3992,11976
521480,201906,44,31,13,30940.94,12976.86,43917.80
521483,201906,313,175,138,174650.4,137724,312374.4
521486,201906,290,187,103,186626,103792.6,290418.6
521487,201906,23,12,11,11976,10978,22954
521490,201906,26,15,11,14970,10978,25948
521500,201906,117,76,41,75848,40918,116766
521520,201906,42,29,13,28942,12974,41916
521523,201906,674,414,260,414170,259480,673650
521525,201906,47,32,15,31936,14970,46906
521530,201906,250,134,116,133732,115768,249500
521540,201906,28,15,13,14970,12974,27944
521550,201906,88,40,48,39923.34,47908.9,87832.24
521560,201906,794,548,246,546904.4,246506.7,793411.1
521565,201906,55,36,19,35928,18962,54890
521570,201906,509,341,168,340318,167664.9,507982.9
521580,201906,60,38,22,37924,21956,59880
521590,201906,36,19,17,18962,16966,35928
521600,201906,24,14,10,13972,9980,23952
521630,201906,244,131,113,130738,112776.46,243514.46
521640,201906,301,156,145,155688,144710,300398
521645,201906,28,15,13,14970,12974,27944
521680,201906,220,138,82,137724,81836.6,219560.6
521690,201906,2,2,0,1996,0,1996
521710,201906,1168,567,601,565866,599798.98,1165664.98
521720,201906,543,369,174,368262,173653.34,541915.34
521730,201906,637,309,328,308382.8,328342.4,636725.2
521740,201906,899,377,522,376246.98,522956.32,899203.30
521760,201906,1693,947,746,945106.59,747503.36,1692609.95
521770,201906,823,524,299,523950,299400,823350
521800,201906,2026,1284,742,1282442.78,740525.8,2022968.58
521805,201906,32,19,13,18962,12974,31936
521810,201906,87,55,32,54890,31936,86826
521830,201906,941,670,271,668693.39,271456.98,940150.37
521839,201906,85,55,30,54890,29940,84830
521850,201906,1093,582,511,580840.01,509994.48,1090834.49
521860,201906,355,225,130,225548,129740,355288
521870,201906,71,42,29,41916,28942,70858
521878,201906,39,18,21,17964,20958,38922
521880,201906,4698,2121,2577,2122748.16,2574846.15,4697594.31
521890,201906,588,420,168,419160,167664,586824
521900,201906,293,238,55,237524,54890,292414
521910,201906,151,105,46,104790,45908,150698
521920,201906,50,24,26,23952,25948,49900
521925,201906,40,24,16,23952,15968,39920
521930,201906,1137,640,497,641721.26,496016.78,1137738.04
521935,201906,35,26,9,25948,8982,34930
521940,201906,192,98,94,97804,93812,191616
521945,201906,15,13,2,12974,1996,14970
521950,201906,8,4,4,3992,3992,7984
521960,201906,73,55,18,54890,17964,72854
521970,201906,411,267,144,266466,143712,410178
521971,201906,87,44,43,43912,42914,86826
521973,201906,33,17,16,16966,15968,32934
521975,201906,1258,647,611,645707.01,609779.1,1255486.11
521980,201906,243,168,75,167664,74850,242514
521990,201906,76,54,22,53892,21956,75848
522000,201906,285,183,102,183632,101796,285428
522005,201906,20,11,9,10978,8982,19960
522010,201906,1142,651,491,649698.98,492014,1141712.98
522015,201906,59,38,21,37924.98,20958,58882.98
522020,201906,874,493,381,493012.5,381236.8,874249.3
522026,201906,27,18,9,17964,8982,26946
522028,201906,17,13,4,12974,3992,16966
522040,201906,768,307,461,307386.46,460081.92,767468.38
522045,201906,2322,1447,875,1444106.7,875248.46,2319355.16
522050,201906,162,81,81,80838,81836,162674
522060,201906,548,352,196,351296,196606,547902
522068,201906,124,84,40,83832,39920,123752
522070,201906,10,10,0,9980,0,9980
522100,201906,41,23,18,22954,17964,40918
522108,201906,43,33,10,32934,9980,42914
522119,201906,54,28,26,27944,25948,53892
522130,201906,78,33,45,32934.98,44912.94,77847.92
522140,201906,3835,1943,1892,1939116.3,1889216.56,3828332.86
522145,201906,50,35,15,34930,15968,50898
522150,201906,67,50,17,49900,16966,66866
522155,201906,53,35,18,34930.98,17964,52894.98
522157,201906,4,3,1,2994,998,3992
522160,201906,1734,1043,691,1044240.66,690616.98,1734857.64
522170,201906,405,274,131,273452,130738,404190
522180,201906,37,20,17,19960,16966,36926
522185,201906,1970,788,1182,787424.76,1184626.99,1972051.75
522190,201906,42,25,17,24950,16966,41916
522200,201906,297,181,116,181636,115768,297404
522205,201906,154,107,47,106786,46906,153692
522220,201906,159,114,45,113772,44910,158682
522230,201906,33,28,5,27944,4990,32934
530010,201906,54776,28372,26404,28349607.68,26385179.69,54734787.37
110001,201907,514,412,102,411176,102794,513970
110002,201907,2757,1719,1038,1725543.38,1040915.36,2766458.74
110003,201907,89,74,15,73852.18,14970,88822.18
110004,201907,2012,1316,696,1316364.36,695606.99,2011971.35
110005,201907,434,351,83,354290.4,82834,437124.4
110006,201907,449,349,100,348302.4,99800,448102.4
110007,201907,76,62,14,61876,13972,75848
110008,201907,240,138,102,137724,101796,239520
110009,201907,832,592,240,591814.42,239521.58,831336.00
110010,201907,1787,1103,684,1105784.98,684629.96,1790414.94
110011,201907,1850,1447,403,1448098.1,403192,1851290.1
110012,201907,4142,2433,1709,2443104.4,1715562.4,4158666.8
110013,201907,777,610,167,611774,167664,779438
110014,201907,372,320,52,319360.4,51896,371256.4
110015,201907,1416,1143,273,1146703.87,272454,1419157.87
110018,201907,1112,693,419,693610,422156.96,1115766.96
110020,201907,15587,9179,6408,9193607.98,6413196.49,15606804.47
110025,201907,633,471,162,470058.4,161676.98,631735.38
110026,201907,39,27,12,26946,11976,38922
110028,201907,1691,1234,457,1233531.06,457085.2,1690616.26
110029,201907,141,127,14,127744,13972,141716
110030,201907,2441,1662,779,1661512.28,777443.8,2438956.08
110032,201907,289,225,64,228543.35,65868.99,294412.34
110033,201907,669,497,172,496006.64,171656.98,667663.62
110034,201907,364,271,93,271456.17,92814,364270.17
110037,201907,100,87,13,86959.06,12974,99933.06
110040,201907,359,247,112,246506,111776,358282
110045,201907,929,651,278,652693.2,281436.64,934129.84
110050,201907,90,80,10,80838.4,9980,90818.4
110060,201907,80,45,35,44910,34930,79840
110070,201907,114,71,43,70858,42914.4,113772.4
110080,201907,415,248,167,248502,166666,415168
110090,201907,31,25,6,24950,5988,30938
110092,201907,101,53,48,52894,47904,100798
110094,201907,189,137,52,137724,51896,189620
110100,201907,30,25,5,24950,4990,29940
110110,201907,64,39,25,38922,25948,64870
110120,201907,70,59,11,59880,10978,70858
110130,201907,296,245,51,244510.4,51896,296406.4
110140,201907,239,164,75,164670,74850,239520
110143,201907,49,41,8,40918,7984,48902
110145,201907,24,19,5,18962,4990,23952
110146,201907,25,12,13,11976,12974,24950
110147,201907,36,27,9,26946,8982,35928
110148,201907,36,25,11,24950,10978,35928
110149,201907,305,217,88,217564,88822,306386
110150,201907,130,102,28,101796,27944,129740
110155,201907,7,6,1,5988,998,6986
110160,201907,64,53,11,52894,10978,63872
110170,201907,202,163,39,162674,38922,201596
110175,201907,61,46,15,45908,14970,60878
110180,201907,94,81,13,80838,12974,93812
120001,201907,146,99,47,99800,46907.98,146707.98
120005,201907,196,121,75,121756,75848,197604
120010,201907,1068,674,394,673651.67,394210.98,1067862.65
120013,201907,148,102,46,101796,46906,148702
120017,201907,93,57,36,56886,35928,92814
120020,201907,3591,2892,699,2894201.83,701594,3595795.83
120025,201907,549,315,234,319360.98,235528,554888.98
120030,201907,1051,889,162,890217,161676,1051893
120032,201907,46,40,6,40918,5988,46906
120033,201907,215,190,25,190618,24950,215568
120034,201907,167,123,44,122754,43912,166666
120035,201907,35,26,9,25948,8982,34930
120038,201907,388,252,136,252494,137724,390218
120039,201907,28,27,1,26946,998,27944
120040,201907,14064,9711,4353,9736845.37,4358287.15,14095132.52
120042,201907,48,43,5,42914,4990,47904
120043,201907,10,3,7,2994,6986,9980
120045,201907,555,359,196,358282.98,195608.98,553891.96
120050,201907,1274,981,293,979039.68,292414,1271453.68
120060,201907,1463,1199,264,1201592,266466,1468058
120070,201907,467,334,133,336327.2,132734,469061.2
120080,201907,174,107,67,106786,66866,173652
130002,201907,149,109,40,109780,41916,151696
130006,201907,74,44,30,43912,29940,73852
130008,201907,137,73,64,73852,63872,137724
130010,201907,140,78,62,77844,61876,139720
130014,201907,256,183,73,183632,72854,256486
130020,201907,92,51,41,50898,40918,91816
130030,201907,931,552,379,550896,379240,930136
130040,201907,322,156,166,155688,166666.36,322354.36
130050,201907,600,319,281,319360,280438,599798
130060,201907,873,600,273,599798,272454,872252
130063,201907,589,329,260,328342,259480,587822
130068,201907,189,124,65,123752,64870,188622
130070,201907,1317,902,415,902192,415168,1317360
130080,201907,690,448,242,448102,241516.98,689618.98
130083,201907,67,37,30,38922,29940,68862
130090,201907,354,179,175,179640,174650,354290
130100,201907,1145,500,645,499000,643710,1142710
130110,201907,738,304,434,304390,435128,739518
130115,201907,167,70,97,70858,96806,167664
130120,201907,1627,1054,573,1059876,571854,1631730
130130,201907,609,424,185,423152,185628,608780
130140,201907,1529,1181,348,1189616,349300,1538916
130150,201907,427,370,57,370258,56886,427144
130160,201907,460,263,197,262474,197604,460078
130165,201907,34,28,6,27944,5988,33932
130170,201907,966,685,281,684564.12,282434,966998.12
130180,201907,171,112,59,112774,58882,171656
130185,201907,2409,1158,1251,1158678,1254486.8,2413164.8
130190,201907,3528,2230,1298,2231529.28,1296402,3527931.28
130195,201907,280,223,57,223552,56886,280438
130200,201907,174,82,92,82834,91816,174650
130210,201907,76,40,36,39920,35928,75848
130220,201907,181,124,57,123752,56886,180638
130230,201907,324,208,116,208582,115768,324350
130240,201907,1395,892,503,891214.99,504988,1396202.99
130250,201907,4822,3104,1718,3108770.4,1717558,4826328.4
130255,201907,425,210,215,209580,215568,425148
130260,201907,55721,26960,28761,26994831.33,28791307.15,55786138.48
130270,201907,1571,1051,520,1053977.82,520956,1574933.82
130280,201907,124,71,53,70858,52894,123752
130290,201907,2142,1525,617,1525942,615766,2141708
130300,201907,448,314,134,313372,134730,448102
130310,201907,898,466,432,467064,431136,898200
130320,201907,496,272,224,271456,224550,496006
130330,201907,734,455,279,454090,283432,737522
130340,201907,3527,2069,1458,2072846.8,1460074.8,3532921.6
130350,201907,461,298,163,297404,162674,460078
130353,201907,876,379,497,378242,497004,875246
130356,201907,840,388,452,387224,454090,841314
130360,201907,71,44,27,43912,26946,70858
130370,201907,692,530,162,528940,162674,691614
130380,201907,689,518,171,520956,172654,693610
130390,201907,485,385,100,385228,99800,485028
130395,201907,174,41,133,40918,132734,173652
130400,201907,64,43,21,42914,20958,63872
130406,201907,2053,1274,779,1278438.4,780436.4,2058874.8
130410,201907,460,212,248,211576,248502,460078
130420,201907,3140,2551,589,2560868.9,589818,3150686.9
130423,201907,159,79,80,78842,79840,158682
130426,201907,149,85,64,84830,64870,149700
130430,201907,401,257,144,259480,144710,404190
130440,201907,205,68,137,67864,137724,205588
140002,201907,32,10,22,9980,21956,31936
140005,201907,202,125,77,124750,76846,201596
140010,201907,10459,6925,3534,6956071.32,3546895.24,10502966.56
140015,201907,131,61,70,61876,71856,133732
140017,201907,114,79,35,79840,35928,115768
140020,201907,462,311,151,312374,151696,464070
140023,201907,45,24,21,24950.54,20958,45908.54
140028,201907,17,11,6,10978,6986,17964
140030,201907,344,247,97,249500,96806,346306
140040,201907,57,41,16,40918,16966,57884
140045,201907,230,102,128,103792,127744,231536
140047,201907,629,423,206,423152,205588,628740
140050,201907,145,93,52,92814,51896,144710
140060,201907,37,26,11,25948,10978,36926
140070,201907,34,31,3,30938,2994,33932
150010,201907,4645,2928,1717,2926136.4,1717558.4,4643694.8
150013,201907,161,115,46,114770.98,45908,160678.98
150020,201907,1062,581,481,581834,481036,1062870
150030,201907,687,291,396,290418,397204,687622
150034,201907,200,130,70,129740,69860,199600
150040,201907,1403,841,562,841314,560876,1402190
150050,201907,621,367,254,368262,256486,624748
150060,201907,4744,3094,1650,3090723.68,1654684.98,4745408.66
150070,201907,312,143,169,142714,169660,312374
150080,201907,14259,7183,7076,7193593.31,7098785.33,14292378.64
150085,201907,401,259,142,260478,142714,403192
150090,201907,749,635,114,634728,114770,749498
150095,201907,341,219,122,219560,123752,343312
150100,201907,57,38,19,37924,18962,56886
150110,201907,173,87,86,87824,86826,174650
150120,201907,419,308,111,309380,110778,420158
150125,201907,53,22,31,21956,31936,53892
150130,201907,1970,1060,910,1066862,911174,1978036
150140,201907,53681,25242,28439,25286342.96,28550808.28,53837151.24
150145,201907,181,101,80,100798,80838,181636
150150,201907,2873,1324,1549,1325344,1547898.8,2873242.8
150157,201907,402,284,118,283432.8,118762,402194.8
150160,201907,126,98,28,97804,27944,125748
150170,201907,3601,2710,891,2717554,900196,3617750
150172,201907,326,221,105,221556,104790,326346
150175,201907,82,51,31,50898,30938,81836
150178,201907,782,524,258,523950.4,257484,781434.4
150180,201907,3091,1529,1562,1532928.5,1561870.4,3094798.9
150190,201907,334,213,121,212574,120758,333332
150195,201907,116,58,58,58882,58882,117764
150200,201907,195,94,101,93812,100798,194610
150210,201907,3101,2529,572,2537914,573850.99,3111764.99
150215,201907,541,353,188,354290,188622.4,542912.4
150220,201907,3692,2524,1168,2529931.52,1175645.4,3705576.92
150230,201907,1159,947,212,948100.45,212574,1160674.45
150240,201907,5926,3502,2424,3511964.59,2425141.97,5937106.56
150250,201907,31,15,16,14970,15968,30938
150260,201907,84,53,31,52894,30938,83832
150270,201907,2301,1499,802,1497000,801394.8,2298394.8
150275,201907,537,341,196,340318,195608,535926
150276,201907,108,49,59,48902,58882,107784
150277,201907,760,330,430,331336.98,430138,761474.98
150280,201907,329,211,118,211576,117764,329340
150285,201907,87,43,44,42914,43912,86826
150290,201907,956,593,363,594808,363272.4,958080.4
150293,201907,645,311,334,310378,334330,644708
150295,201907,476,219,257,218562,257484.4,476046.4
150300,201907,78,41,37,40918,36926,77844
150304,201907,169,107,62,107784,61876,169660
150307,201907,387,322,65,323352,64870,388222
150309,201907,578,418,160,419160.98,159683.6,578844.58
150310,201907,238,161,77,161676,76846,238522
150320,201907,1995,1399,596,1401192,599798,2000990
150330,201907,2040,1190,850,1189616,851294,2040910
150340,201907,200,134,66,133732,65868,199600
150345,201907,609,345,264,345308,267464,612772
150350,201907,403,321,82,321356,81836,403192
150360,201907,4574,2951,1623,2956077.49,1624744,4580821.49
150370,201907,799,561,238,561874.98,238522.98,800397.96
150375,201907,189,100,89,100798,88822,189620
150380,201907,1449,989,460,988020,459080,1447100
150390,201907,769,443,326,443112.99,325348,768460.99
150400,201907,105,87,18,86826,17964,104790
150405,201907,1238,808,430,808380.92,429140,1237520.92
150410,201907,126,84,42,83832,41916,125748
150420,201907,7396,4093,3303,4095967.16,3308412.94,7404380.10
150430,201907,556,374,182,373252,181636,554888
150440,201907,558,339,219,340318,218562,558880
150442,201907,2251,1219,1032,1219556.58,1032930,2252486.58
150445,201907,525,341,184,344310,184630,528940
150450,201907,238,117,121,117764,121756,239520
150460,201907,740,561,179,561874,178642,740516
150470,201907,1314,805,509,809378,508980,1318358
150475,201907,219,171,48,171656,47904,219560
150480,201907,1267,893,374,895206,374250,1269456
150490,201907,590,324,266,323352,266466,589818
150495,201907,320,232,88,232534,89820,322354
150497,201907,300,202,98,201596,98802,300398
150500,201907,204,134,70,133732,69860,203592
150503,201907,922,463,459,464070.4,460078.98,924149.38
150506,201907,969,649,320,650696,322354,973050
150510,201907,1251,714,537,712572.4,538920,1251492.4
150520,201907,272,184,88,184630,87824,272454
150530,201907,1642,916,726,916164.5,725546,1641710.5
150540,201907,235,166,69,166666,68862,235528
150543,201907,776,429,347,429140,347304,776444
150548,201907,474,331,143,333332,142714,476046
150549,201907,61,44,17,43912,16966,60878
150550,201907,2824,1510,1314,1509974.5,1316362.4,2826336.9
150553,201907,3273,1948,1325,1950093.2,1328338,3278431.2
150555,201907,144,77,67,76846,66866,143712
150560,201907,19,12,7,11976,6986,18962
150563,201907,88,45,43,44910,42914,87824
150565,201907,166,103,63,102794,63872,166666
150570,201907,409,276,133,276446,133732,410178
150580,201907,1571,713,858,712572,857282,1569854
150590,201907,804,523,281,522952,281436,804388
150600,201907,460,277,183,278442,184630,463072
150610,201907,140,121,19,121756,18962,140718
150611,201907,113,78,35,77844,36926,114770
150613,201907,3206,1977,1229,1978036,1232530.98,3210566.98
150616,201907,497,294,203,295408.5,202594,498002.5
150618,201907,1283,706,577,704588.98,580836,1285424.98
150619,201907,396,303,93,304390,93812,398202
150620,201907,1259,753,506,755486,511974,1267460
150630,201907,293,195,98,194610,98802,293412
150635,201907,487,209,278,208582,280438,489020
150640,201907,54,27,27,27944,26946,54890
150650,201907,2336,1381,955,1385474.4,955087.39,2340561.79
150655,201907,243,184,59,183632,58882,242514
150658,201907,95,53,42,54890,41916,96806
150660,201907,494,345,149,347304,148702,496006
150670,201907,1002,368,634,368262.98,633730.98,1001993.96
150680,201907,9653,5311,4342,5316348.8,4353277.96,9669626.76
150690,201907,16,9,7,8982,6986,15968
150700,201907,485,323,162,323352,162674,486026
150710,201907,280,161,119,160678,118762,279440
150715,201907,829,510,319,508980.98,318362,827342.98
150720,201907,413,323,90,322354,89820,412174
150730,201907,979,524,455,522952.98,455088,978040.98
150740,201907,222,153,69,153692,68862,222554
150745,201907,804,441,363,440118,362274,802392
150746,201907,52,33,19,32934,18962,51896
150747,201907,242,191,51,191616,52894,244510
150750,201907,134,78,56,77844,55888,133732
150760,201907,1753,1156,597,1156682,603790,1760472
150770,201907,383,211,172,211576,173652,385228
150775,201907,94,44,50,44910,50898,95808
150780,201907,185,104,81,103792,81836,185628
150790,201907,846,469,377,470058,377244,847302
150795,201907,1495,895,600,896204,600796,1497000
150796,201907,367,215,152,214570,154690,369260
150797,201907,297,163,134,162674,133732,296406
150800,201907,1439,868,571,869258,570856,1440114
150803,201907,579,477,102,478042,102794,580836
150805,201907,187,117,70,116766.4,69860.99,186627.39
150808,201907,998,545,453,549898,453092,1002990
150810,201907,3365,2353,1012,2352287.41,1014966.4,3367253.81
150812,201907,435,238,197,237524,196606,434130
150815,201907,968,639,329,638720,329340,968060
150820,201907,1547,952,595,951094,595806,1546900
150830,201907,776,565,211,566864,212574,779438
150835,201907,195,116,79,118762,79840,198602
150840,201907,1364,866,498,870256.2,499998,1370254.2
160005,201907,52,31,21,30938,20958,51896
160010,201907,185,118,67,117764,66866.99,184630.99
160015,201907,118,70,48,69860,47904,117764
160020,201907,127,73,54,72854,53892,126746
160021,201907,42,23,19,22954,18962,41916
160023,201907,124,80,44,79840,43912,123752
160025,201907,29,13,16,12974,15968,28942
160027,201907,1480,858,622,863270.5,620756,1484026.5
160030,201907,15598,8160,7438,8174627.87,7468043.81,15642671.68
160040,201907,287,166,121,165668,121756,287424
160050,201907,702,362,340,363272,343312,706584
160053,201907,315,184,131,185628.4,130738,316366.4
160055,201907,29,22,7,21956,6986,28942
160060,201907,6519,3478,3041,3478032.49,3047893.39,6525925.88
160070,201907,173,107,66,106786,66866,173652
160080,201907,93,49,44,48902,43912,92814
170025,201907,25,14,11,13972,10978,24950
170030,201907,224,183,41,182634.88,40918,223552.88
170035,201907,226,108,118,107784,117764,225548
170040,201907,179,140,39,139720,38922,178642
170070,201907,322,201,121,201596,120758,322354
170100,201907,359,260,99,260478,98802,359280
170105,201907,58,47,11,46906,10978,57884
170110,201907,106,67,39,68862,38922,107784
170130,201907,66,33,33,32934,32934.4,65868.4
170190,201907,95,61,34,60878,33932,94810
170200,201907,382,261,121,262474.98,121756.9,384231.88
170210,201907,6048,3232,2816,3232524.5,2819352.61,6051877.11
170215,201907,107,48,59,47904,59880,107784
170220,201907,1418,1053,365,1050894,367264,1418158
170230,201907,150,99,51,98802,50898,149700
170240,201907,525,352,173,352294.8,174650,526944.8
170255,201907,1108,894,214,895206,213572,1108778
170270,201907,40,29,11,28942,10978,39920
170290,201907,106,79,27,78842,26946,105788
170300,201907,88,60,28,59880,27944,87824
170305,201907,50,39,11,38922,10978,49900
170307,201907,60,45,15,45908,14970,60878
170310,201907,107,60,47,59880,46906,106786
170320,201907,24,18,6,17964,5988,23952
170330,201907,22,21,1,20958,998,21956
170360,201907,27,16,11,15968,10978,26946
170370,201907,123,66,57,65868,57884,123752
170380,201907,82,64,18,63872,17964,81836
170382,201907,44,39,5,38922,4990,43912
170384,201907,142,107,35,106786,34930,141716
170386,201907,60,26,34,25948,33932,59880
170388,201907,48,19,29,18962,28942,47904
170389,201907,26,21,5,20958,4990,25948
170390,201907,60,35,25,34930.98,24950.98,59881.96
170410,201907,33,24,9,23952,8982,32934
170460,201907,17,12,5,11976,4990,16966
170510,201907,34,27,7,26946,6986,33932
170550,201907,1547,916,631,914168,631734,1545902
170555,201907,112,82,30,81836,30938,112774
170560,201907,100,71,29,71856,28942,100798
170600,201907,37,18,19,17964,18962,36926
170610,201907,191,103,88,102794,87826.36,190620.36
170625,201907,35,20,15,19960,14970,34930
170650,201907,77,58,19,57884,18962,76846
170700,201907,574,438,136,438122.5,135728,573850.5
170710,201907,161,100,61,99800,60878.98,160678.98
170720,201907,88,70,18,69860,17964,87824
170730,201907,77,46,31,45908,30938,76846
170740,201907,84,62,22,61876,21956,83832
170755,201907,66,35,31,34930,30938,65868
170765,201907,136,72,64,71856.8,63872,135728.8
170770,201907,217,133,84,132734,84830,217564
170820,201907,595,395,200,394210,199600.8,593810.8
170825,201907,32,18,14,17964,13972,31936
170830,201907,83,66,17,65868,16966,82834
170900,201907,187,146,41,146706,40918,187624
170930,201907,886,479,407,478042.32,409180.4,887222.72
170950,201907,3071,1401,1670,1399197.38,1668658.05,3067855.43
170980,201907,17,10,7,9980,7984,17964
171050,201907,145,115,30,115768,29940,145708
171070,201907,38,32,6,31936,5988,37924
171090,201907,44,33,11,32934,10978,43912
171110,201907,20,12,8,11976,7984,19960
171150,201907,42,21,21,20958,20958,41916
171180,201907,23,13,10,12974,9980,22954
171190,201907,146,85,61,84830,60878,145708
171195,201907,62,51,11,50898,10978,61876
171200,201907,50,26,24,25948,23952,49900
171215,201907,5,3,2,2994,1996,4990
171240,201907,54,43,11,42914,10978,53892
171245,201907,56,50,6,49900,5988,55888
171250,201907,73,41,32,40918,31936,72854
171270,201907,15,11,4,10978,3992,14970
171280,201907,40,36,4,35928.7,3992,39920.7
171320,201907,991,584,407,584828,407184,992012
171330,201907,429,212,217,211576,216566,428142
171360,201907,82,60,22,61876,21956,83832
171370,201907,29,16,13,15968,12974,28942
171380,201907,133,111,22,110778,21956,132734
171395,201907,53,34,19,33932,18962,52894
171420,201907,287,188,99,190618,98802,289420
171430,201907,70,58,12,57884,11976,69860
171488,201907,177,100,77,99800,76846,176646
171500,201907,57,31,26,30938,25948,56886
171510,201907,66,44,22,43912,21956,65868
171515,201907,41,34,7,33932,6986.4,40918.4
171525,201907,29,27,2,26946,1996,28942
171550,201907,14,10,4,9980,3992,13972
171570,201907,56,29,27,28942,27944,56886
171575,201907,320,207,113,207584,112774,320358
171610,201907,1742,894,848,896210.84,848310.78,1744521.62
171620,201907,136,95,41,94810,40918,135728
171630,201907,58,32,26,31936,25948,57884
171650,201907,270,183,87,183632,86826,270458
171660,201907,265,146,119,145708,119760.4,265468.4
171665,201907,54,38,16,37924,15968,53892
171670,201907,425,252,173,251496.5,173652,425148.5
171700,201907,66,59,7,58882,6986,65868
171720,201907,25,10,15,9980,14970,24950
171750,201907,101,55,46,54890,45908,100798
171780,201907,78,62,16,62874,15968,78842
171790,201907,77,67,10,66866,9980,76846
171800,201907,35,28,7,28942,7984,36926
171820,201907,2076,1209,867,1211572.44,868261.78,2079834.22
171830,201907,36,29,7,28942,6986,35928
171840,201907,61,40,21,39920,20958,60878
171845,201907,29,18,11,17964,11976,29940
171850,201907,39,29,10,28942,9980,38922
171855,201907,78,62,16,62874,15968,78842
171865,201907,8,7,1,6986,998,7984
171870,201907,33,24,9,23952,8982,32934
171875,201907,79,55,24,54890,23952,78842
171880,201907,32,20,12,20958,11976,32934
171884,201907,49,26,23,25948,22954,48902
171886,201907,124,52,72,51896,72854,124750
171888,201907,28,22,6,21956,5988,27944
171889,201907,20,14,6,13972,5988,19960
171890,201907,57,47,10,46906,9980,56886
171900,201907,41,28,13,27944,12974,40918
172000,201907,41,34,7,33932,6986,40918
172010,201907,45,37,8,36926,7984,44910
172015,201907,28,19,9,18962.58,8982,27944.58
172020,201907,137,88,49,87824,49900,137724
172025,201907,33,21,12,20958,11976,32934
172030,201907,40,24,16,23952,15968.98,39920.98
172049,201907,79,50,29,49900,28942,78842
172065,201907,145,93,52,92814,51896,144710
172080,201907,101,68,33,67864,32934,100798
172085,201907,26,14,12,13972,11976,25948
172090,201907,411,323,88,323352.18,87824,411176.18
172093,201907,22,19,3,18962,2994,21956
172097,201907,17,10,7,9980,6986.4,16966.4
172100,201907,4922,2829,2093,2824341.88,2095801.98,4920143.86
172110,201907,80,52,28,51896,27944,79840
172120,201907,1671,1431,240,1429137.6,240518.96,1669656.56
172125,201907,4,4,0,3992,0,3992
172130,201907,18,13,5,12974,4990,17964
172208,201907,199,125,74,124750,73852,198602
172210,201907,383,187,196,187624,195608.4,383232.4
210005,201907,2940,1858,1082,1863266.75,1087824.8,2951091.55
210010,201907,173,92,81,91816,83832,175648
210015,201907,38,28,10,27944,9980,37924
210020,201907,344,188,156,187624,155688,343312
210030,201907,337,221,116,220558,115768.98,336326.98
210040,201907,143,112,31,111776,30938,142714
210043,201907,259,188,71,188622,71856,260478
210047,201907,559,315,244,315368,251496,566864
210050,201907,296,220,76,219560,75848,295408
210055,201907,46,34,12,33932,11976,45908
210060,201907,557,451,106,451096,105788,556884
210070,201907,419,318,101,317364,100798,418162
210080,201907,109,99,10,99800,9980,109780
210083,201907,308,149,159,148702,159680,308382
210087,201907,37,28,9,27944,9980,37924
210090,201907,456,324,132,323352,132734,456086
210095,201907,467,346,121,346306,121756,468062
210100,201907,694,542,152,543910,152694,696604
210110,201907,138,84,54,83832,54890,138722
210120,201907,5253,4051,1202,4059873.08,1207581.53,5267454.61
210125,201907,208,125,83,125748,82834,208582
210130,201907,509,283,226,282434,226546,508980
210135,201907,32,20,12,19960,11976,31936
210140,201907,4387,3464,923,3467052.6,929138,4396190.6
210150,201907,376,243,133,242514,132734,375248
210160,201907,3353,2831,522,2846296.55,521954,3368250.55
210170,201907,1186,948,238,949098,239520,1188618
210173,201907,128,108,20,108782,19960,128742
210177,201907,412,216,196,219560,202594,422154
210180,201907,31,17,14,16966,13972,30938
210190,201907,418,280,138,280438,138722,419160
210193,201907,2,1,1,998,998,1996
210197,201907,83,57,26,56886,25948,82834
210200,201907,636,512,124,512972,123752,636724
210203,201907,246,165,81,166666,80838,247504
210207,201907,381,300,81,299400,81836,381236
210210,201907,765,710,55,711574,55888,767462
210215,201907,77,68,9,67864,8982,76846
210220,201907,402,335,67,336326,66866,403192
210230,201907,309,243,66,242514,66866,309380
210232,201907,1443,961,482,962072,488022,1450094
210235,201907,162,125,37,125748,36926,162674
210237,201907,42,24,18,23952,17964,41916
210240,201907,90,75,15,74850,14970,89820
210250,201907,187,156,31,157684,30938,188622
210255,201907,356,267,89,267464,88822,356286
210260,201907,409,271,138,270458,137724,408182
210270,201907,665,438,227,439120,229540,668660
210275,201907,54,42,12,41916,11976,53892
210280,201907,1066,700,366,698600.48,365268,1063868.48
210290,201907,514,351,163,351296,165668,516964
210300,201907,5645,3492,2153,3502980.39,2175640.97,5678621.36
210310,201907,111,78,33,77844,32934,110778
210312,201907,116,80,36,79840,35928,115768
210315,201907,113,86,27,85828,26946,112774
210317,201907,122,91,31,90818,30938,121756
210320,201907,2354,1973,381,1974044.96,384230,2358274.96
210325,201907,129,92,37,91816,36926.4,128742.4
210330,201907,4954,2738,2216,2760468.7,2282426,5042894.7
210340,201907,1317,968,349,967062,353293.94,1320355.94
210350,201907,618,518,100,518960,100798,619758
210355,201907,148,119,29,118762,28942,147704
210360,201907,2454,1629,825,1629734.06,860276.4,2490010.46
210370,201907,1243,579,664,578840,663670,1242510
210375,201907,190,97,93,96806,92814,189620
210380,201907,707,542,165,541914,169660,711574
210390,201907,199,166,33,165668,32934,198602
210400,201907,410,352,58,353292,57884.96,411176.96
210405,201907,1014,705,309,703590,310378,1013968
210407,201907,54,43,11,42914,10978,53892
210408,201907,59,53,6,52894,5988,58882
210409,201907,333,287,46,286426,45908,332334
210410,201907,433,339,94,338322,93812,432134
210420,201907,201,165,36,164670,35928,200598
210430,201907,42,29,13,28942,12974,41916
210440,201907,347,225,122,224550,124750,349300
210450,201907,155,120,35,119760,35928,155688
210455,201907,227,124,103,123752.4,102794,226546.4
210460,201907,324,209,115,210578,114770,325348
210462,201907,66,55,11,54890,10978,65868
210465,201907,157,114,43,113772,43912,157684
210467,201907,528,382,146,384230,146706.98,530936.98
210470,201907,50,43,7,42914,6986,49900
210480,201907,1298,926,372,926144,372254.75,1298398.75
210490,201907,211,135,76,135728,75848,211576
210500,201907,549,315,234,315368,238522,553890
210510,201907,578,457,121,457084,121756,578840
210515,201907,405,237,168,236526,171656,408182
210520,201907,409,362,47,363272,46906,410178
210530,201907,9401,5071,4330,5084814.96,4340305.62,9425120.58
210535,201907,129,96,33,96806,32934,129740
210540,201907,1515,966,549,969058.2,553890,1522948.2
210542,201907,1199,615,584,613770,584828.8,1198598.8
210545,201907,16,15,1,14970,998,15968
210547,201907,132,114,18,113772,17964,131736
210550,201907,713,514,199,513970.44,198602,712572.44
210560,201907,172,148,24,149700,24950,174650
210565,201907,25,20,5,19960,4990,24950
210570,201907,1332,1070,262,1071852.44,264470,1336322.44
210580,201907,115,100,15,99800,14970,114770
210590,201907,758,613,145,616764,146706,763470
210592,201907,32,29,3,28942,2994,31936
210594,201907,109,92,17,91816,16966,108782
210596,201907,95,80,15,79840,14970,94810
210598,201907,126,94,32,93812,31936,125748
210600,201907,333,283,50,284430,49900,334330
210610,201907,254,236,18,236526,17964,254490
210620,201907,43,27,16,26946,15968,42914
210630,201907,70,67,3,66866,2994,69860
210632,201907,1047,715,332,715566,332334,1047900
210635,201907,22,19,3,18962,2994,21956
210637,201907,101,73,28,72854,29940,102794
210640,201907,583,510,73,509978,72854,582832
210650,201907,400,328,72,331336,72854,404190
210660,201907,396,296,100,298402,100798.58,399200.58
210663,201907,26,17,9,16966,8982,25948
210667,201907,108,37,71,36926,72854,109780
210670,201907,263,233,30,232534,29940,262474
210675,201907,562,304,258,303392,261476,564868
210680,201907,213,139,74,139720,73852,213572
210690,201907,635,509,126,509978,126746,636724
210700,201907,173,130,43,129740,42914,172654
210710,201907,273,162,111,161676,115768,277444
210720,201907,137,119,18,118762,17964,136726
210725,201907,70,62,8,61876,7984,69860
210730,201907,25,18,7,17964,6986,24950
210735,201907,393,275,118,275448,117764.4,393212.4
210740,201907,551,470,81,469060,80838,549898
210745,201907,157,117,40,116766,39920,156686
210750,201907,2417,1189,1228,1192610.5,1242510.4,2435120.9
210760,201907,260,196,64,197604,63872,261476
210770,201907,399,314,85,314370,84830,399200
210780,201907,408,302,106,307384,109780,417164
210790,201907,187,148,39,147704,39920,187624
210800,201907,168,128,40,127744,39920,167664
210805,201907,52,48,4,47904,3992,51896
210810,201907,481,384,97,389220,96806,486026
210820,201907,2223,1833,390,1835323.76,397204,2232527.76
210825,201907,167,91,76,90818,76846,167664
210830,201907,760,489,271,489020,273452,762472
210840,201907,205,141,64,140718,64870,205588
210845,201907,250,168,82,167664,84830,252494
210850,201907,801,532,269,531934,270458,802392
210860,201907,3949,2146,1803,2154682.9,1818356,3973038.9
210870,201907,469,364,105,363272,104790,468062
210880,201907,72,55,17,54890,16966,71856
210890,201907,327,277,50,276446,51896,328342
210900,201907,600,391,209,390218,213572,603790
210905,201907,65,33,32,32934,31936,64870
210910,201907,1987,1497,490,1499995.48,493012,1993007.48
210920,201907,189,62,127,61876,130738,192614
210923,201907,81,58,23,58882,23952,82834
210927,201907,421,187,234,188622,233532,422154
210930,201907,72,58,14,57884,14970,72854
210940,201907,87,68,19,67864,18962,86826
210945,201907,206,104,102,104790,101796,206586
210950,201907,525,393,132,392214,133732,525946
210955,201907,74,50,24,49900,24950,74850
210960,201907,2269,1070,1199,1073848,1215564,2289412
210970,201907,113,100,13,99800,12974,112774
210975,201907,84,76,8,75848,7984,83832
210980,201907,1133,529,604,531934,609778.4,1141712.4
210990,201907,4201,2699,1502,2704581,1518956,4223537
211000,201907,1339,1077,262,1076842.4,267464,1344306.4
211003,201907,887,617,270,615766,272454,888220
211010,201907,499,443,56,442114,56886,499000
211020,201907,1517,605,912,607782,926144,1533926
211023,201907,32,27,5,26946,4990,31936
211027,201907,73,54,19,53892,19960,73852
211030,201907,386,271,115,270458,115768,386226
211040,201907,310,252,58,252494.4,57884,310378.4
211050,201907,1172,770,402,771454,405188.4,1176642.4
211060,201907,666,570,96,570856.8,95808,666664.8
211065,201907,22,18,4,17964,3992,21956
211070,201907,912,751,161,752492.66,161676,914168.66
211080,201907,84,80,4,79840,3992,83832
211085,201907,58,30,28,29940.4,27944,57884.4
211090,201907,91,73,18,72854,17964,90818
211100,201907,494,402,92,401196,94810.4,496006.4
211102,201907,249,170,79,170658,78842,249500
211105,201907,223,157,66,156686,66866,223552
211107,201907,135,80,55,79840,54890,134730
211110,201907,831,543,288,541914,288422.98,830336.98
211120,201907,5594,2669,2925,2684622.2,2963063.72,5647685.92
211125,201907,30,23,7,22954,6986,29940
211130,201907,43822,19466,24356,19517896.96,24621666.33,44139563.29
211140,201907,413,357,56,358282.99,57884,416166.99
211150,201907,1287,830,457,830336,457085.39,1287421.39
211153,201907,165,98,67,97804,66866,164670
211157,201907,66,53,13,52894,13972,66866
211160,201907,714,606,108,606784,107784,714568
211163,201907,0,,,,,0.0
211167,201907,10,9,1,9980,998,10978
211170,201907,433,315,118,315368,118762,434130
211172,201907,120,83,37,82834,36926,119760
211174,201907,258,158,100,157684,99800,257484
211176,201907,502,372,130,376246.4,130738,506984.4
211178,201907,90,60,30,59880,29940,89820
211180,201907,206,166,40,165668,40918,206586
211190,201907,69,64,5,63872,4990,68862
211195,201907,34,24,10,23952,9980,33932
211200,201907,151,130,21,129740,20958,150698
211210,201907,473,327,146,326346,148702,475048
211220,201907,4075,2360,1715,2371250.53,1728537.99,4099788.52
211223,201907,95,91,4,90818,3992,94810
211227,201907,72,54,18,53892,17964,71856
211230,201907,761,622,139,622752,140718,763470
211240,201907,409,313,96,312374,96806,409180
211245,201907,193,92,101,91816,100798,192614
211250,201907,1604,1382,222,1384227.59,222554.94,1606782.53
211260,201907,828,668,160,668660,164670,833330
211270,201907,2034,1646,388,1645702.4,396206.8,2041909.2
211280,201907,1822,1151,671,1155684,687622,1843306
211285,201907,201,122,79,121756,78842,200598
211290,201907,684,474,210,476046,213572,689618
211300,201907,793,626,167,624748.96,167664,792412.96
211400,201907,1565,945,620,944108,627742,1571850
220005,201907,17,16,1,15968,998,16966
220010,201907,90,68,22,67864,21956,89820
220020,201907,671,539,132,538920,131736,670656
220025,201907,109,106,3,106786,2994,109780
220027,201907,39,32,7,31936,6986,38922
220030,201907,102,83,19,84830,18962,103792
220040,201907,1202,918,284,922152.6,286426,1208578.6
220045,201907,39,28,11,27944,10978,38922
220050,201907,679,571,108,571855.08,107784,679639.08
220060,201907,170,149,21,149700,20958,170658
220070,201907,105,97,8,96806,7984,104790
220080,201907,16,14,2,13972,1996,15968
220090,201907,33,27,6,26946,5988,32934
220095,201907,2,1,1,998,998,1996
220100,201907,22,18,4,17964,3992,21956
220105,201907,24,23,1,22954.4,998,23952.4
220110,201907,219,202,17,202594,17964,220558
220115,201907,39,38,1,38922,998,39920
220117,201907,23,21,2,20958,1996,22954
220120,201907,1488,1106,382,1107780,381236,1489016
220130,201907,29,29,0,29940,0,29940
220140,201907,102,82,20,81836,19960,101796
220150,201907,486,353,133,352294,133732,486026
220155,201907,5,5,0,4990,0,4990
220157,201907,18,15,3,14970,2994,17964
220160,201907,81,71,10,70858,9980,80838
220170,201907,32,31,1,30938,998,31936
220173,201907,7,7,0,6986,0,6986
220177,201907,6,6,0,5988,0,5988
220180,201907,67,67,0,66866,0,66866
220190,201907,1069,960,109,960076,109780,1069856
220191,201907,43,38,5,38922,4990,43912
220192,201907,72,69,3,68862,2994,71856
220194,201907,46,44,2,43912,1996,45908
220196,201907,96,81,15,80838,14970,95808
220198,201907,3,2,1,1996,998,2994
220200,201907,418,350,68,350298.5,68862,419160.5
220202,201907,37,33,4,32934,3992,36926
220205,201907,44,40,4,39920,3992,43912
220207,201907,13,12,1,11976,998,12974
220208,201907,77,42,35,41916,34930,76846
220209,201907,30,27,3,26946,2994,29940
220210,201907,18,15,3,14970,2994,17964
220211,201907,26,25,1,24950,998,25948
220213,201907,41,37,4,36926,3992.4,40918.4
220217,201907,38,30,8,29940,7984,37924
220220,201907,2118,1379,739,1383228,740517.1,2123745.1
220225,201907,11,5,6,4990,5988,10978
220230,201907,973,774,199,772452,198602,971054
220240,201907,160,147,13,146706,12974,159680
220245,201907,33,30,3,29940.99,2994,32934.99
220250,201907,117,105,12,104790,11976,116766
220253,201907,39,34,5,34930,4990,39920
220255,201907,29,26,3,25948,2994,28942
220260,201907,708,524,184,522952,184630,707582
220265,201907,9,7,2,6986,1996,8982
220270,201907,735,660,75,658680,75848,734528
220271,201907,41,34,7,33932,6986,40918
220272,201907,24,24,0,23952,0,23952
220273,201907,14,13,1,12974,998,13972
220275,201907,56,46,10,45908,9980,55888
220277,201907,13,11,2,10978,1996,12974
220280,201907,14,11,3,10978,2994,13972
220285,201907,45,43,2,42914,1996,44910
220290,201907,1458,1254,204,1255484.4,205588.9,1461073.3
220300,201907,47,45,2,45908,1996,47904
220310,201907,316,269,47,268462.99,46906,315368.99
220320,201907,441,407,34,408182.4,33932,442114.4
220323,201907,0,,,,,0.0
220325,201907,15,10,5,9980,4990,14970
220327,201907,12,11,1,10978,998,11976
220330,201907,222,158,64,157684,63872,221556
220335,201907,136,118,18,117764,17964,135728
220340,201907,36,22,14,21956,13972,35928
220342,201907,59,52,7,51896,6986,58882
220345,201907,81,75,6,74850,5988,80838
220350,201907,436,382,54,382234,53892,436126
220360,201907,42,30,12,30938,11976,42914
220370,201907,1200,990,210,991014,213572,1204586
220375,201907,20,18,2,17964,1996,19960
220380,201907,19,16,3,15968,2994,18962
220385,201907,17,15,2,14970,1996,16966
220390,201907,2320,1334,986,1335324.84,986024.7,2321349.54
220400,201907,32,29,3,28942,2994,31936
220410,201907,21,18,3,17964,2994,20958
220415,201907,13,12,1,11976,998,12974
220420,201907,127,106,21,105788,20958,126746
220430,201907,131,119,12,118762,11976,130738
220435,201907,21,15,6,14970,5988,20958
220440,201907,294,251,43,251496,42914,294410
220450,201907,333,171,162,171656,162674,334330
220455,201907,54,52,2,51896,1996,53892
220460,201907,19,19,0,18962,0,18962
220465,201907,102,66,36,65868,35928,101796
220470,201907,240,211,29,210578,28942,239520
220480,201907,74,66,8,65868,7984,73852
220490,201907,90,77,13,77844,12974,90818
220500,201907,100,87,13,86826,12974,99800
220510,201907,441,342,99,342314,98802,441116
220515,201907,23,21,2,20958,1996,22954
220520,201907,369,333,36,339320.34,35928,375248.34
220525,201907,16,11,5,10978,4990,15968
220527,201907,29,22,7,21956,6986,28942
220530,201907,31,12,19,11976,18962,30938
220535,201907,5,5,0,4990,0,4990
220540,201907,62,51,11,50898,10978,61876
220545,201907,47,33,14,33932,13972,47904
220550,201907,666,519,147,519958,147704,667662
220551,201907,17,13,4,12974,3992,16966
220552,201907,14,14,0,13972,0,13972
220553,201907,51,47,4,46906,3992,50898
220554,201907,9,7,2,6986,1996,8982
220555,201907,31,27,4,26946,3992,30938
220556,201907,49,45,4,44910,3992,48902
220557,201907,56,51,5,50898,4990,55888
220558,201907,9,4,5,3992,4990,8982
220559,201907,2,2,0,1996,0,1996
220560,201907,70,45,25,44910,24950,69860
220570,201907,783,481,302,481036.4,303392,784428.4
220580,201907,555,512,43,510976,42914,553890
220585,201907,6,5,1,4990,998,5988
220590,201907,14,14,0,13972,0,13972
220595,201907,62,47,15,46906,14970,61876
220600,201907,19,12,7,11976,6986,18962
220605,201907,22,20,2,19960,1996,21956
220610,201907,71,63,8,62874,8982,71856
220620,201907,563,459,104,462074,103792,565866
220630,201907,5,4,1,3992,998,4990
220635,201907,39,35,4,34930,3992,38922
220640,201907,103,83,20,82834,19960,102794
220650,201907,113,106,7,105788,6986,112774
220660,201907,41,32,9,31936,8982,40918
220665,201907,4,4,0,3992,0,3992
220667,201907,22,19,3,18962,2994,21956
220669,201907,29,26,3,25948,2994,28942
220670,201907,64,52,12,51896,11976,63872
220672,201907,66,46,20,45908,19960,65868
220675,201907,37,29,8,28942,7984,36926
220680,201907,40,34,6,33932,5988,39920
220690,201907,44,42,2,41916,1996,43912
220695,201907,47,21,26,20958,25948,46906
220700,201907,1707,1324,383,1324346,383232,1707578
220710,201907,4,3,1,2994,998,3992
220720,201907,107,87,20,87824,19960,107784
220730,201907,18,18,0,17964,0,17964
220735,201907,3,1,2,998,1996,2994
220740,201907,49,45,4,45908,3992,49900
220750,201907,110,93,17,93812,16966,110778
220755,201907,14,14,0,13972,0,13972
220760,201907,61,58,3,57884,2994,60878
220770,201907,5718,3057,2661,3054880.66,2668655.32,5723535.98
220775,201907,17,9,8,8982,8982,17964
220777,201907,17,16,1,15968,998,16966
220779,201907,0,0,0,0,0,0
220780,201907,883,756,127,758480,128742.4,887222.4
220785,201907,4,1,3,998,2994,3992
220790,201907,1065,855,210,856284.82,209580,1065864.82
220793,201907,6,6,0,5988,0,5988
220795,201907,15,14,1,13972,998,14970
220800,201907,4016,3091,925,3088812.88,925146.99,4013959.87
220810,201907,64,56,8,56886.4,7984,64870.4
220820,201907,247,225,22,224550,21956,246506
220830,201907,1218,1056,162,1061872,164670,1226542
220840,201907,2434,1702,732,1702591.33,730536.78,2433128.11
220850,201907,54,46,8,45908,7984,53892
220855,201907,9,6,3,5988,2994,8982
220860,201907,12,11,1,10978,998,11976
220865,201907,31,29,2,28942,1996,30938
220870,201907,69,63,6,62874,5988,68862
220880,201907,322,256,66,256486,65868.4,322354.4
220885,201907,38,35,3,34930,2994,37924
220887,201907,14,14,0,13972,0,13972
220890,201907,101,89,12,88822,11976,100798
220900,201907,19,12,7,11976,6986,18962
220910,201907,56,47,9,46906,8982,55888
220915,201907,11,10,1,9980,998,10978
220920,201907,48,44,4,44910,3992,48902
220930,201907,40,39,1,38922,998,39920
220935,201907,15,15,0,15968,0,15968
220937,201907,39,38,1,37924,998,38922
220940,201907,56,51,5,50898,4990,55888
220945,201907,0,,,,,0.0
220950,201907,46,41,5,40918,4990,45908
220955,201907,23,21,2,20958,1996,22954
220960,201907,7,7,0,6986,0,6986
220965,201907,35,32,3,31936,2994,34930
220970,201907,58,48,10,47904,9980,57884
220975,201907,12,9,3,8982,2994,11976
220980,201907,32,30,2,29940,1996,31936
220985,201907,66,58,8,57884,7984,65868
220987,201907,32,30,2,29940,1996,31936
220990,201907,19,18,1,17964,998,18962
220995,201907,22,18,4,17964,3992,21956
220997,201907,60,50,10,49900,9980,59880
221000,201907,1153,1041,112,1044906,112774,1157680
221005,201907,59,52,7,51896,6986,58882
221010,201907,16,12,4,12974,3992,16966
221020,201907,43,41,2,40918,1996,42914
221030,201907,32,26,6,25948,5988,31936
221035,201907,24,24,0,23952,0,23952
221037,201907,12,8,4,7984,3992,11976
221038,201907,27,24,3,23952,2994,26946
221039,201907,22,22,0,21956,0,21956
221040,201907,257,221,36,220558,35928,256486
221050,201907,234,202,32,201596,31936,233532
221060,201907,1839,1622,217,1622748,216566,1839314
221062,201907,34,33,1,32934,998,33932
221063,201907,14,10,4,9980,3992,13972
221065,201907,53,46,7,45908,6986,52894
221070,201907,139,120,19,121756,18962,140718
221080,201907,378,331,47,330338,46906,377244
221090,201907,29,28,1,27944,998,28942
221093,201907,53,36,17,35928,16966,52894
221095,201907,9,9,0,8982,0,8982
221097,201907,16,13,3,12974,2994,15968
221100,201907,25220,14916,10304,14933082.24,10330299.8,25263382.04
221110,201907,1072,802,270,805386.4,270458,1075844.4
221120,201907,535,401,134,401196.4,133732,534928.4
221130,201907,960,787,173,791414,172654,964068
221135,201907,35,32,3,31936,2994,34930
221140,201907,44,38,6,37924,5988,43912
221150,201907,12,9,3,8982,2994,11976
221160,201907,13,13,0,12974,0,12974
221170,201907,15,15,0,14970,0,14970
230010,201907,164,150,14,149700,13972,163672
230015,201907,125,103,22,102794,21956,124750
230020,201907,1636,1387,249,1387220.4,249507.76,1636728.16
230030,201907,1678,1212,466,1214567.78,466066,1680633.78
230040,201907,210,183,27,182634.4,26946,209580.4
230050,201907,221,164,57,163672,56886,220558
230060,201907,157,129,28,128742,29940,158682
230070,201907,294,264,30,263472,30938,294410
230075,201907,847,743,104,744508.8,103792,848300.8
230080,201907,195,169,26,169660,25948,195608
230090,201907,109,78,31,77844,31936,109780
230100,201907,2031,1211,820,1211577.5,821356.84,2032934.34
230110,201907,2796,1828,968,1826340.8,970056,2796396.8
230120,201907,962,774,188,777443.54,187624,965067.54
230125,201907,147,123,24,122754,23952,146706
230130,201907,474,425,49,424150,48902,473052
230140,201907,212,182,30,182634,29940,212574
230150,201907,153,118,35,117764,35928,153692
230160,201907,938,806,132,806384,132734,939118
230170,201907,595,542,53,541915,52894,594809
230180,201907,79,74,5,73852,4990,78842
230185,201907,407,353,54,354290,53892,408182
230190,201907,2305,1849,456,1849295.74,455088,2304383.74
230195,201907,488,425,63,424150,62874,487024
230200,201907,383,330,53,331336,52894,384230
230205,201907,392,254,138,253492,137724,391216
230210,201907,1300,1038,262,1035926.22,263472.94,1299399.16
230220,201907,1545,1054,491,1053888,491018.82,1544906.82
230230,201907,904,782,122,781434,121756,903190
230240,201907,1705,1470,235,1471302.86,235529.14,1706832.00
230250,201907,1805,1490,315,1489017.58,314370,1803387.58
230260,201907,3094,1925,1169,1928136.96,1168658,3096794.96
230270,201907,1366,1103,263,1101794.17,262474,1364268.17
230280,201907,2736,2053,683,2053885.27,681634,2735519.27
230290,201907,412,366,46,367267.61,45908,413175.61
230300,201907,513,382,131,382234,130738,512972
230310,201907,421,321,100,321356,99800,421156
230320,201907,937,802,135,802393.4,137724,940117.4
230330,201907,306,246,60,245508,59880.6,305388.6
230340,201907,444,362,82,361276.6,83832,445108.6
230350,201907,3094,1970,1124,1969055.9,1122750,3091805.9
230360,201907,271,217,54,216566,53892,270458
230365,201907,143,115,28,114770,27944,142714
230370,201907,9846,4911,4935,4908244.79,4941191.87,9849436.66
230380,201907,479,414,65,413173.36,65868.2,479041.56
230390,201907,524,293,231,293412,231536,524948
230393,201907,258,218,40,217564,39920,257484
230395,201907,355,284,71,283432.48,70858,354290.48
230400,201907,606,483,123,483032,122754,605786
230410,201907,2669,1676,993,1675643.09,992013.94,2667657.03
230420,201907,6293,4179,2114,4185615.84,2112768.56,6298384.40
230423,201907,320,280,40,279440,39920,319360
230425,201907,392,324,68,323352.34,67864,391216.34
230426,201907,123,100,23,99800,23952,123752
230427,201907,80,77,3,76846,2994,79840
230428,201907,1459,747,712,746504.96,710577.88,1457082.84
230430,201907,463,382,81,381236.99,80838,462074.99
230435,201907,848,601,247,599798.31,247504.98,847303.29
230440,201907,85982,38641,47341,38667809.6,47366470.16,86034279.76
230445,201907,296,207,89,206586,88822,295408
230450,201907,540,435,105,434130,105788,539918
230460,201907,59,48,11,47904,10978,58882
230465,201907,307,250,57,251496,56886,308382
230470,201907,1975,1556,419,1558876.94,419160.5,1978037.44
230480,201907,160,151,9,150698,8982,159680
230490,201907,295,236,59,236526,59880,296406
230495,201907,455,338,117,338322,116766,455088
230500,201907,1003,744,259,743510,258482,1001992
230510,201907,52,41,11,40918,10978,51896
230520,201907,385,303,82,302394.18,83832,386226.18
230523,201907,2233,1428,805,1428139.22,803391.34,2231530.56
230526,201907,284,238,46,237524,45908,283432
230530,201907,674,507,167,507982.94,166666,674648.94
230533,201907,195,186,9,187624,8982,196606
230535,201907,367,274,93,274450,92814,367264
230540,201907,1852,1636,216,1636720,216566,1853286
230550,201907,3764,2431,1333,2426141.48,1335324,3761465.48
230560,201907,580,444,136,444110.8,136726.94,580837.74
230565,201907,211,156,55,155688,54890,210578
230570,201907,296,261,35,264470,34930,299400
230580,201907,1142,851,291,849298.94,292414,1141712.94
230590,201907,987,771,216,770457.46,215568,986025.46
230600,201907,244,224,20,225548,20958,246506
230610,201907,352,282,70,281436.6,70858,352294.6
230620,201907,173,144,29,143712.4,28942,172654.4
230625,201907,735,529,206,527942.5,205588.94,733531.44
230630,201907,1317,1041,276,1040914,277444,1318358
230640,201907,3715,3222,493,3218551,494014.53,3712565.53
230650,201907,437,381,56,380239.91,55888,436127.91
230655,201907,663,575,88,574848.6,87827.89,662676.49
230660,201907,359,305,54,304390,53892,358282
230670,201907,432,379,53,379240,52894,432134
230680,201907,200,182,18,181636,17964,199600
230690,201907,893,772,121,770456,120758,891214
230700,201907,774,657,117,657682.94,116766.94,774449.88
230710,201907,728,692,36,693610.6,35928,729538.6
230720,201907,150,131,19,131736,18962,150698
230725,201907,263,212,51,213572,50898.98,264470.98
230730,201907,12020,6532,5488,6547881,5500981.29,12048862.29
230740,201907,671,541,130,540916.4,129740,670656.4
230750,201907,829,710,119,710576.6,118762,829338.6
230760,201907,1403,1214,189,1214566,188622,1403188
230763,201907,320,268,52,267464,51896,319360
230765,201907,7200,3398,3802,3407218.54,3805418.25,7212636.79
230770,201907,4982,2577,2405,2573848.06,2402187.34,4976035.40
230780,201907,698,616,82,615766,82834,698600
230790,201907,247,206,41,206586,40918,247504
230800,201907,1123,826,297,825346,296406,1121752
230810,201907,1346,1195,151,1193608,150698,1344306
230820,201907,352,248,104,248502.4,103792,352294.4
230830,201907,967,830,137,829338,136726,966064
230835,201907,285,249,36,248502,35928,284430
230837,201907,169,144,25,143712,24950,168662
230840,201907,915,735,180,733530.4,181636.4,915166.8
230850,201907,1489,1297,192,1294406,191616,1486022
230860,201907,297,222,75,221556,74850,296406
230870,201907,1838,1573,265,1572848.96,264470,1837318.96
230880,201907,62,46,16,45908,15968,61876
230890,201907,554,510,44,508980,43912.97,552892.97
230900,201907,280,209,71,209580,71856.58,281436.58
230910,201907,215,173,42,172654,41916,214570
230920,201907,420,331,89,331336,88822,420158
230930,201907,947,679,268,681634.68,269460.94,951095.62
230940,201907,836,667,169,668660.98,170658.6,839319.58
230945,201907,499,418,81,417165,80838,498003
230950,201907,409,351,58,354290,58882,413172
230960,201907,2626,1797,829,1802391.8,832334.28,2634726.08
230970,201907,1757,989,768,989028.34,766474.4,1755502.74
230980,201907,208,176,32,175648,32934,208582
230990,201907,134,110,24,111776,23952,135728
231000,201907,207,188,19,187624,18962,206586
231010,201907,147,113,34,112774,33932,146706
231020,201907,1330,929,401,931149.28,401199.82,1332349.10
231025,201907,1037,784,253,784428.6,254490.4,1038919.0
231030,201907,1118,939,179,941115.01,180638,1121753.01
231040,201907,137,94,43,94810,42914,137724
231050,201907,979,873,106,873250,105788,979038
231060,201907,144,123,21,123752,20958,144710
231070,201907,1448,1031,417,1032932.6,416166.94,1449099.54
231080,201907,263,244,19,243512,18962,262474
231085,201907,580,360,220,359280.6,219560.96,578841.56
231090,201907,246,202,44,201596,43912,245508
231095,201907,164,131,33,131736,32934,164670
231100,201907,140,119,21,119760,20958,140718
231110,201907,365,314,51,313372,50898,364270
231120,201907,286,244,42,245508,41916,287424
231123,201907,146,140,6,139720,5988,145708
231126,201907,329,260,69,260478,68862,329340
231130,201907,4612,3603,1009,3604777.93,1006983.91,4611761.84
231135,201907,212,185,27,186626,26946,213572
231140,201907,3087,2288,799,2285420,798400,3083820
231150,201907,362,346,16,346306,15968,362274
231160,201907,1188,950,238,949098.94,237524.94,1186623.88
231170,201907,535,369,166,369260,165668,534928
231180,201907,1690,1446,244,1447100,243512,1690612
231190,201907,207,177,30,176646,29940,206586
231195,201907,222,190,32,189620,31936,221556
231200,201907,821,669,152,667662,151696.6,819358.6
231210,201907,597,500,97,500996,96806,597802
231220,201907,1037,758,279,757482.9,279440.94,1036923.84
231230,201907,1431,1143,288,1142710,289420,1432130
231240,201907,1409,1028,381,1026942.94,382234.4,1409177.34
231250,201907,115,105,10,104790,9980,114770
231260,201907,279,184,95,183632,94810,278442
231270,201907,1012,838,174,840317.49,173652,1013969.49
231280,201907,67,50,17,50898,16966,67864
231290,201907,7449,4187,3262,4191600.4,3271445.8,7463046.2
231300,201907,629,582,47,581834,46906,628740
231310,201907,747,690,57,689618.74,56886,746504.74
231320,201907,585,447,138,446108,137724,583832
231325,201907,93,83,10,83832,10978,94810
231330,201907,2028,1577,451,1578089.53,450098,2028187.53
231335,201907,250,222,28,221556,27944,249500
231340,201907,1690,1245,445,1243508,445108,1688616
231350,201907,1258,1034,224,1035924,224550.8,1260474.8
231355,201907,430,373,57,372254,56886,429140
231360,201907,494,376,118,377244.4,117764,495008.4
231370,201907,89,75,14,74850,13972,88822
231375,201907,287,207,80,206586,79840,286426
231380,201907,473,387,86,386226,85828,472054
231390,201907,200,163,37,162674,36926,199600
231395,201907,726,460,266,459080,267464,726544
231400,201907,1124,931,193,932135.04,193614.34,1125749.38
231410,201907,1323,1082,241,1079836.2,240519.74,1320355.94
240010,201907,386,174,212,173652.43,211576.98,385229.41
240020,201907,2285,1816,469,1816361.5,469061.97,2285423.47
240030,201907,125,108,17,108782,16966,125748
240040,201907,31,31,0,30938,0,30938
240050,201907,523,450,73,450098,72854,522952
240060,201907,66,62,4,62874,3992,66866
240070,201907,205,160,45,159680,45908,205588
240080,201907,498,333,165,332334.99,164670.46,497005.45
240090,201907,103,92,11,91816,10978,102794
240100,201907,1487,1407,80,1408179.5,79840,1488019.5
240110,201907,1055,690,365,694609.58,367265.1,1061874.68
240120,201907,137,117,20,117764,20958,138722
240130,201907,288,268,20,268462,19960,288422
240140,201907,83,65,18,64870,17964,82834
240145,201907,717,640,77,640716,76846,717562
240150,201907,19,16,3,15968,2994,18962
240160,201907,41,37,4,36926,3992,40918
240165,201907,38,32,6,31936.5,5988,37924.5
240170,201907,94,70,24,69860,23952,93812
240180,201907,80,67,13,66866,12974,79840
240185,201907,46,41,5,40918,4990,45908
240190,201907,13,11,2,10978,1996,12974
240200,201907,3080,1721,1359,1722550.8,1357281.8,3079832.6
240210,201907,167,130,37,129740,36926,166666
240220,201907,1097,798,299,797402.7,298402,1095804.7
240230,201907,864,799,65,798400.77,65868,864268.77
240240,201907,77,53,24,53892,23952,77844
240250,201907,87,77,10,76846,9980,86826
240260,201907,1796,1344,452,1345304,455088,1800392
240270,201907,188,167,21,166666,20958,187624
240280,201907,42,31,11,30938,10978,41916
240290,201907,50,49,1,48902,998,49900
240300,201907,171,99,72,98802,71856,170658
240310,201907,2200,1229,971,1228540.27,969058.74,2197599.01
240320,201907,201,190,11,189620,10978,200598
240325,201907,4325,2650,1675,2655682.27,1675644.07,4331326.34
240330,201907,66,62,4,61876,3992,65868
240340,201907,62,40,22,39920,21956,61876
240350,201907,90,83,7,82834,7984,90818
240360,201907,470,326,144,325348,144710,470058
240370,201907,47,44,3,43912,2994,46906
240375,201907,70,40,30,40918,29940,70858
240380,201907,225,185,40,184630,39920.8,224550.8
240390,201907,14,12,2,11976,1996,13972
240400,201907,83,78,5,77844,4990,82834
240410,201907,11,7,4,6986,3992,10978
240420,201907,948,714,234,713570.2,233532,947102.2
240430,201907,267,251,16,251496,15968,267464
240440,201907,97,54,43,53892,42914,96806
240450,201907,216,148,68,147704.4,67864,215568.4
240460,201907,60,46,14,45908,13972,59880
240470,201907,242,211,31,210578,30938,241516
240480,201907,15,13,2,12974,1996,14970
240485,201907,80,68,12,67864,11976,79840
240490,201907,46,44,2,43912,1996,45908
240500,201907,83,66,17,66866,16966,83832
240510,201907,50,36,14,35928,13972,49900
240520,201907,120,115,5,114770,4990,119760
240530,201907,55,49,6,48902,5988,54890
240540,201907,78,67,11,67864,10978,78842
240550,201907,13,12,1,11976,998,12974
240560,201907,374,272,102,273452,101796,375248
240570,201907,457,285,172,285428.94,171656.4,457085.34
240580,201907,1254,1013,241,1013969.4,240518.99,1254488.39
240590,201907,29,27,2,26946,1996,28942
240600,201907,110,107,3,106786,2994,109780
240610,201907,512,429,83,428142.4,82834,510976.4
240615,201907,20,19,1,18962,998,19960
240620,201907,90,86,4,85828,3992,89820
240630,201907,36,34,2,33932,1996,35928
240640,201907,27,22,5,21956,4990,26946
240650,201907,238,200,38,199600,37924,237524
240660,201907,103,90,13,89820,12974,102794
240670,201907,296,177,119,177644.7,118762,296406.7
240680,201907,50,40,10,39920,9980,49900
240690,201907,47,45,2,44910,1996,46906
240700,201907,193,156,37,157684,36926,194610
240710,201907,1925,1224,701,1222551.3,701594,1924145.3
240720,201907,1078,805,273,805386,276446.2,1081832.2
240725,201907,64,60,4,59880,3992,63872
240730,201907,141,125,16,124750,16966,141716
240740,201907,232,198,34,201596,33932.74,235528.74
240750,201907,50,27,23,26946,22954,49900
240760,201907,45,41,4,40918,3992,44910
240770,201907,147,115,32,114770,31936,146706
240780,201907,683,564,119,563870,120758,684628
240790,201907,38,37,1,36926,998,37924
240800,201907,9224,6302,2922,6308369.56,2923145.68,9231515.24
240810,201907,20089,11102,8987,11109760.04,8996002.74,20105762.78
240820,201907,219,138,81,137724.19,80838,218562.19
240830,201907,1629,1340,289,1344306.7,292414,1636720.7
240840,201907,84,74,10,73852,9980,83832
240850,201907,85,76,9,75848,8982,84830
240860,201907,110,107,3,106786,2994,109780
240870,201907,59,51,8,50898,7984,58882
240880,201907,29,26,3,25948,2994,28942
240890,201907,1170,682,488,681635.46,487024.99,1168660.45
240895,201907,58,37,21,36926,20958,57884
240910,201907,157,142,15,142714,14970,157684
240920,201907,15,12,3,11976,2994,14970
240930,201907,408,366,42,366266,41916,408182
240933,201907,35,27,8,26946,7984,34930
240940,201907,2436,2153,283,2151689.14,282434,2434123.14
240950,201907,49,46,3,45908,2994,48902
240960,201907,30,25,5,24950,4990,29940
240970,201907,115,82,33,82834,32934,115768
240980,201907,197,160,37,159680,36926,196606
240990,201907,123,81,42,80838,41916,122754
241000,201907,65,61,4,60878,3992,64870
241010,201907,60,48,12,47904,11976,59880
241020,201907,115,106,9,105788,8982,114770
241025,201907,8,3,5,2994,4990,7984
241030,201907,113,93,20,92814,19960,112774
241040,201907,37,30,7,29940,6986,36926
241050,201907,85,76,9,75848,8982,84830
241060,201907,29,24,5,23952,4990,28942
241070,201907,18,18,0,17964,0,17964
241080,201907,61,55,6,54890,5988,60878
241090,201907,48,40,8,40918,8982,49900
241100,201907,71,61,10,61876,9980,71856
241105,201907,6,1,5,998,4990,5988
241110,201907,49,45,4,44910,3992,48902
241120,201907,1453,1123,330,1123748,331336,1455084
241140,201907,222,184,38,184630.4,37924,222554.4
241142,201907,43,39,4,38922,3992,42914
241150,201907,1177,1037,140,1036922,140718,1177640
241160,201907,20,20,0,19960,0,19960
241170,201907,43,38,5,37924,4990,42914
241180,201907,46,40,6,39920,5988,45908
241190,201907,38,37,1,36926,998,37924
241200,201907,3851,2071,1780,2069855.87,1782429.89,3852285.76
241210,201907,67,58,9,57884,8982,66866
241220,201907,1398,953,445,952092.71,445108.97,1397201.68
241230,201907,239,204,35,203592,35928,239520
241240,201907,54,42,12,41916,12974,54890
241250,201907,1147,1047,100,1044906.4,99800,1144706.4
241255,201907,52,41,11,40918,10978,51896
241260,201907,646,508,138,506984,137724,644708
241270,201907,47,34,13,33932,12974,46906
241280,201907,99,85,14,84830,13972,98802
241290,201907,110,85,25,84830,24950,109780
241300,201907,74,55,19,54890,18962,73852
241310,201907,51,38,13,37924.7,12974,50898.7
241320,201907,30,17,13,16966,12974,29940
241330,201907,60,56,4,55888,3992,59880
241335,201907,67,60,7,59880,6986,66866
241340,201907,185,139,46,138722,46906,185628
241350,201907,60,55,5,54890,4990,59880
241355,201907,47,41,6,40918,5988,46906
241360,201907,52,51,1,50898,998,51896
241370,201907,48,40,8,39920,7984,47904
241380,201907,40,36,4,35928,3992,39920
241390,201907,80,65,15,64870,14970,79840
241400,201907,210,170,40,170658,39920,210578
241410,201907,185,166,19,165668,18962,184630
241415,201907,100,81,19,80838,18962,99800
241420,201907,96,72,24,72854,24950.64,97804.64
241430,201907,28,25,3,24950,2994,27944
241440,201907,524,422,102,421156.97,102794,523950.97
241445,201907,36,34,2,33932,1996,35928
241450,201907,288,237,51,237524,50898,288422
241460,201907,145,132,13,131736.5,12974,144710.5
241470,201907,41,34,7,33932,6986,40918
241475,201907,61,58,3,57884,2994,60878
241480,201907,95,70,25,69860,24950,94810
241490,201907,9,8,1,7984,998,8982
241500,201907,48,36,12,35928,11976,47904
250010,201907,102,86,16,85828,15968,101796
250020,201907,33,30,3,29940,2994,32934
250030,201907,834,632,202,631734,202594.6,834328.6
250040,201907,347,287,60,286426,59880,346306
250050,201907,237,196,41,196606.99,41916,238522.99
250053,201907,59,45,14,44910,13972,58882
250057,201907,0,,,,,0.0
250060,201907,479,372,107,371256,106786,478042
250070,201907,714,578,136,577842.75,135728,713570.75
250073,201907,8,8,0,7984,0,7984
250077,201907,187,143,44,142714,44910,187624
250080,201907,418,328,90,327344.72,89820,417164.72
250090,201907,196,131,65,130738,65868,196606
250100,201907,509,423,86,422154,85828.2,507982.2
250110,201907,570,433,137,432134,136726,568860
250115,201907,22,7,15,6986,14970,21956
250120,201907,113,83,30,83832,29940,113772
250130,201907,576,471,105,472054,104790.6,576844.6
250135,201907,14,9,5,8982,4990,13972
250140,201907,83,74,9,73852,8982,82834
250150,201907,574,420,154,420158,154690,574848
250153,201907,8,7,1,6986,998,7984
250157,201907,30,23,7,22954,6986,29940
250160,201907,213,170,43,169660,42914,212574
250170,201907,61,42,19,41916,18962,60878
250180,201907,4070,2805,1265,2816358.76,1267464.15,4083822.91
250190,201907,854,568,286,567862,286426.5,854288.5
250200,201907,51,43,8,42914,7984,50898
250205,201907,23,20,3,19960,2994,22954
250210,201907,86,77,9,76846,8982,85828
250215,201907,62,54,8,53892,7984,61876
250220,201907,24,18,6,17964,5988,23952
250230,201907,79,73,6,72854.99,5988,78842.99
250240,201907,237,197,40,198602,39920,238522
250250,201907,400,348,52,348302,52894,401196
250260,201907,37,32,5,31936,4990,36926
250270,201907,63,49,14,49900,13972,63872
250280,201907,381,316,65,315368,65868,381236
250290,201907,89,83,6,82834,5988,88822
250300,201907,547,376,171,376246,170659.97,546905.97
250310,201907,47,43,4,43912,3992,47904
250320,201907,1950,1344,606,1342313.68,609779.38,1952093.06
250330,201907,94,82,12,81836,11976,93812
250340,201907,24,22,2,21956,1996,23952
250350,201907,147,99,48,98802,47904,146706
250355,201907,35,27,8,26946,7984,34930
250360,201907,199,163,36,162674,35928,198602
250370,201907,2399,1624,775,1631730,773450,2405180
250375,201907,7,3,4,2994,3992,6986
250380,201907,56,43,13,42914,12974,55888
250390,201907,42,34,8,33932,7984,41916
250400,201907,16284,8324,7960,8328319.54,7973028.12,16301347.66
250403,201907,353,290,63,289420,63872,353292
250407,201907,59,50,9,49900,8982,58882
250410,201907,31,27,4,26946,3992,30938
250415,201907,40,26,14,25948,13972,39920
250420,201907,45,38,7,37924,6986,44910
250430,201907,1482,1267,215,1267709.5,214570,1482279.5
250435,201907,17,13,4,12974,3992,16966
250440,201907,685,581,104,581834.6,103792,685626.6
250450,201907,84,70,14,69860,13972,83832
250460,201907,430,298,132,297404,132734,430138
250470,201907,89,67,22,66866,22954,89820
250480,201907,324,261,63,262474,62874,325348
250485,201907,1,1,0,998,0,998
250490,201907,219,185,34,184630,34930,219560
250500,201907,80,61,19,60878,19960,80838
250510,201907,732,583,149,583830,149700,733530
250520,201907,170,118,52,117764,51896,169660
250523,201907,112,93,19,92814,18962,111776
250527,201907,99,80,19,79840,19960,99800
250530,201907,8,4,4,3992,3992,7984
250535,201907,25,21,4,20958,3992,24950
250540,201907,129,100,29,99800,28942,128742
250550,201907,71,68,3,67864,2994,70858
250560,201907,42,32,10,31936,9980,41916
250570,201907,159,129,30,128742,29940,158682
250580,201907,115,91,24,91880,23952,115832
250590,201907,24,16,8,15968,7984,23952
250600,201907,1288,870,418,868261.04,420158,1288419.04
250610,201907,156,135,21,134730,20958,155688
250620,201907,22,18,4,17964,3992,21956
250625,201907,72,54,18,53892,17964,71856
250630,201907,2983,1940,1043,1941125.47,1047907.92,2989033.39
250640,201907,213,176,37,175648,36926,212574
250650,201907,26,18,8,17964,7984,25948
250660,201907,47,35,12,34930,11976,46906
250670,201907,61,42,19,42914,18962,61876
250680,201907,399,328,71,327344,70858,398202
250690,201907,1888,1311,577,1311376.15,576844,1888220.15
250700,201907,918,806,112,805386.5,111776,917162.5
250710,201907,434,337,97,336326,96806,433132
250720,201907,114,89,25,88822,24950,113772
250730,201907,372,318,54,318029.33,53892,371921.33
250740,201907,51,47,4,48902,3992,52894
250750,201907,21176,12936,8240,12964927.33,8269435.9,21234363.23
250760,201907,77,61,16,60878,15968,76846
250770,201907,344,229,115,229540.44,115768,345308.44
250780,201907,57,43,14,42914,13972,56886
250790,201907,470,305,165,304390,164670,469060
250800,201907,149,137,12,136726,11976,148702
250810,201907,79,60,19,59880,18962,78842
250820,201907,154,126,28,126746,27944,154690
250830,201907,425,294,131,294410.4,130738,425148.4
250840,201907,51,49,2,48902,1996,50898
250850,201907,54,44,10,43912,9980,53892
250855,201907,13,11,2,10978,1996,12974
250860,201907,202,142,60,141716,59880,201596
250870,201907,33,30,3,29940,2994,32934
250880,201907,83,62,21,61876,20958,82834
250890,201907,2701,2038,663,2036918,664668,2701586
250900,201907,23,18,5,17964,4990,22954
250905,201907,119,92,27,91816,26946,118762
250910,201907,1149,823,326,826344.99,325348,1151692.99
250915,201907,107,75,32,74850,31936,106786
250920,201907,140,104,36,103792,35928,139720
250930,201907,167,105,62,104790,62874,167664
250933,201907,3,2,1,1996,998,2994
250937,201907,9,8,1,7984,998,8982
250939,201907,34,25,9,24950,8982,33932
250940,201907,105,83,22,82834,21956,104790
250950,201907,67,47,20,46906,19960,66866
250960,201907,92,51,41,50898,40918,91816
250970,201907,1216,864,352,864268,352294,1216562
250980,201907,92,64,28,63872,27944,91816
250990,201907,171,132,39,131736,39920,171656
251000,201907,77,68,9,67864,8982,76846
251010,201907,102,80,22,79840.99,21956,101796.99
251020,201907,81,70,11,69860,10978,80838
251030,201907,43,34,9,33932,8982,42914
251040,201907,52,38,14,37924,13972,51896
251050,201907,24,22,2,21956,1996,23952
251060,201907,50,39,11,38922,10978,49900
251065,201907,4,4,0,3992,0,3992
251070,201907,22,19,3,18962.98,2994,21956.98
251080,201907,4919,2396,2523,2394224.26,2519954.63,4914178.89
251090,201907,194,164,30,164670,29940,194610
251100,201907,18,18,0,17964,0,17964
251110,201907,44,35,9,34930,8982,43912
251120,201907,1798,1105,693,1103789.2,693610.4,1797399.6
251130,201907,390,320,70,321356,69860,391216
251140,201907,533,352,181,352295.2,180638,532933.2
251150,201907,315,276,39,275448.98,39920,315368.98
251160,201907,95,80,15,79840.99,14970,94810.99
251170,201907,103,83,20,82834,19960,102794
251180,201907,291,183,108,182634.99,107784.99,290419.98
251190,201907,192,129,63,129740,62874,192614
251200,201907,261,214,47,214570,47904,262474
251203,201907,36,34,2,33932,1996,35928
251207,201907,94,77,17,76846,16966,93812
251210,201907,1472,1076,396,1074846,396206,1471052
251220,201907,48,38,10,37924,9980,47904
251230,201907,615,521,94,519958,94810,614768
251240,201907,100,72,28,71856,27944,99800
251250,201907,1367,977,390,978040.9,392214.7,1370255.6
251260,201907,11,6,5,5988,4990,10978
251270,201907,323,246,77,246506,76846.7,323352.7
251272,201907,66,59,7,58882,6986,65868
251274,201907,27,21,6,20958,5988,26946
251275,201907,30,18,12,17964,11976,29940
251276,201907,11,9,2,8982,1996,10978
251278,201907,10,8,2,7984,1996,9980
251280,201907,100,96,4,95808,3992,99800
251290,201907,735,557,178,557882,179640,737522
251300,201907,15,13,2,12974,2994,15968
251310,201907,367,263,104,263472.99,104790,368262.99
251315,201907,22,21,1,20958,998,21956
251320,201907,61,49,12,48902,11976,60878
251330,201907,82,72,10,72854,9980,82834
251335,201907,14,9,5,8982,4990,13972
251340,201907,712,424,288,424150,287424,711574
251350,201907,36,35,1,34930,998,35928
251360,201907,74,66,8,66866,7984,74850
251365,201907,14,14,0,13972,0,13972
251370,201907,5438,3730,1708,3732522.74,1708577,5441099.74
251380,201907,46,38,8,37924,7984,45908
251385,201907,3,3,0,2994,0,2994
251390,201907,732,571,161,571854.7,162674.4,734529.1
251392,201907,13,6,7,5988,6986,12974
251394,201907,9,9,0,8982,0,8982
251396,201907,11,7,4,6986,3992,10978
251398,201907,17,14,3,13972,2994,16966
251400,201907,41,34,7,34930,6986,41916
251410,201907,37,31,6,30938,5988,36926
251420,201907,102,75,27,74850,26946,101796
251430,201907,43,40,3,39920,2994,42914
251440,201907,33,20,13,19960,12974,32934
251445,201907,48,43,5,42914,4990,47904
251450,201907,406,356,50,358282.2,49900,408182.2
251455,201907,3,2,1,1996,998,2994
251460,201907,17,15,2,14970,1996,16966
251465,201907,4,2,2,1996,1996,3992
251470,201907,46,37,9,36926,8982,45908
251480,201907,24,21,3,20958,2994,23952
251490,201907,121,85,36,84830,35928.4,120758.4
251500,201907,128,105,23,104790,22954,127744
251510,201907,38,29,9,28942,8982,37924
251520,201907,26,26,0,25948,0,25948
251530,201907,4482,3169,1313,3174638.8,1310374,4485012.8
251540,201907,73,63,10,63872,9980,73852
251550,201907,404,314,90,313372,90818.9,404190.9
251560,201907,20,14,6,14970,5988,20958
251570,201907,20,19,1,18962,998,19960
251580,201907,125,103,22,103792,22954,126746
251590,201907,114,83,31,85019,30938,115957
251593,201907,26,17,9,16966,8982,25948
251597,201907,63,53,10,52894,9980,62874
251600,201907,1078,778,300,780443.71,300399.4,1080843.11
251610,201907,231,181,50,180638,50898,231536
251615,201907,5,5,0,4990,0,4990
251620,201907,4247,2815,1432,2818354.24,1433129.6,4251483.84
251630,201907,446,329,117,328342,116766.98,445108.98
251640,201907,144,105,39,104790,38922,143712
251650,201907,262,191,71,192614.7,71856,264470.7
251660,201907,180,160,20,161676,19960,181636
251670,201907,364,286,78,286426,77844,364270
251675,201907,5,5,0,4990,0,4990
251680,201907,93,84,9,83832,8982,92814
251690,201907,343,283,60,283432,60878,344310
251700,201907,290,250,40,249500,39920,289420
251710,201907,22,15,7,14970,6986,21956
251720,201907,27,18,9,17964,8982.4,26946.4
251740,201907,9,7,2,6986,1996,8982
260005,201907,3141,1786,1355,1785425.91,1356284.88,3141710.79
260010,201907,1561,1136,425,1136722.14,426146.64,1562868.78
260020,201907,417,368,49,367264,48902,416166
260030,201907,580,423,157,423152,156686,579838
260040,201907,818,513,305,511974,304390,816364
260050,201907,1140,828,312,830336,314370.8,1144706.8
260060,201907,391,358,33,359280,32934,392214
260070,201907,1384,869,515,869261.85,514968.69,1384230.54
260080,201907,721,571,150,570856,149700,720556
260090,201907,511,333,178,335329.96,178642,513971.96
260100,201907,233,164,69,164670,68862,233532
260105,201907,215,119,96,118762,95808,214570
260110,201907,2838,2101,737,2101789.38,739518.4,2841307.78
260120,201907,2850,1470,1380,1470055.62,1380234.7,2850290.32
260130,201907,162,114,48,113772,47904,161676
260140,201907,2143,1404,739,1405194.48,742512.98,2147707.46
260150,201907,218,146,72,146706,74850,221556
260160,201907,321,267,54,267464,53892,321356
260170,201907,3355,2066,1289,2068854.88,1289416.4,3358271.28
260180,201907,153,129,24,129740,24950,154690
260190,201907,2249,1588,661,1590812,664668,2255480
260200,201907,950,771,179,775446.63,178642.4,954089.03
260210,201907,1445,1034,411,1032930,411176.98,1444106.98
260220,201907,717,651,66,651694,66866,718560
260230,201907,1193,899,294,897202.94,293412,1190614.94
260240,201907,220,167,53,166666,52894,219560
260250,201907,90,69,21,68862,20958,89820
260260,201907,1004,720,284,720556,283432,1003988
260270,201907,419,337,82,337324,81836,419160
260280,201907,1330,933,397,932132,401196.4,1333328.4
260290,201907,6410,3504,2906,3501988.28,2916162.07,6418150.35
260300,201907,905,790,115,794408.6,114770.4,909179.0
260310,201907,521,411,110,414170.4,110778,524948.4
260320,201907,863,649,214,649698,214570,864268
260330,201907,46,35,11,34930,10978,45908
260340,201907,73,53,20,52894,19960,72854
260345,201907,5534,3096,2438,3105779.47,2442109.9,5547889.37
260350,201907,472,347,125,349300.4,125748,475048.4
260360,201907,273,143,130,143712,129740,273452
260370,201907,688,456,232,455088.5,231537.65,686626.15
260380,201907,605,441,164,440118,163672.66,603790.66
260390,201907,296,252,44,251496,43912,295408
260392,201907,106,89,17,88822,16966,105788
260400,201907,4068,2381,1687,2380232.19,1691610.4,4071842.59
260410,201907,14463,7703,6760,7705561.17,6770433.28,14475994.45
260415,201907,128,116,12,115768,11976,127744
260420,201907,1764,1075,689,1074847.81,690616,1765463.81
260430,201907,189,173,16,172655.25,15968,188623.25
260440,201907,211,154,57,153692.98,56886,210578.98
260450,201907,452,331,121,330339.2,120758,451097.2
260460,201907,820,441,379,441117.2,380238,821355.2
260470,201907,360,223,137,222554,136726.8,359280.8
260480,201907,219,143,76,142714,75848,218562
260490,201907,215,180,35,180638,34930,215568
260500,201907,1128,764,364,763470,365268,1128738
260510,201907,781,631,150,631734,149700,781434
260515,201907,245,220,25,220558,24950,245508
260520,201907,3234,1961,1273,1960072.99,1275444.78,3235517.77
260530,201907,794,649,145,650696,144710,795406
260540,201907,563,434,129,433132,129740,562872
260545,201907,12,10,2,9980,1996,11976
260550,201907,335,210,125,210578,124750,335328
260560,201907,530,398,132,398202.4,131736,529938.4
260570,201907,990,810,180,813370.4,179640,993010.4
260580,201907,257,229,28,228542,27944,256486
260590,201907,623,362,261,362274,260478,622752
260600,201907,8038,4291,3747,4288408.33,3747490,8035898.33
260610,201907,484,326,158,326346,157684,484030
260620,201907,3664,1944,1720,1946103.02,1721552.07,3667655.09
260630,201907,88,84,4,83832,3992,87824
260640,201907,3598,1989,1609,1994004.92,1611770.98,3605775.90
260650,201907,322,238,84,238522,84830,323352
260660,201907,532,362,170,361276,170658,531934
260670,201907,103,77,26,76846,25948,102794
260680,201907,3638,2072,1566,2074844.94,1564865.36,3639710.30
260690,201907,126,95,31,94810,30938,125748
260700,201907,316,206,110,208582,111776,320358
260710,201907,40,37,3,36926,2994,39920
260720,201907,2315,1405,910,1406183.6,914168,2320351.6
260730,201907,660,502,158,501994,157684,659678
260740,201907,61,57,4,57884,3992,61876
260750,201907,612,442,170,444110,171656,615766
260760,201907,619,335,284,334330.63,285428,619758.63
260765,201907,969,516,453,516964.99,454090,971054.99
260770,201907,222,165,57,164653,56886,221539
260775,201907,790,469,321,469061.3,320358.98,789420.28
260780,201907,270,174,96,173652,95808,269460
260790,201907,12181,6729,5452,6737509.28,5467049.41,12204558.69
260795,201907,167,113,54,112774,53892,166666
260800,201907,296,248,48,247504,47904,295408
260805,201907,172,114,58,113772,57884,171656
260810,201907,755,660,95,659678,94810,754488
260820,201907,304,198,106,198602.34,105788,304390.34
260825,201907,204,143,61,143712,61876,205588
260830,201907,279,177,102,176646,101796,278442
260840,201907,233,172,61,171656,60878,232534
260845,201907,180,125,55,124750,54890,179640
260850,201907,469,350,119,350298,118762,469060
260860,201907,256,193,63,193612,62874,256486
260870,201907,369,275,94,274450,93812,368262
260875,201907,732,525,207,527942,208582,736524
260880,201907,1574,1005,569,1003988.2,569858,1573846.2
260890,201907,2385,1688,697,1686621,697602.8,2384223.8
260900,201907,980,689,291,689618,297404,987022
260910,201907,265,209,56,208582,56886,265468
260915,201907,301,212,89,211576,91816,303392
260920,201907,178,98,80,97804,80838,178642
260930,201907,398,343,55,344312.91,54890.97,399203.88
260940,201907,2763,1520,1243,1518957.76,1244506.4,2763464.16
260950,201907,2018,1181,837,1181633.66,839318.4,2020952.06
260960,201907,13721,7178,6543,7185612.36,6561859.37,13747471.73
260970,201907,430,369,61,369260,60878,430138
260980,201907,198,176,22,175648,21956,197604
260990,201907,2615,2133,482,2136720.54,481036,2617756.54
261000,201907,4320,2587,1733,2583823.58,1733526.6,4317350.18
261010,201907,179,132,47,131736,46906,178642
261020,201907,606,453,153,454091.06,152694,606785.06
261030,201907,235,175,60,174650,60878,235528
261040,201907,364,319,45,320358,44910,365268
261050,201907,501,442,59,441116,62874,503990
261060,201907,1354,900,454,899198.5,456086,1355284.5
261070,201907,8656,4447,4209,4450109.05,4220591.41,8670700.46
261080,201907,381,295,86,296406,86826,383232
261090,201907,2229,1718,511,1723550.31,512972.47,2236522.78
261100,201907,1117,782,335,780437.3,335328,1115765.3
261110,201907,8464,5213,3251,5216550.4,3249492.01,8466042.41
261120,201907,264,222,42,221556,41916,263472
261130,201907,565,339,226,338322.6,225549.58,563872.18
261140,201907,183,118,65,119760,64870,184630
261150,201907,680,421,259,422154.18,258482,680636.18
261153,201907,68,64,4,63872,3992,67864
261160,201907,76264,38568,37696,38625727.66,37779329.78,76405057.44
261170,201907,466,355,111,355288,111776,467064
261180,201907,1799,1112,687,1112770,687622,1800392
261190,201907,607,429,178,430140.52,177644.98,607785.50
261200,201907,218,190,28,189620,27944,217564
261210,201907,33,28,5,28942,4990,33932
261220,201907,2686,1893,793,1894206.63,793411.37,2687618.00
261230,201907,337,254,83,253492,82834,336326
261240,201907,460,399,61,399200,61876,461076
261245,201907,236,196,40,195608,40918,236526
261247,201907,172,137,35,136726,34930,171656
261250,201907,2930,1502,1428,1499994.4,1431132,2931126.4
261255,201907,253,230,23,231536,22954,254490
261260,201907,870,754,116,752492.76,115768,868260.76
261270,201907,180,137,43,136726,42914,179640
261280,201907,174,146,28,145708,27944,173652
261290,201907,124,87,37,86826,36926,123752
261300,201907,1267,921,346,922152,347304,1269456
261310,201907,785,530,255,529938,256486,786424
261320,201907,556,388,168,388222,168662,556884
261330,201907,998,769,229,769458,228542.63,998000.63
261340,201907,288,165,123,164670,122754,287424
261350,201907,833,595,238,595806.4,237524,833330.4
261360,201907,1278,838,440,837322,440118,1277440
261370,201907,4844,2984,1860,2984024.3,1865264.77,4849289.07
261380,201907,556,417,139,417164.63,138722.4,555887.03
261390,201907,3562,2383,1179,2389213.03,1179636.7,3568849.73
261400,201907,284,258,26,257484,25948,283432
261410,201907,1113,753,360,754488,360278,1114766
261420,201907,867,547,320,550898.47,319360,870258.47
261430,201907,330,296,34,296406,33932,330338
261440,201907,124,114,10,114770,9980,124750
261450,201907,2541,2082,459,2082827.31,458083.36,2540910.67
261460,201907,734,590,144,589818.74,143712,733530.74
261470,201907,244,189,55,189620.1,55888,245508.1
261480,201907,404,318,86,318362.6,85828.99,404191.59
261485,201907,341,212,129,212574,128742,341316
261500,201907,605,413,192,414170,192614,606784
261510,201907,49,32,17,31936,16966,48902
261520,201907,113,99,14,98802,13972,112774
261530,201907,4070,2589,1481,2590809.19,1483030.78,4073839.97
261540,201907,1210,745,465,744508,466066,1210574
261550,201907,274,137,137,136726.4,136726,273452.4
261560,201907,829,550,279,549898.7,279441.38,829340.08
261570,201907,391,308,83,307384,82834,390218
261580,201907,378,297,81,297404,80838,378242
261590,201907,201,162,39,161676,38922,200598
261600,201907,296,239,57,238522,57884,296406
261610,201907,100,86,14,85828,13972,99800
261618,201907,73,58,15,57884,14970,72854
261620,201907,197,121,76,120758,76846,197604
261630,201907,573,447,126,446106,125748,571854
261640,201907,6345,3412,2933,3414162.31,2939110.5,6353272.81
261650,201907,494,318,176,317364,175648,493012
270010,201907,533,475,58,474050,57884,531934
270020,201907,295,234,61,234530.99,60878,295408.99
270030,201907,9141,5940,3201,5952330.24,3215592.46,9167922.70
270040,201907,2007,1258,749,1258478,750496,2008974
270050,201907,162,122,40,122754,39920,162674
270060,201907,114,63,51,62874,50898,113772
270070,201907,886,648,238,649698,239520.98,889218.98
270080,201907,36,30,6,30938,5988,36926
270090,201907,19,15,4,14970,3992,18962
270100,201907,1213,816,397,814368.98,398202.4,1212571.38
270110,201907,136,104,32,103792,31936,135728
270120,201907,224,184,40,183632,40918,224550
270130,201907,239,163,76,163672,76846,240518
270135,201907,104,62,42,61876,41916,103792
270140,201907,1364,842,522,840319.35,520957.94,1361277.29
270150,201907,262,207,55,206586,54890,261476
270160,201907,515,397,118,397204,119760,516964
270170,201907,776,506,270,504988,270458,775446
270180,201907,72,55,17,54890,16966,71856
270190,201907,95,84,11,83832,10978,94810
270200,201907,103,91,12,90818,11976,102794
270210,201907,487,267,220,267464,220558,488022
270220,201907,181,145,36,144710,35928,180638
270230,201907,2113,1304,809,1305386.64,810377.94,2115764.58
270235,201907,713,551,162,552897.78,163676.88,716574.66
270240,201907,3144,2483,661,2481030.53,663672.54,3144703.07
270250,201907,163,117,46,116766,45908,162674
270255,201907,211,181,30,180638,29940,210578
270260,201907,359,291,68,292414,67864,360278
270270,201907,102,44,58,43912.98,58882,102794.98
270280,201907,263,151,112,150698,111776,262474
270290,201907,1176,902,274,902192,274450.98,1176642.98
270300,201907,285,190,95,189620,94810,284430
270310,201907,894,726,168,726548.88,172655.96,899204.84
270320,201907,845,725,120,727543.61,119760,847303.61
270330,201907,280,237,43,236526,42914,279440
270340,201907,58,47,11,46906,10978,57884
270350,201907,96,49,47,48902,46906,95808
270360,201907,62,36,26,35928,25948,61876
270370,201907,56,45,11,44910,10978,55888
270375,201907,73,47,26,46906,25948,72854
270380,201907,997,600,397,599798,396206,996004
270390,201907,193,112,81,111776,80838,192614
270400,201907,712,526,186,525949.41,185628,711577.41
270410,201907,679,492,187,493012,186626,679638
270420,201907,408,277,131,278475.26,130739.94,409215.20
270430,201907,33208,23905,9303,23928244.26,9318337.44,33246581.70
270440,201907,491,388,103,388222,102794,491016
270450,201907,791,437,354,438122,353292,791414
270460,201907,194,155,39,154690,38922,193612
270470,201907,1437,983,454,983030.79,453092,1436122.79
270480,201907,543,447,96,448102.8,95808,543910.8
270490,201907,24,19,5,18962,4990,23952
270500,201907,500,415,85,415168,84830,499998
270510,201907,766,473,293,473052,292414,765466
270520,201907,328,207,121,206586,121756,328342
270530,201907,68,58,10,57884,9980,67864
270540,201907,116,91,25,90818,24950,115768
270550,201907,1770,1355,415,1355552.11,414170,1769722.11
270560,201907,284,140,144,139720,144710,284430
270570,201907,493,346,147,345308,147704,493012
270580,201907,97,72,25,71856,24950,96806
270590,201907,70,56,14,55888,13972,69860
270600,201907,174,144,30,143712,29940,173652
270610,201907,211,178,33,177644.98,32934,210578.98
270620,201907,30,29,1,28942,998,29940
270630,201907,3846,2943,903,2951688.96,906184,3857872.96
270640,201907,884,651,233,651694,234531.94,886225.94
270642,201907,224,190,34,189620,33932,223552
270644,201907,253,170,83,170658.98,82834,253492.98
270650,201907,311,186,125,185628,124750,310378
270660,201907,253,207,46,206586,45908,252494
270670,201907,3106,2377,729,2378237.9,728540.4,3106778.3
270680,201907,465,272,193,271456.98,193612,465068.98
270690,201907,1140,739,401,741514.58,402194,1143708.58
270700,201907,34,26,8,25948,7984,33932
270710,201907,886,681,205,681534.2,204590,886124.2
270720,201907,250,196,54,195608,53892,249500
270730,201907,1917,1138,779,1138718.8,779440.08,1918158.88
270740,201907,42,28,14,27944,13972,41916
270750,201907,662,487,175,486026.6,175648,661674.6
270760,201907,297,216,81,215568,80838,296406
270770,201907,2791,1817,974,1815698.36,978040.96,2793739.32
270780,201907,81,52,29,51896,30939.98,82835.98
270790,201907,248,164,84,164670,83832,248502
270800,201907,1973,1590,383,1589815.39,383232.4,1973047.79
270810,201907,294,236,58,236526,57884,294410
270820,201907,156,103,53,102794,52894.8,155688.8
270830,201907,825,607,218,605787.98,217564.99,823352.97
270840,201907,1428,1080,348,1078838,348302.74,1427140.74
270850,201907,1584,970,614,971055,613770,1584825
270860,201907,2513,1659,854,1661738.94,854290.67,2516029.61
270870,201907,123,66,57,66866,56886,123752
270880,201907,899,684,215,685636.72,215572.86,901209.58
270890,201907,318,231,87,230538,86826,317364
270895,201907,64,55,9,54890,8982,63872
270900,201907,100,78,22,77844,21956,99800
270910,201907,317,252,65,252494,64870,317364
270915,201907,1908,1183,725,1180662.71,724559.2,1905221.91
270920,201907,490,415,75,415168,74850,490018
270930,201907,6141,4538,1603,4536292.14,1605792.92,6142085.06
270940,201907,2369,1824,545,1823379.26,547902,2371281.26
280010,201907,41,36,5,35928,4990,40918
280020,201907,455,400,55,401196.96,54890,456086.96
280030,201907,20161,13122,7039,13119751.23,7046891.96,20166643.19
280040,201907,332,219,113,218562,112774,331336
280050,201907,381,294,87,295408,86826,382234
280060,201907,338,228,110,228542.48,110778,339320.48
280067,201907,1021,733,288,731534.49,287424.75,1018959.24
280070,201907,122,101,21,102794,21956,124750
280100,201907,612,481,131,482035.05,131736.6,613771.65
280110,201907,75,70,5,70858,4990,75848
280120,201907,640,517,123,516964,122754,639718
280130,201907,1616,1058,558,1059876.6,558880.8,1618757.4
280140,201907,466,384,82,384230,83832,468062
280150,201907,373,273,100,273452,99800,373252
280160,201907,98,86,12,86826,11976,98802
280170,201907,407,271,136,270458,135728,406186
280190,201907,27,25,2,24950,1996,26946
280200,201907,26,21,5,20958,4990,25948
280210,201907,2835,2046,789,2046903.16,789418.4,2836321.56
280220,201907,41,33,8,32934,7984,40918
280230,201907,321,266,55,267464.7,54890,322354.7
280240,201907,116,110,6,109780,5988,115768
280250,201907,16,10,6,9980,5988,15968
280260,201907,81,71,10,70858,9980,80838
280270,201907,155,120,35,120758,34930,155688
280280,201907,191,125,66,124750,65868,190618
280290,201907,3272,2395,877,2398132.64,877242.64,3275375.28
280300,201907,1592,1224,368,1222550.4,368262,1590812.4
280310,201907,103,99,4,98802.6,3992,102794.6
280320,201907,663,461,202,461076,201596,662672
280330,201907,339,244,95,245508,94810,340318
280340,201907,405,329,76,330338,75848,406186
280350,201907,3578,2791,787,2792408.24,787422.7,3579830.94
280360,201907,447,288,159,288422,158682,447104
280370,201907,99,87,12,86826,11976,98802
280380,201907,54,42,12,42914,11976,54890
280390,201907,175,151,24,150698,23952,174650
280400,201907,344,237,107,236527.36,107784,344311.36
280410,201907,285,232,53,231536.6,52894,284430.6
280420,201907,171,145,26,144710,25948,170658
280430,201907,29,19,10,18962,9980,28942
280440,201907,691,538,153,538921.46,154690,693611.46
280445,201907,117,109,8,108782,7984,116766
280450,201907,1167,1006,161,1004986.94,160678,1165664.94
280460,201907,606,437,169,438122.7,168662,606784.7
280470,201907,189,175,14,174650,13972.7,188622.7
280480,201907,2470,1758,712,1754486.76,712573.62,2467060.38
280490,201907,284,264,20,263472.15,19960,283432.15
280500,201907,41,38,3,37924,2994,40918
280510,201907,137,110,27,109780,26946.4,136726.4
280520,201907,53,40,13,39920,12974,52894
280530,201907,72,46,26,46906,25948,72854
280540,201907,514,421,93,420158.7,92814,512972.7
280550,201907,730,675,55,674650.4,55888,730538.4
280560,201907,494,434,60,433132,60878,494010
280570,201907,2198,1715,483,1713568.38,485028,2198596.38
280580,201907,611,474,137,473054.19,137724.8,610778.99
280590,201907,174,113,61,112774,60878,173652
280600,201907,381,322,59,322354,58882,381236
280610,201907,129,98,31,97804,30938,128742
280620,201907,544,455,89,457084,88822,545906
280630,201907,153,128,25,127744,24950,152694
280640,201907,196,157,39,156686.96,38922,195608.96
280650,201907,78,57,21,56886,20958,77844
280660,201907,139,102,37,101796,36926,138722
280670,201907,1762,1121,641,1120759.35,639718.86,1760478.21
280680,201907,176,152,24,152694.29,24950,177644.29
280690,201907,91,79,12,78842,11976,90818
280700,201907,22,21,1,20958,998,21956
280710,201907,1461,1124,337,1122750.6,336326,1459076.6
280720,201907,112,75,37,74850,36926,111776
280730,201907,25,21,4,20958,3992,24950
280740,201907,2508,1875,633,1877238.8,632732,2509970.8
280750,201907,225,199,26,198602,25948,224550
280760,201907,725,502,223,503990,223552,727542
290010,201907,205,144,61,143712,60878,204590
290020,201907,175,161,14,160678,13972,174650
290030,201907,598,391,207,392214,206586,598800
290035,201907,130,105,25,104790,24950,129740
290040,201907,290,192,98,193612,97804,291416
290050,201907,88,67,21,66866,20958,87824
290060,201907,265,120,145,119760,144710,264470
290070,201907,5573,2785,2788,2780429.86,2784424.64,5564854.50
290080,201907,476,222,254,223552.96,253492.96,477045.92
290090,201907,387,173,214,172654,213572,386226
290100,201907,1626,1077,549,1076843.2,550896.8,1627740.0
290110,201907,818,495,323,494011.12,324350.99,818362.11
290115,201907,199,185,14,185628,13972,199600
290120,201907,757,500,257,499000.63,258482,757482.63
290130,201907,433,263,170,262474,169660,432134
290135,201907,293,222,71,221556,70858,292414
290140,201907,312,258,54,258482,54890,313372
290150,201907,134,98,36,97804,35928,133732
290160,201907,247,186,61,186626.62,60878,247504.62
290170,201907,96,70,26,69860,25948,95808
290180,201907,169,130,39,130738.6,38922,169660.6
290190,201907,438,365,73,364270,73852,438122
290195,201907,308,192,116,191616,116766,308382
290200,201907,275,223,52,223552,51896,275448
290205,201907,140,86,54,85828,53892,139720
290210,201907,1143,835,308,835326.4,308382,1143708.4
290220,201907,223,123,100,122754,99800,222554
290225,201907,290,115,175,114770,174650,289420
290230,201907,64,43,21,42914,20958,63872
290240,201907,326,128,198,127744,198602,326346
290250,201907,258,238,20,237524,19960,257484
290260,201907,308,248,60,248502.4,59880,308382.4
290265,201907,193,163,30,162674,29940,192614
290270,201907,1415,1175,240,1174646.5,240519.36,1415165.86
290280,201907,474,339,135,341316,135728,477044
290290,201907,1288,766,522,765466.94,521954.4,1287421.34
290300,201907,446,379,67,380238.4,66866,447104.4
290310,201907,308,137,171,136726,170658,307384
290320,201907,4056,2521,1535,2521946.57,1535923.24,4057869.81
290323,201907,188,165,23,165668,22954,188622
290327,201907,164,130,34,129740,33932,163672
290330,201907,92,51,41,50898,40918,91816
290340,201907,876,359,517,359280,517962,877242
290350,201907,607,369,238,369260,239520,608780
290360,201907,363,275,88,276446.97,87824,364270.97
290370,201907,918,386,532,385228,534928.97,920156.97
290380,201907,319,196,123,195608,123752,319360
290390,201907,2477,1565,912,1562870.9,912172,2475042.9
290395,201907,251,141,110,140718.5,109780,250498.5
290400,201907,285,210,75,209580.4,74850,284430.4
290405,201907,248,217,31,217564,30938,248502
290410,201907,644,539,105,538920.68,104790,643710.68
290420,201907,248,198,50,197604,49900,247504
290430,201907,481,310,171,309380,171656,481036
290440,201907,75,67,8,66866,7984,74850
290450,201907,230,179,51,180638,50898,231536
290460,201907,1924,1165,759,1164675.8,757483.84,1922159.64
290470,201907,1403,598,805,596813.8,804405.64,1401219.44
290475,201907,586,547,39,545906.68,38922.8,584829.48
290480,201907,289,160,129,159680,129740,289420
290485,201907,243,224,19,225548,19960,245508
290490,201907,1197,862,335,862272,338322,1200594
290500,201907,719,368,351,367264,351296,718560
290510,201907,228,175,53,174650,52894,227544
290515,201907,147,91,56,90818,55888,146706
290520,201907,1422,945,477,948100.54,478042.73,1426143.27
290530,201907,310,286,24,285428,23952,309380
290540,201907,98,54,44,53892,43912,97804
290550,201907,147,121,26,121756,25948,147704
290560,201907,3225,1371,1854,1370254,1854287.32,3224541.32
290570,201907,5991,3054,2937,3063866.89,2939116.54,6002983.43
290580,201907,1282,773,509,772452,509978,1282430
290590,201907,567,466,101,466066,100798,566864
290600,201907,1757,1221,536,1222552.02,535926,1758478.02
290610,201907,209,187,22,188622.54,21956,210578.54
290620,201907,347,310,37,309380,37924,347304
290630,201907,2009,873,1136,873250,1134726.4,2007976.4
290640,201907,149,123,26,123752,25948,149700
290650,201907,1711,818,893,817362.69,892212,1709574.69
290660,201907,275,225,50,224550,50898,275448
290670,201907,1039,534,505,536924.8,505986.63,1042911.43
290680,201907,1236,998,238,998000,238522,1236522
290682,201907,297,222,75,222555.24,74850.98,297406.22
290685,201907,239,154,85,153692,84830,238522
290687,201907,1019,663,356,663832.16,357284,1021116.16
290689,201907,144,80,64,80838.97,63872,144710.97
290690,201907,613,262,351,261476.98,352298.84,613775.82
290700,201907,239,118,121,117764,120758,238522
290710,201907,709,483,226,483032,226546,709578
290720,201907,1039,844,195,845306.5,195608,1040914.5
290730,201907,1154,668,486,668660,485028,1153688
290740,201907,15,13,2,12974,1996,14970
290750,201907,1345,628,717,626744,720558.3,1347302.3
290755,201907,73,67,6,66866,5988,72854
290760,201907,301,262,39,261476,38922,300398
290770,201907,190,179,11,179640,10978.4,190618.4
290780,201907,1041,825,216,824351.74,216566,1040917.74
290790,201907,375,263,112,262474,112774,375248
290800,201907,2531,1019,1512,1018958,1511970,2530928
290810,201907,463,322,141,321356.4,141716,463072.4
290820,201907,402,239,163,238522.97,162674,401196.97
290830,201907,404,286,118,287424,119760,407184
290840,201907,1741,1083,658,1083829.28,659678.8,1743508.08
290850,201907,791,440,351,440118,351296,791414
290860,201907,616,283,333,284430,334330.4,618760.4
290870,201907,636,458,178,458082.64,178642.84,636725.48
290880,201907,124,68,56,67864,55888,123752
290890,201907,357,253,104,253492,107784,361276
290900,201907,165,127,38,126746,38922,165668
290910,201907,386,297,89,298402,88822,387224
290920,201907,221,187,34,187624,33932,221556
290930,201907,833,633,200,631734.4,201596.96,833331.36
290940,201907,246,204,42,204590,41916,246506
290950,201907,165,98,67,98802,66866,165668
290960,201907,467,322,145,323352,144710,468062
290970,201907,250,224,26,223552,25948,249500
290980,201907,1603,1139,464,1140714.68,463072.8,1603787.48
290990,201907,398,336,62,337324.98,61878.94,399203.92
291000,201907,862,256,606,257484,604788,862272
291005,201907,2242,993,1249,995007,1247500.98,2242507.98
291010,201907,157,143,14,142714,13972,156686
291020,201907,100,78,22,77844,21956,99800
291030,201907,96,70,26,69860,25948,95808
291040,201907,591,322,269,321356,268462,589818
291050,201907,1383,783,600,785426.96,601794,1387220.96
291060,201907,1507,848,659,850296,659678,1509974
291070,201907,1965,1471,494,1470055.98,494011.78,1964067.76
291072,201907,7270,2749,4521,2748494.78,4527929.92,7276424.70
291075,201907,225,187,38,186626.6,38922,225548.6
291077,201907,53,36,17,35928,16966,52894
291080,201907,20142,8947,11195,8960052.33,11205551.94,20165604.27
291085,201907,299,245,54,244510,53892,298402
291090,201907,302,119,183,118762.4,182634,301396.4
291100,201907,648,197,451,197604,453092,650696
291110,201907,410,313,97,313372.96,96806,410178.96
291120,201907,2474,1215,1259,1216562.7,1260474.99,2477037.69
291125,201907,63,31,32,30938,31936,62874
291130,201907,208,185,23,184630,22954,207584
291140,201907,145,115,30,114770,29940.4,144710.4
291150,201907,381,156,225,155688,225548,381236
291160,201907,384,318,66,319360.5,65868,385228.5
291165,201907,33,27,6,26946,5988,32934
291170,201907,3076,1554,1522,1555883.5,1520952.8,3076836.3
291180,201907,1278,512,766,511977.74,766466.88,1278444.62
291185,201907,82,80,2,79840,1996,81836
291190,201907,1320,587,733,585827.24,731534,1317361.24
291200,201907,165,124,41,123752,40918,164670
291210,201907,2227,902,1325,902193.08,1330335.38,2232528.46
291220,201907,276,208,68,208582,67864,276446
291230,201907,995,349,646,348302.4,647702,996004.4
291240,201907,430,408,22,409180.4,21956,431136.4
291250,201907,439,357,82,358282,81836,440118
291260,201907,53,41,12,40918,11976,52894
291270,201907,1185,492,693,492014,692612,1184626
291280,201907,362,175,187,174650.4,186626,361276.4
291290,201907,1741,906,835,905186.4,834329.4,1739515.8
291300,201907,236,183,53,183632,52894,236526
291310,201907,232,211,21,212939.93,20958,233897.93
291320,201907,1394,997,397,996004,397204,1393208
291330,201907,128,109,19,108782,18962,127744
291340,201907,184,104,80,103792,79840,183632
291345,201907,142,96,46,95808,45908,141716
291350,201907,1611,554,1057,553890,1055884.7,1609774.7
291360,201907,8455,4206,4249,4207572.46,4253479.06,8461051.52
291370,201907,1126,641,485,641714.4,489020.98,1130735.38
291380,201907,255,200,55,202594,54890,257484
291390,201907,3819,1708,2111,1707580.62,2109772.4,3817353.02
291400,201907,2075,1489,586,1489016,585826.81,2074842.81
291410,201907,161,142,19,142714,18962,161676
291420,201907,117,87,30,86826,29940,116766
291430,201907,162,89,73,89820,72854.11,162674.11
291440,201907,522,427,95,426146.8,94810,520956.8
291450,201907,899,575,324,578840.5,328342,907182.5
291460,201907,1817,1483,334,1485025.6,334330,1819355.6
291465,201907,2171,1046,1125,1046915.9,1128751.58,2175667.48
291470,201907,2855,1451,1404,1451092.71,1405184.4,2856277.11
291480,201907,11716,5254,6462,5256491.79,6479141.36,11735633.15
291490,201907,557,235,322,235528,323352,558880
291500,201907,376,217,159,217564,159680,377244
291510,201907,1222,476,746,476046,746504,1222550
291520,201907,948,437,511,439120,510976,950096
291530,201907,973,276,697,276446,698600,975046
291535,201907,122,104,18,103792,17964,121756
291540,201907,351,104,247,104790.4,247504.2,352294.6
291550,201907,1206,582,624,580837.2,622753.38,1203590.58
291560,201907,5333,2730,2603,2735612.5,2603948.89,5339561.39
291570,201907,198,101,97,100798,97804,198602
291580,201907,1232,758,474,757483.81,474050,1231533.81
291590,201907,84,35,49,35928,49900,85828
291600,201907,1190,592,598,591814,599799.96,1191613.96
291610,201907,1468,716,752,718560,757483.58,1476043.58
291620,201907,567,262,305,262474,304390,566864
291630,201907,469,150,319,149700,318362,468062
291640,201907,3961,2030,1931,2032930.2,1929146.96,3962077.16
291650,201907,420,287,133,286426.53,132734,419160.53
291660,201907,402,161,241,160678,241516,402194
291670,201907,222,142,80,141716,79840,221556
291680,201907,676,400,276,402194,275448.8,677642.8
291685,201907,588,328,260,328342.5,259480,587822.5
291690,201907,569,323,246,322354,246507.86,568861.86
291700,201907,957,756,201,756484,200598,957082
291710,201907,1678,803,875,802392.5,883230.98,1685623.48
291720,201907,409,274,135,274450,134730,409180
291730,201907,947,562,385,561874,384230,946104
291733,201907,284,196,88,195608,87824,283432
291735,201907,73,55,18,54890,17964,72854
291740,201907,349,272,77,271456,76846,348302
291750,201907,2078,1356,722,1358278.8,724548,2082826.8
291760,201907,3020,1667,1353,1672648,1353288.4,3025936.4
291770,201907,782,527,255,526949.33,254490,781439.33
291780,201907,46,27,19,26946,18962,45908
291790,201907,163,80,83,79840,83832,163672
291800,201907,10078,4169,5909,4173638.91,5914150.58,10087789.49
291810,201907,1125,826,299,826344.4,299400.6,1125745.0
291820,201907,275,198,77,197604,76846,274450
291830,201907,1106,441,665,442114.98,664668.98,1106783.96
291835,201907,588,547,41,545906,40918,586824
291840,201907,4842,2500,2342,2507975.35,2347297.38,4855272.73
291845,201907,277,96,181,95808,181636,277444
291850,201907,332,295,37,294410,36926,331336
291855,201907,260,105,155,104790,156686,261476
291860,201907,174,109,65,108782,64870,173652
291870,201907,83,32,51,31936,50898,82834
291875,201907,181,168,13,167664,12974,180638
291880,201907,861,554,307,553890,306386.6,860276.6
291890,201907,240,77,163,76846,162674.4,239520.4
291900,201907,58,34,24,33932,24950,58882
291905,201907,130,95,35,94810.4,34930,129740.4
291910,201907,171,138,33,137724,32934,170658
291915,201907,413,365,48,366266.5,47904,414170.5
291920,201907,4951,2571,2380,2580828.98,2385221.98,4966050.96
291930,201907,179,107,72,106786,71856,178642
291940,201907,355,199,156,198602,155688,354290
291950,201907,1138,927,211,927142.4,212574,1139716.4
291955,201907,1195,717,478,717562.4,479040,1196602.4
291960,201907,180,132,48,131736,47904,179640
291970,201907,770,582,188,584828,187624,772452
291980,201907,1522,1347,175,1345305.38,174650.4,1519955.78
291990,201907,129,119,10,118762,9980,128742
291992,201907,170,85,85,85828,86826,172654
291995,201907,160,108,52,107784,51896,159680
292000,201907,392,305,87,305388.4,86826,392214.4
292010,201907,294,207,87,206586,86826,293412
292020,201907,289,211,78,210578,77844,288422
292030,201907,145,114,31,113772,30938,144710
292040,201907,635,319,316,319360,315368,634728
292045,201907,102,93,9,92814,8982,101796
292050,201907,940,683,257,682632,256486.4,939118.4
292060,201907,924,768,156,771454.86,156686,928140.86
292070,201907,49,21,28,20958,27944,48902
292080,201907,134,93,41,92814,40918,133732
292090,201907,506,188,318,187624,318362,505986
292100,201907,1394,618,776,619758.6,776444.98,1396203.58
292105,201907,211,182,29,183632,28942,212574
292110,201907,2224,843,1381,845306,1383233.86,2228539.86
292120,201907,688,542,146,543910,145708,689618
292130,201907,443,260,183,259480,183632,443112
292140,201907,207,164,43,163672,42914,206586
292145,201907,165,86,79,85828.4,78842,164670.4
292150,201907,1472,1195,277,1194606,277444,1472050
292160,201907,175,144,31,143712,30938,174650
292170,201907,1205,1058,147,1057880,146706,1204586
292180,201907,216,154,62,154690,61876,216566
292190,201907,160,100,60,99800,59880,159680
292200,201907,1279,483,796,482035.36,799399.36,1281434.72
292205,201907,128,113,15,112774,14970,127744
292210,201907,365,259,106,258482,105788,364270
292220,201907,23,18,5,17964,4990,22954
292225,201907,38,33,5,32934,4990,37924
292230,201907,968,783,185,784428.3,185628,970056.3
292240,201907,611,445,166,444110.7,165668,609778.7
292250,201907,1753,1153,600,1152690,602792.4,1755482.4
292260,201907,430,256,174,255488,173652,429140
292265,201907,250,176,74,175648,74850,250498
292270,201907,350,157,193,157684,192614,350298
292273,201907,198,111,87,110778,86826,197604
292275,201907,177,89,88,88822,87824,176646
292280,201907,143,103,40,102794,39920,142714
292285,201907,69,59,10,58882,9980,68862
292290,201907,574,388,186,390218.09,186626.4,576844.49
292300,201907,1644,641,1003,643710.8,1001992.72,1645703.52
292303,201907,104,70,34,69860,33932,103792
292305,201907,111,81,30,81836,30938,112774
292310,201907,886,587,299,585827.24,298402.56,884229.80
292320,201907,622,473,149,473052,148702,621754
292330,201907,177,101,76,101796,76846,178642
292335,201907,288,226,62,225548,61876,287424
292340,201907,577,406,171,406186.4,170658,576844.4
292350,201907,269,145,124,144710,124750,269460
292360,201907,712,546,166,545906.56,166666,712572.56
292370,201907,752,576,176,574848,175648,750496
292380,201907,657,517,140,515966.54,141716,657682.54
292390,201907,489,197,292,197604,291416,489020
292400,201907,3480,2174,1306,2173646.14,1305385,3479031.14
292405,201907,267,177,90,176646,90818,267464
292410,201907,142,86,56,85828,55888,141716
292420,201907,296,254,42,253492,41916,295408
292430,201907,525,410,115,409180,114770,523950
292440,201907,594,511,83,509978.44,82834,592812.44
292450,201907,260,201,59,201596,59880,261476
292460,201907,564,423,141,423152.98,140718,563870.98
292465,201907,222,183,39,182634,38922,221556
292467,201907,116,71,45,71856,44910,116766
292470,201907,280,192,88,192614,88822,281436
292480,201907,341,235,106,234530,105788.4,340318.4
292490,201907,229,158,71,157684,70858,228542
292500,201907,1128,499,629,499998.75,628740,1128738.75
292510,201907,3400,1569,1831,1577838.44,1836321.18,3414159.62
292520,201907,1086,516,570,515966.99,572852.98,1088819.97
292525,201907,403,286,117,285428,116766,402194
292530,201907,4298,1781,2517,1779437.73,2527938.54,4307376.27
292540,201907,466,260,206,260478,205588,466066
292550,201907,1036,567,469,566877.48,469071.54,1035949.02
292560,201907,323,304,19,304390,18962,323352
292570,201907,304,235,69,234530,68862,303392
292575,201907,484,316,168,316366.4,168662,485028.4
292580,201907,976,645,331,646704,332334.4,979038.4
292590,201907,554,481,73,481036,72854,553890
292593,201907,141,112,29,111776,28942,140718
292595,201907,188,145,43,145708,42914,188622
292600,201907,1253,923,330,924148.63,330338,1254486.63
292610,201907,134,103,31,102794,31936,134730
292620,201907,536,448,88,447104.4,87824,534928.4
292630,201907,1405,807,598,808380.67,597802.27,1406182.94
292640,201907,802,554,248,552892,248502,801394
292650,201907,183,156,27,155688.4,27944,183632.4
292660,201907,2048,1478,570,1477041.75,572853.15,2049894.90
292665,201907,148,106,42,106786,41916,148702
292670,201907,402,326,76,327344.99,75848,403192.99
292680,201907,261,198,63,198602,62874,261476
292690,201907,189,145,44,144710,44910,189620
292700,201907,943,632,311,631734,310378,942112
292710,201907,109,96,13,95808,12974,108782
292720,201907,904,510,394,508980,393212,902192
292730,201907,195,93,102,92814,102794,195608
292740,201907,67308,33552,33756,33726448.57,33964975.59,67691424.16
292750,201907,387,279,108,278442.78,107784,386226.78
292760,201907,333,274,59,274450.38,58882,333332.38
292770,201907,782,341,441,340318.4,441116,781434.4
292780,201907,406,159,247,158682,246506,405188
292790,201907,749,377,372,377244,371256,748500
292800,201907,1222,737,485,736524,484030,1220554
292805,201907,397,114,283,113772,282434,396206
292810,201907,1478,843,635,843311.2,636725.65,1480036.85
292820,201907,727,599,128,599798.7,127744.98,727543.68
292830,201907,105,86,19,85828,18962,104790
292840,201907,693,570,123,569859,122754,692613
292850,201907,139,95,44,94810,43912,138722
292860,201907,2178,1286,892,1288418.4,895206,2183624.4
292870,201907,3471,2331,1140,2338317.53,1146702,3485019.53
292880,201907,1481,966,515,972053.42,515966,1488019.42
292890,201907,506,435,71,434131.94,70858,504989.94
292895,201907,138,89,49,88822,48902,137724
292900,201907,395,289,106,289420.36,107784,397204.36
292905,201907,463,237,226,236526,225548,462074
292910,201907,441,340,101,341316.3,100798,442114.3
292920,201907,529,238,291,239520,291416,530936
292925,201907,498,460,38,461076,37924.96,499000.96
292930,201907,592,359,233,358282,232534,590816
292935,201907,284,122,162,121756,163672.98,285428.98
292937,201907,244,166,78,165668,78842,244510
292940,201907,199,156,43,155688,42914,198602
292950,201907,1116,585,531,584829.3,531934,1116763.3
292960,201907,607,426,181,425148,180638,605786
292970,201907,251,180,71,179640,70858,250498
292975,201907,130,72,58,72854,57884.6,130738.6
292980,201907,281,190,91,190618.76,90818,281436.76
292990,201907,1321,988,333,990016.8,333332,1323348.8
293000,201907,107,79,28,78842,27944,106786
293010,201907,2763,1676,1087,1674644.3,1084826.99,2759471.29
293015,201907,661,532,129,531934,130738,662672
293020,201907,338,276,62,276446,61876,338322
293030,201907,600,524,76,524948.8,75848,600796.8
293040,201907,349,280,69,279440,68862,348302
293050,201907,2799,1669,1130,1668656.4,1131733.98,2800390.38
293060,201907,256,208,48,207584.58,47904,255488.58
293070,201907,3429,1778,1651,1781432.89,1656683.58,3438116.47
293075,201907,92,61,31,60878,30938,91816
293076,201907,73,49,24,48902,23952,72854
293077,201907,482,287,195,288422.4,195608,484030.4
293080,201907,454,410,44,409180.74,43912,453092.74
293090,201907,133,117,16,116766,15968,132734
293100,201907,531,372,159,372254,159680,531934
293105,201907,343,240,103,239520,103792,343312
293110,201907,174,124,50,123752,49900,173652
293120,201907,334,229,105,228542.45,104790,333332.45
293130,201907,244,167,77,166666,77844,244510
293135,201907,7938,3180,4758,3186635.46,4760512.96,7947148.42
293140,201907,198,130,68,129740.6,67864,197604.6
293150,201907,324,279,45,279440,44910,324350
293160,201907,425,245,180,244510,181636,426146
293170,201907,157,109,48,109780,47904,157684
293180,201907,487,348,139,347304.4,140718,488022.4
293190,201907,1339,940,399,938120.7,398202,1336322.7
293200,201907,535,476,59,476046,58882,534928
293210,201907,383,298,85,298402,84830,383232
293220,201907,2562,1079,1483,1081832,1489016.58,2570848.58
293230,201907,1699,630,1069,631734.35,1071852,1703586.35
293240,201907,230,211,19,210578,18962,229540
293245,201907,119,99,20,100798,19960,120758
293250,201907,699,256,443,256486.67,445108,701594.67
293260,201907,301,253,48,254490,47904,302394
293270,201907,1143,542,601,541914.68,599798,1141712.68
293280,201907,257,146,111,145708,110778,256486
293290,201907,3032,1990,1042,1992008.4,1044907.97,3036916.37
293300,201907,719,515,204,515967.67,203592,719559.67
293305,201907,167,139,28,138722,27944,166666
293310,201907,147,112,35,111776,34930,146706
293315,201907,169,132,37,131736,37924,169660
293317,201907,93,66,27,65868,26946,92814
293320,201907,1018,584,434,583830,436126,1019956
293325,201907,185,70,115,69860,114770,184630
293330,201907,13115,6224,6891,6234109.52,6904170.52,13138280.04
293340,201907,258,190,68,190618,67864,258482
293345,201907,242,193,49,194610,48902,243512
293350,201907,622,355,267,355288.4,268462,623750.4
293360,201907,1543,1102,441,1108778,442114,1550892
310010,201907,143,76,67,75848,66866.4,142714.4
310020,201907,1054,590,464,590816.4,463072.44,1053888.84
310030,201907,330,270,60,270458.2,60878,331336.2
310040,201907,47,32,15,31936,14970,46906
310050,201907,185,119,66,118762.4,65868,184630.4
310060,201907,243,171,72,171656,71856,243512
310070,201907,15,8,7,7984,6986,14970
310080,201907,43,24,19,23952,18962,42914
310090,201907,984,523,461,522953.6,460078.8,983032.4
310100,201907,304,236,68,235528,68862,304390
310110,201907,720,397,323,398202,322354.4,720556.4
310120,201907,381,222,159,222554,158682,381236
310130,201907,32,20,12,19960,11976,31936
310140,201907,25,13,12,12974,11976,24950
310150,201907,1248,862,386,861275,386226.8,1247501.8
310160,201907,2066,1056,1010,1057881.77,1008978.8,2066860.57
310163,201907,94,54,40,53892,39920,93812
310170,201907,2560,1132,1428,1134726.74,1436124.2,2570850.94
310180,201907,129,53,76,52894,79840,132734
310190,201907,475,332,143,331336,142714,474050
310200,201907,497,322,175,323352.4,175648,499000.4
310205,201907,51,38,13,37924,12974,50898
310210,201907,280,226,54,227544,53892,281436
310220,201907,58,35,23,34930,22954,57884
310230,201907,268,187,81,186626,80838,267464
310240,201907,104,93,11,92814,10978,103792
310250,201907,103,82,21,81836,20958,102794
310260,201907,761,415,346,415170.04,347304,762474.04
310270,201907,273,186,87,185628.44,87824,273452.44
310280,201907,366,272,94,272454,93812,366266
310285,201907,215,156,59,155688,58882,214570
310290,201907,249,138,111,139720,110778,250498
310300,201907,153,126,27,125748,26946,152694
310310,201907,9,7,2,6986,1996,8982
310320,201907,29,14,15,13972,14970,28942
310330,201907,33,25,8,24950,7984,32934
310340,201907,1751,1163,588,1163669.4,586824.4,1750493.8
310350,201907,2850,1578,1272,1577839.78,1272450.98,2850290.76
310360,201907,40,33,7,32934,6986,39920
310370,201907,122,102,20,102794,19960.4,122754.4
310375,201907,105,39,66,40918,65868.96,106786.96
310380,201907,47,27,20,26946,19960,46906
310390,201907,92,64,28,63872,27944,91816
310400,201907,2354,1572,782,1572848.8,780436,2353284.8
310410,201907,125,71,54,70858,53892,124750
310420,201907,669,353,316,353292.6,315368.2,668660.8
310430,201907,316,210,106,209580,107784,317364
310440,201907,70,43,27,42914,27944,70858
310445,201907,80,67,13,66866,12974,79840
310450,201907,837,530,307,530936,306386,837322
310460,201907,254,182,72,181636,71856,253492
310470,201907,505,329,176,328342,176646,504988
310480,201907,80,60,20,59880,19960,79840
310490,201907,530,257,273,256486,272454,528940
310500,201907,129,52,77,51896,77844,129740
310510,201907,601,414,187,414170,187624.98,601794.98
310520,201907,132,94,38,93812,37924,131736
310530,201907,99,43,56,42914,55888,98802
310540,201907,461,277,184,279440.6,183632,463072.6
310550,201907,87,58,29,57884,28942,86826
310560,201907,3004,2073,931,2069854.8,932132,3001986.8
310570,201907,107,74,33,73852,32934,106786
310590,201907,366,240,126,239520.5,125748,365268.5
310600,201907,158,90,68,89820.4,67864,157684.4
310610,201907,61,24,37,23952,36926,60878
310620,201907,46742,22704,24038,22723416.28,24073772.31,46797188.59
310630,201907,620,403,217,403192,219560.4,622752.4
310640,201907,149,119,30,118762,29940,148702
310650,201907,165,145,20,144710,19960,164670
310660,201907,90,59,31,59880,30938,90818
310665,201907,59,43,16,42914,15968,58882
310670,201907,6550,2961,3589,2963068.44,3591829,6554897.44
310680,201907,60,37,23,36926,22954,59880
310690,201907,588,416,172,417164.1,171656,588820.1
310700,201907,57,38,19,37924,18962,56886
310710,201907,1331,910,421,911175.38,421156.4,1332331.78
310720,201907,102,30,72,29940,71856,101796
310730,201907,1410,1003,407,1001992.9,409180,1411172.9
310740,201907,977,554,423,555887.2,424150.5,980037.7
310750,201907,242,145,97,144710.66,96806,241516.66
310760,201907,61,43,18,42914,17964.4,60878.4
310770,201907,97,46,51,45908,50898,96806
310780,201907,379,310,69,310378.98,68862,379240.98
310790,201907,100,82,18,81836,17964,99800
310800,201907,454,226,228,225548.5,228542,454090.5
310810,201907,171,121,50,120758.9,49900,170658.9
310820,201907,348,276,72,276446,71856,348302
310825,201907,198,166,32,165668,32934,198602
310830,201907,466,229,237,228542.4,236526,465068.4
310840,201907,364,213,151,214570,151696,366266
310850,201907,106,86,20,85828,20958,106786
310855,201907,396,316,80,317364,79840,397204
310860,201907,1576,1184,392,1185627.16,394210.7,1579837.86
310870,201907,53,43,10,42914,9980,52894
310880,201907,84,65,19,64870,18962,83832
310890,201907,299,180,119,179640,120758,300398
310900,201907,660,305,355,304399.96,354305.36,658705.32
310910,201907,237,163,74,163672.6,73852,237524.6
310920,201907,468,279,189,280438.9,188622,469060.9
310925,201907,35,28,7,27944,6986.4,34930.4
310930,201907,1076,669,407,668675.84,407193.9,1075869.74
310940,201907,665,346,319,347304,320358,667662
310945,201907,122,75,47,74850,46906,121756
310950,201907,247,199,48,199600,47904,247504
310960,201907,81,28,53,27944,52894.99,80838.99
310970,201907,166,105,61,104790,61876,166666
310980,201907,45,25,20,25948,20958,46906
310990,201907,149,81,68,80838,68862,149700
311000,201907,829,420,409,420159.77,409180.98,829340.75
311010,201907,43,37,6,36926,5988,42914
311020,201907,42,27,15,26946,15968,42914
311030,201907,391,231,160,231536,160678,392214
311040,201907,39,35,4,34930,3992,38922
311050,201907,477,195,282,194610.8,283432,478042.8
311060,201907,774,437,337,438122.4,336326.4,774448.8
311070,201907,344,167,177,167664,177644,345308
311080,201907,108,58,50,57884,49900,107784
311090,201907,336,161,175,160678.4,175648,336326.4
311100,201907,602,358,244,357284,243512,600796
311110,201907,696,486,210,485028.4,209580.98,694609.38
311115,201907,74,55,19,54890,19960,74850
311120,201907,1087,577,510,576844.4,509978,1086822.4
311130,201907,377,226,151,226546,150698,377244
311140,201907,162,89,73,88822,72854,161676
311150,201907,357,237,120,238522,119760,358282
311160,201907,720,521,199,522952.4,198602,721554.4
311170,201907,86,68,18,67864,17964,85828
311180,201907,342,230,112,229540,112774.4,342314.4
311190,201907,31,14,17,14970,16966,31936
311200,201907,325,233,92,232534,91816,324350
311205,201907,34,24,10,23952,9980,33932
311210,201907,47,39,8,38922.8,7984,46906.8
311220,201907,21,20,1,19960,998,20958
311230,201907,1637,1079,558,1077840.6,559878,1637718.6
311240,201907,172,113,59,112774,58882,171656
311250,201907,94,25,69,24950,68862,93812
311260,201907,557,354,203,353292,203592,556884
311265,201907,117,83,34,82834,33932,116766
311270,201907,289,200,89,200598,88822,289420
311280,201907,211,100,111,99800,110778,210578
311290,201907,108,87,21,86826,20958.4,107784.4
311300,201907,593,374,219,374250,219560,593810
311310,201907,24,18,6,17964,5988,23952
311320,201907,670,503,167,501994,167664,669658
311330,201907,1091,815,276,814368.6,278442.8,1092811.4
311340,201907,2605,1855,750,1858276.8,752492.98,2610769.78
311350,201907,276,213,63,212574,62874,275448
311360,201907,173,109,64,108782,63872,172654
311370,201907,1190,501,689,501994.5,691614.96,1193609.46
311380,201907,7,6,1,5988,998,6986
311390,201907,261,144,117,143712,116766,260478
311400,201907,153,103,50,102794,49900,152694
311410,201907,101,59,42,58882.09,41916,100798.09
311420,201907,303,171,132,171656.6,131736,303392.6
311430,201907,859,571,288,569858.5,287424.4,857282.9
311440,201907,481,339,142,339320,141716,481036
311450,201907,316,201,115,200598,115768,316366
311455,201907,288,198,90,197604,90818,288422
311460,201907,135,56,79,55888,78842,134730
311470,201907,22,13,9,12974,8982,21956
311480,201907,44,20,24,19960,23952,43912
311490,201907,16,10,6,9980,5988,15968
311500,201907,23,10,13,9980,12974,22954
311510,201907,633,451,182,451096,181636,632732
311520,201907,40,32,8,31936,7984,39920
311530,201907,1812,1357,455,1357281.28,458082,1815363.28
311535,201907,69,49,20,48902,19960,68862
311540,201907,35,30,5,29940,4990,34930
311545,201907,195,143,52,143712,51896,195608
311547,201907,33,25,8,24950,7984.96,32934.96
311550,201907,666,321,345,320358,346306.98,666664.98
311560,201907,42,28,14,27944,13972,41916
311570,201907,287,196,91,195608,90818,286426
311580,201907,328,197,131,196606,131736,328342
311590,201907,33,30,3,29940,2994,32934
311600,201907,99,79,20,78842,19960,98802
311610,201907,253,219,34,218562.5,33932,252494.5
311615,201907,114,96,18,95808,17964,113772
311620,201907,23,12,11,11976,10978,22954
311630,201907,85,73,12,72854,11976,84830
311640,201907,131,70,61,70858,60878,131736
311650,201907,134,95,39,94810,38922,133732
311660,201907,413,200,213,199600,213572,413172
311670,201907,162,106,56,105788.58,55888,161676.58
311680,201907,214,158,56,157684,56886,214570
311690,201907,13,9,4,8982,3992,12974
311700,201907,199,141,58,140718,57884,198602
311710,201907,200,129,71,128742,71856,200598
311720,201907,41,29,12,28942.4,11976,40918.4
311730,201907,598,398,200,399200,199600,598800
311740,201907,37,27,10,26946,9980,36926
311750,201907,721,487,234,486027.36,233532,719559.36
311760,201907,59,33,26,32934,25948,58882
311770,201907,396,202,194,201597.34,194610,396207.34
311780,201907,175,96,79,96806.4,78842,175648.4
311783,201907,86,76,10,75848,9980,85828
311787,201907,35,14,21,13972,20958,34930
311790,201907,270,128,142,127744,142714,270458
311800,201907,672,453,219,454090.9,218562,672652.9
311810,201907,50,42,8,41916,7984,49900
311820,201907,114,99,15,98802,15968,114770
311830,201907,1936,1225,711,1227542.3,711574,1939116.3
311840,201907,1004,562,442,562874,442114.9,1004988.9
311850,201907,10,6,4,5988,3992,9980
311860,201907,9440,4298,5142,4307370.7,5150683.25,9458053.95
311870,201907,137,76,61,75848,60878,136726
311880,201907,934,691,243,691615.38,242514,934129.38
311890,201907,214,107,107,106704,106786,213490
311900,201907,78,33,45,32934,44910,77844
311910,201907,1429,901,528,900196.7,527942.4,1428139.1
311920,201907,226,151,75,150698,75848,226546
311930,201907,905,523,382,524948.4,381236.5,906184.9
311940,201907,2474,1319,1155,1324346,1157680.86,2482026.86
311950,201907,59,45,14,44910,13972,58882
311960,201907,67,49,18,48902,17964,66866
311970,201907,26,16,10,15968,9980,25948
311980,201907,46,36,10,35928,9980,45908
311990,201907,43,35,8,34930,8982,43912
311995,201907,57,38,19,37924,18962,56886
312000,201907,32,23,9,23952,8982,32934
312010,201907,85,65,20,64870,19960,84830
312015,201907,96,72,24,71856.4,23952,95808.4
312020,201907,129,85,44,84830.4,43912,128742.4
312030,201907,52,41,11,40918,10978,51896
312040,201907,87,55,32,54890,31936,86826
312050,201907,217,120,97,120758,96806,217564
312060,201907,63,38,25,37924,24950,62874
312070,201907,73,46,27,45908,26946,72854
312080,201907,534,249,285,249500,284430,533930
312083,201907,57,41,16,40918,15968,56886
312087,201907,111,88,23,87824,22954,110778
312090,201907,3098,1856,1242,1856284.5,1240515.36,3096799.86
312100,201907,151,105,46,104560.86,45908,150468.86
312110,201907,112,68,44,67864,43912,111776
312120,201907,144,109,35,108782.97,34930,143712.97
312125,201907,89,47,42,46906,41916,88822
312130,201907,122,85,37,84830,37924,122754
312140,201907,146,114,32,113772.4,32934,146706.4
312150,201907,45,35,10,35928,9980,45908
312160,201907,1539,1014,525,1014058.8,524948.4,1539007.2
312170,201907,10,9,1,8982,998,9980
312180,201907,105,67,38,66866,37924.8,104790.8
312190,201907,34,30,4,29940,3992,33932
312200,201907,756,651,105,649698.4,105788,755486.4
312210,201907,91,60,31,59880,30938,90818
312220,201907,136,99,37,98802.5,36926,135728.5
312230,201907,3580,1747,1833,1752491.12,1833335.04,3585826.16
312235,201907,167,115,52,114770,51896,166666
312240,201907,106,75,31,74850,30938,105788
312245,201907,180,127,53,126746.99,52894,179640.99
312247,201907,65,46,19,45908,18962,64870
312250,201907,180,86,94,85828,93812,179640
312260,201907,115,76,39,75848,38922,114770
312270,201907,135,83,52,83832,51896,135728
312280,201907,27,14,13,15968,12974,28942
312290,201907,156,109,47,108782,46906.6,155688.6
312300,201907,205,135,70,134730,69860,204590
312310,201907,59,54,5,53892,4990,58882
312320,201907,432,276,156,276446,156686,433132
312330,201907,93,83,10,82834,9980,92814
312340,201907,38,17,21,16966,20958,37924
312350,201907,18,11,7,10978,6986,17964
312352,201907,98,69,29,68862,28942,97804
312360,201907,556,249,307,249500,308382,557882
312370,201907,303,174,129,173652,130738.4,304390.4
312380,201907,147,101,46,100798,45908,146706
312385,201907,171,139,32,138722,31936,170658
312390,201907,305,192,113,191616,112774,304390
312400,201907,371,284,87,284430,86827,371257
312410,201907,919,298,621,299400,621755.39,921155.39
312420,201907,625,488,137,488022.4,136726,624748.4
312430,201907,860,637,223,638721.89,222554,861275.89
312440,201907,44,34,10,33932,9980,43912
312450,201907,206,130,76,129740,75848,205588
312460,201907,33,16,17,15968,16966,32934
312470,201907,52,33,19,32934,18962,51896
312480,201907,197,119,78,118762,78842,197604
312490,201907,271,191,80,190618,79840,270458
312500,201907,34,20,14,19960,13972,33932
312510,201907,500,195,305,195608,304390,499998
312520,201907,38,11,27,11976,27944,39920
312530,201907,50,35,15,34930,14970,49900
312540,201907,101,88,13,87824,12974,100798
312550,201907,40,31,9,30938,8982,39920
312560,201907,223,171,52,170658.4,52894,223552.4
312570,201907,442,268,174,267464,173652,441116
312580,201907,87,46,41,45908,40918,86826
312590,201907,252,198,54,199600,53892,253492
312595,201907,135,122,13,121756,12974,134730
312600,201907,70,43,27,42914.1,27944,70858.1
312610,201907,1587,838,749,839319.6,751494,1590813.6
312620,201907,196,143,53,143712,53892,197604
312630,201907,69,58,11,57884,10978,68862
312640,201907,43,12,31,11976,30938,42914
312650,201907,153,129,24,128742.4,23952,152694.4
312660,201907,77,58,19,57884.7,18962,76846.7
312670,201907,891,591,300,591814,299400,891214
312675,201907,34,26,8,25948,7984,33932
312680,201907,83,56,27,55888,26946,82834
312690,201907,242,131,111,130738,110778,241516
312695,201907,37,31,6,31936,5988,37924
312700,201907,223,132,91,131736,90818,222554
312705,201907,84,70,14,69860,13972,83832
312707,201907,130,93,37,92814.3,36926,129740.3
312710,201907,1883,1029,854,1030935.68,854288.11,1885223.79
312720,201907,64,32,32,31936,31936,63872
312730,201907,277,165,112,164670,111776,276446
312733,201907,55,47,8,46906,7984,54890
312735,201907,24,16,8,15968,7984,23952
312737,201907,72,38,34,37924,33932,71856
312738,201907,53,39,14,38922,13972,52894
312740,201907,77,52,25,51896.4,25948,77844.4
312750,201907,70,51,19,50898,18962,69860
312760,201907,277,202,75,201596,74850,276446
312770,201907,7580,3553,4027,3562867.52,4036912.94,7599780.46
312780,201907,417,322,95,322354,94810,417164
312790,201907,22,18,4,17964,3992,21956
312800,201907,1615,1121,494,1123748.9,494010.46,1617759.36
312810,201907,370,239,131,239520,130738,370258
312820,201907,188,140,48,140718,47904,188622
312825,201907,26,18,8,17964,7984,25948
312830,201907,256,149,107,148702.46,106786,255488.46
312840,201907,151,107,44,106786,43912,150698
312850,201907,49,45,4,44910,3992,48902
312860,201907,158,101,57,100798,56886,157684
312870,201907,1021,543,478,541914.9,477044,1018958.9
312880,201907,143,100,43,100798,42914,143712
312890,201907,164,115,49,114770,48902,163672
312900,201907,201,152,49,152694,48902,201596
312910,201907,184,98,86,97804,85828,183632
312920,201907,157,90,67,89820,66866,156686
312930,201907,323,231,92,232534,91816,324350
312940,201907,111,80,31,79840,30938,110778
312950,201907,705,474,231,474050,230538,704588
312960,201907,170,130,40,129740.96,39920,169660.96
312965,201907,62,54,8,53892,7984,61876
312970,201907,278,224,54,223552.5,53892,277444.5
312980,201907,2401,1265,1136,1262472.18,1135724.99,2398197.17
312990,201907,45,24,21,23952,20958,44910
313000,201907,46,27,19,26946,18962,45908
313005,201907,170,135,35,135728,34930.4,170658.4
313010,201907,926,383,543,382234,542912.98,925146.98
313020,201907,188,99,89,99800,88822,188622
313030,201907,203,133,70,132734.54,69860,202594.54
313040,201907,71,25,46,24950,45908,70858
313050,201907,191,138,53,137724,52894,190618
313055,201907,44,34,10,33932,9980,43912
313060,201907,123,88,35,87824,34930,122754
313065,201907,58,41,17,40918,16966,57884
313070,201907,137,74,63,74850,62874,137724
313080,201907,42,18,24,17964,23952,41916
313090,201907,696,480,216,479040.4,215568,694608.4
313100,201907,168,63,105,62874,104790,167664
313110,201907,138,75,63,74850,62874,137724
313115,201907,186,104,82,103792,81836,185628
313120,201907,780,448,332,447104.4,332334.4,779438.8
313130,201907,5487,3050,2437,3051891.68,2441109.9,5493001.58
313140,201907,147,79,68,78842,67864,146706
313150,201907,303,242,61,243512,61876,305388
313160,201907,190,144,46,143712.4,48902,192614.4
313170,201907,1394,970,424,971055.6,426146.98,1397202.58
313180,201907,305,183,122,183632,122754,306386
313190,201907,751,454,297,456086,297404.2,753490.2
313200,201907,28,25,3,24950,2994,27944
313210,201907,1020,868,152,867263.62,152694,1019957.62
313220,201907,255,169,86,168662,85828.4,254490.4
313230,201907,276,210,66,209580.65,65868,275448.65
313240,201907,2088,1112,976,1112774.29,981034,2093808.29
313250,201907,1273,965,308,969059.4,308383.12,1277442.52
313260,201907,90,51,39,50898,38922,89820
313270,201907,954,565,389,566864.3,391216.8,958081.1
313280,201907,54,45,9,44910,8982,53892
313290,201907,223,180,43,179640.4,42914,222554.4
313300,201907,354,185,169,184631,170658,355289
313310,201907,243,127,116,126746,116766,243512
313320,201907,367,279,88,279440.6,87824,367264.6
313330,201907,1381,869,512,868260,512972,1381232
313340,201907,329,232,97,232534,96806,329340
313350,201907,494,333,161,332334,161676,494010
313360,201907,117,67,50,66866,49900.4,116766.4
313370,201907,189,71,118,70858,120758,191616
313375,201907,272,166,106,166666,106786,273452
313380,201907,1318,708,610,710576.2,610776.99,1321353.19
313390,201907,52,46,6,46906.6,5988,52894.6
313400,201907,414,282,132,281436.6,131736.8,413173.4
313410,201907,24,14,10,13972,9980,23952
313420,201907,4654,2504,2150,2504981,2154682.81,4659663.81
313430,201907,140,70,70,69860,69860,139720
313440,201907,1443,999,444,998998.71,449101.6,1448100.31
313450,201907,62,26,36,25948,35928,61876
313460,201907,380,176,204,175648,203592,379240
313470,201907,526,246,280,245508.8,280438,525946.8
313480,201907,149,106,43,105788.4,42914,148702.4
313490,201907,513,247,266,246506.4,267464.9,513971.3
313500,201907,19,11,8,10978,7984,18962
313505,201907,1003,798,205,801394,206586,1007980
313507,201907,100,62,38,61876,37924,99800
313510,201907,2776,1791,985,1789415,986024,2775439
313520,201907,3515,2762,753,2762468.45,753490.99,3515959.44
313530,201907,40,27,13,26946,12974,39920
313535,201907,53,45,8,44910,7984,52894
313540,201907,73,55,18,54890,17964,72854
313545,201907,118,100,18,99800,17964,117764
313550,201907,229,195,34,194610,33932.4,228542.4
313560,201907,327,168,159,167664,158682,326346
313570,201907,58,28,30,27944,29940,57884
313580,201907,1322,746,576,745506,575847.2,1321353.2
313590,201907,76,45,31,44910,31936,76846
313600,201907,678,417,261,417164,261476.4,678640.4
313610,201907,59,49,10,49900.4,9980,59880.4
313620,201907,1385,739,646,739518.8,647702,1387220.8
313630,201907,1634,1261,373,1260724.8,373252,1633976.8
313640,201907,126,76,50,75848,49900,125748
313650,201907,237,114,123,114770,123752.4,238522.4
313652,201907,17,17,0,16966,0,16966
313655,201907,60,36,24,35928,23952,59880
313657,201907,47,44,3,43912,2994,46906
313660,201907,133,93,40,92814,39937.96,132751.96
313665,201907,653,325,328,325348.3,330338,655686.3
313670,201907,10368,7200,3168,7207562.82,3178631.2,10386194.02
313680,201907,42,31,11,30938,10978.78,41916.78
313690,201907,151,112,39,112774,38922,151696
313695,201907,73,57,16,56886,15968,72854
313700,201907,310,250,60,250498.4,59880,310378.4
313710,201907,145,100,45,99800,44910,144710
313720,201907,1105,534,571,536924.4,571855.4,1108779.8
313730,201907,62,43,19,42914,18962,61876
313740,201907,156,128,28,127744,27944,155688
313750,201907,425,313,112,313372,111776,425148
313753,201907,236,176,60,175648,59880,235528
313760,201907,1261,461,800,461076.4,798402.1,1259478.5
313770,201907,369,275,94,274450.5,94810,369260.5
313780,201907,757,396,361,396206,363272,759478
313790,201907,28,27,1,26946,998,27944
313800,201907,146,92,54,91816,53892,145708
313810,201907,71,40,31,39920,30938,70858
313820,201907,1307,652,655,652692.8,657683.75,1310376.55
313830,201907,63,47,16,46906,15968,62874
313835,201907,62,52,10,51896,9980,61876
313840,201907,1688,1051,637,1054888.09,637722.8,1692610.89
313850,201907,198,74,124,73852,123752,197604
313860,201907,474,365,109,365268.4,109780,475048.4
313862,201907,177,119,58,118762,57884,176646
313865,201907,102,79,23,79840,22954,102794
313867,201907,49,39,10,38922,9980,48902
313868,201907,31,20,11,19960,10978,30938
313870,201907,122,64,58,63872,57884,121756
313880,201907,364,232,132,231536,131736.4,363272.4
313890,201907,332,178,154,177644.6,153692,331336.6
313900,201907,892,494,398,495008.5,399200.9,894209.4
313910,201907,141,102,39,101796,38922,140718
313920,201907,629,449,180,453092,180638.9,633730.9
313925,201907,31,28,3,27944,2994,30938
313930,201907,829,650,179,649698,179640.95,829338.95
313940,201907,1808,1147,661,1149696,660676.4,1810372.4
313950,201907,932,600,332,600796.8,332334,933130.8
313960,201907,1366,797,569,796404.76,568861.8,1365266.56
313970,201907,131,88,43,88822,42914,131736
313980,201907,217,141,76,140718.5,75848,216566.5
313990,201907,226,153,73,152694,72854,225548
314000,201907,916,618,298,618761.74,297404,916165.74
314010,201907,79,52,27,51896,26946,78842
314015,201907,54,17,37,16966,36926,53892
314020,201907,54,37,17,36926,16966,53892
314030,201907,79,39,40,38922,39920,78842
314040,201907,45,29,16,28942,15968,44910
314050,201907,288,175,113,175648.4,112774,288422.4
314053,201907,94,62,32,61876.4,31936,93812.4
314055,201907,303,186,117,185628,116766.4,302394.4
314060,201907,143,123,20,122754.82,19960,142714.82
314070,201907,1059,568,491,567862,492014,1059876
314080,201907,213,138,75,137724,75848.36,213572.36
314085,201907,137,95,42,94810,42914,137724
314090,201907,365,264,101,264470.9,100798,365268.9
314100,201907,478,396,82,395211.18,81838.88,477050.06
314110,201907,734,404,330,403192.4,330338,733530.4
314120,201907,90,53,37,52894,36926,89820
314130,201907,22,12,10,11976,9980,21956
314140,201907,1110,689,421,688621.29,421156,1109777.29
314150,201907,165,105,60,104790,59880,164670
314160,201907,344,262,82,261477.31,82834.6,344311.91
314170,201907,79,62,17,61876,16966,78842
314180,201907,729,645,84,646704.4,83832.5,730536.9
314190,201907,100,62,38,61876,37924,99800
314200,201907,471,323,148,323352,148702,472054
314210,201907,257,198,59,197604,58882.4,256486.4
314220,201907,311,232,79,231536.4,78842,310378.4
314225,201907,67,49,18,48902,17964,66866
314230,201907,119,56,63,55888,62874,118762
314240,201907,137,107,30,106786,30938,137724
314250,201907,57,35,22,34930,21956,56886
314260,201907,224,109,115,108782,114770,223552
314270,201907,335,268,67,267464,66866,334330
314280,201907,704,403,301,402194.98,300398,702592.98
314290,201907,542,447,95,450098.4,95808,545906.4
314300,201907,373,270,103,270460.5,102794.9,373255.4
314310,201907,1397,948,449,953340.53,451096,1404436.53
314315,201907,36,29,7,28942,6986,35928
314320,201907,599,397,202,396206.4,203592,599798.4
314330,201907,10778,5441,5337,5454073.88,5337307.53,10791381.41
314340,201907,590,273,317,272454,316366.8,588820.8
314345,201907,42,31,11,30938,10978,41916
314350,201907,185,117,68,117764,67864,185628
314360,201907,76,47,29,46906,28942,75848
314370,201907,60,47,13,46906,12974,59880
314380,201907,94,63,31,62874,30938,93812
314390,201907,3300,2136,1164,2135722.44,1165664.6,3301387.04
314400,201907,690,498,192,497005.5,193612,690617.5
314410,201907,466,309,157,312374,156686,469060
314420,201907,18,8,10,7984,9980,17964
314430,201907,2432,897,1535,897203.4,1541910,2439113.4
314435,201907,261,154,107,153692,106786,260478
314437,201907,30,24,6,23952,5988,29940
314440,201907,98,72,26,71856,26946,98802
314450,201907,159,115,44,114770,43912,158682
314460,201907,655,307,348,308382,347304,655686
314465,201907,86,59,27,58882,26946,85828
314467,201907,69,57,12,56886,11976,68862
314470,201907,403,209,194,208583.38,195608,404191.38
314480,201907,1078,532,546,531934,546904,1078838
314490,201907,82,59,23,58882,22954,81836
314500,201907,293,195,98,196606,97804,294410
314505,201907,129,85,44,84830,43912,128742
314510,201907,231,194,37,193612,36926,230538
314520,201907,1257,676,581,675653.43,580837.2,1256490.63
314530,201907,750,599,151,601795.66,150698,752493.66
314535,201907,211,131,80,130738,79840,210578
314537,201907,65,39,26,38922,25948,64870
314540,201907,15,10,5,9980,4990,14970
314545,201907,52,34,18,33932,17964,51896
314550,201907,82,44,38,43912,37924,81836
314560,201907,823,455,368,454090.8,367264,821354.8
314570,201907,21,17,4,16966,3992,20958
314580,201907,13,6,7,5988,6986,12974
314585,201907,25,19,6,18962,5988,24950
314587,201907,80,71,9,70858,8982,79840
314590,201907,572,420,152,419162.1,153692,572854.1
314600,201907,939,615,324,617763.4,323353.03,941116.43
314610,201907,949,510,439,509979.3,440118,950097.3
314620,201907,142,105,37,104790,36926,141716
314625,201907,95,70,25,69860,24950,94810
314630,201907,1207,629,578,631734,580836.4,1212570.4
314640,201907,81,56,25,56886,24950,81836
314650,201907,183,106,77,106786,76846,183632
314655,201907,64,47,17,46906,16966,63872
314660,201907,17,15,2,14970,2994,17964
314670,201907,200,155,45,154690.4,44910,199600.4
314675,201907,212,127,85,126746,84830,211576
314690,201907,563,310,253,310378,252494,562872
314700,201907,2328,1269,1059,1267461.6,1058878,2326339.6
314710,201907,1642,976,666,975048.1,665666.4,1640714.5
314720,201907,390,235,155,234530,154690,389220
314730,201907,509,269,240,268463.8,242514.98,510978.78
314740,201907,696,344,352,345308,351296,696604
314750,201907,21,19,2,18962,1996,20958
314760,201907,333,158,175,157684,175648,333332
314770,201907,107,78,29,77844,28942,106786
314780,201907,21,6,15,5988,14970,20958
314790,201907,2346,1492,854,1492013.74,856284,2348297.74
314795,201907,47,41,6,40918.5,5988,46906.5
314800,201907,2875,1703,1172,1705583.88,1173648,2879231.88
314810,201907,1525,874,651,873250,651694.6,1524944.6
314820,201907,100,57,43,56886,42914,99800
314830,201907,216,176,40,175648,39920,215568
314840,201907,86,50,36,49900,35928,85828
314850,201907,348,170,178,169660,177644,347304
314860,201907,699,526,173,524949.13,172654.7,697603.83
314870,201907,1500,796,704,796404,705586,1501990
314875,201907,58,50,8,50898,7984,58882
314880,201907,45,31,14,30938,13972,44910
314890,201907,55,33,22,32934,21956,54890
314900,201907,31,24,7,23952,6986,30938
314910,201907,248,168,80,167664,80838,248502
314915,201907,147,130,17,129740,17964,147704
314920,201907,110,70,40,69860,40918,110778
314930,201907,1067,541,526,541914.4,527942,1069856.4
314940,201907,47,37,10,36926,9980,46906
314950,201907,35,25,10,24950,10978,35928
314960,201907,49,37,12,36926,11976,48902
314970,201907,145,74,71,73852,70858,144710
314980,201907,300,191,109,190618,109780,300398
314990,201907,459,256,203,256486,202594,459080
314995,201907,208,62,146,61876,145708,207584
315000,201907,90,71,19,70858,18962,89820
315010,201907,45,29,16,29940,15968,45908
315015,201907,169,139,30,139720,29940,169660
315020,201907,71,60,11,60878,10978,71856
315030,201907,113,88,25,87824,24950,112774
315040,201907,70,50,20,49900,19960,69860
315050,201907,189,114,75,113772,74850,188622
315053,201907,42,37,5,36926,4990,41916
315057,201907,95,78,17,77844,16966,94810
315060,201907,70,61,9,60878.52,8982,69860.52
315070,201907,104,58,46,58882,45908,104790
315080,201907,370,301,69,300398,68862,369260
315090,201907,108,63,45,62874,44910,107784
315100,201907,82,41,41,40918,40918,81836
315110,201907,275,151,124,150698,123752,274450
315120,201907,1645,833,812,833330,812372.68,1645702.68
315130,201907,349,251,98,250498,97804,348302
315140,201907,518,304,214,304390.4,213572.8,517963.2
315150,201907,963,465,498,464070,498002.4,962072.4
315160,201907,220,112,108,111776,107784,219560
315170,201907,324,211,113,210578.4,112774,323352.4
315180,201907,3301,1408,1893,1409178.4,1896202.7,3305381.1
315190,201907,327,194,133,195608.2,132734,328342.2
315200,201907,1234,725,509,724548,509978,1234526
315210,201907,1618,931,687,931134.6,687622.2,1618756.8
315213,201907,40,23,17,22954,16966,39920
315217,201907,213,170,43,169660,42914,212574
315220,201907,1547,1192,355,1195605.58,354290.28,1549895.86
315230,201907,174,129,45,129740.4,44910,174650.4
315240,201907,425,275,150,276446,149700.98,426146.98
315250,201907,2537,1280,1257,1278438.5,1257480.8,2535919.3
315260,201907,142,86,56,85828,56886,142714
315270,201907,130,91,39,90818,38922,129740
315280,201907,663,432,231,432134.2,231536,663670.2
315290,201907,196,120,76,120758,75848.63,196606.63
315300,201907,74,56,18,55888,18962,74850
315310,201907,72,65,7,64870,6986,71856
315320,201907,164,95,69,94810,68862,163672
315330,201907,57,48,9,47904,8982,56886
315340,201907,393,285,108,284430,107784,392214
315350,201907,152,93,59,92814,58882,151696
315360,201907,91,48,43,47904,42914,90818
315370,201907,55,33,22,32934,22954,55888
315380,201907,11,8,3,7984,2994,10978
315390,201907,67,16,51,15968,50898.4,66866.4
315400,201907,843,635,208,636724.7,210578,847302.7
315410,201907,349,212,137,211576.4,137725.4,349301.8
315415,201907,63,46,17,45908,16966,62874
315420,201907,204,155,49,154690.4,49900.4,204590.8
315430,201907,655,384,271,386226.4,270458.6,656685.0
315440,201907,93,64,29,63872,28942,92814
315445,201907,242,197,45,197604,44910,242514
315450,201907,184,140,44,139720,43912,183632
315460,201907,3767,1940,1827,1940112.98,1826340.98,3766453.96
315470,201907,41,17,24,16966,23952,40918
315480,201907,63,24,39,23952,38922,62874
315490,201907,639,400,239,399200,240518,639718
315500,201907,22,15,7,14970,6986,21956
315510,201907,155,105,50,104790,49900,154690
315520,201907,70,63,7,62874,6986,69860
315530,201907,50,26,24,25948,23952,49900
315540,201907,237,159,78,160678,77844,238522
315550,201907,184,149,35,148702,34930,183632
315560,201907,733,590,143,588820.4,142714,731534.4
315570,201907,306,159,147,159681.43,148702.6,308384.03
315580,201907,701,468,233,468062,232534,700596
315590,201907,201,107,94,106786,94810,201596
315600,201907,301,226,75,226546,74850,301396
315610,201907,98,51,47,51896,46906,98802
315620,201907,34,26,8,25948,7984,33932
315630,201907,132,87,45,87824,44910,132734
315640,201907,66,41,25,40918,24950,65868
315645,201907,51,35,16,35928,15968,51896
315650,201907,169,124,45,123752.8,44910,168662.8
315660,201907,462,206,256,206586,255488,462074
315670,201907,2400,1201,1199,1203589.8,1204587.96,2408177.76
315680,201907,845,583,262,582832,261476,844308
315690,201907,677,471,206,471057.73,208582,679639.73
315700,201907,1881,1005,876,1003989.27,878240,1882229.27
315710,201907,333,98,235,97804,234530,332334
315720,201907,443,281,162,281436.4,161676,443112.4
315725,201907,198,158,40,157684.4,39920,197604.4
315727,201907,38,22,16,21956,15968,37924
315730,201907,50,48,2,47904,1996,49900
315733,201907,87,60,27,59880,26946,86826
315737,201907,50,39,11,38922,10978,49900
315740,201907,37,30,7,29940,6986,36926
315750,201907,159,123,36,122754,35928,158682
315760,201907,45,35,10,34930,9980,44910
315765,201907,120,75,45,74850,44910,119760
315770,201907,226,141,85,142714,86826.4,229540.4
315780,201907,3401,1771,1630,1775443.4,1628737.15,3404180.55
315790,201907,220,171,49,170658,48902,219560
315800,201907,290,211,79,211576,78842,290418
315810,201907,97,58,39,57884,38922.4,96806.4
315820,201907,760,554,206,556885.2,206586,763471.2
315830,201907,134,78,56,77844,55888,133732
315840,201907,86,60,26,59880,25948,85828
315850,201907,257,189,68,188622.5,67864,256486.5
315860,201907,12,4,8,3992,7984,11976
315870,201907,37,29,8,28942,7984,36926
315880,201907,104,68,36,68862,35928,104790
315890,201907,86,63,23,62874,22954,85828
315895,201907,442,299,143,300398.5,142714.8,443113.3
315900,201907,71,36,35,35928,34930,70858
315910,201907,38,25,13,24950,12974,37924
315920,201907,173,111,62,110778,61876.3,172654.3
315930,201907,47,17,30,16966,29940,46906
315935,201907,138,106,32,105788,31936.98,137724.98
315940,201907,97,73,24,72854,23952,96806
315950,201907,43,31,12,30938,11976,42914
315960,201907,545,264,281,263472.4,281436.4,544908.8
315970,201907,35,28,7,27944,6986,34930
315980,201907,682,337,345,336326.1,346306,682632.1
315990,201907,254,149,105,148702,104790.98,253492.98
316000,201907,54,35,19,34930,18962,53892
316010,201907,80,69,11,68862,10978,79840
316020,201907,114,98,16,97804,15968,113772
316030,201907,402,221,181,220559.17,181636.9,402196.07
316040,201907,508,216,292,216566.4,293412.4,509978.8
316045,201907,63,56,7,55888,6986,62874
316050,201907,16,14,2,13972,1996,15968
316060,201907,98,64,34,63872,34930,98802
316070,201907,1095,706,389,710576.1,388222,1098798.1
316080,201907,105,70,35,69860,34930,104790
316090,201907,38,22,16,21956,15968,37924
316095,201907,75,66,9,65868,8982,74850
316100,201907,312,181,131,180638.5,130738,311376.5
316105,201907,39,27,12,26946,11976,38922
316110,201907,1859,1501,358,1502988.55,357284,1860272.55
316120,201907,79,60,19,59880,18962,78842
316130,201907,126,96,30,95808.4,29940,125748.4
316140,201907,30,22,8,21956,7984,29940
316150,201907,207,142,65,141716,64870,206586
316160,201907,77,47,30,46906,29940,76846
316165,201907,66,52,14,51896.6,13972,65868.6
316170,201907,192,129,63,128742,62874,191616
316180,201907,201,88,113,87824,112774.4,200598.4
316190,201907,135,99,36,98802,35928,134730
316200,201907,676,384,292,389220,291416,680636
316210,201907,772,518,254,519131.65,253492,772623.65
316220,201907,114,77,37,76846,37924,114770
316225,201907,26,15,11,14970,10978,25948
316230,201907,32,18,14,17964,13972,31936
316240,201907,646,520,126,519958,125748,645706
316245,201907,127,108,19,108782,18962,127744
316250,201907,1545,1074,471,1073849.66,473052,1546901.66
316255,201907,123,100,23,99800,22954,122754
316257,201907,175,94,81,93812,81836,175648
316260,201907,192,136,56,136726.5,55888.38,192614.88
316265,201907,27,19,8,18962,7984,26946
316270,201907,676,481,195,480038.6,194610.84,674649.44
316280,201907,543,335,208,335329.23,208583.4,543912.63
316290,201907,724,480,244,480038.66,245508,725546.66
316292,201907,505,206,299,206586,300398,506984
316294,201907,102,61,41,60878,40918,101796
316295,201907,300,134,166,134731.36,165668,300399.36
316300,201907,99,73,26,72854,25948,98802
316310,201907,37,20,17,19960,16966,36926
316320,201907,47,28,19,27944,18962,46906
316330,201907,132,88,44,87824.5,43912,131736.5
316340,201907,142,98,44,97804,43912,141716
316350,201907,195,138,57,138722.3,56886,195608.3
316360,201907,23,16,7,16966,6986,23952
316370,201907,1079,570,509,569859.1,509978,1079837.1
316380,201907,121,93,28,92814,27944,120758
316390,201907,119,87,32,87824,31936,119760
316400,201907,136,105,31,104790,30938,135728
316410,201907,303,221,82,220558,81836,302394
316420,201907,204,144,60,143712,59880,203592
316430,201907,151,79,72,78842,72854,151696
316440,201907,94,46,48,45908,48902,94810
316443,201907,37,35,2,34930,1996,36926
316447,201907,66,52,14,51896,13972,65868
316450,201907,231,174,57,173652,56886,230538
316460,201907,74,29,45,28942,44910,73852
316470,201907,1634,1209,425,1207573.77,424150.18,1631723.95
316480,201907,13,10,3,9980,2994,12974
316490,201907,16,7,9,6986,9980,16966
316500,201907,154,103,51,102794,51896,154690
316510,201907,162,125,37,124750,36926,161676
316520,201907,198,124,74,123752,73852,197604
316530,201907,159,112,47,111776,47904,159680
316540,201907,139,77,62,77844,61876,139720
316550,201907,136,93,43,92814,42914,135728
316553,201907,276,131,145,130738,145708.72,276446.72
316555,201907,36,31,5,30938,4990,35928
316556,201907,10,7,3,6986,2994,9980
316557,201907,19,15,4,14970,3992,18962
316560,201907,70,52,18,51896,17964,69860
316570,201907,233,213,20,215568,19960,235528
316580,201907,19,16,3,15968,2994,18962
316590,201907,109,94,15,93812,14970,108782
316600,201907,184,153,31,152694,30938,183632
316610,201907,69,50,19,49900,18962,68862
316620,201907,143,110,33,109780,32934,142714
316630,201907,42,33,9,32934,8982,41916
316640,201907,20,13,7,12974,6986,19960
316650,201907,78,61,17,60878,16966,77844
316660,201907,7,2,5,2994,4990,7984
316670,201907,441,156,285,155688.96,284430,440118.96
316680,201907,154,109,45,108782,45908.6,154690.6
316690,201907,187,121,66,120758,65868,186626
316695,201907,64,56,8,55888,7984,63872
316700,201907,16,10,6,9980,5988,15968
316710,201907,748,559,189,558880.5,188622,747502.5
316720,201907,4922,2523,2399,2519955.15,2401190.74,4921145.89
316730,201907,17,16,1,15968,998,16966
316740,201907,117,76,41,77844,40918,118762
316750,201907,19,13,6,12974,5988,18962
316760,201907,319,259,60,258482,59880,318362
316770,201907,141,79,62,78842,62874,141716
316780,201907,75,47,28,47904,27944,75848
316790,201907,53,39,14,38922,13972,52894
316800,201907,1732,1086,646,1083828,645707,1729535
316805,201907,21,13,8,12974,7984,20958
316810,201907,72,49,23,48902,22954,71856
316820,201907,43,21,22,20958,21956,42914
316830,201907,90,44,46,43912,45908,89820
316840,201907,510,310,200,309380.4,199600,508980.4
316850,201907,340,227,113,226546,113772,340318
316860,201907,5969,2684,3285,2683626.16,3288410.3,5972036.46
316870,201907,1510,1006,504,1006984.3,503991.2,1510975.5
316880,201907,125,62,63,63872,63872,127744
316890,201907,247,168,79,168662,78842,247504
316900,201907,432,299,133,300398.36,132734,433132.36
316905,201907,20,9,11,8982,10978,19960
316910,201907,57,23,34,22954,33932,56886
316920,201907,135,106,29,105788,28942,134730
316930,201907,1867,979,888,983030.8,891214.3,1874245.1
316935,201907,892,547,345,545906.64,345308.4,891215.04
316940,201907,1090,632,458,631734.8,458082.4,1089817.2
316950,201907,181,93,88,92814.4,87824,180638.4
316960,201907,1112,623,489,622752.4,488022.4,1110774.8
316970,201907,657,518,139,516964,138722,655686
316980,201907,113,68,45,67864,44910,112774
316990,201907,2230,1494,736,1496002.34,734529.5,2230531.84
317000,201907,325,249,76,251496,75848,327344
317005,201907,240,174,66,173652,66866,240518
317010,201907,6389,3604,2785,3613762.19,2787414.4,6401176.59
317020,201907,16301,7317,8984,7329326.55,8986009.1,16315335.65
317030,201907,81,31,50,30938,49900,80838
317040,201907,3112,1955,1157,1957080.6,1156682.6,3113763.2
317043,201907,75,55,20,54890,19960,74850
317047,201907,31,16,15,15968,14970.99,30938.99
317050,201907,177,136,41,135728,40918,176646
317052,201907,135,102,33,101796,32934,134730
317057,201907,181,139,42,138722,41916,180638
317060,201907,63,43,20,42914,19960,62874
317065,201907,56,45,11,44910,10978,55888
317070,201907,1973,932,1041,935127.5,1039916.8,1975044.3
317075,201907,110,59,51,58882,50898,109780
317080,201907,856,461,395,460078.5,395208.6,855287.1
317090,201907,650,527,123,525946,122754,648700
317100,201907,426,325,101,325348,100798,426146
317103,201907,109,92,17,92814,16966,109780
317107,201907,44,39,5,38922,4990,43912
317110,201907,109,48,61,47904,61876,109780
317115,201907,48,43,5,42914,4990,47904
317120,201907,1865,962,903,964068.8,903190.4,1867259.2
317130,201907,1996,1328,668,1326344,666664,1993008
317140,201907,11,10,1,9980,998,10978
317150,201907,273,164,109,163672.4,108782,272454.4
317160,201907,320,238,82,237525.03,82834,320359.03
317170,201907,213,148,65,147704,64870,212574
317180,201907,440,319,121,319360,120758,440118
317190,201907,260,180,80,179640,81836,261476
317200,201907,801,564,237,564871.81,238522,803393.81
317210,201907,184,103,81,102794,80838,183632
317220,201907,24,13,11,12974,10978,23952
320010,201907,608,450,158,452094.5,158682,610776.5
320013,201907,133,99,34,98802,33932,132734
320016,201907,275,174,101,174650,100798,275448
320020,201907,713,430,283,432135.1,283432,715567.1
320030,201907,144,103,41,102794,40918.41,143712.41
320035,201907,140,106,34,106786,33932,140718
320040,201907,497,260,237,259480,237524,497004
320050,201907,102,80,22,79840,21956,101796
320060,201907,1621,790,831,792414.58,830339.74,1622754.32
320070,201907,100,68,32,67864,31936,99800
320080,201907,789,458,331,458082.9,331336.1,789419.0
320090,201907,1245,874,371,873250,372254.4,1245504.4
320100,201907,330,191,139,190618,138722,329340
320110,201907,123,79,44,79841.1,43912.4,123753.5
320115,201907,108,89,19,88822,18962,107784
320120,201907,3360,1872,1488,1877239.86,1488019.77,3365259.63
320130,201907,7447,3520,3927,3520964.45,3935147.71,7456112.16
320140,201907,428,284,144,284430.6,143712.68,428143.28
320150,201907,2009,1164,845,1164669.05,846304,2010973.05
320160,201907,664,300,364,300398.99,365269.79,665668.78
320170,201907,114,92,22,91816,21956,113772
320180,201907,52,30,22,29940,21956,51896
320190,201907,242,159,83,160678,83832.4,244510.4
320200,201907,56,45,11,44910,10978,55888
320210,201907,876,489,387,489020.8,389221.76,878242.56
320220,201907,306,116,190,116766,190618,307384
320225,201907,88,72,16,71856,15968,87824
320230,201907,586,380,206,380238.6,206586,586824.6
320240,201907,3145,1592,1553,1596801.6,1552889.78,3149691.38
320245,201907,462,318,144,317364.4,143712,461076.4
320250,201907,226,118,108,117764,107784,225548
320255,201907,144,116,28,115768,27944.7,143712.7
320260,201907,195,139,56,138722,55888,194610
320265,201907,161,128,33,127744,32934,160678
320270,201907,154,124,30,123752,29940,153692
320280,201907,991,597,394,602793.53,394210,997003.53
320290,201907,62,54,8,53892,7984,61876
320300,201907,563,396,167,395209.34,167666.04,562875.38
320305,201907,669,368,301,368262,303393,671655
320310,201907,215,123,92,123752.76,92814,216566.76
320313,201907,317,160,157,159680.9,156686.4,316367.3
320316,201907,110,89,21,88822,20958,109780
320320,201907,3422,1595,1827,1595804.42,1827340.75,3423145.17
320330,201907,260,200,60,199600,59880,259480
320332,201907,857,516,341,520958.5,341316.9,862275.4
320334,201907,251,152,99,151696.4,98802,250498.4
320335,201907,141,101,40,100798,39920,140718
320340,201907,564,392,172,392214.9,172654,564868.9
320350,201907,984,425,559,424151.29,557883.6,982034.89
320360,201907,169,92,77,91816,76846,168662
320370,201907,244,187,57,186626.56,57884.4,244510.96
320380,201907,281,196,85,196606,84830,281436
320390,201907,1156,705,451,704588.92,450098.8,1154687.72
320400,201907,307,224,83,225549.4,82834,308383.4
320405,201907,929,405,524,407184.99,526947.38,934132.37
320410,201907,977,505,472,504988,472055.3,977043.3
320420,201907,483,249,234,248503.3,235528,484031.3
320425,201907,190,105,85,104790,84830,189620
320430,201907,387,223,164,222554.5,163672,386226.5
320435,201907,163,111,52,110778,51896,162674
320440,201907,202,120,82,119760,81836,201596
320450,201907,128,74,54,74850,53892,128742
320455,201907,245,202,43,201596.4,42914,244510.4
320460,201907,261,162,99,161676,98802,260478
320465,201907,115,80,35,79840,34930,114770
320470,201907,682,437,245,437125.99,244510.99,681636.98
320480,201907,184,120,64,120758,64870,185628
320490,201907,3058,1532,1526,1532930.89,1530941.19,3063872.08
320495,201907,100,60,40,59880.96,40918.8,100799.76
320500,201907,9773,4924,4849,4931134.55,4859275.58,9790410.13
320501,201907,538,271,267,270458,266466,536924
320503,201907,291,208,83,207584,82834,290418
320506,201907,257,184,73,183632,72854,256486
320510,201907,993,472,521,473052.4,520957.38,994009.78
320515,201907,82,69,13,68862,12974,81836
320517,201907,206,149,57,148702,56886,205588
320520,201907,6885,3085,3800,3103786,3815361.75,6919147.75
320530,201907,5779,2969,2810,2980035.32,2817358.13,5797393.45
330010,201907,3061,1605,1456,1601792.2,1461072,3062864.2
330015,201907,160,67,93,67864.56,92814,160678.56
330020,201907,3626,1609,2017,1615764.4,2022946.4,3638710.8
330022,201907,240,129,111,128742,110778,239520
330023,201907,559,195,364,194610,365268,559878
330025,201907,571,119,452,120758,456086,576844
330030,201907,1925,1259,666,1260476.66,666664.8,1927141.46
330040,201907,2405,1285,1120,1285426.1,1120756.2,2406182.3
330045,201907,8337,2723,5614,2734520.8,5632713.6,8367234.4
330050,201907,883,571,312,569858,312374,882232
330060,201907,941,578,363,577842.9,363272,941114.9
330070,201907,3454,1325,2129,1326343.14,2146699.94,3473043.08
330080,201907,1499,690,809,691615.7,808380,1499995.7
330090,201907,375,221,154,220558,154690.4,375248.4
330093,201907,268,123,145,122754,145709.88,268463.88
330095,201907,94,51,43,50898,42914,93812
330100,201907,9452,4927,4525,4937841.62,4538904.4,9476746.02
330110,201907,492,210,282,209580.7,284430,494010.7
330115,201907,542,292,250,293412,250498,543910
330120,201907,373,189,184,189620,183633.6,373253.6
330130,201907,1511,404,1107,405188.6,1104786.96,1509975.56
330140,201907,595,317,278,317364.94,281436,598800.94
330150,201907,495,283,212,283432,213572,497004
330160,201907,204,126,78,127744,77844,205588
330170,201907,26728,9425,17303,9447076.6,17388167.32,26835243.92
330180,201907,237,149,88,148702,87824,236526
330185,201907,906,328,578,327344.98,580837.92,908182.90
330187,201907,319,99,220,99800,219560,319360
330190,201907,5548,2224,3324,2229534.56,3327334.08,5556868.64
330200,201907,4721,1463,3258,1466064.24,3262463.46,4728527.70
330205,201907,427,252,175,252494,174650.4,427144.4
330210,201907,996,621,375,620758.84,376248.18,997007.02
330220,201907,2571,1552,1019,1555883,1019956.4,2575839.4
330225,201907,554,296,258,297404,258482,555886
330227,201907,2346,757,1589,759478.4,1598799.26,2358277.66
330230,201907,218,125,93,126746,92814,219560
330240,201907,3613,1897,1716,1901197.04,1718592,3619789.04
330245,201907,158,73,85,72854.74,84830,157684.74
330250,201907,6749,3526,3223,3528930.35,3230529.71,6759460.06
330260,201907,558,158,400,157684,406186,563870
330270,201907,3428,1242,2186,1245504.6,2190612.8,3436117.4
330280,201907,443,283,160,284431.2,160678.98,445110.18
330285,201907,7155,2337,4818,2341309.5,4828328.72,7169638.22
330290,201907,620,236,384,235528,384230.4,619758.4
330300,201907,777,519,258,517963.1,257484.94,775448.04
330310,201907,435,251,184,252494.9,183632,436126.9
330320,201907,7994,3072,4922,3084821.4,4943095.6,8027917.0
330330,201907,8835,3540,5295,3554878.68,5336318.24,8891196.92
330340,201907,2697,1614,1083,1626740.6,1088818,2715558.6
330350,201907,18171,7237,10934,7262454.5,10977013.7,18239468.2
330360,201907,2325,1160,1165,1165665.76,1165664.98,2331330.74
330370,201907,1028,537,491,536924.7,494010.6,1030935.3
330380,201907,859,374,485,374250,484030.61,858280.61
330385,201907,611,322,289,323352.5,290418,613770.5
330390,201907,5371,2945,2426,2958075.24,2438114.8,5396190.04
330395,201907,300,186,114,186626,113772.7,300398.7
330400,201907,696,382,314,384231,316366,700597
330410,201907,502,365,137,365269.7,137724.4,502994.1
330411,201907,241,134,107,133732.62,106786,240518.62
330412,201907,242,98,144,99800.4,143712,243512.4
330414,201907,5514,2293,3221,2299393.88,3238510.8,5537904.68
330415,201907,578,266,312,265468.7,312374.6,577843.3
330420,201907,2260,1189,1071,1187621.42,1068859.38,2256480.80
330430,201907,1754,840,914,847302.8,921157.23,1768460.03
330440,201907,271,133,138,133732,138722,272454
330450,201907,116,51,65,50898,65868,116766
330452,201907,1812,858,954,861276.52,956084,1817360.52
330455,201907,108990,39899,69091,39992965.06,69421916.31,109414881.37
330460,201907,261,107,154,106786,153692.94,260478.94
330470,201907,1223,674,549,676645.3,548901.5,1225546.8
330475,201907,1372,370,1002,370258,1001992,1372250
330480,201907,784,423,361,424150,361276.6,785426.6
330490,201907,13715,4786,8929,4808365.1,8987995.66,13796360.76
330500,201907,1347,606,741,604788,740516.46,1345304.46
330510,201907,10918,3841,7077,3853279.86,7113747.9,10967027.76
330513,201907,102,51,51,50898,50898,101796
330515,201907,823,341,482,341317.26,484031.21,825348.47
330520,201907,2471,926,1545,928140.54,1547898,2476038.54
330530,201907,214,115,99,114770.5,98802.6,213573.1
330540,201907,362,179,183,178642.4,183632,362274.4
330550,201907,2890,1051,1839,1057880.8,1842308.8,2900189.6
330555,201907,817,320,497,319360.96,498002,817362.96
330560,201907,639,211,428,210578,427144.94,637722.94
330570,201907,260,188,72,188622,71856,260478
330575,201907,780,322,458,322354,459081.4,781435.4
330580,201907,3365,1901,1464,1908178.2,1464066.95,3372245.15
330590,201907,307,156,151,155688,150698.98,306386.98
330600,201907,1127,728,399,730536.4,399200,1129736.4
330610,201907,1559,861,698,861276.2,701596.3,1562872.5
330615,201907,200,152,48,151696,47904,199600
330620,201907,1051,436,615,438122.6,616764,1054886.6
330630,201907,4017,2571,1446,2574843.16,1447101.1,4021944.26
350010,201907,599,407,192,407184.82,192614,599798.82
350020,201907,46,22,24,21956,23952,45908
350030,201907,515,322,193,323352.4,192614.8,515967.2
350040,201907,124,47,77,46906,77844,124750
350050,201907,306,166,140,165668,139720.98,305388.98
350055,201907,85,46,39,45908,39920,85828
350060,201907,77,29,48,29940,48902,78842
350070,201907,802,479,323,480070.67,325364.64,805435.31
350075,201907,70,47,23,46906,22954,69860
350080,201907,50,30,20,29940,19960,49900
350090,201907,86,47,39,46906,38922,85828
350100,201907,292,179,113,179640,112774,292414
350110,201907,59,39,20,38922,19960,58882
350115,201907,161,96,65,95808,64870,160678
350120,201907,104,70,34,70858,33932,104790
350130,201907,344,162,182,163672.58,181636.98,345309.56
350140,201907,39,26,13,25948,12974,38922
350150,201907,69,53,16,52894,15968,68862
350160,201907,2522,1004,1518,1004991.26,1525948.93,2530940.19
350170,201907,398,241,157,240519.14,157684.4,398203.54
350180,201907,175,99,76,98802,76846,175648
350190,201907,1014,540,474,539919.59,474050.4,1013969.99
350200,201907,69,26,43,25948,43912,69860
350210,201907,1285,726,559,725548.88,562872.64,1288421.52
350220,201907,673,572,101,570856.63,101796,672652.63
350230,201907,77,53,24,52894,23952,76846
350240,201907,62,45,17,44910,16966,61876
350250,201907,1171,575,596,575847.4,597803.7,1173651.1
350260,201907,90,66,24,66866,23952,90818
350270,201907,844,558,286,560876.42,286426.4,847302.82
350275,201907,303,125,178,124750,179640,304390
350280,201907,4598,2359,2239,2366265.77,2242510.95,4608776.72
350290,201907,422,200,222,200598,221556.4,422154.4
350300,201907,59,32,27,31936,26946,58882
350310,201907,94,59,35,58882,34930,93812
350315,201907,39,24,15,23952,14970,38922
350320,201907,3260,1600,1660,1601790.9,1660672.6,3262463.5
350330,201907,1665,908,757,908183.05,761475.2,1669658.25
350335,201907,21,14,7,13972,6986,20958
350340,201907,129,62,67,61876,66866.3,128742.3
350350,201907,92,46,46,45908,46906,92814
350360,201907,128,86,42,85828.99,41916,127744.99
350370,201907,85,48,37,47904.63,37924,85828.63
350380,201907,768,329,439,330338.8,438123.2,768462.0
350390,201907,1505,609,896,610777.43,900196.4,1510973.83
350395,201907,27,22,5,21956,4990,26946
350400,201907,1675,876,799,877245.19,798401.62,1675646.81
350410,201907,2400,1082,1318,1080834,1323348.63,2404182.63
350420,201907,238,148,90,147705.03,89820,237525.03
350430,201907,76,46,30,45908,29940,75848
350440,201907,144,104,40,103792.4,39920,143712.4
350450,201907,1633,997,636,1001994.67,635727.2,1637721.87
350460,201907,340,125,215,124750,214570,339320
350470,201907,17,11,6,10978,5988,16966
350480,201907,171,94,77,93812,76846,170658
350490,201907,233,119,114,118762,113772,232534
350500,201907,47,21,26,20958,25948,46906
350510,201907,165,114,51,113772,51896,165668
350520,201907,448,216,232,215568,233532,449100
350530,201907,444,209,235,209580,234530,444110
350535,201907,75,61,14,61876,13972,75848
350540,201907,388,194,194,193612,193612,387224
350550,201907,2732,1618,1114,1621752.91,1113773.39,2735526.30
350560,201907,654,459,195,459080.63,195608,654688.63
350570,201907,4050,1722,2328,1727539.63,2337318.93,4064858.56
350580,201907,380,177,203,176646.63,204590.99,381237.62
350590,201907,909,497,412,498002.4,411176,909178.4
350600,201907,6148,3055,3093,3058876.75,3095799.37,6154676.12
350610,201907,1533,809,724,809379.26,724548.98,1533928.24
350620,201907,35,23,12,22954,11976,34930
350630,201907,233,135,98,135728.63,97804.63,233533.26
350635,201907,916,380,536,380238.4,536924.8,917163.2
350640,201907,124,95,29,94810,28942,123752
350650,201907,1878,1242,636,1243508.58,640716.98,1884225.56
350660,201907,749,328,421,327344,424150.99,751494.99
350670,201907,310,151,159,151696,159680,311376
350680,201907,180,94,86,93812,85828.8,179640.8
350690,201907,202,106,96,105788,95808,201596
350700,201907,766,367,399,367264.4,398202,765466.4
350710,201907,355,134,221,133732,223552,357284
350715,201907,54,44,10,43912,9980,53892
350720,201907,17,11,6,10978,5988,16966
350730,201907,44,27,17,26946,16966,43912
350740,201907,206,116,90,116766,89820,206586
350745,201907,19,10,9,9980.44,8982,18962.44
350750,201907,2157,1357,800,1359278.38,803390,2162668.38
350760,201907,3715,1649,2066,1652688.66,2070850.4,3723539.06
350770,201907,62,44,18,44910,18962,63872
350775,201907,48,35,13,34930,12974.98,47904.98
350780,201907,440,221,219,220558,218562.4,439120.4
350790,201907,367,154,213,153692,214570,368262
350800,201907,458,270,188,271456,188622,460078
350810,201907,509,414,95,414171.33,96806,510977.33
350820,201907,89,55,34,54890,33932,88822
350830,201907,81,44,37,43912,37924,81836
350840,201907,776,325,451,326346.4,450099.38,776445.78
350850,201907,1749,1003,746,1006982.5,745509.93,1752492.43
350860,201907,581,334,247,334332.46,248502,582834.46
350870,201907,436,294,142,293412,142714,436126
350880,201907,281,154,127,153692,128742,282434
350890,201907,42,29,13,28942,12974,41916
350900,201907,1460,476,984,476047.36,986024,1462071.36
350910,201907,24,14,10,13972,9980,23952
350920,201907,640,348,292,350298,292414,642712
350925,201907,1208,644,564,645706.78,564869.2,1210575.98
350930,201907,99,59,40,58882,39920,98802
350940,201907,720,400,320,399200,322354.36,721554.36
350945,201907,109,80,29,79840,28942,108782
350950,201907,16180,7724,8456,7735503.08,8484004.41,16219507.49
350960,201907,1296,612,684,611774.4,684628.99,1296403.39
350970,201907,1117,588,529,591708.03,530936.4,1122644.43
350980,201907,90,61,29,61876,28942,90818
350990,201907,379,137,242,137724,241516,379240
350995,201907,36,16,20,15968,19960,35928
351000,201907,633,441,192,440119.26,191616,631735.26
351010,201907,51,32,19,31936,18962,50898
351015,201907,53,37,16,37924,16966,54890
351020,201907,1602,964,638,965066.99,637722,1602788.99
351030,201907,344,235,109,235528,109780,345308
351040,201907,856,455,401,454090.48,402194.11,856284.59
351050,201907,3310,1532,1778,1534929.01,1779442.49,3314371.50
351060,201907,5034,2062,2972,2069853.96,2982028.56,5051882.52
351070,201907,410,258,152,257485.55,151696,409181.55
351080,201907,754,536,218,537922,217564,755486
351090,201907,56,26,30,25948,29940,55888
351100,201907,435,252,183,254490.68,183632,438122.68
351110,201907,2079,1009,1070,1007991.96,1073867.96,2081859.92
351120,201907,68,35,33,34930,32934,67864
351130,201907,173,59,114,58882,113772,172654
351140,201907,333,230,103,229540,102794,332334
351150,201907,426,233,193,232534.3,192614.4,425148.7
351160,201907,264,180,84,179640.4,83832,263472.4
351170,201907,184,104,80,103792,79840,183632
351190,201907,86,58,28,57884,27944,85828
351200,201907,363,245,118,245508.4,118762,364270.4
351210,201907,122,63,59,62874,58882,121756
351220,201907,534,321,213,321357.76,212574,533931.76
351230,201907,275,195,80,196606.52,80838,277444.52
351240,201907,235,105,130,104790,129740,234530
351250,201907,73,52,21,51896.53,20958,72854.53
351260,201907,151,112,39,111776,38922,150698
351270,201907,47,19,28,18962,27944,46906
351280,201907,1050,483,567,485029.26,568862.01,1053891.27
351290,201907,236,108,128,107784,127744.4,235528.4
351300,201907,3687,1728,1959,1735445.55,1963067.62,3698513.17
351310,201907,760,390,370,391216,371256.98,762472.98
351320,201907,116,69,47,69860,46906,116766
351330,201907,37,24,13,23952,12974,36926
351340,201907,1228,745,483,743511,482036.95,1225547.95
351350,201907,2565,1500,1065,1501991,1069856,2571847
351360,201907,765,382,383,382234,382234,764468
351370,201907,384,194,190,193612,190618,384230
351380,201907,9208,4163,5045,4173642.65,5055873.39,9229516.04
351385,201907,28,17,11,16966,10978,27944
351390,201907,285,214,71,213572.54,70858,284430.54
351400,201907,65,41,24,40918,23954.94,64872.94
351410,201907,440,276,164,275448.6,163672,439120.6
351420,201907,60,49,11,48902,10978,59880
351430,201907,66,36,30,36926,29940,66866
351440,201907,796,562,234,562874.56,234530.99,797405.55
351450,201907,259,133,126,132734,125748,258482
351460,201907,115,54,61,54890,60878,115768
351470,201907,135,73,62,72854,61876,134730
351480,201907,525,296,229,295409.76,230538,525947.76
351490,201907,287,107,180,106786,180638,287424
351492,201907,33,24,9,23952,9980,33932
351495,201907,27,19,8,18962,7984,26946
351500,201907,3547,1502,2045,1503987.94,2057877.36,3561865.30
351510,201907,1874,773,1101,776444.8,1109776.4,1886221.2
351512,201907,20,16,4,15968,3992,19960
351515,201907,193,113,80,112774,81836.96,194610.96
351518,201907,775,485,290,484030.99,297404,781434.99
351519,201907,72,46,26,45908,25948,71856
351520,201907,152,96,56,95808,56886,152694
351530,201907,23,15,8,14970,7984,22954
351535,201907,130,74,56,73852,56886,130738
351540,201907,456,326,130,325349.05,129740,455089.05
351550,201907,1383,837,546,836326.46,545906,1382232.46
351560,201907,67,39,28,38922,28942.96,67864.96
351565,201907,8,6,2,5988,1996,7984
351570,201907,2647,1378,1269,1377242.38,1271454.97,2648697.35
351580,201907,42,37,5,36926,4990,41916
351590,201907,66,44,22,43912,21956,65868
351600,201907,193,144,49,143712,48902,192614
351610,201907,57,26,31,25948,30938,56886
351620,201907,5875,3332,2543,3344303.71,2551887.66,5896191.37
351630,201907,2679,1387,1292,1387220.9,1298398,2685618.9
351640,201907,1828,878,950,876244.49,955087.03,1831331.52
351650,201907,32,27,5,26946,4990,31936
351660,201907,138,89,49,88822,48902,137724
351670,201907,721,447,274,448103.9,274450,722553.9
351680,201907,72,57,15,56886,14970,71856
351685,201907,32,19,13,18962,12974,31936
351690,201907,302,213,89,213572.45,88822,302394.45
351700,201907,159,113,46,112774.4,45908,158682.4
351710,201907,69,47,22,46906,22954,69860
351720,201907,126,65,61,64870,60878,125748
351730,201907,98,67,31,66866.63,30938.63,97805.26
351740,201907,730,481,249,481037.66,248502,729539.66
351750,201907,353,147,206,148702,205588,354290
351760,201907,776,586,190,584828,191616,776444
351770,201907,306,262,44,262474,44910,307384
351780,201907,157,90,67,89820.98,66866,156686.98
351790,201907,252,132,120,132734,119760,252494
351800,201907,46,30,16,29940,15968,45908
351810,201907,123,84,39,83832,38922,122754
351820,201907,852,619,233,619759.6,233533.39,853292.99
351830,201907,524,191,333,194610,333332,527942
351840,201907,1840,941,899,945107.44,900198.97,1845306.41
351850,201907,238,175,63,174650.3,62874.96,237525.26
351860,201907,695,478,217,480040.41,218562,698602.41
351870,201907,5606,2692,2914,2700592.44,2942106.73,5642699.17
351880,201907,19017,8054,10963,8067842.69,11002993.96,19070836.65
351885,201907,89,59,30,58882,29940,88822
351890,201907,72,61,11,60878,10978,71856
351900,201907,224,133,91,132734.4,90818,223552.4
351905,201907,71,28,43,28942,43912,72854
351907,201907,3360,1430,1930,1437121.34,1933129.56,3370250.90
351910,201907,183,78,105,77844,104790,182634
351920,201907,123,70,53,69860,52895.98,122755.98
351925,201907,92,61,31,60878,30938,91816
351930,201907,382,247,135,246506,134730,381236
351940,201907,237,107,130,106786,129740,236526
351950,201907,136,78,58,77844,57884,135728
351960,201907,900,432,468,434443,470058.4,904501.4
351970,201907,1871,1006,865,1011972.4,868261.78,1880234.18
351980,201907,152,79,73,78842,72854,151696
351990,201907,266,175,91,174650.8,90818,265468.8
352000,201907,354,220,134,219561.2,133732,353293.2
352010,201907,395,249,146,249500,146706,396206
352020,201907,188,67,121,66866,120758,187624
352030,201907,1076,563,513,562872,512972,1075844
352040,201907,577,246,331,245508,330338,575846
352042,201907,288,92,196,91816,195608.8,287424.8
352044,201907,359,214,145,215568,145708,361276
352050,201907,3302,1300,2002,1299398.76,2004982,3304380.76
352060,201907,103,64,39,63872,38922.4,102794.4
352070,201907,95,69,26,68863.26,25948,94811.26
352080,201907,69,43,26,42914,25948,68862
352090,201907,162,110,52,109780,52894,162674
352100,201907,265,127,138,127745.39,138724.38,266469.77
352110,201907,116,35,81,34930,80838,115768
352115,201907,62,23,39,22954,38922,61876
352120,201907,90,64,26,63872.63,25948,89820.63
352130,201907,221,183,38,182634.4,37924,220558.4
352140,201907,187,84,103,83832,105788.4,189620.4
352150,201907,116,64,52,63872,51896,115768
352160,201907,137,87,50,86826,50898,137724
352170,201907,378,266,112,265468,111776,377244
352180,201907,606,399,207,400198,206586.99,606784.99
352190,201907,254,103,151,102794,150698,253492
352200,201907,32,17,15,16966,14970,31936
352210,201907,3980,1671,2309,1675644.6,2314364.63,3990009.23
352215,201907,54,31,23,30938,22954,53892
352220,201907,7040,2689,4351,2697596.32,4370246.79,7067843.11
352230,201907,3268,2119,1149,2121762.89,1153697.63,3275460.52
352240,201907,2329,1353,976,1356283,981034.9,2337317.9
352250,201907,2632,1348,1284,1352293.35,1283430.77,2635724.12
352260,201907,1013,535,478,537922.8,478042.8,1015965.6
352265,201907,59,26,33,25948,32934,58882
352270,201907,417,246,171,246506,171657.88,418163.88
352280,201907,423,269,154,268462.66,153692,422154.66
352290,201907,176,109,67,108782,67864,176646
352300,201907,93,70,23,69860,22954,92814
352310,201907,6036,2860,3176,2865264.06,3179632.29,6044896.35
352320,201907,972,511,461,510976.4,461076,972052.4
352330,201907,520,254,266,253492,266466.4,519958.4
352340,201907,1364,649,715,650696.8,714569.2,1365266.0
352350,201907,335,206,129,205588,129740.4,335328.4
352360,201907,219,94,125,93812,124750.2,218562.2
352370,201907,106,71,35,71856,35928,107784
352380,201907,115,74,41,73852,41916,115768
352390,201907,2467,1115,1352,1115766.38,1359278.18,2475044.56
352400,201907,488,216,272,215568,273452.4,489020.4
352410,201907,850,603,247,604788.63,247504,852292.63
352420,201907,106,72,34,71856,33932,105788
352430,201907,1751,799,952,802395.32,954090.21,1756485.53
352440,201907,3097,1569,1528,1577839.84,1536924.72,3114764.56
352450,201907,201,168,33,167664,32934,200598
352460,201907,613,319,294,318363.39,293412,611775.39
352470,201907,631,217,414,217564,415168.98,632732.98
352480,201907,1377,777,600,775446,601794.4,1377240.4
352490,201907,64,24,40,23952,39920,63872
352500,201907,1203,542,661,543910.34,661675.38,1205585.72
352510,201907,748,404,344,405189.26,344310,749499.26
352520,201907,613,286,327,287424,327344,614768
352530,201907,1744,921,823,921154.4,824348.4,1745502.8
352540,201907,73,49,24,48902,23952,72854
352550,201907,180,105,75,105788,75848,181636
352560,201907,50,40,10,39920,9980,49900
352570,201907,673,354,319,353292.63,319360,672652.63
352580,201907,57,41,16,40918,15968,56886
352585,201907,19,7,12,6986,11976,18962
352590,201907,4433,2241,2192,2250490.63,2196599.78,4447090.41
352600,201907,341,243,98,244510,98802,343312
352610,201907,961,436,525,435128.97,523950,959078.97
352620,201907,1002,400,602,400198,600796,1000994
352630,201907,170,61,109,60878,109780,170658
352640,201907,539,372,167,373252,166666,539918
352650,201907,85,58,27,57884,26946,84830
352660,201907,72,43,29,42914,28942,71856
352670,201907,1643,888,755,890217.59,756493.9,1646711.49
352680,201907,915,588,327,588822.03,328342.14,917164.17
352690,201907,4427,2023,2404,2028937.8,2409173.29,4438111.09
352700,201907,112,70,42,69860,43912,113772
352710,201907,1353,734,619,736524,621754,1358278
352720,201907,1332,636,696,637722,695606.4,1333328.4
352725,201907,24,21,3,20958,2994,23952
352730,201907,381,201,180,201596,179640,381236
352740,201907,422,276,146,276446.96,145708.68,422155.64
352750,201907,20,13,7,12974,6986,19960
352760,201907,185,124,61,124750,60878,185628
352770,201907,81,64,17,63872,16966,80838
352780,201907,74,40,34,39920,33932,73852
352790,201907,28,23,5,22954.63,4990,27944.63
352800,201907,243,174,69,173652,69860,243512
352810,201907,156,98,58,98802.66,57884,156686.66
352820,201907,67,55,12,54890,11976,66866
352830,201907,90,63,27,62874,26946,89820
352840,201907,662,347,315,347304.5,314370,661674.5
352850,201907,1434,498,936,497004,936124,1433128
352860,201907,131,83,48,82834,47904,130738
352870,201907,43,27,16,26946,15968.4,42914.4
352880,201907,187,125,62,124750,61876,186626
352885,201907,29,21,8,20958,7984,28942
352890,201907,54,36,18,36926,17964.4,54890.4
352900,201907,4766,2310,2456,2311373.76,2461076.77,4772450.53
352910,201907,39,32,7,32934,6986,39920
352920,201907,679,411,268,411176,267464,678640
352930,201907,1225,597,628,598812.74,627786.02,1226598.76
352940,201907,6354,2701,3653,2717558.01,3668655.28,6386213.29
352950,201907,95,37,58,36926,58882,95808
352960,201907,55,37,18,38922,17964,56886
352965,201907,20,10,10,9980,9980,19960
352970,201907,516,391,125,391216.02,124751.61,515967.63
352980,201907,164,87,77,86826,76846,163672
352990,201907,992,449,543,449100,544908,994008
353000,201907,64,30,34,29940,33932,63872
353010,201907,543,337,206,336326,205588,541914
353020,201907,291,211,80,210578,79840,290418
353030,201907,1227,567,660,565866.94,661674.98,1227541.92
353040,201907,88,59,29,58882,29940,88822
353050,201907,1333,857,476,856285.06,477044,1333329.06
353060,201907,8397,3777,4620,3780431.83,4623744.48,8404176.31
353070,201907,1700,1073,627,1072852.96,631556.35,1704409.31
353080,201907,1282,660,622,661675.16,623750,1285425.16
353090,201907,57,32,25,31936,24950,56886
353100,201907,57,47,10,46906,9980,56886
353110,201907,2061,641,1420,642712.4,1424147.19,2066859.59
353120,201907,92,50,42,49900,41916,91816
353130,201907,854,408,446,411179.15,447105.96,858285.11
353140,201907,553,222,331,223552,332334,555886
353150,201907,346,196,150,196606.63,150698,347304.63
353160,201907,94,79,15,78842,14970,93812
353170,201907,182,62,120,61876,120759.96,182635.96
353180,201907,988,469,519,469060,519958.85,989018.85
353190,201907,502,365,137,366266.3,136726.4,502992.7
353200,201907,207,107,100,107784,99800,207584
353205,201907,23,16,7,15968,6986,22954
353210,201907,83,49,34,48902,33932,82834
353215,201907,51,29,22,28942,21956,50898
353220,201907,83,47,36,46906,35928,82834
353230,201907,158,65,93,64870,93812,158682
353240,201907,304,162,142,161676,141716,303392
353250,201907,207,107,100,106786,99800,206586
353260,201907,455,324,131,323353.1,130738,454091.1
353270,201907,67,51,16,50898,15968,66866
353280,201907,103,55,48,54890.6,47904,102794.6
353282,201907,126,86,40,85828,39920,125748
353284,201907,25,18,7,17964,6986,24950
353286,201907,0,0,0,0,0,0
353290,201907,76,44,32,43912,32934,76846
353300,201907,429,240,189,240519.33,188622,429141.33
353310,201907,47,40,7,39920,6986,46906
353320,201907,60,37,23,37924,22954,60878
353325,201907,56,32,24,31936,23953.36,55889.36
353330,201907,62,43,19,43912.7,18962,62874.7
353340,201907,619,214,405,213572,405189.39,618761.39
353350,201907,902,439,463,439122.6,464073.74,903196.34
353360,201907,104,82,22,81836,21956.4,103792.4
353370,201907,121,66,55,65868,54890,120758
353380,201907,31,20,11,19960.99,10978,30938.99
353390,201907,1105,537,568,536924,566864,1103788
353400,201907,45,27,18,26946,17964,44910
353410,201907,105,67,38,67864,37924.9,105788.9
353420,201907,56,24,32,23952,32934,56886
353430,201907,581,389,192,388223.38,192614,580837.38
353440,201907,10506,4687,5819,4697592.98,5849290.32,10546883.30
353450,201907,55,31,24,30938,24950,55888
353460,201907,599,333,266,333332.1,265468,598800.1
353470,201907,2125,1140,985,1141716.19,983033.96,2124750.15
353475,201907,229,154,75,154691.38,74850,229541.38
353480,201907,184,153,31,153692,30938.4,184630.4
353490,201907,239,147,92,147704,92814.4,240518.4
353500,201907,193,111,82,110778.63,81836,192614.63
353510,201907,103,75,28,74850.98,27944,102794.98
353520,201907,207,145,62,144710,61876,206586
353530,201907,471,255,216,254490,215568,470058
353540,201907,373,252,121,252494,120758,373252
353550,201907,737,481,256,481037.24,256486,737523.24
353560,201907,602,245,357,244510,358282.6,602792.6
353570,201907,65,35,30,34930.4,29940,64870.4
353580,201907,351,269,82,269460.34,82834,352294.34
353590,201907,91,63,28,62874,27944,90818
353600,201907,271,156,115,156686.63,115768,272454.63
353610,201907,118,65,53,64870,52894,117764
353620,201907,612,321,291,320358,292414,612772
353625,201907,51,29,22,28942,21956,50898
353630,201907,238,177,61,176646.58,60878,237524.58
353640,201907,126,87,39,86826,39920,126746
353650,201907,908,358,550,358282,551894,910176
353657,201907,25,19,6,18962,5988,24950
353660,201907,262,142,120,142714,119760,262474
353670,201907,767,458,309,460079.03,309380,769459.03
353680,201907,106,76,30,76846.5,29940,106786.5
353690,201907,46,36,10,35928.52,9980,45908.52
353700,201907,281,200,81,200598.09,80838,281436.09
353710,201907,455,217,238,219560.6,237524.4,457085.0
353715,201907,46,33,13,32934,12974,45908
353720,201907,348,161,187,161676.98,187624,349300.98
353730,201907,1106,685,421,683630.8,420158.8,1103789.6
353740,201907,633,349,284,349300,285428,634728
353750,201907,83,53,30,52894,29940,82834
353760,201907,2851,1090,1761,1091814.75,1763468.18,2855282.93
353770,201907,90,74,16,73852,15968,89820
353780,201907,1200,579,621,579838.63,622752,1202590.63
353790,201907,513,305,208,304390.96,208582.4,512973.36
353800,201907,3231,1625,1606,1634727.89,1614835.35,3249563.24
353810,201907,231,133,98,132734.98,97805.96,230540.94
353820,201907,194,93,101,92814,100798,193612
353830,201907,48,41,7,40918,6986,47904
353850,201907,171,88,83,87824,84830,172654
353860,201907,498,226,272,225548,272454,498002
353870,201907,5224,2679,2545,2677640.13,2545900.8,5223540.93
353880,201907,687,484,203,483033.36,203592,686625.36
353890,201907,577,334,243,334330.4,242514.84,576845.24
353900,201907,128,66,62,67864,61876,129740
353910,201907,173,84,89,85828,88822,174650
353920,201907,442,244,198,243512.3,197604.99,441117.29
353930,201907,1002,591,411,591814,411178.14,1002992.14
353940,201907,195,103,92,102794,91816,194610
353950,201907,515,319,196,318362,197604.98,515966.98
353960,201907,69,56,13,56886,12974,69860
353970,201907,67,38,29,37924,28942,66866
353980,201907,1604,761,843,762472,842315.96,1604787.96
353990,201907,77,45,32,44910,31936,76846
354000,201907,362,179,183,179640,183632.99,363272.99
354010,201907,93,51,42,50898,41916,92814
354020,201907,526,334,192,334330,193612,527942
354025,201907,55,45,10,44910,9980,54890
354030,201907,60,36,24,35928,23952,59880
354040,201907,100,73,27,72854,26946,99800
354050,201907,189,99,90,98802.4,89820,188622.4
354060,201907,762,373,389,373252.4,391216,764468.4
354070,201907,934,549,385,550897.28,384230.4,935127.68
354075,201907,218,112,106,111776,105788,217564
354080,201907,309,131,178,131736,177644,309380
354085,201907,21,13,8,12974,7984,20958
354090,201907,300,169,131,169576,131736,301312
354100,201907,5543,2365,3178,2374243.56,3192605.9,5566849.46
354105,201907,91,45,46,44910,45908,90818
354110,201907,48,23,25,22954,24950,47904
354120,201907,134,95,39,94810.98,38922,133732.98
354130,201907,697,456,241,457084,241518.37,698602.37
354140,201907,3128,1453,1675,1459077.2,1672648,3131725.2
354150,201907,634,392,242,392215.76,242514,634729.76
354160,201907,680,436,244,435128.4,246506.4,681634.8
354165,201907,19,14,5,13972,4990,18962
354170,201907,180,122,58,123752,57884,181636
354180,201907,66,40,26,39920.51,25948,65868.51
354190,201907,199,89,110,88822,109780,198602
354200,201907,121,65,56,64870,55888,120758
354210,201907,61,27,34,26946,33932,60878
354220,201907,652,408,244,407184,243512,650696
354230,201907,162,69,93,68862.6,92814,161676.6
354240,201907,325,213,112,213572.64,112774,326346.64
354250,201907,82,50,32,49900,32934,82834
354260,201907,2044,955,1089,958083.87,1094807.67,2052891.54
354270,201907,95,70,25,69860,24950,94810
354280,201907,43,23,20,22954,19960,42914
354290,201907,139,99,40,98802,39920,138722
354300,201907,403,278,125,279440.63,125748,405188.63
354310,201907,100,75,25,74850.4,24950,99800.4
354320,201907,191,99,92,98802,92814.4,191616.4
354323,201907,14,13,1,12974,998,13972
354325,201907,112,67,45,66866.6,44910,111776.6
354330,201907,2575,854,1721,854146.8,1722550.01,2576696.81
354340,201907,10549,5168,5381,5178644.03,5391202.3,10569846.33
354350,201907,120,79,41,78842,40918,119760
354360,201907,84,47,37,46906,36926,83832
354370,201907,253,137,116,136726,116766,253492
354380,201907,195,118,77,117764,78842,196606
354390,201907,2673,975,1698,977043.59,1702588.98,2679632.57
354400,201907,317,170,147,172654,146706.4,319360.4
354410,201907,618,298,320,300398.4,320358.4,620756.8
354420,201907,275,175,100,174650,99800,274450
354425,201907,310,181,129,180638,129740,310378
354430,201907,178,108,70,107784,69860,177644
354440,201907,34,25,9,24950,8982,33932
354450,201907,50,36,14,35928,13972,49900
354460,201907,103,59,44,58882,43912,102794
354470,201907,38,23,15,22954,15968,38922
354480,201907,115,60,55,61876.98,54890,116766.98
354490,201907,147,91,56,90818,55888,146706
354500,201907,385,194,191,193612,192614,386226
354510,201907,97,71,26,70858,25948,96806
354515,201907,37,12,25,11976,24950,36926
354520,201907,1598,690,908,692470.9,909178.8,1601649.7
354530,201907,732,370,362,369261.79,361276,730537.79
354540,201907,276,154,122,153692,121756,275448
354550,201907,41,24,17,23952,16966,40918
354560,201907,153,86,67,85828,67864,153692
354570,201907,142,93,49,92814.5,48902,141716.5
354580,201907,1929,914,1015,915167.89,1012971.96,1928139.85
354600,201907,245,138,107,138722.2,106786,245508.2
354610,201907,74,63,11,62874.46,10978.98,73853.44
354620,201907,61,18,43,17964,42914,60878
354625,201907,16,11,5,10978,4990.99,15968.99
354630,201907,316,207,109,206586.98,108782,315368.98
354640,201907,799,520,279,518960.3,279440,798400.3
354650,201907,76,44,32,43912,31936.98,75848.98
354660,201907,794,595,199,597803.03,198602,796405.03
354670,201907,256,91,165,90818.76,164670.6,255489.36
354680,201907,1259,476,783,475048,788420,1263468
354690,201907,80,54,26,53892.4,26946,80838.4
354700,201907,71,51,20,50898,19960,70858
354710,201907,49,36,13,35928,12974,48902
354720,201907,22,22,0,21956,0,21956
354730,201907,1752,749,1003,750497.78,1007980.4,1758478.18
354740,201907,66,47,19,46906,18962,65868
354750,201907,432,251,181,250498.98,182634,433132.98
354760,201907,486,295,191,296407.86,190618.4,487026.26
354765,201907,10,5,5,4990,4990,9980
354770,201907,345,225,120,225548.4,119760,345308.4
354780,201907,8176,3265,4911,3268463.58,4931141.97,8199605.55
354790,201907,103,59,44,58882,43912,102794
354800,201907,443,243,200,242514,199600.4,442114.4
354805,201907,100,48,52,47904,51896,99800
354810,201907,110,67,43,66866,43912,110778
354820,201907,190,83,107,82834.56,106786,189620.56
354830,201907,38,20,18,19960,18962,38922
354840,201907,61,42,19,41916,18962,60878
354850,201907,4558,2049,2509,2055881.21,2516957.1,4572838.31
354860,201907,331,157,174,156686,173652.93,330338.93
354870,201907,12445,5611,6834,5629729.88,6857266.71,12486996.59
354880,201907,3004,1120,1884,1123749.03,1893210.36,3016959.39
354890,201907,2886,1580,1306,1583829.73,1304386,2888215.73
354900,201907,62,42,20,41916,19960,61876
354910,201907,1255,662,593,663670.4,594808,1258478.4
354920,201907,46,38,8,37924,7984,45908
354925,201907,12,8,4,7984,4990,12974
354930,201907,33,30,3,29940.43,2994,32934.43
354940,201907,833,609,224,612025.3,224550,836575.3
354950,201907,207,137,70,137724.6,69860,207584.6
354960,201907,158,60,98,60878,98802.4,159680.4
354970,201907,916,610,306,608781.77,306386.4,915168.17
354980,201907,8556,3170,5386,3175639.56,5394200.44,8569840.00
354990,201907,8933,4244,4689,4245498.91,4706621.78,8952120.69
354995,201907,550,187,363,186626,365268,551894
355000,201907,472,160,312,161676,313372,475048
355010,201907,603,379,224,381236.4,224550.6,605787.0
355020,201907,740,461,279,462074.32,279442.38,741516.70
355030,201907,207995,81685,126310,81915461.49,127130419,209045880.49
355040,201907,737,355,382,354290.4,382234,736524.4
355050,201907,150,101,49,100799.4,49900,150699.4
355060,201907,1582,806,776,805387.2,777442.6,1582829.8
355070,201907,1422,692,730,691615.81,730537.61,1422153.42
355080,201907,200,119,81,119760,80838,200598
355090,201907,279,173,106,172654.38,105788.32,278442.70
355100,201907,4919,2407,2512,2429037.82,2532926.19,4961964.01
355110,201907,265,176,89,175649.39,89820,265469.39
355120,201907,81,60,21,59880,20958.98,80838.98
355130,201907,57,32,25,31936,24950,56886
355140,201907,188,121,67,120758,66866,187624
355150,201907,689,413,276,414171.39,275448,689619.39
355160,201907,463,223,240,222554,242514.4,465068.4
355170,201907,2096,1097,999,1096802,998998,2095800
355180,201907,673,287,386,286426,385228,671654
355190,201907,213,151,62,150698,62874,213572
355200,201907,112,64,48,63872,47904,111776
355210,201907,691,407,284,409180,285428.98,694608.98
355220,201907,7047,3737,3310,3737515.87,3320350.74,7057866.61
355230,201907,103,62,41,61876,41916,103792
355240,201907,4434,1893,2541,1895205.92,2538914.37,4434120.29
355250,201907,5566,2661,2905,2660688.83,2917160.61,5577849.44
355255,201907,49,31,18,30938,17964,48902
355260,201907,181,110,71,109780.4,70859.96,180640.36
355270,201907,168,107,61,106786,63872,170658
355280,201907,6378,2631,3747,2633724.8,3753479.78,6387204.58
355290,201907,75,58,17,57884,16966,74850
355300,201907,195,126,69,126746,68862.4,195608.4
355310,201907,112,63,49,62874,48902,111776
355320,201907,88,47,41,46906,40918,87824
355330,201907,282,157,125,158682,124750,283432
355340,201907,1561,529,1032,527942.4,1029936,1557878.4
355350,201907,129,69,60,68862,59880,128742
355360,201907,171,109,62,108782,62874,171656
355365,201907,24,19,5,18962,4990,23952
355370,201907,1032,602,430,605800.18,431144.57,1036944.75
355380,201907,798,523,275,522952,275448,798400
355385,201907,69,49,20,48902,19960,68862
355390,201907,106,62,44,61876,43912,105788
355395,201907,187,111,76,110778.47,75848,186626.47
355400,201907,1625,997,628,1001164.53,628741.99,1629906.52
355410,201907,4864,2318,2546,2320354.39,2550894.14,4871248.53
355420,201907,50,36,14,35928,13972,49900
355430,201907,360,213,147,212574,146706,359280
355440,201907,80,48,32,47904,31936,79840
355450,201907,451,228,223,229540.88,224550.7,454091.58
355460,201907,65,49,16,48902.54,15968,64870.54
355465,201907,49,32,17,31936,17964,49900
355470,201907,178,73,105,72854.7,105788,178642.7
355475,201907,13,9,4,8982,3992,12974
355480,201907,470,208,262,207584.6,261476,469060.6
355490,201907,120,87,33,87824,32934,120758
355495,201907,57,30,27,29940,26946,56886
355500,201907,1618,900,718,900198.79,718562.96,1618761.75
355510,201907,274,200,74,200599.26,75848,276447.26
355520,201907,34,26,8,25948.4,7984,33932.4
355530,201907,21,14,7,13972,6986,20958
355535,201907,77,39,38,38922,39920,78842
355540,201907,2371,945,1426,945247.11,1427141.61,2372388.72
355550,201907,59,38,21,37924,20958,58882
355560,201907,249,119,130,118762,129740,248502
355570,201907,26,18,8,17964,7984,25948
355580,201907,249,172,77,171656,76847.39,248503.39
355590,201907,20,14,6,13972,5988,19960
355600,201907,273,141,132,140718,131736,272454
355610,201907,233,156,77,155688,76846,232534
355620,201907,1330,627,703,626744.4,706584.99,1333329.39
355630,201907,436,321,115,321356,114770.63,436126.63
355635,201907,119,58,61,57884,60879.97,118763.97
355640,201907,566,319,247,318362,248502,566864
355645,201907,830,355,475,355288,478042.4,833330.4
355650,201907,2069,883,1186,884229.74,1183628.98,2067858.72
355660,201907,255,140,115,139720,115768,255488
355670,201907,537,216,321,216566,322354,538920
355680,201907,204,117,87,116766.97,86826,203592.97
355690,201907,95,45,50,44910,49900,94810
355695,201907,15,10,5,9980,4990,14970
355700,201907,1139,600,539,602792.66,542912.8,1145705.46
355710,201907,2221,1224,997,1223549.96,996004,2219553.96
355715,201907,19,16,3,15968,2994,18962
355720,201907,203,124,79,123752.44,78842,202594.44
355730,201907,100,56,44,55888,43912,99800
410010,201907,130,110,20,109780,19960,129740
410020,201907,107,90,17,90818,17964,108782
410030,201907,164,105,59,104790.6,58882,163672.6
410040,201907,1070,570,500,569858,502992.6,1072850.6
410045,201907,32,27,5,26946,4990,31936
410050,201907,474,273,201,273452,200598,474050
410060,201907,279,211,68,210578,67864,278442
410070,201907,306,252,54,251496,53892,305388
410080,201907,169,109,60,108782,59880,168662
410090,201907,78,69,9,68862.56,8982,77844.56
410100,201907,290,210,80,210578,79840,290418
410105,201907,46,29,17,28942,16966,45908
410110,201907,329,203,126,202594,125748,328342
410115,201907,32,22,10,21956,9980,31936
410120,201907,413,217,196,217564,195608,413172
410130,201907,46,28,18,27944,17964,45908
410140,201907,3167,1554,1613,1556882.1,1615764.6,3172646.7
410150,201907,2680,1073,1607,1074846.74,1612768.8,2687615.54
410160,201907,510,318,192,318362,191616.4,509978.4
410165,201907,66,44,22,43912,21956,65868
410170,201907,166,119,47,118762.4,46906,165668.4
410180,201907,2201,1269,932,1270454.4,934128.99,2204583.39
410185,201907,35,31,4,30938,3992,34930
410190,201907,497,331,166,332334.51,168662,500996.51
410200,201907,953,716,237,717562,238522,956084
410210,201907,583,305,278,304390,277444.4,581834.4
410220,201907,46,23,23,22954,22954,45908
410230,201907,145,73,72,72854,72854,145708
410240,201907,752,493,259,492014.8,259480,751494.8
410250,201907,385,283,102,283432,101796,385228
410260,201907,297,171,126,170658.4,126746,297404.4
410270,201907,32,22,10,21956,9980,31936
410275,201907,60,45,15,44910,14970,59880
410280,201907,327,188,139,188622,139720,328342
410290,201907,241,154,87,153692,86826,240518
410300,201907,78,58,20,58882,19960,78842
410302,201907,19,12,7,11976,6986,18962
410304,201907,41,27,14,26946,13972,40918
410305,201907,212,113,99,114770,98802,213572
410310,201907,216,131,85,130738,84830,215568
410315,201907,49,35,14,34930,13972,48902
410320,201907,135,95,40,94810,39920,134730
410322,201907,34,22,12,22954,11976,34930
410330,201907,178,127,51,126746,50898.6,177644.6
410335,201907,102,58,44,57884,43912,101796
410337,201907,42,36,6,35928,5988,41916
410340,201907,34,31,3,30938,2994,33932
410345,201907,214,131,83,130738,82834,213572
410347,201907,51,38,13,38922,12974,51896
410350,201907,243,150,93,149700,93812,243512
410360,201907,467,294,173,294410.8,173653.2,468064.0
410370,201907,2376,1016,1360,1017961.08,1359277.54,2377238.62
410380,201907,217,134,83,133732,82834,216566
410390,201907,380,274,106,274450.99,105788,380238.99
410395,201907,31,19,12,18962,11976,30938
410400,201907,833,407,426,409181.61,424585.5,833767.11
410405,201907,96,73,23,72854,22954,95808
410410,201907,34,27,7,26946,6986,33932
410420,201907,1645,806,839,809291.16,839318.34,1648609.50
410425,201907,171,78,93,77844.6,92814,170658.6
410430,201907,2201,1276,925,1274446.74,924148.56,2198595.30
410440,201907,377,277,100,276446,99800,376246
410442,201907,350,238,112,238522.7,111776,350298.7
410445,201907,410,289,121,289420,120758,410178
410450,201907,380,197,183,196606,182634,379240
410460,201907,469,253,216,252494,215568,468062
410465,201907,208,132,76,132734,75848,208582
410470,201907,229,145,84,144710,83832,228542
410480,201907,6020,2995,3025,2993012.77,3030937.39,6023950.16
410490,201907,1421,904,517,906184.84,516964.4,1423149.24
410500,201907,261,154,107,153692,106786,260478
410510,201907,166,124,42,124750,41916.98,166666.98
410520,201907,250,186,64,187624,63872,251496
410530,201907,236,88,148,87824,147704.99,235528.99
410540,201907,316,231,85,231536.99,84830,316366.99
410550,201907,1674,753,921,751494.4,919158.8,1670653.2
410560,201907,144,108,36,107784,35928,143712
410570,201907,434,296,138,297405.32,138722,436127.32
410580,201907,3374,1528,1846,1527939.02,1849295,3377234.02
410590,201907,406,284,122,283432,121756,405188
410600,201907,188,162,26,161676,25948,187624
410610,201907,56,47,9,46906,8982,55888
410620,201907,233,168,65,168662,64870,233532
410630,201907,438,257,181,257484,180638,438122
410640,201907,1027,652,375,650696.7,377244.99,1027941.69
410645,201907,104,79,25,78842.2,24950,103792.2
410650,201907,357,240,117,239520,117764,357284
410655,201907,80,59,21,58882,20958,79840
410657,201907,22,9,13,8982,12974,21956
410660,201907,608,431,177,431136.31,177644,608780.31
410670,201907,74,62,12,61876,11976,73852
410680,201907,202,167,35,166666,35928,202594
410685,201907,19,11,8,10978,7984,18962
410690,201907,28060,12172,15888,12220430.97,15945769.23,28166200.20
410700,201907,329,244,85,244510.4,84830,329340.4
410710,201907,126,105,21,104790,20958,125748
410712,201907,24,17,7,16966,6986,23952
410715,201907,89,68,21,67864,20958,88822
410720,201907,698,402,296,401196,297404.98,698600.98
410725,201907,187,136,51,135728,50898,186626
410730,201907,91,52,39,51896,38922,90818
410740,201907,115,84,31,83832,30938,114770
410750,201907,243,169,74,168662,73852,242514
410752,201907,25,15,10,14970,9980,24950
410753,201907,49,23,26,22954,25948,48902
410754,201907,42,26,16,25948.4,15968,41916.4
410755,201907,80,53,27,52894,26946,79840
410760,201907,741,419,322,418162.4,321356,739518.4
410765,201907,1708,820,888,821356.36,887223.2,1708579.56
410770,201907,111,87,24,86826,23952,110778
410773,201907,55,41,14,40918,13972,54890
410775,201907,187,137,50,136726,49900,186626
410780,201907,82,45,37,44910,36926,81836
410785,201907,56,44,12,43912,11976,55888
410790,201907,75,38,37,37924,36926,74850
410800,201907,280,175,105,175648,105788,281436
410810,201907,21,18,3,17964,2994.4,20958.4
410820,201907,182,133,49,133732,48902,182634
410830,201907,8448,3803,4645,3808373.68,4653683.97,8462057.65
410832,201907,107,78,29,77844,28942,106786
410840,201907,1414,797,617,795408.97,617764.46,1413173.43
410845,201907,67,44,23,43912,22954,66866
410850,201907,194,138,56,137724,55888,193612
410855,201907,52,45,7,44910,6986,51896
410860,201907,704,411,293,412174.4,295408,707582.4
410865,201907,101,77,24,76846,23952,100798
410870,201907,155,131,24,130738,23952,154690
410880,201907,1116,575,541,575851.7,541918.88,1117770.58
410890,201907,83,57,26,56886,25948,82834
410895,201907,72,56,16,55888,15968,71856
410900,201907,23,16,7,15968,6986,22954
410910,201907,15,13,2,12974,1996,14970
410920,201907,36,24,12,23952,11976,35928
410930,201907,498,320,178,320358,177644,498002
410940,201907,4381,2509,1872,2511635.17,1873246.8,4384881.97
410950,201907,108,82,26,81836,25948,107784
410960,201907,776,342,434,341316,436126,777442
410965,201907,66,53,13,52894,12974,65868
410970,201907,630,455,175,455088,174650,629738
410975,201907,116,68,48,67864.72,47904,115768.72
410980,201907,1631,750,881,751494.55,883230.99,1634725.54
410990,201907,261,182,79,181636,79840,261476
411000,201907,65,42,23,41916,22954.4,64870.4
411005,201907,28,23,5,22954,4990,27944
411007,201907,250,146,104,145708,105788,251496
411010,201907,592,413,179,413172,178642,591814
411020,201907,292,203,89,203592,88822,292414
411030,201907,15,8,7,7984,6986,14970
411040,201907,57,42,15,41916,14970,56886
411050,201907,214,167,47,166666,46906,213572
411060,201907,517,356,161,355288.98,160678,515966.98
411065,201907,63,54,9,53892,8982,62874
411070,201907,1226,771,455,773451.54,457084,1230535.54
411080,201907,229,163,66,162674,65868,228542
411090,201907,108,82,26,81836,25948,107784
411095,201907,278,113,165,112774,165668,278442
411100,201907,113,94,19,94810,18962,113772
411110,201907,123,84,39,83832,38922,122754
411120,201907,192,142,50,141716,49900,191616
411125,201907,211,96,115,95808,114770,210578
411130,201907,126,108,18,107784,17964,125748
411140,201907,208,139,69,139720,68862,208582
411150,201907,1236,830,406,829338,407184.63,1236522.63
411155,201907,122,82,40,82834,39920,122754
411160,201907,25,12,13,11976,13972,25948
411170,201907,51,47,4,46906,3992,50898
411180,201907,982,662,320,663271.63,320358,983629.63
411190,201907,332,191,141,191616,140718,332334
411200,201907,669,432,237,431136.63,237524,668660.63
411210,201907,696,381,315,380238,315368.98,695606.98
411220,201907,147,108,39,108782,38922,147704
411230,201907,43,36,7,35928,6986,42914
411240,201907,121,81,40,81836,39920,121756
411250,201907,438,322,116,322354,116766,439120
411260,201907,21,14,7,13972,6986,20958
411270,201907,277,146,131,145708,130738,276446
411275,201907,199,174,25,173652,24950,198602
411280,201907,220,157,63,156686.63,62874,219560.63
411290,201907,59,47,12,46906,11976,58882
411295,201907,140,112,28,111776,27944,139720
411300,201907,70,36,34,35928,33932,69860
411310,201907,93,72,21,71856,20958,92814
411320,201907,747,522,225,523950,225548.6,749498.6
411325,201907,64,42,22,41916,21956,63872
411330,201907,911,584,327,583830.5,330338.16,914168.66
411340,201907,26,19,7,18962,6986.34,25948.34
411342,201907,68,51,17,50898,16966,67864
411345,201907,117,59,58,58882,57884,116766
411350,201907,488,390,98,390218.58,97804.4,488022.98
411360,201907,53,34,19,33932,18962,52894
411370,201907,14281,5888,8393,5899183.99,8411160.62,14310344.61
411373,201907,179,132,47,133732,46906,180638
411375,201907,72,59,13,58882,12974,71856
411380,201907,92,71,21,70858,21956,92814
411390,201907,128,85,43,84830,42914,127744
411400,201907,360,276,84,276446.98,83832,360278.98
411410,201907,450,227,223,227544,222554.4,450098.4
411420,201907,1013,460,553,460078,552892,1012970
411430,201907,433,264,169,264470,168662.98,433132.98
411435,201907,36,24,12,23952,11976,35928
411440,201907,460,369,91,368262,91816,460078
411450,201907,419,352,67,354290,66866,421156
411460,201907,766,304,462,305388.2,461077.98,766466.18
411470,201907,88,65,23,64870,22954,87824
411480,201907,661,380,281,380238,280438,660676
411490,201907,294,191,103,190618,102794,293412
411500,201907,102,87,15,88822,14970,103792
411510,201907,232,183,49,184630,48902,233532
411520,201907,5989,2333,3656,2337318.79,3655679.92,5992998.71
411530,201907,119,83,36,82834,35928,118762
411535,201907,50,21,29,20958,28942,49900
411540,201907,352,242,110,241516,109780,351296
411545,201907,52,39,13,38922,12974,51896
411550,201907,75,56,19,55888,18962,74850
411560,201907,375,168,207,168662,206586,375248
411570,201907,806,303,503,305389.26,503990.6,809379.86
411573,201907,29,18,11,17964,10978,28942
411575,201907,288,182,106,181636,105788,287424
411580,201907,1235,488,747,490018,747502,1237520
411585,201907,73,36,37,35928,36926,72854
411590,201907,20,14,6,13972,5988,19960
411600,201907,23,10,13,9980,12974,22954
411605,201907,236,100,136,100798,136726,237524
411610,201907,207,139,68,140718,68862,209580
411620,201907,348,196,152,196606,152694,349300
411630,201907,56,39,17,38922,16966,55888
411640,201907,32,26,6,25948,5988,31936
411650,201907,12,7,5,6986,4990,11976
411660,201907,39,28,11,27944,10978,38922
411670,201907,247,185,62,184630,61876,246506
411680,201907,158,137,21,136726,20958,157684
411690,201907,604,320,284,319360,283432,602792
411695,201907,59,43,16,42914,15968,58882
411700,201907,148,127,21,127744,20958,148702
411705,201907,103,67,36,66866,36926,103792
411710,201907,306,207,99,206586,98802,305388
411720,201907,135,87,48,86826,47904,134730
411721,201907,62,53,9,52894,8982,61876
411722,201907,100,42,58,41916,57884,99800
411725,201907,154,122,32,121756.4,32934,154690.4
411727,201907,81,62,19,61876,18962,80838
411729,201907,39,31,8,30938,7984,38922
411730,201907,560,357,203,356286,202594,558880
411740,201907,40,26,14,25948,13972,39920
411745,201907,68,47,21,46906,20958,67864
411750,201907,866,398,468,401196.4,467064.4,868260.8
411760,201907,1185,894,291,894208.4,291416.98,1185625.38
411770,201907,456,301,155,301396,154690,456086
411780,201907,324,210,114,210578,113772.5,324350.5
411790,201907,528,297,231,299401.27,230539.96,529941.23
411800,201907,169,132,37,131736,36926,168662
411810,201907,170,128,42,127744,41916,169660
411820,201907,2108,990,1118,999997.74,1127740.6,2127738.34
411830,201907,12,12,0,11976,0,11976
411840,201907,1982,1235,747,1238518,748501.53,1987019.53
411845,201907,50,19,31,18962,30938,49900
411850,201907,1226,692,534,692613.79,533933.64,1226547.43
411860,201907,44,30,14,29940.4,13972,43912.4
411870,201907,77,52,25,51896,24950,76846
411880,201907,420,274,146,274451.18,145708,420159.18
411885,201907,107,73,34,72854,33932,106786
411890,201907,315,203,112,202595.79,111776,314371.79
411900,201907,74,55,19,54890,18962,73852
411910,201907,181,145,36,144710,35928,180638
411915,201907,2113,903,1210,902192,1212571.22,2114763.22
411920,201907,122,96,26,96806,25948,122754
411925,201907,10,7,3,6986,2994,9980
411930,201907,808,593,215,592812.74,215568,808380.74
411940,201907,595,409,186,409180.34,185628,594808.34
411950,201907,918,481,437,482034.95,437124,919158.95
411960,201907,1035,715,320,715567.3,319360,1034927.3
411965,201907,22,16,6,15968,6986,22954
411970,201907,81,74,7,73852,6986,80838
411980,201907,171,118,53,117764,52894,170658
411990,201907,5187,3028,2159,3032926.88,2164663.7,5197590.58
411995,201907,468,179,289,179640,289420,469060
412000,201907,307,194,113,193612,112774,306386
412010,201907,47,31,16,30938,15968,46906
412015,201907,44,32,12,33932,11976,45908
412020,201907,31,27,4,26946,3992,30938
412030,201907,52,47,5,46906,4990,51896
412033,201907,53,34,19,33932.44,18962,52894.44
412035,201907,66,44,22,43912,21956,65868
412040,201907,37,24,13,23952.4,12974,36926.4
412050,201907,200,154,46,154690,45908,200598
412060,201907,777,592,185,592812,185628,778440
412065,201907,50,32,18,31936,17964,49900
412070,201907,167,112,55,111776,55888,167664
412080,201907,274,145,129,145708,128742,274450
412085,201907,34,16,18,15968,17964,33932
412090,201907,783,504,279,504988.9,278442,783430.9
412100,201907,245,209,36,208583.2,35928,244511.2
412110,201907,69,53,16,52894,15968,68862
412120,201907,315,199,116,200598,115768,316366
412125,201907,84,49,35,48902,34930,83832
412130,201907,38,27,11,26946.36,10978,37924.36
412135,201907,28,17,11,16966,10978,27944
412140,201907,324,226,98,226546,97804,324350
412150,201907,256,172,84,171656,84830,256486
412160,201907,87,52,35,51896,34930,86826
412170,201907,691,487,204,487024.4,203592,690616.4
412175,201907,37,29,8,28942,7984,36926
412180,201907,191,151,40,150698.2,39920,190618.2
412190,201907,342,272,70,272454,69860,342314
412200,201907,205,125,80,124750,79840,204590
412210,201907,74,58,16,57884,15968,73852
412215,201907,225,161,64,161676,64870,226546
412217,201907,67,53,14,52894,13972,66866
412220,201907,818,608,210,608780,209580,818360
412230,201907,326,202,124,201596,124751.96,326347.96
412240,201907,1333,665,668,663675.44,669661.48,1333336.92
412250,201907,390,248,142,247504,141716,389220
412260,201907,110,82,28,81836,27944,109780
412265,201907,176,138,38,138722,37924,176646
412270,201907,84,57,27,56886,26946,83832
412280,201907,91,74,17,73852,16966,90818
412290,201907,96,67,29,66866,28942,95808
412300,201907,210,135,75,134730,74850,209580
412310,201907,48,41,7,40918,6986,47904
412320,201907,97,83,14,82834,13972,96806
412330,201907,187,164,23,163672,22954,186626
412340,201907,150,104,46,103792,45908.4,149700.4
412350,201907,590,296,294,296406,295408,591814
412360,201907,30,25,5,24950,4990,29940
412370,201907,163,143,20,143712.2,19960,163672.2
412380,201907,264,196,68,195608,67864.98,263472.98
412382,201907,53,27,26,26946,25948,52894
412385,201907,144,107,37,106786,36926,143712
412390,201907,280,215,65,215568,64870,280438
412395,201907,75,60,15,59880,14970,74850
412400,201907,76,51,25,50898,24950,75848
412402,201907,242,118,124,117764.84,123752,241516.84
412405,201907,833,318,515,317364,513970,831334
412410,201907,967,604,363,602792.4,364270,967062.4
412420,201907,14,12,2,11976,1996,13972
412430,201907,19,14,5,13972,4990,18962
412440,201907,594,326,268,327345.76,268462.44,595808.20
412450,201907,73,63,10,62874,9980,72854
412460,201907,89,67,22,66866,21956,88822
412470,201907,224,180,44,179640,43912,223552
412480,201907,153,113,40,112774.3,40918,153692.3
412490,201907,164,143,21,142714,20958,163672
412500,201907,443,368,75,369260.45,75848,445108.45
412510,201907,185,152,33,151696.4,32934,184630.4
412520,201907,87,58,29,57884,28942,86826
412530,201907,110,59,51,58882,50898,109780
412535,201907,96,70,26,69861.96,25948,95809.96
412540,201907,80,38,42,37924,41916,79840
412545,201907,90,65,25,64870,24950,89820
412550,201907,3670,1661,2009,1661670,2012967.2,3674637.2
412555,201907,13,9,4,8982,3992,12974
412560,201907,612,437,175,438122,174650.7,612772.7
412570,201907,729,398,331,400198,331336,731534
412575,201907,91,65,26,64870,25948,90818
412580,201907,171,115,56,114770,55888,170658
412590,201907,38,34,4,33932,3992,37924
412600,201907,169,126,43,125748.34,42914,168662.34
412610,201907,30,18,12,18962,11976,30938
412620,201907,147,126,21,128742,20958,149700
412625,201907,2202,1178,1024,1178639.88,1027942.73,2206582.61
412627,201907,71,55,16,54890,15968,70858
412630,201907,421,283,138,282434.6,137724,420158.6
412635,201907,64,17,47,16966,46906,63872
412640,201907,115,77,38,76846,37924,114770
412650,201907,355,230,125,229540,125748,355288
412660,201907,472,289,183,288422,182634,471056
412665,201907,51,45,6,44910,5988,50898
412667,201907,298,209,89,208583.76,88823.32,297407.08
412670,201907,65,54,11,53892,10978,64870
412680,201907,298,236,62,235528,61876.48,297404.48
412690,201907,104,68,36,67864,36926.4,104790.4
412700,201907,154,104,50,103792,49900.4,153692.4
412710,201907,1425,869,556,872254.2,557882,1430136.2
412720,201907,228,151,77,150698,76846,227544
412730,201907,190,158,32,158682,31936,190618
412740,201907,416,229,187,228542,187624,416166
412750,201907,458,268,190,270458,190618,461076
412760,201907,273,146,127,145708,126746,272454
412770,201907,2099,1175,924,1177641.86,923151.78,2100793.64
412780,201907,151,119,32,118762,31936,150698
412785,201907,262,134,128,134730,129740,264470
412788,201907,30,18,12,17964,11976,29940
412790,201907,130,110,20,109780,19960,129740
412795,201907,150,111,39,111776,38922,150698
412796,201907,315,211,104,211576,104790,316366
412800,201907,579,375,204,375248.5,203592,578840.5
412810,201907,3005,1661,1344,1658677.3,1341312,2999989.3
412820,201907,943,606,337,606785.5,341316.98,948102.48
412830,201907,14,11,3,10978,2994,13972
412840,201907,216,154,62,153692.4,62874,216566.4
412850,201907,779,512,267,513970,267464,781434
412853,201907,174,92,82,91816,81836.4,173652.4
412855,201907,208,113,95,113772.26,95808,209580.26
412860,201907,90,65,25,64870,24950,89820
412862,201907,60,45,15,44910,14970,59880
412863,201907,5,5,0,4990,0,4990
412865,201907,43,32,11,31936,10978,42914
412870,201907,111,72,39,71856,38922,110778
412880,201907,101,73,28,72854.4,27944,100798.4
420005,201907,42,38,4,37924,3992,41916
420010,201907,369,245,124,244510.3,124750.4,369260.7
420020,201907,83,70,13,69860,12974,82834
420030,201907,24,22,2,22954,1996,24950
420040,201907,111,85,26,84830,25948,110778
420050,201907,52,32,20,31936,19960,51896
420055,201907,18,18,0,17964,0,17964
420060,201907,31,24,7,24950,6986,31936
420070,201907,105,88,17,87824,16966,104790
420075,201907,12,12,0,11976,0,11976
420080,201907,46,40,6,40918,5988,46906
420090,201907,34,32,2,31936,1996,33932
420100,201907,158,137,21,136726.4,21956,158682.4
420110,201907,19,19,0,18962,0,18962
420120,201907,59,45,14,45908,13972,59880
420125,201907,82,65,17,65868,16966,82834
420127,201907,29,24,5,23952,4990,28942
420130,201907,404,252,152,253492,151696,405188
420140,201907,1322,742,580,745508.28,579838.9,1325347.18
420150,201907,44,38,6,37924,5988,43912
420160,201907,35,33,2,32934,1996,34930
420165,201907,18,13,5,12974,4990,17964
420170,201907,72,47,25,47904,24950,72854
420180,201907,23,21,2,20958,1996,22954
420190,201907,29,24,5,23952,4990,28942
420195,201907,130,65,65,64870,65868,130738
420200,201907,1256,560,696,563870.4,697606.88,1261477.28
420205,201907,70,41,29,40918,28942,69860
420207,201907,119,65,54,65868.5,53892,119760.5
420208,201907,21,17,4,16966,3992,20958
420209,201907,19,16,3,15968,2994,18962
420210,201907,471,236,235,236526,236526.98,473052.98
420213,201907,51,40,11,39920,10978,50898
420215,201907,27,23,4,22954,3992,26946
420220,201907,67,43,24,42914,23952,66866
420230,201907,829,474,355,474050.6,355289.97,829340.57
420240,201907,2267,1517,750,1519957.14,750496,2270453.14
420243,201907,43,34,9,33932,8982,42914
420245,201907,137,72,65,71856,64870,136726
420250,201907,61,38,23,37924,22954,60878
420253,201907,40,32,8,31936,7984,39920
420257,201907,13,11,2,10978,1996,12974
420260,201907,102,87,15,86826,14970,101796
420270,201907,41,31,10,31936.99,9980,41916.99
420280,201907,290,216,74,215571.64,73854.66,289426.30
420285,201907,22,13,9,12974,8982,21956
420287,201907,51,33,18,32934,17964,50898
420290,201907,992,704,288,704589.39,289423.96,994013.35
420300,201907,1437,1151,286,1150696.65,286426.98,1437123.63
420310,201907,47,33,14,32934,13972,46906
420315,201907,33,29,4,28942,3992,32934
420320,201907,871,446,425,449100.24,427144.99,876245.23
420325,201907,0,,,,,0.0
420330,201907,116,80,36,79840,35928,115768
420340,201907,160,108,52,107785.18,52894,160679.18
420350,201907,249,183,66,183632,65868,249500
420360,201907,754,576,178,576844.98,179642.46,756487.44
420370,201907,122,76,46,75848.6,45908.4,121757.0
420380,201907,1137,807,330,807383.48,331340.32,1138723.80
420390,201907,265,182,83,181636,82834,264470
420395,201907,188,133,55,135728,54890,190618
420400,201907,254,192,62,192614.75,61876,254490.75
420410,201907,64,48,16,47904,15968,63872
420415,201907,32,29,3,28942,2994,31936
420417,201907,53,41,12,40918,11976,52894
420419,201907,11,11,0,10978,0,10978
420420,201907,2804,1743,1061,1740517.77,1059879.34,2800397.11
420425,201907,75,61,14,60878.98,13972.98,74851.96
420430,201907,1227,857,370,858281.5,370258.98,1228540.48
420435,201907,16,14,2,13972,1996,15968
420440,201907,103,74,29,73852.4,28942,102794.4
420445,201907,22,21,1,20958,998,21956
420450,201907,76,39,37,38922,36926,75848
420455,201907,222,171,51,170660.94,50900.94,221561.88
420460,201907,2373,1559,814,1563874.68,815375.22,2379249.90
420470,201907,110,79,31,79840,30938,110778
420475,201907,7,7,0,6986,0,6986
420480,201907,872,662,210,660677.2,209580.8,870258.0
420490,201907,105,77,28,77844,27944,105788
420500,201907,561,258,303,259480.86,311376,570856.86
420510,201907,19,17,2,16966,1996,18962
420515,201907,28,20,8,19960,7984,27944
420517,201907,10,10,0,9980,0,9980
420519,201907,0,,,,,0.0
420520,201907,76,57,19,56886,18962,75848
420530,201907,163,110,53,109780.3,52894,162674.3
420535,201907,19,18,1,17964,998,18962
420540,201907,5377,3209,2168,3212819.71,2172649.92,5385469.63
420543,201907,27,26,1,25948,998,26946
420545,201907,204,146,58,147704.98,58882.98,206587.96
420550,201907,876,716,160,715567.76,160681.92,876249.68
420555,201907,39,28,11,27944,10978,38922
420560,201907,67,55,12,54890,11976,66866
420570,201907,150,88,62,88822,61876,150698
420580,201907,284,128,156,127744,156686.4,284430.4
420590,201907,516,359,157,359280,156686,515966
420600,201907,110,63,47,62874,46906,109780
420610,201907,40,37,3,36926,2994,39920
420620,201907,78,64,14,63872,13972,77844
420630,201907,157,114,43,113772,42915.98,156687.98
420640,201907,85,76,9,76846,8982,85828
420650,201907,235,121,114,120758,113772,234530
420660,201907,50,39,11,40918,10978,51896
420665,201907,36,27,9,26946,8982,35928
420670,201907,318,241,77,240518,76846.98,317364.98
420675,201907,16,15,1,14970,998,15968
420680,201907,37,27,10,26946,9980,36926
420690,201907,175,143,32,142714,31936,174650
420700,201907,706,492,214,494016.28,213579.84,707596.12
420710,201907,151,87,64,86826,64870,151696
420720,201907,109,87,22,87824.98,21956,109780.98
420730,201907,598,385,213,385231.9,214574.32,599806.22
420740,201907,50,49,1,48902,998,49900
420750,201907,514,352,162,351296,163672,514968
420757,201907,18,15,3,14970,2994,17964
420760,201907,36,31,5,30938,4990,35928
420765,201907,74,58,16,57884,15968,73852
420768,201907,50,47,3,46906,2994,49900
420770,201907,81,68,13,68862,12974,81836
420775,201907,45,41,4,40918,3992,44910
420780,201907,235,188,47,187624,46906,234530
420785,201907,12,9,3,8982,2994,11976
420790,201907,165,140,25,139723.92,25949.96,165673.88
420800,201907,67,51,16,50898,15968,66866
420810,201907,249,219,30,220558,29940,250498
420820,201907,2360,1387,973,1389218.58,972054.77,2361273.35
420830,201907,615,339,276,341316.8,280438,621754.8
420840,201907,148,110,38,109780,37924,147704
420845,201907,430,193,237,192614,236526.4,429140.4
420850,201907,246,193,53,193612,53892,247504
420860,201907,63,53,10,52894,9980,62874
420870,201907,122,86,36,86826,35928,122754
420880,201907,183,126,57,125748,56886.98,182634.98
420890,201907,913,460,453,459081.5,454090.98,913172.48
420895,201907,8,8,0,7984,0,7984
420900,201907,418,336,82,335328,82834.98,418162.98
420910,201907,5805,3272,2533,3271451.73,2534926.71,5806378.44
420915,201907,73,69,4,68862,3992,72854
420917,201907,20,14,6,13972,5988,19960
420920,201907,23,16,7,15968,6986,22954
420930,201907,2832,1770,1062,1768450.34,1062042.47,2830492.81
420940,201907,608,446,162,445108.8,163676.49,608785.29
420945,201907,10,8,2,7984,1996,9980
420950,201907,58,53,5,52894,4990,57884
420960,201907,114,89,25,90820.94,24950.98,115771.92
420970,201907,301,243,58,244514.52,59881.96,304396.48
420980,201907,22,22,0,21956,0,21956
420985,201907,62,56,6,55888,5988,61876
420990,201907,78,59,19,59880,18962,78842
421000,201907,33,20,13,19960,12974,32934
421003,201907,62,43,19,42914,18962.98,61876.98
421005,201907,7,4,3,3992,2994,6986
421010,201907,771,536,235,535926.4,235529.1,771455.5
421020,201907,26,21,5,20958,4990,25948
421030,201907,120,102,18,101796.3,17964,119760.3
421040,201907,70,55,15,54890,14970,69860
421050,201907,328,231,97,230538.4,96806,327344.4
421055,201907,23,19,4,18962,3992,22954
421060,201907,82,53,29,52894,28942,81836
421070,201907,49,44,5,43912.4,4990,48902.4
421080,201907,33,31,2,30938,1996,32934
421085,201907,25,19,6,18962,5988,24950
421090,201907,37,29,8,28942,7984,36926
421100,201907,125,92,33,91816,32934,124750
421105,201907,214,174,40,173652.98,39920.98,213573.96
421110,201907,108,87,21,86826,20958,107784
421120,201907,154,119,35,118762.98,34930,153692.98
421125,201907,17,12,5,11976,4990,16966
421130,201907,828,531,297,530936,296406.4,827342.4
421140,201907,31,23,8,22954,7984,30938
421145,201907,41,33,8,32934,7984,40918
421150,201907,103,77,26,77844,25948.8,103792.8
421160,201907,70,48,22,47904,21956,69860
421165,201907,17,16,1,15968,998,16966
421170,201907,190,159,31,158806.32,30938.98,189745.30
421175,201907,155,104,51,103792,50898,154690
421180,201907,54,34,20,34930.24,19960,54890.24
421185,201907,18,14,4,13972,3992,17964
421187,201907,0,,,,,0.0
421189,201907,43,31,12,30938,11976,42914
421190,201907,1603,1020,583,1021952,582833.06,1604785.06
421200,201907,90,67,23,66866,22954,89820
421205,201907,28,17,11,16966,10978,27944
421210,201907,167,118,49,117764,48902,166666
421220,201907,279,219,60,219560,59880,279440
421223,201907,48,40,8,39920.6,7984,47904.6
421225,201907,71,45,26,45908.6,25948,71856.6
421227,201907,86,65,21,64870,20958,85828
421230,201907,53,38,15,37924,14970,52894
421240,201907,18,18,0,17964,0,17964
421250,201907,359,220,139,221557.6,138722,360279.6
421260,201907,25,21,4,20958,3992,24950
421265,201907,1,1,0,998,0,998
421270,201907,50,44,6,43912,5988,49900
421280,201907,336,192,144,191616,143712,335328
421290,201907,330,224,106,224550,105788,330338
421300,201907,26,21,5,20958,4990,25948
421310,201907,48,35,13,34930,12974,47904
421315,201907,29,19,10,18962,9980,28942
421320,201907,136,92,44,91816,43912,135728
421330,201907,106,78,28,77844,27944.98,105788.98
421335,201907,39,27,12,26946,11976,38922
421340,201907,250,163,87,162675.32,86826,249501.32
421350,201907,197,112,85,111776.97,86826,198602.97
421360,201907,667,497,170,497005.48,169661.92,666667.40
421370,201907,194,151,43,150698,43912,194610
421380,201907,128,103,25,102794,24950,127744
421390,201907,15,11,4,11976,3992,15968
421400,201907,121,102,19,101796,18962,120758
421410,201907,19,17,2,16966,1996,18962
421415,201907,21,20,1,19960,998,20958
421420,201907,145,119,26,118762,25948,144710
421430,201907,15,11,4,10978,3992,14970
421440,201907,56,47,9,46906,9980,56886
421450,201907,95,80,15,79840,14970,94810
421460,201907,62,51,11,50898,10978,61876
421470,201907,68,44,24,43912,23952,67864
421480,201907,680,515,165,514968,164670.98,679638.98
421490,201907,23,22,1,21956.98,998,22954.98
421500,201907,495,323,172,325351.34,172669.68,498021.02
421505,201907,24,17,7,16966,6986,23952
421507,201907,29,22,7,21956,6986,28942
421510,201907,74,47,27,46906,26946,73852
421520,201907,57,48,9,49900,8982,58882
421530,201907,51,44,7,43912,6986,50898
421535,201907,28,26,2,25948.14,1996,27944.14
421540,201907,56,48,8,48902,7984,56886
421545,201907,99,73,26,72854.98,25948,98802.98
421550,201907,292,211,81,210578,81836,292414
421555,201907,24,19,5,18962,4990.8,23952.8
421560,201907,9,8,1,7984,998,8982
421565,201907,126,87,39,86826,38922,125748
421567,201907,32,25,7,24950,6986,31936
421568,201907,29,26,3,25948,2994,28942
421569,201907,9,9,0,8982,0,8982
421570,201907,188,124,64,123752,63872,187624
421575,201907,28,23,5,23952,4990,28942
421580,201907,701,420,281,421156,281436,702592
421590,201907,21,20,1,19960,998,20958
421600,201907,155,102,53,101796,53892.8,155688.8
421605,201907,113,80,33,80838.3,32934,113772.3
421610,201907,195,154,41,153692.4,40918,194610.4
421620,201907,1050,620,430,618761.38,431136,1049897.38
421625,201907,23,20,3,19960,2994,22954
421630,201907,286,183,103,183632.9,104791.2,288424.1
421635,201907,17,8,9,7984,8982,16966
421640,201907,98,83,15,82834,14970,97804
421650,201907,300,178,122,178642,122754,301396
421660,201907,2243,1365,878,1369257.78,885230.73,2254488.51
421670,201907,190,139,51,138722,50898,189620
421680,201907,175,158,17,157684,16966,174650
421690,201907,346,252,94,251498.94,93812.44,345311.38
421700,201907,60,40,20,39920,19960.8,59880.8
421710,201907,27,26,1,25948,998,26946
421715,201907,7,6,1,5988,998,6986
421720,201907,600,429,171,428142.7,171656,599798.7
421725,201907,14,6,8,5988,7984,13972
421730,201907,36,26,10,25948,9980,35928
421740,201907,90,42,48,41916,47904,89820
421750,201907,218,164,54,163672,53892,217564
421755,201907,25,23,2,22954,1996,24950
421760,201907,101,72,29,72854,28942,101796
421770,201907,619,407,212,406196.54,212579.12,618775.66
421775,201907,31,19,12,18962,11976,30938
421780,201907,194,153,41,153692.4,40918,194610.4
421790,201907,159,136,23,136726,22954,159680
421795,201907,19,15,4,14970,3992,18962
421800,201907,512,332,180,332334,179640.5,511974.5
421810,201907,75,62,13,61876,12974,74850
421820,201907,328,226,102,225548.4,102794,328342.4
421825,201907,134,114,20,113772,19960,133732
421830,201907,134,99,35,99800,34930,134730
421835,201907,3,3,0,2994,0,2994
421840,201907,49,41,8,42914.98,7984,50898.98
421850,201907,78,67,11,66866,10978.99,77844.99
421860,201907,40,32,8,31936,7984,39920
421870,201907,1007,767,240,766491.78,240523.72,1007015.50
421875,201907,53,45,8,44910,7984,52894
421880,201907,167,121,46,120758,45908.4,166666.4
421885,201907,22,18,4,17964,3992,21956
421890,201907,127,90,37,90818,37925.38,128743.38
421895,201907,49,45,4,44910,3992,48902
421900,201907,163,128,35,127745.96,34934.9,162680.86
421910,201907,67,42,25,41916,24950,66866
421915,201907,30,25,5,24950,4990,29940
421917,201907,38,29,9,28942,10978,39920
421920,201907,38,35,3,34930,2994,37924
421930,201907,731,575,156,574848,156688.94,731536.94
421935,201907,51,44,7,43912,6986,50898
421940,201907,42,37,5,36926,4990,41916
421950,201907,874,588,286,586825.2,285429.58,872254.78
421960,201907,39,33,6,32934.4,5988,38922.4
421970,201907,360,236,124,235528.4,124750.98,360279.38
421985,201907,29,19,10,18962,9980,28942
422000,201907,0,,,,,0.0
430003,201907,193,49,144,49900,144710,194610
430005,201907,37,28,9,28942,8982,37924
430010,201907,270,191,79,190618,78842,269460
430020,201907,148,96,52,95808.4,51896,147704.4
430030,201907,128,105,23,104790,22954,127744
430040,201907,2969,1746,1223,1748465.37,1226544.34,2975009.71
430045,201907,72,60,12,59880,11976,71856
430047,201907,7,6,1,5988,998,6986
430050,201907,79,66,13,65868,12974,78842
430055,201907,14,12,2,11976,1996,13972
430057,201907,6,4,2,3992,1996,5988
430060,201907,3710,2183,1527,2194609.36,1535926.72,3730536.08
430063,201907,59,55,4,54890,4990,59880
430064,201907,158,128,30,127744,29940,157684
430066,201907,6,4,2,3992,1996,5988
430070,201907,47,36,11,35928,10978,46906
430080,201907,69,47,22,46906,21956,68862
430085,201907,36,13,23,12974,22954,35928
430087,201907,30,24,6,23952.7,6986,30938.7
430090,201907,72,65,7,64870,6986,71856
430100,201907,123,83,40,83832,39920,123752
430105,201907,146,76,70,76846.6,69860,146706.6
430107,201907,19,14,5,13972,4990,18962
430110,201907,415,247,168,247504,167664,415168
430120,201907,145,134,11,134730,10978,145708
430130,201907,797,489,308,489020.4,307384,796404.4
430140,201907,123,116,7,115768,6986,122754
430150,201907,105,69,36,69860,35928,105788
430155,201907,34,31,3,30938,2994,33932
430160,201907,3707,2205,1502,2207578.7,1514964.4,3722543.1
430163,201907,343,156,187,156686,186626,343312
430165,201907,30,19,11,18962,10978,29940
430170,201907,89,76,13,76846,12974,89820
430175,201907,78,60,18,60878,17964,78842
430180,201907,102,84,18,83832,17964,101796
430185,201907,34,25,9,24950,8982,33932
430187,201907,89,38,51,38922,51896,90818
430190,201907,216,122,94,121756,93812,215568
430192,201907,13,11,2,10978,1996,12974
430195,201907,16,11,5,10978,4990,15968
430200,201907,173,151,22,150698,21956,172654
430205,201907,19,18,1,17964,998,18962
430210,201907,679,534,145,534928.4,145708.4,680636.8
430215,201907,13,11,2,10978,1996,12974
430220,201907,76,54,22,53892,21956,75848
430222,201907,12,6,6,5988,5988,11976
430223,201907,15,6,9,5988,8982,14970
430225,201907,2,1,1,998,998,1996
430230,201907,313,186,127,185628,126746,312374
430235,201907,56,42,14,41916,13972,55888
430237,201907,26,21,5,20958,4990,25948
430240,201907,133,85,48,84830,47904,132734
430245,201907,67,55,12,54890,11976,66866
430250,201907,193,113,80,114770,79840,194610
430258,201907,10,8,2,7984,1996,9980
430260,201907,33,29,4,29940,3992,33932
430265,201907,37,31,6,30938,5988,36926
430270,201907,536,404,132,405188.3,132737.92,537926.22
430280,201907,1044,644,400,642712,401197.9,1043909.9
430290,201907,384,217,167,217564.6,166666,384230.6
430300,201907,2104,1173,931,1173651.34,934134.05,2107785.39
430310,201907,1942,1005,937,1006983.96,938126.81,1945110.77
430320,201907,54,44,10,43912,9980,53892
430330,201907,95,84,11,83832,10978,94810
430340,201907,69,59,10,58882,9980,68862
430350,201907,1665,1142,523,1144706.6,523950.98,1668657.58
430355,201907,23,20,3,19960,2994,22954
430360,201907,86,43,43,42914,42914,85828
430367,201907,31,23,8,22954,7984,30938
430370,201907,55,47,8,46906,7984,54890
430380,201907,141,105,36,104790,35928,140718
430390,201907,602,383,219,382234,218562,600796
430400,201907,139,106,33,105788.8,32934,138722.8
430410,201907,58,45,13,44910,12974,57884
430420,201907,510,338,172,337324.96,171656.98,508981.94
430430,201907,54,53,1,52229.33,998,53227.33
430435,201907,155,115,40,114770,39920,154690
430440,201907,512,340,172,341316.6,173652,514968.6
430450,201907,1163,958,205,959078,204590,1163668
430460,201907,5068,2771,2297,2777439.14,2301413.18,5078852.32
430461,201907,17,15,2,14970,1996,16966
430462,201907,8,5,3,4990,2994,7984
430463,201907,1055,563,492,567863.56,492015.96,1059879.52
430465,201907,23,13,10,12974,9980,22954
430466,201907,686,488,198,492014.4,197604,689618.4
430467,201907,96,54,42,53892.6,41916,95808.6
430468,201907,110,66,44,65868,43912,109780
430469,201907,22,17,5,16966,4990,21956
430470,201907,1161,653,508,652989.95,506984,1159973.95
430471,201907,54,39,15,38922,14970,53892
430480,201907,101,62,39,61876,38922,100798
430485,201907,6,6,0,5988.4,0,5988.4
430490,201907,84,68,16,67864,15968,83832
430495,201907,36,27,9,26946,8982,35928
430500,201907,194,131,63,130738,63872.63,194610.63
430510,201907,3392,2227,1165,2229533.24,1165664,3395197.24
430511,201907,16,15,1,14970,998,15968
430512,201907,143,102,41,101796,40918,142714
430513,201907,49,39,10,38922,9980,48902
430515,201907,29,27,2,26946,1996,28942
430517,201907,168,150,18,149700,17964,167664
430520,201907,368,254,114,253492,115768,369260
430530,201907,85,48,37,47904,36926,84830
430535,201907,459,313,146,312374,146706.99,459080.99
430537,201907,11,11,0,10978,0,10978
430540,201907,79,53,26,52894,25948,78842
430543,201907,357,115,242,114770,245508,360278
430544,201907,45,42,3,41916,2994,44910
430545,201907,360,190,170,190618.96,169660,360278.96
430550,201907,44,36,8,35928,7984,43912
430558,201907,5,3,2,2994,1996,4990
430560,201907,53,27,26,26946,25948,52894
430570,201907,109,43,66,42914,65868,108782
430580,201907,125,103,22,102794,21956.6,124750.6
430583,201907,13,13,0,12974,0,12974
430585,201907,11,4,7,3992,6986,10978
430587,201907,15,7,8,6986,7984,14970
430590,201907,151,125,26,124750,26946,151696
430593,201907,2,2,0,1996,0,1996
430595,201907,16,13,3,12974,2994,15968
430597,201907,48,26,22,25948,21956,47904
430600,201907,223,159,64,158682,64870,223552
430605,201907,158,98,60,97804,59880,157684
430607,201907,21,18,3,18962,2994,21956
430610,201907,1626,772,854,772452.9,856285.38,1628738.28
430613,201907,3,3,0,2994,0,2994
430620,201907,112,81,31,80838,30938,111776
430630,201907,45,40,5,39920,4990,44910
430632,201907,33,28,5,27944,4990,32934
430635,201907,35,32,3,31936,2994,34930
430637,201907,54,29,25,28942,24950,53892
430640,201907,190,107,83,107784,82834,190618
430642,201907,21,19,2,18962,1996,20958
430645,201907,36,29,7,29940,6986,36926
430650,201907,254,205,49,205588.4,49900,255488.4
430655,201907,4,4,0,3992,0,3992
430660,201907,981,479,502,480038,505986.4,986024.4
430670,201907,76,52,24,51896,23952,75848
430673,201907,75,42,33,41916,32934,74850
430675,201907,12,10,2,9980,2994,12974
430676,201907,499,302,197,303392.94,196606.94,499999.88
430680,201907,248,176,72,176646.4,71856,248502.4
430690,201907,540,337,203,337324.98,202594.63,539919.61
430692,201907,7,5,2,4990,1996,6986
430693,201907,141,95,46,94810,45908,140718
430695,201907,73,61,12,60878,11976,72854
430697,201907,59,37,22,36926,21956,58882
430700,201907,1555,1082,473,1083828.4,472054,1555882.4
430705,201907,21,20,1,19960,998,20958
430710,201907,264,171,93,170658,92814,263472
430720,201907,106,91,15,90818,14970,105788
430730,201907,138,118,20,117764,19960,137724
430740,201907,71,47,24,46906,23952,70858
430745,201907,35,27,8,26946,7984,34930
430750,201907,339,225,114,224550,113772,338322
430755,201907,89,52,37,51896,36926,88822
430760,201907,368,218,150,217565.04,151696.98,369262.02
430770,201907,1433,751,682,754490.24,683634.84,1438125.08
430780,201907,312,200,112,201596.98,111776.98,313373.96
430781,201907,29,25,4,24950,3992,28942
430783,201907,55,45,10,44910,9980,54890
430786,201907,7,4,3,3992,2994,6986
430790,201907,539,354,185,353292.6,185628.4,538921.0
430800,201907,160,133,27,133732,26946,160678
430805,201907,40,37,3,36926,2994,39920
430807,201907,44,25,19,24950,19960,44910
430810,201907,79,54,25,53892,25948,79840
430820,201907,144,85,59,84830,58882,143712
430825,201907,10,8,2,7984,1996,9980
430830,201907,233,217,16,218562.4,15968,234530.4
430840,201907,127,86,41,86826,40918,127744
430843,201907,6,4,2,3992,1996,5988
430845,201907,72,42,30,41916,29940,71856
430850,201907,579,407,172,408182,172657.9,580839.9
430860,201907,169,109,60,109780,60878,170658
430865,201907,71,39,32,38922,32934.98,71856.98
430870,201907,79,64,15,64870,14970,79840
430880,201907,154,116,38,115768,37924,153692
430885,201907,10,8,2,7984,1996,9980
430890,201907,352,216,136,216566,136726,353292
430900,201907,525,368,157,368761,157684,526445
430905,201907,107,48,59,47904,59880,107784
430910,201907,283,160,123,159680,122754.98,282434.98
430912,201907,5,5,0,4990,0,4990
430915,201907,36,30,6,29940,5988,35928
430920,201907,4236,2314,1922,2317362.2,1930136.34,4247498.54
430925,201907,4,3,1,2994,998,3992
430930,201907,2053,1208,845,1214567.86,844311.88,2058879.74
430940,201907,257,166,91,167664,91816,259480
430950,201907,152,123,29,122754,28942,151696
430955,201907,22,13,9,12974,8982,21956
430957,201907,18,17,1,16966,998,17964
430960,201907,247,162,85,162674,84830,247504
430965,201907,114,72,42,71856,41916,113772
430970,201907,84,70,14,70858,13972,84830
430975,201907,41,37,4,36926,3992,40918
430980,201907,45,29,16,28942,15968,44910
430990,201907,115,88,27,87824,26946,114770
430995,201907,119,114,5,113772,4990,118762
431000,201907,305,137,168,136727,167664,304391
431010,201907,343,200,143,200598,142714,343312
431020,201907,1923,1115,808,1114766.6,808380,1923146.6
431030,201907,41,32,9,31936,8982,40918
431033,201907,385,190,195,189620,194610,384230
431036,201907,14,9,5,8982,4990,13972
431040,201907,135,82,53,81836,52894,134730
431041,201907,36,25,11,24950,11976,36926
431043,201907,50,29,21,29940,20958,50898
431046,201907,11,7,4,6986,3992,10978
431050,201907,197,126,71,125748,70858,196606
431053,201907,73,45,28,44910.96,27944,72854.96
431055,201907,64,46,18,45908,18962,64870
431057,201907,18,18,0,17964,0,17964
431060,201907,1659,1052,607,1050895.85,607797.4,1658693.25
431065,201907,20,12,8,11976,7984,19960
431070,201907,67,61,6,60878,5988,66866
431075,201907,7,7,0,6986,0,6986
431080,201907,133,82,51,81836,50898,132734
431085,201907,34,31,3,30938,2994,33932
431087,201907,15,12,3,11976,2994,14970
431090,201907,53,42,11,41916,10978,52894
431100,201907,1214,724,490,725548.02,491016,1216564.02
431110,201907,243,148,95,147704,94810.4,242514.4
431112,201907,27,16,11,15968,10978,26946
431113,201907,34,25,9,24950,8982,33932
431115,201907,155,107,48,106786,47904,154690
431120,201907,601,360,241,361276.6,242515.92,603792.52
431123,201907,4,3,1,2994,998,3992
431125,201907,96,87,9,86826,8982,95808
431127,201907,9,4,5,3992,4990,8982
431130,201907,697,451,246,453092,247504,700596
431140,201907,763,536,227,536924.4,227544,764468.4
431142,201907,32,26,6,25948.95,5988,31936.95
431150,201907,199,152,47,152694,46906,199600
431160,201907,54,49,5,48902,4990,53892
431162,201907,17,13,4,12974,3992,16966
431164,201907,6,6,0,5988,0,5988
431170,201907,110,87,23,86826,22954,109780
431171,201907,68,42,26,41916,25948,67864
431173,201907,1,1,0,998,0,998
431175,201907,197,102,95,101796.4,95808,197604.4
431177,201907,74,57,17,56886,16966,73852
431179,201907,13,11,2,10978,1996,12974
431180,201907,459,282,177,282434,177644.98,460078.98
431190,201907,83,64,19,63872,18962,82834
431198,201907,67,46,21,45908,20958,66866
431200,201907,20,16,4,15968,3992,19960
431205,201907,23,23,0,22954,0,22954
431210,201907,88,53,35,52894,34930,87824
431213,201907,30,26,4,25948,3992,29940
431215,201907,22,19,3,18962,2994,21956
431217,201907,5,4,1,3992,998,4990
431220,201907,69,60,9,59880.8,8982,68862.8
431225,201907,148,99,49,99800.98,48902,148702.98
431230,201907,104,93,11,92814,10978,103792
431235,201907,8,8,0,7984,0,7984
431237,201907,23,16,7,15968,6986,22954
431238,201907,9,6,3,5988.4,2994,8982.4
431240,201907,989,641,348,640716.2,348302,989018.2
431242,201907,37,36,1,35928,998,36926
431244,201907,11,8,3,7984,2994,10978
431245,201907,52,40,12,39920,11976,51896
431247,201907,12,9,3,8982,2994,11976
431250,201907,280,147,133,147704,132734,280438
431260,201907,58,45,13,44910,12974,57884
431261,201907,17,11,6,10978,5988,16966
431262,201907,18,17,1,16966,998,17964
431265,201907,145,79,66,80838,65868,146706
431267,201907,12,11,1,11976,998,12974
431270,201907,327,270,57,270458,56886,327344
431275,201907,39,36,3,35928,2994,38922
431280,201907,19,15,4,14970,3992,18962
431290,201907,25,20,5,19960,4990,24950
431295,201907,3,3,0,2994,0,2994
431300,201907,22,19,3,18962,2994,21956
431301,201907,6,6,0,5988,0,5988
431303,201907,58,38,20,37924,19960,57884
431306,201907,234,125,109,124572.35,109780,234352.35
431308,201907,7,5,2,4990,1996,6986
431310,201907,68,57,11,56886,10978,67864
431320,201907,145,86,59,85828,58882,144710
431330,201907,182,118,64,117764,63872,181636
431333,201907,28,24,4,24950,3992,28942
431335,201907,9,5,4,4990,3992,8982
431337,201907,330,152,178,152694,178642,331336
431339,201907,20,17,3,16966,2994,19960
431340,201907,2988,1695,1293,1696525.51,1296417.4,2992942.91
431342,201907,40,24,16,23952,15968,39920
431344,201907,17,17,0,16966,0,16966
431346,201907,5,5,0,4990,0,4990
431349,201907,36,32,4,31936,3992,35928
431350,201907,919,539,380,539919.08,380238.4,920157.48
431360,201907,47,42,5,41916,4990,46906
431365,201907,326,158,168,158682,167664,326346
431370,201907,1330,787,543,787422.4,542916.9,1330339.3
431380,201907,95,81,14,81836,13972,95808
431390,201907,514,280,234,280438,233532,513970
431395,201907,296,135,161,135728,160678.96,296406.96
431400,201907,44,31,13,31936,12974,44910
431402,201907,101,72,29,73852,28942,102794
431403,201907,22,12,10,11976,9980,21956
431405,201907,657,360,297,362274.9,298403.96,660678.86
431406,201907,30,26,4,25948,3992,29940
431407,201907,51,40,11,39920,10978,50898
431410,201907,3431,2108,1323,2106779.58,1324346.51,3431126.09
431413,201907,16,13,3,12974,2994,15968
431415,201907,70,52,18,51896,17964,69860
431417,201907,23,13,10,12974,9980,22954
431420,201907,317,217,100,217564,100798,318362
431430,201907,47,22,25,21956,24950,46906
431440,201907,8944,6296,2648,6311361.36,2659671.4,8971032.76
431442,201907,29,16,13,15968,12974,28942
431445,201907,24,21,3,20958,2994,23952
431446,201907,4,4,0,3992,0,3992
431447,201907,88,64,24,64870,23952,88822
431449,201907,54,46,8,45908,7984,53892
431450,201907,416,282,134,282434,134730,417164
431454,201907,0,,,,,0.0
431455,201907,53,41,12,40918,11976,52894
431460,201907,525,363,162,362274,161676,523950
431470,201907,120,93,27,92814,26946,119760
431475,201907,10,9,1,8982,998,9980
431477,201907,37,24,13,23952,12974,36926
431478,201907,8,7,1,6986,998,7984
431480,201907,491,312,179,313372,178642,492014
431490,201907,28675,16086,12589,16152748.46,12646784.25,28799532.71
431500,201907,81,60,21,59880,20958,80838
431505,201907,27,17,10,16966,9980,26946
431507,201907,14,10,4,9980,3992,13972
431510,201907,256,182,74,181636.1,74850,256486.1
431513,201907,24,21,3,20958,3992,24950
431514,201907,6,5,1,4990,998,5988
431515,201907,81,68,13,67864,12974,80838
431517,201907,5,4,1,3992,998,4990
431520,201907,37,33,4,32934,3992,36926
431530,201907,1544,697,847,697604.88,851294.94,1548899.82
431531,201907,24,22,2,21956,1996,23952
431532,201907,30,21,9,20958,8982,29940
431535,201907,26,16,10,15968,9980,25948
431540,201907,139,120,19,120758,18962,139720
431545,201907,13,11,2,10978,1996,12974
431550,201907,354,201,153,200598,152694,353292
431555,201907,12,12,0,11976,998,12974
431560,201907,4515,3148,1367,3152686.77,1367260.4,4519947.17
431570,201907,809,439,370,439120.8,371256,810376.8
431575,201907,38,23,15,23952,14970,38922
431580,201907,101,70,31,69860,30938,100798
431590,201907,150,127,23,126746,22954,149700
431595,201907,12,11,1,10978,998,11976
431600,201907,225,128,97,127744,98802,226546
431610,201907,124,92,32,91816,31936,123752
431620,201907,45,37,8,36926,7984,44910
431630,201907,129,107,22,106786,23952,130738
431640,201907,1338,847,491,850296.4,496007.36,1346303.76
431642,201907,35,33,2,32934,1996,34930
431643,201907,43,21,22,20958,21956,42914
431645,201907,323,189,134,188622,136726,325348
431647,201907,10,10,0,9980,0,9980
431650,201907,33,23,10,22954,9980,32934
431660,201907,316,203,113,204590,113772,318362
431670,201907,236,110,126,109780,125748,235528
431673,201907,3,3,0,2994,0,2994
431675,201907,27,22,5,21956,4990,26946
431680,201907,1128,832,296,834328,296406,1130734
431690,201907,4776,2909,1867,2921148.04,1872252.3,4793400.34
431695,201907,21,17,4,16966,3992,20958
431697,201907,0,,,,,0.0
431700,201907,168,133,35,132734,34930,167664
431710,201907,4015,1785,2230,1784425.58,2238524.78,4022950.36
431720,201907,1364,835,529,833331,531934.99,1365265.99
431725,201907,1,1,0,998,0,998
431730,201907,1182,799,383,802394.16,384230,1186624.16
431740,201907,1369,675,694,674648.96,692616.32,1367265.28
431750,201907,1848,1205,643,1207581.71,650696.98,1858278.69
431755,201907,5,4,1,3992,998,4990
431760,201907,1020,656,364,658681.4,364270,1022951.4
431770,201907,398,294,104,295408,104790,400198
431775,201907,31,23,8,22954,7984,30938
431780,201907,555,346,209,345308,209580,554888
431790,201907,171,133,38,132734,37924,170658
431795,201907,12,10,2,9980,1996,11976
431800,201907,3351,1765,1586,1765475.94,1587912.86,3353388.80
431805,201907,18,16,2,15968,1996,17964
431810,201907,608,409,199,409180,199600.98,608780.98
431820,201907,320,186,134,185628,133732,319360
431830,201907,2337,1413,924,1412170,923153.93,2335323.93
431840,201907,491,328,163,328342.6,163672,492014.6
431842,201907,34,28,6,27944,5988,33932
431843,201907,11,9,2,8982,1996,10978
431844,201907,16,14,2,13972,1996,15968
431845,201907,25,23,2,22954,1996,24950
431846,201907,29,24,5,23952,4990,28942
431848,201907,13,11,2,10978,1996,12974
431849,201907,10,7,3,6986,3992,10978
431850,201907,803,659,144,657682,143712,801394
431860,201907,114,80,34,79840,33932,113772
431861,201907,4,2,2,1996,1996,3992
431862,201907,55,36,19,35928,18962,54890
431870,201907,3407,2018,1389,2025944.88,1393215.76,3419160.64
431880,201907,933,688,245,689618.94,247504,937122.94
431890,201907,1303,806,497,807382,498002,1305384
431900,201907,179,129,50,128742,50898,179640
431910,201907,56,40,16,39920,15968,55888
431912,201907,38,22,16,21956,15968,37924
431915,201907,127,102,25,101796,25948,127744
431920,201907,153,112,41,112774,40918,153692
431930,201907,82,67,15,66866,14970,81836
431935,201907,3,3,0,2994,0,2994
431936,201907,12,11,1,10978,998,11976
431937,201907,19,14,5,13972,4990,18962
431940,201907,468,313,155,313372,154690.5,468062.5
431950,201907,495,311,184,312375.38,185629.96,498005.34
431960,201907,742,412,330,414172.36,329340.98,743513.34
431970,201907,74,65,9,64870,8982,73852
431971,201907,3,3,0,2994,0,2994
431973,201907,23,19,4,18962,3992,22954
431975,201907,9,8,1,7984,998,8982
431980,201907,213,134,79,134730,78842,213572
431990,201907,1196,642,554,641649.71,552894.9,1194544.61
432000,201907,1670,905,765,909180.1,772457,1681637.1
432010,201907,279,188,91,187624,91816,279440
432020,201907,174,142,32,141716,31936,173652
432023,201907,16,14,2,13972,1996,15968
432026,201907,69,64,5,63872,4990,68862
432030,201907,66,32,34,31936,33932,65868
432032,201907,18,15,3,14970,2994,17964
432035,201907,52,42,10,41916,9980,51896
432040,201907,104,72,32,71856,31936,103792
432045,201907,8,7,1,6986,998,7984
432050,201907,81,50,31,50898,30938,81836
432055,201907,115,86,29,85828,28942,114770
432057,201907,5,4,1,3992.4,998,4990.4
432060,201907,33,30,3,29940,2994,32934
432065,201907,33,29,4,28942,3992,32934
432067,201907,89,80,9,79840,8982,88822
432070,201907,403,310,93,309630.8,93812.98,403443.78
432080,201907,822,573,249,574848,251496,826344
432085,201907,13,10,3,9980,2994,12974
432090,201907,269,178,91,177644,90818,268462
432100,201907,175,118,57,117764,56886,174650
432110,201907,600,404,196,405188,195608,600796
432120,201907,945,576,369,582832,369260,952092
432130,201907,497,362,135,364270,135728,499998
432132,201907,23,20,3,21956,2994,24950
432135,201907,78,65,13,64870,12974,77844
432140,201907,271,215,56,214570,55888,270458
432143,201907,204,132,72,131736,72854,204590
432145,201907,274,189,85,188622,84830,273452
432146,201907,14,13,1,12974,998,13972
432147,201907,122,58,64,57884,64870,122754
432149,201907,14,10,4,9980,3992,13972
432150,201907,838,521,317,521954,317365.55,839319.55
432160,201907,1428,747,681,750497.57,685627.94,1436125.51
432162,201907,4,3,1,2994,998,3992
432163,201907,19,14,5,13972,4990,18962
432166,201907,114,85,29,86328,28942,115270
432170,201907,221,116,105,115768,107784,223552
432180,201907,544,335,209,335328,208582.4,543910.4
432183,201907,6,6,0,5988,0,5988
432185,201907,79,70,9,69860,8982,78842
432190,201907,477,277,200,276446,199600.98,476046.98
432195,201907,86,71,15,70858,14970,85828
432200,201907,389,252,137,252494,138722.98,391216.98
432210,201907,118,74,44,74850,43912,118762
432215,201907,54,50,4,50898,3992,54890
432218,201907,21,20,1,19960,998,20958
432220,201907,679,355,324,354290,324351.61,678641.61
432225,201907,13,8,5,7984,4990,12974
432230,201907,141,93,48,92814,49900,142714
432232,201907,14,13,1,12974,998,13972
432234,201907,4,3,1,2994,998,3992
432235,201907,3,3,0,2994,0,2994
432237,201907,26,14,12,13972,11976,25948
432240,201907,4352,2467,1885,2468057.94,1890214.18,4358272.12
432250,201907,1103,706,397,707582,396206,1103788
432252,201907,40,35,5,34930,4990,39920
432253,201907,58,47,11,46906,10978,57884
432254,201907,27,13,14,12974,13972,26946
432255,201907,13,12,1,11976,998,12974
432260,201907,851,675,176,676644.4,175648,852292.4
432270,201907,240,177,63,177644,62874,240518
432280,201907,140,106,34,105788.6,35928,141716.6
432285,201907,2,2,0,1996,0,1996
432290,201907,66,59,7,58882,6986,65868
432300,201907,4637,2596,2041,2608244.75,2054894.62,4663139.37
432310,201907,118,98,20,97804,19960,117764
432320,201907,22,17,5,16966,4990,21956
432330,201907,16,12,4,11976,3992,15968
432335,201907,7,6,1,5988,998,6986
432340,201907,40,35,5,34930,4990,39920
432345,201907,95,68,27,67864,26946,94810
432350,201907,25,24,1,23952,998,24950
432360,201907,7,5,2,4990,1996,6986
432370,201907,23,22,1,21956,998,22954
432375,201907,34,31,3,30938,2994,33932
432377,201907,9,9,0,8982,0,8982
432380,201907,165,75,90,74850,89820,164670
500020,201907,242,140,102,139720,101796,241516
500025,201907,127,64,63,63872,62874,126746
500060,201907,1453,910,543,908180,543911.38,1452091.38
500070,201907,798,390,408,389220.96,408182,797402.96
500080,201907,134,109,25,108782,24950,133732
500085,201907,132,106,26,107784.4,26946,134730.4
500090,201907,328,158,170,157684,169660,327344
500100,201907,727,383,344,383232,346306.8,729538.8
500110,201907,2281,1057,1224,1056887.71,1224557.5,2281445.21
500124,201907,263,155,108,154690,107784,262474
500150,201907,320,138,182,137724.98,182636.94,320361.92
500190,201907,521,364,157,364270,158682.4,522952.4
500200,201907,188,162,26,162674.28,25948,188622.28
500210,201907,1471,532,939,531940.86,938159.1,1470099.96
500215,201907,244,144,100,143712,99800,243512
500220,201907,759,496,263,495011.62,263472,758483.62
500230,201907,250,167,83,166666,82834,249500
500240,201907,680,475,205,476046.36,204590,680636.36
500260,201907,590,230,360,230538,361276,591814
500270,201907,29401,12775,16626,12790803.22,16656805.23,29447608.45
500280,201907,194,71,123,70858,122754,193612
500290,201907,1178,708,470,707582,471056.98,1178638.98
500295,201907,442,282,160,282434.4,159680,442114.4
500310,201907,66,23,43,23952,42914,66866
500315,201907,723,439,284,440118,283432,723550
500320,201907,3657,1848,1809,1850293.75,1816365.88,3666659.63
500325,201907,922,514,408,513970.4,407184.4,921154.8
500330,201907,1433,677,756,675646.4,755486.98,1431133.38
500345,201907,307,236,71,235529.38,70858,306387.38
500348,201907,244,147,97,147704,96806,244510
500350,201907,126,63,63,63872,62874,126746
500370,201907,5415,2453,2962,2452088.48,2967060.9,5419149.38
500375,201907,342,252,90,252494,89820,342314
500380,201907,599,347,252,346306,251496,597802
500390,201907,70,33,37,32934,37924,70858
500400,201907,209,146,63,145708,62874.98,208582.98
500410,201907,552,227,325,226548.95,325353.87,551902.82
500430,201907,528,375,153,374250,153692,527942
500440,201907,206,107,99,106786,98802,205588
500450,201907,405,175,230,175648,229540,405188
500460,201907,288,149,139,149700,140718,290418
500470,201907,438,347,91,347305.39,91816.98,439122.37
500480,201907,109,66,43,65868,42914,108782
500490,201907,108,45,63,45908,62874,108782
500500,201907,1430,523,907,522962.81,908211.51,1431174.32
500510,201907,46,35,11,34930,10978.98,45908.98
500515,201907,105,75,30,74850,30938,105788
500520,201907,337,187,150,187624.8,151697.39,339322.19
500525,201907,91,50,41,49900,40918,90818
500540,201907,908,395,513,394210.98,516965.96,911176.94
500560,201907,899,512,387,512972,389220.4,902192.4
500568,201907,977,575,402,575846.98,402195.39,978042.37
500570,201907,1203,696,507,695626.6,508038.24,1203664.84
500580,201907,335,178,157,177644,156687.97,334331.97
500600,201907,316,169,147,169660,147705.96,317365.96
500620,201907,911,646,265,650697.12,265468,916165.12
500625,201907,77,65,12,64870,11976,76846
500627,201907,25,12,13,11976,12974,24950
500630,201907,1576,851,725,851294.9,724548,1575842.9
500635,201907,519,307,212,308382,212574,520956
500640,201907,404,214,190,213572.8,189620,403192.8
500660,201907,5445,2099,3346,2105780.4,3352282.8,5458063.2
500690,201907,576,207,369,206595.78,368286.5,574882.28
500710,201907,384,198,186,197604,187625.96,385229.96
500720,201907,955,560,395,560876.43,394210,955086.43
500730,201907,192,118,74,118762,73852,192614
500740,201907,858,379,479,380244.34,481064.69,861309.03
500750,201907,151,49,102,48902,102794.98,151696.98
500755,201907,123,87,36,88822.4,36926,125748.4
500769,201907,741,419,322,418164.37,321357.97,739522.34
500770,201907,414,217,197,216566,198602,415168
500780,201907,165,112,53,111776,52894,164670
500790,201907,1064,544,520,544908,521958.91,1066866.91
500793,201907,270,151,119,150698,118763.38,269461.38
500795,201907,170,123,47,122754,46906.98,169660.98
500797,201907,49,37,12,36926,11976,48902
500800,201907,415,188,227,191616.98,226546,418162.98
500830,201907,2257,1283,974,1284427.98,974049.01,2258476.99
500840,201907,140,104,36,103792,35928.98,139720.98
510010,201907,168,93,75,92814,76846,169660
510020,201907,486,225,261,224568.62,260507.4,485076.02
510025,201907,1692,973,719,976054.15,722567.1,1698621.25
510030,201907,666,353,313,352297.9,313374.95,665672.85
510035,201907,129,59,70,58883.96,69860.98,128744.94
510040,201907,379,172,207,171656,206588.68,378244.68
510050,201907,392,217,175,216572.84,175655.28,392228.12
510060,201907,116,60,56,59880,55888,115768
510080,201907,225,90,135,89821.96,134730.98,224552.94
510100,201907,73,33,40,32934,39920,72854
510120,201907,37,24,13,23952,12974,36926
510125,201907,390,244,146,243512,145709.97,389221.97
510130,201907,571,331,240,330346.82,239530.78,569877.60
510140,201907,403,124,279,123752,279440,403192
510160,201907,95,38,57,37924,56886,94810
510170,201907,832,509,323,507996.88,324364.68,832361.56
510180,201907,2872,1402,1470,1399241.37,1470090.1,2869331.47
510185,201907,14,6,8,5988,7984,13972
510190,201907,217,75,142,75848,141716,217564
510250,201907,2558,1522,1036,1521958.25,1035928.32,2557886.57
510260,201907,187,138,49,137738.7,48902.98,186641.68
510263,201907,465,266,199,266469.74,198602.98,465072.72
510267,201907,679,380,299,379255.3,298424.52,677679.82
510268,201907,59,28,31,27944,30938,58882
510269,201907,71,34,37,33932.98,36926,70858.98
510270,201907,392,203,189,203595.92,190622.9,394218.82
510279,201907,224,167,57,167666.94,56886.4,224553.34
510285,201907,178,72,106,72854.98,105788,178642.98
510300,201907,512,286,226,285432.92,225554.86,510987.78
510305,201907,213,100,113,99801.97,114770.98,214572.95
510310,201907,106,56,50,55888,49900,105788
510320,201907,842,538,304,538925.88,303405.73,842331.61
510325,201907,403,165,238,165668,239520,405188
510330,201907,423,241,182,240519.97,181636,422155.97
510335,201907,613,355,258,355290.95,257488.9,612779.85
510336,201907,51,37,14,37924,13972,51896
510337,201907,110,46,64,45908,63872,109780
510340,201907,17101,8096,9005,8104981.35,9020235.81,17125217.16
510343,201907,63,44,19,44910,18962,63872
510345,201907,166,112,54,111776,53892.4,165668.4
510350,201907,657,369,288,370262.9,287428.32,657691.22
510360,201907,195,125,70,125748.98,70863.88,196612.86
510370,201907,141,72,69,71856,69862.94,141718.94
510380,201907,87,62,25,61876,24950.98,86826.98
510385,201907,58,27,31,26946,30938.98,57884.98
510390,201907,108,48,60,47904,59880,107784
510395,201907,47,34,13,33932,12974,46906
510410,201907,698,465,233,465069.98,233533.96,698603.94
510420,201907,567,280,287,279458.58,286456.24,565914.82
510450,201907,52,28,24,27944,23952,51896
510452,201907,46,27,19,26946,18962,45908
510454,201907,52,24,28,23952,27944,51896
510455,201907,125,77,48,76846,47904,124750
510460,201907,174,91,83,90819.68,82834.98,173654.66
510480,201907,730,432,298,433139.12,297414.7,730553.82
510490,201907,350,182,168,182639.84,167666.9,350306.74
510500,201907,239,181,58,180638,57884,238522
510510,201907,805,469,336,470060.36,336326,806386.36
510515,201907,1164,626,538,624753.88,539918.98,1164672.86
510517,201907,258,108,150,107784,149700.98,257484.98
510520,201907,229,151,78,151698.94,77848.88,229547.82
510523,201907,94,70,24,69860,23952,93812
510525,201907,787,472,315,472058.91,314374.9,786433.81
510530,201907,17,12,5,11976,4990,16966
510550,201907,253,116,137,115768.98,136726,252494.98
510558,201907,281,137,144,136726.98,144710,281436.98
510560,201907,413,246,167,246506.4,166667.96,413174.36
510562,201907,659,471,188,471056,189620,660676
510590,201907,763,402,361,402194.98,362275.97,764470.95
510600,201907,247,135,112,134730,111777.96,246507.96
510610,201907,166,81,85,81836,86826,168662
510615,201907,190,77,113,78842,112774,191616
510617,201907,19,12,7,11976,6986,18962
510618,201907,119,58,61,57884,60878,118762
510619,201907,99,69,30,68862.98,29940.98,98803.96
510620,201907,179,99,80,98802,79840,178642
510621,201907,187,122,65,122754.98,66867.96,189622.94
510622,201907,479,305,174,304395.88,175649.96,480045.84
510623,201907,345,237,108,236527.96,107784,344311.96
510624,201907,90,45,45,44910.98,44910,89820.98
510625,201907,551,342,209,343327.68,208594.37,551922.05
510626,201907,112,71,41,70858.98,40918,111776.98
510627,201907,65,46,19,45908,18962,64870
510628,201907,150,89,61,89820.98,60878,150698.98
510629,201907,251,165,86,164670,85828,250498
510630,201907,447,230,217,230539.96,217567.34,448107.30
510631,201907,11,3,8,2994,7984,10978
510637,201907,349,210,139,210581.93,140728.78,351310.71
510642,201907,971,546,425,546906.94,428143.96,975050.90
510645,201907,0,,,,,0.0
510650,201907,1425,954,471,959092.14,474054.87,1433147.01
510665,201907,81,43,38,42917.88,37924,80841.88
510670,201907,62,36,26,35928,25948,61876
510675,201907,1137,714,423,715569.34,423152.98,1138722.32
510677,201907,350,180,170,179644.9,169665.88,349310.78
510680,201907,102,62,40,61877.96,39920.98,101798.94
510682,201907,209,103,106,103792,105788,209580
510685,201907,51,40,11,39920,10978,50898
510700,201907,600,348,252,351305.8,252501.85,603807.65
510704,201907,1114,601,513,601910.59,516073.78,1117984.37
510706,201907,128,67,61,66866,60878.98,127744.98
510710,201907,397,279,118,278447.84,118763.92,397211.76
510715,201907,62,46,16,45908,15968,61876
510718,201907,202,110,92,109782.94,92814,202596.94
510719,201907,36,17,19,16966,18962,35928
510720,201907,189,132,57,131736,56886,188622
510724,201907,88,35,53,34930,52894,87824
510726,201907,51,26,25,25948,24950.98,50898.98
510729,201907,70,33,37,32934,36926,69860
510730,201907,467,265,202,265469.96,202595.97,468065.93
510735,201907,107,45,62,44910,61876,106786
510740,201907,25,13,12,12974,11976,24950
510757,201907,17,13,4,12974,3992,16966
510760,201907,7081,3795,3286,3802442.83,3290614.47,7093057.30
510770,201907,674,319,355,322358.88,356296.74,678655.62
510774,201907,17,7,10,6986,9980,16966
510775,201907,110,84,26,83832,25948,109780
510776,201907,28,10,18,9980,17964,27944
510777,201907,186,83,103,82834,102794,185628
510779,201907,47,22,25,22954.98,24951.96,47906.94
510780,201907,287,162,125,162680.88,125753.85,288434.73
510785,201907,408,222,186,223552,185628,409180
510787,201907,195,95,100,94810.98,99801.97,194612.95
510788,201907,0,,,,,0.0
510790,201907,2436,1307,1129,1308428.88,1126829.22,2435258.10
510792,201907,1136,663,473,666671.84,472067.73,1138739.57
510794,201907,113,56,57,56886,57884.98,114770.98
510795,201907,2363,1401,962,1401197.75,963076.68,2364274.43
510800,201907,183,113,70,113772,69860,183632
510805,201907,169,117,52,117764,51896.98,169660.98
510810,201907,98,45,53,44915.88,52894,97809.88
510820,201907,246,121,125,120762.12,124752.51,245514.63
510830,201907,69,41,28,40918,27944.98,68862.98
510835,201907,12,9,3,8982,2994,11976
510840,201907,9071,4464,4607,4467252.62,4613979.33,9081231.95
510850,201907,210,84,126,83832,125748.98,209580.98
510860,201907,390,176,214,177650.86,213583.16,391234.02
510880,201907,65,48,17,47904.98,16966,64870.98
510885,201907,72,44,28,43912.98,27944,71856.98
510890,201907,69,41,28,41916,27944,69860
510895,201907,189,111,78,110778,77846.37,188624.37
520005,201907,51,30,21,29940,20958,50898
520010,201907,274,128,146,127744,147704.8,275448.8
520013,201907,697,441,256,440118.98,257484,697602.98
520015,201907,53,40,13,40918,12974,53892
520017,201907,92,53,39,52894.4,38922,91816.4
520020,201907,21,11,10,10978,9980,20958
520025,201907,2081,1145,936,1144706.8,937122,2081828.8
520030,201907,803,430,373,431137.85,373252,804389.85
520050,201907,72,49,23,48902,23952,72854
520055,201907,46,30,16,29940,15968,45908
520060,201907,181,122,59,121756,58882,180638
520080,201907,568,410,158,413172,157684,570856
520082,201907,19,14,5,13972,4990,18962
520085,201907,97,72,25,71856,24950,96806
520090,201907,95,64,31,63872,30938,94810
520110,201907,9109,4017,5092,4031927.5,5106773.48,9138700.98
520120,201907,14,8,6,7984,5988,13972
520130,201907,786,550,236,549898.98,235528.4,785427.38
520140,201907,11956,6770,5186,6782421.8,5199598.6,11982020.4
520145,201907,48,32,16,31936,16966,48902
520150,201907,180,141,39,141716,38922,180638
520160,201907,35,26,9,25948,8982,34930
520170,201907,245,147,98,147706.93,97806.92,245513.85
520180,201907,143,72,71,71856,71856,143712
520215,201907,209,139,70,139720,71856,211576
520235,201907,72,54,18,53892,17964,71856
520250,201907,130,79,51,78842,50898,129740
520260,201907,112,71,41,70858,40918,111776
520280,201907,47,32,15,32934,14970,47904
520310,201907,39,26,13,25948,12974,38922
520320,201907,168,109,59,108782,58882,167664
520330,201907,791,423,368,423154.94,367264.98,790419.92
520340,201907,340,202,138,201596,139720.98,341316.98
520350,201907,507,234,273,240518,275448,515966
520355,201907,91,55,36,54890,35928,90818
520357,201907,27,22,5,21956,4990,26946
520360,201907,1,1,0,998,0,998
520380,201907,141,75,66,74850,66866,141716
520390,201907,262,114,148,113772,148702,262474
520393,201907,14,10,4,9980,3992,13972
520396,201907,91,58,33,57884,32934.98,90818.98
520400,201907,210,121,89,121756.4,90818,212574.4
520410,201907,195,98,97,97804.98,96806.98,194611.96
520420,201907,20,14,6,13972,5988,19960
520425,201907,301,142,159,141716,158683.4,300399.4
520430,201907,461,245,216,244510,215569.88,460079.88
520440,201907,642,444,198,445108,197604,642712
520450,201907,1920,870,1050,870256.98,1051896.9,1922153.88
520455,201907,54,39,15,38922,14970,53892
520460,201907,35,20,15,19960,14970,34930
520465,201907,27,23,4,23952,3992,27944
520470,201907,423,269,154,269460,153692,423152
520480,201907,80,48,32,47904.98,31940.9,79845.88
520485,201907,119,42,77,41916,76846.4,118762.4
520490,201907,421,313,108,313372.4,108782,422154.4
520495,201907,167,97,70,96806,69860,166666
520500,201907,177,134,43,133732,42914,176646
520505,201907,177,99,78,98802,78842,177644
520510,201907,1755,872,883,871290.66,886306.28,1757596.94
520520,201907,39,30,9,29940,8982,38922
520530,201907,233,178,55,178642,54890,233532
520540,201907,553,388,165,389220,164670,553890
520545,201907,139,85,54,84830,53892,138722
520547,201907,46,26,20,25948,19960,45908
520549,201907,1161,570,591,570856.32,589818.8,1160675.12
520551,201907,288,154,134,153692,133732.4,287424.4
520552,201907,48,30,18,29940,17964,47904
520570,201907,16,10,6,9980,5988,15968
520580,201907,289,177,112,176646,112774,289420
520590,201907,157,94,63,94810.98,62874,157684.98
520620,201907,1162,543,619,546905.38,619758,1166663.38
520630,201907,38,24,14,23952,13972,37924
520640,201907,398,236,162,236526,161676,398202
520650,201907,62,40,22,39920,21956,61876
520660,201907,39,22,17,21956.98,16966,38922.98
520670,201907,35,31,4,30938,3992,34930
520680,201907,53,35,18,34930,17964,52894
520690,201907,35,12,23,11976,22955.96,34931.96
520710,201907,36,32,4,32934,3992,36926
520725,201907,185,123,62,122754,61876,184630
520735,201907,59,41,18,40918,17964,58882
520740,201907,406,203,203,202594,203592.98,406186.98
520750,201907,36,28,8,27944,7984,35928
520753,201907,58,39,19,38922,18962,57884
520760,201907,108,74,34,74850,33932,108782
520780,201907,293,218,75,218562,75848.96,294410.96
520790,201907,151,83,68,82834,67864,150698
520800,201907,3392,1838,1554,1840314.59,1556880.88,3397195.47
520810,201907,169,124,45,123752,44910,168662
520815,201907,5,4,1,3992,998,4990
520830,201907,148,104,44,103792,43912,147704
520840,201907,359,241,118,241516,117764,359280
520850,201907,104,67,37,66866.98,36926,103792.98
520860,201907,1725,1115,610,1117760.4,609778.4,1727538.8
520870,201907,31534,15378,16156,15433091.47,16192582.16,31625673.63
520880,201907,1136,617,519,617762.4,517962.4,1135724.8
520890,201907,790,478,312,478042.98,312374,790416.98
520910,201907,1002,532,470,534928.88,469060,1003988.88
520915,201907,101,79,22,78842,21956,100798
520920,201907,402,195,207,196606,207584,404190
520929,201907,18,17,1,16966,998,17964
520940,201907,74,49,25,48902,24950,73852
520945,201907,19,11,8,10978,7984,18962
520960,201907,49,31,18,30938,17964,48902
520970,201907,329,209,120,209580.98,120758,330338.98
520980,201907,93,69,24,68862,23952,92814
520990,201907,461,314,147,313372,146706,460078
520993,201907,129,63,66,62874,65868,128742
520995,201907,243,139,104,139720.66,103792.4,243513.06
521000,201907,1586,940,646,941114.6,647703.2,1588817.8
521010,201907,671,325,346,325351.92,347306.36,672658.28
521015,201907,18,12,6,11976,5988,17964
521020,201907,1441,1023,418,1024946.98,421158.36,1446105.34
521030,201907,49,34,15,34930,14970,49900
521040,201907,934,595,339,595806.9,339320.4,935127.3
521056,201907,43,31,12,30938,11976,42914
521060,201907,133,88,45,87824,44910,132734
521080,201907,449,340,109,339321.38,108782,448103.38
521090,201907,540,340,200,339320,200598,539918
521100,201907,279,211,68,210578.98,67864,278442.98
521120,201907,1052,744,308,744508.4,310378.98,1054887.38
521130,201907,365,260,105,259480,104793.34,364273.34
521140,201907,176,96,80,95808,81836,177644
521150,201907,2726,1188,1538,1186624.36,1538917.96,2725542.32
521160,201907,31,17,14,16966,13972,30938
521170,201907,195,113,82,113772,81836,195608
521180,201907,1164,746,418,746504.2,420158.9,1166663.1
521190,201907,2537,1081,1456,1080834,1457080.98,2537914.98
521200,201907,54,40,14,39920,13972,53892
521205,201907,11,8,3,7984,2994,10978
521210,201907,138,79,59,79840,58882,138722
521220,201907,811,565,246,563870,246506.9,810376.9
521225,201907,34,22,12,21956,11976,33932
521230,201907,107,73,34,72854,33932,106786
521250,201907,6156,3566,2590,3572213.54,2593805.88,6166019.42
521260,201907,23,14,9,13972,8982,22954
521270,201907,142,111,31,110778,30938,141716
521280,201907,434,264,170,264470,169660,434130
521290,201907,28,12,16,11976,15968,27944
521295,201907,99,67,32,66866,31936,98802
521300,201907,222,118,104,117765.96,103795.34,221561.30
521305,201907,37,26,11,25948,10978,36926
521308,201907,1070,804,266,804396.82,266466.98,1070863.80
521310,201907,1337,789,548,788424.9,549899.34,1338324.24
521340,201907,21,16,5,15968,4990,20958
521350,201907,126,95,31,95808,30938,126746
521370,201907,181,125,56,124750,56886,181636
521375,201907,173,93,80,93812,79840,173652
521377,201907,50,36,14,36926,13972,50898
521380,201907,1064,692,372,691615.92,372254,1063869.92
521385,201907,12,7,5,6986,4990,11976
521390,201907,100,81,19,80838,18962,99800
521400,201907,336,223,113,222554,112774,335328
521405,201907,147,80,67,79840,66866,146706
521410,201907,64,43,21,42914,20958,63872
521440,201907,198,145,53,144710,52894,197604
521450,201907,731,413,318,413172,319360,732532
521460,201907,1169,741,428,742512,428142,1170654
521470,201907,12,8,4,7984,3992,11976
521480,201907,44,31,13,30940.94,12976.86,43917.80
521483,201907,314,176,138,176646.4,138722,315368.4
521486,201907,289,188,101,188622,101796.6,290418.6
521487,201907,23,12,11,11976,10978,22954
521490,201907,26,15,11,14970,10978,25948
521500,201907,116,74,42,73852,41916,115768
521520,201907,42,29,13,28942,12974,41916
521523,201907,672,415,257,415168,257484,672652
521525,201907,49,33,16,32934,15968,48902
521530,201907,248,133,115,132734,114770,247504
521540,201907,28,15,13,14970,12974,27944
521550,201907,88,40,48,39923.34,47908.9,87832.24
521560,201907,798,556,242,554888.4,242514.7,797403.1
521565,201907,57,37,20,36926,19960,56886
521570,201907,509,343,166,342314.4,166666.9,508981.3
521580,201907,62,40,22,39920,21956,61876
521590,201907,36,19,17,18962,16966,35928
521600,201907,24,14,10,13972,9980,23952
521630,201907,244,130,114,129740,113774.46,243514.46
521640,201907,302,158,144,158682,144710,303392
521645,201907,28,15,13,14970,12974,27944
521680,201907,220,138,82,137724,82834.6,220558.6
521690,201907,2,2,0,1996,0,1996
521710,201907,1164,566,598,566864,597802.98,1164666.98
521720,201907,546,372,174,371256,174651.34,545907.34
521730,201907,637,313,324,312375.6,325348.91,637724.51
521740,201907,894,377,517,376246.98,519962.32,896209.30
521760,201907,1705,957,748,958080.59,751495.36,1709575.95
521770,201907,819,520,299,519958,298402,818360
521800,201907,2023,1284,739,1284438.38,739526.82,2023965.20
521805,201907,32,19,13,18962,12974,31936
521810,201907,86,54,32,54890,31936,86826
521830,201907,940,671,269,670656.13,270458.98,941115.11
521839,201907,85,55,30,54890,29940,84830
521850,201907,1087,583,504,582836.01,507998.48,1090834.49
521860,201907,356,226,130,225548,129740,355288
521870,201907,71,42,29,41916,28942,70858
521878,201907,38,18,20,17964,19960,37924
521880,201907,4671,2114,2557,2113766.16,2562870.15,4676636.31
521890,201907,590,423,167,423152,167664,590816
521900,201907,289,234,55,235528,54890,290418
521910,201907,150,106,44,105788,43912,149700
521920,201907,50,25,25,24950,24950,49900
521925,201907,40,24,16,23952,15968,39920
521930,201907,1137,640,497,639725.26,499011.18,1138736.44
521935,201907,35,26,9,25948,8982,34930
521940,201907,188,96,92,96806,92814,189620
521945,201907,15,13,2,12974,1996,14970
521950,201907,8,4,4,3992,3992,7984
521960,201907,72,54,18,54890,17964,72854
521970,201907,410,269,141,268462,142714,411176
521971,201907,86,44,42,43912,42914,86826
521973,201907,34,17,17,16966,16966,33932
521975,201907,1282,665,617,665667.01,616765.1,1282432.11
521980,201907,241,167,74,166666,74850,241516
521990,201907,76,54,22,53892,21956,75848
522000,201907,285,183,102,182634,101796,284430
522005,201907,19,11,8,10978,7984,18962
522010,201907,1142,651,491,650696.98,490018,1140714.98
522015,201907,61,39,22,38922.98,21956,60878.98
522020,201907,878,497,381,498002.42,380238.8,878241.22
522026,201907,26,17,9,16966,8982,25948
522028,201907,17,13,4,12974,3992,16966
522040,201907,767,308,459,307386.46,458085.92,765472.38
522045,201907,2306,1440,866,1442110.7,866266.46,2308377.16
522050,201907,159,78,81,77844,80838,158682
522060,201907,549,352,197,354290,196606,550896
522068,201907,123,83,40,82834,40918,123752
522070,201907,10,10,0,9980,0,9980
522100,201907,41,23,18,22954,17964,40918
522108,201907,42,33,9,32934,8982,41916
522119,201907,54,28,26,27944,25948,53892
522130,201907,79,34,45,33932.98,44912.94,78845.92
522140,201907,3847,1963,1884,1971052.3,1887220.56,3858272.86
522145,201907,48,35,13,34930,12974,47904
522150,201907,69,51,18,50898,17964,68862
522155,201907,52,34,18,33932.98,17964,51896.98
522157,201907,4,3,1,2994,998,3992
522160,201907,1730,1046,684,1047900,685626.98,1733526.98
522170,201907,403,273,130,275448,129740,405188
522180,201907,36,20,16,19960,15968,35928
522185,201907,1976,792,1184,796405.2,1185624.99,1982030.19
522190,201907,42,25,17,24950,16966,41916
522200,201907,298,181,117,181636,116766,298402
522205,201907,154,107,47,106786,46906,153692
522220,201907,157,113,44,113772,43912,157684
522230,201907,32,27,5,27944,4990,32934
530010,201907,54582,28325,26257,28440055.12,26391161.49,54831216.61
110001,201908,509,406,103,406186,102794,508980
110002,201908,2752,1710,1042,1707579.38,1041913.36,2749492.74
110003,201908,89,75,14,74850,13972,88822
110004,201908,1994,1304,690,1301394.36,689618.99,1991013.35
110005,201908,437,352,85,351296.4,84830,436126.4
110006,201908,446,347,99,347304.4,98802,446106.4
110007,201908,73,61,12,60878,11976,72854
110008,201908,242,137,105,136726,104790,241516
110009,201908,837,599,238,597802.42,237525.58,835328.00
110010,201908,1782,1098,684,1095844.94,683671.92,1779516.86
110011,201908,1838,1439,399,1436122.1,398202,1834324.1
110012,201908,4152,2445,1707,2440250.12,1704624.4,4144874.52
110013,201908,776,609,167,607782,166666,774448
110014,201908,379,325,54,325348.4,53892,379240.4
110015,201908,1415,1141,274,1138719.87,273452,1412171.87
110018,201908,1102,690,412,688620,412176.96,1100796.96
110020,201908,15539,9121,6418,9104066.75,6405411.56,15509478.31
110025,201908,630,469,161,468062.4,160678.98,628741.38
110026,201908,38,27,11,26946,10978,37924
110028,201908,1680,1226,454,1223571.06,453093.2,1676664.26
110029,201908,141,127,14,126746,13972,140718
110030,201908,2433,1653,780,1649536.28,779439.8,2428976.08
110032,201908,293,226,67,226546.37,66866.99,293413.36
110033,201908,670,497,173,496006.4,172654.98,668661.38
110034,201908,366,274,92,273472.17,91816,365288.17
110037,201908,100,88,12,87824,11976,99800
110040,201908,358,246,112,245508,111776,357284
110045,201908,925,645,280,643711.2,279440,923151.2
110050,201908,90,80,10,79840.4,9980,89820.4
110060,201908,79,45,34,44910,33932,78842
110070,201908,112,71,41,70858,40918.4,111776.4
110080,201908,416,248,168,247504,167664,415168
110090,201908,31,25,6,24950,5988,30938
110092,201908,100,53,47,52894,46906,99800
110094,201908,193,140,53,139720,52894,192614
110100,201908,30,25,5,24950,4990,29940
110110,201908,65,39,26,38922,25948,64870
110120,201908,72,61,11,60878,10978,71856
110130,201908,297,245,52,244510.4,51896,296406.4
110140,201908,240,164,76,163672,75848,239520
110143,201908,49,41,8,40918,7984,48902
110145,201908,24,19,5,18962,4990,23952
110146,201908,25,12,13,11976,12974,24950
110147,201908,36,27,9,26946,8982,35928
110148,201908,35,24,11,23952,10978,34930
110149,201908,307,216,91,215568,90818,306386
110150,201908,133,104,29,103792,28942,132734
110155,201908,7,6,1,5988,998,6986
110160,201908,64,53,11,52894,10978,63872
110170,201908,205,166,39,165668,38922,204590
110175,201908,62,47,15,46906,14970,61876
110180,201908,92,79,13,78842,12974,91816
120001,201908,151,103,48,102794,47905.98,150699.98
120005,201908,198,120,78,119760,77844,197604
120010,201908,1074,678,396,676645.67,395208.98,1071854.65
120013,201908,149,102,47,101796,46906,148702
120017,201908,93,57,36,56886,35928,92814
120020,201908,3594,2892,702,2886317.63,701594,3587911.63
120025,201908,546,313,233,312374.98,233532,545906.98
120030,201908,1073,910,163,909179,162674,1071853
120032,201908,45,39,6,38922,5988,44910
120033,201908,217,192,25,191616,24950,216566
120034,201908,166,122,44,121756,43912,165668
120035,201908,35,26,9,25948,8982,34930
120038,201908,386,251,135,250498,134730,385228
120039,201908,27,26,1,25948,998,26946
120040,201908,14079,9725,4354,9713865.4,4351360.41,14065225.81
120042,201908,45,40,5,39920,4990,44910
120043,201908,10,3,7,2994,6986,9980
120045,201908,551,357,194,356286.98,193612.98,549899.96
120050,201908,1278,984,294,982033.68,294410,1276443.68
120060,201908,1467,1202,265,1199596,265468,1465064
120070,201908,462,332,130,331337.2,130738,462075.2
120080,201908,172,106,66,105788,65868,171656
130002,201908,151,110,41,109780,40918,150698
130006,201908,73,43,30,42914,30938,73852
130008,201908,136,73,63,72854,62874,135728
130010,201908,140,79,61,78842,60878,139720
130014,201908,260,187,73,186626,72854,259480
130020,201908,89,48,41,47904,40918,88822
130030,201908,930,554,376,552892,375248,928140
130040,201908,345,175,170,174650,169660.36,344310.36
130050,201908,591,310,281,309380,280438,589818
130060,201908,869,594,275,592812,274450,867262
130063,201908,594,333,261,332334,260478,592812
130068,201908,187,122,65,121756,64870,186626
130070,201908,1314,899,415,897202,414170,1311372
130080,201908,688,448,240,447104,240518.98,687622.98
130083,201908,67,37,30,36926,29940,66866
130090,201908,353,179,174,178642,173652,352294
130100,201908,1144,497,647,496006,645706,1141712
130110,201908,740,304,436,303392,436126,739518
130115,201908,166,69,97,68862,96806,165668
130120,201908,1629,1052,577,1049896,576844,1626740
130130,201908,612,423,189,422154,188622,610776
130140,201908,1527,1180,347,1178638,346306,1524944
130150,201908,416,361,55,360278,54890,415168
130160,201908,457,262,195,261476,194610,456086
130165,201908,32,26,6,25948,5988,31936
130170,201908,968,683,285,681590.08,284430,966020.08
130180,201908,168,110,58,109780,57884,167664
130185,201908,2409,1156,1253,1153688,1250554.68,2404242.68
130190,201908,3498,2211,1287,2208575.28,1286422,3494997.28
130195,201908,279,224,55,223552,54890,278442
130200,201908,178,82,96,81836,95808,177644
130210,201908,76,40,36,39920,35928,75848
130220,201908,178,121,57,120758,56886,177644
130230,201908,320,204,116,204590,115768,320358
130240,201908,1388,888,500,888220.99,499000,1387220.99
130250,201908,4792,3077,1715,3070846.4,1711570,4782416.4
130255,201908,421,206,215,205588,214570,420158
130260,201908,55882,27094,28788,27049122.53,28736736.66,55785859.19
130270,201908,1568,1049,519,1046991.82,517962,1564953.82
130280,201908,125,72,53,71856,52894,124750
130290,201908,2125,1509,616,1505982,614768,2120750
130300,201908,445,314,131,313372,130738,444110
130310,201908,903,467,436,467064,435128,902192
130320,201908,504,274,230,273452,229540,502992
130330,201908,727,448,279,447104,278442,725546
130340,201908,3514,2065,1449,2060870.8,1446102.8,3506973.6
130350,201908,458,295,163,294410,162674,457084
130353,201908,873,379,494,378242,494010,872252
130356,201908,841,391,450,390218,449100,839318
130360,201908,85,60,25,59880,24950,84830
130370,201908,687,526,161,524948,160678,685626
130380,201908,703,532,171,530936,170658,701594
130390,201908,478,379,99,378242,98802,477044
130395,201908,168,40,128,39920,128742,168662
130400,201908,65,44,21,43912,20958,64870
130406,201908,2058,1271,787,1268458.4,785426.4,2053884.8
130410,201908,456,212,244,212574,246565.88,459139.88
130420,201908,3108,2521,587,2515958.9,586824,3102782.9
130423,201908,156,77,79,76846,78842,155688
130426,201908,150,84,66,83832,65868,149700
130430,201908,400,256,144,255488,143712,399200
130440,201908,208,70,138,69860,137724,207584
140002,201908,32,10,22,9980,21956,31936
140005,201908,200,123,77,122754,76846,199600
140010,201908,10390,6874,3516,6864255.33,3510987.24,10375242.57
140015,201908,126,58,68,58882,67864,126746
140017,201908,115,81,34,80838,33932,114770
140020,201908,466,314,152,313372,152694,466066
140023,201908,45,24,21,23952.54,20958,44910.54
140028,201908,18,11,7,10978,6986,17964
140030,201908,346,249,97,248502,96806,345308
140040,201908,60,43,17,42914,16966,59880
140045,201908,229,102,127,101796,126746,228542
140047,201908,627,424,203,423152.8,202594,625746.8
140050,201908,147,95,52,94810,51896,146706
140060,201908,41,29,12,28942,11976,40918
140070,201908,33,30,3,29940,2994,32934
150010,201908,4634,2922,1712,2916156.4,1708576.4,4624732.8
150013,201908,160,116,44,115768.98,43912,159680.98
150020,201908,1062,584,478,583830,477044,1060874
150030,201908,680,286,394,285428,393212,678640
150034,201908,196,128,68,127744,67864,195608
150040,201908,1399,835,564,833330,562872,1396202
150050,201908,616,365,251,364270,250498,614768
150060,201908,4734,3078,1656,3071761.68,1654684.98,4726446.66
150070,201908,316,144,172,143712,171656,315368
150080,201908,14245,7168,7077,7153673.31,7063854.34,14217527.65
150085,201908,399,260,139,259480,138722,398202
150090,201908,755,640,115,638720,114770,753490
150095,201908,341,217,124,216566,123752,340318
150100,201908,58,39,19,38922,18962,57884
150110,201908,174,89,85,88822,84830,173652
150120,201908,416,305,111,304390,110778,415168
150125,201908,54,22,32,21956,31936,53892
150130,201908,1965,1057,908,1055884,906184,1962068
150140,201908,53570,25155,28415,25108819.4,28362544.12,53471363.52
150145,201908,182,102,80,101796,79840,181636
150150,201908,2853,1316,1537,1313368,1533926.8,2847294.8
150157,201908,402,283,119,282434.8,118762,401196.8
150160,201908,127,97,30,96806,29940,126746
150170,201908,3609,2719,890,2713562,888220,3601782
150172,201908,326,224,102,223552,101796,325348
150175,201908,82,51,31,50898,30938,81836
150178,201908,779,521,258,519958.4,257484,777442.4
150180,201908,3096,1532,1564,1529934.5,1560932.28,3090866.78
150190,201908,336,214,122,213572,121756,335328
150195,201908,114,55,59,54890,58882,113772
150200,201908,195,95,100,94810,99800,194610
150210,201908,3094,2528,566,2522944,565866.99,3088810.99
150215,201908,546,358,188,357284,187624.4,544908.4
150220,201908,3663,2506,1157,2500989.52,1154687.4,3655676.92
150230,201908,1158,945,213,943110.45,213572,1156682.45
150240,201908,5935,3506,2429,3498990.89,2429133.97,5928124.86
150250,201908,31,15,16,14970,15968,30938
150260,201908,85,53,32,52894,31936,84830
150270,201908,2300,1501,799,1499055.88,797402.8,2296458.68
150275,201908,533,338,195,337324,194610,531934
150276,201908,107,49,58,48902,57884,106786
150277,201908,759,330,429,329340.98,429140,758480.98
150280,201908,329,211,118,210578,117764,328342
150285,201908,87,43,44,42914,43912,86826
150290,201908,956,594,362,592812,361276.4,954088.4
150293,201908,647,311,336,310378,335328,645706
150295,201908,474,217,257,216566,256486.4,473052.4
150300,201908,77,40,37,40918,36926,77844
150304,201908,168,107,61,106786,60878,167664
150307,201908,394,328,66,327344,65868,393212
150309,201908,582,420,162,419160.98,161679.6,580840.58
150310,201908,237,161,76,160678,75848,236526
150320,201908,1989,1391,598,1390214,596804,1987018
150330,201908,2027,1185,842,1182630,840316,2022946
150340,201908,200,134,66,133732,65868,199600
150345,201908,613,345,268,344310,267464,611774
150350,201908,401,320,81,319360,80838,400198
150360,201908,4568,2937,1631,2931127.49,1630732,4561859.49
150370,201908,799,560,239,558880.98,238522.98,797403.96
150375,201908,186,98,88,98802,87824,186626
150380,201908,1452,992,460,990016,459080,1449096
150390,201908,769,444,325,443112.99,324350,767462.99
150400,201908,105,87,18,86826,17964,104790
150405,201908,1232,810,422,808380.92,421156,1229536.92
150410,201908,124,82,42,81836,41916,123752
150420,201908,7385,4097,3288,4089978.83,3282462.98,7372441.81
150430,201908,559,377,182,376246,181636,557882
150440,201908,548,336,212,335328,211576,546904
150442,201908,2246,1212,1034,1209576.58,1031932,2241508.58
150445,201908,525,342,183,341316,182634,523950
150450,201908,238,118,120,117764,119760,237524
150460,201908,743,564,179,562872,178701.88,741573.88
150470,201908,1309,804,505,802392,503990,1306382
150475,201908,221,171,50,170658,49900,220558
150480,201908,1272,899,373,897202,372254,1269456
150490,201908,590,325,265,324350,264470,588820
150495,201908,323,233,90,232534,90818,323352
150497,201908,299,202,97,201596,96806,298402
150500,201908,203,133,70,132734,69860,202594
150503,201908,936,473,463,472054.4,462074.98,934129.38
150506,201908,974,650,324,648700,323352,972052
150510,201908,1257,711,546,709578.4,544908,1254486.4
150520,201908,272,186,86,185628,85828,271456
150530,201908,1656,914,742,912172.5,740516,1652688.5
150540,201908,233,165,68,164670,67864,232534
150543,201908,777,431,346,430138,346306,776444
150548,201908,477,334,143,333332,142714,476046
150549,201908,60,43,17,42914,16966,59880
150550,201908,2815,1499,1316,1496002.5,1313368.4,2809370.9
150553,201908,3285,1962,1323,1959075.2,1323348,3282423.2
150555,201908,143,76,67,75848,66866,142714
150560,201908,19,12,7,11976,6986,18962
150563,201908,88,45,43,44910,42914,87824
150565,201908,168,104,64,103792,63872,167664
150570,201908,411,275,136,274509.88,135728,410237.88
150580,201908,1568,714,854,713570,852292,1565862
150590,201908,808,525,283,523950,282434,806384
150600,201908,461,278,183,277444,183632,461076
150610,201908,139,120,19,119760,18962,138722
150611,201908,115,79,36,78842,35928,114770
150613,201908,3203,1972,1231,1969054,1228538.98,3197592.98
150616,201908,498,294,204,293412.5,203592,497004.5
150618,201908,1285,703,582,701594.98,580836,1282430.98
150619,201908,394,301,93,300398,92814,393212
150620,201908,1253,751,502,749498,500996,1250494
150630,201908,293,195,98,194610,97804,292414
150635,201908,485,208,277,207584,277444,485028
150640,201908,54,28,26,27944,25948,53892
150650,201908,2333,1379,954,1376492.4,953091.39,2329583.79
150655,201908,245,186,59,185628,58882,244510
150658,201908,94,52,42,51896,41916,93812
150660,201908,501,351,150,350298,149700,499998
150670,201908,1008,372,636,371256.98,634728.98,1005985.96
150680,201908,9639,5288,4351,5277426.8,4343297.96,9620724.76
150690,201908,16,9,7,8982,6986,15968
150700,201908,487,325,162,324350,161676,486026
150710,201908,280,161,119,160678,118762,279440
150715,201908,832,513,319,511974.98,318362,830336.98
150720,201908,414,323,91,322354,90818,413172
150730,201908,975,524,451,522952.98,450098,973050.98
150740,201908,218,150,68,149700,67864,217564
150745,201908,799,440,359,439120,358282,797402
150746,201908,54,34,20,33932,19960,53892
150747,201908,241,190,51,189620,50898,240518
150750,201908,135,78,57,77844,56886,134730
150760,201908,1768,1160,608,1157680,606784,1764464
150770,201908,383,210,173,210578,172654,383232
150775,201908,97,46,51,45908,50898,96806
150780,201908,186,104,82,103792,81836,185628
150790,201908,841,468,373,467064,373252,840316
150795,201908,1498,898,600,896204,598800,1495004
150796,201908,362,213,149,212574,148702,361276
150797,201908,305,163,142,162674,141716,304390
150800,201908,1433,863,570,861274,568860,1430134
150803,201908,581,480,101,479040,100798,579838
150805,201908,185,118,67,117764.61,66866.99,184631.60
150808,201908,997,547,450,545906,449100,995006
150810,201908,3344,2338,1006,2333325.41,1004128.12,3337453.53
150812,201908,432,235,197,234530,196606,431136
150815,201908,966,634,332,632732,331336,964068
150820,201908,1543,950,593,948100,591873.88,1539973.88
150830,201908,772,561,211,559878,210578,770456
150835,201908,196,118,78,117764,77844,195608
150840,201908,1368,870,498,868260.2,497004,1365264.2
160005,201908,52,31,21,30938,20958,51896
160010,201908,184,118,66,117764,65868.99,183632.99
160015,201908,116,69,47,68862,46906,115768
160020,201908,126,73,53,72854,52894,125748
160021,201908,43,24,19,23952,18962,42914
160023,201908,124,79,45,78842,44910,123752
160025,201908,28,13,15,12974,14970,27944
160027,201908,1486,864,622,862272.5,620756,1483028.5
160030,201908,15578,8146,7432,8131754.49,7419201.69,15550956.18
160040,201908,289,166,123,165668,122754,288422
160050,201908,711,363,348,362274,347364,709638
160053,201908,315,183,132,182634.4,131736,314370.4
160055,201908,29,22,7,21956,6986,28942
160060,201908,6499,3472,3027,3469049.89,3020947.39,6489997.28
160070,201908,174,106,68,105788,67864,173652
160080,201908,90,46,44,45908,43912,89820
170025,201908,25,14,11,13972,10978,24950
170030,201908,223,182,41,181636.88,40918,222554.88
170035,201908,228,108,120,107784,119760,227544
170040,201908,180,141,39,140757.92,38922,179679.92
170070,201908,325,201,124,200598,123752,324350
170100,201908,359,260,99,259480,98802,358282
170105,201908,59,47,12,46906,11976,58882
170110,201908,105,66,39,65868,38922,104790
170130,201908,66,33,33,32934,32934.4,65868.4
170190,201908,96,61,35,60878,34930,95808
170200,201908,383,262,121,261476.98,120758,382234.98
170210,201908,6031,3235,2796,3228532.5,2794402.61,6022935.11
170215,201908,109,48,61,47904,60878,108782
170220,201908,1411,1047,364,1044906,364270,1409176
170230,201908,151,100,51,99800,50898,150698
170240,201908,531,355,176,354290.8,175648,529938.8
170255,201908,1112,898,214,896204,213572,1109776
170270,201908,39,28,11,27944,10978,38922
170290,201908,106,79,27,78842,26946,105788
170300,201908,89,60,29,59880,28942,88822
170305,201908,49,39,10,38922,9980,48902
170307,201908,63,48,15,47904,14970,62874
170310,201908,108,60,48,59880,47904,107784
170320,201908,24,18,6,17964,5988,23952
170330,201908,21,20,1,19960,998,20958
170360,201908,28,17,11,16966,10978,27944
170370,201908,121,64,57,63872,56886,120758
170380,201908,81,63,18,62874,17964,80838
170382,201908,44,39,5,38922,4990,43912
170384,201908,141,106,35,105788,34930,140718
170386,201908,60,26,34,25948,33932,59880
170388,201908,48,19,29,18962,28942,47904
170389,201908,26,21,5,20958,4990,25948
170390,201908,62,36,26,35928.98,25948.98,61877.96
170410,201908,32,23,9,23719.13,8982,32701.13
170460,201908,17,12,5,11976,4990,16966
170510,201908,33,27,6,26946,5988,32934
170550,201908,1547,911,636,909178,635765.92,1544943.92
170555,201908,115,83,32,82834,31936,114770
170560,201908,98,69,29,68862,28942,97804
170600,201908,36,18,18,17964,17964,35928
170610,201908,190,102,88,101796,87826.36,189622.36
170625,201908,35,20,15,19960,14970,34930
170650,201908,78,59,19,58882,18962,77844
170700,201908,569,435,134,434130.5,133732,567862.5
170710,201908,160,99,61,98802,60878.98,159680.98
170720,201908,86,69,17,68862,16966,85828
170730,201908,77,46,31,45908,30938,76846
170740,201908,82,60,22,59880,21956,81836
170755,201908,67,36,31,35928,30938,66866
170765,201908,137,71,66,70858.8,65868,136726.8
170770,201908,218,133,85,132734,84830,217564
170820,201908,588,391,197,390218,196606.8,586824.8
170825,201908,33,18,15,17964,14970,32934
170830,201908,84,67,17,66866,16966,83832
170900,201908,186,145,41,144710,40918,185628
170930,201908,893,481,412,480039.12,412174.4,892213.52
170950,201908,3085,1412,1673,1410175.38,1670654.05,3080829.43
170980,201908,17,9,8,8982,7984,16966
171050,201908,147,117,30,116766,29940,146706
171070,201908,38,32,6,31936,5988,37924
171090,201908,44,33,11,32934,10978,43912
171110,201908,20,12,8,11976,7984,19960
171150,201908,39,19,20,18962,19960,38922
171180,201908,23,13,10,12974,9980,22954
171190,201908,144,84,60,83832,60878,144710
171195,201908,63,52,11,51896,10978,62874
171200,201908,50,26,24,25948,23952,49900
171215,201908,5,3,2,2994,1996,4990
171240,201908,55,43,12,42914,11976,54890
171245,201908,56,50,6,49900,5988,55888
171250,201908,72,41,31,40918,30938,71856
171270,201908,15,11,4,10978,3992,14970
171280,201908,41,36,5,35928,4990,40918
171320,201908,988,585,403,583830.48,403192,987022.48
171330,201908,426,212,214,211576,213572,425148
171360,201908,84,62,22,61876,21956,83832
171370,201908,28,15,13,14970,12974,27944
171380,201908,134,112,22,111776,21956,133732
171395,201908,53,34,19,33932,18962,52894
171420,201908,286,188,98,187624,98802,286426
171430,201908,70,58,12,57884,11976,69860
171488,201908,177,100,77,99800,76846,176646
171500,201908,57,31,26,30938,25948,56886
171510,201908,68,45,23,44910,22954,67864
171515,201908,41,34,7,33932,6986.4,40918.4
171525,201908,29,27,2,26946,1996,28942
171550,201908,14,10,4,9980,3992,13972
171570,201908,56,29,27,28942,26946,55888
171575,201908,317,205,112,204590,111776,316366
171610,201908,1740,894,846,892277.88,846313.8,1738591.68
171620,201908,136,95,41,94810,40918,135728
171630,201908,57,31,26,30938,25948,56886
171650,201908,270,184,86,183632,85828,269460
171660,201908,264,147,117,146706,117764.4,264470.4
171665,201908,54,38,16,37924,15968,53892
171670,201908,425,252,173,251496.5,172654,424150.5
171700,201908,66,59,7,58882,6986,65868
171720,201908,26,10,16,9980,15968,25948
171750,201908,101,55,46,54890,45908,100798
171780,201908,78,62,16,61876,15968,77844
171790,201908,78,68,10,67864,9980,77844
171800,201908,36,28,8,27944,7984,35928
171820,201908,2064,1199,865,1198598.44,864269.78,2062868.22
171830,201908,36,29,7,28942,6986,35928
171840,201908,61,40,21,39920,20958,60878
171845,201908,30,18,12,17964,11976,29940
171850,201908,39,29,10,28942,9980,38922
171855,201908,79,63,16,62874,15968,78842
171865,201908,8,7,1,6986,998,7984
171870,201908,33,24,9,23952,8982,32934
171875,201908,79,55,24,54890,23952,78842
171880,201908,32,20,12,19960,11976,31936
171884,201908,50,27,23,26946,22954,49900
171886,201908,123,50,73,49900,72854,122754
171888,201908,28,22,6,21956,5988,27944
171889,201908,20,14,6,13972,5988,19960
171890,201908,55,45,10,44910,9980,54890
171900,201908,42,28,14,27944,13972,41916
172000,201908,41,34,7,33932,6986,40918
172010,201908,45,37,8,36926,7984,44910
172015,201908,27,18,9,17964.58,8982,26946.58
172020,201908,137,89,48,88822,47904,136726
172025,201908,33,21,12,20958,11976,32934
172030,201908,40,24,16,23952,15968.98,39920.98
172049,201908,78,50,28,49900,27944,77844
172065,201908,142,91,51,90818,50898,141716
172080,201908,100,67,33,66866,32934,99800
172085,201908,26,14,12,13972,11976,25948
172090,201908,413,325,88,324350.18,87824,412174.18
172093,201908,21,18,3,17964,2994,20958
172097,201908,18,11,7,10978,6986.4,17964.4
172100,201908,4910,2818,2092,2812406.07,2089813.98,4902220.05
172110,201908,80,51,29,50898,28942,79840
172120,201908,1673,1430,243,1427142.15,242574,1669716.15
172125,201908,4,4,0,3992,0,3992
172130,201908,18,13,5,12974,4990,17964
172208,201908,197,124,73,123752,72854,196606
172210,201908,379,185,194,184630,193612.4,378242.4
210005,201908,2948,1862,1086,1859274.75,1083832.8,2943107.55
210010,201908,172,92,80,91816,79840,171656
210015,201908,38,28,10,27944,9980,37924
210020,201908,344,188,156,187624,155688,343312
210030,201908,333,218,115,217564,114770.98,332334.98
210040,201908,142,111,31,110778,30938,141716
210043,201908,262,190,72,189620,71856,261476
210047,201908,559,315,244,314370,243512,557882
210050,201908,291,216,75,215568,74850,290418
210055,201908,45,34,11,33932,10978,44910
210060,201908,552,446,106,445108,105788,550896
210070,201908,423,321,102,320358,101796,422154
210080,201908,112,102,10,101796,9980,111776
210083,201908,307,150,157,149700,156686,306386
210087,201908,37,27,10,26946,9980,36926
210090,201908,456,324,132,323352,131736,455088
210095,201908,465,344,121,343312,120758,464070
210100,201908,693,542,151,540916,150698,691614
210110,201908,136,84,52,83832,51896,135728
210120,201908,5222,4033,1189,4024943.08,1186623.53,5211566.61
210125,201908,207,125,82,124750,81836,206586
210130,201908,501,280,221,279440,220617.88,500057.88
210135,201908,31,20,11,19960,10978,30938
210140,201908,4400,3478,922,3471104.48,921154,4392258.48
210150,201908,378,244,134,243512,133732,377244
210160,201908,3366,2844,522,2838352.47,520956,3359308.47
210170,201908,1173,941,232,939118,231536,1170654
210173,201908,130,110,20,109780,19960,129740
210177,201908,409,215,194,214570,193612,408182
210180,201908,31,17,14,16966,13972,30938
210190,201908,419,281,138,280438,137724,418162
210193,201908,2,1,1,998,998,1996
210197,201908,80,56,24,55888,23952,79840
210200,201908,637,515,122,513970,122754,636724
210203,201908,244,163,81,162674,80838,243512
210207,201908,378,299,79,298402,78842,377244
210210,201908,767,712,55,710576,54890,765466
210215,201908,76,67,9,66866,8982,75848
210220,201908,402,337,65,336326,64870,401196
210230,201908,310,243,67,242514,66866,309380
210232,201908,1442,960,482,958080,481036,1439116
210235,201908,161,125,36,124750,35928,160678
210237,201908,41,24,17,23952,16966,40918
210240,201908,91,76,15,75848,14970,90818
210250,201908,183,154,29,153692,28942,182634
210255,201908,353,264,89,264470,88822,353292
210260,201908,404,271,133,270458,132734,403192
210270,201908,666,440,226,439120,225548,664668
210275,201908,54,42,12,41916,11976,53892
210280,201908,1057,695,362,693610.48,361276,1054886.48
210290,201908,522,355,167,354290,166666,520956
210300,201908,5590,3475,2115,3468130.23,2110830.85,5578961.08
210310,201908,109,76,33,75848,32934,108782
210312,201908,117,80,37,79840,36926,116766
210315,201908,106,82,24,81836,23952,105788
210317,201908,122,91,31,90818,30938,121756
210320,201908,2350,1974,376,1970112,375248,2345360
210325,201908,129,91,38,90818,37924.4,128742.4
210330,201908,4895,2709,2186,2704580.7,2182626,4887206.7
210340,201908,1314,966,348,965066,347305.94,1312371.94
210350,201908,620,520,100,518960,99800,618760
210355,201908,146,117,29,116766,28942,145708
210360,201908,2424,1611,813,1607778.06,812372.4,2420150.46
210370,201908,1237,584,653,582832,651694,1234526
210375,201908,189,96,93,95808,92814,188622
210380,201908,707,540,167,538920,166666,705586
210390,201908,198,165,33,165668,32934,198602
210400,201908,408,352,56,351296,55948,407244
210405,201908,1004,699,305,697602,305388,1002990
210407,201908,52,42,10,41916,9980,51896
210408,201908,60,54,6,53892,5988,59880
210409,201908,330,285,45,284430,44910,329340
210410,201908,428,335,93,334330,92814,427144
210420,201908,200,164,36,163672,35928,199600
210430,201908,43,29,14,28942,13972,42914
210440,201908,348,225,123,224550,122754,347304
210450,201908,155,119,36,118762,35928,154690
210455,201908,229,125,104,124750.4,103792,228542.4
210460,201908,321,209,112,208582,111776,320358
210462,201908,66,55,11,54890,10978,65868
210465,201908,151,109,42,108782,41916,150698
210467,201908,534,389,145,388222,144710.98,532932.98
210470,201908,50,43,7,42914,6986,49900
210480,201908,1291,926,365,924148,364270.75,1288418.75
210490,201908,207,135,72,134730,72854,207584
210500,201908,543,313,230,312374,229540,541914
210510,201908,576,455,121,454090,120758,574848
210515,201908,397,235,162,234530,161676,396206
210520,201908,410,364,46,363272,45908,409180
210530,201908,9385,5064,4321,5053917.36,4313399.54,9367316.90
210535,201908,129,96,33,95808,32934,128742
210540,201908,1513,967,546,965066.2,544908,1509974.2
210542,201908,1198,619,579,617762,577842.8,1195604.8
210545,201908,17,16,1,15968,998,16966
210547,201908,133,116,17,115768,16966,132734
210550,201908,702,507,195,506026.44,195608,701634.44
210560,201908,173,150,23,149700,22954,172654
210565,201908,25,20,5,19960,4990,24950
210570,201908,1335,1075,260,1072850.84,259480,1332330.84
210580,201908,116,100,16,99800,15968,115768
210590,201908,757,613,144,611774,143712,755486
210592,201908,32,29,3,28942,2994,31936
210594,201908,110,93,17,92814,16966,109780
210596,201908,94,79,15,78842,14970,93812
210598,201908,127,94,33,93812,32934,126746
210600,201908,331,282,49,281436,48902,330338
210610,201908,255,237,18,236526,17964,254490
210620,201908,42,26,16,25948,15968,41916
210630,201908,71,68,3,67864,2994,70858
210632,201908,1048,717,331,715566,330338,1045904
210635,201908,22,19,3,18962,2994,21956
210637,201908,99,73,26,72854,25948,98802
210640,201908,587,514,73,512972,72854,585826
210650,201908,401,330,71,329340,70858,400198
210660,201908,395,294,101,293412,100798,394210
210663,201908,26,17,9,16966,8982,25948
210667,201908,104,37,67,36926,66866,103792
210670,201908,260,232,28,231536,27944,259480
210675,201908,555,303,252,302394,251496,553890
210680,201908,217,143,74,142714,73852,216566
210690,201908,636,510,126,508980,125748,634728
210700,201908,173,131,42,130738,41916,172654
210710,201908,270,161,109,161676,108782,270458
210720,201908,135,117,18,116766,17964,134730
210725,201908,69,61,8,60878,7984,68862
210730,201908,25,18,7,17964,6986,24950
210735,201908,395,277,118,276446,117764.4,394210.4
210740,201908,549,468,81,467064,80838,547902
210745,201908,156,116,40,115768,39920,155688
210750,201908,2399,1191,1208,1188618.5,1205644.28,2394262.78
210760,201908,261,199,62,198602,61876,260478
210770,201908,396,312,84,313471.8,83832,397303.8
210780,201908,423,313,110,312374,109780,422154
210790,201908,186,148,38,147704,37924,185628
210800,201908,169,129,40,128742,39920,168662
210805,201908,52,48,4,47904,3992,51896
210810,201908,477,381,96,380238,96806,477044
210820,201908,2196,1824,372,1821351.76,371256,2192607.76
210825,201908,165,92,73,91816,72854,164670
210830,201908,753,485,268,484030,267464,751494
210840,201908,204,141,63,140718,62874,203592
210845,201908,249,168,81,167664,80838,248502
210850,201908,796,531,265,529938,264470,794408
210860,201908,3922,2141,1781,2137716.9,1777497.88,3915214.78
210870,201908,469,365,104,364270,103792,468062
210880,201908,72,55,17,54890,16966,71856
210890,201908,324,275,49,274450,48902,323352
210900,201908,604,395,209,394210,208582,602792
210905,201908,65,32,33,31936,32934,64870
210910,201908,1986,1490,496,1488019.48,495008,1983027.48
210920,201908,187,64,123,63872,122754,186626
210923,201908,86,62,24,61876,23952,85828
210927,201908,419,188,231,187624,230538,418162
210930,201908,72,58,14,57884,13972,71856
210940,201908,88,69,19,68862,18962,87824
210945,201908,203,102,101,101796,100798,202594
210950,201908,529,395,134,394210,134730,528940
210955,201908,74,50,24,49900,23952,73852
210960,201908,2273,1079,1194,1077840,1191612,2269452
210970,201908,112,99,13,98802,12974,111776
210975,201908,84,77,7,76846,6986,83832
210980,201908,1124,527,597,525946,595806.4,1121752.4
210990,201908,4171,2677,1494,2672645,1491012,4163657
211000,201908,1346,1081,265,1078838.4,264470,1343308.4
211003,201908,886,612,274,610776,273452,884228
211010,201908,498,442,56,441116,55888,497004
211020,201908,1502,599,903,597802,902192,1499994
211023,201908,32,27,5,26946,4990,31936
211027,201908,76,55,21,54890,20958,75848
211030,201908,382,269,113,268462,112774,381236
211040,201908,308,251,57,250498.4,56886,307384.4
211050,201908,1173,771,402,769517.88,401196.4,1170714.28
211060,201908,663,567,96,565906.8,95808,661714.8
211065,201908,22,18,4,17964,3992,21956
211070,201908,915,755,160,753490.66,160678,914168.66
211080,201908,84,80,4,79840,3992,83832
211085,201908,55,29,26,28942,25948,54890
211090,201908,91,73,18,72854,17964,90818
211100,201908,494,401,93,400198,92814.4,493012.4
211102,201908,249,171,78,170658,77844,248502
211105,201908,223,157,66,156686,65868,222554
211107,201908,134,80,54,79840,53931.92,133771.92
211110,201908,827,540,287,538920,286426.98,825346.98
211120,201908,5563,2679,2884,2674642.2,2879270.76,5553912.96
211125,201908,31,23,8,22954,7984,30938
211130,201908,43573,19394,24179,19360312.36,24138753.25,43499065.61
211140,201908,414,357,57,356286.99,56886,413172.99
211150,201908,1278,827,451,825346,450099.39,1275445.39
211153,201908,165,99,66,98802,65868,164670
211157,201908,66,53,13,52894,12974,65868
211160,201908,710,604,106,602792,105788,708580
211163,201908,0,,,,,0.0
211167,201908,11,10,1,9980,998,10978
211170,201908,428,313,115,312374,114770,427144
211172,201908,120,83,37,82834,36926,119760
211174,201908,262,160,102,159680,101796,261476
211176,201908,504,374,130,373252.4,129740,502992.4
211178,201908,91,60,31,59880,30938,90818
211180,201908,208,167,41,166666,40918,207584
211190,201908,69,64,5,63872,4990,68862
211195,201908,33,24,9,23952,8982,32934
211200,201908,150,129,21,128742,20958,149700
211210,201908,467,325,142,324350,141716,466066
211220,201908,4062,2354,1708,2349294.53,1704586.19,4053880.72
211223,201908,95,91,4,90818,3992,94810
211227,201908,72,54,18,53892,17964,71856
211230,201908,760,623,137,621754,136785.88,758539.88
211240,201908,406,310,96,309380,95808,405188
211245,201908,192,93,99,92814,98802,191616
211250,201908,1599,1378,221,1375245.59,220558.94,1595804.53
211260,201908,828,669,159,667662,158682,826344
211270,201908,2037,1643,394,1639714.4,393212.8,2032927.2
211280,201908,1815,1150,665,1147700,663670,1811370
211285,201908,199,120,79,119760,79840,199600
211290,201908,683,475,208,474050,207584,681634
211300,201908,786,620,166,618820,165668,784488
211400,201908,1572,945,627,943110,625746,1568856
220005,201908,17,16,1,15968,998,16966
220010,201908,90,69,21,68862,20958,89820
220020,201908,672,539,133,537922,132734,670656
220025,201908,110,107,3,106786,2994,109780
220027,201908,39,32,7,31936,6986,38922
220030,201908,106,87,19,86826,18962,105788
220040,201908,1211,922,289,920156.6,288422,1208578.6
220045,201908,36,26,10,25948,9980,35928
220050,201908,677,570,107,568861.08,106786,675647.08
220060,201908,169,149,20,148702,19960,168662
220070,201908,108,99,9,98802,8982,107784
220080,201908,16,14,2,13972,1996,15968
220090,201908,33,27,6,26946,5988,32934
220095,201908,2,1,1,998,998,1996
220100,201908,20,16,4,15968,3992,19960
220105,201908,24,23,1,22954.4,998,23952.4
220110,201908,221,204,17,203592,16966,220558
220115,201908,39,38,1,37924,998,38922
220117,201908,23,21,2,20958,1996,22954
220120,201908,1483,1107,376,1104786,375248,1480034
220130,201908,29,29,0,28942,0,28942
220140,201908,100,80,20,79840,19960,99800
220150,201908,485,352,133,351296,132734,484030
220155,201908,5,5,0,4990,0,4990
220157,201908,18,15,3,14970,2994,17964
220160,201908,83,73,10,72854,9980,82834
220170,201908,32,32,0,31936,0,31936
220173,201908,7,7,0,6986,0,6986
220177,201908,6,6,0,5988,0,5988
220180,201908,67,67,0,66866,0,66866
220190,201908,1065,956,109,954088,108782,1062870
220191,201908,43,38,5,37924,4990,42914
220192,201908,73,70,3,69860,2994,72854
220194,201908,47,45,2,44910,1996,46906
220196,201908,94,79,15,79840,14970,94810
220198,201908,3,2,1,1996,998,2994
220200,201908,417,350,67,349300.5,66866,416166.5
220202,201908,38,34,4,33932,3992,37924
220205,201908,44,40,4,39920,3992,43912
220207,201908,11,11,0,10978,0,10978
220208,201908,77,42,35,41916,34930,76846
220209,201908,30,27,3,26946,2994,29940
220210,201908,18,15,3,14970,2994,17964
220211,201908,27,26,1,25948,998,26946
220213,201908,40,36,4,35928,3992.4,39920.4
220217,201908,38,30,8,29940,7984,37924
220220,201908,2122,1384,738,1381271.92,736525.1,2117797.02
220225,201908,11,5,6,4990,5988,10978
220230,201908,966,766,200,764468,199600,964068
220240,201908,160,147,13,146706,12974,159680
220245,201908,32,29,3,28942.99,2994,31936.99
220250,201908,116,104,12,103792,11976,115768
220253,201908,39,34,5,33932,4990,38922
220255,201908,29,26,3,25948,2994,28942
220260,201908,704,522,182,520956,181636,702592
220265,201908,9,7,2,6986,1996,8982
220270,201908,736,661,75,659678,74850,734528
220271,201908,39,32,7,31936,6986,38922
220272,201908,24,24,0,23952,0,23952
220273,201908,15,14,1,13972,998,14970
220275,201908,56,46,10,45908,9980,55888
220277,201908,13,11,2,10978,1996,12974
220280,201908,14,11,3,10978,2994,13972
220285,201908,44,42,2,41916,1996,43912
220290,201908,1455,1252,203,1249496.4,202594.9,1452091.3
220300,201908,45,43,2,42914,1996,44910
220310,201908,313,267,46,266466.99,45928,312394.99
220320,201908,444,410,34,409180.4,33932,443112.4
220323,201908,0,,,,,0.0
220325,201908,15,10,5,9980,4990,14970
220327,201908,12,11,1,10978,998,11976
220330,201908,222,159,63,158682,62874,221556
220335,201908,135,118,17,117764,16966,134730
220340,201908,36,22,14,21956,13972,35928
220342,201908,59,52,7,51896,6986,58882
220345,201908,80,74,6,73852,5988,79840
220350,201908,431,377,54,376246,53892,430138
220360,201908,44,32,12,31936,11976,43912
220370,201908,1196,984,212,984028,211576,1195604
220375,201908,20,18,2,17964,1996,19960
220380,201908,19,16,3,15968,2994,18962
220385,201908,16,14,2,13972,1996,15968
220390,201908,2315,1329,986,1327360.8,985026.7,2312387.5
220400,201908,32,29,3,28942,2994,31936
220410,201908,20,17,3,16966,2994,19960
220415,201908,13,12,1,11976,998,12974
220420,201908,127,106,21,105788,20958,126746
220430,201908,132,120,12,119760,11976,131736
220435,201908,21,15,6,14970,5988,20958
220440,201908,295,251,44,250498,43912,294410
220450,201908,329,169,160,168662,159680,328342
220455,201908,54,52,2,51896,1996,53892
220460,201908,19,19,0,18962,0,18962
220465,201908,102,66,36,65868,35928,101796
220470,201908,239,210,29,209580,28942,238522
220480,201908,73,65,8,64870,7984,72854
220490,201908,91,78,13,77844,12974,90818
220500,201908,100,87,13,86826,12974,99800
220510,201908,441,342,99,341316,98802,440118
220515,201908,22,20,2,19960,1996,21956
220520,201908,370,334,36,333332.34,35928,369260.34
220525,201908,13,9,4,8982,3992,12974
220527,201908,27,20,7,19960,6986,26946
220530,201908,31,12,19,11976,18962,30938
220535,201908,4,4,0,3992,0,3992
220540,201908,64,53,11,52894,10978,63872
220545,201908,47,33,14,32934,13972,46906
220550,201908,668,521,147,519958.96,146706,666664.96
220551,201908,17,13,4,12974,3992,16966
220552,201908,14,14,0,13972,0,13972
220553,201908,51,47,4,46906,3992,50898
220554,201908,9,7,2,6986,1996,8982
220555,201908,31,27,4,26946,3992,30938
220556,201908,50,46,4,45908,3992,49900
220557,201908,56,52,4,51896,3992,55888
220558,201908,8,3,5,2994,4990,7984
220559,201908,3,3,0,2994,0,2994
220560,201908,70,45,25,44910,24950,69860
220570,201908,776,478,298,477044.4,297404,774448.4
220580,201908,555,512,43,510976,42914,553890
220585,201908,6,5,1,4990,998,5988
220590,201908,15,15,0,14970,0,14970
220595,201908,61,46,15,45908,14970,60878
220600,201908,18,12,6,11976,5988,17964
220605,201908,22,20,2,19960,1996,21956
220610,201908,71,63,8,62874,7984,70858
220620,201908,561,460,101,459080,100798,559878
220630,201908,5,4,1,3992,998,4990
220635,201908,39,35,4,34930,3992,38922
220640,201908,103,83,20,82834,19960,102794
220650,201908,113,106,7,105788,6986,112774
220660,201908,44,35,9,34930,8982,43912
220665,201908,4,4,0,3992,0,3992
220667,201908,20,17,3,16966,2994,19960
220669,201908,29,26,3,25948,2994,28942
220670,201908,65,53,12,52894,11976,64870
220672,201908,65,46,19,45908,18962,64870
220675,201908,37,28,9,27944,8982,36926
220680,201908,39,33,6,32934,5988,38922
220690,201908,45,43,2,42914,1996,44910
220695,201908,43,20,23,19960,22954,42914
220700,201908,1711,1325,386,1322350,385228,1707578
220710,201908,4,3,1,2994,998,3992
220720,201908,107,87,20,86826,19960,106786
220730,201908,17,17,0,16966,0,16966
220735,201908,3,1,2,998,1996,2994
220740,201908,49,45,4,44910,3992,48902
220750,201908,113,96,17,95808,16966,112774
220755,201908,14,14,0,13972,0,13972
220760,201908,63,60,3,59880,2994,62874
220770,201908,5688,3044,2644,3037914.66,2638715.32,5676629.98
220775,201908,16,9,7,8982,6986,15968
220777,201908,17,16,1,15968,998,16966
220779,201908,0,0,0,0,0,0
220780,201908,881,755,126,753490,125748.4,879238.4
220785,201908,4,1,3,998,2994,3992
220790,201908,1061,854,207,852292.82,206586,1058878.82
220793,201908,6,6,0,5988,0,5988
220795,201908,15,14,1,13972,998,14970
220800,201908,4002,3079,923,3072845.64,921154.99,3994000.63
220810,201908,64,56,8,55888.4,7984,63872.4
220820,201908,247,225,22,224550,21956,246506
220830,201908,1221,1058,163,1055884,162674,1218558
220840,201908,2438,1710,728,1706583.33,726584.7,2433168.03
220850,201908,54,46,8,45908,7984,53892
220855,201908,9,6,3,5988,2994,8982
220860,201908,13,11,2,10978,1996,12974
220865,201908,31,29,2,28942,1996,30938
220870,201908,70,64,6,63872,5988,69860
220880,201908,318,252,66,251496,65868.4,317364.4
220885,201908,37,34,3,33932,2994,36926
220887,201908,13,13,0,12974,0,12974
220890,201908,101,89,12,88822,11976,100798
220900,201908,19,12,7,11976,6986,18962
220910,201908,54,45,9,44910,8982,53892
220915,201908,10,9,1,8982,998,9980
220920,201908,48,44,4,43912,3992,47904
220930,201908,42,41,1,40918,998,41916
220935,201908,16,16,0,15968,0,15968
220937,201908,38,37,1,36926,998,37924
220940,201908,56,51,5,50898,4990,55888
220945,201908,0,,,,,0.0
220950,201908,46,41,5,40918,4990,45908
220955,201908,24,22,2,21956,1996,23952
220960,201908,7,7,0,6986,0,6986
220965,201908,36,33,3,32934,2994,35928
220970,201908,57,47,10,46906,9980,56886
220975,201908,11,8,3,7984,2994,10978
220980,201908,32,30,2,29940,1996,31936
220985,201908,66,58,8,57884,7984,65868
220987,201908,32,30,2,29940,1996,31936
220990,201908,19,18,1,17964,998,18962
220995,201908,21,17,4,16966,3992,20958
220997,201908,60,50,10,49900,9980,59880
221000,201908,1162,1050,112,1047900,111776,1159676
221005,201908,55,48,7,47904,6986,54890
221010,201908,16,12,4,11976,3992,15968
221020,201908,43,41,2,40918,1996,42914
221030,201908,33,27,6,26946,5988,32934
221035,201908,24,24,0,23952,0,23952
221037,201908,12,8,4,7984,3992,11976
221038,201908,27,24,3,23952,2994,26946
221039,201908,22,22,0,21956,0,21956
221040,201908,257,221,36,220558,35928,256486
221050,201908,233,201,32,200598,31936,232534
221060,201908,1840,1623,217,1620752,216566,1837318
221062,201908,34,33,1,32934,998,33932
221063,201908,13,9,4,8982,3992,12974
221065,201908,52,45,7,44910,6986,51896
221070,201908,138,120,18,119760,17964,137724
221080,201908,378,331,47,330338,46906,377244
221090,201908,29,28,1,27944,998,28942
221093,201908,54,37,17,36926,16966,53892
221095,201908,8,8,0,7984,0,7984
221097,201908,15,12,3,11976,2994,14970
221100,201908,25142,14866,10276,14838313.03,10257445.8,25095758.83
221110,201908,1073,804,269,802392.62,268462,1070854.62
221120,201908,533,399,134,398202.4,133732,531934.4
221130,201908,965,792,173,790416,172654,963070
221135,201908,35,32,3,31936,2994,34930
221140,201908,43,37,6,36926,5988,42914
221150,201908,12,9,3,8982,2994,11976
221160,201908,13,13,0,12974,0,12974
221170,201908,15,15,0,14970,0,14970
230010,201908,165,151,14,150698,13972,164670
230015,201908,125,102,23,101796,22954,124750
230020,201908,1631,1382,249,1379236.4,248509.76,1627746.16
230030,201908,1681,1211,470,1208579.78,469060,1677639.78
230040,201908,215,187,28,186626.4,27944,214570.4
230050,201908,221,164,57,163672,56886,220558
230060,201908,159,130,29,129740,28942,158682
230070,201908,294,263,31,262474,30938,293412
230075,201908,847,742,105,741514.8,104790,846304.8
230080,201908,195,169,26,168662,25948,194610
230090,201908,113,81,32,80838,31936,112774
230100,201908,2036,1211,825,1208583.5,823352.84,2031936.34
230110,201908,2812,1842,970,1838316.8,969058,2807374.8
230120,201908,958,770,188,768462.48,187624,956086.48
230125,201908,146,123,23,122754,22954,145708
230130,201908,474,426,48,425148,47904,473052
230140,201908,213,184,29,183632,28942,212574
230150,201908,154,118,36,117764,35928,153692
230160,201908,935,804,131,803390,130738,934128
230170,201908,596,542,54,540917,53892,594809
230180,201908,79,74,5,73852,4990,78842
230185,201908,406,352,54,351296,53892,405188
230190,201908,2311,1853,458,1849296.14,457084,2306380.14
230195,201908,489,426,63,425148,62874,488022
230200,201908,384,332,52,331336,52894,384230
230205,201908,395,256,139,255488,138722,394210
230210,201908,1298,1036,262,1034928.22,261476.94,1296405.16
230220,201908,1543,1052,491,1050894,490020.82,1540914.82
230230,201908,908,786,122,784428,121756,906184
230240,201908,1696,1464,232,1462320.86,232535.14,1694856.00
230250,201908,1798,1485,313,1482031.58,312374,1794405.58
230260,201908,3108,1937,1171,1933126.96,1168658,3101784.96
230270,201908,1367,1105,262,1104788.17,261476,1366264.17
230280,201908,2719,2040,679,2035960.72,678640,2714600.72
230290,201908,410,365,45,364272.69,44910,409182.69
230300,201908,514,383,131,382234,130738,512972
230310,201908,421,321,100,320358,99800,420158
230320,201908,939,801,138,799399.4,137724,937123.4
230330,201908,304,244,60,243512,59880.6,303392.6
230340,201908,446,364,82,363272.6,81836,445108.6
230350,201908,3094,1974,1120,1970115.34,1117760,3087875.34
230360,201908,274,219,55,218562,54890,273452
230365,201908,143,116,27,115768,26946,142714
230370,201908,9816,4883,4933,4877305.97,4929256.85,9806562.82
230380,201908,478,413,65,412175.36,64870.2,477045.56
230390,201908,526,294,232,293412,231536,524948
230393,201908,255,215,40,214570,39920,254490
230395,201908,353,285,68,284430.48,67864,352294.48
230400,201908,603,481,122,481036,121756,602792
230410,201908,2653,1664,989,1660673.09,988021.94,2648695.03
230420,201908,6285,4171,2114,4162662.8,2109774.56,6272437.36
230423,201908,322,282,40,281436,39920,321356
230425,201908,394,326,68,326346,67864,394210
230426,201908,123,100,23,99800,22954,122754
230427,201908,79,76,3,75848,2994,78842
230428,201908,1452,746,706,744508.96,704591.76,1449100.72
230430,201908,457,376,81,375248.99,80838,456086.99
230435,201908,859,611,248,609778.31,247504.98,857283.29
230440,201908,85906,38656,47250,38596599.62,47190591.94,85787191.56
230445,201908,298,208,90,207584,89820,297404
230450,201908,544,436,108,435128,107784,542912
230460,201908,60,50,10,49900,9980,59880
230465,201908,307,250,57,249500,56886,306386
230470,201908,1974,1557,417,1553886.94,416166.5,1970053.44
230480,201908,160,151,9,150698,8982,159680
230490,201908,293,236,57,235528,56886,292414
230495,201908,452,337,115,336326,115768,452094
230500,201908,1000,742,258,740516,257484,998000
230510,201908,51,40,11,39920,10978,50898
230520,201908,388,304,84,303392.18,83832,387224.18
230523,201908,2238,1434,804,1431292.04,802473.18,2233765.22
230526,201908,280,236,44,235567.92,43912,279479.92
230530,201908,677,510,167,509978.94,166666,676644.94
230533,201908,197,188,9,187624,8982,196606
230535,201908,369,277,92,276446,91816,368262
230540,201908,1853,1636,217,1632728,216566,1849294
230550,201908,3777,2435,1342,2430192.52,1339316,3769508.52
230560,201908,575,440,135,439120.8,134730.94,573851.74
230565,201908,212,157,55,156686,54890,211576
230570,201908,297,262,35,261476,34930,296406
230580,201908,1146,855,291,853291.9,290418,1143709.9
230590,201908,985,771,214,770516.5,213572,984088.5
230600,201908,244,225,19,224550,18962,243512
230610,201908,350,280,70,279440.6,69860,349300.6
230620,201908,176,147,29,146706.4,28942,175648.4
230625,201908,733,528,205,526945.44,204590.94,731536.38
230630,201908,1314,1038,276,1035924,275448,1311372
230640,201908,3700,3209,491,3204579,490023.47,3694602.47
230650,201908,436,381,55,380239.91,54890,435129.91
230655,201908,660,575,85,573851.54,84833.89,658685.43
230660,201908,360,307,53,306386,52894,359280
230670,201908,431,378,53,377244,52894,430138
230680,201908,201,183,18,182634,17964,200598
230690,201908,896,776,120,774448,119760,894208
230700,201908,783,664,119,663670.94,118762.94,782433.88
230710,201908,724,688,36,686624.6,35928,722552.6
230720,201908,153,134,19,133732,18962,152694
230725,201908,264,213,51,212574,50898.98,263472.98
230730,201908,12049,6571,5478,6557861.4,5472099.17,12029960.57
230740,201908,672,543,129,541914.4,128742,670656.4
230750,201908,829,709,120,707582.6,119760,827342.6
230760,201908,1403,1214,189,1211572,188622,1400194
230763,201908,319,267,52,266466,51896,318362
230765,201908,7190,3394,3796,3389254.56,3794445.08,7183699.64
230770,201908,4963,2566,2397,2566863,2398198.18,4965061.18
230780,201908,699,617,82,615865.84,81836,697701.84
230790,201908,251,209,42,208582,41916,250498
230800,201908,1134,835,299,833330,298402,1131732
230810,201908,1345,1195,150,1192610,149700,1342310
230820,201908,350,246,104,246506.4,103792,350298.4
230830,201908,968,832,136,830336,135728,966064
230835,201908,281,245,36,244510,35928,280438
230837,201908,168,143,25,142714,24950,167664
230840,201908,917,734,183,732532.4,182634.4,915166.8
230850,201908,1489,1299,190,1297400,189620,1487020
230860,201908,296,221,75,220558,74850,295408
230870,201908,1833,1571,262,1567858.96,261476,1829334.96
230880,201908,61,45,16,44910,15968,60878
230890,201908,552,510,42,508980,41916.97,550896.97
230900,201908,279,207,72,206586,71856.58,278442.58
230910,201908,217,174,43,173652,42914,216566
230920,201908,419,329,90,328342,89820,418162
230930,201908,952,683,269,681634.68,268462.94,950097.62
230940,201908,842,669,173,667662.98,172654.6,840317.58
230945,201908,495,415,80,414171.96,79840,494011.96
230950,201908,416,357,59,356286,58882,415168
230960,201908,2639,1802,837,1798459.68,836327.22,2634786.90
230970,201908,1751,988,763,987032.34,762483.36,1749515.70
230980,201908,206,173,33,172654,32934,205588
230990,201908,137,113,24,112774,23952,136726
231000,201908,208,189,19,188622,18962,207584
231010,201908,147,114,33,113772,32934,146706
231020,201908,1329,929,400,927157.28,399203.82,1326361.10
231025,201908,1032,781,251,780436.6,250578.24,1031014.84
231030,201908,1121,942,179,940117.95,178642,1118759.95
231040,201908,137,94,43,93812,42914,136726
231050,201908,971,866,105,865266,104790,970056
231060,201908,145,124,21,123752,20958,144710
231070,201908,1448,1031,417,1028940.6,416166.94,1445107.54
231080,201908,263,244,19,243512,18962,262474
231085,201908,580,360,220,359280.6,219560.96,578841.56
231090,201908,246,202,44,201596,43912,245508
231095,201908,170,134,36,133732,35928,169660
231100,201908,142,120,22,119760,21956,141716
231110,201908,363,311,52,310378,51896,362274
231120,201908,287,245,42,244510,41916,286426
231123,201908,143,137,6,136726,5988,142714
231126,201908,332,263,69,262474,68862,331336
231130,201908,4595,3592,1003,3584956.81,1001056.19,4586013.00
231135,201908,211,183,28,182634,27944,210578
231140,201908,3075,2276,799,2271448,797461.88,3068909.88
231150,201908,360,344,16,343312,15968,359280
231160,201908,1188,953,235,952172.78,234590.82,1186763.60
231170,201908,533,367,166,367264,165668,532932
231180,201908,1692,1450,242,1447100,241516,1688616
231190,201908,208,178,30,177644,30938,208582
231195,201908,223,192,31,191616,30938,222554
231200,201908,819,668,151,666664,150698.6,817362.6
231210,201908,593,496,97,495008,96806,591814
231220,201908,1040,757,283,755526.82,283432.94,1038959.76
231230,201908,1431,1145,286,1143708,285428,1429136
231240,201908,1417,1031,386,1028938.94,385228.4,1414167.34
231250,201908,115,105,10,104790,9980,114770
231260,201908,279,183,96,182634,95808,278442
231270,201908,1017,844,173,843311.49,172654,1015965.49
231280,201908,71,54,17,53892,16966,70858
231290,201908,7471,4204,3267,4196650.28,3264459.8,7461110.08
231300,201908,625,578,47,576844,46906,623750
231310,201908,746,690,56,688620.74,55888,744508.74
231320,201908,582,443,139,442116,138722,580838
231325,201908,95,84,11,83832,10978,94810
231330,201908,2022,1572,450,1569107.53,449100,2018207.53
231335,201908,252,224,28,223552,27944,251496
231340,201908,1701,1253,448,1250494,447104,1697598
231350,201908,1268,1044,224,1041912,223552.8,1265464.8
231355,201908,429,372,57,371256,56886,428142
231360,201908,494,377,117,376247.21,117764,494011.21
231370,201908,88,74,14,73852,13972,87824
231375,201908,288,210,78,209580,77844,287424
231380,201908,475,387,88,386285.88,87824,474109.88
231390,201908,201,164,37,163672,36926,200598
231395,201908,727,459,268,458082,267464,725546
231400,201908,1118,925,193,923153.04,192616.34,1115769.38
231410,201908,1318,1081,237,1078838.2,236527.74,1315365.94
240010,201908,384,173,211,172654.43,210578.98,383233.41
240020,201908,2277,1818,459,1815363.5,458083.97,2273447.47
240030,201908,124,107,17,107784,16966,124750
240040,201908,31,31,0,30938,0,30938
240050,201908,525,450,75,449100,74850,523950
240060,201908,68,64,4,63872,3992,67864
240070,201908,210,164,46,163672,45908,209580
240080,201908,501,337,164,336326.99,163672.46,499999.45
240090,201908,104,93,11,92814,10978,103792
240100,201908,1494,1414,80,1412210.82,79840,1492050.82
240110,201908,1057,694,363,692613.58,362275.1,1054888.68
240120,201908,135,114,21,113772,20958,134730
240130,201908,287,267,20,266466,19960,286426
240140,201908,83,65,18,64870,17964,82834
240145,201908,717,641,76,639718,75848,715566
240150,201908,19,16,3,15968,2994,18962
240160,201908,40,36,4,35928,3992,39920
240165,201908,36,30,6,29940.5,5988,35928.5
240170,201908,92,69,23,68862,22954,91816
240180,201908,79,66,13,65868,12974,78842
240185,201908,45,40,5,39920,4990,44910
240190,201908,13,11,2,10978,1996,12974
240200,201908,3081,1727,1354,1724546.8,1353289.8,3077836.6
240210,201908,168,131,37,130738,36926,167664
240220,201908,1098,801,297,799398.7,296406,1095804.7
240230,201908,864,798,66,796404.77,65868,862272.77
240240,201908,78,54,24,53892,23952,77844
240250,201908,87,77,10,76846,9980,86826
240260,201908,1794,1344,450,1342310,449100,1791410
240270,201908,188,167,21,166666,20958,187624
240280,201908,43,32,11,31936,10978,42914
240290,201908,50,49,1,48902,998,49900
240300,201908,170,99,71,98802,70858,169660
240310,201908,2206,1236,970,1233530.67,968100.66,2201631.33
240320,201908,199,189,10,188622,9980,198602
240325,201908,4323,2654,1669,2650693.07,1668658.07,4319351.14
240330,201908,67,63,4,62874,3992,66866
240340,201908,63,41,22,40918,21956,62874
240350,201908,92,83,9,82834,8982,91816
240360,201908,485,334,151,333332,150698,484030
240370,201908,48,45,3,44910,2994,47904
240375,201908,70,40,30,39920,29940,69860
240380,201908,225,185,40,184630,39920.8,224550.8
240390,201908,14,12,2,11976,1996,13972
240400,201908,83,78,5,77844,4990,82834
240410,201908,11,7,4,6986,3992,10978
240420,201908,949,712,237,710576.2,236585.88,947162.08
240430,201908,267,251,16,250498,15968,266466
240440,201908,100,57,43,56886,42914,99800
240450,201908,222,153,69,152694.4,68862,221556.4
240460,201908,60,46,14,45908,13972,59880
240470,201908,241,211,30,210578,29940,240518
240480,201908,15,13,2,12974,1996,14970
240485,201908,79,67,12,66866,11976,78842
240490,201908,46,44,2,43912,1996,45908
240500,201908,82,65,17,65868,16966,82834
240510,201908,49,35,14,34930,13972,48902
240520,201908,120,115,5,114770,4990,119760
240530,201908,55,50,5,49900,5988,55888
240540,201908,79,68,11,67864,10978,78842
240550,201908,13,12,1,11976,998,12974
240560,201908,379,276,103,275448,102794,378242
240570,201908,461,288,173,287424.94,172654.4,460079.34
240580,201908,1258,1018,240,1015965.4,240518.99,1256484.39
240590,201908,30,28,2,27944,1996,29940
240600,201908,110,107,3,106786,2994,109780
240610,201908,513,430,83,429140.4,82834,511974.4
240615,201908,21,20,1,19960,998,20958
240620,201908,90,86,4,85828,3992,89820
240630,201908,36,34,2,33932,1996,35928
240640,201908,27,22,5,21956,4990,26946
240650,201908,237,199,38,198602,37924,236526
240660,201908,104,91,13,90818,12974,103792
240670,201908,297,177,120,176646.7,119760,296406.7
240680,201908,50,40,10,39920,9980,49900
240690,201908,47,45,2,44910,1996,46906
240700,201908,193,158,35,157684,34930,192614
240710,201908,1934,1229,705,1227541.3,703590,1931131.3
240720,201908,1079,802,277,801473.92,276446.2,1077920.12
240725,201908,65,61,4,60878,3992,64870
240730,201908,142,125,17,124750,16966,141716
240740,201908,233,199,34,198602,33932.74,232534.74
240750,201908,54,27,27,26946,26946,53892
240760,201908,46,41,5,40918,4990,45908
240770,201908,147,116,31,115768,30938,146706
240780,201908,681,564,117,562872,116766,679638
240790,201908,39,38,1,37924,998,38922
240800,201908,9222,6306,2916,6299387.17,2914163.28,9213550.45
240810,201908,20036,11064,8972,11045887.4,8959077.54,20004964.94
240820,201908,226,139,87,138722.19,86826,225548.19
240830,201908,1630,1337,293,1335324.7,293412,1628736.7
240840,201908,83,73,10,72854,9980,82834
240850,201908,86,77,9,76846,8982,85828
240860,201908,110,107,3,106786,2994,109780
240870,201908,59,51,8,50898,7984,58882
240880,201908,29,26,3,25948,2994,28942
240890,201908,1164,678,486,676645.46,486026.99,1162672.45
240895,201908,56,35,21,34930,20958,55888
240910,201908,157,143,14,142714,13972,156686
240920,201908,14,11,3,10978,2994,13972
240930,201908,411,369,42,368262,41916,410178
240933,201908,34,27,7,26946,6986,33932
240940,201908,2428,2147,281,2143705.14,281495.88,2425201.02
240950,201908,49,46,3,45908,2994,48902
240960,201908,30,25,5,24950,4990,29940
240970,201908,114,81,33,81836,32934,114770
240980,201908,197,160,37,159680,36926,196606
240990,201908,124,82,42,81836,41916,123752
241000,201908,65,61,4,60878,3992,64870
241010,201908,60,48,12,47904,11976,59880
241020,201908,115,106,9,105788,8982,114770
241025,201908,8,3,5,2994,4990,7984
241030,201908,113,93,20,92814,19960,112774
241040,201908,39,31,8,30938,7984,38922
241050,201908,86,77,9,76846,8982,85828
241060,201908,30,25,5,24950,4990,29940
241070,201908,18,18,0,17964,0,17964
241080,201908,61,55,6,54890,5988,60878
241090,201908,49,40,9,39920,8982,48902
241100,201908,70,61,9,60878,8982,69860
241105,201908,5,1,4,998,3992,4990
241110,201908,48,44,4,43912,3992,47904
241120,201908,1460,1129,331,1126742,331336,1458078
241140,201908,221,183,38,182634.4,37924,220558.4
241142,201908,44,40,4,39920,3992,43912
241150,201908,1178,1039,139,1037920,138722,1176642
241160,201908,19,19,0,18962,0,18962
241170,201908,42,38,4,37924,3992,41916
241180,201908,46,40,6,39920,5988,45908
241190,201908,37,36,1,35928,998,36926
241200,201908,3832,2058,1774,2053907.49,1772449.89,3826357.38
241210,201908,67,58,9,57884,8982,66866
241220,201908,1401,955,446,953090.71,446166.85,1399257.56
241230,201908,240,204,36,203592,35928,239520
241240,201908,54,42,12,41916,11976,53892
241250,201908,1150,1052,98,1049896.4,97804,1147700.4
241255,201908,51,40,11,39920,10978,50898
241260,201908,649,509,140,508980,139720,648700
241270,201908,49,35,14,34930,13972,48902
241280,201908,96,83,13,82834,12974,95808
241290,201908,111,86,25,85828,24950,110778
241300,201908,72,54,18,53892,18962,72854
241310,201908,49,36,13,35928.7,12974,48902.7
241320,201908,30,18,12,17964,12974,30938
241330,201908,60,56,4,55888,3992,59880
241335,201908,67,60,7,59880,6986,66866
241340,201908,185,138,47,137724,46906,184630
241350,201908,58,53,5,52894,4990,57884
241355,201908,48,42,6,41916,5988,47904
241360,201908,51,50,1,49900,998,50898
241370,201908,49,41,8,40918,7984,48902
241380,201908,39,35,4,34930,3992,38922
241390,201908,81,65,16,64870,15968,80838
241400,201908,213,173,40,172654,39920,212574
241410,201908,186,167,19,166666,18962,185628
241415,201908,101,82,19,81836,18962,100798
241420,201908,97,73,24,72854,23952.64,96806.64
241430,201908,28,25,3,24950,2994,27944
241440,201908,521,419,102,418162.97,101836,519998.97
241445,201908,36,34,2,33932,1996,35928
241450,201908,289,238,51,237524,50898,288422
241460,201908,145,132,13,131736.5,12974,144710.5
241470,201908,40,33,7,32934,6986,39920
241475,201908,60,57,3,56886,2994,59880
241480,201908,95,70,25,69860,24950,94810
241490,201908,9,8,1,7984,998,8982
241500,201908,48,36,12,35928,11976,47904
250010,201908,102,86,16,85828,15968,101796
250020,201908,33,30,3,29940,2994,32934
250030,201908,837,634,203,632732,202594.6,835326.6
250040,201908,352,292,60,291416,59880,351296
250050,201908,242,200,42,199600.99,41916,241516.99
250053,201908,58,44,14,43912,13972,57884
250057,201908,0,,,,,0.0
250060,201908,478,372,106,371256,105788,477044
250070,201908,715,578,137,576844.75,136726,713570.75
250073,201908,8,8,0,7984,0,7984
250077,201908,188,144,44,143712,43912,187624
250080,201908,415,325,90,324350.72,89820,414170.72
250090,201908,200,133,67,132734,66866,199600
250100,201908,513,424,89,423152,88822.2,511974.2
250110,201908,573,441,132,440118,131736,571854
250115,201908,21,7,14,6986,13972,20958
250120,201908,115,85,30,84830,29940,114770
250130,201908,572,469,103,470058,102794.6,572852.6
250135,201908,14,9,5,8982,4990,13972
250140,201908,83,74,9,73852,8982,82834
250150,201908,578,422,156,422154,155688,577842
250153,201908,7,6,1,5988,998,6986
250157,201908,32,25,7,24950,6986,31936
250160,201908,215,171,44,170658,43912,214570
250170,201908,60,41,19,40918,18962,59880
250180,201908,4069,2805,1264,2801389.07,1261476.15,4062865.22
250190,201908,850,563,287,561874,286426.5,848300.5
250200,201908,51,43,8,42914,7984,50898
250205,201908,24,21,3,20958,2994,23952
250210,201908,86,77,9,76846,8982,85828
250215,201908,61,54,7,53892,7984,61876
250220,201908,26,20,6,19960,5988,25948
250230,201908,78,72,6,71856.99,5988,77844.99
250240,201908,236,197,39,196606,38922,235528
250250,201908,396,345,51,344310,50898,395208
250260,201908,36,31,5,30938,4990,35928
250270,201908,64,50,14,49900,13972,63872
250280,201908,378,315,63,314370,62874,377244
250290,201908,89,83,6,82834,5988,88822
250300,201908,546,374,172,374250,171657.97,545907.97
250310,201908,47,43,4,42914,3992,46906
250320,201908,1924,1324,600,1321414.72,600797.38,1922212.10
250330,201908,94,82,12,81836,11976,93812
250340,201908,24,22,2,21956,1996,23952
250350,201908,150,102,48,101796,47904,149700
250355,201908,35,27,8,26946,7984,34930
250360,201908,198,163,35,162674,34930,197604
250370,201908,2400,1626,774,1622748,772452,2395200
250375,201908,7,3,4,2994,3992,6986
250380,201908,56,43,13,42914,12974,55888
250390,201908,42,34,8,33932,7984,41916
250400,201908,16245,8302,7943,8288399.44,7937100.12,16225499.56
250403,201908,346,283,63,282434,62874,345308
250407,201908,59,50,9,49900,8982,58882
250410,201908,31,27,4,26946,3992,30938
250415,201908,40,26,14,25948,13972,39920
250420,201908,45,38,7,37924,6986,44910
250430,201908,1475,1264,211,1261721.5,210578,1472299.5
250435,201908,18,14,4,13972,3992,17964
250440,201908,678,573,105,571854.6,104790,676644.6
250450,201908,81,68,13,67864,12974,80838
250460,201908,431,300,131,299400,130738,430138
250470,201908,91,67,24,66866,23952,90818
250480,201908,323,259,64,259480,63872,323352
250485,201908,1,1,0,998,0,998
250490,201908,219,186,33,185628,32934,218562
250500,201908,81,62,19,61876,18962,80838
250510,201908,728,578,150,576844,149700,726544
250520,201908,170,118,52,117764,51896,169660
250523,201908,113,93,20,92814,19960,112774
250527,201908,100,80,20,79840,19960,99800
250530,201908,8,4,4,3992,3992,7984
250535,201908,26,21,5,20958,4990,25948
250540,201908,129,100,29,99800,28942,128742
250550,201908,71,68,3,67864,2994,70858
250560,201908,43,32,11,31936,10978,42914
250570,201908,160,130,30,129740,29940,159680
250580,201908,113,89,24,88886,23952,112838
250590,201908,24,16,8,15968,7984,23952
250600,201908,1290,872,418,870257.04,417164,1287421.04
250610,201908,156,135,21,134730,20958,155688
250620,201908,22,18,4,17964,3992,21956
250625,201908,72,54,18,54890,17964,72854
250630,201908,2985,1943,1042,1941124.48,1039923.92,2981048.40
250640,201908,216,179,37,178642,36926,215568
250650,201908,27,19,8,18962,7984,26946
250660,201908,49,37,12,36926,11976,48902
250670,201908,61,42,19,41916,18962,60878
250680,201908,398,327,71,326346,70858,397204
250690,201908,1908,1333,575,1330338.15,573850,1904188.15
250700,201908,926,814,112,812373.08,111776,924149.08
250710,201908,430,336,94,335328,93812,429140
250720,201908,112,87,25,86826,24950,111776
250730,201908,369,315,54,315368,53892,369260
250740,201908,53,49,4,48902,3992,52894
250750,201908,21232,12947,8285,12933031.11,8276840.34,21209871.45
250760,201908,80,64,16,63872,15968,79840
250770,201908,350,231,119,230598.32,118762,349360.32
250780,201908,58,43,15,42914,14970,57884
250790,201908,465,301,164,300398,163672,464070
250800,201908,146,134,12,133732,11976,145708
250810,201908,79,60,19,59880,18962,78842
250820,201908,154,127,27,126746,26946,153692
250830,201908,424,293,131,292414.4,130738,423152.4
250840,201908,50,48,2,47904,1996,49900
250850,201908,53,43,10,42914,9980,52894
250855,201908,13,11,2,10978,1996,12974
250860,201908,199,139,60,138722,59880,198602
250870,201908,33,29,4,28942,3992,32934
250880,201908,85,63,22,62874,21956,84830
250890,201908,2712,2047,665,2042906,665666,2708572
250900,201908,28,24,4,23952,3992,27944
250905,201908,117,91,26,90818,25948,116766
250910,201908,1147,822,325,821354.99,324350,1145704.99
250915,201908,107,75,32,74850,31936,106786
250920,201908,140,104,36,103792,35928,139720
250930,201908,165,103,62,102794,61876,164670
250933,201908,2,1,1,998,998,1996
250937,201908,9,8,1,7984,998,8982
250939,201908,34,25,9,24950,8982,33932
250940,201908,103,80,23,79840,22954,102794
250950,201908,67,47,20,46906,19960,66866
250960,201908,89,49,40,48902,39920,88822
250970,201908,1215,863,352,861274,351296,1212570
250980,201908,92,64,28,63872,27944,91816
250990,201908,171,132,39,131736,38922,170658
251000,201908,76,68,8,67864,7984,75848
251010,201908,102,80,22,79840.99,21956,101796.99
251020,201908,81,70,11,69860,10978,80838
251030,201908,43,34,9,33932,8982,42914
251040,201908,52,38,14,37924,13972,51896
251050,201908,23,21,2,20958,1996,22954
251060,201908,50,39,11,38922,10978,49900
251065,201908,4,4,0,3992,0,3992
251070,201908,22,19,3,18962.98,2994,21956.98
251080,201908,4929,2400,2529,2395222.26,2525942.63,4921164.89
251090,201908,193,163,30,162674,29940,192614
251100,201908,18,18,0,17964,0,17964
251110,201908,43,34,9,33932,8982,42914
251120,201908,1802,1112,690,1109778,688620.4,1798398.4
251130,201908,388,319,69,318362,68862,387224
251140,201908,531,350,181,349301.2,180638,529939.2
251150,201908,314,274,40,273452.98,39920,313372.98
251160,201908,95,80,15,79840.99,14970,94810.99
251170,201908,101,81,20,80838,19960,100798
251180,201908,287,180,107,179640.99,106786.99,286427.98
251190,201908,191,128,63,127744,62874,190618
251200,201908,262,215,47,214570,46906,261476
251203,201908,36,34,2,33932,1996,35928
251207,201908,93,76,17,75848,16966,92814
251210,201908,1469,1074,395,1071852,395208,1467060
251220,201908,48,38,10,37924,9980,47904
251230,201908,609,515,94,513970,93812,607782
251240,201908,101,72,29,71856,28942,100798
251250,201908,1371,978,393,978040.9,392214.7,1370255.6
251260,201908,11,6,5,5988,4990,10978
251270,201908,323,245,78,244510,77844.7,322354.7
251272,201908,65,58,7,57884,6986,64870
251274,201908,27,21,6,20958,5988,26946
251275,201908,30,18,12,17964,12974,30938
251276,201908,11,9,2,8982,1996,10978
251278,201908,10,8,2,7984,1996,9980
251280,201908,99,95,4,94810,3992,98802
251290,201908,734,554,180,552892,180638,733530
251300,201908,15,13,2,12974,1996,14970
251310,201908,372,266,106,265468.99,105788,371256.99
251315,201908,24,23,1,22954,998,23952
251320,201908,62,50,12,49900,11976,61876
251330,201908,81,71,10,70858,9980,80838
251335,201908,14,9,5,8982,4990,13972
251340,201908,706,418,288,417164,287424,704588
251350,201908,35,34,1,33932,998,34930
251360,201908,74,66,8,65868,7984,73852
251365,201908,15,15,0,14970,0,14970
251370,201908,5438,3724,1714,3719608.62,1710573.43,5430182.05
251380,201908,45,37,8,36926,7984,44910
251385,201908,3,3,0,2994,0,2994
251390,201908,740,574,166,572852.7,165668.4,738521.1
251392,201908,13,6,7,5988,6986,12974
251394,201908,9,9,0,8982,0,8982
251396,201908,11,7,4,6986,3992,10978
251398,201908,18,15,3,14970,2994,17964
251400,201908,39,34,5,33932,4990,38922
251410,201908,37,31,6,30938,5988,36926
251420,201908,101,74,27,73852,26946,100798
251430,201908,42,39,3,38922,2994,41916
251440,201908,33,20,13,19960,12974,32934
251445,201908,46,41,5,40918,4990,45908
251450,201908,405,355,50,354290.2,49900,404190.2
251455,201908,3,2,1,1996,998,2994
251460,201908,18,16,2,15968,1996,17964
251465,201908,5,2,3,1996,2994,4990
251470,201908,46,37,9,36926,8982,45908
251480,201908,24,21,3,20958,2994,23952
251490,201908,122,85,37,84830,36926.4,121756.4
251500,201908,124,102,22,101796,21956,123752
251510,201908,38,29,9,28942,8982,37924
251520,201908,25,25,0,24950,0,24950
251530,201908,4480,3175,1305,3168770.56,1302390,4471160.56
251540,201908,73,63,10,62874,9980,72854
251550,201908,405,313,92,312374,91816.9,404190.9
251560,201908,20,14,6,13972,5988,19960
251570,201908,20,19,1,18962,998,19960
251580,201908,125,103,22,102794,21956,124750
251590,201908,119,86,33,86017,32934,118951
251593,201908,26,16,10,15968,9980,25948
251597,201908,63,53,10,52894,9980,62874
251600,201908,1080,781,299,779445.71,300398.6,1079844.31
251610,201908,235,183,52,182634,51896,234530
251615,201908,5,5,0,4990,0,4990
251620,201908,4230,2802,1428,2796398.24,1426143.6,4222541.84
251630,201908,444,328,116,327344,116766.98,444110.98
251640,201908,143,103,40,102794,39920,142714
251650,201908,262,191,71,190618.7,70858,261476.7
251660,201908,182,163,19,162674,18962,181636
251670,201908,366,288,78,287424,77844,365268
251675,201908,5,5,0,4990,0,4990
251680,201908,93,84,9,83832,8982,92814
251690,201908,339,279,60,278442,59880,338322
251700,201908,285,247,38,246506,37924,284430
251710,201908,22,15,7,14970,6986,21956
251720,201908,25,16,9,15968,8982.4,24950.4
251740,201908,9,7,2,6986,1996,8982
260005,201908,3123,1775,1348,1772510.95,1349298.88,3121809.83
260010,201908,1557,1133,424,1130735.13,423152.64,1553887.77
260020,201908,417,367,50,366266,49900,416166
260030,201908,588,425,163,424150,162674,586824
260040,201908,819,512,307,511974,306386,818360
260050,201908,1143,830,313,828340,312374.8,1140714.8
260060,201908,389,356,33,355288,32934,388222
260070,201908,1380,866,514,864330.89,512972.69,1377303.58
260080,201908,728,571,157,570856,156686,727542
260090,201908,512,335,177,334331.96,176646,510977.96
260100,201908,230,163,67,162674,66866,229540
260105,201908,214,120,94,119760.64,93812,213572.64
260110,201908,2840,2096,744,2091809.78,742512.4,2834322.18
260120,201908,2848,1472,1376,1469057.62,1377240.7,2846298.32
260130,201908,163,114,49,113772,48902,162674
260140,201908,2145,1405,740,1403198.79,739518.98,2142717.77
260150,201908,218,146,72,145708,71856,217564
260160,201908,321,268,53,267464,52894,320358
260170,201908,3354,2057,1297,2053884.88,1295404.4,3349289.28
260180,201908,154,129,25,128742,24950,153692
260190,201908,2258,1591,667,1588816,666664,2255480
260200,201908,959,777,182,775446.63,181636.4,957083.03
260210,201908,1438,1031,407,1028938,406186.98,1435124.98
260220,201908,716,647,69,645706,68862,714568
260230,201908,1189,897,292,897202.94,291416,1188618.94
260240,201908,220,166,54,165668,53892,219560
260250,201908,90,69,21,68862,20958,89820
260260,201908,1011,723,288,721554,288422,1009976
260270,201908,419,336,83,335328,82834,418162
260280,201908,1328,927,401,925146.6,401196.4,1326343.0
260290,201908,6417,3493,2924,3487018.28,2921152.07,6408170.35
260300,201908,915,797,118,795406.6,117764.4,913171.0
260310,201908,521,410,111,409180,110778,519958
260320,201908,858,645,213,644708,212574,857282
260330,201908,52,39,13,38922,12974,51896
260340,201908,72,52,20,51896,19960,71856
260345,201908,5520,3086,2434,3079830.87,2431341.48,5511172.35
260350,201908,477,347,130,346306.4,129740.98,476047.38
260360,201908,278,146,132,145708,131736,277444
260370,201908,691,460,231,459080.5,230538.99,689619.49
260380,201908,603,439,164,439120,163672.66,602792.66
260390,201908,298,251,47,250498,46906,297404
260392,201908,105,88,17,87824,16966,104790
260400,201908,4091,2388,1703,2385222.19,1699653.88,4084876.07
260410,201908,14515,7687,6828,7675660.46,6817339.28,14492999.74
260415,201908,127,115,12,114770,11976,126746
260420,201908,1764,1075,689,1072851.81,687622,1760473.81
260430,201908,191,173,18,173653.25,17964,191617.25
260440,201908,210,153,57,153692.98,56886,210578.98
260450,201908,448,328,120,327345.2,119760,447105.2
260460,201908,817,441,376,440119.2,376246,816365.2
260470,201908,358,222,136,221556,135728.8,357284.8
260480,201908,221,144,77,143712,76846,220558
260490,201908,213,179,34,178642,33932,212574
260500,201908,1126,762,364,760476,364270,1124746
260510,201908,783,633,150,632732,149700,782432
260515,201908,244,219,25,218562,24950,243512
260520,201908,3232,1965,1267,1961070.99,1268458.78,3229529.77
260530,201908,799,654,145,652692,144710,797402
260540,201908,559,433,126,432134,126746,558880
260545,201908,11,9,2,8982,1996,10978
260550,201908,335,209,126,208582,125748,334330
260560,201908,529,398,131,397204.4,131736,528940.4
260570,201908,987,810,177,808380.4,176646,985026.4
260580,201908,255,226,29,225548,28942,254490
260590,201908,626,366,260,365268,259480,624748
260600,201908,8002,4298,3704,4290583.5,3698647.88,7989231.38
260610,201908,480,322,158,322354,157684,480038
260620,201908,3648,1935,1713,1933168.94,1711571.11,3644740.05
260630,201908,88,83,5,82834,4990,87824
260640,201908,3603,1984,1619,1983026.92,1617758.98,3600785.90
260650,201908,325,240,85,239520,84830,324350
260660,201908,533,364,169,363272,168662,531934
260670,201908,104,78,26,77844,25948,103792
260680,201908,3628,2064,1564,2060873.53,1560873.36,3621746.89
260690,201908,126,93,33,92814,32934,125748
260700,201908,314,205,109,204590,108782,313372
260710,201908,39,36,3,35928,2994,38922
260720,201908,2328,1403,925,1400322.01,924148,2324470.01
260730,201908,665,504,161,502992,161676,664668
260740,201908,61,57,4,56886,3992,60878
260750,201908,611,443,168,442114,167664,609778
260760,201908,623,337,286,336326.63,285428,621754.63
260765,201908,966,512,454,510976.99,454090,965066.99
260770,201908,221,165,56,165651,55888,221539
260775,201908,788,468,320,467065.3,319360.98,786426.28
260780,201908,269,175,94,174650,93812,268462
260790,201908,12203,6720,5483,6709684.06,5483077.29,12192761.35
260795,201908,170,114,56,113772,55888,169660
260800,201908,295,247,48,246506,47904,294410
260805,201908,172,114,58,113772,57884,171656
260810,201908,750,656,94,655686,94810,750496
260820,201908,305,196,109,195608.34,108782,304390.34
260825,201908,207,146,61,146706,61876,208582
260830,201908,279,176,103,175648,102794,278442
260840,201908,233,172,61,171656,60878,232534
260845,201908,177,123,54,122754,53892,176646
260850,201908,458,339,119,339320,118762,458082
260860,201908,254,192,62,191616,61876,253492
260870,201908,372,278,94,277444,93812,371256
260875,201908,733,523,210,522952,209580,732532
260880,201908,1578,1009,569,1006982.2,567862,1574844.2
260890,201908,2390,1688,702,1686680.88,700596.8,2387277.68
260900,201908,988,692,296,690616,295408,986024
260910,201908,263,209,54,208582,54890,263472
260915,201908,300,213,87,212574,86826,299400
260920,201908,177,96,81,95808,81836,177644
260930,201908,398,343,55,342316.91,54890.97,397207.88
260940,201908,2747,1507,1240,1503987.76,1240574.28,2744562.04
260950,201908,2020,1176,844,1173768.58,842312.4,2016080.98
260960,201908,13653,7153,6500,7139823.28,6494095.31,13633918.59
260970,201908,428,367,61,366266,60878,427144
260980,201908,195,173,22,172654,21956,194610
260990,201908,2609,2125,484,2123746.94,484030,2607776.94
261000,201908,4337,2594,1743,2588813.58,1740512.6,4329326.18
261010,201908,178,131,47,130738,46906,177644
261020,201908,608,456,152,455089.06,151696,606785.06
261030,201908,235,175,60,174650,59880,234530
261040,201908,366,321,45,320358,44910,365268
261050,201908,501,439,62,438122,61876,499998
261060,201908,1363,897,466,895206.5,465068,1360274.5
261070,201908,8624,4423,4201,4419210.09,4194763.57,8613973.66
261080,201908,376,291,85,290418,84830,375248
261090,201908,2235,1722,513,1719558.31,511974.47,2231532.78
261100,201908,1124,787,337,785427.3,336326,1121753.3
261110,201908,8499,5242,3257,5232517.29,3254482.01,8486999.30
261120,201908,267,226,41,225548,40918,266466
261130,201908,571,340,231,339320.6,230598.62,569919.22
261140,201908,183,119,64,118762,63872,182634
261150,201908,681,423,258,422154.18,258482,680636.18
261153,201908,69,65,4,64870,3992,68862
261160,201908,75947,38382,37565,38335506.57,37530463.04,75865969.61
261170,201908,468,353,115,352294,114770,467064
261180,201908,1809,1110,699,1110833.88,699598,1810431.88
261190,201908,604,429,175,428144.52,174650.98,602795.50
261200,201908,220,191,29,190618,28942,219560
261210,201908,33,28,5,27944,4990,32934
261220,201908,2684,1891,793,1888219.17,793411.37,2681630.54
261230,201908,337,255,82,254490,81836,336326
261240,201908,464,400,64,399200,63872,463072
261245,201908,237,195,42,195608,41916,237524
261247,201908,173,136,37,135728,36926,172654
261250,201908,2945,1498,1447,1496003.3,1446102,2942105.3
261255,201908,256,232,24,231536,23952,255488
261260,201908,867,751,116,749498.76,115768,865266.76
261270,201908,182,138,44,137724,43912,181636
261280,201908,175,145,30,144710,29940,174650
261290,201908,124,87,37,86826,36926,123752
261300,201908,1279,931,348,929138,347304,1276442
261310,201908,788,532,256,530936,256486,787422
261320,201908,558,390,168,389220,167664,556884
261330,201908,1000,766,234,764468,233532.63,998000.63
261340,201908,288,165,123,164670,123752,288422
261350,201908,837,597,240,595806,240518,836324
261360,201908,1276,834,442,833330,442114,1275444
261370,201908,4817,2959,1858,2954273.24,1855323.7,4809596.94
261380,201908,554,417,137,416166.66,136726.4,552893.06
261390,201908,3566,2388,1178,2383344.28,1176642.7,3559986.98
261400,201908,280,255,25,254490,24950,279440
261410,201908,1110,751,359,749498,358282,1107780
261420,201908,869,549,320,548902.47,319360,868262.47
261430,201908,328,293,35,292414,34930,327344
261440,201908,125,115,10,114770,9980,124750
261450,201908,2534,2074,460,2070971.07,459140.4,2530111.47
261460,201908,731,590,141,588820.74,140718,729538.74
261470,201908,244,190,54,189620.1,53892,243512.1
261480,201908,410,325,85,324350.6,84786.99,409137.59
261485,201908,339,212,127,211576,127744,339320
261500,201908,604,413,191,412174,191616,603790
261510,201908,50,34,16,33932,15968,49900
261520,201908,112,98,14,97804,13972,111776
261530,201908,4088,2596,1492,2592805.19,1489017.84,4081823.03
261540,201908,1227,752,475,750496,474050,1224546
261550,201908,273,136,137,135728.4,136726,272454.4
261560,201908,829,550,279,550896.7,279440.98,830337.68
261570,201908,393,309,84,308382,83832,392214
261580,201908,377,297,80,296406,79840,376246
261590,201908,199,160,39,159680,38922,198602
261600,201908,295,237,58,236526,57884,294410
261610,201908,100,84,16,83832,15968,99800
261618,201908,76,61,15,60878,14970,75848
261620,201908,197,119,78,118762,77844,196606
261630,201908,573,446,127,445108,126746,571854
261640,201908,6348,3398,2950,3394261.35,2951086.9,6345348.25
261650,201908,493,314,179,313372,178642,492014
270010,201908,532,474,58,473052,57884,530936
270020,201908,292,231,61,230538.99,60878,291416.99
270030,201908,9106,5923,3183,5915238.9,3179663.48,9094902.38
270040,201908,2003,1258,745,1255484,743510,1998994
270050,201908,161,121,40,121756,39920,161676
270060,201908,113,63,50,62874,49900,112774
270070,201908,884,646,238,645872.33,237524.98,883397.31
270080,201908,36,30,6,29940,5988,35928
270090,201908,17,13,4,12974,3992,16966
270100,201908,1211,813,398,811374.98,397204,1208578.98
270110,201908,135,103,32,102794,31936,134730
270120,201908,225,184,41,183632,40918,224550
270130,201908,237,163,74,162674,73852,236526
270135,201908,105,63,42,62874,41916,104790
270140,201908,1361,843,518,842315.35,517963.94,1360279.29
270150,201908,263,208,55,207584,54890,262474
270160,201908,519,398,121,397204,120758,517962
270170,201908,773,505,268,505986,268462,774448
270180,201908,72,55,17,54890,16966,71856
270190,201908,94,83,11,82834,10978,93812
270200,201908,103,92,11,91816,10978,102794
270210,201908,489,271,218,271456,217564,489020
270220,201908,179,142,37,142714,36926,179640
270230,201908,2109,1300,809,1299548.34,812373.94,2111922.28
270235,201908,713,549,164,547906.82,163676.88,711583.70
270240,201908,3141,2480,661,2476040.22,659680.54,3135720.76
270250,201908,162,117,45,116766,44910,161676
270255,201908,209,179,30,178642,29940,208582
270260,201908,362,294,68,294410,67864,362274
270270,201908,100,43,57,42914.98,56886,99800.98
270280,201908,262,151,111,150698,110817.92,261515.92
270290,201908,1174,902,272,900196,271456.98,1171652.98
270300,201908,282,190,92,189620,91816,281436
270310,201908,890,724,166,722556.88,165669.96,888226.84
270320,201908,843,724,119,723551.61,118762,842313.61
270330,201908,277,236,41,236526,40918,277444
270340,201908,58,47,11,46906,10978,57884
270350,201908,95,48,47,47904,46906,94810
270360,201908,60,36,24,35928,23952,59880
270370,201908,56,45,11,44910,10978,55888
270375,201908,73,47,26,46906,25948,72854
270380,201908,997,600,397,598800,396206,995006
270390,201908,193,112,81,111776,80838,192614
270400,201908,713,527,186,526947.41,185628,712575.41
270410,201908,679,494,185,493012,184630,677642
270420,201908,405,277,128,276479.26,128743.94,405223.20
270430,201908,33091,23821,9270,23792754.88,9259675.08,33052429.96
270440,201908,491,389,102,388222,101796,490018
270450,201908,790,437,353,436126,352294,788420
270460,201908,192,154,38,153692,37924,191616
270470,201908,1447,993,454,993010.64,453092,1446102.64
270480,201908,545,450,95,449134.06,94810,543944.06
270490,201908,24,19,5,18962,4990,23952
270500,201908,500,416,84,415168,83832,499000
270510,201908,770,475,295,475048,294410,769458
270520,201908,324,204,120,203592,120758,324350
270530,201908,68,58,10,57884,9980,67864
270540,201908,114,89,25,88822,24950,113772
270550,201908,1758,1350,408,1348299.98,407184,1755483.98
270560,201908,283,141,142,140718,142714,283432
270570,201908,499,352,147,351296,146706.4,498002.4
270580,201908,96,71,25,70858,24950,95808
270590,201908,70,56,14,55888,13972,69860
270600,201908,172,142,30,141716,29940,171656
270610,201908,213,180,33,179640,32934,212574
270620,201908,30,29,1,28942,998,29940
270630,201908,3841,2941,900,2938116.16,898200,3836316.16
270640,201908,886,655,231,653690,230539.94,884229.94
270642,201908,224,190,34,189620,33932,223552
270644,201908,249,166,83,165668.98,82834,248502.98
270650,201908,310,183,127,182634,126746,309380
270660,201908,255,209,46,208582,45908,254490
270670,201908,3100,2376,724,2372549.3,723550.4,3096099.7
270680,201908,465,273,192,272454.98,191616,464070.98
270690,201908,1146,743,403,741553.92,402194,1143747.92
270700,201908,33,25,8,24950,7984,32934
270710,201908,879,679,200,677642,200598,878240
270720,201908,249,195,54,194610,53892,248502
270730,201908,1909,1134,775,1132531.2,774450.08,1906981.28
270740,201908,42,28,14,27944,13972,41916
270750,201908,662,486,176,485028.6,175648,660676.6
270760,201908,297,217,80,216566,79840,296406
270770,201908,2774,1808,966,1804427.62,964068.96,2768496.58
270780,201908,81,51,30,50898,29941.98,80839.98
270790,201908,248,165,83,164670,82834,247504
270800,201908,1974,1593,381,1589815.39,380238,1970053.39
270810,201908,289,232,57,231536,56886,288422
270820,201908,155,103,52,102794,51896.8,154690.8
270830,201908,818,602,216,600797.98,215568.99,816366.97
270840,201908,1428,1085,343,1082830,342314.74,1425144.74
270850,201908,1577,968,609,966065,608780,1574845
270860,201908,2508,1653,855,1651958.54,855288.67,2507247.21
270870,201908,123,65,58,64870,57884,122754
270880,201908,909,694,215,692622.72,214574.86,907197.58
270890,201908,314,228,86,227583.92,85828,313411.92
270895,201908,64,55,9,54890,8982,63872
270900,201908,97,75,22,74850,21956,96806
270910,201908,319,253,66,252494,65868,318362
270915,201908,1912,1183,729,1180661.73,727553.2,1908214.93
270920,201908,491,416,75,415168,74850,490018
270930,201908,6127,4532,1595,4525007.85,1591820.92,6116828.77
270940,201908,2359,1821,538,1818123.13,537922,2356045.13
280010,201908,41,36,5,35928,4990,40918
280020,201908,463,408,55,407184.96,54890,462074.96
280030,201908,20099,13104,6995,13088264.54,6986273.84,20074538.38
280040,201908,331,219,112,218562,111776,330338
280050,201908,379,293,86,292414,85828,378242
280060,201908,339,228,111,227604.36,110778,338382.36
280067,201908,1024,738,286,736524.49,285428.75,1021953.24
280070,201908,121,99,22,98802,21956,120758
280100,201908,613,483,130,483032.4,129740.6,612773.0
280110,201908,77,72,5,71856,4990,76846
280120,201908,641,521,120,519958,119760,639718
280130,201908,1631,1069,562,1066862.6,560876.8,1627739.4
280140,201908,469,386,83,385228,82834,468062
280150,201908,370,271,99,270458,98802,369260
280160,201908,98,86,12,85828,11976,97804
280170,201908,406,271,135,270458,136726,407184
280190,201908,27,25,2,24950,1996,26946
280200,201908,28,23,5,22954,4990,27944
280210,201908,2845,2060,785,2055884.37,783430.4,2839314.77
280220,201908,41,33,8,32934,7984,40918
280230,201908,325,270,55,269460.7,54890,324350.7
280240,201908,118,112,6,111776,5988,117764
280250,201908,16,10,6,9980,5988,15968
280260,201908,81,71,10,70858,9980,80838
280270,201908,155,120,35,119760,34930,154690
280280,201908,190,123,67,123752.61,66866,190618.61
280290,201908,3286,2409,877,2404120.64,875246.64,3279367.28
280300,201908,1596,1232,364,1229576.32,363272,1592848.32
280310,201908,102,98,4,97804.6,3992,101796.6
280320,201908,662,462,200,461076,199600,660676
280330,201908,337,243,94,242514,93812,336326
280340,201908,406,330,76,329340,75848,405188
280350,201908,3586,2800,786,2795462.12,784428.7,3579890.82
280360,201908,446,289,157,288422,156686,445108
280370,201908,97,85,12,84830,11976,96806
280380,201908,53,41,12,40918,11976,52894
280390,201908,176,152,24,151696,23952,175648
280400,201908,346,237,109,236527.36,108782,345309.36
280410,201908,285,231,54,230538.6,53892,284430.6
280420,201908,168,141,27,140718,26946,167664
280430,201908,29,20,9,19960,8982,28942
280440,201908,693,541,152,539919.46,151696,691615.46
280445,201908,117,109,8,108782,7984,116766
280450,201908,1168,1006,162,1003988.94,161676,1165664.94
280460,201908,608,442,166,441116.7,165668,606784.7
280470,201908,187,173,14,172654,13972.7,186626.7
280480,201908,2480,1766,714,1762470.76,712573.62,2475044.38
280490,201908,282,262,20,261476.15,19960,281436.15
280500,201908,41,38,3,37924,2994,40918
280510,201908,140,112,28,111776,27944.4,139720.4
280520,201908,53,40,13,39920,12974,52894
280530,201908,73,47,26,46906,25948,72854
280540,201908,520,426,94,425148.7,93812,518960.7
280550,201908,731,674,57,672654.4,56886,729540.4
280560,201908,494,435,59,434130,58882,493012
280570,201908,2199,1717,482,1713568.38,481036,2194604.38
280580,201908,609,471,138,470060.19,137724.8,607784.99
280590,201908,174,113,61,112774,60878,173652
280600,201908,386,326,60,326346,59880,386226
280610,201908,128,97,31,96806,30938,127744
280620,201908,548,459,89,458082,88822,546904
280630,201908,151,126,25,125748,24950,150698
280640,201908,192,153,39,152694.96,38922,191616.96
280650,201908,79,57,22,56886,21956,78842
280660,201908,137,101,36,100798,35928,136726
280670,201908,1764,1126,638,1123753.35,637822.66,1761576.01
280680,201908,175,152,23,151696.29,22954,174650.29
280690,201908,90,78,12,77844,11976,89820
280700,201908,23,21,2,20958,1996,22954
280710,201908,1462,1128,334,1125744.6,334330,1460074.6
280720,201908,110,72,38,71856,37924,109780
280730,201908,25,21,4,20958,3992,24950
280740,201908,2505,1874,631,1870252.8,630736,2500988.8
280750,201908,225,199,26,198602,25948,224550
280760,201908,733,508,225,507083.8,224550,731633.8
290010,201908,203,141,62,140718,61936,202654
290020,201908,175,161,14,160678,13972,174650
290030,201908,598,392,206,392214,205588,597802
290035,201908,129,104,25,103792,24950,128742
290040,201908,297,196,101,195608,100798,296406
290050,201908,87,68,19,67864,18962,86826
290060,201908,264,119,145,119760,144710,264470
290070,201908,5580,2780,2800,2774441.86,2794404.64,5568846.50
290080,201908,472,226,246,225548.96,246506.96,472055.92
290090,201908,383,173,210,172654,209580,382234
290100,201908,1630,1077,553,1076843.2,553890.8,1630734.0
290110,201908,817,493,324,493013.12,323352.99,816366.11
290115,201908,199,185,14,184630,13972,198602
290120,201908,756,498,258,497004.63,258482,755486.63
290130,201908,430,263,167,262474,166666,429140
290135,201908,294,224,70,223552,69860,293412
290140,201908,311,256,55,255488,54890,310378
290150,201908,134,99,35,98802,34930,133732
290160,201908,247,188,59,187624.62,58882,246506.62
290170,201908,94,68,26,67864,25948,93812
290180,201908,169,129,40,128742.6,39920,168662.6
290190,201908,438,363,75,362274,74850,437124
290195,201908,310,194,116,193612,115768,309380
290200,201908,275,222,53,222554,52894,275448
290205,201908,141,88,53,87824,52894,140718
290210,201908,1145,837,308,836324.4,307384,1143708.4
290220,201908,221,122,99,121756,98802,220558
290225,201908,288,114,174,114770,173652,288422
290230,201908,66,45,21,44910,20958,65868
290240,201908,334,132,202,131736,201596,333332
290250,201908,260,240,20,239520,19960,259480
290260,201908,309,250,59,249500.4,58882,308382.4
290265,201908,190,161,29,160678,28942,189620
290270,201908,1419,1176,243,1174646.5,242515.36,1417161.86
290280,201908,472,337,135,336326,134730,471056
290290,201908,1289,768,521,767462.94,519958.4,1287421.34
290300,201908,445,380,65,379240.4,64870,444110.4
290310,201908,305,134,171,133732,170658,304390
290320,201908,4072,2531,1541,2525939.15,1537919.24,4063858.39
290323,201908,190,167,23,166666,22954,189620
290327,201908,164,130,34,129740,33932,163672
290330,201908,91,51,40,50898,39920,90818
290340,201908,873,359,514,358282,512972,871254
290350,201908,611,371,240,370258,239520,609778
290360,201908,362,275,87,274450.97,86826,361276.97
290370,201908,920,387,533,386226.73,531934.97,918161.70
290380,201908,318,197,121,196606,120758,317364
290390,201908,2480,1566,914,1563868.9,912172,2476040.9
290395,201908,251,142,109,141716.5,108782,250498.5
290400,201908,282,208,74,207584.4,73852,281436.4
290405,201908,247,216,31,215568,30938,246506
290410,201908,642,536,106,534928.55,105788,640716.55
290420,201908,250,201,49,200598,48902,249500
290430,201908,483,312,171,311376,170658,482034
290440,201908,73,66,7,65868,6986,72854
290450,201908,230,179,51,178642,50898,229540
290460,201908,1931,1173,758,1170663.8,756485.84,1927149.64
290470,201908,1403,600,803,598809.8,801411.64,1400221.44
290475,201908,581,543,38,541914.68,38922,580836.68
290480,201908,287,159,128,158682,127744,286426
290485,201908,241,225,16,224550,15968,240518
290490,201908,1207,871,336,869258,335328,1204586
290500,201908,716,369,347,368262,346306,714568
290510,201908,230,178,52,177644,51896,229540
290515,201908,146,91,55,90818,54890,145708
290520,201908,1422,943,479,941114.54,478042.73,1419157.27
290530,201908,310,286,24,285428,23952,309380
290540,201908,99,55,44,54890,43912,98802
290550,201908,149,123,26,122754,25948,148702
290560,201908,3207,1365,1842,1362270,1840315.32,3202585.32
290570,201908,5986,3045,2941,3038916.49,2937120.54,5976037.03
290580,201908,1280,773,507,771454,505986,1277440
290590,201908,570,469,101,468062,100798,568860
290600,201908,1754,1218,536,1215566.02,534928,1750494.02
290610,201908,211,189,22,188622.54,21956,210578.54
290620,201908,345,308,37,307384,36926,344310
290630,201908,2004,870,1134,868260,1131733.38,1999993.38
290640,201908,152,126,26,125748,25948,151696
290650,201908,1707,810,897,808380.69,895206,1703586.69
290660,201908,276,226,50,225548,49900,275448
290670,201908,937,492,445,492014.8,444110.63,936125.43
290680,201908,1238,1001,237,999996,236526,1236522
290682,201908,300,224,76,223553.24,75848.98,299402.22
290685,201908,236,152,84,151696,83832,235528
290687,201908,1017,663,354,664830,355288,1020118
290689,201908,143,79,64,78842.97,63872,142714.97
290690,201908,611,262,349,261476.98,348306.84,609783.82
290700,201908,239,117,122,116766,121756,238522
290710,201908,712,482,230,481036,229540,710576
290720,201908,1038,842,196,840316.5,196606,1036922.5
290730,201908,1147,663,484,662672,483032,1145704
290740,201908,15,13,2,12974,1996,14970
290750,201908,1352,627,725,625746,724550.3,1350296.3
290755,201908,73,66,7,65868,6986,72854
290760,201908,297,258,39,257484,38922,296406
290770,201908,190,179,11,178642,10978.4,189620.4
290780,201908,1043,826,217,824351.74,216566,1040917.74
290790,201908,376,262,114,261476,113772,375248
290800,201908,2517,1010,1507,1008978,1505982,2514960
290810,201908,462,322,140,321356.4,139720,461076.4
290820,201908,407,241,166,240518.97,165668,406186.97
290830,201908,405,286,119,285428,118762,404190
290840,201908,1745,1089,656,1086823.28,654688.8,1741512.08
290850,201908,801,446,355,445108.4,354290,799398.4
290860,201908,619,287,332,286426,333332.4,619758.4
290870,201908,634,455,179,454090.64,179640.84,633731.48
290880,201908,124,68,56,67864,55888,123752
290890,201908,363,253,110,252494,109780,362274
290900,201908,167,129,38,128742,37924,166666
290910,201908,385,298,87,297404,86826,384230
290920,201908,222,188,34,187624,33932,221556
290930,201908,844,642,202,640716.4,201596.96,842313.36
290940,201908,245,203,42,202594,41916,244510
290950,201908,164,98,66,97804,65868,163672
290960,201908,470,322,148,321356,147704,469060
290970,201908,250,222,28,221556,27944.4,249500.4
290980,201908,1608,1143,465,1140774.96,464071.6,1604846.56
290990,201908,399,337,62,336326.98,61878.94,398205.92
291000,201908,857,254,603,253492,601794,855286
291005,201908,2225,987,1238,985027.14,1236522.98,2221550.12
291010,201908,159,144,15,143712,14970,158682
291020,201908,102,80,22,79840,21956,101796
291030,201908,94,70,24,69860,23952,93812
291040,201908,592,326,266,325348,265468,590816
291050,201908,1383,784,599,782432.96,598800,1381232.96
291060,201908,1500,844,656,842312,654688,1497000
291070,201908,1967,1473,494,1471053.58,493013.78,1964067.36
291072,201908,7273,2740,4533,2735520.78,4526931.92,7262452.70
291075,201908,224,186,38,185628.6,37924,223552.6
291077,201908,53,36,17,35928,16966,52894
291080,201908,20153,8946,11207,8931169.93,11191699.08,20122869.01
291085,201908,298,244,54,243512,53892,297404
291090,201908,301,119,182,118762.4,182634,301396.4
291100,201908,648,197,451,196606,450098,646704
291110,201908,410,313,97,312434,96806,409240
291120,201908,2469,1214,1255,1211572.7,1252490.99,2464063.69
291125,201908,64,31,33,30938,32934,63872
291130,201908,201,179,22,178642,21956,200598
291140,201908,143,114,29,113772,28942.4,142714.4
291150,201908,386,158,228,157684,227544,385228
291160,201908,385,318,67,317364.5,66866,384230.5
291165,201908,36,30,6,29940,5988,35928
291170,201908,3092,1561,1531,1559876.47,1528936.8,3088813.27
291180,201908,1270,508,762,506987.74,760478.88,1267466.62
291185,201908,80,78,2,77844,1996,79840
291190,201908,1322,591,731,589819.24,730536,1320355.24
291200,201908,166,125,41,124750,40918,165668
291210,201908,2244,904,1340,903191.08,1338319.38,2241510.46
291220,201908,276,209,67,208582,66866,275448
291230,201908,997,347,650,346306.4,649698,996004.4
291240,201908,432,410,22,409180.4,21956,431136.4
291250,201908,443,362,81,361276,80838,442114
291260,201908,53,41,12,40918,11976,52894
291270,201908,1176,489,687,488022,685626,1173648
291280,201908,358,173,185,173652.4,184630,358282.4
291290,201908,1735,904,831,902192.4,831335.4,1733527.8
291300,201908,236,183,53,182634,52894,235528
291310,201908,228,208,20,207584,19960,227544
291320,201908,1392,991,401,990016,401196,1391212
291330,201908,128,109,19,108782,18962,127744
291340,201908,186,106,80,105788,79840,185628
291345,201908,144,98,46,97804,45908,143712
291350,201908,1616,558,1058,556884,1055884.7,1612768.7
291360,201908,8422,4181,4241,4173730.28,4234517.06,8408247.34
291370,201908,1137,647,490,645706.4,489020.98,1134727.38
291380,201908,255,201,54,200598,54890,255488
291390,201908,3829,1710,2119,1708578.12,2114762.4,3823340.52
291400,201908,2084,1492,592,1489016,590816.81,2079832.81
291410,201908,164,145,19,144710,18962,163672
291420,201908,115,85,30,84830,29940,114770
291430,201908,162,89,73,88822,72854.11,161676.11
291440,201908,518,423,95,422154.8,94810,516964.8
291450,201908,902,575,327,574848.5,327344,902192.5
291460,201908,1816,1480,336,1478039.6,335328,1813367.6
291465,201908,2173,1049,1124,1046915.9,1121765.58,2168681.48
291470,201908,2863,1455,1408,1452090.71,1406182.4,2858273.11
291480,201908,11682,5232,6450,5226550.73,6443211.4,11669762.13
291490,201908,565,240,325,239520,324350,563870
291500,201908,377,218,159,217564,158682,376246
291510,201908,1218,476,742,475048,741514,1216562
291520,201908,944,435,509,434130,508980,943110
291530,201908,975,275,700,274450,698600,973050
291535,201908,127,107,20,106786,19960,126746
291540,201908,351,104,247,103792.4,246506.2,350298.6
291550,201908,1207,582,625,580837.2,624749.38,1205586.58
291560,201908,5327,2730,2597,2724632.56,2592972.83,5317605.39
291570,201908,199,102,97,101796,96806,198602
291580,201908,1222,751,471,749499.81,470058,1219557.81
291590,201908,82,34,48,33932,48902,82834
291600,201908,1166,583,583,581834,581835.96,1163669.96
291610,201908,1474,720,754,718560,753491.58,1472051.58
291620,201908,571,264,307,263472,306386,569858
291630,201908,467,147,320,146706,320358,467064
291640,201908,3971,2037,1934,2032930.2,1930144.96,3963075.16
291650,201908,418,286,132,285429.15,132734,418163.15
291660,201908,396,158,238,157684,239520,397204
291670,201908,222,142,80,141716,79840,221556
291680,201908,672,397,275,396206,274450.8,670656.8
291685,201908,586,327,259,326346.5,258482,584828.5
291690,201908,570,325,245,324350,244511.86,568861.86
291700,201908,962,759,203,757482,202594,960076
291710,201908,1685,808,877,807382.5,876244.98,1683627.48
291720,201908,412,276,136,275448,135728,411176
291730,201908,942,560,382,558880,381236,940116
291733,201908,285,197,88,196606,87824,284430
291735,201908,75,56,19,55888,18962,74850
291740,201908,350,272,78,271456,77844,349300
291750,201908,2081,1362,719,1359276.8,717562,2076838.8
291760,201908,3028,1673,1355,1669654,1353288,3022942
291770,201908,774,523,251,521959.33,250498,772457.33
291780,201908,49,30,19,29940,18962,48902
291790,201908,164,81,83,80838,82834,163672
291800,201908,10072,4173,5899,4168648.91,5891197.08,10059845.99
291810,201908,1130,833,297,832332.4,296406.6,1128739.0
291820,201908,271,196,75,195608,74850,270458
291830,201908,1111,445,666,444110.98,664668.98,1108779.96
291835,201908,574,533,41,531934,40918,572852
291840,201908,4838,2504,2334,2500989.35,2330331.38,4831320.73
291845,201908,277,96,181,95808,180638,276446
291850,201908,330,293,37,292414,36926,329340
291855,201908,256,102,154,101796,154690,256486
291860,201908,170,107,63,106786,62874,169660
291870,201908,84,33,51,32934,50898,83832
291875,201908,182,169,13,168662,12974,181636
291880,201908,856,556,300,554888,299400.6,854288.6
291890,201908,238,77,161,76846,160678.4,237524.4
291900,201908,59,34,25,33932,24950,58882
291905,201908,127,92,35,91816.4,34930,126746.4
291910,201908,172,139,33,138722,32934,171656
291915,201908,419,371,48,370258.5,47904,418162.5
291920,201908,4948,2565,2383,2560868.98,2378235.98,4939104.96
291930,201908,179,107,72,106786,71856,178642
291940,201908,356,201,155,201596,154690,356286
291950,201908,1137,925,212,923150.4,211576,1134726.4
291955,201908,1203,720,483,718560.4,482034,1200594.4
291960,201908,180,131,49,130738,48902,179640
291970,201908,772,582,190,580836,189620,770456
291980,201908,1523,1347,176,1344307.38,175648.4,1519955.78
291990,201908,132,122,10,121756,9980,131736
291992,201908,169,83,86,82834,85828,168662
291995,201908,162,109,53,108782,52894,161676
292000,201908,391,303,88,303392.4,87824,391216.4
292010,201908,302,213,89,212574,88822,301396
292020,201908,289,213,76,212574,77844,290418
292030,201908,147,115,32,114770,31936,146706
292040,201908,641,323,318,322354,317364,639718
292045,201908,101,93,8,92814,7984,100798
292050,201908,940,686,254,684628,253492.4,938120.4
292060,201908,923,770,153,768460.86,153692,922152.86
292070,201908,48,20,28,19960,27944,47904
292080,201908,135,93,42,92814,41916,134730
292090,201908,514,188,326,187624,325348,512972
292100,201908,1408,624,784,622752.6,788420.98,1411173.58
292105,201908,208,179,29,178642,28942,207584
292110,201908,2241,849,1392,847302,1390219.86,2237521.86
292120,201908,692,547,145,545906,144710,690616
292130,201908,444,261,183,260478,182634,443112
292140,201908,206,163,43,162674,42914,205588
292145,201908,165,86,79,85828.4,78842,164670.4
292150,201908,1470,1198,272,1195604,272454,1468058
292160,201908,176,145,31,144710,30938,175648
292170,201908,1210,1061,149,1058878,148702,1207580
292180,201908,216,156,60,155688,59880,215568
292190,201908,160,100,60,99800,59880,159680
292200,201908,1288,488,800,487025.36,799399.36,1286424.72
292205,201908,127,112,15,111776,14970,126746
292210,201908,368,260,108,260478,107784,368262
292220,201908,24,19,5,18962,4990,23952
292225,201908,38,33,5,32934,4990,37924
292230,201908,973,788,185,786424.3,184630,971054.3
292240,201908,610,447,163,446106.7,162674,608780.7
292250,201908,1758,1158,600,1155684,598800.4,1754484.4
292260,201908,430,256,174,255488,173712,429200
292265,201908,249,176,73,175648,73852,249500
292270,201908,349,158,191,157684,190618,348302
292273,201908,198,111,87,110778,86826,197604
292275,201908,177,89,88,88822,87824,176646
292280,201908,142,102,40,101796,39920,141716
292285,201908,70,59,11,58882,10978,69860
292290,201908,576,391,185,390218,184630.4,574848.4
292300,201908,1651,647,1004,646704.4,1002990.72,1649695.12
292303,201908,103,69,34,68862,33932,102794
292305,201908,111,82,29,81836,29940,111776
292310,201908,899,592,307,592813.24,307384.56,900197.80
292320,201908,620,471,149,470058,148702,618760
292330,201908,178,102,76,101796,75848,177644
292335,201908,288,227,61,226546,60878,287424
292340,201908,579,406,173,405188.4,172654,577842.4
292350,201908,268,144,124,143712,123752,267464
292360,201908,710,541,169,539918.56,168662,708580.56
292370,201908,751,574,177,572852,176646,749498
292380,201908,661,520,141,518960.54,140718,659678.54
292390,201908,491,198,293,197604,292414,490018
292400,201908,3491,2175,1316,2170652.14,1313369,3484021.14
292405,201908,270,178,92,177644,91816,269460
292410,201908,143,86,57,85828,56886,142714
292420,201908,299,257,42,256486,41916,298402
292430,201908,522,408,114,407184,114770,521954
292440,201908,592,509,83,507982.44,83832,591814.44
292450,201908,260,202,58,201596,57884,259480
292460,201908,565,424,141,423152.98,140718,563870.98
292465,201908,218,179,39,178642,38922,217564
292467,201908,119,72,47,71856,46906,118762
292470,201908,282,193,89,192614,88822,281436
292480,201908,346,238,108,237524,107784.4,345308.4
292490,201908,229,158,71,157684,70858,228542
292500,201908,1130,497,633,496006.75,632732,1128738.75
292510,201908,3408,1571,1837,1568856.44,1834326.16,3403182.60
292520,201908,1099,518,581,518960.99,579838.98,1098799.97
292525,201908,401,284,117,283432,116766,400198
292530,201908,4314,1782,2532,1778439.73,2526940.52,4305380.25
292540,201908,472,267,205,266466,204590,471056
292550,201908,1045,571,474,569870.52,473063.54,1042934.06
292560,201908,322,304,18,303392,17964,321356
292570,201908,304,236,68,235528,67864,303392
292575,201908,487,315,172,314370.4,172654,487024.4
292580,201908,975,645,330,643710,330338.4,974048.4
292590,201908,555,483,72,482034,71856,553890
292593,201908,140,111,29,110778,28942,139720
292595,201908,188,145,43,144710,42914,187624
292600,201908,1252,920,332,918160.63,331336,1249496.63
292610,201908,133,101,32,100798,31936,132734
292620,201908,537,452,85,451116.4,84830,535946.4
292630,201908,1411,808,603,806384.67,602792.27,1409176.94
292640,201908,801,556,245,554888,245508,800396
292650,201908,183,155,28,154690.4,27944,182634.4
292660,201908,2046,1476,570,1473048.6,569858.74,2042907.34
292665,201908,146,106,40,105788,39920,145708
292670,201908,399,324,75,323352.99,74850,398202.99
292680,201908,261,198,63,197604,62874,260478
292690,201908,187,143,44,142714,43912,186626
292700,201908,940,630,310,628740,309380,938120
292710,201908,109,96,13,95808,12974,108782
292720,201908,909,513,396,513970,395208,909178
292730,201908,195,94,101,93812,100798,194610
292740,201908,67541,33602,33939,33548982.17,33902361.27,67451343.44
292750,201908,389,280,109,280438.78,108782,389220.78
292760,201908,337,277,60,276446.38,59880,336326.38
292770,201908,783,340,443,339320.4,443112,782432.4
292780,201908,406,160,246,159680,245508,405188
292790,201908,749,379,370,378242,371256,749498
292800,201908,1226,740,486,738520,485028,1223548
292805,201908,394,113,281,112774,280438,393212
292810,201908,1479,844,635,842313.2,633730.98,1476044.18
292820,201908,723,595,128,594808.7,127744.98,722553.68
292830,201908,106,87,19,86826,18962,105788
292840,201908,693,570,123,569858.6,122754,692612.6
292850,201908,140,96,44,95808,43912,139720
292860,201908,2172,1282,890,1280434.4,888220.6,2168655.0
292870,201908,3464,2328,1136,2323347.53,1134726,3458073.53
292880,201908,1485,975,510,973050.82,508980,1482030.82
292890,201908,516,443,73,442115.94,72854,514969.94
292895,201908,138,89,49,88822,48902,137724
292900,201908,397,291,106,290418.36,105788,396206.36
292905,201908,467,237,230,236526,229540,466066
292910,201908,443,342,101,341316.3,100798,442114.3
292920,201908,523,234,289,233532,288422,521954
292925,201908,497,458,39,457084,38982,496066
292930,201908,591,360,231,359280,230538,589818
292935,201908,285,122,163,121756,162674.98,284430.98
292937,201908,243,165,78,164670,77844,242514
292940,201908,196,153,43,152694,42914,195608
292950,201908,1116,586,530,584829.3,529938.6,1114767.9
292960,201908,610,432,178,431136,177644,608780
292970,201908,251,180,71,179640,70858,250498
292975,201908,126,71,55,70858,54890.6,125748.6
292980,201908,277,186,91,185628.76,90818,276446.76
292990,201908,1326,992,334,990016.8,334330,1324346.8
293000,201908,108,78,30,77844,29940,107784
293010,201908,2769,1685,1084,1683626.3,1081832.99,2765459.29
293015,201908,669,536,133,534928,132734,667662
293020,201908,334,274,60,273452,59880,333332
293030,201908,601,524,77,522952.8,76846,599798.8
293040,201908,352,281,71,280438,70858,351296
293050,201908,2815,1681,1134,1677638.4,1132771.9,2810410.3
293060,201908,256,208,48,207584.58,47904,255488.58
293070,201908,3426,1776,1650,1772510.37,1646702.98,3419213.35
293075,201908,92,61,31,60878,30938,91816
293076,201908,73,49,24,48902,23952,72854
293077,201908,483,286,197,285428.4,196606,482034.4
293080,201908,446,403,43,402194.74,42914,445108.74
293090,201908,135,119,16,118762,15968,134730
293100,201908,530,372,158,371256,157684,528940
293105,201908,343,241,102,240518,101796,342314
293110,201908,173,123,50,122754,49900,172654
293120,201908,334,228,106,227544.45,105788,333332.45
293130,201908,244,168,76,167664,75848,243512
293135,201908,7929,3167,4762,3161684.5,4752527.04,7914211.54
293140,201908,197,129,68,128742.6,67864,196606.6
293150,201908,325,279,46,278442,45908,324350
293160,201908,425,246,179,245508,178642,424150
293170,201908,163,115,48,114770,47904,162674
293180,201908,490,350,140,349300,139720,489020
293190,201908,1353,948,405,946104.7,404190,1350294.7
293200,201908,537,477,60,476046,59880,535926
293210,201908,387,299,88,298402,87824,386226
293220,201908,2561,1079,1482,1076842,1480034.58,2556876.58
293230,201908,1704,635,1069,633730.35,1067860,1701590.35
293240,201908,227,209,18,208582,17964,226546
293245,201908,120,100,20,99800,19960,119760
293250,201908,700,255,445,255488.67,444110,699598.67
293260,201908,300,251,49,250498,48902,299400
293270,201908,1138,537,601,535926.68,599798,1135724.68
293280,201908,263,147,116,146706,115768,262474
293290,201908,3032,1993,1039,1989014.61,1036983.85,3025998.46
293300,201908,719,516,203,514969.67,202594,717563.67
293305,201908,171,143,28,142714,27944,170658
293310,201908,148,113,35,112774,34930,147704
293315,201908,168,131,37,130738,36926,167664
293317,201908,94,67,27,66866,26946,93812
293320,201908,1020,586,434,584828,434130,1018958
293325,201908,185,70,115,69860,114770,184630
293330,201908,13259,6286,6973,6274428.72,6962054.12,13236482.84
293340,201908,262,191,71,191616,70858,262474
293345,201908,242,193,49,192614,48902,241516
293350,201908,623,358,265,357284.4,265468,622752.4
293360,201908,1548,1107,441,1104786,440118,1544904
310010,201908,140,75,65,74850,64870.4,139720.4
310020,201908,1046,586,460,585826.4,459080.44,1044906.84
310030,201908,331,271,60,270458.2,59880,330338.2
310040,201908,47,32,15,31936,14970,46906
310050,201908,186,121,65,120758,65868,186626
310060,201908,241,171,70,170658,70858,241516
310070,201908,14,8,6,7984,5988,13972
310080,201908,43,24,19,23952,18962,42914
310090,201908,980,520,460,518961.6,459080.8,978042.4
310100,201908,304,234,70,233532,69860,303392
310110,201908,713,395,318,394210,317364.4,711574.4
310120,201908,377,221,156,220558,156686,377244
310130,201908,32,20,12,19960,11976,31936
310140,201908,25,13,12,12974,11976,24950
310150,201908,1246,861,385,859279,385228.8,1244507.8
310160,201908,2042,1042,1000,1039917.69,999996.8,2039914.49
310163,201908,94,54,40,53892,39920,93812
310170,201908,2564,1136,1428,1134726.74,1427182.12,2561908.86
310180,201908,126,51,75,50898.4,74850,125748.4
310190,201908,480,335,145,334330,144710,479040
310200,201908,497,322,175,321356.4,174650,496006.4
310205,201908,53,39,14,38922,13972,52894
310210,201908,283,229,54,228542,53892,282434
310220,201908,58,35,23,34930,22954,57884
310230,201908,267,187,80,186626,79840,266466
310240,201908,103,92,11,91816,10978,102794
310250,201908,103,82,21,81836,20958,102794
310260,201908,761,415,346,414172.04,346306,760478.04
310270,201908,271,184,87,183632.44,86826,270458.44
310280,201908,368,275,93,274450,92814,367264
310285,201908,211,153,58,152694,57884,210578
310290,201908,248,137,111,136726,110778,247504
310300,201908,148,123,25,122754,24950,147704
310310,201908,9,7,2,6986,1996,8982
310320,201908,28,13,15,12974,14970,27944
310330,201908,33,25,8,24950,7984,32934
310340,201908,1742,1160,582,1157681.4,582832.4,1740513.8
310350,201908,2833,1566,1267,1564865.38,1264466.98,2829332.36
310360,201908,40,33,7,32934,6986,39920
310370,201908,120,100,20,99800,19960.4,119760.4
310375,201908,105,39,66,38922,66866.96,105788.96
310380,201908,48,28,20,27944,19960,47904
310390,201908,93,64,29,63872,28942,92814
310400,201908,2343,1562,781,1560872.8,782432,2343304.8
310410,201908,122,70,52,69860,51896,121756
310420,201908,664,353,311,352294.8,310378.2,662673.0
310430,201908,313,206,107,205588,106786,312374
310440,201908,72,44,28,43912,27944,71856
310445,201908,81,68,13,67864,12974,80838
310450,201908,835,527,308,525946,308382,834328
310460,201908,252,183,69,182634,69860,252494
310470,201908,508,332,176,331336,175648,506984
310480,201908,80,60,20,59880,19960,79840
310490,201908,524,255,269,254490,268462,522952
310500,201908,126,52,74,51896,74850,126746
310510,201908,596,411,185,410178,185628.98,595806.98
310520,201908,133,95,38,94810,37924,132734
310530,201908,99,44,55,43912,54890,98802
310540,201908,457,274,183,273452.6,182634,456086.6
310550,201908,84,56,28,55888,27944,83832
310560,201908,3010,2077,933,2072849.56,931134,3003983.56
310570,201908,107,74,33,73852,32934,106786
310590,201908,370,242,128,241516.5,127744,369260.5
310600,201908,154,87,67,87824.4,66866,154690.4
310610,201908,61,24,37,23952,36926,60878
310620,201908,46384,22549,23835,22519295.37,23802864.37,46322159.74
310630,201908,616,403,213,402194,212574.4,614768.4
310640,201908,147,117,30,116766,29940,146706
310650,201908,163,143,20,142714,19960,162674
310660,201908,89,59,30,58882,29940,88822
310665,201908,59,43,16,42914,15968,58882
310670,201908,6499,2924,3575,2920154.1,3571868.1,6492022.2
310680,201908,59,36,23,35928,22954,58882
310690,201908,587,416,171,415168.1,170658,585826.1
310700,201908,56,38,18,37924,17964,55888
310710,201908,1332,912,420,910177.38,420158.4,1330335.78
310720,201908,106,32,74,31936,73852,105788
310730,201908,1402,1000,402,1000994.9,401196,1402190.9
310740,201908,975,554,421,553891.2,421156.5,975047.7
310750,201908,242,145,97,144710.66,96806,241516.66
310760,201908,61,43,18,42914,17964.4,60878.4
310770,201908,97,46,51,45908,50898,96806
310780,201908,375,309,66,308382.98,65868,374250.98
310790,201908,100,81,19,80838,18962,99800
310800,201908,453,224,229,223552.5,228542,452094.5
310810,201908,170,121,49,120758.9,48902,169660.9
310820,201908,350,278,72,277444,71856,349300
310825,201908,197,166,31,165668,30938,196606
310830,201908,461,225,236,224550.4,235528,460078.4
310840,201908,360,210,150,209580,149700,359280
310850,201908,105,86,19,85828,18962,104790
310855,201908,394,316,78,315368,77844,393212
310860,201908,1573,1180,393,1177643.16,393212.7,1570855.86
310870,201908,55,45,10,44910,9980,54890
310880,201908,82,63,19,62874,18962,81836
310890,201908,297,179,118,178642,117764,296406
310900,201908,656,303,353,302404.68,353308.08,655712.76
310910,201908,239,164,75,163672.6,74850,238522.6
310920,201908,467,276,191,275448.9,190618,466066.9
310925,201908,34,27,7,27944,6986.4,34930.4
310930,201908,1070,664,406,662687.84,405197.9,1067885.74
310940,201908,666,348,318,347304,317364,664668
310945,201908,123,76,47,75848,46906,122754
310950,201908,243,196,47,195608,46906,242514
310960,201908,80,28,52,27944,51896.99,79840.99
310970,201908,165,105,60,104790,59880,164670
310980,201908,44,25,19,24950,18962,43912
310990,201908,145,77,68,76846,67864,144710
311000,201908,816,418,398,417165.77,399200.98,816366.75
311010,201908,43,37,6,36926,5988,42914
311020,201908,42,26,16,25948,15968,41916
311030,201908,391,230,161,229540,160678,390218
311040,201908,39,35,4,34930,3992,38922
311050,201908,475,194,281,193612.8,281436,475048.8
311060,201908,774,439,335,438122.4,334330.4,772452.8
311070,201908,345,167,178,166666,177644,344310
311080,201908,108,59,49,58882,48902,107784
311090,201908,334,161,173,160678.4,172654,333332.4
311100,201908,599,358,241,357284,240518,597802
311110,201908,696,486,210,486026.4,209580.98,695607.38
311115,201908,75,55,20,54890,19960,74850
311120,201908,1081,574,507,573850.4,505986,1079836.4
311130,201908,374,223,151,222554,150698,373252
311140,201908,161,90,71,89820,70858,160678
311150,201908,358,237,121,236526,120758,357284
311160,201908,715,518,197,516964.4,196606,713570.4
311170,201908,85,68,17,67864,16966,84830
311180,201908,342,228,114,227544,113772.4,341316.4
311190,201908,32,15,17,14970,16966,31936
311200,201908,325,233,92,232534,91816,324350
311205,201908,34,24,10,23952,9980,33932
311210,201908,50,42,8,41916.8,7984,49900.8
311220,201908,20,19,1,18962,998,19960
311230,201908,1631,1078,553,1075844.6,551894,1627738.6
311240,201908,174,114,60,113772,59880,173652
311250,201908,95,26,69,25948,68862,94810
311260,201908,555,352,203,351296,202594,553890
311265,201908,119,85,34,84830,33932,118762
311270,201908,290,201,89,200598,88822,289420
311280,201908,211,100,111,99800,110778,210578
311290,201908,108,87,21,86826,20958.4,107784.4
311300,201908,590,371,219,370258,218562,588820
311310,201908,23,17,6,16966,5988,22954
311320,201908,667,500,167,499000,167664,666664
311330,201908,1094,817,277,816364,276446.8,1092810.8
311340,201908,2590,1845,745,1842308.8,743510.98,2585819.78
311350,201908,274,213,61,212574,60878,273452
311360,201908,170,107,63,106786,62874,169660
311370,201908,1191,501,690,501994.5,691614.96,1193609.46
311380,201908,7,6,1,5988,998,6986
311390,201908,257,143,114,142714,113772,256486
311400,201908,153,103,50,102794,49900,152694
311410,201908,103,60,43,59880,42914,102794
311420,201908,300,168,132,167664.6,131736,299400.6
311430,201908,859,572,287,572852.5,286426.4,859278.9
311440,201908,477,337,140,336326,140718,477044
311450,201908,319,203,116,202594,115768,318362
311455,201908,284,196,88,196606,87824,284430
311460,201908,137,57,80,56886,79840,136726
311470,201908,22,13,9,12974,8982,21956
311480,201908,44,20,24,19960,23952,43912
311490,201908,17,11,6,10978,5988,16966
311500,201908,23,10,13,9980,12974,22954
311510,201908,627,445,182,446106,181636,627742
311520,201908,40,32,8,31936,7984,39920
311530,201908,1808,1358,450,1356284.35,451096,1807380.35
311535,201908,68,49,19,48902,18962,67864
311540,201908,36,31,5,30938,4990,35928
311545,201908,191,139,52,138722,51896,190618
311547,201908,34,26,8,25948,7984.96,33932.96
311550,201908,663,319,344,318362,343312.98,661674.98
311560,201908,43,29,14,28942,13972,42914
311570,201908,287,196,91,195608,90818,286426
311580,201908,328,197,131,197604,130738,328342
311590,201908,33,30,3,29940,2994,32934
311600,201908,98,78,20,77844,19960,97804
311610,201908,255,221,34,220559.19,33932,254491.19
311615,201908,115,97,18,96806,17964,114770
311620,201908,23,12,11,11976,10978,22954
311630,201908,85,71,14,70858,13972,84830
311640,201908,130,70,60,69860,59880,129740
311650,201908,133,95,38,94810,37924,132734
311660,201908,406,195,211,194610,210578,405188
311670,201908,161,105,56,104790.58,55888,160678.58
311680,201908,213,157,56,156686,55888,212574
311690,201908,12,8,4,7984,3992,11976
311700,201908,199,140,59,139720,58882,198602
311710,201908,199,129,70,128742,69860,198602
311720,201908,39,29,10,28942.4,9980,38922.4
311730,201908,599,398,201,399200,200598,599798
311740,201908,36,26,10,25948,9980,35928
311750,201908,713,481,232,480039.36,231536,711575.36
311760,201908,60,33,27,32934,26946,59880
311770,201908,389,197,192,196607.34,191616,388223.34
311780,201908,177,98,79,97804.4,78842,176646.4
311783,201908,86,76,10,75848,9980,85828
311787,201908,34,14,20,13972,19960,33932
311790,201908,264,123,141,122754,140718,263472
311800,201908,669,450,219,449100.9,218562,667662.9
311810,201908,50,42,8,41916,7984,49900
311820,201908,114,96,18,95808,17964,113772
311830,201908,1909,1205,704,1203589.64,702592,1906181.64
311840,201908,1003,564,439,562873.5,438122.9,1000996.4
311850,201908,9,5,4,4990,3992,8982
311860,201908,9411,4267,5144,4261522.58,5134776.11,9396298.69
311870,201908,135,74,61,73852,60878,134730
311880,201908,932,689,243,687623.38,242514,930137.38
311890,201908,211,105,106,104708,106786,211494
311900,201908,78,33,45,32934,44910,77844
311910,201908,1417,895,522,893210.7,521954.4,1415165.1
311920,201908,225,150,75,149700,74850,224550
311930,201908,906,528,378,526944.4,377244,904188.4
311940,201908,2458,1310,1148,1308378,1147700.86,2456078.86
311950,201908,59,45,14,44910,13972,58882
311960,201908,64,46,18,45908,17964,63872
311970,201908,25,16,9,15968,8982,24950
311980,201908,45,35,10,34930,9980,44910
311990,201908,42,34,8,33932,7984,41916
311995,201908,56,37,19,36926,18962,55888
312000,201908,31,22,9,21956,8982,30938
312010,201908,81,62,19,61876,18962,80838
312015,201908,91,68,23,67864.4,23952,91816.4
312020,201908,128,84,44,83832.4,43912,127744.4
312030,201908,51,40,11,39920,10978,50898
312040,201908,87,55,32,54890.4,31936,86826.4
312050,201908,216,121,95,120758,94810,215568
312060,201908,63,38,25,37924,24950,62874
312070,201908,73,46,27,45908,26946,72854
312080,201908,531,244,287,243512,286426,529938
312083,201908,56,40,16,39920,15968,55888
312087,201908,111,88,23,87824,22954,110778
312090,201908,3102,1866,1236,1862272.84,1234566.4,3096839.24
312100,201908,151,105,46,104560.86,45908,150468.86
312110,201908,113,69,44,68862,43912,112774
312120,201908,143,107,36,106786.97,35928,142714.97
312125,201908,90,48,42,47904,41916,89820
312130,201908,123,84,39,83832,38922,122754
312140,201908,144,112,32,111776.4,31936,143712.4
312150,201908,45,35,10,34930,9980,44910
312160,201908,1539,1015,524,1013061.2,522952.4,1536013.6
312170,201908,10,9,1,8982,998,9980
312180,201908,104,66,38,65868,37924.8,103792.8
312190,201908,33,29,4,29940,3992,33932
312200,201908,756,651,105,649698.4,104790,754488.4
312210,201908,90,60,30,59880,29940,89820
312220,201908,138,101,37,100798.5,36926,137724.5
312230,201908,3571,1738,1833,1736522.72,1831339.04,3567861.76
312235,201908,167,114,53,113772,52894,166666
312240,201908,103,73,30,73852,29940,103792
312245,201908,180,127,53,126746.99,52894,179640.99
312247,201908,65,47,18,46906,17964,64870
312250,201908,179,87,92,86826,91816,178642
312260,201908,114,75,39,74850,38922,113772
312270,201908,133,81,52,80838,51896,132734
312280,201908,27,14,13,13972,12974,26946
312290,201908,155,108,47,107784,46906.6,154690.6
312300,201908,205,135,70,134730,69860,204590
312310,201908,57,52,5,51896,4990,56886
312320,201908,433,278,155,277444,155688.1,433132.1
312330,201908,91,81,10,81836,9980,91816
312340,201908,38,17,21,16966,20958,37924
312350,201908,18,11,7,10978,6986,17964
312352,201908,98,69,29,68862,28942,97804
312360,201908,561,249,312,248502,311376,559878
312370,201908,303,173,130,173652,129740.4,303392.4
312380,201908,145,99,46,98802,45908,144710
312385,201908,168,136,32,135728,31936,167664
312390,201908,306,192,114,191616,113772,305388
312400,201908,373,286,87,285428,86827,372255
312410,201908,924,308,616,307384,617763.39,925147.39
312420,201908,620,483,137,482034.4,136726,618760.4
312430,201908,859,636,223,634729.89,222554,857283.89
312440,201908,44,34,10,33932,9980,43912
312450,201908,205,129,76,128742,75848,204590
312460,201908,33,16,17,15968,16966,32934
312470,201908,51,33,18,32934,17964,50898
312480,201908,194,117,77,116766,76846,193612
312490,201908,269,192,77,191616,76846,268462
312500,201908,34,19,15,18962,14970,33932
312510,201908,505,199,306,198602,305388,503990
312520,201908,38,11,27,10978,26946,37924
312530,201908,49,34,15,33932,14970,48902
312540,201908,101,88,13,87824,12974,100798
312550,201908,40,31,9,30938,8982,39920
312560,201908,224,171,53,170658.4,52894,223552.4
312570,201908,442,267,175,266466,174650,441116
312580,201908,88,47,41,46906,40918,87824
312590,201908,252,198,54,197604,53892,251496
312595,201908,136,123,13,122754,12974,135728
312600,201908,70,43,27,42914.1,26946,69860.1
312610,201908,1578,829,749,828341.6,747502.4,1575844.0
312620,201908,200,146,54,145708,53892,199600
312630,201908,68,57,11,56886,10978,67864
312640,201908,43,12,31,11976,30938,42914
312650,201908,152,128,24,127744.4,23952,151696.4
312660,201908,78,59,19,58882.7,18962,77844.7
312670,201908,889,590,299,588820,298402,887222
312675,201908,34,26,8,25948,7984,33932
312680,201908,81,54,27,53892,26946,80838
312690,201908,240,129,111,128742,110778,239520
312695,201908,39,32,7,31936,6986,38922
312700,201908,220,130,90,129740,89820,219560
312705,201908,84,70,14,69860,13972,83832
312707,201908,129,93,36,92814.3,35928,128742.3
312710,201908,1861,1014,847,1014967.28,850296,1865263.28
312720,201908,65,33,32,32934,31936,64870
312730,201908,273,161,112,160678,111776,272454
312733,201908,55,47,8,46906,7984,54890
312735,201908,25,16,9,15968,8982,24950
312737,201908,71,37,34,36926,33932,70858
312738,201908,52,38,14,37924,13972,51896
312740,201908,77,52,25,51896.4,24950,76846.4
312750,201908,69,51,18,50898,17964,68862
312760,201908,276,201,75,201596,74850,276446
312770,201908,7564,3551,4013,3546900.92,4013959.93,7560860.85
312780,201908,418,325,93,324350,92814,417164
312790,201908,21,17,4,16966,3992,20958
312800,201908,1602,1117,485,1116762.9,484030.46,1600793.36
312810,201908,368,237,131,236585.88,130738,367323.88
312820,201908,188,140,48,139720,47904,187624
312825,201908,26,18,8,17964,7984,25948
312830,201908,245,143,102,142714.46,101796,244510.46
312840,201908,154,110,44,109780,43912,153692
312850,201908,49,45,4,44910,3992,48902
312860,201908,157,101,56,100798,55888,156686
312870,201908,1016,539,477,537922.9,478042,1015964.9
312880,201908,142,99,43,98802,42914,141716
312890,201908,163,114,49,113772,48902,162674
312900,201908,201,152,49,151696,48902,200598
312910,201908,184,97,87,96806,86826,183632
312920,201908,157,90,67,89820,66866,156686
312930,201908,324,233,91,232534,90818,323352
312940,201908,111,80,31,79840,30938,110778
312950,201908,698,472,226,471056,227544,698600
312960,201908,171,130,41,129740.96,40918,170658.96
312965,201908,64,56,8,55888,7984,63872
312970,201908,278,225,53,224550.5,52894,277444.5
312980,201908,2392,1258,1134,1255485.99,1132730,2388215.99
312990,201908,43,23,20,22954,19960,42914
313000,201908,47,28,19,27944,18962,46906
313005,201908,167,133,34,132734,33932.4,166666.4
313010,201908,921,377,544,376246,543910.98,920156.98
313020,201908,189,101,88,100798,87824,188622
313030,201908,201,132,69,131736.54,68862,200598.54
313040,201908,72,25,47,24950,46906,71856
313050,201908,191,139,52,138722,51896,190618
313055,201908,43,33,10,32934,9980,42914
313060,201908,123,88,35,87824,34930,122754
313065,201908,58,41,17,40918,16966,57884
313070,201908,139,75,64,74850,63872,138722
313080,201908,41,18,23,17964,22954,40918
313090,201908,696,481,215,480038.4,215568,695606.4
313100,201908,167,63,104,62874,103792,166666
313110,201908,135,73,62,72854,61876,134730
313115,201908,186,104,82,103792,81836,185628
313120,201908,779,446,333,446106.4,332334.4,778440.8
313130,201908,5470,3037,2433,3031930.82,2428135.9,5460066.72
313140,201908,146,78,68,77844,67864,145708
313150,201908,304,243,61,242514,60878,303392
313160,201908,189,140,49,139720.4,48902,188622.4
313170,201908,1385,964,421,962073.6,420158.98,1382232.58
313180,201908,305,183,122,182634,121756,304390
313190,201908,745,452,293,451096,292414.51,743510.51
313200,201908,28,25,3,24950,2994,27944
313210,201908,1009,860,149,858281.62,149700,1007981.62
313220,201908,255,166,89,165668,88822.4,254490.4
313230,201908,273,207,66,206586.65,65868,272454.65
313240,201908,2084,1110,974,1107784.29,972052,2079836.29
313250,201908,1268,963,305,961075.4,304391.12,1265466.52
313260,201908,89,50,39,49900,38922,88822
313270,201908,956,568,388,567862.3,387224.8,955087.1
313280,201908,55,46,9,45908,8982,54890
313290,201908,224,181,43,180638.4,42914,223552.4
313300,201908,354,186,168,185629,168662,354291
313310,201908,243,125,118,124750,117764,242514
313320,201908,365,278,87,277444.6,86826,364270.6
313330,201908,1383,870,513,868260,511974,1380234
313340,201908,328,231,97,230538,96806,327344
313350,201908,496,334,162,333332,161676,495008
313360,201908,122,69,53,68862,52894.4,121756.4
313370,201908,191,71,120,70858,119760,190618
313375,201908,272,166,106,165668,106786,272454
313380,201908,1305,704,601,702592.2,599798.99,1302391.19
313390,201908,53,47,6,46906.6,5988,52894.6
313400,201908,413,282,131,281436.6,131736.8,413173.4
313410,201908,23,14,9,13972,8982,22954
313420,201908,4643,2502,2141,2496997.4,2137716.7,4634714.1
313430,201908,140,71,69,70858,68862,139720
313440,201908,1435,992,443,991015.11,442115.6,1433130.71
313450,201908,62,26,36,25948,35928,61876
313460,201908,377,176,201,175648,200598,376246
313470,201908,526,246,280,245508.8,279440,524948.8
313480,201908,148,106,42,105788.4,41916,147704.4
313490,201908,511,245,266,244510.4,265468.9,509979.3
313500,201908,21,12,9,11976,8982,20958
313505,201908,1003,799,204,797402,203592,1000994
313507,201908,97,59,38,58882,37924,96806
313510,201908,2758,1785,973,1781431,976044,2757475
313520,201908,3508,2764,744,2759474.45,743510.99,3502985.44
313530,201908,40,27,13,26946,12974,39920
313535,201908,52,45,7,44910,6986,51896
313540,201908,71,53,18,52894,17964,70858
313545,201908,118,100,18,99800,17964,117764
313550,201908,229,194,35,193612,34930.4,228542.4
313560,201908,327,168,159,167664,158682,326346
313570,201908,58,28,30,27944,29940,57884
313580,201908,1320,747,573,745506,571855.2,1317361.2
313590,201908,76,45,31,44910,31936,76846
313600,201908,675,416,259,415168,259480.4,674648.4
313610,201908,59,49,10,48902.4,9980,58882.4
313620,201908,1385,732,653,730536.8,651753.88,1382290.68
313630,201908,1620,1256,364,1253488.8,363272,1616760.8
313640,201908,125,76,49,75848,48902,124750
313650,201908,238,113,125,112774,124750.4,237524.4
313652,201908,17,17,0,16966,0,16966
313655,201908,61,37,24,36926,23952,60878
313657,201908,48,45,3,44910,2994,47904
313660,201908,131,92,39,91816,38939.96,130755.96
313665,201908,648,321,327,321356.3,326346,647702.3
313670,201908,10326,7161,3165,7153670.93,3160667.6,10314338.53
313680,201908,42,31,11,30938,10978.78,41916.78
313690,201908,150,112,38,111776,37924,149700
313695,201908,73,57,16,56886,15968,72854
313700,201908,308,248,60,247504.4,59880,307384.4
313710,201908,143,99,44,98802,43912,142714
313720,201908,1110,538,572,536924.4,570857.4,1107781.8
313730,201908,61,42,19,41916,18962,60878
313740,201908,156,128,28,127744,27944,155688
313750,201908,420,308,112,307384,111776,419160
313753,201908,235,175,60,174650,59880,234530
313760,201908,1253,460,793,459080.4,792414.1,1251494.5
313770,201908,366,273,93,272454.5,93812,366266.5
313780,201908,756,397,359,396206,359280,755486
313790,201908,28,27,1,26946,998,27944
313800,201908,147,93,54,92814,53892,146706
313810,201908,71,40,31,39920,30938,70858
313820,201908,1299,642,657,640716.8,657683.75,1298400.55
313830,201908,63,47,16,46906,15968,62874
313835,201908,62,52,10,51896,9980,61876
313840,201908,1672,1039,633,1036923.8,632732.8,1669656.6
313850,201908,197,73,124,72854,123752,196606
313860,201908,474,365,109,364270.4,109780,474050.4
313862,201908,176,118,58,117764,57884,175648
313865,201908,102,80,22,79840,21956,101796
313867,201908,48,38,10,37924,9980,47904
313868,201908,30,19,11,18962,10978,29940
313870,201908,120,63,57,62874,56886,119760
313880,201908,363,232,131,231536,130738.4,362274.4
313890,201908,332,180,152,179640.6,152694,332334.6
313900,201908,895,493,402,493012.5,401196.9,894209.4
313910,201908,141,101,40,100798,39920,140718
313920,201908,629,449,180,448102,179640.9,627742.9
313925,201908,31,28,3,27944,2994,30938
313930,201908,833,656,177,654688,177644.95,832332.95
313940,201908,1813,1149,664,1147700,662672.4,1810372.4
313950,201908,929,600,329,598800.8,328342,927142.8
313960,201908,1360,792,568,790416.76,566865.8,1357282.56
313970,201908,132,90,42,89820,41916,131736
313980,201908,215,140,75,139720.5,74850,214570.5
313990,201908,224,152,72,151696,71856,223552
314000,201908,906,613,293,612773.14,292414,905187.14
314010,201908,80,52,28,51896,27944,79840
314015,201908,54,17,37,16966,36926,53892
314020,201908,56,38,18,37924,17964,55888
314030,201908,79,39,40,38922,39920,78842
314040,201908,44,28,16,27944,15968,43912
314050,201908,285,173,112,172654,112774,285428
314053,201908,92,61,31,60878.4,30938,91816.4
314055,201908,298,184,114,183632,113772.4,297404.4
314060,201908,146,125,21,124750.58,20958,145708.58
314070,201908,1054,569,485,567862,484030,1051892
314080,201908,216,141,75,140718,74850.36,215568.36
314085,201908,137,94,43,93812,42914,136726
314090,201908,364,262,102,261476.9,101796,363272.9
314100,201908,476,396,80,395221.74,80842.8,476064.54
314110,201908,730,400,330,399200.4,329340,728540.4
314120,201908,89,52,37,51896,36926,88822
314130,201908,23,13,10,12974,9980,22954
314140,201908,1108,687,421,685626.6,421156,1106782.6
314150,201908,166,105,61,104790,60878,165668
314160,201908,341,261,80,260479.2,79840.6,340319.8
314170,201908,79,62,17,61876,16966,78842
314180,201908,729,646,83,644708.4,82834.5,727542.9
314190,201908,98,61,37,60878,36926,97804
314200,201908,471,322,149,321357.03,148702,470059.03
314210,201908,256,197,59,196606,58882.4,255488.4
314220,201908,307,228,79,227544.4,78842,306386.4
314225,201908,65,47,18,47904,17964,65868
314230,201908,118,56,62,55888,61876,117764
314240,201908,139,106,33,105788,32934,138722
314250,201908,50,30,20,29940,19960,49900
314260,201908,225,110,115,109780,114770,224550
314270,201908,337,270,67,270458,66866,337324
314280,201908,700,398,302,397204.98,301396,698600.98
314290,201908,541,445,96,444111.36,95808,539919.36
314300,201908,371,269,102,268464.5,102794.9,371259.4
314310,201908,1392,948,444,947352.53,444110,1391462.53
314315,201908,34,27,7,26946,6986,33932
314320,201908,598,396,202,395208.4,201596,596804.4
314330,201908,10731,5419,5312,5408185.84,5308405.45,10716591.29
314340,201908,586,272,314,272454,313372.8,585826.8
314345,201908,42,31,11,30938,10978,41916
314350,201908,186,118,68,117764,67864,185628
314360,201908,73,45,28,44910,27944,72854
314370,201908,61,47,14,46906,13972,60878
314380,201908,93,62,31,61876,30938,92814
314390,201908,3283,2130,1153,2125742.6,1152690.6,3278433.2
314400,201908,686,494,192,494011.5,192614,686625.5
314410,201908,466,311,155,310378,154690,465068
314420,201908,18,8,10,7984,9980,17964
314430,201908,2434,900,1534,898202.3,1530932,2429134.3
314435,201908,259,154,105,153692,105788,259480
314437,201908,30,24,6,23952,5988,29940
314440,201908,98,72,26,71856,25948,97804
314450,201908,160,116,44,115768,43912,159680
314460,201908,644,302,342,301396,341316,642712
314465,201908,85,58,27,57884,26946,84830
314467,201908,69,57,12,56886,11976,68862
314470,201908,404,211,193,210579.38,192614,403193.38
314480,201908,1064,523,541,521954,539918,1061872
314490,201908,81,59,22,58882,21956,80838
314500,201908,293,195,98,194610,97804,292414
314505,201908,128,85,43,84830,42914,127744
314510,201908,233,194,39,193612,38922,232534
314520,201908,1265,683,582,681641.2,582833.2,1264474.4
314530,201908,745,598,147,597803.66,146706,744509.66
314535,201908,212,132,80,131736,79840,211576
314537,201908,61,36,25,36926,25948,62874
314540,201908,15,10,5,9980,4990,14970
314545,201908,51,33,18,32934,17964,50898
314550,201908,80,42,38,41916,37924,79840
314560,201908,823,455,368,454090.8,368262,822352.8
314570,201908,21,17,4,16966,3992,20958
314580,201908,13,6,7,5988,6986,12974
314585,201908,25,19,6,18962,5988,24950
314587,201908,81,72,9,71856,8982,80838
314590,201908,570,418,152,417165.7,151696,568861.7
314600,201908,933,610,323,608781.8,322355.03,931136.83
314610,201908,947,509,438,507983.3,437124,945107.3
314620,201908,143,106,37,105788,36926,142714
314625,201908,95,70,25,69860,24950,94810
314630,201908,1202,628,574,626744,573850.4,1200594.4
314640,201908,80,55,25,54890,24950,79840
314650,201908,182,104,78,103792,77844,181636
314655,201908,64,47,17,47904,16966,64870
314660,201908,18,15,3,14970,2994,17964
314670,201908,200,155,45,154690.4,44910,199600.4
314675,201908,213,128,85,127744,84830,212574
314690,201908,570,317,253,316366,252494,568860
314700,201908,2321,1265,1056,1263469.6,1053888,2317357.6
314710,201908,1640,969,671,968062.1,669658.4,1637720.5
314720,201908,384,230,154,229540,154690,384230
314730,201908,506,269,237,268463.4,236526.98,504990.38
314740,201908,701,347,354,346306,353292,699598
314750,201908,21,19,2,18962,1996,20958
314760,201908,335,161,174,160678,173652,334330
314770,201908,105,77,28,76846,27944,104790
314780,201908,21,6,15,5988,14970,20958
314790,201908,2333,1485,848,1482034.27,848300,2330334.27
314795,201908,48,41,7,40918.5,6986,47904.5
314800,201908,2805,1654,1151,1652690.23,1149696,2802386.23
314810,201908,1524,875,649,873250,647702.6,1520952.6
314820,201908,102,58,44,57884,43912,101796
314830,201908,214,174,40,173652,39920,213572
314840,201908,87,51,36,50898,35928,86826
314850,201908,343,168,175,167664,174650,342314
314860,201908,691,523,168,521955.13,168662,690617.13
314870,201908,1494,798,696,796404.4,695606,1492010.4
314875,201908,60,52,8,51896,7984,59880
314880,201908,45,31,14,30938,13972,44910
314890,201908,55,33,22,32934,21956,54890
314900,201908,32,25,7,24950,6986,31936
314910,201908,248,168,80,167664,79840,247504
314915,201908,148,131,17,130738,16966,147704
314920,201908,107,66,41,65868,40918,106786
314930,201908,1064,536,528,534928.4,526944,1061872.4
314940,201908,47,37,10,36926,9980,46906
314950,201908,34,24,10,23952,9980,33932
314960,201908,48,36,12,35928,11976,47904
314970,201908,142,73,69,72854,68862,141716
314980,201908,304,194,110,193612,109780,303392
314990,201908,459,254,205,253492,204590,458082
314995,201908,207,63,144,62874,143712,206586
315000,201908,90,71,19,70858,18962,89820
315010,201908,45,29,16,28942,15968,44910
315015,201908,169,138,31,138722,30938,169660
315020,201908,71,60,11,59880,10978,70858
315030,201908,113,88,25,87824,24950,112774
315040,201908,71,50,21,49900,20958,70858
315050,201908,186,113,73,112774,73852,186626
315053,201908,41,36,5,35928,4990,40918
315057,201908,95,78,17,77844,16966,94810
315060,201908,71,61,10,60878.52,9980,70858.52
315070,201908,105,60,45,59880,44910,104790
315080,201908,371,300,71,299400,70858,370258
315090,201908,107,62,45,61876,44910,106786
315100,201908,81,40,41,39920,40918,80838
315110,201908,274,151,123,150698,122754,273452
315120,201908,1648,837,811,835326,809378.68,1644704.68
315130,201908,343,248,95,247504,95808,343312
315140,201908,513,300,213,299400.4,212574.8,511975.2
315150,201908,961,466,495,465068,495008.4,960076.4
315160,201908,216,109,107,108782,106786,215568
315170,201908,321,208,113,207584.4,112774,320358.4
315180,201908,3279,1392,1887,1391214.4,1883229.1,3274443.5
315190,201908,322,191,131,190618.2,130738,321356.2
315200,201908,1235,727,508,725546,506984,1232530
315210,201908,1614,932,682,931134.6,682632.2,1613766.8
315213,201908,40,23,17,22954,16966,39920
315217,201908,212,169,43,168662,42914,211576
315220,201908,1552,1201,351,1199597.58,350298,1549895.58
315230,201908,171,126,45,125748.4,44910,170658.4
315240,201908,425,276,149,275448,149700.98,425148.98
315250,201908,2522,1266,1256,1263468,1255484.8,2518952.8
315260,201908,140,86,54,85828,53892,139720
315270,201908,131,91,40,90818,39920,130738
315280,201908,658,428,230,427144.2,230538,657682.2
315290,201908,194,119,75,118762,74850.63,193612.63
315300,201908,74,55,19,54890,18962,73852
315310,201908,71,64,7,63872,6986,70858
315320,201908,165,95,70,94810,69860,164670
315330,201908,56,47,9,46906,8982,55888
315340,201908,383,277,106,276446,106786,383232
315350,201908,152,93,59,92814,58882,151696
315360,201908,91,49,42,48902,41916,90818
315370,201908,55,33,22,32934,21956,54890
315380,201908,11,8,3,7984,2994,10978
315390,201908,66,16,50,15968,49900.4,65868.4
315400,201908,847,637,210,635726.7,210578,846304.7
315410,201908,348,211,137,210578.4,136727.4,347305.8
315415,201908,63,46,17,45908,16966,62874
315420,201908,202,153,49,152694.4,48902.4,201596.8
315430,201908,653,383,270,383232.4,270458.6,653691.0
315440,201908,93,64,29,63872,28942,92814
315445,201908,239,194,45,193612,44910,238522
315450,201908,183,140,43,139720,42914,182634
315460,201908,3742,1922,1820,1920152.98,1816360.98,3736513.96
315470,201908,41,17,24,16966,23952,40918
315480,201908,62,23,39,22954,38922,61876
315490,201908,640,402,238,401196,237524,638720
315500,201908,22,15,7,14970,6986,21956
315510,201908,153,104,49,103792,48902,152694
315520,201908,71,64,7,63872,6986,70858
315530,201908,50,26,24,25948,23952,49900
315540,201908,234,158,76,157684,75848,233532
315550,201908,183,148,35,147704,34930,182634
315560,201908,729,589,140,587822.4,140718,728540.4
315570,201908,305,160,145,160679.49,144710.6,305390.09
315580,201908,695,462,233,461308.86,232534,693842.86
315590,201908,199,106,93,105788,92814,198602
315600,201908,300,224,76,223552,75848,299400
315610,201908,97,51,46,50898,45908,96806
315620,201908,34,26,8,25948,7984,33932
315630,201908,133,88,45,87824,44910,132734
315640,201908,66,42,24,41916,23952,65868
315645,201908,50,35,15,34930,14970,49900
315650,201908,168,123,45,122754.8,44910,167664.8
315660,201908,456,202,254,202594,253492,456086
315670,201908,2394,1198,1196,1195605.6,1197601.96,2393207.56
315680,201908,845,582,263,580836,263472,844308
315690,201908,682,477,205,476047.73,204590,680637.73
315700,201908,1881,1010,871,1007981.27,870256,1878237.27
315710,201908,336,100,236,99800,235528,335328
315720,201908,442,281,161,280438.4,160678,441116.4
315725,201908,199,159,40,158682.4,39920,198602.4
315727,201908,38,22,16,21956,15968,37924
315730,201908,50,48,2,47904,1996,49900
315733,201908,87,60,27,59880,26946,86826
315737,201908,49,38,11,37924,10978,48902
315740,201908,35,29,6,28942,5988,34930
315750,201908,156,119,37,118762,36926,155688
315760,201908,44,34,10,33932,9980,43912
315765,201908,121,76,45,75848,44910,120758
315770,201908,229,143,86,142714,85828.4,228542.4
315780,201908,3393,1766,1627,1764465.4,1627739.15,3392204.55
315790,201908,220,172,48,171656,47904,219560
315800,201908,284,206,78,205588,77844,283432
315810,201908,97,58,39,57884,38922.4,96806.4
315820,201908,750,546,204,544909.2,203592,748501.2
315830,201908,132,77,55,76846,54890,131736
315840,201908,86,60,26,59880,25948,85828
315850,201908,257,189,68,188622.5,67864,256486.5
315860,201908,12,4,8,3992,7984,11976
315870,201908,37,29,8,28942,7984,36926
315880,201908,105,68,37,67864,36926,104790
315890,201908,87,65,22,64870,22954,87824
315895,201908,443,301,142,300398.5,141716.8,442115.3
315900,201908,71,36,35,35928,34930,70858
315910,201908,38,25,13,24950,12974,37924
315920,201908,172,110,62,109780,61876.3,171656.3
315930,201908,46,17,29,16966,28942,45908
315935,201908,141,109,32,108782,31936.98,140718.98
315940,201908,100,74,26,73852,25948,99800
315950,201908,43,31,12,30938,11976,42914
315960,201908,539,260,279,261476.4,278442.4,539918.8
315970,201908,35,28,7,27944,6986,34930
315980,201908,683,336,347,336326.1,346306,682632.1
315990,201908,252,148,104,147704,103793.38,251497.38
316000,201908,53,35,18,34930,17964,52894
316010,201908,79,69,10,68862,9980,78842
316020,201908,114,98,16,97804,15968,113772
316030,201908,400,218,182,217564.4,181636.9,399201.3
316040,201908,512,219,293,218562.4,292414.4,510976.8
316045,201908,62,55,7,54890,6986,61876
316050,201908,16,14,2,13972,1996,15968
316060,201908,97,64,33,63872,32934,96806
316070,201908,1090,704,386,702592.1,385228,1087820.1
316080,201908,104,70,34,69860,33932,103792
316090,201908,37,22,15,21956,15968,37924
316095,201908,74,65,9,64870,8982,73852
316100,201908,311,180,131,179640.5,130738,310378.5
316105,201908,40,28,12,27944,11976,39920
316110,201908,1862,1507,355,1503986.55,355288,1859274.55
316120,201908,80,60,20,59880,19960,79840
316130,201908,122,93,29,93812.4,28942,122754.4
316140,201908,30,22,8,21956,7984,29940
316150,201908,205,141,64,140718,63872,204590
316160,201908,77,47,30,46906,29940,76846
316165,201908,65,51,14,50898.6,13972.6,64871.2
316170,201908,191,128,63,127744,62874,190618
316180,201908,197,87,110,86826,109780.4,196606.4
316190,201908,133,98,35,97804,34930,132734
316200,201908,669,380,289,379240,288422,667662
316210,201908,770,516,254,516137.65,253492,769629.65
316220,201908,117,77,40,76846,39920,116766
316225,201908,25,15,10,14970,9980,24950
316230,201908,32,18,14,17964,13972,31936
316240,201908,644,518,126,516964,125748,642712
316245,201908,128,109,19,108782,18962,127744
316250,201908,1545,1070,475,1069857.66,474050.98,1543908.64
316255,201908,122,99,23,98802,22954,121756
316257,201908,174,94,80,93812,79840,173652
316260,201908,190,135,55,134730.5,55888.38,190618.88
316265,201908,27,19,8,18962,7984,26946
316270,201908,679,483,196,482034.6,195608.84,677643.44
316280,201908,543,335,208,334331.03,207585.4,541916.43
316290,201908,725,485,240,485028.66,239520,724548.66
316292,201908,502,208,294,207584,293471.88,501055.88
316294,201908,102,60,42,59880,41916,101796
316295,201908,301,134,167,133733.36,166666,300399.36
316300,201908,98,72,26,72854,25948,98802
316310,201908,36,19,17,18962,16966,35928
316320,201908,47,28,19,27944,18962,46906
316330,201908,132,88,44,87824.5,43912,131736.5
316340,201908,139,97,42,96806,41916,138722
316350,201908,193,136,57,135728.3,56886,192614.3
316360,201908,21,14,7,13972,6986,20958
316370,201908,1082,569,513,567863.1,511974,1079837.1
316380,201908,121,93,28,92814,27944,120758
316390,201908,118,86,32,85828,31936,117764
316400,201908,134,104,30,103792,29940,133732
316410,201908,300,218,82,217564,81836,299400
316420,201908,204,144,60,143712,59880,203592
316430,201908,152,80,72,79840,71856,151696
316440,201908,95,47,48,46906,47904,94810
316443,201908,37,35,2,34930,1996,36926
316447,201908,65,51,14,50898,13972,64870
316450,201908,228,173,55,172654,55888,228542
316460,201908,72,27,45,26946,44910,71856
316470,201908,1630,1205,425,1203581.77,425148,1628729.77
316480,201908,13,10,3,9980,2994,12974
316490,201908,16,7,9,6986,8982,15968
316500,201908,152,102,50,101796,49900,151696
316510,201908,161,125,36,124750,35928,160678
316520,201908,196,123,73,122754,72854,195608
316530,201908,157,110,47,109780,46906,156686
316540,201908,140,77,63,76846,62874,139720
316550,201908,137,94,43,93812,42914,136726
316553,201908,278,130,148,130738,148702.72,279440.72
316555,201908,36,31,5,30938,4990,35928
316556,201908,11,8,3,7984,2994,10978
316557,201908,18,15,3,14970,2994,17964
316560,201908,70,52,18,51896,17964,69860
316570,201908,231,211,20,210578,19960,230538
316580,201908,19,16,3,15968,2994,18962
316590,201908,107,92,15,91816,14970,106786
316600,201908,183,152,31,151696,30938,182634
316610,201908,67,50,17,49900,16966,66866
316620,201908,143,110,33,109780,32934,142714
316630,201908,43,33,10,32934,9980,42914
316640,201908,20,13,7,12974,6986,19960
316650,201908,78,61,17,60878,16966,77844
316660,201908,8,3,5,2994,4990,7984
316670,201908,439,154,285,153692.96,284430,438122.96
316680,201908,152,107,45,106786,44910.6,151696.6
316690,201908,187,119,68,118762,68862,187624
316695,201908,64,56,8,55888,7984,63872
316700,201908,16,10,6,9980,5988,15968
316710,201908,750,561,189,559878.5,188622,748500.5
316720,201908,4888,2489,2399,2484026.75,2395202.74,4879229.49
316730,201908,17,16,1,15968,998,16966
316740,201908,114,73,41,72887.26,40918,113805.26
316750,201908,18,12,6,11976,5988,17964
316760,201908,317,256,61,255488,60878,316366
316770,201908,143,79,64,78842,63872,142714
316780,201908,73,45,28,44910,27944,72854
316790,201908,53,39,14,38922,13972,52894
316800,201908,1725,1081,644,1078838,642713,1721551
316805,201908,20,12,8,11976,7984,19960
316810,201908,70,47,23,46906,22954,69860
316820,201908,42,21,21,20958,20958,41916
316830,201908,92,46,46,45908,45908,91816
316840,201908,506,309,197,308382.4,196606,504988.4
316850,201908,336,225,111,224550,111776,336326
316860,201908,5956,2677,3279,2673644.99,3274438.3,5948083.29
316870,201908,1500,999,501,997004.3,500997.2,1498001.5
316880,201908,125,62,63,61876,62874,124750
316890,201908,245,167,78,166666,77844,244510
316900,201908,431,300,131,299400.36,130738,430138.36
316905,201908,20,9,11,8982,10978,19960
316910,201908,59,24,35,23952,34930,58882
316920,201908,134,106,28,105788,27944,133732
316930,201908,1857,976,881,974048.8,880236.3,1854285.1
316935,201908,895,551,344,549898.64,343312.4,893211.04
316940,201908,1089,631,458,629738.8,458082.4,1087821.2
316950,201908,180,92,88,91816.4,87824,179640.4
316960,201908,1106,621,485,620756.4,484030.4,1104786.8
316970,201908,652,515,137,513970,136726,650696
316980,201908,112,66,46,65868,45908,111776
316990,201908,2205,1486,719,1484026.34,717563.5,2201589.84
317000,201908,325,250,75,249500,74850,324350
317005,201908,238,172,66,171656,65868,237524
317010,201908,6348,3577,2771,3570848.59,2767454.4,6338302.99
317020,201908,16209,7262,8947,7253478.95,8933114.7,16186593.65
317030,201908,81,31,50,30938,49900,80838
317040,201908,3104,1951,1153,1947100.43,1152690.6,3099791.03
317043,201908,73,54,19,53892,18962,72854
317047,201908,31,16,15,15968,14970.99,30938.99
317050,201908,172,132,40,131736,39920,171656
317052,201908,132,101,31,100798,30938,131736
317057,201908,181,140,41,139720,40918,180638
317060,201908,63,43,20,42914,19960,62874
317065,201908,55,44,11,43912,10978,54890
317070,201908,1967,934,1033,933131.5,1031932.8,1965064.3
317075,201908,108,60,48,59880,47904,107784
317080,201908,862,462,400,461076.5,399200.6,860277.1
317090,201908,648,526,122,524948,121756,646704
317100,201908,420,318,102,317364,101796,419160
317103,201908,109,92,17,91816,16966,108782
317107,201908,43,38,5,37924,4990,42914
317110,201908,109,48,61,47904,60878,108782
317115,201908,47,42,5,41916,4990,46906
317120,201908,1861,958,903,957082.8,901194.4,1858277.2
317130,201908,1978,1319,659,1316364,657682,1974046
317140,201908,11,10,1,9980,998,10978
317150,201908,266,162,104,161676.4,104790,266466.4
317160,201908,317,234,83,234531.03,82834,317365.03
317170,201908,212,148,64,147704,63872,211576
317180,201908,441,319,122,318362,121756,440118
317190,201908,260,180,80,179640,79840,259480
317200,201908,809,571,238,569861.76,237524,807385.76
317210,201908,184,102,82,101796,81836,183632
317220,201908,23,12,11,11976,10978,22954
320010,201908,606,450,156,450098.5,156686,606784.5
320013,201908,129,95,34,94810,33932,128742
320016,201908,273,174,99,173652,98802,272454
320020,201908,709,428,281,427144.8,280438,707582.8
320030,201908,146,105,41,104790,40918.4,145708.4
320035,201908,142,108,34,108782,33932,142714
320040,201908,496,261,235,260478,234530,495008
320050,201908,103,80,23,79840,22954,102794
320060,201908,1626,795,831,793412.58,830339.74,1623752.32
320070,201908,104,72,32,71856,31936,103792
320080,201908,789,456,333,456086.9,332334.1,788421.0
320090,201908,1240,871,369,869258,369260.4,1238518.4
320100,201908,330,193,137,192614,136726,329340
320110,201908,122,79,43,78843.1,42914.4,121757.5
320115,201908,108,90,18,89820,17964,107784
320120,201908,3368,1873,1495,1872249.86,1492011.77,3364261.63
320130,201908,7395,3481,3914,3476053.47,3909199.71,7385253.18
320140,201908,427,282,145,281436.6,144710.48,426147.08
320150,201908,2027,1168,859,1167662.55,858280,2025942.55
320160,201908,663,301,362,300398.99,361277.79,661676.78
320170,201908,113,91,22,90818,21956,112774
320180,201908,51,30,21,29940,20958,50898
320190,201908,245,162,83,161676,82834.4,244510.4
320200,201908,55,45,10,44910,9980,54890
320210,201908,879,494,385,493012.8,385229.76,878242.56
320220,201908,305,113,192,112774,191616,304390
320225,201908,90,73,17,72854,16966,89820
320230,201908,581,377,204,376246.6,203592,579838.6
320240,201908,3147,1601,1546,1599795.6,1544905.78,3144701.38
320245,201908,465,321,144,320358.4,143712,464070.4
320250,201908,230,120,110,119760,109780,229540
320255,201908,141,113,28,112774,27944.7,140718.7
320260,201908,193,137,56,136726,55888,192614
320265,201908,164,131,33,130738,32934,163672
320270,201908,152,123,29,122754,29940,152694
320280,201908,992,595,397,593810.58,396206,990016.58
320290,201908,61,53,8,52894,7984,60878
320300,201908,568,396,172,395209.34,171658.04,566867.38
320305,201908,675,371,304,370258,303393,673651
320310,201908,218,124,94,123752.76,93812,217564.76
320313,201908,321,161,160,160678.9,159680.4,320359.3
320316,201908,112,89,23,88822,22954,111776
320320,201908,3422,1594,1828,1590814.42,1827340.75,3418155.17
320330,201908,258,198,60,197604,59880,257484
320332,201908,855,515,340,514970.5,339320.9,854291.4
320334,201908,247,151,96,150698.4,95808,246506.4
320335,201908,143,104,39,103792,39920,143712
320340,201908,560,390,170,389220.9,169660,558880.9
320350,201908,979,424,555,423153.29,555887.22,979040.51
320360,201908,169,92,77,91816,76846,168662
320370,201908,243,186,57,185628.56,56886.4,242514.96
320380,201908,282,197,85,196606,84830,281436
320390,201908,1157,707,450,705586.92,449100.8,1154687.72
320400,201908,305,226,79,226547.4,79840,306387.4
320405,201908,936,408,528,407185.89,527944.39,935130.28
320410,201908,975,504,471,502992,470059.3,973051.3
320420,201908,482,248,234,247505.3,233532,481037.3
320425,201908,190,105,85,105788,85828,191616
320430,201908,386,222,164,221556.5,163672,385228.5
320435,201908,163,111,52,110778,51896,162674
320440,201908,202,120,82,119760,81836,201596
320450,201908,128,74,54,73852,53892,127744
320455,201908,246,203,43,202594.4,42914,245508.4
320460,201908,263,165,98,164670,97804,262474
320465,201908,118,82,36,81836,35928,117764
320470,201908,682,439,243,438123.99,242514.99,680638.98
320480,201908,185,120,65,119760,64870,184630
320490,201908,2899,1444,1455,1441115.23,1454153.87,2895269.10
320495,201908,103,63,40,62934,39920.8,102854.8
320500,201908,9700,4888,4812,4880235.15,4803426.51,9683661.66
320501,201908,539,274,265,273452,265468,538920
320503,201908,289,206,83,205588,82834,288422
320506,201908,260,187,73,186626,72854,259480
320510,201908,992,471,521,470058,520957.38,991015.38
320515,201908,82,69,13,68862,12974,81836
320517,201908,207,150,57,149700,56886,206586
320520,201908,6850,3063,3787,3060872.37,3782427.75,6843300.12
320530,201908,5802,2984,2818,2979136.42,2814364.13,5793500.55
330010,201908,3053,1598,1455,1595804.2,1455084,3050888.2
330015,201908,160,67,93,66866.56,92814,159680.56
330020,201908,3611,1601,2010,1598798.4,2012966.4,3611764.8
330022,201908,240,129,111,128742,111776,240518
330023,201908,564,197,367,196606,366266,562872
330025,201908,568,116,452,115768,451096,566864
330030,201908,1919,1250,669,1247502.66,670716.68,1918219.34
330040,201908,2396,1272,1124,1269458.1,1122752.2,2392210.3
330045,201908,8331,2719,5612,2716556.8,5610877.36,8327434.16
330050,201908,883,570,313,569858,312374,882232
330060,201908,933,571,362,569858.9,361276,931134.9
330070,201908,3455,1318,2137,1317361.32,2132727.94,3450089.26
330080,201908,1508,696,812,694609.89,813370,1507979.89
330090,201908,379,224,155,223552,154690.4,378242.4
330093,201908,267,122,145,121756,144711.88,266467.88
330095,201908,91,50,41,49900,40918,90818
330100,201908,9411,4905,4506,4899186.8,4506120.71,9405307.51
330110,201908,491,208,283,208582.7,282434,491016.7
330115,201908,542,292,250,292414,249500,541914
330120,201908,372,190,182,190618,181637.6,372255.6
330130,201908,1497,402,1095,401196.6,1092810.96,1494007.56
330140,201908,596,317,279,316366.94,278442,594808.94
330150,201908,494,283,211,282434,210578,493012
330160,201908,204,123,81,122754,80838,203592
330170,201908,26590,9388,17202,9377276.48,17184814.2,26562090.68
330180,201908,233,146,87,145708,87824,233532
330185,201908,903,329,574,328342.98,572853.92,901196.90
330187,201908,324,102,222,101796,221556,323352
330190,201908,5527,2211,3316,2207579.06,3318351.1,5525930.16
330200,201908,4694,1452,3242,1451094.24,3244678.64,4695772.88
330205,201908,427,252,175,251496,174650.4,426146.4
330210,201908,994,618,376,618762.84,375250.18,994013.02
330220,201908,2582,1565,1017,1562869.18,1015964.4,2578833.58
330225,201908,551,293,258,292414,257484,549898
330227,201908,2343,753,1590,752492.4,1588877.5,2341369.9
330230,201908,223,130,93,129740,92814,222554
330240,201908,3589,1885,1704,1882234.1,1703622,3585856.1
330245,201908,157,73,84,72854.34,83832,156686.34
330250,201908,6701,3495,3206,3492004.35,3202705.47,6694709.82
330260,201908,550,156,394,155688,395208,550896
330270,201908,3402,1229,2173,1226542.6,2171650.8,3398193.4
330280,201908,444,285,159,284431.2,159680.98,444112.18
330285,201908,7095,2321,4774,2316359.5,4770562.8,7086922.3
330290,201908,622,237,385,236526,384230.4,620756.4
330300,201908,763,509,254,508981.1,254490.94,763472.04
330310,201908,436,252,184,251496.9,185628,437124.9
330320,201908,7960,3046,4914,3041058.5,4913215.48,7954273.98
330330,201908,8810,3524,5286,3520946.68,5291407.46,8812354.14
330340,201908,2702,1613,1089,1610772.6,1087879.88,2698652.48
330350,201908,18067,7221,10846,7208742.44,10837830.94,18046573.38
330360,201908,2300,1142,1158,1140754.8,1158678.98,2299433.78
330370,201908,1021,533,488,531934.7,488022.6,1019957.3
330380,201908,857,374,483,373252,483033.19,856285.19
330385,201908,617,325,292,324350.5,293412,617762.5
330390,201908,5387,2959,2428,2955080.8,2429132.4,5384213.2
330395,201908,301,186,115,185628,114770.7,300398.7
330400,201908,702,385,317,384231,316366,700597
330410,201908,504,366,138,365269.7,138722.4,503992.1
330411,201908,246,135,111,134730.62,110778,245508.62
330412,201908,239,97,142,96806.8,141716,238522.8
330414,201908,5483,2281,3202,2278435.49,3199588.4,5478023.89
330415,201908,576,266,310,265468.7,309380.6,574849.3
330420,201908,2249,1180,1069,1177641.42,1066863.38,2244504.80
330430,201908,1756,834,922,833330.8,921156.4,1754487.2
330440,201908,275,136,139,135728,139720,275448
330450,201908,117,50,67,50864.73,66866,117730.73
330452,201908,1804,855,949,853292.52,947102,1800394.52
330455,201908,108400,39656,68744,39604399.71,68690266.02,108294665.73
330460,201908,259,106,153,105788,152694.94,258482.94
330470,201908,1219,672,547,671655.3,546905.5,1218560.8
330475,201908,1366,368,998,367264,999996,1367260
330480,201908,781,423,358,423152,357284.6,780436.6
330490,201908,13767,4774,8993,4769592.8,8989143.36,13758736.16
330500,201908,1347,608,739,608780,737522.46,1346302.46
330510,201908,10859,3841,7018,3837461.56,7014058.08,10851519.64
330513,201908,102,51,51,50898,50898,101796
330515,201908,824,340,484,340378.3,484031.2,824409.5
330520,201908,2472,920,1552,920156.54,1548896,2469052.54
330530,201908,211,115,96,114770.5,95808.6,210579.1
330540,201908,361,179,182,178642.4,182634,361276.4
330550,201908,2872,1038,1834,1035924.8,1833326.8,2869251.6
330555,201908,815,319,496,318422,495008,813430
330560,201908,640,212,428,211576,427144.94,638720.94
330570,201908,262,189,73,188622,72854,261476
330575,201908,771,314,457,313372,456087.4,769459.4
330580,201908,3344,1890,1454,1889216.2,1456082.4,3345298.6
330590,201908,302,153,149,152694,148702.98,301396.98
330600,201908,1131,727,404,725546.4,403192,1128738.4
330610,201908,1563,861,702,859280.2,701596.3,1560876.5
330615,201908,203,156,47,155688,46906,202594
330620,201908,1053,438,615,439120.6,613770,1052890.6
330630,201908,3989,2542,1447,2536919.16,1446102.9,3983022.06
350010,201908,595,406,189,406186.82,188622,594808.82
350020,201908,46,22,24,21956,23952,45908
350030,201908,512,321,191,320358.4,190618.4,510976.8
350040,201908,122,47,75,46906,74850,121756
350050,201908,299,161,138,161676,137724.98,299400.98
350055,201908,87,46,41,45908,40918,86826
350060,201908,75,28,47,27944,46906,74850
350070,201908,803,479,324,478072.91,324366.64,802439.55
350075,201908,70,47,23,46906,22954,69860
350080,201908,49,29,20,28942,19960,48902
350090,201908,88,49,39,48902,38922,87824
350100,201908,292,180,112,179640,111776,291416
350110,201908,58,38,20,37924,19960,57884
350115,201908,158,94,64,93812,63872,157684
350120,201908,104,70,34,69860,33932,103792
350130,201908,339,157,182,156686.58,181736.98,338423.56
350140,201908,39,26,13,25948,12974,38922
350150,201908,69,53,16,52894,15968,68862
350160,201908,2500,999,1501,997006.86,1500000.93,2497007.79
350170,201908,391,238,153,237525.14,153692.4,391217.54
350180,201908,173,98,75,97804,74850,172654
350190,201908,1005,532,473,530937.03,473052.4,1003989.43
350200,201908,68,25,43,24950,42914,67864
350210,201908,1276,722,554,722555.02,554888.63,1277443.65
350220,201908,671,570,101,569858.63,100798,670656.63
350230,201908,77,53,24,52894,23952,76846
350240,201908,61,44,17,43912,16966,60878
350250,201908,1152,567,585,565867.4,583831.1,1149698.5
350260,201908,92,68,24,67864,23952,91816
350270,201908,848,563,285,561874.42,284430.4,846304.82
350275,201908,303,128,175,127744,175648,303392
350280,201908,4601,2351,2250,2350296.87,2247500.95,4597797.82
350290,201908,422,201,221,202594,220558.4,423152.4
350300,201908,57,30,27,29940,26946,56886
350310,201908,95,60,35,59880,34930,94810
350315,201908,39,24,15,23952,14970,38922
350320,201908,3259,1603,1656,1599854.78,1654684.6,3254539.38
350330,201908,1656,897,759,896207.23,758481.2,1654688.43
350335,201908,19,13,6,12974,5988,18962
350340,201908,127,61,66,60878,65868.3,126746.3
350350,201908,90,45,45,44910,44910,89820
350360,201908,128,87,41,86826.99,40918,127744.99
350370,201908,84,47,37,46906.63,36926,83832.63
350380,201908,767,330,437,330338.8,436127.2,766466.0
350390,201908,1494,602,892,600797.43,892212.4,1493009.83
350395,201908,27,22,5,21956,4990,26946
350400,201908,1679,881,798,880339.59,796405.62,1676745.21
350410,201908,2407,1087,1320,1084826,1319396.63,2404222.63
350420,201908,240,149,91,148703.03,90818,239521.03
350430,201908,75,47,28,46906,27944,74850
350440,201908,145,104,41,104790.4,40918,145708.4
350450,201908,1624,983,641,983032.67,640717.2,1623749.87
350460,201908,341,126,215,125748,214570,340318
350470,201908,17,11,6,10978,5988,16966
350480,201908,171,94,77,93812,76846,170658
350490,201908,235,119,116,118762,115768,234530
350500,201908,46,20,26,19960,25948,45908
350510,201908,166,113,53,112874,52894,165768
350520,201908,447,218,229,218562,228542,447104
350530,201908,444,206,238,205588,238522,444110
350535,201908,75,61,14,60878,13972,74850
350540,201908,390,194,196,193612,195608,389220
350550,201908,2728,1614,1114,1611772.91,1112775.39,2724548.30
350560,201908,652,459,193,458082.63,193612,651694.63
350570,201908,4012,1711,2301,1707579.63,2300392.93,4007972.56
350580,201908,375,173,202,173652,201596.99,375248.99
350590,201908,893,486,407,485028.4,407184,892212.4
350600,201908,6133,3034,3099,3032928.35,3095799.37,6128727.72
350610,201908,1527,805,722,803391.26,720556.98,1523948.24
350620,201908,34,22,12,21956,11976,33932
350630,201908,229,131,98,130738.63,97804.63,228543.26
350635,201908,906,377,529,376246.4,527942.8,904189.2
350640,201908,124,95,29,94810,28942,123752
350650,201908,1872,1238,634,1235564.5,632732.98,1868297.48
350660,201908,742,326,416,326346,416166.99,742512.99
350670,201908,307,148,159,147704,159680,307384
350680,201908,181,95,86,94810,85828.8,180638.8
350690,201908,198,101,97,100798,96806,197604
350700,201908,757,364,393,363272.4,392253.92,755526.32
350710,201908,357,133,224,132734,223552,356286
350715,201908,55,44,11,43912,10978,54890
350720,201908,17,11,6,10978,5988,16966
350730,201908,45,28,17,27944,16966,44910
350740,201908,207,117,90,116766,89820,206586
350745,201908,19,10,9,9980.44,8982,18962.44
350750,201908,2156,1353,803,1350296.38,803390,2153686.38
350760,201908,3716,1643,2073,1641710.66,2070850,3712560.66
350770,201908,62,44,18,43912,17964,61876
350775,201908,47,34,13,33932,12974.98,46906.98
350780,201908,438,221,217,220558,218562.4,439120.4
350790,201908,366,153,213,152694,212574,365268
350800,201908,452,269,183,269460,182634,452094
350810,201908,505,411,94,410178.9,93812,503990.9
350820,201908,90,56,34,55888,33932,89820
350830,201908,82,44,38,43912,37924,81836
350840,201908,769,322,447,321356.4,448103.38,769459.78
350850,201908,1744,1001,743,998998.5,742514.95,1741513.45
350860,201908,583,337,246,337386.3,245508,582894.3
350870,201908,436,293,143,293412,142714,436126
350880,201908,285,158,127,157684.75,127744,285428.75
350890,201908,42,29,13,28942,12974,41916
350900,201908,1431,459,972,459080.7,970056,1429136.7
350910,201908,24,14,10,13972,9980,23952
350920,201908,637,346,291,345308,290418,635726
350925,201908,1209,646,563,644708.78,561875.2,1206583.98
350930,201908,99,60,39,59880,38922,98802
350940,201908,722,399,323,398202,322354.54,720556.54
350945,201908,108,79,29,78842,28942,107784
350950,201908,16043,7638,8405,7625723.08,8399174.41,16024897.49
350960,201908,1290,602,688,602792.4,687623.39,1290415.79
350970,201908,1104,586,518,585720.03,517963.2,1103683.23
350980,201908,91,61,30,60878,29940,90818
350990,201908,378,137,241,136726,240518,377244
350995,201908,36,16,20,15968,19960,35928
351000,201908,630,439,191,438123.26,190618,628741.26
351010,201908,49,31,18,30938,17964,48902
351015,201908,52,36,16,35928,15968,51896
351020,201908,1602,961,641,959078.99,639718,1598796.99
351030,201908,342,233,109,232534,108782,341316
351040,201908,860,457,403,456086.48,403192.11,859278.59
351050,201908,3272,1511,1761,1510039.11,1760479.5,3270518.61
351060,201908,5009,2035,2974,2030931.96,2978036.56,5008968.52
351070,201908,408,255,153,254491.6,152694,407185.6
351080,201908,764,549,215,548900,215568,764468
351090,201908,55,25,30,24950,29940,54890
351100,201908,432,251,181,250498.68,180638,431136.68
351110,201908,2067,1003,1064,1001005.96,1063886.96,2064892.92
351120,201908,67,35,32,34930,31936,66866
351130,201908,176,59,117,58882,116766,175648
351140,201908,329,227,102,226546,101796,328342
351150,201908,416,226,190,225548.3,189620.4,415168.7
351160,201908,265,179,86,178642.4,85828,264470.4
351170,201908,180,101,79,100798,78842,179640
351190,201908,85,58,27,57884,26946,84830
351200,201908,360,246,114,245508.4,113772,359280.4
351210,201908,119,62,57,62874,56886,119760
351220,201908,528,319,209,318363.76,208582,526945.76
351230,201908,277,196,81,195608,80838,276446
351240,201908,224,103,121,102794,121756,224550
351250,201908,74,53,21,52894.53,20958,73852.53
351260,201908,153,114,39,113772,38922,152694
351270,201908,46,19,27,18962,26946,45908
351280,201908,1039,475,564,474051.26,562874.01,1036925.27
351290,201908,237,108,129,108782,128742.4,237524.4
351300,201908,3658,1704,1954,1700516.22,1953087.62,3653603.84
351310,201908,768,392,376,391216,376246.98,767462.98
351320,201908,115,68,47,67864,46906,114770
351330,201908,37,24,13,23952,12974,36926
351340,201908,1214,735,479,733531,480040.95,1213571.95
351350,201908,2685,1565,1120,1562869.46,1118758.55,2681628.01
351360,201908,769,382,387,383232,386226,769458
351370,201908,386,194,192,193612.12,192614,386226.12
351380,201908,9077,4106,4971,4097794.65,4967050.4,9064845.05
351385,201908,28,17,11,16966,10978,27944
351390,201908,287,214,73,213572.54,72854,286426.54
351400,201908,66,41,25,40918,24952.94,65870.94
351410,201908,442,278,164,277444.6,163672,441116.6
351420,201908,61,50,11,49900,10978,60878
351430,201908,65,35,30,34930,30938,65868
351440,201908,787,555,232,553891.93,231536,785427.93
351450,201908,256,130,126,129740,126746,256486
351460,201908,115,53,62,52894,61876,114770
351470,201908,135,73,62,72854,61876,134730
351480,201908,524,298,226,297405.76,225548,522953.76
351490,201908,289,108,181,107784,180638,288422
351492,201908,32,23,9,22954,8982,31936
351495,201908,26,19,7,18962,7984,26946
351500,201908,3525,1489,2036,1486023.94,2031929.36,3517953.30
351510,201908,1870,775,1095,773450.8,1094806.4,1868257.2
351512,201908,19,15,4,14970,3992,18962
351515,201908,194,113,81,112774,80838.96,193612.96
351518,201908,777,484,293,483032.99,292414,775446.99
351519,201908,71,46,25,45908,24950,70858
351520,201908,151,93,58,92814,57884,150698
351530,201908,23,15,8,14970,7984,22954
351535,201908,130,74,56,73852,55888,129740
351540,201908,453,325,128,324351.05,127744,452095.05
351550,201908,1377,831,546,831336.46,545906,1377242.46
351560,201908,68,39,29,38922,29002,67924
351565,201908,8,6,2,5988,1996,7984
351570,201908,2609,1355,1254,1352292.38,1253490.97,2605783.35
351580,201908,39,35,4,34930,3992,38922
351590,201908,65,43,22,42914,21956,64870
351600,201908,193,144,49,143712,48902,192614
351610,201908,56,25,31,24950,30938,55888
351620,201908,5856,3314,2542,3310371.27,2539912.09,5850283.36
351630,201908,2643,1364,1279,1361272.9,1280434,2641706.9
351640,201908,1845,879,966,877242.49,965067.03,1842309.52
351650,201908,31,26,5,25948,4990,30938
351660,201908,138,88,50,88822,49900,138722
351670,201908,716,447,269,446107.8,268462,714569.8
351680,201908,71,58,13,57884,13972,71856
351685,201908,30,17,13,16966,12974,29940
351690,201908,305,215,90,214570.45,89820,304390.45
351700,201908,155,110,45,109780.4,45908,155688.4
351710,201908,67,46,21,45908,20958,66866
351720,201908,126,65,61,64870,60878,125748
351730,201908,97,67,30,66866.63,29940.63,96807.26
351740,201908,725,476,249,475050.36,251496,726546.36
351750,201908,354,147,207,146706,206586,353292
351760,201908,775,585,190,583830,189620,773450
351770,201908,305,261,44,260478.03,43912,304390.03
351780,201908,157,90,67,89820.98,66866,156686.98
351790,201908,253,132,121,132734,120758,253492
351800,201908,46,30,16,29940,15968,45908
351810,201908,123,84,39,83832,38922,122754
351820,201908,843,612,231,610777.2,230539.39,841316.59
351830,201908,522,191,331,193612,331336,524948
351840,201908,1842,938,904,936125.44,903192.97,1839318.41
351850,201908,240,176,64,175648,63932,239580
351860,201908,694,480,214,479042.41,213572,692614.41
351870,201908,5606,2672,2934,2667658.06,2929132.57,5596790.63
351880,201908,18891,7997,10894,7984012.01,10886228.94,18870240.95
351885,201908,88,58,30,57884,29940,87824
351890,201908,73,62,11,61876,10978,72854
351900,201908,223,133,90,132734.4,89820,222554.4
351905,201908,71,28,43,27944,42914,70858
351907,201908,3372,1435,1937,1433129.34,1934128.55,3367257.89
351910,201908,177,72,105,71856,104790,176646
351920,201908,122,70,52,69860,51897.98,121757.98
351925,201908,91,60,31,59880,30938,90818
351930,201908,377,245,132,245508,131736,377244
351940,201908,235,107,128,106786,127744,234530
351950,201908,134,76,58,75848,57884,133732
351960,201908,888,423,465,422467,464070.4,886537.4
351970,201908,1863,1000,863,998998.4,862273.78,1861272.18
351980,201908,153,79,74,78842,73852,152694
351990,201908,264,173,91,172654.8,90818,263472.8
352000,201908,355,221,134,220559.2,133732,354291.2
352010,201908,396,251,145,250498,144710,395208
352020,201908,183,66,117,65868,116766,182634
352030,201908,1068,562,506,561874,506984,1068858
352040,201908,574,245,329,244510,329340,573850
352042,201908,285,90,195,89820,194610.8,284430.8
352044,201908,355,213,142,212574,141716,354290
352050,201908,3263,1270,1993,1269458.76,1991010,3260468.76
352060,201908,104,64,40,63872,39920.4,103792.4
352070,201908,94,69,25,68863.26,24950,93813.26
352080,201908,67,42,25,41916,24950,66866
352090,201908,165,112,53,111776,52894,164670
352100,201908,270,128,142,127745.39,141718.38,269463.77
352110,201908,116,35,81,34930,80838,115768
352115,201908,60,22,38,21956,37924,59880
352120,201908,90,64,26,63872.63,25948,89820.63
352130,201908,222,185,37,184630.64,36926,221556.64
352140,201908,185,83,102,82834,102794,185628
352150,201908,115,64,51,63872,51896,115768
352160,201908,138,89,49,88822,48902,137724
352170,201908,372,263,109,262474,108782,371256
352180,201908,603,399,204,398202,203592.99,601794.99
352190,201908,258,104,154,103792,153692,257484
352200,201908,31,16,15,15968,14970,30938
352210,201908,3994,1661,2333,1658678.6,2329334.63,3988013.23
352215,201908,53,30,23,29940,22954,52894
352220,201908,6952,2656,4296,2651689.31,4291465.23,6943154.54
352230,201908,3255,2109,1146,2105794.89,1146712.5,3252507.39
352240,201908,2338,1362,976,1359277,975046.4,2334323.4
352250,201908,2623,1334,1289,1331335.4,1288419.97,2619755.37
352260,201908,997,520,477,520956.8,476046.4,997003.2
352265,201908,58,26,32,25948,31936,57884
352270,201908,415,246,169,245508,168663.88,414171.88
352280,201908,423,269,154,268463.55,153692,422155.55
352290,201908,172,105,67,104790,66866,171656
352300,201908,93,70,23,69860,22954,92814
352310,201908,6055,2854,3201,2848357.54,3196597.3,6044954.84
352320,201908,977,517,460,515966.4,460078,976044.4
352330,201908,521,252,269,251496,268462.4,519958.4
352340,201908,1338,638,700,637722.8,699599.2,1337322.0
352350,201908,332,204,128,204590,127744,332334
352360,201908,217,95,122,95808,122754.2,218562.2
352370,201908,104,69,35,68862,34930,103792
352380,201908,115,72,43,71856,42914,114770
352390,201908,2454,1103,1351,1100796.38,1351294.18,2452090.56
352400,201908,489,217,272,216566,271456.4,488022.4
352410,201908,842,598,244,598800.63,243512,842312.63
352420,201908,106,72,34,71856,33932,105788
352430,201908,1736,794,942,793413.86,940118.64,1733532.50
352440,201908,3098,1565,1533,1561871.84,1531933.74,3093805.58
352450,201908,201,167,34,166666,33932,200598
352460,201908,615,319,296,318363.39,295408,613771.39
352470,201908,630,218,412,217564,412174,629738
352480,201908,1374,777,597,775446,596804.4,1372250.4
352490,201908,64,24,40,23952,39920,63872
352500,201908,1197,539,658,537922.34,657683.38,1195605.72
352510,201908,743,404,339,403193.26,339320,742513.26
352520,201908,621,290,331,289420,331336,620756
352530,201908,1741,917,824,916164.4,822352.4,1738516.8
352540,201908,73,49,24,48902,23952,72854
352550,201908,182,106,76,105788,75848,181636
352560,201908,50,40,10,39920,9980,49900
352570,201908,669,353,316,352294.63,315368,667662.63
352580,201908,56,40,16,39920,15968,55888
352585,201908,18,6,12,5988,11976,17964
352590,201908,4395,2222,2173,2220610.51,2173645.78,4394256.29
352600,201908,339,243,96,242514,95808,338322
352610,201908,951,431,520,430138.57,518960,949098.57
352620,201908,994,393,601,392214,600796,993010
352630,201908,170,61,109,60878,108782,169660
352640,201908,537,368,169,369260,168662,537922
352650,201908,87,59,28,58882,27944,86826
352660,201908,71,43,28,42914,27944,70858
352670,201908,1649,895,754,893212.19,753498.91,1646711.10
352680,201908,911,583,328,581836.03,329340,911176.03
352690,201908,4444,2013,2431,2010973.78,2428135.26,4439109.04
352700,201908,112,67,45,67864,44910,112774
352710,201908,1351,729,622,727542,622851.8,1350393.8
352720,201908,1324,635,689,635726,689618.4,1325344.4
352725,201908,24,21,3,20958,2994,23952
352730,201908,381,201,180,200598,179640,380238
352740,201908,416,272,144,271456.96,143712.68,415169.64
352750,201908,20,13,7,12974,6986,19960
352760,201908,183,123,60,123752,59880,183632
352770,201908,82,64,18,63872,17964,81836
352780,201908,75,40,35,39920,34930,74850
352790,201908,28,23,5,22954.63,4990,27944.63
352800,201908,243,176,67,175648,66866,242514
352810,201908,155,97,58,96806.66,57884,154690.66
352820,201908,65,53,12,52894,11976,64870
352830,201908,87,60,27,59880,26946,86826
352840,201908,657,345,312,344310.5,313372,657682.5
352850,201908,1434,497,937,496006,937122,1433128
352860,201908,127,79,48,79840,47904,127744
352870,201908,44,28,16,27944,15968.4,43912.4
352880,201908,184,124,60,123911.88,59880,183791.88
352885,201908,30,22,8,21956,7984,29940
352890,201908,53,36,17,35928,16966.4,52894.4
352900,201908,4767,2310,2457,2306523.76,2456236.47,4762760.23
352910,201908,40,33,7,32934,6986,39920
352920,201908,674,404,270,403192,269460,672652
352930,201908,1223,591,632,589830.74,631778.02,1221608.76
352940,201908,6241,2657,3584,2654684.01,3582827.09,6237511.10
352950,201908,95,37,58,36926,58882,95808
352960,201908,53,37,16,36926,16966,53892
352965,201908,20,10,10,9980,9980,19960
352970,201908,515,392,123,391216.02,122755.61,513971.63
352980,201908,163,87,76,86826,76846,163672
352990,201908,989,451,538,450098,537922,988020
353000,201908,65,30,35,29940,35928,65868
353010,201908,538,332,206,331336,205588,536924
353020,201908,297,215,82,214570,81836,296406
353030,201908,1217,565,652,563870.34,651694.98,1215565.32
353040,201908,90,60,30,59880,29940,89820
353050,201908,1334,856,478,855287.69,477044,1332331.69
353060,201908,8292,3712,4580,3708575.83,4574881.8,8283457.63
353070,201908,1719,1075,644,1072853.49,644530.35,1717383.84
353080,201908,1293,673,620,671655.16,620756,1292411.16
353090,201908,58,33,25,32934,24950,57884
353100,201908,57,46,11,45908,10978,56886
353110,201908,2052,633,1419,631734.4,1416163.19,2047897.59
353120,201908,93,51,42,50898,41916,92814
353130,201908,846,406,440,405190.17,439121.96,844312.13
353140,201908,559,223,336,222554.82,336326,558880.82
353150,201908,344,195,149,194610.63,148702,343312.63
353160,201908,93,78,15,77844,14970,92814
353170,201908,181,62,119,61876,118763.96,180639.96
353180,201908,989,472,517,471056,515967.1,987023.1
353190,201908,502,365,137,364270.3,136726.4,500996.7
353200,201908,210,108,102,107784,101796,209580
353205,201908,23,16,7,15968,6986,22954
353210,201908,82,48,34,47904,33932,81836
353215,201908,50,28,22,27944,21956,49900
353220,201908,82,46,36,45908,35928,81836
353230,201908,158,65,93,64870,92814,157684
353240,201908,310,165,145,164670,144710,309380
353250,201908,206,107,99,106786,98802,205588
353260,201908,455,324,131,323353.1,130738,454091.1
353270,201908,68,52,16,51896,15968,67864
353280,201908,102,55,47,54890.6,46906,101796.6
353282,201908,125,88,37,87824,36926,124750
353284,201908,24,17,7,16966,6986,23952
353286,201908,0,0,0,0,0,0
353290,201908,73,43,30,42914,29940,72854
353300,201908,429,240,189,239521.96,188622,428143.96
353310,201908,45,39,6,38922,5988,44910
353320,201908,59,36,23,35928,22954,58882
353325,201908,56,33,23,32934,22955.36,55889.36
353330,201908,63,44,19,43912.7,18962,62874.7
353340,201908,616,214,402,213572,401196.4,614768.4
353350,201908,905,437,468,436128.6,467066.76,903195.36
353360,201908,100,80,20,79840,19960,99800
353370,201908,120,65,55,64870.7,54890,119760.7
353380,201908,29,18,11,17964.99,10978,28942.99
353390,201908,1097,533,564,531934,564868,1096802
353400,201908,44,26,18,25948,17964,43912
353410,201908,104,66,38,66866,37924.9,104790.9
353420,201908,57,24,33,23952,32934,56886
353430,201908,576,388,188,387225.38,187624,574849.38
353440,201908,10391,4626,5765,4618750,5757474.32,10376224.32
353450,201908,55,31,24,30938,23952,54890
353460,201908,594,330,264,329340.1,264470,593810.1
353470,201908,2110,1131,979,1128742.19,977145.76,2105887.95
353475,201908,233,158,75,157685.38,74850,232535.38
353480,201908,182,151,31,150698,30938.4,181636.4
353490,201908,239,147,92,146706,91816.4,238522.4
353500,201908,195,111,84,110778.63,83832,194610.63
353510,201908,101,73,28,72854,27944,100798
353520,201908,205,142,63,142714,62874,205588
353530,201908,469,256,213,255488,212574,468062
353540,201908,373,251,122,250498,121756,372254
353550,201908,729,473,256,472055.24,256486,728541.24
353560,201908,596,244,352,243512,351296.6,594808.6
353570,201908,62,34,28,33932.4,27944,61876.4
353580,201908,353,267,86,266466.34,85828,352294.34
353590,201908,91,64,27,63872,26946,90818
353600,201908,274,159,115,158682.63,114770,273452.63
353610,201908,121,67,54,66866,53892,120758
353620,201908,614,323,291,322354,290418,612772
353625,201908,51,29,22,28942,21956,50898
353630,201908,238,177,61,176646.58,60878,237524.58
353640,201908,126,87,39,86826,38922,125748
353650,201908,911,357,554,356286,552892,909178
353657,201908,25,19,6,18962,5988,24950
353660,201908,265,143,122,142714,121756,264470
353670,201908,767,458,309,457085.03,308382,765467.03
353680,201908,105,75,30,74850.5,29940,104790.5
353690,201908,43,34,9,33932.52,8982,42914.52
353700,201908,280,200,80,199600.09,79840,279440.09
353710,201908,449,214,235,214570.6,234530.4,449101.0
353715,201908,45,33,12,32934,11976,44910
353720,201908,350,163,187,162674.98,186626,349300.98
353730,201908,1089,671,418,670756.6,419160.8,1089917.4
353740,201908,629,346,283,345308,283432,628740
353750,201908,82,52,30,51896,29940,81836
353760,201908,2858,1085,1773,1082832.75,1772450.18,2855282.93
353770,201908,91,74,17,73852,16966,90818
353780,201908,1182,571,611,570856.63,610776,1181632.63
353790,201908,511,303,208,302434.08,207584.4,510018.48
353800,201908,3225,1620,1605,1617821.77,1605853.35,3223675.12
353810,201908,235,135,100,134730.98,99801.96,234532.94
353820,201908,194,92,102,91816,101796,193612
353830,201908,48,41,7,40918,6986,47904
353850,201908,172,87,85,86826,84830,171656
353860,201908,493,224,269,223552,268462,492014
353870,201908,5207,2671,2536,2669657.87,2532926.8,5202584.67
353880,201908,689,484,205,483033.36,204590,687623.36
353890,201908,571,329,242,329340.4,242514.84,571855.24
353900,201908,130,69,61,68862,60878,129740
353910,201908,176,84,92,83832,91816,175648
353920,201908,437,240,197,240518.3,196606.99,437125.29
353930,201908,1000,588,412,586824,412176.14,999000.14
353940,201908,193,100,93,99800,92814,192614
353950,201908,516,321,195,320358,194610.98,514968.98
353960,201908,69,56,13,55888,12974,68862
353970,201908,67,38,29,37924,28942,66866
353980,201908,1598,758,840,756484,839321.96,1595805.96
353990,201908,77,46,31,45908,30938,76846
354000,201908,374,183,191,183632,190618.99,374250.99
354010,201908,93,51,42,50898,41916,92814
354020,201908,524,333,191,333332,190618,523950
354025,201908,54,44,10,43912,9980,53892
354030,201908,58,35,23,35928,22954,58882
354040,201908,103,76,27,75848,26946,102794
354050,201908,189,99,90,98802.4,89820,188622.4
354060,201908,772,377,395,376246.4,394210,770456.4
354070,201908,922,540,382,538920.88,381236.4,920157.28
354075,201908,219,112,107,111776,106786,218562
354080,201908,307,131,176,130738,175648,306386
354085,201908,20,12,8,11976,7984,19960
354090,201908,300,168,132,167580,131736,299316
354100,201908,5536,2337,3199,2334323.56,3192605.5,5526929.06
354105,201908,90,44,46,43912,45908,89820
354110,201908,47,23,24,22954,23952,46906
354120,201908,134,95,39,94810.98,38922,133732.98
354130,201908,688,454,234,455088.98,235529.38,690618.36
354140,201908,3106,1443,1663,1442270.88,1665662,3107932.88
354150,201908,630,389,241,388282.8,240518,628800.8
354160,201908,671,430,241,430271.46,240518.4,670789.86
354165,201908,19,14,5,13972,4990,18962
354170,201908,181,122,59,121756,58882,180638
354180,201908,64,39,25,38922.51,25948,64870.51
354190,201908,196,87,109,86826,108782,195608
354200,201908,119,63,56,62874,55888,118762
354210,201908,58,25,33,24950,32934,57884
354220,201908,647,405,242,404190,242514,646704
354230,201908,163,71,92,70858,91816,162674
354240,201908,323,211,112,210578.64,111776,322354.64
354250,201908,83,50,33,49900,32934,82834
354260,201908,2036,952,1084,952095.87,1082831.67,2034927.54
354270,201908,94,70,24,69860,23952,93812
354280,201908,43,23,20,22954,19960,42914
354290,201908,140,100,40,100798,39920,140718
354300,201908,399,277,122,276446.63,121756,398202.63
354310,201908,101,76,25,75848.4,24950,100798.4
354320,201908,196,100,96,99800,95808.4,195608.4
354323,201908,13,12,1,11976,998,12974
354325,201908,115,69,46,68862.6,45908,114770.6
354330,201908,2513,835,1678,833188.8,1679636.01,2512824.81
354340,201908,10468,5118,5350,5112776.03,5344356.18,10457132.21
354350,201908,122,80,42,79840,41916,121756
354360,201908,82,47,35,46906,35928,82834
354370,201908,257,140,117,139720,116766,256486
354380,201908,191,114,77,113772,76846,190618
354390,201908,2675,982,1693,981035.59,1691610.98,2672646.57
354400,201908,315,170,145,169660,144710,314370
354410,201908,614,297,317,296406.97,316366.4,612773.37
354420,201908,275,175,100,174650,99800,274450
354425,201908,311,180,131,179640,130738,310378
354430,201908,178,106,72,105788,71856,177644
354440,201908,34,26,8,25948,7984,33932
354450,201908,50,36,14,35928,13972,49900
354460,201908,104,60,44,59880,43912,103792
354470,201908,37,22,15,21956,14970,36926
354480,201908,114,60,54,59880.98,53892,113772.98
354490,201908,149,93,56,92814,55888,148702
354500,201908,377,186,191,185628,190618,376246
354510,201908,96,71,25,70858,25948,96806
354515,201908,37,12,25,11976,24950,36926
354520,201908,1590,691,899,689476.9,898200.8,1587677.7
354530,201908,720,365,355,364271.79,355288,719559.79
354540,201908,274,153,121,152694,121756,274450
354550,201908,39,23,16,22954,15968,38922
354560,201908,148,83,65,82834,64870,147704
354570,201908,140,91,49,90818.5,48902,139720.5
354580,201908,1895,901,994,900197.89,993010,1893207.89
354600,201908,244,138,106,137724.2,105788,243512.2
354610,201908,75,63,12,62874.46,11976.98,74851.44
354620,201908,60,17,43,16966,42914,59880
354625,201908,16,11,5,10978,4990.99,15968.99
354630,201908,311,204,107,203592.98,107784,311376.98
354640,201908,797,519,278,518960.3,277444,796404.3
354650,201908,73,42,31,42914,30938.98,73852.98
354660,201908,797,594,203,592812.63,202594,795406.63
354670,201908,251,92,159,91816.76,158682.6,250499.36
354680,201908,1245,469,776,468101.92,774448,1242549.92
354690,201908,80,53,27,52894.4,26946,79840.4
354700,201908,70,51,19,50898,18962,69860
354710,201908,47,35,12,34930,11976,46906
354720,201908,22,22,0,21956,0,21956
354730,201908,1727,734,993,732533.78,991014.4,1723548.18
354740,201908,68,49,19,48902,18962,67864
354750,201908,437,252,185,251496.98,184630,436126.98
354760,201908,479,292,187,292434.9,187624.4,480059.3
354765,201908,10,5,5,4990,4990,9980
354770,201908,347,227,120,226546.4,119760,346306.4
354780,201908,8095,3251,4844,3244511.58,4841321.97,8085833.55
354790,201908,102,59,43,58882,42914,101796
354800,201908,447,248,199,247504,198602.4,446106.4
354805,201908,103,49,54,48902.8,53892,102794.8
354810,201908,108,65,43,64870,42914,107784
354820,201908,190,84,106,83832.56,105788,189620.56
354830,201908,39,20,19,19960,18962,38922
354840,201908,62,43,19,42914,18962,61876
354850,201908,4552,2036,2516,2032927.2,2513963.5,4546890.7
354860,201908,326,156,170,155688,169660.93,325348.93
354870,201908,12315,5571,6744,5563860.6,6738504.71,12302365.31
354880,201908,2953,1104,1849,1102791.43,1851293.37,2954084.80
354890,201908,2877,1582,1295,1579986.83,1293467.88,2873454.71
354900,201908,62,42,20,41916,19960,61876
354910,201908,1257,666,591,664668.4,589818,1254486.4
354920,201908,46,38,8,37924,7984,45908
354925,201908,13,8,5,7984,4990,12974
354930,201908,33,30,3,29940.43,2994,32934.43
354940,201908,836,608,228,608032.8,228542,836574.8
354950,201908,207,137,70,136726.6,69860,206586.6
354960,201908,157,61,96,60878,97804.4,158682.4
354970,201908,905,600,305,600797.77,304390.4,905188.17
354980,201908,8582,3170,5412,3167655.56,5408212.36,8575867.92
354990,201908,8857,4188,4669,4180629.31,4665742.72,8846372.03
354995,201908,547,187,360,186626,359280,545906
355000,201908,475,164,311,163672,312374,476046
355010,201908,602,378,224,378242.79,223553.23,601796.02
355020,201908,745,468,277,468062.32,276448.38,744510.70
355030,201908,205798,80769,125029,80670502.66,124919636.96,205590139.62
355040,201908,732,354,378,353292.4,378242,731534.4
355050,201908,149,100,49,99801.4,48902,148703.4
355060,201908,1574,801,773,801395.2,771454.6,1572849.8
355070,201908,1407,686,721,684630.52,719559.61,1404190.13
355080,201908,200,120,80,119760,79840,199600
355090,201908,279,171,108,171656.38,107784.32,279440.70
355100,201908,4935,2411,2524,2407081.82,2519952.19,4927034.01
355110,201908,266,177,89,176647.39,88822,265469.39
355120,201908,80,60,20,59880,19960.98,79840.98
355130,201908,56,32,24,31936,23952,55888
355140,201908,187,119,68,118762,67864,186626
355150,201908,675,404,271,403193.39,270458,673651.39
355160,201908,459,219,240,218562.03,240518.4,459080.43
355170,201908,2061,1079,982,1078838.4,980036,2058874.4
355180,201908,671,285,386,284430,386226,670656
355190,201908,204,144,60,144710,61876,206586
355200,201908,113,65,48,64870,47904,112774
355210,201908,684,402,282,401196,281436.98,682632.98
355220,201908,7052,3734,3318,3728534.27,3315440.98,7043975.25
355230,201908,100,60,40,59880,39920,99800
355240,201908,4412,1876,2536,1873249.14,2531928.37,4405177.51
355250,201908,5542,2621,2921,2616776.83,2918158.61,5534935.44
355255,201908,49,31,18,30938,17964,48902
355260,201908,181,108,73,107784.4,72855.96,180640.36
355270,201908,171,108,63,107784,62874,170658
355280,201908,6334,2607,3727,2602786.8,3723539.78,6326326.58
355290,201908,75,58,17,57884,16966,74850
355300,201908,197,126,71,126746,70858.4,197604.4
355310,201908,113,62,51,61876,50898,112774
355320,201908,88,47,41,46906,40918,87824
355330,201908,286,161,125,160678,124750,285428
355340,201908,1545,528,1017,526944.44,1014966,1541910.44
355350,201908,131,71,60,71856,60878,132734
355360,201908,170,108,62,107784,61876,169660
355365,201908,23,18,5,17964,4990,22954
355370,201908,1024,595,429,593823.57,429147.24,1022970.81
355380,201908,797,520,277,519019.88,276446,795465.88
355385,201908,70,49,21,48902,20958,69860
355390,201908,103,60,43,59880,42914,102794
355395,201908,184,108,76,107784.91,75848,183632.91
355400,201908,1623,995,628,995176.53,626745.99,1621922.52
355410,201908,4839,2308,2531,2304386.39,2529935.54,4834321.93
355420,201908,49,35,14,34930,13972,48902
355430,201908,357,214,143,213572,143712,357284
355440,201908,78,46,32,46906,31936,78842
355450,201908,461,231,230,230538.88,229540.7,460079.58
355460,201908,65,49,16,48902.54,15968,64870.54
355465,201908,50,32,18,31936,17964,49900
355470,201908,176,73,103,72854.7,102794,175648.7
355475,201908,13,9,4,8982,3992,12974
355480,201908,469,208,261,207584.6,260478,468062.6
355490,201908,117,85,32,85828,31936,117764
355495,201908,57,30,27,29940,26946,56886
355500,201908,1602,898,704,897354.35,703792.96,1601147.31
355510,201908,272,198,74,197625.22,73852,271477.22
355520,201908,35,26,9,25948.4,8982,34930.4
355530,201908,21,14,7,13972,6986,20958
355535,201908,77,38,39,37924,38922,76846
355540,201908,2371,945,1426,943251.11,1424147.61,2367398.72
355550,201908,57,37,20,36926,19960,56886
355560,201908,249,119,130,118762,129740,248502
355570,201908,25,18,7,17964,6986,24950
355580,201908,244,171,73,170658,72855.39,243513.39
355590,201908,20,14,6,13972,5988,19960
355600,201908,273,139,134,138722,134730,273452
355610,201908,231,154,77,153692,76846,230538
355620,201908,1327,626,701,624748.4,700596.99,1325345.39
355630,201908,437,321,116,320358,115768.63,436126.63
355635,201908,119,58,61,57884,60879.97,118763.97
355640,201908,567,320,247,319360,246506,565866
355645,201908,835,351,484,350298,484030.4,834328.4
355650,201908,2037,872,1165,873251.74,1162670.98,2035922.72
355660,201908,256,141,115,140718,114770,255488
355670,201908,529,210,319,210578,318362,528940
355680,201908,201,116,85,115768.97,85828,201596.97
355690,201908,94,45,49,44910,48902.07,93812.07
355695,201908,16,11,5,10978,4990,15968
355700,201908,1139,601,538,599798.66,536924.8,1136723.46
355710,201908,2218,1231,987,1228539.6,988020,2216559.6
355715,201908,18,15,3,14970,2994,17964
355720,201908,201,124,77,123752.44,76846,200598.44
355730,201908,99,55,44,54890,43912,98802
410010,201908,129,109,20,108782,19960,128742
410020,201908,107,90,17,89820,16966,106786
410030,201908,166,104,62,103792.4,61876,165668.4
410040,201908,1069,562,507,561874,506106.36,1067980.36
410045,201908,33,28,5,27944,4990,32934
410050,201908,475,270,205,269460,204590,474050
410060,201908,280,212,68,211576,67864,279440
410070,201908,305,252,53,251496,52894,304390
410080,201908,166,106,60,105788,59880,165668
410090,201908,79,70,9,69860.56,8982,78842.56
410100,201908,290,210,80,209580,79840,289420
410105,201908,46,29,17,28942,16966,45908
410110,201908,325,201,124,200598,123752,324350
410115,201908,32,22,10,21956,9980,31936
410120,201908,409,214,195,213572,194610,408182
410130,201908,47,29,18,28942,17964,46906
410140,201908,3139,1545,1594,1542910.1,1591812.6,3134722.7
410150,201908,2662,1063,1599,1060875.14,1596800.8,2657675.94
410160,201908,506,315,191,314370,191616.4,505986.4
410165,201908,64,43,21,42914,20958,63872
410170,201908,167,119,48,118762.4,47904,166666.4
410180,201908,2199,1261,938,1258478.4,936124.99,2194603.39
410185,201908,36,32,4,31936,3992,35928
410190,201908,498,332,166,331336.51,166666,498002.51
410200,201908,957,714,243,713570,243512,957082
410210,201908,578,304,274,304390,273452.4,577842.4
410220,201908,44,22,22,21956,21956,43912
410230,201908,148,74,74,73852,73852,147704
410240,201908,758,493,265,492014.8,264470,756484.8
410250,201908,382,279,103,280438,102794,383232
410260,201908,297,170,127,170658.4,126746,297404.4
410270,201908,31,21,10,20958,9980,30938
410275,201908,59,44,15,43912,14970,58882
410280,201908,322,187,135,187624,135728,323352
410290,201908,241,154,87,153692,86826,240518
410300,201908,78,58,20,57884,19960,77844
410302,201908,19,12,7,11976,6986,18962
410304,201908,42,28,14,27944,13972,41916
410305,201908,218,117,101,116766,100798,217564
410310,201908,216,131,85,130738,85828,216566
410315,201908,49,35,14,34930,13972,48902
410320,201908,136,96,40,95808,39920,135728
410322,201908,34,22,12,21956,11976,33932
410330,201908,174,124,50,123752,49900.6,173652.6
410335,201908,101,58,43,57884,42914,100798
410337,201908,40,34,6,33932,5988,39920
410340,201908,34,31,3,30938,2994,33932
410345,201908,211,128,83,127744,82834,210578
410347,201908,50,39,11,38922,11976,50898
410350,201908,243,150,93,149700,92814,242514
410360,201908,466,295,171,294410.8,170659.2,465070.0
410370,201908,2374,1015,1359,1013969.08,1357281.54,2371250.62
410380,201908,214,133,81,132734,80838,213572
410390,201908,376,270,106,269460,105788,375248
410395,201908,30,19,11,18962,10978,29940
410400,201908,827,403,424,403193.61,422589.5,825783.11
410405,201908,96,73,23,72854,22954,95808
410410,201908,32,25,7,24950,6986,31936
410420,201908,1640,794,846,792325.16,844308.34,1636633.50
410425,201908,170,77,93,76846.6,93812,170658.6
410430,201908,2201,1273,928,1273448.74,926144.56,2199593.30
410440,201908,377,277,100,276446,99800,376246
410442,201908,350,239,111,238522.7,110778,349300.7
410445,201908,411,292,119,291416,119760,411176
410450,201908,381,198,183,197604,182634,380238
410460,201908,470,251,219,250498,218562,469060
410465,201908,212,136,76,135728,75848,211576
410470,201908,228,147,81,146706,81836,228542
410480,201908,6031,2995,3036,2992014.77,3040916.41,6032931.18
410490,201908,1424,899,525,897202.84,523950.4,1421153.24
410500,201908,259,151,108,150698,107784,258482
410510,201908,164,123,41,122754,41916.98,164670.98
410520,201908,251,187,64,186626,63872,250498
410530,201908,238,88,150,87824,150698.99,238522.99
410540,201908,318,232,86,231536.99,85828,317364.99
410550,201908,1657,740,917,738520.4,918160.8,1656681.2
410560,201908,146,108,38,107784,37924,145708
410570,201908,430,294,136,293413.32,135728,429141.32
410580,201908,3372,1520,1852,1516961.19,1850352.88,3367314.07
410590,201908,403,281,122,280438,121756,402194
410600,201908,187,161,26,160678,25948,186626
410610,201908,56,47,9,46906,8982,55888
410620,201908,236,169,67,168662,66866,235528
410630,201908,440,259,181,258482,180638,439120
410640,201908,1014,645,369,644708.7,368262.99,1012971.69
410645,201908,105,79,26,78842.2,25948,104790.2
410650,201908,360,242,118,241516,117764,359280
410655,201908,82,62,20,61876,19960,81836
410657,201908,22,9,13,8982,12974,21956
410660,201908,607,431,176,431136.31,175648,606784.31
410670,201908,73,62,11,61876,10978,72854
410680,201908,208,170,38,169660,37924,207584
410685,201908,19,11,8,10978,7984,18962
410690,201908,28071,12102,15969,12081866.61,15951876.15,28033742.76
410700,201908,330,244,86,243512.4,85828,329340.4
410710,201908,125,104,21,103792,20958,124750
410712,201908,24,18,6,17964,6986,24950
410715,201908,88,68,20,67864,19960,87824
410720,201908,699,401,298,400198,297404.98,697602.98
410725,201908,185,134,51,133732.4,50898,184630.4
410730,201908,91,52,39,51896,38922,90818
410740,201908,115,84,31,83832,30938,114770
410750,201908,243,169,74,168662,73852,242514
410752,201908,25,15,10,14970,9980,24950
410753,201908,50,23,27,22954,26946,49900
410754,201908,44,25,19,24950.4,18962,43912.4
410755,201908,82,53,29,52894,28942,81836
410760,201908,742,421,321,420158.4,320358,740516.4
410765,201908,1701,811,890,809380.36,888221.2,1697601.56
410770,201908,110,87,23,86826,23952,110778
410773,201908,53,40,13,39920,12974,52894
410775,201908,188,138,50,137724,49900,187624
410780,201908,81,44,37,43912,36926,80838
410785,201908,57,44,13,43912,12974,56886
410790,201908,73,37,36,36926,35928,72854
410800,201908,281,175,106,174650,105788,280438
410810,201908,20,16,4,15968,3992.4,19960.4
410820,201908,181,133,48,132734,48902.4,181636.4
410830,201908,8482,3798,4684,3793403.68,4676736.43,8470140.11
410832,201908,105,76,29,75848,28942,104790
410840,201908,1415,798,617,797404.97,618762.46,1416167.43
410845,201908,68,45,23,44910,22954,67864
410850,201908,196,139,57,138722,56886,195608
410855,201908,51,45,6,44910,5988,50898
410860,201908,707,415,292,414170.4,292414,706584.4
410865,201908,102,77,25,76846,24950,101796
410870,201908,153,129,24,128742,23952,152694
410880,201908,1117,577,540,576849.7,538983.92,1115833.62
410890,201908,85,58,27,57884,26946,84830
410895,201908,72,56,16,55888,15968,71856
410900,201908,23,16,7,15968,6986,22954
410910,201908,15,13,2,12974,1996,14970
410920,201908,34,23,11,22954,10978,33932
410930,201908,500,323,177,322354,176646,499000
410940,201908,4366,2503,1863,2499991.84,1860272.8,4360264.64
410950,201908,108,82,26,81836,25948,107784
410960,201908,775,339,436,338322,435128,773450
410965,201908,64,51,13,50898,12974,63872
410970,201908,631,454,177,453151.88,176646,629797.88
410975,201908,120,70,50,69860.72,49900,119760.72
410980,201908,1627,745,882,744508.55,880236.99,1624745.54
410990,201908,260,181,79,180638,78842,259480
411000,201908,65,41,24,40918,23952.4,64870.4
411005,201908,28,23,5,22954,4990,27944
411007,201908,255,151,104,150698,104790,255488
411010,201908,594,415,179,415168,178642,593810
411020,201908,294,205,89,204590,88822,293412
411030,201908,16,9,7,8982,6986,15968
411040,201908,57,41,16,40918,15968,56886
411050,201908,213,166,47,165668,46906,212574
411060,201908,518,356,162,355288.98,161676,516964.98
411065,201908,63,54,9,53892,8982,62874
411070,201908,1250,780,470,778441.54,469060,1247501.54
411080,201908,228,162,66,161676,65868,227544
411090,201908,105,79,26,78842,25948,104790
411095,201908,280,113,167,112774,166666,279440
411100,201908,109,92,17,92814,17964,110778
411110,201908,124,84,40,83832,39920,123752
411120,201908,192,142,50,142714,49900,192614
411125,201908,214,98,116,97804,115768,213572
411130,201908,126,108,18,107784,17964,125748
411140,201908,209,139,70,138722,69860,208582
411150,201908,1237,830,407,829338,406186.63,1235524.63
411155,201908,124,82,42,81836,41916,123752
411160,201908,25,12,13,11976,12974,24950
411170,201908,50,46,4,45908,3992,49900
411180,201908,977,659,318,659678.83,317364,977042.83
411190,201908,328,188,140,187624,139720,327344
411200,201908,672,433,239,432134.63,238522,670656.63
411210,201908,694,378,316,377244,316366.98,693610.98
411220,201908,147,109,38,108782,37924,146706
411230,201908,41,35,6,34930,5988,40918
411240,201908,122,81,41,80838,40918,121756
411250,201908,440,324,116,323352,115768,439120
411260,201908,20,14,6,13972,5988,19960
411270,201908,277,147,130,146706,129740,276446
411275,201908,197,172,25,171656,24950,196606
411280,201908,218,155,63,154690.63,62874,217564.63
411290,201908,59,47,12,46906,11976,58882
411295,201908,140,112,28,112774,27944,140718
411300,201908,70,35,35,34930,34930,69860
411310,201908,92,72,20,71856,19960,91816
411320,201908,755,525,230,523950,229540.6,753490.6
411325,201908,63,43,20,42914,19960,62874
411330,201908,913,585,328,583830.5,327344.16,911174.66
411340,201908,26,19,7,18962,6986.34,25948.34
411342,201908,69,52,17,51896,16966,68862
411345,201908,117,59,58,58882,57884,116766
411350,201908,485,384,101,383232.58,100798.4,484030.98
411360,201908,53,34,19,33932,18962,52894
411370,201908,14229,5861,8368,5858365.39,8358266.52,14216631.91
411373,201908,177,130,47,129740,46906,176646
411375,201908,72,59,13,58882,12974,71856
411380,201908,94,71,23,70858,22954,93812
411390,201908,117,79,38,78842,37924,116766
411400,201908,361,278,83,277444.98,83832,361276.98
411410,201908,444,223,221,223552,220558.4,444110.4
411420,201908,1015,461,554,460078,552892,1012970
411430,201908,437,266,171,266466,170658.98,437124.98
411435,201908,35,23,12,22954,11976,34930
411440,201908,452,366,86,365268,85828,451096
411450,201908,420,353,67,352294,66866,419160
411460,201908,762,301,461,300398.2,460079.98,760478.18
411470,201908,89,66,23,65868,22954,88822
411480,201908,658,380,278,379240,278442,657682
411490,201908,292,191,101,190618,100798,291416
411500,201908,102,87,15,86826,14970,101796
411510,201908,225,178,47,178642,47904,226546
411520,201908,5974,2317,3657,2315412.79,3654681.92,5970094.71
411530,201908,120,84,36,83832,35928,119760
411535,201908,50,21,29,20958,28942,49900
411540,201908,351,241,110,241516,109780,351296
411545,201908,52,39,13,38922,12974,51896
411550,201908,74,56,18,55888,17964,73852
411560,201908,374,167,207,166666,206586,373252
411570,201908,806,300,506,299401.26,505986.6,805387.86
411573,201908,27,17,10,16966,9980,26946
411575,201908,289,183,106,182634,105788,288422
411580,201908,1240,487,753,486026.6,752492,1238518.6
411585,201908,74,36,38,35928,37924,73852
411590,201908,25,18,7,17964,6986,24950
411600,201908,24,10,14,9980,13972,23952
411605,201908,235,97,138,96806,137724,234530
411610,201908,209,141,68,140718,67864,208582
411620,201908,350,197,153,196606,152694,349300
411630,201908,56,38,18,37924,17964,55888
411640,201908,32,26,6,25948,5988,31936
411650,201908,12,7,5,6986,4990,11976
411660,201908,40,29,11,28942,10978,39920
411670,201908,242,183,59,182634,58882,241516
411680,201908,158,136,22,135728,21956,157684
411690,201908,598,317,281,316366,280438,596804
411695,201908,57,41,16,40918,15968,56886
411700,201908,145,124,21,123752,20958,144710
411705,201908,102,66,36,65868,35928,101796
411710,201908,304,206,98,205588,97804,303392
411720,201908,134,87,47,86826,46906,133732
411721,201908,63,53,10,52894,9980,62874
411722,201908,99,42,57,41916,56886,98802
411725,201908,153,122,31,122754.4,30938,153692.4
411727,201908,80,61,19,60878,18962,79840
411729,201908,40,32,8,31936,7984,39920
411730,201908,556,356,200,355288,200598,555886
411740,201908,41,27,14,26946,13972,40918
411745,201908,66,46,20,45908,19960,65868
411750,201908,862,400,462,399200.4,462074.4,861274.8
411760,201908,1179,889,290,888220.4,289420.98,1177641.38
411770,201908,456,303,153,302394,152694,455088
411780,201908,328,212,116,211576,115768.5,327344.5
411790,201908,522,293,229,292415.27,228542.98,520958.25
411800,201908,161,124,37,123752,36926,160678
411810,201908,171,129,42,128742,41916,170658
411820,201908,2127,989,1138,988021.74,1136782.48,2124804.22
411830,201908,12,12,0,11976,0,11976
411840,201908,1978,1241,737,1238518,736525.53,1975043.53
411845,201908,50,19,31,18962,30938,49900
411850,201908,1221,688,533,686625.79,533933.64,1220559.43
411860,201908,45,31,14,30938.4,13972,44910.4
411870,201908,75,52,23,51896,22954,74850
411880,201908,418,272,146,272454.82,145708,418162.82
411885,201908,105,71,34,70858,33932,104790
411890,201908,308,199,109,198603.79,108782,307385.79
411900,201908,73,54,19,53892,18962,72854
411910,201908,181,145,36,144710,35928,180638
411915,201908,2112,901,1211,900196,1209577.22,2109773.22
411920,201908,122,96,26,95808,25948,121756
411925,201908,10,7,3,6986,2994,9980
411930,201908,808,594,214,593810.74,213572,807382.74
411940,201908,592,406,186,405188.34,185628,590816.34
411950,201908,921,473,448,472054.4,447104,919158.4
411960,201908,1037,717,320,715567.3,319360,1034927.3
411965,201908,21,15,6,14970,5988,20958
411970,201908,81,74,7,73852,6986,80838
411980,201908,170,117,53,116766,52894,169660
411990,201908,5185,3024,2161,3018995.94,2157677.7,5176673.64
411995,201908,467,180,287,179640,287424,467064
412000,201908,307,195,112,194610,111776,306386
412010,201908,48,32,16,31936,15968,47904
412015,201908,43,31,12,30938,11976,42914
412020,201908,29,25,4,24950,3992,28942
412030,201908,50,46,4,45908,3992,49900
412033,201908,52,32,20,31936.44,19960,51896.44
412035,201908,65,44,21,43912,20958,64870
412040,201908,40,25,15,24950.4,14970,39920.4
412050,201908,201,156,45,155688,44910,200598
412060,201908,778,591,187,589818,186626,776444
412065,201908,49,31,18,30938,17964,48902
412070,201908,170,115,55,114770,54890,169660
412080,201908,273,145,128,144710,127744,272454
412085,201908,35,16,19,15968,18962,34930
412090,201908,787,504,283,502992.9,282434,785426.9
412100,201908,239,204,35,203592.8,34930,238522.8
412110,201908,67,51,16,50898,15968,66866
412120,201908,319,198,121,197604,120758,318362
412125,201908,84,49,35,48902,34930,83832
412130,201908,38,27,11,26946.36,10978,37924.36
412135,201908,28,17,11,16966,10978,27944
412140,201908,325,224,101,223552,100798,324350
412150,201908,257,171,86,170658,85828,256486
412160,201908,87,52,35,51896,34930,86826
412170,201908,690,488,202,487024.4,202594,689618.4
412175,201908,38,29,9,28942,8982,37924
412180,201908,190,150,40,149700.2,39920,189620.2
412190,201908,341,272,69,271456,69860,341316
412200,201908,194,121,73,120758,72854,193612
412210,201908,73,57,16,56886,15968,72854
412215,201908,227,162,65,161676,64870,226546
412217,201908,67,53,14,52894,13972,66866
412220,201908,821,609,212,607782,211576,819358
412230,201908,331,206,125,205588,124751.96,330339.96
412240,201908,1329,664,665,662672.6,665666.4,1328339.0
412250,201908,394,249,145,248502,144710,393212
412260,201908,108,80,28,79840,27944,107784
412265,201908,176,139,37,138722,37924,176646
412270,201908,84,57,27,56886,26946,83832
412280,201908,90,73,17,72854,16966,89820
412290,201908,98,68,30,67864,29940,97804
412300,201908,209,133,76,132734,75848,208582
412310,201908,48,41,7,40918,6986,47904
412320,201908,97,83,14,82834,13972,96806
412330,201908,188,165,23,164670,22954,187624
412340,201908,146,100,46,99800,45908.4,145708.4
412350,201908,597,296,301,295408,300398,595806
412360,201908,30,25,5,24950,4990,29940
412370,201908,163,143,20,142714.2,19960,162674.2
412380,201908,262,196,66,195608,65868.98,261476.98
412382,201908,53,27,26,26946,25948,52894
412385,201908,142,106,36,106786,35928,142714
412390,201908,283,218,65,217564,64870,282434
412395,201908,71,57,14,56886,13972,70858
412400,201908,80,53,27,52894,26946,79840
412402,201908,236,115,121,114770.4,120758,235528.4
412405,201908,834,320,514,319360,515966,835326
412410,201908,967,604,363,602792.4,362274,965066.4
412420,201908,13,11,2,10978,1996,12974
412430,201908,19,14,5,13972,4990,18962
412440,201908,600,330,270,329340.44,270458,599798.44
412450,201908,73,64,9,63872,8982,72854
412460,201908,90,68,22,67864,21956,89820
412470,201908,226,182,44,181636,43912,225548
412480,201908,149,110,39,109780.3,39920,149700.3
412490,201908,165,144,21,143712,20958,164670
412500,201908,440,364,76,363272.45,75848,439120.45
412510,201908,181,149,32,148702.4,31936,180638.4
412520,201908,88,58,30,57884,29940,87824
412530,201908,111,59,52,58882,51896,110778
412535,201908,94,69,25,68863.96,24950,93813.96
412540,201908,81,37,44,36926,43912,80838
412545,201908,91,66,25,65868,24950,90818
412550,201908,3689,1655,2034,1652688.4,2030930.8,3683619.2
412555,201908,14,10,4,9980,3992,13972
412560,201908,606,435,171,434130,170658.7,604788.7
412570,201908,733,394,339,393212,339320,732532
412575,201908,91,65,26,64870,25948,90818
412580,201908,174,117,57,116766,56886,173652
412590,201908,38,34,4,33932,3992,37924
412600,201908,169,126,43,125748.34,42914,168662.34
412610,201908,31,19,12,18962,11976,30938
412620,201908,148,127,21,126746,20958,147704
412625,201908,2188,1169,1019,1166663.53,1016964.73,2183628.26
412627,201908,71,55,16,54890,15968,70858
412630,201908,419,280,139,279440.6,138722,418162.6
412635,201908,64,17,47,16966,46906,63872
412640,201908,110,75,35,74850,34930,109780
412650,201908,352,226,126,225548,125748,351296
412660,201908,472,288,184,287424,183632,471056
412665,201908,51,45,6,44910,5988,50898
412667,201908,297,208,89,207584.44,88822,296406.44
412670,201908,64,53,11,52894,10978,63872
412680,201908,296,236,60,235528,59880.48,295408.48
412690,201908,104,69,35,68862,34930.4,103792.4
412700,201908,157,104,53,103792,52894.4,156686.4
412710,201908,1420,867,553,865268.2,551894,1417162.2
412720,201908,225,147,78,146706,77844,224550
412730,201908,189,156,33,155688,32934,188622
412740,201908,417,228,189,227544,188622,416166
412750,201908,456,266,190,265468,189620,455088
412760,201908,273,147,126,146706,126746,273452
412770,201908,2106,1173,933,1170655.86,931135.78,2101791.64
412780,201908,152,119,33,118762,32934,151696
412785,201908,261,132,129,131736,128742,260478
412788,201908,31,18,13,17964,12974,30938
412790,201908,130,109,21,108782,20958,129740
412795,201908,149,110,39,109780,38922,148702
412796,201908,323,215,108,214570,107784,322354
412800,201908,585,377,208,376246.5,207584,583830.5
412810,201908,2976,1644,1332,1640713.3,1330334,2971047.3
412820,201908,950,611,339,610777.9,338322.98,949100.88
412830,201908,14,11,3,10978,2994,13972
412840,201908,218,156,62,155688.4,61876,217564.4
412850,201908,779,511,268,509978,267464,777442
412853,201908,174,92,82,91816,81836.4,173652.4
412855,201908,208,114,94,113772.26,93812,207584.26
412860,201908,93,67,26,66866,25948,92814
412862,201908,59,44,15,43912,14970,58882
412863,201908,5,5,0,4990,0,4990
412865,201908,44,32,12,31936,11976,43912
412870,201908,112,71,41,70858,40918,111776
412880,201908,100,73,27,72854.4,26946,99800.4
420005,201908,42,38,4,37924,3992,41916
420010,201908,371,245,126,244510.3,125748.4,370258.7
420020,201908,85,73,12,72854,11976,84830
420030,201908,24,22,2,21956,1996,23952
420040,201908,111,86,25,85828,24950,110778
420050,201908,53,33,20,32934,19960,52894
420055,201908,18,18,0,17964,0,17964
420060,201908,31,24,7,23952,6986,30938
420070,201908,105,88,17,87824,16966,104790
420075,201908,13,12,1,11976,998,12974
420080,201908,42,37,5,36926,4990,41916
420090,201908,35,33,2,32934,1996,34930
420100,201908,156,135,21,134730.4,20958,155688.4
420110,201908,19,19,0,18962,0,18962
420120,201908,61,47,14,46906,13972,60878
420125,201908,83,66,17,65868,16966,82834
420127,201908,29,24,5,23952,4990,28942
420130,201908,407,253,154,252494,153692,406186
420140,201908,1321,736,585,735528.28,583930,1319458.28
420150,201908,43,37,6,36926,5988,42914
420160,201908,35,33,2,32934,1996,34930
420165,201908,17,12,5,11976,4990,16966
420170,201908,70,44,26,43912,25948,69860
420180,201908,23,21,2,20958,1996,22954
420190,201908,30,25,5,24950,4990,29940
420195,201908,129,65,64,64870,64870,129740
420200,201908,1259,562,697,560936.28,695610.88,1256547.16
420205,201908,72,43,29,42914,28942,71856
420207,201908,119,65,54,64870.5,53892,118762.5
420208,201908,21,17,4,16966,3992,20958
420209,201908,19,16,3,15968,2994,18962
420210,201908,480,235,245,234530,244510.98,479040.98
420213,201908,50,39,11,38922,10978,49900
420215,201908,26,23,3,22954,2994,25948
420220,201908,68,44,24,43912,23952,67864
420230,201908,822,471,351,470058.6,350299.97,820358.57
420240,201908,2261,1511,750,1507981.14,749498,2257479.14
420243,201908,43,34,9,33932,8982,42914
420245,201908,137,72,65,71856,64870,136726
420250,201908,63,40,23,39920,22954,62874
420253,201908,38,31,7,30938,6986,37924
420257,201908,13,11,2,10978,1996,12974
420260,201908,102,86,16,85828,15968,101796
420270,201908,40,30,10,29940.99,9980,39920.99
420280,201908,289,215,74,214573.64,73854.66,288428.30
420285,201908,23,13,10,12974,9980,22954
420287,201908,51,33,18,32934,17964,50898
420290,201908,995,705,290,703591.39,289422.97,993014.36
420300,201908,1427,1141,286,1138720.34,285428.98,1424149.32
420310,201908,44,30,14,29940,13972,43912
420315,201908,33,29,4,28942,3992,32934
420320,201908,871,442,429,441116.24,429140.99,870257.23
420325,201908,0,,,,,0.0
420330,201908,115,80,35,79840,34930,114770
420340,201908,160,107,53,106787.18,52894,159681.18
420350,201908,249,184,65,183632,64870,248502
420360,201908,757,581,176,579838.98,175650.46,755489.44
420370,201908,121,75,46,74850.6,45908.4,120759.0
420380,201908,1138,808,330,806385.48,329344.32,1135729.80
420390,201908,264,183,81,182634,81836,264470
420395,201908,188,134,54,133732,53892,187624
420400,201908,253,191,62,190618.75,61876,252494.75
420410,201908,64,48,16,47904,15968,63872
420415,201908,32,29,3,28942,2994,31936
420417,201908,54,42,12,41916,11976,53892
420419,201908,11,11,0,10978,0,10978
420420,201908,2800,1748,1052,1745506.97,1054988.16,2800495.13
420425,201908,75,61,14,60878.98,13972.98,74851.96
420430,201908,1213,856,357,854289.5,356286.98,1210576.48
420435,201908,17,15,2,14970,1996,16966
420440,201908,103,74,29,73852.4,28942,102794.4
420445,201908,22,21,1,20958,998,21956
420450,201908,77,39,38,38922,37924,76846
420455,201908,222,172,50,171658.94,49902.94,221561.88
420460,201908,2367,1555,812,1554981.74,810385.22,2365366.96
420470,201908,110,78,32,77844,31936,109780
420475,201908,7,7,0,6986,0,6986
420480,201908,871,659,212,658681.2,212574.8,871256.0
420490,201908,108,79,29,78842,28942,107784
420500,201908,557,256,301,255488.86,300398,555886.86
420510,201908,19,17,2,16966,1996,18962
420515,201908,27,19,8,18962,7984,26946
420517,201908,10,10,0,9980,0,9980
420519,201908,0,,,,,0.0
420520,201908,77,58,19,57884,18962,76846
420530,201908,163,110,53,109780.3,53892,163672.3
420535,201908,20,18,2,17964,1996,19960
420540,201908,5393,3213,2180,3207830.66,2177698.96,5385529.62
420543,201908,26,25,1,24950,998,25948
420545,201908,204,146,58,145708.98,57884.98,203593.96
420550,201908,874,712,162,710577.76,161679.92,872257.68
420555,201908,39,28,11,27944,10978,38922
420560,201908,66,54,12,53892,11976,65868
420570,201908,151,89,62,88822,61876,150698
420580,201908,285,129,156,128742,155688.4,284430.4
420590,201908,512,353,159,352294,158682,510976
420600,201908,112,64,48,63872,47904,111776
420610,201908,41,38,3,37924,2994,40918
420620,201908,79,65,14,64870,13972,78842
420630,201908,154,112,42,111776.99,41917.98,153694.97
420640,201908,86,78,8,77844,7984,85828
420650,201908,233,120,113,119760,113772,233532
420660,201908,50,39,11,38922,10978,49900
420665,201908,37,27,10,26946,9980,36926
420670,201908,315,239,76,239520,75848.98,315368.98
420675,201908,16,15,1,14970,998,15968
420680,201908,36,26,10,25948,9980,35928
420690,201908,176,143,33,142714,32934,175648
420700,201908,707,492,215,491022.28,214637.72,705660.00
420710,201908,147,85,62,84830,61876,146706
420720,201908,110,88,22,87824.98,21956,109780.98
420730,201908,598,386,212,385352.02,211580.32,596932.34
420740,201908,51,50,1,49900,998,50898
420750,201908,501,342,159,341316,158682,499998
420757,201908,17,15,2,14970,1996,16966
420760,201908,35,30,5,29940,4990,34930
420765,201908,75,59,16,58882,15968,74850
420768,201908,51,47,4,46906,3992,50898
420770,201908,81,68,13,67864,12974,80838
420775,201908,45,42,3,41916,2994,44910
420780,201908,233,187,46,186626,45908,232534
420785,201908,11,9,2,8982,1996,10978
420790,201908,162,138,24,137726.94,23953.96,161680.90
420800,201908,66,50,16,49900,15968,65868
420810,201908,246,217,29,216566,28942,245508
420820,201908,2343,1371,972,1369258.58,971056.77,2340315.35
420830,201908,615,340,275,339321.4,275448,614769.4
420840,201908,148,110,38,109780,37924,147704
420845,201908,423,189,234,189620,233532.4,423152.4
420850,201908,249,196,53,195608,52894,248502
420860,201908,63,53,10,52894,9980,62874
420870,201908,123,87,36,86826,36926,123752
420880,201908,183,125,58,124750,57884.98,182634.98
420890,201908,915,462,453,461077.5,453092.98,914170.48
420895,201908,8,8,0,7984,0,7984
420900,201908,419,336,83,335328,82834.98,418162.98
420910,201908,5784,3256,2528,3249495.73,2529937.33,5779433.06
420915,201908,73,69,4,68862,3992,72854
420917,201908,20,14,6,13972,5988,19960
420920,201908,23,16,7,15968,6986,22954
420930,201908,2808,1755,1053,1756474.24,1053059.49,2809533.73
420940,201908,610,446,164,445109.32,163676.49,608785.81
420945,201908,10,8,2,7984,1996,9980
420950,201908,57,52,5,51896,4990,56886
420960,201908,111,87,24,86827.96,23952.98,110780.94
420970,201908,303,245,58,244514.52,57884.98,302399.50
420980,201908,22,22,0,21956,0,21956
420985,201908,61,55,6,54890,5988,60878
420990,201908,74,56,18,55888,17964,73852
421000,201908,33,19,14,18962,13972,32934
421003,201908,62,44,18,43912,17964.98,61876.98
421005,201908,7,4,3,3992,2994,6986
421010,201908,762,529,233,527942.4,234531.4,762473.8
421020,201908,25,20,5,19960,4990,24950
421030,201908,119,102,17,101796.3,16966,118762.3
421040,201908,73,56,17,55888,16966,72854
421050,201908,327,230,97,229540.4,96806,326346.4
421055,201908,23,19,4,18962,3992,22954
421060,201908,82,52,30,51896,29940,81836
421070,201908,49,44,5,43912.4,4990,48902.4
421080,201908,33,31,2,30938,1996,32934
421085,201908,25,19,6,18962,5988,24950
421090,201908,37,29,8,28942,7984,36926
421100,201908,124,92,32,91816,31936,123752
421105,201908,214,175,39,174650.98,38922.98,213573.96
421110,201908,110,88,22,87824,21956,109780
421120,201908,152,116,36,115768.98,35928,151696.98
421125,201908,17,12,5,11976,4990,16966
421130,201908,812,520,292,519958,292414.4,812372.4
421140,201908,30,22,8,21956,7984,29940
421145,201908,41,33,8,32934,7984,40918
421150,201908,104,77,27,76846,26946.8,103792.8
421160,201908,69,48,21,47904,20958,68862
421165,201908,17,16,1,15968,998,16966
421170,201908,188,158,30,157808.32,29940.98,187749.30
421175,201908,156,106,50,105788,49900,155688
421180,201908,55,35,20,34930.24,19960,54890.24
421185,201908,18,14,4,13972,3992,17964
421187,201908,0,,,,,0.0
421189,201908,43,31,12,30938,11976,42914
421190,201908,1612,1021,591,1019956,590876.04,1610832.04
421200,201908,90,66,24,65868,23952,89820
421205,201908,29,18,11,17964,10978,28942
421210,201908,167,118,49,117764,48902,166666
421220,201908,282,221,61,220558,60878,281436
421223,201908,48,39,9,38922.6,8982,47904.6
421225,201908,71,45,26,44910.6,25948,70858.6
421227,201908,86,67,19,66866,18962,85828
421230,201908,52,37,15,36926,14970,51896
421240,201908,18,18,0,17964,0,17964
421250,201908,361,220,141,219561.6,141716,361277.6
421260,201908,25,21,4,20958,3992,24950
421265,201908,1,1,0,998,0,998
421270,201908,50,44,6,43912,5988,49900
421280,201908,335,192,143,191616,142714,334330
421290,201908,331,226,105,225548,105788,331336
421300,201908,26,21,5,20958,4990,25948
421310,201908,49,36,13,35928,12974,48902
421315,201908,29,19,10,18962,9980,28942
421320,201908,134,90,44,89820,43912,133732
421330,201908,105,78,27,77844,26946.98,104790.98
421335,201908,39,27,12,26946,11976,38922
421340,201908,248,162,86,161677.32,85828,247505.32
421350,201908,198,113,85,112774.97,84830,197604.97
421360,201908,661,496,165,495009.48,164671.92,659681.40
421370,201908,198,154,44,153692,43912,197604
421380,201908,130,103,27,102794,26946,129740
421390,201908,15,11,4,10978,3992,14970
421400,201908,119,101,18,100798,17964,118762
421410,201908,19,17,2,16966,1996,18962
421415,201908,21,20,1,19960,998,20958
421420,201908,143,117,26,116766,25948,142714
421430,201908,15,11,4,10978,3992,14970
421440,201908,55,47,8,46906,7984,54890
421450,201908,96,81,15,80838,14970,95808
421460,201908,61,50,11,49900,10978,60878
421470,201908,67,44,23,43912,22954,66866
421480,201908,678,515,163,513970,162674.98,676644.98
421490,201908,24,23,1,22954.98,998,23952.98
421500,201908,497,322,175,321359.34,174664.7,496024.04
421505,201908,24,17,7,16966,6986,23952
421507,201908,30,23,7,22954,6986,29940
421510,201908,74,47,27,46906,26946,73852
421520,201908,58,49,9,48902,8982,57884
421530,201908,52,45,7,44910,6986,51896
421535,201908,27,26,1,25948.44,998,26946.44
421540,201908,57,49,8,48902,7984,56886
421545,201908,99,73,26,72854.98,25948,98802.98
421550,201908,294,213,81,212574,80838,293412
421555,201908,24,19,5,18962,4990.8,23952.8
421560,201908,9,8,1,7984,998,8982
421565,201908,129,90,39,89820,38922,128742
421567,201908,31,25,6,24950,5988,30938
421568,201908,29,26,3,25948,2994,28942
421569,201908,8,8,0,7984,0,7984
421570,201908,190,127,63,126746,62874,189620
421575,201908,29,24,5,23952,4990,28942
421580,201908,700,419,281,418162,281436,699598
421590,201908,21,20,1,19960,998,20958
421600,201908,152,99,53,98802,52894.8,151696.8
421605,201908,112,78,34,77844.3,33932,111776.3
421610,201908,192,149,43,148702.4,42914,191616.4
421620,201908,1046,619,427,618761.38,428142,1046903.38
421625,201908,23,20,3,19960,2994,22954
421630,201908,290,187,103,186626.9,103793.2,290420.1
421635,201908,18,9,9,8982,8982,17964
421640,201908,99,84,15,83832.6,14970,98802.6
421650,201908,298,177,121,176646,120758,297404
421660,201908,2230,1350,880,1348299.78,879242.73,2227542.51
421670,201908,188,138,50,137724,49900,187624
421680,201908,174,157,17,156686,16966,173652
421690,201908,349,252,97,251497.96,97804.44,349302.40
421700,201908,58,38,20,37924,19960.8,57884.8
421710,201908,26,25,1,24950,998,25948
421715,201908,7,6,1,5988,998,6986
421720,201908,599,430,169,429140.7,169660,598800.7
421725,201908,14,6,8,5988,7984,13972
421730,201908,36,26,10,25948,9980,35928
421740,201908,89,41,48,40918,47904,88822
421750,201908,216,163,53,162674,52894,215568
421755,201908,26,24,2,23952,1996,25948
421760,201908,101,72,29,71856,28942,100798
421770,201908,630,411,219,410188.54,218567.12,628755.66
421775,201908,30,18,12,17964,11976,29940
421780,201908,194,152,42,152694.4,41916,194610.4
421790,201908,159,137,22,136726,21956,158682
421795,201908,20,16,4,15968,3992,19960
421800,201908,512,331,181,330338,180638.5,510976.5
421810,201908,74,61,13,60878,12974,73852
421820,201908,332,225,107,224550.4,106786,331336.4
421825,201908,134,115,19,114770,19960,134730
421830,201908,134,99,35,98802,34930,133732
421835,201908,3,3,0,2994,0,2994
421840,201908,49,41,8,40918.98,7984,48902.98
421850,201908,79,68,11,67864,10978.99,78842.99
421860,201908,40,31,9,30938,8982,39920
421870,201908,1003,764,239,762499.34,239525.72,1002025.06
421875,201908,53,45,8,44910,7984,52894
421880,201908,165,119,46,118762,45908.4,164670.4
421885,201908,22,18,4,17964,3992,21956
421890,201908,127,91,36,90818,35929.81,126747.81
421895,201908,49,45,4,44910,3992,48902
421900,201908,163,129,34,128743.96,33935.92,162679.88
421910,201908,68,42,26,41916,25948,67864
421915,201908,31,26,5,25948,4990,30938
421917,201908,39,29,10,28942,9980,38922
421920,201908,40,37,3,36926,2994,39920
421930,201908,725,573,152,571854.65,152696.94,724551.59
421935,201908,51,44,7,43912,6986,50898
421940,201908,42,37,5,36926,4990,41916
421950,201908,866,583,283,582833.2,282435.58,865268.78
421960,201908,39,33,6,32934.4,5988,38922.4
421970,201908,359,234,125,233532.4,124750.98,358283.38
421985,201908,28,18,10,17964,9980,27944
422000,201908,0,,,,,0.0
430003,201908,197,51,146,50898,145708,196606
430005,201908,37,28,9,27944,8982,36926
430010,201908,273,194,79,193612,78881.92,272493.92
430020,201908,147,95,52,94810.4,51896,146706.4
430030,201908,128,104,24,103792,23952,127744
430040,201908,2960,1749,1211,1746901.84,1210636.22,2957538.06
430045,201908,71,59,12,58882,11976,70858
430047,201908,7,6,1,5988,998,6986
430050,201908,80,66,14,65868,13972,79840
430055,201908,14,12,2,11976,1996,13972
430057,201908,6,4,2,3992,1996,5988
430060,201908,3696,2159,1537,2157730.46,1539108.4,3696838.86
430063,201908,58,54,4,53892,3992,57884
430064,201908,161,127,34,126746,33932,160678
430066,201908,5,3,2,2994,1996,4990
430070,201908,46,35,11,34930,10978,45908
430080,201908,68,47,21,46906,20958,67864
430085,201908,34,12,22,11976,21956,33932
430087,201908,30,23,7,22954.7,6986,29940.7
430090,201908,72,65,7,64870,6986,71856
430100,201908,121,82,39,81836,38922,120758
430105,201908,146,77,69,77844.6,68921.88,146766.48
430107,201908,19,14,5,13972,4990,18962
430110,201908,416,247,169,246835.34,168851.62,415686.96
430120,201908,143,132,11,132734,10978,143712
430130,201908,798,490,308,490018.4,307384,797402.4
430140,201908,122,115,7,115768,6986,122754
430150,201908,105,69,36,68862,35928,104790
430155,201908,34,31,3,30938,2994,33932
430160,201908,3693,2188,1505,2187678.58,1505982.4,3693660.98
430163,201908,342,156,186,155987.4,185687.88,341675.28
430165,201908,29,18,11,17964,10978,28942
430170,201908,90,77,13,76846,12974,89820
430175,201908,79,61,18,60878,17964,78842
430180,201908,104,86,18,85828,17964,103792
430185,201908,35,25,10,24950,9980,34930
430187,201908,89,38,51,37924,50898,88822
430190,201908,215,121,94,121905.7,93812,215717.7
430192,201908,12,10,2,9980,1996,11976
430195,201908,16,11,5,10978,4990,15968
430200,201908,169,147,22,146706,21956,168662
430205,201908,20,19,1,18962,998,19960
430210,201908,681,535,146,535926.4,145798.22,681724.62
430215,201908,14,12,2,11976,1996,13972
430220,201908,74,52,22,51896,21956,73852
430222,201908,12,6,6,5988,5988,11976
430223,201908,15,7,8,6986,7984,14970
430225,201908,2,1,1,998,998,1996
430230,201908,315,184,131,183632,130738,314370
430235,201908,56,42,14,41916,13972,55888
430237,201908,26,21,5,20958,4990,25948
430240,201908,131,84,47,83832,46906,130738
430245,201908,69,57,12,56886,11976,68862
430250,201908,191,113,78,113772,77844,191616
430258,201908,10,8,2,7984,1996,9980
430260,201908,33,29,4,28942,3992,32934
430265,201908,37,31,6,30997.88,5988,36985.88
430270,201908,539,404,135,403282.12,134733.92,538016.04
430280,201908,1040,643,397,641714,396356,1038070
430290,201908,386,221,165,220558.6,164670,385228.6
430300,201908,2097,1176,921,1173730.34,920311,2094041.34
430310,201908,1919,994,925,994308.52,927106.02,1921414.54
430320,201908,55,44,11,43912,10978,54890
430330,201908,94,83,11,82834,10978,93812
430340,201908,70,59,11,58882,10978,69860
430350,201908,1679,1144,535,1142710.6,533990.86,1676701.46
430355,201908,22,19,3,18962,2994,21956
430360,201908,87,43,44,43912,43912,87824
430367,201908,33,24,9,23952,8982,32934
430370,201908,55,47,8,46906,7984,54890
430380,201908,140,104,36,103792,35928,139720
430390,201908,596,375,221,374250,220597.92,594847.92
430400,201908,139,105,34,104790.15,33932,138722.15
430410,201908,59,46,13,45908,12974,58882
430420,201908,507,337,170,337324.94,169660.98,506985.92
430430,201908,53,52,1,51231.33,998,52229.33
430435,201908,155,116,39,115768,38922,154690
430440,201908,512,342,170,342314.6,170658,512972.6
430450,201908,1166,958,208,956123.92,207584,1163707.92
430460,201908,5040,2747,2293,2742825.54,2295244.06,5038069.60
430461,201908,17,16,1,15968,998,16966
430462,201908,8,5,3,4990,2994,7984
430463,201908,1064,572,492,571125.58,491017.96,1062143.54
430465,201908,23,13,10,12974,9980,22954
430466,201908,684,484,200,483032.4,199600,682632.4
430467,201908,99,55,44,54890.6,43912,98802.6
430468,201908,110,66,44,65868,43912,109780
430469,201908,22,17,5,16966,4990,21956
430470,201908,1157,652,505,653987.95,504109.76,1158097.71
430471,201908,55,39,16,38981.88,15968,54949.88
430480,201908,100,63,37,62874,36926,99800
430485,201908,6,6,0,5988.4,0,5988.4
430490,201908,84,68,16,67864,15968,83832
430495,201908,36,27,9,26946,8982,35928
430500,201908,191,128,63,128742,62874.63,191616.63
430510,201908,3390,2223,1167,2219762.88,1165664,3385426.88
430511,201908,16,15,1,14970,998,15968
430512,201908,144,102,42,101796,41916,143712
430513,201908,49,39,10,38922,9980,48902
430515,201908,30,28,2,27944,1996,29940
430517,201908,166,148,18,148702,17964,166666
430520,201908,361,251,110,250498,110778,361276
430530,201908,84,47,37,46906,36926,83832
430535,201908,449,311,138,310378,138872.69,449250.69
430537,201908,10,10,0,9980,0,9980
430540,201908,81,54,27,53892,26946,80838
430543,201908,353,111,242,110778,241516,352294
430544,201908,45,42,3,41916,2994,44910
430545,201908,358,189,169,188891.7,169719.88,358611.58
430550,201908,42,34,8,33932,7984,41916
430558,201908,4,2,2,1996,1996,3992
430560,201908,55,29,26,28942,25948,54890
430570,201908,109,42,67,41916,66866,108782
430580,201908,124,102,22,101796,21956.6,123752.6
430583,201908,14,14,0,13972,0,13972
430585,201908,11,4,7,3992,6986,10978
430587,201908,15,7,8,6986,7984,14970
430590,201908,152,126,26,125748,25948,151696
430593,201908,2,2,0,1996,0,1996
430595,201908,16,13,3,12974,2994,15968
430597,201908,47,26,21,25948,20958,46906
430600,201908,218,155,63,154690,62874,217564
430605,201908,154,95,59,94810,58882,153692
430607,201908,20,17,3,16966,2994,19960
430610,201908,1613,763,850,764767.7,849299.38,1614067.08
430613,201908,3,3,0,2994,0,2994
430620,201908,108,77,31,76846,30938,107784
430630,201908,46,40,6,39920,5988,45908
430632,201908,32,27,5,26946,4990,31936
430635,201908,34,31,3,30938,2994,33932
430637,201908,54,29,25,28942,24950,53892
430640,201908,186,105,81,106786,80838,187624
430642,201908,21,19,2,18962,1996,20958
430645,201908,37,30,7,29940,6986,36926
430650,201908,253,204,49,203592.4,48902,252494.4
430655,201908,3,3,0,2994,0,2994
430660,201908,976,481,495,481036,496006.4,977042.4
430670,201908,76,52,24,51896,23952,75848
430673,201908,73,41,32,40918,31936,72854
430675,201908,12,9,3,8982,2994,11976
430676,201908,495,300,195,299549.88,195907.58,495457.46
430680,201908,245,174,71,173652,71856,245508
430690,201908,547,342,205,341376.86,204650.51,546027.37
430692,201908,7,5,2,4990,1996,6986
430693,201908,139,93,46,92814,45908,138722
430695,201908,73,61,12,60878,11976,72854
430697,201908,58,36,22,35928,21956,57884
430700,201908,1537,1073,464,1070854.4,463072,1533926.4
430705,201908,20,19,1,18962,998,19960
430710,201908,261,167,94,166666,93812,260478
430720,201908,107,91,16,90818,15968,106786
430730,201908,138,118,20,117764,19960,137724
430740,201908,71,47,24,46906,23952,70858
430745,201908,34,27,7,26946,6986,33932
430750,201908,338,223,115,222554,114770,337324
430755,201908,87,51,36,50898,35928,86826
430760,201908,366,215,151,214571.04,150698.98,365270.02
430770,201908,1424,747,677,745896.7,679123.04,1425019.74
430780,201908,310,197,113,196666.86,112774.98,309441.84
430781,201908,28,24,4,23952,3992,27944
430783,201908,55,45,10,44910,9980,54890
430786,201908,6,4,2,3992,1996,5988
430790,201908,530,349,181,348302,181636.4,529938.4
430800,201908,161,134,27,133732,26946,160678
430805,201908,40,37,3,36926,2994,39920
430807,201908,46,26,20,25948,19960,45908
430810,201908,79,53,26,52894,25948,78842
430820,201908,145,86,59,85828,58882,144710
430825,201908,10,8,2,7984,1996,9980
430830,201908,235,219,16,219620.28,15968,235588.28
430840,201908,128,87,41,86826,40918,127744
430843,201908,7,4,3,3992,2994,6986
430845,201908,74,43,31,42914,30938,73852
430850,201908,586,406,180,405188,179662.94,584850.94
430860,201908,166,106,60,105788,60878,166666
430865,201908,71,39,32,38922,31936.98,70858.98
430870,201908,78,63,15,62874,14970,77844
430880,201908,154,116,38,115827.88,37924,153751.88
430885,201908,10,8,2,7984,1996,9980
430890,201908,354,217,137,216566,136726,353292
430900,201908,527,368,159,366854.82,158682,525536.82
430905,201908,107,48,59,47904,59880,107784
430910,201908,283,157,126,156686,125748.98,282434.98
430912,201908,5,5,0,4990,0,4990
430915,201908,36,30,6,29940,5988,35928
430920,201908,4225,2300,1925,2297907.98,1922909.38,4220817.36
430925,201908,4,3,1,2994,998,3992
430930,201908,2043,1195,848,1196204.82,848871.14,2045075.96
430940,201908,261,170,91,169660,90818,260478
430950,201908,152,124,28,123752,27944,151696
430955,201908,22,13,9,12974,8982,21956
430957,201908,17,16,1,15968,998,16966
430960,201908,246,161,85,160678,84830,245508
430965,201908,113,72,41,71856,40918,112774
430970,201908,83,69,14,68862,13972,82834
430975,201908,41,37,4,36926,3992,40918
430980,201908,45,29,16,28942,15968,44910
430990,201908,114,87,27,86826,26946,113772
430995,201908,122,116,6,115768,5988,121756
431000,201908,306,138,168,137725,167664,305389
431010,201908,343,199,144,198602,144710,343312
431020,201908,1910,1109,801,1107780.6,801433.92,1909214.52
431030,201908,42,33,9,32934,8982,41916
431033,201908,381,191,190,190618,190618,381236
431036,201908,14,9,5,8982,4990,13972
431040,201908,135,82,53,81836,52894,134730
431041,201908,38,27,11,26946.8,10978,37924.8
431043,201908,50,29,21,28942,20958,49900
431046,201908,11,7,4,6986,3992,10978
431050,201908,198,127,71,126746,70858,197604
431053,201908,72,44,28,43972,27944,71916
431055,201908,65,46,19,45908,18962,64870
431057,201908,18,18,0,17964,0,17964
431060,201908,1649,1054,595,1053011.85,595821.4,1648833.25
431065,201908,20,12,8,11976,7984,19960
431070,201908,65,59,6,59880,5988,65868
431075,201908,7,7,0,6986,0,6986
431080,201908,130,79,51,78842,50898,129740
431085,201908,35,30,5,29940,4990,34930
431087,201908,15,12,3,11976,2994,14970
431090,201908,53,42,11,41916,10978,52894
431100,201908,1218,726,492,724550.02,492014,1216564.02
431110,201908,240,147,93,146706,92814.4,239520.4
431112,201908,26,15,11,14970,10978,25948
431113,201908,34,25,9,24950,8982,33932
431115,201908,154,107,47,106786,46906,153692
431120,201908,605,366,239,365358.42,238582.96,603941.38
431123,201908,3,2,1,1996,998,2994
431125,201908,96,87,9,86826,8982,95808
431127,201908,9,4,5,3992,4990,8982
431130,201908,698,452,246,451096,245508,696604
431140,201908,747,520,227,518960.4,227544,746504.4
431142,201908,32,26,6,25948.95,5988,31936.95
431150,201908,193,148,45,147704,44910,192614
431160,201908,53,48,5,47904,4990,52894
431162,201908,13,10,3,9980,2994,12974
431164,201908,6,6,0,5988,0,5988
431170,201908,107,84,23,84830,22954,107784
431171,201908,68,42,26,41916,25948,67864
431173,201908,1,1,0,998,0,998
431175,201908,197,103,94,103792.4,94810,198602.4
431177,201908,76,58,18,57884,18023.88,75907.88
431179,201908,14,12,2,11976,1996,13972
431180,201908,459,282,177,281436,176646.98,458082.98
431190,201908,82,63,19,62874,18962,81836
431198,201908,68,48,20,47904,20958,68862
431200,201908,21,17,4,16966,3992,20958
431205,201908,22,22,0,21956,0,21956
431210,201908,89,54,35,53892,34930,88822
431213,201908,30,26,4,25948,3992,29940
431215,201908,22,19,3,18962,2994,21956
431217,201908,5,4,1,3992,998,4990
431220,201908,69,60,9,59880.69,8982,68862.69
431225,201908,144,96,48,95808.98,47904,143712.98
431230,201908,105,93,12,92814,11976,104790
431235,201908,8,8,0,7984,0,7984
431237,201908,23,16,7,15968,6986,22954
431238,201908,9,6,3,5988.4,2994,8982.4
431240,201908,981,630,351,629009.66,350357.88,979367.54
431242,201908,37,36,1,35928,998,36926
431244,201908,11,8,3,7984,2994,10978
431245,201908,54,41,13,40918,12974,53892
431247,201908,12,9,3,8982,2994,11976
431250,201908,279,146,133,145767.88,132734,278501.88
431260,201908,58,45,13,44910,12974,57884
431261,201908,18,11,7,10978,6986,17964
431262,201908,19,18,1,17964,998,18962
431265,201908,146,79,67,78842,66866,145708
431267,201908,14,13,1,12974,998,13972
431270,201908,325,269,56,268462,55888,324350
431275,201908,38,35,3,34930,2994,37924
431280,201908,19,15,4,14970,3992,18962
431290,201908,25,20,5,19960,4990,24950
431295,201908,3,3,0,2994,0,2994
431300,201908,23,20,3,19960,2994,22954
431301,201908,7,7,0,6986,0,6986
431303,201908,59,39,20,38922,19960,58882
431306,201908,235,125,110,124572.35,109780,234352.35
431308,201908,7,5,2,4990,1996,6986
431310,201908,67,56,11,55888,10978,66866
431320,201908,144,85,59,84830,58882,143712
431330,201908,180,115,65,115768,64870,180638
431333,201908,28,24,4,23952,3992,27944
431335,201908,9,5,4,4990,3992,8982
431337,201908,329,153,176,152694,176825.64,329519.64
431339,201908,20,17,3,16966,2994,19960
431340,201908,2981,1678,1303,1676705.23,1301467.97,2978173.20
431342,201908,39,24,15,23952,14970,38922
431344,201908,16,16,0,15968,0,15968
431346,201908,5,5,0,4990,0,4990
431349,201908,33,30,3,29940,2994,32934
431350,201908,916,541,375,539919.48,375338.22,915257.70
431360,201908,48,43,5,42914,4990,47904
431365,201908,326,159,167,158741.88,166666,325407.88
431370,201908,1329,778,551,776444.4,550900.9,1327345.3
431380,201908,96,82,14,81836,13972,95808
431390,201908,507,277,230,276446,230538,506984
431395,201908,296,135,161,134730,161736,296466
431400,201908,42,30,12,29940,11976,41916
431402,201908,101,72,29,71856,28942,100798
431403,201908,22,12,10,11976,9980,21956
431405,201908,664,361,303,360278.9,303393.96,663672.86
431406,201908,30,26,4,25948,3992,29940
431407,201908,51,40,11,39920,10978,50898
431410,201908,3420,2104,1316,2100792,1314386.26,3415178.26
431413,201908,15,12,3,12974,2994,15968
431415,201908,67,51,16,50898,16966,67864
431417,201908,22,12,10,11976,9980,21956
431420,201908,317,216,101,215568,100798,316366
431430,201908,47,22,25,21956,24950,46906
431440,201908,8943,6278,2665,6271162.6,2665898.92,8937061.52
431442,201908,28,16,12,15968,11976,27944
431445,201908,24,21,3,20958,2994,23952
431446,201908,4,4,0,3992,0,3992
431447,201908,85,61,24,60878,23952,84830
431449,201908,54,46,8,45908,7984,53892
431450,201908,418,281,137,280438,136726,417164
431454,201908,0,,,,,0.0
431455,201908,54,41,13,40918,12974,53892
431460,201908,522,362,160,361276,159680,520956
431470,201908,120,93,27,92814,26946,119760
431475,201908,10,9,1,8982,998,9980
431477,201908,38,25,13,24950,12974,37924
431478,201908,8,7,1,6986,998,7984
431480,201908,485,306,179,305388,178721.84,484109.84
431490,201908,28672,16110,12562,16128075.25,12594431.18,28722506.43
431500,201908,80,58,22,57884,21956,79840
431505,201908,27,17,10,16966,9980,26946
431507,201908,12,9,3,9980,2994,12974
431510,201908,255,178,77,177644.1,76935.82,254579.92
431513,201908,25,22,3,21956,2994,24950
431514,201908,6,5,1,4990,998,5988
431515,201908,82,69,13,68862,13123.7,81985.7
431517,201908,5,4,1,3992,998,4990
431520,201908,37,33,4,32934,3992,36926
431530,201908,1530,687,843,687861.88,841643.52,1529505.40
431531,201908,24,22,2,21956,1996,23952
431532,201908,30,22,8,21956,7984,29940
431535,201908,26,16,10,15968,9980,25948
431540,201908,141,120,21,119760,20958,140718
431545,201908,13,11,2,10978,1996,12974
431550,201908,356,203,153,202594,152694,355288
431555,201908,12,12,0,11976,0,11976
431560,201908,4538,3139,1399,3133884.45,1397320.16,4531204.61
431570,201908,812,437,375,436126.8,374250,810376.8
431575,201908,39,23,16,22954,15968,38922
431580,201908,103,71,32,70858,31936,102794
431590,201908,148,127,21,127744,20958,148702
431595,201908,19,16,3,15968,2994,18962
431600,201908,228,129,99,128781.92,98802,227583.92
431610,201908,119,88,31,87824,30938,118762
431620,201908,45,37,8,36926,7984,44910
431630,201908,127,107,20,106786,19960,126746
431640,201908,1338,851,487,849398.2,487184.2,1336582.4
431642,201908,36,34,2,33932,1996,35928
431643,201908,43,21,22,20958,21956,42914
431645,201908,326,191,135,190618,134730,325348
431647,201908,10,10,0,9980,0,9980
431650,201908,33,23,10,22954,9980,32934
431660,201908,317,201,116,201596,115768,317364
431670,201908,233,110,123,109780,122754,232534
431673,201908,3,3,0,2994,0,2994
431675,201908,26,21,5,20958,4990,25948
431680,201908,1133,839,294,837322,294410,1131732
431690,201908,4775,2909,1866,2907725.02,1865386.06,4773111.08
431695,201908,22,17,5,16966,4990,21956
431697,201908,0,,,,,0.0
431700,201908,169,134,35,133732,34930,168662
431710,201908,4007,1777,2230,1775443.58,2226708.46,4002152.04
431720,201908,1348,827,521,825496.7,522952.99,1348449.69
431725,201908,1,1,0,998,0,998
431730,201908,1180,801,379,799400.16,378242,1177642.16
431740,201908,1364,672,692,670775.88,691658.24,1362434.12
431750,201908,1842,1199,643,1197601.71,644708.98,1842310.69
431755,201908,5,4,1,3992,998,4990
431760,201908,1011,654,357,652693.8,358371.82,1011065.62
431770,201908,400,294,106,293412,106786,400198
431775,201908,30,22,8,21956,7984,29940
431780,201908,553,343,210,342314,209580,551894
431790,201908,172,133,39,132734,38922,171656
431795,201908,12,10,2,9980,1996,11976
431800,201908,3339,1762,1577,1760635,1574938.86,3335573.86
431805,201908,18,16,2,15968,1996,17964
431810,201908,607,410,197,409269.82,196666.86,605936.68
431820,201908,320,185,135,184630,134730,319360
431830,201908,2344,1416,928,1414166,929141.93,2343307.93
431840,201908,491,329,162,329340.6,161676,491016.6
431842,201908,34,28,6,27944,5988,33932
431843,201908,11,9,2,8982,1996,10978
431844,201908,16,14,2,13972,1996,15968
431845,201908,26,24,2,23952,1996,25948
431846,201908,28,23,5,22954,4990,27944
431848,201908,13,11,2,10978,1996,12974
431849,201908,10,7,3,6986,2994,9980
431850,201908,801,658,143,656684,142714,799398
431860,201908,114,79,35,78842,34930,113772
431861,201908,4,2,2,1996,1996,3992
431862,201908,53,35,18,34930,17964,52894
431870,201908,3412,2012,1400,2009745.34,1400809.94,3410555.28
431880,201908,933,688,245,686714,244510,931224
431890,201908,1296,795,501,794467.88,499998,1294465.88
431900,201908,179,128,51,127744,50898,178642
431910,201908,55,39,16,38922,15968,54890
431912,201908,38,22,16,21956,15968,37924
431915,201908,127,101,26,100798,25948,126746
431920,201908,153,113,40,112774,39920,152694
431930,201908,79,64,15,63872,14970,78842
431935,201908,3,3,0,2994,0,2994
431936,201908,12,11,1,10978,998,11976
431937,201908,19,14,5,13972,4990,18962
431940,201908,466,313,153,312374,153692.5,466066.5
431950,201908,502,315,187,314431.26,186626.98,501058.24
431960,201908,737,408,329,407186.36,328492.68,735679.04
431970,201908,72,64,8,63872.4,7984,71856.4
431971,201908,3,3,0,2994,0,2994
431973,201908,23,19,4,18962,3992,22954
431975,201908,9,8,1,7984,998,8982
431980,201908,213,134,79,133732,78842,212574
431990,201908,1178,637,541,635661.71,540009.96,1175671.67
432000,201908,1650,896,754,894709.1,753372.96,1648082.06
432010,201908,279,189,90,188622,90818,279440
432020,201908,174,142,32,141716,31936,173652
432023,201908,15,13,2,12974,1996,14970
432026,201908,69,64,5,63872,4990,68862
432030,201908,66,32,34,31936,33932,65868
432032,201908,19,15,4,14970,3992,18962
432035,201908,52,42,10,41916,9980,51896
432040,201908,102,71,31,70858,30938,101796
432045,201908,8,7,1,6986,998,7984
432050,201908,82,51,31,50898,30938,81836
432055,201908,118,88,30,87824,29940,117764
432057,201908,5,4,1,3992.4,998,4990.4
432060,201908,34,31,3,30938,2994,33932
432065,201908,34,30,4,29940,3992,33932
432067,201908,89,80,9,79899.88,8982,88881.88
432070,201908,402,310,92,309630.8,91816.98,401447.78
432080,201908,820,573,247,571913.88,246545.92,818459.80
432085,201908,13,10,3,9980,2994,12974
432090,201908,265,174,91,173652,90818,264470
432100,201908,174,117,57,116766,56886,173652
432110,201908,595,400,195,399200,194649.92,593849.92
432120,201908,938,568,370,567901.92,369399.72,937301.64
432130,201908,501,365,136,364270,135728,499998
432132,201908,24,21,3,20958,2994,23952
432135,201908,78,65,13,64870,12974,77844
432140,201908,267,212,55,211576,54890,266466
432143,201908,202,130,72,129740,71856,201596
432145,201908,272,189,83,188622,82834,271456
432146,201908,13,13,0,12974,0,12974
432147,201908,119,58,61,57884,60878,118762
432149,201908,14,10,4,9980,3992,13972
432150,201908,833,515,318,515194.37,317365.55,832559.92
432160,201908,1419,739,680,737882.85,680148.08,1418030.93
432162,201908,4,3,1,2994,998,3992
432163,201908,19,14,5,13972,4990,18962
432166,201908,111,83,28,83334,27944,111278
432170,201908,217,112,105,111776,104790,216566
432180,201908,546,335,211,334419.82,210578.4,544998.22
432183,201908,6,6,0,5988,0,5988
432185,201908,78,69,9,68862,8982,77844
432190,201908,477,278,199,277444,198642.9,476086.9
432195,201908,86,72,14,71856,13972,85828
432200,201908,392,255,137,254490,136786.86,391276.86
432210,201908,119,74,45,73852,44910,118762
432215,201908,53,49,4,48902,3992,52894
432218,201908,22,21,1,20958,998,21956
432220,201908,677,354,323,354290,322356.57,676646.57
432225,201908,13,8,5,7984,4990,12974
432230,201908,144,96,48,95808,47904,143712
432232,201908,14,13,1,12974,998,13972
432234,201908,4,3,1,2994,998,3992
432235,201908,3,3,0,2994,0,2994
432237,201908,28,15,13,14970,12974,27944
432240,201908,4363,2473,1890,2475001.52,1888666.88,4363668.40
432250,201908,1099,705,394,703739.7,394210,1097949.7
432252,201908,41,36,5,35928,4990,40918
432253,201908,62,50,12,49900,11976,61876
432254,201908,27,13,14,12974,13972,26946
432255,201908,11,10,1,9980,998,10978
432260,201908,849,673,176,671814.08,176646,848460.08
432270,201908,241,180,61,179640,61876,241516
432280,201908,140,106,34,105788.6,33932,139720.6
432285,201908,2,2,0,1996,0,1996
432290,201908,66,59,7,58882,6986,65868
432300,201908,4618,2582,2036,2579038.41,2038289.36,4617327.77
432310,201908,118,97,21,96806,20958,117764
432320,201908,22,17,5,16966,4990,21956
432330,201908,16,12,4,11976,3992,15968
432335,201908,7,6,1,5988,998,6986
432340,201908,40,35,5,34930,4990,39920
432345,201908,97,67,30,66866,29940,96806
432350,201908,25,24,1,23952,998,24950
432360,201908,7,5,2,4990,1996,6986
432370,201908,23,22,1,21956,998,22954
432375,201908,34,31,3,30938,2994,33932
432377,201908,9,9,0,8982,0,8982
432380,201908,164,76,88,75848,87973.7,163821.7
500020,201908,239,137,102,136726,101796,238522
500025,201908,126,64,62,63872,61876,125748
500060,201908,1451,914,537,912172,535927.38,1448099.38
500070,201908,798,388,410,388222.96,409180,797402.96
500080,201908,131,106,25,105788,24950,130738
500085,201908,132,107,25,106786.4,24950,131736.4
500090,201908,327,158,169,157684,168662,326346
500100,201908,729,386,343,386226,342314.8,728540.8
500110,201908,2294,1068,1226,1067866.69,1224557.5,2292424.19
500124,201908,259,152,107,151696,106786,258482
500150,201908,321,138,183,137724.98,183634.94,321359.92
500190,201908,522,365,157,364370,156736.4,521106.4
500200,201908,188,162,26,161676.28,25948,187624.28
500210,201908,1484,536,948,534934.86,946146.04,1481080.90
500215,201908,243,142,101,141716,100798,242514
500220,201908,754,494,260,495130.54,259480,754610.54
500230,201908,257,169,88,168662,88822,257484
500240,201908,676,472,204,471056.36,203592,674648.36
500260,201908,591,230,361,229540,360278,589818
500270,201908,29403,12787,16616,12769966.78,16603967.14,29373933.92
500280,201908,193,70,123,69860,122754,192614
500290,201908,1177,712,465,711574,466066.98,1177640.98
500295,201908,441,284,157,283432.4,156686,440118.4
500310,201908,65,22,43,21956,42914,64870
500315,201908,719,438,281,437124,280438,717562
500320,201908,3656,1847,1809,1843307.75,1806385.88,3649693.63
500325,201908,923,517,406,515967.38,407184.4,923151.78
500330,201908,1444,682,762,680636.4,761474.98,1442111.38
500345,201908,307,237,70,236527.38,69860,306387.38
500348,201908,249,151,98,150698,97804,248502
500350,201908,127,63,64,62874,63872,126746
500370,201908,5438,2480,2958,2475042.48,2956082.9,5431125.38
500375,201908,339,250,89,249500,88822,338322
500380,201908,594,344,250,343312,249500,592812
500390,201908,71,34,37,33932,36926,70858
500400,201908,209,146,63,145708,62874.98,208582.98
500410,201908,549,226,323,225610.95,322359.87,547970.82
500430,201908,524,375,149,374250,148702,522952
500440,201908,199,105,94,104790,93812,198602
500450,201908,402,178,224,177644,224550,402194
500460,201908,291,150,141,149700,140718,290418
500470,201908,444,351,93,351297.39,92814.98,444112.37
500480,201908,108,65,43,64870,42914,107784
500490,201908,110,46,64,45908,63872,109780
500500,201908,1424,522,902,521964.81,901225.51,1423190.32
500510,201908,45,34,11,33932,10978.98,44910.98
500515,201908,106,75,31,74850,30938,105788
500520,201908,335,187,148,186626.8,148703.39,335330.19
500525,201908,89,49,40,48902,39920,88822
500540,201908,908,394,514,393272.86,512973.96,906246.82
500560,201908,908,516,392,515966,392214.4,908180.4
500568,201908,980,575,405,573850.98,405189.39,979040.37
500570,201908,1200,695,505,694629,504104.88,1198733.88
500580,201908,333,176,157,175648,156747.97,332395.97
500600,201908,314,166,148,165668,147705.96,313373.96
500620,201908,913,647,266,646704,266466,913170
500625,201908,77,65,12,64870,11976,76846
500627,201908,23,11,12,10978,11976,22954
500630,201908,1574,853,721,851294.9,721554,1572848.9
500635,201908,520,308,212,307384,211576,518960
500640,201908,403,212,191,211576.8,190618,402194.8
500660,201908,5416,2081,3335,2077836.4,3330327.51,5408163.91
500690,201908,578,208,370,207593.78,369284.5,576878.28
500710,201908,386,200,186,199600,186627.96,386227.96
500720,201908,953,561,392,559878.43,392214,952092.43
500730,201908,193,118,75,117764,74850,192614
500740,201908,863,378,485,377250.34,484058.69,861309.03
500750,201908,150,46,104,45908,103792.98,149700.98
500755,201908,124,88,36,87824.4,35928,123752.4
500769,201908,739,417,322,416168.37,321357.97,737526.34
500770,201908,411,216,195,215568,195608,411176
500780,201908,163,111,52,110778,51896,162674
500790,201908,1069,549,520,547902,519962.91,1067864.91
500793,201908,275,154,121,153692,120759.38,274451.38
500795,201908,169,122,47,121756,46906.98,168662.98
500797,201908,50,38,12,37924,11976,49900
500800,201908,418,188,230,187624.98,229540,417164.98
500830,201908,2249,1276,973,1274447,974049.01,2248496.01
500840,201908,140,104,36,103792,35928.98,139720.98
510010,201908,165,93,72,92814,71856,164670
510020,201908,484,224,260,224568.62,259510.38,484079.00
510025,201908,1690,971,719,969068.15,717577.1,1686645.25
510030,201908,663,351,312,352296.94,311379.35,663676.29
510035,201908,129,60,69,59881.96,68862.98,128744.94
510040,201908,379,172,207,171656,206588.68,378244.68
510050,201908,390,217,173,216572.84,172720.32,389293.16
510060,201908,115,59,56,59880,55888,115768
510080,201908,223,89,134,88823.96,133732.98,222556.94
510100,201908,73,33,40,32934,39920,72854
510120,201908,37,24,13,23952,12974,36926
510125,201908,386,243,143,242514,142715.97,385229.97
510130,201908,570,332,238,332342.82,237534.18,569877.00
510140,201908,400,123,277,122754,276446,399200
510160,201908,96,39,57,38922,56886,95808
510170,201908,826,506,320,505002.88,319374.68,824377.56
510180,201908,2861,1396,1465,1394250.39,1462104.18,2856354.57
510185,201908,14,6,8,5988,7984,13972
510190,201908,214,74,140,73852,139720,213572
510250,201908,2557,1520,1037,1519961.26,1034930.32,2554891.58
510260,201908,180,133,47,132748.7,47904.98,180653.68
510263,201908,459,262,197,261479.74,196606.98,458086.72
510267,201908,680,381,299,380253.3,298424.52,678677.82
510268,201908,59,29,30,28942,29940,58882
510269,201908,72,34,38,33932.98,37924,71856.98
510270,201908,390,202,188,201599.92,187628.9,389228.82
510279,201908,223,167,56,166668.94,55888.4,222557.34
510285,201908,178,73,105,72854.98,104790,177644.98
510300,201908,510,284,226,283436.92,225554.86,508991.78
510305,201908,210,100,110,99801.97,110838.86,210640.83
510310,201908,105,56,49,55888,48902,104790
510320,201908,847,540,307,538925.88,307397.73,846323.61
510325,201908,397,166,231,165668,230538,396206
510330,201908,419,240,179,239520.99,178642,418162.99
510335,201908,620,360,260,359282.95,259484.9,618767.85
510336,201908,52,39,13,38922,12974,51896
510337,201908,108,45,63,44910,62874,107784
510340,201908,16987,8050,8937,8044161.38,8945380.92,16989542.30
510343,201908,63,44,19,43912,18962,62874
510345,201908,165,111,54,110778,53892.4,164670.4
510350,201908,653,367,286,366270.9,285432.32,651703.22
510360,201908,195,124,71,123752.98,70863.88,194616.86
510370,201908,144,75,69,74850,69862.94,144712.94
510380,201908,88,63,25,62874,24950.98,87824.98
510385,201908,57,26,31,25948,30938.98,56886.98
510390,201908,108,48,60,47904,59880,107784
510395,201908,48,35,13,34930,12974,47904
510410,201908,692,463,229,462075.98,229541.96,691617.94
510420,201908,564,279,285,278461.56,286456.24,564917.80
510450,201908,52,28,24,27944,23952,51896
510452,201908,46,27,19,26946,18962,45908
510454,201908,52,24,28,23952,27944,51896
510455,201908,125,77,48,76846,47904,124750
510460,201908,172,90,82,89821.68,81836.98,171658.66
510480,201908,732,434,298,433139.12,298413.66,731552.78
510490,201908,348,183,165,183637.84,164672.9,348310.74
510500,201908,235,177,58,176646,57884,234530
510510,201908,806,473,333,472056.36,332393.88,804450.24
510515,201908,1167,629,538,627747.88,536924.98,1164672.86
510517,201908,257,108,149,107784,148702.98,256486.98
510520,201908,228,152,76,151698.94,75852.88,227551.82
510523,201908,95,71,24,70858,23952,94810
510525,201908,794,476,318,475052.91,317368.9,792421.81
510530,201908,17,12,5,11976,4990,16966
510550,201908,250,113,137,112774.98,136726,249500.98
510558,201908,282,138,144,137724.98,143712,281436.98
510560,201908,412,244,168,243512.4,167665.96,411178.36
510562,201908,658,471,187,472054,186626,658680
510590,201908,753,395,358,396206.98,357286.95,753493.93
510600,201908,246,136,110,135728,109781.96,245509.96
510610,201908,166,81,85,80838,84830,165668
510615,201908,191,78,113,78842,113772,192614
510617,201908,19,12,7,11976,6986,18962
510618,201908,119,57,62,56886,61876,118762
510619,201908,98,68,30,67864.98,30938.98,98803.96
510620,201908,172,94,78,93812,77844,171656
510621,201908,187,123,64,122754.98,63873.96,186628.94
510622,201908,482,307,175,306392.86,174651.96,481044.82
510623,201908,345,237,108,236527.96,107784,344311.96
510624,201908,89,44,45,43912.98,44910,88822.98
510625,201908,544,337,207,336340.7,207596.37,543937.07
510626,201908,112,71,41,70858.98,40918,111776.98
510627,201908,67,46,21,45908,20958,66866
510628,201908,150,89,61,88822.98,60878,149700.98
510629,201908,254,163,91,162674,90818,253492
510630,201908,450,233,217,232536.94,216569.34,449106.28
510631,201908,11,3,8,2994,7984,10978
510637,201908,349,211,138,210581.93,137734.78,348316.71
510642,201908,973,549,424,547904.94,423153.96,971058.90
510645,201908,0,,,,,0.0
510650,201908,1426,955,471,953103.16,470062.87,1423166.03
510665,201908,81,43,38,42917.88,37924,80841.88
510670,201908,61,35,26,34930,25948,60878
510675,201908,1140,720,420,718563.34,419160,1137723.34
510677,201908,345,177,168,176650.9,167669.88,344320.78
510680,201908,101,61,40,60880.94,39920.98,100801.92
510682,201908,207,104,103,103792,102794,206586
510685,201908,52,41,11,40918,10978,51896
510700,201908,600,349,251,348313.76,251503.85,599817.61
510704,201908,1111,598,513,596923.53,512140.68,1109064.21
510706,201908,127,67,60,67864,59880.98,127744.98
510710,201908,393,275,118,274454.88,117765.92,392220.80
510715,201908,63,46,17,45908,16966,62874
510718,201908,202,109,93,108784.94,92814,201598.94
510719,201908,36,17,19,16966,18962,35928
510720,201908,189,132,57,131736,56886,188622
510724,201908,88,35,53,34930,52894,87824
510726,201908,50,25,25,24950,24950.98,49900.98
510729,201908,70,33,37,32934,36926,69860
510730,201908,465,263,202,262475.96,201597.97,464073.93
510735,201908,107,45,62,44910,61876,106786
510740,201908,23,13,10,12974,9980,22954
510757,201908,17,13,4,12974,3992,16966
510760,201908,7049,3779,3270,3774559.79,3265663.67,7040223.46
510770,201908,673,319,354,318365.9,353302.74,671668.64
510774,201908,17,7,10,6986,9980,16966
510775,201908,109,84,25,83832,25948,109780
510776,201908,29,10,19,9980,18962,28942
510777,201908,184,82,102,81836,101796,183632
510779,201908,48,22,26,21956.98,25949.96,47906.94
510780,201908,287,163,124,162680.88,123757.85,286438.73
510785,201908,398,218,180,217564,179640,397204
510787,201908,191,93,98,92814.98,97805.97,190620.95
510788,201908,0,,,,,0.0
510790,201908,2430,1297,1133,1295453.9,1130820.24,2426274.14
510792,201908,1140,664,476,663677.84,475061.73,1138739.57
510794,201908,114,57,57,56886,56886.98,113772.98
510795,201908,2363,1398,965,1400199.75,967068.68,2367268.43
510800,201908,181,111,70,110778,69860,180638
510805,201908,168,115,53,115768,52894.98,168662.98
510810,201908,99,45,54,44915.88,53892,98807.88
510820,201908,244,120,124,119764.12,123754.51,243518.63
510830,201908,68,41,27,40918,27944.98,68862.98
510835,201908,12,9,3,8982,2994,11976
510840,201908,9003,4426,4577,4421338.74,4571060.03,8992398.77
510850,201908,210,83,127,82834,126746.98,209580.98
510860,201908,387,175,212,174655.88,211587.16,386243.04
510880,201908,63,48,15,47904.98,14970,62874.98
510885,201908,71,43,28,42914.98,27944,70858.98
510890,201908,66,39,27,38922,26946,65868
510895,201908,189,111,78,110778,77846.37,188624.37
520005,201908,50,30,20,29940,19960,49900
520010,201908,273,127,146,126746,145708.8,272454.8
520013,201908,699,443,256,443112.98,255488,698600.98
520015,201908,55,40,15,39920,14970,54890
520017,201908,90,52,38,51896.4,37924,89820.4
520020,201908,21,11,10,10978,9980,20958
520025,201908,2075,1140,935,1139716.8,934128,2073844.8
520030,201908,791,429,362,428143.58,363272,791415.58
520050,201908,73,49,24,48902,23952,72854
520055,201908,44,28,16,27944,15968,43912
520060,201908,178,120,58,119760,57884,177644
520080,201908,569,411,158,410178,157684,567862
520082,201908,19,14,5,13972,4990,18962
520085,201908,96,71,25,70858,24950,95808
520090,201908,94,64,30,63872,29940,93812
520110,201908,9076,4003,5073,4001987.5,5069847.48,9071834.98
520120,201908,13,8,5,7984,4990,12974
520130,201908,786,553,233,551894.98,232534.4,784429.38
520140,201908,11957,6774,5183,6764457.8,5180637.4,11945095.2
520145,201908,49,33,16,32934,15968,48902
520150,201908,177,139,38,138722,38922,177644
520160,201908,36,27,9,26946,8982,35928
520170,201908,242,146,96,145710.93,95810.92,241521.85
520180,201908,144,74,70,73852,69860,143712
520215,201908,211,139,72,138722,71856,210578
520235,201908,74,55,19,54890,18962,73852
520250,201908,129,79,50,78842,49900,128742
520260,201908,113,71,42,70858,41916,112774
520280,201908,48,33,15,32934,14970,47904
520310,201908,37,25,12,24950,11976,36926
520320,201908,169,111,58,110778,57884,168662
520330,201908,790,424,366,423154.94,365268.98,788423.92
520340,201908,341,202,139,201596,138722.98,340318.98
520350,201908,506,235,271,234530,272454,506984
520355,201908,90,54,36,53892,35928,89820
520357,201908,27,22,5,21956,4990,26946
520360,201908,1,1,0,998,0,998
520380,201908,141,74,67,73852,66866,140718
520390,201908,259,112,147,112774,146706,259480
520393,201908,14,10,4,9980,3992,13972
520396,201908,90,57,33,56886,32934.98,89820.98
520400,201908,210,121,89,120758,88822,209580
520410,201908,194,98,96,97804.98,95808.98,193613.96
520420,201908,20,14,6,13972,5988,19960
520425,201908,297,142,155,141716,155689.4,297405.4
520430,201908,458,241,217,240609.81,216567.88,457177.69
520440,201908,645,449,196,448102,195608,643710
520450,201908,1912,867,1045,865266.98,1042915.88,1908182.86
520455,201908,54,39,15,38922,14970,53892
520460,201908,35,20,15,19960,14970,34930
520465,201908,27,23,4,22954,3992,26946
520470,201908,424,271,153,270458,153692,424150
520480,201908,80,48,32,47904.98,31940.9,79845.88
520485,201908,118,42,76,41916,75848.4,117764.4
520490,201908,421,313,108,312374.4,107784,420158.4
520495,201908,167,98,69,97804,68862,166666
520500,201908,176,134,42,133732,41916,175648
520505,201908,179,101,78,100798,77844,178642
520510,201908,1751,869,882,868296.66,880318.28,1748614.94
520520,201908,38,30,8,29940,7984,37924
520530,201908,232,177,55,176646,54890,231536
520540,201908,550,384,166,384230,166666,550896
520545,201908,141,85,56,84830,55888,140718
520547,201908,46,26,20,25948,19960,45908
520549,201908,1163,571,592,569858.42,591864.8,1161723.22
520551,201908,286,153,133,152694,132734.4,285428.4
520552,201908,47,30,17,29940,16966,46906
520570,201908,16,10,6,9980,5988,15968
520580,201908,286,175,111,175648,110778,286426
520590,201908,156,95,61,94810.98,60878,155688.98
520620,201908,1155,543,612,541915.38,612772,1154687.38
520630,201908,38,24,14,23952,13972,37924
520640,201908,400,239,161,238522,160678,399200
520650,201908,63,39,24,38922,23952,62874
520660,201908,40,22,18,21956.98,17964,39920.98
520670,201908,34,30,4,29940,3992,33932
520680,201908,52,35,17,34930,17964,52894
520690,201908,35,12,23,11976,22955.96,34931.96
520710,201908,35,32,3,31936,2994,34930
520725,201908,184,124,60,123752,59880,183632
520735,201908,59,41,18,40918,17964,58882
520740,201908,411,205,206,204590,205588.98,410178.98
520750,201908,35,27,8,26946,7984,34930
520753,201908,58,39,19,38922,18962,57884
520760,201908,106,74,32,73852,31936,105788
520780,201908,295,220,75,219560,74910,294470
520790,201908,151,83,68,82834,67864,150698
520800,201908,3376,1830,1546,1826342.19,1545902.88,3372245.07
520810,201908,168,123,45,122754,44910,167664
520815,201908,5,4,1,3992,998,4990
520830,201908,148,104,44,103792,43912,147704
520840,201908,361,240,121,240518,120758,361276
520850,201908,104,67,37,66866.98,36926,103792.98
520860,201908,1722,1113,609,1110774.4,608780.4,1719554.8
520870,201908,31462,15341,16121,15317402.87,16113819.77,31431222.64
520880,201908,1135,617,518,615766.4,517962.4,1133728.8
520890,201908,789,478,311,478042.98,310378,788420.98
520910,201908,998,531,467,530936.88,466066,997002.88
520915,201908,101,79,22,78842,21956,100798
520920,201908,401,197,204,196606,203592,400198
520929,201908,18,17,1,16966,998,17964
520940,201908,74,49,25,48902,24950,73852
520945,201908,19,11,8,10978,7984,18962
520960,201908,49,31,18,30938,17964,48902
520970,201908,326,207,119,206586.98,118762,325348.98
520980,201908,93,69,24,68862,23952,92814
520990,201908,459,312,147,311376,146706,458082
520993,201908,128,61,67,60878,66866,127744
520995,201908,242,139,103,138722.66,102794.4,241517.06
521000,201908,1577,932,645,932132.6,646705.2,1578837.8
521010,201908,664,319,345,318364.94,344311.96,662676.90
521015,201908,17,11,6,10978,5988,16966
521020,201908,1439,1023,416,1021952.98,415170.36,1437123.34
521030,201908,48,33,15,32934,14970,47904
521040,201908,926,589,337,587822.9,337324.4,925147.3
521056,201908,43,31,12,30938,11976,42914
521060,201908,134,88,46,87824,45908,133732
521080,201908,448,340,108,339361.3,107784,447145.3
521090,201908,534,336,198,336192.93,197604,533796.93
521100,201908,277,210,67,209580.98,66866,276446.98
521120,201908,1058,750,308,748500.4,307384.98,1055885.38
521130,201908,360,259,101,258482,100800.36,359282.36
521140,201908,179,97,82,96806,81836,178642
521150,201908,2721,1184,1537,1181634.36,1535923.96,2717558.32
521160,201908,31,17,14,16966,13972,30938
521170,201908,196,113,83,112774,82834,195608
521180,201908,1161,742,419,741514.2,418162.9,1159677.1
521190,201908,2530,1080,1450,1077899.88,1448098.98,2525998.86
521200,201908,53,39,14,38922,13972,52894
521205,201908,11,8,3,7984,2994,10978
521210,201908,140,81,59,80838,58882,139720
521220,201908,811,566,245,564868,244510.9,809378.9
521225,201908,35,23,12,22954,11976,34930
521230,201908,107,73,34,72854,33932,106786
521250,201908,6163,3567,2596,3560868.81,2593826.24,6154695.05
521260,201908,23,13,10,12974,9980,22954
521270,201908,141,111,30,110778,29940,140718
521280,201908,433,265,168,264470,167664,432134
521290,201908,27,11,16,10978,15968,26946
521295,201908,97,65,32,64870,31936,96806
521300,201908,219,117,102,116767.96,102797.34,219565.30
521305,201908,37,26,11,25948,10978,36926
521308,201908,1065,801,264,800065.5,263472.98,1063538.48
521310,201908,1324,778,546,776448.9,544909.34,1321358.24
521340,201908,22,17,5,16966,4990,21956
521350,201908,127,95,32,94810,31936,126746
521370,201908,182,125,57,124750,56886,181636
521375,201908,173,95,78,94810,77844,172654
521377,201908,50,36,14,35928,13972,49900
521380,201908,1055,686,369,684629.92,369260,1053889.92
521385,201908,13,8,5,7984,4990,12974
521390,201908,100,81,19,80838,18962,99800
521400,201908,336,223,113,222554,112774,335328
521405,201908,149,81,68,80838,67864,148702
521410,201908,64,43,21,42914,20958,63872
521440,201908,195,143,52,142714,51896,194610
521450,201908,725,408,317,407184,316366,723550
521460,201908,1165,738,427,737522,426146,1163668
521470,201908,11,7,4,6986,3992,10978
521480,201908,43,30,13,29942.94,12976.86,42919.80
521483,201908,313,176,137,175648.4,136726,312374.4
521486,201908,289,188,101,187624,100798.6,288422.6
521487,201908,23,12,11,11976,10978,22954
521490,201908,25,14,11,13972,10978,24950
521500,201908,116,75,41,74850,40918,115768
521520,201908,42,29,13,28942,12974,41916
521523,201908,671,412,259,411176,258482,669658
521525,201908,49,33,16,32934,15968,48902
521530,201908,248,134,114,133732,114770,248502
521540,201908,28,15,13,14970,12974,27944
521550,201908,88,40,48,39923.34,47908.9,87832.24
521560,201908,795,558,237,556884.4,237524.7,794409.1
521565,201908,57,37,20,36926,19960,56886
521570,201908,511,343,168,342314.4,167664.9,509979.3
521580,201908,59,38,21,37924,20958,58882
521590,201908,36,19,17,18962,16966,35928
521600,201908,23,13,10,12974,9980,22954
521630,201908,245,129,116,128742,115770.46,244512.46
521640,201908,304,160,144,159680,143712,303392
521645,201908,28,15,13,14970,12974,27944
521680,201908,223,141,82,140718,81836.6,222554.6
521690,201908,2,2,0,1996,0,1996
521710,201908,1165,566,599,564868,597802.98,1162670.98
521720,201908,544,370,174,369260,174651.34,543911.34
521730,201908,635,314,321,313373.6,320358,633731.6
521740,201908,893,376,517,375248.98,516968.32,892217.30
521760,201908,1705,951,754,950096.59,753491.36,1703587.95
521770,201908,821,522,299,520956,298402,819358
521800,201908,2013,1283,730,1281444.38,730544.82,2011989.20
521805,201908,32,19,13,18962,12974,31936
521810,201908,85,54,31,53892,30938,84830
521830,201908,940,673,267,671654.13,267464.98,939119.11
521839,201908,84,54,30,53892,29940,83832
521850,201908,1086,581,505,580840.01,504006.48,1084846.49
521860,201908,351,224,127,223552,126746,350298
521870,201908,70,41,29,40918,28942,69860
521878,201908,37,18,19,17964,18962,36926
521880,201908,4667,2112,2555,2107778.16,2551892.26,4659670.42
521890,201908,579,415,164,414170,163672,577842
521900,201908,292,237,55,236526,54890,291416
521910,201908,149,105,44,104790,43912,148702
521920,201908,49,24,25,23952,24950,48902
521925,201908,40,24,16,23952,15968,39920
521930,201908,1145,643,502,642719.26,501008.16,1143727.42
521935,201908,35,26,9,25948,8982,34930
521940,201908,188,96,92,95808,91816,187624
521945,201908,15,13,2,12974,1996,14970
521950,201908,8,4,4,3992,3992,7984
521960,201908,73,55,18,54890,17964,72854
521970,201908,407,268,139,267464,139720,407184
521971,201908,86,43,43,42914,42914,85828
521973,201908,35,18,17,17964,16966,34930
521975,201908,1281,666,615,665667.01,614769.1,1280436.11
521980,201908,239,165,74,164670,73852,238522
521990,201908,77,55,22,54890,21956,76846
522000,201908,283,182,101,181636,100798,282434
522005,201908,19,11,8,10978,7984,18962
522010,201908,1138,647,491,646704.98,490018,1136722.98
522015,201908,59,37,22,36926.98,21956,58882.98
522020,201908,875,495,380,494010.1,379240.8,873250.9
522026,201908,26,17,9,16966,8982,25948
522028,201908,17,13,4,12974,3992,16966
522040,201908,768,311,457,312376.46,458085.92,770462.38
522045,201908,2292,1430,862,1428138.7,861276.86,2289415.56
522050,201908,158,78,80,77844,79840,157684
522060,201908,547,350,197,349300,196606,545906
522068,201908,122,82,40,81836,39920,121756
522070,201908,10,10,0,9980,0,9980
522100,201908,41,23,18,22954,17964,40918
522108,201908,41,32,9,31936,8982,40918
522119,201908,54,28,26,27944,25948,53892
522130,201908,80,35,45,34930.98,44912.94,79843.92
522140,201908,3896,2013,1883,2008976.3,1882230.56,3891206.86
522145,201908,47,34,13,33932,12974,46906
522150,201908,73,54,19,53892,18962,72854
522155,201908,53,35,18,34930.98,17964,52894.98
522157,201908,4,3,1,2994,998,3992
522160,201908,1723,1038,685,1037919.99,684628.98,1722548.97
522170,201908,404,274,130,273452,129740,403192
522180,201908,36,20,16,19960,15968,35928
522185,201908,1972,794,1178,792452.8,1175644.99,1968097.79
522190,201908,42,25,17,24950,16966,41916
522200,201908,295,180,115,179640,114770,294410
522205,201908,155,109,46,108782,45908,154690
522220,201908,156,113,43,112774,42914,155688
522230,201908,33,27,6,26946,5988,32934
530010,201908,54320,28180,26140,28137141.1,26112040.06,54249181.16
110001,201909,506,404,102,403192,101796,504988
110002,201909,2750,1708,1042,1706581.38,1042910.96,2749492.34
110003,201909,90,76,14,75848,13972,89820
110004,201909,1986,1297,689,1294408.36,688620.99,1983029.35
110005,201909,440,354,86,353292.4,85828,439120.4
110006,201909,441,345,96,344310.4,97804,442114.4
110007,201909,71,59,12,58882,11976,70858
110008,201909,240,137,103,136726,102794,239520
110009,201909,840,602,238,600796.42,238523.58,839320.00
110010,201909,1777,1092,685,1091812.98,685627.96,1777440.94
110011,201909,1832,1436,396,1433128,395208,1828336
110012,201909,4151,2439,1712,2435120.4,1712568.4,4147688.8
110013,201909,771,606,165,604788,165668,770456
110014,201909,372,321,51,321356.4,50898,372254.4
110015,201909,1412,1138,274,1137721.53,274450,1412171.53
110018,201909,1102,694,408,693610,409182.96,1102792.96
110020,201909,15503,9077,6426,9066860.36,6419184.75,15486045.11
110025,201909,625,465,160,465068.4,159680.98,624749.38
110026,201909,37,27,10,26946,9980,36926
110028,201909,1676,1221,455,1219558.12,454091.2,1673649.32
110029,201909,142,129,13,128742,12974,141716
110030,201909,2430,1650,780,1647540.28,781435.8,2428976.08
110032,201909,302,231,71,230538.37,70858.99,301397.36
110033,201909,664,492,172,491016.4,171656.98,662673.38
110034,201909,361,271,90,270458.17,89820,360278.17
110037,201909,99,86,13,85828,12974,98802
110040,201909,363,250,113,249500,112774,362274
110045,201909,919,638,281,636725.2,281436,918161.2
110050,201909,92,82,10,81836.4,9980,91816.4
110060,201909,78,44,34,44910,33932,78842
110070,201909,112,70,42,69860,41916.4,111776.4
110080,201909,423,250,173,249500,172654,422154
110090,201909,29,25,4,24950,3992,28942
110092,201909,100,53,47,52894,46906,99800
110094,201909,191,140,51,139720,50898,190618
110100,201909,30,25,5,24950,4990,29940
110110,201909,67,39,28,38922,27944,66866
110120,201909,73,62,11,61876,10978,72854
110130,201909,297,245,52,244510.4,51896,296406.4
110140,201909,240,164,76,163672,75848,239520
110143,201909,48,40,8,39920,7984,47904
110145,201909,24,19,5,18962,4990,23952
110146,201909,25,12,13,11976,12974,24950
110147,201909,36,27,9,26946,8982,35928
110148,201909,35,24,11,23952,10978,34930
110149,201909,302,214,88,213572,87824,301396
110150,201909,136,106,30,105788,29940,135728
110155,201909,7,6,1,5988,998,6986
110160,201909,65,54,11,53892,10978,64870
110170,201909,206,167,39,166666,38922,205588
110175,201909,62,47,15,46906,14970,61876
110180,201909,91,79,12,78842,11976,90818
120001,201909,152,104,48,103792,47905.98,151697.98
120005,201909,196,118,78,117764,77844,195608
120010,201909,1068,674,394,673651.67,393212.98,1066864.65
120013,201909,149,102,47,101796,46906,148702
120017,201909,93,57,36,56886,35928,92814
120020,201909,3581,2884,697,2883223.83,695606,3578829.83
120025,201909,544,311,233,310378.98,232534,542912.98
120030,201909,1073,910,163,909179,162674,1071853
120032,201909,46,40,6,39920,5988,45908
120033,201909,217,192,25,192614,24950,217564
120034,201909,167,123,44,122754,43912,166666
120035,201909,37,28,9,27944,8982,36926
120038,201909,386,248,138,247504,137724,385228
120039,201909,27,26,1,25948,998,26946
120040,201909,14078,9724,4354,9709899.44,4349304.41,14059203.85
120042,201909,48,42,6,41916,5988,47904
120043,201909,10,3,7,2994,6986,9980
120045,201909,557,362,195,361276.98,194610.98,555887.96
120050,201909,1283,986,297,984029.68,296406,1280435.68
120060,201909,1459,1200,259,1198598,261476,1460074
120070,201909,461,331,130,330339.2,129740,460079.2
120080,201909,169,103,66,102794,65868,168662
130002,201909,149,110,39,109780,38922,148702
130006,201909,73,43,30,42914,29940,72854
130008,201909,135,73,62,72854,61876,134730
130010,201909,141,80,61,79840,60878,140718
130014,201909,261,188,73,187624,72854,260478
130020,201909,89,49,40,48902,39920,88822
130030,201909,926,551,375,549898,374250,924148
130040,201909,346,175,171,174650,170658.36,345308.36
130050,201909,589,307,282,307384,281436,588820
130060,201909,870,588,282,587822,281436,869258
130063,201909,593,333,260,332334,259480,591814
130068,201909,185,121,64,120758,64870,185628
130070,201909,1309,896,413,895206,413172,1308378
130080,201909,684,446,238,446106,238522.98,684628.98
130083,201909,67,37,30,36926,29940,66866
130090,201909,349,177,172,178642,171656,350298
130100,201909,1138,495,643,495008,641714,1136722
130110,201909,739,304,435,303392,434130,737522
130115,201909,166,69,97,68862,96806,165668
130120,201909,1639,1057,582,1055884,581834,1637718
130130,201909,612,421,191,420158,190618,610776
130140,201909,1522,1175,347,1172650,346306,1518956
130150,201909,411,357,54,356286,53892,410178
130160,201909,456,261,195,261476,194610,456086
130165,201909,31,24,7,23952,6986,30938
130170,201909,969,683,286,681570.12,285428,966998.12
130180,201909,169,111,58,110778,57884,168662
130185,201909,2391,1148,1243,1147700,1240514.8,2388214.8
130190,201909,3507,2213,1294,2208575.28,1293408,3501983.28
130195,201909,277,222,55,221556,54890,276446
130200,201909,181,83,98,82834,97804,180638
130210,201909,77,40,37,39920,36926,76846
130220,201909,179,121,58,120758,57884,178642
130230,201909,325,204,121,204590,120758,325348
130240,201909,1384,884,500,882232.99,499000,1381232.99
130250,201909,4760,3061,1699,3057872.4,1697598,4755470.4
130255,201909,420,206,214,205588,213572,419160
130260,201909,55931,27117,28814,27082654.93,28780328.75,55862983.68
130270,201909,1559,1045,514,1042999.82,512972,1555971.82
130280,201909,125,72,53,71856,52894,124750
130290,201909,2115,1501,614,1498996,612772,2111768
130300,201909,447,315,132,314370,131736,446106
130310,201909,887,461,426,461076,426146,887222
130320,201909,508,275,233,274450,232534,506984
130330,201909,727,449,278,448102,277444,725546
130340,201909,3514,2069,1445,2066858.8,1443108.8,3509967.6
130350,201909,457,296,161,295408,160678,456086
130353,201909,876,377,499,376246,499000,875246
130356,201909,832,383,449,382234,448102,830336
130360,201909,97,72,25,71856,24950,96806
130370,201909,687,528,159,526944,158682,685626
130380,201909,703,534,169,533930,168662,702592
130390,201909,476,377,99,376246,98802,475048
130395,201909,168,40,128,39920,128742,168662
130400,201909,64,44,20,43912,19960,63872
130406,201909,2088,1270,818,1267460.4,817362.78,2084823.18
130410,201909,454,210,244,210578,244510,455088
130420,201909,3088,2506,582,2504980.9,582832,3087812.9
130423,201909,154,75,79,74850,78842,153692
130426,201909,149,84,65,83832,64870,148702
130430,201909,402,259,143,258482,143712,402194
130440,201909,209,70,139,69860,138722,208582
140002,201909,31,10,21,9980,20958,30938
140005,201909,196,122,74,121756,73852,195608
140010,201909,10370,6850,3520,6837309.08,3515957.24,10353266.32
140015,201909,130,57,73,56886,72854,129740
140017,201909,114,79,35,78842,34930,113772
140020,201909,465,313,152,312374,151696,464070
140023,201909,45,25,20,24950.54,19960,44910.54
140028,201909,18,11,7,10978,6986,17964
140030,201909,344,246,98,246506,97804,344310
140040,201909,60,43,17,42914,16966,59880
140045,201909,234,101,133,100798,132734,233532
140047,201909,612,416,196,415168.4,196606,611774.4
140050,201909,144,92,52,91816,51896,143712
140060,201909,41,29,12,28942,11976,40918
140070,201909,32,29,3,28942,2994,31936
150010,201909,4639,2907,1732,2903115.86,1729534.4,4632650.26
150013,201909,160,116,44,115768.98,43912,159680.98
150020,201909,1068,580,488,578840,488022,1066862
150030,201909,672,278,394,277444,393212,670656
150034,201909,193,127,66,126746,65868,192614
150040,201909,1403,834,569,833330,567862,1401192
150050,201909,610,359,251,358282,250498,608780
150060,201909,4736,3079,1657,3074755.68,1654684.98,4729440.66
150070,201909,317,143,174,143712,173652,317364
150080,201909,14273,7131,7142,7126727.31,7133716.31,14260443.62
150085,201909,403,260,143,260478,142714,403192
150090,201909,750,634,116,632732,115768,748500
150095,201909,344,219,125,218562,124750,343312
150100,201909,58,39,19,38922,18962,57884
150110,201909,175,90,85,89820,84830,174650
150120,201909,412,305,107,304390,106786.96,411176.96
150125,201909,51,19,32,19960,31936,51896
150130,201909,1977,1061,916,1058878,915166,1974044
150140,201909,53655,25042,28613,25006905.17,28574756.76,53581661.93
150145,201909,182,102,80,101796,79840,181636
150150,201909,2864,1311,1553,1311372,1549894.8,2861266.8
150157,201909,399,282,117,281436.8,116766,398202.8
150160,201909,126,97,29,96806,28942,125748
150170,201909,3570,2690,880,2684620,878240,3562860
150172,201909,329,224,105,223552,104790,328342
150175,201909,82,51,31,50898,30938,81836
150178,201909,776,519,257,517962.4,256488.88,774451.28
150180,201909,3099,1523,1576,1521950.5,1576840.4,3098790.9
150190,201909,331,214,117,213572,116766,330338
150195,201909,115,56,59,55888,58882,114770
150200,201909,193,93,100,92814,99800,192614
150210,201909,3099,2523,576,2519950,574849.95,3094799.95
150215,201909,550,360,190,359280,189620.4,548900.4
150220,201909,3657,2502,1155,2497995.52,1153689.4,3651684.92
150230,201909,1159,943,216,941114.45,215568,1156682.45
150240,201909,6005,3514,2491,3508971.35,2488015.97,5996987.32
150250,201909,32,15,17,14970,16966,31936
150260,201909,86,53,33,52894,32934,85828
150270,201909,2287,1492,795,1491012,795406.69,2286418.69
150275,201909,532,337,195,336326,195608,531934
150276,201909,105,47,58,46906,57884,104790
150277,201909,755,329,426,328342.98,426146,754488.98
150280,201909,325,208,117,207584,116766,324350
150285,201909,87,41,46,40918,45908,86826
150290,201909,971,594,377,592812,376246.4,969058.4
150293,201909,644,310,334,309380,334330,643710
150295,201909,479,219,260,218562,259480.4,478042.4
150300,201909,77,40,37,39920,36926,76846
150304,201909,166,108,58,107784,58882,166666
150307,201909,395,327,68,326346,67864,394210
150309,201909,579,419,160,418162.98,159683.6,577846.58
150310,201909,239,161,78,160678,77844,238522
150320,201909,1978,1385,593,1382230,592812,1975042
150330,201909,2011,1175,836,1172650,835326,2007976
150340,201909,198,133,65,132734,64870,197604
150345,201909,613,344,269,343312,269460,612772
150350,201909,399,318,81,317364,80838,398202
150360,201909,4570,2921,1649,2917155.49,1647698,4564853.49
150370,201909,798,558,240,556884.98,239522.9,796407.88
150375,201909,183,95,88,94810,87824,182634
150380,201909,1452,993,459,991014,459081.92,1450095.92
150390,201909,774,443,331,442114.99,330338,772452.99
150400,201909,105,87,18,86826,17964,104790
150405,201909,1220,799,421,797402.4,422154,1219556.4
150410,201909,122,81,41,80838,40918,121756
150420,201909,7366,4093,3273,4087985.66,3268490.96,7356476.62
150430,201909,556,373,183,372254,182634,554888
150440,201909,550,335,215,334330,214570,548900
150442,201909,2248,1209,1039,1208578.8,1036922,2245500.8
150445,201909,528,344,184,343312,183632,526944
150450,201909,238,116,122,115768,121756,237524
150460,201909,740,558,182,556884.96,181636,738520.96
150470,201909,1310,802,508,801394,508980,1310374
150475,201909,218,171,47,170658,46906,217564
150480,201909,1269,894,375,893210,374250,1267460
150490,201909,587,322,265,321356,264470,585826
150495,201909,330,235,95,234530,94810,329340
150497,201909,295,199,96,198602,96806,295408
150500,201909,205,133,72,132734,71856,204590
150503,201909,950,478,472,477044.4,472054.98,949099.38
150506,201909,960,642,318,640716.96,318362.96,959079.92
150510,201909,1261,710,551,708580.4,549898,1258478.4
150520,201909,271,184,87,183632,86826,270458
150530,201909,1655,916,739,914168.5,738520,1652688.5
150540,201909,231,165,66,164670,65868,230538
150543,201909,773,429,344,428142,344310,772452
150548,201909,475,336,139,336326,138722,475048
150549,201909,59,44,15,43912,14970,58882
150550,201909,2822,1487,1335,1485024.5,1332330.4,2817354.9
150553,201909,3287,1964,1323,1961072.16,1320354,3281426.16
150555,201909,142,76,66,75848,65868,141716
150560,201909,20,12,8,11976,7984,19960
150563,201909,90,45,45,44910,44910,89820
150565,201909,169,104,65,103792,64870,168662
150570,201909,405,271,134,271456,133732,405188
150580,201909,1572,715,857,713570,855286,1568856
150590,201909,800,521,279,520956,278442,799398
150600,201909,458,279,179,278442,178642,457084
150610,201909,137,118,19,117764,18962,136726
150611,201909,117,79,38,78842,37924,116766
150613,201909,3186,1964,1222,1962068,1225544.98,3187612.98
150616,201909,497,293,204,292414,204590,497004
150618,201909,1279,705,574,703590.98,573850,1277440.98
150619,201909,392,297,95,297404,94810,392214
150620,201909,1248,743,505,741514,503990,1245504
150630,201909,295,194,101,193612,100798,294410
150635,201909,476,203,273,202594,272454,475048
150640,201909,54,28,26,27944,25948,53892
150650,201909,2335,1380,955,1377490.4,953091.39,2330581.79
150655,201909,243,184,59,183632,58882,242514
150658,201909,94,52,42,51896,41916,93812
150660,201909,510,352,158,351296,157684,508980
150670,201909,1006,372,634,371256.98,632732.98,1003989.96
150680,201909,9718,5302,4416,5292396.8,4408167.96,9700564.76
150690,201909,16,9,7,8982,6986,15968
150700,201909,485,323,162,322354,161676,484030
150710,201909,278,159,119,158682,118762,277444
150715,201909,827,511,316,509978.98,315368,825346.98
150720,201909,406,317,89,316366,88822,405188
150730,201909,974,521,453,519958.98,453092,973050.98
150740,201909,222,153,69,152694,68862,221556
150745,201909,789,435,354,434130,353292,787422
150746,201909,56,33,23,32934,22954,55888
150747,201909,241,186,55,185628,54890,240518
150750,201909,137,80,57,79840,56886,136726
150760,201909,1771,1168,603,1165664.35,601794,1767458.35
150770,201909,388,210,178,209580,177644,387224
150775,201909,97,45,52,44910,51896,96806
150780,201909,184,104,80,103792,79840,183632
150790,201909,843,466,377,467064,377244,844308
150795,201909,1499,896,603,894208,601794,1496002
150796,201909,361,211,150,210578,149700,360278
150797,201909,306,164,142,163672,141716,305388
150800,201909,1438,855,583,854288,581834,1436122
150803,201909,563,466,97,465068,96806,561874
150805,201909,185,116,69,115768,68862.99,184630.99
150808,201909,1000,548,452,546904,451096,998000
150810,201909,3313,2316,997,2314363.41,998003.28,3312366.69
150812,201909,437,235,202,234530,201596,436126
150815,201909,985,640,345,638720,344310,983030
150820,201909,1537,944,593,944108,591814,1535922
150830,201909,751,549,202,548900,201596,750496
150835,201909,197,118,79,117764,78842,196606
150840,201909,1372,868,504,866264.2,502992,1369256.2
160005,201909,51,31,20,30938,19960,50898
160010,201909,184,118,66,117764,65868.99,183632.99
160015,201909,117,69,48,68862,47904,116766
160020,201909,127,73,54,72854,54890,127744
160021,201909,44,24,20,23952,19960,43912
160023,201909,124,80,44,79840,43912,123752
160025,201909,27,12,15,11976,14970,26946
160027,201909,1499,871,628,870256.5,626744,1497000.5
160030,201909,15578,8129,7449,8118739.76,7439101.81,15557841.57
160040,201909,286,165,121,164670,121756,286426
160050,201909,708,360,348,359280,347304,706584
160053,201909,313,180,133,179640.4,132734,312374.4
160055,201909,30,22,8,21956,7984,29940
160060,201909,6508,3466,3042,3459069.89,3035917.39,6494987.28
160070,201909,174,106,68,105788,67864,173652
160080,201909,93,47,46,46906,45908,92814
170025,201909,25,14,11,13972,10978,24950
170030,201909,223,182,41,181636.88,40918,222554.88
170035,201909,231,108,123,107784,122754,230538
170040,201909,180,140,40,140718,39920,180638
170070,201909,319,197,122,197604,121756,319360
170100,201909,358,260,98,259480,97804,357284
170105,201909,59,47,12,46906,11976,58882
170110,201909,106,67,39,66866,38922,105788
170130,201909,67,33,34,32934,33932.4,66866.4
170190,201909,96,62,34,61876,33932,95808
170200,201909,380,260,120,259480.98,119760,379240.98
170210,201909,6045,3234,2811,3227534.5,2807376.61,6034911.11
170215,201909,107,48,59,47904,58882,106786
170220,201909,1402,1039,363,1037920,362274,1400194
170230,201909,151,100,51,99800,50898,150698
170240,201909,528,354,174,353292.8,173652,526944.8
170255,201909,1107,898,209,896204,208582,1104786
170270,201909,40,28,12,27944,11976,39920
170290,201909,103,78,25,78842,24950,103792
170300,201909,89,59,30,58882,29940,88822
170305,201909,49,39,10,38922,9980,48902
170307,201909,62,48,14,47904,13972,61876
170310,201909,107,59,48,58882,47904,106786
170320,201909,24,18,6,17964,5988,23952
170330,201909,22,21,1,20958,998,21956
170360,201909,28,17,11,16966,10978,27944
170370,201909,121,64,57,63872,56886,120758
170380,201909,80,63,17,62874,16966,79840
170382,201909,43,38,5,37924,4990,42914
170384,201909,142,107,35,106786,34930,141716
170386,201909,62,26,36,25948,35928,61876
170388,201909,48,19,29,18962,28942,47904
170389,201909,25,20,5,19960,4990,24950
170390,201909,66,38,28,37924.98,27944.98,65869.96
170410,201909,32,23,9,22954,8982,31936
170460,201909,17,12,5,11976,4990,16966
170510,201909,33,27,6,26946,5988,32934
170550,201909,1548,910,638,908180,637722,1545902
170555,201909,113,81,32,80838,31936,112774
170560,201909,97,67,30,66866,29940,96806
170600,201909,35,17,18,16966,17964,34930
170610,201909,192,103,89,102794,88824.36,191618.36
170625,201909,35,20,15,19960,14970,34930
170650,201909,79,60,19,59880,18962,78842
170700,201909,569,435,134,434130.5,133732,567862.5
170710,201909,161,100,61,99800,60878.98,160678.98
170720,201909,88,70,18,69860,17964,87824
170730,201909,79,47,32,46906,31936,78842
170740,201909,82,62,20,61876,19960,81836
170755,201909,65,35,30,34930,30938,65868
170765,201909,138,72,66,71856.8,65868,137724.8
170770,201909,217,133,84,133732,84830,218562
170820,201909,585,392,193,391216,192614.8,583830.8
170825,201909,32,17,15,16966,14970,31936
170830,201909,84,67,17,66866,16966,83832
170900,201909,185,144,41,143712,40918,184630
170930,201909,890,481,409,480039.12,409180.4,889219.52
170950,201909,3081,1406,1675,1404187.38,1671652.05,3075839.43
170980,201909,18,10,8,9980,7984,17964
171050,201909,143,113,30,112774,29940,142714
171070,201909,37,31,6,30938,5988,36926
171090,201909,43,32,11,31936,10978,42914
171110,201909,22,14,8,13972,7984,21956
171150,201909,39,19,20,18962,19960,38922
171180,201909,23,13,10,12974,9980,22954
171190,201909,143,83,60,82834,59880,142714
171195,201909,63,52,11,51896,10978,62874
171200,201909,50,25,25,24950,24950,49900
171215,201909,5,3,2,2994,1996,4990
171240,201909,55,43,12,42914,11976,54890
171245,201909,56,50,6,49900,5988,55888
171250,201909,72,41,31,41916,30938,72854
171270,201909,14,10,4,9980,3992,13972
171280,201909,41,36,5,35928,4990,40918
171320,201909,987,585,402,584828.79,401196,986024.79
171330,201909,427,212,215,211576,214570,426146
171360,201909,83,61,22,60878,21956,82834
171370,201909,28,15,13,14970,12974,27944
171380,201909,133,111,22,110778,21956,132734
171395,201909,53,34,19,33932,18962,52894
171420,201909,285,187,98,186626,97804,284430
171430,201909,70,58,12,57884,11976,69860
171488,201909,176,99,77,98802,76846,175648
171500,201909,56,32,24,31936,23952,55888
171510,201909,68,45,23,44910,22954,67864
171515,201909,40,33,7,32934,6986.4,39920.4
171525,201909,29,27,2,26946,1996,28942
171550,201909,14,10,4,9980,3992,13972
171570,201909,53,27,26,26946,25948,52894
171575,201909,316,205,111,204590,110778,315368
171610,201909,1752,898,854,897207.88,854297.8,1751505.68
171620,201909,135,95,40,94810,39920,134730
171630,201909,58,31,27,30938,26946,57884
171650,201909,268,182,86,181636,85828,267464
171660,201909,269,148,121,147704,120758.4,268462.4
171665,201909,56,39,17,38922,16966,55888
171670,201909,427,252,175,251496.5,174650,426146.5
171700,201909,66,59,7,58882,6986,65868
171720,201909,26,10,16,9980,15968,25948
171750,201909,100,55,45,54890,45908,100798
171780,201909,77,61,16,61876,15968,77844
171790,201909,78,68,10,67864,9980,77844
171800,201909,36,28,8,27944,7984,35928
171820,201909,2066,1201,865,1198598.44,864269.78,2062868.22
171830,201909,35,28,7,27944,6986,34930
171840,201909,62,40,22,39920,21956,61876
171845,201909,30,18,12,17964,11976,29940
171850,201909,39,29,10,28942,9980,38922
171855,201909,79,63,16,62874,15968,78842
171865,201909,7,6,1,5988,998,6986
171870,201909,33,24,9,23952,8982,32934
171875,201909,80,56,24,55888,23952,79840
171880,201909,31,20,11,19960,10978,30938
171884,201909,50,27,23,26946,22954,49900
171886,201909,123,51,72,50898,71856,122754
171888,201909,28,22,6,21956,5988,27944
171889,201909,21,14,7,13972,6986,20958
171890,201909,56,46,10,45908,9980,55888
171900,201909,42,28,14,27944,13972,41916
172000,201909,43,35,8,34930,7984,42914
172010,201909,48,39,9,38922,8982,47904
172015,201909,28,19,9,18962.58,8982,27944.58
172020,201909,135,87,48,87824,47904,135728
172025,201909,33,21,12,20958,11976,32934
172030,201909,41,25,16,24950,15968.98,40918.98
172049,201909,81,52,29,51896,28942,80838
172065,201909,138,89,49,88822,48902,137724
172080,201909,101,67,34,66866,33932,100798
172085,201909,27,15,12,14970,11976,26946
172090,201909,415,326,89,325348.18,88822,414170.18
172093,201909,19,16,3,16966,2994,19960
172097,201909,19,11,8,10978,7984.4,18962.4
172100,201909,4909,2813,2096,2808373.88,2097797,4906170.88
172110,201909,80,50,30,49900,29940,79840
172120,201909,1656,1416,240,1416164.3,239520,1655684.3
172125,201909,4,4,0,3992,0,3992
172130,201909,18,13,5,12974,4990,17964
172208,201909,197,125,72,124750,71856,196606
172210,201909,382,187,195,186626,194610.4,381236.4
210005,201909,2948,1862,1086,1862268.75,1084830.8,2947099.55
210010,201909,169,92,77,91816,76846,168662
210015,201909,40,29,11,28942,10978,39920
210020,201909,347,192,155,191616,154690,346306
210030,201909,333,218,115,217564,114770.98,332334.98
210040,201909,139,109,30,108782,29940,138722
210043,201909,260,190,70,189620,69860,259480
210047,201909,551,312,239,312374,238522,550896
210050,201909,292,216,76,215568,75848,291416
210055,201909,44,34,10,33932,9980,43912
210060,201909,556,448,108,447104,107784,554888
210070,201909,417,319,98,318362,97804,416166
210080,201909,112,102,10,101796,9980,111776
210083,201909,306,149,157,148702.4,156686,305388.4
210087,201909,36,27,9,26946,8982,35928
210090,201909,451,324,127,323352,126746,450098
210095,201909,458,343,115,342314,114770,457084
210100,201909,693,542,151,540916,150698,691614
210110,201909,135,83,52,82834,51896,134730
210120,201909,5200,4023,1177,4016959.08,1176643.53,5193602.61
210125,201909,205,125,80,124750,79840,204590
210130,201909,493,278,215,277444,215568,493012
210135,201909,30,19,11,18962,10978,29940
210140,201909,4385,3467,918,3464058.6,918160,4382218.6
210150,201909,381,246,135,245508,134730,380238
210160,201909,3346,2827,519,2824341.53,519958,3344299.53
210170,201909,1161,931,230,929138,229540,1158678
210173,201909,128,110,18,109780,17964,127744
210177,201909,398,214,184,213572,183632,397204
210180,201909,30,16,14,15968,13972,29940
210190,201909,415,278,137,277444,136726,414170
210193,201909,2,1,1,998,998,1996
210197,201909,83,56,27,55888,26946,82834
210200,201909,635,517,118,516964,117764,634728
210203,201909,237,159,78,158682,77844,236526
210207,201909,374,299,75,298402,74850,373252
210210,201909,763,707,56,705586,55888,761474
210215,201909,76,67,9,66866,8982,75848
210220,201909,402,338,64,337324,63872,401196
210230,201909,306,241,65,240518,64870,305388
210232,201909,1407,944,463,943110,463072,1406182
210235,201909,161,127,34,126746,33932,160678
210237,201909,39,23,16,22954,15968,38922
210240,201909,91,76,15,75848,14970,90818
210250,201909,181,152,29,151696,28942,180638
210255,201909,352,265,87,264470,86826,351296
210260,201909,406,274,132,273452,131736,405188
210270,201909,659,437,222,436126,221556,657682
210275,201909,58,45,13,44910,12974,57884
210280,201909,1054,692,362,690649.74,362274,1052923.74
210290,201909,528,359,169,358282,168662,526944
210300,201909,5513,3434,2079,3429128.39,2077836.97,5506965.36
210310,201909,108,75,33,74850,32934,107784
210312,201909,117,81,36,80838,35928,116766
210315,201909,104,81,23,80838,22954,103792
210317,201909,124,93,31,92814,30938,123752
210320,201909,2336,1962,374,1959074,374250,2333324
210325,201909,135,95,40,94810,39920.4,134730.4
210330,201909,4720,2659,2061,2653682.7,2058874,4712556.7
210340,201909,1301,961,340,959078,339321.94,1298399.94
210350,201909,619,521,98,519958,97804,617762
210355,201909,145,116,29,115768,28942,144710
210360,201909,2398,1602,796,1598796.06,794408.4,2393204.46
210370,201909,1234,586,648,584828,647702,1232530
210375,201909,189,98,91,97804,90818,188622
210380,201909,704,537,167,535926,166666,702592
210390,201909,194,163,31,163672,30938,194610
210400,201909,402,346,56,345308,55888,401196
210405,201909,999,697,302,695606,303392,998998
210407,201909,52,42,10,41916,9980,51896
210408,201909,60,54,6,53892,5988,59880
210409,201909,333,288,45,287424,44910,332334
210410,201909,429,337,92,336326,91816,428142
210420,201909,198,162,36,162674,36926,199600
210430,201909,44,29,15,28942,14970,43912
210440,201909,342,222,120,221556,119760,341316
210450,201909,150,116,34,115768,33932,149700
210455,201909,231,126,105,125748.4,104790,230538.4
210460,201909,320,208,112,207584,111776,319360
210462,201909,64,54,10,53892,9980,63872
210465,201909,152,111,41,110778,40918,151696
210467,201909,533,389,144,388222,143712.98,531934.98
210470,201909,50,43,7,42914,6986,49900
210480,201909,1280,920,360,918160,359280.75,1277440.75
210490,201909,208,136,72,135728,71856,207584
210500,201909,538,315,223,314370,222554,536924
210510,201909,567,447,120,446106,119760,565866
210515,201909,392,233,159,232534,158682,391216
210520,201909,409,365,44,364270,43912,408182
210530,201909,9360,5048,4312,5041900.97,4314357.62,9356258.59
210535,201909,129,96,33,95808,32934,128742
210540,201909,1490,958,532,956084.2,530936,1487020.2
210542,201909,1199,622,577,621754,575846.8,1197600.8
210545,201909,17,16,1,15968,998,16966
210547,201909,131,114,17,113772,16966,130738
210550,201909,700,505,195,503990.44,194610,698600.44
210560,201909,173,149,24,148702,23952,172654
210565,201909,24,19,5,18962,4990,23952
210570,201909,1321,1064,257,1061872.04,256486,1318358.04
210580,201909,118,102,16,101796,15968,117764
210590,201909,749,609,140,607782,139720,747502
210592,201909,32,29,3,28942,2994,31936
210594,201909,108,91,17,90818,16966,107784
210596,201909,92,77,15,76846,14970,91816
210598,201909,128,94,34,93812,33932,127744
210600,201909,329,282,47,281436,46906,328342
210610,201909,255,238,17,237524,16966,254490
210620,201909,44,27,17,26946,16966,43912
210630,201909,71,68,3,67864,2994,70858
210632,201909,1033,707,326,705586,325348,1030934
210635,201909,22,19,3,18962,2994,21956
210637,201909,100,72,28,71856,27944,99800
210640,201909,582,511,71,509978,70858,580836
210650,201909,400,329,71,328342,70858,399200
210660,201909,399,298,101,297404,100798,398202
210663,201909,29,20,9,19960,8982,28942
210667,201909,105,36,69,35928,68862,104790
210670,201909,254,227,27,226546,26946,253492
210675,201909,545,302,243,301396,242514,543910
210680,201909,218,144,74,143712,74850,218562
210690,201909,631,510,121,508980,120758,629738
210700,201909,170,128,42,127744,41916,169660
210710,201909,264,160,104,159680,103792,263472
210720,201909,134,116,18,116766,17964,134730
210725,201909,68,60,8,60878,7984,68862
210730,201909,25,18,7,17964,6986,24950
210735,201909,395,276,119,275448,118762.4,394210.4
210740,201909,548,468,80,467064,79840,546904
210745,201909,155,115,40,114770,39920,154690
210750,201909,2386,1194,1192,1193608.5,1191612.4,2385220.9
210760,201909,258,196,62,195608,61876,257484
210770,201909,393,310,83,309380,82834,392214
210780,201909,427,316,111,315368,110778,426146
210790,201909,188,150,38,149700,37924,187624
210800,201909,170,130,40,129740,39920,169660
210805,201909,52,48,4,47904,3992,51896
210810,201909,475,380,95,379240,94810,474050
210820,201909,2180,1812,368,1809375.76,367264,2176639.76
210825,201909,162,90,72,89820,71856,161676
210830,201909,736,476,260,475048,259480,734528
210840,201909,206,142,64,141716,63872,205588
210845,201909,242,164,78,163672,77844,241516
210850,201909,790,526,264,524948,263472,788420
210860,201909,3836,2118,1718,2114762.9,1715562,3830324.9
210870,201909,465,362,103,361276,102794,464070
210880,201909,72,55,17,54890,16966,71856
210890,201909,321,272,49,271456,48902,320358
210900,201909,611,399,212,398202,211576,609778
210905,201909,65,31,34,30938,33932,64870
210910,201909,1976,1483,493,1480035.48,492014,1972049.48
210920,201909,184,63,121,62874,120758,183632
210923,201909,85,62,23,61876,22954,84830
210927,201909,419,190,229,189620,228542,418162
210930,201909,69,55,14,54890,13972,68862
210940,201909,87,68,19,67864,18962,86826
210945,201909,200,100,100,99800,99800,199600
210950,201909,529,395,134,394210,133732,527942
210955,201909,71,50,21,49900,20958,70858
210960,201909,2262,1083,1179,1080834,1176642,2257476
210970,201909,113,100,13,99800,12974,112774
210975,201909,84,77,7,76846,6986,83832
210980,201909,1100,523,577,522952,575846.4,1098798.4
210990,201909,4157,2680,1477,2675639,1474046,4149685
211000,201909,1335,1075,260,1072850.4,260478,1333328.4
211003,201909,887,611,276,609778,275448,885226
211010,201909,493,439,54,438122,53892,492014
211020,201909,1475,598,877,596804,876244,1473048
211023,201909,31,27,4,26946,3992,30938
211027,201909,77,56,21,55888,20958,76846
211030,201909,381,268,113,267464,112774,380238
211040,201909,307,252,55,251496.4,54890,306386.4
211050,201909,1157,766,391,764468,390218.4,1154686.4
211060,201909,655,564,91,562872.74,90818.6,653691.34
211065,201909,21,17,4,16966,3992,20958
211070,201909,910,751,159,750496.66,158682,909178.66
211080,201909,85,81,4,80838,3992,84830
211085,201909,55,29,26,29940,25948,55888
211090,201909,91,73,18,72854,17964,90818
211100,201909,489,398,91,397204,90818.4,488022.4
211102,201909,250,173,77,172654,76846,249500
211105,201909,224,157,67,156686,66866,223552
211107,201909,131,79,52,78842,51896,130738
211110,201909,825,538,287,536924,286426.98,823350.98
211120,201909,5513,2680,2833,2674642.2,2827335.16,5501977.36
211125,201909,31,23,8,22954,7984,30938
211130,201909,43096,19323,23773,19292348.56,23747418.33,43039766.89
211140,201909,412,355,57,354290.99,56886,411176.99
211150,201909,1263,820,443,818360,443113.39,1261473.39
211153,201909,164,99,65,98802,64870,163672
211157,201909,66,53,13,52894,12974,65868
211160,201909,705,602,103,600796,103792,704588
211163,201909,0,0,0,0,0,0
211167,201909,10,9,1,8982,998,9980
211170,201909,433,315,118,314370,117764,432134
211172,201909,119,82,37,81836,36926,118762
211174,201909,261,159,102,158682,101796,260478
211176,201909,502,371,131,370258.4,130738,500996.4
211178,201909,92,61,31,60878,30938,91816
211180,201909,207,166,41,165668,40918,206586
211190,201909,71,66,5,65868,4990,70858
211195,201909,32,24,8,23952,7984,31936
211200,201909,150,129,21,128742,20958,149700
211210,201909,458,325,133,324350,132734,457084
211220,201909,4038,2346,1692,2343307.33,1690614.19,4033921.52
211223,201909,93,90,3,89820,2994,92814
211227,201909,70,53,17,52894,16966,69860
211230,201909,759,623,136,621754,135728,757482
211240,201909,402,310,92,309380,91816,401196
211245,201909,189,90,99,90818,98802,189620
211250,201909,1585,1368,217,1366263.59,216566.94,1582830.53
211260,201909,824,670,154,668660,153692,822352
211270,201909,2008,1635,373,1631730.4,374250.8,2005981.2
211280,201909,1781,1137,644,1134726,642712,1777438
211285,201909,197,119,78,118762,77844,196606
211290,201909,677,469,208,468062,207584,675646
211300,201909,782,616,166,614768,165668,780436
211400,201909,1566,951,615,949098,613770,1562868
220005,201909,17,16,1,15968,998,16966
220010,201909,88,68,20,67864,19960,87824
220020,201909,677,544,133,542912,132734,675646
220025,201909,112,109,3,108782,2994,111776
220027,201909,41,34,7,33932,6986,40918
220030,201909,108,89,19,88822,18962,107784
220040,201909,1218,931,287,929138.6,286426,1215564.6
220045,201909,36,26,10,25948,9980,35928
220050,201909,680,573,107,571855.08,106786,678641.08
220060,201909,171,151,20,150698,19960,170658
220070,201909,108,99,9,98802,8982,107784
220080,201909,16,14,2,13972,1996,15968
220090,201909,33,27,6,26946,5988,32934
220095,201909,2,1,1,998,998,1996
220100,201909,21,17,4,16966,3992,20958
220105,201909,24,23,1,22954.4,998,23952.4
220110,201909,219,202,17,201596,16966,218562
220115,201909,39,38,1,37924,998,38922
220117,201909,23,21,2,20958,1996,22954
220120,201909,1482,1106,376,1103788,376246,1480034
220130,201909,29,29,0,28942,0,28942
220140,201909,100,80,20,79840,19960,99800
220150,201909,483,352,131,351296,130738,482034
220155,201909,5,5,0,4990,0,4990
220157,201909,18,15,3,14970,2994,17964
220160,201909,84,74,10,73852,9980,83832
220170,201909,32,32,0,31936,0,31936
220173,201909,7,7,0,6986,0,6986
220177,201909,6,6,0,5988,0,5988
220180,201909,68,68,0,67864,0,67864
220190,201909,1063,955,108,954088,107784,1061872
220191,201909,43,38,5,37924,4990,42914
220192,201909,73,70,3,69860,2994,72854
220194,201909,47,45,2,44910,1996,46906
220196,201909,93,78,15,77844,14970,92814
220198,201909,3,2,1,1996,998,2994
220200,201909,413,347,66,346306.5,66866,413172.5
220202,201909,38,34,4,33932,3992,37924
220205,201909,44,40,4,39920,3992,43912
220207,201909,12,12,0,11976,0,11976
220208,201909,78,43,35,42914,34930,77844
220209,201909,30,27,3,26946,2994,29940
220210,201909,19,16,3,15968,2994,18962
220211,201909,28,27,1,26946,998,27944
220213,201909,41,37,4,36926,3992.4,40918.4
220217,201909,39,31,8,30938,7984,38922
220220,201909,2123,1381,742,1378238,741515.1,2119753.1
220225,201909,8,4,4,3992,3992,7984
220230,201909,967,767,200,765466,199600,965066
220240,201909,159,147,12,146706,11976,158682
220245,201909,32,29,3,28942.99,2994,31936.99
220250,201909,118,106,12,105788,11976,117764
220253,201909,40,34,6,33932,5988,39920
220255,201909,29,26,3,25948,2994,28942
220260,201909,700,519,181,517962,181636,699598
220265,201909,9,7,2,6986,1996,8982
220270,201909,734,660,74,660676,73852,734528
220271,201909,39,32,7,31936,6986,38922
220272,201909,24,24,0,23952,0,23952
220273,201909,15,14,1,13972,998,14970
220275,201909,56,46,10,45908,9980,55888
220277,201909,13,11,2,10978,1996,12974
220280,201909,14,11,3,10978,2994,13972
220285,201909,44,42,2,41916,1996,43912
220290,201909,1456,1252,204,1250494.4,203592.9,1454087.3
220300,201909,46,44,2,43912,1996,45908
220310,201909,314,270,44,269460.99,45908,315368.99
220320,201909,446,412,34,411176.4,33932,445108.4
220323,201909,0,0,0,0,0,0
220325,201909,15,10,5,9980,4990,14970
220327,201909,12,11,1,10978,998,11976
220330,201909,221,160,61,159680,60878,220558
220335,201909,133,116,17,115768,16966,132734
220340,201909,36,22,14,21956,13972,35928
220342,201909,58,51,7,50898,6986,57884
220345,201909,80,74,6,73852,5988,79840
220350,201909,429,376,53,375248,52894,428142
220360,201909,45,33,12,32934,11976,44910
220370,201909,1194,987,207,985026,206586,1191612
220375,201909,20,18,2,17964,1996,19960
220380,201909,19,16,3,15968,2994,18962
220385,201909,15,13,2,12974,1996,14970
220390,201909,2315,1324,991,1321352.84,989018.7,2310371.54
220400,201909,31,28,3,28942,2994,31936
220410,201909,19,17,2,16966,1996,18962
220415,201909,12,11,1,10978,998,11976
220420,201909,126,105,21,104790,20958,125748
220430,201909,133,121,12,120758,11976,132734
220435,201909,21,14,7,13972,6986,20958
220440,201909,291,248,43,247504,42914,290418
220450,201909,330,171,159,170658,158682,329340
220455,201909,54,52,2,51896,1996,53892
220460,201909,19,19,0,18962,0,18962
220465,201909,101,65,36,64870,35928,100798
220470,201909,238,210,28,209580,27944,237524
220480,201909,74,66,8,65868,7984,73852
220490,201909,90,77,13,76846,12974,89820
220500,201909,101,88,13,87824,12974,100798
220510,201909,440,341,99,340318,98802,439120
220515,201909,21,19,2,18962,1996,20958
220520,201909,373,338,35,337324.34,34930,372254.34
220525,201909,13,9,4,8982,3992,12974
220527,201909,26,19,7,18962,6986,25948
220530,201909,31,12,19,11976,18962,30938
220535,201909,4,4,0,3992,0,3992
220540,201909,62,51,11,50898,10978,61876
220545,201909,47,33,14,32934,13972,46906
220550,201909,666,522,144,520956.96,143712,664668.96
220551,201909,16,12,4,11976,3992,15968
220552,201909,14,14,0,13972,0,13972
220553,201909,51,47,4,46906,3992,50898
220554,201909,10,8,2,7984,1996,9980
220555,201909,31,27,4,26946,3992,30938
220556,201909,51,47,4,46906,3992,50898
220557,201909,56,52,4,51896,3992,55888
220558,201909,8,3,5,2994,4990,7984
220559,201909,2,2,0,1996,0,1996
220560,201909,69,45,24,44910,23952,68862
220570,201909,769,473,296,472054.4,297404,769458.4
220580,201909,551,509,42,507982,41916,549898
220585,201909,6,5,1,4990,998,5988
220590,201909,12,12,0,11976,0,11976
220595,201909,61,46,15,45908,14970,60878
220600,201909,18,12,6,11976,5988,17964
220605,201909,22,20,2,19960,1996,21956
220610,201909,72,64,8,63872,7984,71856
220620,201909,556,454,102,453092,101796,554888
220630,201909,5,4,1,3992,998,4990
220635,201909,39,35,4,34930,3992,38922
220640,201909,101,82,19,81836,18962,100798
220650,201909,112,105,7,104790,6986,111776
220660,201909,46,37,9,36926,8982,45908
220665,201909,4,4,0,3992,0,3992
220667,201909,19,17,2,16966,1996,18962
220669,201909,29,26,3,25948,2994,28942
220670,201909,64,53,11,52894,10978,63872
220672,201909,64,45,19,44910,18962,63872
220675,201909,38,29,9,28942,8982,37924
220680,201909,39,33,6,32934,5988,38922
220690,201909,45,43,2,42914,1996,44910
220695,201909,43,20,23,19960,22954,42914
220700,201909,1711,1327,384,1324346,383232,1707578
220710,201909,4,3,1,2994,998,3992
220720,201909,110,89,21,88822,20958,109780
220730,201909,15,15,0,14970,0,14970
220735,201909,3,1,2,998,1996,2994
220740,201909,49,45,4,44910,3992,48902
220750,201909,112,95,17,94810,16966,111776
220755,201909,14,14,0,13972,0,13972
220760,201909,63,60,3,59880,2994,62874
220770,201909,5641,3026,2615,3020948.26,2610771.32,5631719.58
220775,201909,16,9,7,8982,6986,15968
220777,201909,17,16,1,15968,998,16966
220779,201909,0,0,0,0,0,0
220780,201909,881,753,128,751494,127744.4,879238.4
220785,201909,4,1,3,998,2994,3992
220790,201909,1067,858,209,856284.82,208582,1064866.82
220793,201909,6,6,0,5988,0,5988
220795,201909,15,14,1,13972,998,14970
220800,201909,3998,3079,919,3075839.54,917162.99,3993002.53
220810,201909,66,58,8,57884.4,7984,65868.4
220820,201909,245,224,21,223552,20958,244510
220830,201909,1218,1057,161,1054886,161676,1216562
220840,201909,2425,1699,726,1696603.33,724548.78,2421152.11
220850,201909,55,47,8,46906,7984,54890
220855,201909,9,6,3,5988,2994,8982
220860,201909,14,12,2,11976,1996,13972
220865,201909,32,30,2,29940,1996,31936
220870,201909,73,66,7,65868,6986,72854
220880,201909,318,252,66,252494,65868.56,318362.56
220885,201909,36,33,3,32934,2994,35928
220887,201909,13,13,0,12974,0,12974
220890,201909,100,88,12,87824,11976,99800
220900,201909,19,12,7,11976,6986,18962
220910,201909,53,44,9,43912,8982,52894
220915,201909,10,9,1,8982,998,9980
220920,201909,49,45,4,44910,3992,48902
220930,201909,42,41,1,40918,998,41916
220935,201909,16,16,0,15968,0,15968
220937,201909,36,35,1,34930,998,35928
220940,201909,57,52,5,51896,4990,56886
220945,201909,0,0,0,0,0,0
220950,201909,46,41,5,40918,4990,45908
220955,201909,23,21,2,20958,1996,22954
220960,201909,7,7,0,6986,0,6986
220965,201909,36,33,3,32934,2994,35928
220970,201909,57,47,10,46906,9980,56886
220975,201909,12,9,3,8982,2994,11976
220980,201909,31,29,2,28942,1996,30938
220985,201909,66,58,8,57884,7984,65868
220987,201909,32,30,2,29940,1996,31936
220990,201909,18,17,1,16966,998,17964
220995,201909,19,15,4,14970,3992,18962
220997,201909,59,49,10,48902,9980,58882
221000,201909,1169,1056,113,1053888,112774,1166662
221005,201909,55,47,8,46906,7984,54890
221010,201909,17,13,4,12974,3992,16966
221020,201909,43,41,2,40918,1996,42914
221030,201909,32,26,6,25948,5988,31936
221035,201909,24,24,0,23952,0,23952
221037,201909,12,8,4,7984,3992,11976
221038,201909,27,24,3,23952,2994,26946
221039,201909,23,23,0,22954,0,22954
221040,201909,252,219,33,218562,33932,252494
221050,201909,232,201,31,200598,30938,231536
221060,201909,1842,1625,217,1621750,216566,1838316
221062,201909,33,33,0,32934,0,32934
221063,201909,14,10,4,9980,3992,13972
221065,201909,54,46,8,45908,7984,53892
221070,201909,139,121,18,120758,17964,138722
221080,201909,379,332,47,332334,46906,379240
221090,201909,29,28,1,27944,998,28942
221093,201909,52,35,17,34930,16966,51896
221095,201909,9,9,0,8982,0,8982
221097,201909,16,13,3,12974,2994,15968
221100,201909,25103,14882,10221,14857236,10208543.2,25065779.2
221110,201909,1075,806,269,804388,268462,1072850
221120,201909,530,397,133,396206.4,132734,528940.4
221130,201909,969,796,173,795406,172654,968060
221135,201909,35,32,3,31936,2994,34930
221140,201909,43,37,6,36926,5988,42914
221150,201909,13,10,3,9980,2994,12974
221160,201909,13,13,0,12974,0,12974
221170,201909,15,15,0,14970,0,14970
230010,201909,163,150,13,149700,12974,162674
230015,201909,125,102,23,101796,22954,124750
230020,201909,1628,1379,249,1377240.4,248509.76,1625750.16
230030,201909,1679,1209,470,1208579.78,469060,1677639.78
230040,201909,217,188,29,187624.4,28942,216566.4
230050,201909,224,165,59,164670,58882,223552
230060,201909,159,131,28,130738,27944,158682
230070,201909,297,265,32,264470,31936,296406
230075,201909,849,744,105,743510.8,106786,850296.8
230080,201909,196,169,27,168662,26946,195608
230090,201909,116,84,32,83832,31936,115768
230100,201909,2048,1219,829,1216566.56,828342.84,2044909.40
230110,201909,2794,1832,962,1829334.8,962072.94,2791407.74
230120,201909,961,771,190,769460.48,189620,959080.48
230125,201909,148,125,23,124750,22954,147704
230130,201909,475,428,47,427144,47904,475048
230140,201909,213,184,29,183632,28942,212574
230150,201909,152,116,36,115768,35928,151696
230160,201909,935,805,130,803390,129740,933130
230170,201909,600,541,59,540917,58882,599799
230180,201909,75,70,5,69860,4990,74850
230185,201909,404,350,54,349300,53892,403192
230190,201909,2315,1855,460,1851292.14,459080,2310372.14
230195,201909,492,428,64,427144,63872,491016
230200,201909,386,334,52,333332,52894,386226
230205,201909,398,261,137,260478,136726,397204
230210,201909,1303,1037,266,1035926.22,265468.94,1301395.16
230220,201909,1534,1045,489,1042910,488024.82,1530934.82
230230,201909,909,789,120,787422,119760,907182
230240,201909,1684,1458,226,1456332.86,226547.14,1682880.00
230250,201909,1797,1484,313,1481033.58,313372,1794405.58
230260,201909,3102,1939,1163,1937118.96,1161672,3098790.96
230270,201909,1365,1105,260,1104788.17,262474,1367262.17
230280,201909,2708,2036,672,2031928,670656.4,2702584.4
230290,201909,414,368,46,367266.69,45908,413174.69
230300,201909,508,380,128,379240,127744,506984
230310,201909,415,316,99,316366,98802,415168
230320,201909,941,805,136,803391.4,135728,939119.4
230330,201909,304,244,60,243512,59880.6,303392.6
230340,201909,444,363,81,362274.6,80838,443112.6
230350,201909,3083,1973,1110,1970055.46,1109776,3079831.46
230360,201909,279,222,57,221556,56886,278442
230365,201909,139,113,26,112774,26946,139720
230370,201909,9824,4880,4944,4871316.33,4936200.38,9807516.71
230380,201909,476,409,67,408183.36,66866.2,475049.56
230390,201909,527,294,233,293412,232534,525946
230393,201909,252,213,39,212574,38922,251496
230395,201909,355,285,70,284430.48,69860,354290.48
230400,201909,607,484,123,483032,122754,605786
230410,201909,2664,1671,993,1667659.09,991015.94,2658675.03
230420,201909,6266,4162,2104,4157672.8,2103786.56,6261459.36
230423,201909,321,281,40,280438,39920,320358
230425,201909,393,325,68,324350.74,67864,392214.74
230426,201909,122,99,23,98802,22954,121756
230427,201909,79,76,3,75848,2994,78842
230428,201909,1454,746,708,745506.96,706587.76,1452094.72
230430,201909,458,378,80,377244.99,79840,457084.99
230435,201909,869,619,250,618760,249500.98,868260.98
230440,201909,85859,38610,47249,38553981.56,47195889.75,85749871.31
230445,201909,298,209,89,208582,88822,297404
230450,201909,542,437,105,436126,104790,540916
230460,201909,59,49,10,48902,9980,58882
230465,201909,311,253,58,252494,57884,310378
230470,201909,1978,1565,413,1561870.94,412174.5,1974045.44
230480,201909,160,151,9,150698,8982,159680
230490,201909,297,238,59,237524,58882,296406
230495,201909,453,338,115,337324,114770,452094
230500,201909,996,743,253,741514,252494,994008
230510,201909,52,41,11,40918,10978,51896
230520,201909,385,302,83,301396.18,82834,384230.18
230523,201909,2241,1434,807,1432130.28,806385.34,2238515.62
230526,201909,278,234,44,233532,43912,277444
230530,201909,673,510,163,508980.94,164670,673650.94
230533,201909,198,189,9,188622,8982,197604
230535,201909,369,277,92,276446,91816,368262
230540,201909,1836,1620,216,1618756,216566,1835322
230550,201909,3771,2435,1336,2431130.92,1334326.94,3765457.86
230560,201909,571,437,134,438122.8,133732.94,571855.74
230565,201909,213,157,56,156686,55888,212574
230570,201909,293,258,35,257484,34930,292414
230580,201909,1138,845,293,843311.9,292414,1135725.9
230590,201909,983,770,213,768460.5,212574,981034.5
230600,201909,246,226,20,225548,19960,245508
230610,201909,350,280,70,279440.6,69860,349300.6
230620,201909,178,149,29,148702.4,28942,177644.4
230625,201909,728,527,201,526945.44,200598.94,727544.38
230630,201909,1318,1041,277,1039916,276446,1316362
230640,201909,3698,3203,495,3198591,494014.93,3692605.93
230650,201909,434,379,55,378243.91,54890,433133.91
230655,201909,664,578,86,578842.51,85831.89,664674.40
230660,201909,360,306,54,305388,53892,359280
230670,201909,431,378,53,377244,52894,430138
230680,201909,199,181,18,181636,17964,199600
230690,201909,895,774,121,774448,120758,895206
230700,201909,784,663,121,662672.94,121756.94,784429.88
230710,201909,718,682,36,681634.6,35928,717562.6
230720,201909,152,134,18,133732,17964,151696
230725,201909,264,213,51,212574,50898.98,263472.98
230730,201909,12047,6574,5473,6565844.79,5469045.29,12034890.08
230740,201909,669,542,127,541914.4,126746,668660.4
230750,201909,824,703,121,701594.6,120758,822352.6
230760,201909,1402,1211,191,1210574,191616,1402190
230763,201909,322,270,52,269460,51896,321356
230765,201909,7186,3388,3798,3387255.74,3790453.93,7177709.67
230770,201909,4965,2558,2407,2552890.6,2403190.08,4956080.68
230780,201909,700,617,83,615766.4,82834,698600.4
230790,201909,252,209,43,208582,42914,251496
230800,201909,1134,834,300,832332,299400,1131732
230810,201909,1347,1197,150,1194606,149700,1344306
230820,201909,351,248,103,247504.4,102794,350298.4
230830,201909,965,828,137,826344,136726,963070
230835,201909,280,244,36,243512,35928,279440
230837,201909,167,142,25,141716,24950,166666
230840,201909,912,730,182,728540.4,181636.4,910176.8
230850,201909,1479,1290,189,1288418,189620,1478038
230860,201909,294,219,75,218562,74850,293412
230870,201909,1833,1570,263,1566860.96,262474,1829334.96
230880,201909,62,46,16,45908,15968,61876
230890,201909,550,509,41,507982,40918.97,548900.97
230900,201909,279,208,71,207584,71856.58,279440.58
230910,201909,216,173,43,172654,42914,215568
230920,201909,418,330,88,329340,87824,417164
230930,201909,954,683,271,681634.68,270458.94,952093.62
230940,201909,846,671,175,670656.98,174650.6,845307.58
230945,201909,498,415,83,414171.96,82834,497005.96
230950,201909,409,352,57,351296,56886,408182
230960,201909,2641,1804,837,1800396.76,835329.22,2635725.98
230970,201909,1754,987,767,985035.4,765478.32,1750513.72
230980,201909,207,173,34,172654,33932,206586
230990,201909,138,114,24,113772,23952,137724
231000,201909,209,190,19,189620,18962,208582
231010,201909,147,113,34,113772,33932,147704
231020,201909,1329,929,400,927157.28,400201.82,1327359.10
231025,201909,1035,783,252,782432.6,251496.4,1033929.0
231030,201909,1113,938,175,936124.99,174650,1110774.99
231040,201909,136,94,42,93812,41916,135728
231050,201909,970,866,104,864268,103792,968060
231060,201909,147,126,21,125748,20958,146706
231070,201909,1458,1039,419,1037922.6,418162.94,1456085.54
231080,201909,263,244,19,243512,18962,262474
231085,201909,581,360,221,359281.54,220558.96,579840.50
231090,201909,247,203,44,202594,43912,246506
231095,201909,170,134,36,133732,35928,169660
231100,201909,143,121,22,120758,21956,142714
231110,201909,365,312,53,311376,52894,364270
231120,201909,281,238,43,237524,42914,280438
231123,201909,145,139,6,138722,5988,144710
231126,201909,330,262,68,261476,67864,329340
231130,201909,4596,3595,1001,3589806.97,999001.25,4588808.22
231135,201909,213,184,29,183632,28942,212574
231140,201909,3078,2281,797,2276438,795406,3071844
231150,201909,361,344,17,343312,16966,360278
231160,201909,1182,948,234,946104,233533.88,1179637.88
231170,201909,534,368,166,367264,165668,532932
231180,201909,1688,1450,238,1448098,237524,1685622
231190,201909,208,178,30,177644,29940,207584
231195,201909,219,189,30,188622,29940,218562
231200,201909,821,672,149,671654,149700.6,821354.6
231210,201909,593,497,96,496006,95808,591814
231220,201909,1042,760,282,760476.9,282434.94,1042911.84
231230,201909,1433,1148,285,1145704,284430,1430134
231240,201909,1415,1032,383,1030934.94,383232.4,1414167.34
231250,201909,115,105,10,104790,9980,114770
231260,201909,274,180,94,179640,93812,273452
231270,201909,1018,842,176,840317.49,175648,1015965.49
231280,201909,73,56,17,55888,16966,72854
231290,201909,7475,4210,3265,4201580.4,3261465.8,7463046.2
231300,201909,620,575,45,574848,44910,619758
231310,201909,746,690,56,688620.74,55888,744508.74
231320,201909,583,444,139,444112,138722,582834
231325,201909,96,85,11,84830,10978,95808
231330,201909,2021,1574,447,1573099.53,447104,2020203.53
231335,201909,255,226,29,225548,28942,254490
231340,201909,1702,1255,447,1252490,446106,1698596
231350,201909,1274,1051,223,1049896,223552.8,1273448.8
231355,201909,430,375,55,374250,55888,430138
231360,201909,494,375,119,376446.81,119760,496206.81
231370,201909,88,74,14,73852,13972,87824
231375,201909,288,210,78,209580,77844,287424
231380,201909,476,387,89,387224,88822,476046
231390,201909,201,164,37,163672,36926,200598
231395,201909,724,458,266,457084,265468,722552
231400,201909,1113,920,193,918163.04,193614.34,1111777.38
231410,201909,1317,1079,238,1076842.2,237525.74,1314367.94
240010,201909,382,171,211,170658.43,210578.98,381237.41
240020,201909,2275,1812,463,1808377.5,463073.97,2271451.47
240030,201909,122,105,17,104790,16966,121756
240040,201909,31,31,0,30938,0,30938
240050,201909,531,455,76,454090,75848,529938
240060,201909,65,61,4,60878,3992,64870
240070,201909,210,165,45,164670,44910,209580
240080,201909,506,343,163,342314.99,162674.46,504989.45
240090,201909,106,95,11,94810,10978,105788
240100,201909,1496,1417,79,1414166.9,78842,1493008.9
240110,201909,1058,695,363,693611.98,363273.1,1056885.08
240120,201909,135,113,22,112774,21956,134730
240130,201909,284,264,20,263472,19960,283432
240140,201909,79,61,18,61876,17964,79840
240145,201909,716,640,76,638720,75848,714568
240150,201909,19,16,3,15968,2994,18962
240160,201909,40,36,4,35928,3992,39920
240165,201909,35,28,7,27944.5,6986,34930.5
240170,201909,94,70,24,69860,23952,93812
240180,201909,80,67,13,66866,12974,79840
240185,201909,45,40,5,39920,4990,44910
240190,201909,13,11,2,10978,1996,12974
240200,201909,3087,1728,1359,1725544.8,1359277.8,3084822.6
240210,201909,169,131,38,130738,37924,168662
240220,201909,1099,799,300,797402.7,299400,1096802.7
240230,201909,862,795,67,794408.77,66866,861274.77
240240,201909,77,54,23,53892,22954,76846
240250,201909,85,75,10,75848,9980,85828
240260,201909,1791,1339,452,1336322,452094.5,1788416.5
240270,201909,187,166,21,166666,20958,187624
240280,201909,42,32,10,31936,9980,41916
240290,201909,50,49,1,48902,998,49900
240300,201909,173,98,75,97804,74850,172654
240310,201909,2216,1235,981,1232532.67,983030.74,2215563.41
240320,201909,200,190,10,189620,9980,199600
240325,201909,4351,2657,1694,2652687.96,1692610.07,4345298.03
240330,201909,66,63,3,62874,2994,65868
240340,201909,62,39,23,38922,22954,61876
240350,201909,93,84,9,83832,8982,92814
240360,201909,499,336,163,335328,162674,498002
240370,201909,48,45,3,44910,2994,47904
240375,201909,70,40,30,39920,29940,69860
240380,201909,226,186,40,185628,39920.8,225548.8
240390,201909,13,11,2,10978,1996,12974
240400,201909,84,78,6,77844,5988,83832
240410,201909,11,7,4,6986,3992,10978
240420,201909,957,716,241,714568.2,240518,955086.2
240430,201909,266,250,16,249500,15968,265468
240440,201909,100,57,43,56886,42914,99800
240450,201909,224,153,71,152694.4,70858,223552.4
240460,201909,60,45,15,44910,14970,59880
240470,201909,241,210,31,209580,30938,240518
240480,201909,15,13,2,12974,1996,14970
240485,201909,79,67,12,66866,11976,78842
240490,201909,45,43,2,42914,1996,44910
240500,201909,82,64,18,63872,17964,81836
240510,201909,47,34,13,33932,12974,46906
240520,201909,120,115,5,114770,4990,119760
240530,201909,55,50,5,49900,4990,54890
240540,201909,77,66,11,65868,10978,76846
240550,201909,13,12,1,11976,998,12974
240560,201909,380,277,103,276446,102794,379240
240570,201909,461,288,173,287424.94,172654.4,460079.34
240580,201909,1269,1018,251,1015965.4,250498.99,1266464.39
240590,201909,30,28,2,27944,1996,29940
240600,201909,111,107,4,106786,3992,110778
240610,201909,507,426,81,427144.4,80838,507982.4
240615,201909,20,19,1,18962,998,19960
240620,201909,90,86,4,85828,3992,89820
240630,201909,36,34,2,33932,1996,35928
240640,201909,27,22,5,21956,4990,26946
240650,201909,238,201,37,200598,36926,237524
240660,201909,104,91,13,90818,12974,103792
240670,201909,299,180,119,179640.7,118762,298402.7
240680,201909,50,40,10,39920,9980,49900
240690,201909,49,46,3,45908,2994,48902
240700,201909,191,157,34,156686,33932,190618
240710,201909,1946,1228,718,1226543.3,716564,1943107.3
240720,201909,1079,801,278,799398,278442.2,1077840.2
240725,201909,64,60,4,59880,3992,63872
240730,201909,142,125,17,124750,16966,141716
240740,201909,234,199,35,198602,34930.74,233532.74
240750,201909,53,26,27,25948,27944,53892
240760,201909,46,41,5,40918,4990,45908
240770,201909,148,116,32,115768,31936,147704
240780,201909,684,561,123,559878,122754,682632
240790,201909,39,38,1,37924,998,38922
240800,201909,9200,6291,2909,6281423.88,2907177.68,9188601.56
240810,201909,20105,11053,9052,11035907.4,9042908.51,20078815.91
240820,201909,230,139,91,138722.19,90818,229540.19
240830,201909,1634,1340,294,1340314.7,294410,1634724.7
240840,201909,83,73,10,72854,9980,82834
240850,201909,88,78,10,77844,9980,87824
240860,201909,110,107,3,106786,2994,109780
240870,201909,59,51,8,50898,7984,58882
240880,201909,29,26,3,25948,2994,28942
240890,201909,1165,677,488,675646.76,488022.99,1163669.75
240895,201909,55,35,20,34930,19960,54890
240910,201909,156,141,15,140718,14970,155688
240920,201909,14,11,3,10978,2994,13972
240930,201909,415,372,43,371256,42914,414170
240933,201909,35,28,7,27944,6986,34930
240940,201909,2420,2142,278,2138715.14,278442,2417157.14
240950,201909,50,46,4,45908,3992,49900
240960,201909,30,25,5,24950,4990,29940
240970,201909,112,81,31,80838,30938,111776
240980,201909,193,157,36,156686,35928,192614
240990,201909,125,83,42,82834,41916,124750
241000,201909,65,61,4,60878,3992,64870
241010,201909,61,47,14,46906,13972,60878
241020,201909,115,106,9,105788,8982,114770
241025,201909,8,3,5,2994,4990,7984
241030,201909,111,91,20,90818,19960,110778
241040,201909,41,31,10,30938,9980,40918
241050,201909,85,76,9,75848,8982,84830
241060,201909,30,25,5,24950,4990,29940
241070,201909,17,17,0,17964,0,17964
241080,201909,61,55,6,54890,5988,60878
241090,201909,49,40,9,39920,8982,48902
241100,201909,72,61,11,60878,10978,71856
241105,201909,5,1,4,998,3992,4990
241110,201909,47,44,3,43912,2994,46906
241120,201909,1460,1129,331,1126742,330338,1457080
241140,201909,221,184,37,183632.4,36926,220558.4
241142,201909,41,37,4,36926,3992,40918
241150,201909,1178,1041,137,1038918,137724,1176642
241160,201909,21,19,2,18962,1996,20958
241170,201909,42,38,4,37924,3992,41916
241180,201909,46,40,6,39920,5988,45908
241190,201909,37,36,1,35928,998,36926
241200,201909,3826,2044,1782,2040913.53,1783427.39,3824340.92
241210,201909,66,57,9,56886,8982,65868
241220,201909,1414,959,455,958080.71,454090.97,1412171.68
241230,201909,237,202,35,201596,34930,236526
241240,201909,55,43,12,42914,11976,54890
241250,201909,1147,1049,98,1046902.4,97804,1144706.4
241255,201909,51,40,11,39920,10978,50898
241260,201909,653,511,142,509978,141716,651694
241270,201909,49,35,14,34930,13972,48902
241280,201909,95,82,13,81836,12974,94810
241290,201909,113,87,26,86826,25948,112774
241300,201909,73,55,18,54890,17964,72854
241310,201909,52,38,14,37924.7,13972,51896.7
241320,201909,28,17,11,16966,10978,27944
241330,201909,60,56,4,55888,3992,59880
241335,201909,67,60,7,59880,6986,66866
241340,201909,183,136,47,135728,46906,182634
241350,201909,57,52,5,51896,4990,56886
241355,201909,48,42,6,41916,5988,47904
241360,201909,51,50,1,49900,998,50898
241370,201909,50,42,8,41916,7984,49900
241380,201909,39,35,4,34930,3992,38922
241390,201909,80,64,16,63872,15968,79840
241400,201909,213,174,39,173652,38922,212574
241410,201909,187,167,20,166666,19960,186626
241415,201909,103,84,19,83832,18962,102794
241420,201909,95,72,23,71889.26,22954.64,94843.90
241430,201909,28,25,3,24950,2994,27944
241440,201909,517,418,99,418162.97,98802,516964.97
241445,201909,36,34,2,33932,1996,35928
241450,201909,288,237,51,236526,50898,287424
241460,201909,143,130,13,129740.5,12974,142714.5
241470,201909,39,33,6,32934,5988,38922
241475,201909,60,57,3,56886,2994,59880
241480,201909,95,70,25,69860,24950,94810
241490,201909,10,9,1,8982,998,9980
241500,201909,47,36,11,35928,10978,46906
250010,201909,102,86,16,85828,15968,101796
250020,201909,33,30,3,29940,2994,32934
250030,201909,839,640,199,638720,199600.6,838320.6
250040,201909,360,297,63,296406,62874,359280
250050,201909,243,197,46,196606.99,45908,242514.99
250053,201909,59,45,14,44910,13972,58882
250057,201909,0,0,0,0,0,0
250060,201909,493,375,118,374250,118762,493012
250070,201909,714,571,143,569858.75,142714,712572.75
250073,201909,8,8,0,7984,0,7984
250077,201909,186,142,44,141716,43912,185628
250080,201909,417,326,91,325348.72,90818,416166.72
250090,201909,202,133,69,132734,68862,201596
250100,201909,513,424,89,423152,88822.2,511974.2
250110,201909,577,442,135,441116,134730,575846
250115,201909,21,7,14,6986,13972,20958
250120,201909,115,86,29,85828,28942,114770
250130,201909,569,467,102,467064,101796.6,568860.6
250135,201909,15,9,6,8982,5988,14970
250140,201909,83,75,8,74850,7984,82834
250150,201909,570,418,152,417164,151696,568860
250153,201909,8,7,1,6986,998,7984
250157,201909,31,24,7,23952,6986,30938
250160,201909,216,172,44,171656,43912,215568
250170,201909,60,41,19,40918,18962,59880
250180,201909,4069,2801,1268,2797397.36,1269460.15,4066857.51
250190,201909,851,562,289,560876,288422.5,849298.5
250200,201909,51,43,8,42914,7984,50898
250205,201909,23,20,3,19960,2994,22954
250210,201909,86,77,9,76846,8982,85828
250215,201909,62,55,7,54890,6986,61876
250220,201909,26,20,6,19960,5988,25948
250230,201909,78,72,6,71856.99,5988,77844.99
250240,201909,235,196,39,195608,38922,234530
250250,201909,396,344,52,343312,51896,395208
250260,201909,39,33,6,32934,5988,38922
250270,201909,66,51,15,50898,14970,65868
250280,201909,376,313,63,313372,62874,376246
250290,201909,89,83,6,82834,5988,88822
250300,201909,549,374,175,373252,175649.97,548901.97
250310,201909,48,44,4,43912,3992,47904
250320,201909,1927,1324,603,1321354.72,601795.38,1923150.10
250330,201909,93,81,12,80838,11976,92814
250340,201909,24,22,2,21956,1996,23952
250350,201909,154,105,49,104790,48902,153692
250355,201909,35,27,8,26946,7984,34930
250360,201909,198,162,36,162674,35928,198602
250370,201909,2384,1611,773,1610772,774448,2385220
250375,201909,7,3,4,2994,3992,6986
250380,201909,56,42,14,41916,13972,55888
250390,201909,43,35,8,34930,7984,42914
250400,201909,16290,8322,7968,8313331.9,7961051.14,16274383.04
250403,201909,337,273,64,272454,63872,336326
250407,201909,59,50,9,49900,8982,58882
250410,201909,30,26,4,25948,3992,29940
250415,201909,39,26,13,25948,12974,38922
250420,201909,45,38,7,37924,6986,44910
250430,201909,1472,1263,209,1260723.5,209580,1470303.5
250435,201909,18,14,4,13972,3992,17964
250440,201909,680,574,106,572852.6,105788,678640.6
250450,201909,80,67,13,66866,12974,79840
250460,201909,433,304,129,303392,128742,432134
250470,201909,91,66,25,66866,24950,91816
250480,201909,322,257,65,256486,64870,321356
250485,201909,1,1,0,998,0,998
250490,201909,217,185,32,184630,31936,216566
250500,201909,81,61,20,60878,19960,80838
250510,201909,730,579,151,577842,150698,728540
250520,201909,175,121,54,120758,53892,174650
250523,201909,112,94,18,93812,17964,111776
250527,201909,101,80,21,79840,20958,100798
250530,201909,8,4,4,3992,3992,7984
250535,201909,26,21,5,20958,4990,25948
250540,201909,128,100,28,99800,28942,128742
250550,201909,71,68,3,67864,2994,70858
250560,201909,44,32,12,31936,11976,43912
250570,201909,161,131,30,130738,29940,160678
250580,201909,112,88,24,87888,23952,111840
250590,201909,25,17,8,16966,7984,24950
250600,201909,1295,870,425,870257.04,426146,1296403.04
250610,201909,156,134,22,134730,21956,156686
250620,201909,22,18,4,17964,3992,21956
250625,201909,73,55,18,54890,17964,72854
250630,201909,3005,1938,1067,1934138.48,1064873.92,2999012.40
250640,201909,217,179,38,178642,37924,216566
250650,201909,27,19,8,18962,7984,26946
250660,201909,49,38,11,37924,11976,49900
250670,201909,63,43,20,42914,19960,62874
250680,201909,396,324,72,323352,71856,395208
250690,201909,1921,1340,581,1338322.15,582832,1921154.15
250700,201909,925,811,114,809378.5,113772,923150.5
250710,201909,424,332,92,331336,91816,423152
250720,201909,113,86,27,85828,26946,112774
250730,201909,374,315,59,314370,58882,373252
250740,201909,53,49,4,48902,3992,52894
250750,201909,21330,12958,8372,12945965.52,8378217.14,21324182.66
250760,201909,82,65,17,64870,16966,81836
250770,201909,352,233,119,232534.44,118762,351296.44
250780,201909,58,43,15,42914,14970,57884
250790,201909,463,302,161,302394,160678,463072
250800,201909,147,135,12,134730,11976,146706
250810,201909,78,59,19,58882,18962,77844
250820,201909,152,125,27,124750,26946,151696
250830,201909,426,292,134,291416.4,133732,425148.4
250840,201909,50,47,3,46906,2994,49900
250850,201909,53,43,10,42914,9980,52894
250855,201909,13,11,2,10978,1996,12974
250860,201909,203,141,62,140718,61876,202594
250870,201909,33,29,4,28942,3992,32934
250880,201909,85,63,22,62874,21956,84830
250890,201909,2716,2051,665,2046898,663670,2710568
250900,201909,39,33,6,32934,5988,38922
250905,201909,118,92,26,91816,25948,117764
250910,201909,1139,821,318,819358.99,318362,1137720.99
250915,201909,104,73,31,72854,30938,103792
250920,201909,140,104,36,103792,35928,139720
250930,201909,166,102,64,101796,63872,165668
250933,201909,1,1,0,998,0,998
250937,201909,9,8,1,7984,998,8982
250939,201909,35,26,9,25948,8982,34930
250940,201909,103,79,24,78842,23952,102794
250950,201909,70,47,23,46906,22954,69860
250960,201909,90,50,40,49900,39920,89820
250970,201909,1218,863,355,862272,355288,1217560
250980,201909,93,64,29,63872,28942,92814
250990,201909,170,132,38,131736,37924,169660
251000,201909,76,68,8,67864,7984,75848
251010,201909,103,79,24,78842.99,23952,102794.99
251020,201909,80,69,11,68862,10978,79840
251030,201909,43,34,9,33932,8982,42914
251040,201909,52,38,14,37924,13972,51896
251050,201909,23,21,2,20958,1996,22954
251060,201909,50,39,11,38922,10978,49900
251065,201909,4,4,0,3992,0,3992
251070,201909,22,19,3,18962.98,2994,21956.98
251080,201909,4954,2398,2556,2396220.26,2556880.63,4953100.89
251090,201909,192,163,29,162674,28942,191616
251100,201909,18,18,0,17964,0,17964
251110,201909,44,35,9,34930,8982,43912
251120,201909,1812,1110,702,1108780,700596.68,1809376.68
251130,201909,390,319,71,318362,70858,389220
251140,201909,534,353,181,352295.2,180638,532933.2
251150,201909,311,271,40,270458.98,39920,310378.98
251160,201909,95,80,15,79840.99,14970,94810.99
251170,201909,103,83,20,82834.99,19960,102794.99
251180,201909,291,180,111,179640.99,110778.99,290419.98
251190,201909,190,128,62,127744,62874,190618
251200,201909,263,214,49,213572,48902,262474
251203,201909,35,33,2,32934,1996,34930
251207,201909,92,75,17,74850,16966,91816
251210,201909,1470,1072,398,1070854,398202,1469056
251220,201909,49,38,11,37924,10978,48902
251230,201909,602,510,92,508980,91816,600796
251240,201909,100,71,29,70858,28942,99800
251250,201909,1377,984,393,983030.9,392214.7,1375245.6
251260,201909,11,6,5,5988,4990,10978
251270,201909,324,245,79,244510,78842.18,323352.18
251272,201909,66,59,7,58882,6986,65868
251274,201909,27,21,6,20958,5988,26946
251275,201909,30,18,12,17964,11976,29940
251276,201909,12,10,2,9980,1996,11976
251278,201909,10,8,2,7984,1996,9980
251280,201909,100,96,4,95808,3992,99800
251290,201909,732,549,183,550896,183632,734528
251300,201909,16,13,3,12974,2994,15968
251310,201909,374,265,109,264470.99,108782,373252.99
251315,201909,26,25,1,24950,998,25948
251320,201909,62,49,13,48902,12974,61876
251330,201909,81,71,10,70858,9980,80838
251335,201909,14,9,5,8982,4990,13972
251340,201909,714,422,292,421156,291416,712572
251350,201909,34,33,1,32934,998,33932
251360,201909,74,66,8,65868,7984,73852
251365,201909,15,15,0,14970,0,14970
251370,201909,5425,3704,1721,3701584.74,1719554.6,5421139.34
251380,201909,43,35,8,36926,7984,44910
251385,201909,3,3,0,2994,0,2994
251390,201909,746,580,166,578840.7,165668.4,744509.1
251392,201909,14,7,7,6986,6986,13972
251394,201909,9,9,0,8982,0,8982
251396,201909,11,7,4,6986,3992,10978
251398,201909,17,15,2,14970,1996,16966
251400,201909,39,35,4,34930,3992,38922
251410,201909,37,31,6,30938,5988,36926
251420,201909,102,75,27,74850,26946,101796
251430,201909,42,39,3,38922,2994,41916
251440,201909,34,20,14,19960,13972,33932
251445,201909,48,42,6,41916,5988,47904
251450,201909,399,351,48,350298.2,47904,398202.2
251455,201909,3,2,1,1996,998,2994
251460,201909,17,15,2,14970,1996,16966
251465,201909,5,2,3,1996,2994,4990
251470,201909,46,37,9,36926,8982,45908
251480,201909,24,21,3,20958,2994,23952
251490,201909,122,85,37,85828,36926.4,122754.4
251500,201909,122,100,22,99800,21956,121756
251510,201909,37,29,8,28942,7984,36926
251520,201909,25,25,0,24950,0,24950
251530,201909,4483,3174,1309,3168650.8,1308378,4477028.8
251540,201909,73,63,10,62874,9980,72854
251550,201909,403,311,92,310378,92814.9,403192.9
251560,201909,21,14,7,13972,6986,20958
251570,201909,20,19,1,18962,998,19960
251580,201909,125,102,23,101796,22954,124750
251590,201909,119,86,33,86017,32934,118951
251593,201909,24,14,10,13972,9980,23952
251597,201909,64,53,11,52894,10978,63872
251600,201909,1088,784,304,782439.71,303392.6,1085832.31
251610,201909,234,182,52,181636,52894,234530
251615,201909,5,5,0,4990,0,4990
251620,201909,4227,2797,1430,2795400.24,1431133.6,4226533.84
251630,201909,447,331,116,330338,115768.98,446106.98
251640,201909,142,102,40,101796,39920,141716
251650,201909,261,190,71,189620.7,70858,260478.7
251660,201909,187,167,20,166666,19960,186626
251670,201909,364,287,77,286426,78842,365268
251675,201909,5,5,0,4990,0,4990
251680,201909,95,86,9,85828,8982,94810
251690,201909,339,277,62,276446,61876,338322
251700,201909,284,247,37,246506,36926,283432
251710,201909,23,15,8,14970,7984,22954
251720,201909,26,17,9,16966,8982.4,25948.4
251740,201909,9,7,2,6986,1996,8982
260005,201909,3137,1781,1356,1777440.95,1354288.88,3131729.83
260010,201909,1565,1139,426,1136723.13,426146.64,1562869.77
260020,201909,418,368,50,367264,49900,417164
260030,201909,588,426,162,425148,163672,588820
260040,201909,816,508,308,506984,308382,815366
260050,201909,1145,832,313,830336,312374.8,1142710.8
260060,201909,385,352,33,351296,32934,384230
260070,201909,1377,862,515,860278.89,513970.69,1374249.58
260080,201909,725,569,156,567862,156686,724548
260090,201909,515,337,178,337325.96,181636,518961.96
260100,201909,230,163,67,162674,66866,229540
260105,201909,216,120,96,119760,96806,216566
260110,201909,2834,2095,739,2090811.78,738520.4,2829332.18
260120,201909,2844,1471,1373,1470055.62,1370254.7,2840310.32
260130,201909,163,114,49,113772,48902,162674
260140,201909,2146,1400,746,1399207.08,744508.98,2143716.06
260150,201909,217,145,72,144710,71856,216566
260160,201909,322,272,50,272454,50898,323352
260170,201909,3358,2047,1311,2043904.88,1308378.4,3352283.28
260180,201909,152,129,23,128742,22954,151696
260190,201909,2269,1585,684,1581830,682632,2264462
260200,201909,960,776,184,774448.63,183632.4,958081.03
260210,201909,1438,1031,407,1029936,406186.98,1436122.98
260220,201909,712,642,70,641714,69860,711574
260230,201909,1194,895,299,895206.94,298402,1193608.94
260240,201909,219,165,54,164670,53892,218562
260250,201909,90,67,23,66866,22954,89820
260260,201909,1014,723,291,723550,290418,1013968
260270,201909,415,334,81,333332,80838,414170
260280,201909,1323,926,397,925146.6,397204.4,1322351.0
260290,201909,6446,3507,2939,3501988.28,2941112.07,6443100.35
260300,201909,924,803,121,801394.6,120758.85,922153.45
260310,201909,519,407,112,407184,111776,518960
260320,201909,867,646,221,644708,220558,865266
260330,201909,51,38,13,37924,12974,50898
260340,201909,72,53,19,52894,19960,72854
260345,201909,5516,3081,2435,3074840.27,2435123.9,5509964.17
260350,201909,477,347,130,346306.4,129740.98,476047.38
260360,201909,276,145,131,144710,130738,275448
260370,201909,698,461,237,461076.5,236526.99,697603.49
260380,201909,600,439,161,438122,161676.66,599798.66
260390,201909,296,250,46,249500,45908,295408
260392,201909,103,87,16,86826,16966,103792
260400,201909,4089,2378,1711,2378235.79,1709574,4087809.79
260410,201909,14556,7695,6861,7685600.54,6861251.28,14546851.82
260415,201909,129,116,13,115768,12974,128742
260420,201909,1761,1073,688,1071853.81,691614,1763467.81
260430,201909,195,176,19,175649.25,18962,194611.25
260440,201909,208,152,56,151696.98,56886,208582.98
260450,201909,445,325,120,324351.2,119760,444111.2
260460,201909,818,437,381,436127.2,381236,817363.2
260470,201909,357,218,139,217564,138722.8,356286.8
260480,201909,222,143,79,142714,78842,221556
260490,201909,212,178,34,177644,33932,211576
260500,201909,1129,762,367,761474,366266,1127740
260510,201909,776,629,147,627742,148702,776444
260515,201909,244,219,25,218562,24950,243512
260520,201909,3236,1966,1270,1966060.99,1269456.78,3235517.77
260530,201909,799,656,143,654688,142714,797402
260540,201909,555,433,122,432134,122754,554888
260545,201909,11,9,2,8982,1996,10978
260550,201909,330,206,124,205588,123752,329340
260560,201909,533,401,132,401196.4,131736,532932.4
260570,201909,982,807,175,806384.4,174650,981034.4
260580,201909,256,226,30,225548,29940,255488
260590,201909,627,366,261,365268,261476,626744
260600,201909,7982,4299,3683,4294395.86,3683618,7978013.86
260610,201909,484,323,161,322354,160678,483032
260620,201909,3652,1939,1713,1935125.02,1712570.07,3647695.09
260630,201909,88,82,6,81836,5988,87824
260640,201909,3591,1981,1610,1977038.92,1611770.98,3588809.90
260650,201909,323,239,84,240518,83832,324350
260660,201909,539,366,173,365268,172654,537922
260670,201909,105,79,26,78842,25948,104790
260680,201909,3631,2067,1564,2064865.53,1562869.36,3627734.89
260690,201909,127,93,34,92814,33932,126746
260700,201909,313,208,105,207584,104790,312374
260710,201909,39,36,3,35928,2994,38922
260720,201909,2333,1396,937,1397201.6,937122,2334323.6
260730,201909,667,504,163,502992,162674,665666
260740,201909,61,57,4,56886,3992,60878
260750,201909,611,441,170,440118,169660,609778
260760,201909,628,339,289,338322.63,289420,627742.63
260765,201909,960,505,455,504988.99,454090,959078.99
260770,201909,220,165,55,164653,55888,220541
260775,201909,785,463,322,462075.3,322354.98,784430.28
260780,201909,269,175,94,174650,93812,268462
260790,201909,12276,6713,5563,6702578.3,5559863.41,12262441.71
260795,201909,172,116,56,115768,55888,171656
260800,201909,289,242,47,241516,46906,288422
260805,201909,172,114,58,113772,57884,171656
260810,201909,742,649,93,647702,92814,740516
260820,201909,297,192,105,192614.34,104790,297404.34
260825,201909,205,146,59,145708,58882,204590
260830,201909,282,178,104,177644,103792,281436
260840,201909,226,166,60,166666,59880,226546
260845,201909,177,124,53,123752,52894,176646
260850,201909,457,338,119,337324,118762,456086
260860,201909,255,192,63,191616,62874,254490
260870,201909,373,279,94,278442,93812,372254
260875,201909,730,521,209,520956,208582,729538
260880,201909,1586,1013,573,1010974.2,571854,1582828.2
260890,201909,2396,1686,710,1682629,711574.8,2394203.8
260900,201909,992,694,298,693610,298402,992012
260910,201909,259,206,53,205588,52894,258482
260915,201909,301,213,88,212574,87824,300398
260920,201909,179,97,82,96806,81836,178642
260930,201909,397,343,54,342316.91,53892.97,396209.88
260940,201909,2735,1497,1238,1495005.76,1235524.4,2730530.16
260950,201909,2034,1179,855,1177640.7,853290,2030930.7
260960,201909,13657,7120,6537,7114753.8,6536909.39,13651663.19
260970,201909,431,366,65,365268,64870,430138
260980,201909,194,173,21,172654,20958,193612
260990,201909,2594,2113,481,2110772.34,482034,2592806.34
261000,201909,4340,2586,1754,2582825.58,1752488.6,4335314.18
261010,201909,177,130,47,129740,46906,176646
261020,201909,605,454,151,453093.06,150698,603791.06
261030,201909,237,177,60,176646,59880,236526
261040,201909,367,321,46,320358,45908,366266
261050,201909,501,438,63,437124,62874,499998
261060,201909,1366,898,468,896204.5,467064,1363268.5
261070,201909,8625,4399,4226,4394218.73,4224583.81,8618802.54
261080,201909,376,290,86,289420,85828,375248
261090,201909,2233,1719,514,1716564.31,512972.47,2229536.78
261100,201909,1129,794,335,793411.3,335328,1128739.3
261110,201909,8538,5265,3273,5261459.66,3275440.01,8536899.67
261120,201909,264,224,40,223552,39920,263472
261130,201909,569,340,229,340318.6,228542.62,568861.22
261140,201909,184,120,64,119760,63872,183632
261150,201909,681,423,258,422154.18,258482,680636.18
261153,201909,70,66,4,65868,3992,69860
261160,201909,75900,38274,37626,38234439.41,37623635.88,75858075.29
261170,201909,468,353,115,352294,114770,467064
261180,201909,1807,1116,691,1114766,693610,1808376
261190,201909,601,426,175,425150.52,175648.98,600799.50
261200,201909,217,188,29,187624,28942,216566
261210,201909,34,28,6,27944,5988,33932
261220,201909,2682,1887,795,1884226.39,794408.97,2678635.36
261230,201909,345,259,86,258482,85828,344310
261240,201909,462,398,64,397204,63872,461076
261245,201909,236,194,42,193612,41916,235528
261247,201909,170,134,36,134730,35928,170658
261250,201909,2959,1503,1456,1502989.3,1459076,2962065.3
261255,201909,254,230,24,229540,23952,253492
261260,201909,866,751,115,750496.76,114770,865266.76
261270,201909,187,138,49,137724,48902,186626
261280,201909,175,145,30,144710,29940,174650
261290,201909,123,87,36,86826,35928,122754
261300,201909,1289,938,351,936124,350298,1286422
261310,201909,798,539,259,537922,258482,796404
261320,201909,554,387,167,386226,166666,552892
261330,201909,1001,763,238,762472,238522.63,1000994.63
261340,201909,291,166,125,165668,124750,290418
261350,201909,831,595,236,594808,236526,831334
261360,201909,1267,828,439,827342,440118,1267460
261370,201909,4808,2950,1858,2946099.56,1855283.78,4801383.34
261380,201909,557,418,139,417164.66,138722.4,555887.06
261390,201909,3577,2395,1182,2391208.4,1179636.7,3570845.1
261400,201909,278,253,25,253492,24950,278442
261410,201909,1101,747,354,746504,354290,1100794
261420,201909,870,549,321,549900.47,320358,870258.47
261430,201909,331,296,35,295408,34930,330338
261440,201909,125,115,10,114770,9980,124750
261450,201909,2532,2071,461,2068855.84,464070.4,2532926.24
261460,201909,733,591,142,589818.74,141716,731534.74
261470,201909,243,191,52,190618.1,51896,242514.1
261480,201909,417,328,89,327344.6,88778.99,416123.59
261485,201909,343,211,132,211576,131736,343312
261500,201909,600,410,190,409180,190618,599798
261510,201909,50,34,16,33932,15968,49900
261520,201909,112,98,14,97804,13972,111776
261530,201909,4116,2607,1509,2602785.19,1505983.84,4108769.03
261540,201909,1243,759,484,758480,483032,1241512
261550,201909,273,136,137,135728.4,137724,273452.4
261560,201909,827,549,278,548900.7,277445.38,826346.08
261570,201909,395,311,84,310378,83832,394210
261580,201909,375,296,79,295408.96,79840,375248.96
261590,201909,196,159,37,158682,36926,195608
261600,201909,294,235,59,235528,58882,294410
261610,201909,99,84,15,83832,15968,99800
261618,201909,75,60,15,60878,14970,75848
261620,201909,198,119,79,118762,79840,198602
261630,201909,569,443,126,442114,125748,567862
261640,201909,6339,3384,2955,3380229.35,2957074.9,6337304.25
261650,201909,492,314,178,313372,177644,491016
270010,201909,529,471,58,471056,57884,528940
270020,201909,290,230,60,229540.99,60878,290418.99
270030,201909,8997,5862,3135,5853329.06,3131759.48,8985088.54
270040,201909,1994,1254,740,1251492,739518,1991010
270050,201909,159,120,39,119760,38922,158682
270060,201909,113,63,50,62874,49900,112774
270070,201909,882,645,237,643710,237524.98,881234.98
270080,201909,37,31,6,30938,5988,36926
270090,201909,17,13,4,12974,3992,16966
270100,201909,1206,807,399,805386.98,399200,1204586.98
270110,201909,134,102,32,101796,31936,133732
270120,201909,222,181,41,180638,40918,221556
270130,201909,232,159,73,158682,72854,231536
270135,201909,104,63,41,62874,41916,104790
270140,201909,1354,837,517,835362.61,515966.98,1351329.59
270150,201909,262,206,56,205588,55888,261476
270160,201909,518,398,120,397204,119760,516964
270170,201909,779,507,272,505986,271456,777442
270180,201909,73,56,17,55888,16966,72854
270190,201909,92,81,11,80838,10978,91816
270200,201909,102,91,11,90818,10978,101796
270210,201909,491,275,216,274450,215568,490018
270220,201909,178,142,36,141716,35928,177644
270230,201909,2107,1295,812,1295406.64,810377.94,2105784.58
270235,201909,706,544,162,543914.82,161679.9,705594.72
270240,201909,3110,2457,653,2452088.37,654690.54,3106778.91
270250,201909,159,114,45,114770,44910,159680
270255,201909,207,177,30,176646,29940,206586
270260,201909,358,292,66,292414,65868,358282
270270,201909,99,43,56,42914.98,55888,98802.98
270280,201909,256,148,108,147704,107784,255488
270290,201909,1166,895,271,893210,271456.98,1164666.98
270300,201909,286,194,92,193612,91816,285428
270310,201909,883,723,160,721558.88,160679.96,882238.84
270320,201909,845,727,118,725547.61,117764,843311.61
270330,201909,277,236,41,235528,40918,276446
270340,201909,59,47,12,46906,11976,58882
270350,201909,94,48,46,47904,45908,93812
270360,201909,60,36,24,35928,24950,60878
270370,201909,56,45,11,44910,10978,55888
270375,201909,72,46,26,45908,25948,71856
270380,201909,998,605,393,604788,393212,998000
270390,201909,192,112,80,111776,79840,191616
270400,201909,718,528,190,526948.39,189620,716568.39
270410,201909,674,492,182,491016,181636,672652
270420,201909,404,277,127,276446,126747.94,403193.94
270430,201909,33017,23752,9265,23734730.46,9263447.44,32998177.90
270440,201909,488,388,100,387224,99800,487024
270450,201909,791,436,355,435128,354290,789418
270460,201909,191,153,38,152694,37924,190618
270470,201909,1450,996,454,995006.4,453092,1448098.4
270480,201909,539,445,94,444110.8,93812,537922.8
270490,201909,24,19,5,18962,4990,23952
270500,201909,486,404,82,404190,81836,486026
270510,201909,773,478,295,477044,294410,771454
270520,201909,321,201,120,201596,119760,321356
270530,201909,68,58,10,57884,9980,67864
270540,201909,111,87,24,86826,23952,110778
270550,201909,1758,1349,409,1349297.98,409180,1758477.98
270560,201909,280,141,139,140718,138722,279440
270570,201909,501,355,146,354290,145708,499998
270580,201909,96,71,25,70858,24950,95808
270590,201909,70,56,14,55888,13972,69860
270600,201909,173,142,31,141716,30938,172654
270610,201909,205,174,31,173652,30938,204590
270620,201909,30,29,1,28942,998,29940
270630,201909,3814,2916,898,2911169.76,896204.96,3807374.72
270640,201909,884,655,229,653690,228543.94,882233.94
270642,201909,224,189,35,188622,34930,223552
270644,201909,247,164,83,163672.98,82834,246506.98
270650,201909,316,187,129,186626,128742,315368
270660,201909,252,207,45,207584,44910,252494
270670,201909,3082,2367,715,2363301.16,714568.4,3077869.56
270680,201909,456,266,190,266466.98,189620,456086.98
270690,201909,1144,743,401,741514,400198,1141712
270700,201909,32,24,8,23952,7984,31936
270710,201909,873,674,199,672652,198602,871254
270720,201909,248,195,53,194610,52894,247504
270730,201909,1900,1124,776,1123748.8,776446.08,1900194.88
270740,201909,42,28,14,27944,13972,41916
270750,201909,659,487,172,486026.6,171656,657682.6
270760,201909,296,217,79,216566,78842,295408
270770,201909,2768,1808,960,1805385.69,960076.96,2765462.65
270780,201909,80,50,30,49900,29941.98,79841.98
270790,201909,245,163,82,162674,81836,244510
270800,201909,1969,1589,380,1585823.39,380238,1966061.39
270810,201909,286,230,56,229540,55888,285428
270820,201909,152,101,51,100798,50898.8,151696.8
270830,201909,812,597,215,595807.98,214570.99,810378.97
270840,201909,1420,1081,339,1078838,338322.74,1417160.74
270850,201909,1567,968,599,967063,600796,1567859
270860,201909,2523,1670,853,1666662.41,851296.67,2517959.08
270870,201909,127,67,60,66866,59880,126746
270880,201909,909,696,213,694618.72,212578.86,907197.58
270890,201909,312,227,85,226546,84830,311376
270895,201909,63,54,9,53892,8982,62874
270900,201909,97,75,22,74850,21956,96806
270910,201909,315,252,63,251496,62874,314370
270915,201909,1917,1190,727,1188148.69,726555.2,1914703.89
270920,201909,492,414,78,413172,77844,491016
270930,201909,6107,4526,1581,4518960.96,1579843.94,6098804.90
270940,201909,2362,1827,535,1823346,533930,2357276
280010,201909,41,36,5,35928,4990,40918
280020,201909,462,406,56,406186.96,56886,463072.96
280030,201909,20088,13100,6988,13087483.03,6978029.78,20065512.81
280040,201909,327,216,111,216566,111776,328342
280050,201909,380,293,87,292414,86826,379240
280060,201909,334,226,108,225548.48,107784,333332.48
280067,201909,1032,748,284,746504.49,286426.75,1032931.24
280070,201909,122,100,22,99800,21956,121756
280100,201909,616,486,130,486026.4,130738.6,616765.0
280110,201909,76,71,5,70858,4990,75848
280120,201909,637,521,116,519958,115768,635726
280130,201909,1645,1080,565,1077840.65,565866.8,1643707.45
280140,201909,466,384,82,383232,81836,465068
280150,201909,371,272,99,271456,98802,370258
280160,201909,96,84,12,83832,11976,95808
280170,201909,406,271,135,270458,134730,405188
280190,201909,28,26,2,25948,1996,27944
280200,201909,29,24,5,24950,4990,29940
280210,201909,2853,2069,784,2065864.37,785426.4,2851290.77
280220,201909,41,33,8,32934,7984,40918
280230,201909,324,268,56,267464.7,55888,323352.7
280240,201909,118,112,6,111776,5988,117764
280250,201909,16,10,6,9980,5988,15968
280260,201909,81,71,10,70858,9980,80838
280270,201909,155,121,34,120758,33932,154690
280280,201909,187,121,66,120758.85,65868,186626.85
280290,201909,3290,2410,880,2408112.64,879238.64,3287351.28
280300,201909,1596,1233,363,1232530.4,362274,1594804.4
280310,201909,102,98,4,97804.6,3992,101796.6
280320,201909,665,464,201,464070,201596,665666
280330,201909,335,242,93,241516,92814,334330
280340,201909,405,329,76,328342,75848,404190
280350,201909,3574,2793,781,2792408.24,779438.7,3571846.94
280360,201909,446,289,157,288422,156686,445108
280370,201909,96,84,12,83832,11976,95808
280380,201909,55,43,12,42914,11976,54890
280390,201909,176,152,24,151696,23952,175648
280400,201909,344,234,110,233533.36,109780,343313.36
280410,201909,287,233,54,232534.6,53892,286426.6
280420,201909,164,138,26,137724,25948,163672
280430,201909,29,21,8,20958,7984,28942
280440,201909,690,539,151,537923.46,150698,688621.46
280445,201909,116,108,8,107784,7984,115768
280450,201909,1168,1007,161,1004986.94,160678,1165664.94
280460,201909,610,447,163,446106.7,162674,608780.7
280470,201909,187,173,14,172654,13972.7,186626.7
280480,201909,2484,1773,711,1770454.76,710577.62,2481032.38
280490,201909,282,262,20,261476.15,19960,281436.15
280500,201909,40,37,3,36926,2994,39920
280510,201909,138,111,27,110778,26946.4,137724.4
280520,201909,54,41,13,40918,12974,53892
280530,201909,72,46,26,46906,25948,72854
280540,201909,522,426,96,425148.7,95808,520956.7
280550,201909,727,673,54,671656.4,54890,726546.4
280560,201909,495,436,59,435128,58882,494010
280570,201909,2205,1720,485,1716561.78,484030,2200591.78
280580,201909,606,469,137,469062.19,137724.8,606786.99
280590,201909,173,111,62,110778,61876,172654
280600,201909,385,325,60,325348,59880,385228
280610,201909,126,95,31,94810,30938,125748
280620,201909,550,460,90,459080,89820,548900
280630,201909,148,124,24,123752,24950,148702
280640,201909,191,154,37,153692.96,36926,190618.96
280650,201909,80,57,23,56886,22954,79840
280660,201909,140,104,36,103792,35928,139720
280670,201909,1756,1120,636,1118763.35,635727.26,1754490.61
280680,201909,170,147,23,146706.29,22954,169660.29
280690,201909,88,78,10,77844,9980,87824
280700,201909,23,21,2,20958,1996,22954
280710,201909,1461,1129,332,1126742.6,331336,1458078.6
280720,201909,112,73,39,72854,38922,111776
280730,201909,25,21,4,20958,3992,24950
280740,201909,2491,1866,625,1864264.8,624748,2489012.8
280750,201909,224,197,27,196606,26946,223552
280760,201909,735,510,225,508980,224550,733530
290010,201909,204,141,63,140718,62874,203592
290020,201909,175,161,14,161676,13972,175648
290030,201909,599,391,208,391216,207584,598800
290035,201909,128,104,24,103792,23952,127744
290040,201909,297,197,100,196606,99800,296406
290050,201909,88,68,20,67864,19960,87824
290060,201909,264,119,145,118762,144710,263472
290070,201909,5579,2776,2803,2771447.86,2798395.84,5569843.70
290080,201909,474,224,250,223552.96,249500.96,473053.92
290090,201909,383,174,209,173652,208582,382234
290100,201909,1633,1077,556,1074847.2,554888.8,1629736.0
290110,201909,812,490,322,489021.12,322354.99,811376.11
290115,201909,200,186,14,185628,13972,199600
290120,201909,756,495,261,495008.63,260478,755486.63
290130,201909,429,261,168,260478,167664,428142
290135,201909,294,223,71,222554,70858,293412
290140,201909,310,255,55,254490,54890,309380
290150,201909,135,100,35,99800,34930,134730
290160,201909,244,185,59,185628,58882,244510
290170,201909,93,67,26,66866,25948,92814
290180,201909,169,130,39,130738.6,39920,170658.6
290190,201909,439,362,77,361276,76846,438122
290195,201909,316,200,116,199600,115768,315368
290200,201909,274,221,53,220558,52894,273452
290205,201909,144,89,55,88822,54890,143712
290210,201909,1154,847,307,845306.4,306386,1151692.4
290220,201909,220,121,99,120758,98802,219560
290225,201909,288,114,174,113772,174650,288422
290230,201909,68,46,22,45908,21956,67864
290240,201909,340,132,208,131736,207584,339320
290250,201909,259,239,20,238522,19960,258482
290260,201909,308,249,59,249500.4,59880,309380.4
290265,201909,190,161,29,160678,28942,189620
290270,201909,1414,1170,244,1167660.5,243513.36,1411173.86
290280,201909,473,337,136,336326,135728,472054
290290,201909,1287,768,519,766464.94,517962.4,1284427.34
290300,201909,445,381,64,380238.4,63872,444110.4
290310,201909,307,136,171,135728,170658,306386
290320,201909,4081,2531,1550,2527934.57,1549895.24,4077829.81
290323,201909,189,166,23,165668,22954,188622
290327,201909,166,133,33,132734,32934,165668
290330,201909,91,52,39,51896,38922,90818
290340,201909,867,356,511,356286,509978,866264
290350,201909,613,375,238,374250.4,237524,611774.4
290360,201909,364,278,86,277444.97,85828,363272.97
290370,201909,919,385,534,384230.7,533930.97,918161.67
290380,201909,321,198,123,197604,122754,320358
290390,201909,2478,1562,916,1559876.9,915166,2475042.9
290395,201909,250,142,108,141716.5,107784,249500.5
290400,201909,282,208,74,207585.14,73852,281437.14
290405,201909,248,217,31,216566,30938,247504
290410,201909,641,537,104,535926.55,103792,639718.55
290420,201909,250,202,48,201596,47904,249500
290430,201909,484,313,171,312374,170658,483032
290440,201909,73,66,7,65868,6986,72854
290450,201909,230,181,49,180638,48902,229540
290460,201909,1930,1171,759,1169665.8,758481.84,1928147.64
290470,201909,1395,598,797,597811.8,796420.66,1394232.46
290475,201909,585,546,39,545906.68,38922,584828.68
290480,201909,284,156,128,156686,127744,284430
290485,201909,241,225,16,224550,15968,240518
290490,201909,1202,867,335,865266,334330,1199596
290500,201909,714,368,346,367264,345308,712572
290510,201909,229,179,50,178642,49900,228542
290515,201909,145,90,55,89820,54890,144710
290520,201909,1423,947,476,947102.54,475048.73,1422151.27
290530,201909,307,283,24,282434,23952,306386
290540,201909,103,56,47,55888,46906,102794
290550,201909,149,123,26,122754,25948,148702
290560,201909,3215,1369,1846,1369256,1845304.92,3214560.92
290570,201909,6014,3054,2960,3049894.49,2957080.54,6006975.03
290580,201909,1280,772,508,770456,506984,1277440
290590,201909,569,471,98,470058,97804,567862
290600,201909,1739,1209,530,1206583.42,528940,1735523.42
290610,201909,209,187,22,187624.54,21956,209580.54
290620,201909,347,309,38,308382,37924,346306
290630,201909,2002,864,1138,862272,1136723.38,1998995.38
290640,201909,153,127,26,126746,25948,152694
290650,201909,1703,806,897,805386.69,895206,1700592.69
290660,201909,276,225,51,224550,50898,275448
290670,201909,930,491,439,491016.8,439120.63,930137.43
290680,201909,1232,995,237,994008,236526,1230534
290682,201909,298,222,76,221557.24,75848.98,297406.22
290685,201909,235,151,84,150698,83832,234530
290687,201909,1007,658,349,656846,348302,1005148
290689,201909,142,78,64,77844.97,64870,142714.97
290690,201909,614,261,353,261476.98,353296.84,614773.82
290700,201909,238,117,121,117764,120758,238522
290710,201909,712,482,230,481036,229540,710576
290720,201909,1036,842,194,840316,194610,1034926
290730,201909,1148,664,484,662672,483032,1145704
290740,201909,14,12,2,11976,1996,13972
290750,201909,1359,628,731,626744,731536.3,1358280.3
290755,201909,72,65,7,64870,6986,71856
290760,201909,295,256,39,256486,38922,295408
290770,201909,189,178,11,177644,10978.4,188622.4
290780,201909,1041,824,217,823353.74,216566,1039919.74
290790,201909,376,261,115,260478,114770,375248
290800,201909,2518,1014,1504,1013968,1502988,2516956
290810,201909,462,321,141,320358.14,140718,461076.14
290820,201909,406,243,163,242514.97,164670,407184.97
290830,201909,411,292,119,291416,118762,410178
290840,201909,1752,1094,658,1092811.28,656684.8,1749496.08
290850,201909,804,447,357,446106,357284,803390
290860,201909,617,284,333,283432,332334.4,615766.4
290870,201909,636,453,183,452094.64,182634.84,634729.48
290880,201909,123,67,56,66866,55888,122754
290890,201909,366,253,113,252494,113772,366266
290900,201909,167,129,38,128742,37924,166666
290910,201909,386,298,88,297404,87824,385228
290920,201909,222,189,33,188622,32934,221556
290930,201909,844,642,202,640716.4,201596.96,842313.36
290940,201909,245,203,42,202594,41916,244510
290950,201909,160,96,64,95808,63872,159680
290960,201909,470,323,147,322354,146706,469060
290970,201909,250,222,28,221556,27944.4,249500.4
290980,201909,1614,1153,461,1150695.08,461077.6,1611772.68
290990,201909,396,335,61,334330.98,60880.94,395211.92
291000,201909,859,255,604,254490,602792,857282
291005,201909,2237,999,1238,998000.54,1235524.98,2233525.52
291010,201909,158,143,15,142714,14970,157684
291020,201909,101,80,21,79840,20958,100798
291030,201909,97,71,26,70858,25948,96806
291040,201909,585,323,262,322354,261476,583830
291050,201909,1378,778,600,777442.96,599798,1377240.96
291060,201909,1496,843,653,841314,653690,1495004
291070,201909,1960,1464,496,1462071.58,495009.78,1957081.36
291072,201909,7250,2728,4522,2724542.78,4519944.96,7244487.74
291075,201909,226,187,39,186626.6,39920,226546.6
291077,201909,51,35,16,35928,15968,51896
291080,201909,20170,8970,11200,8959054.05,11186589.72,20145643.77
291085,201909,301,245,56,244510,55888,300398
291090,201909,299,119,180,118762.4,179640,298402.4
291100,201909,650,199,451,198602,452094,650696
291110,201909,412,314,98,313372,97804,411176
291120,201909,2458,1208,1250,1205584.7,1247500.99,2453085.69
291125,201909,66,33,33,32934,32934,65868
291130,201909,204,181,23,180638,22954,203592
291140,201909,142,113,29,112774,28942.4,141716.4
291150,201909,386,158,228,157684,227544,385228
291160,201909,389,321,68,320358.5,67864,388222.5
291165,201909,35,30,5,29940,4990,34930
291170,201909,3107,1567,1540,1565864.47,1536920.8,3102785.27
291180,201909,1267,502,765,502994.78,763472.88,1266467.66
291185,201909,80,78,2,77844,1996,79840
291190,201909,1329,595,734,593811.24,732532,1326343.24
291200,201909,165,124,41,123752,40918,164670
291210,201909,2238,899,1339,897203.08,1336323.38,2233526.46
291220,201909,274,207,67,206586,66866,273452
291230,201909,993,346,647,346306.4,648700,995006.4
291240,201909,427,404,23,403192.4,22954,426146.4
291250,201909,441,360,81,359280,80838,440118
291260,201909,51,40,11,39920,10978,50898
291270,201909,1168,487,681,486026,680636,1166662
291280,201909,356,171,185,170658,184630,355288
291290,201909,1730,901,829,899198.4,827343.23,1726541.63
291300,201909,234,182,52,181636,51896,233532
291310,201909,227,208,19,207584,19960,227544
291320,201909,1390,993,397,992012,397204,1389216
291330,201909,126,108,18,107784,17964,125748
291340,201909,189,109,80,108782,79840,188622
291345,201909,143,97,46,96806,45908,142714
291350,201909,1628,571,1057,569858,1060874.7,1630732.7
291360,201909,8412,4184,4228,4180626.46,4228529.86,8409156.32
291370,201909,1137,649,488,648700.4,487024.98,1135725.38
291380,201909,253,201,52,200598,51896,252494
291390,201909,3834,1716,2118,1713567.44,2115760.4,3829327.84
291400,201909,2077,1490,587,1487020,585826.81,2072846.81
291410,201909,164,145,19,144710,18962,163672
291420,201909,117,87,30,86826,29940,116766
291430,201909,162,89,73,88822,72854.11,161676.11
291440,201909,518,424,94,423152.8,93812,516964.8
291450,201909,905,580,325,578840.5,324350,903190.5
291460,201909,1828,1494,334,1491013.6,333332,1824345.6
291465,201909,2177,1051,1126,1048911.9,1124759.58,2173671.48
291470,201909,2855,1446,1409,1446102.71,1408178.4,2854281.11
291480,201909,11692,5230,6462,5221561.31,6451196.6,11672757.91
291490,201909,573,243,330,242514,329340,571854
291500,201909,379,219,160,218562,159680,378242
291510,201909,1219,476,743,475048,742512,1217560
291520,201909,945,436,509,435128,508980,944108
291530,201909,967,270,697,270458,695606,966064
291535,201909,126,106,20,105788,19960,125748
291540,201909,347,103,244,102794.4,244510.2,347304.6
291550,201909,1209,582,627,580837.2,626745.38,1207582.58
291560,201909,5322,2725,2597,2719641.6,2594966.91,5314608.51
291570,201909,199,102,97,101796,96806,198602
291580,201909,1229,757,472,755487.41,471056,1226543.41
291590,201909,82,34,48,33932,47904,81836
291600,201909,1167,582,585,580836,583831.96,1164667.96
291610,201909,1464,722,742,720556,740517.58,1461073.58
291620,201909,578,265,313,265468,312374,577842
291630,201909,468,148,320,147704,319360,467064
291640,201909,3952,2022,1930,2019956.2,1927149.98,3947106.18
291650,201909,418,286,132,285429.15,131736,417165.15
291660,201909,394,155,239,154690,238522,393212
291670,201909,217,137,80,136726,80838,217564
291680,201909,668,396,272,396206,271456.8,667662.8
291685,201909,587,327,260,326346.5,259480,585826.5
291690,201909,556,318,238,319360,237525.86,556885.86
291700,201909,953,754,199,752492,198602,951094
291710,201909,1685,807,878,806384.5,877242.98,1683627.48
291720,201909,412,277,135,277444,134730,412174
291730,201909,941,557,384,555886,383232,939118
291733,201909,284,197,87,196606,86826,283432
291735,201909,75,56,19,55888,18962,74850
291740,201909,351,273,78,273452.4,77844,351296.4
291750,201909,2081,1361,720,1359276.8,719558,2078834.8
291760,201909,3020,1669,1351,1665662,1348298,3013960
291770,201909,770,520,250,518965.33,249500,768465.33
291780,201909,52,32,20,31936,19960,51896
291790,201909,161,79,82,79840,81836,161676
291800,201909,10065,4177,5888,4171642.51,5887205.08,10058847.59
291810,201909,1121,827,294,825346.4,293412.6,1118759.0
291820,201909,273,197,76,196606,75848,272454
291830,201909,1111,444,667,443112.98,666664.98,1109777.96
291835,201909,576,536,40,534928,39920,574848
291840,201909,4818,2492,2326,2489013.35,2326339.38,4815352.73
291845,201909,274,93,181,92814,180638,273452
291850,201909,329,292,37,291416,36926,328342
291855,201909,255,100,155,99800,154690,254490
291860,201909,170,107,63,106786,62874,169660
291870,201909,84,33,51,32934,50898,83832
291875,201909,182,169,13,168662,12974,181636
291880,201909,472,378,94,377244,93812,471056
291890,201909,240,77,163,76846,163672.4,240518.4
291900,201909,59,34,25,33932,24950,58882
291905,201909,126,92,34,91816.4,33932,125748.4
291910,201909,170,139,31,138722,30938,169660
291915,201909,418,370,48,369260.5,47904,417164.5
291920,201909,4948,2561,2387,2555878.98,2382227.98,4938106.96
291930,201909,179,107,72,106786,71856,178642
291940,201909,357,201,156,200598,155688,356286
291950,201909,1138,923,215,922152.4,214570,1136722.4
291955,201909,1214,724,490,722552.4,489020,1211572.4
291960,201909,182,132,50,131736,49900,181636
291970,201909,765,579,186,578840,185628,764468
291980,201909,1525,1351,174,1348299.38,173652.4,1521951.78
291990,201909,132,122,10,121756,9980,131736
291992,201909,167,84,83,83832,82834,166666
291995,201909,163,110,53,109780,52894,162674
292000,201909,391,303,88,302394.4,87824,390218.4
292010,201909,305,215,90,215568,89820,305388
292020,201909,292,214,78,213572,77844,291416
292030,201909,149,116,33,115768,32934,148702
292040,201909,640,321,319,320358,318362,638720
292045,201909,103,95,8,94810,7984,102794
292050,201909,941,686,255,684628,254490.4,939118.4
292060,201909,908,757,151,756484.86,150698,907182.86
292070,201909,48,19,29,18962,28942,47904
292080,201909,136,93,43,92814,42914,135728
292090,201909,516,188,328,187624,328342,515966
292100,201909,1430,628,802,626744.6,800396.98,1427141.58
292105,201909,204,176,28,176646,27944,204590
292110,201909,2237,844,1393,842312,1390219.86,2232531.86
292120,201909,693,549,144,548900,143712,692612
292130,201909,444,260,184,259480,183632,443112
292140,201909,206,164,42,163672,41916,205588
292145,201909,163,87,76,86826.4,75848,162674.4
292150,201909,1467,1197,270,1195604,269460,1465064
292160,201909,175,144,31,143712,30938,174650
292170,201909,1205,1057,148,1054886,147704,1202590
292180,201909,216,156,60,155688,60878,216566
292190,201909,160,100,60,99800,59880,159680
292200,201909,1288,488,800,487025.36,802393.36,1289418.72
292205,201909,127,112,15,111776,14970,126746
292210,201909,367,258,109,258482,109780,368262
292220,201909,25,20,5,19960,4990,24950
292225,201909,38,33,5,32934,4990,37924
292230,201909,965,780,185,779438.3,184630,964068.3
292240,201909,614,447,167,448102.7,166666,614768.7
292250,201909,1759,1165,594,1162670,592812.4,1755482.4
292260,201909,426,253,173,252494,172654,425148
292265,201909,247,175,72,174650,71856,246506
292270,201909,737,339,398,338322,397204.6,735526.6
292273,201909,199,111,88,110778,87824,198602
292275,201909,177,88,89,87824,88822,176646
292280,201909,142,102,40,101796,39920,141716
292285,201909,70,59,11,58882,10978,69860
292290,201909,570,387,183,387224,182634.4,569858.4
292300,201909,1657,649,1008,647702.4,1006982.72,1654685.12
292303,201909,104,70,34,69860,33932,103792
292305,201909,112,83,29,82834,28942,111776
292310,201909,901,595,306,594809.24,305388.56,900197.80
292320,201909,623,471,152,470058,151696,621754
292330,201909,177,102,75,101796,74850,176646
292335,201909,286,226,60,225548,59880,285428
292340,201909,578,404,174,405188.4,173652,578840.4
292350,201909,268,144,124,143712,123752,267464
292360,201909,712,542,170,541914.56,169660,711574.56
292370,201909,753,578,175,576844,175648,752492
292380,201909,661,520,141,518960.54,140718,659678.54
292390,201909,488,196,292,195608,291416,487024
292400,201909,3492,2181,1311,2179634.7,1308379,3488013.7
292405,201909,270,176,94,176646,93812,270458
292410,201909,142,86,56,85828,55888,141716
292420,201909,300,259,41,258482,40918,299400
292430,201909,525,411,114,410178,113772,523950
292440,201909,584,504,80,503990.44,79840,583830.44
292450,201909,260,203,57,202594,56886,259480
292460,201909,557,419,138,418162.98,138722,556884.98
292465,201909,219,181,38,180638,37924,218562
292467,201909,118,71,47,70858,46906,117764
292470,201909,281,191,90,190618,89820,280438
292480,201909,346,239,107,238522,106786.4,345308.4
292490,201909,231,160,71,159680,70858,230538
292500,201909,1132,498,634,497005.72,632732,1129737.72
292510,201909,3422,1578,1844,1576840.44,1844305.18,3421145.62
292520,201909,1100,519,581,517962.99,580836.98,1098799.97
292525,201909,399,283,116,282434,115768,398202
292530,201909,4315,1776,2539,1775445.73,2537919.5,4313365.23
292540,201909,469,264,205,263472,205588,469060
292550,201909,1055,574,481,572864.52,480049.54,1052914.06
292560,201909,324,306,18,305388,17964,323352
292570,201909,303,235,68,234530,67864,302394
292575,201909,487,315,172,314370.4,171656,486026.4
292580,201909,983,651,332,649698,331336.4,981034.4
292590,201909,556,485,71,484030,70858,554888
292593,201909,140,111,29,110778,28942,139720
292595,201909,190,148,42,147704,41916,189620
292600,201909,1247,916,331,915166.63,331336,1246502.63
292610,201909,133,101,32,100798,31936,132734
292620,201909,535,453,82,453092.4,82834,535926.4
292630,201909,1410,805,605,803390.67,603790.27,1407180.94
292640,201909,803,556,247,554888,246506,801394
292650,201909,180,153,27,152694.4,26946,179640.4
292660,201909,2041,1476,565,1474046,563870.74,2037916.74
292665,201909,148,107,41,106786,40918,147704
292670,201909,398,323,75,322354.99,74850,397204.99
292680,201909,259,196,63,196606,62874,259480
292690,201909,191,145,46,144710,45908,190618
292700,201909,942,634,308,632732,307384,940116
292710,201909,110,97,13,96806,12974,109780
292720,201909,915,519,396,517962,396206,914168
292730,201909,196,95,101,94810,100798,195608
292740,201909,67368,33475,33893,33438024.95,33866175.69,67304200.64
292750,201909,394,280,114,279440.78,113772,393212.78
292760,201909,339,280,59,279440.38,59880,339320.38
292770,201909,794,344,450,343312.4,450098,793410.4
292780,201909,406,158,248,158682,248502,407184
292790,201909,752,380,372,379240,371256,750496
292800,201909,1232,744,488,742512,488022,1230534
292805,201909,394,114,280,113772,281436,395208
292810,201909,1489,847,642,846305.2,640716.98,1487022.18
292820,201909,730,599,131,597802.7,130738.98,728541.68
292830,201909,105,86,19,85828,18962,104790
292840,201909,691,570,121,569858.6,121756,691614.6
292850,201909,140,96,44,95808,43912,139720
292860,201909,2160,1283,877,1281432.4,876244.6,2157677.0
292870,201909,3462,2328,1134,2324345.53,1132730.8,3457076.33
292880,201909,1480,970,510,968060.82,508980,1477040.82
292890,201909,518,444,74,443113.94,74850,517963.94
292895,201909,140,91,49,90818,48902,139720
292900,201909,400,292,108,291416.36,107784,399200.36
292905,201909,466,237,229,237524,228542,466066
292910,201909,445,342,103,341316.3,102794,444110.3
292920,201909,520,234,286,233532,287424,520956
292925,201909,490,451,39,450098,38922,489020
292930,201909,597,364,233,363272,233532,596804
292935,201909,287,124,163,123752,162674.98,286426.98
292937,201909,243,167,76,166666,75848,242514
292940,201909,195,152,43,151696,42914,194610
292950,201909,1116,585,531,583831.9,529938.6,1113770.5
292960,201909,608,428,180,427144,180638,607782
292970,201909,249,180,69,179640,68862,248502
292975,201909,125,71,54,70858,53892.6,124750.6
292980,201909,280,189,91,188622.76,90818,279440.76
292990,201909,1322,988,334,987022.8,334330,1321352.8
293000,201909,106,76,30,75848,29940,105788
293010,201909,2771,1683,1088,1680632.3,1085824.99,2766457.29
293015,201909,664,532,132,531934,131736,663670
293020,201909,335,275,60,274450,59880,334330
293030,201909,602,525,77,523950.8,76846,600796.8
293040,201909,352,282,70,281436,70858,352294
293050,201909,2839,1693,1146,1690612.4,1143709.98,2834322.38
293060,201909,256,208,48,207584.58,47904,255488.58
293070,201909,3411,1773,1638,1772450.09,1635724.98,3408175.07
293075,201909,92,61,31,60878,30938,91816
293076,201909,72,48,24,47904,23952,71856
293077,201909,483,285,198,284430.4,197604,482034.4
293080,201909,440,397,43,397204.74,42914,440118.74
293090,201909,135,119,16,118762,15968,134730
293100,201909,532,375,157,374250,156686,530936
293105,201909,343,241,102,240518,101796,342314
293110,201909,172,122,50,121756,49900,171656
293120,201909,329,224,105,223552.45,104790,328342.45
293130,201909,241,166,75,165668,75848,241516
293135,201909,7931,3161,4770,3158689.54,4765501.04,7924190.58
293140,201909,199,130,69,129740.6,68862,198602.6
293150,201909,326,281,45,280438,44910,325348
293160,201909,422,247,175,246506,174650,421156
293170,201909,164,115,49,114770,48902,163672
293180,201909,490,351,139,350298,142714,493012
293190,201909,1346,941,405,940116.7,404190,1344306.7
293200,201909,543,483,60,482034,59880,541914
293210,201909,387,300,87,299400,87824,387224
293220,201909,2544,1073,1471,1071852,1471052.58,2542904.58
293230,201909,1705,635,1070,633730.35,1068858,1702588.35
293240,201909,225,209,16,208582,15968,224550
293245,201909,119,99,20,98802,19960,118762
293250,201909,702,258,444,257484.67,444110,701594.67
293260,201909,296,247,49,246506,48902,295408
293270,201909,1136,539,597,537922.68,597802,1135724.68
293280,201909,266,150,116,149700,115768,265468
293290,201909,3031,1991,1040,1988016,1037921.97,3025937.97
293300,201909,717,514,203,512973.67,202594,715567.67
293305,201909,173,145,28,144710,27944,172654
293310,201909,147,113,34,112774,33932,146706
293315,201909,168,132,36,131736,35928,167664
293317,201909,95,69,26,68862,25948,94810
293320,201909,1021,584,437,582832,436126,1018958
293325,201909,184,69,115,68862,114770,183632
293330,201909,13264,6289,6975,6279418.72,6968041.82,13247460.54
293340,201909,264,192,72,191616,71856,263472
293345,201909,246,196,50,195608,49900,245508
293350,201909,618,354,264,353292.4,264470,617762.4
293360,201909,1551,1110,441,1107780,440118,1547898
310010,201909,134,72,62,72854,61876.4,134730.4
310020,201909,1040,583,457,581834.4,457084.44,1038918.84
310030,201909,327,269,58,268462.2,57884,326346.2
310040,201909,47,32,15,31936,14970,46906
310050,201909,186,120,66,119760,65868,185628
310060,201909,240,171,69,170658,68862,239520
310070,201909,14,8,6,7984,5988,13972
310080,201909,42,24,18,23952,17964,41916
310090,201909,980,522,458,520957.6,458082.8,979040.4
310100,201909,300,230,70,230538,69860,300398
310110,201909,712,395,317,394210,317364.4,711574.4
310120,201909,378,219,159,218562,159680,378242
310130,201909,32,20,12,19960,11976,31936
310140,201909,24,13,11,12974,10978,23952
310150,201909,1245,863,382,861275,383232.8,1244507.8
310160,201909,2046,1047,999,1045904.9,1001992.8,2047897.7
310163,201909,92,53,39,52894,39920,92814
310170,201909,2548,1136,1412,1134726.74,1410176.2,2544902.94
310180,201909,126,50,76,49900.4,76846,126746.4
310190,201909,477,332,145,331336,146706,478042
310200,201909,494,321,173,320358.4,172654,493012.4
310205,201909,53,39,14,38922,13972,52894
310210,201909,283,229,54,228542,53892,282434
310220,201909,58,35,23,34930,22954,57884
310230,201909,268,188,80,187624,79840,267464
310240,201909,103,92,11,91816,10978,102794
310250,201909,105,84,21,83832,20958,104790
310260,201909,764,415,349,414172.04,349300,763472.04
310270,201909,270,181,89,180638.44,88822,269460.44
310280,201909,368,275,93,274450,92814,367264
310285,201909,214,154,60,153692,59880,213572
310290,201909,248,137,111,136726,110778,247504
310300,201909,148,123,25,122754,24950,147704
310310,201909,9,7,2,6986,1996,8982
310320,201909,28,13,15,12974,14970,27944
310330,201909,33,25,8,25948,7984,33932
310340,201909,1745,1163,582,1163669.8,582832.4,1746502.2
310350,201909,2820,1556,1264,1552888.4,1263468.98,2816357.38
310360,201909,40,33,7,32934,6986,39920
310370,201909,114,96,18,95808,17964.4,113772.4
310375,201909,104,39,65,38922,64870.96,103792.96
310380,201909,48,28,20,27944,19960,47904
310390,201909,91,63,28,62874,27944,90818
310400,201909,2335,1554,781,1554884.8,781434,2336318.8
310410,201909,123,71,52,70858,51896,122754
310420,201909,664,356,308,355288.6,307384.2,662672.8
310430,201909,311,205,106,204590,105788,310378
310440,201909,71,43,28,42914,27944,70858
310445,201909,80,68,12,67864,11976,79840
310450,201909,840,527,313,526944,312374,839318
310460,201909,253,182,71,181636,70858,252494
310470,201909,513,332,181,331336,180638,511974
310480,201909,79,59,20,58882,19960,78842
310490,201909,525,255,270,254490,270458,524948
310500,201909,127,53,74,52894,73852,126746
310510,201909,600,415,185,414170,184630.98,598800.98
310520,201909,132,94,38,93812,37924,131736
310530,201909,99,43,56,42914,55888,98802
310540,201909,459,276,183,275448.6,182634,458082.6
310550,201909,82,54,28,53892,27944,81836
310560,201909,3001,2069,932,2068856.76,930136,2998992.76
310570,201909,106,73,33,72854,32934,105788
310590,201909,363,236,127,235528.4,126746,362274.4
310600,201909,154,87,67,86826.4,66866,153692.4
310610,201909,61,24,37,23952,36926,60878
310620,201909,46395,22574,23821,22547768.76,23811298.45,46359067.21
310630,201909,615,399,216,398202,216566.4,614768.4
310640,201909,146,116,30,115768,29940,145708
310650,201909,163,144,19,143712,19960,163672
310660,201909,93,62,31,61876,30938,92814
310665,201909,59,43,16,42914,15968,58882
310670,201909,6472,2920,3552,2916163.06,3548914.38,6465077.44
310680,201909,58,35,23,34930,22954,57884
310690,201909,589,417,172,416166.1,171656,587822.1
310700,201909,56,38,18,37924,17964,55888
310710,201909,1330,914,416,912173.38,415168.4,1327341.78
310720,201909,107,33,74,32934,73852,106786
310730,201909,1405,1000,405,998998.9,404190,1403188.9
310740,201909,975,554,421,552892.8,421156.5,974049.3
310750,201909,243,144,99,143712.66,98802,242514.66
310760,201909,61,43,18,42914,17964.4,60878.4
310770,201909,99,47,52,46906,51896,98802
310780,201909,375,306,69,305388.98,69860,375248.98
310790,201909,101,82,19,81836,18962,100798
310800,201909,450,221,229,221556.5,228542,450098.5
310810,201909,169,121,48,120758.9,48902,169660.9
310820,201909,350,277,73,276446,72854,349300
310825,201909,197,168,29,167664,28942,196606
310830,201909,459,225,234,224550.4,233532,458082.4
310840,201909,360,211,149,210578,149700,360278
310850,201909,107,86,21,85828,20958,106786
310855,201909,391,313,78,313372,77844,391216
310860,201909,1574,1180,394,1177643.16,395208.7,1572851.86
310870,201909,55,45,10,44910,9980,54890
310880,201909,84,65,19,64870,18962,83832
310890,201909,296,178,118,177644,117764,295408
310900,201909,651,301,350,300407.96,349315.36,649723.32
310910,201909,241,165,76,164670.6,75848,240518.6
310920,201909,467,277,190,276447.3,190618,467065.3
310925,201909,34,27,7,26946,6986.4,33932.4
310930,201909,1076,660,416,658694.85,415177.9,1073872.75
310940,201909,670,349,321,348302,321356,669658
310945,201909,122,76,46,75848,45908,121756
310950,201909,243,197,46,196606,45908,242514
310960,201909,81,29,52,28942,51896.99,80838.99
310970,201909,161,102,59,102794,58882,161676
310980,201909,45,27,18,26946,17964,44910
310990,201909,144,78,66,77844,66866,144710
311000,201909,814,415,399,414171.77,399200.98,813372.75
311010,201909,44,37,7,36926,6986,43912
311020,201909,42,26,16,25948,15968,41916
311030,201909,393,230,163,229540,162674,392214
311040,201909,40,35,5,34930,4990,39920
311050,201909,476,195,281,194610.8,280438,475048.8
311060,201909,772,437,335,437124.4,335328.4,772452.8
311070,201909,345,165,180,164670,179640,344310
311080,201909,106,59,47,58882,46906,105788
311090,201909,337,162,175,161676.4,174650,336326.4
311100,201909,605,363,242,362274,242514,604788
311110,201909,690,484,206,484030.4,206586,690616.4
311115,201909,75,55,20,54890,19960,74850
311120,201909,1072,568,504,567862.4,502992,1070854.4
311130,201909,375,224,151,223552,150698,374250
311140,201909,160,89,71,88822,70858,159680
311150,201909,359,237,122,236526,122754,359280
311160,201909,709,514,195,513970.4,194610,708580.4
311170,201909,84,68,16,67864,15968,83832
311180,201909,339,228,111,227544,111776.4,339320.4
311190,201909,31,15,16,14970,15968,30938
311200,201909,321,229,92,228542,91816,320358
311205,201909,32,23,9,22954,8982,31936
311210,201909,49,41,8,40918.59,7984,48902.59
311220,201909,21,19,2,18962,1996,20958
311230,201909,1630,1076,554,1076842.87,552892,1629734.87
311240,201909,175,114,61,113772,60878,174650
311250,201909,96,27,69,26946,68862,95808
311260,201909,556,352,204,352294,204590,556884
311265,201909,120,86,34,85828,33932,119760
311270,201909,293,200,93,199600,92814,292414
311280,201909,211,100,111,99800,110778,210578
311290,201909,107,87,20,86826,19960.4,106786.4
311300,201909,589,371,218,370258,217564,587822
311310,201909,23,17,6,16966,5988,22954
311320,201909,666,497,169,496006,168662,664668
311330,201909,1085,810,275,808380,274450.8,1082830.8
311340,201909,2580,1840,740,1836320.8,741514.98,2577835.78
311350,201909,273,212,61,211576,60878,272454
311360,201909,169,107,62,106786,61876,168662
311370,201909,1195,503,692,501994.5,690616.96,1192611.46
311380,201909,7,6,1,5988,998,6986
311390,201909,261,147,114,146706,114770,261476
311400,201909,156,106,50,105788,49900,155688
311410,201909,101,58,43,57884,42914,100798
311420,201909,300,169,131,168662.6,130738,299400.6
311430,201909,860,575,285,573850.5,285428.4,859278.9
311440,201909,472,334,138,333332,137724,471056
311450,201909,318,202,116,201596,115768,317364
311455,201909,284,195,89,194610,88822,283432
311460,201909,142,61,81,60878,80838,141716
311470,201909,22,13,9,12974,8982,21956
311480,201909,44,20,24,19960,23952,43912
311490,201909,16,10,6,9980,5988,15968
311500,201909,23,10,13,9980,12974,22954
311510,201909,633,449,184,448102,183632,631734
311520,201909,40,32,8,31936,7984,39920
311530,201909,1797,1351,446,1349297.88,445108,1794405.88
311535,201909,68,49,19,48902,18962,67864
311540,201909,35,30,5,30938,4990,35928
311545,201909,189,139,50,138722,49900,188622
311547,201909,33,26,7,25948,6986.96,32934.96
311550,201909,665,319,346,318362,345308.98,663670.98
311560,201909,43,29,14,28942,13972,42914
311570,201909,287,196,91,195608,90818,286426
311580,201909,331,199,132,198602,131736,330338
311590,201909,31,28,3,27944,2994,30938
311600,201909,98,78,20,77844,19960,97804
311610,201909,258,222,36,221557.1,35928,257485.1
311615,201909,117,99,18,98802,17964,116766
311620,201909,25,13,12,12974,11976,24950
311630,201909,84,70,14,69860,13972,83832
311640,201909,131,70,61,69860,60878,130738
311650,201909,132,94,38,93812,37924,131736
311660,201909,409,196,213,195608,212574,408182
311670,201909,160,106,54,105788.58,53892,159680.58
311680,201909,210,155,55,154690,54890,209580
311690,201909,11,8,3,7984,2994,10978
311700,201909,195,138,57,137724,56886,194610
311710,201909,200,129,71,128742,70858,199600
311720,201909,39,29,10,28942.4,9980,38922.4
311730,201909,602,401,201,400198,200598,600796
311740,201909,36,26,10,25948,9980,35928
311750,201909,709,479,230,478043.36,229540,707583.36
311760,201909,60,33,27,32934,26946,59880
311770,201909,391,196,195,195609.34,194610,390219.34
311780,201909,179,99,80,98802.4,79840,178642.4
311783,201909,86,76,10,75848,9980,85828
311787,201909,34,14,20,13972,19960,33932
311790,201909,263,123,140,122754,140718,263472
311800,201909,669,448,221,448102.9,221556,669658.9
311810,201909,49,41,8,40918,7984,48902
311820,201909,113,95,18,94810,17964,112774
311830,201909,1914,1212,702,1210575.9,700596,1911171.9
311840,201909,998,560,438,559879.5,438122.9,998002.4
311850,201909,10,6,4,5988,3992,9980
311860,201909,9378,4249,5129,4248489.1,5128728.73,9377217.83
311870,201909,136,74,62,73852,61876,135728
311880,201909,935,688,247,686625.38,249500,936125.38
311890,201909,212,105,107,104708,106786,211494
311900,201909,76,33,43,32934,43912,76846
311910,201909,1418,895,523,893210.7,521954.4,1415165.1
311920,201909,225,150,75,149700,74850,224550
311930,201909,908,529,379,527942.4,378242,906184.4
311940,201909,2437,1300,1137,1297400,1137720.86,2435120.86
311950,201909,59,44,15,43912,14970,58882
311960,201909,63,45,18,44910,17964,62874
311970,201909,25,16,9,15968,8982,24950
311980,201909,44,35,9,34930,8982,43912
311990,201909,42,34,8,33932,7984,41916
311995,201909,56,37,19,36926,18962,55888
312000,201909,32,23,9,22954,8982,31936
312010,201909,79,62,17,61876,16966,78842
312015,201909,90,67,23,66866.4,22954,89820.4
312020,201909,127,83,44,82834.4,43912,126746.4
312030,201909,51,40,11,39920,10978,50898
312040,201909,87,55,32,54890.4,31936,86826.4
312050,201909,214,120,94,119760,93812,213572
312060,201909,60,36,24,35928,23952,59880
312070,201909,74,47,27,46906,26946,73852
312080,201909,527,242,285,241516,284430,525946
312083,201909,55,39,16,38922,15968,54890
312087,201909,110,87,23,86826,22954,109780
312090,201909,3122,1879,1243,1877242.64,1243508.4,3120751.04
312100,201909,150,105,45,104560.86,44910,149470.86
312110,201909,112,70,42,69860,41916,111776
312120,201909,143,108,35,107784.97,34930,142714.97
312125,201909,91,48,43,47904,42914,90818
312130,201909,122,84,38,84830,37924,122754
312140,201909,144,112,32,111776.4,32934,144710.4
312150,201909,45,35,10,34930,9980,44910
312160,201909,1555,1026,529,1024039.6,527942.4,1551982.0
312170,201909,10,9,1,8982,998,9980
312180,201909,105,67,38,66866,37924.8,104790.8
312190,201909,33,29,4,28942,3992,32934
312200,201909,754,648,106,646704.4,105788,752492.4
312210,201909,87,57,30,57884,29940,87824
312220,201909,138,101,37,100798.5,36926,137724.5
312230,201909,3563,1740,1823,1738518.32,1821358.06,3559876.38
312235,201909,168,114,54,113772,53892,167664
312240,201909,101,71,30,70858,29940,100798
312245,201909,181,127,54,126746.99,53892,180638.99
312247,201909,65,46,19,45908,18962,64870
312250,201909,177,86,91,85828,90818,176646
312260,201909,114,76,38,75848,37924,113772
312270,201909,133,81,52,80838,51896,132734
312280,201909,27,14,13,13972,12974,26946
312290,201909,154,108,46,107784,45908.6,153692.6
312300,201909,204,134,70,134730,69860,204590
312310,201909,57,52,5,51896,4990,56886
312320,201909,427,272,155,272454,154690.1,427144.1
312330,201909,89,79,10,78842,9980,88822
312340,201909,37,16,21,15968,20958,36926
312350,201909,18,11,7,10978,6986,17964
312352,201909,98,69,29,68862,28942,97804
312360,201909,558,249,309,249500,308382,557882
312370,201909,302,173,129,172654,130738.4,303392.4
312380,201909,142,98,44,97804,43912,141716
312385,201909,168,136,32,135728,31936,167664
312390,201909,304,191,113,190618,112774,303392
312400,201909,371,285,86,284430,85829,370259
312410,201909,922,308,614,308382,613771.39,922153.39
312420,201909,625,486,139,485028.4,138722,623750.4
312430,201909,867,641,226,639719.89,225548,865267.89
312440,201909,42,32,10,31936,9980,41916
312450,201909,206,130,76,129740,75848,205588
312460,201909,33,16,17,15968,16966,32934
312470,201909,50,33,17,32934,16966,49900
312480,201909,195,118,77,117764,76846,194610
312490,201909,268,190,78,189620,78842,268462
312500,201909,34,19,15,18962,14970,33932
312510,201909,508,201,307,200598,306386,506984
312520,201909,36,10,26,9980,25948,35928
312530,201909,47,32,15,31936,14970,46906
312540,201909,99,87,12,86826,11976,98802
312550,201909,40,31,9,30938,8982,39920
312560,201909,222,169,53,168662.4,52894,221556.4
312570,201909,446,268,178,267464,177644,445108
312580,201909,88,47,41,46906,40918,87824
312590,201909,254,200,54,199600,53892,253492
312595,201909,134,121,13,120758,12974,133732
312600,201909,70,43,27,42914.1,26946,69860.1
312610,201909,1571,826,745,826345.6,745506.4,1571852.0
312620,201909,199,145,54,144710,53892,198602
312630,201909,69,57,12,56886,11976,68862
312640,201909,43,12,31,11976,30938,42914
312650,201909,154,130,24,129740.4,23952,153692.4
312660,201909,82,61,21,60878.7,20958,81836.7
312670,201909,894,595,299,593810,298402,892212
312675,201909,34,26,8,25948,7984,33932
312680,201909,80,53,27,52894,26946,79840
312690,201909,241,128,113,127744,112774,240518
312695,201909,39,32,7,31936,6986,38922
312700,201909,216,128,88,127744,88822,216566
312705,201909,84,69,15,69860,14970,84830
312707,201909,129,93,36,92814.3,35928,128742.3
312710,201909,1863,1012,851,1009976.96,850296,1860272.96
312720,201909,65,33,32,32934,31936,64870
312730,201909,271,157,114,156686,113772,270458
312733,201909,53,45,8,44910,7984,52894
312735,201909,23,15,8,14970,7984,22954
312737,201909,71,38,33,37924,32934,70858
312738,201909,54,40,14,39920,13972,53892
312740,201909,78,52,26,51896.4,25948,77844.4
312750,201909,71,52,19,51896,18962,70858
312760,201909,278,202,76,201596,75848,277444
312770,201909,7567,3551,4016,3545904.11,4015955.93,7561860.04
312780,201909,419,324,95,323352,94810,418162
312790,201909,20,16,4,15968,3992,19960
312800,201909,1591,1107,484,1105784.9,483032.46,1588817.36
312810,201909,366,235,131,234530,130738,365268
312820,201909,191,143,48,142714,47904,190618
312825,201909,26,18,8,17964,7984,25948
312830,201909,241,139,102,138722.46,101796,240518.46
312840,201909,155,111,44,110778,43912,154690
312850,201909,47,43,4,42914,3992,46906
312860,201909,156,101,55,100798,54890,155688
312870,201909,1031,544,487,543910.9,486026,1029936.9
312880,201909,142,99,43,98802,42914,141716
312890,201909,163,114,49,113772,48902,162674
312900,201909,201,152,49,151696,48902,200598
312910,201909,182,95,87,95808,86826,182634
312920,201909,158,91,67,90818,66866,157684
312930,201909,322,232,90,231536,89820,321356
312940,201909,110,80,30,79840,29940,109780
312950,201909,695,471,224,471056,223552,694608
312960,201909,173,130,43,129740.96,42914,172654.96
312965,201909,66,57,9,56886,8982,65868
312970,201909,280,227,53,226546.5,52894,279440.5
312980,201909,2399,1260,1139,1259477.78,1139716,2399193.78
312990,201909,43,23,20,22954,19960,42914
313000,201909,47,28,19,27944,18962,46906
313005,201909,169,133,36,132734,35928.4,168662.4
313010,201909,908,374,534,373252,532932.98,906184.98
313020,201909,190,102,88,101796,88822,190618
313030,201909,200,131,69,130738.54,68862,199600.54
313040,201909,72,25,47,24950,46906,71856
313050,201909,191,139,52,138722,51896,190618
313055,201909,42,32,10,31936,9980,41916
313060,201909,126,90,36,89820,35928,125748
313065,201909,57,40,17,39920,16966,56886
313070,201909,137,73,64,72854,63872,136726
313080,201909,41,18,23,17964,22954,40918
313090,201909,704,484,220,483032.4,219560,702592.4
313100,201909,168,64,104,63872,103792,167664
313110,201909,137,75,62,74850,61876,136726
313115,201909,182,100,82,100798,81836,182634
313120,201909,776,445,331,445108.4,330338.4,775446.8
313130,201909,5481,3030,2451,3026940.18,2447097.9,5474038.08
313140,201909,144,77,67,76846,66866,143712
313150,201909,306,246,60,245508,59880,305388
313160,201909,187,141,46,140718.4,46906,187624.4
313170,201909,1385,960,425,959079.6,424150.98,1383230.58
313180,201909,303,183,120,182634,119760,302394
313190,201909,751,459,292,458082,291416.2,749498.2
313200,201909,28,25,3,24950,2994,27944
313210,201909,1005,858,147,857283.62,146706,1003989.62
313220,201909,257,169,88,168662,87824.4,256486.4
313230,201909,271,205,66,204590.65,65868,270458.65
313240,201909,2088,1113,975,1111776.29,977042,2088818.29
313250,201909,1261,954,307,955087.4,307385.12,1262472.52
313260,201909,89,50,39,49900,38922,88822
313270,201909,951,566,385,564868.3,385228.8,950097.1
313280,201909,55,46,9,45908,8982,54890
313290,201909,223,180,43,179640.4,42914,222554.4
313300,201909,352,186,166,185628.6,165668,351296.6
313310,201909,241,124,117,123752,116766,240518
313320,201909,366,278,88,277444.6,87824,365268.6
313330,201909,1378,869,509,867262,508980,1376242
313340,201909,329,230,99,229540,98802,328342
313350,201909,493,334,159,334330,159680,494010
313360,201909,122,69,53,68862,52894.4,121756.4
313370,201909,190,70,120,69860,119760,189620
313375,201909,272,165,107,164670,106786,271456
313380,201909,1310,703,607,703590.2,605786.99,1309377.19
313390,201909,53,47,6,46906.6,5988,52894.6
313400,201909,411,281,130,280438.6,129740.8,410179.4
313410,201909,22,13,9,12974,8982,21956
313420,201909,4643,2500,2143,2496997.4,2140710.7,4637708.1
313430,201909,140,71,69,70858,68862,139720
313440,201909,1432,989,443,989019.11,442115.6,1431134.71
313450,201909,61,26,35,25948,34930,60878
313460,201909,377,176,201,175648.4,200598,376246.4
313470,201909,520,244,276,244510.8,275448,519958.8
313480,201909,147,106,41,105788.4,40918,146706.4
313490,201909,503,238,265,237524.4,266466.9,503991.3
313500,201909,22,13,9,12974,8982,21956
313505,201909,1005,802,203,800396,203592,1003988
313507,201909,97,59,38,58882,37924,96806
313510,201909,2748,1772,976,1770453,976044,2746497
313520,201909,3497,2750,747,2744504.45,745508.63,3490013.08
313530,201909,40,27,13,26946,12974,39920
313535,201909,51,44,7,43912,6986,50898
313540,201909,70,52,18,51896,17964,69860
313545,201909,114,96,18,95808,17964,113772
313550,201909,232,197,35,196606,34930.4,231536.4
313560,201909,330,169,161,168662,160678,329340
313570,201909,58,28,30,27944,29940,57884
313580,201909,1317,745,572,744508,570857.2,1315365.2
313590,201909,77,45,32,44910,31936,76846
313600,201909,679,417,262,416166,261476.4,677642.4
313610,201909,58,48,10,47904.4,9980,57884.4
313620,201909,1377,725,652,724548.8,651694,1376242.8
313630,201909,1613,1253,360,1254486.8,362274,1616760.8
313640,201909,124,76,48,75848,47904,123752
313650,201909,239,114,125,113772,124750.4,238522.4
313652,201909,17,17,0,16966,0,16966
313655,201909,62,39,23,38922,22954,61876
313657,201909,49,46,3,45908,2994,48902
313660,201909,128,91,37,90818,36943.96,127761.96
313665,201909,652,321,331,321356.3,330338,651694.3
313670,201909,10320,7151,3169,7141694.93,3169649.6,10311344.53
313680,201909,41,30,11,29940,10978.78,40918.78
313690,201909,149,111,38,110778,37924,148702
313695,201909,73,57,16,56886,15968,72854
313700,201909,306,246,60,245508.4,59880,305388.4
313710,201909,144,100,44,99800,43912,143712
313720,201909,1100,534,566,533930.4,564869.4,1098799.8
313730,201909,63,43,20,42914,19960,62874
313740,201909,153,125,28,126746,27944,154690
313750,201909,420,310,110,309380,110778,420158
313753,201909,234,173,61,172654,60878,233532
313760,201909,1253,467,786,466066.4,787424.1,1253490.5
313770,201909,363,271,92,270458.5,91816,362274.5
313780,201909,757,398,359,397204,358282,755486
313790,201909,28,27,1,26946,998,27944
313800,201909,143,91,52,91816,51896,143712
313810,201909,74,41,33,40918,32934,73852
313820,201909,1307,647,660,645706.8,659679.75,1305386.55
313830,201909,63,47,16,46906,15968,62874
313835,201909,62,52,10,51896,9980,61876
313840,201909,1656,1022,634,1019957.8,632732.8,1652690.6
313850,201909,195,72,123,71856,122754,194610
313860,201909,472,362,110,361276.4,109780,471056.4
313862,201909,177,118,59,117764,58882,176646
313865,201909,103,81,22,80838,21956,102794
313867,201909,47,37,10,37924,9980,47904
313868,201909,30,19,11,18962,10978,29940
313870,201909,121,64,57,63872,56886,120758
313880,201909,364,233,131,232534,130738,363272
313890,201909,332,179,153,178642.6,152694,331336.6
313900,201909,895,496,399,495008.5,398202.9,893211.4
313910,201909,140,101,39,100798,38922,139720
313920,201909,626,447,179,447104,178642.9,625746.9
313925,201909,31,28,3,27944,2994,30938
313930,201909,837,656,181,654688,180638.95,835326.95
313940,201909,1802,1141,661,1139716,660676.28,1800392.28
313950,201909,927,597,330,595806.8,329340,925146.8
313960,201909,1353,788,565,787422.76,563871.8,1351294.56
313970,201909,131,91,40,90818,40918,131736
313980,201909,217,142,75,142714.5,74850,217564.5
313990,201909,223,152,71,151696,70858,222554
314000,201909,911,618,293,616765.14,292414,909179.14
314010,201909,80,52,28,51896,27944,79840
314015,201909,55,17,38,16966,37924,54890
314020,201909,56,38,18,37924,17964,55888
314030,201909,77,38,39,37924,38922,76846
314040,201909,42,26,16,25948,15968,41916
314050,201909,286,174,112,173652,111776,285428
314053,201909,94,62,32,61876.4,31936,93812.4
314055,201909,299,184,115,183632,114770.4,298402.4
314060,201909,144,124,20,123752.58,19960,143712.58
314070,201909,1052,571,481,569858,481036,1050894
314080,201909,213,138,75,137724,74850.36,212574.36
314085,201909,137,94,43,93812,42914,136726
314090,201909,363,263,100,262474.9,99800,362274.9
314100,201909,479,396,83,395221.74,82838.8,478060.54
314110,201909,730,398,332,398202.4,332334,730536.4
314120,201909,89,52,37,51896,36926,88822
314130,201909,22,12,10,11976,9980,21956
314140,201909,1102,685,417,683630.6,416166,1099796.6
314150,201909,166,104,62,103792,61876,165668
314160,201909,341,259,82,258483.2,81836.6,340319.8
314170,201909,77,61,16,60878,16966,77844
314180,201909,732,647,85,646704.4,84830.5,731534.9
314190,201909,98,61,37,60878,36926,97804
314200,201909,474,325,149,324350.4,148702,473052.4
314210,201909,254,197,57,196606,56886.4,253492.4
314220,201909,309,229,80,228542.4,79840,308382.4
314225,201909,65,47,18,46906,17964,64870
314230,201909,117,54,63,54890,62874,117764
314240,201909,139,106,33,105788,32934,138722
314250,201909,51,30,21,29940,20958,50898
314260,201909,221,109,112,108782,111776,220558
314270,201909,332,265,67,264470,66866,331336
314280,201909,700,397,303,396206.98,302394,698600.98
314290,201909,535,440,95,439121.36,94810,533931.36
314300,201909,369,268,101,267466.5,100798.9,368265.4
314310,201909,1384,941,443,941364.53,442114,1383478.53
314315,201909,36,28,8,27944,7984,35928
314320,201909,599,399,200,398202.4,199600,597802.4
314330,201909,10749,5424,5325,5416149.88,5323335.53,10739485.41
314340,201909,587,273,314,272454,313372.8,585826.8
314345,201909,43,31,12,30938,11976,42914
314350,201909,184,118,66,117764,65868,183632
314360,201909,70,42,28,41916,27944,69860
314370,201909,65,49,16,48902,15968,64870
314380,201909,92,61,31,61876,30938,92814
314390,201909,3290,2131,1159,2127738.6,1157680.6,3285419.2
314400,201909,683,494,189,493013.5,190618,683631.5
314410,201909,465,309,156,309380,156686,466066
314420,201909,17,8,9,7984,8982,16966
314430,201909,2436,903,1533,901196.3,1531930,2433126.3
314435,201909,257,154,103,153692,102794,256486
314437,201909,29,23,6,22954,5988,28942
314440,201909,97,72,25,71856,24950,96806
314450,201909,158,114,44,113772,43912,157684
314460,201909,644,302,342,301396,341316,642712
314465,201909,85,58,27,58882,26946,85828
314467,201909,69,58,11,57884,10978,68862
314470,201909,397,206,191,205589.65,190618,396207.65
314480,201909,1066,525,541,523950,540916,1064866
314490,201909,81,59,22,58882,21956,80838
314500,201909,292,196,96,195608,95808,291416
314505,201909,126,83,43,83832,42914,126746
314510,201909,232,193,39,192614,38922,231536
314520,201909,1261,681,580,679645.2,578841.2,1258486.4
314530,201909,745,600,145,598801.66,144710,743511.66
314535,201909,214,134,80,133732,79840,213572
314537,201909,63,38,25,37924,24950,62874
314540,201909,15,10,5,9980,4990,14970
314545,201909,51,34,17,33932,16966,50898
314550,201909,79,42,37,41916,36926,78842
314560,201909,824,456,368,455088.8,368262,823350.8
314570,201909,21,17,4,16966,3992,20958
314580,201909,13,6,7,5988,6986,12974
314585,201909,26,20,6,19960,5988,25948
314587,201909,81,71,10,70858,9980,80838
314590,201909,570,418,152,417165.7,152694,569859.7
314600,201909,930,607,323,606785.8,323353.03,930138.83
314610,201909,946,508,438,506985.3,437124,944109.3
314620,201909,144,107,37,106786,36926,143712
314625,201909,95,70,25,69860,24950,94810
314630,201909,1198,632,566,630736,564868,1195604
314640,201909,82,55,27,54890,26946,81836
314650,201909,182,104,78,103792,77844,181636
314655,201909,63,46,17,45908,16966,62874
314660,201909,18,15,3,14970,2994,17964
314670,201909,201,155,46,154690.4,45908,200598.4
314675,201909,211,126,85,125748,84830,210578
314690,201909,573,318,255,317364,254490,571854
314700,201909,2317,1263,1054,1260475.6,1051892,2312367.6
314710,201909,1647,975,672,973052.1,672652.4,1645704.5
314720,201909,387,231,156,230538,155688,386226
314730,201909,505,269,236,269461.76,235528.98,504990.74
314740,201909,700,347,353,346306,352294,698600
314750,201909,21,19,2,18962,1996,20958
314760,201909,333,160,173,159680,173652,333332
314770,201909,104,76,28,75848,27944,103792
314780,201909,21,6,15,5988,14970,20958
314790,201909,2333,1489,844,1489019.64,844308,2333327.64
314795,201909,50,42,8,41916.5,7984,49900.5
314800,201909,2860,1697,1163,1694606.21,1160674,2855280.21
314810,201909,1527,877,650,875246,648700.6,1523946.6
314820,201909,100,57,43,56886,43912,100798
314830,201909,212,172,40,171656,39920,211576
314840,201909,86,51,35,50898,34930,85828
314850,201909,342,168,174,167664,173652,341316
314860,201909,690,521,169,519959.13,168662,688621.13
314870,201909,1494,801,693,800396.4,693610,1494006.4
314875,201909,59,51,8,50898,7984,58882
314880,201909,45,31,14,30938,13972,44910
314890,201909,54,33,21,32934,20958,53892
314900,201909,32,25,7,24950,6986,31936
314910,201909,245,168,77,167664,77844,245508
314915,201909,149,132,17,131736,16966,148702
314920,201909,108,66,42,65868,41916,107784
314930,201909,1059,539,520,538920.4,519958,1058878.4
314940,201909,47,37,10,36926,9980,46906
314950,201909,34,24,10,23952,9980,33932
314960,201909,47,36,11,35928,10978,46906
314970,201909,142,73,69,72854,68862,141716
314980,201909,302,194,108,193612,107784,301396
314990,201909,463,258,205,259480,205588,465068
314995,201909,203,62,141,61876,142714,204590
315000,201909,90,71,19,70858,18962,89820
315010,201909,45,29,16,28942,15968,44910
315015,201909,168,136,32,135728,31936,167664
315020,201909,71,60,11,59880,10978,70858
315030,201909,113,88,25,87824,24950,112774
315040,201909,70,49,21,48902,20958,69860
315050,201909,183,112,71,111776,70858,182634
315053,201909,41,36,5,35928,4990,40918
315057,201909,94,77,17,76846,16966,93812
315060,201909,72,62,10,61876.52,9980,71856.52
315070,201909,106,60,46,59880,45908,105788
315080,201909,373,303,70,302394,69860,372254
315090,201909,107,62,45,61876,44910,106786
315100,201909,81,40,41,39920,40918,80838
315110,201909,272,148,124,147704,123752,271456
315120,201909,1658,833,825,832332,824348.68,1656680.68
315130,201909,346,250,96,249500,95808,345308
315140,201909,512,301,211,300398.4,211576.8,511975.2
315150,201909,954,458,496,458082,495008.4,953090.4
315160,201909,215,109,106,108782,105788,214570
315170,201909,319,210,109,209580.4,108782,318362.4
315180,201909,3290,1394,1896,1394208.4,1897201.1,3291409.5
315190,201909,316,187,129,186626.2,128742,315368.2
315200,201909,1235,727,508,726544,506984,1233528
315210,201909,1622,935,687,933130.6,687622.2,1620752.8
315213,201909,40,23,17,22954,16966,39920
315217,201909,211,168,43,167664,42914,210578
315220,201909,1550,1202,348,1199597.58,350298,1549895.58
315230,201909,174,127,47,126746.4,46906,173652.4
315240,201909,423,273,150,272454,149700.98,422154.98
315250,201909,2526,1268,1258,1265464,1257480.8,2522944.8
315260,201909,140,86,54,85828,53892,139720
315270,201909,131,91,40,90818,39920,130738
315280,201909,660,431,229,430138.2,228542,658680.2
315290,201909,194,119,75,118762,74850,193612
315300,201909,73,54,19,53892,18962,72854
315310,201909,71,64,7,63872,6986,70858
315320,201909,167,97,70,96806,69860,166666
315330,201909,56,47,9,46906,8982,55888
315340,201909,383,279,104,278442,103792,382234
315350,201909,151,93,58,92814,57884,150698
315360,201909,91,49,42,48902,41916,90818
315370,201909,56,34,22,33932,21956,55888
315380,201909,11,8,3,7984,2994,10978
315390,201909,66,17,49,16966,48902.4,65868.4
315400,201909,855,644,211,642713.1,210578,853291.1
315410,201909,347,211,136,210578.4,135729.4,346307.8
315415,201909,61,46,15,45908,15968,61876
315420,201909,200,152,48,151696.4,47904,199600.4
315430,201909,655,385,270,385228.4,270458.6,655687.0
315440,201909,92,65,27,64870,26946,91816
315445,201909,238,193,45,192614,44910,237524
315450,201909,184,140,44,139720,43912,183632
315460,201909,3747,1923,1824,1920153.38,1822348.98,3742502.36
315470,201909,41,17,24,16966,23952,40918
315480,201909,62,23,39,22954,38922,61876
315490,201909,643,403,240,402194,239520,641714
315500,201909,22,15,7,14970,6986,21956
315510,201909,153,103,50,102794,49900,152694
315520,201909,70,63,7,62874,6986,69860
315530,201909,50,26,24,25948,23952,49900
315540,201909,235,158,77,157684,76846,234530
315550,201909,181,145,36,144710,35928,180638
315560,201909,732,592,140,590816.4,139720,730536.4
315570,201909,305,160,145,159681.53,144710.6,304392.13
315580,201909,694,461,233,460078,232534,692612
315590,201909,201,107,94,106786,93812,200598
315600,201909,304,228,76,227544,75848,303392
315610,201909,96,51,45,50898,45908,96806
315620,201909,35,27,8,26946,7984,34930
315630,201909,134,89,45,88822,44910,133732
315640,201909,65,42,23,41916,22954,64870
315645,201909,50,35,15,34930,14970,49900
315650,201909,169,124,45,123752.8,44910,168662.8
315660,201909,457,203,254,202594,253492,456086
315670,201909,2381,1190,1191,1189617.6,1190615.96,2380233.56
315680,201909,851,588,263,586824,262474,849298
315690,201909,678,472,206,471057.75,205588,676645.75
315700,201909,1883,1008,875,1006983.27,874248,1881231.27
315710,201909,340,101,239,100798,238522,339320
315720,201909,442,282,160,281436.4,160678,442114.4
315725,201909,199,159,40,158682.4,39920,198602.4
315727,201909,40,22,18,21956,17964,39920
315730,201909,49,47,2,46906,1996,48902
315733,201909,87,60,27,59880,26946,86826
315737,201909,50,38,12,37924,11976,49900
315740,201909,35,28,7,28942,6986,35928
315750,201909,155,118,37,117764,36926,154690
315760,201909,43,33,10,32934,9980,42914
315765,201909,119,75,44,75848,44910,120758
315770,201909,227,142,85,141716,84830.4,226546.4
315780,201909,3375,1765,1610,1761471.09,1610773.15,3372244.24
315790,201909,218,172,46,171656,45908,217564
315800,201909,284,204,80,203592,79840,283432
315810,201909,97,58,39,57884,38922.4,96806.4
315820,201909,746,542,204,540917.2,204590,745507.2
315830,201909,133,79,54,78842,54890,133732
315840,201909,86,59,27,58882,26946,85828
315850,201909,257,189,68,188622.5,67864,256486.5
315860,201909,12,4,8,3992,7984,11976
315870,201909,37,29,8,28942,7984,36926
315880,201909,104,67,37,66866,36926,103792
315890,201909,88,66,22,65868,21956,87824
315895,201909,437,297,140,297404.5,139720.8,437125.3
315900,201909,69,35,34,34930,33932,68862
315910,201909,37,24,13,23952,12974,36926
315920,201909,170,108,62,107784,61876.3,169660.3
315930,201909,45,17,28,16966,27944,44910
315935,201909,140,107,33,107784.8,32934.98,140719.78
315940,201909,99,73,26,73852,25948,99800
315950,201909,43,32,11,31936,10978,42914
315960,201909,538,260,278,260478.4,278442.4,538920.8
315970,201909,35,28,7,27944,6986,34930
315980,201909,680,337,343,336326.1,344310,680636.1
315990,201909,248,148,100,147704,101797.38,249501.38
316000,201909,54,36,18,35928,17964,53892
316010,201909,78,69,9,68862,8982,77844
316020,201909,115,98,17,97804,16966,114770
316030,201909,396,215,181,215568,180638.9,396206.9
316040,201909,511,220,291,220558.4,290418.4,510976.8
316045,201909,62,55,7,54890,6986,61876
316050,201909,16,14,2,13972,1996,15968
316060,201909,97,64,33,63872,32934,96806
316070,201909,1089,706,383,705586.5,382234,1087820.5
316080,201909,105,70,35,70858,34930,105788
316090,201909,38,22,16,21956,15968,37924
316095,201909,72,63,9,62874,8982,71856
316100,201909,310,180,130,179640.5,129740,309380.5
316105,201909,39,27,12,26946,11976,38922
316110,201909,1870,1509,361,1506980.55,361276,1868256.55
316120,201909,80,59,21,59880,20958,80838
316130,201909,121,93,28,93812.4,27944,121756.4
316140,201909,32,24,8,23952,7984,31936
316150,201909,202,139,63,139720,62874,202594
316160,201909,77,47,30,46906,29940,76846
316165,201909,66,52,14,51896.6,13972.6,65869.2
316170,201909,190,127,63,126746,62874,189620
316180,201909,196,86,110,85828,109780.4,195608.4
316190,201909,133,98,35,97804,34930,132734
316200,201909,658,372,286,371256,286426,657682
316210,201909,767,514,253,513211.65,252494,765705.65
316220,201909,114,75,39,74850,38922,113772
316225,201909,25,15,10,14970,9980,24950
316230,201909,34,19,15,18962,14970,33932
316240,201909,641,516,125,516964,125748,642712
316245,201909,129,109,20,108782,19960,128742
316250,201909,1550,1071,479,1069857.66,478042.98,1547900.64
316255,201909,120,97,23,97804,22954,120758
316257,201909,178,96,82,95808,81836,177644
316260,201909,189,134,55,133732.5,54890.38,188622.88
316265,201909,27,19,8,18962,7984,26946
316270,201909,684,484,200,483032.6,199600.84,682633.44
316280,201909,543,338,205,337325.03,206587.4,543912.43
316290,201909,725,486,239,485028.66,238522,723550.66
316292,201909,498,203,295,204590,294410,499000
316294,201909,102,60,42,59880,41916,101796
316295,201909,298,133,165,132735.36,164670,297405.36
316300,201909,99,73,26,72854.4,25948,98802.4
316310,201909,36,19,17,18962,16966,35928
316320,201909,46,27,19,26946,18962,45908
316330,201909,131,87,44,86826.5,43912,130738.5
316340,201909,141,98,43,97804,42914,140718
316350,201909,194,138,56,137724.3,55888,193612.3
316360,201909,23,14,9,13972,8982,22954
316370,201909,1083,571,512,569858.9,510976,1080834.9
316380,201909,121,93,28,92814,27944,120758
316390,201909,117,86,31,85828,30938,116766
316400,201909,133,103,30,102794,29940,132734
316410,201909,301,217,84,216566,83832,300398
316420,201909,206,145,61,144710,60878,205588
316430,201909,151,79,72,78842,71856,150698
316440,201909,95,47,48,46906,47904,94810
316443,201909,38,36,2,35928,1996,37924
316447,201909,65,51,14,50898,13972,64870
316450,201909,224,171,53,170658,52894,223552
316460,201909,71,27,44,26946,44910,71856
316470,201909,1635,1216,419,1214559.77,421156,1635715.77
316480,201909,12,10,2,9980,1996,11976
316490,201909,17,7,10,6986,9980,16966
316500,201909,152,102,50,101796,49900,151696
316510,201909,157,123,34,122754,33932,156686
316520,201909,196,124,72,123752,71856,195608
316530,201909,157,110,47,109780,46906,156686
316540,201909,138,75,63,74850,62874,137724
316550,201909,137,93,44,92814,43912,136726
316553,201909,281,133,148,132734,148702.72,281436.72
316555,201909,36,31,5,30938,4990,35928
316556,201909,11,8,3,7984,2994,10978
316557,201909,19,16,3,15968,2994,18962
316560,201909,70,52,18,51896,17964,69860
316570,201909,226,206,20,205588,19960,225548
316580,201909,19,16,3,15968,2994,18962
316590,201909,105,89,16,88822,15968,104790
316600,201909,178,147,31,148369.33,30938,179307.33
316610,201909,68,51,17,50898,16966,67864
316620,201909,143,111,32,110778,31936,142714
316630,201909,42,33,9,32934,8982,41916
316640,201909,21,14,7,13972,6986,20958
316650,201909,78,61,17,60878,16966,77844
316660,201909,8,3,5,2994,4990,7984
316670,201909,439,153,286,152694.96,285428,438122.96
316680,201909,154,109,45,108782,44910.6,153692.6
316690,201909,187,120,67,119760,66866,186626
316695,201909,64,56,8,55888,7984,63872
316700,201909,16,10,6,9980,5988,15968
316710,201909,758,568,190,567862.5,189620,757482.5
316720,201909,4880,2478,2402,2474046.25,2399193.79,4873240.04
316730,201909,17,16,1,15968,998,16966
316740,201909,116,75,41,74850,40918,115768
316750,201909,19,12,7,11976,6986,18962
316760,201909,314,254,60,254490,59880,314370
316770,201909,142,79,63,78842,63872,142714
316780,201909,73,46,27,45908,26946,72854
316790,201909,54,40,14,39920,13972,53892
316800,201909,1727,1080,647,1079836,647703,1727539
316805,201909,20,12,8,11976,7984,19960
316810,201909,69,46,23,45908,22954,68862
316820,201909,42,21,21,20958,20958,41916
316830,201909,93,46,47,45908,46906,92814
316840,201909,511,310,201,309380.4,200598,509978.4
316850,201909,339,226,113,225548,112774,338322
316860,201909,5929,2666,3263,2662667.36,3257472.3,5920139.66
316870,201909,1495,994,501,992014.7,499999.2,1492013.9
316880,201909,126,64,62,64870,62874,127744
316890,201909,244,166,78,165668,77844,243512
316900,201909,431,300,131,299400.36,130738,430138.36
316905,201909,21,10,11,9980,10978,20958
316910,201909,60,25,35,24950,34930,59880
316920,201909,133,105,28,104790,27944,132734
316930,201909,1863,978,885,978040.8,884228.3,1862269.1
316935,201909,894,550,344,550896.64,343312.4,894209.04
316940,201909,1092,634,458,633730.8,457084.4,1090815.2
316950,201909,177,90,87,89820.4,86826,176646.4
316960,201909,1106,623,483,622752.4,483032.4,1105784.8
316970,201909,656,519,137,517962,136726,654688
316980,201909,111,65,46,64870,45908,110778
316990,201909,2195,1483,712,1481032.34,711575.5,2192607.84
317000,201909,325,251,74,250498,73852,324350
317005,201909,237,172,65,171656,64870,236526
317010,201909,6327,3558,2769,3554880.99,2769450.4,6324331.39
317020,201909,16147,7209,8938,7203578.2,8933114.3,16136692.5
317030,201909,80,30,50,29940,49900,79840
317040,201909,3096,1945,1151,1942110.2,1149696.6,3091806.8
317043,201909,73,54,19,53892,18962,72854
317047,201909,31,16,15,15968,14970.99,30938.99
317050,201909,173,132,41,131736,40918,172654
317052,201909,130,100,30,100798,29940,130738
317057,201909,180,140,40,139720,39920,179640
317060,201909,62,42,20,41916,19960,61876
317065,201909,56,45,11,44910,10978,55888
317070,201909,1956,930,1026,928141.5,1025944.8,1954086.3
317075,201909,108,60,48,59880,47904,107784
317080,201909,880,462,418,462074.9,418162.6,880237.5
317090,201909,646,523,123,522952,122754,645706
317100,201909,425,324,101,324350,100798,425148
317103,201909,109,92,17,91816,16966,108782
317107,201909,43,38,5,37924,4990,42914
317110,201909,109,48,61,47904,60878,108782
317115,201909,47,42,5,41916,4990,46906
317120,201909,1856,956,900,955086.8,899198.4,1854285.2
317130,201909,1970,1315,655,1314368,653690,1968058
317140,201909,13,12,1,11976,998,12974
317150,201909,262,159,103,158682.4,102794,261476.4
317160,201909,316,234,82,233533.03,81836,315369.03
317170,201909,211,148,63,147704,62874,210578
317180,201909,441,319,122,318362,121756,440118
317190,201909,260,180,80,179640,79840,259480
317200,201909,809,571,238,570859.76,237524,808383.76
317210,201909,184,102,82,101796,81836,183632
317220,201909,23,12,11,11976,10978,22954
320010,201909,597,444,153,443112.5,152694,595806.5
320013,201909,126,93,33,92814,32934,125748
320016,201909,272,171,101,170658,100798,271456
320020,201909,704,422,282,423152.8,281436,704588.8
320030,201909,143,104,39,103792,39920.4,143712.4
320035,201909,141,108,33,107784,32934,140718
320040,201909,491,259,232,259480,231536,491016
320050,201909,104,79,25,78842,24950,103792
320060,201909,1618,789,829,791417.56,830339.74,1621757.30
320070,201909,102,71,31,70858,30938,101796
320080,201909,793,464,329,463704.96,329340,793044.96
320090,201909,1238,867,371,869258,372254.4,1241512.4
320100,201909,326,190,136,189620,135728,325348
320110,201909,118,75,43,75849.1,43912.4,119761.5
320115,201909,107,89,18,88822,17964,106786
320120,201909,3376,1881,1495,1878237.86,1497001.77,3375239.63
320130,201909,7376,3456,3920,3453099.47,3920177.71,7373277.18
320140,201909,429,285,144,284430.6,144710.4,429141.0
320150,201909,2023,1169,854,1167662.55,854288,2021950.55
320160,201909,657,299,358,298402.99,357285.79,655688.78
320170,201909,111,88,23,88822,22954,111776
320180,201909,52,30,22,29940,21956,51896
320190,201909,244,162,82,161676,81836.4,243512.4
320200,201909,54,45,9,44910,8982,53892
320210,201909,877,490,387,489020.8,389221.76,878242.56
320220,201909,300,111,189,110778,189620,300398
320225,201909,90,73,17,72854,16966,89820
320230,201909,591,385,206,384230.6,205588,589818.6
320240,201909,3149,1596,1553,1593807.6,1553887.62,3147695.22
320245,201909,464,322,142,321356.4,141716,463072.4
320250,201909,228,119,109,118762,108782,227544
320255,201909,139,111,28,110778.16,27944.7,138722.86
320260,201909,191,138,53,137724,52894,190618
320265,201909,163,131,32,130738,31936,162674
320270,201909,156,125,31,124750,30938,155688
320280,201909,991,590,401,588821.13,400198,989019.13
320290,201909,61,53,8,52894,7984,60878
320300,201909,566,393,173,392215.34,172656.04,564871.38
320305,201909,670,369,301,369260,301397,670657
320310,201909,216,122,94,122754.76,93812,216566.76
320313,201909,320,161,159,160678.9,158682.4,319361.3
320316,201909,113,89,24,88822,23952,112774
320320,201909,3413,1590,1823,1587819.84,1826341.97,3414161.81
320330,201909,256,195,61,195608,60878,256486
320332,201909,852,513,339,511976.5,340318.9,852295.4
320334,201909,243,151,92,150698.4,92814,243512.4
320335,201909,142,104,38,103792,37924,141716
320340,201909,550,383,167,382234.9,167664,549898.9
320350,201909,976,421,555,423153.29,553891.2,977044.49
320360,201909,167,91,76,90818,75848,166666
320370,201909,243,186,57,185628.56,57884.4,243512.96
320380,201909,282,198,84,197604.8,83832,281436.8
320390,201909,1158,705,453,706584.92,452094.8,1158679.72
320400,201909,305,226,79,225549.4,78842,304391.4
320405,201909,942,409,533,408183.89,531936.39,940120.28
320410,201909,964,499,465,499000,465069.3,964069.3
320420,201909,477,245,232,245509.3,231536,477045.3
320425,201909,190,105,85,104790,84830,189620
320430,201909,386,221,165,220558.5,164670,385228.5
320435,201909,162,111,51,110778,50898,161676
320440,201909,198,117,81,116766,81836,198602
320450,201909,127,74,53,73852,52894,126746
320455,201909,245,201,44,200598.4,43912,244510.4
320460,201909,263,164,99,163672,98802,262474
320465,201909,118,82,36,82834,35928,118762
320470,201909,682,438,244,437125.99,244510.99,681636.98
320480,201909,185,118,67,117764,66866,184630
320490,201909,3061,1538,1523,1534928.19,1521958.4,3056886.59
320495,201909,103,63,40,62874,39920.8,102794.8
320500,201909,9659,4863,4796,4856282.65,4793406.68,9649689.33
320501,201909,541,274,267,273452,266466,539918
320503,201909,288,206,82,205588,81836,287424
320506,201909,265,191,74,190618,73852,264470
320510,201909,991,469,522,469060,520957.38,990017.38
320515,201909,84,69,15,68862,14970,83832
320517,201909,213,154,59,153692,58882,212574
320520,201909,6798,3030,3768,3028936.4,3768455.75,6797392.15
320530,201909,5818,3001,2817,2998997.55,2817359.11,5816356.66
330010,201909,3046,1592,1454,1592810.87,1458078,3050888.87
330015,201909,160,68,92,67864.56,92814,160678.56
330020,201909,3595,1592,2003,1589150.1,2000990.4,3590140.5
330022,201909,240,128,112,127744,111776,239520
330023,201909,562,197,365,196606,365268,561874
330025,201909,567,115,452,114770,451096,565866
330030,201909,1907,1239,668,1237522.52,666664.4,1904186.92
330040,201909,2399,1272,1127,1269458.1,1125745.3,2395203.4
330045,201909,8317,2709,5608,2704580.8,5599779.6,8304360.4
330050,201909,893,570,323,569858,322354,892212
330060,201909,940,574,366,572852.9,366266,939118.9
330070,201909,3440,1315,2125,1317361.74,2122747.94,3440109.68
330080,201909,1527,691,836,689619.04,835326,1524945.04
330090,201909,377,223,154,222554,154690.4,377244.4
330093,201909,264,122,142,121756,141717.88,263473.88
330095,201909,89,49,40,48902,40918,89820
330100,201909,9415,4886,4529,4884216.77,4529923.1,9414139.87
330110,201909,486,208,278,208582.7,278442,487024.7
330115,201909,548,291,257,291416,256486,547902
330120,201909,375,193,182,192614,182635.6,375249.6
330130,201909,1526,399,1127,398202.6,1125744.96,1523947.56
330140,201909,600,316,284,315368.94,283432,598800.94
330150,201909,502,286,216,285428,215568,500996
330160,201909,207,126,81,125748,80838,206586
330170,201909,26539,9361,17178,9348274.16,17172599.15,26520873.31
330180,201909,237,150,87,150698,86826,237524
330185,201909,904,331,573,330338.98,571855.92,902194.90
330187,201909,323,103,220,102794,219560,322354
330190,201909,5556,2218,3338,2216561.06,3333321.1,5549882.16
330200,201909,4646,1439,3207,1438120.24,3208571,4646691.24
330205,201909,424,250,174,249500,173652.4,423152.4
330210,201909,998,619,379,618762.84,379242.18,998005.02
330220,201909,2602,1576,1026,1573847.28,1026942.4,2600789.68
330225,201909,557,295,262,295408,261476,556884
330227,201909,2331,744,1587,742512.4,1585823.5,2328335.9
330230,201909,220,128,92,127744,91816,219560
330240,201909,3622,1879,1743,1876246.08,1742543.02,3618789.10
330245,201909,153,72,81,71856.34,81836,153692.34
330250,201909,6667,3476,3191,3470048.35,3191607.71,6661656.06
330260,201909,551,155,396,154690,396206,550896
330270,201909,3361,1223,2138,1221552.6,2137718.8,3359271.4
330280,201909,439,282,157,281437.2,156686.98,438124.18
330285,201909,7035,2304,4731,2302387.5,4732518.8,7034906.3
330290,201909,634,236,398,235528,397204.4,632732.4
330300,201909,764,507,257,506985.1,256486.94,763472.04
330310,201909,437,253,184,252494.9,183632,436126.9
330320,201909,7914,3026,4888,3021946.8,4890201.6,7912148.4
330330,201909,8734,3512,5222,3506975.08,5233523.46,8740498.54
330340,201909,2715,1615,1100,1613766.4,1098798,2712564.4
330350,201909,18001,7199,10802,7190597.86,10796373.78,17986971.64
330360,201909,2296,1134,1162,1132730.8,1160674.98,2293405.78
330370,201909,1025,532,493,530936.7,492014,1022950.7
330380,201909,855,371,484,371256,484031.21,855287.21
330385,201909,621,328,293,328342.5,292414,620756.5
330390,201909,5413,2975,2438,2974042.8,2443104.4,5417147.2
330395,201909,306,189,117,188622,116766.7,305388.7
330400,201909,702,384,318,383233,317364,700597
330410,201909,504,367,137,366267.7,137724.4,503992.1
330411,201909,254,141,113,140718.62,113772,254490.62
330412,201909,242,98,144,97804.8,143712,241516.8
330414,201909,5433,2273,3160,2272447.48,3160666.4,5433113.88
330415,201909,570,261,309,261477.34,308382.6,569859.94
330420,201909,2228,1172,1056,1170655.42,1055885.38,2226540.80
330430,201909,1747,829,918,827342.8,918162.4,1745505.2
330440,201909,275,137,138,136726,138722,275448
330450,201909,118,51,67,50898,67864,118762
330452,201909,1822,851,971,849300.52,971054,1820354.52
330455,201909,108293,39530,68763,39502942.7,68822111.25,108325053.95
330460,201909,258,107,151,106786,150698.94,257484.94
330470,201909,1221,671,550,670657.3,550897.5,1221554.8
330475,201909,1397,376,1021,375248,1018958,1394206
330480,201909,786,427,359,426146,359280.6,785426.6
330490,201909,13770,4767,9003,4760461.1,9000969.26,13761430.36
330500,201909,1360,610,750,608780,751494.46,1360274.46
330510,201909,10825,3810,7015,3805376.52,7012950.3,10818326.82
330513,201909,102,51,51,50898,50898,101796
330515,201909,822,340,482,340318.3,481037.2,821355.5
330520,201909,2472,919,1553,919158.54,1551890,2471048.54
330530,201909,210,114,96,113772.5,95808.6,209581.1
330540,201909,370,181,189,181636.4,188622,370258.4
330550,201909,2854,1029,1825,1027940.68,1825342.8,2853283.48
330555,201909,816,318,498,317364,498002,815366
330560,201909,644,213,431,213572,430138.94,643710.94
330570,201909,265,192,73,191616,72854,264470
330575,201909,765,310,455,309380,454091.4,763471.4
330580,201909,3353,1888,1465,1888218.2,1462070.4,3350288.6
330590,201909,299,150,149,150698,148702.98,299400.98
330600,201909,1149,736,413,734528.4,414170,1148698.4
330610,201909,1566,859,707,858282.2,705588.3,1563870.5
330615,201909,202,154,48,153692,47904,201596
330620,201909,1063,437,626,436126.6,624748,1060874.6
330630,201909,4010,2564,1446,2562867.16,1446102.5,4008969.66
350010,201909,591,404,187,403193.22,189620,592813.22
350020,201909,46,22,24,21956,23952,45908
350030,201909,507,320,187,320358.4,186626.4,506984.8
350040,201909,122,47,75,46906,74850,121756
350050,201909,299,160,139,160678,138722,299400
350055,201909,90,47,43,46906,42914,89820
350060,201909,75,28,47,27944,47904,75848
350070,201909,806,481,325,480063.19,326359.12,806422.31
350075,201909,68,47,21,46906,20958,67864
350080,201909,48,28,20,27944,19960,47904
350090,201909,88,50,38,49900,37924,87824
350100,201909,291,180,111,179640,110778,290418
350110,201909,60,40,20,39920,19960,59880
350115,201909,157,95,62,94810,61876,156686
350120,201909,105,70,35,69860,34930,104790
350130,201909,342,159,183,158682.58,183632.98,342315.56
350140,201909,40,27,13,26946,12974,39920
350150,201909,70,54,16,53892,15968,69860
350160,201909,2504,995,1509,994012.86,1505988.93,2500001.79
350170,201909,392,236,156,235529.14,155688.4,391217.54
350180,201909,174,99,75,98802,74850,173652
350190,201909,998,530,468,528941.03,467064.4,996005.43
350200,201909,69,25,44,24950,43912,68862
350210,201909,1268,717,551,716567.02,549898.63,1266465.65
350220,201909,666,566,100,564868.63,99800,664668.63
350230,201909,77,54,23,53892,22954,76846
350240,201909,60,43,17,42914,16966,59880
350250,201909,1153,565,588,564869.4,588821.1,1153690.5
350260,201909,91,67,24,66866,23952,90818
350270,201909,843,564,279,564868.42,280438.4,845306.82
350275,201909,300,127,173,126746,173652,300398
350280,201909,4603,2352,2251,2349298.87,2250494.95,4599793.82
350290,201909,421,200,221,199600,221556.4,421156.4
350300,201909,56,29,27,29940,26946,56886
350310,201909,95,59,36,59880,35928,95808
350315,201909,39,24,15,23952,14970,38922
350320,201909,3261,1605,1656,1605782.9,1659674.6,3265457.5
350330,201909,1656,898,758,898203.23,757483.2,1655686.43
350335,201909,18,13,5,12974,4990,17964
350340,201909,125,60,65,59880,65868.3,125748.3
350350,201909,90,46,44,45908,43912,89820
350360,201909,125,84,41,83832.99,40918,124750.99
350370,201909,84,46,38,46906.63,37924,84830.63
350380,201909,773,333,440,332335.03,440119.2,772454.23
350390,201909,1502,602,900,600797.43,898200.4,1498997.83
350395,201909,26,21,5,21956,4990,26946
350400,201909,1674,877,797,877245.59,797403.62,1674649.21
350410,201909,2414,1082,1332,1079836,1331332.63,2411168.63
350420,201909,239,145,94,145709.03,93812,239521.03
350430,201909,75,46,29,45908,28942,74850
350440,201909,147,107,40,106786.4,40918,147704.4
350450,201909,1635,990,645,989020.67,645707.2,1634727.87
350460,201909,341,124,217,123752,216566,340318
350470,201909,18,12,6,11976,5988,17964
350480,201909,168,94,74,93812,74850,168662
350490,201909,237,119,118,118762,117764,236526
350500,201909,48,20,28,19960,27944,47904
350510,201909,161,109,52,109780,51896,161676
350520,201909,455,223,232,222554,232534,455088
350530,201909,445,209,236,208582,235528,444110
350535,201909,78,64,14,63872,13972,77844
350540,201909,389,194,195,193612,194610,388222
350550,201909,2740,1623,1117,1623748.91,1117765.39,2741514.30
350560,201909,651,456,195,456086.63,195608,651694.63
350570,201909,4033,1707,2326,1703587.63,2324344.53,4027932.16
350580,201909,372,173,199,172654,199600.99,372254.99
350590,201909,894,492,402,491016.4,401196,892212.4
350600,201909,6150,3035,3115,3036920.35,3116757.37,6153677.72
350610,201909,1523,804,719,804389.26,718560.98,1522950.24
350620,201909,33,22,11,21956,10978,32934
350630,201909,232,131,101,130738.63,100798.63,231537.26
350635,201909,923,382,541,381236.4,543910.8,925147.2
350640,201909,125,95,30,94810,29940,124750
350650,201909,1873,1240,633,1242510.58,632732.98,1875243.56
350660,201909,737,323,414,323352,413172.99,736524.99
350670,201909,306,147,159,146706,158682,305388
350680,201909,180,94,86,94810,85828.8,180638.8
350690,201909,198,101,97,100798,96806,197604
350700,201909,755,365,390,364270.4,391216,755486.4
350710,201909,358,133,225,132734,224550,357284
350715,201909,55,44,11,43912,10978,54890
350720,201909,16,11,5,10978,4990,15968
350730,201909,45,28,17,27944,16966,44910
350740,201909,208,118,90,117764,89820,207584
350745,201909,20,10,10,9980.44,9980,19960.44
350750,201909,2171,1360,811,1357282.38,809378,2166660.38
350760,201909,3717,1644,2073,1644704.66,2072846,3717550.66
350770,201909,62,45,17,44910,17964,62874
350775,201909,46,33,13,32934,12974.98,45908.98
350780,201909,437,222,215,222554,215568.4,438122.4
350790,201909,370,157,213,156686,212574,369260
350800,201909,452,269,183,268462,182634,451096
350810,201909,508,416,92,415168.93,92814,507982.93
350820,201909,89,55,34,54890,33932,88822
350830,201909,81,43,38,43912,37924,81836
350840,201909,767,318,449,318362.4,448103.38,766465.78
350850,201909,1738,994,744,994008.5,742514.95,1736523.45
350860,201909,588,338,250,338324.19,249500,587824.19
350870,201909,435,294,141,293412,140718,434130
350880,201909,288,159,129,158682.5,128742,287424.5
350890,201909,41,28,13,27944,12974,40918
350900,201909,1426,457,969,457084.7,968060.63,1425145.33
350910,201909,24,14,10,13972,9980,23952
350920,201909,639,344,295,344310,295408,639718
350925,201909,1210,646,564,644708.78,564869.2,1209577.98
350930,201909,99,61,38,60878,37924,98802
350940,201909,721,402,319,402194.38,321356,723550.38
350945,201909,109,79,30,78842,29940,108782
350950,201909,16092,7656,8436,7649675.08,8435102.41,16084777.49
350960,201909,1285,601,684,600796.4,684629.39,1285425.79
350970,201909,1098,578,520,577736.03,520957.2,1098693.23
350980,201909,92,61,31,60878,30938,91816
350990,201909,375,138,237,137724,237524,375248
350995,201909,36,16,20,15968,19960,35928
351000,201909,630,441,189,440119.26,188622,628741.26
351010,201909,50,31,19,30938,18962,49900
351015,201909,51,36,15,35928,14970,50898
351020,201909,1605,963,642,962072.99,640716,1602788.99
351030,201909,342,232,110,231536,109780,341316
351040,201909,860,458,402,458082.48,401196.11,859278.59
351050,201909,3257,1506,1751,1503991.31,1748503.5,3252494.81
351060,201909,5036,2032,3004,2033925.96,3001988.56,5035914.52
351070,201909,410,256,154,255489.6,154690,410179.6
351080,201909,773,557,216,557882,216566,774448
351090,201909,52,23,29,23952,28942,52894
351100,201909,431,249,182,248502.68,181636,430138.68
351110,201909,2061,996,1065,996015.96,1065882.98,2061898.94
351120,201909,67,35,32,34930,31936,66866
351130,201909,176,59,117,58882,116766,175648
351140,201909,330,227,103,227544,102794,330338
351150,201909,418,226,192,226546.3,191616.4,418162.7
351160,201909,265,182,83,181636.4,83832,265468.4
351170,201909,179,99,80,99800,79840,179640
351190,201909,86,59,27,58882,26946,85828
351200,201909,362,246,116,245508.4,116766,362274.4
351210,201909,117,61,56,60878,57884,118762
351220,201909,530,318,212,318363.76,211576,529939.76
351230,201909,274,194,80,193612,79840,273452
351240,201909,224,105,119,104790,119760,224550
351250,201909,75,53,22,52894.53,21956,74850.53
351260,201909,152,113,39,112774,38922,151696
351270,201909,46,19,27,18962,26946,45908
351280,201909,1030,469,561,469061.26,564870.01,1033931.27
351290,201909,235,107,128,106786,127744.4,234530.4
351300,201909,3665,1691,1974,1690536.22,1975043.62,3665579.84
351310,201909,760,388,372,388222,372254.98,760476.98
351320,201909,116,69,47,68862,46906,115768
351330,201909,38,24,14,23952,13972,37924
351340,201909,1222,739,483,737523,485030.95,1222553.95
351350,201909,2499,1461,1038,1461073.4,1041912,2502985.4
351360,201909,774,383,391,383232,391216,774448
351370,201909,389,195,194,194610.4,193612,388222.4
351380,201909,9077,4113,4964,4108772.13,4963059.4,9071831.53
351385,201909,28,17,11,16966,10978,27944
351390,201909,285,215,70,214570.54,70858,285428.54
351400,201909,67,42,25,41916,24952.94,66868.94
351410,201909,443,281,162,280438.64,165668,446106.64
351420,201909,60,49,11,48902,10978,59880
351430,201909,66,36,30,35928,29940,65868
351440,201909,789,554,235,554889.93,234530,789419.93
351450,201909,259,131,128,130738,128742,259480
351460,201909,115,54,61,53892,60878,114770
351470,201909,133,72,61,72854,60878,133732
351480,201909,520,296,224,295408.97,223552,518960.97
351490,201909,293,108,185,107784,184630,292414
351492,201909,31,22,9,21956,8982,30938
351495,201909,26,19,7,18962,6986,25948
351500,201909,3565,1503,2062,1501991.94,2060871.36,3562863.30
351510,201909,1870,768,1102,768460.8,1105784.4,1874245.2
351512,201909,20,16,4,15968,3992,19960
351515,201909,193,112,81,111776,80838.96,192614.96
351518,201909,773,481,292,481036.99,295408,776444.99
351519,201909,73,46,27,45908,26946,72854
351520,201909,153,93,60,92814,59880,152694
351530,201909,23,15,8,14970,7984,22954
351535,201909,130,74,56,73852,55888,129740
351540,201909,454,327,127,327345.05,126746,454091.05
351550,201909,1393,832,561,832334.46,561874,1394208.46
351560,201909,70,40,30,39920,29940,69860
351565,201909,8,6,2,5988,1996,7984
351570,201909,2618,1347,1271,1346304.38,1268460.97,2614765.35
351580,201909,38,34,4,33932,3992,37924
351590,201909,65,43,22,42914,21956,64870
351600,201909,196,146,50,145708,49900,195608
351610,201909,56,25,31,24950,30938,55888
351620,201909,5854,3300,2554,3298394.67,2552885.26,5851279.93
351630,201909,2667,1365,1302,1363268.9,1299396,2662664.9
351640,201909,1864,890,974,888220.49,973051.03,1861271.52
351650,201909,31,26,5,26946,4990,31936
351660,201909,139,90,49,89820,48902,138722
351670,201909,710,441,269,440119.8,271456,711575.8
351680,201909,72,59,13,58882,12974,71856
351685,201909,30,17,13,16966,12974,29940
351690,201909,306,213,93,212574.45,92814,305388.45
351700,201909,158,112,46,112774.4,45908,158682.4
351710,201909,68,47,21,46906,20958,67864
351720,201909,129,68,61,67864,60878,128742
351730,201909,100,69,31,68862.63,30938.63,99801.26
351740,201909,722,472,250,473054.27,250498,723552.27
351750,201909,355,148,207,147704,206586,354290
351760,201909,777,588,189,586824,189620,776444
351770,201909,307,263,44,262474.03,43912,306386.03
351780,201909,158,91,67,90818.98,66866,157684.98
351790,201909,252,131,121,130738,121756,252494
351800,201909,44,29,15,28942,14970,43912
351810,201909,122,83,39,82834,38922,121756
351820,201909,845,613,232,612773.2,232535.39,845308.59
351830,201909,530,193,337,192614,336326,528940
351840,201909,1845,941,904,939119.04,906186.97,1845306.01
351850,201909,243,178,65,177644,64870,242514
351860,201909,687,476,211,476047.78,210578,686625.78
351870,201909,5596,2651,2945,2652687.24,2943104.73,5595791.97
351880,201909,18977,8003,10974,7997983.17,10974053.34,18972036.51
351885,201909,87,57,30,56886,29940,86826
351890,201909,73,62,11,61876,10978,72854
351900,201909,226,134,92,133732.81,91816,225548.81
351905,201909,72,29,43,28942,42914,71856
351907,201909,3371,1430,1941,1431133.34,1944108.55,3375241.89
351910,201909,178,74,104,73852,103792,177644
351920,201909,123,71,52,70858,51897.98,122755.98
351925,201909,91,60,31,59880,30938,90818
351930,201909,377,247,130,246506,129740,376246
351940,201909,239,108,131,107784,130738,238522
351950,201909,133,75,58,74850,57884,132734
351960,201909,892,430,462,430451,463072.4,893523.4
351970,201909,1844,989,855,989018.4,854289.78,1843308.18
351980,201909,151,77,74,76846,73852,150698
351990,201909,262,171,91,171656.8,90818,262474.8
352000,201909,353,219,134,219561.32,133732,353293.32
352010,201909,394,250,144,249500,143712,393212
352020,201909,183,67,116,66866,116766,183632
352030,201909,1060,556,504,554888,504988,1059876
352040,201909,577,244,333,243512,333332,576844
352042,201909,286,89,197,88822,196606.8,285428.8
352044,201909,360,218,142,217564,141716,359280
352050,201909,3263,1273,1990,1272452.76,1988016,3260468.76
352060,201909,102,63,39,62874,38922.57,101796.57
352070,201909,93,68,25,67865.26,24950,92815.26
352080,201909,67,42,25,41916,24950,66866
352090,201909,164,111,53,110778,52894,163672
352100,201909,272,129,143,128743.39,142716.38,271459.77
352110,201909,114,34,80,33932,79840,113772
352115,201909,61,21,40,20958,39920,60878
352120,201909,88,63,25,63872.63,24950,88822.63
352130,201909,222,184,38,183632,37924,221556
352140,201909,187,85,102,84830,101796,186626
352150,201909,115,64,51,63872,50898,114770
352160,201909,138,89,49,88822,48902,137724
352170,201909,371,262,109,262474,109780,372254
352180,201909,604,400,204,400198,204590.99,604788.99
352190,201909,255,105,150,104790,150698,255488
352200,201909,32,16,16,15968,15968,31936
352210,201909,4019,1668,2351,1666662.6,2350292.63,4016955.23
352215,201909,54,31,23,30938,22954,53892
352220,201909,6961,2650,4311,2644703.31,4312363.75,6957067.06
352230,201909,3280,2126,1154,2123758.89,1154696.5,3278455.39
352240,201909,2335,1359,976,1356283,975046.4,2331329.4
352250,201909,2623,1332,1291,1330337.65,1292411.97,2622749.62
352260,201909,992,520,472,519958.8,471056.4,991015.2
352265,201909,58,26,32,25948,31936,57884
352270,201909,409,241,168,241516,167665.88,409181.88
352280,201909,435,274,161,273453.26,160678,434131.26
352290,201909,171,104,67,103792,66866,170658
352300,201909,94,70,24,70858,23952,94810
352310,201909,6075,2848,3227,2846301.66,3227535.3,6073836.96
352320,201909,979,515,464,513970.4,464070,978040.4
352330,201909,523,257,266,256486,265468.4,521954.4
352340,201909,1326,632,694,630736.8,694609.2,1325346.0
352350,201909,328,199,129,198602,129740,328342
352360,201909,215,95,120,94810,120758.2,215568.2
352370,201909,105,69,36,69860,35928,105788
352380,201909,115,72,43,71856,42914,114770
352390,201909,2456,1101,1355,1099798.38,1356284.18,2456082.56
352400,201909,489,219,270,218562,270458.4,489020.4
352410,201909,833,593,240,593810.63,240518,834328.63
352420,201909,104,71,33,70858,32934,103792
352430,201909,1729,791,938,790419.32,939120.44,1729539.76
352440,201909,3109,1561,1548,1558878.83,1548899.74,3107778.57
352450,201909,200,166,34,166666,33932,200598
352460,201909,614,318,296,317365.39,295408,612773.39
352470,201909,632,220,412,219560,413172,632732
352480,201909,1384,779,605,777442,603790.4,1381232.4
352490,201909,61,23,38,22954,39920,62874
352500,201909,1202,540,662,538920.34,660677.78,1199598.12
352510,201909,743,402,341,401197.26,341316,742513.26
352520,201909,627,294,333,293412,333332,626744
352530,201909,1746,922,824,920156,826344.4,1746500.4
352540,201909,74,49,25,48902,24950,73852
352550,201909,183,109,74,108782,73852,182634
352560,201909,50,40,10,39920,9980,49900
352570,201909,669,352,317,352294.63,317364,669658.63
352580,201909,57,41,16,40918,15968,56886
352585,201909,18,6,12,5988,11976,17964
352590,201909,4387,2226,2161,2225540.63,2163665.78,4389206.41
352600,201909,337,241,96,241516,96806,338322
352610,201909,942,430,512,430138.57,512972,943110.57
352620,201909,988,390,598,390218,596804,987022
352630,201909,172,62,110,61876,110778,172654
352640,201909,537,366,171,365268.96,171656,536924.96
352650,201909,86,57,29,56886,28942,85828
352660,201909,70,43,27,42914,26946,69860
352670,201909,1657,895,762,894209.59,760484.91,1654694.50
352680,201909,918,584,334,584829.59,333332,918161.59
352690,201909,4454,2027,2427,2024945.81,2428135.61,4453081.42
352700,201909,109,65,44,64870,44910,109780
352710,201909,1354,729,625,728540,624748,1353288
352720,201909,1315,630,685,629738,684628.4,1314366.4
352725,201909,24,21,3,20958,2994,23952
352730,201909,384,202,182,201596,181636,383232
352740,201909,415,271,144,271456.96,143712.68,415169.64
352750,201909,18,12,6,11976,6986,18962
352760,201909,181,120,61,120758,60878,181636
352770,201909,84,66,18,65868,17964,83832
352780,201909,75,40,35,39920,34930,74850
352790,201909,28,23,5,22954.63,4990,27944.63
352800,201909,244,176,68,175648,67864,243512
352810,201909,153,95,58,94810.99,57884,152694.99
352820,201909,65,53,12,52894,11976,64870
352830,201909,87,60,27,59880,26946,86826
352840,201909,658,344,314,344310.5,313372,657682.5
352850,201909,1424,490,934,489020,936124,1425144
352860,201909,127,78,49,77844,48902,126746
352870,201909,44,28,16,27944,15968.4,43912.4
352880,201909,185,124,61,123752,60878,184630
352885,201909,31,22,9,21956,8982,30938
352890,201909,53,36,17,36926,16966.4,53892.4
352900,201909,4782,2322,2460,2319357.83,2458082.77,4777440.60
352910,201909,39,32,7,31936,6986,38922
352920,201909,670,403,267,403192,266466,669658
352930,201909,1219,593,626,591825.76,626789,1218614.76
352940,201909,6213,2640,3573,2640712.01,3572847.09,6213559.10
352950,201909,95,37,58,36926,58882,95808
352960,201909,53,37,16,36926,15968,52894
352965,201909,20,10,10,9980,9980,19960
352970,201909,514,392,122,392214.02,123753.61,515967.63
352980,201909,163,87,76,86826,75848,162674
352990,201909,984,447,537,447104,535926,983030
353000,201909,64,30,34,29940,33932,63872
353010,201909,540,334,206,333332,206586,539918
353020,201909,297,215,82,214570,81836,296406
353030,201909,1216,565,651,564868.34,651694.98,1216563.32
353040,201909,91,60,31,59880,30938,90818
353050,201909,1320,845,475,850297.69,474050,1324347.69
353060,201909,8315,3707,4608,3706579.83,4610769.88,8317349.71
353070,201909,1717,1072,645,1071854.56,643532.35,1715386.91
353080,201909,1309,691,618,689619.16,617762,1307381.16
353090,201909,58,33,25,32934,24950,57884
353100,201909,56,45,11,44910.23,10978,55888.23
353110,201909,2053,628,1425,627742.4,1423149.19,2050891.59
353120,201909,90,49,41,48902,41916,90818
353130,201909,845,408,437,408184.3,436127.96,844312.26
353140,201909,563,225,338,224550.63,337324,561874.63
353150,201909,346,196,150,195608.63,149700,345308.63
353160,201909,93,78,15,77844,14970,92814
353170,201909,190,63,127,62874,126747.96,189621.96
353180,201909,1004,475,529,474050,528941.1,1002991.1
353190,201909,506,370,136,369260.3,136726.4,505986.7
353200,201909,208,107,101,106786,100798,207584
353205,201909,22,15,7,15968,6986,22954
353210,201909,81,47,34,46906,33932,80838
353215,201909,49,28,21,27944,20958,48902
353220,201909,82,46,36,45908,35928,81836
353230,201909,157,66,91,65868,90818,156686
353240,201909,312,165,147,164670,146706,311376
353250,201909,209,108,101,107784,100798,208582
353260,201909,459,327,132,326347.1,131736,458083.1
353270,201909,69,53,16,52894,15968,68862
353280,201909,104,55,49,54890.6,48902,103792.6
353282,201909,124,86,38,85828,37924,123752
353284,201909,25,18,7,17964,6986,24950
353286,201909,1,0,1,0,998,998
353290,201909,74,43,31,42914,30938,73852
353300,201909,427,237,190,236527.96,189620,426147.96
353310,201909,45,39,6,38922,5988,44910
353320,201909,61,37,24,36926,23952,60878
353325,201909,55,32,23,31936,22955.36,54891.36
353330,201909,63,45,18,44910.7,17964,62874.7
353340,201909,613,211,402,211576,401196.4,612772.4
353350,201909,892,429,463,428144.6,463073.96,891218.56
353360,201909,99,79,20,78842,19960,98802
353370,201909,119,66,53,65868,52894,118762
353380,201909,31,18,13,17964.99,12974,30938.99
353390,201909,1092,533,559,531934,560876,1092810
353400,201909,44,26,18,25948,17964,43912
353410,201909,104,66,38,65868,37924.9,103792.9
353420,201909,58,25,33,24950,33932,58882
353430,201909,579,388,191,390219.38,190618,580837.38
353440,201909,10383,4609,5774,4605776,5774440.32,10380216.32
353450,201909,55,31,24,30938,23952,54890
353460,201909,593,332,261,332334.1,261476,593810.1
353470,201909,2106,1128,978,1125747.8,977045.96,2102793.76
353475,201909,235,158,77,157685.38,76846,234531.38
353480,201909,185,152,33,151696,32934.4,184630.4
353490,201909,241,148,93,147704,92814.4,240518.4
353500,201909,196,112,84,111776.63,83832,195608.63
353510,201909,102,74,28,73852,27944,101796
353520,201909,209,146,63,145708,64870,210578
353530,201909,468,255,213,254490,213572,468062
353540,201909,378,257,121,256486,120758,377244
353550,201909,723,469,254,469061.24,253492,722553.24
353560,201909,596,242,354,241516,353292.6,594808.6
353570,201909,64,34,30,33932.4,29940,63872.4
353580,201909,351,265,86,264470.34,85828,350298.34
353590,201909,91,64,27,63872,26946,90818
353600,201909,275,159,116,158682.63,115768,274450.63
353610,201909,123,68,55,67864,54890,122754
353620,201909,612,320,292,319360,291416,610776
353625,201909,49,27,22,27944,21956,49900
353630,201909,236,174,62,174650.58,61876,236526.58
353640,201909,125,86,39,85828,38922,124750
353650,201909,918,362,556,361276,556884,918160
353657,201909,23,18,5,17964,4990,22954
353660,201909,264,143,121,142714,120758,263472
353670,201909,770,457,313,456087.03,312374,768461.03
353680,201909,104,75,29,74850.5,29940,104790.5
353690,201909,42,33,9,32934,8982,41916
353700,201909,280,200,80,199600.45,79840,279440.45
353710,201909,451,215,236,214570.6,236526.4,451097.0
353715,201909,45,33,12,32934,11976,44910
353720,201909,350,162,188,161677.78,187624,349301.78
353730,201909,1087,668,419,667662.8,418162.8,1085825.6
353740,201909,626,344,282,343312,282434,625746
353750,201909,82,52,30,51896,29940,81836
353760,201909,2864,1080,1784,1080835.76,1781432.18,2862267.94
353770,201909,91,74,17,73852,16966,90818
353780,201909,1181,570,611,569858.63,610776,1180634.63
353790,201909,513,306,207,305388.16,206586.4,511974.56
353800,201909,3242,1620,1622,1618759.89,1620823.35,3239583.24
353810,201909,234,133,101,132734.98,100799.96,233534.94
353820,201909,192,92,100,91816,100798,192614
353830,201909,48,41,7,40918,6986,47904
353850,201909,173,86,87,85828,86826,172654
353860,201909,496,227,269,226546,268462,495008
353870,201909,5213,2670,2543,2672651.73,2543904.8,5216556.53
353880,201909,690,485,205,484031.36,205588,689619.36
353890,201909,575,332,243,331336.4,242514.84,573851.24
353900,201909,131,70,61,69860,60878,130738
353910,201909,175,84,91,83832,91816,175648
353920,201909,436,240,196,239520.3,195608.99,435129.29
353930,201909,1004,592,412,591814,411178.14,1002992.14
353940,201909,192,101,91,100798,91816,192614
353950,201909,521,319,202,318362,201596.98,519958.98
353960,201909,71,58,13,57884,12974,70858
353970,201909,67,38,29,37924,28942,66866
353980,201909,1605,759,846,758480,845309.96,1603789.96
353990,201909,76,45,31,44910,30938,75848
354000,201909,374,184,190,184630,189620.99,374250.99
354010,201909,93,52,41,51896,40918,92814
354020,201909,529,340,189,339320,188622,527942
354025,201909,55,45,10,44910,9980,54890
354030,201909,58,34,24,33932,23952,57884
354040,201909,106,79,27,78842,26946,105788
354050,201909,187,99,88,98802.4,87824,186626.4
354060,201909,765,376,389,376246,390218,766464
354070,201909,918,534,384,533930.4,386226.4,920156.8
354075,201909,221,112,109,111776,108782,220558
354080,201909,305,132,173,131736,172654,304390
354085,201909,20,12,8,11976,7984,19960
354090,201909,300,168,132,167580,131736,299316
354100,201909,5526,2308,3218,2304383.56,3215559.9,5519943.46
354105,201909,89,42,47,41916,47904,89820
354110,201909,47,23,24,22954,23952,46906
354120,201909,135,96,39,95808.98,38922,134730.98
354130,201909,694,458,236,457084.98,237525.38,694610.36
354140,201909,3098,1445,1653,1446103.2,1659674,3105777.2
354150,201909,623,384,239,383232.8,239520,622752.8
354160,201909,668,428,240,428142.4,240518.4,668660.8
354165,201909,19,14,5,13972,4990,18962
354170,201909,179,121,58,120758,58882,179640
354180,201909,64,39,25,38922.51,24950,63872.51
354190,201909,197,87,110,86826,110778,197604
354200,201909,120,64,56,63872,55888,119760
354210,201909,58,26,32,25948,31936,57884
354220,201909,646,404,242,406186,241516,647702
354230,201909,165,71,94,70858,93812,164670
354240,201909,325,211,114,210578.64,113772,324350.64
354250,201909,83,50,33,49900,32934,82834
354260,201909,2029,951,1078,949101.47,1076843.67,2025945.14
354270,201909,91,68,23,68862,22954,91816
354280,201909,42,21,21,20958,20958,41916
354290,201909,140,100,40,100798,39920,140718
354300,201909,397,276,121,275448.63,121756,397204.63
354310,201909,96,72,24,71856.4,23952,95808.4
354320,201909,200,100,100,99800,99800.4,199600.4
354323,201909,12,11,1,10978,998,11976
354325,201909,114,69,45,68862.6,44910,113772.6
354330,201909,2504,837,1667,835184.8,1663667.38,2498852.18
354340,201909,10471,5089,5382,5083816.03,5382220.3,10466036.33
354350,201909,122,81,41,80838,40918,121756
354360,201909,83,48,35,47904,34930,82834
354370,201909,253,139,114,138722,114770,253492
354380,201909,191,115,76,114770,75848,190618
354390,201909,2666,980,1686,980037.59,1685622.98,2665660.57
354400,201909,316,173,143,172654,142714,315368
354410,201909,611,295,316,295408,316366.4,611774.4
354420,201909,276,174,102,174650,101796,276446
354425,201909,309,181,128,180638,128742,309380
354430,201909,179,107,72,106786,71856,178642
354440,201909,34,25,9,24950,8982,33932
354450,201909,50,36,14,35928,13972,49900
354460,201909,105,61,44,60878,43912,104790
354470,201909,37,22,15,21956,14970,36926
354480,201909,116,62,54,61876,53892,115768
354490,201909,149,92,57,91816,56886,148702
354500,201909,375,184,191,183632,190618,374250
354510,201909,97,71,26,70858,25948,96806
354515,201909,38,12,26,11976,25948,37924
354520,201909,1586,689,897,689476.9,897202.8,1586679.7
354530,201909,718,368,350,367265.79,349300,716565.79
354540,201909,274,151,123,150698,122754,273452
354550,201909,38,22,16,21956,15968,37924
354560,201909,149,83,66,83832,65868,149700
354570,201909,141,91,50,90818.5,49900,140718.5
354580,201909,1889,899,990,899200.29,988020,1887220.29
354600,201909,243,137,106,136726,105788,242514
354610,201909,74,62,12,61876.46,11976.98,73853.44
354620,201909,62,19,43,18962,42914,61876
354625,201909,15,10,5,9980,4990.99,14970.99
354630,201909,309,201,108,201596.98,107784,309380.98
354640,201909,801,519,282,518960.3,281436,800396.3
354650,201909,72,41,31,41916,30938.98,72854.98
354660,201909,796,594,202,593810.63,201596,795406.63
354670,201909,252,92,160,91816.26,159680.6,251496.86
354680,201909,1242,470,772,469060,771454,1240514
354690,201909,82,55,27,54890.4,26946,81836.4
354700,201909,71,52,19,51896,18962,70858
354710,201909,47,35,12,34930,11976,46906
354720,201909,22,22,0,21956,0,21956
354730,201909,1723,725,998,724549.78,998000.4,1722550.18
354740,201909,68,49,19,48902,18962,67864
354750,201909,441,254,187,254490.98,187624,442114.98
354760,201909,481,293,188,293412.9,187624.4,481037.3
354765,201909,10,5,5,4990,4990,9980
354770,201909,347,228,119,227544.4,118762,346306.4
354780,201909,8099,3260,4839,3254491.58,4834335.97,8088827.55
354790,201909,102,59,43,58882,42914,101796
354800,201909,447,249,198,248502,197604.4,446106.4
354805,201909,105,49,56,48902.8,55888,104790.8
354810,201909,106,63,43,62874,42914,105788
354820,201909,192,85,107,84830.56,106786,191616.56
354830,201909,39,20,19,19960,18962,38922
354840,201909,61,42,19,41916,18962,60878
354850,201909,4545,2032,2513,2028935.2,2512965.75,4541900.95
354860,201909,324,155,169,154690,169660.93,324350.93
354870,201909,12258,5554,6704,5549889.9,6716547.43,12266437.33
354880,201909,2944,1103,1841,1100795.43,1843309.37,2944104.80
354890,201909,2884,1580,1304,1576842.83,1305384,2882226.83
354900,201909,63,43,20,42914,19960,62874
354910,201909,1258,663,595,661674.4,593810,1255484.4
354920,201909,46,39,7,38922,6986,45908
354925,201909,13,8,5,7984,4990,12974
354930,201909,33,30,3,29940.43,2994,32934.43
354940,201909,830,604,226,604041.33,225548,829589.33
354950,201909,208,138,70,137724.6,69860,207584.6
354960,201909,157,61,96,60878,95808,156686
354970,201909,911,601,310,599799.77,309380.4,909180.17
354980,201909,8616,3177,5439,3175639.96,5436116.44,8611756.40
354990,201909,8931,4214,4717,4208572.91,4715602.8,8924175.71
354995,201909,546,186,360,185628,359280,544908
355000,201909,472,163,309,162674,308382,471056
355010,201909,611,383,228,382235,227545.23,609780.23
355020,201909,748,471,277,471056.32,279442.38,750498.70
355030,201909,205704,80720,124984,80654345.45,124970743.54,205625088.99
355040,201909,735,351,384,350298.4,383232,733530.4
355050,201909,149,99,50,98802.77,49900,148702.77
355060,201909,1568,797,771,796405.2,769458.6,1565863.8
355070,201909,1421,689,732,688622.31,733531.61,1422153.92
355080,201909,202,120,82,119760,81836,201596
355090,201909,284,174,110,173652.38,109780.32,283432.70
355100,201909,4936,2398,2538,2397101.82,2536918.19,4934020.01
355110,201909,267,177,90,176647.39,89820,266467.39
355120,201909,78,58,20,57884,19960.98,77844.98
355130,201909,54,32,22,31936,22954,54890
355140,201909,189,119,70,118762,69860,188622
355150,201909,679,409,270,409181.39,270458,679639.39
355160,201909,459,219,240,218562.23,239520.4,458082.63
355170,201909,2066,1084,982,1085824,982032,2067856
355180,201909,672,288,384,288422,383232,671654
355190,201909,203,144,59,144710,59880,204590
355200,201909,112,64,48,63872,47904,111776
355210,201909,672,392,280,392214,280438.98,672652.98
355220,201909,7034,3735,3299,3733524.27,3308374.74,7041899.01
355230,201909,100,59,41,58882,40918,99800
355240,201909,4412,1877,2535,1876243.14,2536918.37,4413161.51
355250,201909,5599,2629,2970,2626757.82,2969056.61,5595814.43
355255,201909,49,31,18,30938,17964,48902
355260,201909,181,108,73,108782.4,72855.96,181638.36
355270,201909,169,107,62,106786,61876,168662
355280,201909,6372,2609,3763,2607776.6,3759467.78,6367244.38
355290,201909,73,57,16,56886,15968,72854
355300,201909,197,126,71,125748,70858.4,196606.4
355310,201909,111,62,49,61876,48902,110778
355320,201909,87,46,41,45908,40918,86826
355330,201909,285,160,125,159680,124750,284430
355340,201909,1538,524,1014,522952.79,1011972,1534924.79
355350,201909,130,72,58,72854,57884,130738
355360,201909,168,107,61,107784,60878,168662
355365,201909,23,18,5,17964,4990,22954
355370,201909,1023,593,430,591827.51,429147.24,1020974.75
355380,201909,802,523,279,521954,279440,801394
355385,201909,69,49,20,48902,19960,68862
355390,201909,100,59,41,58882,42914,101796
355395,201909,185,110,75,109780.91,74850,184630.91
355400,201909,1633,1003,630,1001164.93,628742.29,1629907.22
355410,201909,4832,2309,2523,2307380.39,2520953.54,4828333.93
355420,201909,49,35,14,34930,13972,48902
355430,201909,358,219,139,219560.96,141716,361276.96
355440,201909,79,46,33,45908,32934,78842
355450,201909,461,230,231,229540.88,230538.7,460079.58
355460,201909,65,49,16,48902.54,15968,64870.54
355465,201909,50,32,18,31936,17964,49900
355470,201909,177,72,105,72854.7,104790,177644.7
355475,201909,13,9,4,8982,3992,12974
355480,201909,474,211,263,210578.6,262474,473052.6
355490,201909,115,83,32,83832,31936,115768
355495,201909,57,29,28,28942,27944,56886
355500,201909,1603,896,707,895208.55,705589.36,1600797.91
355510,201909,272,198,74,197605.26,73852,271457.26
355520,201909,35,26,9,25948.4,8982,34930.4
355530,201909,22,15,7,14970,6986,21956
355535,201909,77,37,40,37924,39920,77844
355540,201909,2385,942,1443,941255.11,1443109.61,2384364.72
355550,201909,60,38,22,37924,21956,59880
355560,201909,246,118,128,117764,127744,245508
355570,201909,24,17,7,16966,6986,23952
355580,201909,242,170,72,169660,71857.39,241517.39
355590,201909,20,14,6,13972,5988,19960
355600,201909,271,140,131,139720,131736,271456
355610,201909,231,155,76,154690,75848,230538
355620,201909,1322,627,695,626744.4,694608.99,1321353.39
355630,201909,438,321,117,320358,116766.63,437124.63
355635,201909,117,57,60,56886,60879.97,117765.97
355640,201909,570,322,248,321356,247504,568860
355645,201909,836,349,487,348302,488022.4,836324.4
355650,201909,2023,867,1156,867263.74,1154686.98,2021950.72
355660,201909,259,142,117,141716,116766,258482
355670,201909,532,212,320,211576,319360,530936
355680,201909,202,118,84,117764.97,83832,201596.97
355690,201909,94,45,49,44910,48902.07,93812.07
355695,201909,15,10,5,9980,4990,14970
355700,201909,1137,599,538,597802.66,536924.8,1134727.46
355710,201909,2230,1233,997,1232530.8,998000,2230530.8
355715,201909,18,15,3,14970,2994,17964
355720,201909,199,122,77,121756.44,76846,198602.44
355730,201909,96,52,44,51896,43912,95808
410010,201909,128,108,20,107784,19960,127744
410020,201909,108,89,19,88822,18962,107784
410030,201909,164,102,62,102794.4,61876,164670.4
410040,201909,1071,557,514,557882,513970.6,1071852.6
410045,201909,34,28,6,27944,5988,33932
410050,201909,479,272,207,271456,206586,478042
410060,201909,282,214,68,213572,67864,281436
410070,201909,308,255,53,254490,52894,307384
410080,201909,166,106,60,105788,59880,165668
410090,201909,79,70,9,69860.56,8982,78842.56
410100,201909,289,209,80,209580,79840,289420
410105,201909,47,29,18,28942,17964,46906
410110,201909,326,201,125,200598,126746,327344
410115,201909,32,22,10,21956,9980,31936
410120,201909,407,209,198,210578,197604,408182
410130,201909,46,29,17,28942,16966,45908
410140,201909,3135,1542,1593,1540914.1,1594806.6,3135720.7
410150,201909,2653,1059,1594,1057881.14,1590813.2,2648694.34
410160,201909,513,319,194,318362,194610.4,512972.4
410165,201909,66,43,23,42914,22954,65868
410170,201909,164,117,47,116766,46906,163672
410180,201909,2197,1252,945,1251492.4,947102.99,2198595.39
410185,201909,36,31,5,30938,4990,35928
410190,201909,500,335,165,334330.51,164670,499000.51
410200,201909,955,714,241,712572,242514,955086
410210,201909,583,309,274,308382,273452.4,581834.4
410220,201909,43,21,22,20958,21956,42914
410230,201909,144,72,72,71856,71856,143712
410240,201909,754,488,266,487024.8,265468,752492.8
410250,201909,380,276,104,277444,103792,381236
410260,201909,295,169,126,168662.4,125748,294410.4
410270,201909,31,21,10,20958,9980,30938
410275,201909,59,44,15,43912,14970,58882
410280,201909,321,187,134,186626,134730,321356
410290,201909,243,153,90,152694,89820,242514
410300,201909,76,57,19,56886,18962,75848
410302,201909,19,12,7,11976,6986,18962
410304,201909,41,28,13,27944,12974,40918
410305,201909,215,114,101,114770,100798,215568
410310,201909,216,131,85,130738,84830,215568
410315,201909,49,35,14,34930,13972,48902
410320,201909,136,96,40,95808,39920,135728
410322,201909,33,22,11,21956,10978,32934
410330,201909,171,121,50,120758,49900.6,170658.6
410335,201909,100,58,42,57884,41916,99800
410337,201909,39,33,6,32934,5988,38922
410340,201909,33,30,3,29940,2994,32934
410345,201909,212,128,84,127744,83832,211576
410347,201909,50,39,11,38922,10978,49900
410350,201909,244,152,92,151696,91816,243512
410360,201909,464,297,167,296406.8,167664.8,464071.6
410370,201909,2375,1015,1360,1015965.08,1359277.54,2375242.62
410380,201909,213,133,80,132734,79840,212574
410390,201909,372,267,105,267464,104790,372254
410395,201909,32,20,12,19960,11976,31936
410400,201909,825,399,426,400199.61,425583.5,825783.11
410405,201909,97,73,24,72854,23952,96806
410410,201909,32,25,7,24950,6986,31936
410420,201909,1634,787,847,787335.16,846304.34,1633639.50
410425,201909,168,76,92,76846.6,91816,168662.6
410430,201909,2193,1270,923,1268458.74,925147.46,2193606.20
410440,201909,376,275,101,275448,101796,377244
410442,201909,353,240,113,239520,112774,352294
410445,201909,414,295,119,294410,119760,414170
410450,201909,385,200,185,199600,184630,384230
410460,201909,471,252,219,251496,218562,470058
410465,201909,212,137,75,136726,75848,212574
410470,201909,232,148,84,147704,83832,231536
410480,201909,6052,3008,3044,3003990.77,3047902.41,6051893.18
410490,201909,1436,896,540,895206.84,538920.4,1434127.24
410500,201909,257,149,108,148702,107784,256486
410510,201909,168,126,42,125748,41916.98,167664.98
410520,201909,250,187,63,186626,62874,249500
410530,201909,239,90,149,89820,148702.99,238522.99
410540,201909,319,233,86,232534.99,85828,318362.99
410550,201909,1649,736,913,736525.2,914168.8,1650694.0
410560,201909,147,109,38,109780,37924,147704
410570,201909,434,296,138,295409.32,137724,433133.32
410580,201909,3373,1512,1861,1509975.85,1863267,3373242.85
410590,201909,404,281,123,282434,122754,405188
410600,201909,188,162,26,161676,25948,187624
410610,201909,55,46,9,45908,8982,54890
410620,201909,240,171,69,171656,68862,240518
410630,201909,440,256,184,255488,183632,439120
410640,201909,1009,641,368,640716.7,367264.99,1007981.69
410645,201909,106,79,27,78842.2,26946,105788.2
410650,201909,360,240,120,240518,119760,360278
410655,201909,82,62,20,61876,19960,81836
410657,201909,20,8,12,7984,12974,20958
410660,201909,607,429,178,428142.31,178642,606784.31
410670,201909,74,63,11,62874,10978,73852
410680,201909,204,168,36,167664,35928,203592
410685,201909,20,12,8,11976,7984,19960
410690,201909,28112,12110,16002,12099937.14,16000944.23,28100881.37
410700,201909,331,245,86,244510.4,85828,330338.4
410710,201909,125,103,22,103792,21956,125748
410712,201909,24,18,6,17964,5988,23952
410715,201909,88,68,20,67864,19960,87824
410720,201909,688,395,293,395208,295408.98,690616.98
410725,201909,185,134,51,133732.4,50898,184630.4
410730,201909,91,52,39,51896,38922.6,90818.6
410740,201909,113,82,31,82834,30938,113772
410750,201909,245,169,76,168662,75848,244510
410752,201909,25,15,10,14970,9980,24950
410753,201909,51,23,28,22954,27944,50898
410754,201909,45,26,19,25948.4,18962,44910.4
410755,201909,80,52,28,51896,27944,79840
410760,201909,745,420,325,419160.4,324350,743510.4
410765,201909,1703,820,883,818362.36,882233.2,1700595.56
410770,201909,110,87,23,86826,22954,109780
410773,201909,53,40,13,39920,12974,52894
410775,201909,188,138,50,137724,49900,187624
410780,201909,81,44,37,43912,36926,80838
410785,201909,54,43,11,42914,10978,53892
410790,201909,71,36,35,35928,35928,71856
410800,201909,283,177,106,176646,106786,283432
410810,201909,20,16,4,15968,3992.4,19960.4
410820,201909,180,133,47,132734,47904,180638
410830,201909,8481,3788,4693,3782425.88,4693603.49,8476029.37
410832,201909,105,75,30,74850,29940,104790
410840,201909,1417,799,618,797404.97,619760.46,1417165.43
410845,201909,66,43,23,42914,22954,65868
410850,201909,196,139,57,138722,56886,195608
410855,201909,52,44,8,43912,7984,51896
410860,201909,708,415,293,416166.4,294410,710576.4
410865,201909,101,77,24,76846,23952,100798
410870,201909,152,128,24,127744,23952,151696
410880,201909,1119,581,538,579843.7,536927.92,1116771.62
410890,201909,85,59,26,58882,25948,84830
410895,201909,72,56,16,55888,15968,71856
410900,201909,24,17,7,16966,6986,23952
410910,201909,15,13,2,12974,1996,14970
410920,201909,34,23,11,22954,10978,33932
410930,201909,501,324,177,323352,177644,500996
410940,201909,4386,2509,1877,2505979.84,1877238.8,4383218.64
410950,201909,108,82,26,81836,25948,107784
410960,201909,782,340,442,340318,442114,782432
410965,201909,64,51,13,50898,12974,63872
410970,201909,632,455,177,455088,176646,631734
410975,201909,119,70,49,69860.72,48902,118762.72
410980,201909,1632,750,882,748500.55,881234.99,1629735.54
410990,201909,261,182,79,181636,78842,260478
411000,201909,67,43,24,42914,23952.4,66866.4
411005,201909,27,23,4,22954,3992,26946
411007,201909,259,153,106,152694,107784,260478
411010,201909,599,415,184,416166,183632,599798
411020,201909,294,205,89,205588.74,88822,294410.74
411030,201909,15,9,6,8982,5988,14970
411040,201909,56,40,16,39920,15968,55888
411050,201909,210,165,45,164670,45908,210578
411060,201909,515,354,161,353292.98,160678,513970.98
411065,201909,62,53,9,52894,8982,61876
411070,201909,1246,777,469,775446.6,468062,1243508.6
411080,201909,228,163,65,162674,65868,228542
411090,201909,105,79,26,78842,25948,104790
411095,201909,281,114,167,113772,167664,281436
411100,201909,112,94,18,93812,17964,111776
411110,201909,124,84,40,83832,39920,123752
411120,201909,195,143,52,142714,51896,194610
411125,201909,218,99,119,98802,118762,217564
411130,201909,128,111,17,110778,16966,127744
411140,201909,212,140,72,140718,71856,212574
411150,201909,1233,828,405,826344,405188.63,1231532.63
411155,201909,124,83,41,82834,41916,124750
411160,201909,25,12,13,11976,12974,24950
411170,201909,50,46,4,45908,3992,49900
411180,201909,975,656,319,654688,319360,974048
411190,201909,332,192,140,191616,140718,332334
411200,201909,669,429,240,428142.63,239520,667662.63
411210,201909,701,384,317,383232,316366.98,699598.98
411220,201909,148,110,38,109780,37924,147704
411230,201909,41,35,6,34930,5988,40918
411240,201909,123,82,41,81836,40918,122754
411250,201909,444,327,117,326346,116766,443112
411260,201909,20,14,6,13972,5988,19960
411270,201909,274,147,127,146706,126746,273452
411275,201909,196,171,25,170658,24950,195608
411280,201909,220,156,64,155688.63,63872,219560.63
411290,201909,59,47,12,46906,11976,58882
411295,201909,142,112,30,111776,29940,141716
411300,201909,71,36,35,35928,34930,70858
411310,201909,91,71,20,70858,19960,90818
411320,201909,766,529,237,527942,236526.6,764468.6
411325,201909,64,43,21,42914,20958,63872
411330,201909,908,585,323,585826.5,324350.16,910176.66
411340,201909,26,19,7,18962,6986.34,25948.34
411342,201909,68,51,17,50898,16966,67864
411345,201909,117,58,59,57884,58882,116766
411350,201909,481,381,100,380238.58,99800.4,480038.98
411360,201909,56,36,20,35928,19960,55888
411370,201909,14189,5857,8332,5850281.94,8329324.34,14179606.28
411373,201909,177,130,47,129740,46906,176646
411375,201909,74,60,14,59880,13972,73852
411380,201909,94,71,23,71856,22954,94810
411390,201909,118,79,39,78842,38922,117764
411400,201909,360,277,83,276446.98,82834,359280.98
411410,201909,442,221,221,220558,221556.4,442114.4
411420,201909,1012,461,551,461076,552892,1013968
411430,201909,440,266,174,265468,173652.98,439120.98
411435,201909,34,22,12,21956,11976,33932
411440,201909,452,364,88,364270,88822,453092
411450,201909,420,352,68,351296,67864,419160
411460,201909,761,301,460,300398.2,459080.99,759479.19
411470,201909,87,65,22,65868,22954.8,88822.8
411480,201909,661,382,279,381236.4,279440,660676.4
411490,201909,290,188,102,187624,101796,289420
411500,201909,101,86,15,85828,14970,100798
411510,201909,227,180,47,179640,46906,226546
411520,201909,5961,2304,3657,2303386.79,3656677.92,5960064.71
411530,201909,123,87,36,86826,35928,122754
411535,201909,50,21,29,20958,28942,49900
411540,201909,349,240,109,239520,109780,349300
411545,201909,52,39,13,38922,12974,51896
411550,201909,72,55,17,54890,16966,71856
411560,201909,374,165,209,164670,208582,373252
411570,201909,808,299,509,298403.26,507982.6,806385.86
411573,201909,28,17,11,16966,10978,27944
411575,201909,289,183,106,182634,106786,289420
411580,201909,1243,486,757,485028,756484,1241512
411585,201909,74,36,38,35928,37924,73852
411590,201909,25,18,7,17964,6986,24950
411600,201909,24,10,14,9980,13972,23952
411605,201909,230,94,136,93812,135728,229540
411610,201909,208,141,67,140718,66866,207584
411620,201909,351,195,156,194610,155688,350298
411630,201909,56,38,18,37924,17964,55888
411640,201909,33,25,8,24950,7984,32934
411650,201909,12,7,5,6986,4990,11976
411660,201909,39,28,11,27944,10978,38922
411670,201909,242,182,60,181636,59880,241516
411680,201909,158,135,23,134730,22954,157684
411690,201909,599,322,277,322354,279440,601794
411695,201909,57,41,16,40918,15968,56886
411700,201909,143,122,21,121756,20958,142714
411705,201909,102,66,36,65868,35928,101796
411710,201909,304,207,97,206586,97804,304390
411720,201909,133,87,46,86826,46906,133732
411721,201909,63,53,10,52894,9980,62874
411722,201909,98,41,57,40918,56886,97804
411725,201909,157,124,33,123752.4,32934,156686.4
411727,201909,82,63,19,62874,18962,81836
411729,201909,40,32,8,31936,7984,39920
411730,201909,556,356,200,355288,199600,554888
411740,201909,41,27,14,26946,13972,40918
411745,201909,68,48,20,47904,19960,67864
411750,201909,859,397,462,396206.4,462074.4,858280.8
411760,201909,1183,890,293,888221.03,292414.98,1180636.01
411770,201909,454,304,150,303392,150698,454090
411780,201909,328,213,115,212574,114770.5,327344.5
411790,201909,521,294,227,293413.27,227544.98,520958.25
411800,201909,160,123,37,122754,36926,159680
411810,201909,171,129,42,128742,41916,170658
411820,201909,2144,991,1153,990017.43,1153688.6,2143706.03
411830,201909,12,12,0,11976,0,11976
411840,201909,1982,1242,740,1239516,738521.93,1978037.93
411845,201909,50,19,31,18962,30938,49900
411850,201909,1219,688,531,688621.08,531937.64,1220558.72
411860,201909,44,31,13,30938.4,12974,43912.4
411870,201909,74,52,22,51896,21956,73852
411880,201909,417,270,147,269460.57,146706,416166.57
411885,201909,103,69,34,68862,33932,102794
411890,201909,310,200,110,199601.79,109780,309381.79
411900,201909,73,54,19,53892.4,18962,72854.4
411910,201909,184,147,37,146706,36926,183632
411915,201909,2122,898,1224,896204,1223549.22,2119753.22
411920,201909,120,95,25,94810,25049.8,119859.8
411925,201909,10,7,3,6986,2994,9980
411930,201909,811,597,214,595806.74,213572,809378.74
411940,201909,591,405,186,404190.34,185628,589818.34
411950,201909,925,467,458,467064.4,457084,924148.4
411960,201909,1030,712,318,712572.9,317364,1029936.9
411965,201909,21,15,6,14970,5988,20958
411970,201909,80,73,7,72854,6986,79840
411980,201909,170,117,53,116766,52894,169660
411990,201909,5200,3022,2178,3018956.08,2175641.7,5194597.78
411995,201909,469,178,291,177644,290418,468062
412000,201909,305,197,108,196606,107784,304390
412010,201909,49,32,17,31936,16966,48902
412015,201909,41,29,12,28942,11976,40918
412020,201909,30,26,4,25948,3992,29940
412030,201909,50,46,4,45908,3992,49900
412033,201909,50,32,18,31936.44,17964,49900.44
412035,201909,65,43,22,42914,21956,64870
412040,201909,40,26,14,25948.4,13972,39920.4
412050,201909,201,157,44,156686,43912,200598
412060,201909,779,592,187,590816,186626,777442
412065,201909,49,31,18,30938,17964,48902
412070,201909,173,118,55,117764,54890,172654
412080,201909,271,143,128,142714,127744,270458
412085,201909,35,17,18,16966,17964,34930
412090,201909,793,506,287,505986.9,286426,792412.9
412100,201909,240,204,36,203592.8,35928,239520.8
412110,201909,66,52,14,51896,14970,66866
412120,201909,314,194,120,193612,119760,313372
412125,201909,85,50,35,49900,35928,85828
412130,201909,39,28,11,27944.36,10978,38922.36
412135,201909,28,17,11,16966,10978,27944
412140,201909,325,224,101,223552,101796,325348
412150,201909,258,172,86,171656,85828,257484
412160,201909,89,52,37,51896,36926,88822
412170,201909,691,485,206,484030.4,205588,689618.4
412175,201909,39,29,10,28942,9980,38922
412180,201909,187,147,40,146706.2,39920,186626.2
412190,201909,338,270,68,270458,67864,338322
412200,201909,191,119,72,120758,72854,193612
412210,201909,73,57,16,56886,15968,72854
412215,201909,223,160,63,159680,62874,222554
412217,201909,66,53,13,52894,12974,65868
412220,201909,823,607,216,606784,216566,823350
412230,201909,331,205,126,205588,125749.96,331337.96
412240,201909,1328,668,660,666664.54,658680.4,1325344.94
412250,201909,395,250,145,249500,145708,395208
412260,201909,110,80,30,79840,29940,109780
412265,201909,178,141,37,140718,36926,177644
412270,201909,85,57,28,56886,27944,84830
412280,201909,90,73,17,72854,16966,89820
412290,201909,97,68,29,67864,28942,96806
412300,201909,209,134,75,133732,75848,209580
412310,201909,48,41,7,40918,6986,47904
412320,201909,95,81,14,80838,13972,94810
412330,201909,189,163,26,162674,25948,188622
412340,201909,146,101,45,100798,44910.4,145708.4
412350,201909,601,295,306,294410,305388,599798
412360,201909,30,25,5,24950,4990,29940
412370,201909,163,143,20,142714.2,19960,162674.2
412380,201909,264,198,66,197604,65868.98,263472.98
412382,201909,54,27,27,26946,26946,53892
412385,201909,139,103,36,102794,35928,138722
412390,201909,282,218,64,217564,64870,282434
412395,201909,69,56,13,55888,12974,68862
412400,201909,82,54,28,53892,27944,81836
412402,201909,237,115,122,114770.4,121756,236526.4
412405,201909,840,319,521,318362,519958,838320
412410,201909,965,602,363,601794.4,363272,965066.4
412420,201909,13,11,2,10978,1996,12974
412430,201909,20,15,5,14970,4990,19960
412440,201909,608,334,274,333332,273452,606784
412450,201909,76,66,10,65868,9980,75848
412460,201909,90,68,22,67864,21956,89820
412470,201909,226,182,44,181636,43912,225548
412480,201909,148,109,39,108782.3,38922,147704.3
412490,201909,166,146,20,145708,20958,166666
412500,201909,444,366,78,365268.45,77844,443112.45
412510,201909,182,149,33,148702.4,32934,181636.4
412520,201909,89,58,31,57884,30938,88822
412530,201909,110,58,52,57884,51896,109780
412535,201909,91,66,25,65869.96,24950,90819.96
412540,201909,81,37,44,36926,43912,80838
412545,201909,91,66,25,65868,24950,90818
412550,201909,3721,1658,2063,1654684.4,2062866.8,3717551.2
412555,201909,14,10,4,9980,3992,13972
412560,201909,605,436,169,435128.4,168662.7,603791.1
412570,201909,736,394,342,394210,341316,735526
412575,201909,89,63,26,62874,25948,88822
412580,201909,172,115,57,114770,56886,171656
412590,201909,37,33,4,32934,3992,36926
412600,201909,168,125,43,124750.34,42914,167664.34
412610,201909,34,19,15,18962,14970,33932
412620,201909,148,127,21,126746,20958,147704
412625,201909,2177,1161,1016,1159677.53,1014968.73,2174646.26
412627,201909,68,52,16,51896,15968,67864
412630,201909,418,279,139,280438.6,139720,420158.6
412635,201909,65,17,48,16966,47904,64870
412640,201909,110,75,35,74850,34930,109780
412650,201909,351,226,125,225548,124750,350298
412660,201909,471,289,182,288422,183632,472054
412665,201909,51,45,6,44910,5988,50898
412667,201909,296,207,89,206586.44,88822,295408.44
412670,201909,64,54,10,53892,9980,63872
412680,201909,294,233,61,233532,60878.48,294410.48
412690,201909,105,71,34,70858,33932.4,104790.4
412700,201909,160,107,53,106786,52894.4,159680.4
412710,201909,1417,866,551,864270.2,550896,1415166.2
412720,201909,228,149,79,148702,78842,227544
412730,201909,191,160,31,159680,30938,190618
412740,201909,415,227,188,226546,187624,414170
412750,201909,454,265,189,264470,188622,453092
412760,201909,271,146,125,145708,124750,270458
412770,201909,2109,1172,937,1170655.86,936125.78,2106781.64
412780,201909,149,116,33,115768,32934,148702
412785,201909,263,135,128,134730,127744,262474
412788,201909,30,19,11,18962,10978,29940
412790,201909,130,110,20,109780,20958,130738
412795,201909,150,110,40,109780,39920,149700
412796,201909,327,215,112,214570,111776,326346
412800,201909,586,378,208,377244.5,207584.98,584829.48
412810,201909,2967,1642,1325,1641711.3,1326342,2968053.3
412820,201909,949,610,339,608781.9,340318.98,949100.88
412830,201909,14,11,3,10978,2994,13972
412840,201909,219,157,62,156686.4,61876,218562.4
412850,201909,781,514,267,512972,266466,779438
412853,201909,170,90,80,89820,79840.4,169660.4
412855,201909,207,114,93,113772.26,92814,206586.26
412860,201909,95,67,28,66866,27944,94810
412862,201909,58,44,14,43912,13972,57884
412863,201909,4,4,0,3992,0,3992
412865,201909,44,32,12,31936,11976,43912
412870,201909,111,71,40,70858,39920,110778
412880,201909,100,73,27,72854.4,26946,99800.4
420005,201909,42,38,4,37924,3992,41916
420010,201909,371,245,126,244510.3,125748.4,370258.7
420020,201909,82,71,11,70858,10978,81836
420030,201909,24,22,2,21956,1996,23952
420040,201909,110,85,25,84830,24950,109780
420050,201909,53,33,20,32934,19960,52894
420055,201909,19,19,0,18962,0,18962
420060,201909,31,24,7,23952,6986,30938
420070,201909,104,87,17,86826,16966,103792
420075,201909,13,13,0,12974,0,12974
420080,201909,43,38,5,37924,4990,42914
420090,201909,34,32,2,31936,1996,33932
420100,201909,151,130,21,129740.4,20958,150698.4
420110,201909,19,19,0,18962,0,18962
420120,201909,61,48,13,47904,12974,60878
420125,201909,84,67,17,67864,16966,84830
420127,201909,30,25,5,24950,4990,29940
420130,201909,411,255,156,254490,155688,410178
420140,201909,1313,732,581,730538.28,581834,1312372.28
420150,201909,44,38,6,37924,5988,43912
420160,201909,35,33,2,32934,1996,34930
420165,201909,17,12,5,11976,4990,16966
420170,201909,73,47,26,46906,25948,72854
420180,201909,23,21,2,20958,1996,22954
420190,201909,30,25,5,24950,4990,29940
420195,201909,129,66,63,65868,62874,128742
420200,201909,1271,567,704,565866.4,706589.77,1272456.17
420205,201909,71,42,29,41916,28942,70858
420207,201909,120,65,55,64870.5,54890,119760.5
420208,201909,19,15,4,14970,3992,18962
420209,201909,19,16,3,15968,2994,18962
420210,201909,486,239,247,238522,247504.98,486026.98
420213,201909,50,39,11,38922,10978,49900
420215,201909,26,23,3,22954,2994,25948
420220,201909,69,44,25,43912,24950,68862
420230,201909,821,469,352,468062.6,353293.97,821356.57
420240,201909,2269,1505,764,1504987.14,765466,2270453.14
420243,201909,42,33,9,33932,8982,42914
420245,201909,139,74,65,73852,65868,139720
420250,201909,63,40,23,39920,22954,62874
420253,201909,39,31,8,30938,7984,38922
420257,201909,13,11,2,10978,1996,12974
420260,201909,102,86,16,85828,15968,101796
420270,201909,39,30,9,29940.99,8982,38922.99
420280,201909,287,213,74,212577.64,73854.66,286432.30
420285,201909,22,12,10,11976,9980,21956
420287,201909,49,31,18,30938,17964,48902
420290,201909,1005,710,295,709579.89,296408.97,1005988.86
420300,201909,1434,1146,288,1143710.34,287424.98,1431135.32
420310,201909,44,30,14,29940,13972,43912
420315,201909,33,29,4,28942,3992,32934
420320,201909,883,446,437,445108.24,437124.99,882233.23
420325,201909,0,0,0,0,0,0
420330,201909,116,80,36,79840,35928,115768
420340,201909,160,106,54,105789.18,53892,159681.18
420350,201909,250,186,64,185628,63872,249500
420360,201909,761,585,176,583830.98,175650.46,759481.44
420370,201909,121,75,46,74850.6,45908.4,120759.0
420380,201909,1139,803,336,802393.48,335332.32,1137725.80
420390,201909,264,182,82,182634,81836,264470
420395,201909,187,133,54,132734,53892,186626
420400,201909,251,189,62,188622.75,61876,250498.75
420410,201909,63,47,16,46906,15968,62874
420415,201909,32,29,3,28942,2994,31936
420417,201909,52,41,11,40918,11976,52894
420419,201909,11,11,0,10978,0,10978
420420,201909,2810,1751,1059,1748501.37,1057883.3,2806384.67
420425,201909,72,59,13,58882,12974.98,71856.98
420430,201909,1217,861,356,859279.5,355288.98,1214568.48
420435,201909,17,15,2,14970,1996,16966
420440,201909,103,74,29,73852.4,28942,102794.4
420445,201909,22,21,1,20958,998,21956
420450,201909,78,39,39,38922,38922,77844
420455,201909,221,171,50,170660.94,49902.94,220563.88
420460,201909,2360,1551,809,1550899.3,808388.24,2359287.54
420470,201909,111,78,33,77844,32934,110778
420475,201909,7,7,0,6986,0,6986
420480,201909,868,657,211,656685.2,210578.8,867264.0
420490,201909,108,78,30,77844,29940,107784
420500,201909,546,257,289,256486.46,289420,545906.46
420510,201909,18,17,1,16966,998,17964
420515,201909,27,19,8,18962,7984,26946
420517,201909,10,10,0,9980,0,9980
420519,201909,0,0,0,0,0,0
420520,201909,74,56,18,55888,17964,73852
420530,201909,163,110,53,110778.3,52894,163672.3
420535,201909,20,18,2,17964,1996,19960
420540,201909,5397,3209,2188,3207830.66,2186620.96,5394451.62
420543,201909,26,25,1,24950,998,25948
420545,201909,203,145,58,144710.98,57884.98,202595.96
420550,201909,877,717,160,716566.74,159683.92,876250.66
420555,201909,38,28,10,27944,10978,38922
420560,201909,65,54,11,53892,10978,64870
420570,201909,155,92,63,91816,62874,154690
420580,201909,282,131,151,130738,150698.4,281436.4
420590,201909,521,357,164,357284,163672,520956
420600,201909,111,64,47,63872,47904,111776
420610,201909,41,38,3,37924,2994,40918
420620,201909,79,65,14,64870,13972,78842
420630,201909,156,113,43,112774.99,42915.98,155690.97
420640,201909,87,78,9,77844,8982,86826
420650,201909,233,122,111,121756,111776,233532
420660,201909,50,39,11,38922,10978,49900
420665,201909,37,27,10,26946,9980,36926
420670,201909,313,238,75,237524,75848.98,313372.98
420675,201909,16,15,1,14970,998,15968
420680,201909,37,27,10,26946,9980,36926
420690,201909,181,144,37,143712,36926,180638
420700,201909,704,489,215,488028.28,214577.84,702606.12
420710,201909,150,87,63,86826,62874,149700
420720,201909,111,89,22,88822.98,21956,110778.98
420730,201909,594,384,210,383236.14,210582.32,593818.46
420740,201909,50,49,1,48902,998,49900
420750,201909,512,352,160,351296,159680,510976
420757,201909,17,15,2,14970,1996,16966
420760,201909,35,30,5,29940,4990,34930
420765,201909,77,61,16,60878,15968,76846
420768,201909,51,47,4,46906,3992,50898
420770,201909,83,70,13,69860,12974,82834
420775,201909,45,42,3,41916,2994,44910
420780,201909,233,187,46,186626,45908,232534
420785,201909,11,9,2,8982,1996,10978
420790,201909,161,138,23,138724.94,22955.96,161680.90
420800,201909,66,50,16,49900,15968,65868
420810,201909,248,217,31,216566,31936,248502
420820,201909,2346,1368,978,1366264.58,977044.77,2343309.35
420830,201909,611,340,271,340319.4,271456,611775.4
420840,201909,148,110,38,109780,37924,147704
420845,201909,419,188,231,187624,232534.4,420158.4
420850,201909,252,197,55,198602,54890,253492
420860,201909,64,54,10,53892,9980,63872
420870,201909,123,87,36,86826,35928,122754
420880,201909,180,124,56,123752,55888.98,179640.98
420890,201909,924,466,458,467065.5,458082.98,925148.48
420895,201909,9,9,0,8982,0,8982
420900,201909,420,336,84,335328,84830.98,420158.98
420910,201909,5785,3259,2526,3257480.13,2525945.33,5783425.46
420915,201909,73,69,4,68862,3992,72854
420917,201909,20,14,6,13972,5988,19960
420920,201909,23,16,7,15968,6986,22954
420930,201909,2801,1755,1046,1754478.24,1047068.55,2801546.79
420940,201909,603,442,161,442115.2,161680.49,603795.69
420945,201909,10,8,2,7984,1996,9980
420950,201909,57,52,5,51896,4990,56886
420960,201909,113,89,24,88823.96,23952.98,112776.94
420970,201909,301,244,57,243516.76,56886.98,300403.74
420980,201909,23,22,1,21956,998,22954
420985,201909,62,56,6,55888,5988,61876
420990,201909,77,59,18,58882,17964,76846
421000,201909,34,20,14,19960,13972,33932
421003,201909,62,44,18,44910,17964.98,62874.98
421005,201909,7,4,3,3992,2994,6986
421010,201909,768,531,237,531934.4,236527.4,768461.8
421020,201909,25,20,5,19960,4990,24950
421030,201909,120,102,18,101796.3,17964,119760.3
421040,201909,71,54,17,53892,16966,70858
421050,201909,328,232,96,231536.8,95808,327344.8
421055,201909,23,19,4,18962,3992,22954
421060,201909,84,52,32,51896,31936,83832
421070,201909,49,44,5,43912.4,4990,48902.4
421080,201909,33,31,2,30938,1996,32934
421085,201909,25,19,6,18962,5988,24950
421090,201909,37,29,8,28942,7984,36926
421100,201909,127,94,33,93812,32934,126746
421105,201909,214,175,39,174650.98,38922.98,213573.96
421110,201909,111,89,22,88822,21956,110778
421120,201909,154,117,37,116766.98,36926,153692.98
421125,201909,17,12,5,11976,4990,16966
421130,201909,812,519,293,518960,292414.4,811374.4
421140,201909,30,22,8,21956,7984,29940
421145,201909,41,33,8,32934,7984,40918
421150,201909,103,76,27,75848,26946.8,102794.8
421160,201909,69,49,20,48902,19960,68862
421165,201909,16,15,1,14970,998,15968
421170,201909,189,158,31,157808.32,30938.98,188747.30
421175,201909,157,108,49,107784,49900,157684
421180,201909,56,36,20,35928.24,19960,55888.24
421185,201909,18,14,4,13972,3992,17964
421187,201909,0,0,0,0,0,0
421189,201909,43,31,12,30938,11976,42914
421190,201909,1622,1032,590,1030934,588820.03,1619754.03
421200,201909,87,65,22,64870,21956,86826
421205,201909,27,16,11,15968,10978,26946
421210,201909,168,118,50,117764,49900,167664
421220,201909,278,220,58,219560,57884,277444
421223,201909,50,40,10,39920.6,9980,49900.6
421225,201909,67,42,25,41916.6,24950,66866.6
421227,201909,85,66,19,65868,18962,84830
421230,201909,52,37,15,36926,14970,51896
421240,201909,18,18,0,17964,0,17964
421250,201909,359,220,139,220559.6,139720,360279.6
421260,201909,25,21,4,20958,3992,24950
421265,201909,1,1,0,998,0,998
421270,201909,47,42,5,42914,4990,47904
421280,201909,339,194,145,193612,144710,338322
421290,201909,333,227,106,226546,105788,332334
421300,201909,25,20,5,19960,4990,24950
421310,201909,49,36,13,35928,12974,48902
421315,201909,30,20,10,19960,9980,29940
421320,201909,136,92,44,91816,43912,135728
421330,201909,105,78,27,77844,26946.98,104790.98
421335,201909,39,27,12,26946,11976,38922
421340,201909,244,158,86,158683.32,85828,244511.32
421350,201909,195,110,85,109780.97,84830,194610.97
421360,201909,659,495,164,494011.48,163673.92,657685.40
421370,201909,200,155,45,154690,44910,199600
421380,201909,129,102,27,102794,26946,129740
421390,201909,17,12,5,11976,4990,16966
421400,201909,120,101,19,100798,18962,119760
421410,201909,19,17,2,16966,1996,18962
421415,201909,21,19,2,18962,1996,20958
421420,201909,139,114,25,113772,24950,138722
421430,201909,16,12,4,11976,3992,15968
421440,201909,55,47,8,46906,7984,54890
421450,201909,95,80,15,79840,14970,94810
421460,201909,61,50,11,49900,10978,60878
421470,201909,70,46,24,45908,23952,69860
421480,201909,685,519,166,518960,167664.98,686624.98
421490,201909,24,23,1,22954.98,998,23952.98
421500,201909,498,323,175,322357.34,174665.68,497023.02
421505,201909,25,18,7,17964,6986,24950
421507,201909,30,23,7,22954,6986,29940
421510,201909,76,49,27,48902,26946,75848
421520,201909,56,47,9,46906,8982,55888
421530,201909,51,44,7,43912,6986,50898
421535,201909,26,25,1,24950.44,998,25948.44
421540,201909,57,49,8,48902,7984,56886
421545,201909,99,72,27,71856.98,26946,98802.98
421550,201909,289,209,80,208582,79840,288422
421555,201909,24,19,5,18962,4990,23952
421560,201909,9,8,1,7984,998,8982
421565,201909,125,88,37,87824,36926,124750
421567,201909,30,25,5,24950,4990,29940
421568,201909,29,26,3,25948,2994,28942
421569,201909,8,8,0,7984,0,7984
421570,201909,192,130,62,129740,61876,191616
421575,201909,29,24,5,23952,4990,28942
421580,201909,703,418,285,417229,286426,703655
421590,201909,21,20,1,19960,998,20958
421600,201909,153,100,53,99800,52894.8,152694.8
421605,201909,112,78,34,77844.3,33932,111776.3
421610,201909,192,149,43,148702.4,42914,191616.4
421620,201909,1043,618,425,616765.38,424150,1040915.38
421625,201909,23,20,3,19960,2994,22954
421630,201909,292,189,103,188622.9,102795.2,291418.1
421635,201909,18,9,9,8982,8982,17964
421640,201909,98,83,15,83832.6,14970,98802.6
421650,201909,304,183,121,184630,120758,305388
421660,201909,2227,1355,872,1354287.78,871258.73,2225546.51
421670,201909,186,137,49,136726,48902,185628
421680,201909,176,159,17,158682,16966,175648
421690,201909,346,252,94,251498.36,93812.44,345310.80
421700,201909,58,38,20,37924,19960.8,57884.8
421710,201909,26,25,1,24950,998,25948
421715,201909,7,6,1,5988,998,6986
421720,201909,599,432,167,431136.7,167664,598800.7
421725,201909,14,6,8,5988,7984,13972
421730,201909,36,26,10,25948,9980,35928
421740,201909,90,41,49,40918,48902,89820
421750,201909,214,161,53,160678,52894,213572
421755,201909,26,24,2,23952,1996,25948
421760,201909,103,73,30,72854,29940,102794
421770,201909,629,410,219,409190.54,218567.12,627757.66
421775,201909,30,18,12,17964,11976,29940
421780,201909,194,153,41,152694.4,41916,194610.4
421790,201909,157,136,21,135728,20958,156686
421795,201909,20,16,4,15968,3992,19960
421800,201909,510,328,182,327344,181636.5,508980.5
421810,201909,74,61,13,60878,12974,73852
421820,201909,335,225,110,224550.4,109780,334330.4
421825,201909,135,115,20,114770,19960,134730
421830,201909,135,101,34,100798,33932,134730
421835,201909,4,4,0,3992,0,3992
421840,201909,51,43,8,42914.98,7984,50898.98
421850,201909,78,67,11,67864,10978.99,78842.99
421860,201909,40,31,9,30938,8982,39920
421870,201909,1004,762,242,760503.34,241521.28,1002024.62
421875,201909,54,45,9,44910,8982,53892
421880,201909,164,120,44,119760,44910.4,164670.4
421885,201909,22,18,4,17964,3992,21956
421890,201909,127,90,37,89820,36926.98,126746.98
421895,201909,47,43,4,42914,3992,46906
421900,201909,162,128,34,128743.96,33935.92,162679.88
421910,201909,66,40,26,39920,25948,65868
421915,201909,31,26,5,25948,4990,30938
421917,201909,39,29,10,28942,9980,38922
421920,201909,39,36,3,35928,2994,38922
421930,201909,724,571,153,569858.65,152696.94,722555.59
421935,201909,51,44,7,43912,6986,50898
421940,201909,43,38,5,37924,4990,42914
421950,201909,866,584,282,582832.36,281437.58,864269.94
421960,201909,39,33,6,32934.4,5988,38922.4
421970,201909,360,236,124,235528.4,123752.98,359281.38
421985,201909,28,18,10,17964,9980,27944
422000,201909,0,0,0,0,0,0
430003,201909,193,51,142,50898,141716,192614
430005,201909,37,28,9,27944,8982,36926
430010,201909,270,191,79,191616,78842,270458
430020,201909,146,96,50,95808.4,50898,146706.4
430030,201909,127,103,24,102794,23952,126746
430040,201909,2957,1747,1210,1744506.64,1208580.34,2953086.98
430045,201909,71,59,12,58882,11976,70858
430047,201909,7,6,1,5988,998,6986
430050,201909,80,67,13,66866,12974,79840
430055,201909,14,12,2,11976,1996,13972
430057,201909,6,4,2,3992,1996,5988
430060,201909,3699,2156,1543,2154685.66,1544905.96,3699591.62
430063,201909,56,52,4,51896,3992,55888
430064,201909,161,128,33,127744,32934,160678
430066,201909,5,3,2,2994,1996,4990
430070,201909,46,35,11,34930,10978,45908
430080,201909,69,47,22,46906,21956,68862
430085,201909,33,12,21,11976,20958,32934
430087,201909,31,24,7,23952.7,6986,30938.7
430090,201909,71,64,7,63872,6986,70858
430100,201909,120,81,39,80838,38922,119760
430105,201909,144,76,68,75848.6,67864,143712.6
430107,201909,19,14,5,13972,4990,18962
430110,201909,420,247,173,246506,172654,419160
430120,201909,141,130,11,130738,10978,141716
430130,201909,803,494,309,494010.4,308382,802392.4
430140,201909,124,117,7,116766,6986,123752
430150,201909,106,69,37,68862,36926,105788
430155,201909,34,31,3,30938,2994,33932
430160,201909,3670,2172,1498,2167658.7,1495004.4,3662663.1
430163,201909,345,158,187,158682,186626,345308
430165,201909,29,19,10,18962,9980,28942
430170,201909,91,78,13,77844,12974,90818
430175,201909,78,60,18,59880,17964,77844
430180,201909,105,87,18,86826,17964,104790
430185,201909,35,25,10,24950,9980,34930
430187,201909,86,38,48,37924,47904,85828
430190,201909,216,122,94,121756,93812,215568
430192,201909,13,11,2,10978,1996,12974
430195,201909,16,11,5,10978,4990,15968
430200,201909,164,142,22,143712,21956,165668
430205,201909,20,19,1,18962,998,19960
430210,201909,682,533,149,533930.4,148702.4,682632.8
430215,201909,14,12,2,11976,1996,13972
430220,201909,74,52,22,51896,21956,73852
430222,201909,12,6,6,5988,5988,11976
430223,201909,15,7,8,6986,7984,14970
430225,201909,2,1,1,998,998,1996
430230,201909,319,185,134,184630,133732,318362
430235,201909,55,42,13,41916,12974,54890
430237,201909,25,20,5,19960,4990,24950
430240,201909,128,82,46,82834,45908,128742
430245,201909,68,57,11,56886,10978,67864
430250,201909,192,114,78,113772,77844,191616
430258,201909,10,8,2,7984,1996,9980
430260,201909,32,28,4,27944,3992,31936
430265,201909,37,31,6,30938,5988,36926
430270,201909,531,397,134,398202.3,134733.92,532936.22
430280,201909,1037,640,397,638720,398202,1036922
430290,201909,384,217,167,218562.6,166666,385228.6
430300,201909,2102,1175,927,1173650.38,926148.32,2099798.70
430310,201909,1937,993,944,992013,942115.52,1934128.52
430320,201909,54,43,11,42914,10978,53892
430330,201909,94,83,11,82834,10978,93812
430340,201909,71,59,12,58882,11976,70858
430350,201909,1678,1144,534,1141712.6,532932.98,1674645.58
430355,201909,22,19,3,18962,2994,21956
430360,201909,86,43,43,42914,43912,86826
430367,201909,32,24,8,23952,7984,31936
430370,201909,55,47,8,46906,7984,54890
430380,201909,141,105,36,104790,35928,140718
430390,201909,595,371,224,371256,223552,594808
430400,201909,139,106,33,105788.4,32934,138722.4
430410,201909,58,45,13,44910,12974,57884
430420,201909,506,336,170,335328.94,169660.98,504989.92
430430,201909,53,52,1,51231.33,998,52229.33
430435,201909,151,113,38,112774,38922,151696
430440,201909,508,340,168,339320.6,167664,506984.6
430450,201909,1170,964,206,962072,205588,1167660
430460,201909,5057,2732,2325,2733523.36,2325362.3,5058885.66
430461,201909,17,16,1,15968,998,16966
430462,201909,9,5,4,4990,3992,8982
430463,201909,1056,567,489,565866,492015.96,1057881.96
430465,201909,23,13,10,12974,9980,22954
430466,201909,683,485,198,484030.4,197604,681634.4
430467,201909,99,54,45,53892.6,44910,98802.6
430468,201909,116,69,47,68862,46906,115768
430469,201909,22,17,5,16966,4990,21956
430470,201909,1152,651,501,653987.95,499998,1153985.95
430471,201909,56,39,17,38922,16966,55888
430480,201909,103,65,38,64870,37924,102794
430485,201909,6,6,0,5988.4,0,5988.4
430490,201909,86,70,16,69860,15968,85828
430495,201909,36,27,9,26946,8982,35928
430500,201909,191,128,63,127744,62874.63,190618.63
430510,201909,3457,2279,1178,2278434.28,1177640,3456074.28
430511,201909,16,15,1,14970,998,15968
430512,201909,145,103,42,102794,41916,144710
430513,201909,50,40,10,39920,9980,49900
430515,201909,30,28,2,27944,1996,29940
430517,201909,166,147,19,146706,18962,165668
430520,201909,360,251,109,250498,108782,359280
430530,201909,84,47,37,46906,36926,83832
430535,201909,449,308,141,307384,140718.99,448102.99
430537,201909,9,9,0,8982,0,8982
430540,201909,81,54,27,53892,26946,80838
430543,201909,350,109,241,108782,240518,349300
430544,201909,44,41,3,40918,2994,43912
430545,201909,362,186,176,186626,175648,362274
430550,201909,41,34,7,33932,6986,40918
430558,201909,4,2,2,1996,1996,3992
430560,201909,56,30,26,29940,25948,55888
430570,201909,108,42,66,41916,65868,107784
430580,201909,127,104,23,103792,22954.6,126746.6
430583,201909,14,14,0,13972,0,13972
430585,201909,11,4,7,3992,6986,10978
430587,201909,15,7,8,6986,7984,14970
430590,201909,152,126,26,125748,25948,151696
430593,201909,2,2,0,1996,0,1996
430595,201909,17,14,3,13972,2994,16966
430597,201909,47,26,21,25948,20958,46906
430600,201909,216,155,61,155688,60878,216566
430605,201909,155,96,59,95808,58882,154690
430607,201909,20,17,3,16966,2994,19960
430610,201909,1612,764,848,763470,848301.38,1611771.38
430613,201909,3,3,0,2994,0,2994
430620,201909,111,78,33,77844,32934,110778
430630,201909,46,40,6,39920,5988,45908
430632,201909,32,27,5,26946,4990,31936
430635,201909,35,32,3,31936,2994,34930
430637,201909,53,29,24,28942,24950,53892
430640,201909,188,107,81,106786,80838,187624
430642,201909,21,19,2,18962,1996,20958
430645,201909,35,29,6,28942,5988,34930
430650,201909,251,202,49,203592.4,49900,253492.4
430655,201909,2,2,0,1996,0,1996
430660,201909,973,478,495,477044,496006.4,973050.4
430670,201909,76,52,24,51896,23952,75848
430673,201909,74,42,32,41916,31936,73852
430675,201909,12,9,3,8982,2994,11976
430676,201909,496,300,196,301396,196606,498002
430680,201909,243,169,74,168662,73852,242514
430690,201909,545,342,203,341316.98,204590.63,545907.61
430692,201909,7,5,2,4990,1996,6986
430693,201909,138,92,46,91816,45908,137724
430695,201909,72,60,12,59880,11976,71856
430697,201909,57,36,21,35928,20958,56886
430700,201909,1535,1068,467,1067861.16,468062,1535923.16
430705,201909,20,19,1,18962,998,19960
430710,201909,263,169,94,168662,93812.22,262474.22
430720,201909,106,90,16,90818,15968,106786
430730,201909,137,117,20,116766,19960,136726
430740,201909,72,48,24,47904,23952,71856
430745,201909,34,26,8,25948,7984,33932
430750,201909,340,225,115,224550,115768,340318
430755,201909,88,51,37,50898,36926,87824
430760,201909,368,215,153,214571.04,152694.98,367266.02
430770,201909,1443,757,686,755487.3,684631.88,1440119.18
430780,201909,307,194,113,193612.98,113772.98,307385.96
430781,201909,28,24,4,23952,3992,27944
430783,201909,57,46,11,45908,10978,56886
430786,201909,6,4,2,3992,1996,5988
430790,201909,528,348,180,349300,179640.4,528940.4
430800,201909,158,131,27,131736,26946,158682
430805,201909,40,37,3,36926,2994,39920
430807,201909,45,25,20,24950,19960,44910
430810,201909,80,53,27,52894,26946,79840
430820,201909,145,86,59,85828,59880.98,145708.98
430825,201909,10,8,2,7984,1996,9980
430830,201909,236,220,16,219560.4,15968,235528.4
430840,201909,128,87,41,86826,40918,127744
430843,201909,7,4,3,3992,2994,6986
430845,201909,74,42,32,42914,31936,74850
430850,201909,585,407,178,407184,178644.94,585828.94
430860,201909,166,107,59,106786,58882,165668
430865,201909,70,39,31,38922,30938.98,69860.98
430870,201909,77,63,14,62874,14970,77844
430880,201909,154,116,38,115768,37924,153692
430885,201909,10,8,2,7984,1996,9980
430890,201909,353,214,139,213572,138722,352294
430900,201909,525,366,159,364769,158682,523451
430905,201909,109,48,61,47904,60878,108782
430910,201909,284,157,127,156686,126746.98,283432.98
430912,201909,5,5,0,4990,0,4990
430915,201909,36,30,6,29940,5988,35928
430920,201909,4222,2304,1918,2301390.4,1920154.08,4221544.48
430925,201909,4,3,1,2994,998,3992
430930,201909,2048,1197,851,1195605.9,851296.34,2046902.24
430940,201909,258,169,89,168662,88822,257484
430950,201909,152,125,27,124750,26946,151696
430955,201909,23,12,11,12974,10978,23952
430957,201909,16,15,1,14970,998,15968
430960,201909,247,163,84,162674,83832,246506
430965,201909,115,75,40,74850,39920,114770
430970,201909,81,67,14,67864,13972,81836
430975,201909,43,39,4,38922,3992,42914
430980,201909,46,30,16,29940,15968,45908
430990,201909,115,88,27,87824,26946,114770
430995,201909,121,115,6,114770,5988,120758
431000,201909,308,138,170,137725,169660,307385
431010,201909,345,198,147,198602,146706,345308
431020,201909,1901,1103,798,1102790.6,800396,1903186.6
431030,201909,42,33,9,32934,8982,41916
431033,201909,381,189,192,188622,191616,380238
431036,201909,13,8,5,7984,4990,12974
431040,201909,135,83,52,82834,51896,134730
431041,201909,38,26,12,25948.7,11976,37924.7
431043,201909,50,29,21,28942,20958,49900
431046,201909,11,7,4,6986,3992,10978
431050,201909,197,126,71,126746,70858,197604
431053,201909,72,43,29,42914,28942,71856
431055,201909,65,46,19,45908,18962,64870
431057,201909,18,18,0,17964,0,17964
431060,201909,1640,1052,588,1051894.35,588835.4,1640729.75
431065,201909,20,12,8,11976,7984,19960
431070,201909,63,57,6,56886,5988,62874
431075,201909,7,7,0,6986,0,6986
431080,201909,127,76,51,77844,50898,128742
431085,201909,34,29,5,29940,4990,34930
431087,201909,15,12,3,11976,2994,14970
431090,201909,56,44,12,43912,11976,55888
431100,201909,1219,724,495,722554.02,497004,1219558.02
431110,201909,240,147,93,147704,92814.4,240518.4
431112,201909,25,14,11,14970,10978,25948
431113,201909,34,25,9,24950,8982,33932
431115,201909,155,109,46,108782,47904,156686
431120,201909,602,365,237,365268.6,237524.96,602793.56
431123,201909,3,2,1,1996,998,2994
431125,201909,96,87,9,86826,8982,95808
431127,201909,9,4,5,3992,4990,8982
431130,201909,702,456,246,455088,245508,700596
431140,201909,747,522,225,522952.4,224550,747502.4
431142,201909,32,26,6,25948.95,5988,31936.95
431150,201909,193,148,45,147704,44910,192614
431160,201909,52,47,5,46906,4990,51896
431162,201909,12,9,3,8982,2994,11976
431164,201909,6,6,0,5988,0,5988
431170,201909,110,87,23,86826,22954,109780
431171,201909,68,42,26,41916,25948,67864
431173,201909,1,1,0,998,0,998
431175,201909,198,103,95,102794.4,94810,197604.4
431177,201909,74,56,18,55888,17964,73852
431179,201909,14,12,2,11976,1996,13972
431180,201909,455,279,176,279440,177644.98,457084.98
431190,201909,82,63,19,62874,18962,81836
431198,201909,68,48,20,48902,19960,68862
431200,201909,21,17,4,16966,3992,20958
431205,201909,22,22,0,21956,0,21956
431210,201909,90,55,35,54890,34930,89820
431213,201909,32,28,4,27944,3992,31936
431215,201909,23,20,3,19960,2994,22954
431217,201909,5,4,1,3992,998,4990
431220,201909,69,60,9,59880,8982,68862
431225,201909,144,96,48,96806.98,48902,145708.98
431230,201909,106,93,13,92814,12974,105788
431235,201909,8,8,0,7984,0,7984
431237,201909,22,16,6,15968,5988,21956
431238,201909,9,6,3,5988.4,2994,8982.4
431240,201909,982,632,350,630736.2,350298,981034.2
431242,201909,37,36,1,35928,998,36926
431244,201909,13,9,4,8982,3992,12974
431245,201909,53,40,13,39920,12974,52894
431247,201909,11,8,3,7984,2994,10978
431250,201909,276,143,133,144710,132734,277444
431260,201909,57,44,13,43912,12974,56886
431261,201909,17,10,7,9980,6986,16966
431262,201909,19,18,1,17964,998,18962
431265,201909,147,81,66,80838,65868,146706
431267,201909,14,13,1,12974,998,13972
431270,201909,326,268,58,267464,57884,325348
431275,201909,38,35,3,34930,2994,37924
431280,201909,19,15,4,14970,3992,18962
431290,201909,24,20,4,19960,4990,24950
431295,201909,3,3,0,2994,0,2994
431300,201909,23,20,3,19960,2994,22954
431301,201909,6,6,0,5988,0,5988
431303,201909,59,39,20,38922,19960,58882
431306,201909,236,126,110,125570.35,109780,235350.35
431308,201909,7,5,2,4990,1996,6986
431310,201909,65,54,11,53892,10978,64870
431320,201909,146,88,58,87824,58882,146706
431330,201909,177,115,62,114770,61876,176646
431333,201909,28,24,4,23952,3992,27944
431335,201909,9,5,4,4990,3992,8982
431337,201909,332,148,184,147704,183632,331336
431339,201909,21,18,3,17964,2994,20958
431340,201909,2984,1681,1303,1679559.51,1302406.2,2981965.71
431342,201909,39,24,15,23952,14970,38922
431344,201909,18,18,0,17964,0,17964
431346,201909,5,5,0,4990,0,4990
431349,201909,34,31,3,30938,2994,33932
431350,201909,928,548,380,546905.48,381236.4,928141.88
431360,201909,47,42,5,41916,4990,46906
431365,201909,326,160,166,159680,165668,325348
431370,201909,1323,772,551,771454.4,550900.9,1322355.3
431380,201909,97,83,14,82834,13972,96806
431390,201909,505,274,231,273452,230538,503990
431395,201909,296,134,162,135728,161676,297404
431400,201909,43,30,13,29940,12974,42914
431402,201909,100,71,29,70858,28942,99800
431403,201909,22,12,10,11976,9980,21956
431405,201909,668,364,304,363272.9,304391.96,667664.86
431406,201909,31,26,5,25948,4990,30938
431407,201909,51,40,11,39920,10978,50898
431410,201909,3437,2118,1319,2114763.4,1319356.3,3434119.7
431413,201909,15,12,3,11976,2994,14970
431415,201909,69,53,16,52894,15968,68862
431417,201909,21,12,9,11976,8982,20958
431420,201909,313,213,100,212574,99800,312374
431430,201909,49,23,26,22954,25948,48902
431440,201909,8894,6239,2655,6228528.03,2650689.4,8879217.43
431442,201909,28,16,12,15968,11976,27944
431445,201909,25,22,3,21956,2994,24950
431446,201909,4,4,0,3992,0,3992
431447,201909,85,61,24,60878,23952,84830
431449,201909,55,47,8,46906,7984,54890
431450,201909,420,282,138,281436,137724,419160
431454,201909,0,0,0,0,0,0
431455,201909,54,41,13,40918,12974,53892
431460,201909,522,362,160,362274,159680,521954
431470,201909,120,93,27,92814,26946,119760
431475,201909,10,9,1,8982,998,9980
431477,201909,39,26,13,25948,12974,38922
431478,201909,8,7,1,6986,998,7984
431480,201909,485,305,180,304390,179640,484030
431490,201909,28573,16089,12484,16076797.14,12483003.75,28559800.89
431500,201909,82,60,22,59880.5,21956,81836.5
431505,201909,27,17,10,16966,9980,26946
431507,201909,12,9,3,8982,2994,11976
431510,201909,256,179,77,178642.1,76846,255488.1
431513,201909,25,22,3,21956,2994,24950
431514,201909,6,5,1,4990,998,5988
431515,201909,82,69,13,68862,12974,81836
431517,201909,5,4,1,3992,998,4990
431520,201909,38,33,5,32934,4990,37924
431530,201909,1524,689,835,688620,834328,1522948
431531,201909,26,24,2,23952,1996,25948
431532,201909,30,22,8,21956,7984,29940
431535,201909,26,16,10,15968,9980,25948
431540,201909,139,119,20,118762,20958,139720
431545,201909,13,11,2,10978,1996,12974
431550,201909,353,200,153,199600,153692,353292
431555,201909,12,12,0,11976,0,11976
431560,201909,4541,3139,1402,3135720.77,1400194.4,4535915.17
431570,201909,815,436,379,435128.8,378242,813370.8
431575,201909,39,23,16,22954,15968,38922
431580,201909,101,70,31,69860,30938,100798
431590,201909,145,124,21,123752.5,20958,144710.5
431595,201909,19,16,3,15968,2994,18962
431600,201909,227,127,100,126746,99800,226546
431610,201909,121,88,33,87824,32934,120758
431620,201909,45,37,8,36926,7984,44910
431630,201909,128,106,22,105788,21956,127744
431640,201909,1328,845,483,843310.4,483032.4,1326342.8
431642,201909,35,33,2,32934,1996,34930
431643,201909,43,21,22,20958,21956,42914
431645,201909,324,192,132,191616,131736,323352
431647,201909,10,10,0,9980,0,9980
431650,201909,33,23,10,22954,9980,32934
431660,201909,316,202,114,201596,113772,315368
431670,201909,235,110,125,109780,124750,234530
431673,201909,3,3,0,2994,0,2994
431675,201909,26,21,5,20958,4990,25948
431680,201909,1127,834,293,832332,293412,1125744
431690,201909,4745,2886,1859,2882226.04,1857282.48,4739508.52
431695,201909,21,16,5,15968,4990,20958
431697,201909,0,0,0,0,0,0
431700,201909,169,134,35,133732,34930,168662
431710,201909,3992,1777,2215,1774445.58,2217566.78,3992012.36
431720,201909,1343,825,518,824348.6,517962.99,1342311.59
431725,201909,1,1,0,998,0,998
431730,201909,1178,805,373,803392.16,374250,1177642.16
431740,201909,1367,676,691,675646,691618.32,1367264.32
431750,201909,1838,1204,634,1201593.71,633730.98,1835324.69
431755,201909,5,4,1,3992,998,4990
431760,201909,1022,661,361,659679.8,362274,1021953.8
431770,201909,402,294,108,293412,107784,401196
431775,201909,30,22,8,21956,7984,29940
431780,201909,554,346,208,345308,208582,553890
431790,201909,171,132,39,131736,38922,170658
431795,201909,12,10,2,9980,1996,11976
431800,201909,3308,1745,1563,1742521,1561961.92,3304482.92
431805,201909,19,17,2,16966,1996,18962
431810,201909,604,408,196,407184,195608.98,602792.98
431820,201909,318,186,132,185628,132734,318362
431830,201909,2343,1420,923,1418158.4,923153.93,2341312.33
431840,201909,490,327,163,328342.6,162674,491016.6
431842,201909,36,29,7,28942,6986,35928
431843,201909,11,8,3,8982,2994,11976
431844,201909,16,14,2,13972,1996,15968
431845,201909,26,24,2,23952,1996,25948
431846,201909,29,24,5,23952,4990,28942
431848,201909,12,10,2,9980,1996,11976
431849,201909,10,7,3,6986,2994,9980
431850,201909,803,660,143,658680,142714,801394
431860,201909,113,78,35,77844,34930,112774
431861,201909,4,2,2,1996,1996,3992
431862,201909,53,35,18,34930,17964,52894
431870,201909,3414,2003,1411,2002988.58,1409182.86,3412171.44
431880,201909,925,681,244,680636,243512,924148
431890,201909,1294,793,501,791414,499998,1291412
431900,201909,184,132,52,131736,51896,183632
431910,201909,57,40,17,39920,16966,56886
431912,201909,39,23,16,22954,15968,38922
431915,201909,127,101,26,100798,25948,126746
431920,201909,155,115,40,114770,39920,154690
431930,201909,78,64,14,63872,13972,77844
431935,201909,3,3,0,2994,0,2994
431936,201909,12,11,1,10978,998,11976
431937,201909,19,14,5,13972,4990,18962
431940,201909,464,312,152,311376,151696.5,463072.5
431950,201909,502,313,189,313373.38,188622.98,501996.36
431960,201909,726,404,322,404191.38,321356.98,725548.36
431970,201909,74,66,8,65868.4,7984,73852.4
431971,201909,3,3,0,2994,0,2994
431973,201909,21,17,4,17964,3992,21956
431975,201909,9,8,1,7984,998,8982
431980,201909,212,133,79,132734,78842,211576
431990,201909,1181,635,546,634663.71,544909.96,1179573.67
432000,201909,1650,889,761,888223,760478.18,1648701.18
432010,201909,278,189,89,188622,88822,277444
432020,201909,175,142,33,141716,32934,174650
432023,201909,15,13,2,12974,1996,14970
432026,201909,69,64,5,63872,4990,68862
432030,201909,69,35,34,34930,33932,68862
432032,201909,21,16,5,15968,4990,20958
432035,201909,53,43,10,42914,9980,52894
432040,201909,102,71,31,70858,30938,101796
432045,201909,8,7,1,6986,998,7984
432050,201909,83,51,32,50898,31936,82834
432055,201909,120,90,30,89820,29940,119760
432057,201909,5,4,1,3992.4,998,4990.4
432060,201909,34,31,3,30938,2994,33932
432065,201909,32,28,4,27944,3992,31936
432067,201909,88,79,9,78842,8982,87824
432070,201909,400,309,91,310628.8,91816.98,402445.78
432080,201909,828,578,250,576844,249500,826344
432085,201909,13,10,3,9980,2994,12974
432090,201909,265,174,91,173652,90818,264470
432100,201909,174,117,57,116766,56886,173652
432110,201909,588,395,193,395208,192614,587822
432120,201909,932,568,364,566864,364270,931134
432130,201909,495,357,138,357284,138722,496006
432132,201909,24,21,3,20958,2994,23952
432135,201909,77,64,13,63872,12974,76846
432140,201909,264,210,54,209580,53892,263472
432143,201909,201,130,71,129740,70858,200598
432145,201909,271,187,84,186626,83832,270458
432146,201909,13,13,0,12974,0,12974
432147,201909,114,59,55,58882,55888,114770
432149,201909,13,9,4,8982,3992,12974
432150,201909,836,517,319,515966.4,318363.55,834329.95
432160,201909,1423,744,679,742546.83,677642.98,1420189.81
432162,201909,4,3,1,2994,998,3992
432163,201909,19,14,5,13972,4990,18962
432166,201909,110,82,28,82086.4,27944,110030.4
432170,201909,223,113,110,112774,109780,222554
432180,201909,543,334,209,333332,209580.4,542912.4
432183,201909,6,6,0,5988,0,5988
432185,201909,78,69,9,68862,8982,77844
432190,201909,481,282,199,282434,198602.98,481036.98
432195,201909,86,72,14,71856,13972,85828
432200,201909,392,256,136,255488,135728.98,391216.98
432210,201909,117,73,44,72854,43912,116766
432215,201909,51,47,4,46906,3992,50898
432218,201909,21,20,1,19960,998,20958
432220,201909,679,355,324,354290,324352.57,678642.57
432225,201909,13,8,5,7984,4990,12974
432230,201909,144,97,47,96806,46906,143712
432232,201909,14,13,1,12974,998,13972
432234,201909,4,3,1,2994,998,3992
432235,201909,3,3,0,2994,0,2994
432237,201909,27,15,12,14970,11976,26946
432240,201909,4338,2449,1889,2448095.2,1889216.58,4337311.78
432250,201909,1092,698,394,697602,395208,1092810
432252,201909,43,38,5,37924,4990,42914
432253,201909,62,50,12,49900,11976,61876
432254,201909,28,13,15,12974,14970,27944
432255,201909,12,11,1,10978,998,11976
432260,201909,837,662,175,660676.4,176646,837322.4
432270,201909,242,181,61,180638,60878,241516
432280,201909,145,109,36,108782.6,35928,144710.6
432285,201909,2,2,0,1996,0,1996
432290,201909,66,59,7,58882,6986,65868
432300,201909,4614,2580,2034,2579766.13,2032928.24,4612694.37
432310,201909,120,99,21,98802,20958,119760
432320,201909,22,17,5,16966,4990,21956
432330,201909,16,12,4,11976,3992,15968
432335,201909,7,6,1,5988,998,6986
432340,201909,40,35,5,34930,5988,40918
432345,201909,98,69,29,68862,28942,97804
432350,201909,25,24,1,23952,998,24950
432360,201909,7,5,2,4990,1996,6986
432370,201909,23,22,1,21956,998,22954
432375,201909,34,31,3,30938,2994,33932
432377,201909,9,9,0,8982,0,8982
432380,201909,167,80,87,79840,86826,166666
500020,201909,239,137,102,136726,101796,238522
500025,201909,126,64,62,63872,61876,125748
500060,201909,1451,914,537,912172,535927.38,1448099.38
500070,201909,804,389,415,391216.96,416166,807382.96
500080,201909,129,106,23,105788,22954,128742
500085,201909,134,108,26,107784.4,25948,133732.4
500090,201909,329,158,171,157684,170658,328342
500100,201909,729,385,344,385228,343312.8,728540.8
500110,201909,2285,1063,1222,1061877.71,1225555.8,2287433.51
500124,201909,257,150,107,149700,107784,257484
500150,201909,322,139,183,138722,182636.94,321358.94
500190,201909,523,365,158,364270,158682.4,522952.4
500200,201909,187,162,25,161676.28,25948,187624.28
500210,201909,1491,534,957,533935.88,955128.04,1489063.92
500215,201909,243,142,101,141716,100798,242514
500220,201909,750,489,261,488024.66,261476,749500.66
500230,201909,253,168,85,167664,85828,253492
500240,201909,677,472,205,473052.36,204590,677642.36
500260,201909,587,230,357,229540,358282,587822
500270,201909,29464,12788,16676,12785813.72,16681751.89,29467565.61
500280,201909,194,71,123,70858,122754,193612
500290,201909,1179,711,468,709578.4,467064.98,1176643.38
500295,201909,447,287,160,286426.4,159680,446106.4
500310,201909,67,23,44,22954,43912,66866
500315,201909,724,438,286,437124,285428,722552
500320,201909,3666,1850,1816,1846301.75,1813371.88,3659673.63
500325,201909,928,513,415,511975.38,415168.4,927143.78
500330,201909,1451,682,769,681634.4,767462.98,1449097.38
500345,201909,307,236,71,235529.38,70858,306387.38
500348,201909,249,152,97,151696,96806,248502
500350,201909,126,61,65,60878,64870,125748
500370,201909,5457,2478,2979,2478036.48,2979036.9,5457073.38
500375,201909,341,249,92,248502,91816,340318
500380,201909,590,340,250,339320,249500,588820
500390,201909,73,34,39,33932,38922,72854
500400,201909,208,146,62,145708,61876.98,207584.98
500410,201909,550,226,324,225550.95,323357.87,548908.82
500430,201909,519,371,148,371256,147704,518960
500440,201909,198,105,93,104790,93812,198602
500450,201909,401,179,222,178642,223552,402194
500460,201909,293,151,142,150698,141716,292414
500470,201909,443,351,92,350299.39,92814.98,443114.37
500480,201909,105,61,44,60878,43912,104790
500490,201909,110,46,64,45908,63872,109780
500500,201909,1423,524,899,523959.83,899229.51,1423189.34
500510,201909,43,33,10,32934,9980.98,42914.98
500515,201909,109,76,33,75848,32934,108782
500520,201909,335,186,149,185628.8,148703.39,334332.19
500525,201909,90,49,41,48902,40918,89820
500540,201909,902,386,516,386226.98,516965.96,903192.94
500560,201909,913,522,391,520956,392214.4,913170.4
500568,201909,969,562,407,562872,406187.39,969059.39
500570,201909,1195,695,500,693631.58,500050.92,1193682.50
500580,201909,333,174,159,173652,158683.97,332335.97
500600,201909,317,166,151,165668,150699.96,316367.96
500620,201909,915,647,268,646704,268462,915166
500625,201909,76,64,12,63872,11976,75848
500627,201909,22,11,11,10978,10978,21956
500630,201909,1568,853,715,851294.9,718560,1569854.9
500635,201909,521,306,215,305388,214570,519958
500640,201909,403,211,192,210578.8,191616,402194.8
500660,201909,5449,2078,3371,2073844.4,3374240.18,5448084.58
500690,201909,577,210,367,209589.78,366290.5,575880.28
500710,201909,386,199,187,198602,186627.96,385229.96
500720,201909,958,562,396,562872.43,395208,958080.43
500730,201909,192,118,74,117764,73852,191616
500740,201909,865,375,490,375254.34,489048.69,864303.03
500750,201909,149,47,102,46906,102794.98,149700.98
500755,201909,126,89,37,88822.4,36926,125748.4
500769,201909,735,414,321,414172.37,321357.97,735530.34
500770,201909,413,213,200,212574,199600,412174
500780,201909,161,110,51,109780,51896,161676
500790,201909,1063,547,516,546904,516968.91,1063872.91
500793,201909,275,156,119,155688,118763.38,274451.38
500795,201909,165,119,46,118762,45908.98,164670.98
500797,201909,51,38,13,37924,12974,50898
500800,201909,417,189,228,189620.98,229540,419160.98
500830,201909,2246,1271,975,1271453.34,974049.01,2245502.35
500840,201909,141,105,36,104790,35928.98,140718.98
510010,201909,167,92,75,91816,74850,166666
510020,201909,488,223,265,223570.62,264500.38,488071.00
510025,201909,1693,972,721,972062.15,720572.08,1692634.23
510030,201909,660,346,314,345310.94,314373.35,659684.29
510035,201909,129,61,68,60879.96,67864.98,128744.94
510040,201909,382,172,210,171656,209582.68,381238.68
510050,201909,390,216,174,215573.86,173658.32,389232.18
510060,201909,111,56,55,55888,54890,110778
510080,201909,224,88,136,87825.96,135728.98,223554.94
510100,201909,72,32,40,31936,39920,71856
510120,201909,37,24,13,23952,12974,36926
510125,201909,383,240,143,240518.98,142715.97,383234.95
510130,201909,568,331,237,330346.82,237534.18,567881.00
510140,201909,404,123,281,122754,281436,404190
510160,201909,105,39,66,38922,65868,104790
510170,201909,822,501,321,500012.88,320372.68,820385.56
510180,201909,2876,1390,1486,1388262.39,1485056.22,2873318.61
510185,201909,14,6,8,5988,7984,13972
510190,201909,220,78,142,77844,141716,219560
510250,201909,2567,1519,1048,1518963.26,1047904.32,2566867.58
510260,201909,180,133,47,132748.7,46906.98,179655.68
510263,201909,460,263,197,262477.74,196606.98,459084.72
510267,201909,678,376,302,376260.32,301418.52,677678.84
510268,201909,58,29,29,28942,28942,57884
510269,201909,73,34,39,33932.98,38922,72854.98
510270,201909,390,199,191,198605.92,190622.9,389228.82
510279,201909,221,164,57,163674.94,56886.4,220561.34
510285,201909,181,74,107,73852.98,106786,180638.98
510300,201909,515,286,229,285432.92,229546.86,514979.78
510305,201909,206,99,107,98803.97,106786.98,205590.95
510310,201909,104,55,49,54890,48902,103792
510320,201909,844,536,308,535931.88,308395.73,844327.61
510325,201909,399,166,233,165668,232534,398202
510330,201909,423,240,183,239520.99,183632,423152.99
510335,201909,624,362,262,361278.95,261480.9,622759.85
510336,201909,52,39,13,38922,12974,51896
510337,201909,109,45,64,44910,63872,108782
510340,201909,17082,8031,9051,8019150.65,9043186.89,17062337.54
510343,201909,63,44,19,43912,18962,62874
510345,201909,165,110,55,109780,54890.4,164670.4
510350,201909,650,366,284,365272.9,285432.32,650705.22
510360,201909,197,125,72,124750.98,71861.88,196612.86
510370,201909,140,73,67,72854,66868.94,139722.94
510380,201909,88,63,25,62874,24950.98,87824.98
510385,201909,58,26,32,25948,31936.98,57884.98
510390,201909,110,48,62,47904,61876,109780
510395,201909,48,35,13,34930,12974,47904
510410,201909,697,465,232,464071.98,232535.96,696607.94
510420,201909,567,282,285,281455.56,287452.28,568907.84
510450,201909,52,28,24,27944,23952,51896
510452,201909,47,27,20,26946,19960,46906
510454,201909,53,24,29,23952,28942,52894
510455,201909,127,78,49,77844,48902,126746
510460,201909,172,90,82,89821.68,81836.98,171658.66
510480,201909,743,433,310,432141.12,310389.66,742530.78
510490,201909,352,183,169,182639.84,168664.9,351304.74
510500,201909,238,179,59,178642,58882,237524
510510,201909,805,474,331,473054.36,330338,803392.36
510515,201909,1174,632,542,630741.88,540916.98,1171658.86
510517,201909,256,108,148,107784,147704.98,255488.98
510520,201909,228,152,76,151698.94,75852.88,227551.82
510523,201909,96,73,23,72854,22954,95808
510525,201909,803,479,324,478046.91,323356.9,801403.81
510530,201909,17,12,5,11976,4990,16966
510550,201909,250,112,138,111776.98,137724,249500.98
510558,201909,285,139,146,138722.98,145708,284430.98
510560,201909,409,244,165,243512.4,164671.96,408184.36
510562,201909,653,471,182,471056,183632,654688
510590,201909,748,388,360,388222.98,359282.95,747505.93
510600,201909,245,135,110,134730,110779.96,245509.96
510610,201909,177,81,96,80838,95808,176646
510615,201909,192,79,113,78842,112774,191616
510617,201909,19,12,7,11976,6986,18962
510618,201909,118,57,61,56886,61876,118762
510619,201909,100,69,31,68862.98,30938.98,99801.96
510620,201909,170,93,77,92814,77844,170658
510621,201909,188,124,64,123752.98,63873.96,187626.94
510622,201909,489,311,178,310384.86,177645.96,488030.82
510623,201909,347,238,109,237525.96,108782,346307.96
510624,201909,89,44,45,43912.98,44910,88822.98
510625,201909,544,334,210,333347.68,209592.37,542940.05
510626,201909,112,71,41,70858.98,40918,111776.98
510627,201909,66,45,21,44910,20958,65868
510628,201909,148,88,60,87824.98,59880,147704.98
510629,201909,254,162,92,161676,91816,253492
510630,201909,450,232,218,231538.94,217567.34,449106.28
510631,201909,12,3,9,2994,8982,11976
510637,201909,345,208,137,207586.95,136736.78,344323.73
510642,201909,970,545,425,543912.94,426147.96,970060.90
510645,201909,0,0,0,0,0,0
510650,201909,1427,952,475,951107.16,475052.87,1426160.03
510665,201909,81,42,39,42917.88,38922,81839.88
510670,201909,61,35,26,34930,25948,60878
510675,201909,1139,719,420,717565.34,420158,1137723.34
510677,201909,341,176,165,175652.9,164675.88,340328.78
510680,201909,103,62,41,61878.94,40918.98,102797.92
510682,201909,206,103,103,103792,103792,207584
510685,201909,53,41,12,40918,11976,52894
510700,201909,593,346,247,345318.78,247511.85,592830.63
510704,201909,1123,602,521,601914.51,523055.86,1124970.37
510706,201909,125,65,60,64870,59880.98,124750.98
510710,201909,392,274,118,273456.88,117765.92,391222.80
510715,201909,62,46,16,45908,15968,61876
510718,201909,203,108,95,107786.94,94810,202596.94
510719,201909,37,17,20,16966,19960,36926
510720,201909,191,132,59,132734,58882,191616
510724,201909,88,35,53,34930,52894,87824
510726,201909,50,25,25,24950,24950.98,49900.98
510729,201909,69,32,37,31936,36926,68862
510730,201909,467,261,206,260479.96,205589.97,466069.93
510735,201909,109,46,63,45908,62874,108782
510740,201909,23,13,10,12974,9980,22954
510757,201909,16,13,3,12974,2994,15968
510760,201909,7069,3763,3306,3760527.79,3307577.71,7068105.50
510770,201909,672,318,354,317367.9,353302.74,670670.64
510774,201909,17,7,10,6986,9980,16966
510775,201909,107,82,25,81836,24950,106786
510776,201909,29,10,19,9980,18962,28942
510777,201909,184,83,101,82834,100798,183632
510779,201909,49,21,28,20958.98,27945.96,48904.94
510780,201909,291,162,129,161682.88,128747.85,290430.73
510785,201909,401,216,185,215568,184630,400198
510787,201909,195,94,101,93812.98,100799.97,194612.95
510788,201909,0,0,0,0,0,0
510790,201909,2437,1299,1138,1298448.88,1137806.24,2436255.12
510792,201909,1144,664,480,662680.82,480051.73,1142732.55
510794,201909,113,57,56,56886,55888.98,112774.98
510795,201909,2361,1394,967,1395209.75,968066.68,2363276.43
510800,201909,181,112,69,111776,68862,180638
510805,201909,168,114,54,113772,53892.98,167664.98
510810,201909,97,45,52,44915.88,51896,96811.88
510820,201909,243,119,124,118766.12,123754.51,242520.63
510830,201909,67,41,26,40918,25948.98,66866.98
510835,201909,12,9,3,8982,2994,11976
510840,201909,9028,4417,4611,4409363.34,4607986.04,9017349.38
510850,201909,213,84,129,83832,129740.98,213572.98
510860,201909,381,171,210,170663.88,209590.18,380254.06
510880,201909,64,48,16,47904.98,15968,63872.98
510885,201909,71,42,29,41916.98,28942,70858.98
510890,201909,66,39,27,38922,26946,65868
510895,201909,188,110,78,109780,77846.37,187626.37
520005,201909,51,30,21,29940,20958,50898
520010,201909,274,126,148,125748,148702.8,274450.8
520013,201909,696,444,252,443112.98,253492,696604.98
520015,201909,53,38,15,38922,14970,53892
520017,201909,90,52,38,51896.4,37924,89820.4
520020,201909,20,10,10,9980,9980,19960
520025,201909,2096,1134,962,1133728.8,962072,2095800.8
520030,201909,803,433,370,432135.58,371256,803391.58
520050,201909,73,49,24,48902,23952,72854
520055,201909,45,29,16,28942,15968,44910
520060,201909,177,119,58,118762,57884,176646
520080,201909,569,411,158,410810.06,157684,568494.06
520082,201909,19,13,6,13972,5988,19960
520085,201909,96,71,25,70858,24950,95808
520090,201909,93,62,31,62874,30938,93812
520110,201909,9087,3982,5105,3979032.52,5102781.48,9081814.00
520120,201909,13,8,5,7984,4990,12974
520130,201909,786,555,231,553890.98,231536.4,785427.38
520140,201909,11908,6737,5171,6728530.2,5171654.02,11900184.22
520145,201909,47,31,16,30938,15968,46906
520150,201909,176,138,38,137724,37924,175648
520160,201909,36,27,9,26946,8982,35928
520170,201909,247,144,103,144711.95,102796.92,247508.87
520180,201909,144,74,70,73852,69860,143712
520215,201909,209,138,71,137724,70858,208582
520235,201909,73,55,18,54890,17964,72854
520250,201909,131,80,51,79840,50898,130738
520260,201909,114,72,42,71856,41916,113772
520280,201909,48,33,15,32934,14970,47904
520310,201909,36,25,11,24950,10978,35928
520320,201909,172,111,61,110778,60878,171656
520330,201909,786,421,365,420160.94,364271.96,784432.90
520340,201909,342,203,139,202594,138722.98,341316.98
520350,201909,507,237,270,236526,270458,506984
520355,201909,88,52,36,51896,35928,87824
520357,201909,28,22,6,21956,5988,27944
520360,201909,1,1,0,998,0,998
520380,201909,138,72,66,71856,67864,139720
520390,201909,260,113,147,112774,146706,259480
520393,201909,15,11,4,10978,3992,14970
520396,201909,90,57,33,56886,32934.98,89820.98
520400,201909,209,120,89,119760,89820,209580
520410,201909,195,99,96,98802.98,95808.98,194611.96
520420,201909,20,14,6,13972,5988,19960
520425,201909,297,143,154,142714,154691.4,297405.4
520430,201909,456,239,217,238613.81,216567.88,455181.69
520440,201909,671,474,197,473783.86,196606,670389.86
520450,201909,1915,862,1053,860276.98,1051897.88,1912174.86
520455,201909,53,38,15,37924,14970,52894
520460,201909,35,20,15,19960,14970,34930
520465,201909,28,24,4,23952,3992,27944
520470,201909,427,270,157,269460,156686,426146
520480,201909,79,48,31,48902.98,30942.9,79845.88
520485,201909,119,41,78,40918,78842.4,119760.4
520490,201909,422,311,111,310378.4,110778,421156.4
520495,201909,164,97,67,97804,68862,166666
520500,201909,176,134,42,133732,41916,175648
520505,201909,178,101,77,100798,77844,178642
520510,201909,1759,863,896,864306.62,894291.26,1758597.88
520520,201909,38,30,8,29940,7984,37924
520530,201909,235,176,59,175648,58882,234530
520540,201909,555,389,166,388222,166666,554888
520545,201909,139,85,54,84830,53892,138722
520547,201909,46,26,20,25948,19960,45908
520549,201909,1181,569,612,567862.32,611774.8,1179637.12
520551,201909,285,153,132,152694,132734.4,285428.4
520552,201909,46,30,16,29940,15968,45908
520570,201909,15,9,6,8982,5988,14970
520580,201909,283,173,110,172654,110778,283432
520590,201909,156,95,61,94810.98,60878,155688.98
520620,201909,1161,543,618,541916.36,617762,1159678.36
520630,201909,38,24,14,23952,13972,37924
520640,201909,401,239,162,239520,161676,401196
520650,201909,63,38,25,37924,24950,62874
520660,201909,41,22,19,21956.98,18962,40918.98
520670,201909,36,30,6,29940,5988,35928
520680,201909,53,36,17,35928,16966,52894
520690,201909,36,12,24,11976,23953.96,35929.96
520710,201909,33,31,2,30938,1996,32934
520725,201909,191,132,59,131736,58882,190618
520735,201909,59,41,18,40918,17964,58882
520740,201909,408,205,203,205588,202594.98,408182.98
520750,201909,35,27,8,26946,7984,34930
520753,201909,58,39,19,38922,18962,57884
520760,201909,107,73,34,73852,33932,107784
520780,201909,295,220,75,219560,74850,294410
520790,201909,155,82,73,82468.06,72854,155322.06
520800,201909,3396,1823,1573,1821352.19,1571850.88,3393203.07
520810,201909,164,121,43,120758,42914,163672
520815,201909,5,4,1,3992,998,4990
520830,201909,147,104,43,103792,42914,146706
520840,201909,357,238,119,238522,118762,357284
520850,201909,103,66,37,65869.96,36926,102795.96
520860,201909,1731,1113,618,1111772.4,616764.4,1728536.8
520870,201909,31444,15310,16134,15296365.21,16130705.25,31427070.46
520880,201909,1127,611,516,609778.4,515966.4,1125744.8
520890,201909,785,476,309,475048.98,308382,783430.98
520910,201909,990,528,462,526944.88,462074,989018.88
520915,201909,100,78,22,77844,21956,99800
520920,201909,405,202,203,201596,203592,405188
520929,201909,18,17,1,16966,998,17964
520940,201909,72,47,25,46906,24950,71856
520945,201909,19,11,8,10978,7984,18962
520960,201909,47,31,16,30938,15968,46906
520970,201909,329,208,121,207584.98,120758,328342.98
520980,201909,92,68,24,67864,23952,91816
520990,201909,460,312,148,311376,147704,459080
520993,201909,128,62,66,61876,66866,128742
520995,201909,243,140,103,139720.66,103792.4,243513.06
521000,201909,1569,927,642,925146.6,640717.2,1565863.8
521010,201909,664,321,343,320361.92,342316.8,662678.72
521015,201909,17,11,6,10978,5988,16966
521020,201909,1434,1015,419,1014966.98,418164.36,1433131.34
521030,201909,48,33,15,32934,14970,47904
521040,201909,933,598,335,596804.9,334330.4,931135.3
521056,201909,41,31,10,30938,9980,40918
521060,201909,135,89,46,88822,45908,134730
521080,201909,451,341,110,340319.38,109780,450099.38
521090,201909,536,338,198,337324,198602,535926
521100,201909,275,209,66,208582,65868,274450
521120,201909,1061,750,311,749498.4,312374.98,1061873.38
521130,201909,360,259,101,258482,100800.36,359282.36
521140,201909,177,96,81,95808,80838,176646
521150,201909,2709,1186,1523,1185626.36,1521951.96,2707578.32
521160,201909,30,16,14,15968,13972,29940
521170,201909,196,113,83,112774,82834,195608
521180,201909,1165,745,420,743510.2,420158.9,1163669.1
521190,201909,2541,1083,1458,1080834,1458080.36,2538914.36
521200,201909,53,39,14,38922,13972,52894
521205,201909,11,8,3,7984,2994,10978
521210,201909,140,81,59,80838,58882,139720
521220,201909,811,564,247,562872,246506.9,809378.9
521225,201909,35,23,12,22954,11976,34930
521230,201909,106,72,34,71856,33932,105788
521250,201909,6170,3551,2619,3546896.91,2614764.28,6161661.19
521260,201909,23,13,10,12974,9980,22954
521270,201909,142,111,31,110778,30938,141716
521280,201909,435,266,169,265468,168662,434130
521290,201909,28,11,17,10978,16966,27944
521295,201909,98,66,32,65868,31936,97804
521300,201909,218,116,102,115769.96,101799.34,217569.30
521305,201909,37,26,11,25948,10978,36926
521308,201909,1069,804,265,803398.82,264470.98,1067869.80
521310,201909,1319,772,547,772456.9,546905.34,1319362.24
521340,201909,22,17,5,16966,4990,21956
521350,201909,127,95,32,94810,31936,126746
521370,201909,176,121,55,121756,54890,176646
521375,201909,173,94,79,93812,78842,172654
521377,201909,49,36,13,35928,12974,48902
521380,201909,1051,686,365,684629.92,366266,1050895.92
521385,201909,13,8,5,7984,4990,12974
521390,201909,101,82,19,81836,18962,100798
521400,201909,337,223,114,222554,113772,336326
521405,201909,146,80,66,80838,65868,146706
521410,201909,63,42,21,42914,20958,63872
521440,201909,197,143,54,142714,53892,196606
521450,201909,729,410,319,409180,319360,728540
521460,201909,1158,740,418,739518,419160,1158678
521470,201909,11,7,4,6986,3992,10978
521480,201909,42,29,13,28944.94,12976.86,41921.80
521483,201909,318,180,138,179640.4,137724,317364.4
521486,201909,286,186,100,185628,99800.6,285428.6
521487,201909,23,12,11,11976,10978,22954
521490,201909,25,14,11,13972,10978,24950
521500,201909,116,75,41,74850,40918,115768
521520,201909,42,28,14,27944,13972,41916
521523,201909,676,413,263,413172,262474,675646
521525,201909,47,31,16,30938,15968,46906
521530,201909,245,132,113,131736,112774,244510
521540,201909,28,15,13,14970,12974,27944
521550,201909,88,40,48,39923.34,47908.9,87832.24
521560,201909,796,555,241,553890.4,241516.7,795407.1
521565,201909,58,38,20,37924,19960,57884
521570,201909,514,346,168,345308.4,167664.9,512973.3
521580,201909,58,36,22,35928,21956,57884
521590,201909,37,19,18,18962,17964,36926
521600,201909,22,13,9,12974,8982,21956
521630,201909,246,129,117,128742,116768.46,245510.46
521640,201909,305,162,143,161676,142714,304390
521645,201909,28,15,13,14970,12974,27944
521680,201909,227,142,85,141716,84830.6,226546.6
521690,201909,2,2,0,1996,0,1996
521710,201909,1162,560,602,558880,601794.98,1160674.98
521720,201909,542,369,173,368262,172655.34,540917.34
521730,201909,634,312,322,311377.6,321356,632733.6
521740,201909,899,377,522,376246.98,520960.32,897207.30
521760,201909,1747,952,795,951094.59,793411.36,1744505.95
521770,201909,814,517,297,515966,297404,813370
521800,201909,2018,1285,733,1282442.38,731542.82,2013985.20
521805,201909,30,18,12,18962,11976,30938
521810,201909,85,54,31,53892,30938,84830
521830,201909,936,670,266,668660.13,267464.98,936125.11
521839,201909,85,52,33,52894,32934,85828
521850,201909,1093,585,508,583834.01,506999.5,1090833.51
521860,201909,352,225,127,224550,127744,352294
521870,201909,71,42,29,41916,28942,70858
521878,201909,36,18,18,17964,17964,35928
521880,201909,4659,2105,2554,2104783.9,2552890.15,4657674.05
521890,201909,580,416,164,415168,163672,578840
521900,201909,293,238,55,237524,54890,292414
521910,201909,151,107,44,106786,43912,150698
521920,201909,49,24,25,23952,24950,48902
521925,201909,41,25,16,24950,15968,40918
521930,201909,1139,641,498,639726.24,499012.16,1138738.40
521935,201909,35,26,9,25948,8982,34930
521940,201909,188,96,92,95808,91816,187624
521945,201909,15,13,2,12974,1996,14970
521950,201909,8,4,4,3992,3992,7984
521960,201909,71,53,18,52894,17964,70858
521970,201909,408,265,143,264470,142714,407184
521971,201909,88,44,44,43912,43912,87824
521973,201909,34,18,16,17964,15968,33932
521975,201909,1302,671,631,670656.71,630737.1,1301393.81
521980,201909,238,164,74,163672,73852,237524
521990,201909,78,55,23,54890,22954,77844
522000,201909,285,182,103,181636,102794,284430
522005,201909,19,11,8,10978,7984,18962
522010,201909,1142,651,491,651694.98,491016,1142710.98
522015,201909,59,37,22,36926.98,21956,58882.98
522020,201909,875,495,380,494010.1,379240.8,873250.9
522026,201909,25,16,9,15968,8982,24950
522028,201909,17,13,4,12974,3992,16966
522040,201909,766,309,457,309382.46,456089.92,765472.38
522045,201909,2291,1428,863,1425144.7,862275.26,2287419.96
522050,201909,158,78,80,77844,79840,157684
522060,201909,546,350,196,349300,195608,544908
522068,201909,121,82,39,81836,39920,121756
522070,201909,10,10,0,9980,0,9980
522100,201909,42,24,18,23952,17964,41916
522108,201909,42,32,10,31936,9980,41916
522119,201909,52,28,24,27944,24950,52894
522130,201909,80,35,45,34930.98,44912.94,79843.92
522140,201909,3935,2051,1884,2048896.3,1886221.58,3935117.88
522145,201909,47,35,12,34930,11976,46906
522150,201909,74,54,20,53892,19960,73852
522155,201909,52,33,19,32934,18962,51896
522157,201909,4,3,1,2994,998,3992
522160,201909,1714,1030,684,1028339.2,687622.98,1715962.18
522170,201909,401,271,130,271456,130738,402194
522180,201909,36,20,16,19960,15968,35928
522185,201909,1983,786,1197,787422.8,1197600.99,1985023.79
522190,201909,42,25,17,24950,16966,41916
522200,201909,295,179,116,178642,115768,294410
522205,201909,154,107,47,106786,46906,153692
522220,201909,157,114,43,113772,42914,156686
522230,201909,33,27,6,26946,5988,32934
530010,201909,54438,27992,26446,27965004.46,26437066.18,54402070.64
110001,201910,507,405,102,404190,101796,505986
110002,201910,2757,1711,1046,1711571.38,1045904.96,2757476.34
110003,201910,90,76,14,75848,13972,89820
110004,201910,2000,1304,696,1303390.36,695606.99,1998997.35
110005,201910,442,354,88,354290.4,87824,442114.4
110006,201910,440,345,95,345308.4,94810,440118.4
110007,201910,69,58,11,57884,10978,68862
110008,201910,242,138,104,137724,103792,241516
110009,201910,846,604,242,602792.42,242515.58,845308.00
110010,201910,1781,1094,687,1092810.98,685627.96,1778438.94
110011,201910,1830,1433,397,1432130,396206,1828336
110012,201910,4159,2446,1713,2447096.4,1713566.4,4160662.8
110013,201910,769,608,161,607782,163672,771454
110014,201910,378,327,51,328342.4,50898,379240.4
110015,201910,1418,1142,276,1140715.53,275448,1416163.53
110018,201910,1111,698,413,698600,412176.96,1110776.96
110020,201910,15528,9088,6440,9088816.88,6438145.76,15526962.64
110025,201910,631,467,164,466066.4,163672.98,629739.38
110026,201910,39,29,10,28942,9980,38922
110028,201910,1674,1221,453,1221554.52,453093.2,1674647.72
110029,201910,144,131,13,130738,12974,143712
110030,201910,2432,1652,780,1652530.28,778441.8,2430972.08
110032,201910,300,230,70,229540.37,69860.99,299401.36
110033,201910,664,492,172,491016.4,171656.98,662673.38
110034,201910,362,271,91,272454.17,90818,363272.17
110037,201910,99,86,13,85828,12974,98802
110040,201910,363,252,111,251496,112774,364270
110045,201910,920,640,280,640717.2,279440,920157.2
110050,201910,92,83,9,82834.4,8982,91816.4
110060,201910,76,43,33,43912,32934,76846
110070,201910,112,70,42,71856,41916.4,113772.4
110080,201910,424,253,171,253492,172654,426146
110090,201910,29,24,5,23952,4990,28942
110092,201910,100,53,47,52894,46906,99800
110094,201910,192,142,50,141716,49900,191616
110100,201910,31,26,5,25948,4990,30938
110110,201910,69,39,30,38922,29940,68862
110120,201910,74,63,11,62874,10978,73852
110130,201910,297,247,50,246506.4,49900,296406.4
110140,201910,239,164,75,163672,75848,239520
110143,201910,50,41,9,40918,8982,49900
110145,201910,24,19,5,18962,4990,23952
110146,201910,25,12,13,11976,12974,24950
110147,201910,37,28,9,27944,8982,36926
110148,201910,32,22,10,22954,9980,32934
110149,201910,304,214,90,213572,89820,303392
110150,201910,133,105,28,104790,28942,133732
110155,201910,8,6,2,5988,1996,7984
110160,201910,64,53,11,52894,10978,63872
110170,201910,208,169,39,168662,38922,207584
110175,201910,63,48,15,47904,14970,62874
110180,201910,89,77,12,76846,11976,88822
120001,201910,157,107,50,106786,49901.98,156687.98
120005,201910,198,119,79,118762,78842,197604
120010,201910,1074,679,395,677643.67,395208.98,1072852.65
120013,201910,150,102,48,102794.99,47904,150698.99
120017,201910,92,56,36,56886,35928,92814
120020,201910,3584,2885,699,2885219.83,698600,3583819.83
120025,201910,541,310,231,310378.98,230538,540916.98
120030,201910,1079,914,165,913171,164670,1077841
120032,201910,46,41,5,41916,4990,46906
120033,201910,218,193,25,192614,24950,217564
120034,201910,168,123,45,122754,44910,167664
120035,201910,38,29,9,28942,8982,37924
120038,201910,388,250,138,249500,137724,387224
120039,201910,28,27,1,26946,998,27944
120040,201910,14112,9745,4367,9750817.44,4373256.41,14124073.85
120042,201910,46,42,4,41916,3992,45908
120043,201910,10,3,7,2994,6986,9980
120045,201910,560,364,196,363272.98,196606.98,559879.96
120050,201910,1281,986,295,986025.68,295408,1281433.68
120060,201910,1459,1200,259,1197600,258482,1456082
120070,201910,457,327,130,326347.2,129740,456087.2
120080,201910,170,103,67,103792,66866,170658
130002,201910,148,109,39,108782,38922,147704
130006,201910,74,44,30,43912,29940,73852
130008,201910,136,73,63,72854,62874,135728
130010,201910,141,80,61,79840,60878,140718
130014,201910,265,192,73,191616,72854,264470
130020,201910,87,48,39,47904,38922,86826
130030,201910,920,545,375,546904,374250,921154
130040,201910,346,175,171,174650,170658.36,345308.36
130050,201910,589,307,282,307384,281436,588820
130060,201910,859,580,279,581834,280438,862272
130063,201910,592,332,260,331336,259480,590816
130068,201910,188,122,66,121756,65868,187624
130070,201910,1308,896,412,896204,412174,1308378
130080,201910,682,443,239,443112,239520,682632
130083,201910,66,37,29,36926,28942,65868
130090,201910,347,175,172,174650,171656,346306
130100,201910,1137,492,645,493012,643710,1136722
130110,201910,740,305,435,305388,435128,740516
130115,201910,166,69,97,68862,96806,165668
130120,201910,1644,1062,582,1061872,580836,1642708
130130,201910,608,418,190,418162,191616,609778
130140,201910,1522,1174,348,1174646,347304,1521950
130150,201910,407,353,54,355288,53892,409180
130160,201910,458,265,193,264470,193612,458082
130165,201910,29,22,7,21956,6986,28942
130170,201910,968,679,289,678576.12,289420,967996.12
130180,201910,172,114,58,113772,59880,173652
130185,201910,2382,1139,1243,1139716,1242510.8,2382226.8
130190,201910,3503,2208,1295,2206578.68,1297400,3503978.68
130195,201910,277,222,55,221556,54890,276446
130200,201910,182,84,98,83832,97804,181636
130210,201910,79,40,39,39920,38922,78842
130220,201910,182,123,59,122754,58882,181636
130230,201910,328,206,122,205588,121756,327344
130240,201910,1365,864,501,872252.99,499998,1372250.99
130250,201910,4756,3060,1696,3056874.4,1694604,4751478.4
130255,201910,423,208,215,207584,214570,422154
130260,201910,56240,27205,29035,27211396.53,29035816.75,56247213.28
130270,201910,1561,1046,515,1043997.82,514968,1558965.82
130280,201910,127,73,54,72854,53892,126746
130290,201910,2114,1504,610,1501990,609778,2111768
130300,201910,448,314,134,314370,133732,448102
130310,201910,894,462,432,461076,431136,892212
130320,201910,507,274,233,273452,232534,505986
130330,201910,723,449,274,448102,274450,722552
130340,201910,3507,2066,1441,2066858.8,1440114.8,3506973.6
130350,201910,455,295,160,295408,159680,455088
130353,201910,883,380,503,379240,506984,886224
130356,201910,831,381,450,380238,449100,829338
130360,201910,96,72,24,71856,23952,95808
130370,201910,688,528,160,527942,160678,688620
130380,201910,696,527,169,529938,169660,699598
130390,201910,472,374,98,373252,98802,472054
130395,201910,166,39,127,38922,126746,165668
130400,201910,64,44,20,43912,19960,63872
130406,201910,2084,1262,822,1260474.4,820356,2080830.4
130410,201910,448,206,242,205588,244510,450098
130420,201910,3089,2505,584,2504980.9,582832,3087812.9
130423,201910,158,78,80,77844,79840,157684
130426,201910,150,84,66,83832,65868,149700
130430,201910,399,258,141,257484,143712,401196
130440,201910,208,70,138,69860,139720,209580
140002,201910,31,10,21,9980,20958,30938
140005,201910,195,120,75,119760,75848,195608
140010,201910,10406,6878,3528,6876229.58,3524938.26,10401167.84
140015,201910,127,56,71,56886,70858,127744
140017,201910,114,80,34,79840,33932,113772
140020,201910,466,313,153,312374,152694.98,465068.98
140023,201910,46,24,22,23952.54,21956,45908.54
140028,201910,18,11,7,10978,6986,17964
140030,201910,347,247,100,246506,99800,346306
140040,201910,63,45,18,44910,17964,62874
140045,201910,232,102,130,101796,129740,231536
140047,201910,617,419,198,419160.4,198602,617762.4
140050,201910,145,91,54,91816,53892,145708
140060,201910,40,29,11,28942,10978,39920
140070,201910,32,29,3,28942,2994,31936
150010,201910,4640,2899,1741,2896196.4,1740512.4,4636708.8
150013,201910,159,115,44,114770.98,43912,158682.98
150020,201910,1076,584,492,582832,493012,1075844
150030,201910,673,280,393,280438,393212,673650
150034,201910,195,126,69,125748,68862,194610
150040,201910,1410,836,574,838320,573850,1412170
150050,201910,618,368,250,367264,250498,617762
150060,201910,4741,3078,1663,3074755.68,1668657.97,4743413.65
150070,201910,320,142,178,141716,177644,319360
150080,201910,14401,7170,7231,7168642.15,7235511.32,14404153.47
150085,201910,408,264,144,263472,143712,407184
150090,201910,760,644,116,642712,115768,758480
150095,201910,352,224,128,223552,127744,351296
150100,201910,57,38,19,37924,18962,56886
150110,201910,176,91,85,90818,84830,175648
150120,201910,411,304,107,305388,107784.96,413172.96
150125,201910,53,21,32,20958,31936,52894
150130,201910,1979,1062,917,1060874,916164,1977038
150140,201910,53895,25094,28801,25090736.3,28827251.16,53917987.46
150145,201910,183,103,80,102794,80838,183632
150150,201910,2889,1314,1575,1313368,1573846.8,2887214.8
150157,201910,403,285,118,284430.8,117764,402194.8
150160,201910,127,97,30,96806,29940,126746
150170,201910,3592,2702,890,2700588,891214,3591802
150172,201910,330,224,106,223552,105788,329340
150175,201910,81,51,30,50898,29940,80838
150178,201910,775,519,256,518960.4,256488.88,775449.28
150180,201910,3106,1529,1577,1529934.5,1574844.4,3104778.9
150190,201910,333,212,121,211576,120758,332334
150195,201910,113,56,57,55888,56886,112774
150200,201910,193,93,100,92814,99800,192614
150210,201910,3117,2528,589,2525938,589819.95,3115757.95
150215,201910,559,369,190,369260,189620.4,558880.4
150220,201910,3674,2513,1161,2508973.52,1161673.4,3670646.92
150230,201910,1165,945,220,944108.45,219560,1163668.45
150240,201910,6071,3559,2512,3555877.44,2511966.98,6067844.42
150250,201910,32,15,17,14970,16966,31936
150260,201910,85,52,33,51896,32934,84830
150270,201910,2280,1490,790,1488018,790416.4,2278434.4
150275,201910,529,335,194,334330,193612,527942
150276,201910,102,46,56,45908,56886,102794
150277,201910,754,327,427,328342.98,426146,754488.98
150280,201910,322,205,117,204590,116766,321356
150285,201910,88,42,46,41916,45908,87824
150290,201910,975,595,380,593810,380238.4,974048.4
150293,201910,643,311,332,311376,333332,644708
150295,201910,483,222,261,221556,260478.4,482034.4
150300,201910,79,40,39,39920,38922,78842
150304,201910,167,108,59,107784,59880,167664
150307,201910,397,329,68,328342,68862,397204
150309,201910,576,418,158,417164.98,157687.6,574852.58
150310,201910,237,159,78,158682,77844,236526
150320,201910,1978,1382,596,1383228,595806,1979034
150330,201910,2023,1185,838,1183628,837322,2020950
150340,201910,196,133,63,132734,62874,195608
150345,201910,616,345,271,344310,270458,614768
150350,201910,400,317,83,316366,82834,399200
150360,201910,4571,2927,1644,2926138.45,1643706,4569844.45
150370,201910,807,565,242,563870.98,241518.9,805389.88
150375,201910,185,96,89,95808,88822,184630
150380,201910,1451,992,459,990016,458083.92,1448099.92
150390,201910,784,452,332,451096.99,331336,782432.99
150400,201910,106,88,18,87824,17964,105788
150405,201910,1225,799,426,799398.4,425148,1224546.4
150410,201910,119,79,40,79840,39920,119760
150420,201910,7372,4110,3262,4103954.62,3258512.88,7362467.50
150430,201910,562,378,184,377244,183632,560876
150440,201910,549,334,215,333332,214570,547902
150442,201910,2256,1210,1046,1213568.8,1043908,2257476.8
150445,201910,528,343,185,342314,184630,526944
150450,201910,236,115,121,114770,121756,236526
150460,201910,743,556,187,555886.96,187624,743510.96
150470,201910,1313,802,511,801394,510976,1312370
150475,201910,225,177,48,176646,47904,224550
150480,201910,1285,907,378,906184,377244,1283428
150490,201910,595,329,266,328342,265468,593810
150495,201910,329,236,93,235528,92814,328342
150497,201910,297,201,96,200598,95808,296406
150500,201910,206,134,72,133732,71856,205588
150503,201910,964,484,480,486026.4,482034.98,968061.38
150506,201910,970,647,323,645706.96,322354.96,968061.92
150510,201910,1262,712,550,711574.4,549898,1261472.4
150520,201910,271,183,88,182634,87824,270458
150530,201910,1665,921,744,919158.5,742512,1661670.5
150540,201910,234,168,66,167664,65868,233532
150543,201910,773,428,345,428142,346306,774448
150548,201910,473,335,138,334330,137724,472054
150549,201910,60,44,16,43912,15968,59880
150550,201910,2844,1493,1351,1491012.5,1349296.4,2840308.9
150553,201910,3315,1981,1334,1983028.96,1333328,3316356.96
150555,201910,142,76,66,75848,65868,141716
150560,201910,21,13,8,12974,7984,20958
150563,201910,91,46,45,45908,44910,90818
150565,201910,173,107,66,106786,65868,172654
150570,201910,399,267,132,269460,132734,402194
150580,201910,1580,720,860,719558,858280,1577838
150590,201910,805,526,279,524948,278442,803390
150600,201910,462,281,181,280438,180638,461076
150610,201910,138,119,19,118762,18962,137724
150611,201910,118,80,38,79840,37924,117764
150613,201910,3190,1962,1228,1960072,1227540.98,3187612.98
150616,201910,503,299,204,298402,203592,501994
150618,201910,1287,707,580,705586.98,578840,1284426.98
150619,201910,392,298,94,297404,95808,393212
150620,201910,1250,745,505,746504,503990,1250494
150630,201910,292,193,99,192614,99800,292414
150635,201910,478,202,276,201596,275448,477044
150640,201910,55,28,27,27944,26946,54890
150650,201910,2331,1375,956,1373498.4,954089.39,2327587.79
150655,201910,244,185,59,184630,58882,243512
150658,201910,94,53,41,52894,40918,93812
150660,201910,511,354,157,353292,157684,510976
150670,201910,1012,369,643,368262.98,641714.98,1009977.96
150680,201910,9786,5344,4442,5343294.8,4437109.96,9780404.76
150690,201910,16,9,7,8982,6986,15968
150700,201910,488,328,160,327344,159680,487024
150710,201910,280,158,122,157684,122754,280438
150715,201910,826,509,317,511974.98,316366,828340.98
150720,201910,408,319,89,318362,88822,407184
150730,201910,974,520,454,518960,453092,972052
150740,201910,222,154,68,153692,68862,222554
150745,201910,793,441,352,440118,353292,793410
150746,201910,56,33,23,32934,22954,55888
150747,201910,242,188,54,187624,53892,241516
150750,201910,136,79,57,79840,56886,136726
150760,201910,1790,1182,608,1181632.35,606784,1788416.35
150770,201910,391,215,176,214570,176646,391216
150775,201910,98,45,53,44910,52894,97804
150780,201910,194,112,82,111776,81836,193612
150790,201910,843,464,379,464070,378242,842312
150795,201910,1505,898,607,897202,605786,1502988
150796,201910,364,212,152,211576,152694,364270
150797,201910,305,162,143,162674,142714,305388
150800,201910,1455,868,587,866264,586824,1453088
150803,201910,574,471,103,474050,102794,576844
150805,201910,187,119,68,119760,67864.99,187624.99
150808,201910,997,546,451,544908,451096,996004
150810,201910,3305,2306,999,2303386.37,998004.24,3301390.61
150812,201910,434,229,205,229540,206586,436126
150815,201910,989,639,350,638720,349300,988020
150820,201910,1532,934,598,933130,596804,1529934
150830,201910,758,552,206,552892,205588,758480
150835,201910,198,118,80,117764,79840,197604
150840,201910,1374,870,504,875246.2,502992,1378238.2
160005,201910,51,32,19,31936,19960,51896
160010,201910,185,118,67,117764,66866.99,184630.99
160015,201910,119,71,48,70858,47904,118762
160020,201910,127,72,55,71856,54890,126746
160021,201910,46,25,21,24950,20958,45908
160023,201910,65,44,21,43912,21956,65868
160025,201910,27,12,15,11976,14970,26946
160027,201910,1511,877,634,876244.5,632732,1508976.5
160030,201910,15709,8216,7493,8214548.16,7490997.81,15705545.97
160040,201910,290,166,124,165668,123752,289420
160050,201910,715,363,352,362274,352294,714568
160053,201910,304,178,126,177644.4,125748,303392.4
160055,201910,29,21,8,20958,7984,28942
160060,201910,6523,3468,3055,3471045.89,3054879.39,6525925.28
160070,201910,174,105,69,104790,68862,173652
160080,201910,94,47,47,46906,46906,93812
170025,201910,26,15,11,14970,10978,25948
170030,201910,224,182,42,181636.88,41916,223552.88
170035,201910,230,109,121,108782,120758,229540
170040,201910,180,140,40,139720,39920,179640
170070,201910,320,199,121,198602,120758,319360
170100,201910,356,260,96,259480,95808,355288
170105,201910,60,48,12,47904,11976,59880
170110,201910,109,69,40,68862,39920,108782
170130,201910,66,33,33,32934,33932.4,66866.4
170190,201910,94,60,34,59880,33932,93812
170200,201910,379,261,118,260478.98,117764,378242.98
170210,201910,6036,3240,2796,3237514.5,2795400.61,6032915.11
170215,201910,106,47,59,46906,58882,105788
170220,201910,1397,1035,362,1033961.26,361276,1395237.26
170230,201910,152,100,52,99800,51896,151696
170240,201910,526,355,171,354290.8,171656,525946.8
170255,201910,1111,899,212,900196,211576,1111772
170270,201910,41,29,12,28942,11976,40918
170290,201910,103,77,26,76846,25948,102794
170300,201910,89,60,29,59880,29940,89820
170305,201910,48,38,10,37924,9980,47904
170307,201910,64,48,16,47904,15968,63872
170310,201910,107,59,48,58882,47904,106786
170320,201910,23,17,6,17964,5988,23952
170330,201910,22,21,1,20958,998,21956
170360,201910,29,18,11,17964,10978,28942
170370,201910,120,63,57,62874,56886,119760
170380,201910,78,62,16,61876,15968,77844
170382,201910,45,39,6,38922,5988,44910
170384,201910,140,107,33,106786,32934,139720
170386,201910,63,27,36,26946,35928,62874
170388,201910,48,18,30,17964,29940,47904
170389,201910,25,20,5,19960,4990,24950
170390,201910,65,39,26,38922.98,25948.98,64871.96
170410,201910,31,23,8,22954,7984,30938
170460,201910,17,12,5,11976,4990,16966
170510,201910,33,27,6,26946,5988,32934
170550,201910,1544,907,637,908180,638720,1546900
170555,201910,113,81,32,81836,31936,113772
170560,201910,98,68,30,67864,29940,97804
170600,201910,35,17,18,16966,17964,34930
170610,201910,194,104,90,103792,89822.36,193614.36
170625,201910,35,20,15,19960,14970,34930
170650,201910,80,60,20,59880,19960,79840
170700,201910,576,444,132,443112.5,131736,574848.5
170710,201910,159,99,60,98802,59880.98,158682.98
170720,201910,88,71,17,70858,16966,87824
170730,201910,78,46,32,45908,31936,77844
170740,201910,82,62,20,61876,19960,81836
170755,201910,66,35,31,34930,30938,65868
170765,201910,139,73,66,72854.8,65868,138722.8
170770,201910,216,132,84,131736,83832,215568
170820,201910,587,394,193,394210,194610.8,588820.8
170825,201910,32,17,15,16966,14970,31936
170830,201910,82,67,15,67864,14970,82834
170900,201910,184,144,40,143712,40918,184630
170930,201910,887,480,407,479041.12,406186.4,885227.52
170950,201910,3072,1408,1664,1409177.38,1662668.67,3071846.05
170980,201910,18,10,8,9980,7984,17964
171050,201910,145,115,30,114770,29940,144710
171070,201910,38,32,6,31936,5988,37924
171090,201910,43,32,11,31936,10978,42914
171110,201910,22,14,8,13972,7984,21956
171150,201910,38,18,20,17964,19960,37924
171180,201910,23,13,10,12974,9980,22954
171190,201910,145,84,61,83832,60878,144710
171195,201910,62,52,10,51896,10978,62874
171200,201910,50,25,25,24950,24950,49900
171215,201910,4,3,1,2994,998,3992
171240,201910,58,44,14,43912,13972,57884
171245,201910,55,49,6,49900,5988,55888
171250,201910,74,41,33,40918,32934,73852
171270,201910,13,10,3,9980,3992,13972
171280,201910,42,37,5,36926,4990,41916
171320,201910,985,585,400,583830.79,400198,984028.79
171330,201910,426,210,216,209580,216566,426146
171360,201910,83,61,22,60878,21956,82834
171370,201910,28,15,13,14970,12974,27944
171380,201910,132,110,22,111776,21956,133732
171395,201910,52,33,19,32934,18962,51896
171420,201910,284,186,98,185628,97804,283432
171430,201910,71,59,12,58882,11976,70858
171488,201910,175,99,76,98802,75848,174650
171500,201910,54,31,23,30938,22954,53892
171510,201910,68,45,23,44910,22954,67864
171515,201910,40,33,7,32934,6986.4,39920.4
171525,201910,29,27,2,26946,1996,28942
171550,201910,14,10,4,9980,3992,13972
171570,201910,51,26,25,25948,24950,50898
171575,201910,316,206,110,205588,109780,315368
171610,201910,1765,905,860,904193.88,860286.78,1764480.66
171620,201910,134,93,41,94810,41916,136726
171630,201910,58,31,27,30938,26946,57884
171650,201910,268,182,86,183632,85828,269460
171660,201910,269,148,121,147704,120758.4,268462.4
171665,201910,55,38,17,37924,16966,54890
171670,201910,425,251,174,250498.5,175648,426146.5
171700,201910,66,59,7,58882,6986,65868
171720,201910,26,10,16,9980,15968,25948
171750,201910,102,55,47,54890,46906,101796
171780,201910,77,61,16,60878,15968,76846
171790,201910,77,68,9,67864,9980,77844
171800,201910,35,27,8,26946,7984,34930
171820,201910,2066,1205,861,1204586.44,862273.78,2066860.22
171830,201910,34,27,7,26946,6986,33932
171840,201910,63,41,22,40918,21956,62874
171845,201910,31,19,12,18962,11976,30938
171850,201910,39,29,10,28942,9980,38922
171855,201910,78,62,16,61876,15968,77844
171865,201910,7,6,1,5988,998,6986
171870,201910,33,24,9,23952,8982,32934
171875,201910,79,55,24,55888,23952,79840
171880,201910,33,21,12,20958,11976,32934
171884,201910,50,27,23,26946,22954,49900
171886,201910,126,53,73,52894,72854,125748
171888,201910,28,22,6,21956,5988,27944
171889,201910,20,14,6,13972,5988,19960
171890,201910,56,46,10,45908,9980,55888
171900,201910,42,28,14,27944,13972,41916
172000,201910,43,35,8,34930,7984,42914
172010,201910,47,38,9,37924,8982,46906
172015,201910,28,19,9,18962.58,8982,27944.58
172020,201910,136,88,48,87824,47904,135728
172025,201910,34,21,13,20958,12974,33932
172030,201910,43,26,17,25948,16966.98,42914.98
172049,201910,80,52,28,51896,27944,79840
172065,201910,140,90,50,89820,49900,139720
172080,201910,101,67,34,66866,33932,100798
172085,201910,26,14,12,13972,11976,25948
172090,201910,415,326,89,325348.18,88822,414170.18
172093,201910,19,16,3,15968,2994,18962
172097,201910,19,11,8,10978,7984.4,18962.4
172100,201910,4919,2824,2095,2820349.88,2100791,4921140.88
172110,201910,77,50,27,49900,26946,76846
172120,201910,1656,1418,238,1417162.2,237524,1654686.2
172125,201910,4,4,0,3992,0,3992
172130,201910,18,13,5,12974,4990,17964
172208,201910,197,125,72,124750,71856,196606
172210,201910,381,187,194,187624,195608.4,383232.4
210005,201910,2960,1871,1089,1868256.75,1087824.8,2956081.55
210010,201910,172,92,80,91816,79840,171656
210015,201910,39,29,10,28942,9980,38922
210020,201910,349,194,155,194610,154690,349300
210030,201910,332,218,114,218562,113772.98,332334.98
210040,201910,142,112,30,112774,29940,142714
210043,201910,257,189,68,188622,67864,256486
210047,201910,553,314,239,313372,238522,551894
210050,201910,291,215,76,215568,75848,291416
210055,201910,45,35,10,34930,9980,44910
210060,201910,551,444,107,444110,107784,551894
210070,201910,416,320,96,319360,96806,416166
210080,201910,115,105,10,104790,9980,114770
210083,201910,309,152,157,151696.56,156686,308382.56
210087,201910,2,1,1,998,998,1996
210090,201910,455,326,129,325348,128742,454090
210095,201910,455,344,111,343312,110778,454090
210100,201910,706,552,154,551894,153692,705586
210110,201910,134,81,53,81836,52894,134730
210120,201910,5190,4019,1171,4015961.08,1169657.53,5185618.61
210125,201910,205,124,81,123752,80838,204590
210130,201910,494,278,216,278442,216566,495008
210135,201910,30,19,11,18962,10978,29940
210140,201910,4393,3471,922,3474038.6,923150,4397188.6
210150,201910,384,249,135,248502,134730,383232
210160,201910,3337,2823,514,2821347.53,513970,3335317.53
210170,201910,1168,931,237,929138,236526,1165664
210173,201910,129,111,18,110778,17964,128742
210177,201910,396,214,182,214570,183632,398202
210180,201910,30,16,14,15968,13972,29940
210190,201910,419,279,140,278442,139720,418162
210193,201910,3,2,1,1996,998,2994
210197,201910,83,56,27,55888,26946,82834
210200,201910,639,519,120,517962,119760,637722
210203,201910,238,158,80,159680,79840,239520
210207,201910,377,303,74,303392,73852,377244
210210,201910,764,707,57,706584,56886,763470
210215,201910,75,67,8,66866,7984,74850
210220,201910,402,338,64,337324,63872,401196
210230,201910,306,241,65,241516,64870,306386
210232,201910,1426,952,474,950096,473052,1423148
210235,201910,165,129,36,128742,35928,164670
210237,201910,41,24,17,23952,16966,40918
210240,201910,91,76,15,75848,14970,90818
210250,201910,184,156,28,155688,27944,183632
210255,201910,356,267,89,266466,88822,355288
210260,201910,403,274,129,273452,130738,404190
210270,201910,662,439,223,439120,222554,661674
210275,201910,61,48,13,47904,12974,60878
210280,201910,1049,691,358,690616.48,358282,1048898.48
210290,201910,535,361,174,360278,174650,534928
210300,201910,5521,3436,2085,3432122.39,2085820.97,5517943.36
210310,201910,109,76,33,75848,33932,109780
210312,201910,117,82,35,81836,34930,116766
210315,201910,105,83,22,82834,21956,104790
210317,201910,124,93,31,92814,30938,123752
210320,201910,2348,1977,371,1975042,372254,2347296
210325,201910,134,94,40,93812,39920.4,133732.4
210330,201910,4830,2695,2135,2697594.7,2142706,4840300.7
210340,201910,1312,968,344,968060,345309.94,1313369.94
210350,201910,617,519,98,520956,97804,618760
210355,201910,147,118,29,117764,28942,146706
210360,201910,2412,1605,807,1601790.06,808380.4,2410170.46
210370,201910,1239,589,650,587822,648700,1236522
210375,201910,189,97,92,96806,91816,188622
210380,201910,711,543,168,541914,168662,710576
210390,201910,195,164,31,163672,30938,194610
210400,201910,403,347,56,346306,55888,402194
210405,201910,1004,699,305,698600,304390,1002990
210407,201910,52,42,10,41916,9980,51896
210408,201910,60,54,6,53892,5988,59880
210409,201910,333,289,44,289420,43912,333332
210410,201910,429,337,92,336326,91816,428142
210420,201910,199,163,36,162674,35928,198602
210430,201910,46,30,16,29940,15968,45908
210440,201910,348,225,123,224550,122754,347304
210450,201910,151,117,34,116766,33932,150698
210455,201910,232,127,105,126746.4,104790,231536.4
210460,201910,315,204,111,204590,111776,316366
210462,201910,66,55,11,54890,10978,65868
210465,201910,153,111,42,110778,41916,152694
210467,201910,541,394,147,394210,146706.98,540916.98
210470,201910,50,43,7,42914,6986,49900
210480,201910,1289,919,370,922152,369260.75,1291412.75
210490,201910,206,136,70,135728,70858,206586
210500,201910,538,317,221,316366,223552,539918
210510,201910,575,453,122,452094,121756,573850
210515,201910,396,234,162,233532,161676,395208
210520,201910,411,365,46,364270,45908,410178
210530,201910,9409,5078,4331,5072840.8,4329327.62,9402168.42
210535,201910,130,96,34,95808,33932,129740
210540,201910,1511,976,535,974048.2,536924,1510972.2
210542,201910,1202,623,579,624748,578840.8,1203588.8
210545,201910,17,16,1,15968,998,16966
210547,201910,133,117,16,116766,15968,132734
210550,201910,700,504,196,502992.44,195608,698600.44
210560,201910,172,149,23,149700,22954,172654
210565,201910,24,19,5,18962,4990,23952
210570,201910,1324,1065,259,1064866.04,258482,1323348.04
210580,201910,118,102,16,101796,15968,117764
210590,201910,751,610,141,608780,140718,749498
210592,201910,32,29,3,28942,2994,31936
210594,201910,109,92,17,92814,16966,109780
210596,201910,96,81,15,80838,14970,95808
210598,201910,129,95,34,95808,34930,130738
210600,201910,330,282,48,282434,47904,330338
210610,201910,255,238,17,237524,16966,254490
210620,201910,44,27,17,26946,17964,44910
210630,201910,73,70,3,69860,2994,72854
210632,201910,1040,715,325,714568,324350,1038918
210635,201910,22,19,3,18962,2994,21956
210637,201910,100,73,27,72854,26946,99800
210640,201910,585,514,71,512972,70858,583830
210650,201910,402,331,71,330338,70858,401196
210660,201910,398,297,101,296406,100798,397204
210663,201910,29,20,9,19960,8982,28942
210667,201910,106,37,69,36926,68862,105788
210670,201910,256,228,28,227544,27944,255488
210675,201910,550,304,246,303392,245508,548900
210680,201910,219,145,74,144710,73852,218562
210690,201910,631,513,118,511974,118762,630736
210700,201910,169,127,42,126746,41916,168662
210710,201910,265,162,103,161676,103792,265468
210720,201910,133,116,17,115768,16966,132734
210725,201910,69,61,8,60878,7984,68862
210730,201910,25,18,7,17964,6986,24950
210735,201910,311,215,96,214570,95808.4,310378.4
210740,201910,549,469,80,468062,79840,547902
210745,201910,156,116,40,115768,39920,155688
210750,201910,2393,1203,1190,1200594.5,1194606.4,2395200.9
210760,201910,257,194,63,193612,62874,256486
210770,201910,394,311,83,311376,82834,394210
210780,201910,441,325,116,324350,116766,441116
210790,201910,190,151,39,150698,38922,189620
210800,201910,170,130,40,129740,39920,169660
210805,201910,51,47,4,46906,3992,50898
210810,201910,472,377,95,379240,94810,474050
210820,201910,2184,1811,373,1810373.76,372254,2182627.76
210825,201910,161,90,71,89820,70858,160678
210830,201910,744,481,263,481036,262474,743510
210840,201910,205,142,63,141716,63872,205588
210845,201910,248,167,81,166666,80838,247504
210850,201910,791,529,262,527942,261476,789418
210860,201910,3854,2120,1734,2122746.9,1737518,3860264.9
210870,201910,461,358,103,359280,103792,463072
210880,201910,71,54,17,53892,16966,70858
210890,201910,322,273,49,272454,48902,321356
210900,201910,618,404,214,403192,213572,616764
210905,201910,65,31,34,30938,33932,64870
210910,201910,1987,1485,502,1485025.48,500996,1986021.48
210920,201910,181,63,118,62874,118762,181636
210923,201910,86,63,23,62874,22954,85828
210927,201910,421,192,229,191616,228542,420158
210930,201910,69,55,14,54890,13972,68862
210940,201910,87,68,19,67864,18962,86826
210945,201910,201,100,101,99800,100798,200598
210950,201910,527,392,135,392214,135728,527942
210955,201910,74,51,23,50898,22954,73852
210960,201910,2261,1082,1179,1080834,1179636,2260470
210970,201910,113,100,13,99800,12974,112774
210975,201910,86,79,7,78842,6986,85828
210980,201910,1116,524,592,523950,591814.4,1115764.4
210990,201910,4158,2688,1470,2682625,1471052,4153677
211000,201910,1339,1073,266,1070854.4,265468,1336322.4
211003,201910,1007,703,304,702592,304390,1006982
211010,201910,495,440,55,439120,54890,494010
211020,201910,1487,604,883,602792,883230,1486022
211023,201910,31,27,4,26946,3992,30938
211027,201910,76,55,21,54890,20958,75848
211030,201910,379,267,112,266466,111776,378242
211040,201910,307,253,54,252494.4,54890,307384.4
211050,201910,1166,768,398,766464,398202.4,1164666.4
211060,201910,661,568,93,566864.4,92814.6,659679.0
211065,201910,21,17,4,16966,3992,20958
211070,201910,913,753,160,751494.66,159680,911174.66
211080,201910,87,83,4,82834,3992,86826
211085,201910,55,29,26,28942,25948,54890
211090,201910,91,73,18,72854,17964,90818
211100,201910,486,396,90,396206,90818.4,487024.4
211102,201910,251,172,79,172654,78842,251496
211105,201910,225,158,67,158682,66866,225548
211107,201910,133,82,51,81836,50898,132734
211110,201910,825,539,286,537922,285428.98,823350.98
211120,201910,5510,2692,2818,2693604.2,2828332.76,5521936.96
211125,201910,34,25,9,24950,8982,33932
211130,201910,43242,19388,23854,19382168.52,23883146.33,43265314.85
211140,201910,414,358,56,357284.99,55888,413172.99
211150,201910,1272,829,443,827342,443113.39,1270455.39
211153,201910,167,99,68,99800,67864,167664
211157,201910,65,52,13,51896,12974,64870
211160,201910,702,599,103,598800,102794,701594
211163,201910,0,0,0,0,0,0
211167,201910,10,9,1,8982,998,9980
211170,201910,436,319,117,318362,116766,435128
211172,201910,119,82,37,81836,36926,118762
211174,201910,261,159,102,158682,101796,260478
211176,201910,500,368,132,367264.4,131736,499000.4
211178,201910,91,61,30,60878,29940,90818
211180,201910,209,168,41,167664,40918,208582
211190,201910,71,66,5,65868,4990,70858
211195,201910,33,24,9,23952,8982,32934
211200,201910,151,130,21,129740,20958,150698
211210,201910,457,322,135,322354,134730,457084
211220,201910,4058,2358,1700,2357279.08,1700594.59,4057873.67
211223,201910,92,89,3,89820,2994,92814
211227,201910,71,54,17,53892,16966,70858
211230,201910,759,626,133,625746,133732,759478
211240,201910,405,313,92,312374,91816,404190
211245,201910,190,91,99,90818,99800,190618
211250,201910,1590,1370,220,1367261.59,219560.94,1586822.53
211260,201910,825,670,155,669658,154690,824348
211270,201910,2013,1637,376,1634724.4,381236.8,2015961.2
211280,201910,1790,1138,652,1137720,652692,1790412
211285,201910,196,121,75,120758,74850,195608
211290,201910,689,477,212,477044,211576,688620
211300,201910,786,620,166,620756,165668,786424
211400,201910,1575,952,623,950096,622752,1572848
220005,201910,17,16,1,15968,998,16966
220010,201910,87,67,20,66866,19960,86826
220020,201910,678,542,136,540916,135728,676644
220025,201910,113,110,3,109780,2994,112774
220027,201910,41,34,7,33932,6986,40918
220030,201910,107,88,19,87824,18962,106786
220040,201910,1225,935,290,933130.6,289420,1222550.6
220045,201910,34,24,10,23952,9980,33932
220050,201910,684,578,106,576845.08,105788,682633.08
220060,201910,171,151,20,150698,19960,170658
220070,201910,108,100,8,99800,7984,107784
220080,201910,17,15,2,14970,1996,16966
220090,201910,34,28,6,27944,5988,33932
220095,201910,2,1,1,998,998,1996
220100,201910,20,16,4,15968,3992,19960
220105,201910,24,23,1,22954.4,998,23952.4
220110,201910,218,201,17,200598,16966,217564
220115,201910,37,36,1,35928,998,36926
220117,201910,23,21,2,20958,1996,22954
220120,201910,1496,1117,379,1115764,378242,1494006
220130,201910,30,30,0,29940,0,29940
220140,201910,102,82,20,81836,19960,101796
220150,201910,489,356,133,355288,132734,488022
220155,201910,5,5,0,4990,0,4990
220157,201910,18,15,3,14970,2994,17964
220160,201910,85,75,10,74850,9980,84830
220170,201910,32,32,0,31936,0,31936
220173,201910,7,7,0,6986,0,6986
220177,201910,4,4,0,3992,0,3992
220180,201910,68,68,0,67864,0,67864
220190,201910,1063,955,108,955086,107784,1062870
220191,201910,43,38,5,37924,4990,42914
220192,201910,76,73,3,72854,2994,75848
220194,201910,47,45,2,44910,1996,46906
220196,201910,95,80,15,79840,14970,94810
220198,201910,3,2,1,1996,998,2994
220200,201910,414,348,66,348302.5,65868,414170.5
220202,201910,38,34,4,33932,3992,37924
220205,201910,45,41,4,40918,3992,44910
220207,201910,12,12,0,11976,0,11976
220208,201910,79,43,36,42914,35928,78842
220209,201910,30,27,3,26946,2994,29940
220210,201910,19,16,3,15968,2994,18962
220211,201910,28,27,1,26946,998,27944
220213,201910,41,37,4,36926,3992.4,40918.4
220217,201910,40,32,8,31936,7984,39920
220220,201910,2150,1404,746,1401192,744509.1,2145701.1
220225,201910,9,4,5,3992,4990,8982
220230,201910,970,766,204,765466,203592,969058
220240,201910,162,147,15,147704,14970,162674
220245,201910,33,30,3,29940.99,2994,32934.99
220250,201910,118,106,12,106786,11976,118762
220253,201910,40,34,6,33932,5988,39920
220255,201910,29,26,3,25948,2994,28942
220260,201910,697,517,180,515966,179640,695606
220265,201910,10,8,2,7984,1996,9980
220270,201910,740,663,77,661674,76846,738520
220271,201910,39,32,7,31936,6986,38922
220272,201910,24,24,0,23952,0,23952
220273,201910,15,14,1,13972,998,14970
220275,201910,58,48,10,47904,9980,57884
220277,201910,15,13,2,12974,1996,14970
220280,201910,14,11,3,10978,2994,13972
220285,201910,45,43,2,42914,1996,44910
220290,201910,1471,1263,208,1262470.4,208582.9,1471053.3
220300,201910,45,43,2,42914,1996,44910
220310,201910,313,269,44,269460.99,43912,313372.99
220320,201910,444,412,32,411176.4,31936,443112.4
220323,201910,0,0,0,0,0,0
220325,201910,14,10,4,9980,3992,13972
220327,201910,12,11,1,10978,998,11976
220330,201910,222,162,60,161676,59880,221556
220335,201910,135,118,17,117764,16966,134730
220340,201910,37,23,14,22954,13972,36926
220342,201910,58,51,7,50898,6986,57884
220345,201910,81,75,6,74850,5988,80838
220350,201910,434,380,54,379240,53892,433132
220360,201910,43,31,12,30938,11976,42914
220370,201910,1208,998,210,998000,209580,1207580
220375,201910,20,18,2,17964,1996,19960
220380,201910,19,16,3,15968,2994,18962
220385,201910,15,13,2,12974,1996,14970
220390,201910,2321,1322,999,1322350.84,997002.7,2319353.54
220400,201910,32,29,3,28942,2994,31936
220410,201910,19,17,2,16966,1996,18962
220415,201910,12,11,1,10978,998,11976
220420,201910,127,106,21,105788,20958,126746
220430,201910,133,121,12,120758,11976,132734
220435,201910,21,15,6,14970,5988,20958
220440,201910,293,248,45,247504,44910,292414
220450,201910,331,171,160,170658,159680,330338
220455,201910,52,51,1,51896,1996,53892
220460,201910,19,19,0,18962,0,18962
220465,201910,100,64,36,63872,35928,99800
220470,201910,237,208,29,208582,28942,237524
220480,201910,74,66,8,65868,7984,73852
220490,201910,90,77,13,76846,12974,89820
220500,201910,101,88,13,87824,12974,100798
220510,201910,439,341,98,340318,97804,438122
220515,201910,22,20,2,19960,1996,21956
220520,201910,378,342,36,342314.34,35928,378242.34
220525,201910,12,9,3,8982,2994,11976
220527,201910,25,18,7,17964,6986,24950
220530,201910,32,12,20,11976,19960,31936
220535,201910,5,5,0,4990,0,4990
220540,201910,61,50,11,49900,10978,60878
220545,201910,46,32,14,31936,13972,45908
220550,201910,672,527,145,525946.96,144710,670656.96
220551,201910,14,11,3,10978,2994,13972
220552,201910,16,16,0,15968,0,15968
220553,201910,51,47,4,46906,3992,50898
220554,201910,10,8,2,7984,1996,9980
220555,201910,33,29,4,28942,3992,32934
220556,201910,52,48,4,47904,3992,51896
220557,201910,55,52,3,51896,2994,54890
220558,201910,8,3,5,2994,4990,7984
220559,201910,2,2,0,1996,0,1996
220560,201910,68,45,23,44910,22954,67864
220570,201910,771,472,299,473052.4,298402,771454.4
220580,201910,545,503,42,502992,41916,544908
220585,201910,7,6,1,5988,998,6986
220590,201910,13,13,0,12974,0,12974
220595,201910,62,47,15,46906,14970,61876
220600,201910,19,12,7,11976,6986,18962
220605,201910,24,22,2,21956,1996,23952
220610,201910,72,64,8,63872,7984,71856
220620,201910,564,463,101,463072,100798,563870
220630,201910,5,4,1,3992,998,4990
220635,201910,37,33,4,32934,3992,36926
220640,201910,103,83,20,82834,19960,102794
220650,201910,111,105,6,104790,6986,111776
220660,201910,46,37,9,36926,9980,46906
220665,201910,4,4,0,3992,0,3992
220667,201910,18,16,2,15968,1996,17964
220669,201910,29,26,3,25948,2994,28942
220670,201910,65,53,12,52894,11976,64870
220672,201910,64,45,19,44910,18962,63872
220675,201910,37,29,8,28942,7984,36926
220680,201910,39,33,6,32934,5988,38922
220690,201910,45,43,2,42914,1996,44910
220695,201910,42,20,22,19960,22954,42914
220700,201910,1706,1328,378,1326342,379240,1705582
220710,201910,4,3,1,2994,998,3992
220720,201910,111,90,21,89820,20958,110778
220730,201910,15,15,0,14970,0,14970
220735,201910,3,1,2,998,1996,2994
220740,201910,49,45,4,44910,3992,48902
220750,201910,112,95,17,94810,16966,111776
220755,201910,13,13,0,13972,0,13972
220760,201910,62,59,3,58882,2994,61876
220770,201910,5653,3032,2621,3029930.26,2619753.32,5649683.58
220775,201910,16,9,7,8982,6986,15968
220777,201910,17,16,1,15968,998,16966
220779,201910,0,0,0,0,0,0
220780,201910,884,756,128,754488,127744.4,882232.4
220785,201910,4,1,3,998,2994,3992
220790,201910,1071,858,213,857282.82,212574,1069856.82
220793,201910,6,6,0,5988,0,5988
220795,201910,14,13,1,12974,998,13972
220800,201910,4024,3102,922,3099791.24,921154.99,4020946.23
220810,201910,65,58,7,57884.4,6986,64870.4
220820,201910,247,225,22,224550,21956,246506
220830,201910,1221,1058,163,1060874,162674,1223548
220840,201910,2427,1703,724,1702591.33,725546.78,2428138.11
220850,201910,53,45,8,44910,7984,52894
220855,201910,9,6,3,5988,2994,8982
220860,201910,15,12,3,11976,2994,14970
220865,201910,32,30,2,29940,1996,31936
220870,201910,73,66,7,65868,6986,72854
220880,201910,318,251,67,250498,66866,317364
220885,201910,36,33,3,32934,2994,35928
220887,201910,13,13,0,12974,0,12974
220890,201910,100,88,12,87824,11976,99800
220900,201910,19,12,7,11976,6986,18962
220910,201910,52,44,8,44910,7984,52894
220915,201910,11,9,2,8982,1996,10978
220920,201910,50,46,4,45908,3992,49900
220930,201910,42,41,1,40918,998,41916
220935,201910,16,16,0,15968,0,15968
220937,201910,35,34,1,33932,998,34930
220940,201910,57,52,5,51896,4990,56886
220945,201910,0,0,0,0,0,0
220950,201910,44,39,5,38922,4990,43912
220955,201910,21,19,2,18962,1996,20958
220960,201910,8,8,0,7984,0,7984
220965,201910,36,33,3,32934,2994,35928
220970,201910,58,48,10,47904,9980,57884
220975,201910,12,9,3,8982,2994,11976
220980,201910,30,28,2,27944,1996,29940
220985,201910,64,57,7,57884,6986,64870
220987,201910,30,28,2,27944,1996,29940
220990,201910,19,18,1,17964,998,18962
220995,201910,19,15,4,14970,3992,18962
220997,201910,60,50,10,49900,9980,59880
221000,201910,1173,1060,113,1058878,112774,1171652
221005,201910,55,47,8,46906,7984,54890
221010,201910,16,12,4,11976,3992,15968
221020,201910,41,39,2,39920,1996,41916
221030,201910,32,26,6,25948,5988,31936
221035,201910,24,24,0,23952,0,23952
221037,201910,12,8,4,7984,3992,11976
221038,201910,27,24,3,23952,2994,26946
221039,201910,23,23,0,22954,0,22954
221040,201910,255,221,34,220558,33932,254490
221050,201910,233,201,32,200598,31936,232534
221060,201910,1842,1623,219,1620752,218562,1839314
221062,201910,33,33,0,32934,0,32934
221063,201910,14,10,4,9980,3992,13972
221065,201910,54,46,8,45908,7984,53892
221070,201910,139,121,18,120758,17964,138722
221080,201910,377,330,47,330338,46906,377244
221090,201910,28,26,2,25948,1996,27944
221093,201910,52,35,17,34930,16966,51896
221095,201910,8,8,0,7984,0,7984
221097,201910,15,12,3,11976,2994,14970
221100,201910,25213,14940,10273,14921107.4,10265429.56,25186536.96
221110,201910,1078,808,270,808380,270458,1078838
221120,201910,532,399,133,398202.4,133732,531934.4
221130,201910,971,793,178,792412,177644,970056
221135,201910,35,32,3,31936,2994,34930
221140,201910,44,37,7,36926,6986,43912
221150,201910,13,10,3,9980,2994,12974
221160,201910,13,13,0,12974,0,12974
221170,201910,15,15,0,14970,0,14970
230010,201910,161,148,13,147704,12974,160678
230015,201910,122,100,22,99800,21956,121756
230020,201910,1634,1384,250,1383228.4,249507.76,1632736.16
230030,201910,1679,1212,467,1210575.78,467064,1677639.78
230040,201910,218,189,29,188622.4,28942,217564.4
230050,201910,226,168,58,167664,57884,225548
230060,201910,162,131,31,130738,30938,161676
230070,201910,297,265,32,264470,31936,296406
230075,201910,849,744,105,743510.8,106786,850296.8
230080,201910,197,169,28,169660,27944,197604
230090,201910,117,84,33,84830,32934,117764
230100,201910,2048,1216,832,1215568.56,833332.84,2048901.40
230110,201910,2810,1836,974,1835322.8,978040.94,2813363.74
230120,201910,967,775,192,776446.48,191616,968062.48
230125,201910,150,127,23,126746,22954,149700
230130,201910,474,426,48,426146,47904,474050
230140,201910,215,185,30,184630,29940,214570
230150,201910,153,117,36,116766,35928,152694
230160,201910,942,807,135,805386,134730,940116
230170,201910,610,552,58,550897,57884,608781
230180,201910,76,71,5,70858,4990,75848
230185,201910,400,346,54,345308,53892,399200
230190,201910,2320,1859,461,1857280.14,462074,2319354.14
230195,201910,493,428,65,427144,64870,492014
230200,201910,385,331,54,331336,53892,385228
230205,201910,402,263,139,262474,138722,401196
230210,201910,1315,1045,270,1043910.22,269460.94,1313371.16
230220,201910,1544,1052,492,1050894,493014.82,1543908.82
230230,201910,912,788,124,789418,123752,913170
230240,201910,1695,1469,226,1468308.86,225549.14,1693858.00
230250,201910,1805,1490,315,1488019.58,314370,1802389.58
230260,201910,3132,1961,1171,1962068.96,1171652,3133720.96
230270,201910,1366,1106,260,1105786.17,260478,1366264.17
230280,201910,2721,2043,678,2043904,677642.4,2721546.4
230290,201910,415,369,46,369262.69,45908,415170.69
230300,201910,511,380,131,380238,130738,510976
230310,201910,421,321,100,320358,99800,420158
230320,201910,941,804,137,802393.4,136726,939119.4
230330,201910,310,249,61,248502,60878.6,309380.6
230340,201910,447,365,82,364270.6,81836,446106.6
230350,201910,3108,1986,1122,1985024.96,1120754,3105778.96
230360,201910,281,225,56,224550,55888,280438
230365,201910,138,113,25,112774,24950,137724
230370,201910,9863,4899,4964,4894268.47,4958152.55,9852421.02
230380,201910,480,414,66,413173.36,65868.2,479041.56
230390,201910,525,293,232,292414,232534,524948
230393,201910,248,209,39,210578,39920,250498
230395,201910,355,287,68,286426.48,69860,356286.48
230400,201910,611,487,124,487024,124750,611774
230410,201910,2676,1682,994,1679635.09,992013.94,2671649.03
230420,201910,6294,4183,2111,4180626.8,2108776.56,6289403.36
230423,201910,322,283,39,282434,38922,321356
230425,201910,401,331,70,330338.65,69860,400198.65
230426,201910,121,98,23,97804,22954,120758
230427,201910,79,77,2,76846,1996,78842
230428,201910,1455,741,714,740516.96,714571.76,1455088.72
230430,201910,458,376,82,376246.99,81836,458082.99
230435,201910,874,626,248,624748,248502.98,873250.98
230440,201910,86308,38874,47434,38881452.58,47449366.08,86330818.66
230445,201910,299,209,90,208582,89820,298402
230450,201910,544,436,108,436126,107784,543910
230460,201910,59,49,10,48902,9980,58882
230465,201910,313,255,58,254490,57884,312374
230470,201910,1993,1578,415,1576840.94,414170.5,1991011.44
230480,201910,162,154,8,153692,8982,162674
230490,201910,298,240,58,239520,57884,297404
230495,201910,452,337,115,337324,115768,453092
230500,201910,1000,745,255,745506,254490,999996
230510,201910,55,44,11,43912,10978,54890
230520,201910,388,303,85,303392.18,84830,388222.18
230523,201910,2252,1439,813,1438118,813371.34,2251489.34
230526,201910,278,235,43,234530,42914,277444
230530,201910,678,510,168,508980.94,168662,677642.94
230533,201910,197,188,9,187624,8982,196606
230535,201910,370,278,92,277444,91816,369260
230540,201910,1828,1612,216,1610772,216566,1827338
230550,201910,3784,2442,1342,2441110.92,1344306.94,3785417.86
230560,201910,572,436,136,435128.8,135728.94,570857.74
230565,201910,215,159,56,158682,55888,214570
230570,201910,294,259,35,259480.96,34930,294410.96
230580,201910,1161,860,301,859279.9,301396,1160675.9
230590,201910,988,777,211,776444.5,210578,987022.5
230600,201910,248,227,21,226546,20958,247504
230610,201910,353,282,71,282434.6,70858,353292.6
230620,201910,179,150,29,149700.4,28942,178642.4
230625,201910,742,539,203,537923.44,202594,740517.44
230630,201910,1325,1044,281,1044906,281436,1326342
230640,201910,3704,3205,499,3209569,499004.93,3708573.93
230650,201910,438,382,56,382235.91,55888,438123.91
230655,201910,663,579,84,577843.57,83835.89,661679.46
230660,201910,356,303,53,303392,52894,356286
230670,201910,430,377,53,377244,52894,430138
230680,201910,199,181,18,180638,17964,198602
230690,201910,902,779,123,778440,122754,901194
230700,201910,787,666,121,666664.94,121756.94,788421.88
230710,201910,723,686,37,685626.6,36926,722552.6
230720,201910,153,135,18,134730,17964,152694
230725,201910,266,215,51,215568,50898.98,266466.98
230730,201910,12121,6615,5506,6611752.6,5506968.79,12118721.39
230740,201910,674,547,127,545907.37,126746,672653.37
230750,201910,831,707,124,705586.6,123752,829338.6
230760,201910,1396,1206,190,1204586,190618,1395204
230763,201910,320,268,52,267464,52894,320358
230765,201910,7234,3419,3815,3418194.68,3813406.05,7231600.73
230770,201910,5002,2571,2431,2565865,2429137.14,4995002.14
230780,201910,701,618,83,618760.4,82834,701594.4
230790,201910,256,213,43,212574,42914,255488
230800,201910,1144,837,307,836324,308382,1144706
230810,201910,1347,1196,151,1198598,151696,1350294
230820,201910,354,250,104,249500.4,103792,353292.4
230830,201910,972,832,140,830336,139720,970056
230835,201910,278,242,36,241516,35928,277444
230837,201910,165,139,26,139720,25948,165668
230840,201910,915,732,183,731534.4,184630.4,916164.8
230850,201910,1485,1293,192,1292410,191616,1484026
230860,201910,297,222,75,221556,74850,296406
230870,201910,1832,1571,261,1570852.96,260478,1831330.96
230880,201910,65,49,16,48902,15968,64870
230890,201910,550,509,41,507982,40918.97,548900.97
230900,201910,280,209,71,208582,70858.58,279440.58
230910,201910,217,173,44,172654,43912,216566
230920,201910,422,334,88,333332,87824,421156
230930,201910,966,690,276,688620.68,275448.94,964069.62
230940,201910,848,672,176,670656.98,175648.6,846305.58
230945,201910,504,420,84,420159.96,83832,503991.96
230950,201910,408,351,57,352294,56886,409180
230960,201910,2637,1797,840,1795406.76,841317.22,2636723.98
230970,201910,1750,978,772,979047.4,771465.38,1750512.78
230980,201910,208,173,35,174650,34930,209580
230990,201910,138,114,24,113772,23952,137724
231000,201910,209,190,19,189620,18962,208582
231010,201910,146,114,32,113772,33932,147704
231020,201910,1333,929,404,928155.28,404193.82,1332349.10
231025,201910,1040,787,253,787422.6,252494.4,1039917.0
231030,201910,1115,941,174,942112.99,174650,1116762.99
231040,201910,137,94,43,93812,42914,136726
231050,201910,971,865,106,867262,105788,973050
231060,201910,150,126,24,125748,23952,149700
231070,201910,1465,1048,417,1046905.41,417164.94,1464070.35
231080,201910,262,243,19,243512,18962,262474
231085,201910,590,363,227,363273.54,226546.96,589820.50
231090,201910,245,202,43,202594,42914,245508
231095,201910,171,135,36,134730,35928,170658
231100,201910,145,122,23,121756,22954,144710
231110,201910,365,312,53,312374,52894,365268
231120,201910,280,239,41,238522,41916,280438
231123,201910,145,139,6,139720,5988,145708
231126,201910,332,262,70,261476,69860,331336
231130,201910,4610,3608,1002,3604776.97,999998.31,4604775.28
231135,201910,215,185,30,185628,29940,215568
231140,201910,3061,2272,789,2270450,787422,3057872
231150,201910,361,344,17,343312,16966,360278
231160,201910,1192,954,238,953090,237525.88,1190615.88
231170,201910,535,370,165,369260,165668,534928
231180,201910,1685,1448,237,1447100,237524,1684624
231190,201910,207,177,30,178642,29940,208582
231195,201910,217,187,30,186626,29940,216566
231200,201910,820,673,147,672652,146706.6,819358.6
231210,201910,593,498,95,498002,94810,592812
231220,201910,1043,764,279,763470.9,281436.94,1044907.84
231230,201910,1449,1159,290,1158678,289420,1448098
231240,201910,1426,1035,391,1033928.94,391216.4,1425145.34
231250,201910,115,105,10,104790,9980,114770
231260,201910,272,179,93,178642,92814,271456
231270,201910,1015,839,176,839320.43,175648,1014968.43
231280,201910,72,56,16,55888,15968,71856
231290,201910,7540,4243,3297,4239537.66,3294399.8,7533937.46
231300,201910,617,573,44,572852,44910,617762
231310,201910,749,694,55,692612.74,54890,747502.74
231320,201910,584,444,140,444112,139720,583832
231325,201910,96,85,11,84830,10978,95808
231330,201910,2024,1574,450,1573099.53,449100.4,2022199.93
231335,201910,254,225,29,224550,28942,253492
231340,201910,1705,1260,445,1257480,445108,1702588
231350,201910,1285,1061,224,1058878,223552.8,1282430.8
231355,201910,430,374,56,373252,55888,429140
231360,201910,500,380,120,379241.21,120758,499999.21
231370,201910,86,73,13,73852,12974,86826
231375,201910,289,211,78,210578,77844,288422
231380,201910,482,391,91,391216,90818,482034
231390,201910,200,163,37,162674,36926,199600
231395,201910,724,459,265,459080,266466,725546
231400,201910,1113,924,189,922155.04,188624.34,1110779.38
231410,201910,1321,1085,236,1083828.2,235528.94,1319357.14
240010,201910,384,172,212,171656.43,212574.98,384231.41
240020,201910,2287,1826,461,1824346.45,461077.97,2285424.42
240030,201910,120,103,17,102794,16966,119760
240040,201910,30,30,0,30938,0,30938
240050,201910,532,455,77,454090,76846,530936
240060,201910,67,63,4,62874,3992,66866
240070,201910,217,170,47,169660,46906,216566
240080,201910,506,342,164,341316.99,163672.46,504989.45
240090,201910,107,96,11,95808,10978,106786
240100,201910,1504,1424,80,1422150.9,79840,1501990.9
240110,201910,1060,695,365,694609.98,364271.1,1058881.08
240120,201910,134,113,21,113772,20958,134730
240130,201910,286,266,20,265468,19960,285428
240140,201910,80,62,18,61876,17964,79840
240145,201910,724,647,77,645706,76846,722552
240150,201910,19,16,3,15968,2994,18962
240160,201910,40,36,4,35928,3992,39920
240165,201910,36,28,8,27944.5,7984,35928.5
240170,201910,94,70,24,69860,24950,94810
240180,201910,83,68,15,67864,14970,82834
240185,201910,43,39,4,38922,4990,43912
240190,201910,15,13,2,12974,1996,14970
240200,201910,3089,1732,1357,1736522.8,1356283.4,3092806.2
240210,201910,171,132,39,131736,38922,170658
240220,201910,1099,800,299,798400.7,299400,1097800.7
240230,201910,860,793,67,793410.77,66866,860276.77
240240,201910,72,51,21,50898,22954,73852
240250,201910,89,77,12,76846,11976,88822
240260,201910,1810,1355,455,1353288,455089.48,1808377.48
240270,201910,188,166,22,165668,21956,187624
240280,201910,42,33,9,32934,9980,42914
240290,201910,50,49,1,48902,998,49900
240300,201910,171,97,74,97804,73852,171656
240310,201910,2227,1243,984,1241514.67,985026.74,2226541.41
240320,201910,198,188,10,188622,9980,198602
240325,201910,4371,2674,1697,2670651.68,1694606.07,4365257.75
240330,201910,68,65,3,64870,2994,67864
240340,201910,61,39,22,38922,22954,61876
240350,201910,94,85,9,84830,8982,93812
240360,201910,504,336,168,337324,167664,504988
240370,201910,48,45,3,44910,2994,47904
240375,201910,67,40,27,39920,27944,67864
240380,201910,226,187,39,186626,38922.8,225548.8
240390,201910,12,11,1,10978,998,11976
240400,201910,84,78,6,77844,5988,83832
240410,201910,11,7,4,6986,3992,10978
240420,201910,964,720,244,719558.2,243512,963070.2
240430,201910,269,252,17,251496,16966,268462
240440,201910,103,59,44,58882,43912,102794
240450,201910,223,152,71,153692.4,70858,224550.4
240460,201910,62,47,15,46906,14970,61876
240470,201910,239,210,29,211576,28942,240518
240480,201910,16,13,3,12974,2994,15968
240485,201910,78,66,12,65868,11976,77844
240490,201910,47,45,2,44910,1996,46906
240500,201910,81,64,17,63872,16966,80838
240510,201910,47,34,13,33932,12974,46906
240520,201910,118,113,5,113772,4990,118762
240530,201910,55,50,5,49900,4990,54890
240540,201910,77,66,11,65868,10978,76846
240550,201910,13,12,1,11976,998,12974
240560,201910,378,276,102,275448,101796,377244
240570,201910,459,291,168,290418.94,167664.4,458083.34
240580,201910,1270,1025,245,1022951.4,246506.99,1269458.39
240590,201910,30,28,2,27944,1996,29940
240600,201910,112,108,4,107784,3992,111776
240610,201910,514,432,82,431136.4,81836,512972.4
240615,201910,20,19,1,18962,998,19960
240620,201910,88,84,4,83832,3992,87824
240630,201910,36,34,2,33932,1996,35928
240640,201910,27,22,5,21956,4990,26946
240650,201910,238,200,38,199600,37924,237524
240660,201910,108,93,15,92814,14970,107784
240670,201910,301,179,122,178642.7,121756,300398.7
240680,201910,50,39,11,38922,10978,49900
240690,201910,50,47,3,46906,2994,49900
240700,201910,192,158,34,157684,33932,191616
240710,201910,1967,1243,724,1241513.3,725546,1967059.3
240720,201910,1080,802,278,800396,277444.2,1077840.2
240725,201910,64,60,4,59880,3992,63872
240730,201910,140,123,17,123752,16966,140718
240740,201910,233,198,35,197604,34930.74,232534.74
240750,201910,51,26,25,25948,24950,50898
240760,201910,46,41,5,40918,4990,45908
240770,201910,146,114,32,113772,31936,145708
240780,201910,682,559,123,558880,122754,681634
240790,201910,39,38,1,37924,998,38922
240800,201910,9200,6278,2922,6279425.74,2922147.68,9201573.42
240810,201910,20130,11082,9048,11081815.4,9065860.78,20147676.18
240820,201910,235,143,92,142714.19,91816,234530.19
240830,201910,1641,1346,295,1345304.7,294410,1639714.7
240840,201910,82,72,10,71856,9980,81836
240850,201910,89,79,10,78842,9980,88822
240860,201910,110,107,3,106786,2994,109780
240870,201910,59,51,8,50898,7984,58882
240880,201910,30,26,4,25948,3992,29940
240890,201910,1173,685,488,683630.76,487024.99,1170655.75
240895,201910,56,36,20,35928,19960,55888
240910,201910,160,144,16,143712,15968,159680
240920,201910,14,11,3,10978,2994,13972
240930,201910,411,368,43,369260,42914,412174
240933,201910,36,28,8,27944,7984,35928
240940,201910,2433,2157,276,2154683.14,276446.96,2431130.10
240950,201910,49,45,4,44910,3992,48902
240960,201910,30,25,5,24950,4990,29940
240970,201910,110,80,30,79840,29940,109780
240980,201910,193,157,36,156686,36926,193612
240990,201910,126,84,42,83832,41916,125748
241000,201910,65,61,4,60878,3992,64870
241010,201910,62,47,15,47904,14970,62874
241020,201910,115,106,9,105788,8982,114770
241025,201910,8,3,5,2994,4990,7984
241030,201910,110,91,19,90818,19960,110778
241040,201910,41,31,10,30938,9980,40918
241050,201910,85,76,9,75848,8982,84830
241060,201910,30,25,5,24950,4990,29940
241070,201910,17,17,0,16966,0,16966
241080,201910,60,54,6,53892,5988,59880
241090,201910,53,42,11,42914,10978,53892
241100,201910,73,62,11,61876,10978,72854
241105,201910,5,1,4,998,3992,4990
241110,201910,47,44,3,43912,2994,46906
241120,201910,1463,1127,336,1124746,336326,1461072
241140,201910,222,184,38,183632.4,37924,221556.4
241142,201910,40,36,4,35928,3992,39920
241150,201910,1175,1035,140,1035924,139720,1175644
241160,201910,21,18,3,17964,2994,20958
241170,201910,41,37,4,37924,3992,41916
241180,201910,46,40,6,39920,5988,45908
241190,201910,37,36,1,35928,998,36926
241200,201910,3837,2047,1790,2045903.53,1791410.99,3837314.52
241210,201910,68,58,10,57884,9980,67864
241220,201910,1414,959,455,957083.02,455088.97,1412171.99
241230,201910,239,203,36,202594,35928,238522
241240,201910,55,43,12,42914,11976,54890
241250,201910,1152,1055,97,1054886.4,96806,1151692.4
241255,201910,52,41,11,40918,10978,51896
241260,201910,657,516,141,514968,140718,655686
241270,201910,51,35,16,34930,15968,50898
241280,201910,95,82,13,81836,12974,94810
241290,201910,115,87,28,86826,27944,114770
241300,201910,74,56,18,55888,17964,73852
241310,201910,52,38,14,37924.7,13972,51896.7
241320,201910,29,17,12,16966,11976,28942
241330,201910,60,56,4,55888,3992,59880
241335,201910,70,63,7,62874,6986,69860
241340,201910,181,134,47,134730,46906,181636
241350,201910,57,52,5,51896,4990,56886
241355,201910,48,42,6,41916,5988,47904
241360,201910,51,50,1,49900,998,50898
241370,201910,50,42,8,41916,7984,49900
241380,201910,39,35,4,34930,3992,38922
241390,201910,81,65,16,64870,16966,81836
241400,201910,213,173,40,172654,39920,212574
241410,201910,186,166,20,165668,19960,185628
241415,201910,101,82,19,81836,18962,100798
241420,201910,99,73,26,72854,26946.64,99800.64
241430,201910,28,25,3,24950,2994,27944
241440,201910,527,426,101,426146.97,101796,527942.97
241445,201910,36,34,2,33932,1996,35928
241450,201910,288,237,51,236526,50898,287424
241460,201910,141,128,13,127744.5,12974,140718.5
241470,201910,38,33,5,32934,4990,37924
241475,201910,59,56,3,55888,2994,58882
241480,201910,95,69,26,68862,25948,94810
241490,201910,10,9,1,8982,998,9980
241500,201910,47,36,11,35928,10978,46906
250010,201910,100,84,16,83832,15968,99800
250020,201910,33,30,3,29940,2994,32934
250030,201910,843,642,201,641714,200598.6,842312.6
250040,201910,363,298,65,297404,64870,362274
250050,201910,243,198,45,198602.99,44910,243512.99
250053,201910,58,44,14,43912,13972,57884
250057,201910,0,0,0,0,0,0
250060,201910,508,383,125,382234,124750,506984
250070,201910,714,569,145,569858.75,145708,715566.75
250073,201910,8,8,0,7984,0,7984
250077,201910,186,142,44,141716,43912,185628
250080,201910,421,328,93,327344.72,92814,420158.72
250090,201910,202,132,70,132734,69860,202594
250100,201910,519,429,90,428142,89820.2,517962.2
250110,201910,575,440,135,440118,135728,575846
250115,201910,20,6,14,5988,13972,19960
250120,201910,114,84,30,84830,29940,114770
250130,201910,568,466,102,465068,101796.6,566864.6
250135,201910,16,10,6,9980,5988,15968
250140,201910,82,74,8,73852,7984,81836
250150,201910,577,422,155,421156,154690,575846
250153,201910,8,7,1,6986,998,7984
250157,201910,32,25,7,24950,6986,31936
250160,201910,216,171,45,170658,45908,216566
250170,201910,61,41,20,40918,19960,60878
250180,201910,4100,2820,1280,2819353.36,1279440.15,4098793.51
250190,201910,855,565,290,563870,291416.5,855286.5
250200,201910,51,43,8,42914,7984,50898
250205,201910,23,20,3,19960,2994,22954
250210,201910,84,75,9,74850,8982,83832
250215,201910,62,54,8,53892,7984,61876
250220,201910,25,19,6,18962,5988,24950
250230,201910,78,72,6,71856.99,5988,77844.99
250240,201910,232,193,39,193612,38922,232534
250250,201910,395,343,52,342314,51896,394210
250260,201910,40,34,6,33932,5988,39920
250270,201910,67,51,16,50898,15968,66866
250280,201910,376,313,63,312374,62874,375248
250290,201910,89,83,6,82834,5988,88822
250300,201910,549,374,175,374250,175649.97,549899.97
250310,201910,47,43,4,43912,3992,47904
250320,201910,1930,1328,602,1328340.02,603791.38,1932131.40
250330,201910,92,80,12,79840,11976,91816
250340,201910,24,22,2,21956,1996,23952
250350,201910,153,104,49,103792,48902,152694
250355,201910,34,26,8,25948,7984,33932
250360,201910,198,162,36,161676,36926,198602
250370,201910,2396,1622,774,1619754,773450,2393204
250375,201910,7,3,4,2994,3992,6986
250380,201910,55,41,14,40918,13972,54890
250390,201910,43,35,8,34930,7984,42914
250400,201910,16308,8342,7966,8345268.07,7973028.1,16318296.17
250403,201910,342,281,61,281436,60878,342314
250407,201910,59,50,9,49900,8982,58882
250410,201910,30,26,4,25948,3992,29940
250415,201910,38,26,12,25948,11976,37924
250420,201910,45,38,7,37924,6986,44910
250430,201910,1468,1260,208,1257729.5,207584,1465313.5
250435,201910,18,14,4,13972,3992,17964
250440,201910,681,575,106,575846.6,106786,682632.6
250450,201910,81,67,14,66866,13972,80838
250460,201910,438,308,130,307384,129740,437124
250470,201910,91,66,25,65868,24950,90818
250480,201910,322,257,65,256486,65868,322354
250485,201910,1,1,0,998,0,998
250490,201910,215,183,32,182634,31936,214570
250500,201910,82,62,20,61876,19960,81836
250510,201910,732,581,151,580836,150698,731534
250520,201910,173,119,54,118762,53892,172654
250523,201910,114,96,18,95808,17964,113772
250527,201910,101,80,21,79840,20958,100798
250530,201910,9,5,4,4990,3992,8982
250535,201910,26,21,5,20958,4990,25948
250540,201910,127,98,29,97804,28942,126746
250550,201910,70,67,3,66866,2994,69860
250560,201910,44,32,12,31936,11976,43912
250570,201910,161,131,30,130738,29940,160678
250580,201910,114,89,25,88886,24950,113836
250590,201910,26,17,9,16966,8982,25948
250600,201910,1313,883,430,882233.04,430138,1312371.04
250610,201910,156,134,22,134730,21956,156686
250620,201910,23,18,5,17964,4990,22954
250625,201910,71,53,18,53892,17964,71856
250630,201910,3017,1942,1075,1939127.49,1073855.92,3012983.41
250640,201910,215,177,38,176646,37924,214570
250650,201910,27,19,8,18962,7984,26946
250660,201910,49,38,11,37924,10978,48902
250670,201910,64,44,20,43912,19960,63872
250680,201910,394,321,73,321356,72854,394210
250690,201910,1944,1354,590,1352294.15,590816,1943110.15
250700,201910,926,812,114,811374.5,113772,925146.5
250710,201910,429,337,92,336326,91816,428142
250720,201910,112,85,27,84830,26946,111776
250730,201910,370,312,58,311376,57884,369260
250740,201910,52,48,4,48902,3992,52894
250750,201910,21566,13112,8454,13115625.23,8464046.12,21579671.35
250760,201910,82,65,17,64870,16966,81836
250770,201910,355,236,119,235528.44,118762,354290.44
250780,201910,58,42,16,41916,15968,57884
250790,201910,460,299,161,298402,161676,460078
250800,201910,148,136,12,135728,11976,147704
250810,201910,78,59,19,58882,18962,77844
250820,201910,154,127,27,126746,26946,153692
250830,201910,429,294,135,294410.4,134730,429140.4
250840,201910,51,48,3,47904,2994,50898
250850,201910,53,43,10,43912,9980,53892
250855,201910,13,11,2,10978,1996,12974
250860,201910,199,140,59,139720,59880,199600
250870,201910,33,29,4,28942,3992,32934
250880,201910,82,62,20,61876,19960,81836
250890,201910,2729,2051,678,2047896,676644,2724540
250900,201910,45,38,7,37924,6986,44910
250905,201910,118,92,26,91816,25948,117764
250910,201910,1139,823,316,821354.99,316366,1137720.99
250915,201910,107,74,33,73852,32934,106786
250920,201910,139,104,35,103792,34930,138722
250930,201910,168,105,63,105788,62874,168662
250933,201910,1,1,0,998,0,998
250937,201910,9,8,1,7984,998,8982
250939,201910,34,25,9,24950,8982,33932
250940,201910,102,78,24,77844,23952,101796
250950,201910,70,47,23,46906,22954,69860
250960,201910,89,49,40,48902,39920,88822
250970,201910,1227,871,356,871254,355288,1226542
250980,201910,99,67,32,66866,31936,98802
250990,201910,168,131,37,131736,36926,168662
251000,201910,77,69,8,68862,7984,76846
251010,201910,107,83,24,82834.99,23952,106786.99
251020,201910,78,67,11,66866,10978,77844
251030,201910,44,35,9,34930,8982,43912
251040,201910,52,38,14,37924,13972,51896
251050,201910,23,21,2,20958,1996,22954
251060,201910,50,39,11,38922,10978,49900
251065,201910,4,4,0,3992,0,3992
251070,201910,22,19,3,18962.98,2994,21956.98
251080,201910,4963,2408,2555,2405201.28,2555882.63,4961083.91
251090,201910,191,162,29,161676,28942,190618
251100,201910,18,17,1,16966,998,17964
251110,201910,44,35,9,34930,8982,43912
251120,201910,1816,1117,699,1116764,700596.68,1817360.68
251130,201910,389,319,70,319360,69860,389220
251140,201910,542,357,185,357285.2,184630,541915.2
251150,201910,314,274,40,274450.98,39920,314370.98
251160,201910,94,79,15,78842.99,14970,93812.99
251170,201910,100,82,18,81836.99,18962,100798.99
251180,201910,289,180,109,179640.99,109780.99,289421.98
251190,201910,189,129,60,128742,59880,188622
251200,201910,268,219,49,219560,49900,269460
251203,201910,36,33,3,32934,2994,35928
251207,201910,92,75,17,74850,16966,91816
251210,201910,1470,1072,398,1070854,398202,1469056
251220,201910,49,38,11,37924,10978,48902
251230,201910,599,509,90,507982,90818,598800
251240,201910,97,70,27,69860,26946,96806
251250,201910,1383,990,393,989018.9,394210.7,1383229.6
251260,201910,12,7,5,6986,4990,11976
251270,201910,320,246,74,246506,73852,320358
251272,201910,66,59,7,58882,6986,65868
251274,201910,27,21,6,20958,5988,26946
251275,201910,30,18,12,17964,11976,29940
251276,201910,12,10,2,9980,1996,11976
251278,201910,10,8,2,7984,1996,9980
251280,201910,100,96,4,95808,3992,99800
251290,201910,730,547,183,546904,182634,729538
251300,201910,16,13,3,12974,2994,15968
251310,201910,377,269,108,268462.99,107784,376246.99
251315,201910,26,25,1,24950,998,25948
251320,201910,60,49,11,48902,10978,59880
251330,201910,81,71,10,70858,9980,80838
251335,201910,14,9,5,8982,4990,13972
251340,201910,715,423,292,423152,291416.4,714568.4
251350,201910,32,31,1,30938,998,31936
251360,201910,75,67,8,66866,7984,74850
251365,201910,15,15,0,14970,0,14970
251370,201910,5463,3724,1739,3724438.34,1739514.6,5463952.94
251380,201910,42,34,8,33932,7984,41916
251385,201910,3,3,0,2994,0,2994
251390,201910,759,587,172,586824.7,171656.4,758481.1
251392,201910,14,7,7,6986,6986,13972
251394,201910,9,9,0,8982,0,8982
251396,201910,11,7,4,6986,3992,10978
251398,201910,18,15,3,14970,2994,17964
251400,201910,39,35,4,34930,3992,38922
251410,201910,37,31,6,30938,5988,36926
251420,201910,103,75,28,74850,27944,102794
251430,201910,41,38,3,38922,2994,41916
251440,201910,34,21,13,20958,12974,33932
251445,201910,48,42,6,41916,5988,47904
251450,201910,402,352,50,353292.2,49900,403192.2
251455,201910,3,2,1,1996,998,2994
251460,201910,17,15,2,14970,1996,16966
251465,201910,4,2,2,1996,1996,3992
251470,201910,46,37,9,36926,8982,45908
251480,201910,25,22,3,21956,2994,24950
251490,201910,122,85,37,84830,36926.4,121756.4
251500,201910,121,99,22,98802,21956,120758
251510,201910,36,28,8,27944,7984,35928
251520,201910,26,26,0,25948,0,25948
251530,201910,4482,3178,1304,3175636.8,1303388,4479024.8
251540,201910,74,64,10,63872,9980,73852
251550,201910,404,313,91,312374,91816.9,404190.9
251560,201910,21,14,7,13972,6986,20958
251570,201910,20,19,1,18962,998,19960
251580,201910,127,104,23,104790,22954,127744
251590,201910,120,87,33,87015,32934,119949
251593,201910,25,15,10,14970,9980,24950
251597,201910,66,55,11,54890,10978,65868
251600,201910,1098,784,314,785433.71,313372.6,1098806.31
251610,201910,233,181,52,180638,51896,232534
251615,201910,6,6,0,5988,0,5988
251620,201910,4231,2799,1432,2798394.24,1432131.6,4230525.84
251630,201910,451,333,118,332334,117764.98,450098.98
251640,201910,142,102,40,101796,39920,141716
251650,201910,261,190,71,190618.7,70858,261476.7
251660,201910,190,170,20,170658,19960,190618
251670,201910,363,288,75,287424,74850,362274
251675,201910,5,5,0,4990,0,4990
251680,201910,97,88,9,87824,8982,96806
251690,201910,341,279,62,278442,61876,340318
251700,201910,286,249,37,248502.17,36926,285428.17
251710,201910,23,15,8,14970,7984,22954
251720,201910,25,16,9,15968,8982.4,24950.4
251740,201910,9,7,2,6986,1996,8982
260005,201910,3133,1779,1354,1778438.95,1358280.88,3136719.83
260010,201910,1568,1143,425,1140715.13,425148.64,1565863.77
260020,201910,414,364,50,364270,49900,414170
260030,201910,590,426,164,425148,163672,588820
260040,201910,816,510,306,509978,307384,817362
260050,201910,1150,832,318,830336,317364.8,1147700.8
260060,201910,387,353,34,352294,33932,386226
260070,201910,1389,868,521,866266.89,519958.69,1386225.58
260080,201910,725,569,156,568860,155688,724548
260090,201910,510,333,177,332335.96,177644,509979.96
260100,201910,230,163,67,162674,66866,229540
260105,201910,218,120,98,119760,97804,217564
260110,201910,2843,2101,742,2099793.78,743510.4,2843304.18
260120,201910,2842,1471,1371,1471053.81,1371252.7,2842306.51
260130,201910,161,113,48,113772,47904,161676
260140,201910,2157,1410,747,1410185.08,746504.98,2156690.06
260150,201910,216,143,73,142714,72854,215568
260160,201910,323,274,49,273452,48902,322354
260170,201910,3364,2060,1304,2060870.88,1312370.4,3373241.28
260180,201910,153,130,23,130738,22954,153692
260190,201910,2275,1595,680,1591810,683630,2275440
260200,201910,959,775,184,773450.63,184630.4,958081.03
260210,201910,1454,1045,409,1042910,408182.98,1451092.98
260220,201910,715,646,69,645706.4,69860,715566.4
260230,201910,1192,896,296,895206.94,297404,1192610.94
260240,201910,224,169,55,168662,54890,223552
260250,201910,88,66,22,65868,21956,87824
260260,201910,1020,733,287,733530,287424,1020954
260270,201910,415,334,81,333332,80838,414170
260280,201910,1324,928,396,928140.6,397204.4,1325345.0
260290,201910,6464,3524,2940,3519952.28,2946102.07,6466054.35
260300,201910,930,809,121,809378.6,121756,931134.6
260310,201910,524,409,115,408182,114770,522952
260320,201910,871,646,225,645706,224550,870256
260330,201910,53,39,14,38922,13972,52894
260340,201910,73,54,19,53892,18962,72854
260345,201910,5538,3087,2451,3086816.67,2451091.9,5537908.57
260350,201910,474,346,128,345308.4,128742.98,474051.38
260360,201910,275,146,129,145708,128742,274450
260370,201910,703,468,235,468062.5,234530.99,702593.49
260380,201910,600,441,159,440118,159680.66,599798.66
260390,201910,297,251,46,250498,45908,296406
260392,201910,108,92,16,91816,15968,107784
260400,201910,4104,2391,1713,2392207.79,1713566,4105773.79
260410,201910,14591,7728,6863,7724522.54,6861251.28,14585773.82
260415,201910,134,120,14,119760,13972,133732
260420,201910,1759,1076,683,1074847.81,686624,1761471.81
260430,201910,194,175,19,174651.25,18962,193613.25
260440,201910,209,152,57,151696.98,56886,208582.98
260450,201910,444,325,119,324351.2,119760,444111.2
260460,201910,822,440,382,439121.2,381236,820357.2
260470,201910,358,219,139,219560,139720.8,359280.8
260480,201910,225,146,79,145708,78842,224550
260490,201910,215,181,34,180638,33932,214570
260500,201910,1132,763,369,763470,369260,1132730
260510,201910,773,623,150,625746,149700,775446
260515,201910,242,218,24,217564,23952,241516
260520,201910,3237,1976,1261,1976040.99,1263468.78,3239509.77
260530,201910,806,661,145,660676,145708,806384
260540,201910,557,436,121,435128,121756,556884
260545,201910,11,9,2,8982,1996,10978
260550,201910,330,204,126,204590,125748,330338
260560,201910,538,403,135,402194.4,134730,536924.4
260570,201910,981,808,173,806384.4,172654,979038.4
260580,201910,260,228,32,227544,31936,259480
260590,201910,627,365,262,367264,261476,628740
260600,201910,8005,4317,3688,4315353.86,3689606,8004959.86
260610,201910,487,328,159,328342,159680,488022
260620,201910,3644,1929,1715,1926143.02,1715564.07,3641707.09
260630,201910,89,83,6,82834,5988,88822
260640,201910,3574,1980,1594,1981030.92,1597798.98,3578829.90
260650,201910,327,243,84,242514,83832,326346
260660,201910,541,366,175,365268,174650,539918
260670,201910,103,77,26,76846,25948,102794
260680,201910,3625,2065,1560,2064865.01,1558877.36,3623742.37
260690,201910,129,95,34,94810,33932,128742
260700,201910,318,209,109,208582,108782,317364
260710,201910,39,36,3,35928,2994,38922
260720,201910,2361,1415,946,1413169.6,947102,2360271.6
260730,201910,674,507,167,507982,167664,675646
260740,201910,61,57,4,56886,3992,60878
260750,201910,615,443,172,442114,171656,613770
260760,201910,629,339,290,338322.63,289420,627742.63
260765,201910,963,504,459,504988.99,459080,964068.99
260770,201910,218,163,55,162657,54890,217547
260775,201910,786,464,322,464072.1,321356.98,785429.08
260780,201910,272,177,95,177644,95808,273452
260790,201910,12332,6732,5600,6727528.3,5599783.41,12327311.71
260795,201910,171,116,55,115768,54890,170658
260800,201910,286,239,47,238522,46906,285428
260805,201910,174,116,58,115768,57884,173652
260810,201910,745,652,93,651694,92814,744508
260820,201910,295,190,105,191616.34,104790,296406.34
260825,201910,210,148,62,147704,61876,209580
260830,201910,283,179,104,178642,104790,283432
260840,201910,226,166,60,165668,59880,225548
260845,201910,172,120,52,119760,51896,171656
260850,201910,456,339,117,338322,116766,455088
260860,201910,257,194,63,193612,62874,256486
260870,201910,375,282,93,281436,93812,375248
260875,201910,736,525,211,523950,210578,734528
260880,201910,1600,1018,582,1016962.2,582832,1599794.2
260890,201910,2391,1687,704,1683627.8,704588.8,2388216.6
260900,201910,992,695,297,693610,297404,991014
260910,201910,264,210,54,209580,53892,263472
260915,201910,299,212,87,211576,86826,298402
260920,201910,177,96,81,95808,80838,176646
260930,201910,397,342,55,341318.91,54890.97,396209.88
260940,201910,2726,1497,1229,1496003.76,1228538.4,2724542.16
260950,201910,2024,1178,846,1181632.7,847302,2028934.7
260960,201910,13638,7110,6528,7108766.16,6531918.41,13640684.57
260970,201910,432,367,65,367264,64870,432134
260980,201910,194,172,22,171656,21956,193612
260990,201910,2596,2114,482,2109774.34,483032,2592806.34
261000,201910,4338,2588,1750,2586817.58,1748496.6,4335314.18
261010,201910,175,129,46,128742,45908,174650
261020,201910,611,459,152,458083.06,151696,609779.06
261030,201910,238,178,60,177644,59880,237524
261040,201910,372,327,45,326346,44910,371256
261050,201910,502,439,63,439120,62874,501994
261060,201910,1371,898,473,898200.5,473052,1371252.5
261070,201910,8627,4400,4227,4399209.73,4224583.81,8623793.54
261080,201910,377,291,86,290418,85828,376246
261090,201910,2246,1735,511,1731533.91,511974.47,2243508.38
261100,201910,1129,794,335,793411.3,335328,1128739.3
261110,201910,8597,5299,3298,5293396.06,3295400.01,8588796.07
261120,201910,265,224,41,223552,40918,264470
261130,201910,573,342,231,341316.6,230538.62,571855.22
261140,201910,186,120,66,119760,65868,185628
261150,201910,680,423,257,422154.18,256486,678640.18
261153,201910,69,65,4,65868,3992,69860
261160,201910,75927,38309,37618,38311284.2,37642596.98,75953881.18
261170,201910,478,362,116,361276,115768,477044
261180,201910,1816,1123,693,1123748,695606,1819354
261190,201910,602,426,176,426148.52,177644.98,603793.50
261200,201910,220,191,29,190618,28942,219560
261210,201910,35,29,6,28942,5988,34930
261220,201910,2700,1893,807,1892210.39,805386.97,2697597.36
261230,201910,347,261,86,260478,85828,346306
261240,201910,466,403,63,402194,62874,465068
261245,201910,236,194,42,193612,41916,235528
261247,201910,173,137,36,136726,35928,172654
261250,201910,2985,1517,1468,1515962.81,1465064,2981026.81
261255,201910,253,230,23,230538,22954,253492
261260,201910,869,756,113,757482.76,112774,870256.76
261270,201910,190,141,49,140718,48902,189620
261280,201910,174,144,30,143712,29940,173652
261290,201910,124,88,36,87824,35928,123752
261300,201910,1295,946,349,946104,351296,1297400
261310,201910,806,546,260,545906,259480.4,805386.4
261320,201910,557,390,167,389220,166666,555886
261330,201910,1000,763,237,761474,237524.63,998998.63
261340,201910,289,167,122,166666,121756,288422
261350,201910,831,592,239,591814.4,238522,830336.4
261360,201910,1279,839,440,837322,440118,1277440
261370,201910,4816,2953,1863,2955081.56,1861271.78,4816353.34
261380,201910,558,418,140,419160.66,139720.4,558881.06
261390,201910,3578,2398,1180,2397196.8,1181632.7,3578829.5
261400,201910,281,256,25,255488,24950,280438
261410,201910,1101,747,354,746504,353292,1099796
261420,201910,871,551,320,550898.47,320358,871256.47
261430,201910,329,295,34,294410,33932,328342
261440,201910,125,115,10,114770,9980,124750
261450,201910,2539,2074,465,2073845.91,464070.4,2537916.31
261460,201910,730,585,145,584828.74,144710,729538.74
261470,201910,240,190,50,189620.1,49900,239520.1
261480,201910,426,334,92,333332.6,91772.99,425105.59
261485,201910,344,213,131,212574,131736,344310
261500,201910,607,415,192,414170,191616,605786
261510,201910,51,34,17,33932,16966,50898
261520,201910,112,99,13,98802,13972,112774
261530,201910,4130,2615,1515,2611767.19,1514965.84,4126733.03
261540,201910,1261,767,494,765466,493012,1258478
261550,201910,271,134,137,133732.4,136726,270458.4
261560,201910,832,550,282,549898.7,281437.38,831336.08
261570,201910,398,314,84,313372,83832,397204
261580,201910,376,296,80,295408.96,79840,375248.96
261590,201910,195,159,36,158682,35928,194610
261600,201910,293,237,56,236526,55888,292414
261610,201910,97,81,16,80838,15968,96806
261618,201910,75,61,14,60878,13972,74850
261620,201910,200,120,80,119760,79840,199600
261630,201910,570,444,126,444110,125748,569858
261640,201910,6345,3391,2954,3391208.89,2956076.9,6347285.79
261650,201910,494,316,178,316366,177644,494010
270010,201910,528,469,59,469060,58882,527942
270020,201910,293,232,61,231536.99,60878,292414.99
270030,201910,9029,5870,3159,5876382.86,3162697.71,9039080.57
270040,201910,1999,1260,739,1259342.93,743510,2002852.93
270050,201910,157,119,38,118762,37924,156686
270060,201910,113,63,50,62874,49900,112774
270070,201910,885,648,237,647702,236526.98,884228.98
270080,201910,37,31,6,30938,5988,36926
270090,201910,17,13,4,12974,3992,16966
270100,201910,1200,800,400,800396.98,399200,1199596.98
270110,201910,131,100,31,99800,30938,130738
270120,201910,224,182,42,181636,41916.4,223552.4
270130,201910,234,162,72,161676,71856,233532
270135,201910,104,63,41,62874,40918,103792
270140,201910,1362,848,514,847305.35,513970.98,1361276.33
270150,201910,260,204,56,203592,55888,259480
270160,201910,519,399,120,399200,119760,518960
270170,201910,778,504,274,504821.66,273452,778273.66
270180,201910,72,56,16,55888,16966,72854
270190,201910,91,80,11,79840,10978,90818
270200,201910,103,92,11,91816,10978,102794
270210,201910,494,276,218,275514.53,218562,494076.53
270220,201910,179,142,37,141716,36926,178642
270230,201910,2102,1296,806,1297069.97,806385.94,2103455.91
270235,201910,710,549,161,548904.82,160681.9,709586.72
270240,201910,3120,2466,654,2462067.34,653692.54,3115759.88
270250,201910,160,116,44,115768,43912,159680
270255,201910,209,179,30,178642,29940,208582
270260,201910,361,295,66,294410,65868,360278
270270,201910,99,43,56,42914.98,55888,98802.98
270280,201910,249,140,109,139720,108782,248502
270290,201910,1177,899,278,897202,277444.98,1174646.98
270300,201910,286,194,92,194610,91816,286426
270310,201910,877,717,160,715604.14,160678.98,876283.12
270320,201910,851,730,121,728541.61,120758,849299.61
270330,201910,280,237,43,236526,42914,279440
270340,201910,59,47,12,46906,11976,58882
270350,201910,93,48,45,47904,44910,92814
270360,201910,59,35,24,35928,23952,59880
270370,201910,57,45,12,44910,11976,56886
270375,201910,73,47,26,46906,25948,72854
270380,201910,1008,616,392,614768,392214,1006982
270390,201910,192,112,80,111776,79840,191616
270400,201910,719,529,190,527946.39,189620,717566.39
270410,201910,672,489,183,489020,182634,671654
270420,201910,403,276,127,275448,126747.94,402195.94
270430,201910,33077,23788,9289,23779840.72,9300373.44,33080214.16
270440,201910,487,386,101,386226,100798,487024
270450,201910,788,436,352,435128,352294,787422
270460,201910,190,152,38,151696,37924,189620
270470,201910,1444,998,446,1002990.4,452094,1455084.4
270480,201910,539,446,93,448102.8,92814,540916.8
270490,201910,24,19,5,18962,4990,23952
270500,201910,491,410,81,409180,80838,490018
270510,201910,778,481,297,482034,296406,778440
270520,201910,318,199,119,198602,119760,318362
270530,201910,66,56,10,55888,9980,65868
270540,201910,112,88,24,87824,23952,111776
270550,201910,1762,1352,410,1351293.98,411176,1762469.98
270560,201910,279,142,137,141716,136726,278442
270570,201910,506,357,149,356286,148702,504988
270580,201910,96,71,25,70858,24950,95808
270590,201910,69,55,14,54890,13972,68862
270600,201910,175,144,31,143712,30938,174650
270610,201910,206,174,32,173652,31936,205588
270620,201910,30,29,1,28942,998,29940
270630,201910,3808,2913,895,2908175.76,896204.96,3804380.72
270640,201910,883,654,229,652692,229542.9,882234.9
270642,201910,225,190,35,189620,34930,224550
270644,201910,247,163,84,162674.98,83832,246506.98
270650,201910,319,191,128,190684.53,127744,318428.53
270660,201910,255,211,44,210578,43912,254490
270670,201910,3082,2367,715,2367259.9,714568.4,3081828.3
270680,201910,457,268,189,268462.98,188622,457084.98
270690,201910,1153,749,404,747502,403192,1150694
270700,201910,32,24,8,23952,7984,31936
270710,201910,882,681,201,680636,200599.92,881235.92
270720,201910,248,195,53,194610,52894,247504
270730,201910,1896,1124,772,1125578.46,773452.08,1899030.54
270740,201910,42,28,14,27944,13972,41916
270750,201910,656,487,169,489020.6,168662,657682.6
270760,201910,295,215,80,215568,79840,295408
270770,201910,2766,1809,957,1810375.3,958080.96,2768456.26
270780,201910,80,50,30,49900,29941.98,79841.98
270790,201910,245,163,82,162674,81836,244510
270800,201910,1976,1598,378,1595803.39,378242,1974045.39
270810,201910,288,231,57,230538,56886,287424
270820,201910,152,101,51,100798,50898.8,151696.8
270830,201910,808,594,214,594809.98,213572.99,808382.97
270840,201910,1422,1082,340,1080834,339321.7,1420155.7
270850,201910,1565,966,599,964069,598800,1562869
270860,201910,2527,1673,854,1674480.07,855288.67,2529768.74
270870,201910,129,69,60,68862,60878,129740
270880,201910,904,698,206,698610.72,208586.86,907197.58
270890,201910,312,228,84,227544,83832,311376
270895,201910,65,56,9,55888,8982,64870
270900,201910,97,75,22,74850,21956,96806
270910,201910,314,251,63,250498,62874,313372
270915,201910,1920,1192,728,1192639.69,727553.2,1920192.89
270920,201910,493,415,78,414170,77844,492014
270930,201910,6102,4522,1580,4517962.96,1579843.94,6097806.90
270940,201910,2353,1820,533,1819154.4,532932,2352086.4
280010,201910,41,36,5,35928,4990,40918
280020,201910,462,406,56,405188.96,55888,461076.96
280030,201910,20143,13144,6999,13142707.35,6995994.58,20138701.93
280040,201910,327,216,111,215568,110778,326346
280050,201910,384,295,89,296406,89820,386226
280060,201910,333,222,111,222554.48,110778,333332.48
280067,201910,1029,746,283,745506.49,283432.75,1028939.24
280070,201910,120,99,21,98802,20958,119760
280100,201910,619,487,132,486026.4,131736.6,617763.0
280110,201910,74,69,5,68862,4990,73852
280120,201910,639,524,115,522952,115768,638720
280130,201910,1654,1081,573,1078838,571854.8,1650692.8
280140,201910,471,388,83,387224,82834,470058
280150,201910,379,277,102,277444,101796,379240
280160,201910,96,84,12,83832,11976,95808
280170,201910,403,270,133,269460,132734,402194
280190,201910,29,27,2,26946,1996,28942
280200,201910,30,25,5,24950,4990,29940
280210,201910,2866,2082,784,2079836.37,785426.4,2865262.77
280220,201910,41,33,8,32934,7984,40918
280230,201910,323,267,56,266466,55888,322354
280240,201910,119,113,6,112774,5988,118762
280250,201910,16,10,6,9980,5988,15968
280260,201910,82,72,10,71856,9980,81836
280270,201910,155,121,34,120758,34930,155688
280280,201910,187,120,67,120758.85,66866,187624.85
280290,201910,3315,2424,891,2425078.64,889218.64,3314297.28
280300,201910,1601,1241,360,1239516.4,361276,1600792.4
280310,201910,102,98,4,97804.6,3992,101796.6
280320,201910,667,466,201,466066,200598,666664
280330,201910,338,244,94,243512,93812,337324
280340,201910,406,330,76,329340,75848,405188
280350,201910,3585,2801,784,2799394.24,786424.7,3585818.94
280360,201910,445,291,154,290418,154690,445108
280370,201910,97,85,12,84830,11976,96806
280380,201910,55,43,12,42914,11976,54890
280390,201910,175,151,24,150698,23952,174650
280400,201910,346,235,111,234531.36,110778,345309.36
280410,201910,286,232,54,231536.6,53892,285428.6
280420,201910,168,142,26,141716,25948,167664
280430,201910,30,22,8,21956,7984,29940
280440,201910,694,541,153,540917.46,152694,693611.46
280445,201910,117,109,8,108782,7984,116766
280450,201910,1164,1002,162,1003988.94,161676,1165664.94
280460,201910,612,447,165,447104.7,164670,611774.7
280470,201910,188,173,15,173652,14970.7,188622.7
280480,201910,2498,1782,716,1782430.76,715567.62,2497998.38
280490,201910,278,259,19,258482.15,18962,277444.15
280500,201910,40,37,3,36926,2994,39920
280510,201910,140,113,27,112774,26946.4,139720.4
280520,201910,53,39,14,38922,13972,52894
280530,201910,74,48,26,47904,25948,73852
280540,201910,522,426,96,425148.7,95808,520956.7
280550,201910,725,671,54,669660.4,53892,723552.4
280560,201910,491,433,58,435128,57884,493012
280570,201910,2203,1720,483,1718557.78,483032,2201589.78
280580,201910,605,468,137,468064.19,137724.8,605788.99
280590,201910,172,110,62,109780,61876,171656
280600,201910,389,327,62,327344,61876,389220
280610,201910,126,95,31,94810,30938,125748
280620,201910,554,462,92,462074,91816,553890
280630,201910,150,125,25,124750,24950,149700
280640,201910,189,153,36,152694.96,35928,188622.96
280650,201910,83,59,24,58882,23952,82834
280660,201910,140,104,36,103792,35928,139720
280670,201910,1768,1128,640,1128743.35,640717.26,1769460.61
280680,201910,168,145,23,144710.29,22954,167664.29
280690,201910,88,78,10,77844,9980,87824
280700,201910,21,21,0,20958,0,20958
280710,201910,1465,1130,335,1131732.6,334330,1466062.6
280720,201910,113,74,39,73852,38922,112774
280730,201910,25,21,4,20958,3992,24950
280740,201910,2494,1865,629,1862268.8,628740,2491008.8
280750,201910,222,195,27,194610,26946,221556
280760,201910,746,517,229,515966,228542,744508
290010,201910,201,141,60,140718,59880,200598
290020,201910,178,163,15,162674,14970,177644
290030,201910,601,392,209,392214,208582,600796
290035,201910,127,103,24,103792,24950,128742
290040,201910,299,201,98,200598,97804,298402
290050,201910,89,69,20,68862,19960,88822
290060,201910,264,119,145,118762,144710,263472
290070,201910,5594,2792,2802,2791407.86,2804383.84,5595791.70
290080,201910,474,224,250,223552.96,249500.96,473053.92
290090,201910,385,176,209,175648,209580,385228
290100,201910,1637,1083,554,1081833.2,552893.35,1634726.55
290110,201910,823,495,328,494011.12,328342.99,822354.11
290115,201910,199,185,14,185628,13972,199600
290120,201910,761,500,261,499000.63,260478,759478.63
290130,201910,430,262,168,261476,167664,429140
290135,201910,296,225,71,224550,70858,295408
290140,201910,309,254,55,253492,54890,308382
290150,201910,135,100,35,99800,34930,134730
290160,201910,244,186,58,185628,58882,244510
290170,201910,96,70,26,69860,25948,95808
290180,201910,172,131,41,130738.6,40918,171656.6
290190,201910,435,361,74,361276,74850,436126
290195,201910,315,200,115,199600,114770,314370
290200,201910,276,224,52,223552,51896,275448
290205,201910,148,92,56,91816,55888,147704
290210,201910,1163,856,307,854288.4,307384,1161672.4
290220,201910,220,122,98,121756,97804,219560
290225,201910,289,114,175,113772,174650,288422
290230,201910,72,48,24,47904,23952,71856
290240,201910,340,134,206,133732,206586,340318
290250,201910,260,240,20,240518,19960,260478
290260,201910,308,249,59,248502.4,58882,307384.4
290265,201910,191,162,29,161676,28942,190618
290270,201910,1428,1183,245,1181632.5,246507.36,1428139.86
290280,201910,473,337,136,336326,135728,472054
290290,201910,1287,769,518,769458.94,518960.4,1288419.34
290300,201910,441,376,65,377244.4,64870,442114.4
290310,201910,305,135,170,134730,169660,304390
290320,201910,4103,2554,1549,2555878.57,1550893.24,4106771.81
290323,201910,191,168,23,167664,22954,190618
290327,201910,167,134,33,133732,32934,166666
290330,201910,92,52,40,51896,39920,91816
290340,201910,862,354,508,353292,507982,861274
290350,201910,619,381,238,380238.4,237524,617762.4
290360,201910,365,279,86,278442.97,85828,364270.97
290370,201910,921,384,537,383232.7,535926.97,919159.67
290380,201910,321,198,123,197604,122754,320358
290390,201910,2484,1562,922,1563868.9,922152,2486020.9
290395,201910,249,142,107,141716.5,107784,249500.5
290400,201910,282,209,73,208583,72854,281437
290405,201910,248,217,31,216566,30938,247504
290410,201910,639,535,104,534928.55,103792,638720.55
290420,201910,251,203,48,202594,47904,250498
290430,201910,483,313,170,313372,170658,484030
290440,201910,72,65,7,64870,6986,71856
290450,201910,214,167,47,166666,46906,213572
290460,201910,1938,1177,761,1174655.8,761475.84,1936131.64
290470,201910,1404,605,799,603799.8,797418.66,1401218.46
290475,201910,587,547,40,546904.68,39920,586824.68
290480,201910,285,159,126,158682,125748,284430
290485,201910,243,227,16,226546,15968,242514
290490,201910,1218,877,341,877242,340318,1217560
290500,201910,723,376,347,375248,348302,723550
290510,201910,231,181,50,180638,49900,230538
290515,201910,146,92,54,91816,53892,145708
290520,201910,1436,955,481,955086.54,480038.73,1435125.27
290530,201910,305,282,23,282434,23952,306386
290540,201910,104,56,48,55888,47904,103792
290550,201910,152,126,26,125748,25948,151696
290560,201910,3222,1368,1854,1367260,1853288.92,3220548.92
290570,201910,6039,3047,2992,3049894.49,2990014.54,6039909.03
290580,201910,1292,778,514,776444,513970,1290414
290590,201910,568,470,98,469060,97804,566864
290600,201910,1748,1214,534,1212571.42,533930,1746501.42
290610,201910,209,187,22,186626.54,21956,208582.54
290620,201910,352,314,38,313372,37924,351296
290630,201910,1992,863,1129,864268,1132731.38,1996999.38
290640,201910,156,128,28,127744,27944,155688
290650,201910,1721,817,904,815366.69,906184,1721550.69
290660,201910,278,227,51,226546,50898,277444
290670,201910,945,495,450,494010.88,450098.63,944109.51
290680,201910,1236,997,239,997002,238522,1235524
290682,201910,304,225,79,224551.24,78842.98,303394.22
290685,201910,238,153,85,152694,84830,237524
290687,201910,1020,660,360,660838.96,359280,1020118.96
290689,201910,146,80,66,79840.97,65868,145708.97
290690,201910,611,260,351,259480.98,350302.84,609783.82
290700,201910,238,117,121,116766,120758,237524
290710,201910,717,489,228,488022,227544,715566
290720,201910,1040,847,193,846304,194610,1040914
290730,201910,1150,666,484,665666,483032,1148698
290740,201910,14,12,2,11976,1996,13972
290750,201910,1357,631,726,630736,727544.3,1358280.3
290755,201910,72,65,7,64870,6986,71856
290760,201910,296,257,39,256486,38922,295408
290770,201910,188,178,10,177644,9980.4,187624.4
290780,201910,1061,828,233,827345.74,232534,1059879.74
290790,201910,372,258,114,259480,115768,375248
290800,201910,2530,1021,1509,1018958,1506980,2525938
290810,201910,465,324,141,324350,140718,465068
290820,201910,404,241,163,241516,162674,404190
290830,201910,412,294,118,293412,117764,411176
290840,201910,1749,1091,658,1089817.28,656684.8,1746502.08
290850,201910,810,446,364,445108,363272,808380
290860,201910,625,289,336,288422,336326.4,624748.4
290870,201910,639,453,186,453092.64,185628.84,638721.48
290880,201910,123,68,55,67864,54890,122754
290890,201910,372,258,114,259480,113772,373252
290900,201910,167,129,38,128742,37924,166666
290910,201910,387,300,87,299400,86826,386226
290920,201910,220,188,32,187624,31936,219560
290930,201910,848,643,205,642712.4,204590.96,847303.36
290940,201910,247,205,42,204590,41916,246506
290950,201910,159,96,63,95808,63872,159680
290960,201910,472,325,147,324350,146706,471056
290970,201910,252,224,28,224550,27944,252494
290980,201910,1614,1151,463,1151693.08,465069.13,1616762.21
290990,201910,396,335,61,334331.96,60881.92,395213.88
291000,201910,861,254,607,253492,607782,861274
291005,201910,2253,1014,1239,1011972.54,1240514.98,2252487.52
291010,201910,156,142,14,142714,13972,156686
291020,201910,102,80,22,79840,21956,101796
291030,201910,97,71,26,70858,25948,96806
291040,201910,593,328,265,327344,265468,592812
291050,201910,1393,785,608,784428.96,607782,1392210.96
291060,201910,1508,848,660,848300,658680,1506980
291070,201910,1972,1471,501,1470055.98,499999.78,1970055.76
291072,201910,7265,2739,4526,2736517.82,4521941.92,7258459.74
291075,201910,233,193,40,192614.6,39920,232534.6
291077,201910,53,37,16,36926,15968,52894
291080,201910,20249,9016,11233,9016938.05,11242476.14,20259414.19
291085,201910,298,242,56,242514,55888,298402
291090,201910,303,120,183,119760.4,182634,302394.4
291100,201910,654,199,455,198602,454090,652692
291110,201910,416,313,103,313372,103792,417164
291120,201910,2458,1210,1248,1207580.7,1247500.99,2455081.69
291125,201910,67,33,34,32934,33932,66866
291130,201910,203,180,23,179640,22954,202594
291140,201910,141,112,29,111776,28942.4,140718.4
291150,201910,385,156,229,155688,228542,384230
291160,201910,388,322,66,321356.5,65868,387224.5
291165,201910,35,30,5,29940,4990,34930
291170,201910,3122,1576,1546,1577840.29,1543906.8,3121747.09
291180,201910,1265,504,761,502994.78,759480.88,1262475.66
291185,201910,82,79,3,78842,2994,81836
291190,201910,1331,597,734,597802.5,734528,1332330.5
291200,201910,163,122,41,121756.4,40918,162674.4
291210,201910,2248,908,1340,909179.08,1337320.4,2246499.48
291220,201910,278,210,68,209580,67864,277444
291230,201910,992,348,644,348302.4,643710,992012.4
291240,201910,433,409,24,408182.4,23952,432134.4
291250,201910,443,362,81,361276,81836,443112
291260,201910,52,41,11,40918,10978,51896
291270,201910,1167,488,679,487024,678640,1165664
291280,201910,358,173,185,172654.4,184630,357284.4
291290,201910,1732,903,829,904188.4,828341,1732529.4
291300,201910,232,182,50,182634,50898,233532
291310,201910,231,212,19,211576,18962,230538
291320,201910,1387,991,396,990016,397204,1387220
291330,201910,128,109,19,108782,18962,127744
291340,201910,191,110,81,109780,80838,190618
291345,201910,140,95,45,94810,44910,139720
291350,201910,1630,574,1056,573850,1053888.7,1627738.7
291360,201910,8397,4173,4224,4175636.46,4229527.86,8405164.32
291370,201910,1141,649,492,649698.4,492014.98,1141713.38
291380,201910,255,202,53,202594,52894,255488
291390,201910,3855,1719,2136,1717559.44,2132726.4,3850285.84
291400,201910,2079,1494,585,1493008,587822.81,2080830.81
291410,201910,187,165,22,164670,21956,186626
291420,201910,119,88,31,87824,30938,118762
291430,201910,163,90,73,89820,72854.11,162674.11
291440,201910,521,427,94,426146.8,94810,520956.8
291450,201910,911,584,327,584828.5,326346,911174.5
291460,201910,1828,1492,336,1491013.6,335328,1826341.6
291465,201910,2188,1058,1130,1057893.9,1127753.58,2185647.48
291470,201910,2863,1453,1410,1455084.71,1409176.4,2864261.11
291480,201910,11741,5269,6472,5264475.96,6473152.28,11737628.24
291490,201910,578,243,335,243512,334330,577842
291500,201910,378,219,159,218562,158682,377244
291510,201910,1227,476,751,476046,750496,1226542
291520,201910,943,435,508,435128,507982,943110
291530,201910,968,274,694,274450,692612,967062
291535,201910,126,106,20,105788,19960,125748
291540,201910,343,102,241,101796.4,240518.2,342314.6
291550,201910,1217,585,632,583831.2,631735.38,1215566.58
291560,201910,5339,2737,2602,2735610,2599955.95,5335565.95
291570,201910,199,103,96,102794,95808,198602
291580,201910,1228,755,473,753491.41,474050,1227541.41
291590,201910,81,33,48,32934,47904,80838
291600,201910,1167,584,583,582832,581835.96,1164667.96
291610,201910,1469,721,748,721554,746505.58,1468059.58
291620,201910,579,267,312,266466,313372,579838
291630,201910,476,150,326,149700,326346,476046
291640,201910,3957,2026,1931,2023948.2,1929146.96,3953095.16
291650,201910,420,289,131,288423.15,130738,419161.15
291660,201910,398,158,240,157684.68,239520,397204.68
291670,201910,221,141,80,140718,79840,220558
291680,201910,670,396,274,395208,273452.8,668660.8
291685,201910,588,329,259,328342.5,258482,586824.5
291690,201910,556,320,236,319360,235529.86,554889.86
291700,201910,960,757,203,756484,202594,959078
291710,201910,1685,808,877,806384.5,876244,1682628.5
291720,201910,419,283,136,282434,135728,418162
291730,201910,946,564,382,562872,382234,945106
291733,201910,282,195,87,194610,86826,281436
291735,201910,74,55,19,54890,18962,73852
291740,201910,352,274,78,273452.4,77844,351296.4
291750,201910,2098,1375,723,1372250.8,723550,2095800.8
291760,201910,3025,1669,1356,1667658,1359276,3026934
291770,201910,776,526,250,524953.33,250498,775451.33
291780,201910,54,34,20,33932,19960,53892
291790,201910,159,77,82,76846,81836,158682
291800,201910,10064,4190,5874,4185614.51,5872235.08,10057849.59
291810,201910,1126,833,293,832332.4,293412.6,1125745.0
291820,201910,277,202,75,201596,75848,277444
291830,201910,1107,444,663,443112.98,662672.98,1105785.96
291835,201910,582,540,42,538920,41916,580836
291840,201910,4836,2490,2346,2491009.35,2347296.4,4838305.75
291845,201910,277,95,182,94810,182634,277444
291850,201910,329,292,37,291416,36926,328342
291855,201910,258,101,157,100798,156686,257484
291860,201910,171,108,63,107784,62874,170658
291870,201910,83,33,50,32934,49900,82834
291875,201910,182,169,13,168662,12974,181636
291880,201910,472,378,94,377244.6,93812,471056.6
291890,201910,238,76,162,75848,161676.4,237524.4
291900,201910,58,33,25,33932,24950,58882
291905,201910,126,92,34,91816.4,33932,125748.4
291910,201910,169,139,30,138722,29940,168662
291915,201910,424,376,48,375248.5,47904,423152.5
291920,201910,4978,2582,2396,2578832.98,2397197.98,4976030.96
291930,201910,180,107,73,106786,72854,179640
291940,201910,357,201,156,200598,155688,356286
291950,201910,1142,928,214,927142.4,214570,1141712.4
291955,201910,1231,734,497,732532.4,497004,1229536.4
291960,201910,183,133,50,132734,49900,182634
291970,201910,768,582,186,580836,185628,766464
291980,201910,1528,1352,176,1351293.38,176646.4,1527939.78
291990,201910,133,123,10,122754,9980,132734
291992,201910,169,83,86,82834,87824,170658
291995,201910,164,110,54,109780,53892,163672
292000,201910,393,305,88,304390.4,87824,392214.4
292010,201910,303,214,89,213572,88822,302394
292020,201910,293,214,79,213572,78842,292414
292030,201910,150,115,35,114770,34930,149700
292040,201910,641,322,319,322354,318362,640716
292045,201910,105,97,8,96806,7984,104790
292050,201910,945,690,255,689618,254490.4,944108.4
292060,201910,918,767,151,767462.86,151696,919158.86
292070,201910,49,20,29,19960,28942,48902
292080,201910,137,93,44,92814,43912,136726
292090,201910,522,190,332,189620,331336,520956
292100,201910,1436,632,804,631734.6,805386.98,1437121.58
292105,201910,206,178,28,177644,27944,205588
292110,201910,2255,854,1401,854288,1399201.86,2253489.86
292120,201910,698,554,144,553890,143712,697602
292130,201910,445,258,187,260478,186626,447104
292140,201910,207,165,42,164670,41916,206586
292145,201910,165,88,77,87824.4,76846,164670.4
292150,201910,1469,1198,271,1196602,270458,1467060
292160,201910,175,144,31,143712,30938,174650
292170,201910,1210,1060,150,1059876,149700,1209576
292180,201910,217,158,59,157684,58882,216566
292190,201910,162,102,60,101796,59880,161676
292200,201910,1302,494,808,493013.36,806385.36,1299398.72
292205,201910,126,111,15,111776,14970,126746
292210,201910,361,255,106,255488,106786,362274
292220,201910,25,20,5,19960,4990,24950
292225,201910,39,34,5,33932,4990,38922
292230,201910,968,782,186,782432.3,185628,968060.3
292240,201910,618,452,166,452094.7,166666,618760.7
292250,201910,1765,1167,598,1167660,598800.4,1766460.4
292260,201910,423,252,171,251496,170658,422154
292265,201910,252,179,73,178642,72854,251496
292270,201910,735,338,397,337324,396206.6,733530.6
292273,201910,198,111,87,110778,87824,198602
292275,201910,177,88,89,87824,88822,176646
292280,201910,142,103,39,102794,38922,141716
292285,201910,70,59,11,58882,10978,69860
292290,201910,570,390,180,390218,179640.4,569858.4
292300,201910,1660,647,1013,647702.4,1011972.72,1659675.12
292303,201910,106,71,35,70858,34930,105788
292305,201910,112,83,29,82834,28942,111776
292310,201910,906,597,309,597803.24,310378.56,908181.80
292320,201910,618,468,150,470058,150698,620756
292330,201910,176,103,73,102794,73852,176646
292335,201910,288,227,61,226546,60878,287424
292340,201910,579,406,173,405188.4,174650,579838.4
292350,201910,268,143,125,143712,124750,268462
292360,201910,709,541,168,539918.56,169660,709578.56
292370,201910,752,578,174,576844,174650,751494
292380,201910,660,520,140,518960.54,139720,658680.54
292390,201910,485,194,291,194610,291416,486026
292400,201910,3545,2211,1334,2209575.3,1333329,3542904.3
292405,201910,268,175,93,174650,92814,267464
292410,201910,143,87,56,86826,55888,142714
292420,201910,300,260,40,260478,39920,300398
292430,201910,522,409,113,409180,113772,522952
292440,201910,590,506,84,505986.4,83832,589818.4
292450,201910,260,203,57,202594,56886,259480
292460,201910,561,421,140,420158.98,139720,559878.98
292465,201910,218,179,39,178642,38922,217564
292467,201910,117,70,47,69860,47904,117764
292470,201910,282,191,91,190618,90818,281436
292480,201910,350,242,108,241516,107784.4,349300.4
292490,201910,234,163,71,162674,70858,233532
292500,201910,869,382,487,383233.72,486026,869259.72
292510,201910,3438,1586,1852,1583826.44,1850293.18,3434119.62
292520,201910,1100,521,579,519958.99,580836.98,1100795.97
292525,201910,400,282,118,281436,117764,399200
292530,201910,4344,1786,2558,1786423.73,2564866.48,4351290.21
292540,201910,464,262,202,261476,203592,465068
292550,201910,1060,577,483,577854.52,483042.58,1060897.10
292560,201910,323,305,18,304390,17964,322354
292570,201910,305,237,68,236526,67864,304390
292575,201910,490,320,170,320358.4,170658,491016.4
292580,201910,988,655,333,654688,333332.4,988020.4
292590,201910,555,486,69,485028,68862,553890
292593,201910,140,112,28,111776,27944,139720
292595,201910,194,151,43,150698,43912,194610
292600,201910,1252,919,333,917162.63,332334,1249496.63
292610,201910,133,101,32,100798,31936,132734
292620,201910,535,453,82,453092.4,81836,534928.4
292630,201910,1413,807,606,806384.67,605786.27,1412170.94
292640,201910,808,558,250,557882,250498,808380
292650,201910,183,155,28,155688.4,27944,183632.4
292660,201910,2053,1482,571,1481032,569858.74,2050890.74
292665,201910,149,108,41,107784,40918,148702
292670,201910,400,325,75,324350.99,74850,399200.99
292680,201910,256,195,61,194610,60878,255488
292690,201910,192,146,46,145708,45908,191616
292700,201910,943,634,309,632732,308382,941114
292710,201910,112,99,13,98802,12974,111776
292720,201910,923,528,395,527942,394210,922152
292730,201910,196,93,103,92814,102794,195608
292740,201910,68014,33837,34177,33857183.65,34233439.58,68090623.23
292750,201910,393,279,114,279440.78,113772,393212.78
292760,201910,337,281,56,281436.38,56886,338322.38
292770,201910,801,347,454,346306.4,454090,800396.4
292780,201910,407,159,248,158682,247504,406186
292790,201910,750,381,369,381236,370258,751494
292800,201910,1235,746,489,746504,490018,1236522
292805,201910,397,117,280,116766,280438,397204
292810,201910,1499,855,644,854289.2,642712.98,1497002.18
292820,201910,729,600,129,601794.7,130738.98,732533.68
292830,201910,105,86,19,85828,18962,104790
292840,201910,691,568,123,567862.6,122754,690616.6
292850,201910,139,95,44,94810,43912,138722
292860,201910,2165,1283,882,1283428.4,880236.6,2163665.0
292870,201910,3483,2347,1136,2346301.53,1134726.8,3481028.33
292880,201910,1491,981,510,981034.82,508980,1490014.82
292890,201910,523,446,77,445109.94,76846,521955.94
292895,201910,140,91,49,90818,48902,139720
292900,201910,400,290,110,289420.36,109780,399200.36
292905,201910,475,243,232,242514,231536,474050
292910,201910,449,347,102,347304.3,101796,449100.3
292920,201910,517,234,283,233532,282434,515966
292925,201910,493,455,38,454090,38922,493012
292930,201910,606,366,240,365268,239520,604788
292935,201910,283,122,161,121756,160678.98,282434.98
292937,201910,239,165,74,164670,73852,238522
292940,201910,197,155,42,154690,41916,196606
292950,201910,1130,589,541,587823.9,539918.6,1127742.5
292960,201910,603,424,179,423152,178642,601794
292970,201910,249,180,69,179640,68862,248502
292975,201910,126,72,54,71856,53892.6,125748.6
292980,201910,278,189,89,188622.76,89820,278442.76
292990,201910,1326,990,336,991014.8,336326,1327340.8
293000,201910,109,77,32,76846,31936,108782
293010,201910,2786,1691,1095,1689614.3,1092810.99,2782425.29
293015,201910,667,538,129,536924,128742,665666
293020,201910,337,277,60,276446,59880,336326
293030,201910,599,522,77,520956.8,76846,597802.8
293040,201910,354,283,71,283432,70858,354290
293050,201910,2847,1701,1146,1698596.4,1147701.98,2846298.38
293060,201910,261,213,48,212574.58,47904,260478.58
293070,201910,3417,1778,1639,1779436.09,1642710.98,3422147.07
293075,201910,92,61,31,60878,30938,91816
293076,201910,73,49,24,48902,23952,72854
293077,201910,484,284,200,283432.4,199600,483032.4
293080,201910,442,399,43,398202.74,42914,441116.74
293090,201910,136,120,16,119760,15968,135728
293100,201910,534,374,160,375248,160678,535926
293105,201910,348,246,102,245508,101796,347304
293110,201910,174,124,50,123752,49900,173652
293120,201910,328,222,106,221556.45,105788,327344.45
293130,201910,244,169,75,169660,74850,244510
293135,201910,7945,3169,4776,3164677.54,4773484.01,7938161.55
293140,201910,200,131,69,130738.6,68862,199600.6
293150,201910,329,284,45,283432,44910,328342
293160,201910,422,247,175,246506,174650,421156
293170,201910,167,117,50,116766,49900,166666
293180,201910,492,352,140,352294.8,139720,492014.8
293190,201910,1359,950,409,949098.7,408182,1357280.7
293200,201910,543,483,60,482034,59880,541914
293210,201910,391,301,90,300398,89820,390218
293220,201910,2541,1075,1466,1074846,1465064,2539910
293230,201910,1704,636,1068,636724.35,1069856,1706580.35
293240,201910,227,210,17,209580,16966,226546
293245,201910,121,101,20,100798,19960,120758
293250,201910,705,258,447,258482.67,446106,704588.67
293260,201910,299,251,48,250498,47904,298402
293270,201910,1150,549,601,547902.68,599798,1147700.68
293280,201910,264,148,116,147704,115768,263472
293290,201910,3055,2007,1048,2004982,1048899.97,3053881.97
293300,201910,721,520,201,519959.67,202594,722553.67
293305,201910,181,148,33,147704,32934,180638
293310,201910,147,112,35,111776,34930,146706
293315,201910,169,133,36,132734,35928,168662
293317,201910,95,69,26,68862,25948,94810
293320,201910,1031,589,442,588820,441116,1029936
293325,201910,184,70,114,69860,114770,184630
293330,201910,13577,6430,7147,6424128.72,7140695.82,13564824.54
293340,201910,267,193,74,192614,73852,266466
293345,201910,249,201,48,200598,47904,248502
293350,201910,618,356,262,356286.4,262474,618760.4
293360,201910,1549,1108,441,1107780,442114,1549894
310010,201910,135,73,62,72854,61876.4,134730.4
310020,201910,1039,585,454,583830.4,455088.44,1038918.84
310030,201910,329,270,59,270458.2,58882,329340.2
310040,201910,48,33,15,32934,14970,47904
310050,201910,185,119,66,118762,65868,184630
310060,201910,237,170,67,170658,68862,239520
310070,201910,14,8,6,7984,5988,13972
310080,201910,43,24,19,23952,18962,42914
310090,201910,982,521,461,523951.6,460078.8,984030.4
310100,201910,302,232,70,232534,69860,302394
310110,201910,712,395,317,394210,317364.4,711574.4
310120,201910,375,220,155,219560,155688,375248
310130,201910,32,20,12,19960,11976,31936
310140,201910,24,13,11,12974,10978,23952
310150,201910,1234,853,381,853291.14,381236.8,1234527.94
310160,201910,2049,1048,1001,1047900.9,1000994.8,2048895.7
310163,201910,89,52,37,51896,37924,89820
310170,201910,2559,1144,1415,1143708.74,1415165.6,2558874.34
310180,201910,125,49,76,48902.4,75848,124750.4
310190,201910,475,332,143,332334,143712,476046
310200,201910,495,322,173,321356.4,173652,495008.4
310205,201910,51,37,14,36926,13972,50898
310210,201910,283,229,54,228542,54890,283432
310220,201910,58,35,23,35928,22954,58882
310230,201910,268,189,79,188622,78842,267464
310240,201910,104,94,10,93812,9980,103792
310250,201910,105,84,21,83832,20958,104790
310260,201910,766,414,352,413174.04,352294,765468.04
310270,201910,269,181,88,180638.44,87824,268462.44
310280,201910,369,275,94,274450,93812,368262
310285,201910,212,153,59,153692,58882,212574
310290,201910,250,139,111,139720,110778,250498
310300,201910,148,123,25,122754,24950,147704
310310,201910,9,7,2,6986,1996,8982
310320,201910,28,13,15,12974,14970,27944
310330,201910,33,25,8,24950,7984,32934
310340,201910,1755,1169,586,1166663.8,585826.4,1752490.2
310350,201910,2819,1549,1270,1549894,1270454.98,2820348.98
310360,201910,40,33,7,32934,6986,39920
310370,201910,115,97,18,96806,17964.4,114770.4
310375,201910,105,39,66,38922,65868.96,104790.96
310380,201910,49,29,20,28942,19960,48902
310390,201910,92,62,30,61876,29940,91816
310400,201910,2332,1558,774,1555882.8,772452,2328334.8
310410,201910,125,73,52,72854,51896,124750
310420,201910,663,356,307,356286.6,306386.2,662672.8
310430,201910,314,206,108,205588,107784,313372
310440,201910,72,44,28,43912,27944,71856
310445,201910,80,68,12,67864,11976,79840
310450,201910,835,527,308,525946,309380,835326
310460,201910,253,182,71,181636,70858,252494
310470,201910,510,329,181,330338,180638,510976
310480,201910,79,59,20,58882,19960,78842
310490,201910,523,253,270,253492,271456,524948
310500,201910,129,54,75,53892,74850,128742
310510,201910,605,418,187,417164,187624.98,604788.98
310520,201910,132,93,39,92814,38922,131736
310530,201910,98,43,55,43912,54890,98802
310540,201910,457,274,183,275448.6,182634,458082.6
310550,201910,79,52,27,51896,26946,78842
310560,201910,3006,2072,934,2072848.76,935126,3007974.76
310570,201910,107,74,33,73852,32934,106786
310590,201910,362,236,126,235528.5,125748,361276.5
310600,201910,154,86,68,85828.4,67864,153692.4
310610,201910,60,24,36,23952,35928,59880
310620,201910,46511,22641,23870,22651559.93,23876167.58,46527727.51
310630,201910,619,403,216,403192,215568.4,618760.4
310640,201910,145,116,29,115768,28942,144710
310650,201910,163,145,18,144710,17964,162674
310660,201910,94,63,31,62874,30938,93812
310665,201910,59,43,16,42914,15968,58882
310670,201910,6489,2918,3571,2920155.06,3574861.3,6495016.36
310680,201910,58,36,22,35928,22954,58882
310690,201910,591,420,171,419160.1,170658,589818.1
310700,201910,56,38,18,37924,17964,55888
310710,201910,1334,914,420,916165.38,420158.4,1336323.78
310720,201910,107,34,73,33932,72854,106786
310730,201910,1414,1004,410,1002990.9,410178,1413168.9
310740,201910,970,549,421,550896.8,421156.5,972053.3
310750,201910,242,143,99,142714.66,98802,241516.66
310760,201910,62,44,18,43912,17964.4,61876.4
310770,201910,100,48,52,47904,51896,99800
310780,201910,372,304,68,304390.98,68862,373252.98
310790,201910,100,82,18,81836,17964,99800
310800,201910,450,222,228,222554.5,228542,451096.5
310810,201910,169,122,47,121756.9,47904,169660.9
310820,201910,350,277,73,276446,72854,349300
310825,201910,197,166,31,165668,30938,196606
310830,201910,461,226,235,225548.4,234530,460078.4
310840,201910,361,213,148,212574,147704,360278
310850,201910,108,86,22,85828,21956,107784
310855,201910,393,315,78,314370,77844,392214
310860,201910,1580,1184,396,1181635.16,398202.7,1579837.86
310870,201910,55,45,10,44910,9980,54890
310880,201910,86,66,20,65868,19960,85828
310890,201910,295,177,118,176646,117764,294410
310900,201910,655,305,350,304399.96,351311.36,655711.32
310910,201910,239,164,75,163672.6,74850,238522.6
310920,201910,467,278,189,277445.3,190618.2,468063.5
310925,201910,34,27,7,26946,6986.4,33932.4
310930,201910,1079,660,419,659692.85,419169.9,1078862.75
310940,201910,671,347,324,347304,323352,670656
310945,201910,124,77,47,76846,46906,123752
310950,201910,240,195,45,194610,44910,239520
310960,201910,79,28,51,27944,50898.99,78842.99
310970,201910,161,102,59,101796,58882,160678
310980,201910,45,27,18,26946,17964,44910
310990,201910,145,79,66,78842,65868,144710
311000,201910,811,413,398,413173.77,399200.98,812374.75
311010,201910,46,39,7,38922,6986,45908
311020,201910,43,27,16,26946,15968,42914
311030,201910,394,232,162,232534,161676,394210
311040,201910,41,36,5,35928,4990,40918
311050,201910,478,195,283,194610.8,282434,477044.8
311060,201910,776,441,335,440118.4,336326.4,776444.8
311070,201910,344,164,180,163672,179640,343312
311080,201910,108,60,48,59880,47904,107784
311090,201910,338,163,175,162674.49,178642,341316.49
311100,201910,604,364,240,363272,239520,602792
311110,201910,694,488,206,487024.29,206586,693610.29
311115,201910,76,55,21,54890,20958,75848
311120,201910,1069,569,500,570856.4,499998,1070854.4
311130,201910,374,224,150,223552,150698,374250
311140,201910,160,89,71,88822,70858,159680
311150,201910,359,238,121,238522,120758,359280
311160,201910,701,509,192,508980.4,196606,705586.4
311170,201910,84,68,16,67864,15968,83832
311180,201910,337,228,109,227544,109780.4,337324.4
311190,201910,32,16,16,15968,15968,31936
311200,201910,325,230,95,229540,94810,324350
311205,201910,33,23,10,22954,9980,32934
311210,201910,48,41,7,40918.4,6986,47904.4
311220,201910,21,19,2,18962,1996,20958
311230,201910,1641,1084,557,1081833,555886,1637719
311240,201910,177,115,62,114770,61876,176646
311250,201910,94,28,66,27944,65868,93812
311260,201910,560,351,209,350298,208582,558880
311265,201910,119,85,34,84830,33932,118762
311270,201910,290,198,92,198602,92814,291416
311280,201910,213,100,113,99800,112774,212574
311290,201910,106,87,19,86826,18962.4,105788.4
311300,201910,589,371,218,370258,218562,588820
311310,201910,22,17,5,16966,5988,22954
311320,201910,666,496,170,496006,169660,665666
311330,201910,1090,813,277,811374,276446.8,1087820.8
311340,201910,2588,1848,740,1848296.8,742512.98,2590809.78
311350,201910,275,214,61,213572,60878,274450
311360,201910,174,110,64,109780,63872,173652
311370,201910,1193,502,691,501495.5,690616.96,1192112.46
311380,201910,7,6,1,5988,998,6986
311390,201910,262,147,115,146706,114770,261476
311400,201910,156,106,50,105788,49900,155688
311410,201910,101,58,43,57884,43912,101796
311420,201910,304,171,133,170658.6,132734,303392.6
311430,201910,862,576,286,575846.5,285428.4,861274.9
311440,201910,473,336,137,335328,136726,472054
311450,201910,318,202,116,201596,115768,317364
311455,201910,285,195,90,194610,89820,284430
311460,201910,142,61,81,60878,80838,141716
311470,201910,22,13,9,12974,8982,21956
311480,201910,44,20,24,19960,23952,43912
311490,201910,16,10,6,9980,5988,15968
311500,201910,23,10,13,9980,12974,22954
311510,201910,631,446,185,445108,184630,629738
311520,201910,41,33,8,32934,7984,40918
311530,201910,1805,1355,450,1353289.88,449100,1802389.88
311535,201910,69,49,20,48902,19960,68862
311540,201910,35,30,5,29940,4990,34930
311545,201910,186,138,48,138722,48902,187624
311547,201910,36,29,7,28942,6986.96,35928.96
311550,201910,666,320,346,319360,347304.98,666664.98
311560,201910,43,29,14,28942,13972,42914
311570,201910,285,195,90,194610,89820,284430
311580,201910,328,196,132,195608,131736,327344
311590,201910,33,30,3,29940,2994,32934
311600,201910,98,78,20,78842,19960,98802
311610,201910,259,223,36,222555.1,35928,258483.1
311615,201910,118,100,18,99800,17964,117764
311620,201910,24,13,11,12974,10978,23952
311630,201910,84,70,14,69860,13972,83832
311640,201910,131,70,61,69860,60878,130738
311650,201910,131,92,39,91816,38922,130738
311660,201910,404,197,207,196606,210578,407184
311670,201910,162,107,55,106786.58,54890,161676.58
311680,201910,206,153,53,153692,54890,208582
311690,201910,11,8,3,7984,2994,10978
311700,201910,194,138,56,138722,55888,194610
311710,201910,200,129,71,128742,70858,199600
311720,201910,38,28,10,28942.4,9980,38922.4
311730,201910,598,400,198,400198,198602,598800
311740,201910,36,26,10,25948,9980,35928
311750,201910,712,481,231,480038.76,230538,710576.76
311760,201910,61,33,28,32934,27944,60878
311770,201910,390,198,192,197605.34,191616,389221.34
311780,201910,179,100,79,99800.4,78842,178642.4
311783,201910,86,76,10,75848,9980,85828
311787,201910,34,14,20,13972,19960,33932
311790,201910,263,123,140,122754,141716,264470
311800,201910,671,450,221,450098.9,220558,670656.9
311810,201910,49,41,8,40918,7984,48902
311820,201910,114,96,18,95808,17964,113772
311830,201910,1912,1210,702,1212571.9,700596,1913167.9
311840,201910,1004,563,441,561875.5,441116.9,1002992.4
311850,201910,11,6,5,5988,4990,10978
311860,201910,9402,4268,5134,4266454.43,5129726.73,9396181.16
311870,201910,132,70,62,70858,62874,133732
311880,201910,933,684,249,683631.38,248502,932133.38
311890,201910,212,104,108,103710,108782,212492
311900,201910,75,33,42,32934,42914,75848
311910,201910,1418,897,521,897202.7,520956.4,1418159.1
311920,201910,226,151,75,151696,75848,227544
311930,201910,908,529,379,527942.4,379240.5,907182.9
311940,201910,2440,1305,1135,1303388,1134726.86,2438114.86
311950,201910,60,45,15,44910,14970,59880
311960,201910,61,44,17,43912,16966,60878
311970,201910,24,15,9,14970,8982,23952
311980,201910,45,35,10,34930,9980,44910
311990,201910,42,34,8,33932,7984,41916
311995,201910,55,36,19,35928,18962,54890
312000,201910,32,23,9,22954,8982,31936
312010,201910,80,63,17,62874,16966,79840
312015,201910,91,67,24,66866.4,23952,90818.4
312020,201910,129,85,44,84830.4,43912,128742.4
312030,201910,53,41,12,40918,11976,52894
312040,201910,85,53,32,53892.4,31936,85828.4
312050,201910,213,119,94,118762,93812,212574
312060,201910,39,23,16,22954,15968,38922
312070,201910,74,47,27,46906,26946,73852
312080,201910,527,242,285,241516,284430,525946
312083,201910,57,40,17,39920,16966,56886
312087,201910,110,87,23,86826,22954,109780
312090,201910,3145,1892,1253,1891214.68,1251492.4,3142707.08
312100,201910,150,105,45,104560.86,44910,149470.86
312110,201910,112,70,42,69860,42914,112774
312120,201910,142,107,35,108782.97,34930,143712.97
312125,201910,90,48,42,47904,41916,89820
312130,201910,122,85,37,84830,36926,121756
312140,201910,139,110,29,110778.4,29940,140718.4
312150,201910,45,35,10,34930,9980,44910
312160,201910,1558,1033,525,1032023.6,525946.4,1557970.0
312170,201910,11,10,1,9980,998,10978
312180,201910,105,67,38,66866,37924.8,104790.8
312190,201910,34,30,4,29940,3992,33932
312200,201910,755,648,107,646704.4,107784,754488.4
312210,201910,92,59,33,58882,33932,92814
312220,201910,139,103,36,102794.5,35928,138722.5
312230,201910,3590,1752,1838,1750494.32,1836328.06,3586822.38
312235,201910,171,117,54,116766,53892,170658
312240,201910,104,74,30,74850,29940,104790
312245,201910,179,127,52,127744.99,54890,182634.99
312247,201910,67,47,20,46906,19960,66866
312250,201910,176,85,91,84830,91816,176646
312260,201910,115,75,40,74850,39920,114770
312270,201910,132,81,51,80838,50898,131736
312280,201910,27,14,13,13972,12974,26946
312290,201910,154,109,45,108782,44910.6,153692.6
312300,201910,203,133,70,132734,69860,202594
312310,201910,58,53,5,52894,4990,57884
312320,201910,426,273,153,273452,153692.1,427144.1
312330,201910,89,79,10,79840,9980,89820
312340,201910,37,16,21,15968,20958,36926
312350,201910,18,11,7,10978,6986,17964
312352,201910,100,71,29,70858,28942,99800
312360,201910,565,251,314,250498,313372,563870
312370,201910,300,171,129,170658,128742.4,299400.4
312380,201910,142,97,45,96806,44910,141716
312385,201910,168,135,33,134730,32934,167664
312390,201910,305,192,113,191616,113772,305388
312400,201910,374,288,86,287424,85829,373253
312410,201910,923,307,616,307384,615767.37,923151.37
312420,201910,626,487,139,486026.4,138722,624748.4
312430,201910,870,643,227,641715.66,226546,868261.66
312440,201910,41,31,10,31936,9980,41916
312450,201910,204,128,76,128742,75848,204590
312460,201910,33,16,17,15968,16966,32934
312470,201910,50,33,17,32934,16966,49900
312480,201910,195,118,77,117764,76846,194610
312490,201910,269,192,77,191616,76846,268462
312500,201910,34,19,15,18962,14970,33932
312510,201910,512,203,309,202594,309380.96,511974.96
312520,201910,35,10,25,9980,24950,34930
312530,201910,48,33,15,33932,14970,48902
312540,201910,99,87,12,86826,11976,98802
312550,201910,40,31,9,30938,8982,39920
312560,201910,221,169,52,168662.4,51896,220558.4
312570,201910,445,269,176,268462,176646,445108
312580,201910,89,47,42,46906,41916,88822
312590,201910,254,200,54,200598,53892,254490
312595,201910,138,125,13,124750,12974,137724
312600,201910,69,42,27,41916.1,26946,68862.1
312610,201910,1569,824,745,825347.6,745506.4,1570854.0
312620,201910,201,146,55,145708,54890,200598
312630,201910,68,57,11,56886,10978,67864
312640,201910,44,13,31,12974,30938,43912
312650,201910,153,130,23,129740.4,22954,152694.4
312660,201910,83,62,21,61876.7,20958,82834.7
312670,201910,900,599,301,597802,300398,898200
312675,201910,34,26,8,25948,7984,33932
312680,201910,79,52,27,51896,27944,79840
312690,201910,242,129,113,128742,112774,241516
312695,201910,37,31,6,30938,5988,36926
312700,201910,218,129,89,128742,89820,218562
312705,201910,84,69,15,68862,14970,83832
312707,201910,127,91,36,90818,35928,126746
312710,201910,1870,1014,856,1013968.96,857282,1871250.96
312720,201910,66,33,33,32934,32934,65868
312730,201910,271,159,112,158682,111776,270458
312733,201910,52,45,7,44910,6986,51896
312735,201910,23,15,8,14970,7984,22954
312737,201910,70,37,33,36926,32934,69860
312738,201910,54,40,14,39920,13972,53892
312740,201910,78,52,26,51896.87,25948,77844.87
312750,201910,71,52,19,51896,18962,70858
312760,201910,279,203,76,202594,75848,278442
312770,201910,7590,3557,4033,3555883.82,4035914.94,7591798.76
312780,201910,417,321,96,320358,95808,416166
312790,201910,21,17,4,16966,3992,20958
312800,201910,1597,1110,487,1109776.9,488022.46,1597799.36
312810,201910,365,235,130,234530,130738,365268
312820,201910,186,141,45,141716,46906,188622
312825,201910,26,18,8,17964,7984,25948
312830,201910,241,139,102,138722.46,101796,240518.46
312840,201910,155,111,44,110778,43912,154690
312850,201910,45,41,4,40918,3992,44910
312860,201910,155,101,54,100798,54890,155688
312870,201910,1039,548,491,546904.9,490018,1036922.9
312880,201910,138,95,43,94810,42914,137724
312890,201910,163,114,49,113772,48902,162674
312900,201910,201,151,50,150698,49900,200598
312910,201910,182,96,86,95808,86826,182634
312920,201910,156,89,67,88822,66866,155688
312930,201910,321,230,91,230538,90818,321356
312940,201910,111,81,30,80838,29940,110778
312950,201910,692,469,223,469060,223552,692612
312960,201910,173,131,42,130738.96,41916,172654.96
312965,201910,68,58,10,57884,9980,67864
312970,201910,280,227,53,228542.5,52894,281436.5
312980,201910,2403,1260,1143,1259477.78,1142710,2402187.78
312990,201910,43,23,20,22954,19960,42914
313000,201910,47,28,19,27944,18962,46906
313005,201910,169,133,36,132734,35928.4,168662.4
313010,201910,914,375,539,375248,538920.98,914168.98
313020,201910,190,102,88,101796,87824,189620
313030,201910,201,133,68,132734.54,67864,200598.54
313040,201910,72,25,47,24950,46906,71856
313050,201910,189,137,52,136726,51896,188622
313055,201910,41,32,9,31936,8982,40918
313060,201910,127,91,36,90818,36926,127744
313065,201910,57,40,17,39920,16966,56886
313070,201910,136,73,63,73852,62874,136726
313080,201910,41,18,23,17964,22954,40918
313090,201910,704,481,223,482034.4,222554,704588.4
313100,201910,169,65,104,64870,104790,169660
313110,201910,136,74,62,73852,61876,135728
313115,201910,185,103,82,102794,81836,184630
313120,201910,787,451,336,450098.4,335328.4,785426.8
313130,201910,5506,3047,2459,3043906.18,2463065.9,5506972.08
313140,201910,144,76,68,75848,67864,143712
313150,201910,307,247,60,246506,60878,307384
313160,201910,187,141,46,140718.4,45908,186626.4
313170,201910,1378,955,423,955087.6,425148.98,1380236.58
313180,201910,299,180,119,179640,119760,299400
313190,201910,754,460,294,460078,293412.2,753490.2
313200,201910,28,25,3,24950,2994,27944
313210,201910,1004,857,147,857283.62,147704,1004987.62
313220,201910,261,170,91,169660,90818.4,260478.4
313230,201910,270,204,66,203592.65,65868,269460.65
313240,201910,2103,1121,982,1119760.29,981034,2100794.29
313250,201910,1270,962,308,962073.4,307385.12,1269458.52
313260,201910,89,50,39,49900,38922,88822
313270,201910,953,571,382,570856.3,384230.8,955087.1
313280,201910,55,46,9,45908,8982,54890
313290,201910,224,181,43,180638.4,42914,223552.4
313300,201910,351,186,165,185628.6,164670,350298.6
313310,201910,240,124,116,123752,116766,240518
313320,201910,365,279,86,278442.6,85828,364270.6
313330,201910,1388,872,516,871254,514968,1386222
313340,201910,329,230,99,230538,98802,329340
313350,201910,500,336,164,336326,163672,499998
313360,201910,124,71,53,70858,52894.4,123752.4
313370,201910,192,71,121,70858,120758,191616
313375,201910,277,167,110,166666,109780,276446
313380,201910,1324,711,613,710576.2,612772.99,1323349.19
313390,201910,56,49,7,48902.6,6986,55888.6
313400,201910,412,281,131,281436.66,130738.8,412175.46
313410,201910,22,13,9,12974,8982,21956
313420,201910,4618,2490,2128,2491009.4,2130730.7,4621740.1
313430,201910,141,71,70,70858,69860,140718
313440,201910,1431,989,442,989019.74,443113.6,1432133.34
313450,201910,62,26,36,25948,35928,61876
313460,201910,375,175,200,174650.4,200598,375248.4
313470,201910,526,249,277,248502.8,276446,524948.8
313480,201910,148,107,41,106786.4,40918,147704.4
313490,201910,506,239,267,239520.4,269460.9,508981.3
313500,201910,22,13,9,12974,8982,21956
313505,201910,1011,806,205,805386,205588,1010974
313507,201910,97,59,38,58882,37924,96806
313510,201910,2747,1773,974,1769455,976044,2745499
313520,201910,3499,2750,749,2749494.45,750497.96,3499992.41
313530,201910,38,27,11,26946,11976,38922
313535,201910,51,43,8,43912,7984,51896
313540,201910,72,54,18,53892,17964,71856
313545,201910,114,95,19,94810,18962,113772
313550,201910,235,200,35,199600,34930.4,234530.4
313560,201910,330,168,162,167664,161676,329340
313570,201910,58,28,30,27944,29940,57884
313580,201910,1309,745,564,744508,570857.2,1315365.2
313590,201910,73,42,31,41916,30938,72854
313600,201910,684,420,264,419160,263472.4,682632.4
313610,201910,60,49,11,48902.4,10978,59880.4
313620,201910,1379,724,655,724548.8,653690,1378238.8
313630,201910,1610,1252,358,1251492.8,358282,1609774.8
313640,201910,125,77,48,76846,47904,124750
313650,201910,238,114,124,113772,123752.4,237524.4
313652,201910,17,17,0,16966,0,16966
313655,201910,64,41,23,40918,22954,63872
313657,201910,47,44,3,43912,2994,46906
313660,201910,130,93,37,92814,36943.96,129757.96
313665,201910,657,324,333,323352.3,332334,655686.3
313670,201910,10348,7169,3179,7164648.93,3179629.6,10344278.53
313680,201910,42,31,11,30938,10978.78,41916.78
313690,201910,150,113,37,112774,37924,150698
313695,201910,73,57,16,56886,15968,72854
313700,201910,308,248,60,248502,59880,308382
313710,201910,143,99,44,98802,43912,142714
313720,201910,1102,535,567,533930.4,566865.4,1100795.8
313730,201910,64,43,21,42914,20958,63872
313740,201910,153,125,28,124750,27944,152694
313750,201910,423,311,112,310378,111776,422154
313753,201910,233,174,59,174650,58882,233532
313760,201910,1253,467,786,467064.4,786426.1,1253490.5
313770,201910,362,269,93,270458.5,92814,363272.5
313780,201910,756,398,358,397204,357284,754488
313790,201910,28,27,1,26946,998,27944
313800,201910,140,88,52,87824,51896,139720
313810,201910,73,41,32,40918,31936,72854
313820,201910,1305,647,658,647702.8,661675.75,1309378.55
313830,201910,64,47,17,46906,16966,63872
313835,201910,60,50,10,49900,9980,59880
313840,201910,1647,1016,631,1015965.8,630736.8,1646702.6
313850,201910,199,72,127,71856,126746,198602
313860,201910,470,361,109,361276.4,108782,470058.4
313862,201910,175,118,57,117764,56886,174650
313865,201910,103,81,22,80838,21956,102794
313867,201910,48,38,10,37924,9980,47904
313868,201910,30,19,11,18962,10978,29940
313870,201910,119,63,56,62874,55888,118762
313880,201910,368,236,132,235528,131736,367264
313890,201910,331,178,153,178642.6,152694,331336.6
313900,201910,900,495,405,494010.5,404190.9,898201.4
313910,201910,140,101,39,100798,38922,139720
313920,201910,627,447,180,447104,179640.9,626744.9
313925,201910,32,29,3,28942,2994,31936
313930,201910,843,661,182,660676,182634.95,843310.95
313940,201910,1809,1149,660,1149696,663670,1813366
313950,201910,932,597,335,595806.8,334330,930136.8
313960,201910,1358,788,570,787422.76,569859.8,1357282.56
313970,201910,132,92,40,91816,40918,132734
313980,201910,217,142,75,141716.5,74850,216566.5
313990,201910,226,155,71,154690,70858,225548
314000,201910,910,618,292,616765.14,292414,909179.14
314010,201910,80,52,28,51896,27944,79840
314015,201910,54,17,37,16966,36926,53892
314020,201910,54,37,17,36926,16966,53892
314030,201910,77,38,39,37924,38922,76846
314040,201910,44,27,17,26946,16966,43912
314050,201910,286,174,112,173652,112774,286426
314053,201910,95,63,32,62874.4,31936,94810.4
314055,201910,301,186,115,185628,114770.4,300398.4
314060,201910,143,123,20,122754,19960,142714
314070,201910,1051,569,482,567862,483032,1050894
314080,201910,213,138,75,137724,74850.36,212574.36
314085,201910,138,94,44,93812,43912,137724
314090,201910,364,263,101,262474.9,100798,363272.9
314100,201910,478,394,84,393228.62,83839.68,477068.30
314110,201910,734,396,338,395208.4,337324,732532.4
314120,201910,89,52,37,51896,36926,88822
314130,201910,22,12,10,11976,9980,21956
314140,201910,1108,690,418,689618.6,417164,1106782.6
314150,201910,167,104,63,103792,62874,166666
314160,201910,340,259,81,258482.6,80838.6,339321.2
314170,201910,77,61,16,61876,15968,77844
314180,201910,734,650,84,648700.4,83832.5,732532.9
314190,201910,99,61,38,60878,37924,98802
314200,201910,477,328,149,327344.4,148702,476046.4
314210,201910,256,198,58,197604,57884.4,255488.4
314220,201910,310,230,80,230538.4,79840,310378.4
314225,201910,65,47,18,46906,17964,64870
314230,201910,119,55,64,54890,63872,118762
314240,201910,139,106,33,105788,32934,138722
314250,201910,50,29,21,28942,20958,49900
314260,201910,218,107,111,106786,110778,217564
314270,201910,343,269,74,268462,73852,342314
314280,201910,697,394,303,393212.98,303392,696604.98
314290,201910,536,443,93,443112.96,93812,536924.96
314300,201910,368,268,100,268464.5,99800.9,368265.4
314310,201910,1387,942,445,941364.53,444110,1385474.53
314315,201910,33,27,6,26946,5988,32934
314320,201910,597,399,198,399200.4,199600,598800.4
314330,201910,10792,5424,5368,5421139.91,5360261.53,10781401.44
314340,201910,592,275,317,274450,316366.8,590816.8
314345,201910,42,30,12,29940,11976,41916
314350,201910,183,117,66,116766,65868,182634
314360,201910,69,41,28,40918,27944,68862
314370,201910,62,47,15,46906,14970,61876
314380,201910,92,60,32,59880,31936,91816
314390,201910,3298,2135,1163,2132728.16,1164666.6,3297394.76
314400,201910,683,496,187,497005.5,186626,683631.5
314410,201910,462,305,157,305388,156686,462074
314420,201910,18,9,9,8982,8982,17964
314430,201910,2436,908,1528,908181.81,1529934,2438115.81
314435,201910,257,153,104,152694,103792,256486
314437,201910,29,24,5,23952,4990,28942
314440,201910,95,71,24,71856,23952,95808
314450,201910,156,113,43,113772,43912,157684
314460,201910,644,304,340,303392,342314,645706
314465,201910,84,57,27,57884,26946,84830
314467,201910,70,58,12,57884,11976,69860
314470,201910,401,207,194,206587.78,193612,400199.78
314480,201910,1070,526,544,526944,542912,1069856
314490,201910,78,56,22,55888,21956,77844
314500,201910,295,198,97,198602,96806,295408
314505,201910,124,81,43,80838,42914,123752
314510,201910,233,193,40,192614,39920,232534
314520,201910,1265,682,583,683637.37,582833.2,1266470.57
314530,201910,751,604,147,602793.66,146706,749499.66
314535,201910,212,133,79,133732,78842,212574
314537,201910,64,38,26,37924,25948,63872
314540,201910,15,10,5,9980,4990,14970
314545,201910,52,34,18,33932,17964,51896
314550,201910,80,42,38,41916,37924,79840
314560,201910,833,459,374,458082.8,373252,831334.8
314570,201910,21,17,4,16966,3992,20958
314580,201910,12,5,7,4990,6986,11976
314585,201910,24,18,6,18962,5988,24950
314587,201910,81,71,10,70858,9980,80838
314590,201910,567,414,153,416167.7,152694,568861.7
314600,201910,932,609,323,608781.2,322355.03,931136.23
314610,201910,948,511,437,509979.3,439120,949099.3
314620,201910,143,106,37,105788,36926,142714
314625,201910,94,70,24,69860,24950,94810
314630,201910,1194,626,568,628740,567862,1196602
314640,201910,82,55,27,54890,26946.4,81836.4
314650,201910,179,102,77,102794,77844,180638
314655,201910,62,46,16,45908,15968,61876
314660,201910,18,15,3,14970,2994,17964
314670,201910,201,155,46,154690.4,45908,200598.4
314675,201910,212,127,85,126746,84830,211576
314690,201910,573,317,256,317364,256486,573850
314700,201910,2315,1263,1052,1261473.6,1050894,2312367.6
314710,201910,1650,976,674,977043.34,672652.4,1649695.74
314720,201910,388,233,155,232534,155688,388222
314730,201910,505,268,237,268462.8,236526.98,504989.78
314740,201910,701,347,354,346306,354290,700596
314750,201910,21,19,2,18962,1996,20958
314760,201910,338,162,176,161676,175648,337324
314770,201910,104,76,28,75848,27944,103792
314780,201910,21,6,15,5988,14970,20958
314790,201910,2336,1486,850,1486025.34,851294,2337319.34
314795,201910,51,42,9,41916.5,8982,50898.5
314800,201910,2869,1700,1169,1698598.21,1170654,2869252.21
314810,201910,1522,875,647,874248,647702.6,1521950.6
314820,201910,102,58,44,57884,43912,101796
314830,201910,214,175,39,174650,38922,213572
314840,201910,86,51,35,50898,34930,85828
314850,201910,343,170,173,169660,172654,342314
314860,201910,692,524,168,523951.13,168662,692613.13
314870,201910,1490,799,691,798400.4,691614,1490014.4
314875,201910,59,51,8,50898,7984,58882
314880,201910,45,31,14,30938,13972,44910
314890,201910,53,33,20,32934,19960,52894
314900,201910,31,24,7,23952,6986,30938
314910,201910,245,166,79,165668,78842,244510
314915,201910,148,132,16,131736,16966,148702
314920,201910,108,66,42,65868,41916,107784
314930,201910,1057,538,519,537922.64,519958,1057880.64
314940,201910,48,38,10,37924,9980,47904
314950,201910,34,24,10,23952,9980,33932
314960,201910,45,35,10,34930,9980,44910
314970,201910,142,73,69,72854,68862,141716
314980,201910,303,194,109,194610,108782,303392
314990,201910,464,258,206,257484,206586,464070
314995,201910,200,61,139,60878,139720,200598
315000,201910,87,69,18,69860,17964,87824
315010,201910,45,29,16,28942,15968,44910
315015,201910,167,135,32,134730,31936,166666
315020,201910,66,56,10,55888,9980,65868
315030,201910,113,88,25,87824,24950,112774
315040,201910,71,50,21,49900,20958,70858
315050,201910,184,113,71,112774,71856,184630
315053,201910,40,34,6,33932,5988,39920
315057,201910,97,77,20,76846.4,19960,96806.4
315060,201910,71,61,10,60878.52,9980,70858.52
315070,201910,106,60,46,59880,45908,105788
315080,201910,373,303,70,302394,69860,372254
315090,201910,105,62,43,61876,42914,104790
315100,201910,81,40,41,39920,40918,80838
315110,201910,272,148,124,147704,123752,271456
315120,201910,1673,841,832,840316,830336.68,1670652.68
315130,201910,345,250,95,250498,94810,345308
315140,201910,515,303,212,302394.4,211576.8,513971.2
315150,201910,959,462,497,461076,496006.4,957082.4
315160,201910,216,109,107,108782,106786,215568
315170,201910,319,209,110,209580.4,109780,319360.4
315180,201910,3306,1402,1904,1402192.4,1901193.1,3303385.5
315190,201910,324,193,131,192614.2,130738,323352.2
315200,201910,1237,729,508,729538,506984,1236522
315210,201910,1619,939,680,938120.6,682632.2,1620752.8
315213,201910,40,23,17,22954,16966,39920
315217,201910,211,169,42,168662,41916,210578
315220,201910,1561,1204,357,1202592.54,357284,1559876.54
315230,201910,173,127,46,126746.4,45908,172654.4
315240,201910,427,277,150,276446,150698.98,427144.98
315250,201910,2534,1275,1259,1275444,1260474.8,2535918.8
315260,201910,137,84,53,83832,53892,137724
315270,201910,130,90,40,89820,39920,129740
315280,201910,661,433,228,432134.2,227544,659678.2
315290,201910,196,120,76,119760,75848,195608
315300,201910,71,54,17,53892,18962,72854
315310,201910,71,64,7,63872,6986,70858
315320,201910,167,97,70,96806,69860,166666
315330,201910,57,48,9,47904,8982,56886
315340,201910,385,282,103,283432,102794,386226
315350,201910,152,93,59,92814,58882,151696
315360,201910,91,49,42,48902,41916,90818
315370,201910,56,34,22,33932,21956,55888
315380,201910,11,8,3,7984,2994,10978
315390,201910,67,17,50,16966,49900.4,66866.4
315400,201910,855,644,211,642713.1,210578,853291.1
315410,201910,342,208,134,209580.4,134731.4,344311.8
315415,201910,61,46,15,45908,14970,60878
315420,201910,201,152,49,151696.4,48902,200598.4
315430,201910,656,386,270,385228.4,269460.6,654689.0
315440,201910,93,66,27,65868,26946,92814
315445,201910,237,195,42,194610,41916,236526
315450,201910,182,138,44,138722,43912,182634
315460,201910,3780,1939,1841,1936120.98,1839314.98,3775435.96
315470,201910,40,16,24,16966,23952,40918
315480,201910,63,23,40,22954,39920,62874
315490,201910,644,403,241,402194,240518,642712
315500,201910,22,15,7,14970,6986,21956
315510,201910,151,101,50,100798,49900,150698
315520,201910,69,62,7,61876,6986,68862
315530,201910,49,26,23,25948,22954,48902
315540,201910,237,160,77,159680,76846,236526
315550,201910,178,144,34,143712,33932,177644
315560,201910,734,593,141,591814.4,140718,732532.4
315570,201910,306,161,145,160679.59,145708.6,306388.19
315580,201910,702,468,234,467064,233532,700596
315590,201910,202,107,95,106786,94810,201596
315600,201910,303,227,76,226546,76846,303392
315610,201910,96,51,45,50898,44910,95808
315620,201910,35,27,8,26946,7984,34930
315630,201910,132,87,45,87824,44910,132734
315640,201910,66,42,24,41916,23952,65868
315645,201910,50,35,15,34930,14970,49900
315650,201910,169,124,45,123752.8,44910,168662.8
315660,201910,458,205,253,204590,252494,457084
315670,201910,2383,1194,1189,1193609.6,1190615.96,2384225.56
315680,201910,849,587,262,585826,261476,847302
315690,201910,681,473,208,473053.33,208582,681635.33
315700,201910,1884,1007,877,1005985.27,876244,1882229.27
315710,201910,338,99,239,98802,240518,339320
315720,201910,442,281,161,280438.4,161676,442114.4
315725,201910,198,158,40,158682.4,39920,198602.4
315727,201910,42,22,20,21956,19960,41916
315730,201910,49,47,2,46906,1996,48902
315733,201910,86,60,26,59880,25948,85828
315737,201910,50,38,12,37924,11976,49900
315740,201910,35,28,7,27944,6986,34930
315750,201910,159,120,39,119760,38922,158682
315760,201910,44,34,10,33932,9980,43912
315765,201910,122,76,46,75848,45908,121756
315770,201910,226,140,86,139720,85828.4,225548.4
315780,201910,3382,1765,1617,1764465,1617759.15,3382224.15
315790,201910,220,174,46,173652,45908,219560
315800,201910,284,204,80,203592,79840,283432
315810,201910,98,59,39,58882,38922.4,97804.4
315820,201910,749,547,202,545907.2,201596,747503.2
315830,201910,129,78,51,77844,51896,129740
315840,201910,87,59,28,58882,27944,86826
315850,201910,255,187,68,188622.5,67864,256486.5
315860,201910,14,5,9,4990,8982,13972
315870,201910,37,29,8,28942,7984,36926
315880,201910,104,67,37,66866,36926,103792
315890,201910,90,68,22,67864,21956,89820
315895,201910,436,296,140,296406.5,139720.8,436127.3
315900,201910,68,34,34,33932,33932,67864
315910,201910,37,24,13,23952,12974,36926
315920,201910,168,108,60,107784,59880.3,167664.3
315930,201910,46,18,28,17964,27944,45908
315935,201910,139,107,32,106786.37,31936.98,138723.35
315940,201910,99,73,26,72854,25948,98802
315950,201910,43,32,11,31936,10978,42914
315960,201910,538,258,280,257484.4,279440.4,536924.8
315970,201910,34,27,7,26946,6986,33932
315980,201910,680,338,342,337324.1,341316,678640.1
315990,201910,249,148,101,147704,100799.38,248503.38
316000,201910,53,35,18,35928,17964,53892
316010,201910,79,70,9,69860,8982,78842
316020,201910,117,100,17,99800,16966,116766
316030,201910,398,219,179,218562.65,178642.9,397205.55
316040,201910,513,223,290,223552.4,290418.4,513970.8
316045,201910,62,55,7,54890,6986,61876
316050,201910,15,13,2,12974,1996,14970
316060,201910,99,65,34,64870,33932,98802
316070,201910,1093,711,382,710576.1,382234,1092810.1
316080,201910,105,70,35,69860,34930,104790
316090,201910,38,21,17,20958,16966,37924
316095,201910,73,64,9,63872,8982,72854
316100,201910,311,181,130,180638.5,129740,310378.5
316105,201910,41,28,13,27944,12974,40918
316110,201910,1865,1500,365,1499994.55,364270,1864264.55
316120,201910,78,58,20,58882,19960,78842
316130,201910,121,93,28,93812.4,27944,121756.4
316140,201910,31,22,9,22954,8982,31936
316150,201910,205,141,64,140718,63872,204590
316160,201910,77,46,31,45908,30938,76846
316165,201910,66,52,14,51896.6,13972.6,65869.2
316170,201910,189,126,63,126746,62874,189620
316180,201910,195,86,109,85828,108782.4,194610.4
316190,201910,135,99,36,98802,35928,134730
316200,201910,663,377,286,376246,287424,663670
316210,201910,764,514,250,514209.65,250498,764707.65
316220,201910,115,76,39,75848,38922,114770
316225,201910,25,15,10,14970,9980,24950
316230,201910,34,19,15,18962,14970,33932
316240,201910,645,520,125,518960,124750,643710
316245,201910,128,109,19,108782,18962,127744
316250,201910,1541,1067,474,1065865.66,476046.98,1541912.64
316255,201910,119,96,23,95808,22954,118762
316257,201910,176,95,81,94810,80838,175648
316260,201910,187,132,55,132734.5,54890.38,187624.88
316265,201910,27,19,8,18962,7984,26946
316270,201910,686,484,202,484030.6,201596.84,685627.44
316280,201910,543,341,202,340318.81,203593.4,543912.21
316290,201910,729,486,243,485028.66,243512,728540.66
316292,201910,502,206,296,205588,296406,501994
316294,201910,101,61,40,60878,40918,101796
316295,201910,303,135,168,134731.36,168662,303393.36
316300,201910,99,73,26,72854.4,25948,98802.4
316310,201910,36,19,17,18962,16966,35928
316320,201910,47,27,20,26946,19960,46906
316330,201910,133,89,44,88822.5,43912,132734.5
316340,201910,140,98,42,97804,42914,140718
316350,201910,193,135,58,136726.3,57884,194610.3
316360,201910,23,14,9,13972,8982,22954
316370,201910,1083,572,511,571854.9,509978,1081832.9
316380,201910,116,89,27,88822,26946,115768
316390,201910,113,83,30,82834,29940,112774
316400,201910,133,103,30,102794,29940,132734
316410,201910,301,216,85,215568,84830,300398
316420,201910,207,145,62,145708,61876,207584
316430,201910,151,80,71,79840,70858,150698
316440,201910,93,47,46,46906,45908,92814
316443,201910,39,37,2,36926,1996,38922
316447,201910,64,50,14,49900,13972,63872
316450,201910,225,172,53,171656,53892,225548
316460,201910,72,27,45,26946,44910,71856
316470,201910,1644,1218,426,1217554.17,426146,1643700.17
316480,201910,11,9,2,8982,1996,10978
316490,201910,18,7,11,6986,10978,17964
316500,201910,151,102,49,101796,49900,151696
316510,201910,156,122,34,121756,33932,155688
316520,201910,196,124,72,123752,71856,195608
316530,201910,156,109,47,109780,46906,156686
316540,201910,139,76,63,75848,62874,138722
316550,201910,135,91,44,91816,43912,135728
316553,201910,286,135,151,134730,151696.72,286426.72
316555,201910,37,32,5,31936,4990,36926
316556,201910,11,8,3,7984,2994,10978
316557,201910,20,17,3,16966,2994,19960
316560,201910,69,51,18,50898,17964,68862
316570,201910,232,211,21,210578,20958,231536
316580,201910,18,15,3,14970,2994,17964
316590,201910,103,87,16,88822,15968,104790
316600,201910,176,146,30,145708,29940,175648
316610,201910,68,51,17,50898,16966,67864
316620,201910,142,110,32,109780,31936,141716
316630,201910,42,33,9,32934,8982,41916
316640,201910,21,14,7,13972,6986,20958
316650,201910,78,61,17,60878,16966,77844
316660,201910,8,3,5,2994,4990,7984
316670,201910,438,153,285,152694.96,284430,437124.96
316680,201910,157,109,48,108782,47904.6,156686.6
316690,201910,189,122,67,122754,66866,189620
316695,201910,64,56,8,55888,7984,63872
316700,201910,16,10,6,9980,5988,15968
316710,201910,766,574,192,572852.5,191616,764468.5
316720,201910,4889,2474,2415,2478038.25,2413165.79,4891204.04
316730,201910,17,16,1,15968,998,16966
316740,201910,118,76,42,75848,41916,117764
316750,201910,19,12,7,11976,6986,18962
316760,201910,315,256,59,255488,58882,314370
316770,201910,144,81,63,80838,62874,143712
316780,201910,72,46,26,45908,26946,72854
316790,201910,54,40,14,39920,13972,53892
316800,201910,1734,1084,650,1085824,650697,1736521
316805,201910,19,11,8,10978,7984,18962
316810,201910,69,46,23,45908,22954,68862
316820,201910,41,20,21,19960,20958,40918
316830,201910,92,45,47,44910,46906,91816
316840,201910,513,309,204,310378.4,204590,514968.4
316850,201910,337,225,112,224550,112774,337324
316860,201910,5924,2677,3247,2676373.72,3248490.3,5924864.02
316870,201910,1499,995,504,994010.7,504989.2,1498999.9
316880,201910,127,65,62,64870,61876,126746
316890,201910,240,165,75,164670,75848,240518
316900,201910,430,301,129,300398.36,129740,430138.36
316905,201910,21,10,11,9980,10978,20958
316910,201910,60,25,35,24950,34930,59880
316920,201910,135,107,28,106786,27944,134730
316930,201910,1864,975,889,974048.8,888220.3,1862269.1
316935,201910,902,553,349,551894.64,349300.4,901195.04
316940,201910,1090,633,457,631734.8,457084.4,1088819.2
316950,201910,177,90,87,89820.4,86826,176646.4
316960,201910,1100,624,476,624748.4,478042.4,1102790.8
316970,201910,661,523,138,521954.8,137724,659678.8
316980,201910,112,65,47,64870,46906,111776
316990,201910,2190,1480,710,1479036.34,708581.5,2187617.84
317000,201910,321,248,73,247504,72854,320358
317005,201910,236,171,65,170658,64870,235528
317010,201910,6350,3560,2790,3561866.75,2787414.4,6349281.15
317020,201910,16143,7225,8918,7233517.8,8919142.7,16152660.5
317030,201910,81,31,50,30938,49900,80838
317040,201910,3088,1943,1145,1943108.2,1146702.6,3089810.8
317043,201910,75,55,20,54890,19960,74850
317047,201910,29,16,13,15968,12974.99,28942.99
317050,201910,175,134,41,133732,40918,174650
317052,201910,130,99,31,98802,30938,129740
317057,201910,180,140,40,139720,39920,179640
317060,201910,62,42,20,41916,19960,61876
317065,201910,56,45,11,44910,10978,55888
317070,201910,1962,931,1031,933131.5,1035924.8,1969056.3
317075,201910,107,60,47,59880,46906,106786
317080,201910,884,464,420,465068.9,420159,885227.9
317090,201910,648,523,125,521954,124750,646704
317100,201910,425,325,100,325348,99800,425148
317103,201910,105,89,16,88822,16966,105788
317107,201910,43,38,5,37924,4990,42914
317110,201910,109,47,62,46906,61876,108782
317115,201910,46,41,5,40918,4990,45908
317120,201910,1857,955,902,953090.8,902192.4,1855283.2
317130,201910,1975,1320,655,1320356,656684,1977040
317140,201910,12,10,2,9980,1996,11976
317150,201910,263,160,103,159680.4,103792,263472.4
317160,201910,319,237,82,236527.03,81836,318363.03
317170,201910,214,151,63,150698,63872,214570
317180,201910,442,319,123,318362,122754,441116
317190,201910,261,181,80,180638,79840,260478
317200,201910,810,573,237,571857.76,236526,808383.76
317210,201910,183,101,82,100798,81836,182634
317220,201910,24,13,11,12974,10978,23952
320010,201910,601,446,155,446106.5,154690,600796.5
320013,201910,124,91,33,91816,32934,124750
320016,201910,271,171,100,171656,99800,271456
320020,201910,706,421,285,421156.8,284430,705586.8
320030,201910,143,104,39,103792,38922.5,142714.5
320035,201910,142,109,33,109780,32934,142714
320040,201910,492,259,233,258482,233532,492014
320050,201910,105,79,26,78842,25948,104790
320060,201910,1615,791,824,789421.56,824351.74,1613773.30
320070,201910,103,72,31,71856,30938,102794
320080,201910,795,466,329,466066.9,328342,794408.9
320090,201910,1236,860,376,860276,375248,1235524
320100,201910,325,187,138,186626,137724,324350
320110,201910,120,77,43,76847.1,42914.4,119761.5
320115,201910,107,89,18,88822,17964,106786
320120,201910,3379,1882,1497,1881231.86,1499995.77,3381227.63
320130,201910,7395,3468,3927,3468069.47,3931155.11,7399224.58
320140,201910,432,288,144,287424.6,143712.08,431136.68
320150,201910,2029,1176,853,1175646.55,852292,2027938.55
320160,201910,656,298,358,298402.99,358283.79,656686.78
320170,201910,109,86,23,86826,22954,109780
320180,201910,53,31,22,30938,21956,52894
320190,201910,245,163,82,162674,81836.4,244510.4
320200,201910,55,45,10,44910,9980,54890
320210,201910,892,503,389,501994.8,389221.76,891216.56
320220,201910,303,113,190,112774.98,189620,302394.98
320225,201910,89,72,17,71856,16966,88822
320230,201910,598,389,209,388222.6,208582,596804.6
320240,201910,3160,1600,1560,1598797.6,1560873.38,3159670.98
320245,201910,459,320,139,320358.4,139720,460078.4
320250,201910,230,120,110,119760,109780,229540
320255,201910,140,111,29,110778,28942.7,139720.7
320260,201910,194,141,53,140718,52894,193612
320265,201910,164,132,32,131736,32934,164670
320270,201910,153,124,29,123752,29940,153692
320280,201910,992,592,400,592813.13,399200,992013.13
320290,201910,60,52,8,52894,7984,60878
320300,201910,570,396,174,395209.34,173654.04,568863.38
320305,201910,671,366,305,366266,305389,671655
320310,201910,217,123,94,122754.76,93812,216566.76
320313,201910,322,165,157,164670.9,157684.4,322355.3
320316,201910,112,89,23,89820,22954,112774
320320,201910,3427,1599,1828,1597799.44,1826341.39,3424140.83
320330,201910,254,193,61,192614,61876,254490
320332,201910,856,519,337,519960.5,337324.9,857285.4
320334,201910,247,155,92,154690.4,91816,246506.4
320335,201910,145,103,42,103792,41916,145708
320340,201910,556,387,169,386226.9,169660,555886.9
320350,201910,979,420,559,419161.29,557883.2,977044.49
320360,201910,169,92,77,91816,76846,168662
320370,201910,244,187,57,187624.56,56886.4,244510.96
320380,201910,281,199,82,198602.64,83832,282434.64
320390,201910,1160,707,453,706584.92,453092.8,1159677.72
320400,201910,307,228,79,227545.4,78842,306387.4
320405,201910,940,406,534,406187.89,533932.39,940120.28
320410,201910,969,501,468,499998,467065,967063
320420,201910,475,243,232,243513.3,233532,477045.3
320425,201910,188,104,84,103792,84830,188622
320430,201910,388,223,165,223552.75,164670,388222.75
320435,201910,159,108,51,108782,50898,159680
320440,201910,198,118,80,117764,79840,197604
320450,201910,126,73,53,73852,52894,126746
320455,201910,244,201,43,200598.4,42914,243512.4
320460,201910,267,166,101,165668,100798,266466
320465,201910,117,80,37,79840,36926,116766
320470,201910,684,438,246,439121.99,245508.99,684630.98
320480,201910,187,120,67,119760,66866,186626
320490,201910,3065,1536,1529,1535926.69,1528944.4,3064871.09
320495,201910,102,63,39,62874,38922.8,101796.8
320500,201910,9703,4887,4816,4892210.65,4826341.19,9718551.84
320501,201910,542,275,267,274450,266466,540916
320503,201910,288,206,82,205588,81836,287424
320506,201910,266,191,75,191616,74850,266466
320510,201910,997,470,527,471056,527942.98,998998.98
320515,201910,84,69,15,68862,14970,83832
320517,201910,213,155,58,154690,57884,212574
320520,201910,6808,3027,3781,3035922.4,3786419.75,6822342.15
320530,201910,5878,3020,2858,3021952.99,2862268.15,5884221.14
330010,201910,3052,1599,1453,1596802,1457080,3053882
330015,201910,161,69,92,69860.56,91816,161676.56
330020,201910,3617,1607,2010,1604785.54,2013964.4,3618749.94
330022,201910,241,130,111,129740,110778,240518
330023,201910,563,194,369,195608,370258,565866
330025,201910,577,117,460,116766,459080,575846
330030,201910,1921,1248,673,1247502.26,671654.4,1919156.66
330040,201910,2418,1281,1137,1281434.1,1134727.3,2416161.4
330045,201910,8351,2708,5643,2709570.8,5660657.6,8370228.4
330050,201910,899,575,324,574848,323352,898200
330060,201910,953,579,374,578840.9,373252,952092.9
330070,201910,3465,1315,2150,1313369.74,2153686.88,3467056.62
330080,201910,1550,703,847,703591.04,846304,1549895.04
330090,201910,377,223,154,222554,153692.4,376246.4
330093,201910,271,121,150,120758,149701.88,270459.88
330095,201910,89,49,40,48902,39920,88822
330100,201910,9423,4881,4542,4881221.67,4544893.1,9426114.77
330110,201910,485,205,280,207584.7,279440,487024.7
330115,201910,542,289,253,291416,253492,544908
330120,201910,378,197,181,196606,180639.6,377245.6
330130,201910,1539,403,1136,402194.6,1136722.96,1538917.56
330140,201910,603,319,284,320358.94,285428,605786.94
330150,201910,499,284,215,284430,215568,499998
330160,201910,210,128,82,127744,81836,209580
330170,201910,26678,9359,17319,9360250.16,17334275.15,26694525.31
330180,201910,238,150,88,150698,87824,238522
330185,201910,917,336,581,335328.98,582833.92,918162.90
330187,201910,328,102,226,102794,225548,328342
330190,201910,5598,2230,3368,2231531.06,3370247.1,5601778.16
330200,201910,4639,1431,3208,1431134.24,3210567,4641701.24
330205,201910,421,250,171,250498,171656.4,422154.4
330210,201910,992,615,377,615768.84,377246.18,993015.02
330220,201910,2619,1587,1032,1586821.28,1031932.4,2618753.68
330225,201910,557,294,263,294410.95,263472,557882.95
330227,201910,2331,744,1587,743510.4,1589815.5,2333325.9
330230,201910,224,131,93,130738,92814,223552
330240,201910,3655,1884,1771,1889220.48,1772484.1,3661704.58
330245,201910,153,72,81,72854.34,80838,153692.34
330250,201910,6673,3471,3202,3471046.35,3206577.71,6677624.06
330260,201910,560,159,401,158682,400198,558880
330270,201910,3391,1228,2163,1227540.6,2173646.8,3401187.4
330280,201910,446,286,160,285429.2,159680.98,445110.18
330285,201910,7047,2298,4749,2304383.5,4751480.8,7055864.3
330290,201910,633,236,397,235528,397204.4,632732.4
330300,201910,764,506,258,505987.1,258482.94,764470.04
330310,201910,436,251,185,254490.9,184630,439120.9
330320,201910,7955,3044,4911,3042904.8,4919143.6,7962048.4
330330,201910,8779,3519,5260,3519949.08,5274441.39,8794390.47
330340,201910,2720,1616,1104,1617758.4,1104786,2722544.4
330350,201910,18042,7225,10817,7232513.51,10852261.78,18084775.29
330360,201910,2298,1136,1162,1134726.8,1165664.98,2300391.78
330370,201910,1020,528,492,527942.7,492014,1019956.7
330380,201910,854,372,482,373252,484031.21,857283.21
330385,201910,623,327,296,326346.5,295408,621754.5
330390,201910,5455,3004,2451,3001986.4,2454082.4,5456068.8
330395,201910,309,191,118,190618,117764.7,308382.7
330400,201910,709,388,321,387225,321356,708581
330410,201910,507,370,137,369261.7,136726.4,505988.1
330411,201910,253,139,114,139720.62,114770,254490.62
330412,201910,239,98,141,97804.8,140718,238522.8
330414,201910,5455,2274,3181,2270452.28,3181624.4,5452076.68
330415,201910,576,262,314,261477.4,313372.6,574850.0
330420,201910,2237,1174,1063,1172650.94,1065865.38,2238516.32
330430,201910,1749,827,922,827342.8,923152.4,1750495.2
330440,201910,275,137,138,136726,137724,274450
330450,201910,117,49,68,50898,67864,118762
330452,201910,1851,862,989,860278.52,987022.4,1847300.92
330455,201910,108662,39677,68985,39702543.91,69125505.13,108828049.04
330460,201910,260,108,152,107784,151696.94,259480.94
330470,201910,1232,680,552,680638.24,550897.5,1231535.74
330475,201910,1409,381,1028,380238,1025944,1406182
330480,201910,786,425,361,425148,360278.6,785426.6
330490,201910,13825,4766,9059,4770441.1,9075819.66,13846260.76
330500,201910,1362,610,752,612772,753490.46,1366262.46
330510,201910,10860,3836,7024,3835316.26,7042890.39,10878206.65
330513,201910,101,52,49,51896,50898,102794
330515,201910,823,339,484,339320.3,484031.2,823351.5
330520,201910,2467,905,1562,904188.54,1560872,2465060.54
330530,201910,209,115,94,114770.5,95808.6,210579.1
330540,201910,366,179,187,179640.4,188622,368262.4
330550,201910,2873,1035,1838,1035924.68,1840312.8,2876237.48
330555,201910,824,321,503,321356,501994,823350
330560,201910,648,214,434,213572,433132.94,646704.94
330570,201910,264,190,74,190618,73852,264470
330575,201910,766,310,456,309380,456087.4,765467.4
330580,201910,3360,1892,1468,1895204.2,1471052.4,3366256.6
330590,201910,297,150,147,149700,146706.98,296406.98
330600,201910,1159,746,413,744508.4,416166,1160674.4
330610,201910,1566,864,702,863305.46,706586.3,1569891.76
330615,201910,204,158,46,157684,46906,204590
330620,201910,1066,432,634,432134.6,632732,1064866.6
330630,201910,4039,2587,1452,2584823.16,1454086.5,4038909.66
350010,201910,594,407,187,408183.22,188622,596805.22
350020,201910,46,22,24,21956,23952,45908
350030,201910,515,326,189,325348.4,189620.4,514968.8
350040,201910,122,47,75,46906,74850,121756
350050,201910,300,160,140,159680,140718,300398
350055,201910,90,47,43,46906,42914,89820
350060,201910,77,28,49,27944,49900,77844
350070,201910,810,483,327,483056.31,327356.68,810412.99
350075,201910,70,49,21,48902,21956,70858
350080,201910,50,28,22,27944,21956,49900
350090,201910,87,48,39,48902,38922,87824
350100,201910,292,180,112,179640,111776,291416
350110,201910,59,40,19,39920,18962,58882
350115,201910,154,94,60,94810,60878,155688
350120,201910,106,71,35,70858,34930,105788
350130,201910,345,160,185,159680.58,184630.98,344311.56
350140,201910,40,27,13,26946,12974,39920
350150,201910,72,55,17,54890,16966,71856
350160,201910,2499,992,1507,991018.86,1509980.93,2500999.79
350170,201910,395,238,157,237525.14,156686.4,394211.54
350180,201910,175,100,75,99800,74850,174650
350190,201910,1000,527,473,528941.03,473052.4,1001993.43
350200,201910,68,24,44,23952,43912,67864
350210,201910,1281,720,561,719560.59,559878.63,1279439.22
350220,201910,668,567,101,566864.63,100798,667662.63
350230,201910,76,54,22,53892,21956,75848
350240,201910,62,44,18,43912,17964,61876
350250,201910,1144,558,586,559879.4,584829.1,1144708.5
350260,201910,91,67,24,66866,23952,90818
350270,201910,843,562,281,560876.82,280438.4,841315.22
350275,201910,303,130,173,129740,172654,302394
350280,201910,4625,2366,2259,2369258.65,2258478.95,4627737.60
350290,201910,423,201,222,200598,222554.4,423152.4
350300,201910,56,29,27,28942,26946,55888
350310,201910,94,59,35,58882,35928,94810
350315,201910,40,24,16,23952,15968,39920
350320,201910,3280,1619,1661,1618756.6,1662668.6,3281425.2
350330,201910,1656,899,757,900200.18,759479.2,1659679.38
350335,201910,18,13,5,12974,4990,17964
350340,201910,125,60,65,59880,64870.3,124750.3
350350,201910,90,45,45,44910,44910,89820
350360,201910,124,83,41,82834.99,40918,123752.99
350370,201910,84,46,38,45908.63,38922,84830.63
350380,201910,780,332,448,332334.4,448103.2,780437.6
350390,201910,1516,606,910,605787.43,910176.4,1515963.83
350395,201910,24,19,5,19960,4990,24950
350400,201910,1683,874,809,874251.79,808381.62,1682633.41
350410,201910,2438,1090,1348,1090814,1349296.63,2440110.63
350420,201910,244,148,96,147705.03,95808,243513.03
350430,201910,74,45,29,44910,28942,73852
350440,201910,149,108,41,108782.4,40918,149700.4
350450,201910,1631,985,646,986026.67,647703.55,1633730.22
350460,201910,353,124,229,123752,229540,353292
350470,201910,17,12,5,11976,5988,17964
350480,201910,168,94,74,93812,74850,168662
350490,201910,237,119,118,118762,117764,236526
350500,201910,48,19,29,18962,28942,47904
350510,201910,163,108,55,108782,54890,163672
350520,201910,451,222,229,221556,230538,452094
350530,201910,445,208,237,207584,236526,444110
350535,201910,78,64,14,63872,13972,77844
350540,201910,388,193,195,194610,194610,389220
350550,201910,2747,1635,1112,1634726.91,1114770.4,2749497.31
350560,201910,654,458,196,457084.63,195608,652692.63
350570,201910,4080,1725,2355,1725543.63,2357280.45,4082824.08
350580,201910,372,174,198,173652,199600.99,373252.99
350590,201910,891,495,396,496006.4,395208,891214.4
350600,201910,6138,3020,3118,3021950.79,3118753.64,6140704.43
350610,201910,1525,804,721,803390.63,720556.98,1523947.61
350620,201910,32,21,11,21956,10978,32934
350630,201910,232,130,102,129740.63,101796.63,231537.26
350635,201910,930,382,548,382234.4,549898.8,932133.2
350640,201910,125,94,31,94810,30938,125748
350650,201910,1877,1246,631,1246502.58,631734.98,1878237.56
350660,201910,744,327,417,326346,419160.99,745506.99
350670,201910,306,147,159,146706,158682,305388
350680,201910,180,95,85,94810,85828.8,180638.8
350690,201910,195,100,95,99800,94810,194610
350700,201910,759,367,392,366266.4,391216.4,757482.8
350710,201910,357,133,224,133732,224550,358282
350715,201910,53,42,11,41916,10978,52894
350720,201910,17,11,6,10978,5988,16966
350730,201910,46,29,17,28942,16966,45908
350740,201910,210,120,90,119760,89820,209580
350745,201910,22,11,11,10978.44,10978,21956.44
350750,201910,2183,1371,812,1368260.38,815366,2183626.38
350760,201910,3720,1641,2079,1641710.66,2078834,3720544.66
350770,201910,62,45,17,44910,16966,61876
350775,201910,45,32,13,31936,12974.98,44910.98
350780,201910,435,221,214,221556,214570.4,436126.4
350790,201910,373,158,215,157684,214570,372254
350800,201910,455,270,185,269460,184630,454090
350810,201910,510,418,92,418162.93,91816,509978.93
350820,201910,92,57,35,56886,34930,91816
350830,201910,82,43,39,42914,38922,81836
350840,201910,766,320,446,320358.4,445109.38,765467.78
350850,201910,1741,996,745,996004.5,745508.95,1741513.45
350860,201910,590,338,252,338323.9,251496,589819.9
350870,201910,431,290,141,290418,140718,431136
350880,201910,286,159,127,159680.5,127744,287424.5
350890,201910,41,28,13,27944,12974,40918
350900,201910,1428,463,965,462074.7,967062.63,1429137.33
350910,201910,25,15,10,14970,9980,24950
350920,201910,647,349,298,349300,297404,646704
350925,201910,1203,643,560,642712.78,562873.2,1205585.98
350930,201910,98,61,37,60878,36926,97804
350940,201910,717,401,316,400198.38,318362,718560.38
350945,201910,109,79,30,78842,29940,108782
350950,201910,16193,7703,8490,7709555.31,8494982.41,16204537.72
350960,201910,1293,609,684,607782.4,684629.39,1292411.79
350970,201910,1101,581,520,581728.03,521955.2,1103683.23
350980,201910,92,61,31,61876,30938,92814
350990,201910,377,138,239,138722,238522,377244
350995,201910,37,16,21,15968,20958,36926
351000,201910,633,441,192,442115.26,191616,633731.26
351010,201910,51,32,19,31936,18962,50898
351015,201910,52,37,15,36926,14970,51896
351020,201910,1604,961,643,961075.39,643710,1604785.39
351030,201910,343,233,110,232534,109780,342314
351040,201910,865,458,407,457084.48,408182.11,865266.59
351050,201910,3274,1513,1761,1512973.31,1759480.52,3272453.83
351060,201910,5073,2044,3029,2043905.96,3033924.71,5077830.67
351070,201910,410,255,155,254490.98,154690,409180.98
351080,201910,773,560,213,559878,216566,776444
351090,201910,52,23,29,22954,28942,51896
351100,201910,431,251,180,250498.68,179640,430138.68
351110,201910,2060,998,1062,996014.98,1064884.98,2060899.96
351120,201910,66,33,33,32934,32934,65868
351130,201910,173,58,115,57884,114770,172654
351140,201910,329,227,102,226546,102794,329340
351150,201910,428,228,200,228542.3,199600.4,428142.7
351160,201910,268,182,86,181636.4,85828,267464.4
351170,201910,181,100,81,100798,80838,181636
351190,201910,87,60,27,59880,26946,86826
351200,201910,362,246,116,247504.4,115768,363272.4
351210,201910,116,61,55,60878,55888,116766
351220,201910,527,316,211,317365.76,212574,529939.76
351230,201910,276,194,82,194610,81836,276446
351240,201910,226,108,118,107784,117764,225548
351250,201910,76,55,21,54890.53,21956,76846.53
351260,201910,155,116,39,115768,38922,154690
351270,201910,46,19,27,18962,26946,45908
351280,201910,1028,471,557,472055.26,557884.01,1029939.27
351290,201910,239,107,132,107784,131736.4,239520.4
351300,201910,3701,1708,1993,1708500.22,1993007.62,3701507.84
351310,201910,756,383,373,383232,373252.98,756484.98
351320,201910,116,68,48,67864,47904,115768
351330,201910,38,24,14,23952,13972,37924
351340,201910,1223,741,482,739519,482036.95,1221555.95
351350,201910,2504,1458,1046,1459077.4,1045904,2504981.4
351360,201910,772,380,392,380238,392214,772452
351370,201910,391,196,195,195608.4,194610,390218.4
351380,201910,9115,4136,4979,4134720.13,4982021.09,9116741.22
351385,201910,28,17,11,16966,10978,27944
351390,201910,281,212,69,212574.54,68862,281436.54
351400,201910,66,42,24,41916,23954.94,65870.94
351410,201910,437,277,160,276446.6,160678,437124.6
351420,201910,61,49,12,48902,11976,60878
351430,201910,64,34,30,34930,29940,64870
351440,201910,793,556,237,554889.93,236526,791415.93
351450,201910,258,129,129,128742,128742,257484
351460,201910,115,54,61,53892,60878,114770
351470,201910,140,73,67,72854,66866,139720
351480,201910,520,297,223,296407.36,224550,520957.36
351490,201910,290,108,182,108782,181636,290418
351492,201910,31,22,9,21956,8982,30938
351495,201910,25,19,6,18962,5988,24950
351500,201910,3591,1514,2077,1514965.94,2077837.36,3592803.30
351510,201910,1866,759,1107,759478.8,1105784.4,1865263.2
351512,201910,20,16,4,15968,3992,19960
351515,201910,194,113,81,112774,80838.96,193612.96
351518,201910,771,484,287,483032.99,287424,770456.99
351519,201910,73,46,27,45908,26946,72854
351520,201910,152,92,60,91816,59880,151696
351530,201910,22,14,8,14970,7984,22954
351535,201910,130,74,56,73852,55888,129740
351540,201910,453,327,126,327344.42,125748,453092.42
351550,201910,1395,831,564,830338.46,564868,1395206.46
351560,201910,68,39,29,39920,29940,69860
351565,201910,9,7,2,6986,1996,8982
351570,201910,2636,1355,1281,1356284.38,1282432.97,2638717.35
351580,201910,38,34,4,33932,3992,37924
351590,201910,65,43,22,42914,21956,64870
351600,201910,194,144,50,143712,49900,193612
351610,201910,55,25,30,24950,29940,54890
351620,201910,5863,3310,2553,3313364.27,2559871.26,5873235.53
351630,201910,2705,1378,1327,1376242.9,1325344,2701586.9
351640,201910,1888,899,989,899198.49,989019.03,1888217.52
351650,201910,30,26,4,25948,4990,30938
351660,201910,141,92,49,91816,48902,140718
351670,201910,717,446,271,445109.8,271456,716565.8
351680,201910,74,61,13,60878,12974,73852
351685,201910,30,17,13,16966,12974,29940
351690,201910,305,213,92,212574.45,91816,304390.45
351700,201910,159,112,47,111776.4,46906,158682.4
351710,201910,67,46,21,46906,20958,67864
351720,201910,131,70,61,69860,61876,131736
351730,201910,104,72,32,71856,31936.63,103792.63
351740,201910,724,473,251,473054.27,250498,723552.27
351750,201910,355,147,208,146706,207584,354290
351760,201910,779,591,188,589818,187624,777442
351770,201910,314,268,46,267464.09,45908,313372.09
351780,201910,154,89,65,88822.98,64870,153692.98
351790,201910,252,131,121,131736,120758,252494
351800,201910,43,29,14,28942,13972,42914
351810,201910,120,80,40,80838,39920,120758
351820,201910,842,612,230,613771.2,229541.39,843312.59
351830,201910,532,194,338,193612,339320,532932
351840,201910,1863,944,919,943111.04,919160.97,1862272.01
351850,201910,244,178,66,177644,65868,243512
351860,201910,691,480,211,479041.78,210578,689619.78
351870,201910,5620,2665,2955,2666658.84,2959072.73,5625731.57
351880,201910,19067,8022,11045,8029951.74,11056888.32,19086840.06
351885,201910,87,57,30,56886,29940,86826
351890,201910,74,62,12,61876,11976,73852
351900,201910,229,134,95,133732,94810,228542
351905,201910,72,29,43,28942,42914,71856
351907,201910,3394,1426,1968,1432131.34,1969058.55,3401189.89
351910,201910,178,73,105,72854,104790,177644
351920,201910,120,70,50,69860,50899.98,120759.98
351925,201910,90,59,31,58882,30938,89820
351930,201910,386,252,134,252494,133732,386226
351940,201910,242,109,133,108782,132734,241516
351950,201910,133,74,59,74850,58882,133732
351960,201910,894,431,463,431449,462074.4,893523.4
351970,201910,1862,998,864,996004.4,866265.78,1862270.18
351980,201910,153,78,75,77844,74850,152694
351990,201910,261,171,90,171656.8,89820,261476.8
352000,201910,354,220,134,220558.8,133732,354290.8
352010,201910,398,252,146,251496,145708,397204
352020,201910,182,67,115,66866,115768,182634
352030,201910,1069,558,511,556884,511974,1068858
352040,201910,577,242,335,242514,335328,577842
352042,201910,289,91,198,90818,199600.8,290418.8
352044,201910,360,218,142,217564,142714,360278
352050,201910,3264,1276,1988,1275446.76,1994004.4,3269451.16
352060,201910,102,63,39,63872,38922,102794
352070,201910,95,70,25,69861.26,24950,94811.26
352080,201910,67,42,25,41916,24950,66866
352090,201910,162,110,52,109780,52894,162674
352100,201910,273,131,142,130739.39,141718.38,272457.77
352110,201910,114,34,80,33932,79840,113772
352115,201910,62,21,41,20958,40918,61876
352120,201910,88,63,25,62874.63,24950,87824.63
352130,201910,219,183,36,183632,35928,219560
352140,201910,189,86,103,85828,103792,189620
352150,201910,115,64,51,63872,51896,115768
352160,201910,137,89,48,88822,47904,136726
352170,201910,370,262,108,261476,107784,369260
352180,201910,608,400,208,400198.03,207584.99,607783.02
352190,201910,257,105,152,104790,151696,256486
352200,201910,32,16,16,15968,15968,31936
352210,201910,4035,1667,2368,1668658.26,2370252.63,4038910.89
352215,201910,55,32,23,31936,22954,54890
352220,201910,6958,2644,4314,2643705.31,4309369.75,6953075.06
352230,201910,3296,2140,1156,2135734.89,1155694.5,3291429.39
352240,201910,2351,1365,986,1364267,985026.4,2349293.4
352250,201910,2646,1336,1310,1339319.02,1310375.97,2649694.99
352260,201910,988,517,471,517962.8,473052.4,991015.2
352265,201910,58,26,32,25948,31936,57884
352270,201910,411,240,171,239520,170659.88,410179.88
352280,201910,432,273,159,273453.26,158682,432135.26
352290,201910,173,105,68,104790,67864,172654
352300,201910,96,70,26,69860,25948,95808
352310,201910,6116,2855,3261,2857279.66,3260469.3,6117748.96
352320,201910,989,515,474,514968.4,474050,989018.4
352330,201910,526,256,270,255488,270458.4,525946.4
352340,201910,1340,639,701,637723.64,702593.2,1340316.84
352350,201910,334,203,131,202594,130738,333332
352360,201910,218,97,121,96806,121756.2,218562.2
352370,201910,106,70,36,69860,35928,105788
352380,201910,113,72,41,71856,41916,113772
352390,201910,2467,1107,1360,1106784.38,1360275.3,2467059.68
352400,201910,488,217,271,217564,271456.4,489020.4
352410,201910,835,596,239,597802.63,238522,836324.63
352420,201910,106,73,33,72854,32934,105788
352430,201910,1725,790,935,794410.69,937124.84,1731535.53
352440,201910,3137,1570,1567,1569856.83,1569856.76,3139713.59
352450,201910,201,167,34,166666,33932,200598
352460,201910,615,320,295,320359.39,294410,614769.39
352470,201910,636,223,413,222554,415168,637722
352480,201910,1390,781,609,782432,609778.4,1392210.4
352490,201910,62,24,38,23952,37924,61876
352500,201910,1202,538,664,537922.34,664669.38,1202591.72
352510,201910,743,400,343,401197.26,342314,743511.26
352520,201910,625,297,328,296406.7,330338,626744.7
352530,201910,1761,930,831,928140,829338.4,1757478.4
352540,201910,74,49,25,48902,24950,73852
352550,201910,181,108,73,107784,72854,180638
352560,201910,50,40,10,39920,9980,49900
352570,201910,670,351,319,350298.63,318362,668660.63
352580,201910,58,43,15,42914,15968,58882
352585,201910,19,6,13,5988,12974,18962
352590,201910,4409,2239,2170,2237516.63,2175641.78,4413158.41
352600,201910,339,244,95,243512,95808,339320
352610,201910,949,434,515,434130.57,516964,951094.57
352620,201910,987,391,596,390218,596804,987022
352630,201910,175,62,113,61876,112774.4,174650.4
352640,201910,535,363,172,362274.96,171656,533930.96
352650,201910,84,57,27,56886,27944,84830
352660,201910,70,43,27,42914,26946,69860
352670,201910,1660,899,761,900197.59,762480.91,1662678.50
352680,201910,915,580,335,579839.59,335328,915167.59
352690,201910,4487,2046,2441,2044905.81,2446099.61,4491005.42
352700,201910,108,65,43,64870,42914,107784
352710,201910,1364,732,632,730536,633730,1364266
352720,201910,1327,635,692,635726,694608.4,1330334.4
352725,201910,24,21,3,20958,2994,23952
352730,201910,384,201,183,200598,182634,383232
352740,201910,413,270,143,270458.96,145708.68,416167.64
352750,201910,18,12,6,11976,5988,17964
352760,201910,178,118,60,117764,59880,177644
352770,201910,85,66,19,65868,18962,84830
352780,201910,74,40,34,39920,33932,73852
352790,201910,28,23,5,22954.63,4990,27944.63
352800,201910,242,175,67,175648,66866,242514
352810,201910,152,94,58,94811.03,57884,152695.03
352820,201910,63,51,12,51896,11976,63872
352830,201910,86,58,28,58882,27944,86826
352840,201910,667,346,321,346306.5,321356,667662.5
352850,201910,1444,495,949,494010,948100,1442110
352860,201910,127,79,48,78842,47904,126746
352870,201910,44,28,16,27944,15968.4,43912.4
352880,201910,184,124,60,123752,60878,184630
352885,201910,31,22,9,21956,8982,30938
352890,201910,54,37,17,36926,16966.4,53892.4
352900,201910,4800,2334,2466,2333329.36,2470058.77,4803388.13
352910,201910,39,32,7,31936,6986,38922
352920,201910,675,408,267,407184,266466,673650
352930,201910,1217,591,626,592826.12,625791,1218617.12
352940,201910,6238,2642,3596,2644704.01,3592807.09,6237511.10
352950,201910,96,38,58,37924,58882,96806
352960,201910,55,39,16,38922,15968,54890
352965,201910,20,10,10,9980,9980,19960
352970,201910,516,393,123,393212.02,122755.61,515967.63
352980,201910,165,89,76,88822,75848,164670
352990,201910,974,442,532,442114,531934,974048
353000,201910,66,31,35,30938,34930,65868
353010,201910,540,335,205,334330,204590,538920
353020,201910,297,213,84,213572,83832,297404
353030,201910,1231,565,666,564868.34,664668.98,1229537.32
353040,201910,90,59,31,58882,30938,89820
353050,201910,1326,848,478,848301.69,478042,1326343.69
353060,201910,8345,3715,4630,3712567.83,4633723.88,8346291.71
353070,201910,1724,1083,641,1081834.56,639540.35,1721374.91
353080,201910,1310,693,617,692613.16,617762,1310375.16
353090,201910,58,33,25,32934,24950,57884
353100,201910,55,44,11,44910,10978,55888
353110,201910,2062,629,1433,629738.4,1433129.19,2062867.59
353120,201910,92,50,42,49900,41916,91816
353130,201910,845,412,433,411179.75,432135.96,843315.71
353140,201910,559,224,335,223552.63,334330,557882.63
353150,201910,344,194,150,193612.63,149700,343312.63
353160,201910,94,79,15,78842,14970,93812
353170,201910,197,64,133,63872,133733.96,197605.96
353180,201910,1012,476,536,477044,534929.1,1011973.1
353190,201910,511,375,136,375248.3,135728.4,510976.7
353200,201910,210,109,101,108782,100798,209580
353205,201910,22,15,7,14970,6986,21956
353210,201910,81,47,34,46906,33932,80838
353215,201910,49,28,21,27944,21956,49900
353220,201910,81,45,36,44910,35928,80838
353230,201910,160,65,95,65868,94810,160678
353240,201910,313,165,148,166666,147704,314370
353250,201910,209,108,101,107784,100798,208582
353260,201910,459,326,133,325349.1,133732,459081.1
353270,201910,69,52,17,51896,16966,68862
353280,201910,102,53,49,54890.6,48902,103792.6
353282,201910,122,86,36,85828,35928,121756
353284,201910,25,18,7,17964,6986,24950
353286,201910,1,0,1,0,998,998
353290,201910,74,43,31,42914,30938,73852
353300,201910,434,238,196,238523.96,195608,434131.96
353310,201910,45,39,6,38922,5988,44910
353320,201910,62,37,25,36926,24950,61876
353325,201910,56,32,24,31936,23953.36,55889.36
353330,201910,62,45,17,44910.7,16966,61876.7
353340,201910,616,212,404,212574,403192.4,615766.4
353350,201910,893,432,461,431137.96,461077.96,892215.92
353360,201910,100,80,20,79840,19960,99800
353370,201910,122,68,54,67864,53892,121756
353380,201910,32,18,14,17964.99,13972,31936.99
353390,201910,1095,534,561,532932,562872,1095804
353400,201910,44,26,18,25948,17964,43912
353410,201910,105,67,38,66866,37924.9,104790.9
353420,201910,59,26,33,25948,32934,58882
353430,201910,583,391,192,391217.38,192614,583831.38
353440,201910,10423,4616,5807,4619481.86,5818351.34,10437833.20
353450,201910,56,31,25,30938,24950,55888
353460,201910,599,333,266,333332.1,265468,598800.1
353470,201910,2116,1132,984,1130737.79,984031.96,2114769.75
353475,201910,235,159,76,158683.38,75848,234531.38
353480,201910,185,153,32,152694,31936,184630
353490,201910,241,148,93,147704,92814.4,240518.4
353500,201910,194,113,81,113772.63,82834,196606.63
353510,201910,100,72,28,72854,27944,100798
353520,201910,210,147,63,146706,62874,209580
353530,201910,468,255,213,254490,213572,468062
353540,201910,380,259,121,258482,121756,380238
353550,201910,729,470,259,469061.24,260478,729539.24
353560,201910,600,244,356,243512,356286.6,599798.6
353570,201910,64,34,30,33932.4,29940,63872.4
353580,201910,351,263,88,263472.34,87824,351296.34
353590,201910,92,65,27,64870,26946,91816
353600,201910,275,157,118,157684.63,117764,275448.63
353610,201910,123,68,55,67864,54890,122754
353620,201910,615,322,293,323352,292414,615766
353625,201910,50,28,22,27944,21956,49900
353630,201910,236,173,63,172654.58,62874,235528.58
353640,201910,125,87,38,87824,38922,126746
353650,201910,924,365,559,365268,558880,924148
353657,201910,25,19,6,18962,5988,24950
353660,201910,265,144,121,143712,121756,265468
353670,201910,771,460,311,459081.03,313372.4,772453.43
353680,201910,104,76,28,75848.5,28942,104790.5
353690,201910,43,33,10,32934,9980,42914
353700,201910,282,202,80,202594.45,79840,282434.45
353710,201910,451,217,234,217564.6,233532.4,451097.0
353715,201910,45,33,12,32934,11976,44910
353720,201910,356,166,190,165669.78,189620,355289.78
353730,201910,1089,669,420,668660.8,419160.8,1087821.6
353740,201910,630,343,287,345308,286426,631734
353750,201910,79,49,30,49900,29940,79840
353760,201910,2883,1087,1796,1085825.56,1798398.18,2884223.74
353770,201910,91,74,17,73852,16966,90818
353780,201910,1182,572,610,571854.63,609778,1181632.63
353790,201910,514,308,206,307384.16,205588.4,512972.56
353800,201910,3261,1627,1634,1626761.89,1634795.35,3261557.24
353810,201910,235,134,101,133732.98,100799.96,234532.94
353820,201910,194,94,100,93812,99800,193612
353830,201910,48,41,7,40918,6986,47904
353850,201910,177,86,91,85828,90818,176646
353860,201910,492,227,265,226546,265468,492014
353870,201910,5221,2674,2547,2673649.03,2549893.2,5223542.23
353880,201910,692,488,204,487025.36,204590,691615.36
353890,201910,576,331,245,331336.4,246506.84,577843.24
353900,201910,131,70,61,69860,60878,130738
353910,201910,175,84,91,83832,90818,174650
353920,201910,439,242,197,242514.3,197604,440118.3
353930,201910,1009,595,414,594808,413174.14,1007982.14
353940,201910,195,103,92,102794,91816,194610
353950,201910,516,316,200,319360,199600.98,518960.98
353960,201910,72,59,13,58882,12974,71856
353970,201910,67,39,28,38922,27944,66866
353980,201910,1615,765,850,763470,853293.96,1616763.96
353990,201910,76,45,31,44910,30938,75848
354000,201910,377,185,192,185628,191616.99,377244.99
354010,201910,92,51,41,50898,40918,91816
354020,201910,531,343,188,343312,188622,531934
354025,201910,55,45,10,44910,9980,54890
354030,201910,57,33,24,33932,23952,57884
354040,201910,105,78,27,77844,26946,104790
354050,201910,186,99,87,98802.4,86826,185628.4
354060,201910,767,377,390,378242,390218,768460
354070,201910,913,532,381,533930.4,384230.4,918160.8
354075,201910,221,113,108,112774,107784,220558
354080,201910,306,132,174,132734,173652,306386
354085,201910,21,13,8,12974,7984,20958
354090,201910,303,171,132,170574,131736,302310
354100,201910,5568,2328,3240,2325341.56,3244500.92,5569842.48
354105,201910,90,43,47,42914,46906,89820
354110,201910,47,23,24,22954,23952,46906
354120,201910,136,97,39,96806.98,38922,135728.98
354130,201910,709,463,246,462074.98,245509.38,707584.36
354140,201910,3118,1448,1670,1448099.6,1672648.4,3120748.0
354150,201910,627,386,241,386226.8,240518,626744.8
354160,201910,672,430,242,430138,243512.4,673650.4
354165,201910,19,14,5,13972,4990,18962
354170,201910,178,119,59,118762,58882,177644
354180,201910,62,38,24,37924.51,24950,62874.51
354190,201910,197,87,110,86826,111776,198602
354200,201910,120,64,56,63872,55888,119760
354210,201910,56,25,31,24950,30938,55888
354220,201910,652,410,242,409180,242514,651694
354230,201910,166,71,95,71856.6,94810,166666.6
354240,201910,330,214,116,213572.64,115768,329340.64
354250,201910,84,51,33,50898,32934,83832
354260,201910,2026,951,1075,951097.47,1072851.67,2023949.14
354270,201910,91,68,23,67864,22954,90818
354280,201910,41,21,20,20958,19960,40918
354290,201910,145,102,43,101796,42914,144710
354300,201910,392,274,118,273452.63,117764,391216.63
354310,201910,96,71,25,70858.4,24950,95808.4
354320,201910,198,98,100,97804,99800,197604
354323,201910,12,11,1,10978,998,11976
354325,201910,114,69,45,68862.6,44910,113772.6
354330,201910,2507,836,1671,838178.8,1672649.38,2510828.18
354340,201910,10493,5090,5403,5086810.53,5409165.93,10495976.46
354350,201910,121,81,40,80838,39920,120758
354360,201910,84,49,35,48902,34930,83832
354370,201910,254,138,116,138722,115768,254490
354380,201910,191,114,77,114770,76846,191616
354390,201910,2680,987,1693,987023.59,1696600.98,2683624.57
354400,201910,316,173,143,172654,142714,315368
354410,201910,615,298,317,297404,320358.4,617762.4
354420,201910,276,174,102,173652,102794,276446
354425,201910,309,183,126,183632,125748,309380
354430,201910,180,106,74,105788,73852,179640
354440,201910,34,25,9,24950,8982,33932
354450,201910,51,37,14,36926,13972,50898
354460,201910,106,62,44,61876,43912,105788
354470,201910,37,22,15,21956,14970,36926
354480,201910,116,62,54,61876,53892,115768
354490,201910,149,92,57,91816,56886,148702
354500,201910,374,184,190,184630,189620,374250
354510,201910,97,71,26,70858,25948,96806
354515,201910,38,12,26,11976,25948,37924
354520,201910,1593,688,905,689476.9,905186.8,1594663.7
354530,201910,732,374,358,373253.79,357284,730537.79
354540,201910,272,148,124,147704,123752,271456
354550,201910,40,23,17,22954,16966,39920
354560,201910,148,82,66,83832,66866,150698
354570,201910,142,92,50,91816.5,49900,141716.5
354580,201910,1890,903,987,903192.29,986024,1889216.29
354600,201910,250,139,111,138722,110778,249500
354610,201910,76,64,12,63872.46,11976.98,75849.44
354620,201910,63,20,43,19960,42914,62874
354625,201910,15,10,5,9980,4990.99,14970.99
354630,201910,315,204,111,204590.98,110778,315368.98
354640,201910,804,519,285,519958.3,284430,804388.3
354650,201910,73,42,31,41916,30938.98,72854.98
354660,201910,795,593,202,591814.63,201596,793410.63
354670,201910,249,90,159,89820,159680.6,249500.6
354680,201910,1254,468,786,470058,790416,1260474
354690,201910,79,53,26,52894.4,25948,78842.4
354700,201910,70,50,20,49900,19960,69860
354710,201910,47,35,12,34930,11976,46906
354720,201910,22,22,0,21956,0,21956
354730,201910,1723,721,1002,724549.78,1002990.4,1727540.18
354740,201910,66,48,18,48902,17964,66866
354750,201910,440,253,187,252494.98,187624,440118.98
354760,201910,479,293,186,292415.7,186626.4,479042.1
354765,201910,10,5,5,4990,4990,9980
354770,201910,348,230,118,229540.4,117764,347304.4
354780,201910,8156,3295,4861,3293412.6,4866271.97,8159684.57
354790,201910,101,59,42,58882,41916,100798
354800,201910,449,251,198,250498,197604.4,448102.4
354805,201910,102,48,54,47904.79,53892,101796.79
354810,201910,105,63,42,63872,42914,106786
354820,201910,196,85,111,84830.56,110778,195608.56
354830,201910,39,20,19,19960,18962,38922
354840,201910,62,43,19,42914,18962,61876
354850,201910,4552,2036,2516,2036919.2,2521947.1,4558866.3
354860,201910,326,157,169,156686,169660.93,326346.93
354870,201910,12271,5553,6718,5549888.2,6722535.43,12272423.63
354880,201910,2950,1100,1850,1099797.14,1855286.23,2955083.37
354890,201910,2895,1587,1308,1585824.83,1309376,2895200.83
354900,201910,64,44,20,43912,19960,63872
354910,201910,1264,670,594,668660.4,592812,1261472.4
354920,201910,45,38,7,37924,6986,44910
354925,201910,13,8,5,7984,4990,12974
354930,201910,35,32,3,31936.43,2994,34930.43
354940,201910,825,599,226,600049.53,225548,825597.53
354950,201910,206,136,70,135728.79,69860,205588.79
354960,201910,156,61,95,60878,96806,157684
354970,201910,923,607,316,606785.77,315368.4,922154.17
354980,201910,8650,3192,5458,3186617.96,5458072.44,8644690.40
354990,201910,8993,4236,4757,4237515.31,4762507.82,9000023.13
354995,201910,543,184,359,185628,361276,546904
355000,201910,472,164,308,163672,308382,472054
355010,201910,614,385,229,384231,228543.23,612774.23
355020,201910,747,471,276,471056.32,279442.38,750498.70
355030,201910,206964,81029,125935,81037575.21,126077541.31,207115116.52
355040,201910,739,352,387,353292.4,386226,739518.4
355050,201910,148,99,49,98802.76,48902,147704.76
355060,201910,1561,793,768,793411.2,774448.6,1567859.8
355070,201910,1417,686,731,686626.31,733531.61,1420157.92
355080,201910,202,120,82,119760,82834,202594
355090,201910,285,173,112,173652,111776.32,285428.32
355100,201910,4964,2409,2555,2412071.82,2558874.19,4970946.01
355110,201910,264,176,88,175649.39,88822,264471.39
355120,201910,80,58,22,57884,21956.98,79840.98
355130,201910,55,33,22,32934,21956,54890
355140,201910,191,121,70,120758,69860,190618
355150,201910,675,407,268,406187.39,268462,674649.39
355160,201910,459,219,240,218562.63,239520.4,458083.03
355170,201910,2059,1085,974,1087820,975046,2062866
355180,201910,673,289,384,288422,384230,672652
355190,201910,204,145,59,145708,58882,204590
355200,201910,113,64,49,63872,48902,112774
355210,201910,678,394,284,395208,284430.98,679638.98
355220,201910,7061,3743,3318,3742506.27,3317356.74,7059863.01
355230,201910,102,61,41,60878,40918,101796
355240,201910,4422,1878,2544,1878238.88,2543903.97,4422142.85
355250,201910,5650,2632,3018,2629751.82,3015963.01,5645714.83
355255,201910,50,32,18,31936,17964,49900
355260,201910,182,110,72,109780.4,73853.96,183634.36
355270,201910,169,106,63,105788,62874,168662
355280,201910,6397,2612,3785,2613765.79,3786413.78,6400179.57
355290,201910,74,58,16,57884.4,16966,74850.4
355300,201910,198,124,74,124750,73852.4,198602.4
355310,201910,114,64,50,63872,49900,113772
355320,201910,88,46,42,45908,41916,87824
355330,201910,284,161,123,160678,124750,285428
355340,201910,1541,525,1016,523950.79,1013968,1537918.79
355350,201910,129,72,57,71856,56886,128742
355360,201910,169,108,61,107784,60878,168662
355365,201910,22,18,4,17964,3992,21956
355370,201910,1027,597,430,597814.77,429147.24,1026962.01
355380,201910,801,521,280,521954,281436,803390
355385,201910,67,48,19,47904,18962,66866
355390,201910,102,61,41,60878,40918,101796
355395,201910,185,111,74,110778.91,73852,184630.91
355400,201910,1632,1003,629,1003160.3,629739.99,1632900.29
355410,201910,4856,2324,2532,2322350.39,2533927.54,4856277.93
355420,201910,49,35,14,34930,13972,48902
355430,201910,364,225,139,224551.36,138722,363273.36
355440,201910,79,46,33,45908,32934,78842
355450,201910,462,231,231,230538.88,231536.7,462075.58
355460,201910,63,48,15,47904.54,14970,62874.54
355465,201910,49,32,17,31936,16966,48902
355470,201910,175,71,104,70858.7,103792,174650.7
355475,201910,14,9,5,8982,4990,13972
355480,201910,485,212,273,211576.6,272454,484030.6
355490,201910,117,85,32,84830,31936,116766
355495,201910,57,29,28,28942,27944,56886
355500,201910,1600,897,703,898202.55,702594.37,1600796.92
355510,201910,269,199,70,198603.26,71856,270459.26
355520,201910,34,25,9,24950.4,8982,33932.4
355530,201910,22,15,7,14970,6986,21956
355535,201910,76,37,39,36926,39920,76846
355540,201910,2392,957,1435,957223.11,1445105.61,2402328.72
355550,201910,60,36,24,35928,23952,59880
355560,201910,247,117,130,117764,129740,247504
355570,201910,24,17,7,16966,6986,23952
355580,201910,241,171,70,171656,70859.39,242515.39
355590,201910,20,14,6,13972,5988,19960
355600,201910,270,140,130,139720,130738,270458
355610,201910,229,154,75,153692,74850,228542
355620,201910,1321,624,697,624748.4,695606.99,1320355.39
355630,201910,441,323,118,322354,117764.63,440118.63
355635,201910,117,57,60,56886,59881.97,116767.97
355640,201910,573,323,250,322354,250498,572852
355645,201910,837,350,487,350298,488022.8,838320.8
355650,201910,2029,869,1160,871255.74,1157680.98,2028936.72
355660,201910,264,144,120,143712,119760,263472
355670,201910,533,210,323,210578,322354,532932
355680,201910,203,119,84,118762.97,83832,202594.97
355690,201910,93,44,49,43912,48902.36,92814.36
355695,201910,15,9,6,8982,5988,14970
355700,201910,1139,600,539,600796.66,537922.8,1138719.46
355710,201910,2244,1242,1002,1241512.8,1003988.98,2245501.78
355715,201910,20,15,5,14970,4990,19960
355720,201910,205,125,80,124750.44,79840,204590.44
355730,201910,97,54,43,53892,42914,96806
410010,201910,128,108,20,107784,19960,127744
410020,201910,109,90,19,89820,18962,108782
410030,201910,163,103,60,102794.4,59880,162674.4
410040,201910,1093,566,527,564868,525946.6,1090814.6
410045,201910,34,28,6,27944,5988,33932
410050,201910,480,276,204,275448,203592,479040
410060,201910,282,214,68,214570,67864,282434
410070,201910,307,255,52,255488,52894,308382
410080,201910,166,106,60,105788,59880,165668
410090,201910,81,71,10,70858.56,9980,80838.56
410100,201910,292,211,81,210578,80838,291416
410105,201910,47,29,18,28942,17964,46906
410110,201910,328,202,126,201596,125748,327344
410115,201910,32,22,10,21956,9980,31936
410120,201910,410,211,199,212574,199600,412174
410130,201910,48,29,19,28942,18962,47904
410140,201910,3134,1545,1589,1543908.1,1589816.6,3133724.7
410150,201910,2664,1064,1600,1063868.74,1598797.2,2662665.94
410160,201910,512,320,192,321356,193612.4,514968.4
410165,201910,66,44,22,43912,21956,65868
410170,201910,165,117,48,116766.4,47904,164670.4
410180,201910,2222,1262,960,1262470.4,962072.99,2224543.39
410185,201910,36,31,5,30938,4990,35928
410190,201910,495,330,165,330338.51,165668,496006.51
410200,201910,964,719,245,718560,244510,963070
410210,201910,581,308,273,308382,275448.4,583830.4
410220,201910,44,22,22,21956,21956,43912
410230,201910,143,70,73,69860,72854,142714
410240,201910,758,491,267,491016.8,266466,757482.8
410250,201910,380,276,104,275448,103792,379240
410260,201910,293,168,125,168662.4,125748,294410.4
410270,201910,31,21,10,20958,9980,30938
410275,201910,59,44,15,43912,14970,58882
410280,201910,321,187,134,187624,133732,321356
410290,201910,248,156,92,155688,91816,247504
410300,201910,79,58,21,57884,20958,78842
410302,201910,18,10,8,10978,7984,18962
410304,201910,42,28,14,27944,13972,41916
410305,201910,215,113,102,112774,101796,214570
410310,201910,216,132,84,131736,84830,216566
410315,201910,49,35,14,34930,13972,48902
410320,201910,135,95,40,94810,39920,134730
410322,201910,33,22,11,21956,10978,32934
410330,201910,173,123,50,122754,49900.6,172654.6
410335,201910,101,58,43,57884,42914,100798
410337,201910,38,32,6,31936,5988,37924
410340,201910,34,31,3,30938,2994,33932
410345,201910,213,127,86,126746,85828,212574
410347,201910,51,40,11,39920,10978,50898
410350,201910,244,153,91,152694,91816,244510
410360,201910,466,297,169,299400.8,168662.8,468063.6
410370,201910,2367,1011,1356,1011973.08,1360275.54,2372248.62
410380,201910,213,134,79,133732,79840,213572
410390,201910,376,269,107,268462,107784,376246
410395,201910,32,20,12,19960,11976,31936
410400,201910,824,397,427,397205.61,427579.5,824785.11
410405,201910,94,70,24,69860,23952,93812
410410,201910,32,25,7,24950,6986,31936
410420,201910,1647,787,860,788333.16,863270.34,1651603.50
410425,201910,170,77,93,77844.6,92814,170658.6
410430,201910,2208,1279,929,1277440,928141.46,2205581.46
410440,201910,374,274,100,273452,99800,373252
410442,201910,354,240,114,239520,113772,353292
410445,201910,419,301,118,302394.72,117764,420158.72
410450,201910,389,199,190,198602,189620,388222
410460,201910,475,252,223,251496,223552,475048
410465,201910,213,138,75,137724,74850,212574
410470,201910,232,148,84,148702,84830,233532
410480,201910,6069,3018,3051,3016964.77,3053890.41,6070855.18
410490,201910,1440,899,541,898200.84,539918.4,1438119.24
410500,201910,255,149,106,148702,106786,255488
410510,201910,170,127,43,126746,42914.98,169660.98
410520,201910,252,187,65,187624,64870,252494
410530,201910,242,92,150,91816,149700.99,241516.99
410540,201910,322,236,86,236526.99,85828,322354.99
410550,201910,1653,736,917,735527.23,921155.78,1656683.01
410560,201910,147,108,39,108782,38922,147704
410570,201910,438,299,139,298403.32,138722,437125.32
410580,201910,3382,1508,1874,1507980.19,1873247,3381227.19
410590,201910,406,284,122,283432,121756,405188
410600,201910,191,165,26,164670,25948,190618
410610,201910,56,46,10,45908,9980,55888
410620,201910,238,169,69,169660,68862,238522
410630,201910,442,258,184,257484,183632,441116
410640,201910,1010,640,370,640716.7,369260.99,1009977.69
410645,201910,107,80,27,79840.2,26946,106786.2
410650,201910,356,238,118,240518,118762,359280
410655,201910,84,62,22,61876,21956,83832
410657,201910,21,9,12,8982,11976,20958
410660,201910,605,426,179,427144.31,178642,605786.31
410670,201910,74,63,11,62874,10978,73852
410680,201910,207,170,37,169660,36926,206586
410685,201910,20,12,8,11976,7984,19960
410690,201910,28316,12168,16148,12163545.73,16164616.08,28328161.81
410700,201910,333,246,87,245508.4,86826,332334.4
410710,201910,125,103,22,102794,21956,124750
410712,201910,25,19,6,18962,5988,24950
410715,201910,87,67,20,66866,19960,86826
410720,201910,688,396,292,396206,291416.98,687622.98
410725,201910,187,135,52,135728.4,51896,187624.4
410730,201910,89,50,39,50898,38922.6,89820.6
410740,201910,112,81,31,80838,30938,111776
410750,201910,249,170,79,169660,78842,248502
410752,201910,25,15,10,14970,9980,24950
410753,201910,51,23,28,22954,27944,50898
410754,201910,45,26,19,25948.4,18962,44910.4
410755,201910,80,52,28,51896,27944,79840
410760,201910,752,424,328,424150.4,327344,751494.4
410765,201910,1722,821,901,822354.7,901195.2,1723549.9
410770,201910,109,86,23,85828,22954,108782
410773,201910,53,40,13,39920,12974,52894
410775,201910,188,139,49,138722,48902,187624
410780,201910,83,46,37,45908,36926,82834
410785,201910,55,44,11,43912,10978,54890
410790,201910,70,35,35,34930,34930,69860
410800,201910,281,177,104,176646,104790,281436
410810,201910,20,16,4,15968,3992.4,19960.4
410820,201910,178,131,47,131736,46906,178642
410830,201910,8510,3794,4716,3792404.76,4722545.29,8514950.05
410832,201910,105,75,30,74850,29940,104790
410840,201910,1416,800,616,798402.97,614770.46,1413173.43
410845,201910,66,43,23,42914,22954,65868
410850,201910,198,139,59,138722,58882,197604
410855,201910,54,44,10,43912,9980,53892
410860,201910,706,413,293,414170.4,293412,707582.4
410865,201910,101,77,24,76846,23952,100798
410870,201910,153,130,23,129740,22954,152694
410880,201910,1112,580,532,579843.7,531937.92,1111781.62
410890,201910,87,60,27,59880,26946,86826
410895,201910,73,57,16,56886,15968,72854
410900,201910,23,16,7,15968,6986,22954
410910,201910,15,13,2,12974,1996,14970
410920,201910,35,24,11,23952,10978,34930
410930,201910,500,322,178,324350,178642,502992
410940,201910,4382,2502,1880,2498993.84,1879234.8,4378228.64
410950,201910,108,82,26,81836,25948,107784
410960,201910,788,341,447,342314,447104,789418
410965,201910,65,52,13,51896,12974,64870
410970,201910,631,454,177,454090,177644,631734
410975,201910,120,72,48,71856.72,47904,119760.72
410980,201910,1642,753,889,752492.55,889218.99,1641711.54
410990,201910,265,185,80,185628,79840,265468
411000,201910,66,42,24,41916,23952.4,65868.4
411005,201910,27,23,4,22954,3992,26946
411007,201910,260,156,104,155688,104790,260478
411010,201910,603,418,185,417164,184630,601794
411020,201910,294,205,89,204590.74,88822,293412.74
411030,201910,16,9,7,8982,6986,15968
411040,201910,54,39,15,38922,14970,53892
411050,201910,211,165,46,164670,45908,210578
411060,201910,515,352,163,352294.98,162674,514968.98
411065,201910,62,53,9,52894,8982,61876
411070,201910,1252,783,469,783430.6,470058,1253488.6
411080,201910,230,164,66,163672,65868,229540
411090,201910,106,80,26,79840,25948,105788
411095,201910,278,112,166,112774,166666,279440
411100,201910,112,94,18,94810,17964,112774
411110,201910,124,83,41,82834,40918,123752
411120,201910,197,144,53,143712,52894,196606
411125,201910,224,100,124,99800,123752,223552
411130,201910,128,111,17,110778,16966,127744
411140,201910,211,141,70,140718,70858,211576
411150,201910,1241,826,415,830336,415168.63,1245504.63
411155,201910,125,84,41,83832,40918,124750
411160,201910,25,12,13,11976,12974,24950
411170,201910,49,45,4,44910,3992,48902
411180,201910,981,659,322,657682,322354,980036
411190,201910,334,194,140,193612,140718,334330
411200,201910,674,435,239,435128.63,240518,675646.63
411210,201910,701,382,319,381236,319360.98,700596.98
411220,201910,148,111,37,110778,36926,147704
411230,201910,41,35,6,34930,5988,40918
411240,201910,122,81,41,80838,40918,121756
411250,201910,438,323,115,322354,115768,438122
411260,201910,20,14,6,13972,5988,19960
411270,201910,275,146,129,147704,128742,276446
411275,201910,195,170,25,169660,25948,195608
411280,201910,219,155,64,155688.63,63872,219560.63
411290,201910,58,46,12,45908,11976,57884
411295,201910,142,112,30,111776,29940,141716
411300,201910,70,35,35,34930,34930,69860
411310,201910,90,70,20,70858,19960,90818
411320,201910,770,530,240,529938,240518.6,770456.6
411325,201910,62,42,20,42914,19960,62874
411330,201910,912,585,327,585826.5,326346.16,912172.66
411340,201910,25,19,6,18962,5988,24950
411342,201910,68,51,17,50898,16966,67864
411345,201910,118,59,59,58882,58882,117764
411350,201910,482,382,100,381236.58,99800.4,481036.98
411360,201910,56,36,20,35928,19960,55888
411370,201910,14214,5884,8330,5886209.99,8345290.85,14231500.84
411373,201910,178,130,48,129740,47904,177644
411375,201910,74,60,14,59880,13972,73852
411380,201910,94,70,24,69860,23952,93812
411390,201910,118,79,39,78842,38922,117764
411400,201910,360,277,83,276446.98,82834,359280.98
411410,201910,441,221,220,220558,220558.4,441116.4
411420,201910,1007,460,547,459080,547902,1006982
411430,201910,447,267,180,266466,179640.98,446106.98
411435,201910,33,21,12,21956,11976,33932
411440,201910,452,364,88,363272,88822,452094
411450,201910,419,353,66,352294,66866,419160
411460,201910,766,303,463,303392.2,462074.77,765466.97
411470,201910,88,65,23,64870,22954.8,87824.8
411480,201910,662,379,283,382234.4,283432,665666.4
411490,201910,289,187,102,186626,101796,288422
411500,201910,100,86,14,85828,13972,99800
411510,201910,224,177,47,176646,46906,223552
411520,201910,5959,2311,3648,2313366.79,3652685.92,5966052.71
411530,201910,122,86,36,85828,35928,121756
411535,201910,49,20,29,19960,28942,48902
411540,201910,351,241,110,241516,109780,351296
411545,201910,54,40,14,39920,13972,53892
411550,201910,74,58,16,57884,15968,73852
411560,201910,377,169,208,168662,207584,376246
411570,201910,807,299,508,299401.26,509978.6,809379.86
411573,201910,26,16,10,15968,9980,25948
411575,201910,288,184,104,183632,104790,288422
411580,201910,1248,487,761,486026,760476,1246502
411585,201910,75,37,38,36926,37924,74850
411590,201910,25,17,8,16966,7984,24950
411600,201910,24,10,14,9980,13972,23952
411605,201910,241,98,143,97804,142714,240518
411610,201910,208,141,67,140718,66866,207584
411620,201910,359,198,161,198602,160678,359280
411630,201910,57,38,19,37924,18962,56886
411640,201910,33,25,8,24950,7984,32934
411650,201910,12,7,5,6986,4990,11976
411660,201910,40,29,11,28942,10978,39920
411670,201910,241,180,61,179640,60878,240518
411680,201910,157,134,23,133732,22954,156686
411690,201910,597,322,275,321356,275448,596804
411695,201910,56,41,15,40918,14970,55888
411700,201910,138,116,22,115768,21956,137724
411705,201910,102,66,36,65868,36926,102794
411710,201910,305,208,97,207584,96806,304390
411720,201910,129,86,43,86826,44910,131736
411721,201910,63,53,10,52894,9980,62874
411722,201910,96,41,55,40918,56886,97804
411725,201910,159,124,35,123752.4,34930,158682.4
411727,201910,84,65,19,64870,18962,83832
411729,201910,40,32,8,31936,7984,39920
411730,201910,549,351,198,353292,198602,551894
411740,201910,40,26,14,26946,13972,40918
411745,201910,68,48,20,47904,19960,67864
411750,201910,864,401,463,400198.4,463072.4,863270.8
411760,201910,1189,896,293,894209.43,294410.98,1188620.41
411770,201910,457,305,152,304390,151696,456086
411780,201910,333,219,114,218562,114770.5,333332.5
411790,201910,523,296,227,295409.27,226546.98,521956.25
411800,201910,161,124,37,123752,36926,160678
411810,201910,170,129,41,128742,40918,169660
411820,201910,2167,996,1171,995007.4,1173648.6,2168656.0
411830,201910,12,12,0,11976,0,11976
411840,201910,1976,1243,733,1242510,734529.2,1977039.2
411845,201910,52,19,33,18962,32934,51896
411850,201910,1222,692,530,690617.39,529941.64,1220559.03
411860,201910,46,32,14,31936.4,13972,45908.4
411870,201910,74,52,22,51896,21956,73852
411880,201910,416,269,147,269460.57,146706,416166.57
411885,201910,103,69,34,68862,33932,102794
411890,201910,308,200,108,199601.79,108782,308383.79
411900,201910,75,55,20,54890.4,19960,74850.4
411910,201910,186,149,37,148702,36926,185628
411915,201910,2138,905,1233,903190,1234527.22,2137717.22
411920,201910,120,95,25,94810,24950,119760
411925,201910,11,7,4,6986,3992,10978
411930,201910,814,598,216,597802.74,215568,813370.74
411940,201910,590,406,184,405188.34,184630,589818.34
411950,201910,937,473,464,472054.4,464070,936124.4
411960,201910,1037,715,322,716564.9,321356,1037920.9
411965,201910,20,15,5,14970,5988,20958
411970,201910,81,74,7,73852,6986,80838
411980,201910,171,118,53,117764,52894,170658
411990,201910,5205,3031,2174,3028936.99,2176639.7,5205576.69
411995,201910,465,177,288,178642,289420,468062
412000,201910,306,198,108,197604,107784,305388
412010,201910,48,32,16,31936,15968,47904
412015,201910,41,29,12,28942,11976,40918
412020,201910,30,26,4,25948,3992,29940
412030,201910,47,43,4,43912,3992,47904
412033,201910,52,33,19,32934.44,18962,51896.44
412035,201910,66,44,22,43912,21956,65868
412040,201910,41,26,15,25948.4,14970,40918.4
412050,201910,203,158,45,157684,44910,202594
412060,201910,783,594,189,592812,188622,781434
412065,201910,50,32,18,31936.4,17964,49900.4
412070,201910,173,120,53,119760,54890,174650
412080,201910,275,144,131,144710,130738,275448
412085,201910,33,15,18,15968,17964,33932
412090,201910,799,508,291,507982.9,292414,800396.9
412100,201910,240,204,36,204590.8,36926,241516.8
412110,201910,66,52,14,52894,13972,66866
412120,201910,316,195,121,194610,120758,315368
412125,201910,85,50,35,49900,34930,84830
412130,201910,40,27,13,26946.36,12974,39920.36
412135,201910,28,17,11,16966,10978,27944
412140,201910,326,226,100,225548,99800,325348
412150,201910,256,171,85,170658,85828,256486
412160,201910,89,51,38,50898,37924,88822
412170,201910,692,485,207,485028.4,206586,691614.4
412175,201910,40,29,11,28942,10978,39920
412180,201910,188,149,39,148702.2,38922,187624.2
412190,201910,338,271,67,270458,66866,337324
412200,201910,192,120,72,119760,71856,191616
412210,201910,73,57,16,56886,15968,72854
412215,201910,223,159,64,158682,63872,222554
412217,201910,66,53,13,52894,12974,65868
412220,201910,825,606,219,604788,218562,823350
412230,201910,332,204,128,203592,127745.96,331337.96
412240,201910,1335,677,658,677642.9,661674.4,1339317.3
412250,201910,399,254,145,253492,144710,398202
412260,201910,108,78,30,77844,29940,107784
412265,201910,178,141,37,141716,36926,178642
412270,201910,87,59,28,58882,27944,86826
412280,201910,89,73,16,72854,15968,88822
412290,201910,94,66,28,65868,28942,94810
412300,201910,210,137,73,136726,73852,210578
412310,201910,48,41,7,40918,6986,47904
412320,201910,94,80,14,79840,13972,93812
412330,201910,190,163,27,162674,26946,189620
412340,201910,148,103,45,102794,44910.4,147704.4
412350,201910,611,300,311,299400,310378,609778
412360,201910,30,25,5,24950,4990,29940
412370,201910,161,141,20,141716.2,19960,161676.2
412380,201910,265,199,66,198602,65868.98,264470.98
412382,201910,55,28,27,27944,26946,54890
412385,201910,141,106,35,105788,34930,140718
412390,201910,279,215,64,214570,63872,278442
412395,201910,70,57,13,57884,12974,70858
412400,201910,84,56,28,55888,27944,83832
412402,201910,238,116,122,115768.4,121756,237524.4
412405,201910,844,319,525,319360,524948,844308
412410,201910,971,606,365,605786.4,364270,970056.4
412420,201910,12,10,2,9980,1996,11976
412430,201910,20,15,5,14970,4990,19960
412440,201910,609,334,275,335328,274450,609778
412450,201910,76,66,10,65868,9980,75848
412460,201910,90,68,22,67864,21956,89820
412470,201910,227,183,44,182634,43912,226546
412480,201910,147,108,39,108782.3,38922,147704.3
412490,201910,166,147,19,147704,19960,167664
412500,201910,442,365,77,365268.05,76846,442114.05
412510,201910,183,150,33,149700.4,32934,182634.4
412520,201910,88,57,31,56886,31936,88822
412530,201910,108,57,51,56886,50898,107784
412535,201910,94,69,25,68863.96,24950,93813.96
412540,201910,81,37,44,36926,43912,80838
412545,201910,91,66,25,65868,24950,90818
412550,201910,3736,1666,2070,1666660.4,2071848.8,3738509.2
412555,201910,13,9,4,8982,3992,12974
412560,201910,610,441,169,440119.2,169660.7,609779.9
412570,201910,737,395,342,394210,341316,735526
412575,201910,91,63,28,62874,27944,90818
412580,201910,173,117,56,116766,55888,172654
412590,201910,38,33,5,32934,4990,37924
412600,201910,166,124,42,123752.34,42914,166666.34
412610,201910,34,18,16,17964,15968,33932
412620,201910,149,127,22,126746,21956,148702
412625,201910,2178,1162,1016,1163669.53,1016964.73,2180634.26
412627,201910,69,53,16,52894,15968,68862
412630,201910,417,277,140,277444.6,139720,417164.6
412635,201910,65,17,48,16966,47904,64870
412640,201910,112,77,35,76846,34930,111776
412650,201910,350,225,125,224550,124750,349300
412660,201910,475,293,182,292414,181636,474050
412665,201910,49,44,5,43912,4990,48902
412667,201910,297,207,90,206586.44,89820,296406.44
412670,201910,64,54,10,53892,9980,63872
412680,201910,296,235,61,235528,60878.48,296406.48
412690,201910,104,70,34,69860,33932.4,103792.4
412700,201910,163,110,53,109780,52894.4,162674.4
412710,201910,1428,874,554,872254.2,553890,1426144.2
412720,201910,229,150,79,149700,78842,228542
412730,201910,192,161,31,160678,30938,191616
412740,201910,420,229,191,228542,190618,419160
412750,201910,453,263,190,263472,189620,453092
412760,201910,274,145,129,145708,128742,274450
412770,201910,2123,1180,943,1179637.86,943111.78,2122749.64
412780,201910,149,116,33,115768,32934,148702
412785,201910,265,135,130,134730,129740,264470
412788,201910,31,19,12,18962,11976,30938
412790,201910,131,111,20,110778,19960,130738
412795,201910,149,111,38,110778,38922,149700
412796,201910,327,215,112,214570,111776,326346
412800,201910,586,378,208,379240.5,208582.98,587823.48
412810,201910,2957,1640,1317,1641711.7,1318358,2960069.7
412820,201910,952,612,340,610777.9,341316.98,952094.88
412830,201910,14,11,3,10978,2994,13972
412840,201910,218,157,61,156686.4,60878,217564.4
412850,201910,778,512,266,511974,266466,778440
412853,201910,173,91,82,90818,81836.4,172654.4
412855,201910,205,111,94,110778.26,93812,204590.26
412860,201910,94,66,28,66866,27944,94810
412862,201910,58,44,14,43912,13972,57884
412863,201910,4,4,0,3992,0,3992
412865,201910,44,32,12,31936,11976,43912
412870,201910,112,70,42,70858,41916,112774
412880,201910,99,73,26,72854.4,26946,99800.4
420005,201910,42,38,4,37924,3992,41916
420010,201910,370,243,127,243512.3,126746.4,370258.7
420020,201910,84,73,11,72854,10978,83832
420030,201910,24,22,2,21956,1996,23952
420040,201910,107,84,23,84830,23952,108782
420050,201910,53,33,20,32934,19960,52894
420055,201910,20,20,0,19960,0,19960
420060,201910,31,24,7,23952,6986,30938
420070,201910,104,87,17,86826,16966,103792
420075,201910,12,12,0,11976,0,11976
420080,201910,42,37,5,36926,4990,41916
420090,201910,36,33,3,32934,2994,35928
420100,201910,152,131,21,130738.4,20958,151696.4
420110,201910,20,20,0,19960,0,19960
420120,201910,61,47,14,46906,13972,60878
420125,201910,86,68,18,67864,17964,85828
420127,201910,29,25,4,24950,4990,29940
420130,201910,409,255,154,254490,154690,409180
420140,201910,1309,727,582,726546.28,580836,1307382.28
420150,201910,46,40,6,39920,5988,45908
420160,201910,35,33,2,32934,1996,34930
420165,201910,17,12,5,11976,4990,16966
420170,201910,74,48,26,47904,25948,73852
420180,201910,22,20,2,19960,1996,21956
420190,201910,27,23,4,23952,4990,28942
420195,201910,130,66,64,65868,63872,129740
420200,201910,1290,575,715,574848.4,715571.48,1290419.88
420205,201910,73,43,30,42914,29940,72854
420207,201910,120,65,55,64870.5,54890,119760.5
420208,201910,19,15,4,14970,3992,18962
420209,201910,19,16,3,15968,2994,18962
420210,201910,488,241,247,241516,249500.98,491016.98
420213,201910,50,39,11,38922,10978,49900
420215,201910,27,24,3,23952,2994,26946
420220,201910,70,45,25,44910,24950,69860
420230,201910,817,468,349,468062.6,349301.97,817364.57
420240,201910,2274,1511,763,1510975.14,763470,2274445.14
420243,201910,42,33,9,32934,8982,41916
420245,201910,137,73,64,72854,63872,136726
420250,201910,63,40,23,39920,22954,62874
420253,201910,41,33,8,32934,7984,40918
420257,201910,13,11,2,10978,1996,12974
420260,201910,102,86,16,85828,15968,101796
420270,201910,39,30,9,29940.99,8982,38922.99
420280,201910,290,217,73,216569.64,72856.66,289426.30
420285,201910,22,12,10,11976,9980,21956
420287,201910,50,32,18,31936,17964,49900
420290,201910,1013,715,298,715567.39,297406.97,1012974.36
420300,201910,1443,1154,289,1151694.34,288422.98,1440117.32
420310,201910,44,30,14,29940,13972,43912
420315,201910,33,29,4,28942,3992,32934
420320,201910,882,448,434,448102.24,434130.99,882233.23
420325,201910,0,0,0,0,0,0
420330,201910,118,82,36,81836,35928,117764
420340,201910,159,106,53,105789.18,52894,158683.18
420350,201910,251,186,65,185628,64870,250498
420360,201910,762,586,176,586824.98,175650.46,762475.44
420370,201910,121,74,47,73852,46906.4,120758.4
420380,201910,1146,806,340,806385.48,340322.32,1146707.80
420390,201910,266,182,84,181636,83832,265468
420395,201910,189,136,53,135728,52894,188622
420400,201910,250,189,61,189620.75,60878,250498.75
420410,201910,63,47,16,46906,15968,62874
420415,201910,32,29,3,28942,2994,31936
420417,201910,51,40,11,40918,10978,51896
420419,201910,11,11,0,10978,0,10978
420420,201910,2821,1759,1062,1759479.37,1061875.3,2821354.67
420425,201910,73,60,13,59880,12974.98,72854.98
420430,201910,1218,866,352,866265.5,354290.98,1220556.48
420435,201910,16,14,2,13972,1996,15968
420440,201910,102,73,29,72854.4,28942,101796.4
420445,201910,22,21,1,20958,998,21956
420450,201910,77,38,39,38922,38922,77844
420455,201910,217,169,48,168664.94,48904.94,217569.88
420460,201910,2367,1551,816,1550898.32,815375.59,2366273.91
420470,201910,110,78,32,77844,31936,109780
420475,201910,7,7,0,6986,0,6986
420480,201910,873,662,211,661675.2,210578.8,872254.0
420490,201910,108,78,30,77844,30938,108782
420500,201910,535,252,283,251496.46,287424,538920.46
420510,201910,18,17,1,16966,998,17964
420515,201910,27,19,8,18962,7984,26946
420517,201910,11,10,1,9980,998,10978
420519,201910,0,0,0,0,0,0
420520,201910,74,56,18,55888,17964,73852
420530,201910,163,110,53,109780.3,52894,162674.3
420535,201910,20,18,2,17964,1996,19960
420540,201910,5459,3245,2214,3248748.84,2216560.96,5465309.80
420543,201910,26,25,1,24950,998,25948
420545,201910,205,147,58,147704.98,57884.98,205589.96
420550,201910,870,714,156,715568.74,158685.92,874254.66
420555,201910,37,27,10,27944,9980,37924
420560,201910,66,54,12,53892,11976,65868
420570,201910,156,93,63,93812,63872,157684
420580,201910,285,131,154,130738,153692.4,284430.4
420590,201910,528,363,165,363272,165668,528940
420600,201910,113,64,49,63872,48902,112774
420610,201910,41,38,3,37924,2994,40918
420620,201910,79,65,14,64870,13972,78842
420630,201910,155,112,43,112774.99,42915.98,155690.97
420640,201910,87,78,9,77844,8982,86826
420650,201910,238,125,113,125748,113772,239520
420660,201910,50,39,11,39920,10978,50898
420665,201910,36,27,9,26946,8982,35928
420670,201910,313,238,75,237524,74850.98,312374.98
420675,201910,16,15,1,14970,998,15968
420680,201910,38,28,10,27944,9980,37924
420690,201910,180,144,36,143712,35928,179640
420700,201910,704,487,217,488029.26,216573.84,704603.10
420710,201910,150,88,62,87824,61876,149700
420720,201910,110,89,21,88822.98,21956,110778.98
420730,201910,595,385,210,384234.14,209584.32,593818.46
420740,201910,50,49,1,48902,998,49900
420750,201910,518,356,162,356286,161676.98,517962.98
420757,201910,17,15,2,14970,1996,16966
420760,201910,35,30,5,29940,4990,34930
420765,201910,78,62,16,61876,15968,77844
420768,201910,50,46,4,46906,3992,50898
420770,201910,83,70,13,69860,12974,82834
420775,201910,44,41,3,40918,2994,43912
420780,201910,235,189,46,188622,45908,234530
420785,201910,11,9,2,8982,1996,10978
420790,201910,162,139,23,138724.94,22955.96,161680.90
420800,201910,63,49,14,48902,13972,62874
420810,201910,250,218,32,218562,31936,250498
420820,201910,2360,1372,988,1378240.58,986026.77,2364267.35
420830,201910,606,339,267,338323.4,268462,606785.4
420840,201910,148,110,38,109780,37924,147704
420845,201910,417,186,231,185628,230538.4,416166.4
420850,201910,249,195,54,194610,53892,248502
420860,201910,64,54,10,53892,9980,63872
420870,201910,124,89,35,88822,34930,123752
420880,201910,180,124,56,123752,55888.98,179640.98
420890,201910,937,475,462,475049.5,462074,937123.5
420895,201910,9,9,0,8982,0,8982
420900,201910,420,338,82,337324,81836.98,419160.98
420910,201910,5793,3268,2525,3270455.16,2525945.33,5796400.49
420915,201910,74,69,5,68862,4990,73852
420917,201910,20,14,6,13972,5988,19960
420920,201910,23,16,7,15968,6986,22954
420930,201910,2777,1745,1032,1746496.2,1033089.69,2779585.89
420940,201910,601,441,160,441117.2,159684.49,600801.69
420945,201910,9,7,2,7984,1996,9980
420950,201910,57,52,5,51896,4990,56886
420960,201910,112,88,24,87825.96,23952.98,111778.94
420970,201910,299,242,57,242518.92,58882.98,301401.90
420980,201910,22,21,1,20958,998,21956
420985,201910,61,55,6,54890,5988,60878
420990,201910,79,59,20,58882,19960,78842
421000,201910,35,21,14,20958,13972,34930
421003,201910,63,44,19,43912,18962.98,62874.98
421005,201910,6,3,3,2994,2994,5988
421010,201910,768,536,232,534928.4,234531.4,769459.8
421020,201910,25,20,5,19960,4990,24950
421030,201910,120,102,18,101796.3,17964,119760.3
421040,201910,72,55,17,54890,16966,71856
421050,201910,331,231,100,230538.8,99800,330338.8
421055,201910,22,18,4,17964,3992,21956
421060,201910,85,52,33,51896,32934,84830
421070,201910,49,44,5,43912.4,4990,48902.4
421080,201910,32,30,2,29940,1996,31936
421085,201910,25,19,6,18962,5988,24950
421090,201910,37,29,8,28942,7984,36926
421100,201910,124,93,31,92814,30938,123752
421105,201910,211,172,39,172654.98,38922.98,211577.96
421110,201910,109,88,21,87824,20958,108782
421120,201910,160,122,38,121756.98,37924,159680.98
421125,201910,17,12,5,11976,4990,16966
421130,201910,823,526,297,524948,296406.4,821354.4
421140,201910,30,22,8,21956,7984,29940
421145,201910,41,33,8,32934,7984,40918
421150,201910,105,78,27,77844,26946.8,104790.8
421160,201910,70,50,20,49900,19960,69860
421165,201910,17,16,1,15968,998,16966
421170,201910,186,156,30,155812.32,30938.98,186751.30
421175,201910,159,109,50,108782,49900,158682
421180,201910,55,35,20,34930.24,19960,54890.24
421185,201910,17,14,3,13972,2994,16966
421187,201910,0,0,0,0,0,0
421189,201910,43,31,12,30938,11976,42914
421190,201910,1632,1046,586,1046902,586824.03,1633726.03
421200,201910,87,66,21,65868,20958,86826
421205,201910,26,16,10,15968,9980,25948
421210,201910,171,120,51,119760,50898,170658
421220,201910,277,217,60,218562,59880,278442
421223,201910,49,39,10,39920.6,9980,49900.6
421225,201910,68,44,24,43912.6,23952,67864.6
421227,201910,85,66,19,65868,18962,84830
421230,201910,51,36,15,35928,14970,50898
421240,201910,19,19,0,18962,0,18962
421250,201910,361,221,140,221557.6,139720,361277.6
421260,201910,25,21,4,20958,3992,24950
421265,201910,2,1,1,998,998,1996
421270,201910,47,42,5,41916,4990,46906
421280,201910,339,193,146,193612,146706,340318
421290,201910,333,227,106,227544,106786,334330
421300,201910,25,20,5,19960,4990,24950
421310,201910,47,35,12,34930,11976,46906
421315,201910,31,20,11,19960,10978,30938
421320,201910,136,91,45,90818,44910,135728
421330,201910,106,79,27,78842,26946.98,105788.98
421335,201910,39,27,12,26946,11976,38922
421340,201910,244,158,86,157685.32,85828,243513.32
421350,201910,196,112,84,111776.97,84830,196606.97
421360,201910,656,492,164,492015.48,163673.92,655689.40
421370,201910,201,155,46,154690,45908,200598
421380,201910,129,102,27,101796,26946,128742
421390,201910,18,12,6,11976,5988,17964
421400,201910,122,103,19,102794,18962,121756
421410,201910,21,19,2,18962,1996,20958
421415,201910,21,19,2,18962,1996,20958
421420,201910,141,115,26,114770,25948,140718
421430,201910,16,12,4,11976,3992,15968
421440,201910,56,48,8,47904,7984,55888
421450,201910,96,80,16,79840,15968,95808
421460,201910,61,49,12,48902,11976,60878
421470,201910,70,46,24,45908,23952,69860
421480,201910,690,522,168,520956,167664.98,688620.98
421490,201910,24,23,1,22954.98,998,23952.98
421500,201910,496,324,172,323355.34,171671.68,495027.02
421505,201910,25,18,7,17964,6986,24950
421507,201910,30,23,7,22954,6986,29940
421510,201910,72,47,25,47904,25948,73852
421520,201910,56,47,9,46906,8982,55888
421530,201910,52,44,8,44910,7984,52894
421535,201910,26,25,1,24950.44,998,25948.44
421540,201910,56,48,8,47904,7984,55888
421545,201910,100,74,26,73852.98,25948,99800.98
421550,201910,288,208,80,207584,79840,287424
421555,201910,24,19,5,18962,4990,23952
421560,201910,9,8,1,7984,998,8982
421565,201910,128,90,38,89820,37924,127744
421567,201910,31,26,5,25948,4990,30938
421568,201910,29,26,3,25948,2994,28942
421569,201910,8,8,0,7984,0,7984
421570,201910,194,132,62,131736,61876,193612
421575,201910,29,24,5,23952,4990,28942
421580,201910,704,419,285,420223,284430,704653
421590,201910,21,20,1,19960,998,20958
421600,201910,153,99,54,98802,53892.8,152694.8
421605,201910,113,79,34,78842.3,33932,112774.3
421610,201910,190,147,43,146706.4,42914,189620.4
421620,201910,1047,624,423,622752.98,426146,1048898.98
421625,201910,23,20,3,19960,2994,22954
421630,201910,297,192,105,192614.9,104791.2,297406.1
421635,201910,18,9,9,8982,8982,17964
421640,201910,98,83,15,82834.6,14970,97804.6
421650,201910,308,184,124,183632,124750,308382
421660,201910,2226,1355,871,1355285.78,872256.73,2227542.51
421670,201910,186,137,49,136726,48902,185628
421680,201910,176,159,17,158682,16966,175648
421690,201910,347,254,93,253494.36,93813.42,347307.78
421700,201910,58,38,20,37924,19960.8,57884.8
421710,201910,26,25,1,24950,998,25948
421715,201910,7,7,0,6986,998,7984
421720,201910,607,441,166,440119.1,167664,607783.1
421725,201910,14,6,8,5988,7984,13972
421730,201910,36,26,10,25948,9980,35928
421740,201910,90,42,48,41916,48902,90818
421750,201910,213,160,53,161676,52894,214570
421755,201910,26,24,2,23952,1996,25948
421760,201910,101,71,30,70858,29940,100798
421770,201910,634,415,219,415178.54,218567.12,633745.66
421775,201910,30,18,12,17964,11976,29940
421780,201910,195,153,42,152694.4,41916,194610.4
421790,201910,155,134,21,133732,21956,155688
421795,201910,20,16,4,15968,3992,19960
421800,201910,512,331,181,331336,181636.5,512972.5
421810,201910,74,61,13,60878,12974,73852
421820,201910,337,228,109,227544.4,108782,336326.4
421825,201910,133,115,18,114770,17964,132734
421830,201910,135,99,36,99800,35928,135728
421835,201910,5,4,1,3992,998,4990
421840,201910,53,45,8,44910.98,7984,52894.98
421850,201910,80,69,11,68862,10978.99,79840.99
421860,201910,39,31,8,30938,7984,38922
421870,201910,1001,759,242,759505.34,241521.28,1001026.62
421875,201910,54,45,9,44910,8982,53892
421880,201910,168,122,46,121756,45908.4,167664.4
421885,201910,22,18,4,17964,3992,21956
421890,201910,129,92,37,91816,36926.98,128742.98
421895,201910,47,43,4,42914,3992,46906
421900,201910,162,128,34,127745.96,34933.92,162679.88
421910,201910,67,41,26,40918.21,25948,66866.21
421915,201910,32,27,5,26946,4990,31936
421917,201910,40,31,9,30938,8982,39920
421920,201910,39,36,3,35928,2994,38922
421930,201910,728,576,152,574848.65,152696.94,727545.59
421935,201910,51,44,7,43912,6986,50898
421940,201910,43,38,5,37924,4990,42914
421950,201910,864,585,279,587822.4,281437.58,869259.98
421960,201910,39,33,6,32934.4,5988,38922.4
421970,201910,360,238,122,237524.4,122754.98,360279.38
421985,201910,27,18,9,17964,8982,26946
422000,201910,0,0,0,0,0,0
430003,201910,194,54,140,53892,140718,194610
430005,201910,37,28,9,27944,8982,36926
430010,201910,271,193,78,192614,77844,270458
430020,201910,144,96,48,97804.4,48902,146706.4
430030,201910,128,103,25,102794,24950,127744
430040,201910,2957,1750,1207,1749497.14,1205586.34,2955083.48
430045,201910,69,57,12,56886,11976,68862
430047,201910,8,7,1,6986,998,7984
430050,201910,80,68,12,67864,11976,79840
430055,201910,14,12,2,11976,1996,13972
430057,201910,5,4,1,3992,998,4990
430060,201910,3726,2180,1546,2178636.68,1543908.72,3722545.40
430063,201910,55,51,4,50898,3992,54890
430064,201910,158,127,31,126746,30938,157684
430066,201910,5,3,2,2994,1996,4990
430070,201910,44,33,11,33932,10978,44910
430080,201910,68,47,21,46906,20958,67864
430085,201910,33,11,22,10978,21956,32934
430087,201910,30,23,7,22954.7,6986,29940.7
430090,201910,71,65,6,64870,5988,70858
430100,201910,122,83,39,82834,38922,121756
430105,201910,143,77,66,76846.6,65868,142714.6
430107,201910,19,14,5,13972,4990,18962
430110,201910,424,249,175,248502,175648,424150
430120,201910,145,135,10,134730,9980,144710
430130,201910,800,490,310,491016.4,311376,802392.4
430140,201910,125,118,7,117764,6986,124750
430150,201910,105,69,36,68862,36926,105788
430155,201910,34,31,3,30938,2994,33932
430160,201910,3682,2176,1506,2175642.7,1503986.4,3679629.1
430163,201910,347,162,185,161676,185628,347304
430165,201910,29,19,10,18962,10978,29940
430170,201910,93,79,14,79840,13972,93812
430175,201910,79,61,18,60878,17964,78842
430180,201910,104,86,18,85828,17964,103792
430185,201910,34,24,10,23952,9980,33932
430187,201910,86,39,47,38922,47904,86826
430190,201910,215,120,95,119760,94810,214570
430192,201910,13,11,2,10978,1996,12974
430195,201910,17,11,6,10978,5988,16966
430200,201910,164,142,22,141716,21956,163672
430205,201910,20,19,1,18962,998,19960
430210,201910,693,541,152,540916.4,152694.4,693610.8
430215,201910,14,12,2,11976,1996,13972
430220,201910,75,53,22,52894,21956,74850
430222,201910,12,6,6,5988,5988,11976
430223,201910,15,7,8,6986,7984,14970
430225,201910,2,1,1,998,998,1996
430230,201910,320,187,133,186626,132734,319360
430235,201910,54,41,13,40918,12974,53892
430237,201910,25,20,5,19960,4990,24950
430240,201910,126,81,45,81836,45908,127744
430245,201910,69,57,12,56886,11976,68862
430250,201910,192,114,78,113772,77844,191616
430258,201910,9,8,1,7984,998,8982
430260,201910,32,28,4,27944,3992,31936
430265,201910,35,31,4,30938,3992,34930
430270,201910,527,392,135,395208.3,134733.92,529942.22
430280,201910,1039,643,396,642712,397204,1039916
430290,201910,392,222,170,221556.6,170658,392214.6
430300,201910,2094,1167,927,1169657.98,929142.32,2098800.30
430310,201910,1946,991,955,990017,958083.52,1948100.52
430320,201910,54,43,11,42914,10978,53892
430330,201910,94,83,11,82834,10978,93812
430340,201910,71,60,11,59880,10978,70858
430350,201910,1675,1143,532,1142710.6,531934.98,1674645.58
430355,201910,22,19,3,19960,2994,22954
430360,201910,87,44,43,43912,42914,86826
430367,201910,33,24,9,23952,8982,32934
430370,201910,55,47,8,46906,7984,54890
430380,201910,141,105,36,104790,35928,140718
430390,201910,591,371,220,372254,222554,594808
430400,201910,138,105,33,105788.4,32934,138722.4
430410,201910,58,46,12,45908,11976,57884
430420,201910,506,336,170,335328.94,171656.98,506985.92
430430,201910,53,52,1,51231.33,998,52229.33
430435,201910,154,115,39,114770,38922,153692
430440,201910,509,340,169,342314.6,169660,511974.6
430450,201910,1173,967,206,966064,206586,1172650
430460,201910,5087,2748,2339,2749491.36,2339333.38,5088824.74
430461,201910,17,16,1,15968,998,16966
430462,201910,9,5,4,4990,3992,8982
430463,201910,1069,578,491,576844,495009.96,1071853.96
430465,201910,23,13,10,12974,9980,22954
430466,201910,688,488,200,488022.4,200598,688620.4
430467,201910,101,55,46,54890.6,45908,100798.6
430468,201910,115,68,47,67864,46906,114770
430469,201910,23,18,5,17964,4990,22954
430470,201910,1152,652,500,651991.95,502992,1154983.95
430471,201910,57,40,17,39920,16966,56886
430480,201910,102,64,38,63872,37924,101796
430485,201910,6,6,0,5988.4,0,5988.4
430490,201910,89,71,18,71856,17964,89820
430495,201910,35,27,8,26946,7984,34930
430500,201910,189,126,63,126746,62874.63,189620.63
430510,201910,3482,2295,1187,2297396.28,1186622,3484018.28
430511,201910,16,15,1,14970,998,15968
430512,201910,144,102,42,101796,41916,143712
430513,201910,50,40,10,39920,9980,49900
430515,201910,30,28,2,27944,1996,29940
430517,201910,170,151,19,150698,18962,169660
430520,201910,360,252,108,251496,107784,359280
430530,201910,82,46,36,46906,35928,82834
430535,201910,454,312,142,311376,141716.99,453092.99
430537,201910,10,10,0,9980,0,9980
430540,201910,81,55,26,55888,25948,81836
430543,201910,353,112,241,111776,240518,352294
430544,201910,43,40,3,39920,2994,42914
430545,201910,368,191,177,191616,177644,369260
430550,201910,42,35,7,34930,6986,41916
430558,201910,4,2,2,1996,1996,3992
430560,201910,56,30,26,29940,25948,55888
430570,201910,109,42,67,41916,66866,108782
430580,201910,128,105,23,104790,22954,127744
430583,201910,14,14,0,13972,0,13972
430585,201910,11,4,7,3992,6986,10978
430587,201910,15,7,8,6986,7984,14970
430590,201910,150,125,25,124750,25948,150698
430593,201910,2,2,0,1996,0,1996
430595,201910,17,14,3,13972,2994,16966
430597,201910,47,26,21,25948,20958,46906
430600,201910,220,159,61,158682,60878,219560
430605,201910,157,98,59,97804,58882,156686
430607,201910,20,17,3,16966,2994,19960
430610,201910,1608,762,846,761474,845307.38,1606781.38
430613,201910,3,3,0,2994,0,2994
430620,201910,113,79,34,78842,33932,112774
430630,201910,47,41,6,40918,5988,46906
430632,201910,32,27,5,26946,4990,31936
430635,201910,35,32,3,31936,2994,34930
430637,201910,54,29,25,28942,24950,53892
430640,201910,187,107,80,106786,80838,187624
430642,201910,21,19,2,18962,1996,20958
430645,201910,38,31,7,30938,6986,37924
430650,201910,251,202,49,202594.4,49900,252494.4
430655,201910,2,2,0,1996,0,1996
430660,201910,983,488,495,487024,495008.4,982032.4
430670,201910,75,51,24,50898,23952,74850
430673,201910,74,43,31,42914,30938,73852
430675,201910,12,9,3,8982,2994,11976
430676,201910,501,302,199,302394,198602,500996
430680,201910,242,169,73,168662.8,73852,242514.8
430690,201910,541,339,202,340318.98,203592.63,543911.61
430692,201910,7,5,2,4990,1996,6986
430693,201910,140,94,46,93812,45908,139720
430695,201910,72,60,12,59880,11976,71856
430697,201910,57,36,21,35928,20958,56886
430700,201910,1540,1072,468,1073849.16,469060,1542909.16
430705,201910,20,19,1,18962,998,19960
430710,201910,260,167,93,166666,93812,260478
430720,201910,105,89,16,89820,15968,105788
430730,201910,137,118,19,117764,18962,136726
430740,201910,73,49,24,48902,23952,72854
430745,201910,32,25,7,24950,6986,31936
430750,201910,334,219,115,222554,114770,337324
430755,201910,83,46,37,47904,36926,84830
430760,201910,369,216,153,215569.04,152694.98,368264.02
430770,201910,1441,757,684,758481.3,683632.96,1442114.26
430780,201910,305,193,112,194610.98,111776.98,306387.96
430781,201910,27,23,4,22954,3992,26946
430783,201910,56,45,11,45908,10978,56886
430786,201910,6,4,2,3992,1996,5988
430790,201910,531,352,179,353292,178642.4,531934.4
430800,201910,160,134,26,133732.38,25948,159680.38
430805,201910,40,37,3,36926,2994,39920
430807,201910,45,25,20,24950,19960,44910
430810,201910,76,50,26,49900,25948,75848
430820,201910,145,86,59,85828,58882,144710
430825,201910,10,8,2,7984,1996,9980
430830,201910,238,221,17,221556.4,16966,238522.4
430840,201910,129,88,41,87824,40918,128742
430843,201910,7,4,3,3992,2994,6986
430845,201910,74,43,31,42914,30938,73852
430850,201910,591,414,177,414170,178644.94,592814.94
430860,201910,168,106,62,106786,61876,168662
430865,201910,72,40,32,39920,32934.98,72854.98
430870,201910,77,63,14,62874,13972,76846
430880,201910,154,116,38,115768,37924,153692
430885,201910,10,8,2,7984,1996,9980
430890,201910,353,215,138,215568,137724,353292
430900,201910,523,365,158,364769,157684,522453
430905,201910,113,51,62,50898,61876,112774
430910,201910,285,157,128,156686,127744.98,284430.98
430912,201910,5,5,0,4990,0,4990
430915,201910,35,30,5,29940,4990,34930
430920,201910,4218,2312,1906,2315361.8,1909176.67,4224538.47
430925,201910,4,3,1,2994,998,3992
430930,201910,2051,1200,851,1198599.9,850297.98,2048897.88
430940,201910,262,172,90,172654,89820,262474
430950,201910,151,124,27,123752,26946,150698
430955,201910,24,13,11,12974,10978,23952
430957,201910,16,15,1,14970,998,15968
430960,201910,246,162,84,162674,83832,246506
430965,201910,114,74,40,73852,39920,113772
430970,201910,81,68,13,67864,12974,80838
430975,201910,42,38,4,37924,3992,41916
430980,201910,45,29,16,28942,15968,44910
430990,201910,115,89,26,88822,25948,114770
430995,201910,120,114,6,113772,5988,119760
431000,201910,307,139,168,138723,167664,306387
431010,201910,348,202,146,201596,145708,347304
431020,201910,1899,1104,795,1106782.6,794408,1901190.6
431030,201910,42,33,9,32934,8982,41916
431033,201910,383,191,192,190618,191616,382234
431036,201910,13,8,5,7984,4990,12974
431040,201910,136,83,53,82834,52894,135728
431041,201910,39,27,12,26946.4,11976,38922.4
431043,201910,49,28,21,27944,20958,48902
431046,201910,11,7,4,6986,3992,10978
431050,201910,196,125,71,125748,70858,196606
431053,201910,73,43,30,42914,29940,72854
431055,201910,64,45,19,45908,18962,64870
431057,201910,18,18,0,17964,0,17964
431060,201910,1646,1055,591,1057882.35,592827.4,1650709.75
431065,201910,20,12,8,11976,7984,19960
431070,201910,64,58,6,57884,5988,63872
431075,201910,7,7,0,6986,0,6986
431080,201910,131,78,53,77844,52894,130738
431085,201910,34,29,5,28942,4990,33932
431087,201910,15,12,3,11976,2994,14970
431090,201910,57,45,12,44910,11976,56886
431100,201910,1212,725,487,724550.02,493012,1217562.02
431110,201910,236,145,91,145708,91816.4,237524.4
431112,201910,25,14,11,13972,10978,24950
431113,201910,34,25,9,24950,8982,33932
431115,201910,155,109,46,108782,45908,154690
431120,201910,599,362,237,362274.6,238522.96,600797.56
431123,201910,3,2,1,1996,998,2994
431125,201910,95,86,9,86826,8982,95808
431127,201910,9,4,5,3992,4990,8982
431130,201910,700,455,245,454090,245508,699598
431140,201910,753,525,228,527942.4,229540,757482.4
431142,201910,32,26,6,25948.95,5988,31936.95
431150,201910,193,148,45,147704,44910,192614
431160,201910,54,49,5,48902,4990,53892
431162,201910,11,9,2,8982,1996,10978
431164,201910,6,6,0,5988,0,5988
431170,201910,111,87,24,86826,23952,110778
431171,201910,67,41,26,40918,25948,66866
431173,201910,2,2,0,1996,0,1996
431175,201910,199,103,96,102794.4,95808,198602.4
431177,201910,77,57,20,56886,19960,76846
431179,201910,14,12,2,11976,1996,13972
431180,201910,454,279,175,278442,175648.98,454090.98
431190,201910,81,62,19,61876,18962,80838
431198,201910,69,48,21,47904,20958,68862
431200,201910,21,17,4,16966,3992,20958
431205,201910,22,22,0,21956,0,21956
431210,201910,91,56,35,55888,34930,90818
431213,201910,32,28,4,27944,3992,31936
431215,201910,23,20,3,19960,2994,22954
431217,201910,4,3,1,3992,998,4990
431220,201910,69,60,9,60878,8982,69860
431225,201910,145,96,49,95808.98,48902,144710.98
431230,201910,106,94,12,93812,11976,105788
431235,201910,8,8,0,7984,0,7984
431237,201910,21,15,6,14970,5988,20958
431238,201910,10,7,3,6986.4,2994,9980.4
431240,201910,980,628,352,628740.2,355288,984028.2
431242,201910,38,37,1,36926,998,37924
431244,201910,13,9,4,8982,3992,12974
431245,201910,53,39,14,38922,13972,52894
431247,201910,11,8,3,7984,2994,10978
431250,201910,276,144,132,143712,131736,275448
431260,201910,59,45,14,44910,13972,58882
431261,201910,17,10,7,9980,6986,16966
431262,201910,19,18,1,17964,998,18962
431265,201910,147,81,66,80838,65868,146706
431267,201910,14,13,1,12974,998,13972
431270,201910,327,269,58,268462,57884,326346
431275,201910,39,36,3,35928,2994,38922
431280,201910,20,16,4,15968,3992,19960
431290,201910,23,20,3,19960,3992,23952
431295,201910,3,3,0,2994,0,2994
431300,201910,23,20,3,19960,2994,22954
431301,201910,6,6,0,5988,0,5988
431303,201910,59,39,20,38922,19960,58882
431306,201910,238,127,111,127566.35,110778,238344.35
431308,201910,7,5,2,4990,1996,6986
431310,201910,66,55,11,54890,10978,65868
431320,201910,148,89,59,88822,59880,148702
431330,201910,174,114,60,114770,61876,176646
431333,201910,28,24,4,23952,3992,27944
431335,201910,9,5,4,4990,3992,8982
431337,201910,334,151,183,150698,184630,335328
431339,201910,20,17,3,16966,2994,19960
431340,201910,2995,1684,1311,1686545.31,1311388.2,2997933.51
431342,201910,38,23,15,22954,15968,38922
431344,201910,18,18,0,17964,0,17964
431346,201910,5,5,0,4990,0,4990
431349,201910,36,32,4,31936,3992,35928
431350,201910,924,547,377,548901.48,380238.4,929139.88
431360,201910,46,41,5,40918,4990,45908
431365,201910,326,160,166,159680,165668,325348
431370,201910,1325,777,548,777442.4,547906.9,1325349.3
431380,201910,98,84,14,83832,13972,97804
431390,201910,511,280,231,279440,231536,510976
431395,201910,295,134,161,133732,160678,294410
431400,201910,43,30,13,29940,12974,42914
431402,201910,101,72,29,71856,28942,100798
431403,201910,23,13,10,12974,9980,22954
431405,201910,668,364,304,363272.15,303393.96,666666.11
431406,201910,30,25,5,24950,4990,29940
431407,201910,51,40,11,40918,10978,51896
431410,201910,3434,2119,1315,2120751.4,1316362.3,3437113.7
431413,201910,15,12,3,11976,2994,14970
431415,201910,71,54,17,53892,16966,70858
431417,201910,21,12,9,11976,8982,20958
431420,201910,318,217,101,216566,100798,317364
431430,201910,50,24,26,23952,25948,49900
431440,201910,8908,6264,2644,6265453.74,2647696.16,8913149.90
431442,201910,27,15,12,15968,11976,27944
431445,201910,23,21,2,21956,2994,24950
431446,201910,4,4,0,3992,0,3992
431447,201910,85,61,24,60878,23952,84830
431449,201910,55,47,8,46906,7984,54890
431450,201910,418,280,138,280438,138722,419160
431454,201910,0,0,0,0,0,0
431455,201910,54,41,13,40918,12974,53892
431460,201910,520,362,158,361276,158682,519958
431470,201910,119,93,26,92814,25948,118762
431475,201910,10,9,1,8982,998,9980
431477,201910,39,26,13,25948,12974,38922
431478,201910,8,7,1,6986,998,7984
431480,201910,486,303,183,304390,183632,488022
431490,201910,28767,16244,12523,16253443.74,12545877.05,28799320.79
431500,201910,80,60,20,59880.5,19960,79840.5
431505,201910,27,17,10,16966,9980,26946
431507,201910,12,9,3,8982,2994,11976
431510,201910,258,181,77,180638.1,76846,257484.1
431513,201910,25,22,3,21956,2994,24950
431514,201910,6,5,1,4990,998,5988
431515,201910,82,69,13,68862,12974,81836
431517,201910,5,4,1,3992,998,4990
431520,201910,38,33,5,32934,4990,37924
431530,201910,1520,685,835,684628,834328,1518956
431531,201910,25,23,2,22954,1996,24950
431532,201910,31,23,8,22954,7984,30938
431535,201910,26,16,10,15968,9980,25948
431540,201910,143,118,25,118762,24950,143712
431545,201910,13,11,2,10978,1996,12974
431550,201910,353,200,153,200598,152694,353292
431555,201910,12,12,0,11976,0,11976
431560,201910,4543,3144,1399,3147696.77,1399196.77,4546893.54
431570,201910,815,436,379,436126.8,378242,814368.8
431575,201910,41,23,18,22954,17964,40918
431580,201910,102,70,32,69860,31936,101796
431590,201910,148,126,22,125748,21956,147704
431595,201910,19,16,3,15968,2994,18962
431600,201910,230,129,101,129740,100798,230538
431610,201910,121,88,33,87824,32934,120758
431620,201910,45,37,8,36926,7984,44910
431630,201910,125,104,21,103792,20958,124750
431640,201910,1341,854,487,852292.4,486026.4,1338318.8
431642,201910,36,33,3,32934,2994,35928
431643,201910,43,21,22,20958,21956,42914
431645,201910,326,192,134,191616,133732,325348
431647,201910,10,10,0,9980,0,9980
431650,201910,33,23,10,22954,9980,32934
431660,201910,319,204,115,204590,114770,319360
431670,201910,234,108,126,108782,125748,234530
431673,201910,3,3,0,2994,0,2994
431675,201910,26,21,5,20958,4990,25948
431680,201910,1123,832,291,832332,292414,1124746
431690,201910,4760,2897,1863,2898227.3,1866265.46,4764492.76
431695,201910,21,16,5,15968,4990,20958
431697,201910,0,0,0,0,0,0
431700,201910,172,137,35,136726,34930,171656
431710,201910,4024,1795,2229,1795403.58,2236528.78,4031932.36
431720,201910,1340,821,519,820356.6,519958.99,1340315.59
431725,201910,1,1,0,998,0,998
431730,201910,1171,800,371,798402.16,372254,1170656.16
431740,201910,1365,678,687,676644,689622.32,1366266.32
431750,201910,1831,1200,631,1199597.71,630736.98,1830334.69
431755,201910,5,4,1,3992,998,4990
431760,201910,1022,661,361,661675.8,362274,1023949.8
431770,201910,409,299,110,298402,109780,408182
431775,201910,30,22,8,21956,7984,29940
431780,201910,551,344,207,344310,206586,550896
431790,201910,170,131,39,130738,38922,169660
431795,201910,12,10,2,9980,1996,11976
431800,201910,3304,1743,1561,1742521,1562957.98,3305478.98
431805,201910,19,17,2,16966,1996,18962
431810,201910,604,407,197,408182,196606.98,604788.98
431820,201910,325,188,137,187624,136726,324350
431830,201910,2346,1420,926,1421152,925148.95,2346300.95
431840,201910,490,328,162,327344.6,162674,490018.6
431842,201910,36,29,7,28942,6986,35928
431843,201910,11,8,3,7984,2994,10978
431844,201910,16,14,2,13972,1996,15968
431845,201910,26,24,2,23952,1996,25948
431846,201910,27,23,4,22954,4990,27944
431848,201910,13,11,2,10978,1996,12974
431849,201910,10,7,3,6986,2994,9980
431850,201910,798,655,143,655686,142714,798400
431860,201910,112,77,35,76846,34930,111776
431861,201910,4,2,2,1996,1996,3992
431862,201910,52,35,17,34930,16966,51896
431870,201910,3424,2008,1416,2008976.58,1417166.86,3426143.44
431880,201910,929,684,245,682632,244510,927142
431890,201910,1292,790,502,790416,501994,1292410
431900,201910,186,135,51,134730,50898,185628
431910,201910,56,39,17,38922,16966,55888
431912,201910,39,23,16,22954,15968,38922
431915,201910,126,100,26,99800,25948,125748
431920,201910,156,116,40,115768,39920,155688
431930,201910,78,64,14,64870,13972,78842
431935,201910,3,3,0,2994,0,2994
431936,201910,12,11,1,10978,998,11976
431937,201910,19,14,5,13972,4990,18962
431940,201910,465,313,152,312374,153692.5,466066.5
431950,201910,509,317,192,316367.38,191616.98,507984.36
431960,201910,729,402,327,404191.38,327344.98,731536.36
431970,201910,73,65,8,64870.4,7984,72854.4
431971,201910,3,3,0,2994,0,2994
431973,201910,21,17,4,16966,3992,20958
431975,201910,8,7,1,6986,998,7984
431980,201910,211,133,78,133732,77844,211576
431990,201910,1183,632,551,632667.71,549899.96,1182567.67
432000,201910,1667,902,765,904191,766467.1,1670658.1
432010,201910,280,191,89,190618,88822,279440
432020,201910,175,143,32,142714,31936,174650
432023,201910,15,13,2,12974,1996,14970
432026,201910,69,64,5,63872,4990,68862
432030,201910,69,35,34,34930,33932,68862
432032,201910,21,16,5,15968,4990,20958
432035,201910,53,44,9,43912,8982,52894
432040,201910,101,69,32,69860,31936,101796
432045,201910,5,4,1,3992,998,4990
432050,201910,83,51,32,50898,31936,82834
432055,201910,118,89,29,88822,28942,117764
432057,201910,5,4,1,3992.4,998,4990.4
432060,201910,34,31,3,30938,2994,33932
432065,201910,31,27,4,26946,3992,30938
432067,201910,88,79,9,78842,8982,87824
432070,201910,398,306,92,307634.8,92814.98,400449.78
432080,201910,826,577,249,575846,249500,825346
432085,201910,12,9,3,8982,2994,11976
432090,201910,266,176,90,175648,90818,266466
432100,201910,178,118,60,117764,59880,177644
432110,201910,589,393,196,392214,195608,587822
432120,201910,932,567,365,568860,365268,934128
432130,201910,497,360,137,359280,136726,496006
432132,201910,24,21,3,20958,2994,23952
432135,201910,78,65,13,64870,12974,77844
432140,201910,259,207,52,207584,51896,259480
432143,201910,201,131,70,130738,69860,200598
432145,201910,275,191,84,190618,84830,275448
432146,201910,13,13,0,12974,0,12974
432147,201910,113,59,54,58882,54890,113772
432149,201910,13,9,4,8982,3992,12974
432150,201910,842,521,321,521954.4,321357.55,843311.95
432160,201910,1435,745,690,746505.57,690616.98,1437122.55
432162,201910,4,3,1,2994,998,3992
432163,201910,19,14,5,13972,4990,18962
432166,201910,113,84,29,84082.4,28942,113024.4
432170,201910,226,115,111,114770,110778,225548
432180,201910,541,337,204,336326,204590.4,540916.4
432183,201910,7,7,0,6986,0,6986
432185,201910,78,69,9,68862,8982,77844
432190,201910,479,281,198,282434,199600.98,482034.98
432195,201910,85,72,13,71856,12974,84830
432200,201910,393,255,138,255488,138722.98,394210.98
432210,201910,118,74,44,73852,43912,117764
432215,201910,48,44,4,44910,3992,48902
432218,201910,21,20,1,19960,998,20958
432220,201910,678,355,323,354290,322356.57,676646.57
432225,201910,13,8,5,7984,4990,12974
432230,201910,144,98,46,97804,45908,143712
432232,201910,14,13,1,12974,998,13972
432234,201910,4,3,1,2994,998,3992
432235,201910,3,3,0,2994,0,2994
432237,201910,27,15,12,14970,11976,26946
432240,201910,4372,2469,1903,2469053.2,1904186.58,4373239.78
432250,201910,1094,705,389,704588,392214,1096802
432252,201910,44,40,4,39920,3992,43912
432253,201910,62,50,12,49900,11976,61876
432254,201910,28,13,15,12974,14970,27944
432255,201910,12,11,1,10978,998,11976
432260,201910,838,663,175,661674.4,174650,836324.4
432270,201910,244,183,61,182634,60878,243512
432280,201910,145,109,36,108782.6,35928,144710.6
432285,201910,2,2,0,1996,0,1996
432290,201910,65,58,7,57884,6986,64870
432300,201910,4647,2602,2045,2598096.46,2042908.24,4641004.70
432310,201910,121,100,21,99800,20958,120758
432320,201910,23,17,6,16966,5988,22954
432330,201910,16,12,4,11976,3992,15968
432335,201910,7,6,1,5988,998,6986
432340,201910,40,35,5,34930,4990,39920
432345,201910,100,69,31,68862,30938,99800
432350,201910,25,24,1,23952,998,24950
432360,201910,7,5,2,4990,1996,6986
432370,201910,26,25,1,24950,998,25948
432375,201910,33,30,3,29940,2994,32934
432377,201910,9,9,0,8982,0,8982
432380,201910,166,81,85,80838,84830,165668
500020,201910,241,138,103,137724,103792,241516
500025,201910,127,65,62,64870,61876,126746
500060,201910,1447,911,536,909178,534929.38,1444107.38
500070,201910,807,389,418,388222.96,418162,806384.96
500080,201910,130,105,25,104790,24950,129740
500085,201910,135,109,26,108782.4,25948,134730.4
500090,201910,324,156,168,159680,169660,329340
500100,201910,727,386,341,385228,341316.8,726544.8
500110,201910,2287,1068,1219,1066867.71,1218569.1,2285436.81
500124,201910,261,151,110,150698,109780,260478
500150,201910,324,141,183,140718,183634.94,324352.94
500190,201910,526,365,161,365268,161676.4,526944.4
500200,201910,186,163,23,162674.28,22954,185628.28
500210,201910,1490,537,953,535931.88,952133.06,1488064.94
500215,201910,245,144,101,143712,100798,244510
500220,201910,752,492,260,492017.72,259480,751497.72
500230,201910,249,165,84,164670,83832,248502
500240,201910,680,474,206,473052.36,206586,679638.36
500260,201910,585,227,358,226546,358282,584828
500270,201910,29529,12847,16682,12845232.25,16691732.77,29536965.02
500280,201910,193,72,121,71856,120758,192614
500290,201910,1182,716,466,716564.4,467064.98,1183629.38
500295,201910,447,289,158,288422.4,158682,447104.4
500310,201910,67,24,43,23952,42914,66866
500315,201910,718,436,282,436126,285428,721554
500320,201910,3685,1858,1827,1855283.75,1823351.88,3678635.63
500325,201910,930,515,415,514969.38,415168.4,930137.78
500330,201910,1446,685,761,683630.4,760476.98,1444107.38
500345,201910,306,236,70,235529.38,70858,306387.38
500348,201910,245,150,95,150698,94810,245508
500350,201910,125,60,65,60878,64870,125748
500370,201910,5475,2486,2989,2489014.48,2991012.9,5480027.38
500375,201910,340,250,90,250498,89820,340318
500380,201910,592,343,249,342314,249500,591814
500390,201910,73,34,39,33932,38922,72854
500400,201910,209,147,62,146706,61876.98,208582.98
500410,201910,548,228,320,227546.95,320363.87,547910.82
500430,201910,515,369,146,369260,148702,517962
500440,201910,198,106,92,105788,91816,197604
500450,201910,398,179,219,179640,218562,398202
500460,201910,293,152,141,151696,141716,293412
500470,201910,437,349,88,350299.39,89820.98,440120.37
500480,201910,104,62,42,61876,43912,105788
500490,201910,112,48,64,47904,63872,111776
500500,201910,1429,527,902,525955.83,902223.51,1428179.34
500510,201910,43,33,10,32934,9980.98,42914.98
500515,201910,109,76,33,75848,32934,108782
500520,201910,333,186,147,185628.8,146707.39,332336.19
500525,201910,91,49,42,48902,41916,90818
500540,201910,900,389,511,388222.98,510977.96,899200.94
500560,201910,916,530,386,528940,386226.4,915166.4
500568,201910,980,566,414,564868,415168.4,980036.4
500570,201910,1191,695,496,695628.56,499052.92,1194681.48
500580,201910,335,174,161,173652,160679.97,334331.97
500600,201910,321,167,154,167664,154691.96,322355.96
500620,201910,909,645,264,645706,264470,910176
500625,201910,74,63,11,63872,10978,74850
500627,201910,22,11,11,10978,10978,21956
500630,201910,1576,861,715,860276.9,716564,1576840.9
500635,201910,519,307,212,306386,212574,518960
500640,201910,401,212,189,212574.8,188622,401196.8
500660,201910,5438,2070,3368,2069852.4,3372244.18,5442096.58
500690,201910,575,208,367,207593.78,368285.52,575879.30
500710,201910,389,200,189,199600,188623.96,388223.96
500720,201910,959,563,396,563870.43,395208,959078.43
500730,201910,190,117,73,116766,72854,189620
500740,201910,868,376,492,377249.35,491044.69,868294.04
500750,201910,149,47,102,46906,101796.98,148702.98
500755,201910,123,87,36,87824.4,35928,123752.4
500769,201910,740,417,323,417166.37,323353.97,740520.34
500770,201910,415,216,199,215568,198602,414170
500780,201910,159,108,51,107784,50898,158682
500790,201910,1072,555,517,556884,516968.91,1073852.91
500793,201910,274,156,118,156686,117765.38,274451.38
500795,201910,166,120,46,119760,45908.98,165668.98
500797,201910,51,38,13,37924,12974,50898
500800,201910,424,193,231,193612.98,231536,425148.98
500830,201910,2240,1267,973,1265464.6,975047.01,2240511.61
500840,201910,139,104,35,103792,34930.98,138722.98
510010,201910,166,92,74,91816,73852,165668
510020,201910,488,224,264,224567.64,263502.38,488070.02
510025,201910,1699,976,723,975057.13,724564.08,1699621.21
510030,201910,663,348,315,347306.94,317367.35,664674.29
510035,201910,130,61,69,60879.96,68862.98,129742.94
510040,201910,385,176,209,175648,209582.68,385230.68
510050,201910,389,215,174,214576.84,174656.32,389233.16
510060,201910,113,58,55,57884,54890,112774
510080,201910,227,90,137,89821.96,136726.98,226548.94
510100,201910,70,32,38,31936,38922,70858
510120,201910,39,24,15,23952,14970,38922
510125,201910,384,240,144,239520.98,143713.97,383234.95
510130,201910,569,330,239,329348.82,239530.18,568879.00
510140,201910,406,122,284,123752,285428,409180
510160,201910,103,39,64,38922,63872,102794
510170,201910,825,505,320,505002.88,321370.68,826373.56
510180,201910,2885,1394,1491,1394249.41,1490048.1,2884297.51
510185,201910,14,6,8,5988,7984,13972
510190,201910,220,77,143,76846,142714,219560
510250,201910,2566,1523,1043,1522955.26,1044909.34,2567864.60
510260,201910,177,131,46,131750.7,45908.98,177659.68
510263,201910,465,268,197,269463.74,196606.98,466070.72
510267,201910,681,382,299,381250.32,298423.54,679673.86
510268,201910,61,29,32,28942,31936,60878
510269,201910,72,33,39,33932.98,38922,72854.98
510270,201910,393,200,193,199603.92,192618.9,392222.82
510279,201910,221,164,57,163674.94,56886.4,220561.34
510285,201910,180,74,106,73852.98,105788,179640.98
510300,201910,509,281,228,282438.92,228548.86,510987.78
510305,201910,205,100,105,99801.97,104790.98,204592.95
510310,201910,103,56,47,55888,46906,102794
510320,201910,845,539,306,537927.88,308395.73,846323.61
510325,201910,403,170,233,169660,233532,403192
510330,201910,424,240,184,239520.99,183632,423152.99
510335,201910,625,360,265,360280.95,264475.88,624756.83
510336,201910,52,39,13,38922,12974,51896
510337,201910,109,45,64,44910,63872,108782
510340,201910,17178,8058,9120,8054084.96,9122034.77,17176119.73
510343,201910,63,44,19,43912,18962,62874
510345,201910,168,110,58,110778,57884.4,168662.4
510350,201910,646,365,281,366270.9,281440.32,647711.22
510360,201910,197,124,73,123752.98,72859.88,196612.86
510370,201910,141,72,69,71856,68864.94,140720.94
510380,201910,89,64,25,63872,24950.98,88822.98
510385,201910,59,25,34,24950,33932.98,58882.98
510390,201910,110,49,61,48902,61876,110778
510395,201910,47,34,13,33932,12974,46906
510410,201910,699,466,233,465069.98,234531.96,699601.94
510420,201910,566,280,286,280457.56,285455.32,565912.88
510450,201910,50,27,23,26946,22954,49900
510452,201910,48,26,22,25948,21956,47904
510454,201910,52,24,28,23952,27944,51896
510455,201910,128,78,50,78842,49900,128742
510460,201910,172,90,82,89821.68,82834.98,172656.66
510480,201910,733,430,303,432141.12,303403.66,735544.78
510490,201910,351,185,166,184635.84,166668.9,351304.74
510500,201910,238,179,59,178642,59880,238522
510510,201910,804,477,327,477047.34,331336,808383.34
510515,201910,1173,636,537,636729.88,542912.98,1179642.86
510517,201910,256,108,148,107784,148702.98,256486.98
510520,201910,230,152,78,151698.94,77848.88,229547.82
510523,201910,96,73,23,72854,22954,95808
510525,201910,811,481,330,480042.91,329344.9,809387.81
510530,201910,18,13,5,12974,4990,17964
510550,201910,253,113,140,112774.98,139720,252494.98
510558,201910,285,139,146,138722.98,145708,284430.98
510560,201910,409,246,163,245508.4,163673.96,409182.36
510562,201910,654,472,182,471056,181636,652692
510590,201910,754,394,360,393212.98,359282.95,752495.93
510600,201910,246,136,110,135728,109781.96,245509.96
510610,201910,178,81,97,80838,97804,178642
510615,201910,195,82,113,81836,113772,195608
510617,201910,19,12,7,11976,6986,18962
510618,201910,118,58,60,57884,59880,117764
510619,201910,101,70,31,69860.98,30938.98,100799.96
510620,201910,169,92,77,92814,76846,169660
510621,201910,187,122,65,121756.98,64871.96,186628.94
510622,201910,497,316,181,316372.86,180639.96,497012.82
510623,201910,343,235,108,234531.96,107784,342315.96
510624,201910,94,47,47,46906.98,46906,93812.98
510625,201910,540,334,206,335343.68,207596.37,542940.05
510626,201910,113,71,42,70858.98,41916,112774.98
510627,201910,68,46,22,45908,21956,67864
510628,201910,146,87,59,86826.98,59880,146706.98
510629,201910,254,162,92,161676,91816,253492
510630,201910,447,231,216,231538.94,217566.36,449105.30
510631,201910,12,3,9,2994,8982,11976
510637,201910,347,208,139,209582.95,138732.78,348315.73
510642,201910,974,545,429,545908.94,428143.96,974052.90
510645,201910,0,0,0,0,0,0
510650,201910,1427,950,477,951108.14,477048.87,1428157.01
510665,201910,80,41,39,41918.92,38922,80840.92
510670,201910,60,35,25,34930,24950,59880
510675,201910,1149,728,421,728543.34,420158,1148701.34
510677,201910,343,177,166,176650.9,165673.88,342324.78
510680,201910,106,63,43,62876.94,42914.98,105791.92
510682,201910,205,102,103,102794,103792,206586
510685,201910,53,41,12,40918,11976,52894
510700,201910,595,345,250,345318.78,251503.85,596822.63
510704,201910,1127,608,519,606904.51,520061.86,1126966.37
510706,201910,126,64,62,64870,61876.98,126746.98
510710,201910,391,275,116,275452.88,115769.92,391222.80
510715,201910,62,46,16,45908,15968,61876
510718,201910,205,108,97,107786.94,97804,205590.94
510719,201910,39,17,22,16966,21956,38922
510720,201910,191,132,59,131736,58882,190618
510724,201910,88,35,53,34930,52894,87824
510726,201910,50,25,25,24950,24950.98,49900.98
510729,201910,68,31,37,30938,36926,67864
510730,201910,463,261,202,260479.96,204591.97,465071.93
510735,201910,110,47,63,46906,62874,109780
510740,201910,23,12,11,12974,10978,23952
510757,201910,16,13,3,12974,2994,15968
510760,201910,7077,3759,3318,3758531.79,3314560.77,7073092.56
510770,201910,681,321,360,320361.9,359290.74,679652.64
510774,201910,17,7,10,6986,9980,16966
510775,201910,107,82,25,81836,24950,106786
510776,201910,29,10,19,9980,18962,28942
510777,201910,183,83,100,82834,99800,182634
510779,201910,49,21,28,20958.98,28943.96,49902.94
510780,201910,287,161,126,160684.88,125753.85,286438.73
510785,201910,400,216,184,216566,183632,400198
510787,201910,194,93,101,92814.98,100799.97,193614.95
510788,201910,0,0,0,0,0,0
510790,201910,2437,1293,1144,1296453.86,1144790.28,2441244.14
510792,201910,1153,670,483,669667.8,482047.73,1151715.53
510794,201910,115,59,56,58882,55888.98,114770.98
510795,201910,2358,1384,974,1386228.73,973057.66,2359286.39
510800,201910,179,112,67,111776,67864,179640
510805,201910,172,117,55,116766,54890.98,171656.98
510810,201910,96,42,54,41921.88,53892,95813.88
510820,201910,242,119,123,118766.12,122756.51,241522.63
510830,201910,67,41,26,40918,25948.98,66866.98
510835,201910,12,9,3,8982,2994,11976
510840,201910,9069,4428,4641,4428327.3,4637923.1,9066250.4
510850,201910,212,85,127,84830,126746.98,211576.98
510860,201910,379,171,208,171661.88,207595.16,379257.04
510880,201910,66,50,16,49900.98,15968,65868.98
510885,201910,72,42,30,41916.98,29940,71856.98
510890,201910,68,40,28,39920,27944,67864
510895,201910,184,108,76,108782,77846.37,186628.37
520005,201910,54,31,23,30938,22954,53892
520010,201910,274,127,147,126746,146706.8,273452.8
520013,201910,700,447,253,448102.98,253492,701594.98
520015,201910,55,40,15,39920,14970,54890
520017,201910,90,52,38,51896.4,37924,89820.4
520020,201910,21,11,10,10978,9980,20958
520025,201910,2094,1129,965,1126743.2,963070,2089813.2
520030,201910,796,431,365,433133.58,367264,800397.58
520050,201910,75,52,23,51896,22954,74850
520055,201910,46,30,16,29940,15968,45908
520060,201910,180,121,59,120758,58882,179640
520080,201910,569,409,160,408182,159680,567862
520082,201910,18,12,6,11976,5988,17964
520085,201910,95,71,24,70858,23952,94810
520090,201910,95,62,33,61876,32934,94810
520110,201910,9106,3986,5120,3986018.52,5112761.48,9098780.00
520120,201910,13,8,5,7984,4990,12974
520130,201910,786,554,232,552892.98,232534.4,785427.38
520140,201910,11932,6731,5201,6730524.85,5203589.31,11934114.16
520145,201910,48,32,16,31936,15968,47904
520150,201910,176,138,38,137724,37924,175648
520160,201910,37,28,9,27944,8982,36926
520170,201910,253,150,103,149702.93,102796.92,252499.85
520180,201910,145,75,70,74850,69860,144710
520215,201910,211,139,72,138722,71856,210578
520235,201910,74,56,18,55888,17964,73852
520250,201910,128,78,50,77844,49900,127744
520260,201910,112,71,41,71856,41916,113772
520280,201910,48,33,15,32934,14970,47904
520310,201910,39,26,13,25948,12974,38922
520320,201910,170,110,60,110778,59880,170658
520330,201910,789,421,368,421158.94,367265.96,788424.90
520340,201910,343,203,140,203592,139720.98,343312.98
520350,201910,508,239,269,238522,270458,508980
520355,201910,89,53,36,52894,35928,88822
520357,201910,29,22,7,21956,6986,28942
520360,201910,1,1,0,998,0,998
520380,201910,134,70,64,70858,64870,135728
520390,201910,261,113,148,112774,147704,260478
520393,201910,15,11,4,10978,3992,14970
520396,201910,89,55,34,54890,33932.98,88822.98
520400,201910,208,121,87,120758,87824,208582
520410,201910,194,99,95,98802.98,95808.98,194611.96
520420,201910,20,14,6,13972,5988,19960
520425,201910,296,144,152,143712,152695.4,296407.4
520430,201910,459,241,218,240609.81,217565.88,458175.69
520440,201910,679,480,199,480038,198602,678640
520450,201910,1922,871,1051,869258.98,1048903.88,1918162.86
520455,201910,55,38,17,37924,16966,54890
520460,201910,36,21,15,21956,14970,36926
520465,201910,28,24,4,23952,3992,27944
520470,201910,426,270,156,269460,155688,425148
520480,201910,79,48,31,47904.98,30942.9,78847.88
520485,201910,120,41,79,40918,79840.4,120758.4
520490,201910,422,311,111,311376.4,110778,422154.4
520495,201910,165,99,66,98802,66866,165668
520500,201910,178,136,42,135728,41916,177644
520505,201910,182,104,78,104790,77844,182634
520510,201910,1768,865,903,865305.6,902277.22,1767582.82
520520,201910,39,31,8,30938,7984,38922
520530,201910,234,176,58,176646,57884,234530
520540,201910,557,389,168,388255.26,168662,556917.26
520545,201910,138,84,54,83832,54890,138722
520547,201910,48,27,21,26946,20958,47904
520549,201910,1197,575,622,574848.32,622752.8,1197601.12
520551,201910,289,154,135,153692,134730.4,288422.4
520552,201910,46,30,16,29940,15968,45908
520570,201910,15,9,6,8982,5988,14970
520580,201910,282,173,109,172654,108782,281436
520590,201910,157,96,61,95808.98,60878,156686.98
520620,201910,1155,545,610,545908.36,610776,1156684.36
520630,201910,37,23,14,22954,13972,36926
520640,201910,403,240,163,239520,162674,402194
520650,201910,62,37,25,36926,24950,61876
520660,201910,41,22,19,21956.98,18962,40918.98
520670,201910,36,30,6,29940,5988,35928
520680,201910,54,36,18,35928,17964,53892
520690,201910,36,12,24,11976,23953.96,35929.96
520710,201910,34,31,3,30938,2994,33932
520725,201910,192,133,59,133732,58882,192614
520735,201910,57,39,18,38922,17964,56886
520740,201910,411,207,204,207584,204590.98,412174.98
520750,201910,36,27,9,26946,8982,35928
520753,201910,59,40,19,39920,18962,58882
520760,201910,107,74,33,73852,32934,106786
520780,201910,296,220,76,219560,75848,295408
520790,201910,153,83,70,82834,69860,152694
520800,201910,3417,1843,1574,1842310.19,1578836.88,3421147.07
520810,201910,163,120,43,119760,42914,162674
520815,201910,5,4,1,3992,998,4990
520830,201910,147,104,43,103792,42914,146706
520840,201910,356,237,119,236526,119760,356286
520850,201910,102,66,36,65869.96,35928,101797.96
520860,201910,1728,1116,612,1115764.4,617762.4,1733526.8
520870,201910,31555,15335,16220,15339280.32,16218528.45,31557808.77
520880,201910,1139,620,519,618760.4,518960.4,1137720.8
520890,201910,787,476,311,477044.98,310378,787422.98
520910,201910,991,528,463,526944.88,463072,990016.88
520915,201910,97,75,22,74850,21956,96806
520920,201910,403,200,203,199600,202594,402194
520929,201910,18,17,1,16966,998,17964
520940,201910,73,48,25,47904,24950,72854
520945,201910,19,11,8,10978,7984,18962
520960,201910,46,30,16,30938,15968,46906
520970,201910,332,208,124,208582.98,123752,332334.98
520980,201910,92,67,25,66866,24950,91816
520990,201910,461,311,150,311376,149700,461076
520993,201910,127,62,65,61876,65868,127744
520995,201910,244,141,103,140718.66,102794.4,243513.06
521000,201910,1575,930,645,928140.6,644708.85,1572849.45
521010,201910,670,323,347,323355.92,346307.96,669663.88
521015,201910,16,10,6,9980,5988,15968
521020,201910,1426,1010,416,1011972.98,420160.36,1432133.34
521030,201910,49,34,15,33932,14970,48902
521040,201910,937,601,336,602792.9,335328.4,938121.3
521056,201910,41,31,10,30938,9980,40918
521060,201910,133,88,45,87824,45908,133732
521080,201910,447,339,108,338323.38,107784,446107.38
521090,201910,538,340,198,339320,197604,536924
521100,201910,272,206,66,207584,65868,273452
521120,201910,1060,748,312,749498.4,312374.98,1061873.38
521130,201910,357,257,100,257484,99802.36,357286.36
521140,201910,178,98,80,97804,79840,177644
521150,201910,2711,1185,1526,1184628.36,1522949.96,2707578.32
521160,201910,30,16,14,15968,13972,29940
521170,201910,197,114,83,113772,82834,196606
521180,201910,1168,747,421,747502.2,420158.9,1167661.1
521190,201910,2544,1078,1466,1079836,1469058.36,2548894.36
521200,201910,54,40,14,39920,13972,53892
521205,201910,11,8,3,7984,2994,10978
521210,201910,131,74,57,73852,57884,131736
521220,201910,812,566,246,567862,245508.9,813370.9
521225,201910,36,24,12,23952,11976,35928
521230,201910,105,71,34,71856,33932,105788
521250,201910,6175,3546,2629,3542904.91,2628736.6,6171641.51
521260,201910,25,14,11,13972,10978,24950
521270,201910,142,111,31,110778,30938,141716
521280,201910,431,264,167,264470,168662,433132
521290,201910,28,12,16,11976,15968,27944
521295,201910,97,65,32,65868,31936,97804
521300,201910,219,117,102,117765.96,102797.34,220563.30
521305,201910,37,26,11,25948,10978,36926
521308,201910,1080,815,265,814376.82,265468.98,1079845.80
521310,201910,1321,774,547,774452.9,548901.34,1323354.24
521340,201910,21,16,5,15968,4990,20958
521350,201910,127,95,32,94810,31936,126746
521370,201910,175,123,52,122754,51896,174650
521375,201910,172,95,77,94810,76846,171656
521377,201910,48,36,12,35928,11976,47904
521380,201910,1053,683,370,683631.92,370258,1053889.92
521385,201910,14,9,5,8982,4990,13972
521390,201910,101,82,19,81836,18962,100798
521400,201910,335,223,112,222554,111776,334330
521405,201910,141,77,64,78842,64870,143712
521410,201910,65,44,21,43912,20958,64870
521440,201910,196,143,53,142714,52894,195608
521450,201910,735,414,321,414170,320358,734528
521460,201910,1175,749,426,747502,427144.4,1174646.4
521470,201910,12,8,4,7984,3992,11976
521480,201910,43,30,13,29942.94,12976.86,42919.80
521483,201910,318,183,135,182634.4,135728,318362.4
521486,201910,285,186,99,185628,98802.6,284430.6
521487,201910,23,12,11,11976,10978,22954
521490,201910,25,14,11,13972,10978,24950
521500,201910,116,75,41,74850,40918,115768
521520,201910,42,28,14,27944,13972,41916
521523,201910,691,419,272,420158,271456,691614
521525,201910,47,31,16,30938,15968,46906
521530,201910,245,133,112,132734,111776,244510
521540,201910,28,15,13,14970,12974,27944
521550,201910,87,39,48,38925.34,47908.9,86834.24
521560,201910,797,554,243,552892.4,243512.7,796405.1
521565,201910,59,38,21,37924,20958,58882
521570,201910,516,345,171,346306.4,171656.9,517963.3
521580,201910,57,36,21,36926,20958,57884
521590,201910,38,19,19,18962,18962,37924
521600,201910,23,13,10,12974,9980,22954
521630,201910,244,129,115,128742,114772.46,243514.46
521640,201910,302,162,140,161676,140718,302394
521645,201910,28,15,13,14970,12974,27944
521680,201910,228,143,85,142714,84830.6,227544.6
521690,201910,2,2,0,1996,0,1996
521710,201910,1163,566,597,565866,598800.98,1164666.98
521720,201910,540,371,169,372254,169661.34,541915.34
521730,201910,643,319,324,318363.6,324350,642713.6
521740,201910,907,379,528,378242.98,526948.32,905191.30
521760,201910,1760,959,801,958080.59,802393.36,1760473.95
521770,201910,827,525,302,525946,301396,827342
521800,201910,2020,1288,732,1288430.38,731542.82,2019973.20
521805,201910,31,18,13,17964,12974,30938
521810,201910,86,54,32,53892,31936,85828
521830,201910,944,674,270,672652.13,269460.98,942113.11
521839,201910,87,54,33,53892,32934,86826
521850,201910,1091,585,506,583834.01,506001.5,1089835.51
521860,201910,350,223,127,222554,126746,349300
521870,201910,71,42,29,41916,28942,70858
521878,201910,36,18,18,17964,17964,35928
521880,201910,4669,2107,2562,2106779.76,2564866.15,4671645.91
521890,201910,592,425,167,424150,166666,590816
521900,201910,292,238,54,237524,53892,291416
521910,201910,154,110,44,110778,43912,154690
521920,201910,51,25,26,24950,25948,50898
521925,201910,41,25,16,24950,15968,40918
521930,201910,1136,639,497,638728.24,497015.18,1135743.42
521935,201910,35,26,9,25948,8982,34930
521940,201910,189,96,93,95808,92814,188622
521945,201910,16,14,2,13972,1996,15968
521950,201910,8,4,4,3992,3992,7984
521960,201910,70,53,17,52894,16966,69860
521970,201910,410,267,143,267464,142714,410178
521971,201910,86,44,42,43912,42914,86826
521973,201910,34,18,16,17964,15968,33932
521975,201910,1319,680,639,678640.61,639719.1,1318359.71
521980,201910,240,167,73,166666,72854,239520
521990,201910,79,56,23,55888,22954,78842
522000,201910,286,181,105,180638,104790,285428
522005,201910,19,11,8,10978,7984,18962
522010,201910,1143,650,493,648700.98,492014,1140714.98
522015,201910,60,38,22,37924.98,21956,59880.98
522020,201910,897,512,385,510976.1,386226.8,897202.9
522026,201910,23,14,9,13972,8982,22954
522028,201910,17,13,4,12974,3992,16966
522040,201910,771,312,459,312376.46,458085.92,770462.38
522045,201910,2298,1433,865,1433128.7,865269.26,2298397.96
522050,201910,160,80,80,79840,79840,159680
522060,201910,549,352,197,351296,196606,547902
522068,201910,120,81,39,80838,38922,119760
522070,201910,10,10,0,9980,0,9980
522100,201910,41,23,18,22954,17964,40918
522108,201910,42,32,10,31936,9980,41916
522119,201910,51,28,23,27944,22954,50898
522130,201910,80,35,45,34930.98,44912.94,79843.92
522140,201910,3974,2075,1899,2070852.3,1898197.98,3969050.28
522145,201910,46,34,12,33932,11976,45908
522150,201910,76,54,22,53892,21956,75848
522155,201910,51,33,18,32934.98,17964,50898.98
522157,201910,4,3,1,2994,998,3992
522160,201910,1718,1034,684,1031932,684628.98,1716560.98
522170,201910,404,274,130,273452,129740,403192
522180,201910,37,20,17,19960,16966,36926
522185,201910,2009,801,1208,801394.8,1206582.99,2007977.79
522190,201910,41,25,16,24950,16966,41916
522200,201910,296,180,116,179640,115768,295408
522205,201910,147,102,45,101796,44910,146706
522220,201910,157,113,44,112774,43912,156686
522230,201910,35,28,7,27944,6986,34930
530010,201910,54690,28085,26605,28126281.24,26628681.86,54754963.10
110001,201911,504,403,101,402292.3,101818.46,504110.76
110002,201911,2737,1696,1041,1698964.03,1046152.87,2745116.90
110003,201911,90,75,15,74878.17,14975.08,89853.25
110004,201911,2000,1297,703,1300703.84,705780.93,2006484.77
110005,201911,443,353,90,354358.28,90828.97,445187.25
110006,201911,443,345,98,344397.84,97830.6,442228.44
110007,201911,68,57,11,56898.02,10979.92,67877.94
110008,201911,244,139,105,139749.33,104806.18,244555.51
110009,201911,848,600,248,600878.2,247547.11,848425.31
110010,201911,1776,1086,690,1092008.49,692740.32,1784748.81
110011,201911,1808,1409,399,1417485.25,402296.33,1819781.58
110012,201911,4138,2416,1722,2429524,1727811.45,4157335.45
110013,201911,765,609,156,610904.48,158712.84,769617.32
110014,201911,376,326,50,325452.66,50913.25,376365.91
110015,201911,1412,1136,276,1138001.84,278504.51,1416506.35
110018,201911,1108,696,412,698749.41,412279.4,1111028.81
110020,201911,15499,9019,6480,9048818.87,6490632.95,15539451.82
110025,201911,626,462,164,464145.05,164696.92,628841.97
110026,201911,37,27,10,26950.08,9982.57,36932.65
110028,201911,1659,1207,452,1207840.76,451204.96,1659045.72
110029,201911,143,131,12,130777.57,12977.06,143754.63
110030,201911,2424,1638,786,1640924.22,786592.95,2427517.17
110032,201911,298,229,69,231600.71,69873.96,301474.67
110033,201911,667,494,173,493145.48,172700.42,665845.90
110034,201911,360,268,92,267518.09,91834.63,359352.72
110037,201911,98,86,12,85835.38,12974.14,98809.52
110040,201911,367,252,115,251540.82,114787.26,366328.08
110045,201911,921,638,283,637853.87,284502.84,922356.71
110050,201911,88,80,8,81867.84,7985.98,89853.82
110060,201911,74,41,33,41934.84,32942.03,74876.87
110070,201911,112,70,42,69868.7,41921.82,111790.52
110080,201911,428,252,176,252508.43,175663.6,428172.03
110090,201911,29,24,5,23952.98,4990,28942.98
110092,201911,101,54,47,53896.17,46909.38,100805.55
110094,201911,192,143,49,143732.96,48911.6,192644.56
110100,201911,33,26,7,25955.4,6989.89,32945.29
110110,201911,69,38,31,37933.93,30945.68,68879.61
110120,201911,73,62,11,61894.18,10982.26,72876.44
110130,201911,292,243,49,244594.67,49913.59,294508.26
110140,201911,239,163,76,162697.24,75859.18,238556.42
110143,201911,49,40,9,39922.09,8982.67,48904.76
110145,201911,24,19,5,18965.64,4992.69,23958.33
110146,201911,25,12,13,11977.62,12975.56,24953.18
110147,201911,35,26,9,26953.88,8984.55,35938.43
110148,201911,32,22,10,21958.26,9981.9,31940.16
110149,201911,304,215,89,215583.7,89825.83,305409.53
110150,201911,135,104,31,104799.42,30941.15,135740.57
110155,201911,8,6,2,5989.4,1996.34,7985.74
110160,201911,66,54,12,54892.88,11977.76,66870.64
110170,201911,209,169,40,168707.41,39926.72,208634.13
110175,201911,65,49,16,48904.25,15968,64872.25
110180,201911,89,77,12,76853.31,11976.44,88829.75
120001,201911,156,106,50,105819.84,49917.61,155737.45
120005,201911,197,116,81,118779.41,80848.34,199627.75
120010,201911,1068,671,397,673748.45,399258.76,1073007.21
120013,201911,150,102,48,101803.19,47907.36,149710.55
120017,201911,97,58,39,57888.32,38924.72,96813.04
120020,201911,3571,2878,693,2882412.63,695652.82,3578065.45
120025,201911,545,310,235,309481.43,234614.9,544096.33
120030,201911,1073,910,163,911247.26,164691.34,1075938.60
120032,201911,46,41,5,40926.84,4990.17,45917.01
120033,201911,220,195,25,194623.71,24951.32,219575.03
120034,201911,168,123,45,122756.84,44911.55,167668.39
120035,201911,35,27,8,28944.56,8983.76,37928.32
120038,201911,388,250,138,251540.85,137741.3,389282.15
120039,201911,28,27,1,26947.8,998,27945.8
120040,201911,14030,9648,4382,9674366.53,4392335.83,14066702.36
120042,201911,44,40,4,41918.34,3992.11,45910.45
120043,201911,10,3,7,2994.34,6986.44,9980.78
120045,201911,553,359,194,362349.22,195639.97,557989.19
120050,201911,1277,982,295,981133.14,294435.35,1275568.49
120060,201911,1452,1194,258,1194672.42,259496.81,1454169.23
120070,201911,454,326,128,325396.75,127763.83,453160.58
120080,201911,169,102,67,101801.6,66867.96,168669.56
130002,201911,149,109,40,108786.29,39921.79,148708.08
130006,201911,77,45,32,44910.44,31936.27,76846.71
130008,201911,135,72,63,71859,62875.7,134734.7
130010,201911,143,81,62,80839.41,61877.39,142716.80
130014,201911,265,191,74,190623.84,74854.61,265478.45
130020,201911,91,51,40,50899.22,39920,90819.22
130030,201911,915,542,373,543915.39,374255.67,918171.06
130040,201911,345,173,172,173671.89,171675.64,345347.53
130050,201911,579,300,279,302417.88,282470.33,584888.21
130060,201911,858,577,281,576859.56,281448.82,858308.38
130063,201911,592,334,258,333333.66,259480,592813.66
130068,201911,189,124,65,123758.9,64872.49,188631.39
130070,201911,1305,895,410,894286.04,410225.26,1304511.30
130080,201911,704,461,243,461090.98,248514.67,709605.65
130083,201911,67,38,29,37927.27,28944.04,66871.31
130090,201911,346,174,172,173652.44,172654.89,346307.33
130100,201911,1130,487,643,491060.89,642805.93,1133866.82
130110,201911,734,306,428,305405.64,429159.05,734564.69
130115,201911,164,67,97,67870.51,96818.19,164688.70
130120,201911,1646,1056,590,1056980.93,590859.92,1647840.85
130130,201911,607,413,194,414175.77,193615.7,607791.47
130140,201911,1512,1165,347,1168730.51,348344.71,1517075.22
130150,201911,409,358,51,360286.5,50898.44,411184.94
130160,201911,452,262,190,261496.35,189627.36,451123.71
130165,201911,29,22,7,21960.52,6987.28,28947.80
130170,201911,965,679,286,678638.38,288450.32,967088.70
130180,201911,173,115,58,114775.38,57884.96,172660.34
130185,201911,2372,1133,1239,1130891.72,1237795.07,2368686.79
130190,201911,3498,2191,1307,2195834.55,1308593.02,3504427.57
130195,201911,276,221,55,220558.78,54890.14,275448.92
130200,201911,183,85,98,84833.88,98808.24,183642.12
130210,201911,80,41,39,40918,38922.47,79840.47
130220,201911,181,122,59,121758.94,58885.08,180644.02
130230,201911,364,233,131,233536.26,132739.25,366275.51
130240,201911,1350,851,499,855333.39,498038.64,1353372.03
130250,201911,4733,3041,1692,3045352.13,1690903.24,4736255.37
130255,201911,424,205,219,205594.18,219581.45,425175.63
130260,201911,56434,27161,29273,27232638.75,29328461.7,56561100.45
130270,201911,1544,1036,508,1039044.22,510010.97,1549055.19
130280,201911,127,72,55,72858.02,54890.68,127748.70
130290,201911,2095,1488,607,1494120.64,608846.73,2102967.37
130300,201911,444,310,134,310383.59,133738.87,444122.46
130310,201911,894,460,434,459084.48,433138.94,892223.42
130320,201911,509,274,235,275455.92,236533.1,511989.02
130330,201911,750,469,281,469085.74,280449.76,749535.50
130340,201911,3494,2041,1453,2040110.08,1450241.89,3490351.97
130350,201911,450,292,158,293412.89,159680.94,453093.83
130353,201911,897,380,517,380302.87,517054.95,897357.82
130356,201911,833,384,449,383247.85,449128.78,832376.63
130360,201911,94,70,24,69863.17,23952.89,93816.06
130370,201911,691,531,160,531934.5,160678.93,692613.43
130380,201911,680,518,162,522977.81,167670.29,690648.10
130390,201911,469,372,97,373253.42,97804.44,471057.86
130395,201911,163,39,124,38922.7,123754.07,162676.77
130400,201911,64,44,20,43913.41,19960.07,63873.48
130406,201911,2114,1288,826,1287536.96,828451.07,2115988.03
130410,201911,440,202,238,204590.42,237528.35,442118.77
130420,201911,3046,2470,576,2471347.35,575918.45,3047265.80
130423,201911,159,80,79,79841.18,78842.94,158684.12
130426,201911,151,83,68,82838.15,67867.27,150705.42
130430,201911,401,256,145,256491.36,145709,402200.36
130440,201911,206,69,137,69863.75,137730.9,207594.65
140002,201911,30,10,20,9982.16,20960.32,30942.48
140005,201911,194,117,77,118775.37,77852.91,196628.28
140010,201911,10379,6794,3585,6816103.23,3597802.7,10413905.93
140015,201911,128,55,73,55894.11,73859.21,129753.32
140017,201911,117,80,37,79863.62,36934.33,116797.95
140020,201911,476,314,162,314411.27,161710.61,476121.88
140023,201911,46,24,22,23955.92,21958.85,45914.77
140028,201911,19,11,8,10981.53,7986.45,18967.98
140030,201911,340,242,98,241561.36,99821.61,341382.97
140040,201911,61,42,19,42914.19,18962.95,61877.14
140045,201911,236,100,136,99813.08,135745.86,235558.94
140047,201911,612,412,200,413244.92,201632.54,614877.46
140050,201911,147,92,55,91841.88,54904.69,146746.57
140060,201911,43,30,13,29946.44,12977.36,42923.80
140070,201911,32,29,3,28945.89,2994.44,31940.33
150010,201911,4629,2862,1767,2875635.78,1769729.71,4645365.49
150013,201911,159,114,45,113781,44916.77,158697.77
150020,201911,1071,577,494,577900.52,496050.12,1073950.64
150030,201911,678,281,397,281479.29,397276.78,678756.07
150034,201911,197,127,70,126756.3,69863.76,196620.06
150040,201911,1432,839,593,838483.01,592918.33,1431401.34
150050,201911,621,367,254,368298.83,254510.39,622809.22
150060,201911,4768,3071,1697,3075344.04,1698976.01,4774320.05
150070,201911,323,142,181,141722.04,180651.18,322373.22
150080,201911,14560,7156,7404,7176613.51,7429104.35,14605717.86
150085,201911,412,262,150,262526.04,150724.52,413250.56
150090,201911,759,640,119,643785.14,118778.34,762563.48
150095,201911,352,223,129,223565.07,128748.03,352313.10
150100,201911,57,38,19,37925.49,18963.15,56888.64
150110,201911,177,91,86,91817.08,85828.34,177645.42
150120,201911,406,301,105,301442.65,104800.72,406243.37
150125,201911,53,21,32,20961.02,31941.19,52902.21
150130,201911,1980,1052,928,1060063.12,930258.66,1990321.78
150140,201911,54269,24978,29291,25064104.22,29405541.92,54469646.14
150145,201911,191,104,87,103804.88,86836.26,190641.14
150150,201911,2898,1315,1583,1318684.12,1593190.47,2911874.59
150157,201911,398,281,117,281488.9,117785.92,399274.82
150160,201911,129,102,27,101806.39,27947.29,129753.68
150170,201911,3590,2693,897,2702885.89,902295.11,3605181.00
150172,201911,331,225,106,224596.7,105809.58,330406.28
150175,201911,80,51,29,50903.93,28947.55,79851.48
150178,201911,770,519,251,518044.49,251538.54,769583.03
150180,201911,3137,1528,1609,1528256.44,1611082.19,3139338.63
150190,201911,340,216,124,215607.37,124773.71,340381.08
150195,201911,112,56,56,56889.75,56888.91,113778.66
150200,201911,193,92,101,91822.31,100803.51,192625.82
150210,201911,3113,2512,601,2533356.97,602889.77,3136246.74
150215,201911,564,368,196,367357.34,196645.45,564002.79
150220,201911,3667,2494,1173,2503370.18,1173804.16,3677174.34
150230,201911,1170,943,227,941265.03,226584.97,1167850.00
150240,201911,6152,3576,2576,3574595.28,2582376.19,6156971.47
150250,201911,36,15,21,14973.95,20960.79,35934.74
150260,201911,84,52,32,51901.52,32937.11,84838.63
150270,201911,2282,1478,804,1481369.26,803565.61,2284934.87
150275,201911,528,333,195,334388.4,195635.13,530023.53
150276,201911,102,45,57,45914.56,58891.4,104805.96
150277,201911,759,326,433,327422.67,434214.68,761637.35
150280,201911,324,207,117,208588.42,117767.01,326355.43
150285,201911,92,46,46,45911.08,45908.95,91820.03
150290,201911,979,595,384,595901.23,385289.19,981190.42
150293,201911,639,312,327,311440.28,334400.95,645841.23
150295,201911,477,222,255,221626.62,257563.74,479190.36
150300,201911,80,40,40,39924.59,39924.31,79848.90
150304,201911,169,109,60,108793.67,59888.75,168682.42
150307,201911,396,330,66,331390.26,66873.21,398263.47
150309,201911,576,414,162,414268.26,162715.36,576983.62
150310,201911,237,157,80,156687.54,79840.95,236528.49
150320,201911,1953,1358,595,1362366.49,597867.92,1960234.41
150330,201911,2031,1185,846,1184727.07,853372.92,2038099.99
150340,201911,195,131,64,130745.86,63873.97,194619.83
150345,201911,623,346,277,346334.9,277459.82,623794.72
150350,201911,399,313,86,314464.21,85852.65,400316.86
150360,201911,4603,2909,1694,2913839.03,1693977.21,4607816.24
150370,201911,815,564,251,563036.41,250553.18,813589.59
150375,201911,185,92,93,96811.91,93817.19,190629.10
150380,201911,1453,987,466,988264.77,465201.6,1453466.37
150390,201911,796,459,337,459173.85,338379.16,797553.01
150400,201911,104,87,17,87827.49,16967.03,104794.52
150405,201911,1234,800,434,800515.14,434180.02,1234695.16
150410,201911,122,79,43,79846.8,42917.43,122764.23
150420,201911,7347,4075,3272,4085171.46,3279325.7,7364497.16
150430,201911,578,381,197,380309.12,196636.59,576945.71
150440,201911,546,333,213,333390.58,214602.38,547992.96
150442,201911,2278,1219,1059,1221777.07,1060058.01,2281835.08
150445,201911,535,342,193,342403.68,192659.27,535062.95
150450,201911,231,117,114,116768.83,114773.44,231542.27
150460,201911,733,549,184,548979.13,184653.62,733632.75
150470,201911,1311,795,516,796552.66,515059.09,1311611.75
150475,201911,229,177,52,176693.02,51909.68,228602.70
150480,201911,1289,903,386,904333.71,389275.87,1293609.58
150490,201911,591,328,263,328345.63,262474.95,590820.58
150495,201911,328,236,92,237529.63,92814.94,330344.57
150497,201911,295,200,95,200623.72,94826.84,295450.56
150500,201911,210,134,76,134745.65,75856.09,210601.74
150503,201911,988,495,493,494086.94,496096.08,990183.02
150506,201911,957,635,322,638832.72,323404.93,962237.65
150510,201911,1266,707,559,709685.67,561974.08,1271659.75
150520,201911,268,180,88,180639.66,88822,269461.66
150530,201911,1683,927,756,926426.89,757701.44,1684128.33
150540,201911,233,167,66,167700.42,65885.15,233585.57
150543,201911,782,424,358,423265.21,358377.26,781642.47
150548,201911,469,330,139,330367.41,139733.45,470100.86
150549,201911,58,42,16,41918,15969.93,57887.93
150550,201911,2868,1491,1377,1493258.73,1376454.08,2869712.81
150553,201911,3333,1971,1362,1981532.11,1363613.14,3345145.25
150555,201911,144,75,69,74858.13,68869.89,143728.02
150560,201911,25,13,12,12977.32,11979.21,24956.53
150563,201911,91,45,46,44922.72,45917.73,90840.45
150565,201911,173,107,66,106790.42,66870.78,173661.20
150570,201911,403,266,137,267471.78,136732.54,404204.32
150580,201911,1594,730,864,730612.87,868361.52,1598974.39
150590,201911,806,526,280,525996.35,279475.29,805471.64
150600,201911,458,281,177,282454.31,177657.23,460111.54
150610,201911,139,120,19,119764,19962.71,139726.71
150611,201911,118,79,39,79846.18,38925.76,118771.94
150613,201911,3194,1946,1248,1950586.39,1247816.73,3198403.12
150616,201911,508,301,207,300447.55,206614.98,507062.53
150618,201911,1301,706,595,708658.2,596879.74,1305537.94
150619,201911,390,296,94,295444.43,94824.79,390269.22
150620,201911,1246,737,509,744581.48,509026.13,1253607.61
150630,201911,291,190,101,189643.02,100811.05,290454.07
150635,201911,474,201,273,201619.81,274474.54,476094.35
150640,201911,53,27,26,26951.46,26949.05,53900.51
150650,201911,2344,1369,975,1375778.5,979252.72,2355031.22
150655,201911,246,185,61,184651.62,60886.71,245538.33
150658,201911,95,52,43,52905.5,42926.37,95831.87
150660,201911,517,350,167,351368.27,166694.04,518062.31
150670,201911,1037,372,665,371338.59,664813.67,1036152.26
150680,201911,9917,5334,4583,5345586.98,4582905.6,9928492.58
150690,201911,16,9,7,8984.67,6987.64,15972.31
150700,201911,477,317,160,317417.23,163708.77,481126.00
150710,201911,281,158,123,157710.52,122769.06,280479.58
150715,201911,826,507,319,508051.23,318408.8,826460.03
150720,201911,405,313,92,315410.05,91825.44,407235.49
150730,201911,975,521,454,522103.9,454236.21,976340.11
150740,201911,221,153,68,152714.77,67869.65,220584.42
150745,201911,795,443,352,442227.06,352387.03,794614.09
150746,201911,58,33,25,32937.06,24953.45,57890.51
150747,201911,241,187,54,187641.96,54901.93,242543.89
150750,201911,138,79,59,78858.45,58890.86,137749.31
150760,201911,1797,1173,624,1177422.61,622798.67,1800221.28
150770,201911,387,210,177,212579.59,177650.62,390230.21
150775,201911,98,45,53,44923.2,52904.58,97827.78
150780,201911,193,112,81,111787.61,82842.44,194630.05
150790,201911,845,460,385,461104.22,384255.96,845360.18
150795,201911,1506,895,611,899351.02,612853.9,1512204.92
150796,201911,360,211,149,211580.48,150702.41,362282.89
150797,201911,309,161,148,160710.06,147723.63,308433.69
150800,201911,1456,856,600,860361.07,600840.81,1461201.88
150803,201911,558,459,99,466089.66,99805.92,565895.58
150805,201911,189,118,71,119770.88,70867.14,190638.02
150808,201911,999,544,455,543012.87,457176.36,1000189.23
150810,201911,3292,2281,1011,2287739.06,1013098.37,3300837.43
150812,201911,439,233,206,232570.2,208620.24,441190.44
150815,201911,994,634,360,632816.83,362308.77,995125.60
150820,201911,1540,930,610,929326.17,610904.88,1540231.05
150830,201911,748,547,201,547961.25,202615.97,750577.22
150835,201911,199,118,81,117778.47,80846.11,198624.58
150840,201911,1385,867,518,868470.71,519090.8,1387561.51
160005,201911,51,32,19,31942.43,18965.74,50908.17
160010,201911,190,122,68,121777.4,70870.07,192647.47
160015,201911,119,71,48,71860.95,47906.24,119767.19
160020,201911,130,73,57,72859.91,56891.63,129751.54
160021,201911,53,26,27,25955.32,26952.71,52908.03
160023,201911,65,42,23,41918.67,22956.25,64874.92
160025,201911,26,11,15,10978.52,14970,25948.52
160027,201911,1520,868,652,869408.64,651807.2,1521215.84
160030,201911,15729,8170,7559,8189539.16,7581608.16,15771147.32
160040,201911,294,168,126,167671.81,126754.03,294425.84
160050,201911,718,359,359,361327.84,361327.98,722655.82
160053,201911,297,174,123,174694.11,122780.69,297474.80
160055,201911,29,20,9,19965.28,8983.64,28948.92
160060,201911,6562,3453,3109,3458772.25,3112383.59,6571155.84
160070,201911,173,104,69,103800.67,69862.85,173663.52
160080,201911,98,48,50,47907.33,50900.61,98807.94
170025,201911,26,15,11,14973.12,10979.94,25953.06
170030,201911,220,179,41,178665.29,40921.11,219586.40
170035,201911,229,108,121,107824.28,121800.2,229624.48
170040,201911,179,138,41,138731.78,40920.51,179652.29
170070,201911,317,195,122,197665.62,121776.8,319442.42
170100,201911,358,261,97,260524.5,96826.99,357351.49
170105,201911,58,47,11,46911.54,10979.7,57891.24
170110,201911,109,70,39,69866.16,38922.79,108788.95
170130,201911,67,33,34,32934.76,33933.83,66868.59
170190,201911,93,59,34,59881.2,33932.81,93814.01
170200,201911,378,262,116,262513.32,117779,380292.32
170210,201911,6035,3229,2806,3228066.38,2809819.06,6037885.44
170215,201911,116,46,70,45913.77,69873.18,115786.95
170220,201911,1400,1032,368,1033064.14,367307.27,1400371.41
170230,201911,151,101,50,100826.36,49913.94,150740.30
170240,201911,530,355,175,354372.38,174695.95,529068.33
170255,201911,1104,894,210,897278.59,211595.33,1108873.92
170270,201911,45,32,13,31937.76,12974.02,44911.78
170290,201911,107,76,31,76852.41,30942.74,107795.15
170300,201911,87,59,28,58889.07,27945.75,86834.82
170305,201911,50,39,11,38925.57,10979.63,49905.20
170307,201911,63,48,15,47914.77,14973.32,62888.09
170310,201911,110,59,51,58892.16,50903.88,109796.04
170320,201911,24,18,6,17967.88,5988.72,23956.60
170330,201911,25,23,2,22957.88,1996.85,24954.73
170360,201911,28,17,11,17968.06,10981.66,28949.72
170370,201911,121,62,59,61894.27,58898.27,120792.54
170380,201911,78,61,17,60882.63,16966.34,77848.97
170382,201911,44,38,6,37926.09,5989.72,43915.81
170384,201911,142,108,34,107786.87,33932,141718.87
170386,201911,64,26,38,25950.83,37929.42,63880.25
170388,201911,48,19,29,18964.99,28946.16,47911.15
170389,201911,25,20,5,19962.73,4991.36,24954.09
170390,201911,66,39,27,38929.38,26947.88,65877.26
170410,201911,32,24,8,23957.28,7985.84,31943.12
170460,201911,16,11,5,11979.8,4991.08,16970.88
170510,201911,34,28,6,27949.72,5989.28,33939.00
170550,201911,1552,906,646,906372.11,645841,1552213.11
170555,201911,113,81,32,80860.86,31943.52,112804.38
170560,201911,100,70,30,69860.76,29940.85,99801.61
170600,201911,35,17,18,16967.88,17964.46,34932.34
170610,201911,195,105,90,104820.1,89846.17,194666.27
170625,201911,36,21,15,20959.57,14974.04,35933.61
170650,201911,78,58,20,58885.27,19961.55,78846.82
170700,201911,580,443,137,443171.79,136741.86,579913.65
170710,201911,160,100,60,99835.44,59902.13,159737.57
170720,201911,88,71,17,70861.47,16966.32,87827.79
170730,201911,81,47,34,46915.68,33939.18,80854.86
170740,201911,82,62,20,61877.3,20959.03,82836.33
170755,201911,69,35,34,34935.52,33945.25,68880.77
170765,201911,136,72,64,71880.66,63888.85,135769.51
170770,201911,213,132,81,133746.89,81841.69,215588.58
170820,201911,594,395,199,394277.92,198635.33,592913.25
170825,201911,33,17,16,16967.47,15969.5,32936.97
170830,201911,81,66,15,66873.51,14970,81843.51
170900,201911,184,144,40,144719.33,39922.69,184642.02
170930,201911,890,478,412,477145.76,415424.41,892570.17
170950,201911,3120,1434,1686,1433455.17,1684020.4,3117475.57
170980,201911,19,10,9,9983.27,8983.41,18966.68
171050,201911,145,115,30,115774.6,29940.68,145715.28
171070,201911,38,32,6,31940.27,5988,37928.27
171090,201911,43,32,11,31938.4,10979.66,42918.06
171110,201911,22,14,8,13974.54,7984.74,21959.28
171150,201911,39,18,21,17964,20959.3,38923.3
171180,201911,23,13,10,12977.94,9981.81,22959.75
171190,201911,148,85,63,85845.66,62888.53,148734.19
171195,201911,64,53,11,52907.99,10981.26,63889.25
171200,201911,49,26,23,25954.14,22955.47,48909.61
171215,201911,4,3,1,2994.07,998.89,3992.96
171240,201911,58,43,15,42914,14972.57,57886.57
171245,201911,55,48,7,47920.63,6988.23,54908.86
171250,201911,76,41,35,40921.89,34934.12,75856.01
171270,201911,13,9,4,8984.33,3993.63,12977.96
171280,201911,42,37,5,36936.35,4990.34,41926.69
171320,201911,992,583,409,584929.47,411234.92,996164.39
171330,201911,428,210,218,209600.37,217592.48,427192.85
171360,201911,84,62,22,61881.19,21958.89,83840.08
171370,201911,31,15,16,14973.92,15974.23,30948.15
171380,201911,131,109,22,108784.68,21956.78,130741.46
171395,201911,52,33,19,32935.09,18964.02,51899.11
171420,201911,287,187,100,186634.95,99807.73,286442.68
171430,201911,73,61,12,60893.58,11976.93,72870.51
171488,201911,177,99,78,99810.04,77847.47,177657.51
171500,201911,55,32,23,31940.63,22956.56,54897.19
171510,201911,71,46,25,45910.18,24952.35,70862.53
171515,201911,41,34,7,33937.11,6987.07,40924.18
171525,201911,30,28,2,27950.01,1996.4,29946.41
171550,201911,14,10,4,9983.03,3992.55,13975.58
171570,201911,51,26,25,25950.07,24950.21,50900.28
171575,201911,315,207,108,206605.72,108788.38,315394.10
171610,201911,1753,899,854,900388.35,858464.69,1758853.04
171620,201911,136,95,41,94822.04,40920.96,135743.00
171630,201911,60,32,28,31938.06,27944.47,59882.53
171650,201911,269,183,86,183675.2,85843.27,269518.47
171660,201911,273,151,122,150748.16,121791.82,272539.98
171665,201911,58,40,18,39924.33,17967.33,57891.66
171670,201911,422,249,173,248550.75,173674.3,422225.05
171700,201911,65,58,7,58889.17,6987.71,65876.88
171720,201911,28,10,18,9982.08,17967.61,27949.69
171750,201911,101,53,48,54896.18,47912.4,102808.58
171780,201911,74,58,16,57892.54,15968.6,73861.14
171790,201911,77,68,9,68865.64,8982.44,77848.08
171800,201911,34,26,8,26947.41,7984.44,34931.85
171820,201911,2082,1205,877,1207829.27,877404.16,2085233.43
171830,201911,34,27,7,26950.05,6986.55,33936.60
171840,201911,62,40,22,40924.94,21957.39,62882.33
171845,201911,31,19,12,18964.1,11977.91,30942.01
171850,201911,40,29,11,28946.28,10979.6,39925.88
171855,201911,76,60,16,59882.75,15968.32,75851.07
171865,201911,7,6,1,5988.44,998.34,6986.78
171870,201911,33,23,10,22961.58,9982.22,32943.80
171875,201911,77,54,23,53893.34,23953.15,77846.49
171880,201911,31,20,11,19963.83,10980.92,30944.75
171884,201911,50,27,23,26947.5,22954.6,49902.1
171886,201911,127,53,74,52896.31,73857.41,126753.72
171888,201911,30,22,8,21962.93,7987.71,29950.64
171889,201911,20,14,6,13974.54,5990.42,19964.96
171890,201911,57,47,10,46911.36,9980,56891.36
171900,201911,40,27,13,26954.64,12976.9,39931.54
172000,201911,42,34,8,33939.96,7984.83,41924.79
172010,201911,48,38,10,37928.44,9980.48,47908.92
172015,201911,28,19,9,18968.7,8985.24,27953.94
172020,201911,138,88,50,87834.07,49907.21,137741.28
172025,201911,35,21,14,20959.16,13973.67,34932.83
172030,201911,42,25,17,25949.62,16968.28,42917.90
172049,201911,81,53,28,52898.89,27944.27,80843.16
172065,201911,142,90,52,89849.98,51914.08,141764.06
172080,201911,104,69,35,68868.21,34933.01,103801.22
172085,201911,28,15,13,14971.69,12975.25,27946.94
172090,201911,417,326,91,325406.59,90833.94,416240.53
172093,201911,18,15,3,14970.12,2994,17964.12
172097,201911,20,12,8,11978.01,7987.86,19965.87
172100,201911,4972,2845,2127,2849047.09,2127256.09,4976303.18
172110,201911,78,50,28,49914.08,27949.9,77863.98
172120,201911,1662,1414,248,1414486.86,247551.2,1662038.06
172125,201911,5,4,1,3993.1,998.03,4991.13
172130,201911,16,12,4,12974.87,3993.98,16968.85
172208,201911,195,123,72,122763.1,71862.76,194625.86
172210,201911,383,189,194,188669.1,194649.75,383318.85
210005,201911,2960,1868,1092,1868696.1,1096083.11,2964779.21
210010,201911,169,92,77,91817.94,77844.6,169662.54
210015,201911,39,29,10,28945.03,9980,38925.03
210020,201911,346,194,152,193634.75,152712.64,346347.39
210030,201911,329,214,115,215625.22,114795.67,330420.89
210040,201911,141,111,30,110787.46,29942.42,140729.88
210043,201911,254,189,65,188639.84,64876.52,253516.36
210047,201911,541,310,231,311378.46,233533.27,544911.73
210050,201911,291,214,77,214572.66,76847.79,291420.45
210055,201911,44,35,9,34933.74,8983.61,43917.35
210060,201911,552,439,113,438199.65,112791.94,550991.59
210070,201911,408,312,96,312385.81,95808.61,408194.42
210080,201911,116,106,10,105797.75,9980.88,115778.63
210083,201911,308,152,156,151707.52,155691.24,307398.76
210087,201911,2,1,1,998,998,1996
210090,201911,449,322,127,321421.84,126770.09,448191.93
210095,201911,455,344,111,344354.98,110797.8,455152.78
210100,201911,701,547,154,549966.76,153717.5,703684.26
210110,201911,131,81,50,80842.72,50899.59,131742.31
210120,201911,5153,4001,1152,4002955.65,1154943.42,5157899.07
210125,201911,203,123,80,122771.18,79849.64,202620.82
210130,201911,490,277,213,276490.73,215598.39,492089.12
210135,201911,29,18,11,17972.23,10981.88,28954.11
210140,201911,4372,3442,930,3449804.03,930330.63,4380134.66
210150,201911,379,245,134,246593.25,133771.1,380364.35
210160,201911,3311,2800,511,2805893.24,515071.03,3320964.27
210170,201911,1164,931,233,932311.13,236556.88,1168868.01
210173,201911,128,111,17,110782.34,16968.5,127750.84
210177,201911,388,213,175,212587.25,176671.25,389258.50
210180,201911,30,16,14,15969.54,13973.14,29942.68
210190,201911,417,278,139,279459.2,140725.96,420185.16
210193,201911,3,2,1,1996,998.78,2994.78
210197,201911,84,56,28,55890.72,27948.32,83839.04
210200,201911,636,519,117,518058.38,116794.73,634853.11
210203,201911,237,157,80,156703.01,79846.31,236549.32
210207,201911,375,304,71,305440.89,71876.19,377317.08
210210,201911,759,702,57,702651.08,56893.79,759544.87
210215,201911,72,65,7,65880.83,6986,72866.83
210220,201911,397,335,62,335407.26,62888.71,398295.97
210230,201911,304,240,64,240546.85,63875.54,304422.39
210232,201911,1406,944,462,947227.16,465121.23,1412348.39
210235,201911,167,128,39,127767.85,38928.77,166696.62
210237,201911,39,23,16,22955.85,15970.57,38926.42
210240,201911,90,75,15,74853.32,14971.65,89824.97
210250,201911,183,155,28,154696.12,27946.83,182642.95
210255,201911,358,269,89,269506.27,88827.5,358333.77
210260,201911,399,275,124,274459.28,124750.58,399209.86
210270,201911,654,434,220,436150.61,220577.45,656728.06
210275,201911,64,50,14,49903.02,13975.87,63878.89
210280,201911,1047,689,358,688686.19,360308.2,1048994.39
210290,201911,537,358,179,358302.22,180648.89,538951.11
210300,201911,5453,3409,2044,3415646.54,2064152.69,5479799.23
210310,201911,109,76,33,75850.41,32934.88,108785.29
210312,201911,115,80,35,80841.94,34931.08,115773.02
210315,201911,101,81,20,80845.81,19960.88,100806.69
210317,201911,125,94,31,93820.9,30941.49,124762.39
210320,201911,2327,1966,361,1972373.14,362319.63,2334692.77
210325,201911,132,91,41,91829.69,40925.74,132755.43
210330,201911,4697,2648,2049,2663921.8,2084022.71,4747944.51
210340,201911,1295,956,339,962217.22,340369.41,1302586.63
210350,201911,614,518,96,518032.28,97818.93,615851.21
210355,201911,148,119,29,118772.91,28949.32,147722.23
210360,201911,2337,1586,751,1589991.2,761572.1,2351563.3
210370,201911,1231,583,648,583915.62,649792.26,1233707.88
210375,201911,186,97,89,96827.45,88842.02,185669.47
210380,201911,710,541,169,542980.21,169685.45,712665.66
210390,201911,195,164,31,163676.93,30938.96,194615.89
210400,201911,400,345,55,347372.86,54900.34,402273.20
210405,201911,999,696,303,695658.89,304412.75,1000071.64
210407,201911,52,42,10,41917.86,9981.22,51899.08
210408,201911,60,53,7,52906.39,6988.02,59894.41
210409,201911,329,284,45,287458.39,44915.24,332373.63
210410,201911,430,337,93,337341.77,92819.14,430160.91
210420,201911,200,163,37,163683.63,36928.63,200612.26
210430,201911,46,30,16,29940.99,15969.27,45910.26
210440,201911,343,224,119,223597.49,120777.19,344374.68
210450,201911,147,115,32,114785.31,31939.6,146724.91
210455,201911,231,126,105,125777.41,105808.67,231586.08
210460,201911,316,206,110,205629.2,110802.67,316431.87
210462,201911,66,55,11,54899.04,10979.16,65878.20
210465,201911,148,109,39,109789.31,38924.47,148713.78
210467,201911,533,390,143,391265.11,143732,534997.11
210470,201911,50,43,7,42914.07,6986,49900.07
210480,201911,1279,913,366,916310.19,366335.52,1282645.71
210490,201911,204,134,70,134744.41,69869.66,204614.07
210500,201911,522,309,213,310434.84,216594.87,527029.71
210510,201911,568,448,120,450102.97,119764.16,569867.13
210515,201911,392,234,158,233554.29,160709.68,394263.97
210520,201911,410,366,44,365312,43918.71,409230.71
210530,201911,9410,5030,4380,5044220.23,4389418.82,9433639.05
210535,201911,129,95,34,94816.41,33936.74,128753.15
210540,201911,1490,967,523,971204.35,526004.05,1497208.40
210542,201911,1203,618,585,618869.42,584961.35,1203830.77
210545,201911,17,16,1,15970.46,998,16968.46
210547,201911,132,116,16,115780.41,15970.81,131751.22
210550,201911,699,505,194,504111.93,194642.52,698754.45
210560,201911,168,145,23,145710.48,22954.77,168665.25
210565,201911,23,18,5,17970.95,4992.46,22963.41
210570,201911,1314,1058,256,1056064.64,256542.81,1312607.45
210580,201911,119,102,17,101798.52,16966.47,118764.99
210590,201911,746,607,139,605807.54,139722.44,745529.98
210592,201911,32,29,3,28944.35,2994.24,31938.59
210594,201911,106,90,16,89829.12,15972.12,105801.24
210596,201911,97,82,15,81842.35,14972.09,96814.44
210598,201911,129,95,34,94819.9,33938.24,128758.14
210600,201911,331,283,48,282504.95,47918.17,330423.12
210610,201911,255,239,16,238563.22,16967.55,255530.77
210620,201911,45,28,17,27945,16967.86,44912.86
210630,201911,73,70,3,69865.28,2994,72859.28
210632,201911,1032,710,322,709621.51,323368.45,1032989.96
210635,201911,22,19,3,18970.47,2994.99,21965.46
210637,201911,107,77,30,76850.16,29941.47,106791.63
210640,201911,584,514,70,513993.43,70858.44,584851.87
210650,201911,401,332,69,331347.37,69865.78,401213.15
210660,201911,392,293,99,294482.67,99823.37,394306.04
210663,201911,29,20,9,19962.71,8983.11,28945.82
210667,201911,101,35,66,34934.91,68870.19,103805.10
210670,201911,253,224,29,224586.31,28948.65,253534.96
210675,201911,540,300,240,301427.93,241550.44,542978.37
210680,201911,217,144,73,144728.06,72863.21,217591.27
210690,201911,623,510,113,513975.61,114773.28,628748.89
210700,201911,168,125,43,125756.81,42916.43,168673.24
210710,201911,263,162,101,161687.92,100799.9,262487.82
210720,201911,134,117,17,116768.75,16967.11,133735.86
210725,201911,67,59,8,58905.11,7987.08,66892.19
210730,201911,25,18,7,17966.2,6988.05,24954.25
210735,201911,302,210,92,210586.71,92815.57,303402.28
210740,201911,545,466,79,465193.89,79860.37,545054.26
210745,201911,154,115,39,114779.25,38923.47,153702.72
210750,201911,2371,1196,1175,1197865.6,1188872.15,2386737.75
210760,201911,253,192,61,191634.16,60881.79,252515.95
210770,201911,390,305,85,307456.66,84850.63,392307.29
210780,201911,437,323,114,323404.29,114786.63,438190.92
210790,201911,186,151,35,150731.26,35936.02,186667.28
210800,201911,169,129,40,128773.08,39927.17,168700.25
210805,201911,51,47,4,46908.02,3992.27,50900.29
210810,201911,468,373,95,375324.1,94830.26,470154.36
210820,201911,2162,1795,367,1796813.43,367346.97,2164160.40
210825,201911,159,91,68,90838.95,68880.31,159719.26
210830,201911,734,479,255,478070.42,256499.53,734569.95
210840,201911,202,140,62,140729.11,63874.08,204603.19
210845,201911,248,167,81,166674.95,80839.87,247514.82
210850,201911,783,526,257,525035.01,257516,782551.01
210860,201911,3804,2111,1693,2115041.78,1700787.32,3815829.10
210870,201911,451,352,99,352403.7,99827.93,452231.63
210880,201911,72,55,17,54892.72,16967.22,71859.94
210890,201911,316,270,46,271526.55,46919.3,318445.85
210900,201911,617,405,212,405288.87,213616.38,618905.25
210905,201911,62,30,32,29942.3,32936.64,62878.94
210910,201911,1967,1478,489,1478341.45,494096.78,1972438.23
210920,201911,179,63,116,63880.61,115770.61,179651.22
210923,201911,84,62,22,61879.09,21957,83836.09
210927,201911,413,190,223,189626.24,223570.94,413197.18
210930,201911,69,55,14,54893.64,13973.12,68866.76
210940,201911,86,68,18,67866.63,17964,85830.63
210945,201911,198,99,99,98812.71,98813.19,197625.90
210950,201911,525,387,138,387273.91,137744.88,525018.79
210955,201911,76,51,25,50903.03,24951.71,75854.74
210960,201911,2215,1074,1141,1075934.73,1150797.75,2226732.48
210970,201911,112,99,13,99809.15,12974.44,112783.59
210975,201911,84,77,7,77857.77,6988.32,84846.09
210980,201911,1105,527,578,526046.7,582903.81,1108950.51
210990,201911,4136,2680,1456,2685169.43,1464290.47,4149459.90
211000,201911,1336,1069,267,1074029.11,268511.14,1342540.25
211003,201911,1014,708,306,708649.45,305418.5,1014067.95
211010,201911,492,438,54,439156.64,54895.5,494052.14
211020,201911,1466,599,867,599873.05,872389.63,1472262.68
211023,201911,30,26,4,26948.77,3992,30940.77
211027,201911,75,55,20,54891.83,19961.24,74853.07
211030,201911,377,264,113,263499.71,112792.41,376292.12
211040,201911,306,254,52,253502.11,52895.04,306397.15
211050,201911,1153,762,391,766606.48,395266.63,1161873.11
211060,201911,654,564,90,564974.53,91829.92,656804.45
211065,201911,22,18,4,17969.12,3992.21,21961.33
211070,201911,906,748,158,747673.94,157718.4,905392.34
211080,201911,87,83,4,82839.28,3992.37,86831.65
211085,201911,55,29,26,28946.38,25951.51,54897.89
211090,201911,91,73,18,72876.51,17971.26,90847.77
211100,201911,483,396,87,396279.88,86847.12,483127.00
211102,201911,250,172,78,171656,77844,249500
211105,201911,223,157,66,157696.31,66870.79,224567.10
211107,201911,134,83,51,82836.87,50898.8,133735.67
211110,201911,822,534,288,535040.73,289485.3,824526.03
211120,201911,5389,2664,2725,2670430.68,2769006.83,5439437.51
211125,201911,35,25,10,24959.14,9982.06,34941.20
211130,201911,42544,19277,23267,19316259.51,23475000.55,42791260.06
211140,201911,410,352,58,351380.46,57898.74,409279.20
211150,201911,1255,817,438,817500.45,440184.62,1257685.07
211153,201911,169,100,69,99800.86,68864.68,168665.54
211157,201911,64,51,13,51901.94,12976.07,64878.01
211160,201911,697,592,105,594880.57,104806.08,699686.65
211163,201911,0,0,0,0,0,0
211167,201911,10,9,1,8982.97,998.94,9981.91
211170,201911,427,314,113,315399.4,115787.76,431187.16
211172,201911,118,82,36,81837.93,36929.08,118767.01
211174,201911,255,154,101,153692.32,100798.38,254490.70
211176,201911,498,366,132,365315.11,132746.84,498061.95
211178,201911,91,62,29,61882.74,29942.63,91825.37
211180,201911,210,169,41,168677.06,40923.22,209600.28
211190,201911,71,66,5,65870.99,4990,70860.99
211195,201911,35,24,11,23960.45,10982.35,34942.80
211200,201911,148,127,21,130765.65,20961.67,151727.32
211210,201911,447,322,125,321405.05,126772,448177.05
211220,201911,4033,2346,1687,2351795.27,1696973.49,4048768.76
211223,201911,94,91,3,90831.25,2994,93825.25
211227,201911,71,55,16,54897.41,15970.01,70867.42
211230,201911,757,624,133,625863.3,133759.58,759622.88
211240,201911,402,310,92,309403.08,92818.47,402221.55
211245,201911,189,90,99,90827.3,98813.69,189640.99
211250,201911,1576,1360,216,1361492.26,216601.46,1578093.72
211260,201911,814,667,147,667691.03,147706.09,815397.12
211270,201911,1993,1623,370,1624842.38,371273.9,1996116.28
211280,201911,1763,1124,639,1128914.67,640816.38,1769731.05
211285,201911,194,120,74,119767.49,74850.79,194618.28
211290,201911,687,478,209,478082.57,212586.9,690669.47
211300,201911,778,614,164,617882.24,164696.7,782578.94
211400,201911,1570,952,618,954234.02,618833.12,1573067.14
220005,201911,17,16,1,15974.01,998.5,16972.51
220010,201911,86,66,20,65870.37,19960.84,85831.21
220020,201911,674,537,137,535978.24,136746,672724.24
220025,201911,111,108,3,108787.06,2994.4,111781.46
220027,201911,41,34,7,33933.5,6986,40919.5
220030,201911,107,88,19,87830.21,18962,106792.21
220040,201911,1226,932,294,935230.73,295445.93,1230676.66
220045,201911,33,23,10,22962.24,9983.11,32945.35
220050,201911,682,576,106,576915.55,105799.67,682715.22
220060,201911,168,149,19,150732.75,19963.59,170696.34
220070,201911,111,102,9,101808.36,8982.85,110791.21
220080,201911,16,14,2,13975.06,1996,15971.06
220090,201911,33,28,5,27944.13,5988,33932.13
220095,201911,2,1,1,998.79,998,1996.79
220100,201911,20,16,4,15970.73,3993.97,19964.70
220105,201911,24,23,1,22959,998.44,23957.44
220110,201911,216,199,17,198611.19,16966.72,215577.91
220115,201911,35,34,1,33935.15,998,34933.15
220117,201911,23,21,2,20960,1996,22956
220120,201911,1484,1113,371,1116874.33,375286.06,1492160.39
220130,201911,30,30,0,29942.41,0,29942.41
220140,201911,105,81,24,81841.03,23955.31,105796.34
220150,201911,484,351,133,352398.78,132768.39,485167.17
220155,201911,6,6,0,5988,0,5988
220157,201911,18,15,3,14975.28,2995.07,17970.35
220160,201911,86,75,11,74855.15,10979.49,85834.64
220170,201911,32,32,0,31939.62,0,31939.62
220173,201911,7,7,0,6986.67,0,6986.67
220177,201911,6,6,0,5989.15,0,5989.15
220180,201911,69,69,0,68865.94,0,68865.94
220190,201911,1056,947,109,948209.04,108795.61,1057004.65
220191,201911,43,38,5,37936.73,5990.46,43927.19
220192,201911,76,73,3,72858.17,2994,75852.17
220194,201911,49,47,2,46913.07,1996.34,48909.41
220196,201911,95,80,15,79855.59,14972.1,94827.69
220198,201911,3,2,1,1996,998,2994
220200,201911,415,346,69,346410.05,68877.08,415287.13
220202,201911,38,34,4,33942.73,3993.18,37935.91
220205,201911,48,44,4,43914.34,3992,47906.34
220207,201911,11,11,0,10981.59,0,10981.59
220208,201911,78,42,36,42919.46,35931.57,78851.03
220209,201911,29,26,3,25951.43,2995.3,28946.73
220210,201911,19,16,3,15971.24,2994.07,18965.31
220211,201911,28,26,2,25951.7,1996.6,27948.3
220213,201911,41,37,4,36934.63,3993.17,40927.80
220217,201911,40,32,8,31939.54,7984,39923.54
220220,201911,2144,1404,740,1406365.58,742636.07,2149001.65
220225,201911,9,4,5,3993.35,4992.48,8985.83
220230,201911,967,764,203,769545.6,203623.03,973168.63
220240,201911,159,144,15,143723.78,14972.38,158696.16
220245,201911,33,30,3,29943.58,2994.26,32937.84
220250,201911,119,107,12,106801.91,11977.46,118779.37
220253,201911,40,34,6,33935.77,5988.5,39924.27
220255,201911,28,26,2,25949.49,2995.07,28944.56
220260,201911,693,516,177,516045.58,179670.28,695715.86
220265,201911,10,8,2,7984.42,1996.61,9981.03
220270,201911,735,660,75,662749.2,75857.57,738606.77
220271,201911,39,32,7,31943.99,6987.66,38931.65
220272,201911,24,24,0,23952,0,23952
220273,201911,15,14,1,13975.75,998,14973.75
220275,201911,58,47,11,46906.56,10978.99,57885.55
220277,201911,14,12,2,11977.55,1996,13973.55
220280,201911,14,11,3,10979.56,2994,13973.56
220285,201911,45,43,2,42925.89,1996,44921.89
220290,201911,1463,1257,206,1260665.45,206622.58,1467288.03
220300,201911,43,41,2,40930.98,1996.44,42927.42
220310,201911,309,266,43,265539.09,42925.74,308464.83
220320,201911,441,409,32,409264.22,31942.97,441207.19
220323,201911,0,0,0,0,0,0
220325,201911,13,11,2,10980.85,1996.34,12977.19
220327,201911,12,11,1,10980.54,998.94,11979.48
220330,201911,224,164,60,163683.75,59883.11,223566.86
220335,201911,136,118,18,117765.39,17965.05,135730.44
220340,201911,38,23,15,22958.15,14971.98,37930.13
220342,201911,57,50,7,49912.69,6988.51,56901.20
220345,201911,80,74,6,73857.54,5988.1,79845.64
220350,201911,435,380,55,379262.72,54896.85,434159.57
220360,201911,44,31,13,30940.05,12975.33,43915.38
220370,201911,1205,995,210,998143.98,211605.33,1209749.31
220375,201911,20,18,2,17966.13,1996.67,19962.80
220380,201911,19,16,3,15972.48,2994.7,18967.18
220385,201911,15,13,2,12976.65,1996.47,14973.12
220390,201911,2312,1314,998,1317611.11,1000191.37,2317802.48
220400,201911,34,30,4,29941.98,3992.95,33934.93
220410,201911,19,17,2,16970.34,1997.61,18967.95
220415,201911,12,11,1,10981.93,998,11979.93
220420,201911,125,104,21,103815.42,20963.98,124779.40
220430,201911,131,120,11,119785.04,11978.15,131763.19
220435,201911,21,15,6,14974.57,5990.83,20965.40
220440,201911,295,251,44,250551.72,43922.13,294473.85
220450,201911,328,167,161,169699.96,160724.49,330424.45
220455,201911,52,51,1,50904.96,998,51902.96
220460,201911,19,19,0,18966,0,18966
220465,201911,98,64,34,63895.26,34939.56,98834.82
220470,201911,237,209,28,208628.99,27950.25,236579.24
220480,201911,73,65,8,65868.67,7984.34,73853.01
220490,201911,89,76,13,75848.44,12974,88822.44
220500,201911,100,87,13,88827,12974.7,101801.7
220510,201911,435,339,96,339386.73,96818.02,436204.75
220515,201911,23,20,3,19966.16,2994.51,22960.67
220520,201911,374,338,36,338401.23,35938.17,374339.40
220525,201911,11,8,3,7986.82,2994.74,10981.56
220527,201911,24,17,7,16972.34,6986.84,23959.18
220530,201911,31,12,19,11978.2,18963.82,30942.02
220535,201911,3,3,0,3993.14,0,3993.14
220540,201911,64,53,11,52896.43,10978.6,63875.03
220545,201911,43,29,14,28948.4,13974.01,42922.41
220550,201911,675,532,143,533039.2,143741.94,676781.14
220551,201911,13,10,3,9983.5,2994.98,12978.48
220552,201911,15,15,0,14973.82,0,14973.82
220553,201911,51,46,5,45916.24,4990.25,50906.49
220554,201911,10,8,2,7986.11,1996.47,9982.58
220555,201911,34,29,5,28950.03,4993.26,33943.29
220556,201911,51,47,4,46912,3992.54,50904.54
220557,201911,55,52,3,51914.67,2994.7,54909.37
220558,201911,8,3,5,2995.25,4991.11,7986.36
220559,201911,2,2,0,1997.31,0,1997.31
220560,201911,67,44,23,43915.27,22954.17,66869.44
220570,201911,768,471,297,471126.7,298428.07,769554.77
220580,201911,544,501,43,500146.13,42923.05,543069.18
220585,201911,7,6,1,5989.35,998.74,6988.09
220590,201911,14,14,0,13974.75,0,13974.75
220595,201911,62,47,15,46913.42,14972.9,61886.32
220600,201911,19,12,7,11977.02,6987.4,18964.42
220605,201911,24,22,2,21959.62,1996,23955.62
220610,201911,73,65,8,64872.9,7984.6,72857.5
220620,201911,554,456,98,459173.07,98818.87,557991.94
220630,201911,5,4,1,3992.45,998,4990.45
220635,201911,37,33,4,32944.01,3992.34,36936.35
220640,201911,104,85,19,84832.63,18962,103794.63
220650,201911,108,103,5,102800.31,5988,108788.31
220660,201911,48,38,10,37929.44,9982.58,47912.02
220665,201911,4,4,0,3992.8,0,3992.8
220667,201911,20,18,2,17969.9,1996.4,19966.3
220669,201911,29,26,3,25951.6,2994,28945.6
220670,201911,64,52,12,51905.45,11977.68,63883.13
220672,201911,66,46,20,45916.28,19965.4,65881.68
220675,201911,38,30,8,29949.78,7986.36,37936.14
220680,201911,39,33,6,32935.55,5988,38923.55
220690,201911,45,43,2,42915.29,1996.6,44911.89
220695,201911,36,18,18,18966.59,19965.35,38931.94
220700,201911,1704,1328,376,1328497.64,375287.82,1703785.46
220710,201911,4,3,1,2994.34,998.27,3992.61
220720,201911,110,90,20,89824,19960,109784
220730,201911,16,16,0,15971.52,0,15971.52
220735,201911,5,1,4,998,3993.07,4991.07
220740,201911,48,44,4,43917.21,3992.5,47909.71
220750,201911,113,95,18,94815.36,17966.18,112781.54
220755,201911,13,12,1,11981.19,998.6,12979.79
220760,201911,63,59,4,58887.08,3992,62879.08
220770,201911,5590,3003,2587,3014746.1,2600389.85,5615135.95
220775,201911,17,10,7,9984.17,6986.64,16970.81
220777,201911,17,16,1,15968.72,998,16966.72
220779,201911,0,0,0,0,0,0
220780,201911,882,755,127,754594.26,127759.39,882353.65
220785,201911,4,1,3,998.8,2995.82,3994.62
220790,201911,1071,858,213,857485.04,213617.85,1071102.89
220793,201911,6,6,0,5989.61,0,5989.61
220795,201911,14,13,1,12977.46,998.27,13975.73
220800,201911,4007,3087,920,3091292.57,924310.14,4015602.71
220810,201911,66,59,7,58889.41,6986.44,65875.85
220820,201911,243,221,22,222597.05,21964.11,244561.16
220830,201911,1212,1045,167,1053057.7,166689.01,1219746.71
220840,201911,2416,1696,720,1698921.76,724684.27,2423606.03
220850,201911,53,44,9,43913.4,8983.33,52896.73
220855,201911,8,5,3,4991.4,2995.2,7986.6
220860,201911,15,13,2,12980.23,1996.07,14976.30
220865,201911,33,31,2,30941.32,1996,32937.32
220870,201911,72,64,8,63881.31,7985.39,71866.70
220880,201911,322,255,67,255533.57,66880.49,322414.06
220885,201911,34,31,3,30942.14,2994.8,33936.94
220887,201911,13,13,0,12977.16,0,12977.16
220890,201911,99,88,11,87847.05,11978.03,99825.08
220900,201911,19,12,7,11980.28,6989.46,18969.74
220910,201911,51,43,8,43919.68,7985.15,51904.83
220915,201911,11,9,2,8982.15,1996,10978.15
220920,201911,49,45,4,44919.32,3993.61,48912.93
220930,201911,41,40,1,40922.59,998,41920.59
220935,201911,16,16,0,15975.99,0,15975.99
220937,201911,34,33,1,33939.77,998,34937.77
220940,201911,58,52,6,51898.29,5988.82,57887.11
220945,201911,0,0,0,0,0,0
220950,201911,43,38,5,37930.74,4990.67,42921.41
220955,201911,21,20,1,19963.89,998,20961.89
220960,201911,10,9,1,8982.44,998,9980.44
220965,201911,38,34,4,33932.39,3992.79,37925.18
220970,201911,58,48,10,47904.32,9980,57884.32
220975,201911,11,8,3,7988.43,2994.64,10983.07
220980,201911,29,27,2,27945.91,1996.86,29942.77
220985,201911,63,56,7,55889.97,6986.24,62876.21
220987,201911,29,27,2,26956.39,1997.49,28953.88
220990,201911,19,18,1,17965.09,998,18963.09
220995,201911,19,15,4,14973.16,3993.49,18966.65
220997,201911,61,50,11,49914.61,10979.58,60894.19
221000,201911,1179,1067,112,1068006.58,111792.06,1179798.64
221005,201911,52,46,6,45910.38,5988,51898.38
221010,201911,16,12,4,11977.13,3992,15969.13
221020,201911,41,39,2,38930.67,1997.49,40928.16
221030,201911,32,26,6,25951.79,5988.78,31940.57
221035,201911,24,24,0,23960.82,0,23960.82
221037,201911,12,8,4,7986.53,3992.47,11979.00
221038,201911,26,23,3,23952,2994,26946
221039,201911,22,22,0,21956.96,0,21956.96
221040,201911,254,220,34,220621.47,33939.39,254560.86
221050,201911,231,198,33,198652.53,32940.27,231592.80
221060,201911,1840,1618,222,1620955.31,221583.31,1842538.62
221062,201911,33,33,0,32942.98,0,32942.98
221063,201911,13,9,4,8982.4,3992.67,12975.07
221065,201911,53,45,8,44924.82,7984.49,52909.31
221070,201911,140,121,19,120788.86,18965.28,139754.14
221080,201911,377,329,48,328402.59,48908.56,377311.15
221090,201911,29,26,3,25951.34,2994.72,28946.06
221093,201911,48,32,16,31947.46,15969.27,47916.73
221095,201911,8,8,0,7987.2,0,7987.2
221097,201911,15,12,3,11979.62,2995.2,14974.82
221100,201911,25092,14871,10221,14912235.55,10264050.01,25176285.56
221110,201911,1075,806,269,807542.57,271510,1079052.57
221120,201911,527,393,134,395254.75,133751.01,529005.76
221130,201911,963,789,174,789511.03,175670.1,965181.13
221135,201911,34,31,3,30945.06,2994.89,33939.95
221140,201911,43,37,6,36931.97,5988.51,42920.48
221150,201911,12,9,3,8983.57,2995.01,11978.58
221160,201911,13,13,0,12979.26,0,12979.26
221170,201911,15,15,0,14973.23,0,14973.23
230010,201911,161,148,13,147707.3,12974.2,160681.5
230015,201911,121,99,22,98810.83,21956,120766.83
230020,201911,1633,1386,247,1385385.27,247538.01,1632923.28
230030,201911,1669,1203,466,1206773.65,466135.39,1672909.04
230040,201911,218,189,29,188627.28,28943.34,217570.62
230050,201911,227,169,58,168667.17,57885.71,226552.88
230060,201911,162,131,31,130741.1,30940.13,161681.23
230070,201911,300,264,36,265477.56,35931.07,301408.63
230075,201911,841,733,108,737634.97,108795.82,846430.79
230080,201911,197,169,28,168678.08,27945.09,196623.17
230090,201911,120,86,34,85836.3,33934.64,119770.94
230100,201911,2083,1214,869,1214885.29,871495.51,2086380.80
230110,201911,2818,1830,988,1837536.83,987154.97,2824691.80
230120,201911,962,768,194,770551.44,194641,965192.44
230125,201911,151,126,25,126753.39,24952.11,151705.50
230130,201911,478,430,48,429172.38,47908.43,477080.81
230140,201911,219,186,33,185636.06,32936.45,218572.51
230150,201911,151,115,36,114773.55,36930.85,151704.40
230160,201911,946,808,138,807440.22,137731.34,945171.56
230170,201911,606,551,55,550996.01,54900.03,605896.04
230180,201911,76,71,5,70858.47,4991.11,75849.58
230185,201911,395,341,54,343358.14,53898.3,397256.44
230190,201911,2301,1844,457,1851540.74,457150.24,2308690.98
230195,201911,491,428,63,429214.66,63882.75,493097.41
230200,201911,380,325,55,326393.36,55893.55,382286.91
230205,201911,405,263,142,262479.63,142720.34,405199.97
230210,201911,1326,1046,280,1047016.22,281473.2,1328489.42
230220,201911,1544,1053,491,1053077.06,496106.67,1549183.73
230230,201911,913,787,126,788520.97,125763.4,914284.37
230240,201911,1706,1476,230,1474488.63,230572.46,1705061.09
230250,201911,1798,1486,312,1486192.14,313418.03,1799610.17
230260,201911,3142,1965,1177,1964174.63,1179714.39,3143889.02
230270,201911,1354,1095,259,1097919.85,259508.12,1357427.97
230280,201911,2723,2048,675,2046097.58,675714.92,2721812.50
230290,201911,413,367,46,367321.34,46914.07,414235.41
230300,201911,515,381,134,381248.69,133739.36,514988.05
230310,201911,412,316,96,315397.36,95814.14,411211.50
230320,201911,939,804,135,804480.04,136740.96,941221.00
230330,201911,311,250,61,249517.5,60886.46,310403.96
230340,201911,451,366,85,365337.03,84841.01,450178.04
230350,201911,3118,1980,1138,1980315.27,1137898.62,3118213.89
230360,201911,277,224,53,224579.56,52898.84,277478.40
230365,201911,140,116,24,115774.42,23952.6,139727.02
230370,201911,9947,4899,5048,4904311.14,5052180.87,9956492.01
230380,201911,480,413,67,412237.49,66875.52,479113.01
230390,201911,523,293,230,293433.89,231556.71,524990.60
230393,201911,247,208,39,207585.59,38922.23,246507.82
230395,201911,356,286,70,286499.27,69876.42,356375.69
230400,201911,611,488,123,488075.31,125764.98,613840.29
230410,201911,2691,1693,998,1691855.12,999194.27,2691049.39
230420,201911,6282,4187,2095,4188364.93,2097205.08,6285570.01
230423,201911,323,284,39,283459.83,38927.4,322387.23
230425,201911,405,334,71,334372.24,70867.81,405240.05
230426,201911,124,99,25,98805.26,24950.35,123755.61
230427,201911,79,77,2,77855.33,1996,79851.33
230428,201911,1461,739,722,738650.77,722661.69,1461312.46
230430,201911,458,376,82,375298.64,81854.05,457152.69
230435,201911,878,629,249,628796.96,248522.31,877319.27
230440,201911,87077,38831,48246,38911706.38,48332085.14,87243791.52
230445,201911,301,211,90,210611.47,89834.78,300446.25
230450,201911,541,432,109,436159.27,108786.84,544946.11
230460,201911,62,50,12,49902.94,11978.53,61881.47
230465,201911,315,257,58,257510.94,58892.98,316403.92
230470,201911,1987,1568,419,1572978.6,420197.88,1993176.48
230480,201911,161,153,8,152701.21,7985.06,160686.27
230490,201911,299,240,59,239537.89,58884.65,298422.54
230495,201911,451,337,114,338385.48,113793.79,452179.27
230500,201911,1003,745,258,744564.02,258512.23,1003076.25
230510,201911,56,44,12,43914.03,11977.61,55891.64
230520,201911,382,300,82,302423.48,83841.66,386265.14
230523,201911,2263,1436,827,1437363.4,826503.44,2263866.84
230526,201911,277,235,42,235530.2,41916.17,277446.37
230530,201911,681,512,169,511054.74,168692.59,679747.33
230533,201911,203,191,12,190627.06,11977.12,202604.18
230535,201911,368,276,92,275494.96,92055.69,367550.65
230540,201911,1824,1611,213,1614965.76,213597.85,1828563.61
230550,201911,3781,2440,1341,2438606.63,1340643.53,3779250.16
230560,201911,577,439,138,439186.23,138744.87,577931.10
230565,201911,222,165,57,164686.24,56892.05,221578.29
230570,201911,290,256,34,257512.86,33936.48,291449.34
230580,201911,1164,859,305,860339.65,305416.35,1165756.00
230590,201911,990,778,212,779502.49,211597.43,991099.92
230600,201911,247,226,21,225591.63,20962.37,246554.00
230610,201911,356,283,73,284466.1,72863.58,357329.68
230620,201911,180,151,29,150715.92,28946.23,179662.15
230625,201911,752,539,213,539983.87,212607.59,752591.46
230630,201911,1331,1048,283,1047013.1,284474.99,1331488.09
230640,201911,3726,3217,509,3220976.92,510078.27,3731055.19
230650,201911,438,380,58,379271.72,57891.29,437163.01
230655,201911,668,581,87,580914.88,88837.4,669752.28
230660,201911,361,304,57,303409.03,56893.65,360302.68
230670,201911,430,374,56,376308.64,55894.32,432202.96
230680,201911,199,181,18,180663.9,17967.54,198631.44
230690,201911,903,776,127,776520.98,127757.7,904278.68
230700,201911,797,674,123,673719.95,122767.61,796487.56
230710,201911,712,677,35,678739.37,34935.43,713674.80
230720,201911,151,133,18,132741.36,17964.96,150706.32
230725,201911,265,215,50,214596.33,50903.3,265499.63
230730,201911,12106,6624,5482,6629700.49,5488091.09,12117791.58
230740,201911,672,548,124,547992.85,125762.6,673755.45
230750,201911,827,703,124,704662.38,124766.13,829428.51
230760,201911,1388,1195,193,1200801.9,193643.14,1394445.04
230763,201911,318,266,52,265494.14,51901.7,317395.84
230765,201911,7284,3399,3885,3404987.61,3891176.8,7296164.41
230770,201911,5045,2566,2479,2562258.89,2476441.26,5038700.15
230780,201911,708,626,82,625820.58,81842,707662.58
230790,201911,264,220,44,219563.88,44911.2,264475.08
230800,201911,1143,835,308,833402.32,309405.17,1142807.49
230810,201911,1343,1192,151,1194793.93,150728.83,1345522.76
230820,201911,353,249,104,249522.52,103803.87,353326.39
230830,201911,965,829,136,829424.66,137744.51,967169.17
230835,201911,275,240,35,242557.85,34936.69,277494.54
230837,201911,167,139,28,138733.6,27947.96,166681.56
230840,201911,912,729,183,732605.12,183656.08,916261.20
230850,201911,1486,1295,191,1294595.39,191646.95,1486242.34
230860,201911,297,221,76,222579.37,75855.77,298435.14
230870,201911,1835,1569,266,1569056.45,266515.94,1835572.39
230880,201911,65,49,16,48906.54,15968.44,64874.98
230890,201911,546,505,41,505044.35,41921.44,546965.79
230900,201911,278,208,70,207605.43,69867.86,277473.29
230910,201911,217,172,45,171677.23,44914.06,216591.29
230920,201911,421,334,87,335357.52,86834.27,422191.79
230930,201911,968,691,277,690702.15,276489.49,967191.64
230940,201911,851,675,176,675727.52,176665.42,852392.94
230945,201911,503,418,85,417237.05,85847.32,503084.37
230950,201911,407,352,55,352361.67,56897.15,409258.82
230960,201911,2648,1796,852,1794706.83,852466.96,2647173.79
230970,201911,1762,982,780,984223.4,780606.56,1764829.96
230980,201911,207,172,35,172680.17,34935.85,207616.02
230990,201911,139,114,25,113781.62,24952.48,138734.10
231000,201911,209,190,19,189653.76,18962.95,208616.71
231010,201911,146,112,34,112776.47,34932.6,147709.07
231020,201911,1342,932,410,930304.87,410286.07,1340590.94
231025,201911,1041,784,257,787555.06,256533.01,1044088.07
231030,201911,1109,934,175,936252.57,176677.96,1112930.53
231040,201911,138,93,45,92823.66,45912.75,138736.41
231050,201911,960,856,104,857439.74,104817.96,962257.70
231060,201911,150,126,24,126758.69,23955.71,150714.40
231070,201911,1486,1051,435,1051083.68,434196.18,1485279.86
231080,201911,262,242,20,241565.45,19962.52,261527.97
231085,201911,593,360,233,363322.24,232567.38,595889.62
231090,201911,244,201,43,200613.53,42917.65,243531.18
231095,201911,172,135,37,134733.62,36927.12,171660.74
231100,201911,150,126,24,125749.76,23953.73,149703.49
231110,201911,365,312,53,311425.8,52901.64,364327.44
231120,201911,274,233,41,236546.88,40920.99,277467.87
231123,201911,143,137,6,136732.67,5988.84,142721.51
231126,201911,334,261,73,261487.23,72863.56,334350.79
231130,201911,4608,3597,1011,3599158.63,1013137.56,4612296.19
231135,201911,211,182,29,182643.91,28945.27,211589.18
231140,201911,3064,2266,798,2263760.53,799510.88,3063271.41
231150,201911,364,346,18,345348.32,17968.53,363316.85
231160,201911,1193,946,247,951215.82,248534.93,1199750.75
231170,201911,526,363,163,364313.53,163691.79,528005.32
231180,201911,1682,1442,240,1447322.52,239558.41,1686880.93
231190,201911,208,178,30,177647.83,29941.37,207589.20
231195,201911,214,185,29,184632.42,28942.74,213575.16
231200,201911,815,668,147,667762.57,147732.75,815495.32
231210,201911,586,493,93,492044.71,94816.49,586861.20
231220,201911,1043,766,277,767575.05,279489.08,1047064.13
231230,201911,1446,1156,290,1155794.93,290445.26,1446240.19
231240,201911,1436,1040,396,1038040.42,398253.52,1436293.94
231250,201911,114,105,9,104809.45,9980.36,114789.81
231260,201911,272,178,94,177656,93822.42,271478.42
231270,201911,1014,837,177,836418.85,176664.02,1013082.87
231280,201911,73,57,16,56888.23,15969.26,72857.49
231290,201911,7527,4235,3292,4245070.93,3306964.16,7552035.09
231300,201911,622,578,44,576921.15,43914.4,620835.55
231310,201911,747,692,55,692750.44,54903.07,747653.51
231320,201911,584,445,139,446154.04,138736.79,584890.83
231325,201911,94,84,10,83839.47,9980.21,93819.68
231330,201911,2013,1564,449,1564353.47,452165.31,2016518.78
231335,201911,254,226,28,226559.4,27944.79,254504.19
231340,201911,1712,1262,450,1261668.12,450185.01,1711853.13
231350,201911,1282,1057,225,1059037.92,224603.38,1283641.30
231355,201911,434,376,58,375282.47,57888.84,433171.31
231360,201911,498,377,121,378323.59,120782.39,499105.98
231370,201911,85,72,13,72860.01,12974.36,85834.37
231375,201911,288,210,78,209611.17,77856.2,287467.37
231380,201911,484,393,91,392247.37,90824.65,483072.02
231390,201911,200,161,39,162686.67,38924.67,201611.34
231395,201911,725,459,266,459113.47,266487.51,725600.98
231400,201911,1116,929,187,928250.45,187647.19,1115897.64
231410,201911,1318,1081,237,1082974,236572.69,1319546.69
240010,201911,388,174,214,173685.39,213624.21,387309.60
240020,201911,2276,1824,452,1827628.03,453172.87,2280800.90
240030,201911,119,103,16,102797.27,15968.55,118765.82
240040,201911,30,30,0,29941.88,0,29941.88
240050,201911,530,454,76,454168.3,76861.79,531030.09
240060,201911,66,62,4,61879.58,3992.44,65872.02
240070,201911,210,165,45,165680.64,45909.48,211590.12
240080,201911,502,341,161,341366.85,162703.47,504070.32
240090,201911,107,96,11,95809.74,10978.21,106787.95
240100,201911,1506,1422,84,1424344.95,83843,1508187.95
240110,201911,1057,693,364,694744.09,365363.3,1060107.39
240120,201911,130,109,21,110787.86,20960.26,131748.12
240130,201911,284,264,20,264519.22,19962.16,284481.38
240140,201911,81,62,19,61887.32,18962.68,80850.00
240145,201911,723,649,74,647745.86,73855.65,721601.51
240150,201911,20,17,3,16967.1,2994,19961.1
240160,201911,41,36,5,35929.11,4991.52,40920.63
240165,201911,35,28,7,27948.46,6988.62,34937.08
240170,201911,94,71,23,71863.76,22955.46,94819.22
240180,201911,86,71,15,70865.65,14971.35,85837.00
240185,201911,42,39,3,38923.04,2994.34,41917.38
240190,201911,15,13,2,12975.39,1996.34,14971.73
240200,201911,3083,1733,1350,1730803.72,1352541.56,3083345.28
240210,201911,171,132,39,131739.62,38925.97,170665.59
240220,201911,1105,800,305,799487.96,305435.04,1104923.00
240230,201911,858,791,67,792563.98,66879.64,859443.62
240240,201911,71,50,21,50904.47,20959.66,71864.13
240250,201911,87,75,12,74861.98,11978.54,86840.52
240260,201911,1815,1355,460,1359474.82,462149.4,1821624.22
240270,201911,187,165,22,164677.73,21956.36,186634.09
240280,201911,42,33,9,32934,8982,41916
240290,201911,50,49,1,48903.72,998,49901.72
240300,201911,170,97,73,96810.03,72856.23,169666.26
240310,201911,2234,1242,992,1242680.07,993178.47,2235858.54
240320,201911,197,187,10,186626.44,9980,196606.44
240325,201911,4410,2674,1736,2675195.68,1735927.95,4411123.63
240330,201911,70,67,3,66870.12,2994.34,69864.46
240340,201911,62,39,23,38929.64,22957.37,61887.01
240350,201911,97,86,11,85835.91,10978.59,96814.50
240360,201911,524,338,186,339396.74,186671.22,526067.96
240370,201911,49,46,3,45908.44,2994,48902.44
240375,201911,66,40,26,39926.97,25952.65,65879.62
240380,201911,225,186,39,185653.19,38927.35,224580.54
240390,201911,12,11,1,10979.08,998.34,11977.42
240400,201911,84,78,6,77848.8,5988.83,83837.63
240410,201911,12,7,5,6986.47,4991.4,11977.87
240420,201911,961,721,240,723616.37,242537.08,966153.45
240430,201911,264,247,17,246553.03,16968.27,263521.30
240440,201911,109,64,45,63875.22,44913.03,108788.25
240450,201911,224,153,71,152713.11,70870.71,223583.82
240460,201911,60,45,15,45910.17,14971.55,60881.72
240470,201911,237,208,29,209627.36,28949.95,238577.31
240480,201911,16,13,3,12974.17,2995.81,15969.98
240485,201911,78,65,13,64874.84,12976.03,77850.87
240490,201911,47,45,2,44913.87,1996.95,46910.82
240500,201911,77,61,16,61877.72,15968,77845.72
240510,201911,47,34,13,33932.44,12974,46906.44
240520,201911,113,108,5,110797.09,4990.64,115787.73
240530,201911,53,48,5,48902.77,4990.88,53893.65
240540,201911,77,66,11,66867.07,10978.51,77845.58
240550,201911,12,11,1,10978.44,998,11976.44
240560,201911,377,277,100,276475.88,100802.83,377278.71
240570,201911,454,288,166,287481.53,166711.75,454193.28
240580,201911,1267,1018,249,1018074.18,248531.73,1266605.91
240590,201911,30,28,2,27944.55,1996,29940.55
240600,201911,110,106,4,106788.54,3993.27,110781.81
240610,201911,513,431,82,431229.14,81854.31,513083.45
240615,201911,20,19,1,18967.2,998.5,19965.7
240620,201911,88,84,4,83836.14,3992,87828.14
240630,201911,36,33,3,32942.13,2994.52,35936.65
240640,201911,27,22,5,21958.48,4990.3,26948.78
240650,201911,234,196,38,196620.95,37927.3,234548.25
240660,201911,109,94,15,93816,14971.44,108787.44
240670,201911,300,178,122,178672,121787.1,300459.1
240680,201911,49,38,11,37926.34,10978.77,48905.11
240690,201911,48,45,3,45918.23,2995.59,48913.82
240700,201911,192,159,33,158682.44,32935.95,191618.39
240710,201911,1991,1248,743,1247659.33,742608.08,1990267.41
240720,201911,1071,796,275,798473.13,275474.46,1073947.59
240725,201911,64,60,4,60881.77,3992.2,64873.97
240730,201911,140,123,17,123755.95,16966.6,140722.55
240740,201911,233,198,35,198642.17,34938.79,233580.96
240750,201911,53,27,26,26946.29,25952.6,52898.89
240760,201911,47,42,5,41917.4,4990,46907.4
240770,201911,146,112,34,111779.25,33934.36,145713.61
240780,201911,677,557,120,556955.74,120779.27,677735.01
240790,201911,42,40,2,39927.48,1996.88,41924.36
240800,201911,9161,6250,2911,6258676.98,2916835.04,9175512.02
240810,201911,20175,11041,9134,11052353.61,9152917.67,20205271.28
240820,201911,237,141,96,140741.06,95829.24,236570.30
240830,201911,1639,1346,293,1345444.02,292446.64,1637890.66
240840,201911,81,71,10,70870.17,9982.59,80852.76
240850,201911,88,78,10,77845.88,9981.61,87827.49
240860,201911,110,107,3,106790.22,2994,109784.22
240870,201911,59,51,8,50905.81,7985.44,58891.25
240880,201911,30,26,4,25949.78,3992,29941.78
240890,201911,1174,688,486,686756.21,486138.95,1172895.16
240895,201911,58,37,21,36928.66,20960.86,57889.52
240910,201911,160,144,16,144714.74,15969.19,160683.93
240920,201911,14,11,3,10980.53,2994.84,13975.37
240930,201911,409,366,43,366331.97,42922.52,409254.49
240933,201911,40,29,11,28943.32,10979.7,39923.02
240940,201911,2424,2152,272,2150887.5,272494.51,2423382.01
240950,201911,48,44,4,43917.23,3992,47909.23
240960,201911,30,25,5,24954.15,4991.48,29945.63
240970,201911,109,80,29,79841.09,28943.33,108784.42
240980,201911,191,155,36,155695.98,35931.39,191627.37
240990,201911,131,88,43,87828.26,42916.59,130744.85
241000,201911,64,60,4,59886.14,3992,63878.14
241010,201911,62,47,15,46906,14970,61876
241020,201911,115,106,9,105796.42,8984.81,114781.23
241025,201911,9,4,5,3992.64,4992.04,8984.68
241030,201911,109,90,19,90821.49,18962,109783.49
241040,201911,41,31,10,30938,9980.2,40918.2
241050,201911,84,75,9,75848.32,8982,84830.32
241060,201911,30,25,5,24951.92,4990.84,29942.76
241070,201911,17,17,0,16969.77,0,16969.77
241080,201911,61,54,7,53895.91,6986.98,60882.89
241090,201911,51,41,10,41925.34,9980.63,51905.97
241100,201911,73,62,11,61884.36,10978.52,72862.88
241105,201911,5,1,4,998,3992.4,4990.4
241110,201911,46,43,3,42914.67,2994,45908.67
241120,201911,1466,1126,340,1129824.63,339361.44,1469186.07
241140,201911,219,181,38,182654.82,37928.6,220583.42
241142,201911,40,36,4,35933.82,3992.44,39926.26
241150,201911,1168,1029,139,1027074.41,138747.31,1165821.72
241160,201911,23,20,3,19960.54,2995.41,22955.95
241170,201911,41,37,4,36927.28,3992.29,40919.57
241180,201911,45,39,6,38932.8,5989.4,44922.2
241190,201911,38,37,1,36931.15,998.34,37929.49
241200,201911,3838,2039,1799,2044374.45,1803826.76,3848201.21
241210,201911,69,59,10,58886.61,9981.11,68867.72
241220,201911,1419,960,459,960222.88,459161.99,1419384.87
241230,201911,240,202,38,201617.23,37933.61,239550.84
241240,201911,54,43,11,42917.32,11976.78,54894.10
241250,201911,1154,1057,97,1056051.16,96823.04,1152874.20
241255,201911,51,41,10,40920.65,9981.1,50901.75
241260,201911,659,517,142,518009.55,142735.05,660744.60
241270,201911,56,36,20,35930.74,19963.49,55894.23
241280,201911,95,82,13,81844.18,12975.31,94819.49
241290,201911,119,88,31,87835.88,30944.56,118780.44
241300,201911,75,56,19,55891.07,18963.98,74855.05
241310,201911,51,37,14,37925.76,13972.07,51897.83
241320,201911,29,17,12,16970.15,11977.2,28947.35
241330,201911,61,58,3,57886.64,2994,60880.64
241335,201911,73,66,7,65871.63,6986,72857.63
241340,201911,181,134,47,133738.85,46908.37,180647.22
241350,201911,59,52,7,51898.47,6987.05,58885.52
241355,201911,48,42,6,41921.21,5990.03,47911.24
241360,201911,52,51,1,50900.91,998,51898.91
241370,201911,49,41,8,41917.07,7984.5,49901.57
241380,201911,39,35,4,34934.5,3992.53,38927.03
241390,201911,83,66,17,66866.51,16967.27,83833.78
241400,201911,212,172,40,172655.73,39921.44,212577.17
241410,201911,186,166,20,165676.58,19960.8,185637.38
241415,201911,101,82,19,81837.07,18963,100800.07
241420,201911,100,72,28,71859.56,27950.04,99809.60
241430,201911,28,25,3,24953.56,2994,27947.56
241440,201911,531,428,103,428233.86,102820.54,531054.40
241445,201911,35,33,2,32934.9,1996,34930.9
241450,201911,285,234,51,233564.69,50910.31,284475.00
241460,201911,140,127,13,127752.32,12974.87,140727.19
241470,201911,38,33,5,32937.85,4991.13,37928.98
241475,201911,58,55,3,54891.84,2994.47,57886.31
241480,201911,94,70,24,69866.22,24951.94,94818.16
241490,201911,10,9,1,8982.88,998.07,9980.95
241500,201911,48,37,11,36930.45,10980.8,47911.25
250010,201911,101,85,16,85832.82,15968.46,101801.28
250020,201911,33,30,3,29941.18,2994.4,32935.58
250030,201911,843,638,205,638789.21,205617.98,844407.19
250040,201911,364,300,64,299460.62,63884.57,363345.19
250050,201911,244,200,44,199607.1,43915.69,243522.79
250053,201911,58,45,13,44919.45,12975.16,57894.61
250057,201911,0,0,0,0,0,0
250060,201911,522,386,136,385297.07,135762.2,521059.27
250070,201911,712,570,142,569966.83,142749.74,712716.57
250073,201911,8,8,0,7984.87,0,7984.87
250077,201911,187,142,45,141725.82,44914.1,186639.92
250080,201911,420,328,92,328395.83,92829.66,421225.49
250090,201911,201,132,69,131741.08,70858.88,202599.96
250100,201911,521,429,92,430205.64,91830.74,522036.38
250110,201911,578,443,135,443159.21,134741.87,577901.08
250115,201911,20,6,14,5989.79,13979.33,19969.12
250120,201911,117,87,30,86828.55,29944.26,116772.81
250130,201911,568,467,101,466165.06,101822.14,567987.20
250135,201911,17,10,7,9980.47,6986.84,16967.31
250140,201911,82,74,8,73859.87,7984,81843.87
250150,201911,573,417,156,417207.77,155703.02,572910.79
250153,201911,8,6,2,5989.39,1996.51,7985.90
250157,201911,31,24,7,23952.48,6986,30938.48
250160,201911,219,171,48,171682.75,47912.94,219595.69
250170,201911,62,41,21,40921.62,20958.73,61880.35
250180,201911,4132,2828,1304,2826815.01,1305668.73,4132483.74
250190,201911,849,558,291,561909.78,291450.34,853360.12
250200,201911,51,43,8,42916.97,7984,50900.97
250205,201911,23,20,3,19962.08,2994.21,22956.29
250210,201911,85,75,10,74850.88,9980.86,84831.74
250215,201911,62,54,8,53898.92,7986.07,61884.99
250220,201911,25,19,6,18964.45,5988.94,24953.39
250230,201911,78,72,6,71862.5,5989.13,77851.63
250240,201911,228,190,38,189643.75,37929.41,227573.16
250250,201911,392,340,52,339406.41,51907.25,391313.66
250260,201911,41,35,6,34931.26,5988.4,40919.66
250270,201911,69,52,17,51896.78,16966,68862.78
250280,201911,375,312,63,313392.86,63877.13,377269.99
250290,201911,89,82,7,81842.71,6987.43,88830.14
250300,201911,557,379,178,379285.94,178663.8,557949.74
250310,201911,47,43,4,42920.56,3992.34,46912.90
250320,201911,1933,1322,611,1324576.97,610903.76,1935480.73
250330,201911,92,80,12,79851.03,11976.71,91827.74
250340,201911,24,22,2,21957.51,1996.27,23953.78
250350,201911,155,103,52,102801.84,51901.95,154703.79
250355,201911,35,27,8,26948.32,7985.5,34933.82
250360,201911,199,162,37,161696.39,36934.02,198630.41
250370,201911,2382,1605,777,1610041.29,779599.37,2389640.66
250375,201911,7,3,4,2994.88,3992.11,6986.99
250380,201911,54,40,14,39923.75,13974.89,53898.64
250390,201911,43,34,9,33938.3,8985.44,42923.74
250400,201911,16242,8274,7968,8304962.89,7984795.6,16289758.49
250403,201911,334,274,60,274464.21,59883.24,334347.45
250407,201911,59,49,10,49901.11,9982.23,59883.34
250410,201911,30,26,4,25953.45,3992.67,29946.12
250415,201911,39,26,13,25948,12974.51,38922.51
250420,201911,44,38,6,37925.69,6986.88,44912.57
250430,201911,1466,1258,208,1257861.56,209608.27,1467469.83
250435,201911,18,14,4,13974.16,3992.34,17966.50
250440,201911,680,570,110,571918.36,109794.06,681712.42
250450,201911,80,66,14,65872.88,13972.5,79845.38
250460,201911,450,309,141,310409.73,141742.4,452152.13
250470,201911,89,64,25,64871.44,24951.65,89823.09
250480,201911,322,257,65,256546.43,64891.81,321438.24
250485,201911,1,1,0,998,0,998
250490,201911,223,184,39,183634.85,38927.98,222562.83
250500,201911,85,64,21,63876.65,20958.1,84834.75
250510,201911,744,589,155,588882.56,154704.6,743587.16
250520,201911,175,120,55,119767.25,55890.88,175658.13
250523,201911,114,94,20,94812.44,19961.33,114773.77
250527,201911,100,80,20,79842.06,19960.83,99802.89
250530,201911,9,5,4,4990,3992.34,8982.34
250535,201911,25,20,5,19961.52,4991.11,24952.63
250540,201911,127,98,29,97810.69,28944.03,126754.72
250550,201911,71,68,3,67866.67,2994,70860.67
250560,201911,45,33,12,32934.9,11976,44910.9
250570,201911,163,133,30,132737.89,29940.54,162678.43
250580,201911,114,88,26,87888.92,25948.4,113837.32
250590,201911,26,17,9,16968.28,8984.59,25952.87
250600,201911,1332,893,439,893346.65,439184.55,1332531.20
250610,201911,155,133,22,133765.37,21961.12,155726.49
250620,201911,23,18,5,17965.6,4990.44,22956.04
250625,201911,72,53,19,52916.01,18969.67,71885.68
250630,201911,3015,1937,1078,1940349.99,1081062.94,3021412.93
250640,201911,218,179,39,178670.49,38929.9,217600.39
250650,201911,27,19,8,18962.11,7984.5,26946.61
250660,201911,49,38,11,37924.29,10978.77,48903.06
250670,201911,65,44,21,43913.94,20958.59,64872.53
250680,201911,396,321,75,321417.3,75863.64,397280.94
250690,201911,1951,1351,600,1353419.09,599872,1953291.09
250700,201911,923,809,114,810450.45,116777.01,927227.46
250710,201911,431,338,93,337384.87,92835.33,430220.20
250720,201911,114,87,27,86828.87,26948.09,113776.96
250730,201911,372,312,60,312412.91,60891.86,373304.77
250740,201911,53,49,4,48904.93,3992,52896.93
250750,201911,21681,13129,8552,13163730.68,8588598.47,21752329.15
250760,201911,83,66,17,65868,16966.32,82834.32
250770,201911,354,235,119,234564.21,118773.12,353337.33
250780,201911,60,44,16,43912.8,15968,59880.8
250790,201911,458,297,161,298423.76,162686.01,461109.77
250800,201911,147,134,13,136727.64,12974.9,149702.54
250810,201911,78,59,19,58883.05,18962.82,77845.87
250820,201911,152,126,26,125763,25950.92,151713.92
250830,201911,431,294,137,294477.06,136752.17,431229.23
250840,201911,52,48,4,47910.45,3992.86,51903.31
250850,201911,52,42,10,41918.61,9980.8,51899.41
250855,201911,14,11,3,10982.19,2995.2,13977.39
250860,201911,201,140,61,139724.97,60883.97,200608.94
250870,201911,31,27,4,27946.12,3992,31938.12
250880,201911,82,62,20,61878,19960.32,81838.32
250890,201911,2736,2056,680,2060084.31,680719.39,2740803.70
250900,201911,47,40,7,39922.34,6986,46908.34
250905,201911,119,93,26,92816.15,25949.08,118765.23
250910,201911,1146,828,318,828431.72,319409.54,1147841.26
250915,201911,105,73,32,72863.74,31938.64,104802.38
250920,201911,139,103,36,103795.61,35928.87,139724.48
250930,201911,167,105,62,104790.44,61878.28,166668.72
250933,201911,1,1,0,998.36,0,998.36
250937,201911,9,8,1,7984,998.54,8982.54
250939,201911,34,25,9,24952.46,8982.63,33935.09
250940,201911,106,79,27,78846.08,26951.05,105797.13
250950,201911,70,48,22,47908.51,22956.01,70864.52
250960,201911,91,50,41,49903.51,40918.73,90822.24
250970,201911,1227,872,355,872378.19,355327.86,1227706.05
250980,201911,99,68,31,67870.57,30939.41,98809.98
250990,201911,169,131,38,130738,37925.41,168663.41
251000,201911,77,69,8,68863.86,7984.88,76848.74
251010,201911,108,82,26,81840.72,25952.28,107793.00
251020,201911,79,68,11,67867.49,10980.44,78847.93
251030,201911,44,34,10,33934.55,9981.42,43915.97
251040,201911,52,38,14,37924.13,13972,51896.13
251050,201911,23,21,2,20958,1996,22954
251060,201911,50,39,11,38927.57,11976.75,50904.32
251065,201911,4,4,0,3992.65,0,3992.65
251070,201911,22,19,3,18964.71,2994.2,21958.91
251080,201911,4944,2389,2555,2388524.36,2560325.58,4948849.94
251090,201911,192,163,29,164704.14,28952.37,193656.51
251100,201911,18,17,1,16969.49,998.26,17967.75
251110,201911,44,35,9,34930,8982.44,43912.44
251120,201911,1836,1120,716,1120978.54,715713.9,1836692.44
251130,201911,395,323,72,322394.25,71862.46,394256.71
251140,201911,544,358,186,357326.24,185648.92,542975.16
251150,201911,321,278,43,277497.88,42921.81,320419.69
251160,201911,93,78,15,77846.03,14970,92816.03
251170,201911,101,82,19,82838.88,18963.31,101802.19
251180,201911,288,179,109,178669.74,109802.22,288471.96
251190,201911,196,131,65,130748.03,64879.18,195627.21
251200,201911,268,218,50,217608.31,49910.02,267518.33
251203,201911,35,33,2,32938.38,1996,34934.38
251207,201911,92,75,17,74851.78,16966,91817.78
251210,201911,1459,1066,393,1067974.71,394284.48,1462259.19
251220,201911,50,38,12,37929.03,11978.64,49907.67
251230,201911,597,505,92,505067.1,91830.16,596897.26
251240,201911,97,69,28,68862.81,27944.98,96807.79
251250,201911,1386,991,395,990169.67,395268.16,1385437.83
251260,201911,12,7,5,6989.25,4991.01,11980.26
251270,201911,325,249,76,250542.84,75860.46,326403.30
251272,201911,65,58,7,57885.52,6986.2,64871.72
251274,201911,27,21,6,20958.97,5989.69,26948.66
251275,201911,31,19,12,18964.71,11977.83,30942.54
251276,201911,15,12,3,11978.43,2995.05,14973.48
251278,201911,10,8,2,7987.54,1996.98,9984.52
251280,201911,100,96,4,95810.67,3992,99802.67
251290,201911,736,545,191,545977.29,190649.67,736626.96
251300,201911,15,12,3,11976.88,2994.2,14971.08
251310,201911,376,268,108,267511.07,107800.51,375311.58
251315,201911,27,24,3,24950.36,2995.22,27945.58
251320,201911,61,49,12,48906.74,11978.73,60885.47
251330,201911,79,70,9,70862.41,8983.45,79845.86
251335,201911,13,8,5,7984,4990.53,12974.53
251340,201911,721,426,295,425189.45,294446.12,719635.57
251350,201911,33,32,1,31936.44,998,32934.44
251360,201911,77,68,9,67866.52,8982.56,76849.08
251365,201911,15,15,0,14972.93,0,14972.93
251370,201911,5483,3715,1768,3722945.03,1766691.61,5489636.64
251380,201911,44,36,8,35934.13,7985.56,43919.69
251385,201911,3,3,0,2994.94,0,2994.94
251390,201911,763,589,174,589941.2,174696.57,764637.77
251392,201911,14,7,7,6987.56,6987.94,13975.50
251394,201911,9,9,0,8982.6,0,8982.6
251396,201911,12,8,4,7985.34,3994.06,11979.40
251398,201911,19,16,3,15968.81,2994.6,18963.41
251400,201911,37,33,4,32936.53,3992.88,36929.41
251410,201911,38,31,7,30940.25,6987,37927.25
251420,201911,104,76,28,75857.55,27948.14,103805.69
251430,201911,41,39,2,38922,2994.44,41916.44
251440,201911,33,21,12,20959.05,12974.44,33933.49
251445,201911,49,43,6,42920.39,5988.65,48909.04
251450,201911,401,349,52,349380.44,51907.26,401287.70
251455,201911,4,2,2,1996.94,1996.51,3993.45
251460,201911,17,15,2,14971.49,1996,16967.49
251465,201911,4,2,2,1996.44,1996.88,3993.32
251470,201911,46,37,9,36927.34,8982.67,45910.01
251480,201911,25,22,3,21956.88,2994,24950.88
251490,201911,120,83,37,82857.44,37937.79,120795.23
251500,201911,124,101,23,100804.51,22955.78,123760.29
251510,201911,41,29,12,28945.46,11978.72,40924.18
251520,201911,26,26,0,25949.04,0,25949.04
251530,201911,4475,3160,1315,3163905.93,1322515.49,4486421.42
251540,201911,75,64,11,63876.73,10980.57,74857.30
251550,201911,405,312,93,312425.32,93836.47,406261.79
251560,201911,21,14,7,13974.46,6987.58,20962.04
251570,201911,20,19,1,18962,998,19960
251580,201911,131,106,25,105792.04,24951.47,130743.51
251590,201911,119,86,33,86019.46,32934.11,118953.57
251593,201911,25,15,10,14971.32,9980.85,24952.17
251597,201911,67,56,11,55891.01,10979.84,66870.85
251600,201911,1104,783,321,783532.51,320393.84,1103926.35
251610,201911,235,182,53,181657.09,52899.89,234556.98
251615,201911,6,6,0,5989.03,0,5989.03
251620,201911,4224,2788,1436,2785754.17,1437328.65,4223082.82
251630,201911,455,338,117,337394.71,116793.81,454188.52
251640,201911,144,102,42,101813.04,41928.11,143741.15
251650,201911,262,192,70,191651.61,69873.43,261525.04
251660,201911,187,168,19,168700.47,18966.69,187667.16
251670,201911,363,287,76,287484.17,75863.4,363347.57
251675,201911,5,5,0,4990,0,4990
251680,201911,97,88,9,87828.52,8982.89,96811.41
251690,201911,341,278,63,277494.65,62882.05,340376.70
251700,201911,285,248,37,247556.95,36936.52,284493.47
251710,201911,23,15,8,14971.66,7985.43,22957.09
251720,201911,25,16,9,15972.94,8985.18,24958.12
251740,201911,9,7,2,6988.32,1996,8984.32
260005,201911,3163,1776,1387,1774783.24,1388528.76,3163312.00
260010,201911,1574,1148,426,1147843.94,428206.25,1576050.19
260020,201911,417,368,49,367335.2,48911.96,416247.16
260030,201911,597,428,169,427236.45,168697.97,595934.42
260040,201911,810,508,302,508094.89,305433.39,813528.28
260050,201911,1154,835,319,834436.41,318402.73,1152839.14
260060,201911,386,352,34,352340.83,33938.67,386279.50
260070,201911,1384,862,522,862481.66,523099.36,1385581.02
260080,201911,732,573,159,573986.77,158716.89,732703.66
260090,201911,511,330,181,330383.24,180673.67,511056.91
260100,201911,224,159,65,159692.39,64873.28,224565.67
260105,201911,219,118,101,117770.12,100802.56,218572.68
260110,201911,2837,2095,742,2095241.34,741667.64,2836908.98
260120,201911,2837,1463,1374,1464275.56,1381454.19,2845729.75
260130,201911,163,112,51,111782.74,50901.99,162684.73
260140,201911,2153,1401,752,1406414.72,759598.56,2166013.28
260150,201911,217,143,74,142742.36,73865.89,216608.25
260160,201911,324,274,50,274489.81,50905.42,325395.23
260170,201911,3357,2043,1314,2047265.49,1317579.15,3364844.64
260180,201911,152,129,23,128752.75,22954.82,151707.57
260190,201911,2283,1592,691,1592069.01,692772.44,2284841.45
260200,201911,962,774,188,774558.92,187643.98,962202.90
260210,201911,1442,1034,408,1037072.72,410249.61,1447322.33
260220,201911,711,641,70,644805.29,70872.79,715678.08
260230,201911,1190,892,298,892302.9,298436.44,1190739.34
260240,201911,225,168,57,167697.54,56893.34,224590.88
260250,201911,88,66,22,65877.71,21958.73,87836.44
260260,201911,1030,735,295,735622.37,294453.81,1030076.18
260270,201911,414,331,83,331352.76,83841.12,415193.88
260280,201911,1325,929,396,929257.03,396238.21,1325495.24
260290,201911,6476,3512,2964,3512578.17,2966698.2,6479276.37
260300,201911,927,807,120,808493.01,119774.49,928267.50
260310,201911,519,406,113,407246.19,114789.54,522035.73
260320,201911,869,645,224,644735.49,224565.44,869300.93
260330,201911,55,38,17,37925.82,16968.27,54894.09
260340,201911,74,55,19,54896.85,18963.07,73859.92
260345,201911,5549,3069,2480,3069464.4,2481598.32,5551062.72
260350,201911,478,348,130,349372.67,129766.74,479139.41
260360,201911,274,147,127,146716.14,127751.58,274467.72
260370,201911,713,473,240,472141.14,239568.54,711709.68
260380,201911,599,440,159,439202.83,158712.99,597915.82
260390,201911,296,250,46,250547.69,45918.23,296465.92
260392,201911,106,91,15,91823.01,14970.94,106793.95
260400,201911,4129,2384,1745,2395406.07,1746704.07,4142110.14
260410,201911,14640,7707,6933,7722952.84,6946430.17,14669383.01
260415,201911,134,118,16,117770.25,15969.37,133739.62
260420,201911,1760,1080,680,1080927.62,680700.6,1761628.22
260430,201911,193,174,19,173695.21,18964.86,192660.07
260440,201911,208,150,58,149726.72,57898.25,207624.97
260450,201911,444,320,124,321400.2,123778.78,445178.98
260460,201911,827,443,384,444178.79,386291.55,830470.34
260470,201911,359,219,140,222599.76,140741.83,363341.59
260480,201911,229,150,79,149703.45,79842.16,229545.61
260490,201911,217,181,36,180662.05,35932.13,216594.18
260500,201911,1128,756,372,757625.14,372343.59,1129968.73
260510,201911,774,622,152,623806.71,151712.3,775519.01
260515,201911,239,216,23,215580.63,22958.57,238539.20
260520,201911,3250,1979,1271,1982306.37,1274660.71,3256967.08
260530,201911,806,659,147,659791.22,148728.8,808520.02
260540,201911,561,439,122,439181.49,122775.19,561956.68
260545,201911,11,9,2,8984.4,1997.22,10981.62
260550,201911,332,207,125,207593.65,126750.96,334344.61
260560,201911,538,402,136,402280.04,135755.19,538035.23
260570,201911,985,811,174,811517.31,174670.14,986187.45
260580,201911,255,226,29,225572.39,29943.15,255515.54
260590,201911,618,358,260,358297.65,262488.07,620785.72
260600,201911,8004,4318,3686,4323860.38,3693112.81,8016973.19
260610,201911,490,332,158,332396.14,158710.73,491106.87
260620,201911,3664,1923,1741,1924359.78,1746770.78,3671130.56
260630,201911,89,83,6,82834.44,5988,88822.44
260640,201911,3581,1983,1598,1981266.83,1602036.36,3583303.19
260650,201911,329,242,87,241563.68,86845.73,328409.41
260660,201911,549,371,178,371312.85,177665.03,548977.88
260670,201911,105,78,27,77848.18,26948.53,104796.71
260680,201911,3648,2061,1587,2064309.75,1593263.53,3657573.28
260690,201911,127,94,33,93824.08,33936.16,127760.24
260700,201911,320,211,109,210621.49,109808.9,320430.39
260710,201911,38,35,3,34931.35,2996.13,37927.48
260720,201911,2363,1411,952,1413366.87,953205.33,2366572.20
260730,201911,672,508,164,510015.76,164684.5,674700.26
260740,201911,62,58,4,57886.73,3992.8,61879.53
260750,201911,607,438,169,438204.37,170697.71,608902.08
260760,201911,636,341,295,341374.09,295458.02,636832.11
260765,201911,969,501,468,502048.17,468126.44,970174.61
260770,201911,217,163,54,163683.83,53900.16,217583.99
260775,201911,792,458,334,457143.01,334397.81,791540.82
260780,201911,269,176,93,176647.78,92816.47,269464.25
260790,201911,12546,6740,5806,6743885.19,5816600.98,12560486.17
260795,201911,169,114,55,113774.94,54890.11,168665.05
260800,201911,286,238,48,237556.71,47909.92,285466.63
260805,201911,172,114,58,113780.02,57890.57,171670.59
260810,201911,746,652,94,651791.98,93826.14,745618.12
260820,201911,291,186,105,186638.68,104802.02,291440.70
260825,201911,210,148,62,147706.59,61877.58,209584.17
260830,201911,282,177,105,177647.47,104792.49,282439.96
260840,201911,231,170,61,169686.1,60886.58,230572.68
260845,201911,170,120,50,119763.59,49904.17,169667.76
260850,201911,455,337,118,337377.21,117777.58,455154.79
260860,201911,256,194,62,193624.36,61880.89,255505.25
260870,201911,376,282,94,281495.11,94827.13,376322.24
260875,201911,733,525,208,526041.9,208611.16,734653.06
260880,201911,1598,1022,576,1022024.23,581869.42,1603893.65
260890,201911,2381,1680,701,1681837.79,702705.1,2384542.89
260900,201911,985,693,292,695690.26,293471.52,989161.78
260910,201911,261,207,54,208605.42,53899.06,262504.48
260915,201911,297,212,85,211578.3,86828.7,298407.0
260920,201911,176,95,81,94812.14,80841.25,175653.39
260930,201911,398,343,55,342380.97,54895.84,397276.81
260940,201911,2729,1491,1238,1489410.35,1242888.83,2732299.18
260950,201911,2008,1168,840,1168822.53,845479.19,2014301.72
260960,201911,13652,7065,6587,7083473.87,6614478.8,13697952.67
260970,201911,426,362,64,361343.55,64879.19,426222.74
260980,201911,189,168,21,168684.69,21957.76,190642.45
260990,201911,2598,2114,484,2115169.07,485117.84,2600286.91
261000,201911,4332,2588,1744,2591044.11,1745669.64,4336713.75
261010,201911,177,129,48,130750.88,47916.04,178666.92
261020,201911,607,455,152,456170.81,152716.88,608887.69
261030,201911,237,176,61,175651.47,60880.74,236532.21
261040,201911,373,327,46,327405.47,45917.43,373322.90
261050,201911,504,439,65,439197.44,64885.61,504083.05
261060,201911,1373,893,480,894331.14,482108.7,1376439.84
261070,201911,8657,4380,4277,4396107.32,4307504.92,8703612.24
261080,201911,376,289,87,289482.91,86839.06,376321.97
261090,201911,2240,1724,516,1724776.7,517039.13,2241815.83
261100,201911,1125,789,336,787537.05,336367.42,1123904.47
261110,201911,8596,5301,3295,5304458.47,3299013.47,8603471.94
261120,201911,265,224,41,223556.91,40920.53,264477.44
261130,201911,580,344,236,344401.32,237584.48,581985.80
261140,201911,186,120,66,120763.64,65869.31,186632.95
261150,201911,683,427,256,426195.23,258511.45,684706.68
261153,201911,68,64,4,63878.94,3992,67870.94
261160,201911,76063,38197,37866,38293544.09,38009341.55,76302885.64
261170,201911,478,362,116,362314.18,115778.5,478092.68
261180,201911,1808,1119,689,1119905.06,692705.84,1812610.90
261190,201911,609,427,182,426212.75,181661.52,607874.27
261200,201911,221,191,30,190654.09,29949.61,220603.70
261210,201911,34,28,6,27944.28,5988.28,33932.56
261220,201911,2690,1886,804,1887437.4,805518.41,2692955.81
261230,201911,351,263,88,262500.34,87833.05,350333.39
261240,201911,463,404,59,405223.51,60880.9,466104.41
261245,201911,234,194,40,193615.72,39921.88,233537.60
261247,201911,172,137,35,136745.16,34935.47,171680.63
261250,201911,3026,1522,1504,1525228.98,1502303,3027531.98
261255,201911,250,228,22,227551.04,21957.36,249508.40
261260,201911,868,754,114,753639.98,113793.29,867433.27
261270,201911,195,141,54,140728.84,53897.78,194626.62
261280,201911,177,145,32,144740.72,31940.18,176680.90
261290,201911,123,88,35,87824.66,34932.32,122756.98
261300,201911,1298,947,351,947218.72,351343.06,1298561.78
261310,201911,812,547,265,546004.66,266514.68,812519.34
261320,201911,563,387,176,386290.01,175689.66,561979.67
261330,201911,994,760,234,759644.31,235599.46,995243.77
261340,201911,293,167,126,167688.48,125767.39,293455.87
261350,201911,832,594,238,592943.28,238568.79,831512.07
261360,201911,1288,843,445,842370.32,446146.11,1288516.43
261370,201911,4824,2938,1886,2938503.78,1892505.92,4831009.70
261380,201911,554,417,137,416208.58,136752.86,552961.44
261390,201911,3577,2405,1172,2409633.94,1172889.05,3582522.99
261400,201911,284,259,25,258527.34,24953.04,283480.38
261410,201911,1102,743,359,744611.65,358318.69,1102930.34
261420,201911,872,545,327,544001.87,327394.87,871396.74
261430,201911,330,296,34,295444.08,33935.84,329379.92
261440,201911,125,115,10,114786.17,9980.31,124766.48
261450,201911,2526,2064,462,2069128.4,462153.01,2531281.41
261460,201911,723,579,144,580958.04,144739.85,725697.89
261470,201911,243,190,53,192622.69,52896.67,245519.36
261480,201911,432,336,96,336391.36,95784.78,432176.14
261485,201911,344,214,130,214604.39,131760.49,346364.88
261500,201911,601,412,189,413273.9,188665.48,601939.38
261510,201911,50,33,17,32936.36,16966.78,49903.14
261520,201911,111,98,13,97824.2,12975.79,110799.99
261530,201911,4130,2612,1518,2624045.58,1526165.18,4150210.76
261540,201911,1277,772,505,771532.75,504047.09,1275579.84
261550,201911,270,132,138,131740.63,138733.13,270473.76
261560,201911,834,552,282,551029.37,283505.64,834535.01
261570,201911,395,312,83,312447.22,82854.68,395301.90
261580,201911,377,294,83,295466.15,84844.57,380310.72
261590,201911,194,157,37,157708.82,36929.81,194638.63
261600,201911,293,236,57,235577.69,56890.41,292468.10
261610,201911,98,82,16,81844.34,16968.63,98812.97
261618,201911,76,61,15,60886.03,14971.79,75857.82
261620,201911,203,121,82,120769.02,81842.83,202611.85
261630,201911,565,443,122,444184.72,123774.64,567959.36
261640,201911,6394,3405,2989,3411840.91,2998710.68,6410551.59
261650,201911,489,313,176,314390.26,177654.66,492044.92
270010,201911,528,469,59,470153.61,58900,529053.61
270020,201911,289,229,60,228583.66,59892.63,288476.29
270030,201911,8874,5763,3111,5801485.14,3134219.29,8935704.43
270040,201911,1996,1257,739,1262577.47,738606.11,2001183.58
270050,201911,157,120,37,119774.28,36932.94,156707.22
270060,201911,111,63,48,62891.04,48911.84,111802.88
270070,201911,883,647,236,648765.21,235553.49,884318.70
270080,201911,37,31,6,30940.5,5988.73,36929.23
270090,201911,18,14,4,13972,3992,17964
270100,201911,1207,802,405,801456.27,404249,1205705.27
270110,201911,127,97,30,96812.92,30941.77,127754.69
270120,201911,221,180,41,181665.36,40927.11,222592.47
270130,201911,239,165,74,164694.48,73867.12,238561.60
270135,201911,107,63,44,62877.5,44910.88,107788.38
270140,201911,1364,851,513,852346.52,516076.88,1368423.40
270150,201911,259,203,56,202628.75,55894.24,258522.99
270160,201911,519,401,118,400255.4,117787.9,518043.3
270170,201911,780,509,271,509998.42,271467.24,781465.66
270180,201911,73,57,16,56888.67,15968.54,72857.21
270190,201911,90,79,11,78851.91,10978.55,89830.46
270200,201911,104,92,12,92820.75,11976.88,104797.63
270210,201911,496,276,220,275475.51,219586.09,495061.60
270220,201911,178,142,36,141723.58,35932.19,177655.77
270230,201911,2096,1290,806,1293512.46,805461.65,2098974.11
270235,201911,707,550,157,551958.32,158699.21,710657.53
270240,201911,3099,2452,647,2459331.08,647800.98,3107132.06
270250,201911,159,116,43,115792.16,43923.11,159715.27
270255,201911,209,178,31,177646.31,30939.3,208585.61
270260,201911,360,294,66,293470.08,68881.31,362351.39
270270,201911,98,42,56,41919.24,55893.7,97812.94
270280,201911,245,137,108,136727.13,108782.66,245509.79
270290,201911,1174,897,277,895313.83,278488.28,1173802.11
270300,201911,287,196,91,195612.23,91820.15,287432.38
270310,201911,871,714,157,712660.62,156705.5,869366.12
270320,201911,843,723,120,724659.37,119778.71,844438.08
270330,201911,278,236,42,236537.57,41917.43,278455.00
270340,201911,59,47,12,46908.94,11976.04,58884.98
270350,201911,93,48,45,47910.24,44918.35,92828.59
270360,201911,61,36,25,35931.93,24951.46,60883.39
270370,201911,56,45,11,44910,10978,55888
270375,201911,72,46,26,46909.76,25951.25,72861.01
270380,201911,1003,613,390,613778.34,392220.37,1005998.71
270390,201911,191,112,79,111779.02,79841.48,191620.50
270400,201911,711,523,188,524021.57,188644.01,712665.58
270410,201911,669,487,182,487064.82,182651.04,669715.86
270420,201911,402,276,126,275491.25,126770.73,402261.98
270430,201911,32958,23704,9254,23746117.61,9287574.15,33033691.76
270440,201911,480,378,102,378294.88,101812.35,480107.23
270450,201911,794,442,352,441177.58,352342.45,793520.03
270460,201911,189,152,37,151725.66,36939.2,188664.86
270470,201911,1453,996,457,995885.07,456175.99,1452061.06
270480,201911,538,444,94,445154.5,93824.61,538979.11
270490,201911,25,20,5,19961.54,4990.44,24951.98
270500,201911,486,406,80,406257.27,79856.42,486113.69
270510,201911,783,483,300,485113.27,301446.21,786559.48
270520,201911,313,198,115,197609.2,117767.75,315376.95
270530,201911,65,56,9,55889.34,8982,64871.34
270540,201911,110,86,24,86828.03,23952.88,110780.91
270550,201911,1762,1353,409,1351435.59,408233.82,1759669.41
270560,201911,275,142,133,141749.78,134762.98,276512.76
270570,201911,501,353,148,353318.25,147725.01,501043.26
270580,201911,96,71,25,70858.17,24950.67,95808.84
270590,201911,67,53,14,52900.29,13974.7,66874.99
270600,201911,175,144,31,143751.95,30945.28,174697.23
270610,201911,206,174,32,173668.98,31938.92,205607.90
270620,201911,30,29,1,28942.88,998,29940.88
270630,201911,3772,2882,890,2886601.99,890342.03,3776944.02
270640,201911,875,648,227,648785.31,227582.07,876367.38
270642,201911,221,188,33,188645.21,32940.83,221586.04
270644,201911,249,164,85,165682.55,84845.36,250527.91
270650,201911,319,192,127,191633.18,128752.91,320386.09
270660,201911,255,211,44,212605.53,43920.59,256526.12
270670,201911,3064,2356,708,2359753.07,716668.36,3076421.43
270680,201911,453,264,189,265509.68,188654.35,454164.03
270690,201911,1154,749,405,750268.83,405232.41,1155501.24
270700,201911,32,24,8,23952.88,7984.67,31937.55
270710,201911,876,677,199,677739.2,199636.75,877375.95
270720,201911,247,193,54,193637.7,53902.64,247540.34
270730,201911,1875,1115,760,1116930.55,764592.57,1881523.12
270740,201911,42,28,14,27944.63,13973.27,41917.90
270750,201911,650,483,167,482078.58,167684.44,649763.02
270760,201911,288,212,76,213614.17,77858.95,291473.12
270770,201911,2764,1804,960,1805577.44,960251.44,2765828.88
270780,201911,79,49,30,48903.17,29942.88,78846.05
270790,201911,242,160,82,159714.06,81854.72,241568.78
270800,201911,1974,1595,379,1594036.33,380295.79,1974332.12
270810,201911,287,229,58,228554.56,57890.14,286444.70
270820,201911,150,100,50,99814.1,50908.85,150722.95
270830,201911,803,590,213,589953.75,212628.62,802582.37
270840,201911,1407,1071,336,1072944.82,337355.37,1410300.19
270850,201911,1551,959,592,960139.47,594867.42,1555006.89
270860,201911,2516,1672,844,1673809.03,847444.97,2521254.00
270870,201911,129,68,61,67868.55,60885.67,128754.22
270880,201911,894,689,205,690709.84,205615.47,896325.31
270890,201911,305,223,82,223562.63,81840.03,305402.66
270895,201911,67,57,10,56888.16,9980.3,66868.46
270900,201911,95,74,21,73862.39,20961.95,94824.34
270910,201911,310,247,63,247566.24,62883.42,310449.66
270915,201911,1905,1188,717,1188635.12,719677.28,1908312.40
270920,201911,486,408,78,410269.26,77863.31,488132.57
270930,201911,6067,4510,1557,4511457.92,1564144.77,6075602.69
270940,201911,2344,1815,529,1813544.06,530001.34,2343545.40
280010,201911,40,35,5,34933.44,4990.11,39923.55
280020,201911,464,407,57,406234.37,56892.62,463126.99
280030,201911,20152,13086,7066,13100065.85,7075758.79,20175824.64
280040,201911,327,215,112,214597.39,111793.21,326390.60
280050,201911,384,294,90,293448.84,89835.07,383283.91
280060,201911,341,224,117,223583.28,117780.77,341364.05
280067,201911,1039,747,292,745590.61,291460.03,1037050.64
280070,201911,120,99,21,98807.99,20959.22,119767.21
280100,201911,621,488,133,487093.36,133755.97,620849.33
280110,201911,74,69,5,68872.88,4991.22,73864.10
280120,201911,634,520,114,520000.34,113783.47,633783.81
280130,201911,1657,1079,578,1079922.45,577893.62,1657816.07
280140,201911,472,388,84,387261.15,83840.32,471101.47
280150,201911,379,274,105,274479.48,104801.55,379281.03
280160,201911,95,81,14,81843.59,13975.55,95819.14
280170,201911,400,268,132,268500.13,131749.13,400249.26
280190,201911,29,27,2,26947.5,1996.4,28943.9
280200,201911,29,25,4,24958.27,4992.04,29950.31
280210,201911,2881,2085,796,2085102.2,795520.9,2880623.1
280220,201911,41,33,8,32941.98,7985.47,40927.45
280230,201911,323,267,56,266515.39,55898.61,322414.00
280240,201911,118,112,6,111797.35,5989.38,117786.73
280250,201911,16,10,6,9980.59,5990.32,15970.91
280260,201911,83,73,10,72864.24,9981.12,82845.36
280270,201911,153,119,34,119765.98,33934.95,153700.93
280280,201911,190,121,69,120774.38,68870.1,189644.48
280290,201911,3324,2422,902,2421454.51,902361.66,3323816.17
280300,201911,1596,1241,355,1240699.86,356340.62,1597040.48
280310,201911,101,97,4,97813.51,3992,101805.51
280320,201911,665,465,200,465165.91,199637.46,664803.37
280330,201911,337,242,95,243561.92,94825.89,338387.81
280340,201911,400,326,74,326389.38,73863.19,400252.57
280350,201911,3601,2804,797,2801883.27,796542.87,3598426.14
280360,201911,451,295,156,294452.96,157711.23,452164.19
280370,201911,99,87,12,86839.41,11978.59,98818.00
280380,201911,55,43,12,42918.79,11978.12,54896.91
280390,201911,174,150,24,150711.8,24952.45,175664.25
280400,201911,349,238,111,237549.16,110789.82,348338.98
280410,201911,286,234,52,234573.92,51908.39,286482.31
280420,201911,168,142,26,141739.29,25950.33,167689.62
280430,201911,33,24,9,23958.69,8985.17,32943.86
280440,201911,694,541,153,541989.24,153714.81,695704.05
280445,201911,118,108,10,108800.35,9981.27,118781.62
280450,201911,1167,1005,162,1004132.11,162698.94,1166831.05
280460,201911,616,451,165,450184.65,165710.72,615895.37
280470,201911,188,174,14,173685.8,13975.24,187661.04
280480,201911,2542,1795,747,1796747.7,747668.97,2544416.67
280490,201911,272,255,17,255554.43,16969.82,272524.25
280500,201911,39,36,3,35934.23,2995.39,38929.62
280510,201911,137,110,27,109794.98,26950.85,136745.83
280520,201911,54,39,15,38925.57,14972.12,53897.69
280530,201911,73,47,26,47910.54,25957.71,73868.25
280540,201911,523,427,96,426189.87,95814.38,522004.25
280550,201911,723,669,54,668771.31,53899.01,722670.32
280560,201911,495,437,58,437191.82,57893.6,495085.42
280570,201911,2202,1719,483,1721707.19,482086.54,2203793.73
280580,201911,605,468,137,467149.09,136753.99,603903.08
280590,201911,178,112,66,111793.52,65876.39,177669.91
280600,201911,388,326,62,326392.36,61882.48,388274.84
280610,201911,123,94,29,93836.47,29945.56,123782.03
280620,201911,550,454,96,454125.72,95815.09,549940.81
280630,201911,151,125,26,124765.33,25949.96,150715.29
280640,201911,187,151,36,151709.94,35932.05,187641.99
280650,201911,87,59,28,58887,27946.6,86833.6
280660,201911,141,106,35,105805.62,34937.81,140743.43
280670,201911,1785,1127,658,1126956.78,657809.22,1784766.00
280680,201911,171,148,23,147731.51,22957.64,170689.15
280690,201911,87,77,10,76852.72,9980.71,86833.43
280700,201911,22,22,0,21961.12,0,21961.12
280710,201911,1463,1125,338,1124891.93,338373.63,1463265.56
280720,201911,116,76,40,75860.1,39924.75,115784.85
280730,201911,25,21,4,20961.78,3992.34,24954.12
280740,201911,2497,1870,627,1869516.42,629806.44,2499322.86
280750,201911,221,194,27,193676.69,26952.67,220629.36
280760,201911,750,517,233,518038.9,232570.47,750609.37
290010,201911,204,143,61,142738.21,60889.33,203627.54
290020,201911,179,164,15,163692.69,14972.9,178665.59
290030,201911,606,395,211,395263.17,211606.98,606870.15
290035,201911,127,103,24,102807.54,23955.07,126762.61
290040,201911,298,200,98,200622.51,97812.73,298435.24
290050,201911,88,68,20,67868.85,19960.34,87829.19
290060,201911,262,119,143,118768.54,143717.91,262486.45
290070,201911,5651,2799,2852,2801104.69,2857053,5658157.69
290080,201911,479,223,256,222587.04,255525.59,478112.63
290090,201911,387,175,212,174655.82,211583.22,386239.04
290100,201911,1629,1077,552,1078058.35,552007.62,1630065.97
290110,201911,827,498,329,499125.29,328416.15,827541.44
290115,201911,201,187,14,187654.96,13973.49,201628.45
290120,201911,763,504,259,503104.79,259524.64,762629.43
290130,201911,427,261,166,260529.01,166690.18,427219.19
290135,201911,296,225,71,224593.82,70869.39,295463.21
290140,201911,309,254,55,253564.58,54904.02,308468.60
290150,201911,135,100,35,99802.56,34930.92,134733.48
290160,201911,238,180,58,182677.31,57894.63,240571.94
290170,201911,92,67,25,67878.55,25952.65,93831.20
290180,201911,175,131,44,130767.16,43923.73,174690.89
290190,201911,434,357,77,358362.88,76866.02,435228.90
290195,201911,311,199,112,200617.83,114771.32,315389.15
290200,201911,274,222,52,223576.23,51900.78,275477.01
290205,201911,148,91,57,90838.62,56893.89,147732.51
290210,201911,1156,853,303,857474.53,303448.24,1160922.77
290220,201911,218,121,97,120795.78,96834.1,217629.88
290225,201911,287,113,174,112777.96,173663.41,286441.37
290230,201911,72,48,24,47912.77,23956.45,71869.22
290240,201911,340,134,206,134748.36,206605.77,341354.13
290250,201911,260,240,20,239578.69,19962.68,259541.37
290260,201911,313,255,58,254566.03,58903.24,313469.27
290265,201911,190,162,28,161713.03,27949.43,189662.46
290270,201911,1428,1188,240,1188915.47,241569.51,1430484.98
290280,201911,472,338,134,337418.63,134765.73,472184.36
290290,201911,1284,764,520,762569.01,521007.27,1283576.28
290300,201911,440,375,65,374345.07,64884.01,439229.08
290310,201911,305,136,169,135733.89,168675.92,304409.81
290320,201911,4076,2541,1535,2547500.37,1538263.99,4085764.36
290323,201911,194,170,24,169702.65,23958.5,193661.15
290327,201911,167,134,33,133766.42,32939.19,166705.61
290330,201911,95,52,43,51899.75,42918.54,94818.29
290340,201911,851,347,504,348381.1,506093.62,854474.72
290350,201911,622,382,240,383325.59,240567.42,623893.01
290360,201911,365,280,85,279499.38,84847.68,364347.06
290370,201911,919,384,535,384253.74,535946.91,920200.65
290380,201911,321,199,122,198639.93,121778.55,320418.48
290390,201911,2472,1551,921,1554217.93,922344.25,2476562.18
290395,201911,253,146,107,145730.18,106797.25,252527.43
290400,201911,277,207,70,207635.16,70874.97,278510.13
290405,201911,251,218,33,217578.52,32935.14,250513.66
290410,201911,636,533,103,533040.48,103806.32,636846.80
290420,201911,253,205,48,204618.47,47909.78,252528.25
290430,201911,480,313,167,314391.14,167676.99,482068.13
290440,201911,72,65,7,64872.54,6986,71858.54
290450,201911,208,162,46,161700.82,45918.5,207619.32
290460,201911,1930,1170,760,1169921.87,762595.95,1932517.82
290470,201911,1414,607,807,605914.77,807567.77,1413482.54
290475,201911,576,536,40,537993.8,39925.21,577919.01
290480,201911,285,159,126,158701.87,125759.52,284461.39
290485,201911,247,227,20,226562.08,19961.6,246523.68
290490,201911,1211,877,334,877374.65,336395.69,1213770.34
290500,201911,728,379,349,381318.14,348368.52,729686.66
290510,201911,229,179,50,178687.93,49911.44,228599.37
290515,201911,148,93,55,92826.27,54897.92,147724.19
290520,201911,1440,962,478,960275.43,480117.37,1440392.80
290530,201911,307,284,23,283490.48,22960.48,306450.96
290540,201911,103,56,47,55895.56,46913.63,102809.19
290550,201911,152,126,26,125752.09,25948,151700.09
290560,201911,3221,1360,1861,1362473.71,1862521.33,3224995.04
290570,201911,6064,3024,3040,3026765.15,3051751.96,6078517.11
290580,201911,1302,782,520,780559.3,519037.2,1299596.5
290590,201911,565,466,99,467138.64,98824.42,565963.06
290600,201911,1748,1213,535,1213865.98,536044.59,1749910.57
290610,201911,207,186,21,185682.77,21962.59,207645.36
290620,201911,353,315,38,314442.61,37929.87,352372.48
290630,201911,2008,861,1147,863407.69,1145876.19,2009283.88
290640,201911,156,127,29,127782.16,28950.57,156732.73
290650,201911,1726,815,911,815581.8,918399.24,1733981.04
290660,201911,275,226,49,227604.42,48908.29,276512.71
290670,201911,934,488,446,490150.73,449219.16,939369.89
290680,201911,1238,998,240,999124.88,239550.19,1238675.07
290682,201911,305,227,78,226571.82,77857.79,304429.61
290685,201911,238,152,86,151720.76,85835.31,237556.07
290687,201911,1019,657,362,657006.94,362364.8,1019371.74
290689,201911,145,79,66,79853.73,65872.42,145726.15
290690,201911,609,259,350,260532.04,351379.28,611911.32
290700,201911,243,119,124,118793.62,124784.05,243577.67
290710,201911,720,491,229,490126.76,230588.87,720715.63
290720,201911,1037,845,192,844446.11,191645.84,1036091.95
290730,201911,1145,664,481,663762.37,485086.59,1148848.96
290740,201911,16,14,2,13974.43,1996,15970.43
290750,201911,1384,627,757,626926.86,757695.17,1384622.03
290755,201911,74,66,8,65878.13,7985.22,73863.35
290760,201911,298,260,38,260550.21,38932.57,299482.78
290770,201911,192,181,11,180662.01,10979.45,191641.46
290780,201911,1071,832,239,831460.49,240558.89,1072019.38
290790,201911,368,255,113,254533.02,114793.81,369326.83
290800,201911,2542,1020,1522,1020088.85,1523206.04,2543294.89
290810,201911,461,320,141,319431.51,140744.29,460175.80
290820,201911,403,241,162,242575.17,161714.82,404289.99
290830,201911,409,294,115,294457.51,116790.74,411248.25
290840,201911,1736,1087,649,1089008.98,649787.25,1738796.23
290850,201911,815,448,367,448202.58,368356.26,816558.84
290860,201911,626,288,338,288488.98,340395.35,628884.33
290870,201911,636,450,186,451195.73,187662.4,638858.13
290880,201911,122,67,55,66872.69,54892.47,121765.16
290890,201911,370,257,113,256513.71,113784.63,370298.34
290900,201911,166,128,38,128751.23,38926.1,167677.33
290910,201911,384,300,84,299436.08,85840.93,385277.01
290920,201911,218,187,31,186668.13,30942.75,217610.88
290930,201911,840,639,201,639849.21,201634.07,841483.28
290940,201911,247,205,42,204604.18,42919.49,247523.67
290950,201911,156,96,60,95811.66,61876.23,157687.89
290960,201911,475,330,145,330396.3,145734.62,476130.92
290970,201911,250,222,28,222578.07,27947.41,250525.48
290980,201911,1605,1142,463,1145878.47,462150.55,1608029.02
290990,201911,393,333,60,332416.59,59890.07,392306.66
291000,201911,861,250,611,251511.15,609794.34,861305.49
291005,201911,2260,1014,1246,1015210.12,1248763.54,2263973.66
291010,201911,154,141,13,140747.95,13973.39,154721.34
291020,201911,102,80,22,79840.99,21957.04,101798.03
291030,201911,97,71,26,70865.1,25953.28,96818.38
291040,201911,594,328,266,328356.87,267469.68,595826.55
291050,201911,1407,782,625,784557.95,625836.58,1410394.53
291060,201911,1529,855,674,853447.12,675774.68,1529221.80
291070,201911,1961,1457,504,1464345.18,505088.13,1969433.31
291072,201911,7252,2714,4538,2719165.04,4544963.9,7264128.94
291075,201911,231,191,40,191627.79,39921.46,231549.25
291077,201911,53,37,16,36929.83,15968.89,52898.72
291080,201911,20168,8975,11193,9002196.01,11235136,20237332.01
291085,201911,299,245,54,244549.52,54900.17,299449.69
291090,201911,303,120,183,120766.05,183650.43,304416.48
291100,201911,666,201,465,201597.88,465077.48,666675.36
291110,201911,423,318,105,318456.73,105813.5,424270.23
291120,201911,2454,1208,1246,1209811.79,1252688.8,2462500.59
291125,201911,69,33,36,32941.01,35938.87,68879.88
291130,201911,204,181,23,180688.22,22960.75,203648.97
291140,201911,143,113,30,112801.23,29943.44,142744.67
291150,201911,388,152,236,152697.91,235534.6,388232.51
291160,201911,386,321,65,321426.37,64881.38,386307.75
291165,201911,34,29,5,28943.7,4991.41,33935.11
291170,201911,3109,1565,1544,1570161.47,1545210.24,3115371.71
291180,201911,1270,503,767,502105.91,767630.27,1269736.18
291185,201911,83,80,3,79846.91,2994.78,82841.69
291190,201911,1333,594,739,592938.61,739673.63,1332612.24
291200,201911,164,123,41,122781.8,40924.06,163705.86
291210,201911,2254,906,1348,904323.41,1348469.59,2252793.00
291220,201911,278,210,68,210612.85,67873.31,278486.16
291230,201911,993,351,642,350400.63,643882.45,994283.08
291240,201911,428,403,25,404237.73,24952.74,429190.47
291250,201911,445,363,82,363320.23,81842.99,445163.22
291260,201911,53,43,10,42917.82,9980.39,52898.21
291270,201911,1162,482,680,483193.03,679835.28,1163028.31
291280,201911,361,172,189,173690.02,188649.68,362339.70
291290,201911,1731,896,835,896467.2,834561.44,1731028.64
291300,201911,231,181,50,180688.13,49911.36,230599.49
291310,201911,227,208,19,210619.67,18964.46,229584.13
291320,201911,1385,986,399,988240.91,398292.26,1386533.17
291330,201911,131,112,19,111800.93,18966.86,130767.79
291340,201911,196,112,84,111796.59,83852.52,195649.11
291345,201911,138,94,44,94824.09,43915.79,138739.88
291350,201911,1635,580,1055,578887.67,1055015.08,1633902.75
291360,201911,8421,4153,4268,4157631.27,4277350.62,8434981.89
291370,201911,1135,644,491,643856.34,490129.74,1133986.08
291380,201911,257,203,54,204603.23,53896.28,258499.51
291390,201911,3874,1711,2163,1714927.12,2165162.58,3880089.70
291400,201911,2075,1492,583,1491430.28,582971.7,2074401.98
291410,201911,189,167,22,166696.28,21957.22,188653.50
291420,201911,119,88,31,87826.09,30938,118764.09
291430,201911,161,88,73,89838.45,72867.2,162705.65
291440,201911,523,429,94,429220.25,93828.87,523049.12
291450,201911,909,582,327,583946.26,328401.72,912347.98
291460,201911,1818,1488,330,1491361.21,332418.03,1823779.24
291465,201911,2179,1044,1135,1047136.59,1136993.43,2184130.02
291470,201911,2854,1447,1407,1450382.45,1409469.22,2859851.67
291480,201911,11802,5274,6528,5275635,6530398.69,11806033.69
291490,201911,584,243,341,242548.51,341356.59,583905.10
291500,201911,378,220,158,219600.61,159720.75,379321.36
291510,201911,1227,477,750,476056.86,750522.59,1226579.45
291520,201911,949,432,517,433215.47,517059.54,950275.01
291530,201911,962,270,692,269481.53,693657.61,963139.14
291535,201911,122,102,20,103795.72,19961.78,123757.50
291540,201911,343,103,240,102815.67,239562.35,342378.02
291550,201911,1213,581,632,580931.04,631828.17,1212759.21
291560,201911,5333,2714,2619,2721922.55,2622153.59,5344076.14
291570,201911,195,102,93,102802.25,92817.26,195619.51
291580,201911,1220,759,461,759631.78,465153.35,1224785.13
291590,201911,81,32,49,31939.06,48910.58,80849.64
291600,201911,1157,576,581,577007.03,579990.68,1156997.71
291610,201911,1455,716,739,714771.04,741724.01,1456495.05
291620,201911,580,268,312,267537.39,311459.94,578997.33
291630,201911,478,150,328,150709.73,328356.48,479066.21
291640,201911,3953,2023,1930,2027394.42,1934532.67,3961927.09
291650,201911,418,287,131,287493.84,130768.85,418262.69
291660,201911,400,158,242,157714.02,242563.94,400277.96
291670,201911,217,138,79,140736.55,80844.24,221580.79
291680,201911,667,394,273,394303.11,273508.48,667811.59
291685,201911,586,326,260,325404.94,259528.81,584933.75
291690,201911,549,317,232,317426.82,231608.75,549035.57
291700,201911,963,760,203,759653.82,203621.42,963275.24
291710,201911,1672,807,865,808535.3,867451.48,1675986.78
291720,201911,418,283,135,283461.2,135740.75,419201.95
291730,201911,946,564,382,563000.06,382304.64,945304.70
291733,201911,282,195,87,194642.88,86838.02,281480.90
291735,201911,74,55,19,55891.61,18964.76,74856.37
291740,201911,357,279,78,278510.61,77863.28,356373.89
291750,201911,2100,1374,726,1375619.98,727749.96,2103369.94
291760,201911,3009,1661,1348,1662791.19,1348404.99,3011196.18
291770,201911,785,530,255,529083.96,256550.93,785634.89
291780,201911,56,34,22,33942.87,21962.01,55904.88
291790,201911,160,77,83,76850.58,83833.79,160684.37
291800,201911,10055,4174,5881,4183592.28,5882458.42,10066050.70
291810,201911,1115,823,292,825498.89,293474.32,1118973.21
291820,201911,276,201,75,200617.91,75850.83,276468.74
291830,201911,1105,444,661,443221.82,660811.66,1104033.48
291835,201911,579,537,42,536985.63,41921.74,578907.37
291840,201911,4837,2483,2354,2490591.03,2355783.08,4846374.11
291845,201911,272,92,180,91820.76,179649.23,271469.99
291850,201911,327,290,37,289476,36932.68,326408.68
291855,201911,260,102,158,101800.66,158687.52,260488.18
291860,201911,169,106,63,105802.57,62880.55,168683.12
291870,201911,83,33,50,32934.68,49903.15,82837.83
291875,201911,180,167,13,167705.24,12977.7,180682.94
291880,201911,470,376,94,375346.96,93844.8,469191.76
291890,201911,238,77,161,76849.03,160687.5,237536.53
291900,201911,57,32,25,31936.17,24950.21,56886.38
291905,201911,126,92,34,91843.64,33942.3,125785.94
291910,201911,167,137,30,136737.16,29944.02,166681.18
291915,201911,424,376,48,375354.01,47914.12,423268.13
291920,201911,5005,2573,2432,2579568.86,2441764.09,5021332.95
291930,201911,177,105,72,104813.17,71868.07,176681.24
291940,201911,360,204,156,204635.89,155721.11,360357.00
291950,201911,1142,927,215,929375.74,214612.72,1143988.46
291955,201911,1239,743,496,744691.22,498121.09,1242812.31
291960,201911,184,134,50,133752.29,49903.99,183656.28
291970,201911,769,584,185,582937.78,185652.11,768589.89
291980,201911,1526,1351,175,1350673,174686.69,1525359.69
291990,201911,134,124,10,123765.18,9981.32,133746.50
291992,201911,171,84,87,83855.01,87842.99,171698.00
291995,201911,164,110,54,110797.89,53903.25,164701.14
292000,201911,386,302,84,302445.56,83848.47,386294.03
292010,201911,304,215,89,214591.04,88829.59,303420.63
292020,201911,292,212,80,211620.49,79858.19,291478.68
292030,201911,149,114,35,114782.04,34933.73,149715.77
292040,201911,636,319,317,319369.6,316377.09,635746.69
292045,201911,105,97,8,96810.57,7984.68,104795.25
292050,201911,945,690,255,689734.58,255537.37,945271.95
292060,201911,920,766,154,765610.69,153721.27,919331.96
292070,201911,51,21,30,20961.63,29941.99,50903.62
292080,201911,140,97,43,96809.3,42916.92,139726.22
292090,201911,531,191,340,191641.37,339370.93,531012.30
292100,201911,1450,628,822,626924.75,823629.33,1450554.08
292105,201911,201,174,27,173655.51,27945.59,201601.10
292110,201911,2259,852,1407,852442.21,1408402.34,2260844.55
292120,201911,696,553,143,557044.21,142744.16,699788.37
292130,201911,446,259,187,259529.57,186666.58,446196.15
292140,201911,207,166,41,165717.39,40925.69,206643.08
292145,201911,165,89,76,88833.31,75856.31,164689.62
292150,201911,1467,1199,268,1197861.12,268517.1,1466378.22
292160,201911,172,142,30,141728.68,29944.66,171673.34
292170,201911,1210,1059,151,1060081.47,150725.75,1210807.22
292180,201911,217,159,58,158720.36,57893.73,216614.09
292190,201911,163,104,59,103821.24,58892.08,162713.32
292200,201911,1315,494,821,495092.85,821479.82,1316572.67
292205,201911,127,112,15,112784.01,14970.68,127754.69
292210,201911,362,257,105,256528.2,104808.92,361337.12
292220,201911,26,21,5,20964.62,4991.44,25956.06
292225,201911,38,34,4,33940.58,3992,37932.58
292230,201911,968,776,192,775599.52,191654.31,967253.83
292240,201911,616,447,169,448211.92,168704.9,616916.82
292250,201911,1755,1162,593,1162932.77,594924.6,1757857.37
292260,201911,414,245,169,247546.08,171674.68,419220.76
292265,201911,253,180,73,179671.48,73865.73,253537.21
292270,201911,734,339,395,338385.63,395275.65,733661.28
292273,201911,197,111,86,110793.41,85839.08,196632.49
292275,201911,180,88,92,87832.31,91826.3,179658.61
292280,201911,144,103,41,102796.82,40918.56,143715.38
292285,201911,72,61,11,60879.56,10978,71857.56
292290,201911,570,393,177,393284.15,177668.16,570952.31
292300,201911,1671,642,1029,643821.66,1028109.42,1671931.08
292303,201911,106,70,36,69863.76,35930.22,105793.98
292305,201911,112,84,28,83843.06,27947.48,111790.54
292310,201911,910,603,307,601913.71,308428.83,910342.54
292320,201911,611,463,148,464184.18,148727.59,612911.77
292330,201911,175,102,73,102802.5,72858.96,175661.46
292335,201911,287,225,62,224570.48,61882.93,286453.41
292340,201911,573,403,170,403237.13,171675.81,574912.94
292350,201911,266,141,125,141728.5,124764.95,266493.45
292360,201911,707,540,167,542031.42,166698,708729.42
292370,201911,751,578,173,577938.23,172673.8,750612.03
292380,201911,649,519,130,519076.37,133768.07,652844.44
292390,201911,487,195,292,194647.02,292453.7,487100.72
292400,201911,3567,2212,1355,2213051.28,1358589.26,3571640.54
292405,201911,258,171,87,170665,89821.24,260486.24
292410,201911,142,87,55,86830.71,54894.41,141725.12
292420,201911,292,253,39,253525.37,38926.57,292451.94
292430,201911,526,410,116,410236.72,115783.05,526019.77
292440,201911,590,508,82,508047.81,82848.17,590895.98
292450,201911,259,203,56,202624.43,55894.8,258519.23
292460,201911,555,414,141,413228.15,141730.49,554958.64
292465,201911,216,178,38,179656.83,37925.58,217582.41
292467,201911,114,71,43,70867.51,42917.82,113785.33
292470,201911,280,191,89,190633.49,88827.99,279461.48
292480,201911,358,247,111,247565.99,110801.08,358367.07
292490,201911,234,164,70,164688.8,70864.64,235553.44
292500,201911,868,385,483,386336.55,486165.56,872502.11
292510,201911,3439,1593,1846,1597118.43,1847651.22,3444769.65
292520,201911,1096,517,579,518093.32,580979.99,1099073.31
292525,201911,396,278,118,277502.55,117781.23,395283.78
292530,201911,4355,1777,2578,1783865.06,2578487.25,4362352.31
292540,201911,465,262,203,262487.82,202602.79,465090.61
292550,201911,1070,582,488,581931.26,492091.27,1074022.53
292560,201911,327,307,20,307470.78,19965.7,327436.48
292570,201911,304,236,68,235588.27,67876.53,303464.80
292575,201911,491,318,173,318443.5,172697.16,491140.66
292580,201911,980,651,329,650774.72,330374.73,981149.45
292590,201911,556,486,70,485079.44,69865.69,554945.13
292593,201911,139,110,29,110789.97,28944.35,139734.32
292595,201911,195,152,43,151728.37,42921.18,194649.55
292600,201911,1251,916,335,916393.63,336391.15,1252784.78
292610,201911,133,101,32,101820.55,31945.84,133766.39
292620,201911,532,450,82,453208.94,81852.58,535061.52
292630,201911,1412,803,609,804550.62,609874.82,1414425.44
292640,201911,808,555,253,556986.51,252540.49,809527.00
292650,201911,181,153,28,152737.8,28949.45,181687.25
292660,201911,2031,1472,559,1472382.93,561012.65,2033395.58
292665,201911,147,108,39,109781.51,39921,149702.51
292670,201911,398,325,73,325434.63,73857.95,399292.58
292680,201911,256,196,60,196641.83,59897.37,256539.20
292690,201911,193,147,46,146716.57,45910.43,192627.00
292700,201911,950,635,315,633859.27,314434.33,948293.60
292710,201911,112,99,13,99811.94,13975.74,113787.68
292720,201911,922,528,394,528032.52,393258.36,921290.88
292730,201911,197,95,102,94827.99,102808.48,197636.47
292740,201911,68107,33704,34403,33881914.22,34623251.33,68505165.55
292750,201911,392,280,112,279498.17,111798.42,391296.59
292760,201911,338,281,57,280483.59,56897.31,337380.90
292770,201911,802,346,456,345391.47,456180.36,801571.83
292780,201911,410,161,249,160689.49,248517.79,409207.28
292790,201911,746,380,366,379270.13,366283.73,745553.86
292800,201911,1243,750,493,748601.86,492067.75,1240669.61
292805,201911,404,120,284,119768.57,284449.86,404218.43
292810,201911,1492,850,642,849478.72,641826.64,1491305.36
292820,201911,728,599,129,598910.98,129765.96,728676.94
292830,201911,105,87,18,86844.96,18965.18,105810.14
292840,201911,691,569,122,567977.42,122769.6,690747.02
292850,201911,139,94,45,94833.05,44922.74,139755.79
292860,201911,2169,1275,894,1279809.17,897484.19,2177293.36
292870,201911,3476,2334,1142,2336850.37,1141990.71,3478841.08
292880,201911,1488,984,504,987189.64,506072,1493261.64
292890,201911,523,445,78,444218.36,77856.61,522074.97
292895,201911,141,91,50,90837.43,49907.33,140744.76
292900,201911,398,288,110,288495.58,109809.74,398305.32
292905,201911,473,242,231,241581.55,231595.16,473176.71
292910,201911,448,346,102,346366.58,101813.57,448180.15
292920,201911,513,232,281,232592.86,283491.83,516084.69
292925,201911,490,453,37,453112.66,36928.21,490040.87
292930,201911,605,366,239,366337.36,240568.8,606906.16
292935,201911,285,121,164,121774.05,163694.93,285468.98
292937,201911,235,162,73,161698.1,73861.93,235560.03
292940,201911,193,151,42,152737.76,41926.27,194664.03
292950,201911,1134,583,551,582996.52,551056.29,1134052.81
292960,201911,601,426,175,425253.37,175689.02,600942.39
292970,201911,248,179,69,178691.53,68883.7,247575.23
292975,201911,129,73,56,72871.03,55900.39,128771.42
292980,201911,279,190,89,190640.48,88830.83,279471.31
292990,201911,1327,991,336,992239.12,335383.13,1327622.25
293000,201911,109,77,32,76855.97,31944.43,108800.40
293010,201911,2777,1678,1099,1682055.79,1103040.72,2785096.51
293015,201911,661,533,128,532044.47,127762.89,659807.36
293020,201911,329,272,57,271519.57,56900.17,328419.74
293030,201911,598,523,75,523025.84,75859.37,598885.21
293040,201911,355,284,71,284461.67,72859.33,357321.00
293050,201911,2833,1695,1138,1693884.34,1139900.72,2833785.06
293060,201911,262,213,49,212632.12,48916.96,261549.08
293070,201911,3446,1770,1676,1774891.53,1680081.85,3454973.38
293075,201911,91,60,31,60885.99,30939.72,91825.71
293076,201911,73,49,24,48907.05,23952.67,72859.72
293077,201911,488,285,203,284491.1,203628.4,488119.5
293080,201911,436,395,41,397249.76,41921.03,439170.79
293090,201911,135,119,16,118774.6,15969.36,134743.96
293100,201911,529,373,156,374337.18,155709.58,530046.76
293105,201911,348,247,101,246527.79,100810.84,347338.63
293110,201911,171,123,48,123785.05,47912.25,171697.30
293120,201911,327,223,104,223609.34,103814.65,327423.99
293130,201911,243,168,75,168683.84,74864.78,243548.62
293135,201911,7954,3143,4811,3148421.61,4815245.83,7963667.44
293140,201911,201,131,70,131777.7,69881.26,201658.96
293150,201911,332,287,45,286470.02,44912.66,331382.68
293160,201911,421,244,177,244540.86,176661.57,421202.43
293170,201911,169,119,50,118795.77,51913.2,170708.97
293180,201911,490,350,140,350356.28,140739.79,491096.07
293190,201911,1353,947,406,948332.25,407302.52,1355634.77
293200,201911,542,482,60,484136.49,59894.67,544031.16
293210,201911,389,299,90,298452.15,90829.79,389281.94
293220,201911,2523,1064,1459,1067131.4,1466378.74,2533510.14
293230,201911,1698,631,1067,631849.08,1070045.11,1701894.19
293240,201911,227,210,17,210642.59,16970.57,227613.16
293245,201911,121,101,20,101805.45,19961.64,121767.09
293250,201911,704,256,448,255560.49,449227.62,704788.11
293260,201911,295,247,48,248560.33,47912.53,296472.86
293270,201911,1146,546,600,546998.11,601896.79,1148894.90
293280,201911,266,150,116,149715.61,115783.79,265499.40
293290,201911,3042,2004,1038,2013346.55,1045097.75,3058444.30
293300,201911,723,520,203,520052.48,202619.8,722672.28
293305,201911,183,150,33,149714.68,32936.27,182650.95
293310,201911,147,112,35,112794.61,34936.35,147730.96
293315,201911,164,129,35,129777.74,35938.86,165716.60
293317,201911,94,69,25,68872.16,25950.35,94822.51
293320,201911,1034,589,445,588000.02,445244.99,1033245.01
293325,201911,185,68,117,67872.11,116770.99,184643.10
293330,201911,13499,6398,7101,6410680.07,7106354.42,13517034.49
293340,201911,266,192,74,192620.68,73855.93,266476.61
293345,201911,246,201,45,200646.73,45914.15,246560.88
293350,201911,619,359,260,358377.75,259533.01,617910.76
293360,201911,1537,1099,438,1100017.27,440209.35,1540226.62
310010,201911,137,74,63,73866.27,62880.35,136746.62
310020,201911,1038,585,453,584924.53,453141.56,1038066.09
310030,201911,332,271,61,270526.17,61891.06,332417.23
310040,201911,47,32,15,31941.24,14973.11,46914.35
310050,201911,186,119,67,118776.47,67879.85,186656.32
310060,201911,239,170,69,169693.8,68875.25,238569.05
310070,201911,13,8,5,7984.94,4990,12974.94
310080,201911,45,26,19,25952.89,18965.47,44918.36
310090,201911,999,526,473,525013.2,474115.77,999128.97
310100,201911,301,230,71,230613.14,70878.12,301491.26
310110,201911,719,393,326,395278.87,325406.47,720685.34
310120,201911,373,216,157,217584.75,157705.67,375290.42
310130,201911,32,20,12,19968.03,11980.5,31948.53
310140,201911,24,13,11,12975.78,10979.55,23955.33
310150,201911,1232,847,385,846464.74,386311.12,1232775.86
310160,201911,2051,1037,1014,1041109.52,1014067.93,2055177.45
310163,201911,87,51,36,50901.56,35929.92,86831.48
310170,201911,2550,1141,1409,1142864.17,1413356.65,2556220.82
310180,201911,131,51,80,50906.49,80856.57,131763.06
310190,201911,473,331,142,331401.78,141747.96,473149.74
310200,201911,498,319,179,319423.94,178674.98,498098.92
310205,201911,51,36,15,35929.65,14970.82,50900.47
310210,201911,281,227,54,227597.36,53907.72,281505.08
310220,201911,58,34,24,33943.81,23959.63,57903.44
310230,201911,270,188,82,187662.19,82846.17,270508.36
310240,201911,106,96,10,95822.07,9980.71,105802.78
310250,201911,102,82,20,82852.67,19964.26,102816.93
310260,201911,768,412,356,411249.52,356342.72,767592.24
310270,201911,268,178,90,178684.71,89842.31,268527.02
310280,201911,377,279,98,279487.96,98812.6,378300.56
310285,201911,211,152,59,152720.25,58889.58,211609.83
310290,201911,245,135,110,135751.07,110788.07,246539.14
310300,201911,148,123,25,123780.28,24953.98,148734.26
310310,201911,9,7,2,6988.56,1996.8,8985.36
310320,201911,29,13,16,12975.49,15968.24,28943.73
310330,201911,34,25,9,24952.99,8983.32,33936.31
310340,201911,1748,1163,585,1163856.13,586921.67,1750777.80
310350,201911,2811,1533,1278,1538218.45,1276613.09,2814831.54
310360,201911,41,34,7,33932.56,6986,40918.56
310370,201911,114,97,17,96819.41,16968.47,113787.88
310375,201911,104,39,65,38924.18,64876.34,103800.52
310380,201911,48,28,20,27950.6,19964.79,47915.39
310390,201911,92,62,30,61892.07,29946.58,91838.65
310400,201911,2354,1552,802,1559252.42,803604.23,2362856.65
310410,201911,125,73,52,72874.97,51906.04,124781.01
310420,201911,670,357,313,356353.13,313430.58,669783.71
310430,201911,314,205,109,205605.4,109783.47,315388.87
310440,201911,74,44,30,43912.9,29943.09,73855.99
310445,201911,80,67,13,66873.98,12975.37,79849.35
310450,201911,636,386,250,387342.35,249566.34,636908.69
310460,201911,257,184,73,184659.74,72863.09,257522.83
310470,201911,510,328,182,327385.59,185655.88,513041.47
310480,201911,80,60,20,59892.6,19966.59,79859.19
310490,201911,530,253,277,253559.8,277483.24,531043.04
310500,201911,131,53,78,52896.2,77853.12,130749.32
310510,201911,603,416,187,417245.42,187657.62,604903.04
310520,201911,132,93,39,92841.94,39928.56,132770.50
310530,201911,97,41,56,40920.22,55890.15,96810.37
310540,201911,455,272,183,272501.02,182668.68,455169.70
310550,201911,81,53,28,52900.89,27948.51,80849.40
310560,201911,3006,2069,937,2070315.29,935250.34,3005565.63
310570,201911,104,69,35,70871.91,34935.34,105807.25
310590,201911,363,236,127,235575.73,127771.61,363347.34
310600,201911,152,84,68,84842.5,67874.1,152716.6
310610,201911,59,24,35,23957.67,34935.51,58893.18
310620,201911,46888,22628,24260,22661686.63,24330547.67,46992234.30
310630,201911,625,403,222,404267.15,221596.98,625864.13
310640,201911,143,113,30,113779.59,29942.49,143722.08
310650,201911,162,144,18,143759.69,17967.75,161727.44
310660,201911,95,63,32,62888.32,31944.55,94832.87
310665,201911,61,45,16,44916.75,15972.72,60889.47
310670,201911,6567,2911,3656,2918809.7,3667208.77,6586018.47
310680,201911,58,36,22,35929.73,21957.24,57886.97
310690,201911,593,417,176,419210.21,175664.26,594874.47
310700,201911,58,39,19,38930.78,18963.81,57894.59
310710,201911,1332,915,417,917301.1,419216.83,1336517.93
310720,201911,115,35,80,34934.98,79857.98,114792.96
310730,201911,1427,1003,424,1004178.82,428233.6,1432412.42
310740,201911,978,548,430,548025.52,430236.58,978262.10
310750,201911,242,144,98,143736.38,97814.56,241550.94
310760,201911,62,44,18,43927.97,17968.71,61896.68
310770,201911,100,48,52,47914.22,51913.57,99827.79
310780,201911,370,302,68,302456.45,68877.17,371333.62
310790,201911,100,82,18,81853.49,17966.83,99820.32
310800,201911,453,220,233,219602.06,233567.16,453169.22
310810,201911,170,123,47,122778.73,47914.02,170692.75
310820,201911,351,277,74,277516.69,74866.83,352383.52
310825,201911,193,164,29,163707.46,30944.37,194651.83
310830,201911,469,227,242,226586.52,241546.31,468132.83
310840,201911,361,212,149,211607.6,148733.39,360340.99
310850,201911,108,87,21,86839.99,20960.82,107800.81
310855,201911,394,313,81,313448.06,81854.2,395302.26
310860,201911,1591,1180,411,1183915.57,410286.47,1594202.04
310870,201911,54,45,9,44916.79,8984.02,53900.81
310880,201911,85,65,20,64878.19,19963.53,84841.72
310890,201911,304,178,126,178676.52,126758.52,305435.04
310900,201911,648,300,348,301443.1,348366.04,649809.14
310910,201911,238,164,74,163707.2,73868.07,237575.27
310920,201911,462,274,188,277518.8,187680.13,465198.93
310925,201911,34,27,7,26956.75,6990.13,33946.88
310930,201911,1327,841,486,842449.59,486133.49,1328583.08
310940,201911,673,345,328,346381.11,328423.86,674804.97
310945,201911,123,77,46,76856.25,46913.3,123769.55
310950,201911,243,197,46,196656.65,45917.13,242573.78
310960,201911,79,28,51,27948.43,50909.74,78858.17
310970,201911,159,101,58,100828.19,57894.04,158722.23
310980,201911,45,28,17,27946.35,18965.51,46911.86
310990,201911,152,81,71,80849.66,70869.88,151719.54
311000,201911,809,409,400,410284.48,400288.84,810573.32
311010,201911,47,39,8,38928.47,7986.27,46914.74
311020,201911,43,27,16,26954.01,15971.47,42925.48
311030,201911,385,224,161,226575.18,161693.21,388268.39
311040,201911,41,36,5,35930.08,4990,40920.08
311050,201911,480,195,285,194637.81,284462.27,479100.08
311060,201911,778,437,341,438190.34,341366.46,779556.80
311070,201911,342,160,182,160692.74,182643.62,343336.36
311080,201911,108,59,49,58892.68,48917.77,107810.45
311090,201911,339,163,176,162710.66,176682.21,339392.87
311100,201911,600,362,238,361345.61,238560.88,599906.49
311110,201911,690,484,206,483093.06,205622.49,688715.55
311115,201911,77,56,21,55900.2,20967.49,76867.69
311120,201911,1074,576,498,574972.95,499094.54,1074067.49
311130,201911,373,222,151,221618.34,150729.95,372348.29
311140,201911,162,88,74,87841.65,74868.67,162710.32
311150,201911,357,236,121,237569.77,121783.68,359353.45
311160,201911,700,505,195,505096.36,196647.02,701743.38
311170,201911,84,68,16,67870.07,15969.14,83839.21
311180,201911,339,231,108,231567.74,108798.73,340366.47
311190,201911,35,19,16,18963.34,15968.34,34931.68
311200,201911,324,229,95,228583.58,96821.37,325404.95
311205,201911,33,23,10,22958.12,9981.21,32939.33
311210,201911,48,41,7,40922.47,6986.94,47909.41
311220,201911,21,19,2,18962.73,1996,20958.73
311230,201911,1643,1083,560,1083108.49,560002.31,1643110.80
311240,201911,178,115,63,114770.89,64874.67,179645.56
311250,201911,96,28,68,27948.94,67885.86,95834.80
311260,201911,553,350,203,349349.81,206620.07,555969.88
311265,201911,122,84,38,83852.05,37934.17,121786.22
311270,201911,292,195,97,194650.93,96824.48,291475.41
311280,201911,213,100,113,99810.34,113784.39,213594.73
311290,201911,105,87,18,86846.48,18964.13,105810.61
311300,201911,588,370,218,369348.1,217599.5,586947.6
311310,201911,22,17,5,16966.78,4991.56,21958.34
311320,201911,666,494,172,494096.23,171680.37,665776.60
311330,201911,1097,815,282,815520.05,281489.22,1097009.27
311340,201911,2615,1859,756,1862651.31,758545.12,2621196.43
311350,201911,275,213,62,213618.83,61886.96,275505.79
311360,201911,173,109,64,108801.95,64881.18,173683.13
311370,201911,1206,503,703,502086.32,703703.63,1205789.95
311380,201911,7,6,1,5989.92,998,6987.92
311390,201911,264,146,118,145733.76,117790.74,263524.50
311400,201911,156,104,52,103812.83,51903.96,155716.79
311410,201911,104,58,46,57895.12,45918.3,103813.42
311420,201911,304,170,134,170687.04,133748.23,304435.27
311430,201911,858,571,287,571979.91,286491.06,858470.97
311440,201911,469,333,136,334407.28,135758.26,470165.54
311450,201911,317,199,118,199658.5,118789.54,318448.04
311455,201911,284,192,92,192648.63,91836.13,284484.76
311460,201911,142,61,81,60890.02,80852.71,141742.73
311470,201911,22,13,9,12974,8983.27,21957.27
311480,201911,45,20,25,19962.72,25950.75,45913.47
311490,201911,16,10,6,9982.66,5989.19,15971.85
311500,201911,23,10,13,9980.5,12974.94,22955.44
311510,201911,638,446,192,446182.49,191647.06,637829.55
311520,201911,41,33,8,32934,7984.87,40918.87
311530,201911,1802,1344,458,1349597.96,458117.89,1807715.85
311535,201911,69,49,20,48917.6,19965.92,68883.52
311540,201911,35,30,5,29944.4,4990,34934.4
311545,201911,186,137,49,138747.81,49912.4,188660.21
311547,201911,36,29,7,28949.08,6987.61,35936.69
311550,201911,674,319,355,321414.91,354354.86,675769.77
311560,201911,43,29,14,28944.75,13972,42916.75
311570,201911,287,194,93,193651.85,92835.97,286487.82
311580,201911,328,196,132,195633.51,132746.77,328380.28
311590,201911,33,30,3,29945.81,2995.41,32941.22
311600,201911,102,80,22,79866.04,21960.22,101826.26
311610,201911,254,220,34,220599.04,34937.29,255536.33
311615,201911,67,56,11,55895.91,10980.3,66876.21
311620,201911,26,14,12,13972.67,11976.23,25948.90
311630,201911,82,68,14,67866.81,13972,81838.81
311640,201911,134,70,64,69882.3,64895.86,134778.16
311650,201911,128,90,38,89831.33,38931.76,128763.09
311660,201911,407,198,209,197635.28,208609.79,406245.07
311670,201911,156,102,54,102823.59,53906.59,156730.18
311680,201911,206,153,53,152720.22,52906.06,205626.28
311690,201911,13,9,4,8983.43,3992.93,12976.36
311700,201911,195,138,57,137750.48,56896.18,194646.66
311710,201911,201,130,71,129774.02,71870.68,201644.70
311720,201911,37,27,10,26951.57,9981.25,36932.82
311730,201911,590,397,193,398273.61,193650.99,591924.60
311740,201911,36,26,10,25954.4,9982.31,35936.71
311750,201911,712,482,230,481092.01,229571.64,710663.65
311760,201911,65,33,32,32944.19,31941.58,64885.77
311770,201911,392,198,194,197631.22,194630.08,392261.30
311780,201911,179,100,79,99816.69,78854.4,178671.09
311783,201911,85,76,9,75865.56,9981.32,85846.88
311787,201911,35,14,21,13974.84,20961.73,34936.57
311790,201911,264,122,142,121775.15,141735.62,263510.77
311800,201911,667,445,222,448213.89,223578.41,671792.30
311810,201911,48,40,8,40925.81,7986.19,48912.00
311820,201911,119,98,21,97819.29,20964.91,118784.20
311830,201911,1920,1207,713,1207814.21,712635.85,1920450.06
311840,201911,1011,563,448,563965.23,450179.76,1014144.99
311850,201911,10,6,4,5989.73,3993.87,9983.60
311860,201911,9526,4263,5263,4271490.15,5272353.49,9543843.64
311870,201911,132,70,62,70872.5,62885.04,133757.54
311880,201911,930,681,249,682805.54,251551.87,934357.41
311890,201911,214,104,110,103737.49,109814.73,213552.22
311900,201911,74,32,42,32941.03,41924.76,74865.79
311910,201911,1410,890,520,889328.61,520022.15,1409350.76
311920,201911,226,150,76,149728.37,75861.6,225589.97
311930,201911,914,528,386,529039.79,385291.99,914331.78
311940,201911,2465,1304,1161,1303703.06,1163867.01,2467570.07
311950,201911,59,44,15,43929.15,14974.22,58903.37
311960,201911,59,43,16,43923.33,15969.39,59892.72
311970,201911,24,15,9,14970.14,8982,23952.14
311980,201911,44,35,9,34934.07,8983.77,43917.84
311990,201911,41,32,9,31944.52,8984.3,40928.82
311995,201911,55,36,19,35938.39,18966.23,54904.62
312000,201911,31,23,8,22961.63,7985.24,30946.87
312010,201911,79,62,17,61894.61,16968.88,78863.49
312015,201911,89,66,23,65883.09,22960.48,88843.57
312020,201911,130,85,45,84848.17,44923.84,129772.01
312030,201911,55,41,14,40921.11,13974.18,54895.29
312040,201911,86,52,34,51902.93,33935.57,85838.50
312050,201911,214,118,96,117783.86,96815.96,214599.82
312060,201911,30,17,13,16967.66,12976.67,29944.33
312070,201911,74,47,27,46918.65,27949.85,74868.50
312080,201911,532,242,290,241554.12,289458.47,531012.59
312083,201911,57,38,19,37933.6,18966.35,56899.95
312087,201911,111,87,24,86856.45,23961,110817.45
312090,201911,3142,1896,1246,1895651.15,1249689.27,3145340.42
312100,201911,151,106,45,105587.22,44918.93,150506.15
312110,201911,112,70,42,69879.88,41925.02,111804.90
312120,201911,145,106,39,105805.82,39929.2,145735.02
312125,201911,91,48,43,47908.24,42925.13,90833.37
312130,201911,124,85,39,84851.69,38929.59,123781.28
312140,201911,138,110,28,109799.97,27947.53,137747.50
312150,201911,44,34,10,34932.83,9980,44912.83
312160,201911,1557,1029,528,1028208.78,527053.81,1555262.59
312170,201911,11,10,1,9981.29,998.51,10979.80
312180,201911,111,68,43,67877.84,42923.69,110801.53
312190,201911,34,30,4,29944.92,3992.44,33937.36
312200,201911,760,649,111,648883.91,110805.86,759689.77
312210,201911,99,59,40,58894.2,39931.57,98825.77
312220,201911,137,102,35,102812.51,36933.81,139746.32
312230,201911,3599,1739,1860,1742947.81,1860523.01,3603470.82
312235,201911,171,116,55,115804.45,54909.45,170713.90
312240,201911,102,73,29,72870.76,28948.38,101819.14
312245,201911,182,126,56,126780.92,56902.77,183683.69
312247,201911,67,47,20,46914.07,19966.03,66880.10
312250,201911,176,85,91,84845.53,90834.52,175680.05
312260,201911,116,75,41,74854.01,40922.26,115776.27
312270,201911,132,81,51,80858.34,50911.48,131769.82
312280,201911,27,13,14,13973.67,13975.96,27949.63
312290,201911,153,109,44,108802.81,44915.55,153718.36
312300,201911,205,133,72,132748.88,71867.77,204616.65
312310,201911,60,53,7,52902.23,6989.15,59891.38
312320,201911,426,271,155,270487.44,155709.32,426196.76
312330,201911,88,78,10,77846.06,9980,87826.06
312340,201911,38,17,21,16969.89,20960.2,37930.09
312350,201911,18,11,7,10978.94,6986,17964.94
312352,201911,98,71,27,70869.31,28948.68,99817.99
312360,201911,566,250,316,251549.03,315405.49,566954.52
312370,201911,302,171,131,170684.96,130759.08,301444.04
312380,201911,142,96,46,96827.16,45920.12,142747.28
312385,201911,168,135,33,134756.97,32940.3,167697.27
312390,201911,306,190,116,189657,116792.25,306449.25
312400,201911,375,286,89,286492.03,89842.91,376334.94
312410,201911,951,310,641,310447.64,640843.87,951291.51
312420,201911,628,483,145,483146.83,144750.17,627897.00
312430,201911,872,643,229,643859.34,228602.48,872461.82
312440,201911,41,31,10,30938.6,9980.44,40919.04
312450,201911,204,128,76,127769.78,75863.76,203633.54
312460,201911,33,16,17,15969.62,16967.73,32937.35
312470,201911,48,32,16,31938.56,15968,47906.56
312480,201911,193,117,76,116797.61,75870.46,192668.07
312490,201911,270,193,77,192672.83,76863.08,269535.91
312500,201911,34,19,15,18966.97,14976.51,33943.48
312510,201911,516,205,311,205628.48,311448.66,517077.14
312520,201911,32,10,22,10981,22960.31,33941.31
312530,201911,49,33,16,32943.24,15971.52,48914.76
312540,201911,99,87,12,86841.94,11977,98818.94
312550,201911,40,31,9,30947.83,8982.37,39930.20
312560,201911,222,170,52,169694.94,51910.41,221605.35
312570,201911,442,269,173,269535.01,172694.62,442229.63
312580,201911,89,47,42,47917.74,41932.68,89850.42
312590,201911,255,201,54,201632.88,53906.3,255539.18
312595,201911,137,124,13,123775.21,12976.07,136751.28
312600,201911,71,41,30,41920.7,29944.98,71865.68
312610,201911,1576,823,753,822576.55,751619.48,1574196.03
312620,201911,203,146,57,145730.43,56894.06,202624.49
312630,201911,64,54,10,54892.73,9980,64872.73
312640,201911,44,13,31,12974.98,32940.42,45915.40
312650,201911,150,127,23,127789.79,22960.21,150750.00
312660,201911,84,62,22,61891.5,21961,83852.5
312670,201911,908,600,308,598873.88,308419.46,907293.34
312675,201911,34,26,8,25952.81,7985.22,33938.03
312680,201911,78,51,27,50908.31,26948.1,77856.41
312690,201911,244,128,116,129765.19,115785.15,245550.34
312695,201911,37,31,6,30948.09,5991.91,36940.00
312700,201911,227,130,97,129765.89,97824.31,227590.20
312705,201911,84,69,15,68876.61,14973.13,83849.74
312707,201911,126,90,36,89826.26,35930.01,125756.27
312710,201911,1876,1006,870,1007149.49,870418.59,1877568.08
312720,201911,68,33,35,32942.15,34940.36,67882.51
312730,201911,279,162,117,161710.07,116790.67,278500.74
312733,201911,53,45,8,44915.19,7986.3,52901.49
312735,201911,24,15,9,14975.31,8986.63,23961.94
312737,201911,70,36,34,36933.07,33940.55,70873.62
312738,201911,56,40,16,39924.48,15971.59,55896.07
312740,201911,78,52,26,51908.71,25952.01,77860.72
312750,201911,72,52,20,52899.18,19963.64,72862.82
312760,201911,285,206,79,205628.61,78860.72,284489.33
312770,201911,7678,3584,4094,3583563.54,4097192.27,7680755.81
312780,201911,417,320,97,321450.76,97830.32,419281.08
312790,201911,22,17,5,16966.44,4990.21,21956.65
312800,201911,1594,1108,486,1109947.61,487106.63,1597054.24
312810,201911,367,235,132,235553.26,131751.28,367304.54
312820,201911,188,142,46,141733.56,45916.48,187650.04
312825,201911,25,17,8,16971.99,7986.09,24958.08
312830,201911,239,137,102,137763.06,101818.32,239581.38
312840,201911,157,111,46,110791.95,45913.69,156705.64
312850,201911,44,40,4,40922.62,3992.44,44915.06
312860,201911,154,98,56,98811,55895.88,154706.88
312870,201911,1046,550,496,549008.84,498038.82,1047047.66
312880,201911,138,93,45,93830.07,45916.43,139746.50
312890,201911,164,116,48,115803.99,47916.36,163720.35
312900,201911,198,148,50,147748.45,49915.36,197663.81
312910,201911,182,95,87,94835,86853.58,181688.58
312920,201911,155,87,68,86842.29,67878.16,154720.45
312930,201911,325,231,94,230597.26,93835.6,324432.86
312940,201911,113,81,32,80843.81,31938.89,112782.70
312950,201911,696,469,227,469147.33,227590.06,696737.39
312960,201911,176,131,45,130770.5,44922.08,175692.58
312965,201911,70,59,11,58897.94,10979.5,69877.44
312970,201911,273,222,51,222610.13,51907.28,274517.41
312980,201911,2444,1263,1181,1263758.61,1179854.72,2443613.33
312990,201911,43,23,20,22955.38,19961.18,42916.56
313000,201911,48,28,20,27947.44,19963.04,47910.48
313005,201911,171,132,39,131751.22,38929.23,170680.45
313010,201911,910,374,536,375303.29,539983.32,915286.61
313020,201911,188,102,86,101797.77,86826,188623.77
313030,201911,201,133,68,132755.8,67872.77,200628.57
313040,201911,73,25,48,24953.56,47907.27,72860.83
313050,201911,188,136,52,136744,51904.53,188648.53
313055,201911,42,32,10,31941.42,9981.45,41922.87
313060,201911,126,89,37,88829.51,36930,125759.51
313065,201911,58,41,17,40922.26,16970,57892.26
313070,201911,136,73,63,72869.82,62889.66,135759.48
313080,201911,42,18,24,17967.29,23954.33,41921.62
313090,201911,660,442,218,441200.9,219606.29,660807.19
313100,201911,169,64,105,64876.74,104811.33,169688.07
313110,201911,135,73,62,72873.48,61890.94,134764.42
313115,201911,193,108,85,107814.64,84848.17,192662.81
313120,201911,786,447,339,453177.96,338373.25,791551.21
313130,201911,5555,3059,2496,3063524.65,2501387.21,5564911.86
313140,201911,144,76,68,75853.2,68868.48,144721.68
313150,201911,308,247,61,246564.57,60891.38,307455.95
313160,201911,190,142,48,141763.53,47922.21,189685.74
313170,201911,1388,953,435,952303.74,435171.72,1387475.46
313180,201911,304,180,124,180688.83,123789.29,304478.12
313190,201911,749,454,295,456192.15,294476.31,750668.46
313200,201911,27,24,3,23957.93,2994.95,26952.88
313210,201911,1000,853,147,855465.47,146737.55,1002203.02
313220,201911,259,169,90,168699.69,89829.71,258529.40
313230,201911,270,203,67,202636.81,66879.55,269516.36
313240,201911,2108,1114,994,1114961.95,998090.18,2113052.13
313250,201911,1266,958,308,960347.59,308460.99,1268808.58
313260,201911,90,49,41,48909.66,40922.81,89832.47
313270,201911,953,566,387,569656.7,391282.48,960939.18
313280,201911,54,45,9,45910.13,8984.15,54894.28
313290,201911,221,177,44,178663.19,43916.79,222579.98
313300,201911,351,184,167,183657.8,167679.08,351336.88
313310,201911,242,122,120,122771.24,120770.78,243542.02
313320,201911,365,279,86,278518.76,85853.32,364372.08
313330,201911,1398,871,527,869416.93,527046.02,1396462.95
313340,201911,328,230,98,230596.42,97831.29,328427.71
313350,201911,498,336,162,336375.83,162698.14,499073.97
313360,201911,127,70,57,69878.87,56899.3,126778.17
313370,201911,199,72,127,72864.82,126762.08,199626.90
313375,201911,278,166,112,165687.33,111791.45,277478.78
313380,201911,1336,714,622,715757.14,622829.41,1338586.55
313390,201911,53,47,6,46908.21,5988,52896.21
313400,201911,406,276,130,278533.59,129781.07,408314.66
313410,201911,21,12,9,12976.84,8983.07,21959.91
313420,201911,4624,2486,2138,2486495.88,2139994.72,4626490.60
313430,201911,142,71,71,70878.96,70873.81,141752.77
313440,201911,1439,992,447,994238.53,447213.34,1441451.87
313450,201911,63,27,36,26946.8,35928.67,62875.47
313460,201911,379,173,206,173701.32,207634.6,381335.92
313470,201911,529,249,280,249572.3,281523.86,531096.16
313480,201911,148,107,41,106805.08,40924.06,147729.14
313490,201911,510,238,272,237576.75,272522.32,510099.07
313500,201911,23,14,9,13974.45,8985.35,22959.80
313505,201911,1009,802,207,804558.78,209624.67,1014183.45
313507,201911,102,60,42,59900.5,41928.35,101828.85
313510,201911,2774,1773,1001,1772771.42,1002190.49,2774961.91
313520,201911,3478,2721,757,2730064.38,760627.86,3490692.24
313530,201911,37,26,11,25954.38,10978.78,36933.16
313535,201911,55,45,10,44926.77,9984.22,54910.99
313540,201911,72,54,18,53897.95,17966.14,71864.09
313545,201911,114,95,19,94837.83,18966.23,113804.06
313550,201911,234,200,34,199657.42,33939.55,233596.97
313560,201911,332,165,167,165717.92,166719.28,332437.20
313570,201911,60,29,31,28950.13,30944.27,59894.40
313580,201911,1309,741,568,740627.16,567957.09,1308584.25
313590,201911,73,42,31,41926.48,30946.27,72872.75
313600,201911,684,418,266,418229.3,265516.35,683745.65
313610,201911,61,49,12,48908.66,11977.27,60885.93
313620,201911,1382,717,665,720718.13,663742.71,1384460.84
313630,201911,1610,1248,362,1249822.51,364340.46,1614162.97
313640,201911,124,76,48,75863.45,47916.74,123780.19
313650,201911,241,115,126,114800.71,125781.33,240582.04
313652,201911,17,17,0,16971.17,0,16971.17
313655,201911,63,41,22,40928.48,22958.59,63887.07
313657,201911,47,44,3,43924.32,2994.54,46918.86
313660,201911,132,93,39,92838.96,38948.54,131787.50
313665,201911,658,326,332,325421.67,334399.09,659820.76
313670,201911,10354,7141,3213,7158375.23,3225178.96,10383554.19
313680,201911,42,31,11,30945.84,10981.1,41926.94
313690,201911,150,113,37,112805.5,36931.69,149737.19
313695,201911,73,56,17,55906.45,16972.69,72879.14
313700,201911,306,245,61,246578,60889.77,307467.77
313710,201911,147,99,48,98827.49,47915.42,146742.91
313720,201911,1101,533,568,536056.79,569978.89,1106035.68
313730,201911,66,43,23,42920.03,22961.91,65881.94
313740,201911,150,121,29,121784.77,28945.84,150730.61
313750,201911,424,309,115,309443.25,114790.59,424233.84
313753,201911,235,173,62,173674.68,61889.42,235564.10
313760,201911,1279,469,810,469168.08,808577.2,1277745.28
313770,201911,361,264,97,265527,96830.34,362357.34
313780,201911,763,399,364,400245.73,364308.39,764554.12
313790,201911,29,28,1,27946.12,998,28944.12
313800,201911,139,86,53,85850.07,52908.27,138758.34
313810,201911,76,43,33,42923.77,32940.65,75864.42
313820,201911,1318,652,666,653844.92,666737.68,1320582.60
313830,201911,64,47,17,46914.88,16971.15,63886.03
313835,201911,61,51,10,50908.51,9984.28,60892.79
313840,201911,1646,1002,644,1003167.86,645803.22,1648971.08
313850,201911,205,75,130,74857.15,129762.96,204620.11
313860,201911,475,363,112,362360.35,111795.47,474155.82
313862,201911,166,110,56,109816.57,55910.69,165727.26
313865,201911,109,82,27,81842.88,26949.61,108792.49
313867,201911,48,38,10,37931.06,9980.56,47911.62
313868,201911,31,20,11,19965,10981.59,30946.59
313870,201911,120,63,57,62894.83,56902.38,119797.21
313880,201911,368,235,133,234568.47,133752.21,368320.68
313890,201911,331,177,154,176671.7,153719.5,330391.2
313900,201911,899,491,408,490097.28,408240.63,898337.91
313910,201911,136,101,35,101820.59,36931.71,138752.30
313920,201911,631,449,182,448184.73,184673.44,632858.17
313925,201911,32,29,3,28947.61,2995.3,31942.91
313930,201911,843,656,187,657864.73,187668.76,845533.49
313940,201911,1824,1149,675,1147907.24,677756.93,1825664.17
313950,201911,933,595,338,596926.27,338380.95,935307.22
313960,201911,1372,786,586,789530.86,585920.58,1375451.44
313970,201911,138,95,43,94813.61,43913.18,138726.79
313980,201911,220,139,81,138742.6,80859.15,219601.75
313990,201911,227,154,73,153720.73,73860.38,227581.11
314000,201911,912,615,297,616890.59,298463.7,915354.29
314010,201911,80,52,28,51906.9,27950.86,79857.76
314015,201911,60,17,43,16970.63,42933.57,59904.20
314020,201911,56,38,18,37933.08,17967.44,55900.52
314030,201911,77,39,38,38923.56,38922,77845.56
314040,201911,42,25,17,25953.69,16967.32,42921.01
314050,201911,285,173,112,172681.86,112785.77,285467.63
314053,201911,92,61,31,60890.83,30943.44,91834.27
314055,201911,299,188,111,188647.94,113792.01,302439.95
314060,201911,142,122,20,121775.32,19963.39,141738.71
314070,201911,1061,564,497,564980.25,497107.1,1062087.35
314080,201911,213,138,75,137760.88,75859.78,213620.66
314085,201911,137,93,44,93833.57,43923.98,137757.55
314090,201911,369,265,104,264512.35,103814.19,368326.54
314100,201911,486,399,87,398266.87,86839.81,485106.68
314110,201911,743,397,346,396278.16,346377.48,742655.64
314120,201911,90,53,37,52903.26,36931.73,89834.99
314130,201911,22,12,10,11976.51,9980.8,21957.31
314140,201911,1098,683,415,685750.04,417236.66,1102986.70
314150,201911,168,105,63,104807.21,63889.84,168697.05
314160,201911,337,257,80,256532.81,79856.38,336389.19
314170,201911,77,61,16,60892.38,15969.26,76861.64
314180,201911,727,643,84,644908.1,83857.91,728766.01
314190,201911,98,61,37,60895.52,37932.67,98828.19
314200,201911,484,332,152,331421.87,151733.61,483155.48
314210,201911,255,197,58,196647.39,57897.11,254544.50
314220,201911,310,230,80,229584.13,79853.47,309437.60
314225,201911,65,46,19,45924.65,18970.01,64894.66
314230,201911,119,55,64,54898.52,63877.78,118776.30
314240,201911,141,108,33,107812.36,33939.38,141751.74
314250,201911,50,29,21,28946.69,20960.73,49907.42
314260,201911,216,107,109,106800.32,108790.28,215590.60
314270,201911,350,273,77,272537.03,76866.12,349403.15
314280,201911,700,391,309,393290.04,309449.81,702739.85
314290,201911,533,437,96,439228.86,95828.42,535057.28
314300,201911,367,266,101,267543.43,101826.76,369370.19
314310,201911,1380,938,442,939597.06,441168.37,1380765.43
314315,201911,34,28,6,27951.22,5989.22,33940.44
314320,201911,604,401,203,400284.51,202634.68,602919.19
314330,201911,10853,5420,5433,5434531.62,5435958.62,10870490.24
314340,201911,601,277,324,276497.74,323405.23,599902.97
314345,201911,41,29,12,29951.97,11979.72,41931.69
314350,201911,184,117,67,116790.74,66872.56,183663.30
314360,201911,71,42,29,41932.67,28952.81,70885.48
314370,201911,61,46,15,45915.43,14973.1,60888.53
314380,201911,91,59,32,58885.78,32937.48,91823.26
314390,201911,3303,2128,1175,2130179.38,1175777.94,3305957.32
314400,201911,681,492,189,496141.79,190681.11,686822.90
314410,201911,465,307,158,306435.03,157699.29,464134.32
314420,201911,19,9,10,8983.64,9983.34,18966.98
314430,201911,2441,911,1530,910331.29,1534188.12,2444519.41
314435,201911,256,151,105,150710.65,104797.79,255508.44
314437,201911,30,24,6,23954.12,5988.43,29942.55
314440,201911,95,71,24,70870.52,23954.99,94825.51
314450,201911,156,111,45,111801,44918.85,156719.85
314460,201911,645,304,341,303449.33,340375.63,643824.96
314465,201911,82,57,25,56894.7,25953.84,82848.54
314467,201911,70,58,12,57899.66,11979.86,69879.52
314470,201911,402,203,199,202641.22,198647.96,401289.18
314480,201911,1074,521,553,521091.25,551975.38,1073066.63
314490,201911,64,42,22,41924.42,21962.9,63887.32
314500,201911,291,197,94,196643.73,94832.94,291476.67
314505,201911,121,80,41,79868.14,41929.17,121797.31
314510,201911,236,195,41,194674.45,40925.33,235599.78
314520,201911,1274,683,591,684807.71,590978.07,1275785.78
314530,201911,744,600,144,600978.35,144751.78,745730.13
314535,201911,210,131,79,131756.79,79850.11,211606.90
314537,201911,63,38,25,37933.96,24955.67,62889.63
314540,201911,15,10,5,9980.27,4991.15,14971.42
314545,201911,53,34,19,33940.69,18968.62,52909.31
314550,201911,81,42,39,41925.98,38932.15,80858.13
314560,201911,841,459,382,458142.51,383292.63,841435.14
314570,201911,21,17,4,16971.66,3992.06,20963.72
314580,201911,12,5,7,4990,6986.78,11976.78
314585,201911,25,19,6,18966.95,5988.36,24955.31
314587,201911,82,72,10,71869.45,9982.4,81851.85
314590,201911,569,415,154,414250.15,154717.55,568967.70
314600,201911,939,610,329,609888.83,330401.33,940290.16
314610,201911,943,503,440,508082.03,439215.9,947297.93
314620,201911,145,107,38,106803.21,37929.45,144732.66
314625,201911,92,68,24,68875.35,23956.04,92831.39
314630,201911,1176,619,557,618915.42,561002.69,1179918.11
314640,201911,80,54,26,53902.11,25952.89,79855.00
314650,201911,179,102,77,101821.27,77859.99,179681.26
314655,201911,65,47,18,46910.31,17968.31,64878.62
314660,201911,18,15,3,14972.3,2995.46,17967.76
314670,201911,201,154,47,154726.77,46919.93,201646.70
314675,201911,212,126,86,125778.23,85849.65,211627.88
314690,201911,576,314,262,313414.25,261510.57,574924.82
314700,201911,2311,1259,1052,1259801.57,1054152.84,2313954.41
314710,201911,1670,985,685,984234.52,686687.93,1670922.45
314720,201911,385,233,152,232577.75,152714.6,385292.35
314730,201911,506,265,241,266503.2,240544.06,507047.26
314740,201911,702,345,357,346359.44,358340.36,704699.80
314750,201911,21,19,2,18965.2,1996,20961.2
314760,201911,340,163,177,162704.12,176687.59,339391.71
314770,201911,106,76,30,75871.51,29950.04,105821.55
314780,201911,21,6,15,5989.48,14974.43,20963.91
314790,201911,2346,1482,864,1483324.67,865319.2,2348643.87
314795,201911,51,40,11,39930.33,10981.32,50911.65
314800,201911,2883,1700,1183,1700982.88,1183791.2,2884774.08
314810,201911,1517,869,648,870468.85,647811.28,1518280.13
314820,201911,106,61,45,60886.81,44915.29,105802.10
314830,201911,216,176,40,175692.65,39927.97,215620.62
314840,201911,88,51,37,50904.39,36935.17,87839.56
314850,201911,345,171,174,170679.75,173666.24,344345.99
314860,201911,686,519,167,519047.93,167687.11,686735.04
314870,201911,1506,798,708,798540.61,708733.28,1507273.89
314875,201911,58,50,8,49906.36,7985.65,57892.01
314880,201911,45,31,14,30942.03,13974.88,44916.91
314890,201911,54,33,21,32940.77,20964.39,53905.16
314900,201911,31,24,7,23956.41,6987.27,30943.68
314910,201911,247,167,80,166703.1,79849.26,246552.36
314915,201911,144,128,16,127766.81,15971.7,143738.51
314920,201911,106,65,41,65886.22,41928.22,107814.44
314930,201911,1060,533,527,533078.54,526037.63,1059116.17
314940,201911,48,38,10,37930.24,9982.02,47912.26
314950,201911,33,23,10,22959.1,9981.93,32941.03
314960,201911,43,33,10,32944.82,9982.9,42927.72
314970,201911,143,73,70,73873.68,69881.57,143755.25
314980,201911,301,192,109,193658.61,108808.59,302467.20
314990,201911,452,251,201,252533.09,201618.98,454152.07
314995,201911,199,62,137,61886.56,137763.54,199650.10
315000,201911,89,69,20,68882.69,19963.9,88846.59
315010,201911,45,29,16,28946.69,15970.82,44917.51
315015,201911,170,137,33,136759.73,32939.22,169698.95
315020,201911,69,57,12,56896.92,11979.27,68876.19
315030,201911,114,88,26,87850.05,25954.08,113804.13
315040,201911,71,50,21,49902.72,20959.45,70862.17
315050,201911,183,113,70,112786.17,69866.21,182652.38
315053,201911,43,34,9,33938.59,8984.34,42922.93
315057,201911,99,78,21,77849.91,20960.75,98810.66
315060,201911,71,61,10,60898.4,9981.79,70880.19
315070,201911,108,59,49,58888.04,48906.12,107794.16
315080,201911,378,306,72,305483.79,71871.47,377355.26
315090,201911,102,60,42,59890.6,41921.18,101811.78
315100,201911,81,41,40,40923.86,40924.44,81848.30
315110,201911,270,145,125,146727.15,124766.71,271493.86
315120,201911,1680,838,842,839487.65,841481.07,1680968.72
315130,201911,347,250,97,249552.69,96829.63,346382.32
315140,201911,518,301,217,300454.35,217597.29,518051.64
315150,201911,964,464,500,463168.59,500084.18,963252.77
315160,201911,216,109,107,109817.15,106817.91,216635.06
315170,201911,319,209,110,208621.9,109802.01,318423.91
315180,201911,3297,1392,1905,1395488.38,1915376.89,3310865.27
315190,201911,326,194,132,193669.09,131772.94,325442.03
315200,201911,1245,731,514,731644.41,515080.35,1246724.76
315210,201911,1614,928,686,929316.52,685715.41,1615031.93
315213,201911,41,24,17,23960.31,16975.4,40935.71
315217,201911,214,170,44,169682.89,43918.62,213601.51
315220,201911,1572,1198,374,1198860.53,376340.05,1575200.58
315230,201911,176,127,49,126764.23,48908.22,175672.45
315240,201911,426,279,147,278524.45,150745.71,429270.16
315250,201911,2537,1268,1269,1273686.28,1270581.65,2544267.93
315260,201911,141,84,57,84838.32,56889.04,141727.36
315270,201911,129,91,38,90829.52,39921.27,130750.79
315280,201911,657,431,226,431242.32,226612.16,657854.48
315290,201911,194,118,76,118766.98,75850.16,194617.14
315300,201911,71,54,17,53896.96,16969.12,70866.08
315310,201911,72,65,7,64870.52,6986.94,71857.46
315320,201911,166,97,69,96837.76,68877.3,165715.06
315330,201911,56,47,9,46912.61,8983.04,55895.65
315340,201911,385,281,104,281487.09,104810.03,386297.12
315350,201911,153,94,59,93824.32,59892.42,153716.74
315360,201911,90,47,43,46919.69,43923.91,90843.60
315370,201911,56,34,22,33938.03,21958.87,55896.90
315380,201911,11,8,3,7984.65,2994,10978.65
315390,201911,69,17,52,16970.22,51917.82,68888.04
315400,201911,851,640,211,641815.35,210610.5,852425.85
315410,201911,336,203,133,203647.64,132766.29,336413.93
315415,201911,61,46,15,45922.4,14973.61,60896.01
315420,201911,203,151,52,150726.99,51901.75,202628.74
315430,201911,660,380,280,380326.67,279490.97,659817.64
315440,201911,93,66,27,65875.03,26948.77,92823.80
315445,201911,235,192,43,193678.05,42928.57,236606.62
315450,201911,184,139,45,138741.39,44915.58,183656.97
315460,201911,3840,1935,1905,1937611.06,1906609.32,3844220.38
315470,201911,40,16,24,15970.2,23954.16,39924.36
315480,201911,64,23,41,22957.77,40927.01,63884.78
315490,201911,642,401,241,401234.56,243544.88,644779.44
315500,201911,22,15,7,14975.06,6987.11,21962.17
315510,201911,149,100,49,100813.87,48911.5,149725.37
315520,201911,69,62,7,61879.03,6986,68865.03
315530,201911,48,26,22,25948.77,22954,48902.77
315540,201911,239,161,78,160700.7,77848.52,238549.22
315550,201911,178,144,34,143747.04,33939.63,177686.67
315560,201911,740,595,145,595974.38,145756.75,741731.13
315570,201911,309,159,150,160720.02,150734.15,311454.17
315580,201911,701,468,233,468135.12,234575.79,702710.91
315590,201911,200,107,93,106820.28,92842.6,199662.88
315600,201911,301,225,76,224598.44,75867.49,300465.93
315610,201911,99,52,47,51896.93,47904.71,99801.64
315620,201911,35,27,8,26952.05,7986.75,34938.80
315630,201911,131,87,44,87841.46,43917.37,131758.83
315640,201911,67,42,25,41917.38,24950.67,66868.05
315645,201911,51,36,15,35935.05,14973.28,50908.33
315650,201911,171,125,46,124784.38,45921.28,170705.66
315660,201911,458,205,253,205643.2,255536.76,461179.96
315670,201911,2398,1184,1214,1184971.81,1216912.19,2401884.00
315680,201911,847,587,260,585899.44,261509.81,847409.25
315690,201911,679,469,210,471150.21,212620.19,683770.40
315700,201911,1888,1000,888,1004244.62,887497.43,1891742.05
315710,201911,339,100,239,99811.97,239543.21,339355.18
315720,201911,444,280,164,281491.03,163704.13,445195.16
315725,201911,198,158,40,158721.33,39930.43,198651.76
315727,201911,45,22,23,21963.66,22963.12,44926.78
315730,201911,48,46,2,45912.85,1996.4,47909.25
315733,201911,86,60,26,60886.24,25948.62,86834.86
315737,201911,50,38,12,37933.49,11977.73,49911.22
315740,201911,36,28,8,27948.83,7986.07,35934.90
315750,201911,160,120,40,119794.82,39932.91,159727.73
315760,201911,43,33,10,33934.53,9980.97,43915.50
315765,201911,123,76,47,75873.45,46922.1,122795.55
315770,201911,222,137,85,137743.09,84842.55,222585.64
315780,201911,3433,1765,1668,1762858,1673887.77,3436745.77
315790,201911,221,174,47,173686.59,46912.65,220599.24
315800,201911,284,203,81,202637.59,80857.01,283494.60
315810,201911,97,58,39,57897.51,38930.73,96828.24
315820,201911,752,545,207,546053.65,207634.67,753688.32
315830,201911,130,80,50,79854.84,50908.2,130763.04
315840,201911,86,59,27,58884.04,26947.82,85831.86
315850,201911,254,185,69,184676.66,68884.66,253561.32
315860,201911,14,5,9,4990.88,8982.34,13973.22
315870,201911,37,29,8,28947.86,7987.11,36934.97
315880,201911,104,67,37,66876.13,36932.42,103808.55
315890,201911,91,68,23,67884.33,22959.75,90844.08
315895,201911,445,296,149,296483.22,148738.5,445221.72
315900,201911,69,33,36,32942.57,35938.11,68880.68
315910,201911,38,23,15,22954.2,14971.04,37925.24
315920,201911,166,108,58,107811.18,57890.62,165701.80
315930,201911,46,18,28,17964.12,27951.44,45915.56
315935,201911,137,105,32,104819.63,31945.48,136765.11
315940,201911,99,73,26,72863.14,25950.92,98814.06
315950,201911,44,32,12,31943.32,11979.63,43922.95
315960,201911,536,257,279,256526.23,280475.96,537002.19
315970,201911,34,27,7,26950.18,6986,33936.18
315980,201911,687,338,349,337388.2,348363.54,685751.74
315990,201911,248,146,102,145744.24,102819.48,248563.72
316000,201911,53,35,18,34935.6,17965.24,52900.84
316010,201911,80,70,10,69877.63,9983.65,79861.28
316020,201911,116,99,17,98817.87,16966.77,115784.64
316030,201911,396,219,177,218623.65,177682.02,396305.67
316040,201911,515,221,294,220597.4,293465.43,514062.83
316045,201911,62,55,7,54894.39,6987.24,61881.63
316050,201911,16,13,3,12975.27,2994,15969.27
316060,201911,97,64,33,63881.81,32942.17,96823.98
316070,201911,1091,706,385,709683.83,387288.98,1096972.81
316080,201911,106,69,37,69870.75,36927.31,106798.06
316090,201911,39,22,17,21958.53,16966.85,38925.38
316095,201911,107,89,18,88838.76,17967.31,106806.07
316100,201911,311,181,130,181662.74,130755.14,312417.88
316105,201911,38,26,12,25955.09,11980.63,37935.72
316110,201911,1864,1490,374,1492344.64,374347.49,1866692.13
316120,201911,80,59,21,58891.85,20959.63,79851.48
316130,201911,121,93,28,92838.93,27952.82,120791.75
316140,201911,31,23,8,22954.79,7984.78,30939.57
316150,201911,205,141,64,140735.46,63881.69,204617.15
316160,201911,77,46,31,45921.76,30947.15,76868.91
316165,201911,67,51,16,51907.46,15974.35,67881.81
316170,201911,184,122,62,122780.62,62888.64,185669.26
316180,201911,198,88,110,87841.53,110794.05,198635.58
316190,201911,135,99,36,98819.55,35931.63,134751.18
316200,201911,665,374,291,376304.17,291454.48,667758.65
316210,201911,768,513,255,515306.51,254541.22,769847.73
316220,201911,115,76,39,75850.88,38927,114777.88
316225,201911,25,15,10,14973.15,9982.17,24955.32
316230,201911,34,19,15,18964.44,14970.11,33934.55
316240,201911,646,520,126,519076.84,127774.23,646851.07
316245,201911,125,107,18,106814.69,18965.72,125780.41
316250,201911,1539,1053,486,1058107.53,486077.65,1544185.18
316255,201911,121,97,24,96828.17,23955.93,120784.10
316257,201911,176,94,82,93825.41,81861.98,175687.39
316260,201911,189,134,55,133765.4,54902.8,188668.2
316265,201911,27,19,8,18967.07,7986.71,26953.78
316270,201911,685,482,203,483157.81,202653.99,685811.80
316280,201911,544,342,202,343403.7,202642.61,546046.31
316290,201911,737,491,246,491080.09,245544.66,736624.75
316292,201911,514,207,307,206633.35,306459.67,513093.02
316294,201911,101,61,40,60893.46,40930.24,101823.70
316295,201911,304,134,170,133757.21,171684.15,305441.36
316300,201911,101,70,31,69870.28,30944.12,100814.40
316310,201911,37,20,17,19961.01,16966.11,36927.12
316320,201911,45,27,18,26948.08,17965.29,44913.37
316330,201911,146,101,45,100818.32,44921.07,145739.39
316340,201911,140,99,41,98805.38,40920.9,139726.28
316350,201911,194,134,60,133757.22,59892.5,193649.72
316360,201911,23,14,9,13973.16,8983.87,22957.03
316370,201911,1101,574,527,572960.79,527025.73,1099986.52
316380,201911,119,90,29,89837.23,28949.91,118787.14
316390,201911,116,84,32,83848.77,31942.31,115791.08
316400,201911,133,102,31,102823.62,30947.18,133770.80
316410,201911,294,211,83,211601.25,84836.57,296437.82
316420,201911,209,144,65,143741.23,64883.51,208624.74
316430,201911,152,82,70,81843.72,69861.69,151705.41
316440,201911,90,44,46,43925.8,45922.12,89847.92
316443,201911,39,37,2,36934.4,1996.2,38930.6
316447,201911,50,38,12,37931.6,11980.47,49912.07
316450,201911,223,170,53,169684.62,53902.74,223587.36
316460,201911,74,27,47,26948.59,46911.81,73860.40
316470,201911,1657,1225,432,1225813.23,434171.24,1659984.47
316480,201911,11,9,2,8983.22,1996.87,10980.09
316490,201911,18,7,11,6986.4,10978.88,17965.28
316500,201911,151,101,50,101822.15,49907.66,151729.81
316510,201911,155,121,34,120781.29,33936.41,154717.70
316520,201911,195,121,74,121769.14,73864.94,195634.08
316530,201911,158,109,49,108820.76,48917.47,157738.23
316540,201911,140,75,65,75868.89,64879.95,140748.84
316550,201911,133,90,43,89840.76,42924.82,132765.58
316553,201911,290,134,156,134747.17,157704.2,292451.37
316555,201911,38,32,6,31940.15,5989.43,37929.58
316556,201911,11,8,3,7986.08,2994.44,10980.52
316557,201911,20,17,3,16967.38,2994.67,19962.05
316560,201911,66,48,18,47906.13,17964.78,65870.91
316570,201911,227,207,20,206640.6,19964.24,226604.84
316580,201911,18,15,3,14971.92,2994.44,17966.36
316590,201911,101,86,15,85841.31,14972.69,100814.00
316600,201911,177,147,30,146722.64,29941.95,176664.59
316610,201911,69,51,18,51902.81,17966.71,69869.52
316620,201911,142,110,32,109794.89,31940.32,141735.21
316630,201911,41,33,8,32940.41,7984.83,40925.24
316640,201911,23,15,8,14970.81,7984,22954.81
316650,201911,79,63,16,62885.1,15970.12,78855.22
316660,201911,8,3,5,2994,4991.14,7985.14
316670,201911,441,154,287,153718.71,286473.64,440192.35
316680,201911,156,107,49,106809,48912.08,155721.08
316690,201911,191,121,70,120770.84,69864.22,190635.06
316695,201911,64,55,9,55894.12,8984.6,64878.72
316700,201911,15,9,6,8982.57,5988.11,14970.68
316710,201911,765,575,190,574955.92,190655.78,765611.70
316720,201911,4897,2449,2448,2459551.06,2450368.57,4909919.63
316730,201911,16,16,0,15973.79,0,15973.79
316740,201911,137,86,51,86836.2,51902.77,138738.97
316750,201911,19,12,7,11978.84,6987.08,18965.92
316760,201911,317,254,63,253566.61,62888.03,316454.64
316770,201911,149,80,69,79854.2,68878.33,148732.53
316780,201911,72,46,26,45914.75,25950.66,71865.41
316790,201911,54,40,14,39924.27,13973.52,53897.79
316800,201911,1735,1085,650,1084043.16,654850.69,1738893.85
316805,201911,19,11,8,10979.56,7985.68,18965.24
316810,201911,69,46,23,45921.35,22960.78,68882.13
316820,201911,42,21,21,20959.65,20958.78,41918.43
316830,201911,94,45,49,44920.25,48920.49,93840.74
316840,201911,516,305,211,306458.42,210615.48,517073.90
316850,201911,336,224,112,224594.5,112794.12,337388.62
316860,201911,5931,2666,3265,2669279.75,3276911.66,5946191.41
316870,201911,1516,992,524,993262.85,524015.33,1517278.18
316880,201911,129,65,64,64881.46,63881.71,128763.17
316890,201911,242,165,77,164707.03,76866.98,241574.01
316900,201911,431,300,131,300431.11,130754.86,431185.97
316905,201911,21,10,11,9981.87,10979.19,20961.06
316910,201911,61,26,35,25951.68,34932.3,60883.98
316920,201911,135,107,28,106805.51,27948.03,134753.54
316930,201911,1880,980,900,982178.23,899298.91,1881477.14
316935,201911,898,551,347,552983.02,350358.08,903341.10
316940,201911,1091,629,462,627839.17,463147.24,1090986.41
316950,201911,178,91,87,90838.24,86847.11,177685.35
316960,201911,1105,626,479,624857.53,479137,1103994.53
316970,201911,657,518,139,518074.77,138759.72,656834.49
316980,201911,88,54,34,53903.51,34938.36,88841.87
316990,201911,2180,1468,712,1470283.5,714684.43,2184967.93
317000,201911,324,248,76,247570.26,75864.14,323434.40
317005,201911,240,170,70,169696.8,69875.22,239572.02
317010,201911,6350,3534,2816,3547716.1,2821862.98,6369579.08
317020,201911,16157,7183,8974,7203120.79,9000296.91,16203417.70
317030,201911,81,31,50,30945.27,49904.82,80850.09
317040,201911,3083,1934,1149,1938518.97,1151967.03,3090486.00
317043,201911,77,57,20,56904.97,20965.29,77870.26
317047,201911,30,17,13,16966.93,12974.78,29941.71
317050,201911,172,132,40,133753.41,39927.53,173680.94
317052,201911,127,96,31,97826.58,30944.65,128771.23
317057,201911,178,138,40,138750.33,39926.96,178677.29
317060,201911,65,42,23,41920.69,22957.8,64878.49
317065,201911,55,44,11,44916.74,10979.88,55896.62
317070,201911,1960,924,1036,928360.82,1038036.24,1966397.06
317075,201911,107,59,48,58889.83,47909.85,106799.68
317080,201911,882,460,422,459184.54,423203.02,882387.56
317090,201911,649,524,125,525064.63,125773.68,650838.31
317100,201911,421,321,100,321402.64,99818.25,421220.89
317103,201911,105,88,17,87845.91,16970.47,104816.38
317107,201911,44,39,5,38926.75,4991.04,43917.79
317110,201911,111,47,64,46920.16,63891.34,110811.50
317115,201911,46,41,5,40927.77,4990.34,45918.11
317120,201911,1882,945,937,947337.72,940361.64,1887699.36
317130,201911,1964,1310,654,1309652.81,655762.32,1965415.13
317140,201911,12,10,2,9982.61,1996.85,11979.46
317150,201911,264,160,104,160695.88,104795.98,265491.86
317160,201911,321,238,83,237580.74,82850.67,320431.41
317170,201911,215,151,64,150724.91,63876.93,214601.84
317180,201911,444,316,128,315426.47,127764.45,443190.92
317190,201911,263,181,82,180657.76,81844.08,262501.84
317200,201911,812,573,239,572959.63,238585.3,811544.93
317210,201911,185,102,83,101811.5,82843.68,184655.18
317220,201911,24,13,11,12976.6,10981,23957.6
320010,201911,609,445,164,446241.54,163721.54,609963.08
320013,201911,126,91,35,90848.74,34941.27,125790.01
320016,201911,271,169,102,168715.53,101822.99,270538.52
320020,201911,710,420,290,421266.81,291508.12,712774.93
320030,201911,150,106,44,105816.35,44918.16,150734.51
320035,201911,142,106,36,105813.6,35936.12,141749.72
320040,201911,493,257,236,257548.14,236586.96,494135.10
320050,201911,105,78,27,78873.08,26957.33,105830.41
320060,201911,1632,788,844,792660.62,846565.29,1639225.91
320070,201911,106,71,35,70884.02,34942.73,105826.75
320080,201911,804,466,338,467213.52,338428.5,805642.02
320090,201911,1234,846,388,849498.3,390319.65,1239817.95
320100,201911,326,187,139,188681.7,138773.86,327455.56
320110,201911,122,77,45,76871.44,44928.54,121799.98
320115,201911,106,88,18,87849.46,17970.19,105819.65
320120,201911,3397,1869,1528,1871668.42,1530296.79,3401965.21
320130,201911,7435,3440,3995,3451047.11,4005109.21,7456156.32
320140,201911,435,289,146,288502.08,146746.41,435248.49
320150,201911,2047,1177,870,1178929.44,870491.08,2049420.52
320160,201911,661,298,363,298468.31,363338.57,661806.88
320170,201911,109,87,22,86850.23,21964.54,108814.77
320180,201911,53,31,22,30945.81,21964.1,52909.91
320190,201911,245,161,84,161727.15,83855.7,245582.85
320200,201911,57,45,12,44924.76,11979.06,56903.82
320210,201911,898,504,394,503139.14,393328.86,896468.00
320220,201911,303,111,192,110807.91,192663.81,303471.72
320225,201911,89,72,17,71881.44,16971.36,88852.80
320230,201911,603,389,214,390353.27,213637.3,603990.57
320240,201911,3177,1582,1595,1588158.49,1598216.82,3186375.31
320245,201911,464,320,144,319456.76,143755.86,463212.62
320250,201911,229,120,109,119795.98,109814.88,229610.86
320255,201911,144,113,31,112810.49,30949.32,143759.81
320260,201911,201,142,59,141746.52,58896.8,200643.32
320265,201911,163,131,32,130769.88,31946.89,162716.77
320270,201911,151,122,29,121795.21,28951.64,150746.85
320280,201911,991,582,409,587966.94,410287.64,998254.58
320290,201911,59,49,10,49919.44,9983.88,59903.32
320300,201911,566,391,175,392316.3,174693.92,567010.22
320305,201911,683,371,312,371362.76,313462.29,684825.05
320310,201911,220,125,95,124791.12,95835.25,220626.37
320313,201911,325,165,160,166709.63,160728.14,327437.77
320316,201911,112,88,24,87853.93,23960.2,111814.13
320320,201911,3448,1588,1860,1588241.26,1859752.22,3447993.48
320330,201911,260,195,65,195635.26,64883.53,260518.79
320332,201911,852,517,335,516153.09,337538.25,853691.34
320334,201911,249,155,94,155733.87,93834.42,249568.29
320335,201911,146,102,44,103830.23,43928.99,147759.22
320340,201911,554,383,171,382352.31,170706.73,553059.04
320350,201911,976,418,558,418265.23,559035.46,977300.69
320360,201911,170,92,78,91834.43,77856.9,169691.33
320370,201911,246,186,60,185674.83,59893.43,245568.26
320380,201911,281,197,84,196653.05,83845.43,280498.48
320390,201911,1154,702,452,705790.54,453220.04,1159010.58
320400,201911,308,228,80,227622.46,79864.73,307487.19
320405,201911,947,405,542,406309.01,546068.12,952377.13
320410,201911,974,500,474,501137.43,474169.87,975307.30
320420,201911,490,242,248,242584.74,247577.35,490162.09
320425,201911,193,103,90,103819.93,89847.4,193667.33
320430,201911,388,217,171,218627.2,172705.21,391332.41
320435,201911,160,109,51,109813.14,50912.05,160725.19
320440,201911,199,118,81,117804.82,80871.33,198676.15
320450,201911,130,72,58,72882.97,57902.39,130785.36
320455,201911,246,203,43,202659.34,42928.19,245587.53
320460,201911,270,167,103,166706.94,104817.27,271524.21
320465,201911,116,80,36,79860.89,35938.33,115799.22
320470,201911,684,432,252,438239.46,253565.56,691805.02
320480,201911,194,122,72,122781.19,71874.84,194656.03
320490,201911,3062,1517,1545,1523352.06,1544335.23,3067687.29
320495,201911,106,65,41,64885.5,41932.89,106818.39
320500,201911,9679,4835,4844,4850739.27,4858717.43,9709456.70
320501,201911,546,277,269,279533.75,269553.15,549086.90
320503,201911,285,202,83,202657.01,83851.93,286508.94
320506,201911,265,192,73,191652.94,73864.44,265517.38
320510,201911,1018,465,553,467217.8,553057.5,1020275.3
320515,201911,83,67,16,67890.79,15973.49,83864.28
320517,201911,213,156,57,155744.47,56901.62,212646.09
320520,201911,6896,3020,3876,3029703.3,3895265.78,6924969.08
320530,201911,5976,3020,2956,3024646.4,2963808.74,5988455.14
330010,201911,3074,1593,1481,1597221.14,1484410.94,3081632.08
330015,201911,165,69,96,68873.92,95822.89,164696.81
330020,201911,3611,1588,2023,1592196.1,2031448.17,3623644.27
330022,201911,241,128,113,127769.27,112805.51,240574.78
330023,201911,582,196,386,195644.62,385301.66,580946.28
330025,201911,584,115,469,115785.23,469179.24,584964.47
330030,201911,1933,1240,693,1240772.51,693769.22,1934541.73
330040,201911,2429,1267,1162,1273723.73,1164926.84,2438650.57
330045,201911,8545,2703,5842,2708093.6,5866576.64,8574670.24
330050,201911,903,579,324,578962.96,324418.26,903381.22
330060,201911,964,585,379,584974.07,382314.23,967288.30
330070,201911,3522,1306,2216,1308676.37,2222100.36,3530776.73
330080,201911,1554,700,854,701759.86,853487.69,1555247.55
330090,201911,377,224,153,223611.43,152729.76,376341.19
330093,201911,275,121,154,120782.93,153723.35,274506.28
330095,201911,87,48,39,47914.88,38926.41,86841.29
330100,201911,9535,4884,4651,4902320.38,4665753.18,9568073.56
330110,201911,476,200,276,199641.11,277501.95,477143.06
330115,201911,547,289,258,288493.53,258549.32,547042.85
330120,201911,377,195,182,195652.09,181679.39,377331.48
330130,201911,1553,394,1159,397307.83,1161081.71,1558389.54
330140,201911,605,319,286,320417.38,286472.53,606889.91
330150,201911,503,289,214,288474.29,214616.55,503090.84
330160,201911,210,128,82,127764.03,81849.53,209613.56
330170,201911,26718,9301,17417,9330717.48,17487644.88,26818362.36
330180,201911,242,147,95,147721.6,94821.59,242543.19
330185,201911,916,330,586,330411.38,587020.14,917431.52
330187,201911,345,106,239,106805.48,238565.41,345370.89
330190,201911,5691,2218,3473,2224073.57,3487861.71,5711935.28
330200,201911,4672,1412,3260,1418544.1,3272391.48,4690935.58
330205,201911,423,249,174,249548.27,175684.97,425233.24
330210,201911,989,612,377,612902,376342.46,989244.46
330220,201911,2637,1594,1043,1602217.9,1043183.22,2645401.12
330225,201911,559,291,268,290470.1,268526.96,558997.06
330227,201911,2371,740,1631,742656.5,1638177,2380833.5
330230,201911,222,129,93,129765.35,93834.59,223599.94
330240,201911,3695,1878,1817,1882723.04,1820814.64,3703537.68
330245,201911,153,71,82,70866.81,82850.38,153717.19
330250,201911,6685,3457,3228,3461007.96,3230319.8,6691327.76
330260,201911,560,156,404,157714.14,406270.21,563984.35
330270,201911,3467,1218,2249,1223869.97,2257072.19,3480942.16
330280,201911,448,288,160,287489.44,159714.85,447204.29
330285,201911,7080,2270,4810,2277166.1,4827952.99,7105119.09
330290,201911,635,233,402,233571.84,406260.35,639832.19
330300,201911,770,505,265,505102.44,265532.37,770634.81
330310,201911,446,252,194,252549.33,193660.1,446209.43
330320,201911,7971,3009,4962,3020863.68,4991489.9,8012353.58
330330,201911,8879,3476,5403,3495809.72,5432332.16,8928141.88
330340,201911,2696,1600,1096,1605142.72,1102011.71,2707154.43
330350,201911,18205,7170,11035,7205295.56,11095349.86,18300645.42
330360,201911,2305,1119,1186,1124072.52,1188972.05,2313044.57
330370,201911,1023,525,498,527063.32,501140.26,1028203.58
330380,201911,864,372,492,374316.98,495107.03,869424.01
330385,201911,628,326,302,325397.15,301437.69,626834.84
330390,201911,5438,2975,2463,2992706.22,2472653.92,5465360.14
330395,201911,309,191,118,193650.86,117782.05,311432.91
330400,201911,711,386,325,386320.24,324415.07,710735.31
330410,201911,510,370,140,370352.07,139760.26,510112.33
330411,201911,253,136,117,136751.29,116784.59,253535.88
330412,201911,241,98,143,97820.19,143736.53,241556.72
330414,201911,5447,2251,3196,2261055.48,3223302.45,5484357.93
330415,201911,584,262,322,261541.11,324426.71,585967.82
330420,201911,2235,1165,1070,1170861.75,1079046.31,2249908.06
330430,201911,1772,824,948,826577.89,949292.39,1775870.28
330440,201911,275,137,138,136741.79,138740.49,275482.28
330450,201911,118,49,69,48913.91,69878.12,118792.03
330452,201911,1871,858,1013,862471.65,1013180.03,1875651.68
330455,201911,109877,39537,70340,39655351.37,70774480.86,110429832.23
330460,201911,262,108,154,107808.58,153733.43,261542.01
330470,201911,1232,675,557,676779.32,556007.12,1232786.44
330475,201911,1448,384,1064,385314.51,1066111.1,1451425.61
330480,201911,795,426,369,426233,369357.49,795590.49
330490,201911,14016,4740,9276,4762441.09,9353187.15,14115628.24
330500,201911,1393,607,786,606931.1,787620.37,1394551.47
330510,201911,10910,3785,7125,3802389.9,7165441.91,10967831.81
330513,201911,102,52,50,51901.83,49903.09,101804.92
330515,201911,813,335,478,334426.44,479193.29,813619.73
330520,201911,2493,904,1589,906449.23,1591277.14,2497726.37
330530,201911,207,115,92,114791.99,91835.59,206627.58
330540,201911,364,179,185,178678.47,184678.59,363357.06
330550,201911,2895,1034,1861,1035179.05,1875716.22,2910895.27
330555,201911,817,322,495,321407.72,497096.37,818504.09
330560,201911,664,214,450,214641.31,450238.06,664879.37
330570,201911,260,187,73,186706.05,73868.86,260574.91
330575,201911,786,308,478,308467.38,479183.71,787651.09
330580,201911,3343,1876,1467,1879628.65,1475410.34,3355038.99
330590,201911,295,150,145,149732.73,146743.87,296476.60
330600,201911,1152,734,418,739689.38,417270.06,1156959.44
330610,201911,1580,862,718,863446.16,717718.72,1581164.88
330615,201911,203,158,45,157717.15,45918.74,203635.89
330620,201911,1068,434,634,433249.47,634931.73,1068181.20
330630,201911,4061,2577,1484,2583348.07,1487299.68,4070647.75
350010,201911,601,410,191,409266.2,190653.74,599919.94
350020,201911,50,22,28,21961.97,27954.13,49916.10
350030,201911,517,328,189,328415.16,189664.21,518079.37
350040,201911,122,48,74,47911.9,73864.97,121776.87
350050,201911,301,159,142,158712.23,142733.94,301446.17
350055,201911,89,46,43,46913.7,42919.3,89833.0
350060,201911,80,28,52,27949.98,51903.55,79853.53
350070,201911,811,481,330,481154.98,330425.52,811580.50
350075,201911,70,48,22,47913.45,21961.09,69874.54
350080,201911,54,30,24,29946.54,23958.25,53904.79
350090,201911,85,47,38,47914.96,38927.52,86842.48
350100,201911,290,179,111,178667.52,110793.77,289461.29
350110,201911,58,39,19,38935.93,18965.37,57901.30
350115,201911,151,92,59,91834.5,59891.45,151725.95
350120,201911,107,71,36,70874.01,35939.27,106813.28
350130,201911,351,164,187,163720.11,186677.93,350398.04
350140,201911,42,28,14,27948.47,13975.74,41924.21
350150,201911,73,55,18,54896.56,17965.71,72862.27
350160,201911,2489,987,1502,987252.6,1506170.58,2493423.18
350170,201911,393,235,158,237577,157718.03,395295.03
350180,201911,175,100,75,99817.98,74866.03,174684.01
350190,201911,1006,528,478,528103.5,479099.33,1007202.83
350200,201911,71,25,46,24950.74,46910.26,71861.00
350210,201911,1308,733,575,731698.2,573974.47,1305672.67
350220,201911,668,563,105,562972.22,104809.37,667781.59
350230,201911,76,53,23,52898.67,22959.29,75857.96
350240,201911,64,45,19,44920.26,18968.26,63888.52
350250,201911,1146,551,595,554039.68,595966.39,1150006.07
350260,201911,92,67,25,66879.11,24954.1,91833.21
350270,201911,847,566,281,564967.4,280499.8,845467.2
350275,201911,301,127,174,126783.29,174699.76,301483.05
350280,201911,4638,2354,2284,2358767.45,2289681.8,4648449.25
350290,201911,435,201,234,201642.84,234589.01,436231.85
350300,201911,55,29,26,28952.48,25951.74,54904.22
350310,201911,92,57,35,56894.37,34936.99,91831.36
350315,201911,41,24,17,23954.74,16968.46,40923.20
350320,201911,3304,1612,1692,1615122.73,1690883.49,3306006.22
350330,201911,1662,896,766,897383.34,769589.6,1666972.94
350335,201911,18,13,5,12976.76,4992.74,17969.50
350340,201911,123,59,64,58901.67,63890.31,122791.98
350350,201911,90,45,45,44923.46,44921.91,89845.37
350360,201911,122,81,41,81857.69,40923.77,122781.46
350370,201911,84,47,37,46914.81,37931.06,84845.87
350380,201911,781,329,452,330412.61,453170.47,783583.08
350390,201911,1529,604,925,604922.49,926342.29,1531264.78
350395,201911,24,19,5,18968.62,4990.77,23959.39
350400,201911,1705,876,829,879414.82,828438.92,1707853.74
350410,201911,2478,1081,1397,1087086.12,1400446.4,2487532.52
350420,201911,246,149,97,148731.48,96828.87,245560.35
350430,201911,73,45,28,44919.13,28947.85,73866.98
350440,201911,150,109,41,108808.89,40928.51,149737.40
350450,201911,1642,985,657,984238.75,661748.53,1645987.28
350460,201911,373,126,247,127787.6,246576.03,374363.63
350470,201911,19,12,7,11978.35,6987.96,18966.31
350480,201911,167,92,75,93832.49,74864.88,168697.37
350490,201911,236,118,118,118791.7,118789.28,237580.98
350500,201911,50,19,31,18964.19,30941.13,49905.32
350510,201911,165,108,57,107809.43,56898.6,164708.03
350520,201911,453,225,228,224606.13,228586.65,453192.78
350530,201911,448,209,239,209628.95,238576.68,448205.63
350535,201911,78,64,14,63891.23,13975.61,77866.84
350540,201911,387,192,195,192655.1,194654.75,387309.85
350550,201911,2754,1637,1117,1640115.62,1116916.21,2757031.83
350560,201911,650,454,196,454164.63,195644.93,649809.56
350570,201911,4119,1720,2399,1724994.92,2404712.77,4129707.69
350580,201911,375,176,199,175679.49,198631.01,374310.50
350590,201911,894,493,401,493098.64,401278.44,894377.08
350600,201911,6124,3003,3121,3008608.29,3134107.65,6142715.94
350610,201911,1525,794,731,795581.07,732636.67,1528217.74
350620,201911,29,19,10,18965.7,9982.16,28947.86
350630,201911,239,132,107,131758.18,106803.35,238561.53
350635,201911,941,385,556,387303.93,561003.48,948307.41
350640,201911,127,94,33,93826.18,32939.76,126765.94
350650,201911,1884,1250,634,1252782.5,638821.8,1891604.3
350660,201911,746,325,421,325421.08,424245.76,749666.84
350670,201911,304,149,155,149717.74,154699.3,304417.04
350680,201911,180,94,86,94834.3,85850.18,180684.48
350690,201911,195,101,94,100821.25,94829.39,195650.64
350700,201911,768,366,402,365345.12,402274.45,767619.57
350710,201911,361,132,229,133764.36,229590.69,363355.05
350715,201911,53,42,11,41920.3,10980,52900.3
350720,201911,16,10,6,9981.65,5990.04,15971.69
350730,201911,46,28,18,27948.1,17966.58,45914.68
350740,201911,212,122,90,121773.92,90832.13,212606.05
350745,201911,22,11,11,10982.75,10980.57,21963.32
350750,201911,2194,1364,830,1365560.4,831435.46,2196995.86
350760,201911,3757,1643,2114,1649172.19,2117081.8,3766253.99
350770,201911,63,46,17,45914.85,16967.59,62882.44
350775,201911,46,32,14,31944.31,13973.71,45918.02
350780,201911,436,221,215,222594.38,215618.42,438212.80
350790,201911,377,158,219,157718.93,219612.44,377331.37
350800,201911,460,272,188,271509.81,188658.34,460168.15
350810,201911,509,415,94,416255.58,94829.99,511085.57
350820,201911,91,56,35,56889.59,34937.03,91826.62
350830,201911,81,42,39,41923.83,38928.15,80851.98
350840,201911,765,317,448,318432.6,449200.37,767632.97
350850,201911,1742,984,758,984259.23,759630.03,1743889.26
350860,201911,597,342,255,341407.66,254564.53,595972.19
350870,201911,426,287,139,286474.81,138742.35,425217.16
350880,201911,287,156,131,156727.62,130777.87,287505.49
350890,201911,40,27,13,26953.94,12978.46,39932.40
350900,201911,1437,458,979,459184.03,985282.11,1444466.14
350910,201911,25,15,10,14974.52,9981.55,24956.07
350920,201911,669,356,313,355353.45,313426.55,668780.00
350925,201911,1204,643,561,643847.71,561003.73,1204851.44
350930,201911,98,61,37,60890.8,37930.62,98821.42
350940,201911,713,396,317,397295.03,318434.98,715730.01
350945,201911,110,79,31,78858.41,31947.17,110805.58
350950,201911,16239,7718,8521,7734203.51,8562117.73,16296321.24
350960,201911,1308,615,693,617905.51,701740.25,1319645.76
350970,201911,1098,576,522,576870.97,527109.74,1103980.71
350980,201911,95,62,33,61887.31,32940.34,94827.65
350990,201911,379,138,241,137748.64,242560.67,380309.31
350995,201911,38,16,22,15970.47,21963.84,37934.31
351000,201911,636,441,195,440192.89,194658.83,634851.72
351010,201911,50,31,19,31941.58,18964.37,50905.95
351015,201911,52,37,15,36935.56,14971.9,51907.46
351020,201911,1598,962,636,964233.25,637836.18,1602069.43
351030,201911,345,232,113,232562.66,112783.33,345345.99
351040,201911,867,456,411,456176.51,410260.94,866437.45
351050,201911,3293,1507,1786,1506375.69,1787737.15,3294112.84
351060,201911,5167,2049,3118,2052459.01,3125186.22,5177645.23
351070,201911,410,254,156,254568.36,155735.87,410304.23
351080,201911,766,558,208,556970.1,209614.02,766584.12
351090,201911,54,24,30,23955.19,29943.68,53898.87
351100,201911,433,251,182,250558.59,181680.87,432239.46
351110,201911,2063,988,1075,990235.97,1076985.39,2067221.36
351120,201911,68,33,35,32941.23,34940.43,67881.66
351130,201911,180,58,122,57895.32,121783.17,179678.49
351140,201911,328,225,103,224587.9,102813.61,327401.51
351150,201911,437,231,206,230581.11,205620.77,436201.88
351160,201911,266,180,86,182673.49,88837.7,271511.19
351170,201911,186,100,86,100813.92,85840.93,186654.85
351190,201911,86,58,28,57897.7,27949.81,85847.51
351200,201911,363,245,118,245551.28,117789.13,363340.41
351210,201911,116,61,55,60897.41,55898.99,116796.40
351220,201911,532,320,212,320419.8,213606.58,534026.38
351230,201911,275,191,84,193648.7,83851.39,277500.09
351240,201911,231,108,123,108795.64,123768.72,232564.36
351250,201911,78,55,23,54901.62,22959.95,77861.57
351260,201911,156,117,39,116770.51,38923.62,155694.13
351270,201911,46,19,27,18965.08,26948.81,45913.89
351280,201911,1020,466,554,466157.66,556006.37,1022164.03
351290,201911,244,108,136,107812.45,135765.32,243577.77
351300,201911,3749,1696,2053,1698967.2,2062367.82,3761335.02
351310,201911,762,387,375,389298.45,374367.64,763666.09
351320,201911,116,66,50,66883.88,49915.37,116799.25
351330,201911,39,24,15,23956.85,14972.91,38929.76
351340,201911,1238,742,496,740682.5,495084.47,1235766.97
351350,201911,2487,1441,1046,1442550.26,1046084.1,2488634.36
351360,201911,771,375,396,376338.29,397312.59,773650.88
351370,201911,397,198,199,197639.07,200621.88,398260.95
351380,201911,9097,4111,4986,4125819.2,5008818.55,9134637.75
351385,201911,28,17,11,16972.79,10982.3,27955.09
351390,201911,282,213,69,212617.96,68871.65,281489.61
351400,201911,67,42,25,41921.44,24956.76,66878.20
351410,201911,436,276,160,275513.15,160712.37,436225.52
351420,201911,62,51,11,50902.15,10978.89,61881.04
351430,201911,64,34,30,33938.29,29945.87,63884.16
351440,201911,789,552,237,551997.84,238577.27,790575.11
351450,201911,261,129,132,128769.93,131764.16,260534.09
351460,201911,119,55,64,54903.62,63881.98,118785.60
351470,201911,142,74,68,73862.62,67874.03,141736.65
351480,201911,517,292,225,295452.61,224577.2,520029.81
351490,201911,286,104,182,105796.64,181652.32,287448.96
351492,201911,31,22,9,21962.55,8983.38,30945.93
351495,201911,25,18,7,18964.85,6987.33,25952.18
351500,201911,3569,1499,2070,1505302.61,2080231.14,3585533.75
351510,201911,1868,755,1113,755619.5,1116930.77,1872550.27
351512,201911,21,16,5,15969.24,4990.29,20959.53
351515,201911,197,113,84,112800.1,83849.45,196649.55
351518,201911,761,474,287,479189.76,287498.12,766687.88
351519,201911,73,46,27,45919.69,26952.54,72872.23
351520,201911,153,92,61,91838.5,60887.19,152725.69
351530,201911,23,14,9,13974.91,8983.45,22958.36
351535,201911,131,75,56,74868.59,55904.21,130772.80
351540,201911,454,326,128,327407.57,127770.83,455178.40
351550,201911,1405,832,573,833499.97,574922.96,1408422.93
351560,201911,66,39,27,38925.47,26950.58,65876.05
351565,201911,9,7,2,6987.75,1996.61,8984.36
351570,201911,2674,1348,1326,1354656.5,1328704.09,2683360.59
351580,201911,38,34,4,33938.55,3993.38,37931.93
351590,201911,64,42,22,41926.16,21961.25,63887.41
351600,201911,188,139,49,141744.85,49910.64,191655.49
351610,201911,56,25,31,24955.11,30946.51,55901.62
351620,201911,5863,3304,2559,3315023.6,2568231.33,5883254.93
351630,201911,2749,1375,1374,1376587.18,1377550.81,2754137.99
351640,201911,1918,900,1018,898386.53,1022168.32,1920554.85
351650,201911,29,25,4,24956.13,3993.52,28949.65
351660,201911,144,93,51,92836.92,50906.32,143743.24
351670,201911,711,440,271,441397.69,273497.75,714895.44
351680,201911,73,60,13,60884.93,12975.96,73860.89
351685,201911,30,17,13,16970.39,12977.44,29947.83
351690,201911,307,213,94,213624.49,94831.2,308455.69
351700,201911,159,111,48,110798.75,47912.15,158710.90
351710,201911,69,46,23,45920.49,22960.91,68881.40
351720,201911,130,70,60,69872.7,59889.35,129762.05
351730,201911,107,72,35,71865.19,34933.18,106798.37
351740,201911,733,478,255,477127.16,254542.63,731669.79
351750,201911,357,150,207,150734.4,207631.02,358365.42
351760,201911,777,589,188,588949.6,188656.43,777606.03
351770,201911,315,268,47,267505.3,46919.4,314424.7
351780,201911,160,93,67,92828.58,66874.03,159702.61
351790,201911,252,132,120,131765.02,119793.06,251558.08
351800,201911,44,30,14,29946.06,13973.91,43919.97
351810,201911,121,81,40,80858.22,39928.57,120786.79
351820,201911,839,607,232,607903.37,232587.3,840490.67
351830,201911,536,190,346,191655.55,345388.82,537044.37
351840,201911,1894,948,946,948306.79,948233.55,1896540.34
351850,201911,248,180,68,179688.49,67877.53,247566.02
351860,201911,684,474,210,476141.49,209624.14,685765.63
351870,201911,5609,2641,2968,2659261.13,2980712.75,5639973.88
351880,201911,19266,8005,11261,8021592.9,11303284.96,19324877.86
351885,201911,87,57,30,56897.97,29946.14,86844.11
351890,201911,74,62,12,61885.47,11977.94,73863.41
351900,201911,227,133,94,133771.77,94836.19,228607.96
351905,201911,75,30,45,29943.69,44915.01,74858.70
351907,201911,3409,1418,1991,1422494.12,2000309.81,3422803.93
351910,201911,179,72,107,73870.14,106816.48,180686.62
351920,201911,121,70,51,69869.89,50905.08,120774.97
351925,201911,89,58,31,58896.01,30946.77,89842.78
351930,201911,394,254,140,255553.36,139758.1,395311.46
351940,201911,246,110,136,109797.92,135752.73,245550.65
351950,201911,133,74,59,73866.23,58896.89,132763.12
351960,201911,894,430,464,430524.73,464167.22,894691.95
351970,201911,1862,988,874,993236.94,879438.45,1872675.39
351980,201911,150,77,73,77862.84,72870.88,150733.72
351990,201911,259,170,89,170148.73,89835.71,259984.44
352000,201911,355,222,133,221603.03,132762.36,354365.39
352010,201911,398,253,145,252545.19,144753.44,397298.63
352020,201911,181,65,116,64883.12,116786.76,181669.88
352030,201911,1077,552,525,552005.15,526050.5,1078055.65
352040,201911,576,241,335,240571.68,336407.53,576979.21
352042,201911,284,87,197,88841.4,197665.01,286506.41
352044,201911,361,220,141,219622.43,140757.78,360380.21
352050,201911,3242,1268,1974,1271739.17,1988317.49,3260056.66
352060,201911,102,63,39,62884.63,38929.61,101814.24
352070,201911,95,70,25,69874.76,24954.83,94829.59
352080,201911,68,42,26,41921.69,25956.95,67878.64
352090,201911,165,111,54,110800.88,54897.5,165698.38
352100,201911,277,133,144,132765.92,144743.52,277509.44
352110,201911,113,33,80,32939.5,79848.55,112788.05
352115,201911,63,22,41,21959.64,40925.28,62884.92
352120,201911,88,63,25,62883.77,24956.07,87839.84
352130,201911,219,182,37,181678.57,36931.6,218610.17
352140,201911,187,86,101,85837.86,101812.82,187650.68
352150,201911,114,62,52,62891.16,51912.42,114803.58
352160,201911,138,89,49,88836.43,48911.93,137748.36
352170,201911,373,263,110,262517.55,110793.99,373311.54
352180,201911,607,398,209,400281.06,209636.92,609917.98
352190,201911,253,103,150,104813.68,151721.32,256535.00
352200,201911,32,16,16,15971.75,15971.94,31943.69
352210,201911,4023,1657,2366,1661066.05,2380646.13,4041712.18
352215,201911,56,33,23,32936.94,22955.32,55892.26
352220,201911,6915,2622,4293,2629486.22,4301690.76,6931176.98
352230,201911,3307,2141,1166,2148199.55,1168793.14,3316992.69
352240,201911,2357,1362,995,1363527.42,993208.93,2356736.35
352250,201911,2709,1329,1380,1331657.52,1382465.55,2714123.07
352260,201911,978,506,472,508102.82,471184.82,979287.64
352265,201911,57,25,32,25951.66,31938.84,57890.50
352270,201911,409,238,171,238573.69,170693.46,409267.15
352280,201911,435,273,162,272489.17,161690.8,434179.97
352290,201911,172,104,68,103820.81,67879.48,171700.29
352300,201911,96,70,26,69870.01,25951.88,95821.89
352310,201911,6201,2826,3375,2837116.4,3382624.89,6219741.29
352320,201911,991,517,474,516073.1,475151.33,991224.43
352330,201911,528,257,271,256515.75,272486.38,529002.13
352340,201911,1354,631,723,636882.82,724730.1,1361612.92
352350,201911,339,203,136,202647.64,136768.98,339416.62
352360,201911,220,99,121,98815.47,120771.05,219586.52
352370,201911,107,71,36,70871.32,35936.9,106808.22
352380,201911,113,72,41,71873.26,40925.75,112799.01
352390,201911,2458,1088,1370,1101077.54,1377456.34,2478533.88
352400,201911,491,213,278,214604.98,280490.2,495095.18
352410,201911,833,594,239,595914.62,240567.28,836481.90
352420,201911,104,70,34,69872.29,33938.27,103810.56
352430,201911,1717,780,937,787558.97,942264.35,1729823.32
352440,201911,3174,1580,1594,1586146.7,1602025.85,3188172.55
352450,201911,200,166,34,166723.02,33942.18,200665.20
352460,201911,609,315,294,314436.97,294479.25,608916.22
352470,201911,645,222,423,222595.6,422232.96,644828.56
352480,201911,1387,768,619,775599.9,618875.78,1394475.68
352490,201911,63,24,39,23964.36,38936.66,62901.02
352500,201911,1210,529,681,531069.18,681790.59,1212859.77
352510,201911,742,401,341,401284.02,340393.56,741677.58
352520,201911,646,306,340,305468.9,340402.54,645871.44
352530,201911,1755,927,828,931368.17,830457.77,1761825.94
352540,201911,74,49,25,48910.65,24955.3,73865.95
352550,201911,182,108,74,107805.43,74860.76,182666.19
352560,201911,48,39,9,38928.67,8984.7,47913.37
352570,201911,675,352,323,351374.27,325421.88,676796.15
352580,201911,57,43,14,42921.82,13975.86,56897.68
352585,201911,20,6,14,5988.58,13976.74,19965.32
352590,201911,4423,2234,2189,2240093.65,2197989.21,4438082.86
352600,201911,345,248,97,247556.94,96832.27,344389.21
352610,201911,950,431,519,431217.26,520064.8,951282.06
352620,201911,1003,401,602,400313.09,601967.23,1002280.32
352630,201911,174,64,110,63889.32,111803.15,175692.47
352640,201911,534,359,175,358364.08,174697.82,533061.90
352650,201911,83,58,25,57891.36,24953.91,82845.27
352660,201911,71,43,28,42924.53,27949.18,70873.71
352670,201911,1660,893,767,898395.33,768538.49,1666933.82
352680,201911,923,581,342,580980.95,342414.42,923395.37
352690,201911,4522,2043,2479,2049399.75,2483423.77,4532823.52
352700,201911,107,64,43,64888.92,42924.12,107813.04
352710,201911,1375,734,641,733672.99,640773.83,1374446.82
352720,201911,1340,631,709,630896.01,708767.71,1339663.72
352725,201911,25,21,4,20964.76,3992.5,24957.26
352730,201911,389,202,187,201641.84,187667.07,389308.91
352740,201911,410,264,146,264518.37,145747.15,410265.52
352750,201911,19,12,7,11981.1,6987.33,18968.43
352760,201911,176,117,59,117785.21,58887.81,176673.02
352770,201911,83,64,19,63887.05,18964.28,82851.33
352780,201911,74,40,34,39924.74,33933.94,73858.68
352790,201911,26,21,5,20961.98,4992.34,25954.32
352800,201911,237,172,65,172695.42,65882.41,238577.83
352810,201911,152,93,59,92842.23,58900.32,151742.55
352820,201911,64,51,13,50905.6,12977.92,63883.52
352830,201911,85,57,28,56902.25,27950.49,84852.74
352840,201911,668,339,329,339417.66,331424.11,670841.77
352850,201911,1477,497,980,497082.95,985188.37,1482271.32
352860,201911,124,78,46,77864.04,48913.09,126777.13
352870,201911,44,28,16,27950.71,15973.99,43924.70
352880,201911,184,123,61,122775.89,60894.06,183669.95
352885,201911,33,22,11,21963.33,10980.07,32943.40
352890,201911,53,36,17,35935.22,16970.96,52906.18
352900,201911,4822,2334,2488,2338799.19,2490363.12,4829162.31
352910,201911,39,32,7,31941.67,6987.85,38929.52
352920,201911,666,400,266,404276.43,265529.73,669806.16
352930,201911,1219,585,634,587931.21,634841.44,1222772.65
352940,201911,6215,2614,3601,2629254.01,3612452.69,6241706.70
352950,201911,99,39,60,38932.18,59895.12,98827.30
352960,201911,55,39,16,38929.86,15970.32,54900.18
352965,201911,19,9,10,9982.71,9981.62,19964.33
352970,201911,516,392,124,392309.97,124788.95,517098.92
352980,201911,163,88,75,88846.71,74864.14,163710.85
352990,201911,971,443,528,442205.83,529088.87,971294.70
353000,201911,66,31,35,30944.6,34943.4,65888.0
353010,201911,540,334,206,335406.27,205635.04,541041.31
353020,201911,297,213,84,213613.38,83855.32,297468.70
353030,201911,1239,569,670,567970.99,670792.72,1238763.71
353040,201911,90,58,32,57895.04,31941.33,89836.37
353050,201911,1323,851,472,851499.93,474124.67,1325624.60
353060,201911,8423,3706,4717,3714604.04,4724172.53,8438776.57
353070,201911,1734,1086,648,1088081.46,648603.45,1736684.91
353080,201911,1306,695,611,696768.74,610858.29,1307627.03
353090,201911,56,31,25,30940.69,24952.03,55892.72
353100,201911,55,44,11,43918.91,10980.61,54899.52
353110,201911,2063,623,1440,623880.57,1445516.51,2069397.08
353120,201911,92,48,44,48912.31,43918.73,92831.04
353130,201911,845,413,432,415242.82,433203.06,848445.88
353140,201911,559,226,333,226588.39,333402.81,559991.20
353150,201911,348,195,153,194648.11,152726.9,347375.01
353160,201911,93,78,15,77861.08,14974.44,92835.52
353170,201911,207,65,142,64880.85,144744.48,209625.33
353180,201911,1021,476,545,477124.81,546004.57,1023129.38
353190,201911,505,370,135,372322.93,134750.3,507073.23
353200,201911,214,109,105,108798.67,104802.18,213600.85
353205,201911,21,15,6,14973.89,5988.5,20962.39
353210,201911,82,47,35,46915.3,34936.37,81851.67
353215,201911,48,27,21,26950.15,20961.06,47911.21
353220,201911,81,45,36,44920.52,35934.6,80855.12
353230,201911,163,64,99,63883.58,99823.7,163707.28
353240,201911,314,166,148,165695.39,147734.63,313430.02
353250,201911,215,110,105,109799.79,105816.42,215616.21
353260,201911,462,328,134,327451.41,134769.79,462221.20
353270,201911,70,53,17,52906.25,16968.72,69874.97
353280,201911,103,53,50,52906.99,49913.51,102820.50
353282,201911,124,87,37,86838.23,36931.11,123769.34
353284,201911,25,18,7,17969.17,6987.72,24956.89
353286,201911,1,0,1,0,998,998
353290,201911,74,44,30,43920.3,29944.54,73864.84
353300,201911,434,239,195,238570.07,196650.48,435220.55
353310,201911,45,39,6,38924.79,5989.2,44913.99
353320,201911,60,35,25,35938.73,24952.93,60891.66
353325,201911,55,31,24,30945.24,23959.42,54904.66
353330,201911,61,43,18,42922.81,17966.1,60888.91
353340,201911,625,215,410,214614.66,410282.57,624897.23
353350,201911,897,432,465,432226.31,465191.47,897417.78
353360,201911,102,82,20,81849.55,19965.54,101815.09
353370,201911,122,68,54,67880.59,53904.25,121784.84
353380,201911,31,18,13,17965.72,12974.42,30940.14
353390,201911,1106,533,573,535030.35,571970.4,1107000.75
353400,201911,45,26,19,25954.88,18966.39,44921.27
353410,201911,105,66,39,65876.54,38929.04,104805.58
353420,201911,60,27,33,26950.42,32938.44,59888.86
353430,201911,583,393,190,392299,190656.36,582955.36
353440,201911,10497,4601,5896,4616860.48,5935106.65,10551967.13
353450,201911,56,30,26,29948.06,25955.1,55903.16
353460,201911,608,333,275,333376.26,275495.03,608871.29
353470,201911,2132,1128,1004,1128983.93,1006135.32,2135119.25
353475,201911,235,159,76,158706.28,76864.25,235570.53
353480,201911,184,153,31,152714.95,30941.33,183656.28
353490,201911,239,148,91,147728.18,90833.69,238561.87
353500,201911,193,113,80,112800.94,81856.05,194656.99
353510,201911,100,71,29,70873.3,28947.37,99820.67
353520,201911,211,149,62,148731.44,61886.22,210617.66
353530,201911,465,254,211,254549.94,212633.71,467183.65
353540,201911,382,259,123,259524.16,122785.56,382309.72
353550,201911,725,467,258,468157.79,258539.4,726697.19
353560,201911,595,238,357,240567.43,360357.37,600924.80
353570,201911,63,33,30,33939,29947.34,63886.34
353580,201911,354,265,89,265514.89,89834.86,355349.75
353590,201911,93,66,27,65881.99,26950.28,92832.27
353600,201911,274,159,115,158709.91,115782.08,274491.99
353610,201911,126,69,57,68869.4,56898.83,125768.23
353620,201911,615,320,295,323417.77,295469.9,618887.67
353625,201911,51,28,23,27952.7,22960.53,50913.23
353630,201911,233,171,62,172680.88,61882.78,234563.66
353640,201911,124,86,38,86845.83,37935.78,124781.61
353650,201911,924,364,560,364321.42,561958.06,926279.48
353657,201911,25,19,6,18964.18,5989.01,24953.19
353660,201911,265,142,123,143733.72,123776.79,267510.51
353670,201911,776,461,315,461175.55,315435.52,776611.07
353680,201911,105,76,29,75859.3,28944.19,104803.49
353690,201911,43,33,10,32943.75,9983.22,42926.97
353700,201911,282,202,80,202635.01,79854.53,282489.54
353710,201911,463,224,239,223610.86,239583.37,463194.23
353715,201911,45,33,12,32941.97,11979.31,44921.28
353720,201911,349,161,188,160722.79,188674.57,349397.36
353730,201911,1089,667,422,667781.47,423222.48,1091003.95
353740,201911,629,342,287,342370.48,288478.53,630849.01
353750,201911,79,48,31,48912.48,30943.38,79855.86
353760,201911,2902,1090,1812,1092068.55,1815786.23,2907854.78
353770,201911,90,73,17,73868.61,16967.88,90836.49
353780,201911,1195,572,623,572947.18,623878.05,1196825.23
353790,201911,513,306,207,306455.42,208622.06,515077.48
353800,201911,3311,1641,1670,1645082.8,1673906.09,3318988.89
353810,201911,234,133,101,132766.01,101817.49,234583.50
353820,201911,197,95,102,94824.54,101803.9,196628.44
353830,201911,48,41,7,40927.27,6987.68,47914.95
353850,201911,178,84,94,83847.41,93829.2,177676.61
353860,201911,498,227,271,227590.97,270504.7,498095.67
353870,201911,5264,2668,2596,2672235.63,2601156.84,5273392.47
353880,201911,689,486,203,487121.5,203622.45,690743.95
353890,201911,574,330,244,329445.29,246578.16,576023.45
353900,201911,131,70,61,69873.6,60887.04,130760.64
353910,201911,169,78,91,80855.58,90836.14,171691.72
353920,201911,438,244,194,243554.59,194645.62,438200.21
353930,201911,1004,592,412,591922.86,412230.33,1004153.19
353940,201911,193,100,93,101813.7,92830.23,194643.93
353950,201911,512,315,197,314425.71,197642.51,512068.22
353960,201911,73,60,13,59892.26,12976.83,72869.09
353970,201911,66,39,27,38933.5,26956.52,65890.02
353980,201911,1642,769,873,774638.17,876455.6,1651093.77
353990,201911,74,44,30,43924.14,29945.73,73869.87
354000,201911,375,183,192,182657.48,191646.3,374303.78
354010,201911,89,48,41,49917.24,40929.14,90846.38
354020,201911,528,338,190,339387.84,189664.98,529052.82
354025,201911,56,46,10,45920.18,9983.03,55903.21
354030,201911,56,34,22,33940.97,21960.63,55901.60
354040,201911,104,78,26,77859.24,25953.17,103812.41
354050,201911,185,98,87,97820.25,86838.89,184659.14
354060,201911,775,382,393,382310.72,392304.01,774614.73
354070,201911,915,531,384,532040.88,384318.16,916359.04
354075,201911,222,111,111,111807.31,110812.36,222619.67
354080,201911,307,132,175,131760.57,175682.7,307443.27
354085,201911,22,14,8,13975.84,7987.38,21963.22
354090,201911,301,170,131,169610.4,131755.41,301365.81
354100,201911,5531,2295,3236,2311856.78,3256090.54,5567947.32
354105,201911,91,43,48,42918.55,47908.09,90826.64
354110,201911,46,23,23,22960.9,23960.33,46921.23
354120,201911,138,98,40,97825.52,39931.12,137756.64
354130,201911,711,457,254,459176.07,253549.75,712725.82
354140,201911,3125,1443,1682,1449368.02,1684833.54,3134201.56
354150,201911,633,388,245,387302.82,247549.71,634852.53
354160,201911,670,427,243,426245.09,242563.63,668808.72
354165,201911,19,14,5,13975.98,4990.4,18966.38
354170,201911,177,118,59,118781.65,58893.94,177675.59
354180,201911,63,38,25,37931.3,24955.51,62886.81
354190,201911,199,85,114,85845.78,113790.44,199636.22
354200,201911,121,64,57,63886.42,56906.83,120793.25
354210,201911,56,25,31,25955.18,30940.46,56895.64
354220,201911,647,407,240,406263.04,239568.54,645831.58
354230,201911,169,71,98,70876.73,97833.13,168709.86
354240,201911,329,213,116,214600.06,115792.01,330392.07
354250,201911,84,52,32,51906.65,31939.95,83846.60
354260,201911,2028,950,1078,951305.67,1081095.54,2032401.21
354270,201911,94,68,26,67871.71,25953.54,93825.25
354280,201911,42,22,20,21961.83,19963.67,41925.50
354290,201911,145,101,44,101820.46,43920.25,145740.71
354300,201911,389,273,116,273523.35,117792.72,391316.07
354310,201911,97,71,26,70874.33,25954.42,96828.75
354320,201911,195,96,99,96826.78,100812.37,197639.15
354323,201911,12,11,1,10980.97,998.27,11979.24
354325,201911,115,69,46,68869.84,45910.79,114780.63
354330,201911,2498,831,1667,832423.33,1670993.2,2503416.53
354340,201911,10429,5057,5372,5066979.75,5391105.11,10458084.86
354350,201911,122,81,41,80842.21,40923.71,121765.92
354360,201911,82,48,34,48910.1,33937.57,82847.67
354370,201911,256,140,116,139749.66,116787.22,256536.88
354380,201911,192,114,78,113796.22,77858.3,191654.52
354390,201911,2700,991,1709,993215.04,1711864.09,2705079.13
354400,201911,318,173,145,172688.74,144743.8,317432.54
354410,201911,615,296,319,296483.4,321435.06,617918.46
354420,201911,281,177,104,176693.4,103820.6,280514.0
354425,201911,308,184,124,183665.92,125778.25,309444.17
354430,201911,180,104,76,104807.64,75863.74,180671.38
354440,201911,35,26,9,25954.56,8982.44,34937.00
354450,201911,54,38,16,37930.12,15973.19,53903.31
354460,201911,106,62,44,61887.37,43919.7,105807.07
354470,201911,36,21,15,20962.21,14977.37,35939.58
354480,201911,116,63,53,62885,52901.03,115786.03
354490,201911,149,92,57,91834.74,56893.64,148728.38
354500,201911,377,182,195,181674.41,194648.09,376322.50
354510,201911,98,71,27,70867,26952.14,97819.14
354515,201911,38,12,26,11978.83,25952.78,37931.61
354520,201911,1593,685,908,686639.19,911277.19,1597916.38
354530,201911,735,375,360,376320.93,360339.62,736660.55
354540,201911,271,146,125,145747.53,124779.33,270526.86
354550,201911,40,23,17,22955.57,16967.01,39922.58
354560,201911,151,83,68,82843.22,67868.6,150711.82
354570,201911,143,92,51,91836.35,50911.63,142747.98
354580,201911,1887,901,986,903382.61,992196.19,1895578.80
354600,201911,252,141,111,140752.64,112795.91,253548.55
354610,201911,77,65,12,64884.94,11979.97,76864.91
354620,201911,62,19,43,18966.68,42919.8,61886.48
354625,201911,15,10,5,9981.85,4991.92,14973.77
354630,201911,312,202,110,202636.03,109806.76,312442.79
354640,201911,811,522,289,522042.54,288481.47,810524.01
354650,201911,72,41,31,40923.88,30941.1,71864.98
354660,201911,788,586,202,588963.07,202643.74,791606.81
354670,201911,249,91,158,90836.33,159700.76,250537.09
354680,201911,1257,469,788,470144.89,793548.3,1263693.19
354690,201911,79,53,26,53902.73,25952.77,79855.50
354700,201911,70,50,20,49905.36,19961.54,69866.90
354710,201911,45,34,11,33939.2,11979.63,45918.83
354720,201911,22,22,0,21959.03,0,21959.03
354730,201911,1719,712,1007,715771.25,1010258.52,1726029.77
354740,201911,66,48,18,47908.49,17966.08,65874.57
354750,201911,435,251,184,250526.95,186656.52,437183.47
354760,201911,477,291,186,291488.77,185670.83,477159.60
354765,201911,10,5,5,4991.57,4992.6,9984.17
354770,201911,346,226,120,227580.67,119778.14,347358.81
354780,201911,8216,3303,4913,3311082.89,4932837.59,8243920.48
354790,201911,99,57,42,57889.79,41918.99,99808.78
354800,201911,451,248,203,250550.62,202641.96,453192.58
354805,201911,102,48,54,48908.92,54907.08,103816.00
354810,201911,104,62,42,62885.67,41922.7,104808.37
354820,201911,194,84,110,83855.04,110810.59,194665.63
354830,201911,39,20,19,19961.12,19965.8,39926.92
354840,201911,62,43,19,42920.21,18963.44,61883.65
354850,201911,4531,2020,2511,2030381.26,2526330.07,4556711.33
354860,201911,330,159,171,158705.77,172695.06,331400.83
354870,201911,12285,5533,6752,5549207.85,6777634.08,12326841.93
354880,201911,2901,1082,1819,1086131.77,1837727.37,2923859.14
354890,201911,2890,1568,1322,1578169.02,1322524.52,2900693.54
354900,201911,64,44,20,43921.08,19963.17,63884.25
354910,201911,1262,668,594,669824,594848.2,1264672.2
354920,201911,46,39,7,38928.59,6987.5,45916.09
354925,201911,12,7,5,7985.69,4992.41,12978.10
354930,201911,35,32,3,31944.64,2994.88,34939.52
354940,201911,816,593,223,593175.56,225606.48,818782.04
354950,201911,202,134,68,133750.53,68875.33,202625.86
354960,201911,157,61,96,60895.87,95837.95,156733.82
354970,201911,931,618,313,618893.7,314413.26,933306.96
354980,201911,8672,3166,5506,3178274.19,5519772,8698046.19
354990,201911,9118,4244,4874,4251374.09,4898955.17,9150329.26
354995,201911,543,182,361,181674.53,362365.38,544039.91
355000,201911,472,164,308,163703.34,310444.85,474148.19
355010,201911,616,386,230,387324,231597.11,618921.11
355020,201911,743,468,275,468162.75,277498.4,745661.15
355030,201911,207323,80643,126680,80953655.18,127364980.55,208318635.73
355040,201911,749,354,395,354341.91,395254.62,749596.53
355050,201911,152,98,54,97820.51,53903.81,151724.32
355060,201911,1574,796,778,795626.48,780550.79,1576177.27
355070,201911,1440,683,757,684772.46,757668.49,1442440.95
355080,201911,201,121,80,120779.23,81850.73,202629.96
355090,201911,289,175,114,175685.94,113798.11,289484.05
355100,201911,4987,2395,2592,2400614.86,2603216.58,5003831.44
355110,201911,266,177,89,176699.18,88844.84,265544.02
355120,201911,81,58,23,57895.8,22958.15,80853.95
355130,201911,52,30,22,29948.29,21962.09,51910.38
355140,201911,184,116,68,116778.14,69866.46,186644.60
355150,201911,675,405,270,410274.14,269518.94,679793.08
355160,201911,460,220,240,219608.2,240560.39,460168.59
355170,201911,2061,1090,971,1088053.89,975189.56,2063243.45
355180,201911,673,287,386,286486.17,385307.12,671793.29
355190,201911,204,144,60,144734.02,59892.07,204626.09
355200,201911,116,65,51,64878.33,50904.58,115782.91
355210,201911,680,390,290,393304.83,292488.61,685793.44
355220,201911,7088,3732,3356,3732410.26,3362823.98,7095234.24
355230,201911,101,61,40,60886.03,40924.51,101810.54
355240,201911,4430,1882,2548,1884663.14,2552209.13,4436872.27
355250,201911,5723,2631,3092,2645379.34,3097177.86,5742557.20
355255,201911,47,28,19,28948.49,18967.74,47916.23
355260,201911,181,110,71,109806.53,70870.81,180677.34
355270,201911,172,109,63,108804.87,62884.55,171689.42
355280,201911,6426,2610,3816,2619458.76,3833391.79,6452850.55
355290,201911,74,58,16,57890.38,15971,73861.38
355300,201911,198,125,73,124781.16,72863.71,197644.87
355310,201911,113,62,51,61886.07,50907.14,112793.21
355320,201911,90,48,42,47912.23,41922.61,89834.84
355330,201911,282,163,119,162705.26,120780.36,283485.62
355340,201911,1539,523,1016,524066.73,1016324.46,1540391.19
355350,201911,132,72,60,71866.66,59885.56,131752.22
355360,201911,171,110,61,109806.86,60896.48,170703.34
355365,201911,21,17,4,17970.38,3992.88,21963.26
355370,201911,1028,596,432,596916.65,433188.79,1030105.44
355380,201911,805,523,282,522070.77,281520.33,803591.10
355385,201911,67,47,20,46910.95,19963.17,66874.12
355390,201911,104,62,42,61888.53,41925.72,103814.25
355395,201911,187,110,77,109803.36,76868.95,186672.31
355400,201911,1635,997,638,1000121.05,638784.67,1638905.72
355410,201911,4881,2322,2559,2330816.15,2571148.52,4901964.67
355420,201911,52,37,15,36930.71,14971.83,51902.54
355430,201911,366,225,141,225590.49,141754.04,367344.53
355440,201911,80,46,34,45915.62,33935.9,79851.52
355450,201911,460,227,233,229583.62,232568.48,462152.10
355460,201911,62,47,15,47912.69,14972.09,62884.78
355465,201911,48,31,17,30942.05,16969.02,47911.07
355470,201911,174,70,104,69871.79,103807.72,173679.51
355475,201911,14,9,5,8984.56,4990.77,13975.33
355480,201911,505,219,286,218608.71,286486.02,505094.73
355490,201911,118,86,32,85855.41,31945.32,117800.73
355495,201911,57,27,30,26949.9,29943.69,56893.59
355500,201911,1595,898,697,898349.62,701722.73,1600072.35
355510,201911,267,199,68,200639.06,68875.59,269514.65
355520,201911,33,24,9,23956.18,8982.64,32938.82
355530,201911,22,15,7,14971.68,6986.16,21957.84
355535,201911,77,37,40,36936.48,39929.06,76865.54
355540,201911,2427,965,1462,964469.61,1466492.15,2430961.76
355550,201911,58,36,22,35932.36,21960.96,57893.32
355560,201911,249,118,131,117787.48,131763.08,249550.56
355570,201911,23,16,7,15971.36,6986.34,22957.70
355580,201911,241,170,71,170703.7,70875.65,241579.35
355590,201911,20,14,6,13975.87,5989.99,19965.86
355600,201911,274,142,132,142754.04,131757.04,274511.08
355610,201911,230,153,77,152731.01,76866.05,229597.06
355620,201911,1327,619,708,621906.82,708683.62,1330590.44
355630,201911,445,325,120,326421.29,119784.06,446205.35
355635,201911,119,56,63,55898.39,63885.63,119784.02
355640,201911,568,319,249,319419.46,249550.35,568969.81
355645,201911,842,347,495,348383.2,494113.34,842496.54
355650,201911,2022,862,1160,863530.43,1168819.15,2032349.58
355660,201911,260,139,121,141740.52,121782.4,263522.92
355670,201911,539,215,324,215600.36,324398.54,539998.90
355680,201911,203,119,84,119789.32,84854.35,204643.67
355690,201911,92,42,50,42924.49,49915.84,92840.33
355695,201911,17,10,7,9982.32,6986.6,16968.92
355700,201911,1146,604,542,604911.06,540992.33,1145903.39
355710,201911,2247,1238,1009,1237784.65,1008115.05,2245899.70
355715,201911,20,15,5,14973.34,4991.21,19964.55
355720,201911,212,126,86,126770.94,85847.16,212618.10
355730,201911,98,55,43,55901.57,42925.53,98827.10
410010,201911,132,110,22,109810.2,21963.45,131773.65
410020,201911,114,89,25,88856.74,24958.19,113814.93
410030,201911,163,101,62,102823.14,61893.46,164716.60
410040,201911,1106,563,543,566934.35,542978.59,1109912.94
410045,201911,34,28,6,27951.89,5989.44,33941.33
410050,201911,478,274,204,275498.13,204624.62,480122.75
410060,201911,283,214,69,213611.14,69867.95,283479.09
410070,201911,304,252,52,251545.81,51907.76,303453.57
410080,201911,165,104,61,103809.93,60889.75,164699.68
410090,201911,79,69,10,68877.98,9983.31,78861.29
410100,201911,290,209,81,209597.75,80842.7,290440.45
410105,201911,47,29,18,28944.6,17964.87,46909.47
410110,201911,329,202,127,201625.97,127771.23,329397.20
410115,201911,32,22,10,21959.8,9980.81,31940.61
410120,201911,412,210,202,210614.79,202628.84,413243.63
410130,201911,48,29,19,28951.15,18965.22,47916.37
410140,201911,3122,1536,1586,1538184.44,1592108.63,3130293.07
410150,201911,2671,1061,1610,1060072.04,1612055.17,2672127.21
410160,201911,514,320,194,319424.19,194645.83,514070.02
410165,201911,69,45,24,44915.51,23955.43,68870.94
410170,201911,163,115,48,115782.92,48909.01,164691.93
410180,201911,2243,1261,982,1261749.87,984228.15,2245978.02
410185,201911,36,31,5,30942.81,4990.45,35933.26
410190,201911,492,326,166,329375.9,166684,496059.9
410200,201911,958,713,245,715693.27,245542.47,961235.74
410210,201911,589,310,279,309428.92,279497.26,588926.18
410220,201911,43,22,21,21956.52,20958.23,42914.75
410230,201911,148,70,78,69869.74,77851.48,147721.22
410240,201911,761,493,268,492141.87,268512.62,760654.49
410250,201911,384,279,105,279483.65,105804.41,385288.06
410260,201911,289,163,126,163711.28,128775.79,292487.07
410270,201911,27,19,8,19961.11,7984.67,27945.78
410275,201911,61,44,17,43918.3,16970.4,60888.7
410280,201911,319,188,131,187664.56,132761.54,320426.10
410290,201911,248,155,93,154712.77,92825.88,247538.65
410300,201911,77,56,21,56901.89,20965.19,77867.08
410302,201911,17,10,7,9982.19,6986.34,16968.53
410304,201911,42,29,13,28945.22,13974.48,42919.70
410305,201911,218,116,102,115779.79,101805.7,217585.49
410310,201911,215,131,84,131759.54,83842.65,215602.19
410315,201911,50,35,15,34936,14972.22,49908.22
410320,201911,131,92,39,91827.19,38927.31,130754.50
410322,201911,33,22,11,21958.93,10979.46,32938.39
410330,201911,172,122,50,122792.78,49911.9,172704.68
410335,201911,100,57,43,56888.78,42915.64,99804.42
410337,201911,39,32,7,31939.89,6986.93,38926.82
410340,201911,34,31,3,30944.07,2994.1,33938.17
410345,201911,214,128,86,127767.5,85843.45,213610.95
410347,201911,50,39,11,38930.59,10979.71,49910.30
410350,201911,244,152,92,151725.77,92829.62,244555.39
410360,201911,470,299,171,298460.39,171686.76,470147.15
410370,201911,2353,1006,1347,1006181.51,1347612.31,2353793.82
410380,201911,213,132,81,132770.63,81861.09,214631.72
410390,201911,377,267,110,267513.97,109799.35,377313.32
410395,201911,36,23,13,22959.18,12981.54,35940.72
410400,201911,827,397,430,397287.3,428684.75,825972.05
410405,201911,93,69,24,68875.31,23957.74,92833.05
410410,201911,34,25,9,24956.61,8984.94,33941.55
410420,201911,1658,789,869,788480.07,870421.62,1658901.69
410425,201911,173,77,96,76869.66,95835.34,172705.00
410430,201911,2238,1285,953,1282625.08,952267.88,2234892.96
410440,201911,371,271,100,271512.91,99819.59,371332.50
410442,201911,349,237,112,236566.32,111799.17,348365.49
410445,201911,417,298,119,298439.81,118781.84,417221.65
410450,201911,392,200,192,201625.16,192636.66,394261.82
410460,201911,485,255,230,254517.93,229572.54,484090.47
410465,201911,211,136,75,136746.56,74857.89,211604.45
410470,201911,233,149,84,148734.4,84839.36,233573.76
410480,201911,6108,3022,3086,3024503.43,3095472.44,6119975.87
410490,201911,1424,886,538,889444.85,540048.58,1429493.43
410500,201911,260,151,109,150720.84,109795.74,260516.58
410510,201911,170,126,44,125769.61,43923.48,169693.09
410520,201911,249,186,63,186661.51,62889.5,249551.01
410530,201911,248,91,157,91827.77,156701.51,248529.28
410540,201911,320,234,86,233563,85837.37,319400.37
410550,201911,1669,729,940,730679.66,940309.97,1670989.63
410560,201911,151,110,41,109792.01,40921.89,150713.90
410570,201911,435,299,136,299442.07,137745.74,437187.81
410580,201911,3408,1513,1895,1514318.92,1898612.91,3412931.83
410590,201911,406,284,122,283463.35,121777.21,405240.56
410600,201911,195,167,28,166689.6,27947.82,194637.42
410610,201911,56,46,10,45912.32,9980.47,55892.79
410620,201911,241,168,73,168697.27,72871.84,241569.11
410630,201911,442,257,185,257513.56,184652.02,442165.58
410640,201911,1021,640,381,644799.74,380298.82,1025098.56
410645,201911,107,78,29,78859.07,28950.66,107809.73
410650,201911,357,237,120,237559.93,120770.86,358330.79
410655,201911,86,63,23,62878.98,22958.9,85837.88
410657,201911,21,9,12,8984.78,11978.01,20962.79
410660,201911,607,425,182,425219.64,181667.53,606887.17
410670,201911,74,63,11,62890.34,10980.79,73871.13
410680,201911,210,171,39,171690.09,38932.13,210622.22
410685,201911,19,11,8,10980,7985.82,18965.82
410690,201911,28382,12148,16234,12173084.37,16263688.88,28436773.25
410700,201911,338,249,89,249558.45,88839.51,338397.96
410710,201911,126,105,21,104805.03,20961.65,125766.68
410712,201911,27,21,6,20960.54,5990.51,26951.05
410715,201911,87,67,20,66876.19,19962.13,86838.32
410720,201911,691,398,293,398255.3,293439.65,691694.95
410725,201911,184,133,51,133758.48,50902.77,184661.25
410730,201911,91,50,41,49905.71,40924.7,90830.41
410740,201911,111,80,31,79850.95,30944.03,110794.98
410750,201911,246,167,79,167685.47,78849.04,246534.51
410752,201911,25,15,10,14973.18,9981.62,24954.80
410753,201911,52,23,29,22961.1,28950.24,51911.34
410754,201911,45,25,20,24954.74,19960.64,44915.38
410755,201911,81,52,29,51900.72,28942.67,80843.39
410760,201911,755,427,328,426222.41,327410.9,753633.31
410765,201911,1731,819,912,820554.68,912419.16,1732973.84
410770,201911,109,86,23,85844.31,22957.42,108801.73
410773,201911,53,40,13,39924.03,12975.92,52899.95
410775,201911,186,138,48,137757.43,47912.78,185670.21
410780,201911,83,46,37,45912.38,36927.7,82840.08
410785,201911,55,43,12,42918.41,11977.86,54896.27
410790,201911,68,33,35,32938.44,34934.1,67872.54
410800,201911,284,179,105,178678.56,105813.58,284492.14
410810,201911,21,17,4,16967.52,3992.77,20960.29
410820,201911,178,130,48,130765.26,47915.66,178680.92
410830,201911,8551,3782,4769,3789164.48,4787503.5,8576667.98
410832,201911,104,74,30,75858.56,29946.01,105804.57
410840,201911,1420,799,621,802532.58,622840.84,1425373.42
410845,201911,68,43,25,42917.57,24953.09,67870.66
410850,201911,197,138,59,138759.76,58895.11,197654.87
410855,201911,56,46,10,45919.39,9983.02,55902.41
410860,201911,718,413,305,414217.84,304433.44,718651.28
410865,201911,100,77,23,76867.84,22958.62,99826.46
410870,201911,154,131,23,130771.08,22958.27,153729.35
410880,201911,1115,579,536,581934.23,536041.34,1117975.57
410890,201911,89,62,27,61883.89,26946.14,88830.03
410895,201911,72,56,16,55896.14,15972.16,71868.30
410900,201911,23,16,7,15973.96,6986.44,22960.40
410910,201911,15,13,2,12977.56,1996.47,14974.03
410920,201911,36,24,12,23959.07,11980.26,35939.33
410930,201911,499,320,179,322407.6,178668.48,501076.08
410940,201911,4357,2492,1865,2494504.74,1869641.76,4364146.50
410950,201911,108,82,26,81855,25957.39,107812.39
410960,201911,784,342,442,342380.52,445188.5,787569.02
410965,201911,65,52,13,51903.58,12976.99,64880.57
410970,201911,625,451,174,450197.83,174684.03,624881.86
410975,201911,122,74,48,73861.19,47913.08,121774.27
410980,201911,1633,748,885,750615.16,885395.37,1636010.53
410990,201911,263,185,78,184651.38,78856.38,263507.76
411000,201911,66,42,24,41928.55,23958.86,65887.41
411005,201911,27,23,4,22956.51,3992.44,26948.95
411007,201911,265,158,107,158688.79,106791.37,265480.16
411010,201911,604,418,186,418243.52,185662.61,603906.13
411020,201911,292,204,88,203634.12,88842.05,292476.17
411030,201911,16,9,7,8983.73,6988.21,15971.94
411040,201911,57,41,16,40927.08,15974.42,56901.50
411050,201911,209,164,45,165714.04,44921.35,210635.39
411060,201911,514,349,165,350355.16,165697.27,516052.43
411065,201911,60,52,8,51902.68,7985.48,59888.16
411070,201911,1244,778,466,777591.59,466157.39,1243748.98
411080,201911,233,167,66,166686.34,65875.05,232561.39
411090,201911,105,79,26,78862.78,25953.75,104816.53
411095,201911,278,111,167,110797.66,167694.53,278492.19
411100,201911,115,95,20,94824.33,19961.33,114785.66
411110,201911,125,84,41,83842.8,40925.74,124768.54
411120,201911,199,144,55,143733.76,54899.28,198633.04
411125,201911,230,100,130,99812.47,129769.56,229582.03
411130,201911,127,110,17,109799.57,16966.8,126766.37
411140,201911,209,139,70,139738.84,69867.7,209606.54
411150,201911,1243,826,417,825455.69,417215.66,1242671.35
411155,201911,125,84,41,83843.89,40925.09,124768.98
411160,201911,25,12,13,11976.49,12975.14,24951.63
411170,201911,50,46,4,45910.78,3992,49902.78
411180,201911,970,649,321,649804.62,322405.3,972209.92
411190,201911,336,200,136,199631.02,138740.48,338371.50
411200,201911,670,431,239,432233.12,238562.09,670795.21
411210,201911,692,377,315,380293.65,319399.39,699693.04
411220,201911,149,111,38,110806.26,37933.35,148739.61
411230,201911,40,34,6,34934.94,5990.99,40925.93
411240,201911,125,81,44,80853.52,43923.06,124776.58
411250,201911,435,322,113,321387.39,113781.87,435169.26
411260,201911,20,14,6,13974.62,5991.08,19965.70
411270,201911,277,147,130,146741.61,129776.37,276517.98
411275,201911,192,169,23,169695.96,22957.51,192653.47
411280,201911,214,151,63,151724.01,62886.02,214610.03
411290,201911,59,46,13,45912.66,12977.22,58889.88
411295,201911,141,111,30,110801.47,30943.05,141744.52
411300,201911,70,34,36,33935.81,35934.67,69870.48
411310,201911,90,70,20,69871.7,19961.4,89833.1
411320,201911,772,527,245,528045.01,244542.27,772587.28
411325,201911,61,42,19,41920.07,19961.34,61881.41
411330,201911,905,579,326,578922.63,327388.72,906311.35
411340,201911,24,18,6,17968.27,5989.46,23957.73
411342,201911,67,50,17,49909.42,16969.59,66879.01
411345,201911,119,59,60,59892.68,59892.46,119785.14
411350,201911,479,379,100,379322.19,99822.52,479144.71
411360,201911,55,36,19,35938.52,18967.09,54905.61
411370,201911,14198,5854,8344,5865389.5,8358009.79,14223399.29
411373,201911,178,129,49,128763.01,48910.33,177673.34
411375,201911,74,59,15,58889.42,14973.16,73862.58
411380,201911,92,68,24,67885.74,23961.86,91847.60
411390,201911,118,79,39,78858.83,38928.73,117787.56
411400,201911,361,277,84,276491.95,83840.42,360332.37
411410,201911,443,224,219,224590.42,219597.21,444187.63
411420,201911,1010,452,558,455167.84,558993.27,1014161.11
411430,201911,444,267,177,266547.32,178695.38,445242.70
411435,201911,33,21,12,20961.32,11979.31,32940.63
411440,201911,452,362,90,363302.02,89834.36,453136.38
411450,201911,420,355,65,356338.08,65877.4,422215.48
411460,201911,757,299,458,298458.12,457189.88,755648.00
411470,201911,85,63,22,62883.69,22955.5,85839.19
411480,201911,670,381,289,380303.47,289468.42,669771.89
411490,201911,290,187,103,187668.81,102821.48,290490.29
411500,201911,100,86,14,85840.88,13973.95,99814.83
411510,201911,222,176,46,175657.48,46909.77,222567.25
411520,201911,5978,2296,3682,2303803.82,3689258.01,5993061.83
411530,201911,123,86,37,85832.51,36929.46,122761.97
411535,201911,51,20,31,19965.02,30944.68,50909.70
411540,201911,353,245,108,244529.23,108786.48,353315.71
411545,201911,54,40,14,39923.2,13973,53896.2
411550,201911,74,58,16,57891.06,15971.36,73862.42
411560,201911,379,169,210,168687.82,210609.7,379297.52
411570,201911,808,300,508,301465.29,510073.38,811538.67
411573,201911,24,15,9,14973.32,8985.17,23958.49
411575,201911,289,183,106,182651.78,105794.93,288446.71
411580,201911,1268,488,780,490088.96,781554.77,1271643.73
411585,201911,75,37,38,36937.73,37936.15,74873.88
411590,201911,26,17,9,16968.71,8984.96,25953.67
411600,201911,25,11,14,10981.97,13976.46,24958.43
411605,201911,242,100,142,99817.95,142742.76,242560.71
411610,201911,208,139,69,139747.88,69877.7,209625.58
411620,201911,364,198,166,198638.72,166687.37,365326.09
411630,201911,56,38,18,37925.42,17966.1,55891.52
411640,201911,33,24,9,24952.77,8984.26,33937.03
411650,201911,12,7,5,6986.83,4991.34,11978.17
411660,201911,39,28,11,27944.66,10980.69,38925.35
411670,201911,238,177,61,177674.61,60893.19,238567.80
411680,201911,158,133,25,132755.41,24955.65,157711.06
411690,201911,601,324,277,323402.47,276492.12,599894.59
411695,201911,57,42,15,41920.21,14971.46,56891.67
411700,201911,137,114,23,114797.36,22960.87,137758.23
411705,201911,104,69,35,68877.54,35936.16,104813.70
411710,201911,309,210,99,209599.4,98816.13,308415.53
411720,201911,126,83,43,84841.46,43917.31,128758.77
411721,201911,62,52,10,52901.67,9982.03,62883.70
411722,201911,96,41,55,40923.68,54902.46,95826.14
411725,201911,160,122,38,121771.04,37927.84,159698.88
411727,201911,85,66,19,65875.76,18963.93,84839.69
411729,201911,40,32,8,31939.41,7984,39923.41
411730,201911,548,351,197,350361.45,197634.55,547996.00
411740,201911,40,25,15,24951.71,14970.44,39922.15
411745,201911,66,46,20,46907.76,19960.2,66867.96
411750,201911,870,403,467,404268.22,467171.71,871439.93
411760,201911,1185,889,296,890364.05,295463.74,1185827.79
411770,201911,457,305,152,305456.2,151734.48,457190.68
411780,201911,333,221,112,220589.73,112793.47,333383.20
411790,201911,523,297,226,296471.19,226589.82,523061.01
411800,201911,162,124,38,123788.5,37931.25,161719.75
411810,201911,173,130,43,129762.97,42923.26,172686.23
411820,201911,2167,990,1177,994207.35,1181851.37,2176058.72
411830,201911,11,11,0,10978.84,0,10978.84
411840,201911,1998,1247,751,1247706.63,754626.54,2002333.17
411845,201911,55,20,35,19962.29,34932.45,54894.74
411850,201911,1217,680,537,679747.14,538030.98,1217778.12
411860,201911,46,32,14,31945.01,13975.12,45920.13
411870,201911,74,51,23,50901.89,22958.13,73860.02
411880,201911,419,270,149,269505.54,148726.7,418232.24
411885,201911,103,69,34,68868.76,33938,102806.76
411890,201911,309,201,108,202633.45,107802.96,310436.41
411900,201911,75,55,20,54905.82,19964.4,74870.22
411910,201911,186,149,37,149735.17,36933.67,186668.84
411915,201911,2149,902,1247,902362.66,1248737.78,2151100.44
411920,201911,119,95,24,94837.8,24958.41,119796.21
411925,201911,11,7,4,6987.11,3994.01,10981.12
411930,201911,810,594,216,593943.45,216614.37,810557.82
411940,201911,588,406,182,405269.23,181661.86,586931.09
411950,201911,941,471,470,471162.51,471160.73,942323.24
411960,201911,1030,707,323,708649.95,322394.66,1031044.61
411965,201911,19,14,5,13976.38,4991.75,18968.13
411970,201911,80,73,7,72862.73,6986.58,79849.31
411980,201911,171,117,54,117792.3,54903.37,172695.67
411990,201911,5175,3013,2162,3017641.24,2168149.25,5185790.49
411995,201911,474,177,297,176685.86,296464.24,473150.10
412000,201911,309,201,108,201625.24,107807.71,309432.95
412010,201911,48,32,16,31942.31,15972.96,47915.27
412015,201911,41,29,12,28948.95,11978.98,40927.93
412020,201911,32,26,6,25955.4,5989.61,31945.01
412030,201911,49,46,3,45919.22,2995.28,48914.50
412033,201911,51,32,19,31939.68,18963.73,50903.41
412035,201911,66,44,22,43919.05,21958.09,65877.14
412040,201911,41,26,15,25952.11,14970.64,40922.75
412050,201911,201,156,45,156720.83,44918.42,201639.25
412060,201911,777,591,186,589972.46,187666.9,777639.36
412065,201911,49,32,17,31940.2,16967.65,48907.85
412070,201911,171,118,53,117788.74,52903.56,170692.30
412080,201911,278,145,133,144727.98,132759.21,277487.19
412085,201911,35,16,19,15970.43,18964.91,34935.34
412090,201911,797,504,293,506063.48,293457.15,799520.63
412100,201911,236,200,36,202636.07,35936.2,238572.27
412110,201911,65,51,14,50904.26,13974.47,64878.73
412120,201911,317,191,126,190656.02,126764.99,317421.01
412125,201911,84,50,34,49902.48,33937.23,83839.71
412130,201911,38,25,13,24956.57,12974.83,37931.40
412135,201911,28,16,12,15970.44,11978.01,27948.45
412140,201911,327,227,100,227566.69,99816.95,327383.64
412150,201911,256,171,85,170690.75,84843.47,255534.22
412160,201911,89,51,38,50903.51,37926.49,88830.00
412170,201911,687,482,205,484152.21,204637.31,688789.52
412175,201911,39,28,11,27950.07,10981.25,38931.32
412180,201911,190,150,40,149724.93,39926.16,189651.09
412190,201911,342,273,69,272522.15,68875.37,341397.52
412200,201911,189,119,70,118773.65,70866,189639.65
412210,201911,72,57,15,56893.6,14974.15,71867.75
412215,201911,223,158,65,157704.05,65877.75,223581.80
412217,201911,66,53,13,52899.77,12976.17,65875.94
412220,201911,824,600,224,598944.09,225594.47,824538.56
412230,201911,331,203,128,202629.89,127773.72,330403.61
412240,201911,1336,671,665,674775.15,665806.66,1340581.81
412250,201911,402,256,146,255536.43,146727.29,402263.72
412260,201911,108,78,30,78856.14,29942.93,108799.07
412265,201911,180,142,38,141732.34,37925.76,179658.10
412270,201911,85,56,29,57897.5,28948.01,86845.51
412280,201911,89,73,16,72855.16,15969.45,88824.61
412290,201911,93,65,28,64879.28,27945.99,92825.27
412300,201911,211,138,73,137738.41,72862.21,210600.62
412310,201911,48,41,7,41925.63,6986.95,48912.58
412320,201911,94,79,15,78867.77,14972.38,93840.15
412330,201911,189,161,28,160707.7,27948.36,188656.06
412340,201911,149,103,46,102810.07,46911.56,149721.63
412350,201911,618,302,316,302419.49,316400.11,618819.60
412360,201911,31,25,6,24954.06,5988.8,30942.86
412370,201911,160,138,22,139747.11,21959.13,161706.24
412380,201911,263,199,64,198633.86,63880.88,262514.74
412382,201911,55,28,27,27947.1,26949.08,54896.18
412385,201911,144,106,38,105804.33,37932.16,143736.49
412390,201911,283,219,64,219602.27,63882.52,283484.79
412395,201911,69,56,13,55891.9,12974.68,68866.58
412400,201911,85,57,28,56893.61,27948.06,84841.67
412402,201911,239,115,124,115779.27,123771.32,239550.59
412405,201911,849,315,534,316399.51,533979.76,850379.27
412410,201911,971,601,370,602922.64,371332.27,974254.91
412420,201911,12,10,2,9981.8,1996.9,11978.7
412430,201911,20,15,5,14974.98,4992.49,19967.47
412440,201911,607,335,272,335377.94,274479.32,609857.26
412450,201911,77,67,10,66878.17,9981.63,76859.80
412460,201911,90,69,21,68874.61,21957.83,90832.44
412470,201911,224,181,43,180685.53,42925.44,223610.97
412480,201911,148,110,38,109792.52,38927.22,148719.74
412490,201911,165,145,20,144727.19,19962.49,164689.68
412500,201911,442,363,79,362344.04,78855.94,441199.98
412510,201911,183,150,33,149742.91,32942.72,182685.63
412520,201911,89,58,31,57897.22,30943.48,88840.70
412530,201911,107,57,50,56892.62,50901.85,107794.47
412535,201911,94,69,25,68876.23,24953.19,93829.42
412540,201911,81,37,44,36927.77,43916.17,80843.94
412545,201911,91,65,26,65881.64,26948.99,92830.63
412550,201911,3766,1675,2091,1677988.76,2091291.17,3769279.93
412555,201911,13,9,4,8983.62,3993.82,12977.44
412560,201911,606,438,168,438196.89,167688.62,605885.51
412570,201911,740,392,348,392294.09,348358.62,740652.71
412575,201911,90,62,28,62886.8,27950.17,90836.97
412580,201911,175,117,58,116804.51,57895.4,174699.91
412590,201911,37,32,5,31942.55,4991.37,36933.92
412600,201911,169,125,44,124772.9,43921.09,168693.99
412610,201911,34,18,16,18962.73,15969.35,34932.08
412620,201911,149,127,22,126783.11,21961.63,148744.74
412625,201911,2177,1151,1026,1153894.33,1030118.15,2184012.48
412627,201911,69,53,16,52908.69,15972,68880.69
412630,201911,416,275,141,274526.03,140758.65,415284.68
412635,201911,65,17,48,16967.52,47907.34,64874.86
412640,201911,110,76,34,75866.25,34937.31,110803.56
412650,201911,351,225,126,225593.63,125771.21,351364.84
412660,201911,479,296,183,295456.86,182662.24,478119.10
412665,201911,48,43,5,43916.19,4991.65,48907.84
412667,201911,296,205,91,206633.46,91829.03,298462.49
412670,201911,66,55,11,54898.38,10979.08,65877.46
412680,201911,294,231,63,232576.96,62888.59,295465.55
412690,201911,102,69,33,68875.46,33938.86,102814.32
412700,201911,162,109,53,108793.97,52898.76,161692.73
412710,201911,1419,869,550,871446.72,549996.98,1421443.70
412720,201911,231,150,81,149724.84,80851.21,230576.05
412730,201911,192,161,31,162693.88,30940.64,193634.52
412740,201911,421,229,192,229593.55,191657.35,421250.90
412750,201911,449,259,190,260535.72,189649.58,450185.30
412760,201911,274,145,129,144741.74,128769.08,273510.82
412770,201911,2124,1173,951,1177863.56,952244.55,2130108.11
412780,201911,147,114,33,113801.36,32941.35,146742.71
412785,201911,270,137,133,136746.02,132746.93,269492.95
412788,201911,32,19,13,18969.38,12978.75,31948.13
412790,201911,128,108,20,108811.1,19966.95,128778.05
412795,201911,150,110,40,110804.1,39932.45,150736.55
412796,201911,324,214,110,214582.6,109782.92,324365.52
412800,201911,593,380,213,381293.45,213603.05,594896.50
412810,201911,2961,1633,1328,1637991.17,1331552.77,2969543.94
412820,201911,949,609,340,611918.12,342381.94,954300.06
412830,201911,14,11,3,10979.89,2994.96,13974.85
412840,201911,222,160,62,159705.9,61885.25,221591.15
412850,201911,771,508,263,508081.58,262514.57,770596.15
412853,201911,169,88,81,88833.77,80848.33,169682.10
412855,201911,202,111,91,110802.55,90839.73,201642.28
412860,201911,94,64,30,64890.3,29946.71,94837.01
412862,201911,56,42,14,41923.46,13973.62,55897.08
412863,201911,5,5,0,4991.5,0,4991.5
412865,201911,44,32,12,31940.57,11976.94,43917.51
412870,201911,111,69,42,69873.02,41927.47,111800.49
412880,201911,99,75,24,74866.51,24953.77,99820.28
420005,201911,41,37,4,37927.97,3992,41919.97
420010,201911,372,244,128,243551.19,127758.32,371309.51
420020,201911,82,70,12,70868.58,11977.48,82846.06
420030,201911,22,20,2,20961.28,1996,22957.28
420040,201911,105,82,23,81853.7,22959.19,104812.89
420050,201911,53,33,20,32941.25,19963.39,52904.64
420055,201911,19,19,0,18969.22,0,18969.22
420060,201911,30,23,7,22962.69,6989.42,29952.11
420070,201911,104,87,17,86843.72,16969.66,103813.38
420075,201911,12,12,0,11976.93,0,11976.93
420080,201911,42,36,6,36933.76,5988.85,42922.61
420090,201911,36,33,3,32939.82,2995.47,35935.29
420100,201911,152,130,22,129779.18,21964.91,151744.09
420110,201911,21,21,0,20963.07,0,20963.07
420120,201911,60,47,13,47915.64,13976.24,61891.88
420125,201911,84,66,18,66877.01,17966.21,84843.22
420127,201911,29,25,4,24951.74,3992,28943.74
420130,201911,406,252,154,253531.52,155711.94,409243.46
420140,201911,1304,726,578,729682.7,578974.09,1308656.79
420150,201911,46,40,6,39930.98,5988.74,45919.72
420160,201911,35,33,2,32940.51,1996.84,34937.35
420165,201911,16,11,5,10979.92,4990.42,15970.34
420170,201911,76,50,26,49907.94,25949.07,75857.01
420180,201911,22,20,2,19962.16,1996.8,21958.96
420190,201911,26,22,4,21962.29,3992.63,25954.92
420195,201911,129,66,63,66891.13,63893.76,130784.89
420200,201911,1291,573,718,577951.79,719702.4,1297654.19
420205,201911,72,42,30,41925.09,29944.87,71869.96
420207,201911,117,64,53,63892.59,52908.53,116801.12
420208,201911,19,15,4,14970.72,3992.4,18963.12
420209,201911,19,16,3,15969.23,2994.07,18963.30
420210,201911,494,238,256,239547.03,255517.7,495064.73
420213,201911,49,38,11,37930.85,10979.07,48909.92
420215,201911,26,23,3,23959.14,2995.42,26954.56
420220,201911,71,48,23,47915.19,22958.94,70874.13
420230,201911,818,466,352,467179.36,353401.42,820580.78
420240,201911,2285,1517,768,1520188.75,768561.35,2288750.10
420243,201911,41,32,9,32940.49,8985.27,41925.76
420245,201911,139,75,64,74863.17,63886.2,138749.37
420250,201911,63,40,23,39932.24,22959.04,62891.28
420253,201911,40,32,8,32940.49,7987.27,40927.76
420257,201911,13,11,2,10978.87,1996.4,12975.27
420260,201911,99,84,15,84846.95,15972.28,100819.23
420270,201911,38,29,9,28945.8,8983.7,37929.5
420280,201911,290,217,73,216619.85,73867.65,290487.50
420285,201911,22,12,10,11978.13,9981.6,21959.73
420287,201911,49,32,17,31944.95,16970.03,48914.98
420290,201911,1007,706,301,711673.95,303438.91,1015112.86
420300,201911,1445,1156,289,1157947.55,289473.39,1447420.94
420310,201911,48,32,16,31940.21,15970.57,47910.78
420315,201911,35,30,5,29949.08,4991.88,34940.96
420320,201911,885,447,438,450201.1,439215.19,889416.29
420325,201911,0,0,0,0,0,0
420330,201911,119,82,37,81859.73,36933.29,118793.02
420340,201911,158,105,53,104811.65,52904.42,157716.07
420350,201911,247,182,65,182662.23,64878.47,247540.70
420360,201911,755,581,174,580973.48,173696.62,754670.10
420370,201911,123,75,48,74866.13,47922.47,122788.60
420380,201911,1149,806,343,806527.98,344381.64,1150909.62
420390,201911,261,179,82,179667.45,83843.91,263511.36
420395,201911,192,139,53,139743.49,52905.98,192649.47
420400,201911,250,189,61,188654.52,60885.19,249539.71
420410,201911,61,46,15,45916.42,14971.32,60887.74
420415,201911,32,29,3,28944.93,2994.28,31939.21
420417,201911,51,40,11,39929.32,10981.39,50910.71
420419,201911,11,11,0,10981.62,0,10981.62
420420,201911,2829,1758,1071,1761787.72,1073056.3,2834844.02
420425,201911,73,60,13,59892.11,12976.84,72868.95
420430,201911,1212,865,347,867373.5,349335.06,1216708.56
420435,201911,16,14,2,13977.32,1996.11,15973.43
420440,201911,96,67,29,67878.54,28947.2,96825.74
420445,201911,22,21,1,20963.52,998,21961.52
420450,201911,77,39,38,38926.65,37928.8,76855.45
420455,201911,217,169,48,168694.23,47918.8,216613.03
420460,201911,2341,1530,811,1536203.15,813531.56,2349734.71
420470,201911,109,77,32,76860.15,31941.94,108802.09
420475,201911,7,7,0,6986,0,6986
420480,201911,873,660,213,659795.55,212614.95,872410.50
420490,201911,106,78,28,77859.51,28948.38,106807.89
420500,201911,501,248,253,248541.88,263513.43,512055.31
420510,201911,19,18,1,17966.68,998,18964.68
420515,201911,25,18,7,18967.15,6987.31,25954.46
420517,201911,10,10,0,9982.85,0,9982.85
420519,201911,0,0,0,0,0,0
420520,201911,73,55,18,54905.01,17970.54,72875.55
420530,201911,166,112,54,112786.51,53902.37,166688.88
420535,201911,20,18,2,17965.62,1996,19961.62
420540,201911,5454,3245,2209,3257538.32,2218110.2,5475648.52
420543,201911,26,25,1,24954.63,998.99,25953.62
420545,201911,207,149,58,149727.31,57894.43,207621.74
420550,201911,866,709,157,710708.47,157715.44,868423.91
420555,201911,37,27,10,26951.73,9984.92,36936.65
420560,201911,65,53,12,53903.07,11977.64,65880.71
420570,201911,156,93,63,92835.84,62891.01,155726.85
420580,201911,280,130,150,129768.96,149742.17,279511.13
420590,201911,522,354,168,355322.15,169668.95,524991.10
420600,201911,113,63,50,63887.24,50909.36,114796.60
420610,201911,40,37,3,36934.94,2994.8,39929.74
420620,201911,80,65,15,64884.88,14972.82,79857.70
420630,201911,153,110,43,109798.41,43922.14,153720.55
420640,201911,87,78,9,77854.31,8983.72,86838.03
420650,201911,247,128,119,127765,118788.94,246553.94
420660,201911,52,39,13,38926.91,12977.8,51904.71
420665,201911,37,28,9,27949.27,8983.69,36932.96
420670,201911,313,238,75,238593.94,74869.1,313463.04
420675,201911,15,14,1,13975.99,998,14973.99
420680,201911,38,28,10,27951.21,9982.21,37933.42
420690,201911,183,145,38,145733.44,37929.9,183663.34
420700,201911,704,488,216,488123.32,216612.86,704736.18
420710,201911,151,89,62,88837.43,61888.3,150725.73
420720,201911,110,89,21,88839.71,20960.79,109800.50
420730,201911,585,378,207,378326.21,208632.85,586959.06
420740,201911,50,49,1,48907.6,998,49905.6
420750,201911,522,356,166,357343.01,166687.67,524030.68
420757,201911,17,15,2,14975.17,1997.28,16972.45
420760,201911,36,30,6,29946.4,5988.88,35935.28
420765,201911,80,64,16,63880.16,15970.36,79850.52
420768,201911,50,46,4,45922.61,3992.47,49915.08
420770,201911,77,66,11,66877.87,11976.11,78853.98
420775,201911,44,41,3,40925.01,2994,43919.01
420780,201911,235,189,46,189665.36,45917.08,235582.44
420785,201911,11,9,2,8985.58,1996,10981.58
420790,201911,163,139,24,138750.36,23958.62,162708.98
420800,201911,64,49,15,48909.71,14971.23,63880.94
420810,201911,250,216,34,216611.14,33937.62,250548.76
420820,201911,2348,1368,980,1374486.52,984209.52,2358696.04
420830,201911,602,334,268,338394.17,267508.5,605902.67
420840,201911,149,110,39,109791.5,38925.24,148716.74
420845,201911,419,186,233,185654.39,234574.16,420228.55
420850,201911,252,196,56,196627.89,55893.96,252521.85
420860,201911,64,54,10,53906.14,9981.1,63887.24
420870,201911,124,89,35,88836.72,34937.89,123774.61
420880,201911,180,122,58,121784.99,57894.55,179679.54
420890,201911,950,476,474,477122.75,473116.74,950239.49
420895,201911,9,9,0,8983.83,0,8983.83
420900,201911,422,339,83,338394.39,82846.78,421241.17
420910,201911,5819,3268,2551,3276041.39,2558316.25,5834357.64
420915,201911,71,66,5,66887.29,4990.7,71877.99
420917,201911,20,14,6,13975.7,5989.58,19965.28
420920,201911,23,16,7,15971.2,6987.94,22959.14
420930,201911,2781,1743,1038,1742827,1040179.29,2783006.29
420940,201911,601,444,157,444221.91,158733.13,602955.04
420945,201911,9,7,2,6987.06,1996,8983.06
420950,201911,58,53,5,52902.4,4990.38,57892.78
420960,201911,108,85,23,85847.52,23957.89,109805.41
420970,201911,295,237,58,236599.99,57899.93,294499.92
420980,201911,23,22,1,21959.3,998,22957.3
420985,201911,61,55,6,54896.35,5988.32,60884.67
420990,201911,81,61,20,60889.59,19965.1,80854.69
421000,201911,36,22,14,21958.36,13974.08,35932.44
421003,201911,60,41,19,41928.53,18966.32,60894.85
421005,201911,6,3,3,2995.54,2995.34,5990.88
421010,201911,770,533,237,532052.39,236580.49,768632.88
421020,201911,26,20,6,19966.54,5989.73,25956.27
421030,201911,121,102,19,102827.08,18968.67,121795.75
421040,201911,72,55,17,54903.53,16974.12,71877.65
421050,201911,334,232,102,232555.94,102801.19,335357.13
421055,201911,22,18,4,17967.82,3992.44,21960.26
421060,201911,82,49,33,49904.76,32938.34,82843.10
421070,201911,49,44,5,43923.13,4991.59,48914.72
421080,201911,32,30,2,29948.2,1997.36,31945.56
421085,201911,25,19,6,18968.92,5990.47,24959.39
421090,201911,37,29,8,28947.39,7985.43,36932.82
421100,201911,125,93,32,93836.56,31941.08,125777.64
421105,201911,209,171,38,170689.63,37930.35,208619.98
421110,201911,109,88,21,87846.26,20963.08,108809.34
421120,201911,159,121,38,120772.96,37933.74,158706.70
421125,201911,17,12,5,11977.18,4990.46,16967.64
421130,201911,814,519,295,522045.83,296458.9,818504.73
421140,201911,30,22,8,21958.06,7987.02,29945.08
421145,201911,41,33,8,32939.15,7984.74,40923.89
421150,201911,104,77,27,76866.74,26954.2,103820.94
421160,201911,69,49,20,49905.98,19961.8,69867.78
421165,201911,17,16,1,15969.88,998,16967.88
421170,201911,187,156,31,155844.86,30947.65,186792.51
421175,201911,162,111,51,110804.42,51905.43,162709.85
421180,201911,54,34,20,34937.1,19966.12,54903.22
421185,201911,18,15,3,14973.37,2994.58,17967.95
421187,201911,0,0,0,0,0,0
421189,201911,43,31,12,30942.8,11978.15,42920.95
421190,201911,1634,1048,586,1050186.77,591976.87,1642163.64
421200,201911,88,67,21,67875.4,20961.57,88836.97
421205,201911,26,16,10,15971.4,9981.36,25952.76
421210,201911,171,119,52,119782.08,51906.19,171688.27
421220,201911,278,220,58,219592.56,58890.44,278483.00
421223,201911,48,38,10,38927.04,9981.12,48908.16
421225,201911,68,45,23,44922.64,22962.82,67885.46
421227,201911,85,67,18,66870.85,17965.64,84836.49
421230,201911,54,37,17,36936.13,16971.79,53907.92
421240,201911,19,19,0,18967.6,0,18967.6
421250,201911,365,223,142,223595.24,143739.15,367334.39
421260,201911,24,20,4,19964.21,3992.49,23956.70
421265,201911,2,2,0,1996.56,0,1996.56
421270,201911,46,41,5,41925.63,4990.22,46915.85
421280,201911,341,192,149,192654.18,148737.41,341391.59
421290,201911,336,227,109,226572.96,108793.52,335366.48
421300,201911,24,19,5,18965.6,4990,23955.6
421310,201911,45,33,12,33938.54,11980.5,45919.04
421315,201911,31,20,11,19965.66,10979.2,30944.86
421320,201911,138,92,46,91831.08,45914.35,137745.43
421330,201911,105,79,26,78858.36,26953.12,105811.48
421335,201911,39,27,12,26948.95,11976.85,38925.80
421340,201911,241,154,87,153726.56,86843.2,240569.76
421350,201911,195,112,83,111812.2,83852.69,195664.89
421360,201911,653,489,164,489112.08,164702.47,653814.55
421370,201911,204,157,47,156719.08,46914.14,203633.22
421380,201911,129,102,27,102822.55,26953.75,129776.30
421390,201911,18,12,6,11976.45,5988,17964.45
421400,201911,121,102,19,102801.81,18963.12,121764.93
421410,201911,19,17,2,16971.49,1996,18967.49
421415,201911,21,19,2,18966.13,1996.96,20963.09
421420,201911,139,116,23,115778.44,23953.08,139731.52
421430,201911,16,12,4,11980.64,3992,15972.64
421440,201911,57,49,8,48912.16,7985.96,56898.12
421450,201911,94,78,16,77858.46,15971.91,93830.37
421460,201911,61,49,12,48914.14,11978.22,60892.36
421470,201911,69,45,24,44923.56,23957.93,68881.49
421480,201911,699,526,173,527999.1,173668.6,701667.7
421490,201911,25,24,1,23957.54,998,24955.54
421500,201911,496,323,173,322419.39,172684.93,495104.32
421505,201911,25,18,7,17969.48,6986.88,24956.36
421507,201911,30,23,7,22958.39,6986.55,29944.94
421510,201911,73,48,25,47917.75,24953.26,72871.01
421520,201911,56,47,9,46914.26,8984.71,55898.97
421530,201911,52,44,8,43920.88,7984.73,51905.61
421535,201911,27,25,2,25959.21,1996.27,27955.48
421540,201911,55,47,8,46915.23,7984.07,54899.30
421545,201911,101,75,26,74872.88,25952.6,100825.48
421550,201911,287,207,80,208642.33,79860.32,288502.65
421555,201911,25,20,5,19967.14,4990.72,24957.86
421560,201911,8,7,1,7986.01,998.4,8984.41
421565,201911,127,89,38,88842.31,37935.82,126778.13
421567,201911,31,25,6,24955.4,5988,30943.4
421568,201911,29,26,3,25949.59,2994.99,28944.58
421569,201911,9,9,0,8984.64,0,8984.64
421570,201911,194,133,61,133763.96,60891.51,194655.47
421575,201911,29,24,5,23955.2,4990.44,28945.64
421580,201911,710,420,290,422289.91,289466.75,711756.66
421590,201911,20,19,1,18967.91,998.02,19965.93
421600,201911,150,99,51,98811.8,50903.18,149714.98
421605,201911,113,79,34,78855.78,33938.43,112794.21
421610,201911,187,143,44,143729.6,43920.11,187649.71
421620,201911,1045,623,422,622869.4,423248.99,1046118.39
421625,201911,23,20,3,19962.37,2994.23,22956.60
421630,201911,305,195,110,194655.64,109803.6,304459.24
421635,201911,18,9,9,8984.42,8985.12,17969.54
421640,201911,100,85,15,84855.5,14973.86,99829.36
421650,201911,306,184,122,183678.5,121783.56,305462.06
421660,201911,2218,1343,875,1347588.84,879461.34,2227050.18
421670,201911,185,136,49,137738.33,48903.49,186641.82
421680,201911,176,159,17,158713.34,16968.84,175682.18
421690,201911,350,254,96,253535.85,95830.23,349366.08
421700,201911,58,38,20,37930.79,19963.29,57894.08
421710,201911,26,25,1,24953.64,998,25951.64
421715,201911,7,7,0,6988.09,0,6988.09
421720,201911,607,435,172,437179.12,172675.45,609854.57
421725,201911,14,6,8,5990.33,7986.05,13976.38
421730,201911,35,25,10,24957.15,9985.54,34942.69
421740,201911,89,39,50,38930.19,49904.71,88834.90
421750,201911,212,158,54,158697.35,54897.6,213594.95
421755,201911,26,24,2,23955.28,1996.44,25951.72
421760,201911,100,71,29,70870.22,28949.34,99819.56
421770,201911,632,409,223,412265.09,223603.51,635868.60
421775,201911,30,18,12,17968.2,11979.06,29947.26
421780,201911,197,155,42,154712.87,42917.05,197629.92
421790,201911,153,132,21,132755.43,20961.66,153717.09
421795,201911,20,16,4,15972.67,3992,19964.67
421800,201911,508,326,182,329446.01,183676.04,513122.05
421810,201911,72,60,12,59891.82,12977.16,72868.98
421820,201911,337,228,109,229584.21,108796.35,338380.56
421825,201911,133,114,19,113809.1,18968.72,132777.82
421830,201911,135,98,37,98828.6,36931.71,135760.31
421835,201911,5,4,1,3992.99,998,4990.99
421840,201911,53,45,8,44920.24,7987.57,52907.81
421850,201911,80,69,11,69877.35,10981.32,80858.67
421860,201911,40,32,8,31943.55,7984.58,39928.13
421870,201911,998,755,243,757631.36,242558.52,1000189.88
421875,201911,54,45,9,44919.8,8982.89,53902.69
421880,201911,168,121,47,121768.24,46910.09,168678.33
421885,201911,22,18,4,17966.89,3992.34,21959.23
421890,201911,132,94,38,93833.15,37936.38,131769.53
421895,201911,48,43,5,42922.62,4990.67,47913.29
421900,201911,161,127,34,127785.99,33942.88,161728.87
421910,201911,68,41,27,40927.21,26950.66,67877.87
421915,201911,32,27,5,26951.49,4991.74,31943.23
421917,201911,40,31,9,30941.01,8983.31,39924.32
421920,201911,40,37,3,36937.69,2994,39931.69
421930,201911,725,576,149,576961.38,149733.76,726695.14
421935,201911,50,44,6,43918.35,5989.98,49908.33
421940,201911,43,38,5,37928.95,4990.44,42919.39
421950,201911,864,584,280,585918.74,279496.48,865415.22
421960,201911,44,38,6,37929,5988,43917
421970,201911,367,241,126,240551.35,125766.57,366317.92
421985,201911,27,18,9,17971.67,8986.73,26958.40
422000,201911,0,0,0,0,0,0
430003,201911,186,54,132,53893.72,132734.55,186628.27
430005,201911,37,28,9,27948.11,8982.67,36930.78
430010,201911,266,191,75,193623.62,77847.22,271470.84
430020,201911,144,96,48,95823.4,47909.2,143732.6
430030,201911,126,100,26,100810.34,26948.44,127758.78
430040,201911,2945,1744,1201,1743677.83,1202714.88,2946392.71
430045,201911,70,58,12,57884.17,11977.08,69861.25
430047,201911,7,6,1,5988,998.88,6986.88
430050,201911,78,67,11,68867.06,11976.67,80843.73
430055,201911,14,12,2,11976.39,1996.4,13972.79
430057,201911,5,4,1,3992,998,4990
430060,201911,3723,2178,1545,2183985.95,1554146.56,3738132.51
430063,201911,55,51,4,50900.24,3992.23,54892.47
430064,201911,155,125,30,124752.47,29940.68,154693.15
430066,201911,5,2,3,2994.4,2995,5989.4
430070,201911,44,33,11,32935.59,10979.07,43914.66
430080,201911,67,46,21,45911.36,20958.4,66869.76
430085,201911,33,11,22,10979.1,21960.4,32939.5
430087,201911,29,23,6,22960.36,5991.06,28951.42
430090,201911,72,66,6,65870.27,5988,71858.27
430100,201911,123,84,39,85836.67,38924.82,124761.49
430105,201911,145,78,67,77866.33,66880.53,144746.86
430107,201911,19,14,5,13975.7,4991.65,18967.35
430110,201911,430,250,180,249523.19,182648.44,432171.63
430120,201911,146,135,11,135734.65,10978.74,146713.39
430130,201911,797,488,309,488057.86,308400.44,796458.30
430140,201911,126,119,7,118773.34,6986.4,125759.74
430150,201911,105,70,35,69867.52,34930.44,104797.96
430155,201911,35,31,4,30942.53,3992,34934.53
430160,201911,3632,2144,1488,2156927.83,1489181.31,3646109.14
430163,201911,347,162,185,162691.87,186643.38,349335.25
430165,201911,28,18,10,18962.81,9980,28942.81
430170,201911,93,79,14,78846.36,13972,92818.36
430175,201911,79,61,18,60878.79,17964,78842.79
430180,201911,104,86,18,85834.9,17964,103798.9
430185,201911,34,24,10,23954.16,9980.55,33934.71
430187,201911,85,38,47,37924.97,46907.3,84832.27
430190,201911,221,120,101,120769.95,100807.08,221577.03
430192,201911,13,11,2,10979.12,1996.31,12975.43
430195,201911,17,11,6,10978,5988,16966
430200,201911,164,142,22,141733.4,21958.62,163692.02
430205,201911,20,19,1,18962.67,998,19960.67
430210,201911,697,544,153,544946.49,153700.51,698647.00
430215,201911,13,11,2,10978,1996.2,12974.2
430220,201911,74,52,22,51899.27,21956,73855.27
430222,201911,12,6,6,5988,5988.67,11976.67
430223,201911,16,8,8,7984.2,7984,15968.2
430225,201911,2,1,1,998,998,1996
430230,201911,318,186,132,186643.75,131741.93,318385.68
430235,201911,53,40,13,40922.17,12974.34,53896.51
430237,201911,25,20,5,19961.15,4990,24951.15
430240,201911,127,83,44,82836.49,44910.46,127746.95
430245,201911,70,57,13,56891.7,12977.05,69868.75
430250,201911,191,114,77,113780.24,77844,191624.24
430258,201911,9,8,1,7985.37,998,8983.37
430260,201911,32,28,4,27946.13,3992,31938.13
430265,201911,35,31,4,30939.91,3992.17,34932.08
430270,201911,520,388,132,390261.73,132749.52,523011.25
430280,201911,1036,641,395,642746.16,395227.82,1037973.98
430290,201911,391,219,172,220573.52,172663.17,393236.69
430300,201911,2078,1160,918,1163818.1,926251.98,2090070.08
430310,201911,1948,1001,947,1001146.95,954224.65,1955371.60
430320,201911,55,44,11,43912.15,10978,54890.15
430330,201911,97,86,11,85835.8,10978,96813.8
430340,201911,71,60,11,59886.95,10978,70864.95
430350,201911,1658,1131,527,1135817.37,531975.18,1667792.55
430355,201911,22,19,3,18963.28,2994,21957.28
430360,201911,89,46,43,45910.59,42914.56,88825.15
430367,201911,33,24,9,23953.38,8982.84,32936.22
430370,201911,55,47,8,46907.03,7984,54891.03
430380,201911,140,105,35,104798.55,34931.4,139729.95
430390,201911,587,368,219,369318.95,220595,589913.95
430400,201911,138,106,32,105792.96,31937.69,137730.65
430410,201911,58,46,12,45909.62,11976.44,57886.06
430420,201911,506,335,171,334366.23,170673.03,505039.26
430430,201911,54,53,1,52235.51,998,53233.51
430435,201911,155,115,40,114776.41,40919.84,155696.25
430440,201911,510,341,169,340357.92,169672.65,510030.57
430450,201911,1168,962,206,960179.49,207608.91,1167788.40
430460,201911,5103,2745,2358,2746863.6,2367534.9,5114398.5
430461,201911,16,15,1,15968,998,16966
430462,201911,9,5,4,4990.89,3992.99,8983.88
430463,201911,1066,574,492,575922.73,495076.46,1070999.19
430465,201911,23,13,10,12976.29,9980,22956.29
430466,201911,692,496,196,498054.16,197620.56,695674.72
430467,201911,102,56,46,55891.69,45910.03,101801.72
430468,201911,113,66,47,66871.12,46908.95,113780.07
430469,201911,23,18,5,17970.01,4991.01,22961.02
430470,201911,1152,651,501,653041.14,501038.41,1154079.55
430471,201911,58,41,17,40924.2,16969.08,57893.28
430480,201911,102,64,38,63874.29,37924.96,101799.25
430485,201911,6,6,0,5988.87,0,5988.87
430490,201911,87,69,18,68866.09,17964.79,86830.88
430495,201911,34,26,8,25949.27,7984,33933.27
430500,201911,188,127,61,126752.27,61877.96,188630.23
430510,201911,3466,2283,1183,2292609.37,1186699.67,3479309.04
430511,201911,17,16,1,15970.27,998,16968.27
430512,201911,146,103,43,103801.42,42919.14,146720.56
430513,201911,52,41,11,40920.94,10978,51898.94
430515,201911,31,29,2,28942.81,1996,30938.81
430517,201911,169,150,19,149707.2,18962.67,168669.87
430520,201911,355,248,107,248519.15,106792.04,355311.19
430530,201911,85,49,36,48904.66,35930.73,84835.39
430535,201911,454,313,141,312405.93,143724.73,456130.66
430537,201911,10,10,0,9981.07,0,9981.07
430540,201911,80,55,25,54890,24950,79840
430543,201911,351,113,238,112779.07,239552.14,352331.21
430544,201911,42,39,3,39931.71,2995.07,42926.78
430545,201911,365,191,174,191635.29,175669.17,367304.46
430550,201911,42,35,7,34932.29,6986.76,41919.05
430558,201911,4,2,2,1996,1996,3992
430560,201911,56,30,26,29940,25948,55888
430570,201911,107,41,66,40923.79,65870.41,106794.20
430580,201911,128,105,23,104794.12,22955.59,127749.71
430583,201911,14,14,0,13972.76,0,13972.76
430585,201911,11,4,7,3992,6986.12,10978.12
430587,201911,15,7,8,6986,7985.74,14971.74
430590,201911,148,122,26,122759.38,25950.56,148709.94
430593,201911,2,2,0,1996,0,1996
430595,201911,16,13,3,12974.99,2994,15968.99
430597,201911,47,26,21,25950.43,20960.75,46911.18
430600,201911,220,160,60,159689.22,60879.55,220568.77
430605,201911,157,99,58,99802.83,58882,158684.83
430607,201911,20,17,3,16969.53,2994.5,19964.03
430610,201911,1609,772,837,772513.45,836368.82,1608882.27
430613,201911,3,3,0,2995.01,0,2995.01
430620,201911,114,80,34,79841.57,34931.76,114773.33
430630,201911,49,42,7,41919.33,6986,48905.33
430632,201911,32,27,5,26946.68,4990,31936.68
430635,201911,35,32,3,31937.02,2994,34931.02
430637,201911,52,29,23,28942.74,22954,51896.74
430640,201911,186,106,80,105801.17,79852.42,185653.59
430642,201911,22,20,2,19960.17,1996,21956.17
430645,201911,38,31,7,30938.67,6986,37924.67
430650,201911,251,202,49,201631.58,48904.63,250536.21
430655,201911,2,2,0,1996.26,0,1996.26
430660,201911,975,481,494,484094.56,495073.65,979168.21
430670,201911,75,52,23,51897.65,23952.54,75850.19
430673,201911,71,42,29,41919.08,29940.69,71859.77
430675,201911,11,9,2,8982.79,1996.58,10979.37
430676,201911,501,296,205,297435.01,204619.09,502054.10
430680,201911,241,169,72,169680.81,71861.06,241541.87
430690,201911,537,336,201,335367.79,201615.66,536983.45
430692,201911,7,5,2,4991.18,1996.54,6987.72
430693,201911,138,93,45,92822.39,45912.22,138734.61
430695,201911,72,60,12,59880.12,11976,71856.12
430697,201911,56,35,21,34931.16,20958.71,55889.87
430700,201911,1531,1066,465,1068965.89,468110.79,1537076.68
430705,201911,20,19,1,18962.94,998,19960.94
430710,201911,256,164,92,165674.4,92814.76,258489.16
430720,201911,106,90,16,89821.66,15968,105789.66
430730,201911,137,118,19,117768.15,18962,136730.15
430740,201911,73,50,23,49903.1,22954,72857.1
430745,201911,31,24,7,24952.25,6986,31938.25
430750,201911,333,217,116,216574.01,116769.2,333343.21
430755,201911,83,46,37,45911.01,36928.93,82839.94
430760,201911,369,213,156,213598.87,157704.3,371303.17
430770,201911,1449,757,692,757597.27,694720.71,1452317.98
430780,201911,296,192,104,192621.49,105793.04,298414.53
430781,201911,26,22,4,22959.02,3992.34,26951.36
430783,201911,57,46,11,45908.67,10978,56886.67
430786,201911,6,4,2,3992,1996,5988
430790,201911,523,346,177,345337.74,176660.43,521998.17
430800,201911,154,129,25,130746.99,24951.17,155698.16
430805,201911,40,36,4,36929.41,3992,40921.41
430807,201911,45,26,19,25948.61,18962,44910.61
430810,201911,73,47,26,46908.4,25948.98,72857.38
430820,201911,144,85,59,84835.38,58883.52,143718.90
430825,201911,10,8,2,7984.83,1996,9980.83
430830,201911,238,221,17,221568.61,16966.95,238535.56
430840,201911,125,86,39,85837.04,39920.73,125757.77
430843,201911,6,4,2,3992.44,1996,5988.44
430845,201911,74,43,31,42916.12,30938,73854.12
430850,201911,587,411,176,413194.31,175653.79,588848.10
430860,201911,167,107,60,106791.48,60880.51,167671.99
430865,201911,73,41,32,40919.87,31936.82,72856.69
430870,201911,77,63,14,62881.55,13972.45,76854.00
430880,201911,154,117,37,116773.41,36929.43,153702.84
430885,201911,10,8,2,7984.98,1996,9980.98
430890,201911,350,212,138,214576.01,137725.12,352301.13
430900,201911,521,365,156,365284.25,157689.77,522974.02
430905,201911,114,51,63,50899.17,62876,113775.17
430910,201911,284,157,127,156711.27,128753.41,285464.68
430912,201911,5,5,0,4990,0,4990
430915,201911,34,29,5,28942.54,4990,33932.54
430920,201911,4197,2293,1904,2301776.3,1910494.36,4212270.66
430925,201911,4,3,1,2994,998,3992
430930,201911,2060,1204,856,1204756.81,861402.38,2066159.19
430940,201911,262,173,89,172669.07,89824.32,262493.39
430950,201911,151,124,27,123758.94,26946.55,150705.49
430955,201911,24,13,11,12974.34,10978,23952.34
430957,201911,16,15,1,14972.79,998,15970.79
430960,201911,243,163,80,163678.97,80840.99,244519.96
430965,201911,113,73,40,72855.98,39921.18,112777.16
430970,201911,81,68,13,67865.86,12974,80839.86
430975,201911,41,37,4,37927.15,3992.34,41919.49
430980,201911,46,29,17,28946.12,16967.33,45913.45
430990,201911,115,89,26,88824.67,25948,114772.67
430995,201911,117,111,6,111780.59,5988.4,117768.99
431000,201911,305,140,165,139734.5,166674.43,306408.93
431010,201911,353,205,148,206610.97,148721.84,355332.81
431020,201911,1885,1097,788,1099914.91,790484.78,1890399.69
431030,201911,42,33,9,32936.45,8982,41918.45
431033,201911,384,189,195,189649.99,195641.19,385291.18
431036,201911,13,8,5,7984.73,4990,12974.73
431040,201911,136,83,53,82839.02,52897.14,135736.16
431041,201911,38,26,12,26946.91,11976,38922.91
431043,201911,47,27,20,26948.1,20958.79,47906.89
431046,201911,11,7,4,6986.78,3992.44,10979.22
431050,201911,197,126,71,125760.37,70862.31,196622.68
431053,201911,73,43,30,42918.46,29944.42,72862.88
431055,201911,64,45,19,44914.36,18962,63876.36
431057,201911,18,18,0,17964.09,0,17964.09
431060,201911,1637,1053,584,1053936.52,585856.66,1639793.18
431065,201911,20,12,8,11977.15,7984,19961.15
431070,201911,63,57,6,56887.44,5988,62875.44
431075,201911,7,7,0,6988.75,0,6988.75
431080,201911,131,80,51,79849.19,50902.44,130751.63
431085,201911,32,28,4,27946.17,3992,31938.17
431087,201911,15,12,3,11976.27,2994.17,14970.44
431090,201911,56,44,12,43912,11976,55888
431100,201911,1199,723,476,725609.17,479082.54,1204691.71
431110,201911,233,143,90,144725.96,90822.39,235548.35
431112,201911,26,15,11,14974.06,10980.1,25954.16
431113,201911,33,24,9,24951.41,8982,33933.41
431115,201911,155,109,46,108791.08,45908.44,154699.52
431120,201911,592,355,237,359302.1,237542.52,596844.62
431123,201911,3,2,1,1996.74,998.77,2995.51
431125,201911,95,86,9,85830.29,8982,94812.29
431127,201911,9,4,5,3992,4990.87,8982.87
431130,201911,697,454,243,453116.51,243520.05,696636.56
431140,201911,761,533,228,532974.65,229555.06,762529.71
431142,201911,33,26,7,25953.82,6987.61,32941.43
431150,201911,194,148,46,147717.04,45909.51,193626.55
431160,201911,53,48,5,47905.94,4990,52895.94
431162,201911,10,8,2,7986.21,1996.44,9982.65
431164,201911,6,6,0,5988.22,0,5988.22
431170,201911,108,84,24,86831.48,23952,110783.48
431171,201911,67,41,26,40918.66,25948.5,66867.16
431173,201911,1,1,0,998.93,0,998.93
431175,201911,198,103,95,103796.92,94814.41,198611.33
431177,201911,79,59,20,58894.41,19961.7,78856.11
431179,201911,14,12,2,11978,1996.78,13974.78
431180,201911,451,277,174,276457.93,173661.47,450119.40
431190,201911,81,63,18,62879.73,17964.49,80844.22
431198,201911,70,49,21,48905.6,20958.8,69864.4
431200,201911,21,17,4,16966,3992,20958
431205,201911,22,22,0,21956.67,0,21956.67
431210,201911,92,56,36,56889.91,35932,92821.91
431213,201911,32,28,4,28947.03,3994.18,32941.21
431215,201911,23,20,3,19961.24,2994,22955.24
431217,201911,4,3,1,2995.53,998,3993.53
431220,201911,68,59,9,58885.02,8982.34,67867.36
431225,201911,146,96,50,95809.17,49901.52,145710.69
431230,201911,105,92,13,91818.67,12974,104792.67
431235,201911,8,8,0,7984.8,0,7984.8
431237,201911,22,16,6,15969.68,5988.2,21957.88
431238,201911,10,7,3,6987.65,2994.44,9982.09
431240,201911,984,630,354,631820.92,353339.11,985160.03
431242,201911,38,37,1,36928.94,998,37926.94
431244,201911,13,9,4,8985.27,3992.27,12977.54
431245,201911,53,39,14,38924.23,13974.01,52898.24
431247,201911,10,7,3,7984.8,2994,10978.8
431250,201911,275,144,131,143727.76,131750.63,275478.39
431260,201911,60,46,14,45909.37,13972,59881.37
431261,201911,16,10,6,9980,5988.34,15968.34
431262,201911,19,18,1,17964.24,998,18962.24
431265,201911,146,80,66,79842.77,65869.22,145711.99
431267,201911,14,13,1,12976.42,998.5,13974.92
431270,201911,326,269,57,268480.21,56889.95,325370.16
431275,201911,39,36,3,35930.76,2994,38924.76
431280,201911,20,16,4,15969.77,3992,19961.77
431290,201911,23,20,3,19961.18,2994,22955.18
431295,201911,2,2,0,2994,0,2994
431300,201911,22,19,3,18962.38,2994.82,21957.20
431301,201911,6,6,0,5989.28,0,5989.28
431303,201911,59,39,20,38925.05,19960.88,58885.93
431306,201911,239,129,110,128573.06,109783.56,238356.62
431308,201911,7,5,2,4990,1996,6986
431310,201911,66,55,11,54892.64,10978,65870.64
431320,201911,146,89,57,89825.69,58883.52,148709.21
431330,201911,172,113,59,112782.9,58884.85,171667.75
431333,201911,28,24,4,23955.03,3992,27947.03
431335,201911,9,5,4,4990,3992.44,8982.44
431337,201911,337,153,184,153702.59,183641.11,337343.70
431339,201911,20,17,3,16967.18,2994,19961.18
431340,201911,2999,1681,1318,1682744.01,1321503.34,3004247.35
431342,201911,38,23,15,22955.73,14970.97,37926.70
431344,201911,18,18,0,17964.65,0,17964.65
431346,201911,5,5,0,4990,0,4990
431349,201911,36,32,4,31936,3992,35928
431350,201911,919,541,378,543000.17,379306.97,922307.14
431360,201911,48,42,6,41916,5988,47904
431365,201911,325,157,168,156709.13,168675.74,325384.87
431370,201911,1325,777,548,779484.71,547927.9,1327412.61
431380,201911,96,83,13,82842.08,13972.34,96814.42
431390,201911,508,279,229,279459.94,230544.8,510004.74
431395,201911,293,134,159,134744.16,160693.15,295437.31
431400,201911,43,30,13,29942.79,12974,42916.79
431402,201911,102,72,30,71863.3,29941.41,101804.71
431403,201911,23,13,10,12974.85,9981.51,22956.36
431405,201911,664,363,301,364313.84,304428.83,668742.67
431406,201911,31,27,4,26949.87,3992,30941.87
431407,201911,51,41,10,40918.55,10978.44,51896.99
431410,201911,3423,2114,1309,2115024.37,1311513.4,3426537.77
431413,201911,15,12,3,11977.78,2994.36,14972.14
431415,201911,69,52,17,52904.2,16969.16,69873.36
431417,201911,22,12,10,11976,9980,21956
431420,201911,319,218,101,218586.05,100807.39,319393.44
431430,201911,49,23,26,22954.11,25948.44,48902.55
431440,201911,8852,6226,2626,6247289.85,2633061.59,8880351.44
431442,201911,27,15,12,14971.46,11977.67,26949.13
431445,201911,22,20,2,19960.17,1996,21956.17
431446,201911,4,4,0,3992.33,0,3992.33
431447,201911,85,61,24,60882.49,23952,84834.49
431449,201911,54,46,8,45908.1,7984.67,53892.77
431450,201911,417,281,136,280451.26,135730.33,416181.59
431454,201911,0,0,0,0,0,0
431455,201911,54,41,13,40928.29,12976.43,53904.72
431460,201911,513,359,154,358325.56,153705.54,512031.10
431470,201911,116,91,25,91821.94,25950.23,117772.17
431475,201911,10,9,1,8982.47,998.44,9980.91
431477,201911,39,26,13,25948.81,12974,38922.81
431478,201911,8,7,1,6986.96,998,7984.96
431480,201911,497,307,190,306418.56,189636.22,496054.78
431490,201911,28623,16201,12422,16286938.35,12487049.1,28773987.45
431500,201911,78,60,18,59885.34,19960.54,79845.88
431505,201911,27,17,10,16967.78,9980.77,26948.55
431507,201911,12,9,3,8984.97,2994,11978.97
431510,201911,255,181,74,181644.95,73853.94,255498.89
431513,201911,25,22,3,21958.5,2994.11,24952.61
431514,201911,6,5,1,4990,998,5988
431515,201911,83,69,14,68865.76,13972.78,82838.54
431517,201911,5,4,1,3993.08,998,4991.08
431520,201911,39,34,5,33933.49,4990,38923.49
431530,201911,1499,680,819,678677.08,828378.92,1507056.00
431531,201911,25,23,2,22956.38,1996,24952.38
431532,201911,31,22,9,21956.55,8982.18,30938.73
431535,201911,26,16,10,15971.26,9980.4,25951.66
431540,201911,140,116,24,117767.13,23952.34,141719.47
431545,201911,13,11,2,10980.91,1996,12976.91
431550,201911,350,197,153,196629.21,153706.54,350335.75
431555,201911,12,12,0,11976,0,11976
431560,201911,4526,3130,1396,3134120.15,1400381.65,4534501.80
431570,201911,815,435,380,435175.05,381273.33,816448.38
431575,201911,40,23,17,22955.41,16967.35,39922.76
431580,201911,102,69,33,68864.22,32934.14,101798.36
431590,201911,148,126,22,125750.29,21956,147706.29
431595,201911,18,15,3,15971.65,2994.96,18966.61
431600,201911,236,134,102,133748.89,101803.81,235552.70
431610,201911,121,88,33,87831.06,32935.55,120766.61
431620,201911,45,38,7,37926.76,6986,44912.76
431630,201911,128,107,21,106788.44,20958,127746.44
431640,201911,1333,854,479,855345.43,482066.16,1337411.59
431642,201911,36,33,3,32935.07,2994,35929.07
431643,201911,43,21,22,20959.9,21961.71,42921.61
431645,201911,328,194,134,193617.77,133735.68,327353.45
431647,201911,9,9,0,8982.34,0,8982.34
431650,201911,33,23,10,22954.88,9981.6,32936.48
431660,201911,317,203,114,203597.83,113773.82,317371.65
431670,201911,232,108,124,108787.8,125749.87,234537.67
431673,201911,3,3,0,2994.95,0,2994.95
431675,201911,25,20,5,19961.28,4990,24951.28
431680,201911,1103,816,287,820450.63,286462.16,1106912.79
431690,201911,4732,2880,1852,2889549.88,1863474.36,4753024.24
431695,201911,22,17,5,16967.68,4990,21957.68
431697,201911,0,0,0,0,0,0
431700,201911,172,136,36,137728.01,35928,173656.01
431710,201911,3981,1783,2198,1787631.97,2209854.44,3997486.41
431720,201911,1327,816,511,818914.86,511009.47,1329924.33
431725,201911,1,1,0,998,0,998
431730,201911,1165,799,366,798515.43,367317.74,1165833.17
431740,201911,1349,671,678,669715,679677.83,1349392.83
431750,201911,1803,1185,618,1192735.7,618828.33,1811564.03
431755,201911,5,4,1,3992.4,998.49,4990.89
431760,201911,1027,659,368,660797.94,369334.08,1030132.02
431770,201911,405,295,110,297416.21,109782.07,407198.28
431775,201911,30,22,8,21959.7,7985.01,29944.71
431780,201911,550,342,208,342316.95,207584.94,549901.89
431790,201911,167,130,37,129749.2,36926.99,166676.19
431795,201911,12,10,2,9980,1996,11976
431800,201911,3278,1737,1541,1738725.01,1552116.68,3290841.69
431805,201911,19,17,2,16966,1996,18962
431810,201911,604,406,198,406222.39,197611.42,603833.81
431820,201911,319,186,133,185636.9,132735.92,318372.82
431830,201911,2321,1403,918,1409274.07,918239.16,2327513.23
431840,201911,484,323,161,324379.77,160691.26,485071.03
431842,201911,36,29,7,28942,6986,35928
431843,201911,11,8,3,7984.4,2994.47,10978.87
431844,201911,16,13,3,13972,2994,16966
431845,201911,26,24,2,23952.4,1996.44,25948.84
431846,201911,26,22,4,21957.52,3992,25949.52
431848,201911,12,10,2,9980.57,1996,11976.57
431849,201911,9,7,2,6987.45,2994,9981.45
431850,201911,797,655,142,655764.31,141734.19,797498.50
431860,201911,112,77,35,76850.02,34930.44,111780.46
431861,201911,4,2,2,1996.36,1996.78,3993.14
431862,201911,50,34,16,33932.78,16968.52,50901.30
431870,201911,3438,2006,1432,2009283.1,1441335.18,3450618.28
431880,201911,928,684,244,683685.81,243522.57,927208.38
431890,201911,1286,788,498,788465.94,501018.6,1289484.54
431900,201911,185,134,51,133737.98,50898.44,184636.42
431910,201911,56,39,17,38922.8,16967.55,55890.35
431912,201911,42,24,18,23953.92,17964.95,41918.87
431915,201911,123,98,25,98802.44,25948.8,124751.24
431920,201911,152,113,39,113779.53,39920.44,153699.97
431930,201911,78,64,14,64873.07,13972,78845.07
431935,201911,3,3,0,2994,0,2994
431936,201911,12,11,1,10978.5,998,11976.5
431937,201911,20,16,4,15970.89,3992,19962.89
431940,201911,455,305,150,305408.75,149707.53,455116.28
431950,201911,504,315,189,314426.31,190652.7,505079.01
431960,201911,716,396,320,396245.37,321367.25,717612.62
431970,201911,72,65,7,65874.35,6987.11,72861.46
431971,201911,3,3,0,2994,0,2994
431973,201911,21,17,4,16968.79,3992,20960.79
431975,201911,9,8,1,7984,998,8982
431980,201911,212,134,78,133738.9,77847.07,211585.97
431990,201911,1185,631,554,631771.72,555004.24,1186775.96
432000,201911,1671,905,766,906324.75,769589.05,1675913.80
432010,201911,279,192,87,191621.99,87826.7,279448.69
432020,201911,174,144,30,143721.34,30938.36,174659.70
432023,201911,15,13,2,12974,1996,14970
432026,201911,69,64,5,63875.26,4990.32,68865.58
432030,201911,68,34,34,33932.44,33932,67864.44
432032,201911,20,16,4,15969.49,3992.67,19962.16
432035,201911,53,44,9,43916.8,8982.72,52899.52
432040,201911,100,68,32,67868.9,31936.78,99805.68
432045,201911,5,4,1,3992.34,998,4990.34
432050,201911,82,50,32,49904.69,31936.51,81841.20
432055,201911,119,90,29,89825.64,28943.72,118769.36
432057,201911,5,4,1,3992.93,998,4990.93
432060,201911,34,31,3,30941.07,2994,33935.07
432065,201911,31,27,4,26946,3992,30938
432067,201911,88,79,9,78843.8,8982,87825.8
432070,201911,395,304,91,303676.92,90829.22,394506.14
432080,201911,823,578,245,577909.17,246520.98,824430.15
432085,201911,12,9,3,8982.21,2994,11976.21
432090,201911,269,180,89,179651.62,89823.06,269474.68
432100,201911,176,118,58,117769.62,57886.77,175656.39
432110,201911,585,392,193,392245.98,194620.49,586866.47
432120,201911,933,560,373,563918.39,373295.6,937213.99
432130,201911,493,355,138,356320.67,137736.13,494056.80
432132,201911,24,21,3,20958.67,2994,23952.67
432135,201911,77,64,13,63875.38,12974.67,76850.05
432140,201911,257,205,52,207591.74,51897.32,259489.06
432143,201911,200,129,71,129753.1,70865.81,200618.91
432145,201911,277,191,86,191632.3,85831.84,277464.14
432146,201911,13,13,0,12975.55,0,12975.55
432147,201911,109,59,50,58882,50898.72,109780.72
432149,201911,13,9,4,8983.06,3992.27,12975.33
432150,201911,855,532,323,533018.94,325399.99,858418.93
432160,201911,1431,741,690,742599.46,696684.82,1439284.28
432162,201911,4,3,1,2994,998,3992
432163,201911,19,14,5,13972,4990,18962
432166,201911,114,84,30,84104.1,29946.09,114050.19
432170,201911,228,117,111,116778.7,110786.29,227564.99
432180,201911,547,341,206,340326.69,205595.43,545922.12
432183,201911,7,7,0,6988.11,0,6988.11
432185,201911,78,69,9,68869.58,8982.81,77852.39
432190,201911,475,281,194,280455.32,194616.22,475071.54
432195,201911,87,73,14,72856.32,13972.44,86828.76
432200,201911,390,254,136,254507.7,137729.75,392237.45
432210,201911,116,72,44,72857.72,43913.11,116770.83
432215,201911,48,44,4,44915.83,3992,48907.83
432218,201911,20,19,1,18963.97,998,19961.97
432220,201911,674,353,321,353319.52,322372.27,675691.79
432225,201911,13,8,5,7986.21,4990.8,12977.01
432230,201911,141,98,43,97812.57,42914.44,140727.01
432232,201911,14,13,1,12974,998,13972
432234,201911,4,3,1,2994.44,998.8,3993.24
432235,201911,3,3,0,2994,0,2994
432237,201911,27,15,12,14972.57,11977.24,26949.81
432240,201911,4348,2458,1890,2465356.3,1895451.85,4360808.15
432250,201911,1098,707,391,707631.6,392231.27,1099862.87
432252,201911,43,40,3,39920.94,3992,43912.94
432253,201911,62,50,12,49906.12,11979.14,61885.26
432254,201911,28,13,15,12974.4,14970.87,27945.27
432255,201911,14,13,1,12974.78,998,13972.78
432260,201911,834,660,174,660714.06,173660.03,834374.09
432270,201911,241,180,61,180667.33,60891.88,241559.21
432280,201911,145,109,36,108794.22,35930.58,144724.80
432285,201911,2,2,0,1996,0,1996
432290,201911,66,59,7,58884,6986,65870
432300,201911,4624,2592,2032,2606112.73,2039245.41,4645358.14
432310,201911,124,102,22,101801.61,21956,123757.61
432320,201911,23,17,6,16966,5988,22954
432330,201911,16,12,4,11976.02,3992,15968.02
432335,201911,7,6,1,5988.67,998,6986.67
432340,201911,40,35,5,34931.04,4990,39921.04
432345,201911,99,68,31,67867.44,30939.38,98806.82
432350,201911,24,23,1,23952,998,24950
432360,201911,7,5,2,4991.04,1996,6987.04
432370,201911,25,24,1,23954.55,998,24952.55
432375,201911,33,30,3,29941.73,2994,32935.73
432377,201911,9,9,0,8982.22,0,8982.22
432380,201911,167,82,85,82844.19,84834.6,167678.79
500020,201911,243,137,106,136761.91,105812.21,242574.12
500025,201911,128,65,63,64876.57,62876.88,127753.45
500060,201911,1451,912,539,913332.47,539015.83,1452348.30
500070,201911,812,389,423,388291.6,423214.45,811506.05
500080,201911,130,104,26,103813.74,25956.32,129770.06
500085,201911,131,106,25,106798.91,24952.71,131751.62
500090,201911,339,157,182,157711,181666.49,339377.49
500100,201911,727,382,345,385316.78,346395.61,731712.39
500110,201911,2284,1063,1221,1063093.44,1220844.71,2283938.15
500124,201911,265,153,112,152715.51,112790.58,265506.09
500150,201911,335,139,196,138757.5,195666.08,334423.58
500190,201911,524,364,160,364356.97,161717.48,526074.45
500200,201911,186,163,23,163705.49,22957.32,186662.81
500210,201911,1505,544,961,544993.93,963237.7,1508231.63
500215,201911,241,140,101,140754.68,100820.33,241575.01
500220,201911,749,489,260,491133.26,259539.89,750673.15
500230,201911,246,160,86,159714.83,85850.48,245565.31
500240,201911,682,470,212,470149.23,211619.08,681768.31
500260,201911,589,228,361,227599.57,362338.78,589938.35
500270,201911,29670,12831,16839,12842595.12,16857139.6,29699734.72
500280,201911,200,72,128,71861.58,127749.59,199611.17
500290,201911,1180,710,470,710723.3,470149.07,1180872.37
500295,201911,448,290,158,291481.41,157718.43,449199.84
500310,201911,68,23,45,22955.52,44912.58,67868.10
500315,201911,709,425,284,425165.67,284450.28,709615.95
500320,201911,3660,1838,1822,1844694.85,1833717.93,3678412.78
500325,201911,937,514,423,515096.14,423263.28,938359.42
500330,201911,1459,689,770,688764.23,771599.35,1460363.58
500345,201911,308,238,70,237566.07,70872.17,308438.24
500348,201911,242,148,94,149724.34,93825.93,243550.27
500350,201911,122,59,63,58891.94,62888.24,121780.18
500370,201911,5489,2481,3008,2486539.78,3022615.74,5509155.52
500375,201911,340,245,95,246552.49,95828.69,342381.18
500380,201911,590,341,249,342387.22,250541.85,592929.07
500390,201911,74,35,39,34931.86,38925.9,73857.76
500400,201911,213,145,68,144737.62,67880.2,212617.82
500410,201911,546,226,320,225601.19,320439.69,546040.88
500430,201911,524,374,150,376284.8,149723.15,526007.95
500440,201911,199,105,94,104804.2,93826.59,198630.79
500450,201911,400,176,224,175679.72,224586.35,400266.07
500460,201911,286,149,137,149728.71,136753.55,286482.26
500470,201911,438,351,87,351362.21,87840.13,439202.34
500480,201911,104,62,42,61883.98,41924.89,103808.87
500490,201911,113,48,65,47913.33,64878.11,112791.44
500500,201911,1429,524,905,524062.78,907393.92,1431456.70
500510,201911,42,33,9,32943.72,8985.47,41929.19
500515,201911,110,76,34,75863.84,33943.13,109806.97
500520,201911,331,182,149,181671.66,148731.79,330403.45
500525,201911,92,50,42,49908.24,41923.09,91831.33
500540,201911,906,385,521,384324.1,522084.81,906408.91
500560,201911,920,530,390,533028.97,389293.95,922322.92
500568,201911,987,571,416,570964.09,416262.99,987227.08
500570,201911,1200,699,501,699716.62,500117.39,1199834.01
500580,201911,340,173,167,173700.06,166705.13,340405.19
500600,201911,323,164,159,165714.06,159715.02,325429.08
500620,201911,913,644,269,645829.18,269520.16,915349.34
500625,201911,78,64,14,63876.95,13972.33,77849.28
500627,201911,22,11,11,10981.98,10981.16,21963.14
500630,201911,1580,862,718,860487.43,718717.93,1579205.36
500635,201911,518,306,212,307394.27,215574.84,522969.11
500640,201911,394,207,187,208636.19,186678.16,395314.35
500660,201911,5467,2065,3402,2069259.18,3419939.22,5489198.40
500690,201911,576,207,369,206624.43,371306.39,577930.82
500710,201911,384,196,188,197645.23,187670.06,385315.29
500720,201911,966,559,407,559982.67,408269.88,968252.55
500730,201911,192,117,75,116809.46,74875.33,191684.79
500740,201911,883,379,504,381311.62,503084.66,884396.28
500750,201911,149,48,101,47909.85,100806.37,148716.22
500755,201911,124,88,36,87854.52,35937.2,123791.72
500769,201911,747,419,328,418255.69,327405.56,745661.25
500770,201911,408,213,195,215616.64,196641.22,412257.86
500780,201911,159,104,55,106819.68,54906.3,161725.98
500790,201911,1075,553,522,554021.99,521080.65,1075102.64
500793,201911,274,153,121,152723.27,121781.25,274504.52
500795,201911,167,120,47,120771.86,47912.47,168684.33
500797,201911,52,38,14,37927.38,13972.23,51899.61
500800,201911,420,191,229,190646.74,231566.1,422212.84
500830,201911,2235,1267,968,1266767,968296.75,2235063.75
500840,201911,139,104,35,103823.76,34937.41,138761.17
510010,201911,168,92,76,91819.53,76849.8,168669.33
510020,201911,494,223,271,222595.34,271509.79,494105.13
510025,201911,1698,974,724,974252.21,724690.58,1698942.79
510030,201911,669,347,322,346406.1,321456.1,667862.2
510035,201911,128,61,67,60881.38,67870.05,128751.43
510040,201911,390,176,214,176675.61,214602.57,391278.18
510050,201911,390,214,176,214626.9,175697.1,390324.0
510060,201911,117,59,58,58891.98,57888.78,116780.76
510080,201911,228,90,138,89830.42,137732.88,227563.30
510100,201911,70,31,39,30940.94,38927.28,69868.22
510120,201911,39,24,15,23957.85,14972.35,38930.20
510125,201911,380,237,143,238557.19,144732.04,383289.23
510130,201911,563,328,235,329375.57,235557.53,564933.10
510140,201911,415,128,287,127777.43,286475.23,414252.66
510160,201911,111,39,72,38926.38,71875.01,110801.39
510170,201911,823,502,321,505068.98,321415.77,826484.75
510180,201911,2914,1393,1521,1394505.13,1525249.44,2919754.57
510185,201911,14,6,8,5990.61,7984.34,13974.95
510190,201911,222,79,143,78849.28,145723.75,224573.03
510250,201911,2575,1521,1054,1522213.48,1056063.11,2578276.59
510260,201911,177,129,48,128784.58,47918.89,176703.47
510263,201911,468,269,199,269514.79,199632.81,469147.60
510267,201911,681,378,303,380318.26,303465.27,683783.53
510268,201911,61,29,32,28946.69,31941.32,60888.01
510269,201911,72,34,38,33937.03,37927.03,71864.06
510270,201911,394,199,195,199629.96,195630.94,395260.90
510279,201911,221,164,57,163697.41,56894.65,220592.06
510285,201911,183,74,109,73860.94,108795.51,182656.45
510300,201911,511,275,236,278505.93,235591.32,514097.25
510305,201911,206,99,107,98812.25,106795.78,205608.03
510310,201911,102,55,47,54892.93,46909.15,101802.08
510320,201911,842,534,308,535055.26,307456.17,842511.43
510325,201911,402,171,231,170672.79,233558.61,404231.40
510330,201911,425,240,185,239571.63,184659.88,424231.51
510335,201911,635,361,274,363335.88,275498.67,638834.55
510336,201911,50,37,13,37926.54,12976.28,50902.82
510337,201911,107,45,62,44913.04,63874.95,108787.99
510340,201911,17245,7994,9251,8027909.99,9295610.85,17323520.84
510343,201911,62,44,18,43913.69,18962.03,62875.72
510345,201911,168,110,58,109797.31,57893.13,167690.44
510350,201911,655,366,289,367334.99,289463.73,656798.72
510360,201911,195,122,73,123778.37,72869.01,196647.38
510370,201911,140,71,69,71857.42,68865.48,140722.90
510380,201911,88,64,24,63873.33,23952.66,87825.99
510385,201911,58,25,33,24952.36,32934.51,57886.87
510390,201911,109,49,60,48907.72,59884.92,108792.64
510395,201911,46,33,13,33933.37,12974.2,46907.57
510410,201911,701,465,236,466178.01,235581.65,701759.66
510420,201911,568,279,289,280473.71,290448.67,570922.38
510450,201911,48,25,23,26946.88,22955.24,49902.12
510452,201911,51,26,25,25952.08,24954.16,50906.24
510454,201911,52,24,28,23954.36,27946.27,51900.63
510455,201911,127,77,50,76857.4,49904.43,126761.83
510460,201911,175,90,85,89842.09,84845.3,174687.39
510480,201911,730,426,304,428241.66,303459.13,731700.79
510490,201911,352,185,167,184653.29,166684.75,351338.04
510500,201911,237,178,59,177660.16,58888.32,236548.48
510510,201911,804,474,330,475144.15,329398.22,804542.37
510515,201911,1177,634,543,635839.1,544009.57,1179848.67
510517,201911,256,108,148,107802.39,148722.41,256524.80
510520,201911,232,152,80,151729.31,79856.5,231585.81
510523,201911,97,74,23,74853.43,22954.5,97807.93
510525,201911,811,481,330,482111.64,331390.54,813502.18
510530,201911,20,14,6,13973.94,5988.94,19962.88
510550,201911,252,112,140,111805.6,140751.57,252557.17
510558,201911,285,139,146,138735.31,145714.5,284449.81
510560,201911,411,246,165,245576,164708.65,410284.65
510562,201911,649,471,178,471179.33,179675.63,650854.96
510590,201911,763,395,368,395258.66,370322.36,765581.02
510600,201911,248,136,112,135749.54,112792.35,248541.89
510610,201911,193,83,110,83839.94,110797.63,194637.57
510615,201911,191,81,110,80848.45,109793.15,190641.60
510617,201911,20,12,8,11978.14,7985.48,19963.62
510618,201911,116,55,61,54895.47,60882.89,115778.36
510619,201911,101,70,31,69871.3,30942.08,100813.38
510620,201911,169,92,77,92817.8,76848.89,169666.69
510621,201911,185,122,63,121769.43,63875.73,185645.16
510622,201911,494,311,183,311447.79,182671.86,494119.65
510623,201911,339,232,107,231570.21,106798.15,338368.36
510624,201911,94,47,47,46912.45,46913.47,93825.92
510625,201911,540,333,207,334425.38,206640.46,541065.84
510626,201911,113,71,42,70868.39,41919.89,112788.28
510627,201911,68,46,22,45914.77,21958.81,67873.58
510628,201911,146,87,59,88839.81,58888.77,147728.58
510629,201911,256,161,95,160687.41,94813.61,255501.02
510630,201911,448,230,218,230574.49,217597.57,448172.06
510631,201911,12,3,9,2994.2,8983.16,11977.36
510637,201911,350,206,144,206625.19,143748.77,350373.96
510642,201911,970,538,432,539016.74,433207.72,972224.46
510645,201911,0,0,0,0,0,0
510650,201911,1432,948,484,950354.73,484136.92,1434491.65
510665,201911,80,41,39,40931.75,38935.05,79866.80
510670,201911,61,35,26,34934.65,25949.29,60883.94
510675,201911,1149,728,421,728725.08,423261.18,1151986.26
510677,201911,349,179,170,178680.53,169682.56,348363.09
510680,201911,106,62,44,62895.08,43922.88,106817.96
510682,201911,203,100,103,99804.22,102799.43,202603.65
510685,201911,54,42,12,41921.44,11978.57,53900.01
510700,201911,598,345,253,344415.77,254570.35,598986.12
510704,201911,1138,607,531,606975.92,530083.97,1137059.89
510706,201911,132,66,66,65874.33,65878.94,131753.27
510710,201911,392,275,117,274509.23,116786.34,391295.57
510715,201911,60,45,15,45911.6,14970,60881.6
510718,201911,203,106,97,106804.27,97823.56,204627.83
510719,201911,38,17,21,16967.27,20963.31,37930.58
510720,201911,190,131,59,130765.54,60891.18,191656.72
510724,201911,87,35,52,34931.48,51900.09,86831.57
510726,201911,49,25,24,24953.53,24956.66,49910.19
510729,201911,68,30,38,30940.83,37927.07,68867.90
510730,201911,466,262,204,261511.08,203617.82,465128.90
510735,201911,110,45,65,45910.94,64874.01,110784.95
510740,201911,23,12,11,11980.99,10981.79,22962.78
510757,201911,16,13,3,12977.66,2994,15971.66
510760,201911,7119,3728,3391,3730287.76,3398937.34,7129225.10
510770,201911,684,325,359,325407.88,364334.28,689742.16
510774,201911,17,7,10,6988.01,9981.63,16969.64
510775,201911,107,82,25,81840.72,24950,106790.72
510776,201911,29,11,18,10979.36,18964.6,29943.96
510777,201911,192,85,107,84830.18,106787.32,191617.50
510779,201911,49,21,28,20962.33,27950.18,48912.51
510780,201911,285,159,126,159728.03,126770.96,286498.99
510785,201911,397,213,184,213607.25,184649.48,398256.73
510787,201911,193,93,100,92834.82,101816.02,194650.84
510788,201911,1,0,1,0,998.56,998.56
510790,201911,2451,1296,1155,1300625.64,1162881.06,2463506.70
510792,201911,1151,661,490,662809.23,492110.25,1154919.48
510794,201911,115,60,55,59888.05,54899.18,114787.23
510795,201911,2366,1374,992,1377418.08,994164.2,2371582.28
510800,201911,180,111,69,110793.52,68870.6,179664.12
510805,201911,172,116,56,115781.72,56894.46,172676.18
510810,201911,95,42,53,42919.42,53896.67,96816.09
510820,201911,244,119,125,118801.97,124786.92,243588.89
510830,201911,66,41,25,40919.53,24950.9,65870.43
510835,201911,13,9,4,8982.67,3992.81,12975.48
510840,201911,9103,4400,4703,4415298.76,4719767.71,9135066.47
510850,201911,212,85,127,84836.72,126756.78,211593.50
510860,201911,377,170,207,170673.47,208599.68,379273.15
510880,201911,65,49,16,48906.35,15968.34,64874.69
510885,201911,75,42,33,41918.77,32938.11,74856.88
510890,201911,66,39,27,38927.48,27947.37,66874.85
510895,201911,185,109,76,108801.5,75858.97,184660.47
520005,201911,63,35,28,34933.91,27946.87,62880.78
520010,201911,276,127,149,127772.4,148745.81,276518.21
520013,201911,716,456,260,457179.11,260525.69,717704.80
520015,201911,55,40,15,40922.61,14971.38,55893.99
520017,201911,88,49,39,48912.43,38932.97,87845.40
520020,201911,21,11,10,10980.8,9981.32,20962.12
520025,201911,2130,1129,1001,1132062.41,1005300,2137362.41
520030,201911,786,422,364,422257.65,363353.43,785611.08
520050,201911,74,51,23,51899.68,22958.79,74858.47
520055,201911,45,29,16,29943.12,15970.42,45913.54
520060,201911,180,121,59,120790.11,59897.41,180687.52
520080,201911,563,404,159,406239.72,158702.99,564942.71
520082,201911,18,12,6,11978.37,5989.22,17967.59
520085,201911,95,71,24,70866.39,23955.96,94822.35
520090,201911,95,62,33,61881.53,32939.32,94820.85
520110,201911,9130,3980,5150,3990031.08,5170944.22,9160975.30
520120,201911,13,8,5,7984.6,4990.34,12974.94
520130,201911,785,553,232,552969.31,231585.76,784555.07
520140,201911,11977,6733,5244,6757333.22,5261873.07,12019206.29
520145,201911,49,32,17,31941.35,16968.45,48909.80
520150,201911,176,138,38,137752.98,37934.51,175687.49
520160,201911,37,28,9,27949.52,8982.79,36932.31
520170,201911,255,150,105,150760.12,104833.98,255594.10
520180,201911,151,79,72,78853.41,72863.05,151716.46
520215,201911,209,136,73,135746.5,72865.4,208611.9
520235,201911,76,58,18,57889.82,17964.11,75853.93
520250,201911,130,79,51,79851.64,51902.59,131754.23
520260,201911,114,73,41,72871.68,40929.04,113800.72
520280,201911,48,33,15,32937.42,14971.81,47909.23
520310,201911,41,26,15,25950.26,14971.33,40921.59
520320,201911,166,108,58,108800.86,57892.37,166693.23
520330,201911,781,419,362,418270.51,364400.97,782671.48
520340,201911,344,201,143,201643.61,142744.09,344387.70
520350,201911,507,240,267,240559.99,268516.05,509076.04
520355,201911,87,52,35,52902.48,34939.47,87841.95
520357,201911,27,20,7,19960.43,6987.26,26947.69
520360,201911,1,1,0,998.29,0,998.29
520380,201911,134,70,64,69870.21,63880.46,133750.67
520390,201911,261,112,149,112810.97,148746.58,261557.55
520393,201911,15,11,4,10980.02,3993.26,14973.28
520396,201911,88,54,34,53896.01,33936.15,87832.16
520400,201911,207,121,86,120787.28,86845.66,207632.94
520410,201911,193,97,96,96827.11,95825.67,192652.78
520420,201911,19,13,6,12974.91,5988,18962.91
520425,201911,295,145,150,146746.22,150742.07,297488.29
520430,201911,464,244,220,243641.71,220590.88,464232.59
520440,201911,681,482,199,481135.02,198643.65,679778.67
520450,201911,1940,870,1070,868447.02,1070085.24,1938532.26
520455,201911,58,38,20,37937.17,19966.87,57904.04
520460,201911,40,25,15,24955.8,14972.22,39928.02
520465,201911,30,26,4,25951.93,3992.03,29943.96
520470,201911,429,272,157,271520.56,157716.68,429237.24
520480,201911,79,48,31,47920.8,30949.82,78870.62
520485,201911,118,41,77,40925.23,77858.4,118783.63
520490,201911,417,308,109,309443.83,109807.84,419251.67
520495,201911,165,99,66,98812.5,67869.16,166681.66
520500,201911,183,140,43,139760.27,42923.82,182684.09
520505,201911,182,104,78,103802.11,77846.66,181648.77
520510,201911,1787,862,925,866452,928342.39,1794794.39
520520,201911,38,29,9,28945.63,8982.8,37928.43
520530,201911,232,174,58,174713.16,58897.57,233610.73
520540,201911,562,388,174,387302.87,173684.06,560986.93
520545,201911,140,86,54,85855.78,53912.21,139767.99
520547,201911,50,27,23,26952.1,22961.4,49913.5
520549,201911,1203,571,632,571971.62,632869.48,1204841.10
520551,201911,289,153,136,153723.25,135756.47,289479.72
520552,201911,43,29,14,28947.35,14972.95,43920.30
520570,201911,16,9,7,8982,6986.38,15968.38
520580,201911,281,174,107,173690.91,107806.6,281497.51
520590,201911,156,96,60,96824.77,59890.42,156715.19
520620,201911,1152,541,611,543048.58,613926.63,1156975.21
520630,201911,37,23,14,22954.88,13972,36926.88
520640,201911,403,237,166,238567.01,165696.38,404263.39
520650,201911,63,37,26,36926.93,25950.08,62877.01
520660,201911,43,22,21,21958.66,20961.21,42919.87
520670,201911,36,30,6,29942.55,5989.72,35932.27
520680,201911,54,35,19,34943.41,18968.2,53911.61
520690,201911,38,12,26,11978.39,25951.81,37930.20
520710,201911,34,31,3,30938.59,2994.44,33933.03
520725,201911,189,134,55,133764.92,55901.67,189666.59
520735,201911,56,38,18,37925.17,17966.49,55891.66
520740,201911,409,201,208,201631.35,207620.18,409251.53
520750,201911,34,26,8,26947.89,7984.33,34932.22
520753,201911,58,40,18,39923.68,18963.92,58887.60
520760,201911,107,74,33,73876.8,32943.09,106819.89
520780,201911,296,220,76,219604.97,77855.4,297460.37
520790,201911,153,84,69,83836.74,68865,152701.74
520800,201911,3424,1847,1577,1851797.38,1582232.37,3434029.75
520810,201911,162,120,42,120775.96,41922.3,162698.26
520815,201911,5,4,1,3993.38,998,4991.38
520830,201911,148,104,44,103817.28,43924.41,147741.69
520840,201911,354,235,119,235553.88,118774.96,354328.84
520850,201911,101,65,36,64888.41,35937.23,100825.64
520860,201911,1724,1108,616,1108998.85,618878.54,1727877.39
520870,201911,31516,15215,16301,15266707.1,16340052.44,31606759.54
520880,201911,1149,621,528,622887.75,529061.92,1151949.67
520890,201911,785,476,309,475127.66,311439.59,786567.25
520910,201911,990,531,459,531069.66,460200.09,991269.75
520915,201911,98,76,22,75873.04,21962.93,97835.97
520920,201911,407,202,205,201642.23,204634.3,406276.53
520929,201911,18,17,1,16970.76,998.44,17969.20
520940,201911,74,49,25,48907.82,24954.23,73862.05
520945,201911,18,11,7,10978,6986.84,17964.84
520960,201911,45,30,15,29943.3,15968.05,45911.35
520970,201911,335,208,127,208620.3,126769.5,335389.8
520980,201911,94,68,26,67864.6,25948.87,93813.47
520990,201911,458,308,150,310424.41,150717.12,461141.53
520993,201911,129,62,67,61893.74,66888.09,128781.83
520995,201911,247,142,105,142745.33,104817.24,247562.57
521000,201911,1565,922,643,924372.33,645858.4,1570230.73
521010,201911,674,326,348,325405.31,348374.51,673779.82
521015,201911,16,10,6,9983.61,5989.16,15972.77
521020,201911,1430,1005,425,1005175.87,424237.43,1429413.30
521030,201911,50,35,15,34933.19,14971.32,49904.51
521040,201911,947,604,343,607893.34,344386.21,952279.55
521056,201911,42,32,10,31939.45,9980.99,41920.44
521060,201911,131,86,45,85848.06,44920.89,130768.95
521080,201911,446,342,104,343409.74,104817.92,448227.66
521090,201911,532,336,196,336379.77,199637.78,536017.55
521100,201911,274,208,66,207616.34,65879.12,273495.46
521120,201911,1060,744,316,745630.94,315424.77,1061055.71
521130,201911,353,253,100,253549.31,99828.26,353377.57
521140,201911,177,97,80,97824.06,80856.93,178680.99
521150,201911,2699,1184,1515,1184882.7,1518318.31,2703201.01
521160,201911,29,15,14,15968.99,13975.73,29944.72
521170,201911,199,114,85,113785.47,85841.92,199627.39
521180,201911,1180,751,429,751691.48,429269.64,1180961.12
521190,201911,2542,1072,1470,1078076.46,1471379.92,2549456.38
521200,201911,55,41,14,40918.98,13972.58,54891.56
521205,201911,11,8,3,7984,2994,10978
521210,201911,129,74,55,73876.87,56906.49,130783.36
521220,201911,813,567,246,565980.89,245554.67,811535.56
521225,201911,34,23,11,22963.61,10980.89,33944.50
521230,201911,103,68,35,70878.54,35936.73,106815.27
521250,201911,6173,3531,2642,3546936.07,2650483.91,6197419.98
521260,201911,25,14,11,13972.2,10978.5,24950.7
521270,201911,141,109,32,108788.72,31938.29,140727.01
521280,201911,431,264,167,263515.37,166704.99,430220.36
521290,201911,28,12,16,11978.31,15970.47,27948.78
521295,201911,97,64,33,63888.48,32942.18,96830.66
521300,201911,218,117,101,116792.9,100816.09,217608.99
521305,201911,37,25,12,24956.34,11978.87,36935.21
521308,201911,1093,827,266,825509.37,265517.94,1091027.31
521310,201911,1322,772,550,773686.26,550056.09,1323742.35
521340,201911,21,16,5,15969.32,4990.44,20959.76
521350,201911,127,95,32,94830.58,31944.16,126774.74
521370,201911,174,122,52,121771.64,51901.44,173673.08
521375,201911,173,94,79,93835.64,78861.13,172696.77
521377,201911,46,35,11,34937.61,10980.55,45918.16
521380,201911,1054,678,376,679795.05,375330.83,1055125.88
521385,201911,15,9,6,8983.17,5989.09,14972.26
521390,201911,99,80,19,80852.33,18964.56,99816.89
521400,201911,333,224,109,223582.53,109793.06,333375.59
521405,201911,140,78,62,77855.16,61886.32,139741.48
521410,201911,65,44,21,43916.02,20960.82,64876.84
521440,201911,197,142,55,142755.16,54909.22,197664.38
521450,201911,732,411,321,412257.51,320431.88,732689.39
521460,201911,1171,744,427,744685.15,426246.69,1170931.84
521470,201911,12,8,4,7986.04,3992.55,11978.59
521480,201911,43,30,13,29948.02,12978.51,42926.53
521483,201911,313,181,132,181664.82,135755.54,317420.36
521486,201911,282,184,98,184652.03,97816.16,282468.19
521487,201911,22,11,11,11979.07,10979.36,22958.43
521490,201911,25,14,11,14971.54,10978.51,25950.05
521500,201911,115,75,40,75870.09,40930.02,116800.11
521520,201911,42,29,13,28946.65,12976.81,41923.46
521523,201911,691,420,271,421216.37,273484.15,694700.52
521525,201911,46,30,16,30938.78,15968.34,46907.12
521530,201911,244,131,113,130764.05,112795.93,243559.98
521540,201911,29,15,14,14971.93,13972.98,28944.91
521550,201911,86,39,47,38934.07,46918.97,85853.04
521560,201911,805,553,252,553014.9,251549.05,804563.95
521565,201911,57,37,20,36927.16,19960.37,56887.53
521570,201911,518,345,173,345384.36,172688.31,518072.67
521580,201911,57,35,22,35937.75,21962.42,57900.17
521590,201911,38,19,19,18962.84,18962.5,37925.34
521600,201911,23,13,10,12974,9980.78,22954.78
521630,201911,247,130,117,129769.32,116800.84,246570.16
521640,201911,298,161,137,161697.02,138744.36,300441.38
521645,201911,29,16,13,15971.33,12976.21,28947.54
521680,201911,228,142,86,142738.84,85840.35,228579.19
521690,201911,2,2,0,1996,0,1996
521710,201911,1156,560,596,562955.94,598907.54,1161863.48
521720,201911,542,374,168,373318.93,168697.56,542016.49
521730,201911,639,312,327,314428.33,327421.51,641849.84
521740,201911,908,380,528,380313.3,527058.66,907371.96
521760,201911,1805,963,842,963292.49,848508.7,1811801.19
521770,201911,829,525,304,527012.21,304434.61,831446.82
521800,201911,2016,1284,732,1283620.34,732647.56,2016267.90
521805,201911,32,18,14,17967.66,13974.33,31941.99
521810,201911,86,54,32,53908.9,31946.52,85855.42
521830,201911,939,669,270,672791.31,271520.8,944312.11
521839,201911,86,54,32,53897.97,32939.24,86837.21
521850,201911,1091,585,506,584993.5,509123.32,1094116.82
521860,201911,350,221,129,221603.98,128772.82,350376.80
521870,201911,72,42,30,41924.17,29945.37,71869.54
521878,201911,35,18,17,17965.27,16967.5,34932.77
521880,201911,4684,2108,2576,2110288.49,2580474.15,4690762.64
521890,201911,589,426,163,426226.29,164697.93,590924.22
521900,201911,292,238,54,237546.63,53898.83,291445.46
521910,201911,156,110,46,109815.01,45924.28,155739.29
521920,201911,52,25,27,24954.69,26956.14,51910.83
521925,201911,44,26,18,25952.44,17966.01,43918.45
521930,201911,1143,638,505,637872.6,504105.75,1141978.35
521935,201911,35,26,9,25958.45,8984.95,34943.40
521940,201911,195,98,97,97825.65,96825.61,194651.26
521945,201911,16,14,2,13974.42,1996.5,15970.92
521950,201911,8,4,4,3993.53,3992,7985.53
521960,201911,71,54,17,53892.52,16967.22,70859.74
521970,201911,403,262,141,261511.29,140733.7,402244.99
521971,201911,89,46,43,45912.47,42918.56,88831.03
521973,201911,33,18,15,17966.75,14971.87,32938.62
521975,201911,1344,682,662,682797.63,661836.26,1344633.89
521980,201911,243,166,77,165695.47,76861.42,242556.89
521990,201911,79,56,23,55901.16,22957.81,78858.97
522000,201911,291,182,109,181328.63,108808.42,290137.05
522005,201911,20,12,8,11977.43,7986.29,19963.72
522010,201911,1141,647,494,648824.29,495108.55,1143932.84
522015,201911,61,39,22,38927.9,21957.33,60885.23
522020,201911,896,513,383,514040.77,387269.03,901309.80
522026,201911,22,13,9,12974.91,8983.04,21957.95
522028,201911,17,13,4,12977.32,3993.38,16970.70
522040,201911,777,319,458,319447.96,460217.08,779665.04
522045,201911,2289,1425,864,1428507.55,866527.2,2295034.75
522050,201911,161,80,81,79860.89,80854.65,160715.54
522060,201911,549,351,198,350354.83,197639.46,547994.29
522068,201911,120,81,39,80844.73,38925.15,119769.88
522070,201911,12,11,1,10979.33,998.87,11978.20
522100,201911,41,23,18,22957.52,17965.46,40922.98
522108,201911,41,31,10,30943.27,10980.99,41924.26
522119,201911,53,28,25,28943.21,24951.13,53894.34
522130,201911,79,34,45,33943.33,44925.88,78869.21
522140,201911,4042,2115,1927,2116171.02,1933514.65,4049685.67
522145,201911,46,34,12,33934.11,11979.61,45913.72
522150,201911,82,60,22,59887.18,21957.96,81845.14
522155,201911,51,33,18,32935.95,17966.12,50902.07
522157,201911,6,3,3,2994.21,2995.16,5989.37
522160,201911,1707,1022,685,1026989.59,687788.52,1714778.11
522170,201911,398,270,128,270507.93,128767.83,399275.76
522180,201911,39,20,19,19966.54,18965.8,38932.34
522185,201911,2024,801,1223,804575.26,1221917.29,2026492.55
522190,201911,43,26,17,25952.37,16967.59,42919.96
522200,201911,294,177,117,177673.68,116784.84,294458.52
522205,201911,146,101,45,100824.09,45920.07,146744.16
522220,201911,156,113,43,112784.5,43914.95,156699.45
522230,201911,35,27,8,27949.22,7986.91,35936.13
530010,201911,54695,27889,26806,28016635.44,26917727.44,54934362.88
110001,201912,506,405,101,404190,100798,504988
110002,201912,2741,1689,1052,1691611.38,1053888.96,2745500.34
110003,201912,88,74,14,73852,13972,87824
110004,201912,1991,1295,696,1300397.16,700596.99,2000994.15
110005,201912,444,354,90,353292.4,89820,443112.4
110006,201912,445,345,100,345308.4,99800,445108.4
110007,201912,66,57,9,56886,9980,66866
110008,201912,237,135,102,136726,101796,238522
110009,201912,853,606,247,604788.42,248503.58,853292.00
110010,201912,1769,1081,688,1085824.98,691615.96,1777440.94
110011,201912,1798,1404,394,1407180.94,395208,1802388.94
110012,201912,4115,2402,1713,2414162.4,1720552.4,4134714.8
110013,201912,766,609,157,608780,157684,766464
110014,201912,378,328,50,328342.4,49900,378242.4
110015,201912,1404,1132,272,1133729.53,274450.4,1408179.93
110018,201912,1100,689,411,689618,411178.96,1100796.96
110020,201912,15519,9001,6518,9015964.83,6531959.62,15547924.45
110025,201912,624,462,162,461076.4,161676.98,622753.38
110026,201912,36,27,9,26946,8982,35928
110028,201912,1654,1199,455,1199598.52,454092.16,1653690.68
110029,201912,139,127,12,127744,11976,139720
110030,201912,2419,1635,784,1638558.28,787423.25,2425981.53
110032,201912,298,229,69,231536.37,68862.99,300399.36
110033,201912,664,492,172,493012.4,174650.98,667663.38
110034,201912,360,268,92,268462.17,91816,360278.17
110037,201912,98,86,12,85828,11976,97804
110040,201912,371,255,116,254490,115768,370258
110045,201912,926,639,287,640717.2,287424.66,928141.86
110050,201912,87,78,9,78842.4,8982,87824.4
110060,201912,74,40,34,40918,33932,74850
110070,201912,112,71,41,70858,41916.4,112774.4
110080,201912,430,246,184,247504,183632,431136
110090,201912,28,23,5,23952,4990,28942
110092,201912,99,53,46,52894,46906,99800
110094,201912,189,139,50,138722,49900,188622
110100,201912,34,26,8,25948,7984,33932
110110,201912,68,37,31,37924,30938,68862
110120,201912,70,59,11,58882,10978,69860
110130,201912,293,243,50,242514.4,49900,292414.4
110140,201912,239,164,75,163672,74850,238522
110143,201912,50,41,9,40918,8982,49900
110145,201912,25,20,5,20958,4990,25948
110146,201912,24,12,12,11976,11976,23952
110147,201912,37,27,10,26946,9980,36926
110148,201912,32,22,10,21956,9980,31936
110149,201912,306,216,90,215568,89820,305388
110150,201912,132,102,30,102794,30938,133732
110155,201912,8,6,2,5988,1996,7984
110160,201912,69,55,14,54890,13972,68862
110170,201912,207,168,39,168662,39920,208582
110175,201912,64,48,16,48902,15968,64870
110180,201912,91,77,14,76846,13972,90818
120001,201912,158,106,52,106786,51897.98,158683.98
120005,201912,197,115,82,114770,81836,196606
120010,201912,1074,675,399,673651.67,398202.98,1071854.65
120013,201912,148,100,48,100798,47904,148702
120017,201912,98,58,40,57884,39920,97804
120020,201912,3539,2851,688,2858274.39,687622,3545896.39
120025,201912,543,309,234,309381.86,235528,544909.86
120030,201912,1065,902,163,904189,162674,1066863
120032,201912,47,42,5,41916,4990,46906
120033,201912,218,193,25,192614,24950,217564
120034,201912,166,123,43,122754,42914,165668
120035,201912,35,28,7,27944,6986,34930
120038,201912,390,251,139,250498,139720,390218
120039,201912,28,27,1,26946,998,27944
120040,201912,13986,9600,4386,9621076.23,4397208.39,14018284.62
120042,201912,43,39,4,38922,3992,42914
120043,201912,11,3,8,2994,7984,10978
120045,201912,554,361,193,360278.98,193612.98,553891.96
120050,201912,1274,978,296,979039.68,296406,1275445.68
120060,201912,1450,1191,259,1192610,259480,1452090
120070,201912,452,323,129,322355.2,128742,451097.2
120080,201912,167,100,67,101796,67864,169660
130002,201912,149,108,41,108782,40918,149700
130006,201912,83,49,34,48902,33932,82834
130008,201912,134,72,62,71856,61876,133732
130010,201912,141,81,60,80838.96,60878,141716.96
130014,201912,265,191,74,192614,73852,266466
130020,201912,93,53,40,52894,39920,92814
130030,201912,920,542,378,543910,378242,922152
130040,201912,343,171,172,170658,171656.36,342314.36
130050,201912,569,295,274,296406,273452,569858
130060,201912,865,587,278,588820,277444,866264
130063,201912,590,335,255,335328,254490,589818
130068,201912,186,122,64,122754,63872,186626
130070,201912,1298,889,409,892212.98,409180,1301392.98
130080,201912,715,470,245,469060,244510,713570
130083,201912,68,37,31,36926,30938,67864
130090,201912,343,174,169,173652,170658,344310
130100,201912,1119,482,637,482034,635726,1117760
130110,201912,735,308,427,307384,427144,734528
130115,201912,162,67,95,66866,95808,162674
130120,201912,1635,1053,582,1055884,581834,1637718
130130,201912,607,414,193,413172,192614,605786
130140,201912,1508,1163,345,1165664,344310,1509974
130150,201912,412,361,51,361276,51896,413172
130160,201912,452,261,191,260478,190618,451096
130165,201912,27,21,6,20958,5988,26946
130170,201912,950,667,283,669595.08,284430,954025.08
130180,201912,179,121,58,121756,58882,180638
130185,201912,2358,1123,1235,1125744,1232531.76,2358275.76
130190,201912,3486,2183,1303,2184622.68,1301392.96,3486015.64
130195,201912,276,221,55,220558,54890,275448
130200,201912,182,85,97,84830,96806,181636
130210,201912,78,39,39,38922,38922,77844
130220,201912,180,122,58,121756,58882,180638
130230,201912,371,239,132,238522,132734,371256
130240,201912,1358,853,505,853290.99,503990,1357280.99
130250,201912,4728,3034,1694,3031926.32,1693606.96,4725533.28
130255,201912,425,205,220,204590,219560,424150
130260,201912,56615,27125,29490,27196426.58,29548803.95,56745230.53
130270,201912,1536,1033,503,1035015.82,505986,1541001.82
130280,201912,128,72,56,71856,55888,127744
130290,201912,2098,1491,607,1491012,606784,2097796
130300,201912,444,312,132,311376,131736,443112
130310,201912,920,481,439,481036,439120,920156
130320,201912,507,276,231,275448,230538,505986
130330,201912,748,468,280,467064,280438,747502
130340,201912,3491,2029,1462,2028934.8,1462070.8,3491005.6
130350,201912,442,289,153,289420,152694,442114
130353,201912,907,379,528,380238,526944,907182
130356,201912,828,383,445,382234,445108,827342
130360,201912,93,68,25,68862,24950,93812
130370,201912,712,551,161,550896,162674,713570
130380,201912,670,511,159,515966,160678,676644
130390,201912,497,401,96,400198,95808,496006
130395,201912,165,39,126,39920,125748,165668
130400,201912,64,45,19,44910,18962,63872
130406,201912,2099,1277,822,1275444.4,821354,2096798.4
130410,201912,438,201,237,201596,237524,439120
130420,201912,3018,2451,567,2454082.9,569858,3023940.9
130423,201912,156,79,77,78842,77844,156686
130426,201912,147,80,67,79840,66866,146706
130430,201912,403,258,145,258482,146706,405188
130440,201912,200,67,133,67864,132734,200598
140002,201912,32,10,22,9980,21956,31936
140005,201912,196,118,78,117764,77844,195608
140010,201912,10346,6736,3610,6760461.92,3631725.78,10392187.70
140015,201912,127,56,71,55888,71856,127744
140017,201912,117,79,38,79840,37924,117764
140020,201912,477,313,164,313372,164670.98,478042.98
140023,201912,46,24,22,23952.54,21956,45908.54
140028,201912,19,11,8,10978,7984,18962
140030,201912,339,242,97,243512,97804,341316
140040,201912,57,40,17,41916,16966,58882
140045,201912,238,100,138,99800,138722,238522
140047,201912,610,409,201,410178.4,202594,612772.4
140050,201912,148,92,56,91816,55888,147704
140060,201912,43,30,13,29940,12974,42914
140070,201912,33,30,3,29940,2994,32934
150010,201912,4612,2840,1772,2849290.4,1776440.4,4625730.8
150013,201912,162,113,49,112774.98,48902,161676.98
150020,201912,1062,571,491,572852,491016,1063868
150030,201912,674,280,394,279440,395208,674648
150034,201912,195,126,69,126746,68862,195608
150040,201912,1434,837,597,837322,595806,1433128
150050,201912,625,366,259,366266,258482,624748
150060,201912,4770,3068,1702,3076751.68,1712981.17,4789732.85
150070,201912,322,141,181,140718,180638,321356
150080,201912,14608,7121,7487,7143691.25,7511959.24,14655650.49
150085,201912,412,263,149,267464,151696,419160
150090,201912,749,631,118,632732,118762,751494
150095,201912,354,222,132,221556,131736,353292
150100,201912,59,39,20,39920,19960,59880
150110,201912,173,87,86,87824,86826,174650
150120,201912,402,300,102,301396,101796.96,403192.96
150125,201912,53,21,32,20958,31936,52894
150130,201912,1972,1049,923,1050894.96,931134,1982028.96
150140,201912,54320,24909,29411,24974965.98,29500903.02,54475869.00
150145,201912,190,104,86,104790,85828,190618
150150,201912,2909,1328,1581,1328338,1588816.8,2917154.8
150157,201912,395,281,114,280438.8,113772,394210.8
150160,201912,129,99,30,99800,29940,129740
150170,201912,3578,2686,892,2692604,897202,3589806
150172,201912,330,225,105,224550,104790,329340
150175,201912,80,50,30,49900,29940,79840
150178,201912,781,523,258,521954.4,257486.88,779441.28
150180,201912,3123,1522,1601,1526940.5,1599794.4,3126734.9
150190,201912,342,216,126,216566,126746,343312
150195,201912,107,53,54,54890,54890,109780
150200,201912,194,91,103,90818,102794,193612
150210,201912,3091,2486,605,2495998,610777.95,3106775.95
150215,201912,559,365,194,365268,195608.4,560876.4
150220,201912,3645,2465,1180,2474043.52,1182631.4,3656674.92
150230,201912,1169,943,226,942112.45,226546,1168658.45
150240,201912,6190,3588,2602,3585817.45,2603782.98,6189600.43
150250,201912,36,15,21,14970,20958,35928
150260,201912,84,53,31,52894,30938,83832
150270,201912,2273,1476,797,1479036,798400.4,2277436.4
150275,201912,525,332,193,331336,192614,523950
150276,201912,102,43,59,43912,58882,102794
150277,201912,752,330,422,329340.98,422154,751494.98
150280,201912,325,207,118,206586,118762,325348
150285,201912,94,47,47,46906,46906,93812
150290,201912,977,592,385,591814,384230.4,976044.4
150293,201912,626,309,317,309380,319360,628740
150295,201912,478,223,255,222554,255488.4,478042.4
150300,201912,79,39,40,38922,39920,78842
150304,201912,168,108,60,108782,59880,168662
150307,201912,395,328,67,329340,67864,397204
150309,201912,573,412,161,411176.98,160681.2,571858.18
150310,201912,234,156,78,155688,77844,233532
150320,201912,1930,1345,585,1347300,587822,1935122
150330,201912,1999,1165,834,1171652,839318,2010970
150340,201912,196,131,65,131736,64870,196606
150345,201912,620,343,277,343312,279440,622752
150350,201912,403,313,90,312374,89820,402194
150360,201912,4614,2900,1714,2904182.45,1716560,4620742.45
150370,201912,817,565,252,564871.86,252496.9,817368.76
150375,201912,186,92,94,92814,94810,187624
150380,201912,1447,980,467,982032,468063.92,1450095.92
150390,201912,798,458,340,458082.99,340318,798400.99
150400,201912,106,87,19,86826,18962,105788
150405,201912,1221,787,434,790416,434130,1224546
150410,201912,123,80,43,79840,42914,122754
150420,201912,7311,4029,3282,4040083.58,3288453.4,7328536.98
150430,201912,572,376,196,376246,196606,572852
150440,201912,546,335,211,335328,212574,547902
150442,201912,2286,1217,1069,1215564.8,1070854,2286418.8
150445,201912,533,340,193,341316,192614,533930
150450,201912,231,121,110,120758,110778,231536
150460,201912,726,543,183,543910.96,185628,729538.96
150470,201912,1303,790,513,792412,512972,1305384
150475,201912,228,175,53,175648,52894,228542
150480,201912,1296,904,392,906184,392214,1298398
150490,201912,590,327,263,327344,262474,589818
150495,201912,330,240,90,239520,89820,329340
150497,201912,293,199,94,198602,95808,294410
150500,201912,213,136,77,135728,76846,212574
150503,201912,997,497,500,499000.4,500996.98,999997.38
150506,201912,947,629,318,628740.96,321356.96,950097.92
150510,201912,1265,701,564,701594.4,565866,1267460.4
150520,201912,264,176,88,176646,87824,264470
150530,201912,1687,927,760,925146.5,759478,1684624.5
150540,201912,233,168,65,167664,65868,233532
150543,201912,786,420,366,420158,365268,785426
150548,201912,465,327,138,329340,137724,467064
150549,201912,59,43,16,42914,15968,58882
150550,201912,2889,1491,1398,1491012.9,1397200.4,2888213.3
150553,201912,3332,1957,1375,1964066.16,1375244,3339310.16
150555,201912,144,75,69,74850,68862,143712
150560,201912,26,13,13,12974,12974,25948
150563,201912,93,47,46,46906,45908,92814
150565,201912,177,107,70,107784,69860,177644
150570,201912,400,264,136,263472,135728,399200
150580,201912,1592,736,856,739518,857282,1596800
150590,201912,803,526,277,524948,277444,802392
150600,201912,454,279,175,280438,177644,458082
150610,201912,139,120,19,119760,18962,138722
150611,201912,118,80,38,79840,37924,117764
150613,201912,3189,1938,1251,1941110,1254487.38,3195597.38
150616,201912,509,302,207,302394,207584,509978
150618,201912,1296,706,590,706584.98,595806,1302390.98
150619,201912,388,297,91,297404,90818,388222
150620,201912,1236,729,507,732532.96,510976,1243508.96
150630,201912,295,192,103,191616,103792,295408
150635,201912,468,197,271,196606,270458,467064
150640,201912,54,28,26,27944,25948,53892
150650,201912,2341,1365,976,1370371.33,976045.39,2346416.72
150655,201912,246,185,61,185628,61876,247504
150658,201912,94,52,42,51896,41916,93812
150660,201912,516,346,170,346306,169660,515966
150670,201912,1031,371,660,370258.98,659678.98,1029937.96
150680,201912,9948,5319,4629,5326331.68,4632718.56,9959050.24
150690,201912,15,9,6,8982,5988,14970
150700,201912,479,317,162,316366,161676,478042
150710,201912,281,157,124,157684,123752,281436
150715,201912,815,504,311,505986.98,310378,816364.98
150720,201912,404,313,91,312374,90818,403192
150730,201912,983,518,465,516964,465068,982032
150740,201912,225,155,70,155688,69860,225548
150745,201912,797,442,355,442114,354290,796404
150746,201912,58,35,23,34930,23952,58882
150747,201912,236,183,53,182634,52894,235528
150750,201912,137,78,59,77844,59880,137724
150760,201912,1797,1171,626,1174646.35,628740,1803386.35
150770,201912,385,210,175,210578,175648,386226
150775,201912,95,45,50,44910,49900,94810
150780,201912,188,109,79,108782,78842,187624
150790,201912,836,457,379,459080,379240,838320
150795,201912,1501,896,605,894208,603790,1497998
150796,201912,357,208,149,208582,149700,358282
150797,201912,309,159,150,160678,149700,310378
150800,201912,1456,850,606,850296,605786,1456082
150803,201912,549,451,98,455088,97804,552892
150805,201912,194,119,75,118762,74850.99,193612.99
150808,201912,991,539,452,541914,452094,994008
150810,201912,3274,2268,1006,2270451.47,1006987.2,3277438.67
150812,201912,438,229,209,230538,209580,440118
150815,201912,1000,635,365,635726,364270,999996
150820,201912,1536,922,614,925146,613770,1538916
150830,201912,744,542,202,542912,202594,745506
150835,201912,197,115,82,116766,81836,198602
150840,201912,1373,859,514,863270.2,516964,1380234.2
160005,201912,52,32,20,31936,19960,51896
160010,201912,189,121,68,120758,67864,188622
160015,201912,116,70,46,69860,45908,115768
160020,201912,126,73,53,72854,56886,129740
160021,201912,53,26,27,25948,26946,52894
160023,201912,64,42,22,41916,21956,63872
160025,201912,25,10,15,9980,14970,24950
160027,201912,1513,862,651,863270.5,651694,1514964.5
160030,201912,15709,8143,7566,8150677.12,7591794.85,15742471.97
160040,201912,290,168,122,167664,121756.6,289420.6
160050,201912,724,362,362,365268,362274,727542
160053,201912,290,168,122,167664.4,121756,289420.4
160055,201912,29,19,10,19960,9980,29940
160060,201912,6566,3459,3107,3459069.89,3107774.35,6566844.24
160070,201912,174,104,70,104790,69860,174650
160080,201912,99,48,51,47904,51896,99800
170025,201912,26,15,11,14970,10978.96,25948.96
170030,201912,220,179,41,179640.88,40918,220558.88
170035,201912,230,109,121,108782,120758,229540
170040,201912,180,138,42,137724.51,41916,179640.51
170070,201912,314,192,122,193612,121756,315368
170100,201912,358,261,97,260478,96806,357284
170105,201912,58,47,11,46906,10978,57884
170110,201912,110,71,39,72854,38922,111776
170130,201912,68,33,35,32934,34930.4,67864.4
170190,201912,93,60,33,60878,34930,95808
170200,201912,377,262,115,262474.98,115768,378242.98
170210,201912,6038,3237,2801,3242503.7,2805381.57,6047885.27
170215,201912,116,47,69,46906,68862,115768
170220,201912,1407,1037,370,1035924,369260,1405184
170230,201912,151,100,51,99800,50898,150698
170240,201912,528,354,174,353292.8,173652,526944.8
170255,201912,1093,886,207,886224,207584,1093808
170270,201912,44,31,13,30938,12974,43912
170290,201912,108,75,33,75848,32934,108782
170300,201912,87,59,28,58882,27944,86826
170305,201912,50,39,11,38922,10978,49900
170307,201912,62,48,14,47904,13972,61876
170310,201912,109,59,50,58882,49900,108782
170320,201912,26,18,8,17964,7984,25948
170330,201912,23,21,2,20958,1996,22954
170360,201912,28,17,11,16966,10978,27944
170370,201912,124,63,61,62874,61876,124750
170380,201912,77,60,17,59880,16966,76846
170382,201912,43,37,6,36926,5988,42914
170384,201912,144,109,35,108782,34930,143712
170386,201912,64,26,38,25948,37924,63872
170388,201912,48,19,29,18962,28942,47904
170389,201912,25,20,5,19960,4990,24950
170390,201912,66,39,27,38922.98,26946.98,65869.96
170410,201912,32,24,8,23952,7984,31936
170460,201912,16,11,5,10978,4990,15968
170510,201912,34,28,6,27944,5988,33932
170550,201912,1554,908,646,908180,644708.96,1552888.96
170555,201912,115,81,34,80838,33932,114770
170560,201912,98,68,30,68862,29940,98802
170600,201912,35,17,18,16966,17964,34930
170610,201912,195,106,89,105788,89821.38,195609.38
170625,201912,36,21,15,20958,14970,35928
170650,201912,79,58,21,57884,20958,78842
170700,201912,575,440,135,443112.5,134730,577842.5
170710,201912,160,100,60,99800,59880.98,159680.98
170720,201912,88,71,17,70858,16966,87824
170730,201912,82,47,35,46906,34930,81836
170740,201912,83,62,21,61876,20958,82834
170755,201912,65,35,30,34930,29940,64870
170765,201912,138,74,64,73852.8,63872,137724.8
170770,201912,209,129,80,129740,79840,209580
170820,201912,592,396,196,396206,195608.4,591814.4
170825,201912,35,17,18,16966,17964,34930
170830,201912,81,67,14,66866,14970,81836
170900,201912,184,143,41,142714,40918,183632
170930,201912,892,477,415,476047.12,416166.4,892213.52
170950,201912,3120,1435,1685,1437120.98,1689615.07,3126736.05
170980,201912,18,10,8,9980,7984,17964
171050,201912,144,115,29,114770,28942,143712
171070,201912,38,32,6,31936,5988,37924
171090,201912,41,30,11,30938,10978,41916
171110,201912,22,15,7,14970,6986,21956
171150,201912,40,19,21,18962,20958,39920
171180,201912,24,13,11,12974,10978,23952
171190,201912,147,83,64,83832,63872,147704
171195,201912,64,54,10,53892,9980,63872
171200,201912,50,26,24,25948,23952,49900
171215,201912,4,3,1,2994,998,3992
171240,201912,59,42,17,41916,16966,58882
171245,201912,55,48,7,47904,6986,54890
171250,201912,75,40,35,39920,34930,74850
171270,201912,14,10,4,9980,3992,13972
171280,201912,42,37,5,36926,4990,41916
171320,201912,982,578,404,578840.79,404190,983030.79
171330,201912,431,212,219,211576,219560,431136
171360,201912,83,61,22,60878,21956,82834
171370,201912,32,16,16,15968,15968,31936
171380,201912,131,109,22,108782,21956,130738
171395,201912,52,32,20,32934,19960,52894
171420,201912,283,185,98,184630,99800,284430
171430,201912,75,61,14,60878,13972,74850
171488,201912,177,99,78,98802,77844,176646
171500,201912,54,31,23,30938,22954,53892
171510,201912,72,46,26,45908,25948,71856
171515,201912,41,34,7,33932,6986.4,40918.4
171525,201912,30,28,2,27944,1996,29940
171550,201912,14,10,4,9980,3992,13972
171570,201912,51,27,24,26946,24950,51896
171575,201912,313,205,108,205588,107784,313372
171610,201912,1758,897,861,898205.88,860287.74,1758493.62
171620,201912,137,95,42,95808,41916,137724
171630,201912,59,31,28,30938,27944,58882
171650,201912,273,184,89,184630,88822.96,273452.96
171660,201912,271,151,120,151696,119760.4,271456.4
171665,201912,58,40,18,39920,17964,57884
171670,201912,419,248,171,248502.5,170658,419160.5
171700,201912,65,59,6,58882,6986,65868
171720,201912,28,10,18,9980,17964,27944
171750,201912,103,54,49,53892,48902,102794
171780,201912,72,57,15,57884,14970,72854
171790,201912,75,66,9,67864,8982,76846
171800,201912,33,25,8,25948,7984,33932
171820,201912,2083,1207,876,1205584.44,876245.78,2081830.22
171830,201912,35,28,7,27944,6986,34930
171840,201912,63,41,22,40918,21956,62874
171845,201912,30,18,12,17964,11976,29940
171850,201912,40,29,11,28942,11976,40918
171855,201912,77,61,16,60878,15968,76846
171865,201912,7,6,1,5988,998,6986
171870,201912,33,24,9,23952,8982,32934
171875,201912,76,53,23,53892,22954,76846
171880,201912,31,20,11,19960,10978,30938
171884,201912,51,27,24,26946,23952,50898
171886,201912,130,53,77,52894,76846,129740
171888,201912,31,23,8,22954,7984,30938
171889,201912,20,14,6,13972,5988,19960
171890,201912,56,46,10,45908,9980,55888
171900,201912,40,27,13,26946,12974,39920
172000,201912,42,34,8,33932,7984,41916
172010,201912,49,39,10,38922,9980,48902
172015,201912,29,20,9,19960.58,8982,28942.58
172020,201912,136,87,49,86826,48902,135728
172025,201912,35,21,14,20958,13972,34930
172030,201912,42,25,17,24950,16966.98,41916.98
172049,201912,81,52,29,51896,28942,80838
172065,201912,143,89,54,89820,53892,143712
172080,201912,106,69,37,69860,36926,106786
172085,201912,28,15,13,14970,12974,27944
172090,201912,414,323,91,326346.18,90818,417164.18
172093,201912,17,15,2,14970,1996,16966
172097,201912,19,12,7,11976,6986.4,18962.4
172100,201912,4990,2851,2139,2852285.88,2145701.96,4997987.84
172110,201912,78,49,29,49900,28942,78842
172120,201912,1665,1414,251,1417162.9,251496,1668658.9
172125,201912,5,4,1,3992,998,4990
172130,201912,16,12,4,11976,3992,15968
172208,201912,193,123,70,122754,70858,193612
172210,201912,385,189,196,188622,195608.4,384230.4
210005,201912,2952,1857,1095,1858276.75,1099800.8,2958077.55
210010,201912,167,92,75,91816,75848,167664
210015,201912,39,29,10,28942,9980,38922
210020,201912,343,194,149,193612,148702,342314
210030,201912,326,213,113,213572,114770.98,328342.98
210040,201912,141,111,30,110778,29940,140718
210043,201912,251,187,64,186626,63872,250498
210047,201912,529,307,222,307384,226546,533930
210050,201912,290,214,76,213572,75848,289420
210055,201912,45,34,11,33932,10978,44910
210060,201912,551,438,113,441116,112774,553890
210070,201912,404,309,95,309380,95808,405188
210080,201912,116,106,10,105788,9980,115768
210083,201912,306,151,155,150698,154690,305388
210087,201912,2,1,1,998,998,1996
210090,201912,448,322,126,321356,125748,447104
210095,201912,449,342,107,342314,107784,450098
210100,201912,692,538,154,538920,153692,692612
210110,201912,130,80,50,79840,49900,129740
210120,201912,5097,3963,1134,3979035.02,1141713.53,5120748.55
210125,201912,200,120,80,119760,81836,201596
210130,201912,487,277,210,276446,209580,486026
210135,201912,28,19,9,18962,9980,28942
210140,201912,4358,3423,935,3431124.6,934128,4365252.6
210150,201912,382,246,136,245508,135728,381236
210160,201912,3276,2775,501,2786417.53,502992,3289409.53
210170,201912,1156,929,227,929138,228542,1157680
210173,201912,126,110,16,109780,15968,125748
210177,201912,379,209,170,210578,170658,381236
210180,201912,32,17,15,16966,14970,31936
210190,201912,419,280,139,279440,139720,419160
210193,201912,3,2,1,1996,998,2994
210197,201912,81,56,25,55888,24950,80838
210200,201912,630,516,114,516964,114770,631734
210203,201912,237,159,78,158682,77844,236526
210207,201912,372,301,71,301396,70858,372254
210210,201912,755,697,58,700596,57884,758480
210215,201912,72,65,7,64870,6986,71856
210220,201912,393,332,61,332334,61876,394210
210230,201912,303,240,63,240518,62874,303392
210232,201912,1380,932,448,931134,453092,1384226
210235,201912,168,126,42,127744,41916,169660
210237,201912,38,23,15,22954,14970,37924
210240,201912,89,75,14,74850,13972,88822
210250,201912,183,155,28,154690,27944,182634
210255,201912,354,268,86,268462,85828,354290
210260,201912,399,275,124,274450,123752,398202
210270,201912,649,429,220,430138,220558,650696
210275,201912,66,51,15,50898,14970,65868
210280,201912,1046,688,358,688620.48,359280,1047900.48
210290,201912,540,361,179,360278,178642,538920
210300,201912,5371,3375,1996,3386214.39,2017956.97,5404171.36
210310,201912,106,76,30,75848,29940,105788
210312,201912,115,80,35,79840,34930,114770
210315,201912,103,82,21,81836,20958,102794
210317,201912,125,94,31,93812,30938,124750
210320,201912,2326,1969,357,1968056,358282,2326338
210325,201912,130,90,40,89820.4,39920.4,129740.8
210330,201912,4593,2615,1978,2631726.7,2010970,4642696.7
210340,201912,1280,944,336,949098,337326.34,1286424.34
210350,201912,611,513,98,514968,97804,612772
210355,201912,148,119,29,118762,28942,147704
210360,201912,2306,1570,736,1570852.06,746504.4,2317356.46
210370,201912,1215,579,636,579838,635726,1215564
210375,201912,187,97,90,96806,89820,186626
210380,201912,703,539,164,540916,164670,705586
210390,201912,192,163,29,162674,29940,192614
210400,201912,397,344,53,344310,52894,397204
210405,201912,983,689,294,693610,296406,990016
210407,201912,52,42,10,41916,9980,51896
210408,201912,62,55,7,54890,6986,61876
210409,201912,323,281,42,283432,41916,325348
210410,201912,432,339,93,339320,93812,433132
210420,201912,193,158,35,160678,35928,196606
210430,201912,48,31,17,30938,16966,47904
210440,201912,338,224,114,223552,114770,338322
210450,201912,149,116,33,115768,32934,148702
210455,201912,228,124,104,124750.4,103792,228542.4
210460,201912,313,205,108,204590,107784,312374
210462,201912,65,54,11,53892,10978,64870
210465,201912,148,109,39,108782,39920,148702
210467,201912,525,388,137,388222,137724.98,525946.98
210470,201912,50,43,7,42914,6986,49900
210480,201912,1273,911,362,916164,363272.75,1279436.75
210490,201912,205,135,70,135728,69860,205588
210500,201912,515,305,210,306386,214570,520956
210510,201912,560,445,115,445108,117764,562872
210515,201912,384,234,150,233532,152694,386226
210520,201912,404,361,43,361276,42914,404190
210530,201912,9377,5004,4373,5010964.46,4377231.62,9388196.08
210535,201912,129,95,34,94810,33932,128742
210540,201912,1480,960,520,958080.2,518960,1477040.2
210542,201912,1196,615,581,614768,581834.8,1196602.8
210545,201912,17,16,1,15968,998,16966
210547,201912,131,115,16,114770,15968,130738
210550,201912,694,500,194,500996.44,194610,695606.44
210560,201912,162,142,20,142714,20958,163672
210565,201912,22,17,5,16966,4990,21956
210570,201912,1300,1048,252,1050894.04,253492,1304386.04
210580,201912,119,102,17,101796,16966,118762
210590,201912,740,604,136,605786,136726,742512
210592,201912,32,29,3,28942,2994,31936
210594,201912,105,89,16,89820,15968,105788
210596,201912,97,82,15,81836,14970,96806
210598,201912,129,95,34,94810,33932,128742
210600,201912,328,281,47,280438,46906,327344
210610,201912,256,240,16,239520,15968,255488
210620,201912,43,27,16,26946,15968,42914
210630,201912,72,69,3,68862,2994,71856
210632,201912,1017,704,313,704588,315368,1019956
210635,201912,22,19,3,18962,2994,21956
210637,201912,107,78,29,77844,29940,107784
210640,201912,581,511,70,510976,70858,581834
210650,201912,392,327,65,328342,67864,396206
210660,201912,391,297,94,297404,94810,392214
210663,201912,30,21,9,20958,8982,29940
210667,201912,101,35,66,34930,65868,100798
210670,201912,249,221,28,223552,27944,251496
210675,201912,539,301,238,303392,237524,540916
210680,201912,215,143,72,142714,72854,215568
210690,201912,620,511,109,509978,108782,618760
210700,201912,167,125,42,124750,42914,167664
210710,201912,260,161,99,160678,102794,263472
210720,201912,134,118,16,117764,15968,133732
210725,201912,68,59,9,58882,8982,67864
210730,201912,25,18,7,17964,6986,24950
210735,201912,294,205,89,204590,89820.4,294410.4
210740,201912,540,462,78,462074,77844,539918
210745,201912,152,114,38,113772,37924,151696
210750,201912,2351,1181,1170,1184626.5,1178638.4,2363264.9
210760,201912,252,192,60,191616,59880,251496
210770,201912,387,303,84,304390,84830,389220
210780,201912,440,325,115,325348,115768,441116
210790,201912,184,150,34,149700,33932,183632
210800,201912,168,127,41,127744,40918,168662
210805,201912,50,46,4,45908,3992,49900
210810,201912,466,371,95,370258,94810,465068
210820,201912,2140,1779,361,1782429.76,361276,2143705.76
210825,201912,153,86,67,87824,67864,155688
210830,201912,720,475,245,474050,252494,726544
210840,201912,201,139,62,138722,62874,201596
210845,201912,244,167,77,166666,78842,245508
210850,201912,771,521,250,523950,252494,776444
210860,201912,3762,2104,1658,2109772.5,1675642,3785414.5
210870,201912,445,348,97,347304,96806,444110
210880,201912,72,56,16,55888,15968,71856
210890,201912,313,269,44,269460,44910,314370
210900,201912,623,406,217,406186,216566,622752
210905,201912,63,31,32,30938,31936,62874
210910,201912,1968,1480,488,1478039.48,488022,1966061.48
210920,201912,176,62,114,61876,113772,175648
210923,201912,80,60,20,59880,20958,80838
210927,201912,401,186,215,186626,218562,405188
210930,201912,70,57,13,56886,13972,70858
210940,201912,84,66,18,66866,17964,84830
210945,201912,194,99,95,99800,95808,195608
210950,201912,525,387,138,386226,137724,523950
210955,201912,77,51,26,50898,25948,76846
210960,201912,2175,1071,1104,1069856,1114766,2184622
210970,201912,111,98,13,98802,12974,111776
210975,201912,81,75,6,74850,5988,80838
210980,201912,1084,520,564,521954,570856.4,1092810.4
210990,201912,4083,2665,1418,2664660.93,1431132,4095792.93
211000,201912,1328,1068,260,1066862.4,260478,1327340.4
211003,201912,1006,707,299,707582,301396,1008978
211010,201912,489,436,53,436126,52894,489020
211020,201912,1453,596,857,596804,860276,1457080
211023,201912,29,26,3,25948,3992,29940
211027,201912,73,53,20,53892,20958,74850
211030,201912,372,260,112,261476,112774,374250
211040,201912,300,250,50,249500.4,49900,299400.4
211050,201912,1146,758,388,759478,390218.4,1149696.4
211060,201912,645,555,90,555886.4,92814.6,648701.0
211065,201912,23,18,5,17964,4990,22954
211070,201912,897,741,156,741514.66,156686,898200.66
211080,201912,86,82,4,81836,3992,85828
211085,201912,55,28,27,27944,26946,54890
211090,201912,91,73,18,72854,17964,90818
211100,201912,481,397,84,397204,85828.4,483032.4
211102,201912,246,172,74,171656,75848,247504
211105,201912,225,158,67,157684,66866,224550
211107,201912,132,82,50,81836,49900,131736
211110,201912,820,531,289,531934,288422.98,820356.98
211120,201912,5343,2636,2707,2645700.2,2729530.76,5375230.96
211125,201912,33,25,8,24950,7984,32934
211130,201912,42076,19108,22968,19165601.24,23187540.33,42353141.57
211140,201912,405,349,56,350298.99,55888,406186.99
211150,201912,1238,810,428,811374,429141.39,1240515.39
211153,201912,170,101,69,100798,69860,170658
211157,201912,64,51,13,50898,12974,63872
211160,201912,694,592,102,591814,102794,694608
211163,201912,0,0,0,0,0,0
211167,201912,10,9,1,8982,998,9980
211170,201912,424,315,109,315368,111776,427144
211172,201912,118,82,36,81836,35928,117764
211174,201912,252,153,99,152694,99800,252494
211176,201912,492,365,127,365268.4,126746,492014.4
211178,201912,89,60,29,59880,28942,88822
211180,201912,210,168,42,167664,41916,209580
211190,201912,68,63,5,62874,4990,67864
211195,201912,35,24,11,23952,10978,34930
211200,201912,148,127,21,126746,20958,147704
211210,201912,445,324,121,323352,121756,445108
211220,201912,4015,2342,1673,2345302.53,1680634.59,4025937.12
211223,201912,94,91,3,90818,2994,93812
211227,201912,72,56,16,55888,15968,71856
211230,201912,752,623,129,622752,129740,752492
211240,201912,396,307,89,307384,89820,397204
211245,201912,189,90,99,89820,98802,188622
211250,201912,1570,1354,216,1356283.59,216566,1572849.59
211260,201912,807,661,146,661674,147704,809378
211270,201912,1959,1606,353,1605782.4,356286.4,1962068.8
211280,201912,1733,1108,625,1110774,634728,1745502
211285,201912,196,121,75,120758,74850,195608
211290,201912,674,468,206,470058,206586,676644
211300,201912,772,610,162,609778,162674,772452
211400,201912,1546,941,605,942112,608780,1550892
220005,201912,16,15,1,15968,998,16966
220010,201912,86,67,19,66866,18962,85828
220020,201912,681,542,139,541914,138722,680636
220025,201912,113,110,3,109780,2994,112774
220027,201912,42,34,8,33932,7984,41916
220030,201912,109,91,18,90818,18962,109780
220040,201912,1217,927,290,926144.6,292414,1218558.6
220045,201912,33,23,10,22954,9980,32934
220050,201912,678,572,106,571855.08,105788,677643.08
220060,201912,169,150,19,150698,18962,169660
220070,201912,113,103,10,102794,9980,112774
220080,201912,16,14,2,13972,1996,15968
220090,201912,32,27,5,26946,4990,31936
220095,201912,2,1,1,998,998,1996
220100,201912,22,16,6,15968,5988,21956
220105,201912,23,22,1,21956.4,998,22954.4
220110,201912,218,200,18,199600,17964,217564
220115,201912,36,35,1,34930,998,35928
220117,201912,23,21,2,20958,1996,22954
220120,201912,1478,1116,362,1113768,369260,1483028
220130,201912,30,30,0,29940,0,29940
220140,201912,101,78,23,79840,22954,102794
220150,201912,487,353,134,354290,133732,488022
220155,201912,6,6,0,5988,0,5988
220157,201912,18,15,3,14970,2994,17964
220160,201912,87,75,12,74850,11976,86826
220170,201912,31,31,0,30938,0,30938
220173,201912,7,7,0,6986,0,6986
220177,201912,7,7,0,6986,0,6986
220180,201912,69,69,0,68862,0,68862
220190,201912,1051,942,109,944108,109780,1053888
220191,201912,43,38,5,37924,4990,42914
220192,201912,78,75,3,74850,2994,77844
220194,201912,49,47,2,46906,1996,48902
220196,201912,94,78,16,77844,15968,93812
220198,201912,3,2,1,1996,998,2994
220200,201912,417,346,71,345308.5,70858,416166.5
220202,201912,38,34,4,33932,3992,37924
220205,201912,47,43,4,42914,3992,46906
220207,201912,11,11,0,10978,0,10978
220208,201912,77,41,36,40918,36926,77844
220209,201912,29,26,3,25948,2994,28942
220210,201912,19,16,3,15968,2994,18962
220211,201912,28,26,2,25948,1996,27944
220213,201912,40,36,4,36926,3992.4,40918.4
220217,201912,40,32,8,31936,7984,39920
220220,201912,2154,1403,751,1402190,751495.1,2153685.1
220225,201912,9,4,5,3992,4990,8982
220230,201912,965,760,205,763470,205588,969058
220240,201912,160,145,15,144710,14970,159680
220245,201912,33,30,3,29940.99,2994,32934.99
220250,201912,121,109,12,108782,11976,120758
220253,201912,40,34,6,33932,5988,39920
220255,201912,28,26,2,25948,1996,27944
220260,201912,691,514,177,514968,177644,692612
220265,201912,10,8,2,7984,1996,9980
220270,201912,739,664,75,665666,74850,740516
220271,201912,38,31,7,31936,6986,38922
220272,201912,23,23,0,22954,0,22954
220273,201912,16,14,2,13972,1996,15968
220275,201912,57,46,11,45908,10978,56886
220277,201912,14,12,2,11976,1996,13972
220280,201912,15,12,3,11976,2994,14970
220285,201912,44,42,2,41916,1996,43912
220290,201912,1453,1246,207,1252490.4,207584.9,1460075.3
220300,201912,40,39,1,38922,998,39920
220310,201912,312,268,44,267464.99,43912,311376.99
220320,201912,443,410,33,411176.4,32934,444110.4
220323,201912,0,0,0,0,0,0
220325,201912,13,11,2,10978,1996,12974
220327,201912,12,11,1,10978,998,11976
220330,201912,223,161,62,161676,61876,223552
220335,201912,137,119,18,118762,17964,136726
220340,201912,37,23,14,22954,13972,36926
220342,201912,57,50,7,49900,6986,56886
220345,201912,81,75,6,74850,5988,80838
220350,201912,436,381,55,380238,55888,436126
220360,201912,44,31,13,30938,12974,43912
220370,201912,1209,998,211,998998,210578,1209576
220375,201912,20,18,2,17964,1996,19960
220380,201912,19,16,3,15968,2994,18962
220385,201912,15,13,2,12974,1996,14970
220390,201912,2296,1310,986,1308378.84,991014.7,2299393.54
220400,201912,33,29,4,28942,3992,32934
220410,201912,20,17,3,16966,2994,19960
220415,201912,12,11,1,10978,998,11976
220420,201912,125,104,21,103792,20958,124750
220430,201912,130,119,11,119760,10978,130738
220435,201912,21,15,6,14970,5988,20958
220440,201912,289,245,44,244510,43912,288422
220450,201912,330,169,161,168662,160678,329340
220455,201912,52,51,1,50898,998,51896
220460,201912,20,19,1,18962,998,19960
220465,201912,94,64,30,63872,29940,93812
220470,201912,236,207,29,207584,28942,236526
220480,201912,72,64,8,64870,7984,72854
220490,201912,89,76,13,75848,12974,88822
220500,201912,101,88,13,87824,12974,100798
220510,201912,428,332,96,334330,95808,430138
220515,201912,22,20,2,19960,1996,21956
220520,201912,378,341,37,341316.34,36926,378242.34
220525,201912,10,7,3,6986,2994,9980
220527,201912,23,16,7,15968,6986,22954
220530,201912,30,12,18,11976,18962,30938
220535,201912,3,3,0,2994,0,2994
220540,201912,64,54,10,53892,10978,64870
220545,201912,43,29,14,28942,13972,42914
220550,201912,679,535,144,533930.96,143712,677642.96
220551,201912,13,10,3,9980,2994,12974
220552,201912,15,15,0,15968,0,15968
220553,201912,50,45,5,45908,4990,50898
220554,201912,10,8,2,7984,1996,9980
220555,201912,32,29,3,28942,2994,31936
220556,201912,52,48,4,47904,3992,51896
220557,201912,55,52,3,51896,2994,54890
220558,201912,8,3,5,2994,4990,7984
220559,201912,2,2,0,1996,0,1996
220560,201912,67,45,22,44910,21956,66866
220570,201912,760,470,290,472054.4,290418,762472.4
220580,201912,547,506,41,505986,40918,546904
220585,201912,7,6,1,5988,998,6986
220590,201912,14,14,0,13972,0,13972
220595,201912,61,47,14,46906,13972,60878
220600,201912,19,12,7,11976,6986,18962
220605,201912,24,22,2,21956,1996,23952
220610,201912,72,64,8,63872,7984,71856
220620,201912,541,447,94,459080,95808,554888
220630,201912,5,4,1,3992,998,4990
220635,201912,36,32,4,31936,3992,35928
220640,201912,105,85,20,85828,19960,105788
220650,201912,109,104,5,103792,4990,108782
220660,201912,52,41,11,40918,10978,51896
220665,201912,5,5,0,4990,0,4990
220667,201912,18,16,2,15968,1996,17964
220669,201912,28,25,3,25948,2994,28942
220670,201912,64,52,12,51896,11976,63872
220672,201912,65,45,20,45908,19960,65868
220675,201912,36,29,7,29940,6986,36926
220680,201912,39,33,6,32934,5988,38922
220690,201912,45,43,2,42914,1996,44910
220695,201912,35,18,17,17964,17964,35928
220700,201912,1698,1321,377,1325344,376246,1701590
220710,201912,4,3,1,2994,998,3992
220720,201912,107,89,18,89820,17964,107784
220730,201912,15,15,0,14970,0,14970
220735,201912,5,1,4,998,3992,4990
220740,201912,48,44,4,43912,3992,47904
220750,201912,112,95,17,94810,16966,111776
220755,201912,14,13,1,12974,998,13972
220760,201912,63,59,4,59880,3992,63872
220770,201912,5526,3002,2524,3001986.66,2526938.38,5528925.04
220775,201912,17,10,7,9980,6986,16966
220777,201912,17,16,1,15968,998,16966
220779,201912,0,0,0,0,0,0
220780,201912,883,756,127,757482,126746.4,884228.4
220785,201912,4,1,3,998,2994,3992
220790,201912,1070,858,212,860276.82,214570,1074846.82
220793,201912,7,6,1,5988,998,6986
220795,201912,14,13,1,12974,998,13972
220800,201912,4005,3065,940,3072845.24,938120.99,4010966.23
220810,201912,67,59,8,59880.4,7984,67864.4
220820,201912,241,221,20,221556,19960,241516
220830,201912,1196,1030,166,1039916,166666,1206582
220840,201912,2422,1694,728,1700594.55,729538.78,2430133.33
220850,201912,54,44,10,43912,9980,53892
220855,201912,8,5,3,4990,2994,7984
220860,201912,15,13,2,12974,1996,14970
220865,201912,33,31,2,30938,1996,32934
220870,201912,73,65,8,64870,7984,72854
220880,201912,316,250,66,251496,65868,317364
220885,201912,34,31,3,30938,2994,33932
220887,201912,12,12,0,11976,0,11976
220890,201912,97,86,11,87824,10978,98802
220900,201912,19,12,7,11976,6986,18962
220910,201912,51,43,8,42914,7984,50898
220915,201912,11,9,2,8982,1996,10978
220920,201912,49,45,4,44910,3992,48902
220930,201912,41,40,1,39920,998,40918
220935,201912,16,16,0,15968,0,15968
220937,201912,34,33,1,32934,998,33932
220940,201912,56,51,5,50898,4990,55888
220945,201912,0,0,0,0,0,0
220950,201912,44,38,6,37924,5988,43912
220955,201912,22,21,1,20958,998,21956
220960,201912,10,9,1,8982,998,9980
220965,201912,38,34,4,33932,3992,37924
220970,201912,58,48,10,47904,9980,57884
220975,201912,13,10,3,9980,2994,12974
220980,201912,29,27,2,26946,1996,28942
220985,201912,63,56,7,55888,6986,62874
220987,201912,29,27,2,26946,1996,28942
220990,201912,18,17,1,16966,998,17964
220995,201912,19,15,4,14970,3992,18962
220997,201912,61,50,11,49900,10978,60878
221000,201912,1175,1064,111,1064866,113772,1178638
221005,201912,54,48,6,47904,5988,53892
221010,201912,16,12,4,11976,3992,15968
221020,201912,40,38,2,37924,1996,39920
221030,201912,32,26,6,25948,5988,31936
221035,201912,24,24,0,23952,0,23952
221037,201912,12,8,4,7984,3992,11976
221038,201912,25,22,3,21956,2994,24950
221039,201912,21,21,0,20958,0,20958
221040,201912,251,218,33,217564,32934,250498
221050,201912,233,198,35,197604,34930,232534
221060,201912,1841,1617,224,1614764,224550,1839314
221062,201912,33,33,0,32934,0,32934
221063,201912,13,9,4,8982,3992,12974
221065,201912,56,46,10,45908,9980,55888
221070,201912,140,121,19,121756,18962,140718
221080,201912,377,327,50,327344,49900,377244
221090,201912,28,26,2,25948,1996,27944
221093,201912,48,32,16,31936,15968,47904
221095,201912,8,8,0,7984,0,7984
221097,201912,15,12,3,11976,2994,14970
221100,201912,25008,14818,10190,14848253,10234490.96,25082743.96
221110,201912,1072,803,269,803390,268462,1071852
221120,201912,523,388,135,389220.4,135728,524948.4
221130,201912,962,786,176,790416,177644,968060
221135,201912,34,31,3,30938,2994,33932
221140,201912,42,36,6,35928,5988,41916
221150,201912,12,9,3,8982,2994,11976
221160,201912,13,13,0,12974,0,12974
221170,201912,15,15,0,14970,0,14970
230010,201912,164,150,14,149700,13972,163672
230015,201912,123,100,23,99800,22954,122754
230020,201912,1632,1383,249,1381232.4,249506.79,1630739.19
230030,201912,1671,1207,464,1206583.78,467064,1673647.78
230040,201912,217,187,30,187624.4,29940,217564.4
230050,201912,230,172,58,171656,57884,229540
230060,201912,161,129,32,129740,31936,161676
230070,201912,299,261,38,260478,37924,298402
230075,201912,840,731,109,731534.8,109780,841314.8
230080,201912,197,169,28,168662,27944,196606
230090,201912,121,86,35,85828,34930,120758
230100,201912,2095,1214,881,1212570.8,882232,2094802.8
230110,201912,2816,1821,995,1826340.8,997002.4,2823343.2
230120,201912,962,765,197,765466.6,198602,964068.6
230125,201912,151,125,26,124750,25948,150698
230130,201912,478,430,48,429140,47904,477044
230140,201912,222,187,35,186626,34930,221556
230150,201912,150,115,35,114770,34930,149700
230160,201912,946,805,141,803390,140718,944108
230170,201912,610,552,58,550897,57884,608781
230180,201912,74,69,5,69860,4990,74850
230185,201912,395,340,55,339320,55888,395208
230190,201912,2306,1849,457,1851292.14,460078,2311370.14
230195,201912,491,428,63,428142,63872,492014
230200,201912,383,328,55,327344,54890,382234
230205,201912,408,264,144,264470,143712,408182
230210,201912,1328,1039,289,1038918.34,288422,1327340.34
230220,201912,1553,1052,501,1053888,502992,1556880
230230,201912,913,787,126,785426,125748,911174
230240,201912,1709,1477,232,1476292.7,231536.2,1707828.9
230250,201912,1797,1484,313,1484026.98,312374,1796400.98
230260,201912,3146,1965,1181,1967058,1182630,3149688
230270,201912,1350,1092,258,1093810.17,259480,1353290.17
230280,201912,2724,2047,677,2046898,678640.4,2725538.4
230290,201912,406,360,46,362274.79,45908,408182.79
230300,201912,517,384,133,384230,135728,519958
230310,201912,419,316,103,315368,102794,418162
230320,201912,936,803,133,803391.4,132734,936125.4
230330,201912,314,252,62,252494,61876.6,314370.6
230340,201912,450,365,85,365268.6,84830,450098.6
230350,201912,3127,1982,1145,1983026.2,1144706,3127732.2
230360,201912,277,223,54,222554,54890,277444
230365,201912,139,116,23,115768,22954,138722
230370,201912,9977,4901,5076,4906172.35,5084811.99,9990984.34
230380,201912,477,410,67,410178.4,66866.2,477044.6
230390,201912,522,295,227,294410,229540,523950
230393,201912,245,205,40,206586,39920,246506
230395,201912,357,288,69,287424.48,69860,357284.48
230400,201912,608,485,123,484030,123752,607782
230410,201912,2703,1692,1011,1693607.09,1008979,2702586.09
230420,201912,6267,4182,2085,4183619.63,2092808.56,6276428.19
230423,201912,323,282,41,282434,40918,323352
230425,201912,408,335,73,335328.34,73852,409180.34
230426,201912,123,99,24,98802,23952,122754
230427,201912,77,75,2,74850,1996,76846
230428,201912,1473,744,729,742512,731534,1474046
230430,201912,453,371,82,371256.99,81836,453092.99
230435,201912,883,632,251,631734,250498.98,882232.98
230440,201912,87514,38857,48657,38915037.86,48733364.44,87648402.30
230445,201912,304,214,90,213572,89820,303392
230450,201912,543,434,109,435128,108782,543910
230460,201912,62,50,12,50898,11976,62874
230465,201912,310,253,57,255488,56886,312374
230470,201912,1980,1563,417,1564864,419160.5,1984024.5
230480,201912,162,153,9,152694,8982,161676
230490,201912,301,240,61,239520,60878,300398
230495,201912,456,336,120,336326,119760,456086
230500,201912,1004,745,259,745506,259480,1004986
230510,201912,58,45,13,44910,12974,57884
230520,201912,376,297,79,297404,78842,376246
230523,201912,2274,1437,837,1435124,836324.4,2271448.4
230526,201912,272,230,42,230538,41916,272454
230530,201912,681,511,170,510976,169660,680636
230533,201912,199,186,13,187624,12974,200598
230535,201912,366,274,92,273452,91816,365268
230540,201912,1819,1607,212,1609774,214570,1824344
230550,201912,3782,2433,1349,2435121.96,1347300.97,3782422.93
230560,201912,579,440,139,439120.8,138722,577842.8
230565,201912,224,166,58,165668,57884,223552
230570,201912,289,256,33,255488,33932,289420
230580,201912,1163,857,306,861274,306386,1167660
230590,201912,988,776,212,776477.76,211576,988053.76
230600,201912,249,226,23,226546,22954,249500
230610,201912,357,281,76,280438.6,75848,356286.6
230620,201912,181,152,29,151696.4,28942,180638.4
230625,201912,754,536,218,534928.5,217564,752492.5
230630,201912,1329,1043,286,1044906,285428,1330334
230640,201912,3728,3210,518,3213561,519960.07,3733521.07
230650,201912,442,380,62,380238.97,61876,442114.97
230655,201912,674,582,92,580837.57,91818.92,672656.49
230660,201912,362,304,58,304390,57884,362274
230670,201912,431,376,55,375248,55888,431136
230680,201912,201,183,18,182634,17964,200598
230690,201912,900,772,128,772452,127744,900196
230700,201912,806,679,127,680636,126746,807382
230710,201912,708,674,34,677642.6,33932,711574.6
230720,201912,152,133,19,132734,18962,151696
230725,201912,265,217,48,216566,48902.98,265468.98
230730,201912,12099,6610,5489,6618872.16,5500979.85,12119852.01
230740,201912,676,550,126,549898.4,125748,675646.4
230750,201912,826,702,124,700596.6,124750,825346.6
230760,201912,1392,1196,196,1194606,195608,1390214
230763,201912,320,267,53,267464,52894,320358
230765,201912,7336,3396,3940,3401185.28,3945096.69,7346281.97
230770,201912,5067,2562,2505,2561867.34,2505979.37,5067846.71
230780,201912,706,623,83,626744.4,83832,710576.4
230790,201912,266,221,45,221556,44910,266466
230800,201912,1143,832,311,832332,310378,1142710
230810,201912,1349,1196,153,1194606,152694,1347300
230820,201912,353,247,106,246506.4,105788,352294.4
230830,201912,964,828,136,827342,135728,963070
230835,201912,273,238,35,238522,34930,273452
230837,201912,168,139,29,138722,29940,168662
230840,201912,910,726,184,726544.4,184630.4,911174.8
230850,201912,1485,1292,193,1292410,192614,1485024
230860,201912,297,221,76,220558,75848,296406
230870,201912,1825,1559,266,1560872,266466,1827338
230880,201912,66,50,16,49900,15968,65868
230890,201912,547,503,44,501994,43912.97,545906.97
230900,201912,280,208,72,207584,71856.58,279440.58
230910,201912,217,171,46,171656,45908,217564
230920,201912,421,333,88,332334,88822,421156
230930,201912,967,690,277,690616.68,276446,967062.68
230940,201912,851,672,179,671654,178642.6,850296.6
230945,201912,507,421,86,421157,85828,506985
230950,201912,409,355,54,355288,53892,409180
230960,201912,2646,1789,857,1788416.98,857282.4,2645699.38
230970,201912,1750,969,781,971054,782432,1753486
230980,201912,208,173,35,172654,34930,207584
230990,201912,138,113,25,112774,24950,137724
231000,201912,205,186,19,187624,18962,206586
231010,201912,146,112,34,111776,33932,145708
231020,201912,1339,927,412,934128.9,414170,1348298.9
231025,201912,1044,783,261,782432.6,260478.4,1042911.0
231030,201912,1098,926,172,929139.35,173652,1102791.35
231040,201912,136,94,42,93812,42914,136726
231050,201912,958,854,104,854288,103792,958080
231060,201912,150,126,24,126746,23952,150698
231070,201912,1485,1048,437,1047901.3,438122,1486023.3
231080,201912,263,242,21,241516,20958,262474
231085,201912,596,359,237,359280.6,236526,595806.6
231090,201912,243,200,43,199600,43912,243512
231095,201912,170,134,36,133732,36926,170658
231100,201912,150,125,25,124750,24950,149700
231110,201912,364,311,53,311376,52894,364270
231120,201912,272,230,42,230538,41916,272454
231123,201912,144,137,7,137724,6986,144710
231126,201912,332,260,72,259480.4,71856,331336.4
231130,201912,4606,3592,1014,3598788.97,1015965.37,4614754.34
231135,201912,211,183,28,182634,27944,210578
231140,201912,3055,2254,801,2260470,799398,3059868
231150,201912,364,346,18,345308,17964,363272
231160,201912,1193,946,247,946104,247504,1193608
231170,201912,528,364,164,364270,164670,528940
231180,201912,1672,1429,243,1434126,243512,1677638
231190,201912,211,179,32,179640,31936,211576
231195,201912,215,185,30,185628,29940,215568
231200,201912,813,665,148,663670,147704.6,811374.6
231210,201912,581,487,94,489020,93812,582832
231220,201912,1043,764,279,763470.9,278442,1041912.9
231230,201912,1453,1157,296,1156682,296406,1453088
231240,201912,1438,1041,397,1041912,398202,1440114
231250,201912,113,104,9,103792,8982,112774
231260,201912,274,180,94,179640,93812,273452
231270,201912,1014,833,181,832333.49,180638,1012971.49
231280,201912,74,57,17,56886,16966,73852
231290,201912,7537,4227,3310,4230522.4,3319349.8,7549872.2
231300,201912,620,575,45,574848,44910,619758
231310,201912,745,690,55,688620.74,54890,743510.74
231320,201912,585,446,139,445110,139720,584830
231325,201912,94,83,11,83832,10978,94810
231330,201912,2016,1562,454,1561123.53,454090.4,2015213.93
231335,201912,255,227,28,227544,27944,255488
231340,201912,1711,1264,447,1266462,446106,1712568
231350,201912,1281,1056,225,1055884,224550.8,1280434.8
231355,201912,431,372,59,373252,58882,432134
231360,201912,495,372,123,375249.21,124750,499999.21
231370,201912,86,73,13,72854,12974,85828
231375,201912,289,210,79,209580,78842,288422
231380,201912,483,392,91,391216,90818,482034
231390,201912,201,159,42,160678,41916,202594
231395,201912,730,461,269,460078,268462,728540
231400,201912,1117,928,189,927145.04,190620.34,1117765.38
231410,201912,1315,1082,233,1080834.2,234530,1315364.2
240010,201912,389,174,215,174650.43,214570.98,389221.41
240020,201912,2278,1826,452,1825344.45,452095.97,2277440.42
240030,201912,117,101,16,100798,15968,116766
240040,201912,30,30,0,29940,0,29940
240050,201912,527,454,73,456086,74850,530936
240060,201912,64,60,4,60878,3992,64870
240070,201912,210,164,46,165668,46906,212574
240080,201912,505,344,161,345308.99,161676.46,506985.45
240090,201912,107,96,11,95808,10978,106786
240100,201912,1496,1415,81,1420154.9,80838,1500992.9
240110,201912,1053,693,360,693612.94,363273.1,1056886.04
240120,201912,128,106,22,108782,21956,130738
240130,201912,280,260,20,261476,19960,281436
240140,201912,78,59,19,58882,18962,77844
240145,201912,723,648,75,651694,74850,726544
240150,201912,21,16,5,15968,4990,20958
240160,201912,41,36,5,35928,4990,40918
240165,201912,33,26,7,26946.5,6986,33932.5
240170,201912,96,72,24,71856,23952,95808
240180,201912,86,71,15,70858,14970,85828
240185,201912,43,41,2,40918,1996,42914
240190,201912,15,13,2,12974,1996,14970
240200,201912,3077,1732,1345,1734526.8,1348299.4,3082826.2
240210,201912,173,134,39,133732,38922,172654
240220,201912,1105,798,307,796404.7,308382,1104786.7
240230,201912,855,789,66,788422.1,65868,854290.1
240240,201912,70,49,21,48902,20958,69860
240250,201912,88,76,12,75848,11976,87824
240260,201912,1806,1343,463,1351292,464070,1815362
240270,201912,187,165,22,164670,21956,186626
240280,201912,42,34,8,33932,7984,41916
240290,201912,51,49,2,48902,1996,50898
240300,201912,172,99,73,98802,72854,171656
240310,201912,2301,1281,1020,1280437.37,1019956,2300393.37
240320,201912,195,185,10,186626,9980,196606
240325,201912,4434,2676,1758,2680631.17,1761472.07,4442103.24
240330,201912,71,68,3,67864,2994,70858
240340,201912,64,40,24,39920,23952,63872
240350,201912,100,88,12,87824,11976,99800
240360,201912,532,343,189,344310,188622,532932
240370,201912,50,46,4,46906,3992,50898
240375,201912,65,39,26,39920,25948,65868
240380,201912,227,188,39,187624,38922.8,226546.8
240390,201912,12,11,1,10978,998,11976
240400,201912,84,78,6,77844,5988,83832
240410,201912,12,7,5,6986,4990,11976
240420,201912,964,723,241,721554.2,243512,965066.2
240430,201912,263,246,17,246506,16966,263472
240440,201912,111,64,47,63872,46906,110778
240450,201912,223,153,70,152694.4,70858,223552.4
240460,201912,61,46,15,45908,14970,60878
240470,201912,234,207,27,207584,26946,234530
240480,201912,16,13,3,12974,2994,15968
240485,201912,78,65,13,64870,12974,77844
240490,201912,46,44,2,44910,1996,46906
240500,201912,78,61,17,60878,16966,77844
240510,201912,44,32,12,31936,11976,43912
240520,201912,116,111,5,111776,4990,116766
240530,201912,51,46,5,47904,4990,52894
240540,201912,77,66,11,65868,10978,76846
240550,201912,13,12,1,11976,998,12974
240560,201912,378,275,103,275448,102794,378242
240570,201912,453,287,166,286426,165668.4,452094.4
240580,201912,1268,1015,253,1015965.1,252494.99,1268460.09
240590,201912,30,28,2,27944,1996,29940
240600,201912,108,105,3,105788,2994,108782
240610,201912,512,430,82,430139.36,81836,511975.36
240615,201912,19,18,1,17964,998,18962
240620,201912,88,84,4,83832,3992,87824
240630,201912,37,33,4,32934,3992,36926
240640,201912,26,22,4,21956,3992,25948
240650,201912,236,197,39,196606,38922,235528
240660,201912,109,95,14,94810,13972,108782
240670,201912,302,179,123,179640.7,122754,302394.7
240680,201912,51,39,12,38922,11976,50898
240690,201912,46,43,3,42914,2994,45908
240700,201912,187,155,32,157684,31936,189620
240710,201912,2004,1250,754,1250495.3,753490,2003985.3
240720,201912,1068,797,271,798400,274450.2,1072850.2
240725,201912,64,60,4,59880,3992,63872
240730,201912,143,125,18,124750,17964,142714
240740,201912,231,197,34,196606,34930.74,231536.74
240750,201912,53,27,26,26946,25948,52894
240760,201912,46,42,4,41916,4990,46906
240770,201912,146,113,33,112774,32934,145708
240780,201912,675,553,122,554888,121756,676644
240790,201912,42,40,2,39920,1996,41916
240800,201912,9156,6237,2919,6247490.63,2923145.68,9170636.31
240810,201912,20212,11031,9181,11060855.72,9207574.97,20268430.69
240820,201912,238,140,98,139721.15,97804,237525.15
240830,201912,1631,1338,293,1341312.7,293412,1634724.7
240840,201912,79,70,9,70858,9980,80838
240850,201912,87,77,10,76846,9980,86826
240860,201912,111,107,4,106786,3992,110778
240870,201912,59,51,8,50898,7984,58882
240880,201912,31,27,4,26946,3992,30938
240890,201912,1117,651,466,650696.76,467064.99,1117761.75
240895,201912,58,36,22,35928,21956,57884
240910,201912,158,144,14,143712,13972,157684
240920,201912,14,11,3,10978,2994,13972
240930,201912,412,369,43,368262,42914,411176
240933,201912,40,29,11,28942,10978,39920
240940,201912,2411,2139,272,2144702.58,272454.96,2417157.54
240950,201912,46,43,3,42914,2994,45908
240960,201912,30,25,5,24950,4990,29940
240970,201912,111,81,30,80838,29940,110778
240980,201912,194,158,36,157684,35928,193612
240990,201912,130,88,42,87824,41916,129740
241000,201912,62,58,4,58882,3992,62874
241010,201912,62,48,14,47904,13972,61876
241020,201912,115,106,9,105788,8982,114770
241025,201912,11,6,5,5988,4990,10978
241030,201912,109,89,20,89820,19960,109780
241040,201912,43,31,12,30938,11976,42914
241050,201912,83,74,9,74850,8982,83832
241060,201912,29,24,5,23952,4990,28942
241070,201912,17,17,0,16966,0,16966
241080,201912,61,54,7,53892,6986,60878
241090,201912,55,45,10,44910,9980,54890
241100,201912,72,62,10,61876,9980,71856
241105,201912,5,1,4,998,3992,4990
241110,201912,46,44,2,43912,1996,45908
241120,201912,1466,1124,342,1123748.96,342314,1466062.96
241140,201912,219,181,38,180638.4,37924,218562.4
241142,201912,39,36,3,35928,2994,38922
241150,201912,1178,1036,142,1035924,142714,1178638
241160,201912,23,20,3,19960,2994,22954
241170,201912,42,37,5,36926,4990,41916
241180,201912,44,38,6,37924,5988,43912
241190,201912,39,38,1,37924,998,38922
241200,201912,3846,2034,1812,2036921.53,1818356.99,3855278.52
241210,201912,68,58,10,57884,9980,67864
241220,201912,1428,969,459,970057.02,458082.97,1428139.99
241230,201912,242,205,37,204590.96,37924,242514.96
241240,201912,54,43,11,42914,10978,53892
241250,201912,1144,1048,96,1055884.4,96806,1152690.4
241255,201912,51,40,11,39920,10978,50898
241260,201912,664,519,145,517962,144710,662672
241270,201912,62,39,23,38922,22954,61876
241280,201912,94,81,13,81836,12974,94810
241290,201912,122,89,33,88822,32934,121756
241300,201912,76,55,21,54890,20958,75848
241310,201912,51,37,14,36926.7,13972,50898.7
241320,201912,29,16,13,15968,12974,28942
241330,201912,61,57,4,56886,3992,60878
241335,201912,73,66,7,65868,6986,72854
241340,201912,181,134,47,133732,46906,180638
241350,201912,60,52,8,51896,7984,59880
241355,201912,48,42,6,41916,5988,47904
241360,201912,52,51,1,50898,998,51896
241370,201912,49,41,8,40918,7984,48902
241380,201912,38,34,4,33932,3992,37924
241390,201912,84,66,18,66866,17964,84830
241400,201912,217,177,40,176646,39920,216566
241410,201912,187,167,20,166666,19960,186626
241415,201912,102,82,20,81836,19960,101796
241420,201912,102,73,29,72854,28942.64,101796.64
241430,201912,28,25,3,24950,2994,27944
241440,201912,533,431,102,433136.81,102794.6,535931.41
241445,201912,35,33,2,32934,1996,34930
241450,201912,285,234,51,234530,50898,285428
241460,201912,138,124,14,125748.5,13972,139720.5
241470,201912,39,34,5,33932,4990,38922
241475,201912,57,54,3,53892,2994,56886
241480,201912,89,65,24,65868,23952,89820
241490,201912,11,10,1,9980,998,10978
241500,201912,47,36,11,35928,10978,46906
250010,201912,101,85,16,84830,15968,100798
250020,201912,33,30,3,29940,2994,32934
250030,201912,838,635,203,636724,203592.6,840316.6
250040,201912,372,304,68,303392,67864,371256
250050,201912,249,204,45,203592.99,44910,248502.99
250053,201912,54,41,13,43912,12974,56886
250057,201912,0,0,0,0,0,0
250060,201912,544,398,146,399200,147704,546904
250070,201912,710,568,142,568860.75,142714,711574.75
250073,201912,8,8,0,7984,0,7984
250077,201912,184,140,44,139720,43912,183632
250080,201912,425,332,93,332334.72,93812,426146.72
250090,201912,204,134,70,134730,70858,205588
250100,201912,517,427,90,427144,91816.2,518960.2
250110,201912,584,449,135,449100,136726,585826
250115,201912,21,7,14,6986,13972,20958
250120,201912,116,85,31,84830,30938,115768
250130,201912,568,465,103,465068,102794.6,567862.6
250135,201912,17,10,7,9980,6986,16966
250140,201912,82,73,9,72854,8982,81836
250150,201912,580,420,160,419160,160678,579838
250153,201912,8,6,2,5988,1996,7984
250157,201912,31,24,7,23952,6986,30938
250160,201912,223,172,51,171656,50898,222554
250170,201912,62,41,21,40918,20958,61876
250180,201912,4156,2846,1310,2847297.36,1313372.15,4160669.51
250190,201912,846,557,289,556884,290418.5,847302.5
250200,201912,51,44,7,43912,7984,51896
250205,201912,24,20,4,19960,3992,23952
250210,201912,86,76,10,75848,9980,85828
250215,201912,66,56,10,55888,9980,65868
250220,201912,25,19,6,18962,5988,24950
250230,201912,78,72,6,71856.99,5988,77844.99
250240,201912,232,195,37,194610,36926,231536
250250,201912,397,345,52,346306,51896,398202
250260,201912,41,35,6,35928,5988,41916
250270,201912,67,50,17,49900,16966,66866
250280,201912,377,313,64,313372,63872,377244
250290,201912,89,81,8,80838,7984,88822
250300,201912,546,374,172,374250,172655.97,546905.97
250310,201912,46,42,4,41916,3992,45908
250320,201912,1932,1321,611,1324347.52,610777.38,1935124.90
250330,201912,94,80,14,79840,13972,93812
250340,201912,24,22,2,21956,1996,23952
250350,201912,154,101,53,101796,52894,154690
250355,201912,35,27,8,26946,7984,34930
250360,201912,202,164,38,163672,37924,201596
250370,201912,2376,1600,776,1608776,779438,2388214
250375,201912,9,5,4,4990,3992,8982
250380,201912,57,42,15,41916,14970,56886
250390,201912,44,34,10,34930,9980,44910
250400,201912,16261,8247,8014,8255448.09,8024923.63,16280371.72
250403,201912,332,273,59,272454,59880,332334
250407,201912,59,49,10,48902,9980,58882
250410,201912,30,26,4,25948,3992,29940
250415,201912,39,26,13,25948,12974,38922
250420,201912,44,38,6,37924,5988,43912
250430,201912,1455,1253,202,1254735.5,203592,1458327.5
250435,201912,19,14,5,13972,4990,18962
250440,201912,674,566,108,565866.6,108782,674648.6
250450,201912,80,66,14,65868,13972,79840
250460,201912,455,313,142,313372,144710,458082
250470,201912,91,64,27,63872,26946,90818
250480,201912,326,260,66,260478,65868,326346
250485,201912,1,1,0,998,0,998
250490,201912,223,183,40,183632,40918,224550
250500,201912,85,64,21,63872,20958,84830
250510,201912,741,588,153,588820,152694,741514
250520,201912,177,121,56,120758,55888,176646
250523,201912,114,94,20,93812,20958,114770
250527,201912,102,80,22,79840,21956,101796
250530,201912,9,5,4,4990,3992,8982
250535,201912,26,20,6,19960,5988,25948
250540,201912,130,101,29,100798,28942,129740
250550,201912,73,70,3,69860,2994,72854
250560,201912,46,34,12,33932,11976,45908
250570,201912,163,133,30,132734,29940,162674
250580,201912,111,85,26,84894,25948,110842
250590,201912,24,15,9,14970,8982,23952
250600,201912,1343,897,446,897203.04,445108,1342311.04
250610,201912,154,131,23,131736,22954,154690
250620,201912,23,18,5,17964,4990,22954
250625,201912,69,51,18,50898,17964,68862
250630,201912,3007,1927,1080,1927153.07,1082837.92,3009990.99
250640,201912,215,175,40,174650,39920,214570
250650,201912,27,19,8,18962,7984,26946
250660,201912,50,39,11,38922,10978,49900
250670,201912,65,44,21,43912,20958,64870
250680,201912,398,322,76,321356,75848,397204
250690,201912,1948,1347,601,1356286.15,603790,1960076.15
250700,201912,929,812,117,811374.5,117764,929138.5
250710,201912,430,337,93,336326,92814,429140
250720,201912,112,85,27,86826,26946,113772
250730,201912,371,312,59,311376,58882,370258
250740,201912,53,49,4,48902,3992,52894
250750,201912,21762,13168,8594,13206443.31,8637697.13,21844140.44
250760,201912,85,67,18,66866,17964,84830
250770,201912,356,234,122,234530.44,121756,356286.44
250780,201912,60,43,17,42914,16966,59880
250790,201912,466,305,161,305388,160678,466066
250800,201912,148,135,13,134730,12974,147704
250810,201912,78,59,19,59880,18962,78842
250820,201912,153,127,26,126746,25948,152694
250830,201912,433,294,139,294410.4,139720,434130.4
250840,201912,52,48,4,47904,3992,51896
250850,201912,52,43,9,42914,8982,51896
250855,201912,14,11,3,10978,2994,13972
250860,201912,204,141,63,141716,62874,204590
250870,201912,33,28,5,27944,4990,32934
250880,201912,81,62,19,61876,19960,81836
250890,201912,2753,2067,686,2066858,686624,2753482
250900,201912,49,42,7,41916,6986,48902
250905,201912,117,91,26,93812,25948,119760
250910,201912,1138,823,315,821354.99,315368,1136722.99
250915,201912,105,73,32,72854,31936,104790
250920,201912,138,102,36,101796,35928,137724
250930,201912,164,101,63,100798,62874,163672
250933,201912,2,2,0,1996,0,1996
250937,201912,8,7,1,7984,998,8982
250939,201912,35,26,9,25948,8982,34930
250940,201912,108,80,28,79840,27944,107784
250950,201912,70,48,22,47904,21956,69860
250960,201912,89,49,40,49900,40918,90818
250970,201912,1220,864,356,867262.96,355288,1222550.96
250980,201912,100,68,32,67864,31936,99800
250990,201912,168,130,38,131736,37924,169660
251000,201912,77,69,8,68862,7984,76846
251010,201912,109,81,28,81836.99,27944,109780.99
251020,201912,81,69,12,68862,11976,80838
251030,201912,46,36,10,35928,9980,45908
251040,201912,52,38,14,37924,13972,51896
251050,201912,23,21,2,20958,1996,22954
251060,201912,50,39,11,38922,10978,49900
251065,201912,4,4,0,3992,0,3992
251070,201912,22,18,4,17964.98,3992,21956.98
251080,201912,4956,2394,2562,2389233.88,2564864.63,4954098.51
251090,201912,195,168,27,167664,26946,194610
251100,201912,19,18,1,17964,998,18962
251110,201912,45,36,9,35928,8982,44910
251120,201912,1847,1128,719,1128740,723550.68,1852290.68
251130,201912,392,319,73,319360,73852,393212
251140,201912,550,359,191,359281.2,190618,549899.2
251150,201912,324,280,44,279440.98,43912,323352.98
251160,201912,93,77,16,76846.99,15968,92814.99
251170,201912,101,82,19,82834.99,18962,101796.99
251180,201912,288,178,110,177644.99,109780.99,287425.98
251190,201912,196,129,67,129740,68862,198602
251200,201912,266,219,47,218562,47904,266466
251203,201912,34,32,2,31936,1996,33932
251207,201912,90,74,16,73852,15968,89820
251210,201912,1467,1071,396,1073848,396206,1470054
251220,201912,49,37,12,36926,11976,48902
251230,201912,597,504,93,503990,93812,597802
251240,201912,100,69,31,68862,30938,99800
251250,201912,1392,993,399,993010.9,401196.7,1394207.6
251260,201912,13,7,6,6986,5988,12974
251270,201912,324,247,77,248502,76846,325348
251272,201912,66,59,7,58882,6986,65868
251274,201912,29,22,7,21956,6986,28942
251275,201912,32,19,13,18962,12974,31936
251276,201912,15,11,4,10978,3992,14970
251278,201912,10,8,2,7984,1996,9980
251280,201912,100,96,4,95808,3992,99800
251290,201912,739,544,195,545906,195608,741514
251300,201912,14,12,2,11976,1996,13972
251310,201912,376,269,107,269460.99,107784,377244.99
251315,201912,27,24,3,23952,2994,26946
251320,201912,59,46,13,46906,12974,59880
251330,201912,78,69,9,68862,8982,77844
251335,201912,13,8,5,7984,4990,12974
251340,201912,718,424,294,425148,294410,719558
251350,201912,34,33,1,32934,998,33932
251360,201912,78,69,9,68862,8982,77844
251365,201912,15,15,0,14970,0,14970
251370,201912,5501,3722,1779,3728530.14,1788416.6,5516946.74
251380,201912,44,36,8,35928,7984,43912
251385,201912,3,3,0,2994,0,2994
251390,201912,773,591,182,590816.7,181636.4,772453.1
251392,201912,13,7,6,6986,5988,12974
251394,201912,9,9,0,8982,0,8982
251396,201912,12,8,4,7984,3992,11976
251398,201912,18,16,2,15968,2994,18962
251400,201912,38,33,5,32934,4990,37924
251410,201912,38,31,7,30938,6986,37924
251420,201912,103,75,28,75848,27944,103792
251430,201912,41,39,2,38922,1996,40918
251440,201912,34,21,13,20958,12974,33932
251445,201912,47,42,5,42914.09,4990,47904.09
251450,201912,404,352,52,354290.2,51896,406186.2
251455,201912,4,2,2,1996,1996,3992
251460,201912,15,13,2,12974,1996,14970
251465,201912,4,2,2,1996,1996,3992
251470,201912,47,38,9,37924,8982,46906
251480,201912,25,22,3,21956,2994,24950
251490,201912,121,84,37,83832,36926.4,120758.4
251500,201912,125,101,24,100798,23952,124750
251510,201912,41,29,12,28942,11976,40918
251520,201912,26,26,0,25948,0,25948
251530,201912,4488,3159,1329,3161664.8,1330334,4491998.8
251540,201912,75,63,12,62874,11976,74850
251550,201912,407,313,94,312374,93812.9,406186.9
251560,201912,21,14,7,13972,6986,20958
251570,201912,19,18,1,18962,998,19960
251580,201912,132,106,26,105788,25948,131736
251590,201912,119,86,33,86017,32934,118951
251593,201912,25,15,10,14970,9980,24950
251597,201912,69,54,15,54890,14970,69860
251600,201912,1098,779,319,781442.51,319360.6,1100803.11
251610,201912,236,183,53,182634,52894,235528
251615,201912,6,6,0,5988,0,5988
251620,201912,4210,2773,1437,2778433.84,1436123.6,4214557.44
251630,201912,456,338,118,338322,118762.98,457084.98
251640,201912,144,102,42,101796,41916,143712
251650,201912,263,192,71,192614.7,71856,264470.7
251660,201912,189,170,19,169660,18962,188622
251670,201912,360,285,75,287424,74850,362274
251675,201912,6,6,0,5988,0,5988
251680,201912,95,88,7,87824,7984,95808
251690,201912,341,279,62,278442,62874,341316
251700,201912,286,248,38,247504.56,37924,285428.56
251710,201912,23,15,8,14970,7984,22954
251720,201912,25,16,9,15968,8982.4,24950.4
251740,201912,10,8,2,7984,1996,9980
260005,201912,3174,1769,1405,1771452.95,1406184.88,3177637.83
260010,201912,1586,1158,428,1157681.13,427144.64,1584825.77
260020,201912,420,368,52,367264,51896,419160
260030,201912,600,426,174,427144,173652,600796
260040,201912,805,505,300,505986,301396,807382
260050,201912,1158,836,322,837322,323352.8,1160674.8
260060,201912,381,348,33,349300,33932,383232
260070,201912,1379,856,523,856285.9,524948.32,1381234.22
260080,201912,732,572,160,571854,160678,732532
260090,201912,507,330,177,329341.96,177644,506985.96
260100,201912,224,158,66,158682,65868,224550
260105,201912,225,126,99,125748,99800,225548
260110,201912,2858,2111,747,2108775.78,746505.39,2855281.17
260120,201912,2833,1459,1374,1462072.32,1374246.7,2836319.02
260130,201912,165,114,51,113772,50898,164670
260140,201912,2145,1394,751,1397211.08,756484.98,2153696.06
260150,201912,216,141,75,140718,74850,215568
260160,201912,324,273,51,272454,50898,323352
260170,201912,3355,2044,1311,2045900.88,1313368.4,3359269.28
260180,201912,155,129,26,129740,25948,155688
260190,201912,2279,1578,701,1580832,702592,2283424
260200,201912,965,776,189,776444.63,189620.4,966065.03
260210,201912,1437,1031,406,1031932,405188.98,1437120.98
260220,201912,706,635,71,635726.4,70858,706584.4
260230,201912,1197,895,302,893210.94,302394,1195604.94
260240,201912,227,172,55,171656,55888,227544
260250,201912,90,67,23,66866,22954,89820
260260,201912,1039,739,300,739518,300398,1039916
260270,201912,417,331,86,331336,86826,418162
260280,201912,1329,934,395,933130,396206.4,1329336.4
260290,201912,6498,3508,2990,3512965.74,2995005.43,6507971.17
260300,201912,935,812,123,810376.6,122754,933130.6
260310,201912,519,407,112,407184,111776,518960
260320,201912,869,642,227,645707.92,228542,874249.92
260330,201912,59,41,18,40918,17964,58882
260340,201912,75,55,20,54890,19960,74850
260345,201912,5541,3059,2482,3059870.67,2489015.9,5548886.57
260350,201912,487,354,133,354290.4,133732.98,488023.38
260360,201912,272,146,126,145708,125748,271456
260370,201912,719,474,245,473052.5,245508.99,718561.49
260380,201912,593,435,158,438123.92,158682.66,596806.58
260390,201912,300,254,46,253492,46906,300398
260392,201912,102,88,14,91816,13972,105788
260400,201912,4115,2369,1746,2379233.79,1748496,4127729.79
260410,201912,14702,7714,6988,7710550.54,6991989.28,14702539.82
260415,201912,133,117,16,117764,15968,133732
260420,201912,1755,1075,680,1076843.81,684628,1761471.81
260430,201912,190,173,17,174651.25,16966,191617.25
260440,201912,208,149,59,148702.98,58882,207584.98
260450,201912,442,318,124,318363.2,125748,444111.2
260460,201912,831,442,389,443113.2,390218,833331.2
260470,201912,355,218,137,218562,136726.8,355288.8
260480,201912,227,148,79,148702,80838,229540
260490,201912,215,179,36,178642,36926,215568
260500,201912,1124,754,370,755486,371256,1126742
260510,201912,776,625,151,623750,151696,775446
260515,201912,245,221,24,220558,23952,244510
260520,201912,3251,1983,1268,1982028.99,1272450.78,3254479.77
260530,201912,807,660,147,661674,146706,808380
260540,201912,557,437,120,437124,121756,558880
260545,201912,11,9,2,8982,1996,10978
260550,201912,333,209,124,209580,123752,333332
260560,201912,539,403,136,402194.4,137724,539918.4
260570,201912,979,805,174,807382.4,174650,982032.4
260580,201912,253,225,28,225548,28942,254490
260590,201912,618,358,260,357284,259480,616764
260600,201912,7970,4312,3658,4313357.96,3672640.96,7985998.92
260610,201912,501,336,165,335328,164670,499998
260620,201912,3684,1919,1765,1930135.02,1772450.47,3702585.49
260630,201912,89,83,6,82834,5988,88822
260640,201912,3565,1981,1584,1982028.92,1588816.98,3570845.90
260650,201912,327,239,88,241516,88822,330338
260660,201912,552,374,178,373252,177644,550896
260670,201912,104,77,27,76846,26946,103792
260680,201912,3672,2067,1605,2066861.13,1607779.36,3674640.49
260690,201912,127,94,33,94810,32934,127744
260700,201912,317,209,108,209580,108782,318362
260710,201912,37,34,3,33932,2994,36926
260720,201912,2377,1417,960,1419157.6,963070,2382227.6
260730,201912,683,513,170,512972,169660,682632
260740,201912,62,58,4,57884,3992,61876
260750,201912,607,436,171,435128,170658,605786
260760,201912,636,339,297,338322.63,297404,635726.63
260765,201912,984,508,476,507982.99,476046,984028.99
260770,201912,220,166,54,165651,54890,220541
260775,201912,795,456,339,457086.1,340318.98,797405.08
260780,201912,262,169,93,171656,92814,264470
260790,201912,12720,6759,5961,6760462.3,5982017.41,12742479.71
260795,201912,169,114,55,113772,54890,168662
260800,201912,284,238,46,239520,47904,287424
260805,201912,172,115,57,114770,57884,172654
260810,201912,744,646,98,646704,99800,746504
260820,201912,292,186,106,185628.34,105788,291416.34
260825,201912,207,147,60,146706,59880,206586
260830,201912,279,174,105,176646,104790,281436
260840,201912,232,171,61,170658,60878,231536
260845,201912,172,120,52,119760,53892,173652
260850,201912,457,337,120,337324,119760,457084
260860,201912,254,192,62,191616,61876,253492
260870,201912,374,281,93,280438,93812,374250
260875,201912,733,524,209,523950,208582,732532
260880,201912,1595,1017,578,1014966.2,577842,1592808.2
260890,201912,2384,1681,703,1678637.8,701594.8,2380232.6
260900,201912,981,687,294,689618,293412,983030
260910,201912,259,205,54,206586,53892,260478
260915,201912,296,213,83,212574,83832,296406
260920,201912,176,96,80,95808,80838,176646
260930,201912,398,342,56,341318.91,55888.97,397207.88
260940,201912,2726,1492,1234,1490015.76,1236522.4,2726538.16
260950,201912,2010,1166,844,1169656.7,843310,2012966.7
260960,201912,13715,7038,6677,7057868.16,6698584.01,13756452.17
260970,201912,424,358,66,359280,66866,426146
260980,201912,189,168,21,168662,20958,189620
260990,201912,2603,2116,487,2114763.94,489020,2603783.94
261000,201912,4305,2579,1726,2588813.68,1732528.6,4321342.28
261010,201912,179,130,49,129740,48902,178642
261020,201912,603,453,150,455089.06,150698,605787.06
261030,201912,237,176,61,176646,60878,237524
261040,201912,377,330,47,329340,46906,376246
261050,201912,507,440,67,440118,66866,506984
261060,201912,1371,887,484,888220.5,484030,1372250.5
261070,201912,8728,4377,4351,4382243.13,4357316.3,8739559.43
261080,201912,378,289,89,290418,88822,379240
261090,201912,2237,1724,513,1722551.91,512972.47,2235524.38
261100,201912,1123,786,337,787423.3,338322,1125745.3
261110,201912,8584,5282,3302,5289404.74,3302386.14,8591790.88
261120,201912,266,226,40,225548,39920,265468
261130,201912,586,348,238,347304.6,238522.62,585827.22
261140,201912,189,121,68,120758,67864,188622
261150,201912,687,428,259,428142.18,259480,687622.18
261153,201912,68,64,4,63872,3992,67864
261160,201912,76159,38096,38063,38200502.75,38175529.88,76376032.63
261170,201912,477,363,114,363272,115768,479040
261180,201912,1795,1106,689,1113768,689618,1803386
261190,201912,613,429,184,429142.52,184630.98,613773.50
261200,201912,220,190,30,189620,29940,219560
261210,201912,34,28,6,27944,5988,33932
261220,201912,2686,1886,800,1885224.39,799398.97,2684623.36
261230,201912,351,263,88,262474,87824,350298
261240,201912,464,404,60,405188,59880,465068
261245,201912,234,194,40,193612,39920,233532
261247,201912,173,137,36,136726,35928,172654
261250,201912,3035,1517,1518,1519954.9,1518956,3038910.9
261255,201912,249,228,21,227544,21956,249500
261260,201912,865,751,114,749498.76,113772,863270.76
261270,201912,194,140,54,139720,53892,193612
261280,201912,175,143,32,142714,31936,174650
261290,201912,120,86,34,86826,34930,121756
261300,201912,1299,944,355,947102,354290,1301392
261310,201912,815,549,266,547902,265468,813370
261320,201912,563,387,176,386226,175648,561874
261330,201912,989,757,232,757482,232534.63,990016.63
261340,201912,289,165,124,164670,123752,288422
261350,201912,833,596,237,595806.4,236526,832332.4
261360,201912,1295,850,445,850296,447104,1297400
261370,201912,4831,2933,1898,2934123.56,1901191.78,4835315.34
261380,201912,553,417,136,419160.96,136726.4,555887.36
261390,201912,3590,2424,1166,2425140.8,1169656.7,3594797.5
261400,201912,285,260,25,259480,24950,284430
261410,201912,1105,742,363,740516,364270,1104786
261420,201912,878,545,333,544910.47,332334,877244.47
261430,201912,333,298,35,297404,34930,332334
261440,201912,125,115,10,114770,9980,124750
261450,201912,2521,2057,464,2060871.91,464070.4,2524942.31
261460,201912,718,575,143,575846.74,143712,719558.74
261470,201912,243,191,52,191616,52894,244510
261480,201912,441,341,100,341316.6,100754.99,442071.59
261485,201912,344,213,131,212574,131736,344310
261500,201912,603,414,189,413172.94,190618,603790.94
261510,201912,47,30,17,29940,16966,46906
261520,201912,112,98,14,98802,13972,112774
261530,201912,4127,2602,1525,2603783.19,1529934.9,4133718.09
261540,201912,1287,776,511,774448,509978,1284426
261550,201912,266,130,136,129740.4,137724,267464.4
261560,201912,835,553,282,551894.7,281437.38,833332.08
261570,201912,395,312,83,312374,82834,395208
261580,201912,376,292,84,293412,83832,377244
261590,201912,194,156,38,156686,39920,196606
261600,201912,292,235,57,235528,56886,292414
261610,201912,96,82,14,82834,13972,96806
261618,201912,76,61,15,60878,14970,75848
261620,201912,203,124,79,123752,78842,202594
261630,201912,565,442,123,441116,122754,563870
261640,201912,6384,3393,2991,3399191.42,2997992.9,6397184.32
261650,201912,486,309,177,309380,176646,486026
270010,201912,525,467,58,467064,58882,525946
270020,201912,289,231,58,231536.99,57884,289420.99
270030,201912,8781,5684,3097,5751699.4,3121777.12,8873476.52
270040,201912,1988,1252,736,1251525.26,738520,1990045.26
270050,201912,155,118,37,117764,36926,154690
270060,201912,110,62,48,61876,47904,109780
270070,201912,879,643,236,641714,236526.98,878240.98
270080,201912,38,31,7,30938,6986,37924
270090,201912,18,14,4,13972,3992,17964
270100,201912,1214,810,404,808813.44,403192,1212005.44
270110,201912,125,96,29,95808,28942,124750
270120,201912,220,179,41,179640,41916,221556
270130,201912,245,170,75,170658,74850,245508
270135,201912,112,68,44,67864,43912,111776
270140,201912,1370,860,510,860279.35,510976.98,1371256.33
270150,201912,256,201,55,200598,55888,256486
270160,201912,514,398,116,397204,116766,513970
270170,201912,781,511,270,509978,272454,782432
270180,201912,74,57,17,56886,17964,74850
270190,201912,92,81,11,80838,10978,91816
270200,201912,102,90,12,89820,11976,101796
270210,201912,503,284,219,284430,218562,502992
270220,201912,179,143,36,142714,35928,178642
270230,201912,2104,1300,804,1299399.23,803390.98,2102790.21
270235,201912,699,544,155,546907.86,156689.9,703597.76
270240,201912,3090,2446,644,2447097.02,642714.54,3089811.56
270250,201912,159,116,43,115768,42914,158682
270255,201912,207,176,31,176646,30938,207584
270260,201912,360,293,67,294410,66866,361276
270270,201912,97,42,55,41916.98,54890,96806.98
270280,201912,241,134,107,135728,106786,242514
270290,201912,1166,892,274,894208,275448.98,1169656.98
270300,201912,292,200,92,199600,92814,292414
270310,201912,864,710,154,711578.88,154690.98,866269.86
270320,201912,843,723,120,723152.41,119760,842912.41
270330,201912,284,240,44,239520,44910,284430
270340,201912,59,47,12,46906,11976,58882
270350,201912,92,49,43,48902,42914,91816
270360,201912,60,35,25,35928,24950,60878
270370,201912,54,45,9,44910,8982,53892
270375,201912,72,46,26,45908,25948,71856
270380,201912,1013,624,389,623750,389220,1012970
270390,201912,189,112,77,112774,76846,189620
270400,201912,711,525,186,524952.39,188622,713574.39
270410,201912,664,488,176,489020,179640,668660
270420,201912,396,273,123,272454,122754.96,395208.96
270430,201912,32835,23635,9200,23696741.73,9260653,32957394.73
270440,201912,484,382,102,381236,104790,486026
270450,201912,790,442,348,441116,351296,792412
270460,201912,193,154,39,154690,38922,193612
270470,201912,1412,1001,411,1002990.4,416166,1419156.4
270480,201912,540,444,96,443112.8,95808,538920.8
270490,201912,25,20,5,19960,4990,24950
270500,201912,486,405,81,406186,80838,487024
270510,201912,787,486,301,485028,301396,786424
270520,201912,310,197,113,196606,114770,311376
270530,201912,67,58,9,57884,8982,66866
270540,201912,112,88,24,87824,23952,111776
270550,201912,1762,1351,411,1352291.98,411176,1763467.98
270560,201912,276,143,133,142714,132734,275448
270570,201912,498,350,148,350298,149700,499998
270580,201912,95,71,24,70858,23952,94810
270590,201912,68,54,14,53892,13972,67864
270600,201912,176,145,31,144710,31936,176646
270610,201912,208,174,34,173652,33932,207584
270620,201912,30,29,1,28942,998,29940
270630,201912,3755,2866,889,2866259.76,890216.56,3756476.32
270640,201912,875,647,228,647702,227546.9,875248.9
270642,201912,219,186,33,187624,32934,220558
270644,201912,250,164,86,163672.98,85828,249500.98
270650,201912,320,190,130,191616,129740,321356
270660,201912,251,208,43,208582,43912,252494
270670,201912,3052,2344,708,2347898.7,709578.4,3057477.1
270680,201912,451,263,188,262474,188622,451096
270690,201912,1153,748,405,749498,405188,1154686
270700,201912,31,24,7,23952,6986,30938
270710,201912,873,674,199,673650,198603.92,872253.92
270720,201912,246,192,54,192614,53892,246506
270730,201912,1853,1114,739,1111772.8,741516.08,1853288.88
270740,201912,41,28,13,27944,12974,40918
270750,201912,642,483,159,485028.6,160678,645706.6
270760,201912,290,214,76,213572,75848,289420
270770,201912,2758,1801,957,1804387.3,959078.96,2763466.26
270780,201912,77,49,28,48902,28943.98,77845.98
270790,201912,244,161,83,160678,82834,243512
270800,201912,1973,1589,384,1592808.99,385228,1978036.99
270810,201912,288,229,59,228542,58882,287424
270820,201912,148,98,50,97804,49900.8,147704.8
270830,201912,800,590,210,591815.98,210578.99,802394.97
270840,201912,1407,1072,335,1070854,337324.74,1408178.74
270850,201912,1538,953,585,961075,586824,1547899
270860,201912,2515,1671,844,1669889.27,845307.97,2515197.24
270870,201912,128,67,61,67864,60878,128742
270880,201912,900,697,203,699607.74,203597.84,903205.58
270890,201912,304,221,83,220558,82834,303392
270895,201912,65,55,10,55888,9980,65868
270900,201912,95,74,21,73852,20958,94810
270910,201912,310,249,61,248502,61876,310378
270915,201912,1901,1185,716,1186115.51,715577.2,1901692.71
270920,201912,483,407,76,407184,75848,483032
270930,201912,6039,4502,1537,4502990,1541918.95,6044908.95
270940,201912,2327,1809,518,1805382,521954,2327336
280010,201912,40,34,6,33932,5988,39920
280020,201912,465,406,59,406187.12,59880,466067.12
280030,201912,20174,13083,7091,13099790.87,7104776.45,20204567.32
280040,201912,327,214,113,213572,113772,327344
280050,201912,382,292,90,291416,89820,381236
280060,201912,350,227,123,226546.48,122754,349300.48
280067,201912,1038,746,292,746504.49,292414.75,1038919.24
280070,201912,119,98,21,97804,20958,118762
280100,201912,625,489,136,489020.4,135728.6,624749.0
280110,201912,74,69,5,68862,5988,74850
280120,201912,627,516,111,516964,110778,627742
280130,201912,1662,1083,579,1081832,577842.8,1659674.8
280140,201912,474,389,85,388222,85828,474050
280150,201912,385,277,108,277444,107784,385228
280160,201912,95,81,14,81836,13972,95808
280170,201912,397,269,128,268462,127744,396206
280190,201912,29,27,2,26946,1996,28942
280200,201912,27,23,4,22954,3992,26946
280210,201912,2893,2085,808,2087820.37,812372.8,2900193.17
280220,201912,41,33,8,32934,7984,40918
280230,201912,325,267,58,266466,57884,324350
280240,201912,116,110,6,109780,5988,115768
280250,201912,16,10,6,9980,5988,15968
280260,201912,81,72,9,72854,8982,81836
280270,201912,150,117,33,116766,32934,149700
280280,201912,189,120,69,119760.85,69860,189620.85
280290,201912,3321,2416,905,2416095.77,906184.64,3322280.41
280300,201912,1596,1239,357,1239516.4,356286,1595802.4
280310,201912,102,98,4,97804.8,3992,101796.8
280320,201912,661,460,201,462074,200598,662672
280330,201912,335,240,95,239520,94810,334330
280340,201912,400,325,75,326346,74850,401196
280350,201912,3596,2799,797,2800393.22,799398.7,3599791.92
280360,201912,458,301,157,300398,156686,457084
280370,201912,97,86,11,85828.06,10978,96806.06
280380,201912,55,43,12,42914,11976,54890
280390,201912,174,150,24,149700,23952,173652
280400,201912,348,237,111,236527.36,111776,348303.36
280410,201912,288,235,53,234530.6,52894,287424.6
280420,201912,169,142,27,141716,26946,168662
280430,201912,34,25,9,24950,8982,33932
280440,201912,690,540,150,538921.46,151696,690617.46
280445,201912,120,109,11,108782,10978,119760
280450,201912,1172,1009,163,1009976,162674,1172650
280460,201912,617,453,164,452094.7,163672,615766.7
280470,201912,188,174,14,173652,13972.7,187624.7
280480,201912,2549,1791,758,1790414.76,758481.62,2548896.38
280490,201912,271,254,17,253492.15,16966,270458.15
280500,201912,39,36,3,35928,2994,38922
280510,201912,137,110,27,110778,26946.4,137724.4
280520,201912,54,39,15,38922,14970,53892
280530,201912,73,47,26,46906,25948,72854
280540,201912,526,434,92,433132.7,92814,525946.7
280550,201912,727,671,56,670658.4,55888,726546.4
280560,201912,493,435,58,435128,57884,493012
280570,201912,2207,1725,482,1723547.78,482034,2205581.78
280580,201912,605,471,134,470060.19,136726.8,606786.99
280590,201912,184,115,69,114770,68862,183632
280600,201912,391,328,63,327344,62874,390218
280610,201912,124,94,30,93812,29940,123752
280620,201912,551,454,97,455088,96806,551894
280630,201912,148,124,24,123752,23952,147704
280640,201912,186,150,36,149700.96,35928,185628.96
280650,201912,90,61,29,60878,28942,89820
280660,201912,141,107,34,106786,33932,140718
280670,201912,1789,1127,662,1128743.35,662672.86,1791416.21
280680,201912,170,149,21,148702.29,20958,169660.29
280690,201912,83,73,10,73852,9980,83832
280700,201912,23,23,0,22954,0,22954
280710,201912,1459,1123,336,1123748.6,336326,1460074.6
280720,201912,113,74,39,73852,39920,113772
280730,201912,26,21,5,20958,4990,25948
280740,201912,2504,1871,633,1873246.8,632732,2505978.8
280750,201912,222,194,28,193612,27944,221556
280760,201912,752,516,236,516964,236526,753490
290010,201912,204,142,62,142714,61876,204590
290020,201912,180,165,15,164670,14970,179640
290030,201912,613,397,216,396206,215568,611774
290035,201912,128,103,25,102794,24950,127744
290040,201912,299,201,98,200598,97804,298402
290050,201912,87,67,20,67864,19960,87824
290060,201912,262,120,142,119760,142714,262474
290070,201912,5686,2812,2874,2814362.42,2881229.84,5695592.26
290080,201912,474,217,257,221556.96,256486.96,478043.92
290090,201912,386,175,211,175648,211576,387224
290100,201912,1633,1076,557,1074847.2,556884.4,1631731.6
290110,201912,820,488,332,492015.12,334330.99,826346.11
290115,201912,200,186,14,187624,13972,201596
290120,201912,760,503,257,502992.63,258482,761474.63
290130,201912,427,263,164,263472,163672,427144
290135,201912,296,226,70,225548,69860,295408
290140,201912,311,256,55,256486,54890,311376
290150,201912,136,100,36,99800,35928,135728
290160,201912,235,178,57,178642,56886,235528
290170,201912,91,66,25,65868,24950,90818
290180,201912,176,130,46,131736.6,45908,177644.6
290190,201912,437,357,80,357284,79840,437124
290195,201912,307,198,109,197604,108782,306386
290200,201912,274,222,52,221556,51896,273452
290205,201912,148,91,57,90818,56886,147704
290210,201912,1157,853,304,851294.4,306386,1157680.4
290220,201912,220,122,98,121756,97804,219560
290225,201912,288,113,175,112774,174650,287424
290230,201912,72,48,24,47904,23952,71856
290240,201912,341,135,206,134730,205588,340318
290250,201912,260,240,20,239520,19960,259480
290260,201912,311,253,58,254490.4,57884,312374.4
290265,201912,190,162,28,161676,27944,189620
290270,201912,1426,1186,240,1185624.5,241517.36,1427141.86
290280,201912,470,336,134,337324.98,133732,471056.98
290290,201912,1288,768,520,766464.94,519958.8,1286423.74
290300,201912,443,377,66,376246.4,65868,442114.4
290310,201912,303,137,166,136726,165668,302394
290320,201912,4085,2543,1542,2543902.57,1542909.24,4086811.81
290323,201912,193,169,24,168662,23952,192614
290327,201912,164,131,33,133732,32934,166666
290330,201912,99,55,44,54890,43912,98802
290340,201912,854,348,506,349300,504988,854288
290350,201912,619,376,243,376246.4,243512,619758.4
290360,201912,363,278,85,279440.97,84830,364270.97
290370,201912,921,388,533,387224,532932.97,920156.97
290380,201912,320,198,122,197604,121756,319360
290390,201912,2463,1548,915,1550894.9,918160,2469054.9
290395,201912,253,146,107,146706.5,106786,253492.5
290400,201912,275,207,68,206587,68862,275449
290405,201912,250,216,34,215568,33932,249500
290410,201912,633,530,103,531934.55,102794,634728.55
290420,201912,252,204,48,203592,48902,252494
290430,201912,478,310,168,311376,168662,480038
290440,201912,72,65,7,64870,6986,71856
290450,201912,204,159,45,158682,44910,203592
290460,201912,1933,1176,757,1175653.8,760477.84,1936131.64
290470,201912,1415,607,808,606793.8,809394.66,1416188.46
290475,201912,573,534,39,532932.68,38922,571854.68
290480,201912,284,157,127,158682,126746,285428
290485,201912,244,226,18,227544,18962,246506
290490,201912,1215,880,335,880236,337324,1217560
290500,201912,727,378,349,378242,348302,726544
290510,201912,227,177,50,176646,49900,226546
290515,201912,147,93,54,92814,53892,146706
290520,201912,1437,956,481,958081,483032.73,1441113.73
290530,201912,303,280,23,281436,22954,304390
290540,201912,100,54,46,53892,45908,99800
290550,201912,152,126,26,125748,25948,151696
290560,201912,3219,1356,1863,1359276,1861272.92,3220548.92
290570,201912,6104,3020,3084,3021950.49,3084824.94,6106775.43
290580,201912,1297,776,521,775446,522952,1298398
290590,201912,567,468,99,467064,99800,566864
290600,201912,1753,1210,543,1208579.02,542912,1751491.02
290610,201912,207,186,21,185628.54,20958,206586.54
290620,201912,351,313,38,313372,37924,351296
290630,201912,2007,855,1152,856284,1150695.38,2006979.38
290640,201912,155,125,30,124750,29940,154690
290650,201912,1737,811,926,813370.69,926144,1739514.69
290660,201912,276,225,51,225548,50898,276446
290670,201912,937,489,448,491016.88,449100,940116.88
290680,201912,1240,1000,240,998000,240518,1238518
290682,201912,307,229,78,228543.24,77844,306387.24
290685,201912,239,154,85,153692,84830,238522
290687,201912,1023,657,366,658842.96,366266,1025108.96
290689,201912,142,76,66,75848.97,65868,141716.97
290690,201912,608,259,349,258482.98,349304.84,607787.82
290700,201912,245,119,126,118762,125748,244510
290710,201912,717,487,230,487024,229540,716564
290720,201912,1033,842,191,843310,191616,1034926
290730,201912,1146,663,483,663670.7,483032,1146702.7
290740,201912,16,14,2,13972,1996,15968
290750,201912,1405,629,776,629738,777445.28,1407183.28
290755,201912,73,65,8,64870,7984,72854
290760,201912,297,258,39,257484,38922,296406
290770,201912,188,177,11,180638,10978.4,191616.4
290780,201912,1081,835,246,834331.74,246506,1080837.74
290790,201912,366,253,113,254490,112774.4,367264.4
290800,201912,2541,1020,1521,1019956.98,1524944,2544900.98
290810,201912,465,323,142,322354,141716,464070
290820,201912,402,238,164,237524,163672,401196
290830,201912,408,293,115,292414,115768,408182
290840,201912,1740,1089,651,1089817.28,650696.8,1740514.08
290850,201912,813,444,369,446106,371256,817362
290860,201912,624,287,337,288422,340318.4,628740.4
290870,201912,638,450,188,450098.64,187624.84,637723.48
290880,201912,122,67,55,66866,54890,121756
290890,201912,373,259,114,258482,115768,374250
290900,201912,166,128,38,127744,37924,165668
290910,201912,386,301,85,300398,84830,385228
290920,201912,217,186,31,186626,30938,217564
290930,201912,836,635,201,635726.4,201596.96,837323.36
290940,201912,247,205,42,204590,41916,246506
290950,201912,154,94,60,93812,59880,153692
290960,201912,477,332,145,331336,144710,476046
290970,201912,250,221,29,222554,29940,252494
290980,201912,1607,1142,465,1141713.08,467065.2,1608778.28
290990,201912,394,336,58,337326.94,58885.92,396212.86
291000,201912,861,250,611,249500,611774,861274
291005,201912,2267,1009,1258,1009976.8,1258478,2268454.8
291010,201912,155,142,13,141716,12974,154690
291020,201912,102,80,22,79840,21956,101796
291030,201912,97,71,26,70858,25948,96806
291040,201912,594,327,267,327344,266466,593810
291050,201912,1424,784,640,784428.96,640716,1425144.96
291060,201912,1534,851,683,854288,686624,1540912
291070,201912,1973,1464,509,1462071.98,507983.78,1970055.76
291072,201912,7252,2710,4542,2712565.82,4547889.4,7260455.22
291075,201912,232,191,41,190618.6,40918,231536.6
291077,201912,53,37,16,36926,15968,52894
291080,201912,20167,8936,11231,8949074.05,11249462.74,20198536.79
291085,201912,298,245,53,244510,52894,297404
291090,201912,304,120,184,119760.4,183632,303392.4
291100,201912,663,199,464,198602,463072,661674
291110,201912,424,319,105,318362,104790,423152
291120,201912,2441,1205,1236,1205584.7,1239516.99,2445101.69
291125,201912,65,30,35,29940,34930,64870
291130,201912,205,182,23,181636,22954,204590
291140,201912,143,114,29,113772,28942.4,142714.4
291150,201912,386,148,238,151696,237524,389220
291160,201912,389,322,67,322354.5,66866,389220.5
291165,201912,34,29,5,28942,4990,33932
291170,201912,3109,1560,1549,1563868.07,1549894.4,3113762.47
291180,201912,1266,504,762,505988.78,763472.88,1269461.66
291185,201912,84,81,3,80838,2994,83832
291190,201912,1334,592,742,591814.5,741514,1333328.5
291200,201912,167,126,41,125748.4,40918,166666.4
291210,201912,2261,908,1353,909179.08,1356282.4,2265461.48
291220,201912,277,209,68,209580,67864,277444
291230,201912,994,353,641,353292.4,639718,993010.4
291240,201912,425,400,25,401196.4,24950,426146.4
291250,201912,446,363,83,362274,82834,445108
291260,201912,54,44,10,43912,10978,54890
291270,201912,1160,484,676,483032,675646,1158678
291280,201912,364,173,191,172654,191616,364270
291290,201912,1728,891,837,893210.4,837323,1730533.4
291300,201912,231,182,49,181636,48902,230538
291310,201912,225,206,19,208582,18962,227544
291320,201912,1378,981,397,983030,397204,1380234
291330,201912,131,112,19,111776,18962,130738
291340,201912,199,113,86,112774,85828,198602
291345,201912,139,95,44,94810,43912,138722
291350,201912,1638,582,1056,580836,1055884.7,1636720.7
291360,201912,8456,4138,4318,4144698.46,4325335.46,8470033.92
291370,201912,1132,639,493,641714.4,492014.98,1133729.38
291380,201912,257,203,54,203592,54890,258482
291390,201912,3882,1712,2170,1714565.44,2173644.8,3888210.24
291400,201912,2075,1486,589,1488018,590816.81,2078834.81
291410,201912,187,165,22,164670,21956,186626
291420,201912,119,87,32,86826,31936,118762
291430,201912,162,87,75,86826,75848.11,162674.11
291440,201912,526,431,95,431136.8,94810,525946.8
291450,201912,904,582,322,582832.5,323352,906184.5
291460,201912,1825,1495,330,1494007.6,331336.4,1825344.0
291465,201912,2174,1037,1137,1039929.9,1135736.6,2175666.5
291470,201912,2860,1446,1414,1446102.71,1415164.4,2861267.11
291480,201912,11809,5262,6547,5269466.11,6553985.76,11823451.87
291490,201912,586,242,344,242514,343312,585826
291500,201912,377,220,157,220558,158682,379240
291510,201912,1230,475,755,475048,754488,1229536
291520,201912,946,433,513,433132,513970,947102
291530,201912,956,266,690,267464,690616,958080
291535,201912,124,103,21,103792,20958,124750
291540,201912,342,102,240,102794.4,239520.2,342314.6
291550,201912,1215,577,638,578841.2,636725.38,1215566.58
291560,201912,5318,2695,2623,2709659.12,2629892.09,5339551.21
291570,201912,198,102,96,101796,95808,197604
291580,201912,1226,761,465,761475.41,468062,1229537.41
291590,201912,85,34,51,33932,50898,84830
291600,201912,1156,575,581,574848,579839.96,1154687.96
291610,201912,1465,716,749,716564,751495.58,1468059.58
291620,201912,580,267,313,267464,313372,580836
291630,201912,478,149,329,148702,328342,477044
291640,201912,3953,2021,1932,2025944.2,1934135.98,3960080.18
291650,201912,416,287,129,286427.15,128742,415169.15
291660,201912,401,160,241,159680.63,240518,400198.63
291670,201912,219,137,82,136726,81836,218562
291680,201912,663,391,272,391216,272454.8,663670.8
291685,201912,590,329,261,328342,261476,589818
291690,201912,547,316,231,315368,230539.86,545907.86
291700,201912,960,755,205,757482,204590,962072
291710,201912,1662,807,855,807382.5,857282,1664664.5
291720,201912,419,281,138,282434,137724,420158
291730,201912,942,557,385,556884,386226,943110
291733,201912,284,196,88,195608,87824,283432
291735,201912,73,55,18,54890,17964,72854
291740,201912,357,278,79,277444,78842,356286
291750,201912,2102,1374,728,1375245.3,727542,2102787.3
291760,201912,2997,1657,1340,1653686,1343308,2996994
291770,201912,789,533,256,531939.97,255488,787427.97
291780,201912,59,36,23,35928,22954,58882
291790,201912,162,80,82,79840,81836,161676
291800,201912,10044,4149,5895,4153678.51,5895189.08,10048867.59
291810,201912,1111,821,290,821354.4,290418.6,1111773.0
291820,201912,275,198,77,199600,76846,276446
291830,201912,1108,445,663,444110.98,661674.98,1105785.96
291835,201912,578,536,42,537922,41916,579838
291840,201912,4849,2480,2369,2493005.35,2369252.4,4862257.75
291845,201912,273,92,181,92814,181636,274450
291850,201912,325,289,36,288422,35928,324350
291855,201912,260,103,157,102794,157684,260478
291860,201912,167,107,60,106786,59880,166666
291870,201912,85,34,51,33932,50898,84830
291875,201912,180,167,13,166666,12974,179640
291880,201912,469,376,93,375248.6,93812,469060.6
291890,201912,238,76,162,75848,161676.4,237524.4
291900,201912,57,32,25,31936,24950,56886
291905,201912,127,93,34,92814.4,33932,126746.4
291910,201912,165,135,30,135728,29940,165668
291915,201912,425,377,48,377244.5,47904,425148.5
291920,201912,5034,2579,2455,2583823.58,2456078.4,5039901.98
291930,201912,176,104,72,103792.12,71856,175648.12
291940,201912,360,204,156,203592,155688,359280
291950,201912,1146,930,216,928140.4,215568,1143708.4
291955,201912,1249,747,502,747502.57,503990,1251492.57
291960,201912,184,134,50,133732,49900,183632
291970,201912,772,586,186,584828,185628,770456
291980,201912,1521,1347,174,1350295.38,174650.4,1524945.78
291990,201912,131,121,10,122754,9980,132734
291992,201912,172,86,86,85828,86826,172654
291995,201912,166,110,56,109780,55888,165668
292000,201912,388,303,85,302394.4,84830,387224.4
292010,201912,303,214,89,213572,89820,303392
292020,201912,293,213,80,212574,79840,292414
292030,201912,149,114,35,113772,35928,149700
292040,201912,631,318,313,317364,314370,631734
292045,201912,103,96,7,95808,6986,102794
292050,201912,949,693,256,691614,255488.4,947102.4
292060,201912,918,767,151,767462.86,153692,921154.86
292070,201912,51,19,32,19960,31936,51896
292080,201912,141,98,43,97804,42914,140718
292090,201912,535,191,344,192614,344310,536924
292100,201912,1461,631,830,633730.6,830336.98,1464067.58
292105,201912,202,174,28,174650,27944,202594
292110,201912,2257,838,1419,844308,1419161.86,2263469.86
292120,201912,695,551,144,552892,144710,697602
292130,201912,446,257,189,257484,188622,446106
292140,201912,207,167,40,166666,40918,207584
292145,201912,162,88,74,88822.4,74850,163672.4
292150,201912,1481,1206,275,1203588,274450,1478038
292160,201912,172,142,30,141716,29940,171656
292170,201912,1208,1054,154,1054886,154690,1209576
292180,201912,215,157,58,157684,59880,217564
292190,201912,163,104,59,103792,58882,162674
292200,201912,1320,490,830,491016.96,831334.4,1322351.36
292205,201912,126,112,14,111776,13972,125748
292210,201912,363,257,106,256486,105788,362274
292220,201912,26,20,6,19960,5988,25948
292225,201912,40,35,5,34930,4990,39920
292230,201912,973,779,194,783430.3,193612,977042.3
292240,201912,622,449,173,448102.7,172654,620756.7
292250,201912,1749,1155,594,1154686,593810,1748496
292260,201912,418,250,168,249500,168662,418162
292265,201912,252,179,73,178642,72854,251496
292270,201912,733,336,397,335328,396206.6,731534.6
292273,201912,196,110,86,110778,85828,196606
292275,201912,177,86,91,87824,91816,179640
292280,201912,142,101,41,100798,40918,141716
292285,201912,71,60,11,59880,10978,70858
292290,201912,570,391,179,390218,178642.4,568860.4
292300,201912,1674,637,1037,636724.4,1038918.72,1675643.12
292303,201912,107,71,36,72854,36926,109780
292305,201912,114,85,29,84830,29940,114770
292310,201912,906,599,307,600797.24,308382.56,909179.80
292320,201912,603,458,145,457084,144710,601794
292330,201912,176,102,74,101796,73852,175648
292335,201912,281,219,62,221556,61876,283432
292340,201912,573,403,170,402194.4,169660,571854.4
292350,201912,270,144,126,143712,125748,269460
292360,201912,706,537,169,538920.56,168662,707582.56
292370,201912,752,578,174,577842,173652,751494
292380,201912,648,518,130,516964.54,129740,646704.54
292390,201912,485,194,291,194610,290418,485028
292400,201912,3569,2212,1357,2216561.63,1357281,3573842.63
292405,201912,260,174,86,173652,86826,260478
292410,201912,144,87,57,86826,56886,143712
292420,201912,290,250,40,250498,39920,290418
292430,201912,523,409,114,408182,113772,521954
292440,201912,585,503,82,503990.44,82834,586824.44
292450,201912,254,199,55,199600,54890,254490
292460,201912,556,415,141,415168.98,140718,555886.98
292465,201912,213,177,36,176646,36926,213572
292467,201912,116,69,47,69860,46906,116766
292470,201912,284,193,91,192614,90818,283432
292480,201912,358,245,113,244510,113772.4,358282.4
292490,201912,236,165,71,164670,70858,235528
292500,201912,871,388,483,388223.72,483032,871255.72
292510,201912,3426,1582,1844,1581830.44,1843307.18,3425137.62
292520,201912,1086,509,577,511974.99,580836.98,1092811.97
292525,201912,401,281,120,281436.31,119760,401196.31
292530,201912,4367,1777,2590,1782431.73,2594806.48,4377238.21
292540,201912,460,261,199,260478,198602,459080
292550,201912,1068,576,492,578852.52,493022.58,1071875.10
292560,201912,326,306,20,305388,19960,325348
292570,201912,305,236,69,236526,68862,305388
292575,201912,494,322,172,321356.4,171656.4,493012.8
292580,201912,978,650,328,651694,328342.4,980036.4
292590,201912,554,486,68,486026,67864,553890
292593,201912,140,111,29,110778,28942,139720
292595,201912,194,151,43,150698,42914,193612
292600,201912,1250,916,334,917162.63,335328,1252490.63
292610,201912,131,100,31,99800,30938,130738
292620,201912,523,443,80,445108.4,80838,525946.4
292630,201912,1413,799,614,801394.67,612772.27,1414166.94
292640,201912,809,555,254,554888,253492,808380
292650,201912,182,154,28,153692.4,28942,182634.4
292660,201912,2037,1468,569,1470054,568860.74,2038914.74
292665,201912,145,107,38,106786,38922,145708
292670,201912,396,325,71,324350.99,70858,395208.99
292680,201912,255,195,60,194610,59880,254490
292690,201912,191,146,45,145708,44910,190618
292700,201912,952,633,319,632732,318362,951094
292710,201912,111,98,13,97804,12974,110778
292720,201912,914,524,390,522952,390218,913170
292730,201912,196,93,103,92814,102794,195608
292740,201912,68179,33609,34570,33812273.59,34852201.58,68664475.17
292750,201912,388,277,111,277444.78,110778,388222.78
292760,201912,334,278,56,278442.78,55888,334330.78
292770,201912,798,348,450,347304.4,452094,799398.4
292780,201912,407,159,248,158682,247504,406186
292790,201912,758,387,371,386226,372254,758480
292800,201912,1249,749,500,750496,499000,1249496
292805,201912,399,119,280,118762,282434,401196
292810,201912,1498,854,644,853291.2,643710.98,1497002.18
292820,201912,722,596,126,595807.5,125748.98,721556.48
292830,201912,106,88,18,87824,17964,105788
292840,201912,688,567,121,567862.6,121756,689618.6
292850,201912,138,94,44,93812,43912,137724
292860,201912,2169,1270,899,1269456.4,900196.6,2169653.0
292870,201912,3457,2323,1134,2331331.53,1138718.8,3470050.33
292880,201912,1487,981,506,987022.82,505986,1493008.82
292890,201912,518,443,75,443113.94,74850,517963.94
292895,201912,140,91,49,90818,48902,139720
292900,201912,392,281,111,283432.76,110778,394210.76
292905,201912,475,243,232,242514,232534,475048
292910,201912,446,342,104,345308.3,103792,449100.3
292920,201912,513,230,283,232534,283432,515966
292925,201912,487,449,38,450098,37924,488022
292930,201912,602,365,237,367264,236526,603790
292935,201912,286,124,162,123752,161676.98,285428.98
292937,201912,233,163,70,162674,70858,233532
292940,201912,193,151,42,150698,41916,192614
292950,201912,1141,584,557,585827.9,556884.6,1142712.5
292960,201912,598,424,174,423152,173652,596804
292970,201912,246,176,70,176646,69860,246506
292975,201912,127,72,55,71856,54890.6,126746.6
292980,201912,281,190,91,189620.76,90818,280438.76
292990,201912,1327,989,338,989019.5,338322,1327341.5
293000,201912,110,77,33,76846,32934,109780
293010,201912,2770,1669,1101,1670652.3,1102790.99,2773443.29
293015,201912,648,525,123,527942,125748,653690
293020,201912,331,272,59,272454,58882,331336
293030,201912,598,522,76,520956.8,75848,596804.8
293040,201912,354,283,71,284430,71856,356286
293050,201912,2848,1697,1151,1694604.4,1148699.98,2843304.38
293060,201912,261,212,49,212574.58,48902,261476.58
293070,201912,3452,1766,1686,1769456.89,1692610.98,3462067.87
293075,201912,91,60,31,60878,30938,91816
293076,201912,71,49,22,48902,21956,70858
293077,201912,494,291,203,293412.4,202594,496006.4
293080,201912,438,393,45,392214.74,44910,437124.74
293090,201912,136,120,16,119760,15968,135728
293100,201912,527,371,156,371256,155688,526944
293105,201912,348,248,100,249500,100798,350298
293110,201912,171,123,48,122754,47904,170658
293120,201912,325,225,100,224550.45,101796,326346.45
293130,201912,244,168,76,167664,75848,243512
293135,201912,7986,3149,4837,3147709.78,4833361.74,7981071.52
293140,201912,203,134,69,133732.6,68862,202594.6
293150,201912,332,287,45,287424,46906,334330
293160,201912,418,242,176,243512,176646,420158
293170,201912,173,120,53,120758,52894,173652
293180,201912,492,352,140,351296.4,140718,492014.4
293190,201912,1340,936,404,936124.7,406186,1342310.7
293200,201912,544,483,61,483032,60878,543910
293210,201912,392,300,92,299400,91816,391216
293220,201912,2515,1062,1453,1064866,1459076,2523942
293230,201912,1701,631,1070,631734.35,1068858,1700592.35
293240,201912,229,212,17,212574,16966,229540
293245,201912,121,102,19,101796,18962,120758
293250,201912,708,254,454,256486.67,453092,709578.67
293260,201912,295,247,48,247504,47904,295408
293270,201912,1157,544,613,545906.68,612772,1158678.68
293280,201912,262,145,117,145708,116766,262474
293290,201912,3021,1985,1036,1990012,1044907.97,3034919.97
293300,201912,719,517,202,519959.67,202594,722553.67
293305,201912,183,149,34,148702,33932,182634
293310,201912,147,112,35,111776,34930,146706
293315,201912,163,127,36,126746,35928,162674
293317,201912,94,69,25,68862,24950,93812
293320,201912,1037,587,450,588820.7,452094,1040914.7
293325,201912,182,67,115,67864,114770,182634
293330,201912,13495,6387,7108,6394188.72,7122731.82,13516920.54
293340,201912,266,191,75,190618,74850,265468
293345,201912,247,201,46,200598,45908,246506
293350,201912,612,353,259,354290.4,258482,612772.4
293360,201912,1543,1103,440,1102790,439120,1541910
310010,201912,138,75,63,74850,62874.4,137724.4
310020,201912,1030,575,455,580836.4,456086.44,1036922.84
310030,201912,334,270,64,270458.2,63872,334330.2
310040,201912,45,31,14,31936,14970,46906
310050,201912,186,118,68,117764,67864,185628
310060,201912,240,171,69,171656,69860,241516
310070,201912,13,8,5,7984,4990,12974
310080,201912,45,26,19,26946,18962,45908
310090,201912,990,520,470,518962,473052.8,992014.8
310100,201912,300,228,72,228542,71856,300398
310110,201912,721,394,327,393212,326346.4,719558.4
310120,201912,370,215,155,215568,154690,370258
310130,201912,32,20,12,19960,11976,31936
310140,201912,24,13,11,12974,10978,23952
310150,201912,1225,841,384,842313.6,387224.8,1229538.4
310160,201912,2045,1027,1018,1031932.7,1019956.8,2051889.5
310163,201912,87,51,36,50898,35928,86826
310170,201912,2540,1144,1396,1149697.14,1402191.6,2551888.74
310180,201912,135,52,83,51896.4,82834,134730.4
310190,201912,472,331,141,330338,140718,471056
310200,201912,495,317,178,316366.4,177644,494010.4
310205,201912,51,36,15,35928,14970,50898
310210,201912,280,226,54,226546,54890,281436
310220,201912,57,33,24,32934,23952,56886
310230,201912,273,190,83,189620,82834,272454
310240,201912,104,95,9,94810,8982,103792
310250,201912,101,81,20,81836,19960,101796
310260,201912,765,411,354,412176.04,355288,767464.04
310270,201912,269,176,93,175648.44,92814,268462.44
310280,201912,377,278,99,277444,99800,377244
310285,201912,210,151,59,150698,58882,209580
310290,201912,245,134,111,133732,110778,244510
310300,201912,151,124,27,123752,26946,150698
310310,201912,9,7,2,6986,1996,8982
310320,201912,28,13,15,12974,14970,27944
310330,201912,35,25,10,24950,9980,34930
310340,201912,1746,1160,586,1158679.8,586824.4,1745504.2
310350,201912,2809,1525,1284,1527938,1285424,2813362
310360,201912,41,34,7,33932,6986,40918
310370,201912,115,98,17,97804,16966.4,114770.4
310375,201912,104,39,65,38922,64870.96,103792.96
310380,201912,49,28,21,27944,20958,48902
310390,201912,93,63,30,62874,29940,92814
310400,201912,2352,1539,813,1542908.8,813370,2356278.8
310410,201912,125,73,52,72854,51896,124750
310420,201912,675,359,316,358282.6,316366.2,674648.8
310430,201912,317,207,110,206586,109780,316366
310440,201912,74,44,30,44910,29940,74850
310445,201912,80,67,13,66866,12974,79840
310450,201912,634,385,249,384230.96,248502,632732.96
310460,201912,257,184,73,183632,73852,257484
310470,201912,505,323,182,325348,183632,508980
310480,201912,74,55,19,55888,18962,74850
310490,201912,536,256,280,255488,281436,536924
310500,201912,131,53,78,52894,77844,130738
310510,201912,603,417,186,418162,186626.98,604788.98
310520,201912,131,93,38,92814,37924,130738
310530,201912,99,41,58,40918,57884,98802
310540,201912,452,269,183,271456.6,183632,455088.6
310550,201912,81,52,29,51896,28942,80838
310560,201912,2990,2064,926,2065863.44,925146,2991009.44
310570,201912,103,69,34,68862,33932,102794
310590,201912,363,235,128,234530.5,128742,363272.5
310600,201912,152,82,70,83832.4,69860,153692.4
310610,201912,59,23,36,22954,35928,58882
310620,201912,46954,22605,24349,22665532.97,24415086.75,47080619.72
310630,201912,632,404,228,403192,228542.4,631734.4
310640,201912,142,110,32,111776,31936,143712
310650,201912,162,144,18,143712,17964,161676
310660,201912,95,62,33,61876,32934,94810
310665,201912,61,45,16,44910,15968,60878
310670,201912,6587,2913,3674,2922150.1,3674660.32,6596810.42
310680,201912,57,36,21,35928,21956,57884
310690,201912,598,420,178,420158.2,177644,597802.2
310700,201912,57,39,18,38922,17964,56886
310710,201912,1334,920,414,919159.38,416166.4,1335325.78
310720,201912,116,35,81,34930,80838,115768
310730,201912,1422,999,423,1002990.9,426146.4,1429137.3
310740,201912,974,542,432,544908.8,431136.5,976045.3
310750,201912,243,146,97,145708.66,96806,242514.66
310760,201912,62,44,18,43912,17964.4,61876.4
310770,201912,100,48,52,47904,51896,99800
310780,201912,366,298,68,301396.98,69860,371256.98
310790,201912,99,81,18,80838,17964,98802
310800,201912,456,220,236,219560.5,236526,456086.5
310810,201912,170,123,47,122754.9,46906,169660.9
310820,201912,349,277,72,277444,71856,349300
310825,201912,194,165,29,164670,28942,193612
310830,201912,466,227,239,226546.4,239520,466066.4
310840,201912,364,214,150,213572,149700,363272
310850,201912,108,87,21,86826,20958,107784
310855,201912,392,310,82,311376,81836,393212
310860,201912,1594,1180,414,1180636.91,415168.7,1595805.61
310870,201912,53,44,9,43912,8982,52894
310880,201912,84,65,19,65868,18962,84830
310890,201912,306,179,127,178642,126746,305388
310900,201912,650,299,351,298411.96,351309.92,649721.88
310910,201912,239,164,75,163672.6,74850,238522.6
310920,201912,459,272,187,272455.28,187624.2,460079.48
310925,201912,34,27,7,26946,6986.4,33932.4
310930,201912,1325,837,488,835340.85,489029.9,1324370.75
310940,201912,682,348,334,347304,333332,680636
310945,201912,122,76,46,75848,45908,121756
310950,201912,245,197,48,196606,47904,244510
310960,201912,79,28,51,27944,50898.99,78842.99
310970,201912,159,101,58,100798,57884.4,158682.4
310980,201912,45,29,16,28942,15968,44910
310990,201912,150,81,69,80838,69860,150698
311000,201912,799,405,394,406187.37,396207.38,802394.75
311010,201912,46,39,7,38922,6986,45908
311020,201912,44,28,16,27944,15968,43912
311030,201912,390,227,163,227544,162674,390218
311040,201912,43,36,7,35928,6986,42914
311050,201912,477,193,284,192614.8,284430,477044.8
311060,201912,778,436,342,437124,341316.4,778440.4
311070,201912,345,160,185,160678,186626,347304
311080,201912,108,58,50,57884,49900,107784
311090,201912,343,163,180,162674,179640,342314
311100,201912,595,359,236,360278,236526,596804
311110,201912,690,483,207,482034,206586,688620
311115,201912,78,56,22,55888,21956,77844
311120,201912,1083,582,501,580836.4,501994,1082830.4
311130,201912,371,222,149,221556,150698,372254
311140,201912,165,90,75,89820,74850,164670
311150,201912,354,234,120,233532,120758,354290
311160,201912,704,506,198,505986.4,197604,703590.4
311170,201912,83,67,16,66866,15968,82834
311180,201912,333,225,108,228542,107784.4,336326.4
311190,201912,36,19,17,18962,16966,35928
311200,201912,323,228,95,228542,95808,324350
311205,201912,33,23,10,22954,9980,32934
311210,201912,46,41,5,40918.4,5988,46906.4
311220,201912,21,19,2,18962,1996,20958
311230,201912,1635,1080,555,1080835,555886,1636721
311240,201912,180,115,65,114770,64870,179640
311250,201912,96,28,68,27944,67864,95808
311260,201912,555,350,205,351296,204590,555886
311265,201912,122,83,39,83832,38922,122754
311270,201912,291,196,95,195608,94810,290418
311280,201912,214,100,114,99800,113772,213572
311290,201912,106,87,19,86826,18962,105788
311300,201912,585,368,217,371256,216566,587822
311310,201912,22,17,5,16966,4990,21956
311320,201912,665,493,172,494010,172654,666664
311330,201912,1103,814,289,815366,290418.8,1105784.8
311340,201912,2600,1848,752,1852288.8,756484.98,2608773.78
311350,201912,278,215,63,214570,62874,277444
311360,201912,175,109,66,108782,65868,174650
311370,201912,1201,500,701,499998.5,702592,1202590.5
311380,201912,7,6,1,5988,998,6986
311390,201912,263,146,117,145708,116766,262474
311400,201912,141,92,49,91816,48902,140718
311410,201912,105,57,48,56886,47904,104790
311420,201912,305,169,136,168662.6,136726,305388.6
311430,201912,854,567,287,568860.5,286426.4,855286.9
311440,201912,466,330,136,331336,135728,467064
311450,201912,317,199,118,198602,117764,316366
311455,201912,285,193,92,193612,91816,285428
311460,201912,143,62,81,61876,80838,142714
311470,201912,22,13,9,12974,8982,21956
311480,201912,46,20,26,19960,25948,45908
311490,201912,15,10,5,9980,4990,14970
311500,201912,24,10,14,9980,13972,23952
311510,201912,632,441,191,445108,190618,635726
311520,201912,40,32,8,32934,7984,40918
311530,201912,1800,1337,463,1337321.88,463072,1800393.88
311535,201912,69,49,20,48902,19960,68862
311540,201912,35,30,5,29940,4990,34930
311545,201912,183,136,47,135728,46906,182634
311547,201912,35,29,6,28942,5988.96,34930.96
311550,201912,684,323,361,322354,362274.98,684628.98
311560,201912,43,29,14,28942,13972,42914
311570,201912,286,194,92,193612,91816,285428
311580,201912,328,196,132,195608,131736,327344
311590,201912,33,30,3,29940,2994,32934
311600,201912,103,81,22,80838,21956,102794
311610,201912,255,221,34,221556.5,33932,255488.5
311615,201912,67,56,11,55888,10978,66866
311620,201912,27,14,13,13972,12974,26946
311630,201912,84,70,14,69860,13972,83832
311640,201912,130,67,63,66866,62874,129740
311650,201912,127,89,38,88822,37924,126746
311660,201912,408,198,210,198602,209580,408182
311670,201912,154,102,52,101797.28,52894,154691.28
311680,201912,205,153,52,153692,52894,206586
311690,201912,13,9,4,8982,3992,12974
311700,201912,198,140,58,139720,57884,197604
311710,201912,202,132,70,131736,69860,201596
311720,201912,37,27,10,26946.4,9980,36926.4
311730,201912,581,390,191,390218,191616,581834
311740,201912,35,25,10,25948,9980,35928
311750,201912,713,480,233,481036.76,233532,714568.76
311760,201912,66,32,34,31936,33932,65868
311770,201912,394,198,196,198603.34,196606,395209.34
311780,201912,179,99,80,99800.4,79840,179640.4
311783,201912,85,76,9,75848,8982,84830
311787,201912,36,14,22,13972,21956,35928
311790,201912,263,119,144,120758,143712,264470
311800,201912,663,443,220,444110.9,221556,665666.9
311810,201912,47,39,8,39920,7984,47904
311820,201912,120,99,21,98802,20958,119760
311830,201912,1931,1211,720,1208579.9,718560,1927139.9
311840,201912,1004,560,444,560876.8,443112.9,1003989.7
311850,201912,10,6,4,5988,3992,9980
311860,201912,9568,4258,5310,4261463.4,5320344.71,9581808.11
311870,201912,130,68,62,67864,61876,129740
311880,201912,930,678,252,679639.38,251496,931135.38
311890,201912,214,103,111,102712,110778,213490
311900,201912,75,31,44,31936,43912,75848
311910,201912,1404,886,518,888220.9,519958.4,1408179.3
311920,201912,225,150,75,149700,74850,224550
311930,201912,909,524,385,524948.4,385228.5,910176.9
311940,201912,2476,1310,1166,1309376,1165664.46,2475040.46
311950,201912,60,45,15,44910,14970,59880
311960,201912,59,43,16,42914,15968,58882
311970,201912,24,15,9,14970,8982,23952
311980,201912,45,36,9,35928,8982,44910
311990,201912,39,31,8,30938,7984,38922
311995,201912,55,36,19,35928,18962,54890
312000,201912,29,22,7,22954,6986,29940
312010,201912,77,61,16,60878,16966,77844
312015,201912,89,66,23,65868.4,22954,88822.4
312020,201912,126,81,45,80838,44910,125748
312030,201912,55,41,14,40918,13972,54890
312040,201912,86,52,34,51896.4,33932,85828.4
312050,201912,212,117,95,116766,94810,211576
312060,201912,28,16,12,15968,11976,27944
312070,201912,76,49,27,48902,26946,75848
312080,201912,533,243,290,243512,289420,532932
312083,201912,57,38,19,37924,18962,56886
312087,201912,111,87,24,86826,23952,110778
312090,201912,3143,1903,1240,1902192.24,1239516.4,3141708.64
312100,201912,152,107,45,106556.86,44910,151466.86
312110,201912,112,70,42,69860,41916,111776
312120,201912,143,105,38,104790.97,37924,142714.97
312125,201912,90,47,43,46906,42914,89820
312130,201912,125,84,41,83832,40918,124750
312140,201912,138,110,28,109780,27944,137724
312150,201912,45,35,10,34930,9980,44910
312160,201912,1559,1030,529,1031025.6,527942.4,1558968.0
312170,201912,11,10,1,9980,998,10978
312180,201912,111,67,44,66866,43912.8,110778.8
312190,201912,35,31,4,30938,3992,34930
312200,201912,764,652,112,650696.4,112774,763470.4
312210,201912,107,60,47,59880,46906,106786
312220,201912,137,101,36,101796.5,35928,137724.5
312230,201912,3615,1735,1880,1736522.32,1879242.06,3615764.38
312235,201912,172,116,56,115768,55888,171656
312240,201912,99,70,29,69860,28942,98802
312245,201912,181,125,56,125748.99,55888,181636.99
312247,201912,68,47,21,46906,20958,67864
312250,201912,178,87,91,86826,90818,177644
312260,201912,114,73,41,72854,40918,113772
312270,201912,129,78,51,77844,50898,128742
312280,201912,27,13,14,12974,13972,26946
312290,201912,152,109,43,108782,42914.6,151696.6
312300,201912,203,132,71,131736,70858,202594
312310,201912,60,53,7,52894,6986,59880
312320,201912,423,271,152,270458,152694.7,423152.7
312330,201912,90,79,11,78842,10978,89820
312340,201912,38,17,21,16966,20958,37924
312350,201912,18,11,7,10978,6986,17964
312352,201912,99,71,28,70858,27944,98802
312360,201912,571,253,318,253492,317364,570856
312370,201912,299,170,129,170658,129740.4,300398.4
312380,201912,142,96,46,95808,45908,141716
312385,201912,167,134,33,133732,32934,166666
312390,201912,305,190,115,189620,115768,305388
312400,201912,377,287,90,286426,89821,376247
312410,201912,954,311,643,310378,645706.99,956084.99
312420,201912,634,487,147,487024.4,147704.27,634728.67
312430,201912,872,643,229,645707.66,228542,874249.66
312440,201912,41,31,10,30938,9980,40918
312450,201912,206,129,77,128742,76846,205588
312460,201912,33,16,17,15968,16966,32934
312470,201912,48,32,16,31936,15968,47904
312480,201912,193,117,76,116766,76846,193612
312490,201912,269,192,77,191616,76846,268462
312500,201912,34,19,15,18962,14970,33932
312510,201912,520,207,313,206586,313372.96,519958.96
312520,201912,32,10,22,9980,21956,31936
312530,201912,50,34,16,33932,15968,49900
312540,201912,98,86,12,85828,11976,97804
312550,201912,38,30,8,29940,7984,37924
312560,201912,222,168,54,168662.4,53892,222554.4
312570,201912,443,270,173,269460,172654,442114
312580,201912,90,47,43,46906,42914,89820
312590,201912,253,201,52,200598,52894,253492
312595,201912,138,125,13,125748,12974,138722
312600,201912,68,40,28,40918.1,27944,68862.1
312610,201912,1572,818,754,822353.6,755486.4,1577840.0
312620,201912,207,147,60,146706,59880,206586
312630,201912,64,54,10,53892,9980,63872
312640,201912,45,13,32,12974,31936,44910
312650,201912,149,125,24,125748.4,23952,149700.4
312660,201912,83,62,21,61876.7,20958,82834.7
312670,201912,909,600,309,600796,310378,911174
312675,201912,34,26,8,25948,7984,33932
312680,201912,77,50,27,49900,27944,77844
312690,201912,248,129,119,128742,118762,247504
312695,201912,37,31,6,30938,5988,36926
312700,201912,225,130,95,129740,96806,226546
312705,201912,84,69,15,68862,14970,83832
312707,201912,126,91,35,90818,35928,126746
312710,201912,1871,1005,866,1005984.96,865266,1871250.96
312720,201912,68,33,35,32934,34930,67864
312730,201912,278,162,116,161676,115768,277444
312733,201912,54,46,8,45908,7984,53892
312735,201912,24,15,9,14970,8982,23952
312737,201912,67,35,32,34930,31936,66866
312738,201912,56,41,15,41916,15968,57884
312740,201912,79,53,26,52894,25948,78842
312750,201912,71,52,19,51896,18962,70858
312760,201912,286,207,79,207584,78842,286426
312770,201912,7712,3583,4129,3587819.82,4137710.94,7725530.76
312780,201912,420,321,99,320358,98802,419160
312790,201912,22,17,5,16966,4990,21956
312800,201912,1589,1106,483,1110774.9,485028.46,1595803.36
312810,201912,367,234,133,234530,132734,367264
312820,201912,187,141,46,141716,45908,187624
312825,201912,25,17,8,16966,7984,24950
312830,201912,239,137,102,137724.46,101796,239520.46
312840,201912,160,111,49,110778,49900,160678
312850,201912,44,40,4,39920,3992,43912
312860,201912,155,97,58,96806,57884,154690
312870,201912,1042,549,493,548900.9,496006,1044906.9
312880,201912,135,92,43,91816,44910,136726
312890,201912,162,115,47,114770,46906,161676
312900,201912,198,148,50,147704,49900,197604
312910,201912,178,93,85,92814,84830,177644
312920,201912,155,87,68,86826,67864,154690
312930,201912,327,230,97,230538,96806,327344
312940,201912,111,80,31,79840,30938,110778
312950,201912,694,467,227,467064,227544,694608
312960,201912,176,132,44,131736.96,43912,175648.96
312965,201912,72,61,11,60878,10978,71856
312970,201912,272,221,51,223552.5,50898,274450.5
312980,201912,2455,1261,1194,1265465.78,1192610,2458075.78
312990,201912,43,23,20,22954,19960,42914
313000,201912,49,28,21,27944,20958,48902
313005,201912,172,133,39,132734,38922.4,171656.4
313010,201912,908,373,535,372254.8,538920.98,911175.78
313020,201912,189,101,88,100798,87824,188622
313030,201912,197,130,67,129740.54,66866,196606.54
313040,201912,73,25,48,24950,47904,72854
313050,201912,189,135,54,134730,53892,188622
313055,201912,41,32,9,31936,8982,40918
313060,201912,126,89,37,88822,36926,125748
313065,201912,59,42,17,41916,16966,58882
313070,201912,135,72,63,71856,62874,134730
313080,201912,42,18,24,17964,23952,41916
313090,201912,661,440,221,442114.4,220558,662672.4
313100,201912,173,65,108,64870,107784,172654
313110,201912,136,74,62,73852,61876,135728
313115,201912,197,111,86,110778,85828,196606
313120,201912,783,444,339,444110.4,339320.4,783430.8
313130,201912,5583,3069,2514,3076839.78,2519951.9,5596791.68
313140,201912,145,76,69,75848,68862,144710
313150,201912,304,245,59,247504,59880,307384
313160,201912,191,142,49,141716.4,48902,190618.4
313170,201912,1380,951,429,952093.6,432134.98,1384228.58
313180,201912,302,179,123,178642,124750,303392
313190,201912,754,455,299,454090.23,298402.2,752492.43
313200,201912,28,25,3,24950,2994,27944
313210,201912,996,849,147,851295.62,147704,998999.62
313220,201912,259,168,91,167664,91816.4,259480.4
313230,201912,269,203,66,202594.65,65868,268462.65
313240,201912,2102,1109,993,1114770.29,994008,2108778.29
313250,201912,1268,960,308,961075.4,307385.12,1268460.52
313260,201912,91,49,42,48902,41916,90818
313270,201912,952,565,387,568860.3,389220.8,958081.1
313280,201912,53,44,9,43912,8982,52894
313290,201912,221,178,43,177644,43912,221556
313300,201912,346,182,164,181636.6,165668,347304.6
313310,201912,247,122,125,121756,124750,246506
313320,201912,372,281,91,280438.6,90818,371256.6
313330,201912,1399,870,529,870256,528940,1399196
313340,201912,328,231,97,230538,98802,329340
313350,201912,502,335,167,334330,166666,500996
313360,201912,126,70,56,70858,56886.4,127744.4
313370,201912,200,70,130,69860,129740,199600
313375,201912,278,166,112,166666,112774,279440
313380,201912,1334,710,624,710576.2,625746.99,1336323.19
313390,201912,52,46,6,45908.6,5988,51896.6
313400,201912,406,277,129,276446.2,130738.8,407185.0
313410,201912,21,12,9,11976,8982,20958
313420,201912,4617,2480,2137,2481029,2136718.4,4617747.4
313430,201912,143,71,72,70858,71856,142714
313440,201912,1432,987,445,993011.74,446107.6,1439119.34
313450,201912,65,27,38,26946,37924,64870
313460,201912,381,172,209,173652.4,208582,382234.4
313470,201912,526,249,277,248502.8,280438.8,528941.6
313480,201912,149,108,41,107784.4,40918,148702.4
313490,201912,508,238,270,237524.4,272454.9,509979.3
313500,201912,24,14,10,13972,9980,23952
313505,201912,1010,800,210,802392.72,210578,1012970.72
313507,201912,102,60,42,59880,41916,101796
313510,201912,2773,1766,1007,1768457,1004986,2773443
313520,201912,3463,2710,753,2715562.15,753491.96,3469054.11
313530,201912,36,25,11,24950,10978,35928
313535,201912,57,46,11,45908,10978,56886
313540,201912,71,54,17,53892,16966.4,70858.4
313545,201912,115,96,19,95808,18962,114770
313550,201912,233,199,34,198602,34930.4,233532.4
313560,201912,334,165,169,164670,168662,333332
313570,201912,60,29,31,28942,30938,59880
313580,201912,1309,744,565,744509.14,568861.2,1313370.34
313590,201912,73,42,31,41916,30938,72854
313600,201912,679,414,265,415168,267464.4,682632.4
313610,201912,61,48,13,48902.4,12974,61876.4
313620,201912,1385,707,678,710576.8,677642,1388218.8
313630,201912,1611,1244,367,1244506.8,366266,1610772.8
313640,201912,124,76,48,75848,47904,123752
313650,201912,239,115,124,114770,124750.4,239520.4
313652,201912,17,17,0,16966,0,16966
313655,201912,61,39,22,38922,21956,60878
313657,201912,49,45,4,44910,3992,48902
313660,201912,133,93,40,92814,39937.96,132751.96
313665,201912,663,326,337,325348.9,336326,661674.9
313670,201912,10378,7142,3236,7151675.61,3240507.6,10392183.21
313680,201912,43,32,11,31936,10978.78,42914.78
313690,201912,146,111,35,110778,35928,146706
313695,201912,73,56,17,55888,16966,72854
313700,201912,302,242,60,243512,59880,303392
313710,201912,145,99,46,98802,45908,144710
313720,201912,1105,535,570,533930.4,570857.4,1104787.8
313730,201912,71,45,26,44910,25948,70858
313740,201912,150,121,29,120758,28942,149700
313750,201912,423,308,115,308382,114770,423152
313753,201912,234,172,62,171656,61876,233532
313760,201912,1289,470,819,471056.21,818361.5,1289417.71
313770,201912,365,265,100,264470.5,99800,364270.5
313780,201912,767,405,362,405188,364270,769458
313790,201912,29,28,1,27944,998,28942
313800,201912,139,86,53,85828,52894,138722
313810,201912,76,43,33,42914,32934,75848
313820,201912,1323,649,674,651694.8,674649.35,1326344.15
313830,201912,65,47,18,46906,17964,64870
313835,201912,62,52,10,51896,9980,61876
313840,201912,1650,1006,644,1004987.8,643710.8,1648698.6
313850,201912,205,75,130,74850,129740,204590
313860,201912,477,364,113,364270.4,112774,477044.4
313862,201912,164,109,55,108782,55888,164670
313865,201912,111,85,26,84830,25948,110778
313867,201912,47,38,9,37924,8982,46906
313868,201912,31,20,11,19960,10978,30938
313870,201912,120,63,57,62874,56886,119760
313880,201912,368,234,134,233532,133732,367264
313890,201912,330,178,152,178642.6,152694,331336.6
313900,201912,899,489,410,488023.1,410178.9,898202.0
313910,201912,135,100,35,99800,34930,134730
313920,201912,631,448,183,447104,183632.9,630736.9
313925,201912,31,28,3,27944,2994,30938
313930,201912,845,659,186,662672,187624.95,850296.95
313940,201912,1831,1152,679,1153688,682632,1836320
313950,201912,936,593,343,592812.8,342314,935126.8
313960,201912,1382,787,595,790416.76,595807.8,1386224.56
313970,201912,138,95,43,94810,42914,137724
313980,201912,216,137,79,137724.5,79840,217564.5
313990,201912,229,157,72,156686,73852,230538
314000,201912,917,612,305,611774.74,304390,916164.74
314010,201912,80,52,28,51896,27944,79840
314015,201912,63,19,44,18962,43912,62874
314020,201912,53,36,17,35928,16966,52894
314030,201912,75,37,38,36926,37924,74850
314040,201912,41,24,17,23952,16966,40918
314050,201912,288,174,114,173652,113772,287424
314053,201912,97,63,34,62874.4,33932,96806.4
314055,201912,300,188,112,187624,111776.4,299400.4
314060,201912,142,123,19,122754,19960,142714
314070,201912,1064,562,502,562872,501994,1064866
314080,201912,211,137,74,136726,74850.36,211576.36
314085,201912,137,93,44,92814,43912,136726
314090,201912,370,267,103,267464.9,102794,370258.9
314100,201912,483,395,88,396222.62,87832.64,484055.26
314110,201912,741,394,347,394210.4,347304,741514.4
314120,201912,90,53,37,52894,36926,89820
314130,201912,23,12,11,11976,10978,22954
314140,201912,1099,683,416,681634.2,418162,1099796.2
314150,201912,168,106,62,105788,61876,167664
314160,201912,337,257,80,256486.6,79840.6,336327.2
314170,201912,77,62,15,61876,14970,76846
314180,201912,730,648,82,648700.4,82834.5,731534.9
314190,201912,98,61,37,60878,36926,97804
314200,201912,486,334,152,333332.4,151696,485028.4
314210,201912,254,196,58,196606,58882.4,255488.4
314220,201912,310,230,80,229540.4,79840,309380.4
314225,201912,66,47,19,46906,18962,65868
314230,201912,119,55,64,54890,63872,118762
314240,201912,141,108,33,107784,32934,140718
314250,201912,51,30,21,29940,20958,50898
314260,201912,214,106,108,105788,107784,213572
314270,201912,352,276,76,275448,75848,351296
314280,201912,705,391,314,390218.98,314370,704588.98
314290,201912,536,438,98,441116.96,97804,538920.96
314300,201912,366,264,102,263474.5,101796.9,365271.4
314310,201912,1375,933,442,936374.53,443112,1379486.53
314315,201912,34,28,6,27944,5988,33932
314320,201912,599,397,202,398202.4,202594,600796.4
314330,201912,10920,5432,5488,5438105.88,5491997.53,10930103.41
314340,201912,604,278,326,277444,325348.8,602792.8
314345,201912,43,31,12,30938.4,11976,42914.4
314350,201912,185,117,68,116766,67864,184630
314360,201912,71,43,28,42914,27944,70858
314370,201912,63,46,17,45908,16966,62874
314380,201912,91,59,32,58882,31936,90818
314390,201912,3312,2134,1178,2136720.54,1176642.6,3313363.14
314400,201912,684,491,193,495009.5,194610,689619.5
314410,201912,466,305,161,305388,160678,466066
314420,201912,18,8,10,8982,9980,18962
314430,201912,2447,909,1538,910177.9,1537918.4,2448096.3
314435,201912,233,140,93,139720,92814,232534
314437,201912,28,22,6,21956,5988,27944
314440,201912,96,71,25,70858,24950,95808
314450,201912,154,109,45,110778,44910,155688
314460,201912,642,303,339,303392,340318,643710
314465,201912,87,59,28,58882,27944,86826
314467,201912,67,55,12,55888,11976,67864
314470,201912,404,204,200,204591.78,199600,404191.78
314480,201912,1069,514,555,514968,553890,1068858
314490,201912,56,40,16,39920,15968,55888
314500,201912,288,195,93,196606,93812,290418
314505,201912,120,80,40,79840,39920,119760
314510,201912,236,194,42,194610,41916,236526
314520,201912,1275,682,593,684634.4,594809.2,1279443.6
314530,201912,740,595,145,596805.66,144710,741515.66
314535,201912,194,121,73,120758,72854,193612
314537,201912,62,37,25,36926,24950,61876
314540,201912,15,10,5,9980,4990,14970
314545,201912,53,35,18,34930,17964,52894
314550,201912,80,41,39,40918,38922,79840
314560,201912,863,474,389,474050.8,388222,862272.8
314570,201912,21,17,4,16966,3992,20958
314580,201912,13,5,8,4990,7984,12974
314585,201912,25,19,6,18962,5988,24950
314587,201912,84,73,11,72854,10978,83832
314590,201912,561,409,152,410179.3,151696,561875.3
314600,201912,937,611,326,610777.2,328343.03,939120.23
314610,201912,947,504,443,503991.3,443112,947103.3
314620,201912,143,106,37,106786,37924.4,144710.4
314625,201912,92,68,24,67864,23952,91816
314630,201912,1169,618,551,621754,551894,1173648
314640,201912,81,54,27,53892,26946.4,80838.4
314650,201912,181,104,77,103792,76846,180638
314655,201912,65,47,18,47904,17964,65868
314660,201912,18,15,3,14970,2994,17964
314670,201912,200,152,48,151696.4,47904,199600.4
314675,201912,212,126,86,125748,86826,212574
314690,201912,578,314,264,314370,263472,577842
314700,201912,2307,1256,1051,1256483.6,1049896,2306379.6
314710,201912,1675,983,692,986025.1,691614.8,1677639.9
314720,201912,385,234,151,234530,150698,385228
314730,201912,508,268,240,267464.8,240518.98,507983.78
314740,201912,699,342,357,342314,358282,700596
314750,201912,22,19,3,18962,2994,21956
314760,201912,339,160,179,160678,178642,339320
314770,201912,106,75,31,74850,30938,105788
314780,201912,19,6,13,5988,12974,18962
314790,201912,2345,1483,862,1483031.34,861274,2344305.34
314795,201912,50,40,10,39920,10978,50898
314800,201912,2901,1705,1196,1710573.81,1197600,2908173.81
314810,201912,1523,870,653,872252,652692.6,1524944.6
314820,201912,107,60,47,59880,46906,106786
314830,201912,216,174,42,173652,41916,215568
314840,201912,87,50,37,49900,37924,87824
314850,201912,371,186,185,185628.4,184630,370258.4
314860,201912,685,519,166,518960.4,166666,685626.4
314870,201912,1496,793,703,793410.4,705586,1498996.4
314875,201912,57,49,8,49900,7984,57884
314880,201912,45,31,14,30938,13972,44910
314890,201912,55,33,22,32934,21956,54890
314900,201912,31,24,7,23952,6986,30938
314910,201912,246,166,80,165668,79840,245508
314915,201912,144,128,16,127744,15968,143712
314920,201912,105,64,41,63872,40918,104790
314930,201912,1071,533,538,532933.24,537922,1070855.24
314940,201912,48,38,10,37924,9980,47904
314950,201912,33,23,10,22954,9980,32934
314960,201912,41,31,10,30938,9980,40918
314970,201912,144,73,71,72854,70858,143712
314980,201912,300,192,108,192614,108782,301396
314990,201912,447,250,197,250498,200598,451096
314995,201912,204,67,137,66866,137724,204590
315000,201912,89,69,20,68862,19960,88822
315010,201912,44,28,16,28942,15968,44910
315015,201912,168,135,33,135728,33932,169660
315020,201912,68,57,11,56886,11976,68862
315030,201912,115,89,26,88822,25948,114770
315040,201912,71,50,21,49900,20958,70858
315050,201912,181,110,71,110778,70858,181636
315053,201912,44,36,8,35928,7984,43912
315057,201912,100,79,21,78842.4,20958,99800.4
315060,201912,72,62,10,61876.52,9980,71856.52
315070,201912,108,60,48,59880,47904,107784
315080,201912,376,304,72,303392,71856,375248
315090,201912,102,60,42,59880,41916,101796
315100,201912,84,42,42,41916,41916,83832
315110,201912,272,145,127,145708,126746,272454
315120,201912,1691,846,845,844308,845306.68,1689614.68
315130,201912,345,248,97,248502,97804,346306
315140,201912,516,298,218,297404.4,217564.8,514969.2
315150,201912,960,460,500,460078,501994.4,962072.4
315160,201912,218,110,108,109780,107784,217564
315170,201912,320,209,111,208582.4,110778,319360.4
315180,201912,3301,1388,1913,1393210.4,1913169.1,3306379.5
315190,201912,327,194,133,193612.2,132734,326346.2
315200,201912,1241,729,512,730536,511974,1242510
315210,201912,1633,938,695,940116.6,696604.2,1636720.8
315213,201912,41,24,17,23952,16966,40918
315217,201912,213,170,43,169660,43912,213572
315220,201912,1571,1195,376,1195606.54,375248,1570854.54
315230,201912,176,128,48,127744.4,47904,175648.4
315240,201912,424,274,150,277444,149700.98,427144.98
315250,201912,2534,1264,1270,1265464,1273448.8,2538912.8
315260,201912,141,83,58,82834,57884,140718
315270,201912,126,90,36,89820,36926,126746
315280,201912,654,429,225,429140.2,226546,655686.2
315290,201912,197,119,78,118762,78842,197604
315300,201912,71,54,17,53892,16966,70858
315310,201912,71,64,7,63872,6986,70858
315320,201912,166,97,69,96806,68862,165668
315330,201912,56,47,9,46906,8982,55888
315340,201912,388,282,106,281436,106786,388222
315350,201912,153,94,59,93812,58882,152694
315360,201912,90,47,43,46906,42914,89820
315370,201912,57,35,22,34930,21956,56886
315380,201912,11,8,3,7984,2994,10978
315390,201912,69,17,52,16966,51896.4,68862.4
315400,201912,847,636,211,635727.1,211576,847303.1
315410,201912,333,198,135,198602.4,134731.4,333333.8
315415,201912,61,45,16,44910,15968,60878
315420,201912,201,150,51,150698.4,50898,201596.4
315430,201912,658,378,280,381236.4,281436.6,662673.0
315440,201912,92,65,27,64870,26946,91816
315445,201912,236,192,44,191616,43912,235528
315450,201912,183,139,44,138722,43912,182634
315460,201912,3875,1934,1941,1936120.98,1947098.98,3883219.96
315470,201912,40,16,24,15968,23952,39920
315480,201912,64,23,41,22954,40918,63872
315490,201912,644,399,245,400198,245508,645706
315500,201912,21,14,7,13972,6986,20958
315510,201912,151,101,50,100798,50898,151696
315520,201912,69,62,7,61876,6986,68862
315530,201912,48,26,22,25948,21956,47904
315540,201912,239,162,77,161676,77844,239520
315550,201912,175,141,34,140718,33932,174650
315560,201912,735,593,142,593810.4,142714,736524.4
315570,201912,307,159,148,158683.56,149700.6,308384.16
315580,201912,704,470,234,470058,233532,703590
315590,201912,202,108,94,107784,93812,201596
315600,201912,305,229,76,228542,75848,304390
315610,201912,98,52,46,51896,46906,98802
315620,201912,34,27,7,26946,7984,34930
315630,201912,131,87,44,86826,43912,130738
315640,201912,68,42,26,41916,25948,67864
315645,201912,50,35,15,34930,14970,49900
315650,201912,173,126,47,125748.8,46906,172654.8
315660,201912,462,205,257,204590.4,257484,462074.4
315670,201912,2395,1181,1214,1181633.6,1218559.96,2400193.56
315680,201912,843,586,257,586824,257484,844308
315690,201912,679,470,209,469061.33,208582,677643.33
315700,201912,1881,994,887,995007.71,887222,1882229.71
315710,201912,337,99,238,98802,237524,336326
315720,201912,445,279,166,280438.4,166666,447104.4
315725,201912,197,157,40,157684.4,39920,197604.4
315727,201912,46,22,24,21956,23952,45908
315730,201912,48,46,2,45908,1996,47904
315733,201912,87,60,27,59880,26946,86826
315737,201912,49,37,12,36926,11976,48902
315740,201912,36,28,8,27944,7984,35928
315750,201912,161,122,39,121756,38922,160678
315760,201912,43,33,10,32934,9980,42914
315765,201912,124,76,48,75848,47904,123752
315770,201912,219,136,83,137724,83832.4,221556.4
315780,201912,3453,1758,1695,1761471,1693607.15,3455078.15
315790,201912,221,175,46,174650,46906,221556
315800,201912,285,203,82,202594,81836,284430
315810,201912,96,57,39,56886,38922.4,95808.4
315820,201912,749,543,206,544909.2,205588,750497.2
315830,201912,129,79,50,79840,49900,129740
315840,201912,85,58,27,57884,26946,84830
315850,201912,252,184,68,183632.5,68862,252494.5
315860,201912,14,5,9,4990,8982,13972
315870,201912,37,28,9,28942,8982,37924
315880,201912,108,69,39,68862,38922,107784
315890,201912,89,66,23,66866,22954,89820
315895,201912,444,294,150,295408.5,149700.8,445109.3
315900,201912,70,32,38,32934,37924,70858
315910,201912,38,23,15,22954,14970,37924
315920,201912,166,108,58,107784,57884.3,165668.3
315930,201912,46,18,28,17964,27944,45908
315935,201912,135,105,30,104790.4,29940.98,134731.38
315940,201912,99,73,26,72854,25948,98802
315950,201912,42,31,11,30938,10978,41916
315960,201912,536,257,279,256486.4,278442.4,534928.8
315970,201912,33,27,6,26946,5988,32934
315980,201912,686,338,348,337324,348302,685626
315990,201912,250,147,103,146706,102795.38,249501.38
316000,201912,52,34,18,33932,17964,51896
316010,201912,80,70,10,69860,9980,79840
316020,201912,117,100,17,99800,16966,116766
316030,201912,393,219,174,220558.4,173652.9,394211.3
316040,201912,516,221,295,220558.4,294410.4,514968.8
316045,201912,62,56,6,55888,6986,62874
316050,201912,17,14,3,13972,2994,16966
316060,201912,97,64,33,63872,32934,96806
316070,201912,1092,707,385,708580.7,386226,1094806.7
316080,201912,103,67,36,66866,35928,102794
316090,201912,40,22,18,21956,17964,39920
316095,201912,104,86,18,86826,17964,104790
316100,201912,309,180,129,179640.5,129740,309380.5
316105,201912,38,26,12,25948,11976,37924
316110,201912,1863,1490,373,1491012.55,376246,1867258.55
316120,201912,79,58,21,58882,20958,79840
316130,201912,122,93,29,92814.4,28942,121756.4
316140,201912,31,23,8,22954,7984,30938
316150,201912,203,141,62,141716,61876,203592
316160,201912,79,46,33,45908,32934,78842
316165,201912,67,51,16,50898.6,15968.6,66867.2
316170,201912,185,123,62,122754,62874,185628
316180,201912,199,88,111,87824,110778.4,198602.4
316190,201912,135,100,35,99800,34930,134730
316200,201912,660,369,291,369260,292414,661674
316210,201912,768,512,256,514141.65,257484,771625.65
316220,201912,115,75,40,74850,39920,114770
316225,201912,26,15,11,14970,10978,25948
316230,201912,34,19,15,18962,14970,33932
316240,201912,650,524,126,523950,125748,649698
316245,201912,129,111,18,110778,17964,128742
316250,201912,1542,1056,486,1055885.26,490018.98,1545904.24
316255,201912,121,98,23,97804,22954,120758
316257,201912,176,93,83,92814,82834,175648
316260,201912,192,137,55,137724.5,54890.8,192615.3
316265,201912,27,19,8,19960,7984,27944
316270,201912,690,484,206,484030.6,206586.84,690617.44
316280,201912,547,344,203,343313.23,202595.4,545908.63
316290,201912,741,491,250,492014.66,249500,741514.66
316292,201912,512,203,309,202594,308382,510976
316294,201912,100,60,40,60878,39920,100798
316295,201912,308,135,173,134731.36,172654,307385.36
316300,201912,102,72,30,71856,29940,101796
316310,201912,38,20,18,19960,17964,37924
316320,201912,44,26,18,25948,17964,43912
316330,201912,152,104,48,103792.5,47904,151696.5
316340,201912,139,98,41,97804,40918,138722
316350,201912,192,135,57,134730.3,57884,192614.3
316360,201912,23,14,9,13972,8982,22954
316370,201912,1110,576,534,576844.9,534928,1111772.9
316380,201912,119,89,30,88822,29940,118762
316390,201912,118,86,32,85828,31936,117764
316400,201912,132,102,30,101796,29940,131736
316410,201912,295,213,82,212574,81836,294410
316420,201912,206,141,65,140718,64870,205588
316430,201912,153,82,71,81836,70858,152694
316440,201912,88,43,45,43912,45908,89820
316443,201912,42,39,3,38922,2994,41916
316447,201912,51,39,12,38922,11976,50898
316450,201912,226,172,54,171656,53892,225548
316460,201912,73,27,46,26946,45908,72854
316470,201912,1659,1225,434,1226536.17,434130,1660666.17
316480,201912,11,9,2,8982,1996,10978
316490,201912,18,7,11,6986,10978,17964
316500,201912,152,101,51,100798,50898,151696
316510,201912,157,122,35,121756,34930,156686
316520,201912,197,123,74,122754,73852,196606
316530,201912,156,107,49,106786,48902,155688
316540,201912,141,75,66,74850,65868,140718
316550,201912,131,88,43,88822,42914,131736
316553,201912,291,135,156,134730,156686.72,291416.72
316555,201912,38,32,6,31936,5988,37924
316556,201912,11,8,3,7984,2994,10978
316557,201912,20,17,3,16966,2994,19960
316560,201912,67,48,19,47904,18962,66866
316570,201912,227,205,22,207584,21956,229540
316580,201912,18,15,3,14970,2994,17964
316590,201912,102,86,16,85828,15968,101796
316600,201912,178,147,31,146706,30938,177644
316610,201912,69,51,18,50898,17964,68862
316620,201912,143,109,34,108782,33932,142714
316630,201912,41,33,8,32934,7984,40918
316640,201912,23,15,8,14970,7984,22954
316650,201912,77,62,15,61876,14970,76846
316660,201912,8,3,5,2994,4990,7984
316670,201912,441,154,287,153692.96,286426,440118.96
316680,201912,156,107,49,106786,48902.6,155688.6
316690,201912,193,121,72,120758,71856,192614
316695,201912,64,55,9,54890,8982,63872
316700,201912,15,9,6,8982,5988,14970
316710,201912,767,577,190,575846.5,191616,767462.5
316720,201912,4922,2450,2472,2455084.65,2473045.79,4928130.44
316730,201912,16,16,0,15968,0,15968
316740,201912,141,90,51,89820,50898,140718
316750,201912,19,12,7,11976,6986,18962
316760,201912,320,255,65,254490,64870,319360
316770,201912,148,79,69,79840,68862,148702
316780,201912,72,46,26,45908,25948,71856
316790,201912,54,40,14,39920,13972,53892
316800,201912,1735,1082,653,1082830,652693,1735523
316805,201912,19,11,8,10978,7984,18962
316810,201912,69,45,24,45908,23952,69860
316820,201912,42,21,21,20958,20958,41916
316830,201912,94,45,49,44910,48902,93812
316840,201912,524,305,219,304390,219560,523950
316850,201912,335,223,112,223552,111776,335328
316860,201912,5917,2651,3266,2652686.83,3275436.3,5928123.13
316870,201912,1530,1001,529,1002992.78,527943.2,1530935.98
316880,201912,129,65,64,64870,63872,128742
316890,201912,240,163,77,162674,76846,239520
316900,201912,427,298,129,298402.36,130738,429140.36
316905,201912,21,10,11,9980,10978,20958
316910,201912,62,27,35,26946,34930,61876
316920,201912,135,107,28,106786,27944,134730
316930,201912,1891,979,912,977042.8,911174.3,1888217.1
316935,201912,898,551,347,549898.64,347304.4,897203.04
316940,201912,1094,633,461,634728.8,461076.4,1095805.2
316950,201912,180,89,91,88822.4,90818,179640.4
316960,201912,1104,625,479,624748.8,479040,1103788.8
316970,201912,658,520,138,518960.4,137724,656684.4
316980,201912,77,46,31,45908,30938.98,76846.98
316990,201912,2182,1464,718,1464066.34,716565.5,2180631.84
317000,201912,325,249,76,249500,75848,325348
317005,201912,241,170,71,169660,70858,240518
317010,201912,6350,3525,2825,3538913.01,2831326.8,6370239.81
317020,201912,16089,7129,8960,7150683.8,8976029.1,16126712.9
317030,201912,80,31,49,30938,48902,79840
317040,201912,3087,1939,1148,1941112.6,1155684.6,3096797.2
317043,201912,76,56,20,56886,19960,76846
317047,201912,30,17,13,16966,12974.99,29940.99
317050,201912,167,127,40,127744,39920,167664
317052,201912,127,96,31,95808,30938,126746
317057,201912,174,134,40,134730,39920,174650
317060,201912,65,42,23,41916,23952,65868
317065,201912,55,44,11,43912,10978,54890
317070,201912,1973,924,1049,927142.9,1050894.8,1978037.7
317075,201912,106,58,48,57884,47904,105788
317080,201912,889,464,425,464070.9,425148.6,889219.5
317090,201912,650,525,125,524948,124750,649698
317100,201912,421,320,101,320358,100798,421156
317103,201912,107,88,19,88822,18962,107784
317107,201912,45,40,5,39920,4990,44910
317110,201912,113,47,66,46906,65868,112774
317115,201912,45,40,5,39920,4990,44910
317120,201912,1889,939,950,943110.8,950096.4,1893207.2
317130,201912,1973,1321,652,1320356,651694,1972050
317140,201912,12,10,2,9980,1996,11976
317150,201912,263,158,105,158682.4,104790,263472.4
317160,201912,322,239,83,238523.03,82834,321357.03
317170,201912,217,151,66,150698,65868,216566
317180,201912,444,314,130,313372,129740,443112
317190,201912,261,182,79,181636,80838,262474
317200,201912,818,575,243,574851.16,242514,817365.16
317210,201912,187,102,85,101796,84830,186626
317220,201912,24,13,11,12974,10978,23952
320010,201912,612,445,167,444110.5,166666,610776.5
320013,201912,125,91,34,90818,33932,124750
320016,201912,272,169,103,168662,102794,271456
320020,201912,709,419,290,420159.45,291416,711575.45
320030,201912,152,107,45,106786,44910.5,151696.5
320035,201912,141,106,35,105788,34930,140718
320040,201912,492,254,238,253492,237524,491016
320050,201912,104,77,27,77844,27944,105788
320060,201912,1635,785,850,790418.86,851298.44,1641717.30
320070,201912,105,70,35,69860,34930,104790
320080,201912,804,467,337,467064.9,336326,803390.9
320090,201912,1225,838,387,841314,388222,1229536
320100,201912,326,188,138,188622,139720,328342
320110,201912,123,78,45,77845.1,44910.4,122755.5
320115,201912,109,90,19,89820,18962,108782
320120,201912,3401,1861,1540,1864265.86,1542909.37,3407175.23
320130,201912,7424,3422,4002,3438129.47,4013989.11,7452118.58
320140,201912,432,287,145,287424.6,144710.08,432134.68
320150,201912,2048,1174,874,1176644.55,876244,2052888.55
320160,201912,656,298,358,298402.99,358283.79,656686.78
320170,201912,110,87,23,86826,22954,109780
320180,201912,53,31,22,30938,21956,52894
320190,201912,245,159,86,158682,86826.4,245508.4
320200,201912,57,45,12,44910,11976,56886
320210,201912,901,504,397,504988.8,397205.76,902194.56
320220,201912,302,110,192,110778.98,192614,303392.98
320225,201912,90,73,17,72854,16966,89820
320230,201912,599,385,214,386226.6,213572.4,599799.0
320240,201912,3175,1572,1603,1572849.6,1610773.38,3183622.98
320245,201912,462,316,146,318362.4,146706,465068.4
320250,201912,229,118,111,118762,110778,229540
320255,201912,142,112,30,111776,29940.7,141716.7
320260,201912,200,141,59,141716,59880,201596
320265,201912,163,130,33,129740,32934,162674
320270,201912,152,123,29,122754,28942,151696
320280,201912,988,576,412,579838.93,412174,992012.93
320290,201912,60,50,10,49900,9980,59880
320300,201912,566,391,175,391217.34,175650.04,566867.38
320305,201912,681,371,310,371256,310379,681635
320310,201912,218,124,94,124750.76,93812,218562.76
320313,201912,327,164,163,164670.9,163672.4,328343.3
320316,201912,113,89,24,88822,23952,112774
320320,201912,3444,1576,1868,1582829.04,1866260.99,3449090.03
320330,201912,264,200,64,199600,63872,263472
320332,201912,852,518,334,519960.15,335328.9,855289.05
320334,201912,243,151,92,151696.4,92814,244510.4
320335,201912,145,101,44,100798,43912,144710
320340,201912,554,382,172,381236.9,171656,552892.9
320350,201912,981,421,560,420159.29,558880.8,979040.09
320360,201912,169,91,78,91816,77844,169660
320370,201912,245,185,60,184630.56,59880.4,244510.96
320380,201912,282,196,86,197604.4,87824,285428.4
320390,201912,1143,696,447,697602.92,453092.8,1150695.72
320400,201912,310,229,81,228543.4,80838,309381.4
320405,201912,946,401,545,401197.89,545908.39,947106.28
320410,201912,971,499,472,500996,472054.9,973050.9
320420,201912,497,244,253,243513.3,252494,496007.3
320425,201912,194,104,90,103792,89820,193612
320430,201912,384,213,171,214571.07,171656,386227.07
320435,201912,159,106,53,107784,52894,160678
320440,201912,200,118,82,117764,81836,199600
320450,201912,127,69,58,68862,57884,126746
320455,201912,249,206,43,205588.4,42914,248502.4
320460,201912,270,166,104,165668,103792,269460
320465,201912,115,80,35,79840,34930,114770
320470,201912,686,430,256,432135.99,255488.99,687624.98
320480,201912,191,122,69,121756,71856,193612
320490,201912,3057,1514,1543,1515967.65,1547906.4,3063874.05
320495,201912,111,69,42,68862,41916.8,110778.8
320500,201912,9644,4794,4850,4811371.29,4867260.17,9678631.46
320501,201912,548,277,271,277444,270458,547902
320503,201912,285,199,86,200598,85828,286426
320506,201912,264,191,73,191616,72854,264470
320510,201912,1022,469,553,469060,553890.98,1022950.98
320515,201912,85,69,16,68862,15968,84830
320517,201912,214,156,58,155688,57884,213572
320520,201912,6865,2990,3875,2999995.1,3887217.75,6887212.85
320530,201912,6029,3028,3001,3035925.27,3005982.11,6041907.38
330010,201912,3089,1593,1496,1594806,1499994,3094800
330015,201912,162,69,93,68862.56,95808,164670.56
330020,201912,3603,1578,2025,1588851.3,2039912.4,3628763.7
330022,201912,242,127,115,129740,114770,244510
330023,201912,589,199,390,199600,393212,592812
330025,201912,574,111,463,114770,466066,580836
330030,201912,1923,1230,693,1232531.05,693610.4,1926141.45
330040,201912,2418,1259,1159,1264468.1,1160675.3,2425143.4
330045,201912,8591,2690,5901,2704580.8,5924129.6,8628710.4
330050,201912,897,575,322,575846,321356,897202
330060,201912,978,592,386,595806.9,387224,983030.9
330070,201912,3523,1304,2219,1310375.74,2242508.88,3552884.62
330080,201912,1562,703,859,707583.64,860276.8,1567860.44
330090,201912,377,223,154,223552,153692.4,377244.4
330093,201912,272,120,152,119760,151697.88,271457.88
330095,201912,84,46,38,46906,38922,85828
330100,201912,9612,4879,4733,4886212.17,4737506.7,9623718.87
330110,201912,471,200,271,201596.7,273452,475048.7
330115,201912,542,285,257,285428,256486,541914
330120,201912,374,196,178,196606,177645.6,374251.6
330130,201912,1553,394,1159,395208.6,1162670.96,1557879.56
330140,201912,608,323,285,323352.94,285428,608780.94
330150,201912,505,292,213,294410,213572,507982
330160,201912,211,129,82,128742,81836,210578
330170,201912,26647,9220,17427,9253464.16,17540861.16,26794325.32
330180,201912,243,145,98,145708,97804,243512
330185,201912,929,335,594,335328.98,597803.92,933132.90
330187,201912,346,105,241,105788,240518,346306
330190,201912,5714,2203,3511,2211570.7,3516952.4,5728523.1
330200,201912,4659,1407,3252,1415165.84,3268451,4683616.84
330205,201912,423,249,174,250498,175648.4,426146.4
330210,201912,985,611,374,610778.24,375250.18,986028.42
330220,201912,2642,1598,1044,1597799.29,1046902.4,2644701.69
330225,201912,556,289,267,291416.6,266466,557882.6
330227,201912,2363,734,1629,735526.67,1637719.5,2373246.17
330230,201912,227,132,95,131736,94810,226546
330240,201912,3723,1882,1841,1887224.22,1849330.9,3736555.12
330245,201912,153,71,82,70858.99,81836,152694.99
330250,201912,6660,3441,3219,3450089.25,3234521.71,6684610.96
330260,201912,563,157,406,157684,407184,564868
330270,201912,3486,1208,2278,1220554.6,2293406.8,3513961.4
330280,201912,449,287,162,287425.2,161676.98,449102.18
330285,201912,7065,2251,4814,2258475.5,4837308.8,7095784.3
330290,201912,635,233,402,233532,404190,637722
330300,201912,772,505,267,505987.1,268462.94,774450.04
330310,201912,446,252,194,252494.9,193612,446106.9
330320,201912,7956,2996,4960,3002984.8,4985011.6,7987996.4
330330,201912,8857,3451,5406,3472043.7,5461069.44,8933113.14
330340,201912,2694,1595,1099,1600792.4,1103788,2704580.4
330350,201912,18247,7152,11095,7182612.66,11147670.14,18330282.80
330360,201912,2293,1111,1182,1116762.8,1186622.98,2303385.78
330370,201912,1021,521,500,520956.7,499998,1020954.7
330380,201912,863,371,492,373252,492015.21,865267.21
330385,201912,632,326,306,325348.5,307384,632732.5
330390,201912,5408,2957,2451,2975040.4,2465060.4,5440100.8
330395,201912,310,191,119,190618,119760.7,310378.7
330400,201912,710,383,327,383232.6,327344,710576.6
330410,201912,509,371,138,370259.7,138722.4,508982.1
330411,201912,252,136,116,135728.62,115768,251496.62
330412,201912,238,97,141,96806.4,141716,238522.4
330414,201912,5410,2219,3191,2232528.08,3209568.4,5442096.48
330415,201912,585,262,323,261477.4,323352.6,584830.0
330420,201912,2230,1157,1073,1160675.42,1077841.38,2238516.80
330430,201912,1788,831,957,832333.4,958082,1790415.4
330440,201912,276,137,139,137724,138722,276446
330450,201912,121,51,70,50898,69860,120758
330452,201912,1893,855,1038,858282.52,1040914.4,1899196.92
330455,201912,110045,39400,70645,39556836.71,71047650.94,110604487.65
330460,201912,265,111,154,110778,153692.94,264470.94
330470,201912,1228,669,559,671656.5,558881.9,1230538.4
330475,201912,1456,387,1069,386226,1066862,1453088
330480,201912,799,423,376,425148,376246.6,801394.6
330490,201912,14068,4721,9347,4743495.1,9408154.06,14151649.16
330500,201912,1406,610,796,610776,796404.46,1407180.46
330510,201912,10825,3746,7079,3777432.26,7156662.21,10934094.47
330513,201912,102,52,50,51896,49900,101796
330515,201912,819,338,481,337324.3,483032.8,820357.1
330520,201912,2491,900,1591,904188.54,1591810,2495998.54
330530,201912,209,116,93,115768.5,92814.6,208583.1
330540,201912,365,179,186,178642.4,186626,365268.4
330550,201912,2891,1032,1859,1030934.68,1866260.8,2897195.48
330555,201912,817,321,496,321356,498002,819358
330560,201912,665,214,451,213572,452094.94,665666.94
330570,201912,264,190,74,189620,73852,263472
330575,201912,782,305,477,306386,478044.1,784430.1
330580,201912,3331,1868,1463,1877240.35,1472050.4,3349290.75
330590,201912,291,149,142,148702.62,143712.98,292415.60
330600,201912,1157,736,421,736225,421156,1157381
330610,201912,1571,857,714,863272.2,716565.4,1579837.6
330615,201912,205,160,45,159680,44910,204590
330620,201912,1067,429,638,429140.6,640716,1069856.6
330630,201912,4055,2570,1485,2572847.16,1490014.5,4062861.66
350010,201912,599,406,193,407185.25,192614,599799.25
350020,201912,51,22,29,21956,28942,50898
350030,201912,516,326,190,325348.4,189620.4,514968.8
350040,201912,122,48,74,47904,73852,121756
350050,201912,297,158,139,158682,142714,301396
350055,201912,89,47,42,47904,42914,90818
350060,201912,86,30,56,29940,55888,85828
350070,201912,809,481,328,481036.99,329340.8,810377.79
350075,201912,71,50,21,49900,20958,70858
350080,201912,54,30,24,29940,23952,53892
350090,201912,82,46,36,45908,35928,81836
350100,201912,292,180,112,179640,113772,293412
350110,201912,59,40,19,39920,18962,58882
350115,201912,151,92,59,91816,58882,150698
350120,201912,108,72,36,71856,35928,107784
350130,201912,355,165,190,164670.18,191616.98,356287.16
350140,201912,43,29,14,28942,13972,42914
350150,201912,74,55,19,54890,18962,73852
350160,201912,2485,980,1505,985031.66,1508982.93,2494014.59
350170,201912,392,236,156,237525.14,157684.4,395209.54
350180,201912,175,101,74,100798,74850.4,175648.4
350190,201912,1013,533,480,533099.36,480038.4,1013137.76
350200,201912,69,24,45,23952,44910,68862
350210,201912,1311,732,579,732533.8,577842.63,1310376.43
350220,201912,669,560,109,560876.63,109780,670656.63
350230,201912,74,53,21,52894,20958,73852
350240,201912,64,45,19,44910,18962,63872
350250,201912,1132,544,588,545907,590817.1,1136724.1
350260,201912,92,68,24,67864,23952,91816
350270,201912,853,570,283,569859,283432.4,853291.4
350275,201912,302,125,177,126746,177644,304390
350280,201912,4619,2356,2263,2360276.87,2272450.95,4632727.82
350290,201912,439,200,239,201596,238522.4,440118.4
350300,201912,55,29,26,28942,25948,54890
350310,201912,92,57,35,56886,34930,91816
350315,201912,41,24,17,23952,16966,40918
350320,201912,3312,1619,1693,1617759.4,1699594.6,3317354.0
350330,201912,1659,892,767,892215.63,769459.2,1661674.83
350335,201912,18,13,5,13972,4990,18962
350340,201912,124,59,65,58882,64870.3,123752.3
350350,201912,91,45,46,44910,45908,90818
350360,201912,122,81,41,80838.99,40918,121756.99
350370,201912,88,51,37,50898.63,36926,87824.63
350380,201912,783,332,451,332334.4,451097.2,783431.6
350390,201912,1527,601,926,599799.43,931134.4,1530933.83
350395,201912,25,20,5,19960,4990,24950
350400,201912,1699,872,827,873253.19,828341.62,1701594.81
350410,201912,2521,1108,1413,1109776,1412170.63,2521946.63
350420,201912,246,149,97,148703.03,96806,245509.03
350430,201912,73,45,28,44910,27944,72854
350440,201912,150,109,41,108782.4,40918,149700.4
350450,201912,1636,980,656,978042.67,656686,1634728.67
350460,201912,375,127,248,126746,249500,376246
350470,201912,18,11,7,11976,6986,18962
350480,201912,169,94,75,93812,74850,168662
350490,201912,233,116,117,116766,117764,234530
350500,201912,50,19,31,18962,30938,49900
350510,201912,166,108,58,107784,58882,166666
350520,201912,455,226,229,226546,229540,456086
350530,201912,451,210,241,209580,240518,450098
350535,201912,81,66,15,65868,14970,80838
350540,201912,388,191,197,190618,196606,387224
350550,201912,2740,1629,1111,1637720.91,1112775.38,2750496.29
350560,201912,645,448,197,453092,196606,649698
350570,201912,4114,1714,2400,1719555.63,2414166.45,4133722.08
350580,201912,373,176,197,175648,197604.99,373252.99
350590,201912,895,494,401,495008.4,400198,895206.4
350600,201912,6122,2988,3134,2996001.67,3135719.37,6131721.04
350610,201912,1524,791,733,795407.26,733531.58,1528938.84
350620,201912,29,19,10,18962,9980,28942
350630,201912,242,135,107,134730.63,108782.63,243513.26
350635,201912,937,383,554,384230.79,558880.8,943111.59
350640,201912,129,95,34,94810,33932,128742
350650,201912,1891,1255,636,1257480.58,635726.98,1893207.56
350660,201912,743,319,424,320358,423152.99,743510.99
350670,201912,305,149,156,148702,156686,305388
350680,201912,180,94,86,93812,85828.8,179640.8
350690,201912,198,101,97,100798,97804,198602
350700,201912,769,365,404,366266.4,403192.4,769458.8
350710,201912,363,133,230,133732,229540,363272
350715,201912,54,43,11,42914,10978,53892
350720,201912,18,11,7,10978,6986,17964
350730,201912,44,27,17,27944,17964,45908
350740,201912,213,124,89,123752,89820,213572
350745,201912,22,11,11,10978,10978,21956
350750,201912,2188,1361,827,1363270.38,830336,2193606.38
350760,201912,3755,1638,2117,1643706.66,2119752,3763458.66
350770,201912,63,46,17,45908,16966,62874
350775,201912,45,32,13,31936,12974.98,44910.98
350780,201912,435,220,215,219560,215568.4,435128.4
350790,201912,376,158,218,157684,218562,376246
350800,201912,464,273,191,273452,190618,464070
350810,201912,513,418,95,418162.93,94810,512972.93
350820,201912,92,57,35,56886,34930,91816
350830,201912,81,42,39,41916,38922,80838
350840,201912,765,318,447,318362.4,450099.38,768461.78
350850,201912,1742,984,758,985026.5,761477.35,1746503.85
350860,201912,599,342,257,342315.9,257484,599799.9
350870,201912,425,285,140,285428,139720,425148
350880,201912,286,156,130,155688.5,129740,285428.5
350890,201912,40,27,13,26946,12974,39920
350900,201912,1449,455,994,457084.7,995006.63,1452091.33
350910,201912,26,15,11,14970,10978,25948
350920,201912,665,354,311,354290,312374,666664
350925,201912,1208,645,563,643710.78,563871.35,1207582.13
350930,201912,98,61,37,60878,36926,97804
350940,201912,713,397,316,397204,317364,714568
350945,201912,110,80,30,79840,29940,109780
350950,201912,16210,7684,8526,7724524.71,8570830.23,16295354.94
350960,201912,1315,618,697,617762.4,700597.39,1318359.79
350970,201912,1099,577,522,575740.03,522953.2,1098693.23
350980,201912,95,62,33,61876,32934,94810
350990,201912,379,136,243,136726,242514,379240
350995,201912,38,17,21,16966,20958,37924
351000,201912,640,441,199,440119.26,198602,638721.26
351010,201912,49,30,19,29940,18962,48902
351015,201912,52,37,15,36926,14970,51896
351020,201912,1590,957,633,956085.39,633730,1589815.39
351030,201912,346,231,115,230538,114770,345308
351040,201912,876,460,416,461076.48,415168.11,876244.59
351050,201912,3317,1520,1797,1521955.31,1797404.52,3319359.83
351060,201912,5216,2060,3156,2065861.96,3162665.96,5228527.92
351070,201912,411,255,156,255489.77,156686,412175.77
351080,201912,763,559,204,559878.03,203592,763470.03
351090,201912,53,24,29,23952,28942,52894
351100,201912,434,250,184,250498.68,183632,434130.68
351110,201912,2052,979,1073,985036,1076860.98,2061896.98
351120,201912,67,33,34,32934,33932,66866
351130,201912,186,59,127,58882,126746,185628
351140,201912,328,225,103,224550,103792,328342
351150,201912,440,232,208,231536.3,208582.4,440118.7
351160,201912,266,181,85,180638.4,84830,265468.4
351170,201912,185,99,86,100798,85828,186626
351190,201912,84,57,27,56886,26946,83832
351200,201912,366,247,119,247504.4,119760,367264.4
351210,201912,119,60,59,59880,58882,118762
351220,201912,530,317,213,318363.76,212574,530937.76
351230,201912,275,191,84,190618,83832,274450
351240,201912,234,111,123,110778,123752,234530
351250,201912,78,55,23,54890.53,22954,77844.53
351260,201912,155,117,38,117764,37924,155688
351270,201912,44,19,25,18962,24950,43912
351280,201912,1020,465,555,466067.26,558882.01,1024949.27
351290,201912,241,108,133,108782,134730.4,243512.4
351300,201912,3745,1681,2064,1694528.22,2068855.62,3763383.84
351310,201912,767,388,379,387224,378242.98,765466.98
351320,201912,115,67,48,66866,47904,114770
351330,201912,39,25,14,24950,14970,39920
351340,201912,1241,737,504,739519,502994.95,1242513.95
351350,201912,2467,1422,1045,1427141.4,1049896,2477037.4
351360,201912,770,376,394,375248,395208,770456
351370,201912,395,197,198,196606.4,200598,397204.4
351380,201912,9080,4114,4966,4123742.13,4988009,9111751.13
351385,201912,29,18,11,17964,10978,28942
351390,201912,279,210,69,211576.54,68862,280438.54
351400,201912,65,41,24,40918,23954.94,64872.94
351410,201912,435,277,158,276446.99,158682,435128.99
351420,201912,64,52,12,52894,11976,64870
351430,201912,65,35,30,34930,29940,64870
351440,201912,794,555,239,554890.73,238522,793412.73
351450,201912,263,129,134,128742,134730,263472
351460,201912,119,55,64,54890,63872,118762
351470,201912,144,76,68,75848,69860,145708
351480,201912,511,290,221,289421.36,220558,509979.36
351490,201912,285,102,183,102794,183632,286426
351492,201912,31,22,9,21956,8982,30938
351495,201912,25,18,7,17964,6986,24950
351500,201912,3579,1507,2072,1511971.34,2069853.36,3581824.70
351510,201912,1871,751,1120,752492.8,1121752.4,1874245.2
351512,201912,20,15,5,14970,4990,19960
351515,201912,196,112,84,113772,84830.96,198602.96
351518,201912,756,472,284,474050.99,285428,759478.99
351519,201912,75,46,29,45908,28942,74850
351520,201912,155,94,61,93812,60878,154690
351530,201912,23,14,9,13972,8982,22954
351535,201912,131,75,56,74850,56886,131736
351540,201912,455,328,127,327344.42,126746,454090.42
351550,201912,1424,842,582,840318.86,581834,1422152.86
351560,201912,67,39,28,38922,27944,66866
351565,201912,9,7,2,6986,1996,8982
351570,201912,2686,1340,1346,1340316.38,1349298.97,2689615.35
351580,201912,38,34,4,33932,3992,37924
351590,201912,62,42,20,41916,19960,61876
351600,201912,187,137,50,137724,49900,187624
351610,201912,56,25,31,24950,30938,55888
351620,201912,5832,3280,2552,3290409.94,2565858.7,5856268.64
351630,201912,2767,1378,1389,1382231.7,1393208,2775439.7
351640,201912,1943,910,1033,912172.49,1031933.03,1944105.52
351650,201912,30,26,4,25948,3992,29940
351660,201912,143,93,50,92814,49900,142714
351670,201912,708,437,271,439121.8,270458,709579.8
351680,201912,72,60,12,59880,11976,71856
351685,201912,28,15,13,15968,12974,28942
351690,201912,306,212,94,212574.45,93812,306386.45
351700,201912,160,111,49,110778.4,48902,159680.4
351710,201912,70,46,24,45908,23952,69860
351720,201912,131,74,57,73852,56886,130738
351730,201912,106,71,35,71856,34930.63,106786.63
351740,201912,739,483,256,482036.27,255488,737524.27
351750,201912,358,148,210,147704,210578,358282
351760,201912,778,589,189,589818,188622,778440
351770,201912,316,269,47,268462.63,46906,315368.63
351780,201912,157,92,65,91816.98,65868,157684.98
351790,201912,251,133,118,132734,118762.3,251496.3
351800,201912,43,29,14,28942,13972,42914
351810,201912,120,80,40,80838,39920,120758
351820,201912,831,599,232,599799.2,233533.39,833332.59
351830,201912,536,189,347,188622,349300,537922
351840,201912,1903,951,952,953091.84,954090.97,1907182.81
351850,201912,250,180,70,179640,69860,249500
351860,201912,679,467,212,470060.41,211576,681636.41
351870,201912,5600,2632,2968,2644702.84,2991008.73,5635711.57
351880,201912,19287,7990,11297,8008960.48,11336329.3,19345289.78
351885,201912,90,58,32,57884,31936,89820
351890,201912,75,63,12,62874,11976,74850
351900,201912,224,130,94,131736,93812,225548
351905,201912,75,31,44,30938,44910,75848
351907,201912,3405,1416,1989,1425144.94,1998000.15,3423145.09
351910,201912,178,70,108,70858,108782,179640
351920,201912,122,71,51,70858,50899.98,121757.98
351925,201912,90,59,31,58882,30938,89820
351930,201912,392,254,138,254490,137724,392214
351940,201912,245,107,138,107784,137724,245508
351950,201912,133,74,59,73852,58882,132734
351960,201912,895,435,460,434443,460078.4,894521.4
351970,201912,1864,991,873,996004.4,877243.78,1873248.18
351980,201912,150,77,73,76846,72854,149700
351990,201912,257,169,88,168662.8,87824,256486.8
352000,201912,354,220,134,219560.8,133732,353292.8
352010,201912,396,252,144,252494,146706,399200
352020,201912,184,67,117,66866,116766,183632
352030,201912,1081,553,528,552892,529938,1082830
352040,201912,574,239,335,238522,334330,572852
352042,201912,284,88,196,87824,196606.8,284430.8
352044,201912,356,217,139,218562,139720,358282
352050,201912,3240,1275,1965,1276444.76,1970052.4,3246497.16
352060,201912,105,66,39,65868,38922,104790
352070,201912,94,69,25,68863.26,24950,93813.26
352080,201912,70,44,26,43912,25948,69860
352090,201912,164,110,54,109780,53892,163672
352100,201912,279,134,145,133733.39,144712.38,278445.77
352110,201912,113,33,80,32934,79840,112774
352115,201912,63,21,42,21956,41916,63872
352120,201912,86,60,26,59880.63,25948,85828.63
352130,201912,219,182,37,181636,36926,218562
352140,201912,188,87,101,86826,100798,187624
352150,201912,115,61,54,60878,53892,114770
352160,201912,139,89,50,88822,49900,138722
352170,201912,378,264,114,263472,113772,377244
352180,201912,609,399,210,399200.63,209581.39,608782.02
352190,201912,251,100,151,102794,150698,253492
352200,201912,31,16,15,15968,14970,30938
352210,201912,4037,1663,2374,1667660.83,2381230.43,4048891.26
352215,201912,55,32,23,31936,22954,54890
352220,201912,6869,2600,4269,2611769.31,4287413.35,6899182.66
352230,201912,3316,2147,1169,2150704.89,1173658.5,3324363.39
352240,201912,2354,1355,999,1358279,998998.4,2357277.4
352250,201912,2723,1326,1397,1327342.65,1400195.97,2727538.62
352260,201912,972,504,468,503990.4,468062.4,972052.8
352265,201912,56,25,31,24950,30938,55888
352270,201912,405,235,170,235528,170659.88,406187.88
352280,201912,436,272,164,272455.26,163672,436127.26
352290,201912,169,101,68,101796,67864,169660
352300,201912,96,69,27,69860,26946,96806
352310,201912,6231,2817,3414,2822349.66,3415159.01,6237508.67
352320,201912,999,521,478,520956.4,477044,998000.4
352330,201912,527,256,271,257484,271456.4,528940.4
352340,201912,1355,632,723,633731.2,723551.2,1357282.4
352350,201912,338,204,134,203592,133732,337324
352360,201912,217,98,119,98802,120758.2,219560.2
352370,201912,105,70,35,69860,35928,105788
352380,201912,113,73,40,72854,39920,112774
352390,201912,2437,1067,1370,1070855.4,1376243.91,2447099.31
352400,201912,490,214,276,215568,277444.4,493012.4
352410,201912,827,590,237,591814.63,236526,828340.63
352420,201912,104,71,33,70858,32934,103792
352430,201912,1719,782,937,784430.69,940118.84,1724549.53
352440,201912,3176,1583,1593,1587819.97,1598798.76,3186618.73
352450,201912,201,166,35,165668,34930,200598
352460,201912,611,316,295,316366.99,294410,610776.99
352470,201912,652,224,428,223552,427144,650696
352480,201912,1394,771,623,772452,621754.4,1394206.4
352490,201912,62,23,39,22954,38922,61876
352500,201912,1211,526,685,529938.34,688621.38,1218559.72
352510,201912,740,399,341,399201.26,340318,739519.26
352520,201912,650,307,343,306386.84,342314,648700.84
352530,201912,1750,924,826,925146,826344.4,1751490.4
352540,201912,77,49,28,48902,27944,76846
352550,201912,182,109,73,108782,73852,182634
352560,201912,46,37,9,36926,8982,45908
352570,201912,675,351,324,351296.63,323352,674648.63
352580,201912,55,42,13,42914,12974,55888
352585,201912,19,6,13,5988,12974,18962
352590,201912,4426,2224,2202,2238514.63,2208575.78,4447090.41
352600,201912,348,252,96,252494,96806,349300
352610,201912,949,431,518,431136.57,520956,952092.57
352620,201912,1006,406,600,405188,601794,1006982
352630,201912,174,64,110,64870,109780,174650
352640,201912,534,359,175,359280.96,175648,534928.96
352650,201912,83,59,24,58882,24950,83832
352660,201912,72,44,28,43912,27944,71856
352670,201912,1662,899,763,899199.59,764475.92,1663675.51
352680,201912,924,577,347,577843.59,347304,925147.59
352690,201912,4532,2048,2484,2054885.43,2486019.61,4540905.04
352700,201912,107,64,43,63872.4,42914,106786.4
352710,201912,1372,734,638,739518,641714,1381232
352720,201912,1341,625,716,630736,717562.4,1348298.4
352725,201912,25,21,4,20958,3992,24950
352730,201912,391,202,189,202594,188622,391216
352740,201912,405,259,146,262474.96,146706.68,409181.64
352750,201912,19,12,7,11976,6986,18962
352760,201912,176,117,59,117764,58882,176646
352770,201912,83,64,19,63872,18962,82834
352780,201912,75,40,35,39920,34930,74850
352790,201912,27,22,5,21956.63,4990,26946.63
352800,201912,236,171,65,170658,64870,235528
352810,201912,152,94,58,93813.03,57884,151697.03
352820,201912,64,51,13,50898,12974,63872
352830,201912,85,56,29,55888,28942,84830
352840,201912,671,339,332,339320,332334,671654
352850,201912,1479,501,978,501994,981034,1483028
352860,201912,123,77,46,76846,45908,122754
352870,201912,43,27,16,26946,15968.4,42914.4
352880,201912,186,124,62,123752,61876,185628
352885,201912,32,22,10,21956,9980,31936
352890,201912,53,36,17,35928,16966.4,52894.4
352900,201912,4819,2349,2470,2350295.36,2482033.78,4832329.14
352910,201912,39,32,7,31936,6986,38922
352920,201912,668,401,267,400198,267464,667662
352930,201912,1217,584,633,586838.12,633774.02,1220612.14
352940,201912,6197,2596,3601,2608776.01,3611769.09,6220545.10
352950,201912,103,39,64,38922,64870,103792
352960,201912,56,39,17,38922,16966,55888
352965,201912,19,9,10,8982,9980,18962
352970,201912,517,394,123,395208.02,124751.61,519959.63
352980,201912,163,88,75,88822,75848,164670
352990,201912,973,442,531,441116,529938,971054
353000,201912,65,30,35,29940,34930,64870
353010,201912,543,337,206,337324,205588,542912
353020,201912,297,214,83,214570,82834,297404
353030,201912,1239,566,673,565866.34,673651.96,1239518.30
353040,201912,90,57,33,56886,32934,89820
353050,201912,1324,855,469,854289.69,473052,1327341.69
353060,201912,8415,3687,4728,3698596.78,4740509.88,8439106.66
353070,201912,1741,1091,650,1090816.16,649520.35,1740336.51
353080,201912,1296,693,603,693611.16,607782,1301393.16
353090,201912,56,31,25,30938,24950,55888
353100,201912,53,43,10,43912,9980,53892
353110,201912,2065,622,1443,622752.4,1445105.89,2067858.29
353120,201912,91,48,43,48902,42914,91816
353130,201912,844,414,430,413175.13,432136.94,845312.07
353140,201912,552,224,328,226546.63,330338,556884.63
353150,201912,346,195,151,194610.63,150698,345308.63
353160,201912,93,77,16,77844,15968,93812
353170,201912,209,67,142,66866,143713.96,210579.96
353180,201912,1028,475,553,478042,552894.08,1030936.08
353190,201912,504,369,135,369260,134730.4,503990.4
353200,201912,211,108,103,107784,102794,210578
353205,201912,21,15,6,14970,5988,20958
353210,201912,80,46,34,45908,33932,79840
353215,201912,47,27,20,26946,19960,46906
353220,201912,81,45,36,44910,35928,80838
353230,201912,164,64,100,64870,99800,164670
353240,201912,316,167,149,166666,148702,315368
353250,201912,213,108,105,109780,105788,215568
353260,201912,462,325,137,326347.1,136726,463073.1
353270,201912,70,53,17,52894,16966,69860
353280,201912,105,54,51,53892.6,50898,104790.6
353282,201912,126,89,37,88822,36926,125748
353284,201912,25,18,7,17964,6986,24950
353286,201912,1,0,1,0,998,998
353290,201912,74,44,30,43912,29940,73852
353300,201912,439,242,197,241517.96,196606,438123.96
353310,201912,46,40,6,39920,5988,45908
353320,201912,59,34,25,33932,24950,58882
353325,201912,54,31,23,30938,22955.36,53893.36
353330,201912,62,44,18,43912.7,17964,61876.7
353340,201912,629,216,413,216566,416166.4,632732.4
353350,201912,892,428,464,429141.96,465070.36,894212.32
353360,201912,102,82,20,81836,19960,101796
353370,201912,121,67,54,67864,53892,121756
353380,201912,32,18,14,17964.99,13972,31936.99
353390,201912,1111,535,576,534928,576844,1111772
353400,201912,45,26,19,25948,18962,44910
353410,201912,107,66,41,66866,40918.9,107784.9
353420,201912,61,27,34,27944,33932,61876
353430,201912,588,397,191,396207.38,191616,587823.38
353440,201912,10554,4613,5941,4632919.63,5963060.36,10595979.99
353450,201912,56,30,26,29940,25948,55888
353460,201912,604,329,275,331336.1,274450,605786.1
353470,201912,2130,1122,1008,1122753.79,1007983.96,2130737.75
353475,201912,237,160,77,160679.38,76846,237525.38
353480,201912,184,153,31,154690,30938,185628
353490,201912,240,148,92,147704,91816.4,239520.4
353500,201912,197,117,80,116766.63,79840,196606.63
353510,201912,101,71,30,70858,29940,100798
353520,201912,212,149,63,148702,62874,211576
353530,201912,465,253,212,252494,212574,465068
353540,201912,381,256,125,258482,124750,383232
353550,201912,730,471,259,472055.24,259480,731535.24
353560,201912,597,237,360,238522,359280.6,597802.6
353570,201912,65,35,30,34930.4,29940,64870.4
353580,201912,357,266,91,265468.34,90818,356286.34
353590,201912,93,66,27,66866,26946,93812
353600,201912,276,161,115,160678.63,115768,276446.63
353610,201912,127,69,58,68862,57884,126746
353620,201912,611,321,290,321356,292414,613770
353625,201912,49,27,22,26946,22954,49900
353630,201912,232,170,62,170658.58,61876,232534.58
353640,201912,124,85,39,84830,38922,123752
353650,201912,925,358,567,361276,565866,927142
353657,201912,24,18,6,17964,5988,23952
353660,201912,267,142,125,141716,124750,266466
353670,201912,776,463,313,463073.03,314370.4,777443.43
353680,201912,105,75,30,74850.5,29940,104790.5
353690,201912,43,33,10,32934,9980,42914
353700,201912,282,202,80,201596,79840,281436
353710,201912,461,224,237,223552.6,237524.4,461077.0
353715,201912,45,33,12,32934,11976,44910
353720,201912,349,160,189,160679.38,189620,350299.38
353730,201912,1083,666,417,667662.8,418196.06,1085858.86
353740,201912,626,342,284,341316,285428,626744
353750,201912,79,48,31,47904,30938,78842
353760,201912,2896,1091,1805,1093809.26,1816362.18,2910171.44
353770,201912,87,70,17,69860,16966,86826
353780,201912,1192,568,624,567862.63,622752,1190614.63
353790,201912,512,305,207,306386.96,206586.4,512973.36
353800,201912,3329,1642,1687,1641731.89,1691681.35,3333413.24
353810,201912,237,133,104,132734.98,103793.96,236528.94
353820,201912,198,95,103,94810,102794,197604
353830,201912,49,42,7,41916,6986,48902
353850,201912,179,84,95,83832,94810,178642
353860,201912,501,227,274,226546,273452,499998
353870,201912,5277,2677,2600,2682631.36,2603784.1,5286415.46
353880,201912,691,487,204,487025.36,203592,690617.36
353890,201912,578,332,246,331336.4,245509.12,576845.52
353900,201912,130,69,61,69860,60878,130738
353910,201912,170,77,93,76846,92814,169660
353920,201912,436,242,194,242514.3,193612,436126.3
353930,201912,999,587,412,589818,413174.14,1002992.14
353940,201912,193,101,92,100798,91816,192614
353950,201912,515,316,199,315368,198602,513970
353960,201912,73,60,13,59880,12974,72854
353970,201912,64,39,25,38922,25948,64870
353980,201912,1655,774,881,775446,883234.36,1658680.36
353990,201912,74,44,30,43912,29940,73852
354000,201912,376,183,193,183632,193612.99,377244.99
354010,201912,88,47,41,46906,40918,87824
354020,201912,523,332,191,333332,191616,524948
354025,201912,55,45,10,44910,9980,54890
354030,201912,56,34,22,33932,21956,55888
354040,201912,103,77,26,78842,25948,104790
354050,201912,184,97,87,96806.43,86826,183632.43
354060,201912,774,381,393,382234,395208,777442
354070,201912,912,528,384,526944.4,384230.4,911174.8
354075,201912,223,108,115,108782,114770,223552
354080,201912,306,132,174,131736,174650,306386
354085,201912,22,14,8,13972,7984,21956
354090,201912,296,169,127,169576,129740,299316
354100,201912,5525,2299,3226,2302386.93,3245498.92,5547885.85
354105,201912,91,43,48,42914,47904,90818
354110,201912,48,24,24,23952,23952,47904
354120,201912,137,98,39,97804.98,38922,136726.98
354130,201912,711,458,253,458082.98,254491.38,712574.36
354140,201912,3138,1450,1688,1452091.29,1691610.4,3143701.69
354150,201912,630,384,246,384231.89,245508,629739.89
354160,201912,668,426,242,426146,242514.71,668660.71
354165,201912,18,14,4,13972,4990,18962
354170,201912,176,118,58,117764,57884,175648
354180,201912,64,38,26,37924.51,25948,63872.51
354190,201912,197,86,111,85828,111776,197604
354200,201912,121,64,57,63872,56886,120758
354210,201912,56,24,32,24950,31936,56886
354220,201912,644,406,238,405188,237524,642712
354230,201912,172,73,99,73852.6,98802,172654.6
354240,201912,328,213,115,212574.64,114770,327344.64
354250,201912,83,51,32,50898,31936,82834
354260,201912,2040,959,1081,959081.03,1083829.27,2042910.30
354270,201912,94,68,26,67864,25948,93812
354280,201912,43,23,20,22954,19960,42914
354290,201912,146,101,45,100798,44910,145708
354300,201912,387,272,115,271456.63,114770,386226.63
354310,201912,96,71,25,71856.4,24950,96806.4
354320,201912,195,97,98,96806,98802,195608
354323,201912,12,11,1,10978,998,11976
354325,201912,114,68,46,68862.6,45908,114770.6
354330,201912,2488,826,1662,828198.8,1667659.38,2495858.18
354340,201912,10405,5048,5357,5066850.53,5367249.9,10434100.43
354350,201912,121,81,40,80838,40918,121756
354360,201912,80,47,33,46906,32934,79840
354370,201912,247,134,113,134730,115768,250498
354380,201912,190,114,76,113772,76846,190618
354390,201912,2699,992,1707,994009.59,1716560.98,2710570.57
354400,201912,317,172,145,171656,145708,317364
354410,201912,615,296,319,297404,320358.4,617762.4
354420,201912,280,176,104,175648,103792,279440
354425,201912,305,182,123,182634,123752,306386
354430,201912,182,103,79,103792,78842,182634
354440,201912,35,26,9,25948,8982,34930
354450,201912,54,38,16,37924,15968.4,53892.4
354460,201912,104,61,43,61876,43912,105788
354470,201912,37,22,15,21956,14970,36926
354480,201912,113,61,52,61876,52894,114770
354490,201912,146,90,56,89820,55888,145708
354500,201912,376,183,193,182634,192614,375248
354510,201912,99,71,28,70858,27944,98802
354515,201912,38,12,26,11976,25948,37924
354520,201912,1604,690,914,693468.5,915166.8,1608635.3
354530,201912,732,371,361,371257.79,362274,733531.79
354540,201912,269,145,124,145708,123752,269460
354550,201912,40,23,17,22954,16966,39920
354560,201912,149,80,69,80838,68862,149700
354570,201912,141,91,50,90818.5,50898,141716.5
354580,201912,1887,903,984,904190.29,985026.4,1889216.69
354600,201912,251,142,109,142714,110778,253492
354610,201912,75,63,12,62874.46,11976.98,74851.44
354620,201912,61,19,42,18962,42914,61876
354625,201912,15,10,5,9980,4990.99,14970.99
354630,201912,309,199,110,199600.98,109780,309380.98
354640,201912,805,518,287,517963.06,287424,805387.06
354650,201912,72,41,31,40918,30938.98,71856.98
354660,201912,786,584,202,585826.63,201596,787422.63
354670,201912,247,91,156,90818.76,156686.6,247505.36
354680,201912,1258,473,785,472054,784428,1256482
354690,201912,80,54,26,53892.4,25948,79840.4
354700,201912,70,50,20,49900,19960,69860
354710,201912,45,33,12,32934,11976,44910
354720,201912,22,22,0,21956,0,21956
354730,201912,1733,716,1017,717563.78,1020954.4,1738518.18
354740,201912,68,49,19,48902,18962,67864
354750,201912,436,251,185,251496.98,185628,437124.98
354760,201912,480,292,188,292415.3,187624.4,480039.7
354765,201912,10,5,5,4990,4990,9980
354770,201912,347,227,120,227544.4,119760,347304.4
354780,201912,8197,3283,4914,3296405.8,4936130.09,8232535.89
354790,201912,99,57,42,56886,41916,98802
354800,201912,445,243,202,242514,201596.4,444110.4
354805,201912,101,47,54,46906.4,53892,100798.4
354810,201912,106,63,43,62874,42914,105788
354820,201912,202,86,116,85828.56,115768,201596.56
354830,201912,39,20,19,19960,18962,38922
354840,201912,64,45,19,44910,18962,63872
354850,201912,4532,2022,2510,2027937.2,2520949.1,4548886.3
354860,201912,331,158,173,157684,172654.93,330338.93
354870,201912,12264,5509,6755,5527931.66,6779422.42,12307354.08
354880,201912,2869,1070,1799,1072851.69,1816364.23,2889215.92
354890,201912,2894,1565,1329,1569856.83,1331332,2901188.83
354900,201912,64,44,20,43912,19960,63872
354910,201912,1255,666,589,666664.4,591814,1258478.4
354920,201912,47,39,8,38922,7984,46906
354925,201912,12,7,5,6986,4990,11976
354930,201912,35,32,3,31936.43,2994,34930.43
354940,201912,808,589,219,590069.93,221556,811625.93
354950,201912,200,134,66,133732.1,66866,200598.1
354960,201912,157,61,96,60878,95808,156686
354970,201912,930,619,311,619759.77,312374.4,932134.17
354980,201912,8689,3168,5521,3170649.76,5529927.46,8700577.22
354990,201912,9128,4236,4892,4249491.31,4906218.84,9155710.15
354995,201912,545,184,361,183632,360278,543910
355000,201912,468,164,304,163672,305388,469060
355010,201912,613,384,229,384231,230539.23,614770.23
355020,201912,754,473,281,472054.32,281437.39,753491.71
355030,201912,206971,80474,126497,80778339.66,127417874.97,208196214.63
355040,201912,744,351,393,350298.4,394210,744508.4
355050,201912,150,96,54,95808,53892,149700
355060,201912,1589,803,786,804389.2,786424.6,1590813.8
355070,201912,1443,684,759,684630.31,760477.61,1445107.92
355080,201912,201,120,81,120758,80838,201596
355090,201912,284,171,113,172654,112774.32,285428.32
355100,201912,4977,2379,2598,2392110.82,2609772.19,5001883.01
355110,201912,265,177,88,176647.39,89820,266467.39
355120,201912,80,58,22,57884,21956.98,79840.98
355130,201912,51,29,22,28942,21956,50898
355140,201912,182,114,68,113772,67864,181636
355150,201912,668,408,260,407185.39,266466,673651.39
355160,201912,463,223,240,223552.63,240518.4,464071.03
355170,201912,2056,1085,971,1089816,973050,2062866
355180,201912,671,288,383,288422,382234,670656
355190,201912,205,145,60,144710,59880,204590
355200,201912,115,64,51,64870,50898,115768
355210,201912,675,389,286,390218,289420.98,679638.98
355220,201912,7090,3717,3373,3722545.77,3387218.1,7109763.87
355230,201912,99,59,40,59880,39920,99800
355240,201912,4430,1878,2552,1881232.88,2558873.97,4440106.85
355250,201912,5731,2621,3110,2634739.34,3113766.61,5748505.95
355255,201912,47,28,19,27944,18962,46906
355260,201912,184,110,74,110778.4,73853.96,184632.36
355270,201912,174,111,63,110778,62874,173652
355280,201912,6265,2543,3722,2553884.4,3737511.78,6291396.18
355290,201912,74,58,16,57884.4,15968,73852.4
355300,201912,195,123,72,123752,71856.4,195608.4
355310,201912,109,60,49,59880,49900,109780
355320,201912,89,47,42,46906,41916,88822
355330,201912,283,165,118,164670,117764,282434
355340,201912,1531,520,1011,519958.79,1010974,1530932.79
355350,201912,130,70,60,70858,59880,130738
355360,201912,169,109,60,109780,59880,169660
355365,201912,21,17,4,16966,3992,20958
355370,201912,1032,600,432,600809.38,434137.84,1034947.22
355380,201912,801,521,280,519958,280438,800396
355385,201912,69,48,21,47904,20958,68862
355390,201912,107,62,45,61876,44910,106786
355395,201912,190,113,77,112774.47,76846,189620.47
355400,201912,1631,994,637,998919.1,640716.63,1639635.73
355410,201912,4883,2319,2564,2322350.39,2577838.84,4900189.23
355420,201912,52,37,15,36926,14970,51896
355430,201912,367,224,143,223553.36,142714,366267.36
355440,201912,78,44,34,43912,33932,77844
355450,201912,464,231,233,231536.88,233532.7,465069.58
355460,201912,63,47,16,46906.54,15968,62874.54
355465,201912,47,31,16,30938,15968,46906
355470,201912,174,69,105,69860.7,104790,174650.7
355475,201912,13,9,4,8982,3992,12974
355480,201912,510,221,289,221556.6,288422,509978.6
355490,201912,118,84,34,84830,33932,118762
355495,201912,59,27,32,26946,31936,58882
355500,201912,1598,902,696,904190.58,700598.37,1604788.95
355510,201912,266,199,67,198603.23,66866,265469.23
355520,201912,33,24,9,23952.4,8982,32934.4
355530,201912,21,14,7,13972,6986,20958
355535,201912,78,37,41,36926,40918,77844
355540,201912,2429,964,1465,967203.11,1470056.01,2437259.12
355550,201912,59,37,22,36926,21956,58882
355560,201912,251,118,133,117764,132734,250498
355570,201912,24,16,8,15968,7984,23952
355580,201912,244,170,74,169660,73853.39,243513.39
355590,201912,18,12,6,12974,5988,18962
355600,201912,277,144,133,143712,134730,278442
355610,201912,228,151,77,150698,76846,227544
355620,201912,1330,617,713,616764.4,713570.99,1330335.39
355630,201912,442,324,118,326346,119760.63,446106.63
355635,201912,118,54,64,53892,63873.97,117765.97
355640,201912,567,320,247,319360,247504,566864
355645,201912,843,343,500,343312,500996.8,844308.8
355650,201912,2015,858,1157,858281.74,1158678.98,2016960.72
355660,201912,257,137,120,137724,119760,257484
355670,201912,542,217,325,218562,326346,544908
355680,201912,203,119,84,118762,84830,203592
355690,201912,91,42,49,41916,49900.67,91816.67
355695,201912,17,10,7,9980,6986,16966
355700,201912,1148,607,541,608780.66,543910.8,1152691.46
355710,201912,2248,1239,1009,1241513.23,1008978.98,2250492.21
355715,201912,19,15,4,14970,3992,18962
355720,201912,212,127,85,126746.44,84830,211576.44
355730,201912,99,57,42,57884,41916,99800
410010,201912,132,109,23,108782,22954,131736
410020,201912,112,88,24,87824,23952,111776
410030,201912,160,99,61,98802.4,60878,159680.4
410040,201912,1115,565,550,564868,550896.6,1115764.6
410045,201912,35,28,7,27944,6986,34930
410050,201912,478,270,208,270458,207584,478042
410060,201912,283,214,69,214570,70858,285428
410070,201912,297,250,47,250498,50898,301396
410080,201912,165,104,61,103792,60878,164670
410090,201912,78,68,10,67864.56,9980,77844.56
410100,201912,288,206,82,206586,81836,288422
410105,201912,47,29,18,28942,17964,46906
410110,201912,327,199,128,199600,127744,327344
410115,201912,32,22,10,21956,9980,31936
410120,201912,414,211,203,210578,202594,413172
410130,201912,48,29,19,28942,18962,47904
410140,201912,3125,1534,1591,1537920.44,1595805,3133725.44
410150,201912,2693,1063,1630,1063868.74,1630732.8,2694601.54
410160,201912,514,319,195,318362,194610.11,512972.11
410165,201912,67,43,24,43912,23952,67864
410170,201912,163,113,50,114770.4,49900,164670.4
410180,201912,2253,1263,990,1268458.4,991014.99,2259473.39
410185,201912,37,32,5,31936,4990,36926
410190,201912,491,323,168,323352.51,167664,491016.51
410200,201912,956,710,246,710576,245508,956084
410210,201912,589,311,278,313372,278442.4,591814.4
410220,201912,44,22,22,21956,21956,43912
410230,201912,146,67,79,68862,79840,148702
410240,201912,758,491,267,491017.3,266466,757483.3
410250,201912,380,276,104,275448,103792,379240
410260,201912,292,163,129,162674.4,130738,293412.4
410270,201912,29,20,9,19960,8982,28942
410275,201912,60,44,16,43912,16966,60878
410280,201912,321,188,133,188622,132734,321356
410290,201912,246,154,92,154690,92814,247504
410300,201912,78,56,22,55888,21956,77844
410302,201912,18,11,7,10978,6986,17964
410304,201912,43,29,14,28942,13972,42914
410305,201912,221,117,104,116766,103792,220558
410310,201912,215,129,86,128742,85828,214570
410315,201912,49,34,15,33932,14970,48902
410320,201912,133,93,40,92814,39920,132734
410322,201912,34,22,12,21956,11976,33932
410330,201912,172,121,51,120758,50898.6,171656.6
410335,201912,101,57,44,56886,43912,100798
410337,201912,41,32,9,31936,8982,40918
410340,201912,34,31,3,30938,2994,33932
410345,201912,215,127,88,126746,87824,214570
410347,201912,50,39,11,38922,10978,49900
410350,201912,240,149,91,149700,91816,241516
410360,201912,476,303,173,302394.8,172654.8,475049.6
410370,201912,2360,1008,1352,1008979.68,1352291.14,2361270.82
410380,201912,214,131,83,130738,82834,213572
410390,201912,379,268,111,267464,111776,379240
410395,201912,36,23,13,22954,12974,35928
410400,201912,826,395,431,395209.61,429575.5,824785.11
410405,201912,95,70,25,69860,24950,94810
410410,201912,33,25,8,24950,7984,32934
410420,201912,1655,785,870,789331.16,877242.34,1666573.50
410425,201912,173,76,97,75848.6,97804,173652.6
410430,201912,2246,1281,965,1284426,967063.06,2251489.06
410440,201912,370,270,100,270458,100798,371256
410442,201912,350,236,114,236526,113772,350298
410445,201912,419,297,122,297404.72,121756,419160.72
410450,201912,390,198,192,199600,191616,391216
410460,201912,484,256,228,255488.99,227544,483032.99
410465,201912,212,135,77,134730,76846,211576
410470,201912,235,149,86,149700,85828,235528
410480,201912,6138,3017,3121,3020955.18,3119758.41,6140713.59
410490,201912,1425,886,539,885227.55,537922.4,1423149.95
410500,201912,263,152,111,151696,110778,262474
410510,201912,168,125,43,124750,43912.98,168662.98
410520,201912,248,184,64,184630,63872,248502
410530,201912,248,94,154,93812,153692.99,247504.99
410540,201912,321,236,85,236526.99,85828,322354.99
410550,201912,1668,728,940,728540.8,942114.18,1670654.98
410560,201912,148,107,41,107784,40918,148702
410570,201912,439,297,142,296407.32,141716,438123.32
410580,201912,3411,1510,1901,1517960.19,1901191,3419151.19
410590,201912,412,287,125,286409,124750,411159
410600,201912,198,170,28,170658,27944,198602
410610,201912,56,46,10,45908,9980,55888
410620,201912,243,167,76,167664,75848,243512
410630,201912,442,256,186,255488,185628,441116
410640,201912,1019,636,383,639718.7,384230.99,1023949.69
410645,201912,110,80,30,79840.2,29940,109780.2
410650,201912,353,234,119,233532,119760,353292
410655,201912,86,63,23,63872,22954,86826
410657,201912,22,9,13,8982,12974,21956
410660,201912,611,428,183,427144.31,183632,610776.31
410670,201912,75,64,11,63872,10978,74850
410680,201912,208,169,39,168662,38922,207584
410685,201912,19,11,8,10978,7984,18962
410690,201912,28342,12127,16215,12162545.51,16276390.51,28438936.02
410700,201912,343,252,91,251496.4,91816,343312.4
410710,201912,125,104,21,103792,20958,124750
410712,201912,27,21,6,20958,5988,26946
410715,201912,88,67,21,66866,20958,87824
410720,201912,691,398,293,397204,293412.98,690616.98
410725,201912,183,133,50,132734,50898,183632
410730,201912,92,49,43,49900,43912,93812
410740,201912,111,80,31,79840,30938,110778
410750,201912,253,172,81,171656,80838,252494
410752,201912,25,15,10,14970,9980,24950
410753,201912,52,23,29,23952,29940,53892
410754,201912,45,25,20,24950.4,19960,44910.4
410755,201912,80,51,29,50898,28942,79840
410760,201912,760,427,333,427144.4,334330,761474.4
410765,201912,1742,822,920,822353.7,919159.2,1741512.9
410770,201912,109,86,23,86826,22954,109780
410773,201912,55,40,15,39920,14970,54890
410775,201912,186,139,47,138722,48902,187624
410780,201912,83,45,38,45908,37924,83832
410785,201912,57,45,12,44910,11976,56886
410790,201912,71,34,37,33932,36926,70858
410800,201912,283,178,105,178642,105788,284430
410810,201912,21,17,4,16966,3992.4,20958.4
410820,201912,179,131,48,131736,47904,179640
410830,201912,8580,3775,4805,3778433.19,4813363.29,8591796.48
410832,201912,103,73,30,72854,29940,102794
410840,201912,1435,799,636,799400.97,634730.46,1434131.43
410845,201912,66,43,23,42914,22954,65868
410850,201912,197,138,59,137724,59880,197604
410855,201912,57,47,10,46906,9980,56886
410860,201912,721,412,309,411176.4,309380,720556.4
410865,201912,100,77,23,76846,22954,99800
410870,201912,154,131,23,130738,22954,153692
410880,201912,1108,575,533,576849.26,537924.94,1114774.20
410890,201912,89,63,26,62874,25948,88822
410895,201912,72,56,16,55888,15968,71856
410900,201912,23,16,7,15968,6986,22954
410910,201912,15,13,2,12974,1996,14970
410920,201912,38,26,12,25948,12974,38922
410930,201912,504,321,183,320358,182634,502992
410940,201912,4356,2492,1864,2494003.84,1865262.8,4359266.64
410950,201912,108,82,26,81836,25948,107784
410960,201912,796,343,453,342314,454090,796404
410965,201912,65,51,14,50898,13972,64870
410970,201912,630,450,180,451096,179640,630736
410975,201912,121,73,48,73852.72,47904,121756.72
410980,201912,1624,744,880,746504,884228.99,1630732.99
410990,201912,266,185,81,184630,81836,266466
411000,201912,65,41,24,40918,23952.4,64870.4
411005,201912,27,23,4,22954,3992,26946
411007,201912,264,157,107,157684,106786,264470
411010,201912,603,417,186,417164,185628,602792
411020,201912,291,202,89,203592.46,88822,292414.46
411030,201912,17,10,7,9980,6986,16966
411040,201912,59,42,17,41916,16966,58882
411050,201912,207,162,45,163672,44910,208582
411060,201912,511,346,165,347304.98,165668,512972.98
411065,201912,61,53,8,52894,7984,60878
411070,201912,1245,775,470,779438.6,470058,1249496.6
411080,201912,230,164,66,165668,65868,231536
411090,201912,105,79,26,78842,25948,104790
411095,201912,280,110,170,109780,169660,279440
411100,201912,118,97,21,96806,20958,117764
411110,201912,127,84,43,83832,42914,126746
411120,201912,201,143,58,143712,57884,201596
411125,201912,233,100,133,99800,132734,232534
411130,201912,128,111,17,110778,16966,127744
411140,201912,207,138,69,137724,68862,206586
411150,201912,1233,819,414,824348,414170.63,1238518.63
411155,201912,124,83,41,82834,40918,123752
411160,201912,25,12,13,11976,12974,24950
411170,201912,51,46,5,45908,4990,50898
411180,201912,973,647,326,647702,325348,973050
411190,201912,332,198,134,198602,133732,332334
411200,201912,668,425,243,425148.63,243512,668660.63
411210,201912,692,375,317,374250,317364.98,691614.98
411220,201912,149,111,38,110778,37924,148702
411230,201912,41,35,6,34930,5988,40918
411240,201912,127,81,46,80838,45908,126746
411250,201912,436,325,111,324350,111776,436126
411260,201912,20,14,6,13972,5988.96,19960.96
411270,201912,277,147,130,146706,131736,278442
411275,201912,193,170,23,170658,22954,193612
411280,201912,212,151,61,150698.63,61876,212574.63
411290,201912,60,47,13,46906,12974,59880
411295,201912,141,111,30,110778,29940,140718
411300,201912,72,34,38,33932,37924,71856
411310,201912,89,70,19,69860,19960,89820
411320,201912,771,526,245,524948,245508.6,770456.6
411325,201912,61,42,19,42914,18962,61876
411330,201912,900,575,325,575846.8,324350.16,900196.96
411340,201912,25,18,7,17964,6986,24950
411342,201912,67,50,17,49900,16966,66866
411345,201912,119,58,61,57884,60878,118762
411350,201912,477,377,100,378242.58,100798.4,479040.98
411360,201912,55,35,20,35928,19960,55888
411370,201912,14237,5838,8399,5847287,8412156.85,14259443.85
411373,201912,177,128,49,128742,48902,177644
411375,201912,74,59,15,59880,14970,74850
411380,201912,92,69,23,68862,22954,91816
411390,201912,118,79,39,78842,38922,117764
411400,201912,365,278,87,277444.98,87824,365268.98
411410,201912,446,225,221,224550,220558.4,445108.4
411420,201912,1012,454,558,453092,560876,1013968
411430,201912,450,268,182,268462,181636.98,450098.98
411435,201912,33,22,11,21956,10978,32934
411440,201912,456,364,92,363272,92814,456086
411450,201912,419,354,65,354290,65868,420158
411460,201912,756,297,459,297404.2,459081.01,756485.21
411470,201912,83,62,21,62874,20958,83832
411480,201912,673,381,292,381236.4,291416,672652.4
411490,201912,291,189,102,189620,101796,291416
411500,201912,101,86,15,85828,14970,100798
411510,201912,221,174,47,174650,46906,221556
411520,201912,6000,2293,3707,2301390.39,3712566.12,6013956.51
411530,201912,121,85,36,84830,36926,121756
411535,201912,50,19,31,18962,30938,49900
411540,201912,350,241,109,243512,108782,352294
411545,201912,54,40,14,39920,13972,53892
411550,201912,75,58,17,57884,16966,74850
411560,201912,383,169,214,169660,213572,383232
411570,201912,816,301,515,300399.26,514968.6,815367.86
411573,201912,25,16,9,15968,8982,24950
411575,201912,291,185,106,185628,105788,291416
411580,201912,1280,487,793,490018,791414,1281432
411585,201912,77,37,40,36926,40918,77844
411590,201912,26,17,9,16966,8982,25948
411600,201912,25,11,14,10978,13972,24950
411605,201912,244,100,144,100798,144710,245508
411610,201912,208,139,69,138722,69860,208582
411620,201912,359,194,165,193612,164670,358282
411630,201912,56,38,18,37924,17964,55888
411640,201912,33,24,9,23952,8982,32934
411650,201912,12,7,5,6986,4990,11976
411660,201912,39,28,11,27944,10978,38922
411670,201912,237,177,60,177644,60878,238522
411680,201912,159,134,25,133732,24950,158682
411690,201912,594,318,276,318362,275448,593810
411695,201912,57,42,15,41916,14970,56886
411700,201912,139,116,23,115768,22954,138722
411705,201912,104,69,35,68862,34930,103792
411710,201912,306,209,97,208582,98802,307384
411720,201912,125,83,42,82834,42914,125748
411721,201912,65,53,12,52894,11976,64870
411722,201912,96,41,55,40918,54890,95808
411725,201912,159,120,39,120758.4,38922,159680.4
411727,201912,84,65,19,65868,18962,84830
411729,201912,42,34,8,33932,7984,41916
411730,201912,552,353,199,353292,198602,551894
411740,201912,40,25,15,24950,14970,39920
411745,201912,67,47,20,46906,19960,66866
411750,201912,870,401,469,400198.4,468062.07,868260.47
411760,201912,1190,886,304,885227.23,303392.98,1188620.21
411770,201912,454,303,151,303392,150698,454090
411780,201912,330,219,111,220558,111776.5,332334.5
411790,201912,530,299,231,298403.27,230538.98,528942.25
411800,201912,163,125,38,124750,37924,162674
411810,201912,173,129,44,129740,43912,173652
411820,201912,2169,986,1183,991015.8,1187620.6,2178636.4
411830,201912,11,11,0,10978,0,10978
411840,201912,1998,1239,759,1244506,762473.2,2006979.2
411845,201912,55,20,35,19960,34930,54890
411850,201912,1210,671,539,675647.39,539920.66,1215568.05
411860,201912,47,32,15,31936.4,14970,46906.4
411870,201912,74,50,24,50898,23952,74850
411880,201912,414,268,146,267464.57,146706,414170.57
411885,201912,104,69,35,68862,34930,103792
411890,201912,310,202,108,201597.79,107784,309381.79
411900,201912,74,55,19,54890.4,18962,73852.4
411910,201912,186,149,37,148702,36926,185628
411915,201912,2145,897,1248,898200,1251493.22,2149693.22
411920,201912,118,93,25,92814,24950,117764
411925,201912,12,8,4,7984,3992,11976
411930,201912,812,594,218,593810.74,218562,812372.74
411940,201912,588,404,184,404190.34,183632,587822.34
411950,201912,963,478,485,478042.4,485028,963070.4
411960,201912,1026,701,325,701594.9,325348,1026942.9
411965,201912,19,14,5,13972,4990,18962
411970,201912,83,74,9,73852,8982,82834
411980,201912,171,114,57,113772,56886,170658
411990,201912,5168,2999,2169,3001990.56,2172647.7,5174638.26
411995,201912,474,176,298,175648,297404,473052
412000,201912,309,201,108,200598,108782,309380
412010,201912,48,32,16,31936,15968,47904
412015,201912,41,29,12,28942,11976,40918
412020,201912,32,26,6,25948,5988,31936
412030,201912,48,45,3,45908,2994,48902
412033,201912,52,31,21,30938,20958,51896
412035,201912,68,46,22,45908,21956,67864
412040,201912,41,25,16,24950.4,15968,40918.4
412050,201912,202,154,48,153692,47904,201596
412060,201912,774,588,186,587822,186626,774448
412065,201912,47,30,17,29940.4,16966,46906.4
412070,201912,170,117,53,116766,52894,169660
412080,201912,279,146,133,146706,132734,279440
412085,201912,34,16,18,15968,18962,34930
412090,201912,803,506,297,504988.9,297404,802392.9
412100,201912,238,204,34,203593.34,33932,237525.34
412110,201912,65,50,15,50898.36,14970,65868.36
412120,201912,321,194,127,194610,128742,323352
412125,201912,85,50,35,49900,34930,84830
412130,201912,40,27,13,26946.36,12974,39920.36
412135,201912,30,17,13,16966,12974,29940
412140,201912,330,226,104,226546,103792,330338
412150,201912,256,170,86,169660,85828,255488
412160,201912,89,51,38,50898,37924,88822
412170,201912,687,481,206,480038.4,205588,685626.4
412175,201912,39,28,11,27944,10978,38922
412180,201912,192,151,41,150698.2,40918,191616.2
412190,201912,344,275,69,274450,68862,343312
412200,201912,189,119,70,118762,69860,188622
412210,201912,73,57,16,56886,15968,72854
412215,201912,222,157,65,156686,64870,221556
412217,201912,66,53,13,52894,12974,65868
412220,201912,818,595,223,595806,222554,818360
412230,201912,331,203,128,204590,127745.96,332335.96
412240,201912,1342,676,666,676644,664668.48,1341312.48
412250,201912,403,256,147,255488,146706,402194
412260,201912,106,77,29,76846,28942,105788
412265,201912,179,141,38,141716,37924,179640
412270,201912,85,57,28,57884,27944,85828
412280,201912,89,73,16,72854,15968,88822
412290,201912,93,64,29,63872,28942,92814
412300,201912,211,139,72,138722,72854,211576
412310,201912,48,41,7,40918,6986,47904
412320,201912,95,79,16,78842,15968,94810
412330,201912,190,161,29,160678,28942,189620
412340,201912,150,104,46,103792,45908.4,149700.4
412350,201912,624,303,321,303392,323352,626744
412360,201912,31,25,6,24950,5988,30938
412370,201912,160,138,22,138722.2,21956,160678.2
412380,201912,263,198,65,198602,64870.98,263472.98
412382,201912,58,29,29,28942,28942,57884
412385,201912,143,106,37,105788,37924,143712
412390,201912,285,221,64,220558,63872,284430
412395,201912,69,56,13,55888,12974,68862
412400,201912,85,57,28,56886,27944,84830
412402,201912,239,116,123,115768.4,122754,238522.4
412405,201912,855,315,540,315368,540916,856284
412410,201912,975,599,376,599798.4,375248,975046.4
412420,201912,12,10,2,9980,1996,11976
412430,201912,20,15,5,14970,4990,19960
412440,201912,604,333,271,335328,273452,608780
412450,201912,77,67,10,66866,9980,76846
412460,201912,91,70,21,69860,20958,90818
412470,201912,221,180,41,179640,40918,220558
412480,201912,150,109,41,108782.3,40918,149700.3
412490,201912,164,144,20,143712,19960,163672
412500,201912,440,360,80,362274.85,79840,442114.85
412510,201912,182,149,33,148702.4,32934,181636.4
412520,201912,87,57,30,57884,30938,88822
412530,201912,106,56,50,56886,49900,106786
412535,201912,93,68,25,67865.96,24950,92815.96
412540,201912,80,37,43,36926,42914,79840
412545,201912,92,66,26,65868,25948,91816
412550,201912,3764,1670,2094,1675642.4,2098794.8,3774437.2
412555,201912,13,9,4,8982,3992,12974
412560,201912,608,439,169,439120.8,169660.7,608781.5
412570,201912,748,393,355,393212,356286,749498
412575,201912,89,61,28,60878,27944,88822
412580,201912,175,116,59,116766,58882,175648
412590,201912,37,32,5,31936,4990,36926
412600,201912,169,125,44,124750.34,43912,168662.34
412610,201912,34,17,17,16966,16966,33932
412620,201912,150,127,23,127744,22954,150698
412625,201912,2171,1146,1025,1150695.53,1028940.73,2179636.26
412627,201912,69,53,16,52894,15968,68862
412630,201912,414,273,141,273452.6,140718,414170.6
412635,201912,64,16,48,15968,47904,63872
412640,201912,110,75,35,74850,34930,109780
412650,201912,351,225,126,224550,126746,351296
412660,201912,482,298,184,298402,183632,482034
412665,201912,48,43,5,42914,4990,47904
412667,201912,296,204,92,204590,91816,296406
412670,201912,66,55,11,54890,10978,65868
412680,201912,293,231,62,231536,61876.48,293412.48
412690,201912,104,70,34,69860,33932.4,103792.4
412700,201912,161,109,52,108782,51896,160678
412710,201912,1415,866,549,867263.7,549898,1417161.7
412720,201912,232,151,81,150698,80838,231536
412730,201912,193,161,32,161676,31936,193612
412740,201912,424,228,196,228542,196606,425148
412750,201912,445,257,188,256486,188622,445108
412760,201912,276,145,131,144710,130738,275448
412770,201912,2125,1168,957,1175645.86,958081.78,2133727.64
412780,201912,146,114,32,113772,32934,146706
412785,201912,276,140,136,139720,135728,275448
412788,201912,33,19,14,18962,13972,32934
412790,201912,128,108,20,107784,19960,127744
412795,201912,152,111,41,110778,40918,151696
412796,201912,322,215,107,216566,107784,324350
412800,201912,605,380,225,379240.5,224550.98,603791.48
412810,201912,2958,1624,1334,1631732.1,1335324,2967056.1
412820,201912,946,609,337,610778.1,339320.98,950099.08
412830,201912,14,11,3,10978,2994,13972
412840,201912,221,160,61,159680.4,60878,220558.4
412850,201912,766,503,263,502992,262474,765466
412853,201912,168,87,81,86826,80838.4,167664.4
412855,201912,203,111,92,110778.26,91816,202594.26
412860,201912,96,66,30,65868,29940,95808
412862,201912,56,43,13,42914,12974,55888
412863,201912,6,5,1,4990,998,5988
412865,201912,44,32,12,31936,11976,43912
412870,201912,111,68,43,68862,42914,111776
412880,201912,99,75,24,74850.4,23952,98802.4
420005,201912,42,37,5,36926,4990,41916
420010,201912,368,242,126,241516.3,127744.4,369260.7
420020,201912,82,71,11,70858,10978,81836
420030,201912,22,20,2,20958,1996,22954
420040,201912,106,84,22,83832,21956,105788
420050,201912,56,34,22,33932,21956,55888
420055,201912,19,19,0,18962,0,18962
420060,201912,29,22,7,22954,6986,29940
420070,201912,104,87,17,86826,16966,103792
420075,201912,12,12,0,11976,0,11976
420080,201912,43,37,6,36926,5988,42914
420090,201912,36,33,3,32934,2994,35928
420100,201912,151,129,22,128742.4,21956,150698.4
420110,201912,21,21,0,20958,0,20958
420120,201912,63,48,15,47904,14970,62874
420125,201912,84,67,17,66866,17964,84830
420127,201912,29,25,4,24950,3992,28942
420130,201912,410,254,156,254490,156686,411176
420140,201912,1304,730,574,731536.28,576844,1308380.28
420150,201912,49,41,8,40918,7984,48902
420160,201912,37,35,2,34930,1996,36926
420165,201912,17,12,5,11976,4990,16966
420170,201912,77,50,27,49900,26946,76846
420180,201912,22,19,3,18962,2994,21956
420190,201912,27,23,4,22954,3992,26946
420195,201912,129,66,63,65868,62874,128742
420200,201912,1294,574,720,576844.4,722557.48,1299401.88
420205,201912,71,43,28,42914,28942,71856
420207,201912,115,62,53,62874.5,52894,115768.5
420208,201912,19,15,4,14970,3992,18962
420209,201912,19,16,3,15968,2994,18962
420210,201912,495,234,261,235528,262474.98,498002.98
420213,201912,48,37,11,37924,10978,48902
420215,201912,26,23,3,22954,2994,25948
420220,201912,70,48,22,47904,21956,69860
420230,201912,828,471,357,471057.58,356287.97,827345.55
420240,201912,2293,1522,771,1524946.54,773450,2298396.54
420243,201912,39,30,9,29940,8982,38922
420245,201912,138,74,64,73852,63872,137724
420250,201912,62,40,22,39920,21956,61876
420253,201912,40,32,8,31936,7984,39920
420257,201912,13,11,2,10978,1996,12974
420260,201912,99,84,15,83832,14970,98802
420270,201912,35,28,7,27944.99,6986,34930.99
420280,201912,289,216,73,216569.64,72856.66,289426.30
420285,201912,23,13,10,12974,9980,22954
420287,201912,50,33,17,32934,16966,49900
420290,201912,1001,701,300,708581.39,301398.97,1009980.36
420300,201912,1444,1153,291,1154688.34,290418.93,1445107.27
420310,201912,48,32,16,31936,15968,47904
420315,201912,36,30,6,29940,5988,35928
420320,201912,893,449,444,450098.24,444110.99,894209.23
420325,201912,0,0,0,0,0,0
420330,201912,120,82,38,81836,37924,119760
420340,201912,162,108,54,107785.18,53892,161677.18
420350,201912,246,181,65,180638,65868,246506
420360,201912,756,581,175,580836.98,175650.46,756487.44
420370,201912,123,75,48,74850,47904.4,122754.4
420380,201912,1156,807,349,811375.48,349304.32,1160679.80
420390,201912,260,177,83,177644,82834,260478
420395,201912,193,141,52,140718,52894,193612
420400,201912,252,190,62,189620.75,61876,251496.75
420410,201912,61,46,15,45908,14970,60878
420415,201912,32,29,3,28942,2994,31936
420417,201912,51,40,11,39920,10978,50898
420419,201912,11,11,0,10978,0,10978
420420,201912,2834,1760,1074,1761475.87,1073850.36,2835326.23
420425,201912,72,59,13,59880,12974.98,72854.98
420430,201912,1206,860,346,867263.5,348302.98,1215566.48
420435,201912,16,14,2,13972,1996,15968
420440,201912,96,67,29,66866.4,28942,95808.4
420445,201912,22,21,1,20958,998,21956
420450,201912,77,39,38,38922,37924,76846
420455,201912,217,168,49,167666.94,48904.94,216571.88
420460,201912,2330,1517,813,1521956.32,814377.22,2336333.54
420470,201912,108,77,31,76846,30938,107784
420475,201912,7,7,0,6986,0,6986
420480,201912,874,659,215,657683.2,214570.8,872254.0
420490,201912,106,78,28,77844,27944,105788
420500,201912,495,251,244,250498.46,254490,504988.46
420510,201912,19,18,1,17964,998,18962
420515,201912,25,18,7,17964,6986,24950
420517,201912,10,10,0,9980,0,9980
420519,201912,0,0,0,0,0,0
420520,201912,72,53,19,53892,18962,72854
420530,201912,167,113,54,112774.3,53892,166666.3
420535,201912,20,18,2,17964,1996,19960
420540,201912,5493,3268,2225,3280684.32,2230532.96,5511217.28
420543,201912,26,25,1,24950,998,25948
420545,201912,206,149,57,148702.98,57884.98,206587.96
420550,201912,859,707,152,705589.16,154693.92,860283.08
420555,201912,37,27,10,26946,9980,36926
420560,201912,65,53,12,52894,11976,64870
420570,201912,156,92,64,91816,63872,155688
420580,201912,278,128,150,128742,149700.4,278442.4
420590,201912,518,352,166,354290,165668,519958
420600,201912,113,61,52,60878,51896,112774
420610,201912,40,37,3,36926,2994,39920
420620,201912,81,65,16,64870,15968,80838
420630,201912,152,110,42,109780.99,42915.98,152696.97
420640,201912,86,77,9,76846,8982,85828
420650,201912,250,128,122,127744,121756,249500
420660,201912,52,40,12,39920,11976,51896
420665,201912,37,28,9,27944,8982,36926
420670,201912,312,238,74,237524,73852.98,311376.98
420675,201912,15,14,1,13972,998,14970
420680,201912,39,28,11,27944,10978,38922
420690,201912,181,142,39,143712,38922,182634
420700,201912,709,487,222,489026.32,221566.78,710593.10
420710,201912,150,88,62,87824,61876,149700
420720,201912,109,89,20,89820.98,19960,109780.98
420730,201912,591,378,213,380241.74,212578.32,592820.06
420740,201912,52,51,1,50898,998,51896
420750,201912,520,353,167,353292,166666,519958
420757,201912,17,14,3,14970,2994,17964
420760,201912,36,29,7,29940,6986,36926
420765,201912,80,63,17,63872,16966,80838
420768,201912,50,46,4,45908,3992,49900
420770,201912,75,64,11,63872,10978,74850
420775,201912,44,41,3,41916,2994,44910
420780,201912,237,188,49,187624,48902,236526
420785,201912,11,9,2,8982,1996,10978
420790,201912,161,136,25,135730.94,25949.96,161680.90
420800,201912,66,50,16,49900,15968,65868
420810,201912,252,215,37,214570,36926,251496
420820,201912,2354,1367,987,1377242.38,992014.77,2369257.15
420830,201912,595,329,266,330339.4,267464,597803.4
420840,201912,150,111,39,110778,38922,149700
420845,201912,418,184,234,184630,234530.4,419160.4
420850,201912,256,198,58,198602,57884,256486
420860,201912,62,52,10,52894,9980,62874
420870,201912,126,91,35,90818,34930,125748
420880,201912,182,123,59,122754,58882.98,181636.98
420890,201912,941,472,469,473053.5,469060,942113.5
420895,201912,9,9,0,8982,0,8982
420900,201912,419,336,83,335328,82834.98,418162.98
420910,201912,5880,3285,2595,3295404.23,2593809.33,5889213.56
420915,201912,72,67,5,67864,4990,72854
420917,201912,19,14,5,13972,5988,19960
420920,201912,23,16,7,15968,6986,22954
420930,201912,2806,1764,1042,1760462.32,1043068.71,2803531.03
420940,201912,600,444,156,445109.2,155692.49,600801.69
420945,201912,9,7,2,6986,1996,8982
420950,201912,57,52,5,51896,4990,56886
420960,201912,107,84,23,84831.96,22954.98,107786.94
420970,201912,296,238,58,238526.92,57884.98,296411.90
420980,201912,24,23,1,22954,998,23952
420985,201912,58,52,6,53892,5988,59880
420990,201912,84,62,22,61876,21956,83832
421000,201912,36,22,14,21956,13972,35928
421003,201912,59,40,19,39920,18962.98,58882.98
421005,201912,6,3,3,2994,2994,5988
421010,201912,771,535,236,536924.4,236527.4,773451.8
421020,201912,26,20,6,19960,5988,25948
421030,201912,121,102,19,101796.3,18962,120758.3
421040,201912,71,54,17,53892,16966,70858
421050,201912,336,233,103,233532.8,103792,337324.8
421055,201912,21,17,4,16966,3992,20958
421060,201912,86,52,34,51896,33932,85828
421070,201912,49,44,5,43912.4,4990,48902.4
421080,201912,33,30,3,29940,2994,32934
421085,201912,24,18,6,17964,5988,23952
421090,201912,38,29,9,28942,8982,37924
421100,201912,124,92,32,92814,31936,124750
421105,201912,208,169,39,168662.98,38922.98,207585.96
421110,201912,109,88,21,87824,20958,108782
421120,201912,161,123,38,122754.98,37924,160678.98
421125,201912,17,12,5,11976,4990,16966
421130,201912,810,518,292,518960,295408.4,814368.4
421140,201912,31,21,10,21956,9980,31936
421145,201912,41,33,8,32934,7984,40918
421150,201912,106,77,29,76846,28942.8,105788.8
421160,201912,68,48,20,47904,19960,67864
421165,201912,17,16,1,15968,998,16966
421170,201912,186,156,30,156810.32,29940.98,186751.30
421175,201912,164,113,51,112774,50898,163672
421180,201912,54,34,20,33932.24,19960,53892.24
421185,201912,18,15,3,14970,2994,17964
421187,201912,1,0,1,0,998,998
421189,201912,42,30,12,29940,11976,41916
421190,201912,1647,1052,595,1052890,595807.01,1648697.01
421200,201912,92,70,22,69860,21956,91816
421205,201912,27,17,10,16966,9980,26946
421210,201912,167,119,48,118762,49900,168662
421220,201912,276,218,58,218562,57884,276446
421223,201912,47,38,9,37924.6,9980,47904.6
421225,201912,70,44,26,43912.6,25948,69860.6
421227,201912,85,67,18,66866,17964,84830
421230,201912,53,37,16,36926,15968,52894
421240,201912,19,19,0,18962,0,18962
421250,201912,366,221,145,222555.6,144710,367265.6
421260,201912,23,19,4,18962,3992,22954
421265,201912,2,2,0,1996,0,1996
421270,201912,46,41,5,40918,4990,45908
421280,201912,344,193,151,193612,152694,346306
421290,201912,338,227,111,226546,110778,337324
421300,201912,24,19,5,18962,4990,23952
421310,201912,43,32,11,32934,10978,43912
421315,201912,30,19,11,18962,10978,29940
421320,201912,141,94,47,93812,46906,140718
421330,201912,104,78,26,78842,25948.98,104790.98
421335,201912,39,27,12,26946,11976,38922
421340,201912,243,155,88,154690.7,87824,242514.7
421350,201912,191,110,81,111776.97,82834,194610.97
421360,201912,651,488,163,488023.48,162674.98,650698.46
421370,201912,201,157,44,156686,44910,201596
421380,201912,127,102,25,101796,24950,126746
421390,201912,18,12,6,11976,5988,17964
421400,201912,126,107,19,106786,18962,125748
421410,201912,19,17,2,16966,1996,18962
421415,201912,20,19,1,18962,998,19960
421420,201912,136,114,22,114770,22954,137724
421430,201912,16,12,4,11976,3992,15968
421440,201912,59,49,10,48902,9980,58882
421450,201912,95,78,17,77844,16966,94810
421460,201912,60,48,12,48902,11976,60878
421470,201912,70,45,25,44910,24950,69860
421480,201912,712,536,176,536924,175648.98,712572.98
421490,201912,25,24,1,23952.98,998,24950.98
421500,201912,496,321,175,320361.34,174665.68,495027.02
421505,201912,25,18,7,17964,6986,24950
421507,201912,30,23,7,22954,6986,29940
421510,201912,72,47,25,47904,24950,72854
421520,201912,56,47,9,46906,8982,55888
421530,201912,53,45,8,44910,7984,52894
421535,201912,26,24,2,23952,1996,25948
421540,201912,54,47,7,46906,6986,53892
421545,201912,101,75,26,74850.98,25948,100798.98
421550,201912,285,207,78,207584,77844,285428
421555,201912,25,21,4,20958,3992.8,24950.8
421560,201912,8,7,1,6986,998,7984
421565,201912,124,86,38,85828,37924,123752
421567,201912,31,25,6,24950,5988,30938
421568,201912,29,26,3,25948,2994,28942
421569,201912,9,9,0,8982,0,8982
421570,201912,195,133,62,132734,62874,195608
421575,201912,29,24,5,23952,4990,28942
421580,201912,713,422,291,421221.98,291416,712637.98
421590,201912,20,19,1,18962,998,19960
421600,201912,153,100,53,99800,52894.4,152694.4
421605,201912,114,79,35,78842.3,34930,113772.3
421610,201912,187,143,44,142714,43912,186626
421620,201912,1048,620,428,618760.98,428142,1046902.98
421625,201912,23,20,3,19960,2994,22954
421630,201912,306,195,111,194610.9,110779.44,305390.34
421635,201912,18,9,9,8982,8982,17964
421640,201912,100,85,15,84830.6,14970,99800.6
421650,201912,303,181,122,182634,121756.97,304390.97
421660,201912,2230,1344,886,1348299.78,888224.73,2236524.51
421670,201912,183,134,49,134730,49900,184630
421680,201912,174,157,17,159680,16966,176646
421690,201912,352,253,99,253494.36,98803.42,352297.78
421700,201912,58,38,20,37924,19960.8,57884.8
421710,201912,26,25,1,24950,998,25948
421715,201912,7,7,0,6986,0,6986
421720,201912,610,436,174,437125.54,173652,610777.54
421725,201912,16,6,10,5988,9980,15968
421730,201912,35,25,10,24950,9980,34930
421740,201912,91,39,52,38922,51896,90818
421750,201912,213,159,54,158682,53892,212574
421755,201912,26,24,2,23952,1996,25948
421760,201912,100,71,29,70858,28942,99800
421770,201912,635,412,223,411186.34,223557.12,634743.46
421775,201912,30,18,12,17964,11976,29940
421780,201912,198,155,43,155688.4,42914,198602.4
421790,201912,152,131,21,130738,20958,151696
421795,201912,19,15,4,15968,3992,19960
421800,201912,507,325,182,327344,182634.5,509978.5
421810,201912,73,61,12,60878,11976,72854
421820,201912,336,225,111,227544.4,110778,338322.4
421825,201912,135,114,21,113772,20958,134730
421830,201912,133,95,38,95808,37924,133732
421835,201912,4,4,0,3992,0,3992
421840,201912,53,45,8,44910.98,7984,52894.98
421850,201912,78,67,11,67864,10978.99,78842.99
421860,201912,37,30,7,30938,6986,37924
421870,201912,994,746,248,749524.02,248507.28,998031.30
421875,201912,55,45,10,44910,9980,54890
421880,201912,164,117,47,117764,46906.4,164670.4
421885,201912,22,18,4,17964,3992,21956
421890,201912,131,93,38,92814,37924.98,130738.98
421895,201912,50,44,6,43912,5988,49900
421900,201912,158,123,35,124751.96,34933.92,159685.88
421910,201912,68,41,27,40918.6,26946,67864.6
421915,201912,32,26,6,25948,5988,31936
421917,201912,40,30,10,29940,9980,39920
421920,201912,39,36,3,36926,2994,39920
421930,201912,720,575,145,575846.65,145710.94,721557.59
421935,201912,48,42,6,43912,5988,49900
421940,201912,43,38,5,37924,4990,42914
421950,201912,864,583,281,583830.4,280439.58,864269.98
421960,201912,47,41,6,40918.4,5988,46906.4
421970,201912,366,240,126,240518.4,126746.98,367265.38
421985,201912,27,18,9,17964,8982,26946
422000,201912,0,0,0,0,0,0
430003,201912,183,54,129,53892,130738,184630
430005,201912,37,28,9,27944,8982,36926
430010,201912,265,192,73,191616,73852,265468
430020,201912,143,95,48,94810.4,47904,142714.4
430030,201912,124,100,24,99800,24950,124750
430040,201912,2932,1735,1197,1739516.2,1198600.34,2938116.54
430045,201912,70,58,12,58882,11976,70858
430047,201912,8,6,2,5988,1996,7984
430050,201912,79,68,11,67864,10978,78842
430055,201912,14,12,2,11976,1996,13972
430057,201912,5,4,1,3992,998,4990
430060,201912,3692,2158,1534,2170653.66,1535924.56,3706578.22
430063,201912,53,49,4,49900,3992,53892
430064,201912,154,124,30,124750,29940,154690
430066,201912,5,2,3,1996,2994.4,4990.4
430070,201912,44,32,12,31936,11976,43912
430080,201912,68,47,21,46906,20958,67864
430085,201912,34,12,22,11976,21956,33932
430087,201912,29,23,6,22954.7,5988,28942.7
430090,201912,73,66,7,65868,6986,72854
430100,201912,123,84,39,83832,39920,123752
430105,201912,146,78,68,77844.6,67864,145708.6
430107,201912,18,13,5,12974,4990,17964
430110,201912,430,249,181,248502,182634,431136
430120,201912,146,136,10,135728,9980,145708
430130,201912,802,491,311,491016.4,310378,801394.4
430140,201912,126,119,7,118762,6986,125748
430150,201912,108,71,37,70858,37924,108782
430155,201912,35,31,4,30938,3992,34930
430160,201912,3612,2131,1481,2142708.7,1493008.4,3635717.1
430163,201912,356,165,191,164670,190618,355288
430165,201912,29,19,10,18962,9980,28942
430170,201912,93,79,14,78842,13972,92814
430175,201912,80,62,18,61876,17964,79840
430180,201912,104,85,19,85828,18962,104790
430185,201912,34,24,10,23952,9980,33932
430187,201912,85,39,46,38922,46906,85828
430190,201912,223,121,102,120758,101796,222554
430192,201912,13,11,2,10978,1996,12974
430195,201912,17,11,6,10978,5988,16966
430200,201912,164,142,22,142714,21956,164670
430205,201912,20,19,1,18962,998,19960
430210,201912,700,543,157,543910.4,156686.4,700596.8
430215,201912,13,11,2,10978,1996,12974
430220,201912,73,51,22,50898,21956,72854
430222,201912,12,6,6,5988,5988,11976
430223,201912,15,7,8,6986,7984,14970
430225,201912,2,1,1,998,998,1996
430230,201912,319,187,132,187624,131736,319360
430235,201912,53,40,13,39920,12974,52894
430237,201912,25,20,5,19960,4990,24950
430240,201912,129,84,45,84830,44910,129740
430245,201912,70,57,13,57884,12974,70858
430250,201912,190,113,77,113772,76846,190618
430258,201912,9,8,1,7984,998,8982
430260,201912,33,29,4,28942,3992,32934
430265,201912,35,31,4,30938,3992,34930
430270,201912,515,385,130,384230.7,130741.92,514972.62
430280,201912,1036,641,395,643710,398202,1041912
430290,201912,391,217,174,216566,174650,391216
430300,201912,2086,1163,923,1166663,926148.32,2092811.32
430310,201912,1964,1006,958,1009977,960079.52,1970056.52
430320,201912,55,44,11,43912,10978,54890
430330,201912,96,85,11,85828,10978,96806
430340,201912,70,59,11,59880,10978,70858
430350,201912,1650,1125,525,1127740.6,525946.98,1653687.58
430355,201912,21,19,2,18962,1996,20958
430360,201912,89,45,44,44910,43912,88822
430367,201912,35,26,9,25948,8982,34930
430370,201912,54,47,7,46906,7984,54890
430380,201912,139,105,34,104790,34930,139720
430390,201912,591,370,221,371256,222554,593810
430400,201912,137,105,32,105788.4,31936,137724.4
430410,201912,58,46,12,45908,11976,57884
430420,201912,502,334,168,334330.94,168662.98,502993.92
430430,201912,54,53,1,52229.33,998,53227.33
430435,201912,155,115,40,114770,39920,154690
430440,201912,506,338,168,338322.6,168662,506984.6
430450,201912,1162,955,207,955086,206586,1161672
430460,201912,5146,2753,2393,2762465.5,2397216.44,5159681.94
430461,201912,16,15,1,14970,998,15968
430462,201912,9,5,4,4990,3992,8982
430463,201912,1067,572,495,572852,498003.96,1070855.96
430465,201912,23,13,10,12974,9980,22954
430466,201912,690,495,195,496006.4,195608,691614.4
430467,201912,102,56,46,55888.6,45908,101796.6
430468,201912,114,65,49,65868,48902,114770
430469,201912,23,18,5,17964,4990,22954
430470,201912,1148,647,501,647001.95,502992,1149993.95
430471,201912,57,39,18,39920,17964,57884
430480,201912,102,65,37,64870,36926,101796
430485,201912,6,6,0,5988.4,0,5988.4
430490,201912,86,68,18,68862,17964,86826
430495,201912,33,26,7,25948,6986,32934
430500,201912,188,127,61,126746,60878.63,187624.63
430510,201912,3473,2277,1196,2282426.28,1197600,3480026.28
430511,201912,17,16,1,15968,998,16966
430512,201912,145,101,44,102794,43912,146706
430513,201912,53,42,11,41916,10978,52894
430515,201912,31,29,2,28942,1996,30938
430517,201912,169,150,19,150698,18962,169660
430520,201912,355,247,108,247504,107784,355288
430530,201912,85,49,36,48902,35928,84830
430535,201912,453,312,141,311376,140718.99,452094.99
430537,201912,10,10,0,9980,0,9980
430540,201912,80,55,25,54890,24950,79840
430543,201912,347,111,236,110778,237524,348302
430544,201912,43,40,3,39920,2994,42914
430545,201912,367,193,174,193612,175648,369260
430550,201912,41,34,7,34930,6986,41916
430558,201912,3,2,1,1996,1996,3992
430560,201912,56,30,26,29940,25948,55888
430570,201912,106,41,65,40918,65868,106786
430580,201912,126,103,23,102794,22954,125748
430583,201912,14,14,0,13972,0,13972
430585,201912,11,4,7,3992,6986,10978
430587,201912,15,7,8,6986,7984,14970
430590,201912,146,121,25,121756,24950,146706
430593,201912,2,2,0,1996,0,1996
430595,201912,17,14,3,13972,2994,16966
430597,201912,47,26,21,25948,20958,46906
430600,201912,218,159,59,159680,59880,219560
430605,201912,158,100,58,99800,57884,157684
430607,201912,23,20,3,19960,2994,22954
430610,201912,1602,763,839,765466,840317.38,1605783.38
430613,201912,2,2,0,1996,0,1996
430620,201912,113,79,34,78842,33932,112774
430630,201912,49,42,7,41916,6986,48902
430632,201912,32,27,5,26946,4990,31936
430635,201912,35,32,3,31936,2994,34930
430637,201912,52,29,23,28942,22954,51896
430640,201912,182,105,77,106786,77844,184630
430642,201912,22,20,2,19960,1996,21956
430645,201912,38,31,7,30938,6986,37924
430650,201912,253,206,47,205588.4,47904,253492.4
430655,201912,2,2,0,1996,0,1996
430660,201912,975,483,492,482034,493012.4,975046.4
430670,201912,77,53,24,52894,23952,76846
430673,201912,70,42,28,41916,27944,69860
430675,201912,11,9,2,8982,1996,10978
430676,201912,501,297,204,298402,205588,503990
430680,201912,245,172,73,171656.8,73852,245508.8
430690,201912,532,330,202,331336.98,203592.63,534929.61
430692,201912,7,5,2,4990,1996,6986
430693,201912,142,96,46,95808,45908,141716
430695,201912,71,59,12,60878,11976,72854
430697,201912,56,35,21,34930,20958,55888
430700,201912,1529,1062,467,1062871.16,467064,1529935.16
430705,201912,22,20,2,19960,1996,21956
430710,201912,254,162,92,162674,92814,255488
430720,201912,106,90,16,89820,15968,105788
430730,201912,135,118,17,117764,17964,135728
430740,201912,73,50,23,49900,22954,72854
430745,201912,30,23,7,22954,6986,29940
430750,201912,330,216,114,216566,113772,330338
430755,201912,84,47,37,46906,36926,83832
430760,201912,372,215,157,215569.04,157684.98,373254.02
430770,201912,1451,755,696,755486.9,696606.96,1452093.86
430780,201912,291,189,102,190618.98,103792.98,294411.96
430781,201912,26,22,4,21956,3992,25948
430783,201912,57,46,11,45908,10978,56886
430786,201912,5,3,2,3992,1996,5988
430790,201912,512,339,173,341316,175648.4,516964.4
430800,201912,154,129,25,128742.91,24950,153692.91
430805,201912,40,35,5,35928,4990,40918
430807,201912,43,24,19,23952,18962,42914
430810,201912,75,47,28,46906,27944,74850
430820,201912,145,86,59,85828,58882,144710
430825,201912,10,8,2,7984,1996,9980
430830,201912,237,220,17,221556.4,16966,238522.4
430840,201912,125,85,40,85828,39920,125748
430843,201912,6,4,2,3992,1996,5988
430845,201912,73,42,31,42914,30938,73852
430850,201912,590,411,179,412174,178644.94,590818.94
430860,201912,162,103,59,106786,59880,166666
430865,201912,71,42,29,41916,29940.98,71856.98
430870,201912,78,64,14,63872,13972,77844
430880,201912,152,116,36,116766,36926,153692
430885,201912,10,8,2,7984,1996,9980
430890,201912,347,211,136,210578,136726,347304
430900,201912,514,362,152,362274,153692,515966
430905,201912,114,51,63,50898,63872,114770
430910,201912,282,157,125,156686,124750.98,281436.98
430912,201912,5,5,0,4990,0,4990
430915,201912,34,29,5,28942,4990,33932
430920,201912,4216,2285,1931,2296399.8,1938116.98,4234516.78
430925,201912,4,3,1,2994,998,3992
430930,201912,2075,1218,857,1219557.9,858281.98,2077839.88
430940,201912,262,171,91,171656,91816,263472
430950,201912,148,122,26,122754,25948,148702
430955,201912,24,13,11,12974,10978,23952
430957,201912,16,15,1,14970,998,15968
430960,201912,242,164,78,163672,78842,242514
430965,201912,113,73,40,72854,39920,112774
430970,201912,82,68,14,67864,13972,81836
430975,201912,41,37,4,36926,3992,40918
430980,201912,45,29,16,28942,15968,44910
430990,201912,114,89,25,88822,24950,113772
430995,201912,117,111,6,111776,5988,117764
431000,201912,298,138,160,137725,161676,299401
431010,201912,354,205,149,206586,148702,355288
431020,201912,1879,1094,785,1094806.6,787422,1882228.6
431030,201912,41,33,8,32934,7984,40918
431033,201912,382,189,193,189620,197604,387224
431036,201912,12,7,5,7984,4990,12974
431040,201912,137,84,53,83832,53892,137724
431041,201912,41,27,14,26946.4,13972,40918.4
431043,201912,46,26,20,25948,19960,45908
431046,201912,11,7,4,6986,3992,10978
431050,201912,198,126,72,126746,71856,198602
431053,201912,73,43,30,42914,29940,72854
431055,201912,64,44,20,43912,19960,63872
431057,201912,18,18,0,17964,0,17964
431060,201912,1630,1056,574,1058880.35,579852.42,1638732.77
431065,201912,20,12,8,11976,7984,19960
431070,201912,63,57,6,56886,5988,62874
431075,201912,7,7,0,6986,0,6986
431080,201912,131,80,51,80838,50898,131736
431085,201912,33,29,4,28942,3992,32934
431087,201912,13,11,2,11976,1996,13972
431090,201912,54,42,12,42914,11976,54890
431100,201912,1197,723,474,725548.02,477044,1202592.02
431110,201912,230,142,88,141716,87824.4,229540.4
431112,201912,26,15,11,14970,10978,25948
431113,201912,34,25,9,24950,8982,33932
431115,201912,155,109,46,108782,45908,154690
431120,201912,595,358,237,358282.6,239520.96,597803.56
431123,201912,3,2,1,1996,998,2994
431125,201912,96,87,9,86826,8982,95808
431127,201912,10,4,6,3992,5988,9980
431130,201912,703,459,244,458082,244510,702592
431140,201912,759,526,233,531934.4,235528,767462.4
431142,201912,33,26,7,25948.95,6986,32934.95
431150,201912,195,149,46,149700,45908,195608
431160,201912,53,48,5,47904,4990,52894
431162,201912,7,5,2,5988,1996,7984
431164,201912,5,5,0,5988,0,5988
431170,201912,109,85,24,84830,23952,108782
431171,201912,67,40,27,40918,26946,67864
431173,201912,1,1,0,998,0,998
431175,201912,200,103,97,102794.4,96806,199600.4
431177,201912,79,59,20,58882,19960,78842
431179,201912,14,12,2,11976,1996,13972
431180,201912,448,271,177,271456,177644.98,449100.98
431190,201912,81,63,18,62874,17964,80838
431198,201912,72,51,21,50898,20958,71856
431200,201912,21,17,4,16966,3992,20958
431205,201912,23,22,1,21956,998,22954
431210,201912,91,56,35,55888,35928,91816
431213,201912,32,28,4,27944,3992,31936
431215,201912,21,18,3,18962,2994,21956
431217,201912,4,3,1,2994,998,3992
431220,201912,67,59,8,58882,7984,66866
431225,201912,149,96,53,96806,52894,149700
431230,201912,106,93,13,92814,12974,105788
431235,201912,8,8,0,7984,0,7984
431237,201912,21,15,6,14970,5988,20958
431238,201912,10,7,3,6986.4,2994,9980.4
431240,201912,980,623,357,626744.2,359280,986024.2
431242,201912,38,37,1,36926,998,37924
431244,201912,13,9,4,8982,3992,12974
431245,201912,51,37,14,37924,13972,51896
431247,201912,10,7,3,6986,2994,9980
431250,201912,276,144,132,144710,132734,277444
431260,201912,59,45,14,44910,13972,58882
431261,201912,17,11,6,10978,5988,16966
431262,201912,18,17,1,16966,998,17964
431265,201912,144,79,65,79840,65868,145708
431267,201912,14,13,1,12974,998,13972
431270,201912,326,269,57,269460,56886,326346
431275,201912,39,36,3,35928,2994,38922
431280,201912,20,16,4,15968,3992,19960
431290,201912,23,20,3,19960,2994,22954
431295,201912,2,2,0,1996,0,1996
431300,201912,22,19,3,18962,2994,21956
431301,201912,6,6,0,5988,0,5988
431303,201912,59,39,20,38922,19960,58882
431306,201912,237,126,111,125570.35,110778,236348.35
431308,201912,7,5,2,4990,1996,6986
431310,201912,66,55,11,54890,10978,65868
431320,201912,144,88,56,88822,55888,144710
431330,201912,172,114,58,113772,57884,171656
431333,201912,27,23,4,23952,3992,27944
431335,201912,9,5,4,4990,3992,8982
431337,201912,343,154,189,153692,188622,342314
431339,201912,20,17,3,16966,2994,19960
431340,201912,3000,1676,1324,1681555.31,1325359.22,3006914.53
431342,201912,37,23,14,22954,14970,37924
431344,201912,17,17,0,16966,0,16966
431346,201912,5,5,0,4990,0,4990
431349,201912,36,32,4,31936,3992,35928
431350,201912,925,536,389,538921.48,390218.4,929139.88
431360,201912,49,42,7,41916,6986,48902
431365,201912,330,158,172,157684.4,171656,329340.4
431370,201912,1319,773,546,774448.4,547906.9,1322355.3
431380,201912,97,84,13,83832,12974,96806
431390,201912,507,276,231,276446,232534,508980
431395,201912,294,133,161,132734,161676,294410
431400,201912,43,30,13,29940,12974,42914
431402,201912,101,72,29,72854,28942,101796
431403,201912,24,14,10,13972,9980,23952
431405,201912,667,362,305,363272.5,304391.96,667664.46
431406,201912,31,27,4,26946,3992,30938
431407,201912,52,42,10,41916,9980,51896
431410,201912,3416,2106,1310,2108775.4,1315364.3,3424139.7
431413,201912,15,12,3,11976,2994,14970
431415,201912,69,51,18,51896,17964,69860
431417,201912,23,12,11,11976,10978,22954
431420,201912,314,214,100,216566,100798,317364
431430,201912,49,23,26,22954,25948,48902
431440,201912,8835,6200,2635,6221541.56,2645700.16,8867241.72
431442,201912,28,14,14,13972,13972,27944
431445,201912,22,20,2,19960,1996,21956
431446,201912,4,4,0,3992,0,3992
431447,201912,85,61,24,60878,23952,84830
431449,201912,54,46,8,45908,7984,53892
431450,201912,414,281,133,281436,133732,415168
431454,201912,0,0,0,0,0,0
431455,201912,54,41,13,40918,12974,53892
431460,201912,520,364,156,363272,155688,518960
431470,201912,117,91,26,90818,25948,116766
431475,201912,11,9,2,8982,1996,10978
431477,201912,38,25,13,25948,12974,38922
431478,201912,8,7,1,6986,998,7984
431480,201912,494,308,186,310378,187624,498002
431490,201912,28470,16124,12346,16231485.75,12418132.01,28649617.76
431500,201912,77,59,18,58882,17964,76846
431505,201912,28,18,10,17964,9980,27944
431507,201912,12,9,3,8982,2994,11976
431510,201912,252,179,73,178642.1,73852,252494.1
431513,201912,25,22,3,21956,2994,24950
431514,201912,6,5,1,4990,998,5988
431515,201912,84,70,14,69860,13972,83832
431517,201912,5,4,1,3992,998,4990
431520,201912,39,34,5,33932,4990,38922
431530,201912,1493,676,817,675646.4,821354,1497000.4
431531,201912,25,23,2,22954,1996,24950
431532,201912,31,22,9,21956,8982,30938
431535,201912,26,16,10,15968,9980,25948
431540,201912,138,115,23,115768,23952,139720
431545,201912,13,11,2,10978,1996,12974
431550,201912,348,196,152,197604,153692,351296
431555,201912,12,12,0,11976,0,11976
431560,201912,4544,3140,1404,3144702.77,1404186,4548888.77
431570,201912,814,433,381,437124.8,381236,818360.8
431575,201912,40,23,17,22954,16966,39920
431580,201912,100,69,31,68862,31936,100798
431590,201912,146,124,22,124750,21956,146706
431595,201912,18,15,3,14970,2994,17964
431600,201912,233,133,100,133732,99800,233532
431610,201912,121,88,33,87824,32934,120758
431620,201912,45,38,7,37924,6986,44910
431630,201912,128,108,20,107784,19960,127744
431640,201912,1330,853,477,859278.4,480038.4,1339316.8
431642,201912,35,33,2,32934,1996,34930
431643,201912,44,21,23,20958,22954,43912
431645,201912,328,196,132,195608,131736,327344
431647,201912,9,9,0,8982,0,8982
431650,201912,33,23,10,22954,9980,32934
431660,201912,318,203,115,202594,115768,318362
431670,201912,230,108,122,107784,121756,229540
431673,201912,3,3,0,2994,0,2994
431675,201912,25,20,5,20958,4990,25948
431680,201912,1104,815,289,821354,291416,1112770
431690,201912,4691,2849,1842,2866258.04,1857283.12,4723541.16
431695,201912,23,17,6,16966,5988,22954
431697,201912,0,0,0,0,0,0
431700,201912,174,136,38,135728,37924,173652
431710,201912,3969,1771,2198,1782429.58,2206588.78,3989018.36
431720,201912,1327,818,509,818859.6,512972.98,1331832.58
431725,201912,0,0,0,998,0,998
431730,201912,1173,807,366,808382.16,366266,1174648.16
431740,201912,1345,667,678,668660,677643.38,1346303.38
431750,201912,1786,1171,615,1185625.71,619758.98,1805384.69
431755,201912,5,4,1,3992,998,4990
431760,201912,1031,658,373,661675.8,374250,1035925.8
431770,201912,408,296,112,295408,112774,408182
431775,201912,31,23,8,22954,7984,30938
431780,201912,548,339,209,341316,208582,549898
431790,201912,167,130,37,129740,36926,166666
431795,201912,12,10,2,9980,1996,11976
431800,201912,3259,1724,1535,1728548.69,1543996.96,3272545.65
431805,201912,19,17,2,16966,1996,18962
431810,201912,602,405,197,404190,197604.98,601794.98
431820,201912,317,186,131,186626,131736,318362
431830,201912,2309,1391,918,1392210,917163.96,2309373.96
431840,201912,480,319,161,321356.6,161676,483032.6
431842,201912,36,29,7,28942,6986,35928
431843,201912,11,8,3,7984,2994,10978
431844,201912,17,13,4,12974,3992,16966
431845,201912,26,24,2,23952,1996,25948
431846,201912,26,22,4,21956,3992,25948
431848,201912,12,10,2,9980,1996,11976
431849,201912,9,7,2,6986,1996,8982
431850,201912,793,654,139,657682,140718,798400
431860,201912,112,77,35,76846,34930,111776
431861,201912,4,2,2,1996,1996,3992
431862,201912,53,36,17,35928,16966,52894
431870,201912,3439,1997,1442,2009974.68,1451098.86,3461073.54
431880,201912,926,683,243,681634,243512,925146
431890,201912,1284,785,499,786424,499000,1285424
431900,201912,183,132,51,132734,50898,183632
431910,201912,55,38,17,38922,16966,55888
431912,201912,42,24,18,23952,17964,41916
431915,201912,122,97,25,96806,25948,122754
431920,201912,149,110,39,110778,38922,149700
431930,201912,78,64,14,63872,13972,77844
431935,201912,3,3,0,2994,0,2994
431936,201912,12,11,1,10978,998,11976
431937,201912,19,15,4,14970,3992,18962
431940,201912,462,311,151,310378,151696.5,462074.5
431950,201912,510,318,192,318363.38,192614.98,510978.36
431960,201912,718,398,320,398203.38,322354.98,720558.36
431970,201912,71,64,7,63872,6986,70858
431971,201912,3,3,0,2994,0,2994
431973,201912,22,18,4,17964,3992,21956
431975,201912,9,8,1,7984,998,8982
431980,201912,212,135,77,134730,77844,212574
431990,201912,1174,625,549,627677.71,549899.96,1177577.67
432000,201912,1680,903,777,909180.1,781437.1,1690617.2
432010,201912,279,191,88,192614,87824,280438
432020,201912,173,144,29,143712,28942,172654
432023,201912,15,13,2,12974,1996,14970
432026,201912,69,64,5,63872,4990,68862
432030,201912,70,36,34,35928,33932,69860
432032,201912,20,16,4,15968,3992,19960
432035,201912,56,46,10,46906,9980,56886
432040,201912,99,68,31,67864,30938,98802
432045,201912,5,4,1,3992,998,4990
432050,201912,83,50,33,49900,32934,82834
432055,201912,117,89,28,88822,27944,116766
432057,201912,5,4,1,3992.4,998,4990.4
432060,201912,34,31,3,30938,2994,33932
432065,201912,32,28,4,27944,3992,31936
432067,201912,89,79,10,78842,9980,88822
432070,201912,392,302,90,302644.8,89820.98,392465.78
432080,201912,824,580,244,579838,243512,823350
432085,201912,11,8,3,7984,2994,10978
432090,201912,268,179,89,179640,88822,268462
432100,201912,174,116,58,116766,57884,174650
432110,201912,583,393,190,392214,192614,584828
432120,201912,939,565,374,564868,381236,946104
432130,201912,494,356,138,360278,139720,499998
432132,201912,23,20,3,19960,2994,22954
432135,201912,78,65,13,64870,12974,77844
432140,201912,260,207,53,206586,52894,259480
432143,201912,202,127,75,126746,74850,201596
432145,201912,277,190,87,190618,86826,277444
432146,201912,13,13,0,12974,0,12974
432147,201912,106,58,48,58882,49900,108782
432149,201912,15,10,5,9980,4990,14970
432150,201912,857,528,329,532932.4,330338.98,863271.38
432160,201912,1434,742,692,744509.57,696604.98,1441114.55
432162,201912,4,3,1,2994,998,3992
432163,201912,18,14,4,13972,3992,17964
432166,201912,115,85,30,86078.4,29940,116018.4
432170,201912,227,116,111,115768,110778,226546
432180,201912,542,339,203,338322,203592.4,541914.4
432183,201912,6,6,0,5988,0,5988
432185,201912,79,70,9,69860,8982,78842
432190,201912,476,281,195,280438,196606.98,477044.98
432195,201912,84,70,14,71856,13972,85828
432200,201912,393,254,139,253492,139720.98,393212.98
432210,201912,116,73,43,73852,43912,117764
432215,201912,47,43,4,42914,3992,46906
432218,201912,20,19,1,18962,998,19960
432220,201912,678,351,327,351296,326348.57,677644.57
432225,201912,14,8,6,7984,5988,13972
432230,201912,139,97,42,96806,41916,138722
432232,201912,13,12,1,12974,998,13972
432234,201912,4,3,1,2994,998,3992
432235,201912,3,3,0,2994,0,2994
432237,201912,27,15,12,14970,11976,26946
432240,201912,4333,2448,1885,2451089.2,1887220.98,4338310.18
432250,201912,1106,713,393,716564,394210,1110774
432252,201912,42,39,3,38922,2994,41916
432253,201912,62,50,12,49900,11976,61876
432254,201912,30,14,16,13972,15968,29940
432255,201912,14,13,1,12974,998,13972
432260,201912,834,660,174,659678.4,174650,834328.4
432270,201912,238,177,61,178642,60878,239520
432280,201912,143,108,35,108782.6,35928,144710.6
432285,201912,2,2,0,1996,0,1996
432290,201912,67,60,7,59880,6986,66866
432300,201912,4594,2564,2030,2581761.73,2040912.24,4622673.97
432310,201912,125,102,23,101796,22954,124750
432320,201912,22,17,5,16966,4990,21956
432330,201912,17,12,5,11976,4990,16966
432335,201912,7,6,1,5988,998,6986
432340,201912,40,35,5,34930,4990,39920
432345,201912,99,68,31,67864,30938,98802
432350,201912,23,22,1,22954,998,23952
432360,201912,6,5,1,4990,998,5988
432370,201912,25,24,1,23952,998,24950
432375,201912,33,30,3,29940,2994,32934
432377,201912,9,9,0,8982,0,8982
432380,201912,168,82,86,81836,85828,167664
500020,201912,240,136,104,136726,103792,240518
500025,201912,131,65,66,64870,66866,131736
500060,201912,1455,913,542,913170,543911.38,1457081.38
500070,201912,812,391,421,392214.96,422154.98,814369.94
500080,201912,130,104,26,103792,25948,129740
500085,201912,133,108,25,107784.4,24950,132734.4
500090,201912,342,159,183,158682,182634,341316
500100,201912,726,382,344,382234,345308.8,727542.8
500110,201912,2269,1057,1212,1060879.71,1216573.1,2277452.81
500124,201912,264,151,113,152694,112774,265468
500150,201912,335,137,198,136726,198604.94,335330.94
500190,201912,527,364,163,365268,162674.4,527942.4
500200,201912,187,164,23,163672.28,22954,186626.28
500210,201912,1517,543,974,544912.9,976084.08,1520996.98
500215,201912,242,140,102,139720,101796,241516
500220,201912,748,489,259,489023.24,259480,748503.24
500230,201912,242,159,83,158682,82834,241516
500240,201912,688,477,211,476046.36,210578,686624.36
500260,201912,589,227,362,226546,362274.96,588820.96
500270,201912,29686,12798,16888,12814758.72,16908295.38,29723054.10
500280,201912,202,72,130,71856,129740,201596
500290,201912,1175,709,466,709578.4,466066.98,1175645.38
500295,201912,448,289,159,290418.4,159680,450098.4
500310,201912,68,23,45,22954,44910,67864
500315,201912,705,421,284,422154,285428,707582
500320,201912,3649,1824,1825,1827339.75,1827343.88,3654683.63
500325,201912,938,513,425,511975.38,424150.4,936125.78
500330,201912,1460,686,774,685626.4,773450.98,1459077.38
500345,201912,302,231,71,233533.38,70858,304391.38
500348,201912,242,147,95,148702,94810,243512
500350,201912,123,59,64,58882,63872,122754
500370,201912,5497,2474,3023,2483026.08,3029933.92,5512960.00
500375,201912,338,245,93,246506,95808,342314
500380,201912,591,340,251,339320,250498,589818
500390,201912,75,36,39,35928,38922,74850
500400,201912,214,146,68,145708,67864.98,213572.98
500410,201912,552,228,324,227546.95,324355.87,551902.82
500430,201912,524,375,149,378242,148702,526944
500440,201912,199,105,94,104790,93812,198602
500450,201912,399,175,224,175648,224550,400198
500460,201912,281,148,133,147704,134730,282434
500470,201912,434,346,88,348303.39,87824.98,436128.37
500480,201912,105,63,42,63872,41916,105788
500490,201912,111,48,63,47904,62874,110778
500500,201912,1428,521,907,520965.83,907212.53,1428178.36
500510,201912,41,33,8,32934,8982,41916
500515,201912,109,76,33,75848,32934.98,108782.98
500520,201912,332,180,152,179640.8,151697.39,331338.19
500525,201912,92,50,42,49900,41916,91816
500540,201912,893,379,514,381236.98,515967.96,897204.94
500560,201912,918,525,393,525946,392214.4,918160.4
500568,201912,985,567,418,569858,420158.4,990016.4
500570,201912,1193,697,496,697624.56,499051.94,1196676.50
500580,201912,344,176,168,175648,167665.97,343313.97
500600,201912,321,162,159,162674,158683.96,321357.96
500620,201912,903,637,266,639719,269460,909179
500625,201912,79,64,15,63872,14970,78842
500627,201912,22,11,11,10978,10978,21956
500630,201912,1571,859,712,859278.3,714568,1573846.3
500635,201912,515,305,210,305388,209580,514968
500640,201912,390,206,184,206586.8,183632,390218.8
500660,201912,5462,2051,3411,2060870.4,3413162.18,5474032.58
500690,201912,582,209,373,208591.78,374273.52,582865.30
500710,201912,386,196,190,195608,189621.96,385229.96
500720,201912,966,558,408,556884.43,408182,965066.43
500730,201912,196,120,76,119760,75848,195608
500740,201912,884,375,509,376250.95,511004.69,887255.64
500750,201912,147,48,99,47904,101796.98,149700.98
500755,201912,124,88,36,87824.4,35928,123752.4
500769,201912,747,415,332,416168.37,332334.98,748503.35
500770,201912,403,213,190,214570,192614,407184
500780,201912,156,102,54,101796,53892,155688
500790,201912,1080,556,524,557882,526948.91,1084830.91
500793,201912,274,152,122,152694,121757.38,274451.38
500795,201912,165,118,47,118762,46906.98,165668.98
500797,201912,52,37,15,36926,14970,51896
500800,201912,419,190,229,190618.98,229540,420158.98
500830,201912,2227,1258,969,1263468.8,971054.6,2234523.4
500840,201912,138,103,35,103792,34930.98,138722.98
510010,201912,168,91,77,90818,76846,167664
510020,201912,495,224,271,224567.64,270488.38,495056.02
510025,201912,1686,969,717,971065.13,716579.1,1687644.23
510030,201912,665,343,322,342316.94,323355.35,665672.29
510035,201912,127,62,65,61877.96,65868.98,127746.94
510040,201912,391,177,214,176646,213574.68,390220.68
510050,201912,393,216,177,215574.84,176652.32,392227.16
510060,201912,118,60,58,59880,57884,117764
510080,201912,227,89,138,88823.96,137724.98,226548.94
510100,201912,68,30,38,29940,37924,67864
510120,201912,37,23,14,22954,14970,37924
510125,201912,380,236,144,237524.98,143713.97,381238.95
510130,201912,564,329,235,329349.8,236536.18,565885.98
510140,201912,415,126,289,126746,288422,415168
510160,201912,110,38,72,37924,71856.98,109780.98
510170,201912,825,505,320,505002.88,321370.68,826373.56
510180,201912,2903,1383,1520,1388262.39,1520983.76,2909246.15
510185,201912,15,6,9,5988,8982,14970
510190,201912,228,84,144,83832,143712,227544
510250,201912,2574,1511,1063,1515969.26,1060877.34,2576846.60
510260,201912,176,128,48,128756.7,47904.98,176661.68
510263,201912,472,270,202,270460.76,201597.96,472058.72
510267,201912,678,378,300,377258.32,299420.56,676678.88
510268,201912,60,28,32,28942,31936,60878
510269,201912,73,34,39,33932.98,38922,72854.98
510270,201912,389,198,191,197607.92,191619.92,389227.84
510279,201912,217,162,55,161678.94,55888.4,217567.34
510285,201912,183,74,109,73852.98,109780,183632.98
510300,201912,513,275,238,274454.92,240524.86,514979.78
510305,201912,206,99,107,98803.97,106786.98,205590.95
510310,201912,101,54,47,53892,46906,100798
510320,201912,845,535,310,534933.88,312387.73,847321.61
510325,201912,403,171,232,171656,233532,405188
510330,201912,424,236,188,238522.99,187624,426146.99
510335,201912,630,357,273,357286.95,274455.88,631742.83
510336,201912,50,37,13,36926,12974,49900
510337,201912,106,45,61,44910,60878,105788
510340,201912,17255,7970,9285,7985222.15,9287696.92,17272919.07
510343,201912,62,44,18,43912,17964,61876
510345,201912,166,108,58,108782,57884.4,166666.4
510350,201912,658,367,291,369265.88,290422.32,659688.20
510360,201912,193,121,72,121756.98,71861.88,193618.86
510370,201912,143,71,72,71856,71858.94,143714.94
510380,201912,88,64,24,63872,23952.98,87824.98
510385,201912,59,25,34,24950,33932.98,58882.98
510390,201912,110,48,62,47904,61876,109780
510395,201912,46,33,13,32934,12974,45908
510410,201912,695,459,236,462075.98,237524.98,699600.96
510420,201912,565,277,288,278461.56,287451.32,565912.88
510450,201912,48,25,23,24950,22954,47904
510452,201912,50,26,24,25948,23952,49900
510454,201912,51,25,26,24950,25948,50898
510455,201912,127,76,51,75848,51896,127744
510460,201912,178,92,86,91817.68,85828.98,177646.66
510480,201912,733,427,306,428149.12,305399.66,733548.78
510490,201912,352,184,168,184636.82,168664.9,353301.72
510500,201912,238,177,61,177644,60878,238522
510510,201912,801,474,327,473055.34,329340,802395.34
510515,201912,1184,637,547,635731.88,545906.98,1181638.86
510517,201912,257,109,148,108782,147704.98,256486.98
510520,201912,228,150,78,150700.94,77848.88,228549.82
510523,201912,97,73,24,72854,23952,96806
510525,201912,813,483,330,482039.89,332339.88,814379.77
510530,201912,20,14,6,13972,5988,19960
510550,201912,253,112,141,111776.98,140718,252494.98
510558,201912,286,140,146,139720.98,145708,285428.98
510560,201912,408,246,162,245508.4,162675.96,408184.36
510562,201912,650,472,178,473052,177644.98,650696.98
510590,201912,762,396,366,395208.98,365270.95,760479.93
510600,201912,247,135,112,135728,111777.96,247505.96
510610,201912,197,82,115,81836,115768,197604
510615,201912,190,82,108,82834,107784,190618
510617,201912,20,12,8,11976,7984,19960
510618,201912,116,55,61,54890,60878,115768
510619,201912,101,70,31,69860.98,30938.98,100799.96
510620,201912,169,92,77,91816,76846,168662
510621,201912,186,122,64,121756.98,63873.96,185630.94
510622,201912,497,311,186,313378.86,185629.96,499008.82
510623,201912,337,234,103,233533.96,104790,338323.96
510624,201912,91,46,45,46906.98,44910,91816.98
510625,201912,538,331,207,331350.7,206597.39,537948.09
510626,201912,111,70,41,69860.98,41916,111776.98
510627,201912,68,46,22,45908,21956,67864
510628,201912,144,86,58,87824.98,57884,145708.98
510629,201912,257,163,94,162674,94810,257484
510630,201912,445,230,215,229542.94,216568.36,446111.30
510631,201912,12,3,9,2994,8982,11976
510637,201912,353,207,146,206588.95,145718.78,352307.73
510642,201912,972,542,430,540918.94,432135.96,973054.90
510645,201912,0,0,0,0,0,0
510650,201912,1437,945,492,945120.14,492018.87,1437139.01
510665,201912,81,41,40,40920.92,39920,80840.92
510670,201912,61,35,26,34930,25948,60878
510675,201912,1146,730,416,729541.34,416166,1145707.34
510677,201912,348,178,170,177648.9,169665.88,347314.78
510680,201912,107,62,45,61878.94,44910.98,106789.92
510682,201912,203,100,103,99800,102794,202594
510685,201912,54,42,12,41916,11976,53892
510700,201912,600,345,255,345318.78,254497.85,599816.63
510704,201912,1135,601,534,601908.63,533031.94,1134940.57
510706,201912,134,67,67,66866,66866.98,133732.98
510710,201912,393,275,118,274454.88,117765.92,392220.80
510715,201912,59,44,15,43912,14970,58882
510718,201912,207,106,101,105790.94,100798,206588.94
510719,201912,38,17,21,16966,20958,37924
510720,201912,188,129,59,130738,58882,189620
510724,201912,87,35,52,34930,51896,86826
510726,201912,49,25,24,24950,23952.98,48902.98
510729,201912,68,30,38,29940,37924,67864
510730,201912,469,263,206,262475.96,206587.97,469063.93
510735,201912,110,45,65,44910,64870,109780
510740,201912,23,12,11,11976,10978,22954
510757,201912,16,13,3,12974,2994,15968
510760,201912,7130,3725,3405,3730588.77,3411361.86,7141950.63
510770,201912,686,324,362,325351.9,362284.74,687636.64
510774,201912,18,7,11,6986,10978,17964
510775,201912,108,83,25,82834,24950,107784
510776,201912,29,11,18,10978,17964,28942
510777,201912,191,84,107,83832,106786,190618
510779,201912,51,23,28,22954.98,27946.94,50901.92
510780,201912,286,159,127,158688.88,126751.85,285440.73
510785,201912,396,213,183,212574,182634,395208
510787,201912,191,93,98,92814.98,97805.97,190620.95
510788,201912,1,0,1,0,998,998
510790,201912,2451,1297,1154,1298448.88,1160757.3,2459206.18
510792,201912,1150,660,490,662680.82,491029.73,1153710.55
510794,201912,116,61,55,60878,54890.98,115768.98
510795,201912,2360,1364,996,1366268.73,998007.66,2364276.39
510800,201912,178,110,68,109780,67864,177644
510805,201912,174,117,57,116766,56886.98,173652.98
510810,201912,96,42,54,41921.88,53892,95813.88
510820,201912,245,120,125,119764.12,125750.51,245514.63
510830,201912,69,44,25,43912,24950.98,68862.98
510835,201912,13,9,4,8982,3992,12974
510840,201912,9074,4371,4703,4374430.38,4706782.16,9081212.54
510850,201912,210,84,126,83832,125748.98,209580.98
510860,201912,377,170,207,169665.88,206596.18,376262.06
510880,201912,65,50,15,49900.98,14970,64870.98
510885,201912,75,42,33,41916.98,32934,74850.98
510890,201912,66,38,28,37924,27944,65868
510895,201912,186,109,77,108782,76848.37,185630.37
520005,201912,67,38,29,38922,28942,67864
520010,201912,276,125,151,124750,150698.8,275448.8
520013,201912,716,457,259,460078.98,258482,718560.98
520015,201912,55,40,15,39920,14970,54890
520017,201912,88,49,39,48902.4,38922,87824.4
520020,201912,21,11,10,10978,9980,20958
520025,201912,2141,1130,1011,1131733.4,1010974,2142707.4
520030,201912,790,423,367,423153.58,368262,791415.58
520050,201912,73,50,23,49900,22954,72854
520055,201912,47,28,19,28942,18962,47904
520060,201912,177,121,56,120758,58882,179640
520080,201912,567,405,162,405188,161676,566864
520082,201912,18,12,6,11976,5988,17964
520085,201912,95,72,23,71856,22954,94810
520090,201912,93,62,31,61876,31936,93812
520110,201912,9128,3961,5167,3975040.71,5174637.88,9149678.59
520120,201912,14,8,6,7984,5988,13972
520130,201912,786,553,233,554888.98,232534.4,787423.38
520140,201912,11941,6694,5247,6707570.82,5259477.2,11967048.02
520145,201912,50,32,18,31936,17964,49900
520150,201912,174,136,38,135728,37924,173652
520160,201912,37,28,9,27944,8982,36926
520170,201912,256,150,106,149702.93,105790.92,255493.85
520180,201912,152,78,74,78842,73852,152694
520215,201912,208,135,73,136726,73852,210578
520235,201912,77,59,18,58882,17964,76846
520250,201912,130,79,51,78842,50898,129740
520260,201912,114,73,41,72854,40918,113772
520280,201912,47,32,15,31936,14970,46906
520310,201912,41,26,15,25948,14970,40918
520320,201912,166,108,58,107784,57884,165668
520330,201912,779,420,359,419163.34,361277.96,780441.30
520340,201912,344,200,144,199600,144710.98,344310.98
520350,201912,506,239,267,238522,267464,505986
520355,201912,87,52,35,51896,34930,86826
520357,201912,26,19,7,19960,6986,26946
520360,201912,1,1,0,998,0,998
520380,201912,136,72,64,71856,64870,136726
520390,201912,262,112,150,111776,149700,261476
520393,201912,15,11,4,10978,3992,14970
520396,201912,87,54,33,53892,32934.98,86826.98
520400,201912,205,121,84,121756,83832,205588
520410,201912,193,96,97,96806.98,96806.98,193613.96
520420,201912,20,13,7,12974,6986,19960
520425,201912,291,144,147,144710,146707.4,291417.4
520430,201912,465,245,220,244601.81,219561.88,464163.69
520440,201912,673,478,195,478042,195608,673650
520450,201912,1936,864,1072,867262.98,1074851.88,1942114.86
520455,201912,56,38,18,37924,17964,55888
520460,201912,37,22,15,21956,14970,36926
520465,201912,33,29,4,28942,3992,32934
520470,201912,427,271,156,273452,155688,429140
520480,201912,79,48,31,47904.98,30943.88,78848.86
520485,201912,117,40,77,39920,76846.4,116766.4
520490,201912,413,305,108,304390.4,107784,412174.4
520495,201912,165,99,66,98802,66866,165668
520500,201912,182,139,43,138722,42914,181636
520505,201912,180,102,78,102794,77844,180638
520510,201912,1787,861,926,862313.56,930227.1,1792540.66
520520,201912,39,29,10,28942,9980,38922
520530,201912,234,176,58,175648,58882,234530
520540,201912,560,386,174,386226,173652,559878
520545,201912,138,85,53,84830,53892,138722
520547,201912,50,27,23,26946,22954,49900
520549,201912,1208,575,633,575846.32,633730,1209576.32
520551,201912,290,153,137,152694,137724.4,290418.4
520552,201912,42,29,13,28942,13972,42914
520570,201912,16,9,7,8982,6986,15968
520580,201912,281,175,106,174650,105788,280438
520590,201912,156,96,60,95808.98,60878,156686.98
520620,201912,1154,542,612,541915.38,612772.9,1154688.28
520630,201912,37,23,14,22954,13972,36926
520640,201912,398,234,164,235528,164670,400198
520650,201912,63,37,26,36926,25948,62874
520660,201912,43,22,21,21956,20958,42914
520670,201912,37,30,7,29940,6986,36926
520680,201912,53,35,18,34930,17964,52894
520690,201912,39,12,27,11976,26947.96,38923.96
520710,201912,34,31,3,30938,2994,33932
520725,201912,187,134,53,133732,53892,187624
520735,201912,56,38,18,37924,17964,55888
520740,201912,409,202,207,202594,206586.98,409180.98
520750,201912,34,26,8,25948,7984,33932
520753,201912,58,40,18,39920,17964,57884
520760,201912,106,72,34,72854,33932,106786
520780,201912,295,219,76,218562,75848,294410
520790,201912,152,83,69,83832,68862,152694
520800,201912,3412,1842,1570,1845304.19,1572848.88,3418153.07
520810,201912,164,122,42,123752,41916,165668
520815,201912,5,4,1,3992,998,4990
520830,201912,147,103,44,102794,43912,146706
520840,201912,353,234,119,233532,118762,352294
520850,201912,101,65,36,64871.96,35928,100799.96
520860,201912,1713,1103,610,1108778.4,610776.4,1719554.8
520870,201912,31465,15130,16335,15192574.39,16377210.74,31569785.13
520880,201912,1144,616,528,616764.4,528940.4,1145704.8
520890,201912,785,475,310,477044.98,309380,786424.98
520910,201912,978,525,453,526944.88,454090,981034.88
520915,201912,97,75,22,74850,21956,96806
520920,201912,408,202,206,201596,205588,407184
520929,201912,18,17,1,16966,998,17964
520940,201912,74,49,25,48902,24950,73852
520945,201912,18,11,7,10978,6986,17964
520960,201912,45,30,15,29940,14970,44910
520970,201912,334,206,128,205588.98,128742,334330.98
520980,201912,94,68,26,67864,25948,93812
520990,201912,449,303,146,303392,148702,452094
520993,201912,130,62,68,62874,67864,130738
520995,201912,243,141,102,140718.66,103792.4,244511.06
521000,201912,1552,918,634,922152.6,636724.8,1558877.4
521010,201912,671,325,346,325351.92,345310.94,670662.86
521015,201912,15,9,6,8982,5988,14970
521020,201912,1421,998,423,998998.98,423154.36,1422153.34
521030,201912,51,36,15,35928,14970,50898
521040,201912,941,596,345,601794.9,345308.4,947103.3
521056,201912,44,32,12,31936,11976,43912
521060,201912,130,85,45,84830,44910,129740
521080,201912,444,340,104,339321.38,104790,444111.38
521090,201912,531,335,196,335328,195608,530936
521100,201912,274,207,67,207584,66866,274450
521120,201912,1061,746,315,745506.4,314370.98,1059877.38
521130,201912,352,252,100,252494,99802.36,352296.36
521140,201912,175,95,80,96806,79840,176646
521150,201912,2680,1169,1511,1176644.36,1514965.96,2691610.32
521160,201912,29,15,14,14970,14970,29940
521170,201912,201,114,87,113772,86826,200598
521180,201912,1187,755,432,755486.2,434130.9,1189617.1
521190,201912,2533,1067,1466,1069856,1466064.36,2535920.36
521200,201912,54,40,14,40918,13972,54890
521205,201912,11,8,3,7984,2994,10978
521210,201912,126,73,53,72854,53892,126746
521220,201912,802,562,240,567862,241516.9,809378.9
521225,201912,35,24,11,23952,10978,34930
521230,201912,104,69,35,68862,34930,103792
521250,201912,6155,3507,2648,3518953.89,2654683.28,6173637.17
521260,201912,26,14,12,13972,11976,25948
521270,201912,140,109,31,108782,30938,139720
521280,201912,428,261,167,260478,166666,427144
521290,201912,27,11,16,10978,15968,26946
521295,201912,98,64,34,63872,33932,97804
521300,201912,218,116,102,116767.96,101799.34,218567.30
521305,201912,36,25,11,24950,11976,36926
521308,201912,1104,841,263,839325.84,262474.98,1101800.82
521310,201912,1322,771,551,772456.9,549899.34,1322356.24
521340,201912,21,16,5,15968,4990,20958
521350,201912,127,94,33,93812,32934,126746
521370,201912,173,121,52,120758,51896,172654
521375,201912,170,93,77,92814,78842,171656
521377,201912,46,35,11,34930,10978,45908
521380,201912,1051,673,378,675648.32,377244.4,1052892.72
521385,201912,14,8,6,7984,5988,13972
521390,201912,99,80,19,79840,18962,98802
521400,201912,334,226,108,225548,108782,334330
521405,201912,142,79,63,78842,62874,141716
521410,201912,65,44,21,43912,20958,64870
521440,201912,194,142,52,141716,51896,193612
521450,201912,733,411,322,411176,322354,733530
521460,201912,1163,742,421,741514.55,425148.41,1166662.96
521470,201912,12,8,4,7984,3992,11976
521480,201912,43,30,13,29942.94,12976.86,42919.80
521483,201912,313,182,131,182634.4,130738,313372.4
521486,201912,280,183,97,182634,97804.6,280438.6
521487,201912,22,11,11,10978,10978,21956
521490,201912,26,15,11,14970,10978,25948
521500,201912,115,74,41,74850,40918,115768
521520,201912,41,29,12,28942,12974,41916
521523,201912,692,418,274,419160,273452,692612
521525,201912,45,29,16,28942,15968,44910
521530,201912,246,133,113,132734,112774,245508
521540,201912,30,15,15,14970,14970,29940
521550,201912,86,39,47,38925.34,46910.9,85836.24
521560,201912,804,552,252,550896.4,255488.7,806385.1
521565,201912,57,37,20,36926,19960,56886
521570,201912,519,344,175,343312.4,174650.9,517963.3
521580,201912,58,34,24,35928,23952,59880
521590,201912,38,18,20,17964,19960,37924
521600,201912,22,13,9,12974,8982,21956
521630,201912,247,129,118,128742,117766.46,246508.46
521640,201912,296,161,135,161676,135728,297404
521645,201912,28,16,12,15968,12974,28942
521680,201912,226,140,86,140718,86826.6,227544.6
521690,201912,2,2,0,1996,0,1996
521710,201912,1149,553,596,556884,595806.98,1152690.98
521720,201912,540,372,168,373252,169661.34,542913.34
521730,201912,639,311,328,310379.6,327344,637723.6
521740,201912,905,381,524,381236.98,523954.32,905191.30
521760,201912,1818,968,850,969058.59,849299.36,1818357.95
521770,201912,823,523,300,523950,302394,826344
521800,201912,2009,1278,731,1285435.4,733538.82,2018974.22
521805,201912,32,18,14,17964,13972,31936
521810,201912,85,53,32,53892,31936,85828
521830,201912,935,669,266,675646.13,267464.98,943111.11
521839,201912,86,53,33,53892,32934,86826
521850,201912,1081,579,502,578844.01,503006.52,1081850.53
521860,201912,349,220,129,219560,128742,348302
521870,201912,72,42,30,41916,29940,71856
521878,201912,35,17,18,16966,17964,34930
521880,201912,4674,2105,2569,2107779.24,2575843.75,4683622.99
521890,201912,593,427,166,427144,165668,592812
521900,201912,287,235,52,234530,51896,286426
521910,201912,158,112,46,111776,45908,157684
521920,201912,50,24,26,24950,25948,50898
521925,201912,49,26,23,26946,22954,49900
521930,201912,1143,637,506,636734.2,508991.18,1145725.38
521935,201912,35,26,9,25948,8982,34930
521940,201912,198,100,98,99800,97804,197604
521945,201912,16,14,2,13972,1996,15968
521950,201912,8,4,4,3992,3992,7984
521960,201912,72,54,18,53925.26,17964,71889.26
521970,201912,399,259,140,259480,140718,400198
521971,201912,90,45,45,45908,44910,90818
521973,201912,33,18,15,17964,14970,32934
521975,201912,1350,681,669,686624.61,668661.1,1355285.71
521980,201912,241,164,77,164670,76846,241516
521990,201912,79,56,23,55888,22954,78842
522000,201912,289,180,109,181287.69,109780,291067.69
522005,201912,19,11,8,10978,7984,18962
522010,201912,1140,645,495,646704.98,496006,1142710.98
522015,201912,62,39,23,38922.98,22954,61876.98
522020,201912,890,512,378,510976.1,378242.8,889218.9
522026,201912,21,13,8,12974,8982,21956
522028,201912,17,13,4,12974,3992,16966
522040,201912,777,317,460,319362.46,459083.92,778446.38
522045,201912,2294,1424,870,1428139.16,869260.28,2297399.44
522050,201912,161,80,81,79840,80838,160678
522060,201912,546,349,197,351296,197604,548900
522068,201912,120,80,40,80838,39920,120758
522070,201912,12,11,1,10978,998,11976
522100,201912,41,23,18,22954,17964,40918
522108,201912,41,31,10,30938,9980,40918
522119,201912,54,28,26,27944,25948,53892
522130,201912,80,34,46,33932,45911.92,79843.92
522140,201912,4032,2096,1936,2098796.3,1935123.58,4033919.88
522145,201912,45,33,12,33932,11976,45908
522150,201912,82,60,22,59880,21956,81836
522155,201912,52,34,18,33932.98,17964.98,51897.96
522157,201912,6,3,3,2994,2994,5988
522160,201912,1698,1019,679,1018958,678640.98,1697598.98
522170,201912,394,269,125,269460,124750,394210
522180,201912,40,20,20,19960,19960,39920
522185,201912,2023,802,1221,806384.8,1222551.95,2028936.75
522190,201912,44,26,18,25948,17964,43912
522200,201912,296,176,120,175648,119760,295408
522205,201912,145,100,45,99800,44910,144710
522220,201912,156,113,43,112774,42914,155688
522230,201912,34,27,7,26946,7984,34930
530010,201912,54455,27702,26753,27892283.24,26932071.95,54824355.19
